match_id,player,row,shots,pt_ending,winners,induced_forced,unforced,shots_in_pts_won,shots_in_pts_lost
20090606-W-Roland_Garros-F-Svetlana_Kuznetsova-Dinara_Safina,1,F-XC,34,9,0,2,7,20,14
20090606-W-Roland_Garros-F-Svetlana_Kuznetsova-Dinara_Safina,1,F-DTM,23,3,0,0,3,14,9
20090606-W-Roland_Garros-F-Svetlana_Kuznetsova-Dinara_Safina,1,F-DTL,12,5,0,1,4,5,7
20090606-W-Roland_Garros-F-Svetlana_Kuznetsova-Dinara_Safina,1,F-IO,11,4,4,0,0,9,2
20090606-W-Roland_Garros-F-Svetlana_Kuznetsova-Dinara_Safina,1,F-II,2,1,0,0,1,0,2
20090606-W-Roland_Garros-F-Svetlana_Kuznetsova-Dinara_Safina,1,B-XC,19,5,2,2,1,12,7
20090606-W-Roland_Garros-F-Svetlana_Kuznetsova-Dinara_Safina,1,B-DTM,16,2,0,0,2,12,4
20090606-W-Roland_Garros-F-Svetlana_Kuznetsova-Dinara_Safina,1,B-DTL,9,5,0,2,3,4,5
20090606-W-Roland_Garros-F-Svetlana_Kuznetsova-Dinara_Safina,1,B-IO,8,1,0,1,0,6,2
20090606-W-Roland_Garros-F-Svetlana_Kuznetsova-Dinara_Safina,1,S-XC,6,0,0,0,0,2,4
20090606-W-Roland_Garros-F-Svetlana_Kuznetsova-Dinara_Safina,1,S-DTM,6,0,0,0,0,1,5
20090606-W-Roland_Garros-F-Svetlana_Kuznetsova-Dinara_Safina,1,S-DTL,2,0,0,0,0,1,1
20090606-W-Roland_Garros-F-Svetlana_Kuznetsova-Dinara_Safina,2,F-XC,45,11,3,0,8,18,27
20090606-W-Roland_Garros-F-Svetlana_Kuznetsova-Dinara_Safina,2,F-DTM,19,3,0,0,3,6,13
20090606-W-Roland_Garros-F-Svetlana_Kuznetsova-Dinara_Safina,2,F-DTL,10,2,0,0,2,4,6
20090606-W-Roland_Garros-F-Svetlana_Kuznetsova-Dinara_Safina,2,F-IO,14,7,4,1,2,8,6
20090606-W-Roland_Garros-F-Svetlana_Kuznetsova-Dinara_Safina,2,B-XC,24,5,1,2,2,13,11
20090606-W-Roland_Garros-F-Svetlana_Kuznetsova-Dinara_Safina,2,B-DTM,29,3,0,0,3,6,23
20090606-W-Roland_Garros-F-Svetlana_Kuznetsova-Dinara_Safina,2,B-DTL,3,1,0,0,1,0,3
20090606-W-Roland_Garros-F-Svetlana_Kuznetsova-Dinara_Safina,2,B-IO,1,0,0,0,0,0,1
20090606-W-Roland_Garros-F-Svetlana_Kuznetsova-Dinara_Safina,2,S-DTM,4,0,0,0,0,1,3
20090606-W-Roland_Garros-F-Svetlana_Kuznetsova-Dinara_Safina,2,S-DTL,2,0,0,0,0,1,1
20110614-W-Wimbledon-R64-Venus_Williams-Kimiko_Date_Krumm,1,F-XC,36,6,1,1,4,14,22
20110614-W-Wimbledon-R64-Venus_Williams-Kimiko_Date_Krumm,1,F-DTM,45,9,1,2,6,12,33
20110614-W-Wimbledon-R64-Venus_Williams-Kimiko_Date_Krumm,1,F-DTL,18,8,5,2,1,14,4
20110614-W-Wimbledon-R64-Venus_Williams-Kimiko_Date_Krumm,1,F-IO,29,10,5,2,3,17,12
20110614-W-Wimbledon-R64-Venus_Williams-Kimiko_Date_Krumm,1,B-XC,49,5,1,1,3,23,26
20110614-W-Wimbledon-R64-Venus_Williams-Kimiko_Date_Krumm,1,B-DTM,50,4,0,0,4,20,30
20110614-W-Wimbledon-R64-Venus_Williams-Kimiko_Date_Krumm,1,B-DTL,15,6,4,1,1,10,5
20110614-W-Wimbledon-R64-Venus_Williams-Kimiko_Date_Krumm,1,B-IO,12,7,1,1,5,5,7
20110614-W-Wimbledon-R64-Venus_Williams-Kimiko_Date_Krumm,1,S-XC,2,0,0,0,0,2,0
20110614-W-Wimbledon-R64-Venus_Williams-Kimiko_Date_Krumm,1,S-DTM,5,0,0,0,0,1,4
20110614-W-Wimbledon-R64-Venus_Williams-Kimiko_Date_Krumm,1,S-DTL,1,0,0,0,0,0,1
20110614-W-Wimbledon-R64-Venus_Williams-Kimiko_Date_Krumm,2,F-XC,44,15,5,5,5,25,19
20110614-W-Wimbledon-R64-Venus_Williams-Kimiko_Date_Krumm,2,F-DTM,48,10,0,2,8,21,27
20110614-W-Wimbledon-R64-Venus_Williams-Kimiko_Date_Krumm,2,F-DTL,9,6,3,1,2,6,3
20110614-W-Wimbledon-R64-Venus_Williams-Kimiko_Date_Krumm,2,F-IO,20,9,4,2,3,12,8
20110614-W-Wimbledon-R64-Venus_Williams-Kimiko_Date_Krumm,2,F-II,2,1,1,0,0,1,1
20110614-W-Wimbledon-R64-Venus_Williams-Kimiko_Date_Krumm,2,B-XC,43,8,3,4,1,32,11
20110614-W-Wimbledon-R64-Venus_Williams-Kimiko_Date_Krumm,2,B-DTM,70,12,0,0,12,26,44
20110614-W-Wimbledon-R64-Venus_Williams-Kimiko_Date_Krumm,2,B-DTL,12,1,1,0,0,7,5
20110614-W-Wimbledon-R64-Venus_Williams-Kimiko_Date_Krumm,2,B-IO,12,4,1,0,3,7,5
20110614-W-Wimbledon-R64-Venus_Williams-Kimiko_Date_Krumm,2,S-XC,2,1,0,1,0,1,1
20110614-W-Wimbledon-R64-Venus_Williams-Kimiko_Date_Krumm,2,S-DTM,4,0,0,0,0,1,3
20110614-W-Wimbledon-R64-Venus_Williams-Kimiko_Date_Krumm,2,S-DTL,2,1,0,1,0,2,0
20110614-W-Wimbledon-R64-Venus_Williams-Kimiko_Date_Krumm,2,S-IO,2,2,2,0,0,2,0
20121007-W-Beijing-F-Maria_Sharapova-Victoria_Azarenka,1,F-XC,37,13,3,3,7,18,19
20121007-W-Beijing-F-Maria_Sharapova-Victoria_Azarenka,1,F-DTM,42,4,0,1,3,18,24
20121007-W-Beijing-F-Maria_Sharapova-Victoria_Azarenka,1,F-DTL,5,4,1,1,2,3,2
20121007-W-Beijing-F-Maria_Sharapova-Victoria_Azarenka,1,F-IO,22,12,4,0,8,8,14
20121007-W-Beijing-F-Maria_Sharapova-Victoria_Azarenka,1,F-II,1,0,0,0,0,0,1
20121007-W-Beijing-F-Maria_Sharapova-Victoria_Azarenka,1,B-XC,19,5,2,1,2,11,8
20121007-W-Beijing-F-Maria_Sharapova-Victoria_Azarenka,1,B-DTM,28,6,0,0,6,8,20
20121007-W-Beijing-F-Maria_Sharapova-Victoria_Azarenka,1,B-DTL,8,3,0,0,3,1,7
20121007-W-Beijing-F-Maria_Sharapova-Victoria_Azarenka,1,B-IO,5,2,1,1,0,3,2
20121007-W-Beijing-F-Maria_Sharapova-Victoria_Azarenka,1,S-DTM,1,0,0,0,0,1,0
20121007-W-Beijing-F-Maria_Sharapova-Victoria_Azarenka,2,F-XC,27,5,2,0,3,15,12
20121007-W-Beijing-F-Maria_Sharapova-Victoria_Azarenka,2,F-DTM,57,7,0,0,7,31,26
20121007-W-Beijing-F-Maria_Sharapova-Victoria_Azarenka,2,F-DTL,4,1,0,0,1,0,4
20121007-W-Beijing-F-Maria_Sharapova-Victoria_Azarenka,2,F-IO,15,6,2,4,0,12,3
20121007-W-Beijing-F-Maria_Sharapova-Victoria_Azarenka,2,F-II,1,0,0,0,0,1,0
20121007-W-Beijing-F-Maria_Sharapova-Victoria_Azarenka,2,B-XC,12,3,2,0,1,8,4
20121007-W-Beijing-F-Maria_Sharapova-Victoria_Azarenka,2,B-DTM,19,1,0,0,1,13,6
20121007-W-Beijing-F-Maria_Sharapova-Victoria_Azarenka,2,B-DTL,5,1,1,0,0,2,3
20121007-W-Beijing-F-Maria_Sharapova-Victoria_Azarenka,2,B-IO,4,1,0,0,1,2,2
20121007-W-Beijing-F-Maria_Sharapova-Victoria_Azarenka,2,S-XC,1,0,0,0,0,1,0
20121007-W-Beijing-F-Maria_Sharapova-Victoria_Azarenka,2,S-DTM,4,0,0,0,0,1,3
20121007-W-Beijing-F-Maria_Sharapova-Victoria_Azarenka,2,S-DTL,1,0,0,0,0,0,1
20120429-W-Stuttgart-F-Maria_Sharapova-Victoria_Azarenka,1,F-XC,28,8,2,1,5,17,11
20120429-W-Stuttgart-F-Maria_Sharapova-Victoria_Azarenka,1,F-DTM,15,1,0,0,1,7,8
20120429-W-Stuttgart-F-Maria_Sharapova-Victoria_Azarenka,1,F-DTL,3,0,0,0,0,3,0
20120429-W-Stuttgart-F-Maria_Sharapova-Victoria_Azarenka,1,F-IO,6,3,1,1,1,3,3
20120429-W-Stuttgart-F-Maria_Sharapova-Victoria_Azarenka,1,B-XC,21,13,8,2,3,16,5
20120429-W-Stuttgart-F-Maria_Sharapova-Victoria_Azarenka,1,B-DTM,17,1,0,0,1,9,8
20120429-W-Stuttgart-F-Maria_Sharapova-Victoria_Azarenka,1,B-DTL,9,6,5,0,1,6,3
20120429-W-Stuttgart-F-Maria_Sharapova-Victoria_Azarenka,1,B-IO,2,2,1,1,0,2,0
20120429-W-Stuttgart-F-Maria_Sharapova-Victoria_Azarenka,1,S-DTM,1,0,0,0,0,0,1
20120429-W-Stuttgart-F-Maria_Sharapova-Victoria_Azarenka,2,F-XC,26,9,2,4,3,15,11
20120429-W-Stuttgart-F-Maria_Sharapova-Victoria_Azarenka,2,F-DTM,12,2,0,0,2,4,8
20120429-W-Stuttgart-F-Maria_Sharapova-Victoria_Azarenka,2,F-DTL,12,2,0,0,2,3,9
20120429-W-Stuttgart-F-Maria_Sharapova-Victoria_Azarenka,2,F-IO,9,5,2,2,1,6,3
20120429-W-Stuttgart-F-Maria_Sharapova-Victoria_Azarenka,2,B-XC,14,6,3,1,2,8,6
20120429-W-Stuttgart-F-Maria_Sharapova-Victoria_Azarenka,2,B-DTM,9,0,0,0,0,4,5
20120429-W-Stuttgart-F-Maria_Sharapova-Victoria_Azarenka,2,B-DTL,4,2,0,0,2,0,4
20120429-W-Stuttgart-F-Maria_Sharapova-Victoria_Azarenka,2,B-IO,7,1,1,0,0,3,4
20120429-W-Stuttgart-F-Maria_Sharapova-Victoria_Azarenka,2,S-XC,2,0,0,0,0,0,2
20120429-W-Stuttgart-F-Maria_Sharapova-Victoria_Azarenka,2,S-DTM,2,0,0,0,0,1,1
20120429-W-Stuttgart-F-Maria_Sharapova-Victoria_Azarenka,2,S-DTL,1,0,0,0,0,0,1
20140119-W-Australian_Open-R16-Serena_Williams-Ana_Ivanovic,1,F-XC,14,3,0,1,2,4,10
20140119-W-Australian_Open-R16-Serena_Williams-Ana_Ivanovic,1,F-DTM,12,1,0,1,0,5,7
20140119-W-Australian_Open-R16-Serena_Williams-Ana_Ivanovic,1,F-DTL,3,2,0,0,2,0,3
20140119-W-Australian_Open-R16-Serena_Williams-Ana_Ivanovic,1,F-IO,10,2,1,0,1,6,4
20140119-W-Australian_Open-R16-Serena_Williams-Ana_Ivanovic,1,B-XC,48,10,1,3,6,19,29
20140119-W-Australian_Open-R16-Serena_Williams-Ana_Ivanovic,1,B-DTM,43,6,0,0,6,13,30
20140119-W-Australian_Open-R16-Serena_Williams-Ana_Ivanovic,1,B-DTL,6,2,0,1,1,1,5
20140119-W-Australian_Open-R16-Serena_Williams-Ana_Ivanovic,1,B-IO,9,3,1,1,1,3,6
20140119-W-Australian_Open-R16-Serena_Williams-Ana_Ivanovic,1,S-DTM,3,0,0,0,0,0,3
20140119-W-Australian_Open-R16-Serena_Williams-Ana_Ivanovic,2,F-XC,21,13,5,1,7,14,7
20140119-W-Australian_Open-R16-Serena_Williams-Ana_Ivanovic,2,F-DTM,14,1,0,1,0,13,1
20140119-W-Australian_Open-R16-Serena_Williams-Ana_Ivanovic,2,F-DTL,14,6,4,1,1,12,2
20140119-W-Australian_Open-R16-Serena_Williams-Ana_Ivanovic,2,F-IO,28,12,5,3,4,22,6
20140119-W-Australian_Open-R16-Serena_Williams-Ana_Ivanovic,2,F-II,2,2,0,1,1,1,1
20140119-W-Australian_Open-R16-Serena_Williams-Ana_Ivanovic,2,B-XC,18,4,0,0,4,7,11
20140119-W-Australian_Open-R16-Serena_Williams-Ana_Ivanovic,2,B-DTM,34,2,0,1,1,20,14
20140119-W-Australian_Open-R16-Serena_Williams-Ana_Ivanovic,2,B-DTL,4,4,1,1,2,2,2
20140119-W-Australian_Open-R16-Serena_Williams-Ana_Ivanovic,2,B-IO,2,0,0,0,0,1,1
20140119-W-Australian_Open-R16-Serena_Williams-Ana_Ivanovic,2,S-XC,5,0,0,0,0,2,3
20140119-W-Australian_Open-R16-Serena_Williams-Ana_Ivanovic,2,S-DTM,12,0,0,0,0,8,4
20140119-W-Australian_Open-R16-Serena_Williams-Ana_Ivanovic,2,S-DTL,2,0,0,0,0,1,1
20140119-W-Australian_Open-R16-Serena_Williams-Ana_Ivanovic,2,S-IO,1,0,0,0,0,1,0
20140118-W-Australian_Open-R32-Maria_Sharapova-Alize_Cornet,1,F-XC,31,7,5,0,2,22,9
20140118-W-Australian_Open-R32-Maria_Sharapova-Alize_Cornet,1,F-DTM,22,1,0,1,0,12,10
20140118-W-Australian_Open-R32-Maria_Sharapova-Alize_Cornet,1,F-DTL,8,4,1,2,1,5,3
20140118-W-Australian_Open-R32-Maria_Sharapova-Alize_Cornet,1,F-IO,25,9,4,2,3,19,6
20140118-W-Australian_Open-R32-Maria_Sharapova-Alize_Cornet,1,F-II,2,1,0,0,1,1,1
20140118-W-Australian_Open-R32-Maria_Sharapova-Alize_Cornet,1,B-XC,48,12,8,1,3,24,24
20140118-W-Australian_Open-R32-Maria_Sharapova-Alize_Cornet,1,B-DTM,34,4,0,0,4,12,22
20140118-W-Australian_Open-R32-Maria_Sharapova-Alize_Cornet,1,B-DTL,9,5,1,1,3,4,5
20140118-W-Australian_Open-R32-Maria_Sharapova-Alize_Cornet,1,B-IO,12,6,1,2,3,7,5
20140118-W-Australian_Open-R32-Maria_Sharapova-Alize_Cornet,1,S-DTM,5,0,0,0,0,0,5
20140118-W-Australian_Open-R32-Maria_Sharapova-Alize_Cornet,2,F-XC,27,6,4,1,1,16,11
20140118-W-Australian_Open-R32-Maria_Sharapova-Alize_Cornet,2,F-DTM,23,2,0,0,2,4,19
20140118-W-Australian_Open-R32-Maria_Sharapova-Alize_Cornet,2,F-DTL,12,2,0,1,1,7,5
20140118-W-Australian_Open-R32-Maria_Sharapova-Alize_Cornet,2,F-IO,21,3,1,2,0,13,8
20140118-W-Australian_Open-R32-Maria_Sharapova-Alize_Cornet,2,B-XC,19,1,0,0,1,11,8
20140118-W-Australian_Open-R32-Maria_Sharapova-Alize_Cornet,2,B-DTM,56,3,0,1,2,29,27
20140118-W-Australian_Open-R32-Maria_Sharapova-Alize_Cornet,2,B-DTL,2,2,0,0,2,0,2
20140118-W-Australian_Open-R32-Maria_Sharapova-Alize_Cornet,2,B-IO,3,0,0,0,0,0,3
20140118-W-Australian_Open-R32-Maria_Sharapova-Alize_Cornet,2,S-XC,6,1,0,0,1,1,5
20140118-W-Australian_Open-R32-Maria_Sharapova-Alize_Cornet,2,S-DTM,7,0,0,0,0,1,6
20140118-W-Australian_Open-R32-Maria_Sharapova-Alize_Cornet,2,S-DTL,1,0,0,0,0,0,1
20140117-W-Australian_Open-R32-Serena_Williams-Daniela_Hantuchova,1,F-XC,11,7,1,4,2,7,4
20140117-W-Australian_Open-R32-Serena_Williams-Daniela_Hantuchova,1,F-DTM,8,2,0,0,2,5,3
20140117-W-Australian_Open-R32-Serena_Williams-Daniela_Hantuchova,1,F-DTL,2,2,2,0,0,2,0
20140117-W-Australian_Open-R32-Serena_Williams-Daniela_Hantuchova,1,F-IO,7,5,1,0,4,3,4
20140117-W-Australian_Open-R32-Serena_Williams-Daniela_Hantuchova,1,B-XC,12,4,1,0,3,8,4
20140117-W-Australian_Open-R32-Serena_Williams-Daniela_Hantuchova,1,B-DTM,14,2,0,0,2,10,4
20140117-W-Australian_Open-R32-Serena_Williams-Daniela_Hantuchova,1,B-DTL,3,1,1,0,0,2,1
20140117-W-Australian_Open-R32-Serena_Williams-Daniela_Hantuchova,1,B-IO,7,3,1,1,1,3,4
20140117-W-Australian_Open-R32-Serena_Williams-Daniela_Hantuchova,1,S-DTM,2,0,0,0,0,0,2
20140117-W-Australian_Open-R32-Serena_Williams-Daniela_Hantuchova,1,S-IO,1,0,0,0,0,1,0
20140117-W-Australian_Open-R32-Serena_Williams-Daniela_Hantuchova,2,F-XC,13,6,3,0,3,5,8
20140117-W-Australian_Open-R32-Serena_Williams-Daniela_Hantuchova,2,F-DTM,10,1,0,0,1,6,4
20140117-W-Australian_Open-R32-Serena_Williams-Daniela_Hantuchova,2,F-DTL,4,4,1,0,3,1,3
20140117-W-Australian_Open-R32-Serena_Williams-Daniela_Hantuchova,2,F-IO,8,4,0,1,3,1,7
20140117-W-Australian_Open-R32-Serena_Williams-Daniela_Hantuchova,2,B-XC,8,0,0,0,0,1,7
20140117-W-Australian_Open-R32-Serena_Williams-Daniela_Hantuchova,2,B-DTM,13,4,0,0,4,3,10
20140117-W-Australian_Open-R32-Serena_Williams-Daniela_Hantuchova,2,B-DTL,4,1,1,0,0,1,3
20140117-W-Australian_Open-R32-Serena_Williams-Daniela_Hantuchova,2,B-IO,2,1,0,0,1,0,2
20140113-W-Australian_Open-R128-Venus_Williams-Ekaterina_Makarova,1,F-XC,80,12,5,1,6,38,42
20140113-W-Australian_Open-R128-Venus_Williams-Ekaterina_Makarova,1,F-DTM,46,4,1,1,2,19,27
20140113-W-Australian_Open-R128-Venus_Williams-Ekaterina_Makarova,1,F-DTL,16,9,4,1,4,8,8
20140113-W-Australian_Open-R128-Venus_Williams-Ekaterina_Makarova,1,F-IO,33,19,10,4,5,23,10
20140113-W-Australian_Open-R128-Venus_Williams-Ekaterina_Makarova,1,F-II,1,1,1,0,0,1,0
20140113-W-Australian_Open-R128-Venus_Williams-Ekaterina_Makarova,1,B-XC,34,7,1,1,5,17,17
20140113-W-Australian_Open-R128-Venus_Williams-Ekaterina_Makarova,1,B-DTM,25,5,0,0,5,10,15
20140113-W-Australian_Open-R128-Venus_Williams-Ekaterina_Makarova,1,B-DTL,12,8,4,1,3,9,3
20140113-W-Australian_Open-R128-Venus_Williams-Ekaterina_Makarova,1,B-IO,13,8,7,0,1,8,5
20140113-W-Australian_Open-R128-Venus_Williams-Ekaterina_Makarova,1,B-II,1,0,0,0,0,1,0
20140113-W-Australian_Open-R128-Venus_Williams-Ekaterina_Makarova,1,S-DTM,2,1,0,0,1,1,1
20140113-W-Australian_Open-R128-Venus_Williams-Ekaterina_Makarova,1,S-DTL,2,0,0,0,0,0,2
20140113-W-Australian_Open-R128-Venus_Williams-Ekaterina_Makarova,2,F-XC,46,9,1,3,5,22,24
20140113-W-Australian_Open-R128-Venus_Williams-Ekaterina_Makarova,2,F-DTM,33,2,0,0,2,11,22
20140113-W-Australian_Open-R128-Venus_Williams-Ekaterina_Makarova,2,F-DTL,8,3,1,1,1,4,4
20140113-W-Australian_Open-R128-Venus_Williams-Ekaterina_Makarova,2,F-IO,7,2,0,1,1,3,4
20140113-W-Australian_Open-R128-Venus_Williams-Ekaterina_Makarova,2,F-II,2,0,0,0,0,0,2
20140113-W-Australian_Open-R128-Venus_Williams-Ekaterina_Makarova,2,B-XC,67,13,5,3,5,44,23
20140113-W-Australian_Open-R128-Venus_Williams-Ekaterina_Makarova,2,B-DTM,66,2,0,0,2,31,35
20140113-W-Australian_Open-R128-Venus_Williams-Ekaterina_Makarova,2,B-DTL,16,10,3,3,4,9,7
20140113-W-Australian_Open-R128-Venus_Williams-Ekaterina_Makarova,2,B-IO,13,4,3,1,0,7,6
20140113-W-Australian_Open-R128-Venus_Williams-Ekaterina_Makarova,2,B-II,4,1,1,0,0,2,2
20130117-W-Australian_Open-R64-Victoria_Azarenka-Eleni_Daniilidou,1,F-XC,17,4,3,0,1,13,4
20130117-W-Australian_Open-R64-Victoria_Azarenka-Eleni_Daniilidou,1,F-DTM,7,0,0,0,0,2,5
20130117-W-Australian_Open-R64-Victoria_Azarenka-Eleni_Daniilidou,1,F-DTL,11,1,1,0,0,9,2
20130117-W-Australian_Open-R64-Victoria_Azarenka-Eleni_Daniilidou,1,F-IO,21,3,1,1,1,17,4
20130117-W-Australian_Open-R64-Victoria_Azarenka-Eleni_Daniilidou,1,B-XC,53,9,4,1,4,41,12
20130117-W-Australian_Open-R64-Victoria_Azarenka-Eleni_Daniilidou,1,B-DTM,15,3,0,0,3,8,7
20130117-W-Australian_Open-R64-Victoria_Azarenka-Eleni_Daniilidou,1,B-DTL,6,3,3,0,0,6,0
20130117-W-Australian_Open-R64-Victoria_Azarenka-Eleni_Daniilidou,1,B-IO,7,2,2,0,0,7,0
20130117-W-Australian_Open-R64-Victoria_Azarenka-Eleni_Daniilidou,1,S-XC,1,0,0,0,0,0,1
20130117-W-Australian_Open-R64-Victoria_Azarenka-Eleni_Daniilidou,1,S-DTM,3,1,0,0,1,0,3
20130117-W-Australian_Open-R64-Victoria_Azarenka-Eleni_Daniilidou,1,S-DTL,1,0,0,0,0,0,1
20130117-W-Australian_Open-R64-Victoria_Azarenka-Eleni_Daniilidou,2,F-XC,20,5,2,0,3,8,12
20130117-W-Australian_Open-R64-Victoria_Azarenka-Eleni_Daniilidou,2,F-DTM,14,3,0,0,3,2,12
20130117-W-Australian_Open-R64-Victoria_Azarenka-Eleni_Daniilidou,2,F-DTL,1,0,0,0,0,1,0
20130117-W-Australian_Open-R64-Victoria_Azarenka-Eleni_Daniilidou,2,F-IO,16,3,2,1,0,10,6
20130117-W-Australian_Open-R64-Victoria_Azarenka-Eleni_Daniilidou,2,F-II,2,0,0,0,0,1,1
20130117-W-Australian_Open-R64-Victoria_Azarenka-Eleni_Daniilidou,2,B-XC,25,3,0,1,2,9,16
20130117-W-Australian_Open-R64-Victoria_Azarenka-Eleni_Daniilidou,2,B-DTM,15,2,0,0,2,4,11
20130117-W-Australian_Open-R64-Victoria_Azarenka-Eleni_Daniilidou,2,B-DTL,1,1,0,0,1,0,1
20130117-W-Australian_Open-R64-Victoria_Azarenka-Eleni_Daniilidou,2,S-XC,19,3,0,0,3,1,18
20130117-W-Australian_Open-R64-Victoria_Azarenka-Eleni_Daniilidou,2,S-DTM,22,2,0,0,2,2,20
20130117-W-Australian_Open-R64-Victoria_Azarenka-Eleni_Daniilidou,2,S-DTL,5,2,0,0,2,1,4
20130118-W-Australian_Open-R32-Victoria_Azarenka-Jamie_Hampton,1,F-XC,44,7,3,0,4,18,26
20130118-W-Australian_Open-R32-Victoria_Azarenka-Jamie_Hampton,1,F-DTM,33,1,0,0,1,15,18
20130118-W-Australian_Open-R32-Victoria_Azarenka-Jamie_Hampton,1,F-DTL,20,6,3,1,2,11,9
20130118-W-Australian_Open-R32-Victoria_Azarenka-Jamie_Hampton,1,F-IO,22,7,1,2,4,12,10
20130118-W-Australian_Open-R32-Victoria_Azarenka-Jamie_Hampton,1,B-XC,56,13,1,5,7,28,28
20130118-W-Australian_Open-R32-Victoria_Azarenka-Jamie_Hampton,1,B-DTM,60,3,0,1,2,28,32
20130118-W-Australian_Open-R32-Victoria_Azarenka-Jamie_Hampton,1,B-DTL,15,3,1,0,2,8,7
20130118-W-Australian_Open-R32-Victoria_Azarenka-Jamie_Hampton,1,B-IO,16,5,2,1,2,10,6
20130118-W-Australian_Open-R32-Victoria_Azarenka-Jamie_Hampton,1,S-XC,1,0,0,0,0,1,0
20130118-W-Australian_Open-R32-Victoria_Azarenka-Jamie_Hampton,1,S-DTM,7,0,0,0,0,0,7
20130118-W-Australian_Open-R32-Victoria_Azarenka-Jamie_Hampton,1,S-DTL,1,0,0,0,0,0,1
20130118-W-Australian_Open-R32-Victoria_Azarenka-Jamie_Hampton,1,S-IO,1,0,0,0,0,0,1
20130118-W-Australian_Open-R32-Victoria_Azarenka-Jamie_Hampton,2,F-XC,66,30,13,6,11,41,25
20130118-W-Australian_Open-R32-Victoria_Azarenka-Jamie_Hampton,2,F-DTM,46,8,0,0,8,18,28
20130118-W-Australian_Open-R32-Victoria_Azarenka-Jamie_Hampton,2,F-DTL,17,9,5,1,3,9,8
20130118-W-Australian_Open-R32-Victoria_Azarenka-Jamie_Hampton,2,F-IO,19,8,7,0,1,13,6
20130118-W-Australian_Open-R32-Victoria_Azarenka-Jamie_Hampton,2,B-XC,50,10,4,0,6,28,22
20130118-W-Australian_Open-R32-Victoria_Azarenka-Jamie_Hampton,2,B-DTM,42,5,0,1,4,19,23
20130118-W-Australian_Open-R32-Victoria_Azarenka-Jamie_Hampton,2,B-DTL,12,9,2,1,6,4,8
20130118-W-Australian_Open-R32-Victoria_Azarenka-Jamie_Hampton,2,B-IO,4,2,1,0,1,2,2
20130118-W-Australian_Open-R32-Victoria_Azarenka-Jamie_Hampton,2,S-XC,18,2,0,0,2,10,8
20130118-W-Australian_Open-R32-Victoria_Azarenka-Jamie_Hampton,2,S-DTM,12,1,0,0,1,5,7
20130118-W-Australian_Open-R32-Victoria_Azarenka-Jamie_Hampton,2,S-DTL,3,1,0,0,1,1,2
20130118-W-Australian_Open-R32-Victoria_Azarenka-Jamie_Hampton,2,S-IO,1,0,0,0,0,0,1
20130123-W-Australian_Open-QF-Svetlana_Kuznetsova-Victoria_Azarenka,1,F-XC,35,10,5,0,5,16,19
20130123-W-Australian_Open-QF-Svetlana_Kuznetsova-Victoria_Azarenka,1,F-DTM,20,2,0,0,2,7,13
20130123-W-Australian_Open-QF-Svetlana_Kuznetsova-Victoria_Azarenka,1,F-DTL,12,6,3,0,3,7,5
20130123-W-Australian_Open-QF-Svetlana_Kuznetsova-Victoria_Azarenka,1,F-IO,19,4,0,1,3,9,10
20130123-W-Australian_Open-QF-Svetlana_Kuznetsova-Victoria_Azarenka,1,B-XC,29,7,1,2,4,15,14
20130123-W-Australian_Open-QF-Svetlana_Kuznetsova-Victoria_Azarenka,1,B-DTM,35,4,0,0,4,12,23
20130123-W-Australian_Open-QF-Svetlana_Kuznetsova-Victoria_Azarenka,1,B-DTL,19,8,4,2,2,11,8
20130123-W-Australian_Open-QF-Svetlana_Kuznetsova-Victoria_Azarenka,1,B-IO,2,0,0,0,0,1,1
20130123-W-Australian_Open-QF-Svetlana_Kuznetsova-Victoria_Azarenka,1,S-XC,11,3,0,0,3,6,5
20130123-W-Australian_Open-QF-Svetlana_Kuznetsova-Victoria_Azarenka,1,S-DTM,14,2,0,0,2,3,11
20130123-W-Australian_Open-QF-Svetlana_Kuznetsova-Victoria_Azarenka,1,S-DTL,3,0,0,0,0,2,1
20130123-W-Australian_Open-QF-Svetlana_Kuznetsova-Victoria_Azarenka,1,S-IO,1,0,0,0,0,1,0
20130123-W-Australian_Open-QF-Svetlana_Kuznetsova-Victoria_Azarenka,2,F-XC,40,8,4,2,2,22,18
20130123-W-Australian_Open-QF-Svetlana_Kuznetsova-Victoria_Azarenka,2,F-DTM,22,2,0,0,2,12,10
20130123-W-Australian_Open-QF-Svetlana_Kuznetsova-Victoria_Azarenka,2,F-DTL,18,5,1,1,3,10,8
20130123-W-Australian_Open-QF-Svetlana_Kuznetsova-Victoria_Azarenka,2,F-IO,31,6,2,2,2,20,11
20130123-W-Australian_Open-QF-Svetlana_Kuznetsova-Victoria_Azarenka,2,B-XC,48,11,4,4,3,24,24
20130123-W-Australian_Open-QF-Svetlana_Kuznetsova-Victoria_Azarenka,2,B-DTM,25,3,0,0,3,11,14
20130123-W-Australian_Open-QF-Svetlana_Kuznetsova-Victoria_Azarenka,2,B-DTL,10,3,2,0,1,8,2
20130123-W-Australian_Open-QF-Svetlana_Kuznetsova-Victoria_Azarenka,2,B-IO,4,1,1,0,0,2,2
20130123-W-Australian_Open-QF-Svetlana_Kuznetsova-Victoria_Azarenka,2,S-XC,5,0,0,0,0,2,3
20130123-W-Australian_Open-QF-Svetlana_Kuznetsova-Victoria_Azarenka,2,S-DTM,3,2,0,0,2,0,3
20130123-W-Australian_Open-QF-Svetlana_Kuznetsova-Victoria_Azarenka,2,S-IO,1,0,0,0,0,1,0
20130123-W-Australian_Open-QF-Svetlana_Kuznetsova-Victoria_Azarenka,2,S-II,1,0,0,0,0,1,0
20130115-W-Australian_Open-R128-Victoria_Azarenka-Monica_Niculescu,1,F-XC,74,7,3,0,4,47,27
20130115-W-Australian_Open-R128-Victoria_Azarenka-Monica_Niculescu,1,F-DTM,25,0,0,0,0,15,10
20130115-W-Australian_Open-R128-Victoria_Azarenka-Monica_Niculescu,1,F-DTL,27,4,1,0,3,19,8
20130115-W-Australian_Open-R128-Victoria_Azarenka-Monica_Niculescu,1,F-IO,38,5,2,0,3,25,13
20130115-W-Australian_Open-R128-Victoria_Azarenka-Monica_Niculescu,1,F-II,1,1,1,0,0,1,0
20130115-W-Australian_Open-R128-Victoria_Azarenka-Monica_Niculescu,1,B-XC,54,11,4,1,6,33,21
20130115-W-Australian_Open-R128-Victoria_Azarenka-Monica_Niculescu,1,B-DTM,31,2,0,0,2,16,15
20130115-W-Australian_Open-R128-Victoria_Azarenka-Monica_Niculescu,1,B-DTL,9,1,1,0,0,4,5
20130115-W-Australian_Open-R128-Victoria_Azarenka-Monica_Niculescu,1,B-IO,16,3,0,2,1,12,4
20130115-W-Australian_Open-R128-Victoria_Azarenka-Monica_Niculescu,1,S-DTM,2,1,0,0,1,1,1
20130115-W-Australian_Open-R128-Victoria_Azarenka-Monica_Niculescu,2,F-XC,4,0,0,0,0,1,3
20130115-W-Australian_Open-R128-Victoria_Azarenka-Monica_Niculescu,2,F-DTM,5,1,0,0,1,0,5
20130115-W-Australian_Open-R128-Victoria_Azarenka-Monica_Niculescu,2,F-DTL,3,1,1,0,0,1,2
20130115-W-Australian_Open-R128-Victoria_Azarenka-Monica_Niculescu,2,F-IO,4,1,0,1,0,3,1
20130115-W-Australian_Open-R128-Victoria_Azarenka-Monica_Niculescu,2,B-XC,29,5,1,0,4,12,17
20130115-W-Australian_Open-R128-Victoria_Azarenka-Monica_Niculescu,2,B-DTM,78,6,0,0,6,23,55
20130115-W-Australian_Open-R128-Victoria_Azarenka-Monica_Niculescu,2,B-DTL,15,6,2,1,3,6,9
20130115-W-Australian_Open-R128-Victoria_Azarenka-Monica_Niculescu,2,B-IO,9,3,1,0,2,2,7
20130115-W-Australian_Open-R128-Victoria_Azarenka-Monica_Niculescu,2,S-XC,3,0,0,0,0,0,3
20130115-W-Australian_Open-R128-Victoria_Azarenka-Monica_Niculescu,2,S-DTM,6,0,0,0,0,2,4
20130115-W-Australian_Open-R128-Victoria_Azarenka-Monica_Niculescu,2,S-IO,1,0,0,0,0,0,1
20130124-W-Australian_Open-SF-Sloane_Stephens-Victoria_Azarenka,1,F-XC,35,9,1,1,7,10,25
20130124-W-Australian_Open-SF-Sloane_Stephens-Victoria_Azarenka,1,F-DTM,38,7,0,0,7,9,29
20130124-W-Australian_Open-SF-Sloane_Stephens-Victoria_Azarenka,1,F-DTL,6,3,2,0,1,2,4
20130124-W-Australian_Open-SF-Sloane_Stephens-Victoria_Azarenka,1,F-IO,20,8,5,1,2,10,10
20130124-W-Australian_Open-SF-Sloane_Stephens-Victoria_Azarenka,1,B-XC,49,12,1,2,9,17,32
20130124-W-Australian_Open-SF-Sloane_Stephens-Victoria_Azarenka,1,B-DTM,61,7,1,0,6,22,39
20130124-W-Australian_Open-SF-Sloane_Stephens-Victoria_Azarenka,1,B-DTL,14,7,1,1,5,5,9
20130124-W-Australian_Open-SF-Sloane_Stephens-Victoria_Azarenka,1,B-IO,5,1,0,1,0,2,3
20130124-W-Australian_Open-SF-Sloane_Stephens-Victoria_Azarenka,1,S-XC,8,0,0,0,0,4,4
20130124-W-Australian_Open-SF-Sloane_Stephens-Victoria_Azarenka,1,S-DTM,8,1,0,0,1,3,5
20130124-W-Australian_Open-SF-Sloane_Stephens-Victoria_Azarenka,1,S-DTL,1,0,0,0,0,0,1
20130124-W-Australian_Open-SF-Sloane_Stephens-Victoria_Azarenka,1,S-IO,1,0,0,0,0,0,1
20130124-W-Australian_Open-SF-Sloane_Stephens-Victoria_Azarenka,2,F-XC,36,10,4,1,5,28,8
20130124-W-Australian_Open-SF-Sloane_Stephens-Victoria_Azarenka,2,F-DTM,23,2,0,0,2,12,11
20130124-W-Australian_Open-SF-Sloane_Stephens-Victoria_Azarenka,2,F-DTL,17,3,2,1,0,13,4
20130124-W-Australian_Open-SF-Sloane_Stephens-Victoria_Azarenka,2,F-IO,40,7,1,1,5,21,19
20130124-W-Australian_Open-SF-Sloane_Stephens-Victoria_Azarenka,2,B-XC,53,6,3,0,3,32,21
20130124-W-Australian_Open-SF-Sloane_Stephens-Victoria_Azarenka,2,B-DTM,36,1,0,0,1,27,9
20130124-W-Australian_Open-SF-Sloane_Stephens-Victoria_Azarenka,2,B-DTL,5,2,0,0,2,1,4
20130124-W-Australian_Open-SF-Sloane_Stephens-Victoria_Azarenka,2,B-IO,12,4,2,0,2,5,7
20130124-W-Australian_Open-SF-Sloane_Stephens-Victoria_Azarenka,2,S-XC,4,0,0,0,0,2,2
20130124-W-Australian_Open-SF-Sloane_Stephens-Victoria_Azarenka,2,S-DTM,1,0,0,0,0,0,1
20130124-W-Australian_Open-SF-Sloane_Stephens-Victoria_Azarenka,2,S-DTL,1,0,0,0,0,0,1
20130120-W-Australian_Open-R16-Elena_Vesnina-Victoria_Azarenka,1,F-XC,15,4,1,0,3,6,9
20130120-W-Australian_Open-R16-Elena_Vesnina-Victoria_Azarenka,1,F-DTM,12,3,0,0,3,5,7
20130120-W-Australian_Open-R16-Elena_Vesnina-Victoria_Azarenka,1,F-DTL,3,1,1,0,0,1,2
20130120-W-Australian_Open-R16-Elena_Vesnina-Victoria_Azarenka,1,F-IO,3,2,0,0,2,1,2
20130120-W-Australian_Open-R16-Elena_Vesnina-Victoria_Azarenka,1,F-II,1,1,0,0,1,0,1
20130120-W-Australian_Open-R16-Elena_Vesnina-Victoria_Azarenka,1,B-XC,7,3,1,1,1,2,5
20130120-W-Australian_Open-R16-Elena_Vesnina-Victoria_Azarenka,1,B-DTM,21,7,0,0,7,5,16
20130120-W-Australian_Open-R16-Elena_Vesnina-Victoria_Azarenka,1,B-DTL,4,3,1,0,2,2,2
20130120-W-Australian_Open-R16-Elena_Vesnina-Victoria_Azarenka,1,B-IO,3,3,2,0,1,2,1
20130120-W-Australian_Open-R16-Elena_Vesnina-Victoria_Azarenka,1,S-XC,1,0,0,0,0,1,0
20130120-W-Australian_Open-R16-Elena_Vesnina-Victoria_Azarenka,1,S-DTM,2,0,0,0,0,1,1
20130120-W-Australian_Open-R16-Elena_Vesnina-Victoria_Azarenka,2,F-XC,14,8,6,1,1,11,3
20130120-W-Australian_Open-R16-Elena_Vesnina-Victoria_Azarenka,2,F-DTM,13,0,0,0,0,6,7
20130120-W-Australian_Open-R16-Elena_Vesnina-Victoria_Azarenka,2,F-DTL,3,1,0,0,1,1,2
20130120-W-Australian_Open-R16-Elena_Vesnina-Victoria_Azarenka,2,F-IO,5,3,2,0,1,3,2
20130120-W-Australian_Open-R16-Elena_Vesnina-Victoria_Azarenka,2,B-XC,11,5,2,2,1,8,3
20130120-W-Australian_Open-R16-Elena_Vesnina-Victoria_Azarenka,2,B-DTM,17,1,0,0,1,10,7
20130120-W-Australian_Open-R16-Elena_Vesnina-Victoria_Azarenka,2,B-DTL,1,1,0,1,0,1,0
20130120-W-Australian_Open-R16-Elena_Vesnina-Victoria_Azarenka,2,B-IO,2,2,0,0,2,0,2
20130120-W-Australian_Open-R16-Elena_Vesnina-Victoria_Azarenka,2,S-DTM,1,0,0,0,0,1,0
20140104-W-Brisbane-F-Victoria_Azarenka-Serena_Williams,1,F-XC,19,4,2,0,2,7,12
20140104-W-Brisbane-F-Victoria_Azarenka-Serena_Williams,1,F-DTM,24,7,0,0,7,9,15
20140104-W-Brisbane-F-Victoria_Azarenka-Serena_Williams,1,F-DTL,11,1,0,0,1,4,7
20140104-W-Brisbane-F-Victoria_Azarenka-Serena_Williams,1,F-IO,16,3,1,0,2,5,11
20140104-W-Brisbane-F-Victoria_Azarenka-Serena_Williams,1,B-XC,15,3,1,2,0,12,3
20140104-W-Brisbane-F-Victoria_Azarenka-Serena_Williams,1,B-DTM,24,2,0,0,2,10,14
20140104-W-Brisbane-F-Victoria_Azarenka-Serena_Williams,1,B-DTL,10,2,0,1,1,3,7
20140104-W-Brisbane-F-Victoria_Azarenka-Serena_Williams,1,B-IO,8,2,1,1,0,6,2
20140104-W-Brisbane-F-Victoria_Azarenka-Serena_Williams,1,S-XC,2,0,0,0,0,1,1
20140104-W-Brisbane-F-Victoria_Azarenka-Serena_Williams,1,S-DTM,4,0,0,0,0,2,2
20140104-W-Brisbane-F-Victoria_Azarenka-Serena_Williams,2,F-XC,22,9,3,1,5,10,12
20140104-W-Brisbane-F-Victoria_Azarenka-Serena_Williams,2,F-DTM,22,1,0,0,1,11,11
20140104-W-Brisbane-F-Victoria_Azarenka-Serena_Williams,2,F-DTL,4,2,1,1,0,4,0
20140104-W-Brisbane-F-Victoria_Azarenka-Serena_Williams,2,F-IO,5,2,2,0,0,4,1
20140104-W-Brisbane-F-Victoria_Azarenka-Serena_Williams,2,B-XC,25,9,4,0,5,13,12
20140104-W-Brisbane-F-Victoria_Azarenka-Serena_Williams,2,B-DTM,23,1,0,0,1,8,15
20140104-W-Brisbane-F-Victoria_Azarenka-Serena_Williams,2,B-DTL,13,5,1,2,2,10,3
20140104-W-Brisbane-F-Victoria_Azarenka-Serena_Williams,2,B-IO,13,3,0,0,3,9,4
20140104-W-Brisbane-F-Victoria_Azarenka-Serena_Williams,2,S-DTM,1,0,0,0,0,0,1
20140104-W-Brisbane-F-Victoria_Azarenka-Serena_Williams,2,S-IO,1,0,0,0,0,0,1
20130407-W-Charleston-F-Serena_Williams-Jelena_Jankovic,1,F-XC,34,3,3,0,0,24,10
20130407-W-Charleston-F-Serena_Williams-Jelena_Jankovic,1,F-DTM,15,2,0,0,2,8,7
20130407-W-Charleston-F-Serena_Williams-Jelena_Jankovic,1,F-DTL,9,2,2,0,0,5,4
20130407-W-Charleston-F-Serena_Williams-Jelena_Jankovic,1,F-IO,11,7,3,2,2,9,2
20130407-W-Charleston-F-Serena_Williams-Jelena_Jankovic,1,F-II,1,0,0,0,0,1,0
20130407-W-Charleston-F-Serena_Williams-Jelena_Jankovic,1,B-XC,57,20,8,4,8,31,26
20130407-W-Charleston-F-Serena_Williams-Jelena_Jankovic,1,B-DTM,26,2,1,0,1,16,10
20130407-W-Charleston-F-Serena_Williams-Jelena_Jankovic,1,B-DTL,29,13,5,3,5,17,12
20130407-W-Charleston-F-Serena_Williams-Jelena_Jankovic,1,B-IO,21,10,6,1,3,13,8
20130407-W-Charleston-F-Serena_Williams-Jelena_Jankovic,1,S-XC,6,0,0,0,0,4,2
20130407-W-Charleston-F-Serena_Williams-Jelena_Jankovic,1,S-DTM,2,0,0,0,0,1,1
20130407-W-Charleston-F-Serena_Williams-Jelena_Jankovic,2,F-XC,24,2,0,0,2,6,18
20130407-W-Charleston-F-Serena_Williams-Jelena_Jankovic,2,F-DTM,14,0,0,0,0,4,10
20130407-W-Charleston-F-Serena_Williams-Jelena_Jankovic,2,F-DTL,36,7,1,2,4,15,21
20130407-W-Charleston-F-Serena_Williams-Jelena_Jankovic,2,F-IO,28,5,1,0,4,14,14
20130407-W-Charleston-F-Serena_Williams-Jelena_Jankovic,2,B-XC,36,11,4,1,6,14,22
20130407-W-Charleston-F-Serena_Williams-Jelena_Jankovic,2,B-DTM,18,1,1,0,0,9,9
20130407-W-Charleston-F-Serena_Williams-Jelena_Jankovic,2,B-DTL,19,6,1,4,1,12,7
20130407-W-Charleston-F-Serena_Williams-Jelena_Jankovic,2,B-IO,14,3,1,1,1,4,10
20130407-W-Charleston-F-Serena_Williams-Jelena_Jankovic,2,B-II,1,1,1,0,0,1,0
20130407-W-Charleston-F-Serena_Williams-Jelena_Jankovic,2,S-XC,3,0,0,0,0,2,1
20130407-W-Charleston-F-Serena_Williams-Jelena_Jankovic,2,S-DTM,1,0,0,0,0,1,0
20130407-W-Charleston-F-Serena_Williams-Jelena_Jankovic,2,S-DTL,2,0,0,0,0,1,1
20130816-W-Cincinnati-QF-Magdalena_Rybarikova-Victoria_Azarenka,1,F-XC,22,6,4,0,2,7,15
20130816-W-Cincinnati-QF-Magdalena_Rybarikova-Victoria_Azarenka,1,F-DTM,21,2,0,0,2,5,16
20130816-W-Cincinnati-QF-Magdalena_Rybarikova-Victoria_Azarenka,1,F-DTL,15,4,1,0,3,6,9
20130816-W-Cincinnati-QF-Magdalena_Rybarikova-Victoria_Azarenka,1,F-IO,15,6,1,0,5,5,10
20130816-W-Cincinnati-QF-Magdalena_Rybarikova-Victoria_Azarenka,1,F-II,2,1,0,0,1,0,2
20130816-W-Cincinnati-QF-Magdalena_Rybarikova-Victoria_Azarenka,1,B-XC,21,3,0,0,3,4,17
20130816-W-Cincinnati-QF-Magdalena_Rybarikova-Victoria_Azarenka,1,B-DTM,21,2,1,0,1,6,15
20130816-W-Cincinnati-QF-Magdalena_Rybarikova-Victoria_Azarenka,1,B-DTL,13,2,2,0,0,5,8
20130816-W-Cincinnati-QF-Magdalena_Rybarikova-Victoria_Azarenka,1,B-IO,6,0,0,0,0,5,1
20130816-W-Cincinnati-QF-Magdalena_Rybarikova-Victoria_Azarenka,1,S-XC,15,0,0,0,0,6,9
20130816-W-Cincinnati-QF-Magdalena_Rybarikova-Victoria_Azarenka,1,S-DTM,16,3,0,0,3,5,11
20130816-W-Cincinnati-QF-Magdalena_Rybarikova-Victoria_Azarenka,1,S-DTL,4,1,0,1,0,1,3
20130816-W-Cincinnati-QF-Magdalena_Rybarikova-Victoria_Azarenka,1,S-IO,4,2,0,0,2,1,3
20130816-W-Cincinnati-QF-Magdalena_Rybarikova-Victoria_Azarenka,2,F-XC,29,7,2,0,5,19,10
20130816-W-Cincinnati-QF-Magdalena_Rybarikova-Victoria_Azarenka,2,F-DTM,17,0,0,0,0,13,4
20130816-W-Cincinnati-QF-Magdalena_Rybarikova-Victoria_Azarenka,2,F-DTL,12,0,0,0,0,9,3
20130816-W-Cincinnati-QF-Magdalena_Rybarikova-Victoria_Azarenka,2,F-IO,29,5,2,1,2,18,11
20130816-W-Cincinnati-QF-Magdalena_Rybarikova-Victoria_Azarenka,2,F-II,1,1,1,0,0,1,0
20130816-W-Cincinnati-QF-Magdalena_Rybarikova-Victoria_Azarenka,2,B-XC,47,9,2,1,6,27,20
20130816-W-Cincinnati-QF-Magdalena_Rybarikova-Victoria_Azarenka,2,B-DTM,24,1,0,0,1,14,10
20130816-W-Cincinnati-QF-Magdalena_Rybarikova-Victoria_Azarenka,2,B-DTL,11,3,2,1,0,8,3
20130816-W-Cincinnati-QF-Magdalena_Rybarikova-Victoria_Azarenka,2,B-IO,7,1,0,0,1,4,3
20130816-W-Cincinnati-QF-Magdalena_Rybarikova-Victoria_Azarenka,2,S-XC,1,0,0,0,0,1,0
20130816-W-Cincinnati-QF-Magdalena_Rybarikova-Victoria_Azarenka,2,S-DTM,2,1,0,0,1,1,1
20130816-W-Cincinnati-QF-Magdalena_Rybarikova-Victoria_Azarenka,2,S-DTL,1,0,0,0,0,0,1
20130816-W-Cincinnati-QF-Magdalena_Rybarikova-Victoria_Azarenka,2,S-IO,1,0,0,0,0,0,1
20130818-W-Cincinnati-F-Victoria_Azarenka-Serena_Williams,1,F-XC,34,10,4,3,3,19,15
20130818-W-Cincinnati-F-Victoria_Azarenka-Serena_Williams,1,F-DTM,38,7,0,0,7,14,24
20130818-W-Cincinnati-F-Victoria_Azarenka-Serena_Williams,1,F-DTL,13,2,1,0,1,6,7
20130818-W-Cincinnati-F-Victoria_Azarenka-Serena_Williams,1,F-IO,22,5,1,3,1,17,5
20130818-W-Cincinnati-F-Victoria_Azarenka-Serena_Williams,1,B-XC,21,8,1,1,6,8,13
20130818-W-Cincinnati-F-Victoria_Azarenka-Serena_Williams,1,B-DTM,57,6,0,1,5,27,30
20130818-W-Cincinnati-F-Victoria_Azarenka-Serena_Williams,1,B-DTL,9,3,1,0,2,3,6
20130818-W-Cincinnati-F-Victoria_Azarenka-Serena_Williams,1,B-IO,12,3,1,1,1,7,5
20130818-W-Cincinnati-F-Victoria_Azarenka-Serena_Williams,1,S-DTM,5,0,0,0,0,0,5
20130818-W-Cincinnati-F-Victoria_Azarenka-Serena_Williams,1,S-DTL,1,0,0,0,0,0,1
20130818-W-Cincinnati-F-Victoria_Azarenka-Serena_Williams,2,F-XC,46,23,11,4,8,28,18
20130818-W-Cincinnati-F-Victoria_Azarenka-Serena_Williams,2,F-DTM,46,10,0,0,10,16,30
20130818-W-Cincinnati-F-Victoria_Azarenka-Serena_Williams,2,F-DTL,13,5,2,1,2,10,3
20130818-W-Cincinnati-F-Victoria_Azarenka-Serena_Williams,2,F-IO,15,7,2,0,5,7,8
20130818-W-Cincinnati-F-Victoria_Azarenka-Serena_Williams,2,F-II,1,0,0,0,0,0,1
20130818-W-Cincinnati-F-Victoria_Azarenka-Serena_Williams,2,B-XC,33,13,6,3,4,23,10
20130818-W-Cincinnati-F-Victoria_Azarenka-Serena_Williams,2,B-DTM,64,15,2,0,13,19,45
20130818-W-Cincinnati-F-Victoria_Azarenka-Serena_Williams,2,B-DTL,6,3,2,0,1,3,3
20130818-W-Cincinnati-F-Victoria_Azarenka-Serena_Williams,2,B-IO,11,4,0,2,2,6,5
20130818-W-Cincinnati-F-Victoria_Azarenka-Serena_Williams,2,S-XC,2,0,0,0,0,2,0
20130818-W-Cincinnati-F-Victoria_Azarenka-Serena_Williams,2,S-DTM,7,1,0,0,1,3,4
20130818-W-Cincinnati-F-Victoria_Azarenka-Serena_Williams,2,S-DTL,1,0,0,0,0,1,0
20140121-W-Dubai-QF-Serena_Williams-Jelena_Jankovic,1,F-XC,31,10,2,3,5,17,14
20140121-W-Dubai-QF-Serena_Williams-Jelena_Jankovic,1,F-DTM,14,1,0,0,1,6,8
20140121-W-Dubai-QF-Serena_Williams-Jelena_Jankovic,1,F-DTL,7,2,1,1,0,5,2
20140121-W-Dubai-QF-Serena_Williams-Jelena_Jankovic,1,F-IO,9,5,0,4,1,7,2
20140121-W-Dubai-QF-Serena_Williams-Jelena_Jankovic,1,B-XC,12,3,2,1,0,9,3
20140121-W-Dubai-QF-Serena_Williams-Jelena_Jankovic,1,B-DTM,28,6,1,1,4,17,11
20140121-W-Dubai-QF-Serena_Williams-Jelena_Jankovic,1,B-DTL,11,8,4,2,2,8,3
20140121-W-Dubai-QF-Serena_Williams-Jelena_Jankovic,1,B-IO,6,1,0,0,1,3,3
20140121-W-Dubai-QF-Serena_Williams-Jelena_Jankovic,1,S-DTM,1,0,0,0,0,0,1
20140121-W-Dubai-QF-Serena_Williams-Jelena_Jankovic,1,S-IO,1,0,0,0,0,1,0
20140121-W-Dubai-QF-Serena_Williams-Jelena_Jankovic,2,F-XC,20,4,1,0,3,10,10
20140121-W-Dubai-QF-Serena_Williams-Jelena_Jankovic,2,F-DTM,22,3,1,0,2,5,17
20140121-W-Dubai-QF-Serena_Williams-Jelena_Jankovic,2,F-DTL,9,5,0,0,5,1,8
20140121-W-Dubai-QF-Serena_Williams-Jelena_Jankovic,2,F-IO,19,7,0,2,5,8,11
20140121-W-Dubai-QF-Serena_Williams-Jelena_Jankovic,2,B-XC,10,1,0,0,1,1,9
20140121-W-Dubai-QF-Serena_Williams-Jelena_Jankovic,2,B-DTM,24,4,0,2,2,9,15
20140121-W-Dubai-QF-Serena_Williams-Jelena_Jankovic,2,B-DTL,4,1,0,1,0,2,2
20140121-W-Dubai-QF-Serena_Williams-Jelena_Jankovic,2,B-IO,18,3,2,0,1,10,8
20140121-W-Dubai-QF-Serena_Williams-Jelena_Jankovic,2,B-II,1,0,0,0,0,0,1
20140121-W-Dubai-QF-Serena_Williams-Jelena_Jankovic,2,S-DTM,1,0,0,0,0,1,0
20140121-W-Dubai-QF-Serena_Williams-Jelena_Jankovic,2,S-IO,1,0,0,0,0,1,0
20140309-W-Indian_Wells-R32-Eugenie_Bouchard-Sara_Errani,1,F-XC,37,13,10,0,3,28,9
20140309-W-Indian_Wells-R32-Eugenie_Bouchard-Sara_Errani,1,F-DTM,16,4,0,2,2,9,7
20140309-W-Indian_Wells-R32-Eugenie_Bouchard-Sara_Errani,1,F-DTL,4,1,1,0,0,4,0
20140309-W-Indian_Wells-R32-Eugenie_Bouchard-Sara_Errani,1,F-IO,15,5,2,0,3,7,8
20140309-W-Indian_Wells-R32-Eugenie_Bouchard-Sara_Errani,1,B-XC,34,8,3,2,2,18,16
20140309-W-Indian_Wells-R32-Eugenie_Bouchard-Sara_Errani,1,B-DTM,31,6,0,1,5,16,15
20140309-W-Indian_Wells-R32-Eugenie_Bouchard-Sara_Errani,1,B-DTL,4,3,3,0,0,4,0
20140309-W-Indian_Wells-R32-Eugenie_Bouchard-Sara_Errani,1,B-IO,5,3,2,0,1,3,2
20140309-W-Indian_Wells-R32-Eugenie_Bouchard-Sara_Errani,1,S-XC,1,0,0,0,0,1,0
20140309-W-Indian_Wells-R32-Eugenie_Bouchard-Sara_Errani,2,F-XC,25,6,2,2,2,10,15
20140309-W-Indian_Wells-R32-Eugenie_Bouchard-Sara_Errani,2,F-DTM,29,2,0,0,2,10,19
20140309-W-Indian_Wells-R32-Eugenie_Bouchard-Sara_Errani,2,F-DTL,5,1,0,1,0,2,3
20140309-W-Indian_Wells-R32-Eugenie_Bouchard-Sara_Errani,2,F-IO,5,1,0,0,1,3,2
20140309-W-Indian_Wells-R32-Eugenie_Bouchard-Sara_Errani,2,F-II,2,1,0,0,1,0,2
20140309-W-Indian_Wells-R32-Eugenie_Bouchard-Sara_Errani,2,B-XC,26,0,0,0,0,11,15
20140309-W-Indian_Wells-R32-Eugenie_Bouchard-Sara_Errani,2,B-DTM,40,5,0,1,4,21,19
20140309-W-Indian_Wells-R32-Eugenie_Bouchard-Sara_Errani,2,B-DTL,2,2,2,0,0,2,0
20140309-W-Indian_Wells-R32-Eugenie_Bouchard-Sara_Errani,2,S-DTM,5,0,0,0,0,2,3
20140405-W-Monterrey-SF-Caroline_Wozniacki-Ana_Ivanovic,1,F-XC,39,6,1,2,3,22,17
20140405-W-Monterrey-SF-Caroline_Wozniacki-Ana_Ivanovic,1,F-DTM,24,0,0,0,0,11,13
20140405-W-Monterrey-SF-Caroline_Wozniacki-Ana_Ivanovic,1,F-DTL,24,1,0,1,0,9,15
20140405-W-Monterrey-SF-Caroline_Wozniacki-Ana_Ivanovic,1,F-IO,17,9,2,1,6,7,10
20140405-W-Monterrey-SF-Caroline_Wozniacki-Ana_Ivanovic,1,F-II,1,1,0,0,1,0,1
20140405-W-Monterrey-SF-Caroline_Wozniacki-Ana_Ivanovic,1,B-XC,43,7,1,2,4,19,24
20140405-W-Monterrey-SF-Caroline_Wozniacki-Ana_Ivanovic,1,B-DTM,25,1,0,0,1,14,11
20140405-W-Monterrey-SF-Caroline_Wozniacki-Ana_Ivanovic,1,B-DTL,11,6,1,1,4,3,8
20140405-W-Monterrey-SF-Caroline_Wozniacki-Ana_Ivanovic,1,B-IO,12,6,1,3,2,7,5
20140405-W-Monterrey-SF-Caroline_Wozniacki-Ana_Ivanovic,1,S-XC,3,0,0,0,0,1,2
20140405-W-Monterrey-SF-Caroline_Wozniacki-Ana_Ivanovic,1,S-DTM,3,0,0,0,0,1,2
20140405-W-Monterrey-SF-Caroline_Wozniacki-Ana_Ivanovic,2,F-XC,63,22,7,3,12,31,32
20140405-W-Monterrey-SF-Caroline_Wozniacki-Ana_Ivanovic,2,F-DTM,19,2,0,0,2,8,11
20140405-W-Monterrey-SF-Caroline_Wozniacki-Ana_Ivanovic,2,F-DTL,12,8,4,0,4,6,6
20140405-W-Monterrey-SF-Caroline_Wozniacki-Ana_Ivanovic,2,F-IO,28,11,6,2,3,18,10
20140405-W-Monterrey-SF-Caroline_Wozniacki-Ana_Ivanovic,2,F-II,6,4,1,1,2,3,3
20140405-W-Monterrey-SF-Caroline_Wozniacki-Ana_Ivanovic,2,B-XC,32,8,1,4,3,20,12
20140405-W-Monterrey-SF-Caroline_Wozniacki-Ana_Ivanovic,2,B-DTM,30,3,0,0,3,11,19
20140405-W-Monterrey-SF-Caroline_Wozniacki-Ana_Ivanovic,2,B-DTL,16,3,0,0,3,5,11
20140405-W-Monterrey-SF-Caroline_Wozniacki-Ana_Ivanovic,2,B-IO,2,1,0,0,1,1,1
20140405-W-Monterrey-SF-Caroline_Wozniacki-Ana_Ivanovic,2,S-XC,2,0,0,0,0,1,1
20140405-W-Monterrey-SF-Caroline_Wozniacki-Ana_Ivanovic,2,S-DTL,4,0,0,0,0,3,1
20140528-W-Roland_Garros-R64-Dominika_Cibulkova-Tamira_Paszek,1,F-XC,34,8,3,2,3,25,9
20140528-W-Roland_Garros-R64-Dominika_Cibulkova-Tamira_Paszek,1,F-DTM,13,0,0,0,0,6,7
20140528-W-Roland_Garros-R64-Dominika_Cibulkova-Tamira_Paszek,1,F-DTL,13,3,3,0,0,10,3
20140528-W-Roland_Garros-R64-Dominika_Cibulkova-Tamira_Paszek,1,F-IO,37,13,6,1,6,23,14
20140528-W-Roland_Garros-R64-Dominika_Cibulkova-Tamira_Paszek,1,B-XC,33,7,1,0,6,22,11
20140528-W-Roland_Garros-R64-Dominika_Cibulkova-Tamira_Paszek,1,B-DTM,19,3,1,0,2,9,10
20140528-W-Roland_Garros-R64-Dominika_Cibulkova-Tamira_Paszek,1,B-DTL,10,2,1,0,1,8,2
20140528-W-Roland_Garros-R64-Dominika_Cibulkova-Tamira_Paszek,1,B-IO,5,1,0,0,1,4,1
20140528-W-Roland_Garros-R64-Dominika_Cibulkova-Tamira_Paszek,1,S-XC,5,1,0,0,1,2,3
20140528-W-Roland_Garros-R64-Dominika_Cibulkova-Tamira_Paszek,1,S-DTM,11,2,0,0,2,6,5
20140528-W-Roland_Garros-R64-Dominika_Cibulkova-Tamira_Paszek,2,F-XC,32,6,1,1,4,10,22
20140528-W-Roland_Garros-R64-Dominika_Cibulkova-Tamira_Paszek,2,F-DTM,14,3,0,0,3,5,9
20140528-W-Roland_Garros-R64-Dominika_Cibulkova-Tamira_Paszek,2,F-DTL,11,4,2,0,2,4,7
20140528-W-Roland_Garros-R64-Dominika_Cibulkova-Tamira_Paszek,2,F-IO,13,3,0,1,2,6,7
20140528-W-Roland_Garros-R64-Dominika_Cibulkova-Tamira_Paszek,2,B-XC,48,6,1,1,4,19,29
20140528-W-Roland_Garros-R64-Dominika_Cibulkova-Tamira_Paszek,2,B-DTM,17,1,0,0,1,2,15
20140528-W-Roland_Garros-R64-Dominika_Cibulkova-Tamira_Paszek,2,B-DTL,13,6,2,1,3,4,9
20140528-W-Roland_Garros-R64-Dominika_Cibulkova-Tamira_Paszek,2,B-IO,6,5,2,1,2,3,3
20140528-W-Roland_Garros-R64-Dominika_Cibulkova-Tamira_Paszek,2,S-XC,5,0,0,0,0,2,3
20140528-W-Roland_Garros-R64-Dominika_Cibulkova-Tamira_Paszek,2,S-DTM,6,0,0,0,0,1,5
20140528-W-Roland_Garros-R64-Dominika_Cibulkova-Tamira_Paszek,2,S-DTL,6,2,0,0,2,2,4
20140528-W-Roland_Garros-R64-Dominika_Cibulkova-Tamira_Paszek,2,S-IO,4,2,0,1,1,2,2
20140528-W-Roland_Garros-R64-Serena_Williams-Garbine_Muguruza,1,F-XC,26,7,2,2,3,12,14
20140528-W-Roland_Garros-R64-Serena_Williams-Garbine_Muguruza,1,F-DTM,10,2,1,1,0,4,6
20140528-W-Roland_Garros-R64-Serena_Williams-Garbine_Muguruza,1,F-DTL,7,0,0,0,0,4,3
20140528-W-Roland_Garros-R64-Serena_Williams-Garbine_Muguruza,1,F-IO,11,5,1,0,4,1,10
20140528-W-Roland_Garros-R64-Serena_Williams-Garbine_Muguruza,1,F-II,1,0,0,0,0,1,0
20140528-W-Roland_Garros-R64-Serena_Williams-Garbine_Muguruza,1,B-XC,16,3,0,0,3,4,12
20140528-W-Roland_Garros-R64-Serena_Williams-Garbine_Muguruza,1,B-DTM,23,2,0,0,2,8,15
20140528-W-Roland_Garros-R64-Serena_Williams-Garbine_Muguruza,1,B-DTL,4,3,1,0,2,1,3
20140528-W-Roland_Garros-R64-Serena_Williams-Garbine_Muguruza,1,B-IO,8,2,0,0,2,3,5
20140528-W-Roland_Garros-R64-Serena_Williams-Garbine_Muguruza,1,S-DTM,3,0,0,0,0,0,3
20140528-W-Roland_Garros-R64-Serena_Williams-Garbine_Muguruza,1,S-IO,1,0,0,0,0,1,0
20140528-W-Roland_Garros-R64-Serena_Williams-Garbine_Muguruza,2,F-XC,27,4,1,1,2,16,11
20140528-W-Roland_Garros-R64-Serena_Williams-Garbine_Muguruza,2,F-DTM,21,6,0,1,5,11,10
20140528-W-Roland_Garros-R64-Serena_Williams-Garbine_Muguruza,2,F-DTL,8,6,1,1,4,4,4
20140528-W-Roland_Garros-R64-Serena_Williams-Garbine_Muguruza,2,F-IO,5,1,0,0,1,4,1
20140528-W-Roland_Garros-R64-Serena_Williams-Garbine_Muguruza,2,B-XC,21,8,3,2,3,14,7
20140528-W-Roland_Garros-R64-Serena_Williams-Garbine_Muguruza,2,B-DTM,27,5,0,2,3,17,10
20140528-W-Roland_Garros-R64-Serena_Williams-Garbine_Muguruza,2,B-DTL,3,2,1,0,1,2,1
20140528-W-Roland_Garros-R64-Serena_Williams-Garbine_Muguruza,2,B-IO,2,0,0,0,0,1,1
20140110-W-Sydney-F-Tsvetana_Pironkova-Angelique_Kerber,1,F-XC,59,6,1,1,4,25,34
20140110-W-Sydney-F-Tsvetana_Pironkova-Angelique_Kerber,1,F-DTM,46,8,0,1,7,17,29
20140110-W-Sydney-F-Tsvetana_Pironkova-Angelique_Kerber,1,F-DTL,17,5,3,1,1,7,10
20140110-W-Sydney-F-Tsvetana_Pironkova-Angelique_Kerber,1,F-IO,13,6,2,4,0,10,3
20140110-W-Sydney-F-Tsvetana_Pironkova-Angelique_Kerber,1,B-XC,28,11,7,2,2,20,8
20140110-W-Sydney-F-Tsvetana_Pironkova-Angelique_Kerber,1,B-DTM,22,2,0,1,1,7,15
20140110-W-Sydney-F-Tsvetana_Pironkova-Angelique_Kerber,1,B-DTL,25,10,4,2,4,16,9
20140110-W-Sydney-F-Tsvetana_Pironkova-Angelique_Kerber,1,B-IO,18,6,4,0,2,10,8
20140110-W-Sydney-F-Tsvetana_Pironkova-Angelique_Kerber,1,S-DTM,2,0,0,0,0,0,2
20140110-W-Sydney-F-Tsvetana_Pironkova-Angelique_Kerber,1,S-DTL,4,1,0,1,0,2,2
20140110-W-Sydney-F-Tsvetana_Pironkova-Angelique_Kerber,2,F-XC,35,4,0,1,3,15,20
20140110-W-Sydney-F-Tsvetana_Pironkova-Angelique_Kerber,2,F-DTM,14,0,0,0,0,8,6
20140110-W-Sydney-F-Tsvetana_Pironkova-Angelique_Kerber,2,F-DTL,16,8,4,1,3,8,8
20140110-W-Sydney-F-Tsvetana_Pironkova-Angelique_Kerber,2,F-IO,22,9,4,1,4,14,8
20140110-W-Sydney-F-Tsvetana_Pironkova-Angelique_Kerber,2,B-XC,68,15,5,5,5,42,26
20140110-W-Sydney-F-Tsvetana_Pironkova-Angelique_Kerber,2,B-DTM,38,4,0,1,3,18,20
20140110-W-Sydney-F-Tsvetana_Pironkova-Angelique_Kerber,2,B-DTL,19,9,5,2,2,11,8
20140110-W-Sydney-F-Tsvetana_Pironkova-Angelique_Kerber,2,B-IO,16,2,0,2,0,11,5
20140110-W-Sydney-F-Tsvetana_Pironkova-Angelique_Kerber,2,S-XC,1,0,0,0,0,0,1
20140110-W-Sydney-F-Tsvetana_Pironkova-Angelique_Kerber,2,S-DTM,8,0,0,0,0,2,6
20140110-W-Sydney-F-Tsvetana_Pironkova-Angelique_Kerber,2,S-DTL,1,0,0,0,0,0,1
20140110-W-Sydney-F-Tsvetana_Pironkova-Angelique_Kerber,2,S-IO,1,1,0,1,0,1,0
20130112-W-Beijing-R16-Agnieszka_Radwanska-Polona_Hercog,1,F-XC,26,2,1,0,1,12,14
20130112-W-Beijing-R16-Agnieszka_Radwanska-Polona_Hercog,1,F-DTM,20,1,0,0,1,8,12
20130112-W-Beijing-R16-Agnieszka_Radwanska-Polona_Hercog,1,F-DTL,14,4,1,0,3,6,8
20130112-W-Beijing-R16-Agnieszka_Radwanska-Polona_Hercog,1,F-IO,15,2,1,1,0,8,7
20130112-W-Beijing-R16-Agnieszka_Radwanska-Polona_Hercog,1,B-XC,19,2,1,1,0,12,7
20130112-W-Beijing-R16-Agnieszka_Radwanska-Polona_Hercog,1,B-DTM,8,1,0,0,1,5,3
20130112-W-Beijing-R16-Agnieszka_Radwanska-Polona_Hercog,1,B-DTL,12,4,1,1,2,6,6
20130112-W-Beijing-R16-Agnieszka_Radwanska-Polona_Hercog,1,B-IO,4,0,0,0,0,2,2
20130112-W-Beijing-R16-Agnieszka_Radwanska-Polona_Hercog,1,S-XC,7,2,1,0,1,4,3
20130112-W-Beijing-R16-Agnieszka_Radwanska-Polona_Hercog,1,S-DTM,5,0,0,0,0,3,2
20130112-W-Beijing-R16-Agnieszka_Radwanska-Polona_Hercog,1,S-DTL,2,0,0,0,0,2,0
20130112-W-Beijing-R16-Agnieszka_Radwanska-Polona_Hercog,1,S-IO,1,0,0,0,0,0,1
20130112-W-Beijing-R16-Agnieszka_Radwanska-Polona_Hercog,1,S-II,1,0,0,0,0,0,1
20130112-W-Beijing-R16-Agnieszka_Radwanska-Polona_Hercog,2,F-XC,43,12,1,2,9,24,19
20130112-W-Beijing-R16-Agnieszka_Radwanska-Polona_Hercog,2,F-DTM,15,5,0,0,5,5,10
20130112-W-Beijing-R16-Agnieszka_Radwanska-Polona_Hercog,2,F-DTL,7,3,2,0,1,4,3
20130112-W-Beijing-R16-Agnieszka_Radwanska-Polona_Hercog,2,F-IO,24,7,5,0,2,11,13
20130112-W-Beijing-R16-Agnieszka_Radwanska-Polona_Hercog,2,F-II,5,1,1,0,0,3,2
20130112-W-Beijing-R16-Agnieszka_Radwanska-Polona_Hercog,2,B-XC,7,2,1,0,1,2,5
20130112-W-Beijing-R16-Agnieszka_Radwanska-Polona_Hercog,2,B-DTM,7,1,0,0,1,2,5
20130112-W-Beijing-R16-Agnieszka_Radwanska-Polona_Hercog,2,B-DTL,1,1,0,0,1,0,1
20130112-W-Beijing-R16-Agnieszka_Radwanska-Polona_Hercog,2,S-XC,16,5,0,1,4,5,11
20130112-W-Beijing-R16-Agnieszka_Radwanska-Polona_Hercog,2,S-DTM,12,1,0,1,0,8,4
20130112-W-Beijing-R16-Agnieszka_Radwanska-Polona_Hercog,2,S-DTL,6,0,0,0,0,2,4
20070907-W-US_Open-SF-Venus_Williams-Justine_Henin,1,F-XC,49,9,5,0,4,27,22
20070907-W-US_Open-SF-Venus_Williams-Justine_Henin,1,F-DTM,28,4,0,0,4,8,20
20070907-W-US_Open-SF-Venus_Williams-Justine_Henin,1,F-DTL,9,3,1,0,2,4,5
20070907-W-US_Open-SF-Venus_Williams-Justine_Henin,1,F-IO,22,10,1,3,6,10,12
20070907-W-US_Open-SF-Venus_Williams-Justine_Henin,1,B-XC,42,7,1,5,1,24,18
20070907-W-US_Open-SF-Venus_Williams-Justine_Henin,1,B-DTM,30,2,0,0,2,12,18
20070907-W-US_Open-SF-Venus_Williams-Justine_Henin,1,B-DTL,13,4,1,0,3,6,7
20070907-W-US_Open-SF-Venus_Williams-Justine_Henin,1,B-IO,12,3,1,0,2,6,6
20070907-W-US_Open-SF-Venus_Williams-Justine_Henin,1,S-XC,5,0,0,0,0,2,3
20070907-W-US_Open-SF-Venus_Williams-Justine_Henin,1,S-DTM,2,1,0,0,1,0,2
20070907-W-US_Open-SF-Venus_Williams-Justine_Henin,1,S-DTL,4,0,0,0,0,0,4
20070907-W-US_Open-SF-Venus_Williams-Justine_Henin,2,F-XC,45,18,9,3,6,27,18
20070907-W-US_Open-SF-Venus_Williams-Justine_Henin,2,F-DTM,38,1,0,0,1,21,17
20070907-W-US_Open-SF-Venus_Williams-Justine_Henin,2,F-DTL,19,5,2,1,2,8,11
20070907-W-US_Open-SF-Venus_Williams-Justine_Henin,2,F-IO,18,3,2,0,1,13,5
20070907-W-US_Open-SF-Venus_Williams-Justine_Henin,2,B-XC,15,4,1,2,1,7,8
20070907-W-US_Open-SF-Venus_Williams-Justine_Henin,2,B-DTM,20,0,0,0,0,10,10
20070907-W-US_Open-SF-Venus_Williams-Justine_Henin,2,B-DTL,14,3,0,0,3,7,7
20070907-W-US_Open-SF-Venus_Williams-Justine_Henin,2,B-IO,5,2,0,0,2,2,3
20070907-W-US_Open-SF-Venus_Williams-Justine_Henin,2,S-XC,9,0,0,0,0,4,5
20070907-W-US_Open-SF-Venus_Williams-Justine_Henin,2,S-DTM,16,0,0,0,0,9,7
20070907-W-US_Open-SF-Venus_Williams-Justine_Henin,2,S-DTL,3,0,0,0,0,2,1
20140623-W-Wimbledon-R128-Petra_Kvitova-Andrea_Hlavackova,1,F-XC,31,15,2,5,8,17,14
20140623-W-Wimbledon-R128-Petra_Kvitova-Andrea_Hlavackova,1,F-DTM,7,2,0,0,2,4,3
20140623-W-Wimbledon-R128-Petra_Kvitova-Andrea_Hlavackova,1,F-DTL,11,10,5,1,4,7,4
20140623-W-Wimbledon-R128-Petra_Kvitova-Andrea_Hlavackova,1,F-IO,11,5,2,3,0,8,3
20140623-W-Wimbledon-R128-Petra_Kvitova-Andrea_Hlavackova,1,F-II,1,1,0,0,1,0,1
20140623-W-Wimbledon-R128-Petra_Kvitova-Andrea_Hlavackova,1,B-XC,4,4,2,1,1,3,1
20140623-W-Wimbledon-R128-Petra_Kvitova-Andrea_Hlavackova,1,B-DTM,5,3,1,1,1,3,2
20140623-W-Wimbledon-R128-Petra_Kvitova-Andrea_Hlavackova,1,B-DTL,2,1,1,0,0,1,1
20140623-W-Wimbledon-R128-Petra_Kvitova-Andrea_Hlavackova,1,B-IO,6,3,3,0,0,6,0
20140623-W-Wimbledon-R128-Petra_Kvitova-Andrea_Hlavackova,1,B-II,1,1,0,0,1,0,1
20140623-W-Wimbledon-R128-Petra_Kvitova-Andrea_Hlavackova,1,S-XC,1,0,0,0,0,0,1
20140623-W-Wimbledon-R128-Petra_Kvitova-Andrea_Hlavackova,1,S-DTM,2,0,0,0,0,1,1
20140623-W-Wimbledon-R128-Petra_Kvitova-Andrea_Hlavackova,1,S-DTL,2,0,0,0,0,2,0
20140623-W-Wimbledon-R128-Petra_Kvitova-Andrea_Hlavackova,1,S-IO,1,0,0,0,0,0,1
20140623-W-Wimbledon-R128-Petra_Kvitova-Andrea_Hlavackova,2,F-XC,11,3,3,0,0,8,3
20140623-W-Wimbledon-R128-Petra_Kvitova-Andrea_Hlavackova,2,F-DTM,7,2,1,1,0,3,4
20140623-W-Wimbledon-R128-Petra_Kvitova-Andrea_Hlavackova,2,F-DTL,5,3,2,1,0,4,1
20140623-W-Wimbledon-R128-Petra_Kvitova-Andrea_Hlavackova,2,F-IO,10,4,2,0,2,5,5
20140623-W-Wimbledon-R128-Petra_Kvitova-Andrea_Hlavackova,2,B-XC,15,1,1,0,0,6,9
20140623-W-Wimbledon-R128-Petra_Kvitova-Andrea_Hlavackova,2,B-DTM,11,2,0,0,2,4,7
20140623-W-Wimbledon-R128-Petra_Kvitova-Andrea_Hlavackova,2,B-DTL,4,1,0,0,1,0,4
20140623-W-Wimbledon-R128-Petra_Kvitova-Andrea_Hlavackova,2,S-XC,5,1,0,0,1,0,5
20140625-W-Wimbledon-R64-Mona_Barthel-Petra_Kvitova,1,F-XC,10,6,3,2,1,6,4
20140625-W-Wimbledon-R64-Mona_Barthel-Petra_Kvitova,1,F-DTM,8,2,0,0,2,3,5
20140625-W-Wimbledon-R64-Mona_Barthel-Petra_Kvitova,1,F-DTL,10,3,0,1,2,2,8
20140625-W-Wimbledon-R64-Mona_Barthel-Petra_Kvitova,1,F-IO,11,3,0,0,3,3,8
20140625-W-Wimbledon-R64-Mona_Barthel-Petra_Kvitova,1,F-II,1,1,0,0,1,0,1
20140625-W-Wimbledon-R64-Mona_Barthel-Petra_Kvitova,1,B-XC,7,5,3,1,1,4,3
20140625-W-Wimbledon-R64-Mona_Barthel-Petra_Kvitova,1,B-DTM,8,1,0,0,1,2,6
20140625-W-Wimbledon-R64-Mona_Barthel-Petra_Kvitova,1,B-DTL,4,2,0,0,2,0,4
20140625-W-Wimbledon-R64-Mona_Barthel-Petra_Kvitova,1,B-IO,4,0,0,0,0,1,3
20140625-W-Wimbledon-R64-Mona_Barthel-Petra_Kvitova,1,S-DTM,1,0,0,0,0,0,1
20140625-W-Wimbledon-R64-Mona_Barthel-Petra_Kvitova,2,F-XC,19,9,6,2,1,16,3
20140625-W-Wimbledon-R64-Mona_Barthel-Petra_Kvitova,2,F-DTM,10,1,0,1,0,5,5
20140625-W-Wimbledon-R64-Mona_Barthel-Petra_Kvitova,2,F-DTL,1,1,0,0,1,0,1
20140625-W-Wimbledon-R64-Mona_Barthel-Petra_Kvitova,2,F-IO,9,5,3,0,2,7,2
20140625-W-Wimbledon-R64-Mona_Barthel-Petra_Kvitova,2,B-XC,10,2,1,0,1,9,1
20140625-W-Wimbledon-R64-Mona_Barthel-Petra_Kvitova,2,B-DTM,5,0,0,0,0,2,3
20140625-W-Wimbledon-R64-Mona_Barthel-Petra_Kvitova,2,B-DTL,2,0,0,0,0,2,0
20140625-W-Wimbledon-R64-Mona_Barthel-Petra_Kvitova,2,B-II,1,0,0,0,0,0,1
20140625-W-Wimbledon-R64-Mona_Barthel-Petra_Kvitova,2,S-XC,2,1,0,0,1,1,1
20140627-W-Wimbledon-R32-Venus_Williams-Petra_Kvitova,1,F-XC,47,12,4,0,8,23,24
20140627-W-Wimbledon-R32-Venus_Williams-Petra_Kvitova,1,F-DTM,30,4,0,0,4,18,12
20140627-W-Wimbledon-R32-Venus_Williams-Petra_Kvitova,1,F-DTL,6,4,0,3,1,3,3
20140627-W-Wimbledon-R32-Venus_Williams-Petra_Kvitova,1,F-IO,15,9,4,2,3,11,4
20140627-W-Wimbledon-R32-Venus_Williams-Petra_Kvitova,1,B-XC,24,9,1,2,6,8,16
20140627-W-Wimbledon-R32-Venus_Williams-Petra_Kvitova,1,B-DTM,29,2,0,0,2,12,17
20140627-W-Wimbledon-R32-Venus_Williams-Petra_Kvitova,1,B-DTL,7,1,0,1,0,5,2
20140627-W-Wimbledon-R32-Venus_Williams-Petra_Kvitova,1,B-IO,11,4,1,0,3,3,8
20140627-W-Wimbledon-R32-Venus_Williams-Petra_Kvitova,1,S-DTM,10,0,0,0,0,9,1
20140627-W-Wimbledon-R32-Venus_Williams-Petra_Kvitova,1,S-DTL,1,0,0,0,0,1,0
20140627-W-Wimbledon-R32-Venus_Williams-Petra_Kvitova,1,S-IO,2,1,1,0,0,2,0
20140627-W-Wimbledon-R32-Venus_Williams-Petra_Kvitova,2,F-XC,34,17,7,3,7,18,16
20140627-W-Wimbledon-R32-Venus_Williams-Petra_Kvitova,2,F-DTM,24,4,0,1,3,9,15
20140627-W-Wimbledon-R32-Venus_Williams-Petra_Kvitova,2,F-DTL,9,6,4,1,1,8,1
20140627-W-Wimbledon-R32-Venus_Williams-Petra_Kvitova,2,F-IO,16,12,5,2,5,10,6
20140627-W-Wimbledon-R32-Venus_Williams-Petra_Kvitova,2,B-XC,40,20,7,4,9,19,21
20140627-W-Wimbledon-R32-Venus_Williams-Petra_Kvitova,2,B-DTM,30,6,1,1,4,19,11
20140627-W-Wimbledon-R32-Venus_Williams-Petra_Kvitova,2,B-DTL,10,2,0,0,2,4,6
20140627-W-Wimbledon-R32-Venus_Williams-Petra_Kvitova,2,B-IO,15,7,3,0,4,6,9
20140627-W-Wimbledon-R32-Venus_Williams-Petra_Kvitova,2,S-XC,3,1,0,0,1,2,1
20140627-W-Wimbledon-R32-Venus_Williams-Petra_Kvitova,2,S-DTM,7,2,0,0,2,1,6
20140627-W-Wimbledon-R32-Venus_Williams-Petra_Kvitova,2,S-DTL,2,0,0,0,0,1,1
20140627-W-Wimbledon-R32-Venus_Williams-Petra_Kvitova,2,S-IO,3,0,0,0,0,1,2
20140630-W-Wimbledon-R16-Petra_Kvitova-Shuai_Peng,1,F-XC,21,10,6,2,2,15,6
20140630-W-Wimbledon-R16-Petra_Kvitova-Shuai_Peng,1,F-DTM,11,2,0,0,2,7,4
20140630-W-Wimbledon-R16-Petra_Kvitova-Shuai_Peng,1,F-DTL,9,6,2,2,2,6,3
20140630-W-Wimbledon-R16-Petra_Kvitova-Shuai_Peng,1,F-IO,3,0,0,0,0,3,0
20140630-W-Wimbledon-R16-Petra_Kvitova-Shuai_Peng,1,F-II,1,0,0,0,0,1,0
20140630-W-Wimbledon-R16-Petra_Kvitova-Shuai_Peng,1,B-XC,8,2,1,1,0,6,2
20140630-W-Wimbledon-R16-Petra_Kvitova-Shuai_Peng,1,B-DTM,7,2,0,0,2,2,5
20140630-W-Wimbledon-R16-Petra_Kvitova-Shuai_Peng,1,B-IO,3,2,2,0,0,2,1
20140630-W-Wimbledon-R16-Petra_Kvitova-Shuai_Peng,1,S-DTM,2,0,0,0,0,1,1
20140630-W-Wimbledon-R16-Petra_Kvitova-Shuai_Peng,2,F-XC,5,1,0,0,1,4,1
20140630-W-Wimbledon-R16-Petra_Kvitova-Shuai_Peng,2,F-DTM,12,1,0,1,0,4,8
20140630-W-Wimbledon-R16-Petra_Kvitova-Shuai_Peng,2,F-DTL,2,0,0,0,0,0,2
20140630-W-Wimbledon-R16-Petra_Kvitova-Shuai_Peng,2,F-IO,6,2,2,0,0,4,2
20140630-W-Wimbledon-R16-Petra_Kvitova-Shuai_Peng,2,B-XC,13,4,2,0,2,6,7
20140630-W-Wimbledon-R16-Petra_Kvitova-Shuai_Peng,2,B-DTM,13,2,0,0,2,2,11
20140630-W-Wimbledon-R16-Petra_Kvitova-Shuai_Peng,2,B-DTL,1,0,0,0,0,1,0
20140630-W-Wimbledon-R16-Petra_Kvitova-Shuai_Peng,2,B-IO,6,5,1,2,2,3,3
20140630-W-Wimbledon-R16-Petra_Kvitova-Shuai_Peng,2,B-II,1,0,0,0,0,0,1
20140630-W-Wimbledon-R16-Petra_Kvitova-Shuai_Peng,2,S-DTM,1,0,0,0,0,1,0
20140701-W-Wimbledon-QF-Barbora_Strycova-Petra_Kvitova,1,F-XC,35,8,0,2,6,18,17
20140701-W-Wimbledon-QF-Barbora_Strycova-Petra_Kvitova,1,F-DTM,24,4,0,0,4,9,15
20140701-W-Wimbledon-QF-Barbora_Strycova-Petra_Kvitova,1,F-DTL,7,0,0,0,0,2,5
20140701-W-Wimbledon-QF-Barbora_Strycova-Petra_Kvitova,1,F-IO,3,1,0,0,1,2,1
20140701-W-Wimbledon-QF-Barbora_Strycova-Petra_Kvitova,1,B-XC,16,3,1,1,1,11,5
20140701-W-Wimbledon-QF-Barbora_Strycova-Petra_Kvitova,1,B-DTM,17,3,0,1,2,9,8
20140701-W-Wimbledon-QF-Barbora_Strycova-Petra_Kvitova,1,B-DTL,2,0,0,0,0,1,1
20140701-W-Wimbledon-QF-Barbora_Strycova-Petra_Kvitova,1,B-IO,1,0,0,0,0,1,0
20140701-W-Wimbledon-QF-Barbora_Strycova-Petra_Kvitova,1,S-XC,1,0,0,0,0,0,1
20140701-W-Wimbledon-QF-Barbora_Strycova-Petra_Kvitova,1,S-DTM,3,0,0,0,0,2,1
20140701-W-Wimbledon-QF-Barbora_Strycova-Petra_Kvitova,2,F-XC,27,14,5,3,6,14,13
20140701-W-Wimbledon-QF-Barbora_Strycova-Petra_Kvitova,2,F-DTM,14,3,0,1,2,6,8
20140701-W-Wimbledon-QF-Barbora_Strycova-Petra_Kvitova,2,F-DTL,12,7,3,1,3,7,5
20140701-W-Wimbledon-QF-Barbora_Strycova-Petra_Kvitova,2,F-IO,15,10,4,3,3,8,7
20140701-W-Wimbledon-QF-Barbora_Strycova-Petra_Kvitova,2,B-XC,38,11,1,1,9,17,21
20140701-W-Wimbledon-QF-Barbora_Strycova-Petra_Kvitova,2,B-DTM,16,0,0,0,0,10,6
20140701-W-Wimbledon-QF-Barbora_Strycova-Petra_Kvitova,2,B-DTL,7,5,3,1,1,5,2
20140701-W-Wimbledon-QF-Barbora_Strycova-Petra_Kvitova,2,B-IO,7,4,1,1,2,3,4
20140701-W-Wimbledon-QF-Barbora_Strycova-Petra_Kvitova,2,S-XC,1,0,0,0,0,1,0
20140701-W-Wimbledon-QF-Barbora_Strycova-Petra_Kvitova,2,S-DTM,2,1,0,0,1,0,2
20140701-W-Wimbledon-QF-Barbora_Strycova-Petra_Kvitova,2,S-IO,1,1,0,0,1,0,1
20140705-W-Wimbledon-F-Eugenie_Bouchard-Petra_Kvitova,1,F-XC,14,3,1,1,1,6,8
20140705-W-Wimbledon-F-Eugenie_Bouchard-Petra_Kvitova,1,F-DTM,9,1,0,0,1,2,7
20140705-W-Wimbledon-F-Eugenie_Bouchard-Petra_Kvitova,1,F-DTL,4,0,0,0,0,0,4
20140705-W-Wimbledon-F-Eugenie_Bouchard-Petra_Kvitova,1,F-IO,9,4,2,1,1,5,4
20140705-W-Wimbledon-F-Eugenie_Bouchard-Petra_Kvitova,1,B-XC,4,2,0,1,1,1,3
20140705-W-Wimbledon-F-Eugenie_Bouchard-Petra_Kvitova,1,B-DTM,4,1,0,0,1,1,3
20140705-W-Wimbledon-F-Eugenie_Bouchard-Petra_Kvitova,1,B-DTL,3,2,2,0,0,2,1
20140705-W-Wimbledon-F-Eugenie_Bouchard-Petra_Kvitova,1,B-IO,3,2,1,0,1,1,2
20140705-W-Wimbledon-F-Eugenie_Bouchard-Petra_Kvitova,1,S-DTM,1,0,0,0,0,0,1
20140705-W-Wimbledon-F-Eugenie_Bouchard-Petra_Kvitova,2,F-XC,15,11,4,3,4,9,6
20140705-W-Wimbledon-F-Eugenie_Bouchard-Petra_Kvitova,2,F-DTM,1,1,0,1,0,1,0
20140705-W-Wimbledon-F-Eugenie_Bouchard-Petra_Kvitova,2,F-DTL,1,0,0,0,0,1,0
20140705-W-Wimbledon-F-Eugenie_Bouchard-Petra_Kvitova,2,F-IO,7,4,4,0,0,7,0
20140705-W-Wimbledon-F-Eugenie_Bouchard-Petra_Kvitova,2,F-II,1,0,0,0,0,1,0
20140705-W-Wimbledon-F-Eugenie_Bouchard-Petra_Kvitova,2,B-XC,16,10,6,2,2,14,2
20140705-W-Wimbledon-F-Eugenie_Bouchard-Petra_Kvitova,2,B-DTM,6,1,0,0,1,2,4
20140705-W-Wimbledon-F-Eugenie_Bouchard-Petra_Kvitova,2,B-IO,4,3,2,1,0,3,1
20140705-W-Wimbledon-F-Eugenie_Bouchard-Petra_Kvitova,2,S-DTM,2,0,0,0,0,0,2
20140703-W-Wimbledon-SF-Lucie_Safarova-Petra_Kvitova,1,F-XC,20,6,4,0,2,10,10
20140703-W-Wimbledon-SF-Lucie_Safarova-Petra_Kvitova,1,F-DTM,12,1,0,0,1,7,5
20140703-W-Wimbledon-SF-Lucie_Safarova-Petra_Kvitova,1,F-DTL,4,2,0,0,2,0,4
20140703-W-Wimbledon-SF-Lucie_Safarova-Petra_Kvitova,1,F-IO,3,2,0,1,1,1,2
20140703-W-Wimbledon-SF-Lucie_Safarova-Petra_Kvitova,1,B-XC,7,3,2,1,0,5,2
20140703-W-Wimbledon-SF-Lucie_Safarova-Petra_Kvitova,1,B-DTM,13,3,0,0,3,4,9
20140703-W-Wimbledon-SF-Lucie_Safarova-Petra_Kvitova,1,B-DTL,6,4,1,0,3,1,5
20140703-W-Wimbledon-SF-Lucie_Safarova-Petra_Kvitova,1,B-IO,10,4,0,2,2,3,7
20140703-W-Wimbledon-SF-Lucie_Safarova-Petra_Kvitova,1,S-DTM,2,0,0,0,0,1,1
20140703-W-Wimbledon-SF-Lucie_Safarova-Petra_Kvitova,2,F-XC,24,11,6,1,4,17,7
20140703-W-Wimbledon-SF-Lucie_Safarova-Petra_Kvitova,2,F-DTM,14,4,1,1,2,7,7
20140703-W-Wimbledon-SF-Lucie_Safarova-Petra_Kvitova,2,F-DTL,3,2,0,0,2,0,3
20140703-W-Wimbledon-SF-Lucie_Safarova-Petra_Kvitova,2,F-IO,10,5,1,1,3,6,4
20140703-W-Wimbledon-SF-Lucie_Safarova-Petra_Kvitova,2,B-XC,14,6,2,1,3,8,6
20140703-W-Wimbledon-SF-Lucie_Safarova-Petra_Kvitova,2,B-DTM,8,0,0,0,0,6,2
20140703-W-Wimbledon-SF-Lucie_Safarova-Petra_Kvitova,2,B-DTL,1,0,0,0,0,0,1
20140703-W-Wimbledon-SF-Lucie_Safarova-Petra_Kvitova,2,B-IO,3,2,0,1,1,1,2
20140703-W-Wimbledon-SF-Lucie_Safarova-Petra_Kvitova,2,S-DTM,2,0,0,0,0,1,1
20140806-W-Montreal-R32-Petra_Kvitova-Casey_Dellacqua,1,F-XC,26,13,7,3,3,18,8
20140806-W-Montreal-R32-Petra_Kvitova-Casey_Dellacqua,1,F-DTM,7,0,0,0,0,2,5
20140806-W-Montreal-R32-Petra_Kvitova-Casey_Dellacqua,1,F-DTL,9,7,3,1,3,4,5
20140806-W-Montreal-R32-Petra_Kvitova-Casey_Dellacqua,1,F-IO,20,12,6,1,5,11,9
20140806-W-Montreal-R32-Petra_Kvitova-Casey_Dellacqua,1,B-XC,19,4,0,1,3,7,12
20140806-W-Montreal-R32-Petra_Kvitova-Casey_Dellacqua,1,B-DTM,10,1,0,0,1,5,5
20140806-W-Montreal-R32-Petra_Kvitova-Casey_Dellacqua,1,B-DTL,9,3,1,1,1,5,4
20140806-W-Montreal-R32-Petra_Kvitova-Casey_Dellacqua,1,B-IO,8,5,1,0,3,2,6
20140806-W-Montreal-R32-Petra_Kvitova-Casey_Dellacqua,1,S-DTM,4,0,0,0,0,2,2
20140806-W-Montreal-R32-Petra_Kvitova-Casey_Dellacqua,1,S-DTL,1,0,0,0,0,0,1
20140806-W-Montreal-R32-Petra_Kvitova-Casey_Dellacqua,2,F-XC,14,2,1,0,1,9,5
20140806-W-Montreal-R32-Petra_Kvitova-Casey_Dellacqua,2,F-DTM,19,2,0,0,2,9,10
20140806-W-Montreal-R32-Petra_Kvitova-Casey_Dellacqua,2,F-DTL,8,4,3,0,1,5,3
20140806-W-Montreal-R32-Petra_Kvitova-Casey_Dellacqua,2,F-IO,15,5,1,1,3,8,7
20140806-W-Montreal-R32-Petra_Kvitova-Casey_Dellacqua,2,B-XC,17,4,0,0,4,8,9
20140806-W-Montreal-R32-Petra_Kvitova-Casey_Dellacqua,2,B-DTM,19,1,0,0,1,9,10
20140806-W-Montreal-R32-Petra_Kvitova-Casey_Dellacqua,2,B-DTL,2,2,2,0,0,2,0
20140806-W-Montreal-R32-Petra_Kvitova-Casey_Dellacqua,2,B-IO,5,0,0,0,0,3,2
20140806-W-Montreal-R32-Petra_Kvitova-Casey_Dellacqua,2,S-DTM,6,0,0,0,0,4,2
20140807-W-Montreal-R16-Caroline_Wozniacki-Shelby_Rogers,1,F-XC,13,4,3,1,0,12,1
20140807-W-Montreal-R16-Caroline_Wozniacki-Shelby_Rogers,1,F-DTM,16,1,1,0,0,12,4
20140807-W-Montreal-R16-Caroline_Wozniacki-Shelby_Rogers,1,F-DTL,7,3,1,0,2,3,4
20140807-W-Montreal-R16-Caroline_Wozniacki-Shelby_Rogers,1,F-IO,10,1,1,0,0,6,4
20140807-W-Montreal-R16-Caroline_Wozniacki-Shelby_Rogers,1,B-XC,11,3,0,2,1,9,2
20140807-W-Montreal-R16-Caroline_Wozniacki-Shelby_Rogers,1,B-DTM,5,0,0,0,0,5,0
20140807-W-Montreal-R16-Caroline_Wozniacki-Shelby_Rogers,1,B-DTL,4,3,3,0,0,4,0
20140807-W-Montreal-R16-Caroline_Wozniacki-Shelby_Rogers,1,B-IO,4,0,0,0,0,3,1
20140807-W-Montreal-R16-Caroline_Wozniacki-Shelby_Rogers,1,S-XC,2,0,0,0,0,0,2
20140807-W-Montreal-R16-Caroline_Wozniacki-Shelby_Rogers,1,S-DTM,1,0,0,0,0,1,0
20140807-W-Montreal-R16-Caroline_Wozniacki-Shelby_Rogers,2,F-XC,18,6,1,1,4,5,13
20140807-W-Montreal-R16-Caroline_Wozniacki-Shelby_Rogers,2,F-DTM,11,1,0,0,1,2,9
20140807-W-Montreal-R16-Caroline_Wozniacki-Shelby_Rogers,2,F-DTL,5,3,1,0,2,1,4
20140807-W-Montreal-R16-Caroline_Wozniacki-Shelby_Rogers,2,F-IO,12,7,4,0,3,5,7
20140807-W-Montreal-R16-Caroline_Wozniacki-Shelby_Rogers,2,F-II,2,0,0,0,0,0,2
20140807-W-Montreal-R16-Caroline_Wozniacki-Shelby_Rogers,2,B-XC,13,3,1,1,1,5,8
20140807-W-Montreal-R16-Caroline_Wozniacki-Shelby_Rogers,2,B-DTM,11,2,0,0,2,1,10
20140807-W-Montreal-R16-Caroline_Wozniacki-Shelby_Rogers,2,B-DTL,9,4,1,1,2,4,5
20140807-W-Montreal-R16-Caroline_Wozniacki-Shelby_Rogers,2,B-IO,5,1,0,0,1,2,3
20140807-W-Montreal-R16-Caroline_Wozniacki-Shelby_Rogers,2,S-XC,1,1,0,0,1,0,1
20140807-W-Montreal-R16-Caroline_Wozniacki-Shelby_Rogers,2,S-DTM,1,0,0,0,0,0,1
20110702-W-Wimbledon-F-Petra_Kvitova-Maria_Sharapova,1,F-XC,24,8,3,0,5,14,10
20110702-W-Wimbledon-F-Petra_Kvitova-Maria_Sharapova,1,F-DTM,15,5,1,0,4,5,10
20110702-W-Wimbledon-F-Petra_Kvitova-Maria_Sharapova,1,F-DTL,14,6,4,1,1,10,4
20110702-W-Wimbledon-F-Petra_Kvitova-Maria_Sharapova,1,F-IO,10,2,0,1,1,6,4
20110702-W-Wimbledon-F-Petra_Kvitova-Maria_Sharapova,1,F-II,1,1,0,0,1,0,1
20110702-W-Wimbledon-F-Petra_Kvitova-Maria_Sharapova,1,B-XC,16,5,2,1,2,8,8
20110702-W-Wimbledon-F-Petra_Kvitova-Maria_Sharapova,1,B-DTM,14,3,0,0,3,5,9
20110702-W-Wimbledon-F-Petra_Kvitova-Maria_Sharapova,1,B-DTL,7,5,3,0,2,4,3
20110702-W-Wimbledon-F-Petra_Kvitova-Maria_Sharapova,1,B-IO,5,3,1,1,1,4,1
20110702-W-Wimbledon-F-Petra_Kvitova-Maria_Sharapova,1,S-XC,2,0,0,0,0,2,0
20110702-W-Wimbledon-F-Petra_Kvitova-Maria_Sharapova,1,S-DTM,4,0,0,0,0,2,2
20110702-W-Wimbledon-F-Petra_Kvitova-Maria_Sharapova,1,S-DTL,1,0,0,0,0,1,0
20110702-W-Wimbledon-F-Petra_Kvitova-Maria_Sharapova,2,F-XC,21,7,0,4,3,13,8
20110702-W-Wimbledon-F-Petra_Kvitova-Maria_Sharapova,2,F-DTM,17,1,0,0,1,3,14
20110702-W-Wimbledon-F-Petra_Kvitova-Maria_Sharapova,2,F-DTL,11,2,0,1,1,6,5
20110702-W-Wimbledon-F-Petra_Kvitova-Maria_Sharapova,2,F-IO,9,3,0,0,3,3,6
20110702-W-Wimbledon-F-Petra_Kvitova-Maria_Sharapova,2,B-XC,23,4,2,1,1,10,13
20110702-W-Wimbledon-F-Petra_Kvitova-Maria_Sharapova,2,B-DTM,14,2,0,1,1,7,7
20110702-W-Wimbledon-F-Petra_Kvitova-Maria_Sharapova,2,B-DTL,7,4,0,0,4,2,5
20110702-W-Wimbledon-F-Petra_Kvitova-Maria_Sharapova,2,B-IO,6,2,1,0,1,5,1
20020126-W-Australian_Open-F-Martina_Hingis-Jennifer_Capriati,1,F-XC,70,12,3,0,9,27,43
20020126-W-Australian_Open-F-Martina_Hingis-Jennifer_Capriati,1,F-DTM,33,1,0,0,1,15,18
20020126-W-Australian_Open-F-Martina_Hingis-Jennifer_Capriati,1,F-DTL,44,6,2,0,4,21,23
20020126-W-Australian_Open-F-Martina_Hingis-Jennifer_Capriati,1,F-IO,66,13,3,2,8,38,28
20020126-W-Australian_Open-F-Martina_Hingis-Jennifer_Capriati,1,B-XC,109,17,2,3,12,57,52
20020126-W-Australian_Open-F-Martina_Hingis-Jennifer_Capriati,1,B-DTM,53,4,0,0,4,23,30
20020126-W-Australian_Open-F-Martina_Hingis-Jennifer_Capriati,1,B-DTL,30,11,2,2,7,12,18
20020126-W-Australian_Open-F-Martina_Hingis-Jennifer_Capriati,1,B-IO,25,8,0,2,6,10,15
20020126-W-Australian_Open-F-Martina_Hingis-Jennifer_Capriati,1,S-XC,8,0,0,0,0,5,3
20020126-W-Australian_Open-F-Martina_Hingis-Jennifer_Capriati,1,S-DTM,3,0,0,0,0,1,2
20020126-W-Australian_Open-F-Martina_Hingis-Jennifer_Capriati,2,F-XC,87,20,8,4,8,49,38
20020126-W-Australian_Open-F-Martina_Hingis-Jennifer_Capriati,2,F-DTM,38,2,0,0,2,17,21
20020126-W-Australian_Open-F-Martina_Hingis-Jennifer_Capriati,2,F-DTL,34,12,4,2,6,21,13
20020126-W-Australian_Open-F-Martina_Hingis-Jennifer_Capriati,2,F-IO,30,6,0,1,5,12,18
20020126-W-Australian_Open-F-Martina_Hingis-Jennifer_Capriati,2,F-II,2,1,0,0,1,1,1
20020126-W-Australian_Open-F-Martina_Hingis-Jennifer_Capriati,2,B-XC,101,12,2,2,8,51,50
20020126-W-Australian_Open-F-Martina_Hingis-Jennifer_Capriati,2,B-DTM,96,4,0,0,4,42,54
20020126-W-Australian_Open-F-Martina_Hingis-Jennifer_Capriati,2,B-DTL,29,8,3,1,4,14,15
20020126-W-Australian_Open-F-Martina_Hingis-Jennifer_Capriati,2,B-IO,14,5,1,0,4,6,8
20020126-W-Australian_Open-F-Martina_Hingis-Jennifer_Capriati,2,S-XC,4,1,0,0,1,1,3
20020126-W-Australian_Open-F-Martina_Hingis-Jennifer_Capriati,2,S-DTM,12,1,0,0,1,7,5
20020126-W-Australian_Open-F-Martina_Hingis-Jennifer_Capriati,2,S-DTL,5,0,0,0,0,3,2
20020126-W-Australian_Open-F-Martina_Hingis-Jennifer_Capriati,2,S-IO,1,0,0,0,0,1,0
20140404-W-Charleston-QF-Sara_Errani-Belinda_Bencic,1,F-XC,79,15,8,3,4,45,34
20140404-W-Charleston-QF-Sara_Errani-Belinda_Bencic,1,F-DTM,30,2,0,1,1,17,13
20140404-W-Charleston-QF-Sara_Errani-Belinda_Bencic,1,F-DTL,40,3,0,0,3,16,24
20140404-W-Charleston-QF-Sara_Errani-Belinda_Bencic,1,F-IO,27,3,0,2,1,18,9
20140404-W-Charleston-QF-Sara_Errani-Belinda_Bencic,1,F-II,3,0,0,0,0,2,1
20140404-W-Charleston-QF-Sara_Errani-Belinda_Bencic,1,B-XC,65,5,1,1,3,31,34
20140404-W-Charleston-QF-Sara_Errani-Belinda_Bencic,1,B-DTM,39,1,0,0,1,15,24
20140404-W-Charleston-QF-Sara_Errani-Belinda_Bencic,1,B-DTL,18,4,1,1,2,8,10
20140404-W-Charleston-QF-Sara_Errani-Belinda_Bencic,1,B-IO,3,0,0,0,0,1,2
20140404-W-Charleston-QF-Sara_Errani-Belinda_Bencic,1,S-XC,11,0,0,0,0,7,4
20140404-W-Charleston-QF-Sara_Errani-Belinda_Bencic,1,S-DTM,8,0,0,0,0,6,2
20140404-W-Charleston-QF-Sara_Errani-Belinda_Bencic,1,S-DTL,4,0,0,0,0,2,2
20140404-W-Charleston-QF-Sara_Errani-Belinda_Bencic,1,S-IO,1,0,0,0,0,1,0
20140404-W-Charleston-QF-Sara_Errani-Belinda_Bencic,2,F-XC,70,20,9,3,8,36,34
20140404-W-Charleston-QF-Sara_Errani-Belinda_Bencic,2,F-DTM,15,3,0,0,3,4,11
20140404-W-Charleston-QF-Sara_Errani-Belinda_Bencic,2,F-DTL,31,11,3,2,6,14,17
20140404-W-Charleston-QF-Sara_Errani-Belinda_Bencic,2,F-IO,28,5,3,0,2,14,14
20140404-W-Charleston-QF-Sara_Errani-Belinda_Bencic,2,B-XC,79,12,5,3,4,44,35
20140404-W-Charleston-QF-Sara_Errani-Belinda_Bencic,2,B-DTM,45,1,1,0,0,18,27
20140404-W-Charleston-QF-Sara_Errani-Belinda_Bencic,2,B-DTL,49,18,12,2,4,28,21
20140404-W-Charleston-QF-Sara_Errani-Belinda_Bencic,2,B-IO,23,4,1,1,2,13,10
20140404-W-Charleston-QF-Sara_Errani-Belinda_Bencic,2,B-II,1,0,0,0,0,1,0
20140404-W-Charleston-QF-Sara_Errani-Belinda_Bencic,2,S-XC,2,1,1,0,0,2,0
20140404-W-Charleston-QF-Sara_Errani-Belinda_Bencic,2,S-DTM,1,0,0,0,0,1,0
20140404-W-Charleston-QF-Sara_Errani-Belinda_Bencic,2,S-DTL,1,0,0,0,0,0,1
20120802-W-Olympics-QF-Victoria_Azarenka-Angelique_Kerber,1,F-XC,61,11,6,3,2,36,25
20120802-W-Olympics-QF-Victoria_Azarenka-Angelique_Kerber,1,F-DTM,20,2,0,0,2,10,10
20120802-W-Olympics-QF-Victoria_Azarenka-Angelique_Kerber,1,F-DTL,34,6,2,1,3,19,15
20120802-W-Olympics-QF-Victoria_Azarenka-Angelique_Kerber,1,F-IO,24,4,2,0,2,15,9
20120802-W-Olympics-QF-Victoria_Azarenka-Angelique_Kerber,1,F-II,2,0,0,0,0,2,0
20120802-W-Olympics-QF-Victoria_Azarenka-Angelique_Kerber,1,B-XC,54,9,4,3,2,27,27
20120802-W-Olympics-QF-Victoria_Azarenka-Angelique_Kerber,1,B-DTM,25,3,0,1,2,17,8
20120802-W-Olympics-QF-Victoria_Azarenka-Angelique_Kerber,1,B-DTL,18,6,1,0,5,11,7
20120802-W-Olympics-QF-Victoria_Azarenka-Angelique_Kerber,1,B-IO,5,0,0,0,0,1,4
20120802-W-Olympics-QF-Victoria_Azarenka-Angelique_Kerber,1,S-XC,2,0,0,0,0,1,1
20120802-W-Olympics-QF-Victoria_Azarenka-Angelique_Kerber,1,S-DTM,2,0,0,0,0,1,1
20120802-W-Olympics-QF-Victoria_Azarenka-Angelique_Kerber,1,S-DTL,2,0,0,0,0,2,0
20120802-W-Olympics-QF-Victoria_Azarenka-Angelique_Kerber,1,S-IO,1,0,0,0,0,1,0
20120802-W-Olympics-QF-Victoria_Azarenka-Angelique_Kerber,2,F-XC,79,13,4,2,7,35,44
20120802-W-Olympics-QF-Victoria_Azarenka-Angelique_Kerber,2,F-DTM,22,1,0,0,1,6,16
20120802-W-Olympics-QF-Victoria_Azarenka-Angelique_Kerber,2,F-DTL,23,14,8,2,4,16,7
20120802-W-Olympics-QF-Victoria_Azarenka-Angelique_Kerber,2,F-IO,14,4,1,1,2,5,9
20120802-W-Olympics-QF-Victoria_Azarenka-Angelique_Kerber,2,B-XC,69,12,3,3,6,32,37
20120802-W-Olympics-QF-Victoria_Azarenka-Angelique_Kerber,2,B-DTM,23,4,0,1,3,8,15
20120802-W-Olympics-QF-Victoria_Azarenka-Angelique_Kerber,2,B-DTL,11,8,1,1,6,3,8
20120802-W-Olympics-QF-Victoria_Azarenka-Angelique_Kerber,2,B-IO,5,2,1,0,1,2,3
20120802-W-Olympics-QF-Victoria_Azarenka-Angelique_Kerber,2,B-II,1,0,0,0,0,0,1
20120802-W-Olympics-QF-Victoria_Azarenka-Angelique_Kerber,2,S-DTM,4,1,0,0,1,0,4
20120802-W-Olympics-QF-Victoria_Azarenka-Angelique_Kerber,2,S-DTL,1,0,0,0,0,0,1
20120804-W-Olympics-F-Serena_Williams-Maria_Sharapova,1,F-XC,15,6,1,1,4,9,6
20120804-W-Olympics-F-Serena_Williams-Maria_Sharapova,1,F-DTM,8,2,0,0,2,2,6
20120804-W-Olympics-F-Serena_Williams-Maria_Sharapova,1,F-DTL,6,2,1,1,0,4,2
20120804-W-Olympics-F-Serena_Williams-Maria_Sharapova,1,F-IO,7,2,2,0,0,6,1
20120804-W-Olympics-F-Serena_Williams-Maria_Sharapova,1,B-XC,9,5,3,1,1,5,4
20120804-W-Olympics-F-Serena_Williams-Maria_Sharapova,1,B-DTM,9,1,0,0,1,4,5
20120804-W-Olympics-F-Serena_Williams-Maria_Sharapova,1,B-DTL,3,2,1,1,0,3,0
20120804-W-Olympics-F-Serena_Williams-Maria_Sharapova,1,B-IO,1,0,0,0,0,1,0
20120804-W-Olympics-F-Serena_Williams-Maria_Sharapova,1,S-DTM,2,0,0,0,0,1,1
20120804-W-Olympics-F-Serena_Williams-Maria_Sharapova,2,F-XC,12,2,0,1,1,6,6
20120804-W-Olympics-F-Serena_Williams-Maria_Sharapova,2,F-DTM,13,3,0,0,3,4,9
20120804-W-Olympics-F-Serena_Williams-Maria_Sharapova,2,F-DTL,4,1,0,0,1,1,3
20120804-W-Olympics-F-Serena_Williams-Maria_Sharapova,2,F-IO,5,0,0,0,0,3,2
20120804-W-Olympics-F-Serena_Williams-Maria_Sharapova,2,B-XC,12,6,1,1,4,5,7
20120804-W-Olympics-F-Serena_Williams-Maria_Sharapova,2,B-DTM,5,3,1,0,2,2,3
20120804-W-Olympics-F-Serena_Williams-Maria_Sharapova,2,B-DTL,4,2,2,0,0,3,1
20120804-W-Olympics-F-Serena_Williams-Maria_Sharapova,2,B-IO,3,1,0,0,1,2,1
20120804-W-Olympics-F-Serena_Williams-Maria_Sharapova,2,S-DTM,1,0,0,0,0,0,1
20140812-W-Cincinnati-R32-Maria_Sharapova-Madison_Keys,1,F-XC,27,8,2,0,6,8,19
20140812-W-Cincinnati-R32-Maria_Sharapova-Madison_Keys,1,F-DTM,32,5,0,0,5,18,14
20140812-W-Cincinnati-R32-Maria_Sharapova-Madison_Keys,1,F-DTL,11,5,0,1,4,5,6
20140812-W-Cincinnati-R32-Maria_Sharapova-Madison_Keys,1,F-IO,14,4,1,1,2,9,5
20140812-W-Cincinnati-R32-Maria_Sharapova-Madison_Keys,1,B-XC,23,5,0,2,3,12,11
20140812-W-Cincinnati-R32-Maria_Sharapova-Madison_Keys,1,B-DTM,27,1,0,1,0,15,12
20140812-W-Cincinnati-R32-Maria_Sharapova-Madison_Keys,1,B-DTL,9,5,1,3,1,6,3
20140812-W-Cincinnati-R32-Maria_Sharapova-Madison_Keys,1,B-IO,6,4,1,0,3,2,4
20140812-W-Cincinnati-R32-Maria_Sharapova-Madison_Keys,1,S-DTM,3,1,0,0,1,2,1
20140812-W-Cincinnati-R32-Maria_Sharapova-Madison_Keys,1,S-DTL,1,0,0,0,0,1,0
20140812-W-Cincinnati-R32-Maria_Sharapova-Madison_Keys,2,F-XC,36,10,2,3,5,23,13
20140812-W-Cincinnati-R32-Maria_Sharapova-Madison_Keys,2,F-DTM,30,4,0,0,4,11,19
20140812-W-Cincinnati-R32-Maria_Sharapova-Madison_Keys,2,F-DTL,6,3,2,1,0,4,2
20140812-W-Cincinnati-R32-Maria_Sharapova-Madison_Keys,2,F-IO,24,14,6,1,7,10,14
20140812-W-Cincinnati-R32-Maria_Sharapova-Madison_Keys,2,F-II,1,0,0,0,0,1,0
20140812-W-Cincinnati-R32-Maria_Sharapova-Madison_Keys,2,B-XC,22,4,0,0,4,6,16
20140812-W-Cincinnati-R32-Maria_Sharapova-Madison_Keys,2,B-DTM,27,4,0,1,3,12,15
20140812-W-Cincinnati-R32-Maria_Sharapova-Madison_Keys,2,B-DTL,6,1,0,0,1,4,2
20140812-W-Cincinnati-R32-Maria_Sharapova-Madison_Keys,2,B-IO,4,3,1,0,2,1,3
20140812-W-Cincinnati-R32-Maria_Sharapova-Madison_Keys,2,S-XC,2,1,0,0,1,1,1
20140812-W-Cincinnati-R32-Maria_Sharapova-Madison_Keys,2,S-DTM,1,1,0,0,1,0,1
20140812-W-Cincinnati-R32-Maria_Sharapova-Madison_Keys,2,S-DTL,1,0,0,0,0,1,0
20140812-W-Cincinnati-R32-Maria_Sharapova-Madison_Keys,2,S-II,1,0,0,0,0,1,0
20140621-W-Eastbourne-F-Madison_Keys-Angelique_Kerber,1,F-XC,64,14,8,3,3,44,20
20140621-W-Eastbourne-F-Madison_Keys-Angelique_Kerber,1,F-DTM,30,4,0,1,3,18,12
20140621-W-Eastbourne-F-Madison_Keys-Angelique_Kerber,1,F-DTL,10,7,0,1,6,4,6
20140621-W-Eastbourne-F-Madison_Keys-Angelique_Kerber,1,F-IO,29,16,9,1,6,16,13
20140621-W-Eastbourne-F-Madison_Keys-Angelique_Kerber,1,F-II,2,2,2,0,0,2,0
20140621-W-Eastbourne-F-Madison_Keys-Angelique_Kerber,1,B-XC,49,9,2,3,4,30,19
20140621-W-Eastbourne-F-Madison_Keys-Angelique_Kerber,1,B-DTM,25,5,0,0,5,8,17
20140621-W-Eastbourne-F-Madison_Keys-Angelique_Kerber,1,B-DTL,17,11,3,1,7,8,9
20140621-W-Eastbourne-F-Madison_Keys-Angelique_Kerber,1,B-IO,7,2,0,1,1,6,1
20140621-W-Eastbourne-F-Madison_Keys-Angelique_Kerber,1,S-XC,2,0,0,0,0,2,0
20140621-W-Eastbourne-F-Madison_Keys-Angelique_Kerber,1,S-DTM,3,1,0,0,1,1,2
20140621-W-Eastbourne-F-Madison_Keys-Angelique_Kerber,1,S-DTL,1,0,0,0,0,1,0
20140621-W-Eastbourne-F-Madison_Keys-Angelique_Kerber,1,S-IO,1,0,0,0,0,1,0
20140621-W-Eastbourne-F-Madison_Keys-Angelique_Kerber,2,F-XC,67,14,2,5,7,29,38
20140621-W-Eastbourne-F-Madison_Keys-Angelique_Kerber,2,F-DTM,25,2,0,0,2,12,13
20140621-W-Eastbourne-F-Madison_Keys-Angelique_Kerber,2,F-DTL,14,7,2,2,3,6,8
20140621-W-Eastbourne-F-Madison_Keys-Angelique_Kerber,2,F-IO,15,3,1,1,1,9,6
20140621-W-Eastbourne-F-Madison_Keys-Angelique_Kerber,2,B-XC,49,13,2,4,7,22,27
20140621-W-Eastbourne-F-Madison_Keys-Angelique_Kerber,2,B-DTM,39,3,1,1,1,13,26
20140621-W-Eastbourne-F-Madison_Keys-Angelique_Kerber,2,B-DTL,12,2,1,1,0,3,9
20140621-W-Eastbourne-F-Madison_Keys-Angelique_Kerber,2,B-IO,10,0,0,0,0,6,4
20140621-W-Eastbourne-F-Madison_Keys-Angelique_Kerber,2,B-II,1,1,1,0,0,1,0
20140621-W-Eastbourne-F-Madison_Keys-Angelique_Kerber,2,S-XC,1,1,0,0,1,0,1
20140621-W-Eastbourne-F-Madison_Keys-Angelique_Kerber,2,S-DTM,3,0,0,0,0,1,2
20140621-W-Eastbourne-F-Madison_Keys-Angelique_Kerber,2,S-DTL,4,0,0,0,0,2,2
20140621-W-Eastbourne-F-Madison_Keys-Angelique_Kerber,2,S-IO,1,0,0,0,0,1,0
20120630-W-Wimbledon-R32-Petra_Kvitova-Varvara_Lepchenko,1,F-XC,12,9,5,1,3,8,4
20120630-W-Wimbledon-R32-Petra_Kvitova-Varvara_Lepchenko,1,F-DTM,5,1,0,0,1,2,3
20120630-W-Wimbledon-R32-Petra_Kvitova-Varvara_Lepchenko,1,F-DTL,9,6,5,1,0,9,0
20120630-W-Wimbledon-R32-Petra_Kvitova-Varvara_Lepchenko,1,F-IO,5,4,2,0,2,3,2
20120630-W-Wimbledon-R32-Petra_Kvitova-Varvara_Lepchenko,1,B-XC,5,1,0,0,1,1,4
20120630-W-Wimbledon-R32-Petra_Kvitova-Varvara_Lepchenko,1,B-DTM,3,1,0,0,1,0,3
20120630-W-Wimbledon-R32-Petra_Kvitova-Varvara_Lepchenko,1,B-DTL,2,0,0,0,0,1,1
20120630-W-Wimbledon-R32-Petra_Kvitova-Varvara_Lepchenko,1,S-XC,1,0,0,0,0,1,0
20120630-W-Wimbledon-R32-Petra_Kvitova-Varvara_Lepchenko,1,S-DTM,2,0,0,0,0,0,2
20120630-W-Wimbledon-R32-Petra_Kvitova-Varvara_Lepchenko,2,F-XC,6,1,1,0,0,2,4
20120630-W-Wimbledon-R32-Petra_Kvitova-Varvara_Lepchenko,2,F-DTM,5,0,0,0,0,1,4
20120630-W-Wimbledon-R32-Petra_Kvitova-Varvara_Lepchenko,2,F-DTL,5,4,1,1,2,3,2
20120630-W-Wimbledon-R32-Petra_Kvitova-Varvara_Lepchenko,2,F-IO,7,3,0,0,3,3,4
20120630-W-Wimbledon-R32-Petra_Kvitova-Varvara_Lepchenko,2,B-XC,3,3,3,0,0,3,0
20120630-W-Wimbledon-R32-Petra_Kvitova-Varvara_Lepchenko,2,B-DTM,7,2,0,1,1,4,3
20120630-W-Wimbledon-R32-Petra_Kvitova-Varvara_Lepchenko,2,B-DTL,3,1,1,0,0,2,1
20120630-W-Wimbledon-R32-Petra_Kvitova-Varvara_Lepchenko,2,B-IO,1,0,0,0,0,0,1
20120630-W-Wimbledon-R32-Petra_Kvitova-Varvara_Lepchenko,2,S-XC,1,1,0,0,1,0,1
20120630-W-Wimbledon-R32-Petra_Kvitova-Varvara_Lepchenko,2,S-DTM,2,1,0,0,1,0,2
20120630-W-Wimbledon-R32-Petra_Kvitova-Varvara_Lepchenko,2,S-DTL,2,1,0,0,1,0,2
20140714-W-Istanbul-R32-Caroline_Wozniacki-Belinda_Bencic,1,F-XC,12,1,0,0,1,9,3
20140714-W-Istanbul-R32-Caroline_Wozniacki-Belinda_Bencic,1,F-DTM,7,2,0,0,2,1,6
20140714-W-Istanbul-R32-Caroline_Wozniacki-Belinda_Bencic,1,F-DTL,3,2,1,0,1,1,2
20140714-W-Istanbul-R32-Caroline_Wozniacki-Belinda_Bencic,1,F-IO,2,2,1,1,0,2,0
20140714-W-Istanbul-R32-Caroline_Wozniacki-Belinda_Bencic,1,B-XC,17,2,0,1,1,11,6
20140714-W-Istanbul-R32-Caroline_Wozniacki-Belinda_Bencic,1,B-DTM,7,1,0,1,0,5,2
20140714-W-Istanbul-R32-Caroline_Wozniacki-Belinda_Bencic,1,B-DTL,4,2,0,2,0,3,1
20140714-W-Istanbul-R32-Caroline_Wozniacki-Belinda_Bencic,1,B-IO,6,3,1,0,2,3,3
20140714-W-Istanbul-R32-Caroline_Wozniacki-Belinda_Bencic,1,S-XC,2,0,0,0,0,1,1
20140714-W-Istanbul-R32-Caroline_Wozniacki-Belinda_Bencic,1,S-DTM,1,1,0,1,0,1,0
20140714-W-Istanbul-R32-Caroline_Wozniacki-Belinda_Bencic,1,S-IO,1,0,0,0,0,0,1
20140714-W-Istanbul-R32-Caroline_Wozniacki-Belinda_Bencic,2,F-XC,11,2,0,0,2,3,8
20140714-W-Istanbul-R32-Caroline_Wozniacki-Belinda_Bencic,2,F-DTM,11,5,0,0,5,0,11
20140714-W-Istanbul-R32-Caroline_Wozniacki-Belinda_Bencic,2,F-DTL,5,1,0,0,1,1,4
20140714-W-Istanbul-R32-Caroline_Wozniacki-Belinda_Bencic,2,F-IO,4,0,0,0,0,1,3
20140714-W-Istanbul-R32-Caroline_Wozniacki-Belinda_Bencic,2,B-XC,14,6,1,2,3,6,8
20140714-W-Istanbul-R32-Caroline_Wozniacki-Belinda_Bencic,2,B-DTM,5,0,0,0,0,1,4
20140714-W-Istanbul-R32-Caroline_Wozniacki-Belinda_Bencic,2,B-DTL,8,3,1,0,2,4,4
20140714-W-Istanbul-R32-Caroline_Wozniacki-Belinda_Bencic,2,B-IO,3,1,1,0,0,3,0
20140714-W-Istanbul-R32-Caroline_Wozniacki-Belinda_Bencic,2,B-II,2,1,1,0,0,1,1
20140714-W-Istanbul-R32-Caroline_Wozniacki-Belinda_Bencic,2,S-DTM,1,0,0,0,0,0,1
20140805-W-Montreal-R32-Eugenie_Bouchard-Shelby_Rogers,1,F-XC,38,13,2,4,7,17,21
20140805-W-Montreal-R32-Eugenie_Bouchard-Shelby_Rogers,1,F-DTM,9,2,0,1,1,1,8
20140805-W-Montreal-R32-Eugenie_Bouchard-Shelby_Rogers,1,F-DTL,6,3,2,0,1,3,3
20140805-W-Montreal-R32-Eugenie_Bouchard-Shelby_Rogers,1,F-IO,16,7,5,0,2,8,8
20140805-W-Montreal-R32-Eugenie_Bouchard-Shelby_Rogers,1,F-II,1,1,0,0,1,0,1
20140805-W-Montreal-R32-Eugenie_Bouchard-Shelby_Rogers,1,B-XC,27,7,2,1,4,12,15
20140805-W-Montreal-R32-Eugenie_Bouchard-Shelby_Rogers,1,B-DTM,8,1,0,0,1,1,7
20140805-W-Montreal-R32-Eugenie_Bouchard-Shelby_Rogers,1,B-DTL,11,7,1,0,6,1,10
20140805-W-Montreal-R32-Eugenie_Bouchard-Shelby_Rogers,1,B-IO,2,1,0,0,1,0,2
20140805-W-Montreal-R32-Eugenie_Bouchard-Shelby_Rogers,1,S-DTM,3,0,0,0,0,1,2
20140805-W-Montreal-R32-Eugenie_Bouchard-Shelby_Rogers,2,F-XC,18,7,5,0,2,12,6
20140805-W-Montreal-R32-Eugenie_Bouchard-Shelby_Rogers,2,F-DTM,16,0,0,0,0,8,8
20140805-W-Montreal-R32-Eugenie_Bouchard-Shelby_Rogers,2,F-DTL,11,2,1,0,1,7,4
20140805-W-Montreal-R32-Eugenie_Bouchard-Shelby_Rogers,2,F-IO,14,4,4,0,0,10,4
20140805-W-Montreal-R32-Eugenie_Bouchard-Shelby_Rogers,2,F-II,2,2,2,0,0,2,0
20140805-W-Montreal-R32-Eugenie_Bouchard-Shelby_Rogers,2,B-XC,16,3,1,0,2,10,6
20140805-W-Montreal-R32-Eugenie_Bouchard-Shelby_Rogers,2,B-DTM,19,6,0,0,6,10,9
20140805-W-Montreal-R32-Eugenie_Bouchard-Shelby_Rogers,2,B-DTL,12,6,2,0,4,6,6
20140805-W-Montreal-R32-Eugenie_Bouchard-Shelby_Rogers,2,S-DTM,7,2,0,0,2,1,6
20140805-W-Montreal-R32-Eugenie_Bouchard-Shelby_Rogers,2,S-DTL,1,0,0,0,0,1,0
20140807-W-Montreal-R32-Ana_Ivanovic-Coco_Vandeweghe,1,F-XC,50,17,7,4,6,29,21
20140807-W-Montreal-R32-Ana_Ivanovic-Coco_Vandeweghe,1,F-DTM,21,4,0,0,4,11,10
20140807-W-Montreal-R32-Ana_Ivanovic-Coco_Vandeweghe,1,F-DTL,8,2,0,0,2,4,4
20140807-W-Montreal-R32-Ana_Ivanovic-Coco_Vandeweghe,1,F-IO,18,8,2,0,6,9,9
20140807-W-Montreal-R32-Ana_Ivanovic-Coco_Vandeweghe,1,F-II,4,2,1,0,1,3,1
20140807-W-Montreal-R32-Ana_Ivanovic-Coco_Vandeweghe,1,B-XC,18,4,2,0,2,8,10
20140807-W-Montreal-R32-Ana_Ivanovic-Coco_Vandeweghe,1,B-DTM,21,3,0,0,3,10,11
20140807-W-Montreal-R32-Ana_Ivanovic-Coco_Vandeweghe,1,B-DTL,11,5,1,0,4,4,7
20140807-W-Montreal-R32-Ana_Ivanovic-Coco_Vandeweghe,1,B-IO,3,0,0,0,0,1,2
20140807-W-Montreal-R32-Ana_Ivanovic-Coco_Vandeweghe,1,S-XC,2,1,1,0,0,1,1
20140807-W-Montreal-R32-Ana_Ivanovic-Coco_Vandeweghe,1,S-DTM,5,0,0,0,0,1,4
20140807-W-Montreal-R32-Ana_Ivanovic-Coco_Vandeweghe,1,S-DTL,2,0,0,0,0,1,1
20140807-W-Montreal-R32-Ana_Ivanovic-Coco_Vandeweghe,2,F-XC,48,24,11,4,9,32,16
20140807-W-Montreal-R32-Ana_Ivanovic-Coco_Vandeweghe,2,F-DTM,19,3,0,0,3,5,14
20140807-W-Montreal-R32-Ana_Ivanovic-Coco_Vandeweghe,2,F-DTL,19,12,3,1,8,7,12
20140807-W-Montreal-R32-Ana_Ivanovic-Coco_Vandeweghe,2,F-IO,15,9,5,1,3,10,5
20140807-W-Montreal-R32-Ana_Ivanovic-Coco_Vandeweghe,2,F-II,4,4,4,0,0,4,0
20140807-W-Montreal-R32-Ana_Ivanovic-Coco_Vandeweghe,2,B-XC,18,4,2,0,2,12,6
20140807-W-Montreal-R32-Ana_Ivanovic-Coco_Vandeweghe,2,B-DTM,20,3,0,0,3,8,12
20140807-W-Montreal-R32-Ana_Ivanovic-Coco_Vandeweghe,2,B-DTL,15,7,3,0,4,6,9
20140807-W-Montreal-R32-Ana_Ivanovic-Coco_Vandeweghe,2,B-IO,3,1,1,0,0,2,1
20140807-W-Montreal-R32-Ana_Ivanovic-Coco_Vandeweghe,2,S-XC,1,1,1,0,0,1,0
20140807-W-Montreal-R32-Ana_Ivanovic-Coco_Vandeweghe,2,S-DTM,6,0,0,0,0,4,2
20140807-W-Montreal-R32-Ana_Ivanovic-Coco_Vandeweghe,2,S-DTL,2,0,0,0,0,0,2
20140807-W-Montreal-R32-Ana_Ivanovic-Coco_Vandeweghe,2,S-IO,1,0,0,0,0,1,0
20140811-W-Cincinnati-R64-Alize_Cornet-Madison_Keys,1,F-XC,20,3,1,1,1,8,12
20140811-W-Cincinnati-R64-Alize_Cornet-Madison_Keys,1,F-DTM,12,3,0,0,3,5,7
20140811-W-Cincinnati-R64-Alize_Cornet-Madison_Keys,1,F-DTL,8,2,1,0,1,5,3
20140811-W-Cincinnati-R64-Alize_Cornet-Madison_Keys,1,F-IO,12,3,0,0,3,2,10
20140811-W-Cincinnati-R64-Alize_Cornet-Madison_Keys,1,B-XC,22,1,0,0,1,9,13
20140811-W-Cincinnati-R64-Alize_Cornet-Madison_Keys,1,B-DTM,25,5,0,0,5,12,13
20140811-W-Cincinnati-R64-Alize_Cornet-Madison_Keys,1,B-DTL,1,1,1,0,0,1,0
20140811-W-Cincinnati-R64-Alize_Cornet-Madison_Keys,1,B-IO,1,1,1,0,0,1,0
20140811-W-Cincinnati-R64-Alize_Cornet-Madison_Keys,1,S-XC,2,0,0,0,0,1,1
20140811-W-Cincinnati-R64-Alize_Cornet-Madison_Keys,1,S-DTM,4,0,0,0,0,0,4
20140811-W-Cincinnati-R64-Alize_Cornet-Madison_Keys,2,F-XC,28,15,6,1,8,16,12
20140811-W-Cincinnati-R64-Alize_Cornet-Madison_Keys,2,F-DTM,15,6,0,0,6,8,7
20140811-W-Cincinnati-R64-Alize_Cornet-Madison_Keys,2,F-DTL,2,1,1,0,0,2,0
20140811-W-Cincinnati-R64-Alize_Cornet-Madison_Keys,2,F-IO,22,9,4,2,3,14,8
20140811-W-Cincinnati-R64-Alize_Cornet-Madison_Keys,2,F-II,2,1,0,0,1,0,2
20140811-W-Cincinnati-R64-Alize_Cornet-Madison_Keys,2,B-XC,19,7,3,0,4,11,8
20140811-W-Cincinnati-R64-Alize_Cornet-Madison_Keys,2,B-DTM,25,6,1,0,5,12,13
20140811-W-Cincinnati-R64-Alize_Cornet-Madison_Keys,2,B-DTL,12,9,2,0,7,3,9
20140811-W-Cincinnati-R64-Alize_Cornet-Madison_Keys,2,B-IO,5,3,2,0,1,2,3
20140811-W-Cincinnati-R64-Alize_Cornet-Madison_Keys,2,S-XC,1,0,0,0,0,1,0
20140811-W-Cincinnati-R64-Alize_Cornet-Madison_Keys,2,S-DTM,3,1,0,0,1,1,2
20140811-W-Cincinnati-R64-Alize_Cornet-Madison_Keys,2,S-DTL,1,1,1,0,0,1,0
20140308-W-Indian_Wells-R64-Ana_Ivanovic-Elina_Svitolina,1,F-XC,83,34,15,3,16,53,30
20140308-W-Indian_Wells-R64-Ana_Ivanovic-Elina_Svitolina,1,F-DTM,20,4,0,0,4,6,14
20140308-W-Indian_Wells-R64-Ana_Ivanovic-Elina_Svitolina,1,F-DTL,17,7,4,1,2,10,7
20140308-W-Indian_Wells-R64-Ana_Ivanovic-Elina_Svitolina,1,F-IO,30,14,8,1,5,21,9
20140308-W-Indian_Wells-R64-Ana_Ivanovic-Elina_Svitolina,1,F-II,8,4,0,1,3,3,5
20140308-W-Indian_Wells-R64-Ana_Ivanovic-Elina_Svitolina,1,B-XC,56,10,2,2,6,28,28
20140308-W-Indian_Wells-R64-Ana_Ivanovic-Elina_Svitolina,1,B-DTM,29,2,0,0,2,14,15
20140308-W-Indian_Wells-R64-Ana_Ivanovic-Elina_Svitolina,1,B-DTL,29,4,0,1,3,19,10
20140308-W-Indian_Wells-R64-Ana_Ivanovic-Elina_Svitolina,1,B-IO,10,3,1,0,2,5,5
20140308-W-Indian_Wells-R64-Ana_Ivanovic-Elina_Svitolina,1,B-II,1,0,0,0,0,0,1
20140308-W-Indian_Wells-R64-Ana_Ivanovic-Elina_Svitolina,1,S-XC,5,2,1,0,1,3,2
20140308-W-Indian_Wells-R64-Ana_Ivanovic-Elina_Svitolina,1,S-DTM,6,0,0,0,0,2,4
20140308-W-Indian_Wells-R64-Ana_Ivanovic-Elina_Svitolina,1,S-DTL,8,4,0,0,4,1,7
20140308-W-Indian_Wells-R64-Ana_Ivanovic-Elina_Svitolina,1,S-IO,2,0,0,0,0,1,1
20140308-W-Indian_Wells-R64-Ana_Ivanovic-Elina_Svitolina,2,F-XC,63,11,3,2,6,33,30
20140308-W-Indian_Wells-R64-Ana_Ivanovic-Elina_Svitolina,2,F-DTM,48,4,0,0,4,21,27
20140308-W-Indian_Wells-R64-Ana_Ivanovic-Elina_Svitolina,2,F-DTL,22,3,0,0,3,8,14
20140308-W-Indian_Wells-R64-Ana_Ivanovic-Elina_Svitolina,2,F-IO,27,9,2,2,5,14,13
20140308-W-Indian_Wells-R64-Ana_Ivanovic-Elina_Svitolina,2,F-II,4,2,1,0,1,2,2
20140308-W-Indian_Wells-R64-Ana_Ivanovic-Elina_Svitolina,2,B-XC,55,5,1,0,4,28,27
20140308-W-Indian_Wells-R64-Ana_Ivanovic-Elina_Svitolina,2,B-DTM,30,3,0,0,3,11,19
20140308-W-Indian_Wells-R64-Ana_Ivanovic-Elina_Svitolina,2,B-DTL,11,7,4,0,3,5,6
20140308-W-Indian_Wells-R64-Ana_Ivanovic-Elina_Svitolina,2,B-IO,7,0,0,0,0,5,2
20140308-W-Indian_Wells-R64-Ana_Ivanovic-Elina_Svitolina,2,S-XC,5,0,0,0,0,1,4
20140308-W-Indian_Wells-R64-Ana_Ivanovic-Elina_Svitolina,2,S-DTM,4,0,0,0,0,0,4
20140102-W-Auckland-QF-Garbine_Muguruza-Venus_Williams,1,F-XC,45,13,2,2,9,18,27
20140102-W-Auckland-QF-Garbine_Muguruza-Venus_Williams,1,F-DTM,31,3,0,0,3,15,16
20140102-W-Auckland-QF-Garbine_Muguruza-Venus_Williams,1,F-DTL,8,4,0,0,4,1,7
20140102-W-Auckland-QF-Garbine_Muguruza-Venus_Williams,1,F-IO,7,5,1,1,3,3,4
20140102-W-Auckland-QF-Garbine_Muguruza-Venus_Williams,1,B-XC,13,1,0,0,1,5,8
20140102-W-Auckland-QF-Garbine_Muguruza-Venus_Williams,1,B-DTM,24,2,0,0,2,5,19
20140102-W-Auckland-QF-Garbine_Muguruza-Venus_Williams,1,B-DTL,2,1,0,0,1,1,1
20140102-W-Auckland-QF-Garbine_Muguruza-Venus_Williams,1,B-IO,1,1,0,0,1,0,1
20140102-W-Auckland-QF-Garbine_Muguruza-Venus_Williams,1,S-DTM,2,0,0,0,0,0,2
20140102-W-Auckland-QF-Garbine_Muguruza-Venus_Williams,2,F-XC,41,9,0,1,8,21,20
20140102-W-Auckland-QF-Garbine_Muguruza-Venus_Williams,2,F-DTM,21,3,0,0,3,12,9
20140102-W-Auckland-QF-Garbine_Muguruza-Venus_Williams,2,F-DTL,7,5,4,0,1,6,1
20140102-W-Auckland-QF-Garbine_Muguruza-Venus_Williams,2,F-IO,19,9,2,3,4,11,8
20140102-W-Auckland-QF-Garbine_Muguruza-Venus_Williams,2,B-XC,13,2,1,0,1,10,3
20140102-W-Auckland-QF-Garbine_Muguruza-Venus_Williams,2,B-DTM,16,1,0,0,1,7,9
20140102-W-Auckland-QF-Garbine_Muguruza-Venus_Williams,2,B-DTL,7,1,0,0,1,4,3
20140102-W-Auckland-QF-Garbine_Muguruza-Venus_Williams,2,B-IO,11,7,3,1,3,7,4
20140102-W-Auckland-QF-Garbine_Muguruza-Venus_Williams,2,S-DTL,1,0,0,0,0,0,1
20130508-W-Madrid-R32-Victoria_Azarenka-Ekaterina_Makarova,1,F-XC,31,11,3,4,4,17,14
20130508-W-Madrid-R32-Victoria_Azarenka-Ekaterina_Makarova,1,F-DTM,14,2,0,0,2,6,8
20130508-W-Madrid-R32-Victoria_Azarenka-Ekaterina_Makarova,1,F-DTL,22,10,5,0,5,13,9
20130508-W-Madrid-R32-Victoria_Azarenka-Ekaterina_Makarova,1,F-IO,15,7,5,0,2,9,6
20130508-W-Madrid-R32-Victoria_Azarenka-Ekaterina_Makarova,1,F-II,1,0,0,0,0,1,0
20130508-W-Madrid-R32-Victoria_Azarenka-Ekaterina_Makarova,1,B-XC,32,6,3,0,3,21,11
20130508-W-Madrid-R32-Victoria_Azarenka-Ekaterina_Makarova,1,B-DTM,26,6,0,0,6,3,23
20130508-W-Madrid-R32-Victoria_Azarenka-Ekaterina_Makarova,1,B-DTL,15,6,2,1,3,7,8
20130508-W-Madrid-R32-Victoria_Azarenka-Ekaterina_Makarova,1,B-IO,12,4,1,0,3,4,8
20130508-W-Madrid-R32-Victoria_Azarenka-Ekaterina_Makarova,1,S-XC,1,0,0,0,0,0,1
20130508-W-Madrid-R32-Victoria_Azarenka-Ekaterina_Makarova,1,S-DTM,4,0,0,0,0,1,3
20130508-W-Madrid-R32-Victoria_Azarenka-Ekaterina_Makarova,1,S-DTL,3,1,0,0,1,0,3
20130508-W-Madrid-R32-Victoria_Azarenka-Ekaterina_Makarova,1,S-IO,1,0,0,0,0,1,0
20130508-W-Madrid-R32-Victoria_Azarenka-Ekaterina_Makarova,2,F-XC,41,8,4,0,4,23,18
20130508-W-Madrid-R32-Victoria_Azarenka-Ekaterina_Makarova,2,F-DTM,18,3,0,0,3,8,10
20130508-W-Madrid-R32-Victoria_Azarenka-Ekaterina_Makarova,2,F-DTL,9,5,1,1,3,4,5
20130508-W-Madrid-R32-Victoria_Azarenka-Ekaterina_Makarova,2,F-IO,8,2,1,0,1,4,4
20130508-W-Madrid-R32-Victoria_Azarenka-Ekaterina_Makarova,2,B-XC,41,11,5,0,6,20,21
20130508-W-Madrid-R32-Victoria_Azarenka-Ekaterina_Makarova,2,B-DTM,20,5,1,0,4,12,8
20130508-W-Madrid-R32-Victoria_Azarenka-Ekaterina_Makarova,2,B-DTL,16,6,3,0,3,10,6
20130508-W-Madrid-R32-Victoria_Azarenka-Ekaterina_Makarova,2,B-IO,9,6,3,1,2,5,4
20130508-W-Madrid-R32-Victoria_Azarenka-Ekaterina_Makarova,2,S-DTM,6,0,0,0,0,4,2
20130508-W-Madrid-R32-Victoria_Azarenka-Ekaterina_Makarova,2,S-DTL,3,0,0,0,0,2,1
20140928-W-Beijing-R64-Agnieszka_Radwanska-Coco_Vandeweghe,1,F-XC,20,3,1,0,2,7,13
20140928-W-Beijing-R64-Agnieszka_Radwanska-Coco_Vandeweghe,1,F-DTM,10,2,0,0,2,7,3
20140928-W-Beijing-R64-Agnieszka_Radwanska-Coco_Vandeweghe,1,F-DTL,8,2,0,1,1,3,5
20140928-W-Beijing-R64-Agnieszka_Radwanska-Coco_Vandeweghe,1,F-IO,10,2,2,0,0,7,3
20140928-W-Beijing-R64-Agnieszka_Radwanska-Coco_Vandeweghe,1,B-XC,16,0,0,0,0,10,6
20140928-W-Beijing-R64-Agnieszka_Radwanska-Coco_Vandeweghe,1,B-DTM,17,1,0,0,1,7,10
20140928-W-Beijing-R64-Agnieszka_Radwanska-Coco_Vandeweghe,1,B-DTL,3,2,1,0,1,2,1
20140928-W-Beijing-R64-Agnieszka_Radwanska-Coco_Vandeweghe,1,S-XC,2,0,0,0,0,1,1
20140928-W-Beijing-R64-Agnieszka_Radwanska-Coco_Vandeweghe,1,S-DTL,1,1,0,0,1,0,1
20140928-W-Beijing-R64-Agnieszka_Radwanska-Coco_Vandeweghe,1,S-IO,1,0,0,0,0,0,1
20140928-W-Beijing-R64-Agnieszka_Radwanska-Coco_Vandeweghe,2,F-XC,35,10,5,0,5,21,14
20140928-W-Beijing-R64-Agnieszka_Radwanska-Coco_Vandeweghe,2,F-DTM,9,5,0,0,5,1,8
20140928-W-Beijing-R64-Agnieszka_Radwanska-Coco_Vandeweghe,2,F-DTL,8,6,2,0,4,4,4
20140928-W-Beijing-R64-Agnieszka_Radwanska-Coco_Vandeweghe,2,F-IO,8,2,2,0,0,6,2
20140928-W-Beijing-R64-Agnieszka_Radwanska-Coco_Vandeweghe,2,F-II,3,1,0,0,1,1,2
20140928-W-Beijing-R64-Agnieszka_Radwanska-Coco_Vandeweghe,2,B-XC,25,6,0,0,6,9,16
20140928-W-Beijing-R64-Agnieszka_Radwanska-Coco_Vandeweghe,2,B-DTM,12,3,0,0,3,4,8
20140928-W-Beijing-R64-Agnieszka_Radwanska-Coco_Vandeweghe,2,B-DTL,6,4,2,1,1,4,2
20140928-W-Beijing-R64-Agnieszka_Radwanska-Coco_Vandeweghe,2,B-IO,1,0,0,0,0,0,1
20140928-W-Beijing-R64-Agnieszka_Radwanska-Coco_Vandeweghe,2,S-XC,3,1,1,0,0,3,0
20140928-W-Beijing-R64-Agnieszka_Radwanska-Coco_Vandeweghe,2,S-DTM,2,1,0,0,1,1,1
20140928-W-Beijing-R64-Agnieszka_Radwanska-Coco_Vandeweghe,2,S-DTL,3,0,0,0,0,3,0
20140927-W-Wuhan-F-Petra_Kvitova-Eugenie_Bouchard,1,F-XC,7,6,4,1,1,6,1
20140927-W-Wuhan-F-Petra_Kvitova-Eugenie_Bouchard,1,F-DTM,15,5,2,0,3,7,8
20140927-W-Wuhan-F-Petra_Kvitova-Eugenie_Bouchard,1,F-IO,26,7,3,1,3,18,8
20140927-W-Wuhan-F-Petra_Kvitova-Eugenie_Bouchard,1,F-II,10,5,4,1,0,8,2
20140927-W-Wuhan-F-Petra_Kvitova-Eugenie_Bouchard,1,B-XC,8,5,0,0,5,1,7
20140927-W-Wuhan-F-Petra_Kvitova-Eugenie_Bouchard,1,B-DTM,6,1,0,0,1,1,5
20140927-W-Wuhan-F-Petra_Kvitova-Eugenie_Bouchard,1,B-IO,15,8,5,0,3,8,7
20140927-W-Wuhan-F-Petra_Kvitova-Eugenie_Bouchard,1,B-II,5,3,1,0,2,1,4
20140927-W-Wuhan-F-Petra_Kvitova-Eugenie_Bouchard,1,S-XC,1,0,0,0,0,1,0
20140927-W-Wuhan-F-Petra_Kvitova-Eugenie_Bouchard,1,S-DTM,1,0,0,0,0,1,0
20140927-W-Wuhan-F-Petra_Kvitova-Eugenie_Bouchard,1,S-II,1,0,0,0,0,0,1
20140927-W-Wuhan-F-Petra_Kvitova-Eugenie_Bouchard,2,F-XC,4,2,2,0,0,4,0
20140927-W-Wuhan-F-Petra_Kvitova-Eugenie_Bouchard,2,F-DTM,12,2,0,0,2,3,9
20140927-W-Wuhan-F-Petra_Kvitova-Eugenie_Bouchard,2,F-IO,17,5,2,0,3,10,7
20140927-W-Wuhan-F-Petra_Kvitova-Eugenie_Bouchard,2,F-II,2,1,0,0,1,0,2
20140927-W-Wuhan-F-Petra_Kvitova-Eugenie_Bouchard,2,B-DTM,16,2,0,0,2,6,10
20140927-W-Wuhan-F-Petra_Kvitova-Eugenie_Bouchard,2,B-IO,18,9,2,1,6,5,13
20140927-W-Wuhan-F-Petra_Kvitova-Eugenie_Bouchard,2,B-II,8,5,1,1,3,4,4
20140927-W-Wuhan-F-Petra_Kvitova-Eugenie_Bouchard,2,S-DTM,1,0,0,0,0,1,0
20140214-W-Doha-QF-Petra_Cetkovska-Angelique_Kerber,1,F-XC,38,5,0,0,5,11,27
20140214-W-Doha-QF-Petra_Cetkovska-Angelique_Kerber,1,F-DTM,8,3,1,0,2,5,3
20140214-W-Doha-QF-Petra_Cetkovska-Angelique_Kerber,1,F-DTL,13,6,1,0,5,3,10
20140214-W-Doha-QF-Petra_Cetkovska-Angelique_Kerber,1,F-IO,10,4,1,2,1,4,6
20140214-W-Doha-QF-Petra_Cetkovska-Angelique_Kerber,1,B-XC,26,6,0,0,6,7,19
20140214-W-Doha-QF-Petra_Cetkovska-Angelique_Kerber,1,B-DTM,13,1,0,0,1,5,8
20140214-W-Doha-QF-Petra_Cetkovska-Angelique_Kerber,1,B-DTL,7,2,0,0,2,3,4
20140214-W-Doha-QF-Petra_Cetkovska-Angelique_Kerber,1,B-IO,4,0,0,0,0,1,3
20140214-W-Doha-QF-Petra_Cetkovska-Angelique_Kerber,1,S-XC,12,3,0,0,3,5,7
20140214-W-Doha-QF-Petra_Cetkovska-Angelique_Kerber,1,S-DTM,7,0,0,0,0,2,5
20140214-W-Doha-QF-Petra_Cetkovska-Angelique_Kerber,1,S-DTL,4,2,0,0,2,0,4
20140214-W-Doha-QF-Petra_Cetkovska-Angelique_Kerber,1,S-IO,3,0,0,0,0,0,3
20140214-W-Doha-QF-Petra_Cetkovska-Angelique_Kerber,2,F-XC,51,1,0,0,1,33,18
20140214-W-Doha-QF-Petra_Cetkovska-Angelique_Kerber,2,F-DTM,4,0,0,0,0,2,2
20140214-W-Doha-QF-Petra_Cetkovska-Angelique_Kerber,2,F-DTL,11,4,1,1,2,5,6
20140214-W-Doha-QF-Petra_Cetkovska-Angelique_Kerber,2,F-IO,10,5,2,1,1,6,4
20140214-W-Doha-QF-Petra_Cetkovska-Angelique_Kerber,2,B-XC,34,7,3,2,2,23,11
20140214-W-Doha-QF-Petra_Cetkovska-Angelique_Kerber,2,B-DTM,11,3,1,0,2,5,6
20140214-W-Doha-QF-Petra_Cetkovska-Angelique_Kerber,2,B-DTL,9,4,2,0,2,6,3
20140214-W-Doha-QF-Petra_Cetkovska-Angelique_Kerber,2,B-IO,1,0,0,0,0,1,0
20140214-W-Doha-QF-Petra_Cetkovska-Angelique_Kerber,2,S-XC,4,0,0,0,0,4,0
20140214-W-Doha-QF-Petra_Cetkovska-Angelique_Kerber,2,S-DTM,5,0,0,0,0,5,0
20140214-W-Doha-QF-Petra_Cetkovska-Angelique_Kerber,2,S-DTL,2,1,0,0,1,1,1
20140926-W-Wuhan-SF-Petra_Kvitova-Elina_Svitolina,1,F-XC,31,12,8,1,3,18,13
20140926-W-Wuhan-SF-Petra_Kvitova-Elina_Svitolina,1,F-DTM,13,5,0,0,5,4,9
20140926-W-Wuhan-SF-Petra_Kvitova-Elina_Svitolina,1,F-DTL,4,3,1,1,1,2,2
20140926-W-Wuhan-SF-Petra_Kvitova-Elina_Svitolina,1,F-IO,27,16,8,4,4,18,9
20140926-W-Wuhan-SF-Petra_Kvitova-Elina_Svitolina,1,B-XC,23,6,0,1,5,8,15
20140926-W-Wuhan-SF-Petra_Kvitova-Elina_Svitolina,1,B-DTM,25,4,0,0,4,9,16
20140926-W-Wuhan-SF-Petra_Kvitova-Elina_Svitolina,1,B-DTL,3,1,0,0,1,1,2
20140926-W-Wuhan-SF-Petra_Kvitova-Elina_Svitolina,1,B-IO,4,1,0,0,1,2,2
20140926-W-Wuhan-SF-Petra_Kvitova-Elina_Svitolina,1,S-DTM,1,0,0,0,0,1,0
20140926-W-Wuhan-SF-Petra_Kvitova-Elina_Svitolina,1,S-DTL,2,1,0,0,1,1,1
20140926-W-Wuhan-SF-Petra_Kvitova-Elina_Svitolina,2,F-XC,26,4,1,0,3,18,8
20140926-W-Wuhan-SF-Petra_Kvitova-Elina_Svitolina,2,F-DTM,32,4,0,0,4,15,17
20140926-W-Wuhan-SF-Petra_Kvitova-Elina_Svitolina,2,F-DTL,7,6,4,0,2,5,2
20140926-W-Wuhan-SF-Petra_Kvitova-Elina_Svitolina,2,F-IO,8,2,2,0,0,6,2
20140926-W-Wuhan-SF-Petra_Kvitova-Elina_Svitolina,2,B-XC,14,3,0,1,2,7,7
20140926-W-Wuhan-SF-Petra_Kvitova-Elina_Svitolina,2,B-DTM,22,1,0,0,1,13,9
20140926-W-Wuhan-SF-Petra_Kvitova-Elina_Svitolina,2,B-DTL,4,1,0,0,1,1,3
20140926-W-Wuhan-SF-Petra_Kvitova-Elina_Svitolina,2,B-IO,6,1,1,0,0,2,4
20140926-W-Wuhan-SF-Petra_Kvitova-Elina_Svitolina,2,S-XC,1,0,0,0,0,0,1
20140924-W-Wuhan-R16-Eugenie_Bouchard-Alison_Riske,1,F-XC,44,12,5,1,6,28,16
20140924-W-Wuhan-R16-Eugenie_Bouchard-Alison_Riske,1,F-DTM,20,0,0,0,0,10,10
20140924-W-Wuhan-R16-Eugenie_Bouchard-Alison_Riske,1,F-DTL,17,10,4,1,5,10,7
20140924-W-Wuhan-R16-Eugenie_Bouchard-Alison_Riske,1,F-IO,13,4,3,1,0,8,5
20140924-W-Wuhan-R16-Eugenie_Bouchard-Alison_Riske,1,B-XC,22,7,2,1,4,11,11
20140924-W-Wuhan-R16-Eugenie_Bouchard-Alison_Riske,1,B-DTM,16,2,0,0,2,5,11
20140924-W-Wuhan-R16-Eugenie_Bouchard-Alison_Riske,1,B-DTL,11,2,1,0,1,6,5
20140924-W-Wuhan-R16-Eugenie_Bouchard-Alison_Riske,1,B-IO,3,2,1,0,1,2,1
20140924-W-Wuhan-R16-Eugenie_Bouchard-Alison_Riske,1,S-XC,1,1,0,0,1,0,1
20140924-W-Wuhan-R16-Eugenie_Bouchard-Alison_Riske,1,S-DTM,2,0,0,0,0,1,1
20140924-W-Wuhan-R16-Eugenie_Bouchard-Alison_Riske,2,F-XC,35,4,1,0,3,17,18
20140924-W-Wuhan-R16-Eugenie_Bouchard-Alison_Riske,2,F-DTM,26,4,0,0,4,9,17
20140924-W-Wuhan-R16-Eugenie_Bouchard-Alison_Riske,2,F-DTL,11,4,1,0,3,5,6
20140924-W-Wuhan-R16-Eugenie_Bouchard-Alison_Riske,2,F-IO,6,2,2,0,0,4,2
20140924-W-Wuhan-R16-Eugenie_Bouchard-Alison_Riske,2,B-XC,14,2,1,0,1,9,5
20140924-W-Wuhan-R16-Eugenie_Bouchard-Alison_Riske,2,B-DTM,28,5,0,0,5,11,17
20140924-W-Wuhan-R16-Eugenie_Bouchard-Alison_Riske,2,B-DTL,8,4,2,0,2,2,6
20140924-W-Wuhan-R16-Eugenie_Bouchard-Alison_Riske,2,B-IO,6,3,1,1,1,4,2
20140924-W-Wuhan-R16-Eugenie_Bouchard-Alison_Riske,2,S-DTM,3,0,0,0,0,0,3
20140924-W-Wuhan-R16-Eugenie_Bouchard-Alison_Riske,2,S-DTL,2,0,0,0,0,0,2
20140925-W-Wuhan-QF-Elina_Svitolina-Angelique_Kerber,1,F-XC,63,14,8,1,5,40,23
20140925-W-Wuhan-QF-Elina_Svitolina-Angelique_Kerber,1,F-DTM,39,4,0,0,4,17,22
20140925-W-Wuhan-QF-Elina_Svitolina-Angelique_Kerber,1,F-DTL,8,3,1,0,2,3,5
20140925-W-Wuhan-QF-Elina_Svitolina-Angelique_Kerber,1,F-IO,22,9,7,1,1,17,5
20140925-W-Wuhan-QF-Elina_Svitolina-Angelique_Kerber,1,B-XC,78,12,4,2,6,49,29
20140925-W-Wuhan-QF-Elina_Svitolina-Angelique_Kerber,1,B-DTM,34,2,0,0,2,16,18
20140925-W-Wuhan-QF-Elina_Svitolina-Angelique_Kerber,1,B-DTL,11,8,3,0,5,5,6
20140925-W-Wuhan-QF-Elina_Svitolina-Angelique_Kerber,1,B-IO,6,1,0,0,1,4,2
20140925-W-Wuhan-QF-Elina_Svitolina-Angelique_Kerber,1,B-II,1,1,1,0,0,1,0
20140925-W-Wuhan-QF-Elina_Svitolina-Angelique_Kerber,1,S-XC,2,0,0,0,0,0,2
20140925-W-Wuhan-QF-Elina_Svitolina-Angelique_Kerber,1,S-DTM,7,0,0,0,0,1,6
20140925-W-Wuhan-QF-Elina_Svitolina-Angelique_Kerber,1,S-DTL,2,1,1,0,0,1,1
20140925-W-Wuhan-QF-Elina_Svitolina-Angelique_Kerber,2,F-XC,81,7,4,1,2,36,45
20140925-W-Wuhan-QF-Elina_Svitolina-Angelique_Kerber,2,F-DTM,28,4,0,0,4,8,20
20140925-W-Wuhan-QF-Elina_Svitolina-Angelique_Kerber,2,F-DTL,31,14,4,1,9,16,15
20140925-W-Wuhan-QF-Elina_Svitolina-Angelique_Kerber,2,F-IO,23,15,8,2,5,14,9
20140925-W-Wuhan-QF-Elina_Svitolina-Angelique_Kerber,2,F-II,2,1,1,0,0,2,0
20140925-W-Wuhan-QF-Elina_Svitolina-Angelique_Kerber,2,B-XC,42,10,2,0,8,20,22
20140925-W-Wuhan-QF-Elina_Svitolina-Angelique_Kerber,2,B-DTM,40,3,0,1,2,13,27
20140925-W-Wuhan-QF-Elina_Svitolina-Angelique_Kerber,2,B-DTL,16,7,2,2,3,9,7
20140925-W-Wuhan-QF-Elina_Svitolina-Angelique_Kerber,2,B-IO,8,1,1,0,0,5,3
20140925-W-Wuhan-QF-Elina_Svitolina-Angelique_Kerber,2,S-DTM,4,0,0,0,0,1,3
20140925-W-Wuhan-QF-Elina_Svitolina-Angelique_Kerber,2,S-IO,3,0,0,0,0,1,2
20140926-W-Wuhan-SF-Caroline_Wozniacki-Eugenie_Bouchard,1,F-XC,28,8,2,3,3,16,12
20140926-W-Wuhan-SF-Caroline_Wozniacki-Eugenie_Bouchard,1,F-DTM,24,2,0,0,2,8,16
20140926-W-Wuhan-SF-Caroline_Wozniacki-Eugenie_Bouchard,1,F-DTL,17,3,1,0,2,8,9
20140926-W-Wuhan-SF-Caroline_Wozniacki-Eugenie_Bouchard,1,F-IO,12,3,2,0,1,8,4
20140926-W-Wuhan-SF-Caroline_Wozniacki-Eugenie_Bouchard,1,B-XC,26,6,0,0,6,12,14
20140926-W-Wuhan-SF-Caroline_Wozniacki-Eugenie_Bouchard,1,B-DTM,16,3,0,1,2,8,8
20140926-W-Wuhan-SF-Caroline_Wozniacki-Eugenie_Bouchard,1,B-DTL,10,5,2,1,2,6,4
20140926-W-Wuhan-SF-Caroline_Wozniacki-Eugenie_Bouchard,1,B-IO,5,4,2,2,0,5,0
20140926-W-Wuhan-SF-Caroline_Wozniacki-Eugenie_Bouchard,1,S-XC,4,0,0,0,0,2,2
20140926-W-Wuhan-SF-Caroline_Wozniacki-Eugenie_Bouchard,1,S-DTM,4,1,0,0,1,1,3
20140926-W-Wuhan-SF-Caroline_Wozniacki-Eugenie_Bouchard,1,S-DTL,3,0,0,0,0,0,3
20140926-W-Wuhan-SF-Caroline_Wozniacki-Eugenie_Bouchard,2,F-XC,36,9,2,3,4,18,18
20140926-W-Wuhan-SF-Caroline_Wozniacki-Eugenie_Bouchard,2,F-DTM,10,2,0,0,2,4,6
20140926-W-Wuhan-SF-Caroline_Wozniacki-Eugenie_Bouchard,2,F-DTL,10,6,4,0,2,7,3
20140926-W-Wuhan-SF-Caroline_Wozniacki-Eugenie_Bouchard,2,F-IO,11,4,2,1,1,4,7
20140926-W-Wuhan-SF-Caroline_Wozniacki-Eugenie_Bouchard,2,B-XC,44,7,0,0,7,18,26
20140926-W-Wuhan-SF-Caroline_Wozniacki-Eugenie_Bouchard,2,B-DTM,15,1,0,0,1,7,8
20140926-W-Wuhan-SF-Caroline_Wozniacki-Eugenie_Bouchard,2,B-DTL,19,6,4,0,2,13,6
20140926-W-Wuhan-SF-Caroline_Wozniacki-Eugenie_Bouchard,2,B-IO,8,5,3,1,1,6,2
20140926-W-Wuhan-SF-Caroline_Wozniacki-Eugenie_Bouchard,2,S-DTM,4,0,0,0,0,0,4
20140915-W-Tokyo-R32-Svetlana_Kuznetsova-Belinda_Bencic,1,F-XC,27,5,2,1,2,12,15
20140915-W-Tokyo-R32-Svetlana_Kuznetsova-Belinda_Bencic,1,F-DTM,13,1,0,0,1,5,8
20140915-W-Tokyo-R32-Svetlana_Kuznetsova-Belinda_Bencic,1,F-DTL,13,3,2,0,1,5,8
20140915-W-Tokyo-R32-Svetlana_Kuznetsova-Belinda_Bencic,1,F-IO,5,1,1,0,0,4,1
20140915-W-Tokyo-R32-Svetlana_Kuznetsova-Belinda_Bencic,1,F-II,2,1,1,0,0,1,1
20140915-W-Tokyo-R32-Svetlana_Kuznetsova-Belinda_Bencic,1,B-XC,28,7,3,1,3,11,17
20140915-W-Tokyo-R32-Svetlana_Kuznetsova-Belinda_Bencic,1,B-DTM,22,1,0,0,1,9,13
20140915-W-Tokyo-R32-Svetlana_Kuznetsova-Belinda_Bencic,1,B-DTL,8,5,1,0,4,2,6
20140915-W-Tokyo-R32-Svetlana_Kuznetsova-Belinda_Bencic,1,B-IO,1,0,0,0,0,0,1
20140915-W-Tokyo-R32-Svetlana_Kuznetsova-Belinda_Bencic,1,S-XC,5,3,0,0,3,1,4
20140915-W-Tokyo-R32-Svetlana_Kuznetsova-Belinda_Bencic,1,S-DTM,4,0,0,0,0,1,3
20140915-W-Tokyo-R32-Svetlana_Kuznetsova-Belinda_Bencic,1,S-DTL,3,2,0,1,1,1,2
20140915-W-Tokyo-R32-Svetlana_Kuznetsova-Belinda_Bencic,2,F-XC,26,6,1,2,3,20,6
20140915-W-Tokyo-R32-Svetlana_Kuznetsova-Belinda_Bencic,2,F-DTM,11,2,0,1,1,4,7
20140915-W-Tokyo-R32-Svetlana_Kuznetsova-Belinda_Bencic,2,F-DTL,10,6,2,1,3,5,5
20140915-W-Tokyo-R32-Svetlana_Kuznetsova-Belinda_Bencic,2,F-IO,20,5,1,3,1,14,6
20140915-W-Tokyo-R32-Svetlana_Kuznetsova-Belinda_Bencic,2,B-XC,31,2,2,0,0,23,8
20140915-W-Tokyo-R32-Svetlana_Kuznetsova-Belinda_Bencic,2,B-DTM,7,0,0,0,0,3,4
20140915-W-Tokyo-R32-Svetlana_Kuznetsova-Belinda_Bencic,2,B-DTL,13,4,2,0,2,6,7
20140915-W-Tokyo-R32-Svetlana_Kuznetsova-Belinda_Bencic,2,B-IO,8,5,3,0,2,5,3
20140915-W-Tokyo-R32-Svetlana_Kuznetsova-Belinda_Bencic,2,S-DTM,1,0,0,0,0,1,0
20140607-W-Roland_Garros-F-Maria_Sharapova-Simona_Halep,1,F-XC,85,24,10,4,10,54,31
20140607-W-Roland_Garros-F-Maria_Sharapova-Simona_Halep,1,F-DTM,34,3,0,0,3,13,21
20140607-W-Roland_Garros-F-Maria_Sharapova-Simona_Halep,1,F-DTL,35,20,10,3,7,22,13
20140607-W-Roland_Garros-F-Maria_Sharapova-Simona_Halep,1,F-IO,32,13,6,3,4,22,10
20140607-W-Roland_Garros-F-Maria_Sharapova-Simona_Halep,1,F-II,4,3,2,1,0,3,1
20140607-W-Roland_Garros-F-Maria_Sharapova-Simona_Halep,1,B-XC,105,18,2,7,9,53,52
20140607-W-Roland_Garros-F-Maria_Sharapova-Simona_Halep,1,B-DTM,53,8,1,0,7,20,33
20140607-W-Roland_Garros-F-Maria_Sharapova-Simona_Halep,1,B-DTL,33,16,4,2,10,15,18
20140607-W-Roland_Garros-F-Maria_Sharapova-Simona_Halep,1,B-IO,18,5,2,0,3,7,11
20140607-W-Roland_Garros-F-Maria_Sharapova-Simona_Halep,1,S-XC,1,1,0,0,1,0,1
20140607-W-Roland_Garros-F-Maria_Sharapova-Simona_Halep,1,S-DTM,2,0,0,0,0,1,1
20140607-W-Roland_Garros-F-Maria_Sharapova-Simona_Halep,2,F-XC,85,18,7,5,6,42,43
20140607-W-Roland_Garros-F-Maria_Sharapova-Simona_Halep,2,F-DTM,23,1,1,0,0,13,10
20140607-W-Roland_Garros-F-Maria_Sharapova-Simona_Halep,2,F-DTL,34,10,2,1,7,14,20
20140607-W-Roland_Garros-F-Maria_Sharapova-Simona_Halep,2,F-IO,35,9,4,2,3,24,11
20140607-W-Roland_Garros-F-Maria_Sharapova-Simona_Halep,2,F-II,1,0,0,0,0,0,1
20140607-W-Roland_Garros-F-Maria_Sharapova-Simona_Halep,2,B-XC,78,8,1,1,6,36,42
20140607-W-Roland_Garros-F-Maria_Sharapova-Simona_Halep,2,B-DTM,59,2,0,0,2,27,32
20140607-W-Roland_Garros-F-Maria_Sharapova-Simona_Halep,2,B-DTL,35,13,2,3,8,14,21
20140607-W-Roland_Garros-F-Maria_Sharapova-Simona_Halep,2,B-IO,12,4,1,0,3,6,6
20140607-W-Roland_Garros-F-Maria_Sharapova-Simona_Halep,2,S-XC,7,0,0,0,0,4,3
20140607-W-Roland_Garros-F-Maria_Sharapova-Simona_Halep,2,S-DTM,5,0,0,0,0,2,3
20140607-W-Roland_Garros-F-Maria_Sharapova-Simona_Halep,2,S-DTL,2,0,0,0,0,0,2
20140311-W-Indian_Wells-R16-Dominika_Cibulkova-Petra_Kvitova,1,F-XC,12,3,2,0,1,9,3
20140311-W-Indian_Wells-R16-Dominika_Cibulkova-Petra_Kvitova,1,F-DTM,5,0,0,0,0,5,0
20140311-W-Indian_Wells-R16-Dominika_Cibulkova-Petra_Kvitova,1,F-DTL,2,0,0,0,0,2,0
20140311-W-Indian_Wells-R16-Dominika_Cibulkova-Petra_Kvitova,1,F-IO,7,2,1,0,1,5,2
20140311-W-Indian_Wells-R16-Dominika_Cibulkova-Petra_Kvitova,1,B-XC,24,3,1,0,2,19,5
20140311-W-Indian_Wells-R16-Dominika_Cibulkova-Petra_Kvitova,1,B-DTM,22,3,0,0,3,14,8
20140311-W-Indian_Wells-R16-Dominika_Cibulkova-Petra_Kvitova,1,B-DTL,3,3,1,1,1,2,1
20140311-W-Indian_Wells-R16-Dominika_Cibulkova-Petra_Kvitova,1,B-IO,5,1,0,0,1,4,1
20140311-W-Indian_Wells-R16-Dominika_Cibulkova-Petra_Kvitova,1,S-XC,1,0,0,0,0,1,0
20140311-W-Indian_Wells-R16-Dominika_Cibulkova-Petra_Kvitova,1,S-DTM,2,0,0,0,0,0,2
20140311-W-Indian_Wells-R16-Dominika_Cibulkova-Petra_Kvitova,1,S-DTL,1,1,1,0,0,1,0
20140311-W-Indian_Wells-R16-Dominika_Cibulkova-Petra_Kvitova,1,S-IO,1,0,0,0,0,1,0
20140311-W-Indian_Wells-R16-Dominika_Cibulkova-Petra_Kvitova,2,F-XC,30,13,2,1,10,8,22
20140311-W-Indian_Wells-R16-Dominika_Cibulkova-Petra_Kvitova,2,F-DTM,11,3,0,0,3,1,10
20140311-W-Indian_Wells-R16-Dominika_Cibulkova-Petra_Kvitova,2,F-DTL,8,7,2,0,5,2,6
20140311-W-Indian_Wells-R16-Dominika_Cibulkova-Petra_Kvitova,2,F-IO,12,10,1,1,8,3,9
20140311-W-Indian_Wells-R16-Dominika_Cibulkova-Petra_Kvitova,2,F-II,1,0,0,0,0,1,0
20140311-W-Indian_Wells-R16-Dominika_Cibulkova-Petra_Kvitova,2,B-XC,9,6,2,0,4,3,6
20140311-W-Indian_Wells-R16-Dominika_Cibulkova-Petra_Kvitova,2,B-DTM,9,1,0,0,1,2,7
20140311-W-Indian_Wells-R16-Dominika_Cibulkova-Petra_Kvitova,2,B-DTL,4,1,0,0,1,0,4
20140311-W-Indian_Wells-R16-Dominika_Cibulkova-Petra_Kvitova,2,B-IO,3,2,1,0,1,1,2
20140311-W-Indian_Wells-R16-Dominika_Cibulkova-Petra_Kvitova,2,S-XC,1,1,0,0,1,0,1
20140311-W-Indian_Wells-R16-Dominika_Cibulkova-Petra_Kvitova,2,S-DTM,2,0,0,0,0,0,2
20140311-W-Indian_Wells-R16-Dominika_Cibulkova-Petra_Kvitova,2,S-DTL,1,0,0,0,0,1,0
20140311-W-Indian_Wells-R16-Dominika_Cibulkova-Petra_Kvitova,2,S-IO,2,0,0,0,0,1,1
20140314-W-Indian_Wells-SF-Agnieszka_Radwanska-Simona_Halep,1,F-XC,45,6,2,0,4,21,24
20140314-W-Indian_Wells-SF-Agnieszka_Radwanska-Simona_Halep,1,F-DTM,30,2,0,0,2,10,20
20140314-W-Indian_Wells-SF-Agnieszka_Radwanska-Simona_Halep,1,F-DTL,25,3,0,1,2,11,14
20140314-W-Indian_Wells-SF-Agnieszka_Radwanska-Simona_Halep,1,F-IO,26,5,0,2,3,14,12
20140314-W-Indian_Wells-SF-Agnieszka_Radwanska-Simona_Halep,1,B-XC,49,6,0,0,6,19,30
20140314-W-Indian_Wells-SF-Agnieszka_Radwanska-Simona_Halep,1,B-DTM,51,1,0,0,1,16,35
20140314-W-Indian_Wells-SF-Agnieszka_Radwanska-Simona_Halep,1,B-DTL,18,4,1,0,3,8,10
20140314-W-Indian_Wells-SF-Agnieszka_Radwanska-Simona_Halep,1,B-IO,3,0,0,0,0,1,2
20140314-W-Indian_Wells-SF-Agnieszka_Radwanska-Simona_Halep,1,S-XC,6,0,0,0,0,3,3
20140314-W-Indian_Wells-SF-Agnieszka_Radwanska-Simona_Halep,1,S-DTM,8,0,0,0,0,5,3
20140314-W-Indian_Wells-SF-Agnieszka_Radwanska-Simona_Halep,1,S-DTL,4,3,0,0,3,0,4
20140314-W-Indian_Wells-SF-Agnieszka_Radwanska-Simona_Halep,1,S-IO,1,0,0,0,0,0,1
20140314-W-Indian_Wells-SF-Agnieszka_Radwanska-Simona_Halep,2,F-XC,58,7,3,1,3,39,19
20140314-W-Indian_Wells-SF-Agnieszka_Radwanska-Simona_Halep,2,F-DTM,18,4,0,0,4,9,9
20140314-W-Indian_Wells-SF-Agnieszka_Radwanska-Simona_Halep,2,F-DTL,25,9,2,1,6,13,12
20140314-W-Indian_Wells-SF-Agnieszka_Radwanska-Simona_Halep,2,F-IO,32,5,2,0,3,20,12
20140314-W-Indian_Wells-SF-Agnieszka_Radwanska-Simona_Halep,2,F-II,1,1,1,0,0,1,0
20140314-W-Indian_Wells-SF-Agnieszka_Radwanska-Simona_Halep,2,B-XC,70,6,1,1,4,42,28
20140314-W-Indian_Wells-SF-Agnieszka_Radwanska-Simona_Halep,2,B-DTM,32,7,0,0,7,18,14
20140314-W-Indian_Wells-SF-Agnieszka_Radwanska-Simona_Halep,2,B-DTL,29,9,2,0,7,13,16
20140314-W-Indian_Wells-SF-Agnieszka_Radwanska-Simona_Halep,2,B-IO,18,6,3,1,2,12,6
20140314-W-Indian_Wells-SF-Agnieszka_Radwanska-Simona_Halep,2,S-XC,2,2,0,1,1,1,1
20140314-W-Indian_Wells-SF-Agnieszka_Radwanska-Simona_Halep,2,S-DTM,5,0,0,0,0,0,5
20140314-W-Indian_Wells-SF-Agnieszka_Radwanska-Simona_Halep,2,S-DTL,2,0,0,0,0,0,2
20140314-W-Indian_Wells-SF-Agnieszka_Radwanska-Simona_Halep,2,S-IO,1,0,0,0,0,0,1
20140113-W-Australian_Open-R128-Ana_Konjuh-Na_Li,1,F-XC,19,7,2,0,5,10,9
20140113-W-Australian_Open-R128-Ana_Konjuh-Na_Li,1,F-DTM,25,8,0,1,7,13,12
20140113-W-Australian_Open-R128-Ana_Konjuh-Na_Li,1,F-DTL,1,0,0,0,0,1,0
20140113-W-Australian_Open-R128-Ana_Konjuh-Na_Li,1,F-IO,7,3,0,0,3,4,3
20140113-W-Australian_Open-R128-Ana_Konjuh-Na_Li,1,B-XC,10,1,1,0,0,2,8
20140113-W-Australian_Open-R128-Ana_Konjuh-Na_Li,1,B-DTM,19,3,0,0,3,3,16
20140113-W-Australian_Open-R128-Ana_Konjuh-Na_Li,1,B-DTL,1,1,1,0,0,1,0
20140113-W-Australian_Open-R128-Ana_Konjuh-Na_Li,1,B-IO,3,1,0,0,1,0,3
20140113-W-Australian_Open-R128-Ana_Konjuh-Na_Li,1,S-XC,4,0,0,0,0,2,2
20140113-W-Australian_Open-R128-Ana_Konjuh-Na_Li,1,S-DTM,4,0,0,0,0,0,4
20140113-W-Australian_Open-R128-Ana_Konjuh-Na_Li,1,S-DTL,2,0,0,0,0,1,1
20140113-W-Australian_Open-R128-Ana_Konjuh-Na_Li,2,F-XC,24,8,3,1,4,15,9
20140113-W-Australian_Open-R128-Ana_Konjuh-Na_Li,2,F-DTM,17,3,0,0,3,4,13
20140113-W-Australian_Open-R128-Ana_Konjuh-Na_Li,2,F-DTL,7,1,0,0,1,4,3
20140113-W-Australian_Open-R128-Ana_Konjuh-Na_Li,2,F-IO,9,7,5,0,2,7,2
20140113-W-Australian_Open-R128-Ana_Konjuh-Na_Li,2,B-XC,13,5,2,0,3,7,6
20140113-W-Australian_Open-R128-Ana_Konjuh-Na_Li,2,B-DTM,11,1,0,0,1,8,3
20140113-W-Australian_Open-R128-Ana_Konjuh-Na_Li,2,B-DTL,7,3,1,1,1,6,1
20140113-W-Australian_Open-R128-Ana_Konjuh-Na_Li,2,B-IO,5,0,0,0,0,4,1
20140113-W-Australian_Open-R128-Ana_Konjuh-Na_Li,2,S-DTM,1,0,0,0,0,1,0
20141011-W-Osaka-SF-Samantha_Stosur-Elina_Svitolina,1,F-XC,45,9,2,1,6,23,22
20141011-W-Osaka-SF-Samantha_Stosur-Elina_Svitolina,1,F-DTM,19,3,0,0,3,9,10
20141011-W-Osaka-SF-Samantha_Stosur-Elina_Svitolina,1,F-DTL,19,4,3,0,1,10,9
20141011-W-Osaka-SF-Samantha_Stosur-Elina_Svitolina,1,F-IO,31,7,3,2,2,18,13
20141011-W-Osaka-SF-Samantha_Stosur-Elina_Svitolina,1,F-II,8,1,1,0,0,3,5
20141011-W-Osaka-SF-Samantha_Stosur-Elina_Svitolina,1,B-XC,6,0,0,0,0,3,3
20141011-W-Osaka-SF-Samantha_Stosur-Elina_Svitolina,1,B-DTM,7,1,0,0,1,3,4
20141011-W-Osaka-SF-Samantha_Stosur-Elina_Svitolina,1,B-DTL,11,6,0,2,4,3,8
20141011-W-Osaka-SF-Samantha_Stosur-Elina_Svitolina,1,B-IO,3,1,0,0,1,0,3
20141011-W-Osaka-SF-Samantha_Stosur-Elina_Svitolina,1,S-XC,12,2,0,0,2,3,9
20141011-W-Osaka-SF-Samantha_Stosur-Elina_Svitolina,1,S-DTM,14,0,0,0,0,7,7
20141011-W-Osaka-SF-Samantha_Stosur-Elina_Svitolina,1,S-DTL,6,1,0,1,0,2,4
20141011-W-Osaka-SF-Samantha_Stosur-Elina_Svitolina,1,S-IO,1,0,0,0,0,1,0
20141011-W-Osaka-SF-Samantha_Stosur-Elina_Svitolina,2,F-XC,51,9,2,3,4,24,27
20141011-W-Osaka-SF-Samantha_Stosur-Elina_Svitolina,2,F-DTM,31,5,1,1,3,17,14
20141011-W-Osaka-SF-Samantha_Stosur-Elina_Svitolina,2,F-DTL,14,4,1,0,3,8,6
20141011-W-Osaka-SF-Samantha_Stosur-Elina_Svitolina,2,F-IO,19,9,3,0,6,11,8
20141011-W-Osaka-SF-Samantha_Stosur-Elina_Svitolina,2,B-XC,33,6,2,1,3,17,16
20141011-W-Osaka-SF-Samantha_Stosur-Elina_Svitolina,2,B-DTM,18,2,0,1,1,8,10
20141011-W-Osaka-SF-Samantha_Stosur-Elina_Svitolina,2,B-DTL,5,3,2,1,0,4,1
20141011-W-Osaka-SF-Samantha_Stosur-Elina_Svitolina,2,B-IO,1,0,0,0,0,0,1
20141011-W-Osaka-SF-Samantha_Stosur-Elina_Svitolina,2,S-XC,5,1,0,0,1,2,3
20141011-W-Osaka-SF-Samantha_Stosur-Elina_Svitolina,2,S-DTM,1,1,0,0,1,0,1
20141021-W-Singapore-RR-Caroline_Wozniacki-Maria_Sharapova,1,F-XC,49,7,1,3,3,32,17
20141021-W-Singapore-RR-Caroline_Wozniacki-Maria_Sharapova,1,F-DTM,39,4,1,0,3,21,18
20141021-W-Singapore-RR-Caroline_Wozniacki-Maria_Sharapova,1,F-DTL,50,15,3,4,8,28,22
20141021-W-Singapore-RR-Caroline_Wozniacki-Maria_Sharapova,1,F-IO,25,4,1,0,3,13,12
20141021-W-Singapore-RR-Caroline_Wozniacki-Maria_Sharapova,1,B-XC,58,5,0,0,5,26,32
20141021-W-Singapore-RR-Caroline_Wozniacki-Maria_Sharapova,1,B-DTM,42,4,0,1,3,27,15
20141021-W-Singapore-RR-Caroline_Wozniacki-Maria_Sharapova,1,B-DTL,21,10,2,1,7,9,12
20141021-W-Singapore-RR-Caroline_Wozniacki-Maria_Sharapova,1,B-IO,10,4,0,1,3,3,7
20141021-W-Singapore-RR-Caroline_Wozniacki-Maria_Sharapova,1,S-XC,9,2,0,0,2,4,5
20141021-W-Singapore-RR-Caroline_Wozniacki-Maria_Sharapova,1,S-DTM,12,0,0,0,0,6,6
20141021-W-Singapore-RR-Caroline_Wozniacki-Maria_Sharapova,2,F-XC,82,18,2,3,13,36,46
20141021-W-Singapore-RR-Caroline_Wozniacki-Maria_Sharapova,2,F-DTM,22,3,0,0,3,6,16
20141021-W-Singapore-RR-Caroline_Wozniacki-Maria_Sharapova,2,F-DTL,21,10,4,0,6,10,11
20141021-W-Singapore-RR-Caroline_Wozniacki-Maria_Sharapova,2,F-IO,34,15,6,2,7,20,14
20141021-W-Singapore-RR-Caroline_Wozniacki-Maria_Sharapova,2,B-XC,100,22,2,5,15,47,53
20141021-W-Singapore-RR-Caroline_Wozniacki-Maria_Sharapova,2,B-DTM,43,3,0,0,3,21,22
20141021-W-Singapore-RR-Caroline_Wozniacki-Maria_Sharapova,2,B-DTL,27,10,1,1,8,9,18
20141021-W-Singapore-RR-Caroline_Wozniacki-Maria_Sharapova,2,B-IO,11,1,0,0,1,4,7
20141021-W-Singapore-RR-Caroline_Wozniacki-Maria_Sharapova,2,S-DTM,2,0,0,0,0,0,2
20141021-W-Singapore-RR-Caroline_Wozniacki-Maria_Sharapova,2,S-DTL,1,1,0,0,1,0,1
20141021-W-Singapore-RR-Caroline_Wozniacki-Maria_Sharapova,2,S-IO,1,1,0,1,0,1,0
20141023-W-Singapore-RR-Agnieszka_Radwanska-Caroline_Wozniacki,1,F-XC,61,4,2,0,2,29,32
20141023-W-Singapore-RR-Agnieszka_Radwanska-Caroline_Wozniacki,1,F-DTM,29,1,0,0,1,11,18
20141023-W-Singapore-RR-Agnieszka_Radwanska-Caroline_Wozniacki,1,F-DTL,24,7,3,1,3,11,13
20141023-W-Singapore-RR-Agnieszka_Radwanska-Caroline_Wozniacki,1,F-IO,29,6,2,1,3,19,10
20141023-W-Singapore-RR-Agnieszka_Radwanska-Caroline_Wozniacki,1,F-II,1,0,0,0,0,0,1
20141023-W-Singapore-RR-Agnieszka_Radwanska-Caroline_Wozniacki,1,B-XC,62,6,0,1,5,21,41
20141023-W-Singapore-RR-Agnieszka_Radwanska-Caroline_Wozniacki,1,B-DTM,26,1,0,0,1,13,13
20141023-W-Singapore-RR-Agnieszka_Radwanska-Caroline_Wozniacki,1,B-DTL,43,8,2,0,6,18,25
20141023-W-Singapore-RR-Agnieszka_Radwanska-Caroline_Wozniacki,1,B-IO,10,3,0,0,3,3,7
20141023-W-Singapore-RR-Agnieszka_Radwanska-Caroline_Wozniacki,1,S-XC,2,1,0,0,1,1,1
20141023-W-Singapore-RR-Agnieszka_Radwanska-Caroline_Wozniacki,1,S-DTM,10,1,0,0,1,3,7
20141023-W-Singapore-RR-Agnieszka_Radwanska-Caroline_Wozniacki,1,S-DTL,5,1,0,0,1,2,3
20141023-W-Singapore-RR-Agnieszka_Radwanska-Caroline_Wozniacki,2,F-XC,69,4,1,1,2,37,32
20141023-W-Singapore-RR-Agnieszka_Radwanska-Caroline_Wozniacki,2,F-DTM,20,1,0,0,1,12,8
20141023-W-Singapore-RR-Agnieszka_Radwanska-Caroline_Wozniacki,2,F-DTL,44,5,2,1,2,22,22
20141023-W-Singapore-RR-Agnieszka_Radwanska-Caroline_Wozniacki,2,F-IO,25,0,0,0,0,15,10
20141023-W-Singapore-RR-Agnieszka_Radwanska-Caroline_Wozniacki,2,B-XC,66,7,0,2,5,39,27
20141023-W-Singapore-RR-Agnieszka_Radwanska-Caroline_Wozniacki,2,B-DTM,26,0,0,0,0,13,13
20141023-W-Singapore-RR-Agnieszka_Radwanska-Caroline_Wozniacki,2,B-DTL,17,5,1,2,2,10,7
20141023-W-Singapore-RR-Agnieszka_Radwanska-Caroline_Wozniacki,2,B-IO,13,4,0,0,4,7,6
20141023-W-Singapore-RR-Agnieszka_Radwanska-Caroline_Wozniacki,2,S-XC,7,0,0,0,0,2,5
20141023-W-Singapore-RR-Agnieszka_Radwanska-Caroline_Wozniacki,2,S-DTM,7,0,0,0,0,3,4
20141023-W-Singapore-RR-Agnieszka_Radwanska-Caroline_Wozniacki,2,S-DTL,4,0,0,0,0,2,2
20141023-W-Singapore-RR-Agnieszka_Radwanska-Caroline_Wozniacki,2,S-IO,1,0,0,0,0,1,0
20141023-W-Singapore-RR-Agnieszka_Radwanska-Caroline_Wozniacki,2,S-II,1,0,0,0,0,0,1
20141007-W-Linz-R32-Camila_Giorgi-Andrea_Petkovic,1,F-XC,29,8,5,2,1,22,7
20141007-W-Linz-R32-Camila_Giorgi-Andrea_Petkovic,1,F-DTM,23,5,0,2,3,16,7
20141007-W-Linz-R32-Camila_Giorgi-Andrea_Petkovic,1,F-DTL,4,2,1,0,1,2,2
20141007-W-Linz-R32-Camila_Giorgi-Andrea_Petkovic,1,F-IO,9,4,4,0,0,9,0
20141007-W-Linz-R32-Camila_Giorgi-Andrea_Petkovic,1,F-II,2,1,1,0,0,2,0
20141007-W-Linz-R32-Camila_Giorgi-Andrea_Petkovic,1,B-XC,19,2,0,0,2,13,6
20141007-W-Linz-R32-Camila_Giorgi-Andrea_Petkovic,1,B-DTM,12,3,0,1,2,7,5
20141007-W-Linz-R32-Camila_Giorgi-Andrea_Petkovic,1,B-DTL,4,2,0,0,2,2,2
20141007-W-Linz-R32-Camila_Giorgi-Andrea_Petkovic,1,B-IO,4,3,1,0,2,1,3
20141007-W-Linz-R32-Camila_Giorgi-Andrea_Petkovic,1,S-DTM,1,0,0,0,0,0,1
20141007-W-Linz-R32-Camila_Giorgi-Andrea_Petkovic,2,F-XC,26,5,0,1,4,9,17
20141007-W-Linz-R32-Camila_Giorgi-Andrea_Petkovic,2,F-DTM,19,3,0,1,2,4,15
20141007-W-Linz-R32-Camila_Giorgi-Andrea_Petkovic,2,F-DTL,6,3,2,0,1,2,4
20141007-W-Linz-R32-Camila_Giorgi-Andrea_Petkovic,2,F-IO,7,4,0,2,2,2,5
20141007-W-Linz-R32-Camila_Giorgi-Andrea_Petkovic,2,B-XC,13,1,0,0,1,6,7
20141007-W-Linz-R32-Camila_Giorgi-Andrea_Petkovic,2,B-DTM,20,1,0,0,1,4,16
20141007-W-Linz-R32-Camila_Giorgi-Andrea_Petkovic,2,B-DTL,2,0,0,0,0,1,1
20141007-W-Linz-R32-Camila_Giorgi-Andrea_Petkovic,2,B-IO,2,1,1,0,0,1,1
20141007-W-Linz-R32-Camila_Giorgi-Andrea_Petkovic,2,S-XC,2,0,0,0,0,1,1
20141007-W-Linz-R32-Camila_Giorgi-Andrea_Petkovic,2,S-DTM,1,0,0,0,0,0,1
20141007-W-Linz-R32-Camila_Giorgi-Andrea_Petkovic,2,S-DTL,2,0,0,0,0,0,2
20141012-W-Tianjin-F-Belinda_Bencic-Alison_Riske,1,F-XC,61,4,1,0,3,30,31
20141012-W-Tianjin-F-Belinda_Bencic-Alison_Riske,1,F-DTM,26,2,0,0,2,9,17
20141012-W-Tianjin-F-Belinda_Bencic-Alison_Riske,1,F-DTL,7,3,0,1,2,2,5
20141012-W-Tianjin-F-Belinda_Bencic-Alison_Riske,1,F-IO,30,7,1,1,5,18,12
20141012-W-Tianjin-F-Belinda_Bencic-Alison_Riske,1,B-XC,33,3,2,0,1,23,10
20141012-W-Tianjin-F-Belinda_Bencic-Alison_Riske,1,B-DTM,19,3,0,0,3,7,12
20141012-W-Tianjin-F-Belinda_Bencic-Alison_Riske,1,B-DTL,14,3,2,0,1,10,4
20141012-W-Tianjin-F-Belinda_Bencic-Alison_Riske,1,B-IO,19,3,2,0,1,13,6
20141012-W-Tianjin-F-Belinda_Bencic-Alison_Riske,1,S-XC,1,0,0,0,0,1,0
20141012-W-Tianjin-F-Belinda_Bencic-Alison_Riske,1,S-DTM,3,1,1,0,0,1,2
20141012-W-Tianjin-F-Belinda_Bencic-Alison_Riske,1,S-DTL,2,0,0,0,0,1,1
20141012-W-Tianjin-F-Belinda_Bencic-Alison_Riske,2,F-XC,52,7,3,0,4,28,24
20141012-W-Tianjin-F-Belinda_Bencic-Alison_Riske,2,F-DTM,40,3,0,0,3,18,22
20141012-W-Tianjin-F-Belinda_Bencic-Alison_Riske,2,F-DTL,22,4,1,2,1,11,11
20141012-W-Tianjin-F-Belinda_Bencic-Alison_Riske,2,F-IO,8,3,0,1,2,5,3
20141012-W-Tianjin-F-Belinda_Bencic-Alison_Riske,2,B-XC,27,6,4,2,0,16,11
20141012-W-Tianjin-F-Belinda_Bencic-Alison_Riske,2,B-DTM,29,1,0,0,1,10,19
20141012-W-Tianjin-F-Belinda_Bencic-Alison_Riske,2,B-DTL,16,4,1,2,1,9,7
20141012-W-Tianjin-F-Belinda_Bencic-Alison_Riske,2,B-IO,12,4,3,0,1,8,4
20141012-W-Tianjin-F-Belinda_Bencic-Alison_Riske,2,S-XC,3,0,0,0,0,0,3
20141012-W-Tianjin-F-Belinda_Bencic-Alison_Riske,2,S-DTM,5,0,0,0,0,1,4
20140423-W-Stuttgart-R32-Julia_Goerges-Sorana_Cirstea,1,F-XC,30,11,4,2,5,19,11
20140423-W-Stuttgart-R32-Julia_Goerges-Sorana_Cirstea,1,F-DTM,4,1,0,0,1,2,2
20140423-W-Stuttgart-R32-Julia_Goerges-Sorana_Cirstea,1,F-DTL,2,2,2,0,0,2,0
20140423-W-Stuttgart-R32-Julia_Goerges-Sorana_Cirstea,1,F-IO,9,8,6,1,1,7,2
20140423-W-Stuttgart-R32-Julia_Goerges-Sorana_Cirstea,1,F-II,4,3,2,0,1,2,2
20140423-W-Stuttgart-R32-Julia_Goerges-Sorana_Cirstea,1,B-XC,24,7,2,2,3,18,6
20140423-W-Stuttgart-R32-Julia_Goerges-Sorana_Cirstea,1,B-DTM,13,2,0,0,2,8,5
20140423-W-Stuttgart-R32-Julia_Goerges-Sorana_Cirstea,1,B-DTL,7,3,1,0,2,5,2
20140423-W-Stuttgart-R32-Julia_Goerges-Sorana_Cirstea,1,B-IO,3,2,1,1,0,2,1
20140423-W-Stuttgart-R32-Julia_Goerges-Sorana_Cirstea,1,S-XC,1,1,0,1,0,1,0
20140423-W-Stuttgart-R32-Julia_Goerges-Sorana_Cirstea,1,S-DTM,1,0,0,0,0,1,0
20140423-W-Stuttgart-R32-Julia_Goerges-Sorana_Cirstea,2,F-XC,15,4,1,0,3,5,10
20140423-W-Stuttgart-R32-Julia_Goerges-Sorana_Cirstea,2,F-DTM,10,2,0,1,1,1,9
20140423-W-Stuttgart-R32-Julia_Goerges-Sorana_Cirstea,2,F-DTL,13,4,2,0,2,6,7
20140423-W-Stuttgart-R32-Julia_Goerges-Sorana_Cirstea,2,F-IO,8,2,0,0,2,2,6
20140423-W-Stuttgart-R32-Julia_Goerges-Sorana_Cirstea,2,B-XC,17,2,0,0,2,4,13
20140423-W-Stuttgart-R32-Julia_Goerges-Sorana_Cirstea,2,B-DTM,12,3,0,0,3,5,7
20140423-W-Stuttgart-R32-Julia_Goerges-Sorana_Cirstea,2,B-DTL,6,5,1,0,4,1,5
20140423-W-Stuttgart-R32-Julia_Goerges-Sorana_Cirstea,2,B-IO,7,4,2,2,0,6,1
20140423-W-Stuttgart-R32-Julia_Goerges-Sorana_Cirstea,2,S-DTM,1,0,0,0,0,0,1
20141024-W-Singapore-RR-Ana_Ivanovic-Simona_Halep,1,F-XC,49,18,5,3,10,26,23
20141024-W-Singapore-RR-Ana_Ivanovic-Simona_Halep,1,F-DTM,15,3,0,0,3,5,10
20141024-W-Singapore-RR-Ana_Ivanovic-Simona_Halep,1,F-DTL,16,9,4,0,5,8,8
20141024-W-Singapore-RR-Ana_Ivanovic-Simona_Halep,1,F-IO,25,10,5,4,1,22,3
20141024-W-Singapore-RR-Ana_Ivanovic-Simona_Halep,1,F-II,2,0,0,0,0,2,0
20141024-W-Singapore-RR-Ana_Ivanovic-Simona_Halep,1,B-XC,44,7,3,1,3,28,16
20141024-W-Singapore-RR-Ana_Ivanovic-Simona_Halep,1,B-DTM,24,1,1,0,0,12,12
20141024-W-Singapore-RR-Ana_Ivanovic-Simona_Halep,1,B-DTL,11,3,1,0,2,6,5
20141024-W-Singapore-RR-Ana_Ivanovic-Simona_Halep,1,B-IO,3,0,0,0,0,2,1
20141024-W-Singapore-RR-Ana_Ivanovic-Simona_Halep,1,S-XC,8,1,1,0,0,3,5
20141024-W-Singapore-RR-Ana_Ivanovic-Simona_Halep,1,S-DTM,5,0,0,0,0,1,4
20141024-W-Singapore-RR-Ana_Ivanovic-Simona_Halep,1,S-DTL,8,1,0,0,1,4,4
20141024-W-Singapore-RR-Ana_Ivanovic-Simona_Halep,2,F-XC,44,10,2,4,4,27,17
20141024-W-Singapore-RR-Ana_Ivanovic-Simona_Halep,2,F-DTM,12,1,1,0,0,3,9
20141024-W-Singapore-RR-Ana_Ivanovic-Simona_Halep,2,F-DTL,20,4,2,0,2,10,10
20141024-W-Singapore-RR-Ana_Ivanovic-Simona_Halep,2,F-IO,22,7,1,1,5,10,12
20141024-W-Singapore-RR-Ana_Ivanovic-Simona_Halep,2,F-II,3,2,2,0,0,3,0
20141024-W-Singapore-RR-Ana_Ivanovic-Simona_Halep,2,B-XC,55,12,3,1,8,22,33
20141024-W-Singapore-RR-Ana_Ivanovic-Simona_Halep,2,B-DTM,28,6,0,0,6,6,22
20141024-W-Singapore-RR-Ana_Ivanovic-Simona_Halep,2,B-DTL,19,9,3,0,6,9,10
20141024-W-Singapore-RR-Ana_Ivanovic-Simona_Halep,2,B-IO,9,6,3,1,2,5,4
20141024-W-Singapore-RR-Ana_Ivanovic-Simona_Halep,2,S-DTM,5,0,0,0,0,0,5
20141024-W-Singapore-RR-Ana_Ivanovic-Simona_Halep,2,S-DTL,1,0,0,0,0,0,1
20141107-W-Taipei-QF-Vitalia_Diatchenko-Luksika_Kumkhum,1,F-XC,10,4,2,0,2,7,3
20141107-W-Taipei-QF-Vitalia_Diatchenko-Luksika_Kumkhum,1,F-DTM,8,0,0,0,0,6,2
20141107-W-Taipei-QF-Vitalia_Diatchenko-Luksika_Kumkhum,1,F-DTL,10,5,0,0,5,4,6
20141107-W-Taipei-QF-Vitalia_Diatchenko-Luksika_Kumkhum,1,F-IO,6,5,4,0,1,5,1
20141107-W-Taipei-QF-Vitalia_Diatchenko-Luksika_Kumkhum,1,B-XC,20,6,1,1,4,11,9
20141107-W-Taipei-QF-Vitalia_Diatchenko-Luksika_Kumkhum,1,B-DTM,11,2,0,0,2,5,6
20141107-W-Taipei-QF-Vitalia_Diatchenko-Luksika_Kumkhum,1,B-DTL,6,5,2,1,2,3,3
20141107-W-Taipei-QF-Vitalia_Diatchenko-Luksika_Kumkhum,1,B-IO,4,2,1,0,1,3,1
20141107-W-Taipei-QF-Vitalia_Diatchenko-Luksika_Kumkhum,1,S-IO,1,0,0,0,0,1,0
20141107-W-Taipei-QF-Vitalia_Diatchenko-Luksika_Kumkhum,2,F-XC,15,5,0,1,4,7,8
20141107-W-Taipei-QF-Vitalia_Diatchenko-Luksika_Kumkhum,2,F-DTM,7,1,0,0,1,1,6
20141107-W-Taipei-QF-Vitalia_Diatchenko-Luksika_Kumkhum,2,F-DTL,6,2,1,0,1,1,5
20141107-W-Taipei-QF-Vitalia_Diatchenko-Luksika_Kumkhum,2,F-IO,9,4,0,0,4,3,6
20141107-W-Taipei-QF-Vitalia_Diatchenko-Luksika_Kumkhum,2,B-XC,27,11,1,3,7,10,17
20141107-W-Taipei-QF-Vitalia_Diatchenko-Luksika_Kumkhum,2,B-DTM,8,0,0,0,0,2,6
20141107-W-Taipei-QF-Vitalia_Diatchenko-Luksika_Kumkhum,2,B-DTL,6,3,1,0,2,2,4
20141107-W-Taipei-QF-Vitalia_Diatchenko-Luksika_Kumkhum,2,B-IO,1,0,0,0,0,1,0
20141107-W-Taipei-QF-Vitalia_Diatchenko-Luksika_Kumkhum,2,S-DTM,1,0,0,0,0,0,1
20140529-W-Roland_Garros-R64-Marina_Erakovic-Petra_Kvitova,1,F-XC,8,3,1,0,2,5,3
20140529-W-Roland_Garros-R64-Marina_Erakovic-Petra_Kvitova,1,F-DTM,10,1,0,1,0,4,6
20140529-W-Roland_Garros-R64-Marina_Erakovic-Petra_Kvitova,1,F-DTL,4,4,1,0,3,1,3
20140529-W-Roland_Garros-R64-Marina_Erakovic-Petra_Kvitova,1,F-IO,12,6,3,2,1,7,5
20140529-W-Roland_Garros-R64-Marina_Erakovic-Petra_Kvitova,1,B-XC,7,3,0,0,3,3,4
20140529-W-Roland_Garros-R64-Marina_Erakovic-Petra_Kvitova,1,B-DTM,17,2,0,0,2,6,11
20140529-W-Roland_Garros-R64-Marina_Erakovic-Petra_Kvitova,1,B-DTL,4,3,1,1,1,3,1
20140529-W-Roland_Garros-R64-Marina_Erakovic-Petra_Kvitova,1,B-IO,6,2,0,0,2,2,4
20140529-W-Roland_Garros-R64-Marina_Erakovic-Petra_Kvitova,1,B-II,1,0,0,0,0,1,0
20140529-W-Roland_Garros-R64-Marina_Erakovic-Petra_Kvitova,1,S-XC,1,0,0,0,0,1,0
20140529-W-Roland_Garros-R64-Marina_Erakovic-Petra_Kvitova,2,F-XC,22,8,1,2,5,10,12
20140529-W-Roland_Garros-R64-Marina_Erakovic-Petra_Kvitova,2,F-DTM,5,1,0,0,1,3,2
20140529-W-Roland_Garros-R64-Marina_Erakovic-Petra_Kvitova,2,F-DTL,4,4,2,0,2,2,2
20140529-W-Roland_Garros-R64-Marina_Erakovic-Petra_Kvitova,2,F-IO,7,6,2,0,4,2,5
20140529-W-Roland_Garros-R64-Marina_Erakovic-Petra_Kvitova,2,B-XC,16,6,2,1,3,8,8
20140529-W-Roland_Garros-R64-Marina_Erakovic-Petra_Kvitova,2,B-DTM,6,1,0,0,1,3,3
20140529-W-Roland_Garros-R64-Marina_Erakovic-Petra_Kvitova,2,B-DTL,2,1,0,0,1,0,2
20140529-W-Roland_Garros-R64-Marina_Erakovic-Petra_Kvitova,2,B-IO,8,3,0,0,3,4,4
20140529-W-Roland_Garros-R64-Marina_Erakovic-Petra_Kvitova,2,S-IO,1,0,0,0,0,1,0
20140530-W-Roland_Garros-R32-Anna_Karolina_Schmiedlova-Garbine_Muguruza,1,F-XC,46,13,5,2,6,29,17
20140530-W-Roland_Garros-R32-Anna_Karolina_Schmiedlova-Garbine_Muguruza,1,F-DTM,30,1,0,0,1,12,18
20140530-W-Roland_Garros-R32-Anna_Karolina_Schmiedlova-Garbine_Muguruza,1,F-DTL,14,1,1,0,0,9,5
20140530-W-Roland_Garros-R32-Anna_Karolina_Schmiedlova-Garbine_Muguruza,1,F-IO,9,4,0,0,4,0,9
20140530-W-Roland_Garros-R32-Anna_Karolina_Schmiedlova-Garbine_Muguruza,1,B-XC,47,4,0,1,3,17,30
20140530-W-Roland_Garros-R32-Anna_Karolina_Schmiedlova-Garbine_Muguruza,1,B-DTM,27,2,0,0,2,8,19
20140530-W-Roland_Garros-R32-Anna_Karolina_Schmiedlova-Garbine_Muguruza,1,B-DTL,9,3,2,0,1,4,5
20140530-W-Roland_Garros-R32-Anna_Karolina_Schmiedlova-Garbine_Muguruza,1,B-IO,4,2,2,0,0,3,1
20140530-W-Roland_Garros-R32-Anna_Karolina_Schmiedlova-Garbine_Muguruza,1,S-DTM,3,0,0,0,0,0,3
20140530-W-Roland_Garros-R32-Anna_Karolina_Schmiedlova-Garbine_Muguruza,1,S-DTL,1,0,0,0,0,0,1
20140530-W-Roland_Garros-R32-Anna_Karolina_Schmiedlova-Garbine_Muguruza,2,F-XC,51,7,1,1,5,21,30
20140530-W-Roland_Garros-R32-Anna_Karolina_Schmiedlova-Garbine_Muguruza,2,F-DTM,16,0,0,0,0,11,5
20140530-W-Roland_Garros-R32-Anna_Karolina_Schmiedlova-Garbine_Muguruza,2,F-DTL,10,1,0,0,1,3,7
20140530-W-Roland_Garros-R32-Anna_Karolina_Schmiedlova-Garbine_Muguruza,2,F-IO,8,5,3,1,1,7,1
20140530-W-Roland_Garros-R32-Anna_Karolina_Schmiedlova-Garbine_Muguruza,2,B-XC,56,13,4,6,3,39,17
20140530-W-Roland_Garros-R32-Anna_Karolina_Schmiedlova-Garbine_Muguruza,2,B-DTM,35,3,0,1,2,22,13
20140530-W-Roland_Garros-R32-Anna_Karolina_Schmiedlova-Garbine_Muguruza,2,B-DTL,14,7,1,2,4,7,7
20140530-W-Roland_Garros-R32-Anna_Karolina_Schmiedlova-Garbine_Muguruza,2,B-IO,13,3,3,0,0,8,5
20140530-W-Roland_Garros-R32-Anna_Karolina_Schmiedlova-Garbine_Muguruza,2,S-XC,1,0,0,0,0,0,1
20140530-W-Roland_Garros-R32-Anna_Karolina_Schmiedlova-Garbine_Muguruza,2,S-DTM,1,0,0,0,0,0,1
20140530-W-Roland_Garros-R32-Anna_Karolina_Schmiedlova-Garbine_Muguruza,2,S-IO,1,0,0,0,0,1,0
20140619-W-Eastbourne-QF-Madison_Keys-Lauren_Davis,1,F-XC,25,9,2,2,5,17,8
20140619-W-Eastbourne-QF-Madison_Keys-Lauren_Davis,1,F-DTM,10,1,0,0,1,4,6
20140619-W-Eastbourne-QF-Madison_Keys-Lauren_Davis,1,F-DTL,1,1,0,0,1,0,1
20140619-W-Eastbourne-QF-Madison_Keys-Lauren_Davis,1,F-IO,9,5,4,0,1,6,3
20140619-W-Eastbourne-QF-Madison_Keys-Lauren_Davis,1,F-II,1,1,1,0,0,1,0
20140619-W-Eastbourne-QF-Madison_Keys-Lauren_Davis,1,B-XC,19,7,2,2,3,13,6
20140619-W-Eastbourne-QF-Madison_Keys-Lauren_Davis,1,B-DTM,18,2,0,0,2,12,6
20140619-W-Eastbourne-QF-Madison_Keys-Lauren_Davis,1,B-DTL,8,4,3,0,1,5,3
20140619-W-Eastbourne-QF-Madison_Keys-Lauren_Davis,1,B-IO,4,3,2,0,1,2,2
20140619-W-Eastbourne-QF-Madison_Keys-Lauren_Davis,1,S-DTM,3,1,0,0,1,1,2
20140619-W-Eastbourne-QF-Madison_Keys-Lauren_Davis,1,S-IO,2,1,1,0,0,2,0
20140619-W-Eastbourne-QF-Madison_Keys-Lauren_Davis,2,F-XC,24,7,0,2,5,12,12
20140619-W-Eastbourne-QF-Madison_Keys-Lauren_Davis,2,F-DTM,10,3,0,0,3,3,7
20140619-W-Eastbourne-QF-Madison_Keys-Lauren_Davis,2,F-DTL,15,4,1,0,3,5,10
20140619-W-Eastbourne-QF-Madison_Keys-Lauren_Davis,2,F-IO,10,4,1,1,2,4,6
20140619-W-Eastbourne-QF-Madison_Keys-Lauren_Davis,2,B-XC,12,2,0,0,2,4,8
20140619-W-Eastbourne-QF-Madison_Keys-Lauren_Davis,2,B-DTM,18,4,0,0,4,3,15
20140619-W-Eastbourne-QF-Madison_Keys-Lauren_Davis,2,B-DTL,4,4,4,0,0,4,0
20140619-W-Eastbourne-QF-Madison_Keys-Lauren_Davis,2,B-IO,2,1,0,0,1,0,2
20140619-W-Eastbourne-QF-Madison_Keys-Lauren_Davis,2,S-XC,1,0,0,0,0,0,1
20140619-W-Eastbourne-QF-Madison_Keys-Lauren_Davis,2,S-DTM,6,1,0,0,1,2,4
20140619-W-Eastbourne-QF-Madison_Keys-Lauren_Davis,2,S-DTL,2,1,0,0,1,0,2
20140729-W-Stanford-R32-Dominika_Cibulkova-Garbine_Muguruza,1,F-XC,31,13,4,1,8,15,16
20140729-W-Stanford-R32-Dominika_Cibulkova-Garbine_Muguruza,1,F-DTM,36,1,1,0,0,22,14
20140729-W-Stanford-R32-Dominika_Cibulkova-Garbine_Muguruza,1,F-DTL,11,4,1,0,3,5,6
20140729-W-Stanford-R32-Dominika_Cibulkova-Garbine_Muguruza,1,F-IO,21,13,3,2,8,10,11
20140729-W-Stanford-R32-Dominika_Cibulkova-Garbine_Muguruza,1,F-II,2,1,1,0,0,1,1
20140729-W-Stanford-R32-Dominika_Cibulkova-Garbine_Muguruza,1,B-XC,20,5,0,2,3,11,9
20140729-W-Stanford-R32-Dominika_Cibulkova-Garbine_Muguruza,1,B-DTM,23,7,0,1,6,7,16
20140729-W-Stanford-R32-Dominika_Cibulkova-Garbine_Muguruza,1,B-DTL,5,2,0,0,2,3,2
20140729-W-Stanford-R32-Dominika_Cibulkova-Garbine_Muguruza,1,B-IO,8,3,1,0,2,5,3
20140729-W-Stanford-R32-Dominika_Cibulkova-Garbine_Muguruza,1,S-DTM,3,0,0,0,0,0,3
20140729-W-Stanford-R32-Dominika_Cibulkova-Garbine_Muguruza,1,S-DTL,1,0,0,0,0,0,1
20140729-W-Stanford-R32-Dominika_Cibulkova-Garbine_Muguruza,2,F-XC,27,8,3,2,3,15,12
20140729-W-Stanford-R32-Dominika_Cibulkova-Garbine_Muguruza,2,F-DTM,31,5,0,0,5,11,20
20140729-W-Stanford-R32-Dominika_Cibulkova-Garbine_Muguruza,2,F-DTL,9,6,3,0,3,6,3
20140729-W-Stanford-R32-Dominika_Cibulkova-Garbine_Muguruza,2,F-IO,12,5,2,2,1,10,2
20140729-W-Stanford-R32-Dominika_Cibulkova-Garbine_Muguruza,2,B-XC,25,7,3,0,4,9,16
20140729-W-Stanford-R32-Dominika_Cibulkova-Garbine_Muguruza,2,B-DTM,37,8,0,0,8,12,25
20140729-W-Stanford-R32-Dominika_Cibulkova-Garbine_Muguruza,2,B-DTL,6,3,3,0,0,5,1
20140729-W-Stanford-R32-Dominika_Cibulkova-Garbine_Muguruza,2,B-IO,12,7,2,0,5,5,7
20140729-W-Stanford-R32-Dominika_Cibulkova-Garbine_Muguruza,2,S-XC,1,0,0,0,0,1,0
20140729-W-Stanford-R32-Dominika_Cibulkova-Garbine_Muguruza,2,S-DTM,2,0,0,0,0,0,2
20140813-W-Cincinnati-R32-Petra_Kvitova-Elina_Svitolina,1,F-XC,40,15,5,2,8,20,20
20140813-W-Cincinnati-R32-Petra_Kvitova-Elina_Svitolina,1,F-DTM,13,2,0,0,2,5,8
20140813-W-Cincinnati-R32-Petra_Kvitova-Elina_Svitolina,1,F-DTL,12,4,1,0,3,4,8
20140813-W-Cincinnati-R32-Petra_Kvitova-Elina_Svitolina,1,F-IO,26,13,6,3,4,16,10
20140813-W-Cincinnati-R32-Petra_Kvitova-Elina_Svitolina,1,F-II,1,1,1,0,0,1,0
20140813-W-Cincinnati-R32-Petra_Kvitova-Elina_Svitolina,1,B-XC,27,10,2,0,8,8,19
20140813-W-Cincinnati-R32-Petra_Kvitova-Elina_Svitolina,1,B-DTM,18,7,0,1,6,6,12
20140813-W-Cincinnati-R32-Petra_Kvitova-Elina_Svitolina,1,B-DTL,3,2,2,0,0,2,1
20140813-W-Cincinnati-R32-Petra_Kvitova-Elina_Svitolina,1,B-IO,4,2,0,0,2,1,3
20140813-W-Cincinnati-R32-Petra_Kvitova-Elina_Svitolina,1,S-XC,1,0,0,0,0,0,1
20140813-W-Cincinnati-R32-Petra_Kvitova-Elina_Svitolina,1,S-DTM,2,0,0,0,0,0,2
20140813-W-Cincinnati-R32-Petra_Kvitova-Elina_Svitolina,2,F-XC,24,5,1,2,2,13,11
20140813-W-Cincinnati-R32-Petra_Kvitova-Elina_Svitolina,2,F-DTM,19,1,0,0,1,11,8
20140813-W-Cincinnati-R32-Petra_Kvitova-Elina_Svitolina,2,F-DTL,8,2,1,1,0,5,3
20140813-W-Cincinnati-R32-Petra_Kvitova-Elina_Svitolina,2,F-IO,12,2,1,0,1,6,6
20140813-W-Cincinnati-R32-Petra_Kvitova-Elina_Svitolina,2,B-XC,11,0,0,0,0,8,3
20140813-W-Cincinnati-R32-Petra_Kvitova-Elina_Svitolina,2,B-DTM,28,0,0,0,0,14,14
20140813-W-Cincinnati-R32-Petra_Kvitova-Elina_Svitolina,2,B-DTL,3,0,0,0,0,1,2
20140813-W-Cincinnati-R32-Petra_Kvitova-Elina_Svitolina,2,B-IO,3,1,1,0,0,2,1
20140813-W-Cincinnati-R32-Petra_Kvitova-Elina_Svitolina,2,S-DTM,4,0,0,0,0,3,1
20140813-W-Cincinnati-R32-Petra_Kvitova-Elina_Svitolina,2,S-DTL,2,0,0,0,0,1,1
20140828-W-US_Open-R64-Zarina_Diyas-Catherine_Cartan_Bellis,1,F-XC,54,11,5,2,4,32,22
20140828-W-US_Open-R64-Zarina_Diyas-Catherine_Cartan_Bellis,1,F-DTM,69,6,0,0,6,44,25
20140828-W-US_Open-R64-Zarina_Diyas-Catherine_Cartan_Bellis,1,F-DTL,21,4,0,1,3,12,9
20140828-W-US_Open-R64-Zarina_Diyas-Catherine_Cartan_Bellis,1,F-IO,48,10,3,1,6,29,19
20140828-W-US_Open-R64-Zarina_Diyas-Catherine_Cartan_Bellis,1,B-XC,68,6,3,1,2,45,23
20140828-W-US_Open-R64-Zarina_Diyas-Catherine_Cartan_Bellis,1,B-DTM,61,2,0,0,2,29,32
20140828-W-US_Open-R64-Zarina_Diyas-Catherine_Cartan_Bellis,1,B-DTL,9,2,2,0,0,6,3
20140828-W-US_Open-R64-Zarina_Diyas-Catherine_Cartan_Bellis,1,B-IO,19,7,0,1,6,10,9
20140828-W-US_Open-R64-Zarina_Diyas-Catherine_Cartan_Bellis,1,S-XC,2,0,0,0,0,1,1
20140828-W-US_Open-R64-Zarina_Diyas-Catherine_Cartan_Bellis,1,S-DTM,6,0,0,0,0,2,4
20140828-W-US_Open-R64-Zarina_Diyas-Catherine_Cartan_Bellis,2,F-XC,64,11,1,6,4,36,28
20140828-W-US_Open-R64-Zarina_Diyas-Catherine_Cartan_Bellis,2,F-DTM,62,5,0,2,3,28,34
20140828-W-US_Open-R64-Zarina_Diyas-Catherine_Cartan_Bellis,2,F-DTL,11,2,0,0,2,5,6
20140828-W-US_Open-R64-Zarina_Diyas-Catherine_Cartan_Bellis,2,F-IO,35,16,8,2,6,18,17
20140828-W-US_Open-R64-Zarina_Diyas-Catherine_Cartan_Bellis,2,B-XC,49,13,1,1,11,21,28
20140828-W-US_Open-R64-Zarina_Diyas-Catherine_Cartan_Bellis,2,B-DTM,75,7,0,0,7,23,52
20140828-W-US_Open-R64-Zarina_Diyas-Catherine_Cartan_Bellis,2,B-DTL,14,6,1,1,4,4,10
20140828-W-US_Open-R64-Zarina_Diyas-Catherine_Cartan_Bellis,2,B-IO,18,8,2,0,6,6,12
20140828-W-US_Open-R64-Zarina_Diyas-Catherine_Cartan_Bellis,2,S-XC,8,1,0,0,1,0,8
20140828-W-US_Open-R64-Zarina_Diyas-Catherine_Cartan_Bellis,2,S-DTM,14,0,0,0,0,4,10
20140828-W-US_Open-R64-Zarina_Diyas-Catherine_Cartan_Bellis,2,S-DTL,1,1,0,0,1,0,1
20140828-W-US_Open-R64-Zarina_Diyas-Catherine_Cartan_Bellis,2,S-IO,1,1,0,0,1,0,1
20120225-W-Dubai-F-Julia_Goerges-Agnieszka_Radwanska,1,F-XC,48,12,5,2,5,19,29
20120225-W-Dubai-F-Julia_Goerges-Agnieszka_Radwanska,1,F-DTM,18,2,0,0,2,4,14
20120225-W-Dubai-F-Julia_Goerges-Agnieszka_Radwanska,1,F-DTL,23,11,3,0,8,11,12
20120225-W-Dubai-F-Julia_Goerges-Agnieszka_Radwanska,1,F-IO,45,23,10,1,12,22,23
20120225-W-Dubai-F-Julia_Goerges-Agnieszka_Radwanska,1,F-II,1,1,1,0,0,1,0
20120225-W-Dubai-F-Julia_Goerges-Agnieszka_Radwanska,1,B-XC,44,6,0,1,5,18,26
20120225-W-Dubai-F-Julia_Goerges-Agnieszka_Radwanska,1,B-DTM,52,4,0,0,4,20,32
20120225-W-Dubai-F-Julia_Goerges-Agnieszka_Radwanska,1,B-DTL,18,10,4,1,5,6,12
20120225-W-Dubai-F-Julia_Goerges-Agnieszka_Radwanska,1,B-IO,6,1,0,0,1,5,1
20120225-W-Dubai-F-Julia_Goerges-Agnieszka_Radwanska,1,S-DTM,1,0,0,0,0,1,0
20120225-W-Dubai-F-Julia_Goerges-Agnieszka_Radwanska,2,F-XC,35,4,1,1,2,23,12
20120225-W-Dubai-F-Julia_Goerges-Agnieszka_Radwanska,2,F-DTM,32,1,0,0,1,20,12
20120225-W-Dubai-F-Julia_Goerges-Agnieszka_Radwanska,2,F-DTL,10,3,0,1,2,6,4
20120225-W-Dubai-F-Julia_Goerges-Agnieszka_Radwanska,2,F-IO,26,6,3,1,2,17,9
20120225-W-Dubai-F-Julia_Goerges-Agnieszka_Radwanska,2,B-XC,45,1,0,0,1,24,21
20120225-W-Dubai-F-Julia_Goerges-Agnieszka_Radwanska,2,B-DTM,40,3,0,0,3,20,20
20120225-W-Dubai-F-Julia_Goerges-Agnieszka_Radwanska,2,B-DTL,9,2,2,0,0,6,3
20120225-W-Dubai-F-Julia_Goerges-Agnieszka_Radwanska,2,B-IO,12,4,2,0,2,9,3
20120225-W-Dubai-F-Julia_Goerges-Agnieszka_Radwanska,2,S-XC,5,1,1,0,0,3,2
20120225-W-Dubai-F-Julia_Goerges-Agnieszka_Radwanska,2,S-DTM,8,1,0,1,0,4,4
20120225-W-Dubai-F-Julia_Goerges-Agnieszka_Radwanska,2,S-DTL,2,0,0,0,0,1,1
20120225-W-Dubai-F-Julia_Goerges-Agnieszka_Radwanska,2,S-IO,1,0,0,0,0,1,0
20140113-W-Australian_Open-R64-Alla_Kudryavtseva-Angelique_Kerber,1,F-XC,25,9,5,0,4,12,13
20140113-W-Australian_Open-R64-Alla_Kudryavtseva-Angelique_Kerber,1,F-DTM,1,0,0,0,0,0,1
20140113-W-Australian_Open-R64-Alla_Kudryavtseva-Angelique_Kerber,1,F-DTL,8,3,2,0,1,6,2
20140113-W-Australian_Open-R64-Alla_Kudryavtseva-Angelique_Kerber,1,F-IO,15,8,2,2,4,7,8
20140113-W-Australian_Open-R64-Alla_Kudryavtseva-Angelique_Kerber,1,F-II,2,0,0,0,0,1,1
20140113-W-Australian_Open-R64-Alla_Kudryavtseva-Angelique_Kerber,1,B-XC,30,4,1,2,1,11,19
20140113-W-Australian_Open-R64-Alla_Kudryavtseva-Angelique_Kerber,1,B-DTM,8,1,0,0,1,2,6
20140113-W-Australian_Open-R64-Alla_Kudryavtseva-Angelique_Kerber,1,B-DTL,14,9,4,0,5,7,7
20140113-W-Australian_Open-R64-Alla_Kudryavtseva-Angelique_Kerber,1,B-IO,1,1,0,0,1,0,1
20140113-W-Australian_Open-R64-Alla_Kudryavtseva-Angelique_Kerber,2,F-XC,35,4,2,2,0,23,12
20140113-W-Australian_Open-R64-Alla_Kudryavtseva-Angelique_Kerber,2,F-DTM,6,0,0,0,0,2,4
20140113-W-Australian_Open-R64-Alla_Kudryavtseva-Angelique_Kerber,2,F-DTL,17,11,5,3,3,12,5
20140113-W-Australian_Open-R64-Alla_Kudryavtseva-Angelique_Kerber,2,F-IO,7,5,2,1,2,4,3
20140113-W-Australian_Open-R64-Alla_Kudryavtseva-Angelique_Kerber,2,B-XC,15,5,1,1,3,9,6
20140113-W-Australian_Open-R64-Alla_Kudryavtseva-Angelique_Kerber,2,B-DTM,5,0,0,0,0,3,2
20140113-W-Australian_Open-R64-Alla_Kudryavtseva-Angelique_Kerber,2,B-DTL,3,1,0,0,1,2,1
20140113-W-Australian_Open-R64-Alla_Kudryavtseva-Angelique_Kerber,2,B-IO,2,1,1,0,0,1,1
20140113-W-Australian_Open-R64-Alla_Kudryavtseva-Angelique_Kerber,2,B-II,1,1,1,0,0,1,0
20140113-W-Australian_Open-R64-Alla_Kudryavtseva-Angelique_Kerber,2,S-XC,1,0,0,0,0,0,1
20140113-W-Australian_Open-R64-Alla_Kudryavtseva-Angelique_Kerber,2,S-DTM,2,0,0,0,0,2,0
20130107-W-Hobart-R32-Timea_Babos-Klara_Koukalova,1,F-XC,48,15,1,1,13,15,33
20130107-W-Hobart-R32-Timea_Babos-Klara_Koukalova,1,F-DTM,18,4,0,0,4,7,11
20130107-W-Hobart-R32-Timea_Babos-Klara_Koukalova,1,F-DTL,9,5,1,2,2,5,4
20130107-W-Hobart-R32-Timea_Babos-Klara_Koukalova,1,F-IO,6,4,2,1,1,4,2
20130107-W-Hobart-R32-Timea_Babos-Klara_Koukalova,1,F-II,1,0,0,0,0,0,1
20130107-W-Hobart-R32-Timea_Babos-Klara_Koukalova,1,B-XC,30,4,1,0,3,20,10
20130107-W-Hobart-R32-Timea_Babos-Klara_Koukalova,1,B-DTM,19,4,0,0,4,6,13
20130107-W-Hobart-R32-Timea_Babos-Klara_Koukalova,1,B-DTL,6,1,1,0,0,4,2
20130107-W-Hobart-R32-Timea_Babos-Klara_Koukalova,1,B-IO,4,1,0,0,1,2,2
20130107-W-Hobart-R32-Timea_Babos-Klara_Koukalova,1,S-XC,2,1,0,0,1,0,2
20130107-W-Hobart-R32-Timea_Babos-Klara_Koukalova,1,S-DTM,2,0,0,0,0,0,2
20130107-W-Hobart-R32-Timea_Babos-Klara_Koukalova,1,S-IO,1,0,0,0,0,1,0
20130107-W-Hobart-R32-Timea_Babos-Klara_Koukalova,2,F-XC,49,8,3,3,2,34,15
20130107-W-Hobart-R32-Timea_Babos-Klara_Koukalova,2,F-DTM,26,4,0,0,4,6,20
20130107-W-Hobart-R32-Timea_Babos-Klara_Koukalova,2,F-DTL,9,5,0,1,3,4,5
20130107-W-Hobart-R32-Timea_Babos-Klara_Koukalova,2,F-IO,5,1,0,1,0,3,2
20130107-W-Hobart-R32-Timea_Babos-Klara_Koukalova,2,F-II,1,0,0,0,0,1,0
20130107-W-Hobart-R32-Timea_Babos-Klara_Koukalova,2,B-XC,30,10,2,0,8,13,17
20130107-W-Hobart-R32-Timea_Babos-Klara_Koukalova,2,B-DTM,16,4,0,1,3,7,9
20130107-W-Hobart-R32-Timea_Babos-Klara_Koukalova,2,B-DTL,4,2,2,0,0,4,0
20130107-W-Hobart-R32-Timea_Babos-Klara_Koukalova,2,B-IO,5,2,0,0,2,3,2
20130107-W-Hobart-R32-Timea_Babos-Klara_Koukalova,2,B-II,1,0,0,0,0,0,1
20130107-W-Hobart-R32-Timea_Babos-Klara_Koukalova,2,S-XC,4,0,0,0,0,2,2
20130107-W-Hobart-R32-Timea_Babos-Klara_Koukalova,2,S-DTM,5,0,0,0,0,0,5
20120723-W-Baku-R32-Qiang_Wang-Mandy_Minella,1,F-XC,102,17,7,0,10,52,50
20120723-W-Baku-R32-Qiang_Wang-Mandy_Minella,1,F-DTM,32,2,0,0,2,17,15
20120723-W-Baku-R32-Qiang_Wang-Mandy_Minella,1,F-DTL,27,11,2,1,8,11,16
20120723-W-Baku-R32-Qiang_Wang-Mandy_Minella,1,F-IO,39,8,4,0,4,25,14
20120723-W-Baku-R32-Qiang_Wang-Mandy_Minella,1,B-XC,78,17,3,1,13,36,42
20120723-W-Baku-R32-Qiang_Wang-Mandy_Minella,1,B-DTM,38,10,0,1,9,13,25
20120723-W-Baku-R32-Qiang_Wang-Mandy_Minella,1,B-DTL,43,14,4,1,9,24,19
20120723-W-Baku-R32-Qiang_Wang-Mandy_Minella,1,B-IO,23,8,1,1,6,9,14
20120723-W-Baku-R32-Qiang_Wang-Mandy_Minella,1,S-XC,1,0,0,0,0,1,0
20120723-W-Baku-R32-Qiang_Wang-Mandy_Minella,1,S-DTM,2,0,0,0,0,2,0
20120723-W-Baku-R32-Qiang_Wang-Mandy_Minella,2,F-XC,110,23,4,2,17,49,61
20120723-W-Baku-R32-Qiang_Wang-Mandy_Minella,2,F-DTM,36,2,0,0,2,17,19
20120723-W-Baku-R32-Qiang_Wang-Mandy_Minella,2,F-DTL,38,8,1,0,7,21,17
20120723-W-Baku-R32-Qiang_Wang-Mandy_Minella,2,F-IO,28,10,4,3,3,12,16
20120723-W-Baku-R32-Qiang_Wang-Mandy_Minella,2,F-II,4,2,0,1,1,3,1
20120723-W-Baku-R32-Qiang_Wang-Mandy_Minella,2,B-XC,66,8,0,0,8,29,37
20120723-W-Baku-R32-Qiang_Wang-Mandy_Minella,2,B-DTM,42,5,0,0,5,22,20
20120723-W-Baku-R32-Qiang_Wang-Mandy_Minella,2,B-DTL,6,2,0,0,2,2,4
20120723-W-Baku-R32-Qiang_Wang-Mandy_Minella,2,B-IO,4,0,0,0,0,3,1
20120723-W-Baku-R32-Qiang_Wang-Mandy_Minella,2,S-XC,16,0,0,0,0,9,7
20120723-W-Baku-R32-Qiang_Wang-Mandy_Minella,2,S-DTM,12,0,0,0,0,6,6
20120723-W-Baku-R32-Qiang_Wang-Mandy_Minella,2,S-DTL,4,1,0,0,1,0,4
20120723-W-Baku-R32-Qiang_Wang-Mandy_Minella,2,S-IO,1,0,0,0,0,1,0
20141006-W-Linz-SF-Anna_Lena_Friedsam-Karolina_Pliskova,1,F-XC,56,11,5,1,5,30,26
20141006-W-Linz-SF-Anna_Lena_Friedsam-Karolina_Pliskova,1,F-DTM,34,2,0,0,2,15,19
20141006-W-Linz-SF-Anna_Lena_Friedsam-Karolina_Pliskova,1,F-DTL,25,8,2,0,6,14,11
20141006-W-Linz-SF-Anna_Lena_Friedsam-Karolina_Pliskova,1,F-IO,26,5,2,1,2,17,9
20141006-W-Linz-SF-Anna_Lena_Friedsam-Karolina_Pliskova,1,B-XC,31,7,2,3,2,21,10
20141006-W-Linz-SF-Anna_Lena_Friedsam-Karolina_Pliskova,1,B-DTM,32,4,1,1,2,15,17
20141006-W-Linz-SF-Anna_Lena_Friedsam-Karolina_Pliskova,1,B-DTL,7,4,3,1,0,7,0
20141006-W-Linz-SF-Anna_Lena_Friedsam-Karolina_Pliskova,1,B-IO,7,2,1,1,0,5,2
20141006-W-Linz-SF-Anna_Lena_Friedsam-Karolina_Pliskova,1,B-II,1,0,0,0,0,0,1
20141006-W-Linz-SF-Anna_Lena_Friedsam-Karolina_Pliskova,1,S-XC,16,2,0,0,2,7,9
20141006-W-Linz-SF-Anna_Lena_Friedsam-Karolina_Pliskova,1,S-DTM,6,1,0,0,1,2,4
20141006-W-Linz-SF-Anna_Lena_Friedsam-Karolina_Pliskova,1,S-DTL,1,1,1,0,0,1,0
20141006-W-Linz-SF-Anna_Lena_Friedsam-Karolina_Pliskova,1,S-II,1,0,0,0,0,0,1
20141006-W-Linz-SF-Anna_Lena_Friedsam-Karolina_Pliskova,2,F-XC,69,13,2,3,8,37,32
20141006-W-Linz-SF-Anna_Lena_Friedsam-Karolina_Pliskova,2,F-DTM,13,2,0,0,2,3,10
20141006-W-Linz-SF-Anna_Lena_Friedsam-Karolina_Pliskova,2,F-DTL,11,4,2,0,2,6,5
20141006-W-Linz-SF-Anna_Lena_Friedsam-Karolina_Pliskova,2,F-IO,21,10,5,3,2,15,6
20141006-W-Linz-SF-Anna_Lena_Friedsam-Karolina_Pliskova,2,F-II,1,0,0,0,0,1,0
20141006-W-Linz-SF-Anna_Lena_Friedsam-Karolina_Pliskova,2,B-XC,39,9,1,3,5,16,23
20141006-W-Linz-SF-Anna_Lena_Friedsam-Karolina_Pliskova,2,B-DTM,29,1,0,0,1,17,12
20141006-W-Linz-SF-Anna_Lena_Friedsam-Karolina_Pliskova,2,B-DTL,17,4,2,0,2,6,11
20141006-W-Linz-SF-Anna_Lena_Friedsam-Karolina_Pliskova,2,B-IO,9,4,0,1,3,1,8
20141006-W-Linz-SF-Anna_Lena_Friedsam-Karolina_Pliskova,2,B-II,1,0,0,0,0,1,0
20141006-W-Linz-SF-Anna_Lena_Friedsam-Karolina_Pliskova,2,S-XC,10,2,0,0,2,0,10
20141006-W-Linz-SF-Anna_Lena_Friedsam-Karolina_Pliskova,2,S-DTM,7,0,0,0,0,5,2
20141006-W-Linz-SF-Anna_Lena_Friedsam-Karolina_Pliskova,2,S-DTL,6,1,0,0,1,2,4
20141006-W-Linz-SF-Anna_Lena_Friedsam-Karolina_Pliskova,2,S-IO,2,0,0,0,0,1,1
20140908-W-Quebec_City-F-Mirjana_Lucic-Venus_Williams,1,F-XC,28,10,3,4,3,17,11
20140908-W-Quebec_City-F-Mirjana_Lucic-Venus_Williams,1,F-DTM,13,2,0,0,2,3,10
20140908-W-Quebec_City-F-Mirjana_Lucic-Venus_Williams,1,F-DTL,6,3,1,0,2,4,2
20140908-W-Quebec_City-F-Mirjana_Lucic-Venus_Williams,1,F-IO,8,4,2,0,2,6,2
20140908-W-Quebec_City-F-Mirjana_Lucic-Venus_Williams,1,B-XC,32,12,2,1,9,13,19
20140908-W-Quebec_City-F-Mirjana_Lucic-Venus_Williams,1,B-DTM,16,2,0,0,2,6,10
20140908-W-Quebec_City-F-Mirjana_Lucic-Venus_Williams,1,B-DTL,4,0,0,0,0,4,0
20140908-W-Quebec_City-F-Mirjana_Lucic-Venus_Williams,1,B-IO,9,6,3,1,2,6,3
20140908-W-Quebec_City-F-Mirjana_Lucic-Venus_Williams,1,S-XC,2,0,0,0,0,1,1
20140908-W-Quebec_City-F-Mirjana_Lucic-Venus_Williams,2,F-XC,23,9,2,1,6,8,15
20140908-W-Quebec_City-F-Mirjana_Lucic-Venus_Williams,2,F-DTM,19,1,0,0,1,12,7
20140908-W-Quebec_City-F-Mirjana_Lucic-Venus_Williams,2,F-DTL,10,4,1,0,3,3,7
20140908-W-Quebec_City-F-Mirjana_Lucic-Venus_Williams,2,F-IO,11,4,1,0,3,7,4
20140908-W-Quebec_City-F-Mirjana_Lucic-Venus_Williams,2,B-XC,21,8,1,0,7,7,14
20140908-W-Quebec_City-F-Mirjana_Lucic-Venus_Williams,2,B-DTM,21,2,0,0,2,9,12
20140908-W-Quebec_City-F-Mirjana_Lucic-Venus_Williams,2,B-DTL,4,3,1,0,2,2,2
20140908-W-Quebec_City-F-Mirjana_Lucic-Venus_Williams,2,B-IO,1,1,0,0,1,0,1
20140908-W-Quebec_City-F-Mirjana_Lucic-Venus_Williams,2,S-XC,1,0,0,0,0,0,1
20140908-W-Quebec_City-F-Mirjana_Lucic-Venus_Williams,2,S-DTM,2,0,0,0,0,1,1
20130715-W-Bastad-F-Serena_Williams-Johanna_Larsson,1,F-XC,51,9,3,0,6,34,17
20130715-W-Bastad-F-Serena_Williams-Johanna_Larsson,1,F-DTM,17,2,0,0,2,8,9
20130715-W-Bastad-F-Serena_Williams-Johanna_Larsson,1,F-DTL,20,8,3,0,5,14,6
20130715-W-Bastad-F-Serena_Williams-Johanna_Larsson,1,F-IO,15,9,3,3,3,9,6
20130715-W-Bastad-F-Serena_Williams-Johanna_Larsson,1,F-II,1,1,1,0,0,1,0
20130715-W-Bastad-F-Serena_Williams-Johanna_Larsson,1,B-XC,33,10,2,1,7,15,18
20130715-W-Bastad-F-Serena_Williams-Johanna_Larsson,1,B-DTM,15,0,0,0,0,11,4
20130715-W-Bastad-F-Serena_Williams-Johanna_Larsson,1,B-DTL,16,8,5,0,3,12,4
20130715-W-Bastad-F-Serena_Williams-Johanna_Larsson,1,B-IO,8,2,1,0,1,4,4
20130715-W-Bastad-F-Serena_Williams-Johanna_Larsson,1,S-XC,1,0,0,0,0,1,0
20130715-W-Bastad-F-Serena_Williams-Johanna_Larsson,1,S-DTM,1,0,0,0,0,0,1
20130715-W-Bastad-F-Serena_Williams-Johanna_Larsson,1,S-DTL,1,0,0,0,0,0,1
20130715-W-Bastad-F-Serena_Williams-Johanna_Larsson,1,S-IO,1,0,0,0,0,0,1
20130715-W-Bastad-F-Serena_Williams-Johanna_Larsson,2,F-XC,52,11,0,1,10,14,38
20130715-W-Bastad-F-Serena_Williams-Johanna_Larsson,2,F-DTM,16,1,0,0,1,5,11
20130715-W-Bastad-F-Serena_Williams-Johanna_Larsson,2,F-DTL,15,6,3,0,3,7,8
20130715-W-Bastad-F-Serena_Williams-Johanna_Larsson,2,F-IO,9,1,1,0,0,3,6
20130715-W-Bastad-F-Serena_Williams-Johanna_Larsson,2,F-II,3,0,0,0,0,2,1
20130715-W-Bastad-F-Serena_Williams-Johanna_Larsson,2,B-XC,22,1,0,0,1,10,12
20130715-W-Bastad-F-Serena_Williams-Johanna_Larsson,2,B-DTM,16,0,0,0,0,7,9
20130715-W-Bastad-F-Serena_Williams-Johanna_Larsson,2,B-DTL,12,2,0,0,2,3,9
20130715-W-Bastad-F-Serena_Williams-Johanna_Larsson,2,B-IO,3,0,0,0,0,0,3
20130715-W-Bastad-F-Serena_Williams-Johanna_Larsson,2,S-XC,3,0,0,0,0,2,1
20130715-W-Bastad-F-Serena_Williams-Johanna_Larsson,2,S-DTM,6,0,0,0,0,2,4
20130819-W-New_Haven-F-Petra_Kvitova-Simona_Halep,1,F-XC,22,10,2,1,7,5,17
20130819-W-New_Haven-F-Petra_Kvitova-Simona_Halep,1,F-DTM,11,1,0,0,1,0,11
20130819-W-New_Haven-F-Petra_Kvitova-Simona_Halep,1,F-DTL,6,2,1,0,1,1,5
20130819-W-New_Haven-F-Petra_Kvitova-Simona_Halep,1,F-IO,10,5,2,1,2,5,5
20130819-W-New_Haven-F-Petra_Kvitova-Simona_Halep,1,F-II,2,0,0,0,0,0,2
20130819-W-New_Haven-F-Petra_Kvitova-Simona_Halep,1,B-XC,22,7,1,1,5,4,18
20130819-W-New_Haven-F-Petra_Kvitova-Simona_Halep,1,B-DTM,11,0,0,0,0,1,10
20130819-W-New_Haven-F-Petra_Kvitova-Simona_Halep,1,B-DTL,5,2,0,1,1,1,4
20130819-W-New_Haven-F-Petra_Kvitova-Simona_Halep,1,B-IO,8,2,1,1,0,4,4
20130819-W-New_Haven-F-Petra_Kvitova-Simona_Halep,1,B-II,1,1,1,0,0,1,0
20130819-W-New_Haven-F-Petra_Kvitova-Simona_Halep,1,S-XC,2,0,0,0,0,1,1
20130819-W-New_Haven-F-Petra_Kvitova-Simona_Halep,1,S-IO,1,0,0,0,0,0,1
20130819-W-New_Haven-F-Petra_Kvitova-Simona_Halep,2,F-XC,16,2,2,0,0,15,1
20130819-W-New_Haven-F-Petra_Kvitova-Simona_Halep,2,F-DTM,14,0,0,0,0,11,3
20130819-W-New_Haven-F-Petra_Kvitova-Simona_Halep,2,F-DTL,11,6,2,2,2,9,2
20130819-W-New_Haven-F-Petra_Kvitova-Simona_Halep,2,F-IO,10,5,4,1,0,9,1
20130819-W-New_Haven-F-Petra_Kvitova-Simona_Halep,2,F-II,1,0,0,0,0,1,0
20130819-W-New_Haven-F-Petra_Kvitova-Simona_Halep,2,B-XC,12,5,2,3,0,11,1
20130819-W-New_Haven-F-Petra_Kvitova-Simona_Halep,2,B-DTM,16,0,0,0,0,13,3
20130819-W-New_Haven-F-Petra_Kvitova-Simona_Halep,2,B-DTL,9,3,2,0,1,8,1
20130819-W-New_Haven-F-Petra_Kvitova-Simona_Halep,2,B-IO,4,2,0,0,2,1,3
20140918-W-Tokyo-R16-Caroline_Wozniacki-Jarmila_Gajdosova,1,F-XC,64,11,5,1,5,37,27
20140918-W-Tokyo-R16-Caroline_Wozniacki-Jarmila_Gajdosova,1,F-DTM,40,1,0,0,1,19,21
20140918-W-Tokyo-R16-Caroline_Wozniacki-Jarmila_Gajdosova,1,F-DTL,27,11,4,3,4,18,9
20140918-W-Tokyo-R16-Caroline_Wozniacki-Jarmila_Gajdosova,1,F-IO,22,3,0,0,3,12,10
20140918-W-Tokyo-R16-Caroline_Wozniacki-Jarmila_Gajdosova,1,B-XC,53,6,5,1,0,31,22
20140918-W-Tokyo-R16-Caroline_Wozniacki-Jarmila_Gajdosova,1,B-DTM,36,3,0,0,3,16,20
20140918-W-Tokyo-R16-Caroline_Wozniacki-Jarmila_Gajdosova,1,B-DTL,18,6,3,1,2,10,8
20140918-W-Tokyo-R16-Caroline_Wozniacki-Jarmila_Gajdosova,1,B-IO,15,5,2,1,2,11,4
20140918-W-Tokyo-R16-Caroline_Wozniacki-Jarmila_Gajdosova,1,S-XC,3,0,0,0,0,1,2
20140918-W-Tokyo-R16-Caroline_Wozniacki-Jarmila_Gajdosova,1,S-DTM,5,0,0,0,0,2,3
20140918-W-Tokyo-R16-Caroline_Wozniacki-Jarmila_Gajdosova,1,S-DTL,2,0,0,0,0,1,1
20140918-W-Tokyo-R16-Caroline_Wozniacki-Jarmila_Gajdosova,2,F-XC,61,12,7,0,5,31,30
20140918-W-Tokyo-R16-Caroline_Wozniacki-Jarmila_Gajdosova,2,F-DTM,21,2,1,0,1,5,16
20140918-W-Tokyo-R16-Caroline_Wozniacki-Jarmila_Gajdosova,2,F-DTL,35,16,8,1,7,20,15
20140918-W-Tokyo-R16-Caroline_Wozniacki-Jarmila_Gajdosova,2,F-IO,29,9,4,1,4,16,13
20140918-W-Tokyo-R16-Caroline_Wozniacki-Jarmila_Gajdosova,2,F-II,3,1,1,0,0,3,0
20140918-W-Tokyo-R16-Caroline_Wozniacki-Jarmila_Gajdosova,2,B-XC,41,3,0,0,3,18,23
20140918-W-Tokyo-R16-Caroline_Wozniacki-Jarmila_Gajdosova,2,B-DTM,36,3,0,0,3,18,18
20140918-W-Tokyo-R16-Caroline_Wozniacki-Jarmila_Gajdosova,2,B-DTL,40,12,2,0,10,13,27
20140918-W-Tokyo-R16-Caroline_Wozniacki-Jarmila_Gajdosova,2,B-IO,13,5,2,0,3,5,8
20141006-W-Tianjin-SF-Alison_Riske-Saisai_Zheng,1,F-XC,46,6,2,2,2,30,16
20141006-W-Tianjin-SF-Alison_Riske-Saisai_Zheng,1,F-DTM,8,0,0,0,0,3,5
20141006-W-Tianjin-SF-Alison_Riske-Saisai_Zheng,1,F-DTL,7,3,1,1,1,4,3
20141006-W-Tianjin-SF-Alison_Riske-Saisai_Zheng,1,F-IO,10,0,0,0,0,10,0
20141006-W-Tianjin-SF-Alison_Riske-Saisai_Zheng,1,F-II,1,0,0,0,0,1,0
20141006-W-Tianjin-SF-Alison_Riske-Saisai_Zheng,1,B-XC,39,4,1,1,2,32,7
20141006-W-Tianjin-SF-Alison_Riske-Saisai_Zheng,1,B-DTM,20,1,0,0,1,13,7
20141006-W-Tianjin-SF-Alison_Riske-Saisai_Zheng,1,B-DTL,16,4,2,2,0,13,3
20141006-W-Tianjin-SF-Alison_Riske-Saisai_Zheng,1,B-IO,5,0,0,0,0,3,2
20141006-W-Tianjin-SF-Alison_Riske-Saisai_Zheng,1,S-XC,2,0,0,0,0,1,1
20141006-W-Tianjin-SF-Alison_Riske-Saisai_Zheng,2,F-XC,30,7,2,1,4,13,17
20141006-W-Tianjin-SF-Alison_Riske-Saisai_Zheng,2,F-DTM,22,4,0,0,4,3,19
20141006-W-Tianjin-SF-Alison_Riske-Saisai_Zheng,2,F-DTL,17,2,0,0,2,6,11
20141006-W-Tianjin-SF-Alison_Riske-Saisai_Zheng,2,F-IO,13,3,0,0,3,3,10
20141006-W-Tianjin-SF-Alison_Riske-Saisai_Zheng,2,B-XC,18,6,0,0,6,4,14
20141006-W-Tianjin-SF-Alison_Riske-Saisai_Zheng,2,B-DTM,11,0,0,0,0,3,8
20141006-W-Tianjin-SF-Alison_Riske-Saisai_Zheng,2,B-DTL,9,3,1,0,2,3,6
20141006-W-Tianjin-SF-Alison_Riske-Saisai_Zheng,2,B-IO,6,2,2,0,0,2,4
20141006-W-Tianjin-SF-Alison_Riske-Saisai_Zheng,2,S-XC,8,1,0,0,1,1,7
20141006-W-Tianjin-SF-Alison_Riske-Saisai_Zheng,2,S-DTM,8,1,0,0,1,2,6
20141006-W-Tianjin-SF-Alison_Riske-Saisai_Zheng,2,S-DTL,3,0,0,0,0,0,3
20141006-W-Tianjin-SF-Alison_Riske-Saisai_Zheng,2,S-IO,1,0,0,0,0,1,0
20130506-W-Madrid-R64-Maria_Sharapova-Alexandra_Dulgheru,1,F-XC,46,15,3,5,7,27,19
20130506-W-Madrid-R64-Maria_Sharapova-Alexandra_Dulgheru,1,F-DTM,7,2,0,0,2,4,3
20130506-W-Madrid-R64-Maria_Sharapova-Alexandra_Dulgheru,1,F-DTL,9,4,2,2,0,8,1
20130506-W-Madrid-R64-Maria_Sharapova-Alexandra_Dulgheru,1,F-IO,22,11,5,1,5,12,10
20130506-W-Madrid-R64-Maria_Sharapova-Alexandra_Dulgheru,1,B-XC,29,9,1,3,5,18,11
20130506-W-Madrid-R64-Maria_Sharapova-Alexandra_Dulgheru,1,B-DTM,23,1,0,0,1,11,12
20130506-W-Madrid-R64-Maria_Sharapova-Alexandra_Dulgheru,1,B-DTL,13,8,3,2,3,7,6
20130506-W-Madrid-R64-Maria_Sharapova-Alexandra_Dulgheru,1,B-IO,3,1,0,1,0,3,0
20130506-W-Madrid-R64-Maria_Sharapova-Alexandra_Dulgheru,1,S-XC,1,1,0,1,0,1,0
20130506-W-Madrid-R64-Maria_Sharapova-Alexandra_Dulgheru,1,S-DTM,1,0,0,0,0,0,1
20130506-W-Madrid-R64-Maria_Sharapova-Alexandra_Dulgheru,2,F-XC,30,5,0,0,5,9,21
20130506-W-Madrid-R64-Maria_Sharapova-Alexandra_Dulgheru,2,F-DTM,10,0,0,0,0,6,4
20130506-W-Madrid-R64-Maria_Sharapova-Alexandra_Dulgheru,2,F-DTL,18,7,2,0,5,9,9
20130506-W-Madrid-R64-Maria_Sharapova-Alexandra_Dulgheru,2,F-IO,6,0,0,0,0,2,4
20130506-W-Madrid-R64-Maria_Sharapova-Alexandra_Dulgheru,2,B-XC,24,2,1,0,1,12,12
20130506-W-Madrid-R64-Maria_Sharapova-Alexandra_Dulgheru,2,B-DTM,29,0,0,0,0,10,19
20130506-W-Madrid-R64-Maria_Sharapova-Alexandra_Dulgheru,2,B-DTL,2,0,0,0,0,0,2
20130506-W-Madrid-R64-Maria_Sharapova-Alexandra_Dulgheru,2,B-IO,10,6,2,2,2,5,5
20130506-W-Madrid-R64-Maria_Sharapova-Alexandra_Dulgheru,2,S-XC,2,0,0,0,0,1,1
20130506-W-Madrid-R64-Maria_Sharapova-Alexandra_Dulgheru,2,S-DTM,6,0,0,0,0,1,5
20140113-W-Australian_Open_Q-Q2-Carina_Witthoeft-Anastasia_Rodionova,1,F-XC,49,9,3,1,5,18,31
20140113-W-Australian_Open_Q-Q2-Carina_Witthoeft-Anastasia_Rodionova,1,F-DTM,33,2,0,1,1,14,19
20140113-W-Australian_Open_Q-Q2-Carina_Witthoeft-Anastasia_Rodionova,1,F-DTL,15,7,1,1,5,8,7
20140113-W-Australian_Open_Q-Q2-Carina_Witthoeft-Anastasia_Rodionova,1,F-IO,11,5,1,2,2,6,5
20140113-W-Australian_Open_Q-Q2-Carina_Witthoeft-Anastasia_Rodionova,1,B-XC,25,2,1,0,1,13,12
20140113-W-Australian_Open_Q-Q2-Carina_Witthoeft-Anastasia_Rodionova,1,B-DTM,33,2,0,0,2,16,17
20140113-W-Australian_Open_Q-Q2-Carina_Witthoeft-Anastasia_Rodionova,1,B-DTL,10,3,0,2,1,8,2
20140113-W-Australian_Open_Q-Q2-Carina_Witthoeft-Anastasia_Rodionova,1,B-IO,3,1,0,0,1,2,1
20140113-W-Australian_Open_Q-Q2-Carina_Witthoeft-Anastasia_Rodionova,1,S-XC,2,0,0,0,0,1,1
20140113-W-Australian_Open_Q-Q2-Carina_Witthoeft-Anastasia_Rodionova,1,S-DTM,6,2,0,0,2,2,4
20140113-W-Australian_Open_Q-Q2-Carina_Witthoeft-Anastasia_Rodionova,2,F-XC,50,14,3,1,10,27,23
20140113-W-Australian_Open_Q-Q2-Carina_Witthoeft-Anastasia_Rodionova,2,F-DTM,37,5,0,1,4,19,18
20140113-W-Australian_Open_Q-Q2-Carina_Witthoeft-Anastasia_Rodionova,2,F-DTL,6,3,1,0,2,3,3
20140113-W-Australian_Open_Q-Q2-Carina_Witthoeft-Anastasia_Rodionova,2,F-IO,22,10,2,2,6,9,13
20140113-W-Australian_Open_Q-Q2-Carina_Witthoeft-Anastasia_Rodionova,2,B-XC,30,4,1,0,3,17,13
20140113-W-Australian_Open_Q-Q2-Carina_Witthoeft-Anastasia_Rodionova,2,B-DTM,27,4,0,0,4,10,17
20140113-W-Australian_Open_Q-Q2-Carina_Witthoeft-Anastasia_Rodionova,2,B-DTL,12,2,0,1,1,8,4
20140113-W-Australian_Open_Q-Q2-Carina_Witthoeft-Anastasia_Rodionova,2,B-IO,4,3,0,1,2,1,3
20140113-W-Australian_Open_Q-Q2-Carina_Witthoeft-Anastasia_Rodionova,2,S-XC,1,0,0,0,0,0,1
20140601-W-Roland_Garros-R16-Pauline_Parmentier-Garbine_Muguruza,1,F-XC,58,14,1,2,11,20,38
20140601-W-Roland_Garros-R16-Pauline_Parmentier-Garbine_Muguruza,1,F-DTM,40,2,0,0,2,12,28
20140601-W-Roland_Garros-R16-Pauline_Parmentier-Garbine_Muguruza,1,F-DTL,11,4,2,0,2,6,5
20140601-W-Roland_Garros-R16-Pauline_Parmentier-Garbine_Muguruza,1,F-IO,15,3,2,0,1,9,6
20140601-W-Roland_Garros-R16-Pauline_Parmentier-Garbine_Muguruza,1,F-II,3,0,0,0,0,1,2
20140601-W-Roland_Garros-R16-Pauline_Parmentier-Garbine_Muguruza,1,B-XC,16,2,0,0,2,6,10
20140601-W-Roland_Garros-R16-Pauline_Parmentier-Garbine_Muguruza,1,B-DTM,31,5,0,1,4,11,20
20140601-W-Roland_Garros-R16-Pauline_Parmentier-Garbine_Muguruza,1,B-DTL,4,1,0,1,0,2,2
20140601-W-Roland_Garros-R16-Pauline_Parmentier-Garbine_Muguruza,1,B-IO,2,1,1,0,0,1,1
20140601-W-Roland_Garros-R16-Pauline_Parmentier-Garbine_Muguruza,1,S-XC,2,0,0,0,0,1,1
20140601-W-Roland_Garros-R16-Pauline_Parmentier-Garbine_Muguruza,1,S-DTM,7,2,0,0,2,1,6
20140601-W-Roland_Garros-R16-Pauline_Parmentier-Garbine_Muguruza,1,S-DTL,2,2,1,0,1,1,1
20140601-W-Roland_Garros-R16-Pauline_Parmentier-Garbine_Muguruza,2,F-XC,43,8,3,2,3,27,16
20140601-W-Roland_Garros-R16-Pauline_Parmentier-Garbine_Muguruza,2,F-DTM,39,1,0,1,0,24,15
20140601-W-Roland_Garros-R16-Pauline_Parmentier-Garbine_Muguruza,2,F-DTL,12,3,0,0,3,6,6
20140601-W-Roland_Garros-R16-Pauline_Parmentier-Garbine_Muguruza,2,F-IO,10,4,1,3,0,9,1
20140601-W-Roland_Garros-R16-Pauline_Parmentier-Garbine_Muguruza,2,B-XC,31,6,0,2,4,17,14
20140601-W-Roland_Garros-R16-Pauline_Parmentier-Garbine_Muguruza,2,B-DTM,29,1,0,0,1,17,12
20140601-W-Roland_Garros-R16-Pauline_Parmentier-Garbine_Muguruza,2,B-DTL,8,4,3,0,1,6,2
20140601-W-Roland_Garros-R16-Pauline_Parmentier-Garbine_Muguruza,2,B-IO,10,5,2,2,1,7,3
20140601-W-Roland_Garros-R16-Pauline_Parmentier-Garbine_Muguruza,2,S-XC,1,0,0,0,0,1,0
20140901-W-US_Open-R16-Eugenie_Bouchard-Ekaterina_Makarova,1,F-XC,29,7,3,0,4,15,14
20140901-W-US_Open-R16-Eugenie_Bouchard-Ekaterina_Makarova,1,F-DTM,21,2,0,1,1,11,10
20140901-W-US_Open-R16-Eugenie_Bouchard-Ekaterina_Makarova,1,F-DTL,19,11,5,1,5,11,8
20140901-W-US_Open-R16-Eugenie_Bouchard-Ekaterina_Makarova,1,F-IO,19,10,4,1,5,8,11
20140901-W-US_Open-R16-Eugenie_Bouchard-Ekaterina_Makarova,1,B-XC,21,7,0,0,7,6,15
20140901-W-US_Open-R16-Eugenie_Bouchard-Ekaterina_Makarova,1,B-DTM,16,2,0,0,2,4,12
20140901-W-US_Open-R16-Eugenie_Bouchard-Ekaterina_Makarova,1,B-DTL,2,1,1,0,0,1,1
20140901-W-US_Open-R16-Eugenie_Bouchard-Ekaterina_Makarova,1,B-IO,3,3,1,0,2,1,2
20140901-W-US_Open-R16-Eugenie_Bouchard-Ekaterina_Makarova,1,S-XC,1,0,0,0,0,1,0
20140901-W-US_Open-R16-Eugenie_Bouchard-Ekaterina_Makarova,1,S-DTM,2,0,0,0,0,1,1
20140901-W-US_Open-R16-Eugenie_Bouchard-Ekaterina_Makarova,2,F-XC,25,4,2,0,2,17,8
20140901-W-US_Open-R16-Eugenie_Bouchard-Ekaterina_Makarova,2,F-DTM,19,6,0,0,6,6,13
20140901-W-US_Open-R16-Eugenie_Bouchard-Ekaterina_Makarova,2,F-DTL,12,8,4,0,4,6,6
20140901-W-US_Open-R16-Eugenie_Bouchard-Ekaterina_Makarova,2,F-IO,22,11,3,2,6,11,11
20140901-W-US_Open-R16-Eugenie_Bouchard-Ekaterina_Makarova,2,B-XC,34,14,3,5,6,17,17
20140901-W-US_Open-R16-Eugenie_Bouchard-Ekaterina_Makarova,2,B-DTM,15,0,0,0,0,10,5
20140901-W-US_Open-R16-Eugenie_Bouchard-Ekaterina_Makarova,2,B-DTL,6,4,1,2,1,4,2
20140901-W-US_Open-R16-Eugenie_Bouchard-Ekaterina_Makarova,2,B-IO,5,4,2,2,0,5,0
20140901-W-US_Open-R16-Eugenie_Bouchard-Ekaterina_Makarova,2,S-DTM,1,0,0,0,0,0,1
20140513-W-Rome-R32-Camila_Giorgi-Dominika_Cibulkova,1,F-XC,42,15,3,7,5,27,15
20140513-W-Rome-R32-Camila_Giorgi-Dominika_Cibulkova,1,F-DTM,25,4,0,0,4,12,13
20140513-W-Rome-R32-Camila_Giorgi-Dominika_Cibulkova,1,F-DTL,8,6,2,2,2,6,2
20140513-W-Rome-R32-Camila_Giorgi-Dominika_Cibulkova,1,F-IO,6,6,5,0,1,5,1
20140513-W-Rome-R32-Camila_Giorgi-Dominika_Cibulkova,1,F-II,1,0,0,0,0,1,0
20140513-W-Rome-R32-Camila_Giorgi-Dominika_Cibulkova,1,B-XC,30,7,2,3,2,22,8
20140513-W-Rome-R32-Camila_Giorgi-Dominika_Cibulkova,1,B-DTM,30,4,0,1,3,13,17
20140513-W-Rome-R32-Camila_Giorgi-Dominika_Cibulkova,1,B-DTL,9,5,4,0,1,8,1
20140513-W-Rome-R32-Camila_Giorgi-Dominika_Cibulkova,1,B-IO,10,9,5,1,3,7,3
20140513-W-Rome-R32-Camila_Giorgi-Dominika_Cibulkova,1,S-DTM,1,0,0,0,0,1,0
20140513-W-Rome-R32-Camila_Giorgi-Dominika_Cibulkova,2,F-XC,36,9,3,1,5,15,21
20140513-W-Rome-R32-Camila_Giorgi-Dominika_Cibulkova,2,F-DTM,25,4,0,0,4,9,16
20140513-W-Rome-R32-Camila_Giorgi-Dominika_Cibulkova,2,F-DTL,10,5,1,1,3,3,7
20140513-W-Rome-R32-Camila_Giorgi-Dominika_Cibulkova,2,F-IO,9,4,1,1,2,3,6
20140513-W-Rome-R32-Camila_Giorgi-Dominika_Cibulkova,2,B-XC,14,1,0,0,1,1,13
20140513-W-Rome-R32-Camila_Giorgi-Dominika_Cibulkova,2,B-DTM,30,1,0,0,1,17,13
20140513-W-Rome-R32-Camila_Giorgi-Dominika_Cibulkova,2,B-DTL,1,0,0,0,0,0,1
20140513-W-Rome-R32-Camila_Giorgi-Dominika_Cibulkova,2,B-IO,5,2,1,0,1,3,2
20140513-W-Rome-R32-Camila_Giorgi-Dominika_Cibulkova,2,S-XC,3,0,0,0,0,0,3
20140513-W-Rome-R32-Camila_Giorgi-Dominika_Cibulkova,2,S-DTM,5,0,0,0,0,1,4
20140513-W-Rome-R32-Camila_Giorgi-Dominika_Cibulkova,2,S-DTL,1,0,0,0,0,0,1
20140616-W-Eastbourne-R32-Caroline_Wozniacki-Samantha_Stosur,1,F-XC,29,7,2,5,0,15,14
20140616-W-Eastbourne-R32-Caroline_Wozniacki-Samantha_Stosur,1,F-DTM,11,1,0,0,1,7,4
20140616-W-Eastbourne-R32-Caroline_Wozniacki-Samantha_Stosur,1,F-DTL,22,6,1,1,4,9,13
20140616-W-Eastbourne-R32-Caroline_Wozniacki-Samantha_Stosur,1,F-IO,10,3,0,3,0,6,4
20140616-W-Eastbourne-R32-Caroline_Wozniacki-Samantha_Stosur,1,B-XC,30,1,0,0,1,19,11
20140616-W-Eastbourne-R32-Caroline_Wozniacki-Samantha_Stosur,1,B-DTM,7,0,0,0,0,3,4
20140616-W-Eastbourne-R32-Caroline_Wozniacki-Samantha_Stosur,1,B-DTL,9,4,1,1,2,5,4
20140616-W-Eastbourne-R32-Caroline_Wozniacki-Samantha_Stosur,1,B-IO,12,4,4,0,0,10,2
20140616-W-Eastbourne-R32-Caroline_Wozniacki-Samantha_Stosur,1,S-XC,6,0,0,0,0,2,4
20140616-W-Eastbourne-R32-Caroline_Wozniacki-Samantha_Stosur,2,F-XC,31,8,2,1,5,15,16
20140616-W-Eastbourne-R32-Caroline_Wozniacki-Samantha_Stosur,2,F-DTM,12,0,0,0,0,6,6
20140616-W-Eastbourne-R32-Caroline_Wozniacki-Samantha_Stosur,2,F-DTL,14,7,2,1,4,7,7
20140616-W-Eastbourne-R32-Caroline_Wozniacki-Samantha_Stosur,2,F-IO,22,8,2,1,5,12,10
20140616-W-Eastbourne-R32-Caroline_Wozniacki-Samantha_Stosur,2,F-II,5,2,1,0,1,4,1
20140616-W-Eastbourne-R32-Caroline_Wozniacki-Samantha_Stosur,2,B-XC,5,1,0,0,1,1,4
20140616-W-Eastbourne-R32-Caroline_Wozniacki-Samantha_Stosur,2,B-DTM,9,0,0,0,0,3,6
20140616-W-Eastbourne-R32-Caroline_Wozniacki-Samantha_Stosur,2,B-DTL,12,6,2,1,3,7,5
20140616-W-Eastbourne-R32-Caroline_Wozniacki-Samantha_Stosur,2,B-IO,2,1,0,0,1,0,2
20140616-W-Eastbourne-R32-Caroline_Wozniacki-Samantha_Stosur,2,S-XC,15,2,0,1,1,8,7
20140616-W-Eastbourne-R32-Caroline_Wozniacki-Samantha_Stosur,2,S-DTM,12,1,0,0,1,3,9
20140616-W-Eastbourne-R32-Caroline_Wozniacki-Samantha_Stosur,2,S-DTL,8,3,0,1,2,4,4
20140620-W-Eastbourne-SF-Madison_Keys-Heather_Watson,1,F-XC,16,8,2,3,3,10,6
20140620-W-Eastbourne-SF-Madison_Keys-Heather_Watson,1,F-DTM,5,1,0,0,1,4,1
20140620-W-Eastbourne-SF-Madison_Keys-Heather_Watson,1,F-DTL,7,5,2,1,2,5,2
20140620-W-Eastbourne-SF-Madison_Keys-Heather_Watson,1,F-IO,6,3,2,0,1,3,3
20140620-W-Eastbourne-SF-Madison_Keys-Heather_Watson,1,F-II,1,0,0,0,0,1,0
20140620-W-Eastbourne-SF-Madison_Keys-Heather_Watson,1,B-XC,15,9,1,1,7,4,11
20140620-W-Eastbourne-SF-Madison_Keys-Heather_Watson,1,B-DTM,7,1,0,0,1,3,4
20140620-W-Eastbourne-SF-Madison_Keys-Heather_Watson,1,B-DTL,5,2,2,0,0,4,1
20140620-W-Eastbourne-SF-Madison_Keys-Heather_Watson,1,B-IO,7,4,0,0,4,2,5
20140620-W-Eastbourne-SF-Madison_Keys-Heather_Watson,1,S-XC,1,0,0,0,0,0,1
20140620-W-Eastbourne-SF-Madison_Keys-Heather_Watson,1,S-DTM,3,0,0,0,0,2,1
20140620-W-Eastbourne-SF-Madison_Keys-Heather_Watson,2,F-XC,17,8,2,0,6,4,13
20140620-W-Eastbourne-SF-Madison_Keys-Heather_Watson,2,F-DTM,8,0,0,0,0,5,3
20140620-W-Eastbourne-SF-Madison_Keys-Heather_Watson,2,F-DTL,4,0,0,0,0,4,0
20140620-W-Eastbourne-SF-Madison_Keys-Heather_Watson,2,F-IO,11,5,0,0,5,1,10
20140620-W-Eastbourne-SF-Madison_Keys-Heather_Watson,2,F-II,1,1,1,0,0,1,0
20140620-W-Eastbourne-SF-Madison_Keys-Heather_Watson,2,B-XC,12,2,0,0,2,7,5
20140620-W-Eastbourne-SF-Madison_Keys-Heather_Watson,2,B-DTM,9,0,0,0,0,3,6
20140620-W-Eastbourne-SF-Madison_Keys-Heather_Watson,2,B-DTL,3,2,0,0,2,1,2
20140620-W-Eastbourne-SF-Madison_Keys-Heather_Watson,2,B-IO,2,1,0,0,1,0,2
20140620-W-Eastbourne-SF-Madison_Keys-Heather_Watson,2,S-XC,1,0,0,0,0,0,1
20140620-W-Eastbourne-SF-Madison_Keys-Heather_Watson,2,S-II,1,0,0,0,0,0,1
20120220-W-Dubai-QF-Caroline_Wozniacki-Ana_Ivanovic,1,F-XC,44,11,2,4,5,27,17
20120220-W-Dubai-QF-Caroline_Wozniacki-Ana_Ivanovic,1,F-DTM,20,2,0,0,2,8,12
20120220-W-Dubai-QF-Caroline_Wozniacki-Ana_Ivanovic,1,F-DTL,37,6,2,2,2,25,12
20120220-W-Dubai-QF-Caroline_Wozniacki-Ana_Ivanovic,1,F-IO,18,3,0,0,3,11,7
20120220-W-Dubai-QF-Caroline_Wozniacki-Ana_Ivanovic,1,B-XC,98,6,2,1,3,56,42
20120220-W-Dubai-QF-Caroline_Wozniacki-Ana_Ivanovic,1,B-DTM,21,1,0,0,1,11,10
20120220-W-Dubai-QF-Caroline_Wozniacki-Ana_Ivanovic,1,B-DTL,5,2,2,0,0,5,0
20120220-W-Dubai-QF-Caroline_Wozniacki-Ana_Ivanovic,1,B-IO,3,1,0,0,1,1,2
20120220-W-Dubai-QF-Caroline_Wozniacki-Ana_Ivanovic,1,S-XC,2,0,0,0,0,1,1
20120220-W-Dubai-QF-Caroline_Wozniacki-Ana_Ivanovic,2,F-XC,50,16,2,5,9,20,30
20120220-W-Dubai-QF-Caroline_Wozniacki-Ana_Ivanovic,2,F-DTM,8,1,0,0,1,2,6
20120220-W-Dubai-QF-Caroline_Wozniacki-Ana_Ivanovic,2,F-DTL,12,5,3,0,2,5,7
20120220-W-Dubai-QF-Caroline_Wozniacki-Ana_Ivanovic,2,F-IO,24,8,3,2,3,12,12
20120220-W-Dubai-QF-Caroline_Wozniacki-Ana_Ivanovic,2,F-II,19,7,2,2,3,12,7
20120220-W-Dubai-QF-Caroline_Wozniacki-Ana_Ivanovic,2,B-XC,67,13,2,1,10,29,38
20120220-W-Dubai-QF-Caroline_Wozniacki-Ana_Ivanovic,2,B-DTM,31,3,0,1,2,12,19
20120220-W-Dubai-QF-Caroline_Wozniacki-Ana_Ivanovic,2,B-DTL,33,12,2,1,9,9,24
20120220-W-Dubai-QF-Caroline_Wozniacki-Ana_Ivanovic,2,B-IO,2,0,0,0,0,1,1
20120220-W-Dubai-QF-Caroline_Wozniacki-Ana_Ivanovic,2,S-XC,2,1,0,0,1,1,1
20120220-W-Dubai-QF-Caroline_Wozniacki-Ana_Ivanovic,2,S-DTM,1,0,0,0,0,0,1
20120220-W-Dubai-QF-Caroline_Wozniacki-Ana_Ivanovic,2,S-DTL,7,1,0,0,1,2,5
20141023-W-Singapore-RR-Petra_Kvitova-Maria_Sharapova,1,F-XC,23,5,4,0,1,18,5
20141023-W-Singapore-RR-Petra_Kvitova-Maria_Sharapova,1,F-DTM,19,1,0,0,1,9,10
20141023-W-Singapore-RR-Petra_Kvitova-Maria_Sharapova,1,F-DTL,13,7,4,1,2,10,3
20141023-W-Singapore-RR-Petra_Kvitova-Maria_Sharapova,1,F-IO,16,13,5,1,7,9,7
20141023-W-Singapore-RR-Petra_Kvitova-Maria_Sharapova,1,B-XC,11,3,1,1,1,8,3
20141023-W-Singapore-RR-Petra_Kvitova-Maria_Sharapova,1,B-DTM,5,0,0,0,0,1,4
20141023-W-Singapore-RR-Petra_Kvitova-Maria_Sharapova,1,B-DTL,4,3,1,0,2,2,2
20141023-W-Singapore-RR-Petra_Kvitova-Maria_Sharapova,1,B-IO,2,1,0,0,1,1,1
20141023-W-Singapore-RR-Petra_Kvitova-Maria_Sharapova,1,S-DTM,1,0,0,0,0,1,0
20141023-W-Singapore-RR-Petra_Kvitova-Maria_Sharapova,1,S-IO,1,0,0,0,0,1,0
20141023-W-Singapore-RR-Petra_Kvitova-Maria_Sharapova,2,F-XC,21,9,3,1,5,11,10
20141023-W-Singapore-RR-Petra_Kvitova-Maria_Sharapova,2,F-DTM,7,1,0,0,1,1,6
20141023-W-Singapore-RR-Petra_Kvitova-Maria_Sharapova,2,F-DTL,7,3,2,0,1,3,4
20141023-W-Singapore-RR-Petra_Kvitova-Maria_Sharapova,2,F-IO,9,2,1,1,0,4,5
20141023-W-Singapore-RR-Petra_Kvitova-Maria_Sharapova,2,B-XC,25,7,1,1,5,7,18
20141023-W-Singapore-RR-Petra_Kvitova-Maria_Sharapova,2,B-DTM,18,3,0,0,3,6,12
20141023-W-Singapore-RR-Petra_Kvitova-Maria_Sharapova,2,B-DTL,4,3,0,1,2,1,3
20141023-W-Singapore-RR-Petra_Kvitova-Maria_Sharapova,2,S-XC,1,0,0,0,0,0,1
20141023-W-Singapore-RR-Petra_Kvitova-Maria_Sharapova,2,S-DTM,1,0,0,0,0,0,1
20120315-W-Indian_Wells-QF-Ana_Ivanovic-Marion_Bartoli,1,F-XC,36,14,6,2,6,19,17
20120315-W-Indian_Wells-QF-Ana_Ivanovic-Marion_Bartoli,1,F-DTM,17,3,0,0,3,9,8
20120315-W-Indian_Wells-QF-Ana_Ivanovic-Marion_Bartoli,1,F-DTL,9,5,4,0,1,5,4
20120315-W-Indian_Wells-QF-Ana_Ivanovic-Marion_Bartoli,1,F-IO,10,3,2,0,1,6,4
20120315-W-Indian_Wells-QF-Ana_Ivanovic-Marion_Bartoli,1,F-II,1,1,0,0,1,0,1
20120315-W-Indian_Wells-QF-Ana_Ivanovic-Marion_Bartoli,1,B-XC,34,3,1,0,2,17,17
20120315-W-Indian_Wells-QF-Ana_Ivanovic-Marion_Bartoli,1,B-DTM,25,1,0,0,1,11,14
20120315-W-Indian_Wells-QF-Ana_Ivanovic-Marion_Bartoli,1,B-DTL,6,4,1,0,3,2,4
20120315-W-Indian_Wells-QF-Ana_Ivanovic-Marion_Bartoli,1,B-IO,4,1,0,0,1,1,3
20120315-W-Indian_Wells-QF-Ana_Ivanovic-Marion_Bartoli,1,S-XC,2,0,0,0,0,0,2
20120315-W-Indian_Wells-QF-Ana_Ivanovic-Marion_Bartoli,1,S-DTM,9,1,0,0,1,1,8
20120315-W-Indian_Wells-QF-Ana_Ivanovic-Marion_Bartoli,1,S-DTL,2,0,0,0,0,0,2
20120315-W-Indian_Wells-QF-Ana_Ivanovic-Marion_Bartoli,2,F-XC,30,8,3,0,5,18,12
20120315-W-Indian_Wells-QF-Ana_Ivanovic-Marion_Bartoli,2,F-DTM,15,1,0,0,1,7,8
20120315-W-Indian_Wells-QF-Ana_Ivanovic-Marion_Bartoli,2,F-DTL,6,0,0,0,0,3,3
20120315-W-Indian_Wells-QF-Ana_Ivanovic-Marion_Bartoli,2,F-IO,8,0,0,0,0,6,2
20120315-W-Indian_Wells-QF-Ana_Ivanovic-Marion_Bartoli,2,B-XC,44,7,0,1,6,26,18
20120315-W-Indian_Wells-QF-Ana_Ivanovic-Marion_Bartoli,2,B-DTM,32,4,0,0,4,14,18
20120315-W-Indian_Wells-QF-Ana_Ivanovic-Marion_Bartoli,2,B-DTL,10,4,2,0,2,7,3
20120315-W-Indian_Wells-QF-Ana_Ivanovic-Marion_Bartoli,2,B-IO,3,0,0,0,0,0,3
20120315-W-Indian_Wells-QF-Ana_Ivanovic-Marion_Bartoli,2,S-DTL,1,0,0,0,0,0,1
20120730-W-Olympics-R16-Daniela_Hantuchova-Caroline_Wozniacki,1,F-XC,28,12,5,0,7,16,12
20120730-W-Olympics-R16-Daniela_Hantuchova-Caroline_Wozniacki,1,F-DTM,4,0,0,0,0,2,2
20120730-W-Olympics-R16-Daniela_Hantuchova-Caroline_Wozniacki,1,F-DTL,7,4,3,1,0,6,1
20120730-W-Olympics-R16-Daniela_Hantuchova-Caroline_Wozniacki,1,F-IO,6,1,0,0,1,3,3
20120730-W-Olympics-R16-Daniela_Hantuchova-Caroline_Wozniacki,1,B-XC,26,7,1,2,4,15,11
20120730-W-Olympics-R16-Daniela_Hantuchova-Caroline_Wozniacki,1,B-DTM,11,0,0,0,0,7,4
20120730-W-Olympics-R16-Daniela_Hantuchova-Caroline_Wozniacki,1,B-DTL,14,8,4,0,4,9,5
20120730-W-Olympics-R16-Daniela_Hantuchova-Caroline_Wozniacki,1,B-IO,3,0,0,0,0,2,1
20120730-W-Olympics-R16-Daniela_Hantuchova-Caroline_Wozniacki,1,S-XC,1,0,0,0,0,1,0
20120730-W-Olympics-R16-Daniela_Hantuchova-Caroline_Wozniacki,2,F-XC,17,5,2,1,2,5,12
20120730-W-Olympics-R16-Daniela_Hantuchova-Caroline_Wozniacki,2,F-DTM,12,1,0,0,1,6,6
20120730-W-Olympics-R16-Daniela_Hantuchova-Caroline_Wozniacki,2,F-DTL,12,4,1,0,3,3,9
20120730-W-Olympics-R16-Daniela_Hantuchova-Caroline_Wozniacki,2,F-IO,2,0,0,0,0,1,1
20120730-W-Olympics-R16-Daniela_Hantuchova-Caroline_Wozniacki,2,B-XC,28,5,0,2,3,11,17
20120730-W-Olympics-R16-Daniela_Hantuchova-Caroline_Wozniacki,2,B-DTM,11,1,0,1,0,7,4
20120730-W-Olympics-R16-Daniela_Hantuchova-Caroline_Wozniacki,2,B-DTL,9,4,2,1,1,4,5
20120730-W-Olympics-R16-Daniela_Hantuchova-Caroline_Wozniacki,2,B-IO,6,3,3,0,0,3,3
20120730-W-Olympics-R16-Daniela_Hantuchova-Caroline_Wozniacki,2,S-XC,1,0,0,0,0,0,1
20120730-W-Olympics-R16-Daniela_Hantuchova-Caroline_Wozniacki,2,S-DTL,1,0,0,0,0,0,1
20090511-W-Madrid-SF-Patty_Schnyder-Dinara_Safina,1,F-XC,33,8,1,0,7,10,23
20090511-W-Madrid-SF-Patty_Schnyder-Dinara_Safina,1,F-DTM,11,0,0,0,0,6,5
20090511-W-Madrid-SF-Patty_Schnyder-Dinara_Safina,1,F-DTL,17,7,3,2,2,8,9
20090511-W-Madrid-SF-Patty_Schnyder-Dinara_Safina,1,F-IO,11,4,2,1,1,4,7
20090511-W-Madrid-SF-Patty_Schnyder-Dinara_Safina,1,F-II,1,0,0,0,0,0,1
20090511-W-Madrid-SF-Patty_Schnyder-Dinara_Safina,1,B-XC,28,3,1,0,2,11,17
20090511-W-Madrid-SF-Patty_Schnyder-Dinara_Safina,1,B-DTM,14,1,0,1,0,7,7
20090511-W-Madrid-SF-Patty_Schnyder-Dinara_Safina,1,B-DTL,11,3,0,1,2,4,7
20090511-W-Madrid-SF-Patty_Schnyder-Dinara_Safina,1,B-IO,7,4,0,0,4,1,6
20090511-W-Madrid-SF-Patty_Schnyder-Dinara_Safina,1,S-XC,4,0,0,0,0,0,4
20090511-W-Madrid-SF-Patty_Schnyder-Dinara_Safina,1,S-DTM,3,0,0,0,0,0,3
20090511-W-Madrid-SF-Patty_Schnyder-Dinara_Safina,1,S-DTL,3,0,0,0,0,0,3
20090511-W-Madrid-SF-Patty_Schnyder-Dinara_Safina,2,F-XC,50,8,1,1,6,31,19
20090511-W-Madrid-SF-Patty_Schnyder-Dinara_Safina,2,F-DTM,8,2,1,0,1,5,3
20090511-W-Madrid-SF-Patty_Schnyder-Dinara_Safina,2,F-DTL,13,8,4,1,3,10,3
20090511-W-Madrid-SF-Patty_Schnyder-Dinara_Safina,2,F-IO,15,6,4,1,1,10,5
20090511-W-Madrid-SF-Patty_Schnyder-Dinara_Safina,2,F-II,2,2,1,1,0,2,0
20090511-W-Madrid-SF-Patty_Schnyder-Dinara_Safina,2,B-XC,42,12,5,4,3,30,12
20090511-W-Madrid-SF-Patty_Schnyder-Dinara_Safina,2,B-DTM,10,0,0,0,0,7,3
20090511-W-Madrid-SF-Patty_Schnyder-Dinara_Safina,2,B-DTL,6,3,1,0,2,4,2
20090511-W-Madrid-SF-Patty_Schnyder-Dinara_Safina,2,B-IO,7,2,1,0,1,3,4
20090511-W-Madrid-SF-Patty_Schnyder-Dinara_Safina,2,B-II,1,0,0,0,0,1,0
20090511-W-Madrid-SF-Patty_Schnyder-Dinara_Safina,2,S-DTM,1,0,0,0,0,1,0
20090511-W-Madrid-SF-Patty_Schnyder-Dinara_Safina,2,S-DTL,2,1,1,0,0,1,1
20140919-W-Tokyo-QF-Ana_Ivanovic-Lucie_Safarova,1,F-XC,21,4,2,1,1,11,10
20140919-W-Tokyo-QF-Ana_Ivanovic-Lucie_Safarova,1,F-DTM,9,1,0,0,1,3,6
20140919-W-Tokyo-QF-Ana_Ivanovic-Lucie_Safarova,1,F-DTL,3,2,1,0,1,1,2
20140919-W-Tokyo-QF-Ana_Ivanovic-Lucie_Safarova,1,F-IO,9,3,2,1,0,7,2
20140919-W-Tokyo-QF-Ana_Ivanovic-Lucie_Safarova,1,F-II,2,2,1,0,1,1,1
20140919-W-Tokyo-QF-Ana_Ivanovic-Lucie_Safarova,1,B-XC,20,5,3,0,2,9,11
20140919-W-Tokyo-QF-Ana_Ivanovic-Lucie_Safarova,1,B-DTM,10,1,0,0,1,2,8
20140919-W-Tokyo-QF-Ana_Ivanovic-Lucie_Safarova,1,B-DTL,11,3,1,0,2,7,4
20140919-W-Tokyo-QF-Ana_Ivanovic-Lucie_Safarova,1,B-IO,4,1,0,0,1,2,2
20140919-W-Tokyo-QF-Ana_Ivanovic-Lucie_Safarova,1,S-XC,4,1,0,1,0,3,1
20140919-W-Tokyo-QF-Ana_Ivanovic-Lucie_Safarova,1,S-DTM,5,0,0,0,0,2,3
20140919-W-Tokyo-QF-Ana_Ivanovic-Lucie_Safarova,1,S-DTL,3,0,0,0,0,0,3
20140919-W-Tokyo-QF-Ana_Ivanovic-Lucie_Safarova,1,S-IO,1,0,0,0,0,0,1
20140919-W-Tokyo-QF-Ana_Ivanovic-Lucie_Safarova,2,F-XC,33,8,2,3,3,19,14
20140919-W-Tokyo-QF-Ana_Ivanovic-Lucie_Safarova,2,F-DTM,10,0,0,0,0,7,3
20140919-W-Tokyo-QF-Ana_Ivanovic-Lucie_Safarova,2,F-DTL,11,5,1,3,1,6,5
20140919-W-Tokyo-QF-Ana_Ivanovic-Lucie_Safarova,2,F-IO,10,7,5,1,1,7,3
20140919-W-Tokyo-QF-Ana_Ivanovic-Lucie_Safarova,2,F-II,1,1,1,0,0,1,0
20140919-W-Tokyo-QF-Ana_Ivanovic-Lucie_Safarova,2,B-XC,14,5,2,0,3,9,5
20140919-W-Tokyo-QF-Ana_Ivanovic-Lucie_Safarova,2,B-DTM,18,1,0,0,1,3,15
20140919-W-Tokyo-QF-Ana_Ivanovic-Lucie_Safarova,2,B-DTL,10,4,1,0,3,6,4
20140919-W-Tokyo-QF-Ana_Ivanovic-Lucie_Safarova,2,B-IO,4,1,0,0,1,3,1
20140919-W-Tokyo-QF-Ana_Ivanovic-Lucie_Safarova,2,S-DTM,2,0,0,0,0,0,2
20140918-W-Tokyo-R16-Garbine_Muguruza-Jelena_Jankovic,1,F-XC,38,6,0,2,4,24,14
20140918-W-Tokyo-R16-Garbine_Muguruza-Jelena_Jankovic,1,F-DTM,38,5,0,0,5,21,17
20140918-W-Tokyo-R16-Garbine_Muguruza-Jelena_Jankovic,1,F-DTL,5,2,1,1,0,3,2
20140918-W-Tokyo-R16-Garbine_Muguruza-Jelena_Jankovic,1,F-IO,12,8,4,1,3,9,3
20140918-W-Tokyo-R16-Garbine_Muguruza-Jelena_Jankovic,1,B-XC,50,8,1,4,3,33,17
20140918-W-Tokyo-R16-Garbine_Muguruza-Jelena_Jankovic,1,B-DTM,66,4,0,1,3,38,28
20140918-W-Tokyo-R16-Garbine_Muguruza-Jelena_Jankovic,1,B-DTL,12,7,3,2,2,7,5
20140918-W-Tokyo-R16-Garbine_Muguruza-Jelena_Jankovic,1,B-IO,15,4,2,0,2,9,6
20140918-W-Tokyo-R16-Garbine_Muguruza-Jelena_Jankovic,1,S-XC,2,1,0,0,1,1,1
20140918-W-Tokyo-R16-Garbine_Muguruza-Jelena_Jankovic,1,S-DTM,3,0,0,0,0,2,1
20140918-W-Tokyo-R16-Garbine_Muguruza-Jelena_Jankovic,2,F-XC,29,8,4,0,4,14,15
20140918-W-Tokyo-R16-Garbine_Muguruza-Jelena_Jankovic,2,F-DTM,20,1,0,0,1,4,16
20140918-W-Tokyo-R16-Garbine_Muguruza-Jelena_Jankovic,2,F-DTL,26,6,1,0,5,10,16
20140918-W-Tokyo-R16-Garbine_Muguruza-Jelena_Jankovic,2,F-IO,41,16,4,4,8,17,24
20140918-W-Tokyo-R16-Garbine_Muguruza-Jelena_Jankovic,2,B-XC,35,9,0,1,8,10,25
20140918-W-Tokyo-R16-Garbine_Muguruza-Jelena_Jankovic,2,B-DTM,39,7,0,1,6,11,28
20140918-W-Tokyo-R16-Garbine_Muguruza-Jelena_Jankovic,2,B-DTL,11,9,8,0,1,8,3
20140918-W-Tokyo-R16-Garbine_Muguruza-Jelena_Jankovic,2,B-IO,25,11,4,2,5,11,14
20140918-W-Tokyo-R16-Garbine_Muguruza-Jelena_Jankovic,2,S-XC,5,2,1,0,1,2,3
20140918-W-Tokyo-R16-Garbine_Muguruza-Jelena_Jankovic,2,S-DTM,6,1,0,0,1,0,6
20130701-W-Wimbledon-R16-Kaia_Kanepi-Laura_Robson,1,F-XC,18,7,2,0,5,9,9
20130701-W-Wimbledon-R16-Kaia_Kanepi-Laura_Robson,1,F-DTM,19,2,0,0,2,10,9
20130701-W-Wimbledon-R16-Kaia_Kanepi-Laura_Robson,1,F-DTL,7,3,2,0,1,4,3
20130701-W-Wimbledon-R16-Kaia_Kanepi-Laura_Robson,1,F-IO,21,14,8,2,4,16,5
20130701-W-Wimbledon-R16-Kaia_Kanepi-Laura_Robson,1,B-XC,13,5,2,1,2,9,4
20130701-W-Wimbledon-R16-Kaia_Kanepi-Laura_Robson,1,B-DTM,22,4,0,0,4,9,13
20130701-W-Wimbledon-R16-Kaia_Kanepi-Laura_Robson,1,B-DTL,7,1,0,0,1,3,4
20130701-W-Wimbledon-R16-Kaia_Kanepi-Laura_Robson,1,B-IO,9,4,1,0,3,5,4
20130701-W-Wimbledon-R16-Kaia_Kanepi-Laura_Robson,1,S-DTM,2,0,0,0,0,2,0
20130701-W-Wimbledon-R16-Kaia_Kanepi-Laura_Robson,2,F-XC,26,10,2,3,5,13,13
20130701-W-Wimbledon-R16-Kaia_Kanepi-Laura_Robson,2,F-DTM,21,3,0,0,3,7,14
20130701-W-Wimbledon-R16-Kaia_Kanepi-Laura_Robson,2,F-DTL,5,3,1,0,2,1,4
20130701-W-Wimbledon-R16-Kaia_Kanepi-Laura_Robson,2,F-IO,23,13,5,1,7,13,10
20130701-W-Wimbledon-R16-Kaia_Kanepi-Laura_Robson,2,B-XC,15,3,1,0,2,7,8
20130701-W-Wimbledon-R16-Kaia_Kanepi-Laura_Robson,2,B-DTM,22,2,0,0,2,9,13
20130701-W-Wimbledon-R16-Kaia_Kanepi-Laura_Robson,2,B-DTL,3,2,0,0,2,0,3
20130701-W-Wimbledon-R16-Kaia_Kanepi-Laura_Robson,2,B-IO,2,2,1,0,1,1,1
20130701-W-Wimbledon-R16-Kaia_Kanepi-Laura_Robson,2,S-DTM,1,0,0,0,0,0,1
20060821-W-New_Haven-QF-Amelie_Mauresmo-Lindsay_Davenport,1,F-XC,21,8,3,0,5,9,12
20060821-W-New_Haven-QF-Amelie_Mauresmo-Lindsay_Davenport,1,F-DTM,11,1,0,0,1,7,4
20060821-W-New_Haven-QF-Amelie_Mauresmo-Lindsay_Davenport,1,F-DTL,19,7,4,1,2,12,7
20060821-W-New_Haven-QF-Amelie_Mauresmo-Lindsay_Davenport,1,F-IO,12,5,2,1,2,7,5
20060821-W-New_Haven-QF-Amelie_Mauresmo-Lindsay_Davenport,1,B-XC,16,3,0,0,3,7,9
20060821-W-New_Haven-QF-Amelie_Mauresmo-Lindsay_Davenport,1,B-DTM,27,2,0,0,2,12,15
20060821-W-New_Haven-QF-Amelie_Mauresmo-Lindsay_Davenport,1,B-DTL,7,2,0,0,2,4,3
20060821-W-New_Haven-QF-Amelie_Mauresmo-Lindsay_Davenport,1,B-IO,2,1,1,0,0,2,0
20060821-W-New_Haven-QF-Amelie_Mauresmo-Lindsay_Davenport,1,S-XC,7,1,0,0,1,2,5
20060821-W-New_Haven-QF-Amelie_Mauresmo-Lindsay_Davenport,1,S-DTM,20,2,0,0,2,11,9
20060821-W-New_Haven-QF-Amelie_Mauresmo-Lindsay_Davenport,1,S-DTL,6,0,0,0,0,2,4
20060821-W-New_Haven-QF-Amelie_Mauresmo-Lindsay_Davenport,2,F-XC,36,11,4,1,6,14,22
20060821-W-New_Haven-QF-Amelie_Mauresmo-Lindsay_Davenport,2,F-DTM,4,3,0,1,2,1,3
20060821-W-New_Haven-QF-Amelie_Mauresmo-Lindsay_Davenport,2,F-DTL,8,5,1,1,3,5,3
20060821-W-New_Haven-QF-Amelie_Mauresmo-Lindsay_Davenport,2,F-IO,31,8,2,3,3,18,13
20060821-W-New_Haven-QF-Amelie_Mauresmo-Lindsay_Davenport,2,B-XC,51,11,1,3,7,25,26
20060821-W-New_Haven-QF-Amelie_Mauresmo-Lindsay_Davenport,2,B-DTM,11,1,0,1,0,2,9
20060821-W-New_Haven-QF-Amelie_Mauresmo-Lindsay_Davenport,2,B-DTL,6,4,1,1,2,4,2
20060821-W-New_Haven-QF-Amelie_Mauresmo-Lindsay_Davenport,2,B-IO,9,5,0,2,3,3,6
20060821-W-New_Haven-QF-Amelie_Mauresmo-Lindsay_Davenport,2,S-XC,1,0,0,0,0,0,1
20140125-W-Australian_Open-F-Dominika_Cibulkova-Na_Li,1,F-XC,47,9,1,1,7,18,29
20140125-W-Australian_Open-F-Dominika_Cibulkova-Na_Li,1,F-DTM,57,4,2,0,2,23,34
20140125-W-Australian_Open-F-Dominika_Cibulkova-Na_Li,1,F-DTL,11,4,3,0,1,6,5
20140125-W-Australian_Open-F-Dominika_Cibulkova-Na_Li,1,F-IO,13,5,2,2,1,8,5
20140125-W-Australian_Open-F-Dominika_Cibulkova-Na_Li,1,B-XC,20,3,1,1,1,12,8
20140125-W-Australian_Open-F-Dominika_Cibulkova-Na_Li,1,B-DTM,40,2,0,1,1,17,23
20140125-W-Australian_Open-F-Dominika_Cibulkova-Na_Li,1,B-DTL,5,2,1,0,1,2,3
20140125-W-Australian_Open-F-Dominika_Cibulkova-Na_Li,1,B-IO,11,6,0,2,4,5,6
20140125-W-Australian_Open-F-Dominika_Cibulkova-Na_Li,1,S-XC,2,0,0,0,0,0,2
20140125-W-Australian_Open-F-Dominika_Cibulkova-Na_Li,1,S-DTM,8,0,0,0,0,2,6
20140125-W-Australian_Open-F-Dominika_Cibulkova-Na_Li,1,S-DTL,1,0,0,0,0,0,1
20140125-W-Australian_Open-F-Dominika_Cibulkova-Na_Li,2,F-XC,58,11,2,2,7,33,25
20140125-W-Australian_Open-F-Dominika_Cibulkova-Na_Li,2,F-DTM,45,6,0,0,6,25,20
20140125-W-Australian_Open-F-Dominika_Cibulkova-Na_Li,2,F-DTL,10,3,0,1,2,6,4
20140125-W-Australian_Open-F-Dominika_Cibulkova-Na_Li,2,F-IO,24,8,4,1,3,15,9
20140125-W-Australian_Open-F-Dominika_Cibulkova-Na_Li,2,B-XC,26,11,7,2,2,17,9
20140125-W-Australian_Open-F-Dominika_Cibulkova-Na_Li,2,B-DTM,29,0,0,0,0,15,14
20140125-W-Australian_Open-F-Dominika_Cibulkova-Na_Li,2,B-DTL,15,12,8,0,4,9,6
20140125-W-Australian_Open-F-Dominika_Cibulkova-Na_Li,2,B-IO,11,4,2,0,2,7,4
20140125-W-Australian_Open-F-Dominika_Cibulkova-Na_Li,2,S-XC,1,0,0,0,0,0,1
20140907-W-US_Open-F-Serena_Williams-Caroline_Wozniacki,1,F-XC,40,11,6,2,3,27,13
20140907-W-US_Open-F-Serena_Williams-Caroline_Wozniacki,1,F-DTM,29,3,0,0,3,13,16
20140907-W-US_Open-F-Serena_Williams-Caroline_Wozniacki,1,F-DTL,5,2,0,2,0,4,1
20140907-W-US_Open-F-Serena_Williams-Caroline_Wozniacki,1,F-IO,19,4,2,1,1,14,5
20140907-W-US_Open-F-Serena_Williams-Caroline_Wozniacki,1,B-XC,21,6,2,2,2,13,8
20140907-W-US_Open-F-Serena_Williams-Caroline_Wozniacki,1,B-DTM,21,6,0,0,6,7,14
20140907-W-US_Open-F-Serena_Williams-Caroline_Wozniacki,1,B-DTL,12,3,1,0,2,8,4
20140907-W-US_Open-F-Serena_Williams-Caroline_Wozniacki,1,B-IO,20,3,2,0,1,14,6
20140907-W-US_Open-F-Serena_Williams-Caroline_Wozniacki,1,S-DTM,1,0,0,0,0,1,0
20140907-W-US_Open-F-Serena_Williams-Caroline_Wozniacki,2,F-XC,28,7,0,2,5,10,18
20140907-W-US_Open-F-Serena_Williams-Caroline_Wozniacki,2,F-DTM,40,1,0,0,1,13,27
20140907-W-US_Open-F-Serena_Williams-Caroline_Wozniacki,2,F-DTL,10,2,0,1,1,5,5
20140907-W-US_Open-F-Serena_Williams-Caroline_Wozniacki,2,F-IO,9,0,0,0,0,3,6
20140907-W-US_Open-F-Serena_Williams-Caroline_Wozniacki,2,B-XC,17,4,1,1,2,10,7
20140907-W-US_Open-F-Serena_Williams-Caroline_Wozniacki,2,B-DTM,30,1,0,0,1,10,20
20140907-W-US_Open-F-Serena_Williams-Caroline_Wozniacki,2,B-DTL,6,1,0,1,0,3,3
20140907-W-US_Open-F-Serena_Williams-Caroline_Wozniacki,2,B-IO,10,3,0,2,1,5,5
20140907-W-US_Open-F-Serena_Williams-Caroline_Wozniacki,2,S-DTM,4,0,0,0,0,1,3
20140907-W-US_Open-F-Serena_Williams-Caroline_Wozniacki,2,S-DTL,4,1,0,0,1,0,4
20140102-W-Brisbane-QF-Angelique_Kerber-Jelena_Jankovic,1,F-XC,65,16,4,4,8,30,35
20140102-W-Brisbane-QF-Angelique_Kerber-Jelena_Jankovic,1,F-DTM,30,9,0,0,9,9,21
20140102-W-Brisbane-QF-Angelique_Kerber-Jelena_Jankovic,1,F-DTL,21,13,5,4,4,11,10
20140102-W-Brisbane-QF-Angelique_Kerber-Jelena_Jankovic,1,F-IO,36,22,9,1,12,19,17
20140102-W-Brisbane-QF-Angelique_Kerber-Jelena_Jankovic,1,B-XC,47,5,0,0,5,21,26
20140102-W-Brisbane-QF-Angelique_Kerber-Jelena_Jankovic,1,B-DTM,73,1,0,0,1,27,46
20140102-W-Brisbane-QF-Angelique_Kerber-Jelena_Jankovic,1,B-DTL,3,1,0,0,1,1,2
20140102-W-Brisbane-QF-Angelique_Kerber-Jelena_Jankovic,1,B-IO,13,3,0,1,2,7,6
20140102-W-Brisbane-QF-Angelique_Kerber-Jelena_Jankovic,1,S-DTM,7,0,0,0,0,3,4
20140102-W-Brisbane-QF-Angelique_Kerber-Jelena_Jankovic,1,S-DTL,1,0,0,0,0,0,1
20140102-W-Brisbane-QF-Angelique_Kerber-Jelena_Jankovic,2,F-XC,42,6,2,0,4,24,18
20140102-W-Brisbane-QF-Angelique_Kerber-Jelena_Jankovic,2,F-DTM,55,4,0,0,4,34,21
20140102-W-Brisbane-QF-Angelique_Kerber-Jelena_Jankovic,2,F-DTL,15,1,0,0,1,8,7
20140102-W-Brisbane-QF-Angelique_Kerber-Jelena_Jankovic,2,F-IO,34,20,13,2,5,21,13
20140102-W-Brisbane-QF-Angelique_Kerber-Jelena_Jankovic,2,B-XC,34,8,5,2,1,23,11
20140102-W-Brisbane-QF-Angelique_Kerber-Jelena_Jankovic,2,B-DTM,46,4,0,2,2,26,20
20140102-W-Brisbane-QF-Angelique_Kerber-Jelena_Jankovic,2,B-DTL,17,8,1,1,6,7,10
20140102-W-Brisbane-QF-Angelique_Kerber-Jelena_Jankovic,2,B-IO,31,13,7,2,4,18,13
20140102-W-Brisbane-QF-Angelique_Kerber-Jelena_Jankovic,2,S-XC,3,0,0,0,0,1,2
20140102-W-Brisbane-QF-Angelique_Kerber-Jelena_Jankovic,2,S-DTM,2,0,0,0,0,0,2
20140102-W-Brisbane-QF-Angelique_Kerber-Jelena_Jankovic,2,S-IO,2,0,0,0,0,1,1
20131031-W-Sofia-RR-Simona_Halep-Elina_Svitolina,1,F-XC,23,5,1,1,3,13,10
20131031-W-Sofia-RR-Simona_Halep-Elina_Svitolina,1,F-DTM,9,0,0,0,0,3,6
20131031-W-Sofia-RR-Simona_Halep-Elina_Svitolina,1,F-DTL,3,2,1,1,0,3,0
20131031-W-Sofia-RR-Simona_Halep-Elina_Svitolina,1,F-IO,15,5,3,0,2,7,8
20131031-W-Sofia-RR-Simona_Halep-Elina_Svitolina,1,F-II,1,1,0,1,0,1,0
20131031-W-Sofia-RR-Simona_Halep-Elina_Svitolina,1,B-XC,18,0,0,0,0,14,4
20131031-W-Sofia-RR-Simona_Halep-Elina_Svitolina,1,B-DTM,10,2,0,0,2,3,7
20131031-W-Sofia-RR-Simona_Halep-Elina_Svitolina,1,B-DTL,7,4,1,0,3,2,5
20131031-W-Sofia-RR-Simona_Halep-Elina_Svitolina,1,B-IO,4,1,0,0,1,2,2
20131031-W-Sofia-RR-Simona_Halep-Elina_Svitolina,1,S-DTM,3,0,0,0,0,2,1
20131031-W-Sofia-RR-Simona_Halep-Elina_Svitolina,1,S-DTL,2,0,0,0,0,2,0
20131031-W-Sofia-RR-Simona_Halep-Elina_Svitolina,2,F-XC,14,3,0,1,2,6,8
20131031-W-Sofia-RR-Simona_Halep-Elina_Svitolina,2,F-DTM,18,3,0,0,3,5,13
20131031-W-Sofia-RR-Simona_Halep-Elina_Svitolina,2,F-DTL,7,4,0,1,3,3,4
20131031-W-Sofia-RR-Simona_Halep-Elina_Svitolina,2,F-IO,4,2,0,1,1,1,3
20131031-W-Sofia-RR-Simona_Halep-Elina_Svitolina,2,B-XC,16,3,1,0,2,6,10
20131031-W-Sofia-RR-Simona_Halep-Elina_Svitolina,2,B-DTM,25,5,0,0,5,13,12
20131031-W-Sofia-RR-Simona_Halep-Elina_Svitolina,2,B-DTL,7,4,1,0,3,1,6
20131031-W-Sofia-RR-Simona_Halep-Elina_Svitolina,2,B-IO,4,2,1,0,1,3,1
20131031-W-Sofia-RR-Simona_Halep-Elina_Svitolina,2,S-XC,1,0,0,0,0,0,1
20131031-W-Sofia-RR-Simona_Halep-Elina_Svitolina,2,S-DTM,2,0,0,0,0,0,2
20131230-W-Brisbane-R32-Maria_Sharapova-Caroline_Garcia,1,F-XC,13,8,5,1,2,9,4
20131230-W-Brisbane-R32-Maria_Sharapova-Caroline_Garcia,1,F-DTM,13,3,0,1,2,10,3
20131230-W-Brisbane-R32-Maria_Sharapova-Caroline_Garcia,1,F-DTL,6,2,2,0,0,5,1
20131230-W-Brisbane-R32-Maria_Sharapova-Caroline_Garcia,1,F-IO,8,5,2,1,2,6,2
20131230-W-Brisbane-R32-Maria_Sharapova-Caroline_Garcia,1,B-XC,5,2,1,0,1,3,2
20131230-W-Brisbane-R32-Maria_Sharapova-Caroline_Garcia,1,B-DTM,5,1,0,0,1,3,2
20131230-W-Brisbane-R32-Maria_Sharapova-Caroline_Garcia,1,B-DTL,1,1,1,0,0,1,0
20131230-W-Brisbane-R32-Maria_Sharapova-Caroline_Garcia,1,B-IO,1,0,0,0,0,0,1
20131230-W-Brisbane-R32-Maria_Sharapova-Caroline_Garcia,1,S-DTM,1,0,0,0,0,1,0
20131230-W-Brisbane-R32-Maria_Sharapova-Caroline_Garcia,2,F-XC,11,5,2,0,3,4,7
20131230-W-Brisbane-R32-Maria_Sharapova-Caroline_Garcia,2,F-DTM,8,1,0,0,1,2,6
20131230-W-Brisbane-R32-Maria_Sharapova-Caroline_Garcia,2,F-DTL,3,2,1,0,1,2,1
20131230-W-Brisbane-R32-Maria_Sharapova-Caroline_Garcia,2,F-IO,4,3,0,1,2,1,3
20131230-W-Brisbane-R32-Maria_Sharapova-Caroline_Garcia,2,B-XC,5,2,0,0,2,2,3
20131230-W-Brisbane-R32-Maria_Sharapova-Caroline_Garcia,2,B-DTM,15,4,0,0,4,4,11
20131230-W-Brisbane-R32-Maria_Sharapova-Caroline_Garcia,2,B-DTL,2,1,0,0,1,0,2
20131230-W-Brisbane-R32-Maria_Sharapova-Caroline_Garcia,2,S-XC,1,0,0,0,0,1,0
20131230-W-Brisbane-R32-Maria_Sharapova-Caroline_Garcia,2,S-DTM,1,0,0,0,0,0,1
20131230-W-Brisbane-R32-Maria_Sharapova-Caroline_Garcia,2,S-DTL,1,0,0,0,0,0,1
20131230-W-Brisbane-R32-Maria_Sharapova-Caroline_Garcia,2,S-IO,1,0,0,0,0,0,1
20131229-W-Brisbane-R32-Elina_Svitolina-Varvara_Lepchenko,1,F-XC,13,5,0,3,2,8,5
20131229-W-Brisbane-R32-Elina_Svitolina-Varvara_Lepchenko,1,F-DTM,38,4,0,1,3,27,11
20131229-W-Brisbane-R32-Elina_Svitolina-Varvara_Lepchenko,1,F-DTL,2,1,0,1,0,1,1
20131229-W-Brisbane-R32-Elina_Svitolina-Varvara_Lepchenko,1,F-IO,5,2,0,1,1,3,2
20131229-W-Brisbane-R32-Elina_Svitolina-Varvara_Lepchenko,1,B-XC,12,2,1,1,0,11,1
20131229-W-Brisbane-R32-Elina_Svitolina-Varvara_Lepchenko,1,B-DTM,22,3,0,0,3,12,10
20131229-W-Brisbane-R32-Elina_Svitolina-Varvara_Lepchenko,1,B-DTL,7,3,1,2,0,3,4
20131229-W-Brisbane-R32-Elina_Svitolina-Varvara_Lepchenko,1,B-IO,6,3,1,2,0,5,1
20131229-W-Brisbane-R32-Elina_Svitolina-Varvara_Lepchenko,1,S-XC,1,1,0,1,0,1,0
20131229-W-Brisbane-R32-Elina_Svitolina-Varvara_Lepchenko,1,S-DTM,7,0,0,0,0,5,2
20131229-W-Brisbane-R32-Elina_Svitolina-Varvara_Lepchenko,1,S-DTL,1,0,0,0,0,1,0
20131229-W-Brisbane-R32-Elina_Svitolina-Varvara_Lepchenko,2,F-XC,30,8,1,2,5,13,17
20131229-W-Brisbane-R32-Elina_Svitolina-Varvara_Lepchenko,2,F-DTM,21,4,0,1,3,3,18
20131229-W-Brisbane-R32-Elina_Svitolina-Varvara_Lepchenko,2,F-DTL,7,1,0,0,1,1,6
20131229-W-Brisbane-R32-Elina_Svitolina-Varvara_Lepchenko,2,F-IO,20,9,3,0,6,8,12
20131229-W-Brisbane-R32-Elina_Svitolina-Varvara_Lepchenko,2,B-XC,7,5,1,1,3,2,5
20131229-W-Brisbane-R32-Elina_Svitolina-Varvara_Lepchenko,2,B-DTM,28,5,0,0,5,5,23
20131229-W-Brisbane-R32-Elina_Svitolina-Varvara_Lepchenko,2,B-DTL,3,1,0,1,0,1,2
20131229-W-Brisbane-R32-Elina_Svitolina-Varvara_Lepchenko,2,B-IO,3,2,1,0,1,2,1
20131229-W-Brisbane-R32-Elina_Svitolina-Varvara_Lepchenko,2,S-IO,1,1,0,0,1,0,1
20140701-W-Wimbledon-QF-Lucie_Safarova-Ekaterina_Makarova,1,F-XC,31,11,4,3,4,16,15
20140701-W-Wimbledon-QF-Lucie_Safarova-Ekaterina_Makarova,1,F-DTM,12,1,0,0,1,5,7
20140701-W-Wimbledon-QF-Lucie_Safarova-Ekaterina_Makarova,1,F-DTL,9,4,2,0,2,4,5
20140701-W-Wimbledon-QF-Lucie_Safarova-Ekaterina_Makarova,1,F-IO,8,6,1,2,3,4,4
20140701-W-Wimbledon-QF-Lucie_Safarova-Ekaterina_Makarova,1,F-II,2,1,1,0,0,1,1
20140701-W-Wimbledon-QF-Lucie_Safarova-Ekaterina_Makarova,1,B-XC,7,1,0,0,1,4,3
20140701-W-Wimbledon-QF-Lucie_Safarova-Ekaterina_Makarova,1,B-DTM,14,1,0,0,1,6,8
20140701-W-Wimbledon-QF-Lucie_Safarova-Ekaterina_Makarova,1,B-DTL,7,3,0,0,3,3,4
20140701-W-Wimbledon-QF-Lucie_Safarova-Ekaterina_Makarova,1,B-IO,1,0,0,0,0,0,1
20140701-W-Wimbledon-QF-Lucie_Safarova-Ekaterina_Makarova,1,S-XC,1,0,0,0,0,0,1
20140701-W-Wimbledon-QF-Lucie_Safarova-Ekaterina_Makarova,1,S-DTM,4,0,0,0,0,1,3
20140701-W-Wimbledon-QF-Lucie_Safarova-Ekaterina_Makarova,1,S-DTL,5,0,0,0,0,5,0
20140701-W-Wimbledon-QF-Lucie_Safarova-Ekaterina_Makarova,2,F-XC,28,6,0,1,5,14,14
20140701-W-Wimbledon-QF-Lucie_Safarova-Ekaterina_Makarova,2,F-DTM,12,0,0,0,0,7,5
20140701-W-Wimbledon-QF-Lucie_Safarova-Ekaterina_Makarova,2,F-DTL,11,7,1,1,5,3,8
20140701-W-Wimbledon-QF-Lucie_Safarova-Ekaterina_Makarova,2,F-IO,8,0,0,0,0,6,2
20140701-W-Wimbledon-QF-Lucie_Safarova-Ekaterina_Makarova,2,B-XC,22,5,1,3,1,11,11
20140701-W-Wimbledon-QF-Lucie_Safarova-Ekaterina_Makarova,2,B-DTM,8,1,0,0,1,3,5
20140701-W-Wimbledon-QF-Lucie_Safarova-Ekaterina_Makarova,2,B-DTL,4,1,1,0,0,2,2
20140701-W-Wimbledon-QF-Lucie_Safarova-Ekaterina_Makarova,2,B-IO,4,1,0,0,1,2,2
20140701-W-Wimbledon-QF-Lucie_Safarova-Ekaterina_Makarova,2,S-DTM,2,0,0,0,0,0,2
20140701-W-Wimbledon-QF-Lucie_Safarova-Ekaterina_Makarova,2,S-DTL,1,0,0,0,0,1,0
20140807-W-Montreal-R16-Heather_Watson-Victoria_Azarenka,1,F-XC,31,9,2,3,4,15,16
20140807-W-Montreal-R16-Heather_Watson-Victoria_Azarenka,1,F-DTM,33,5,0,0,5,11,22
20140807-W-Montreal-R16-Heather_Watson-Victoria_Azarenka,1,F-DTL,6,3,2,0,1,3,3
20140807-W-Montreal-R16-Heather_Watson-Victoria_Azarenka,1,F-IO,10,5,1,1,3,5,5
20140807-W-Montreal-R16-Heather_Watson-Victoria_Azarenka,1,F-II,1,0,0,0,0,1,0
20140807-W-Montreal-R16-Heather_Watson-Victoria_Azarenka,1,B-XC,50,10,4,1,5,20,30
20140807-W-Montreal-R16-Heather_Watson-Victoria_Azarenka,1,B-DTM,29,2,0,0,2,10,19
20140807-W-Montreal-R16-Heather_Watson-Victoria_Azarenka,1,B-DTL,12,8,1,3,4,5,7
20140807-W-Montreal-R16-Heather_Watson-Victoria_Azarenka,1,B-IO,16,8,3,1,4,4,12
20140807-W-Montreal-R16-Heather_Watson-Victoria_Azarenka,1,S-XC,3,0,0,0,0,2,1
20140807-W-Montreal-R16-Heather_Watson-Victoria_Azarenka,1,S-DTM,2,0,0,0,0,0,2
20140807-W-Montreal-R16-Heather_Watson-Victoria_Azarenka,1,S-IO,1,0,0,0,0,1,0
20140807-W-Montreal-R16-Heather_Watson-Victoria_Azarenka,2,F-XC,27,4,3,0,1,17,10
20140807-W-Montreal-R16-Heather_Watson-Victoria_Azarenka,2,F-DTM,19,0,0,0,0,9,10
20140807-W-Montreal-R16-Heather_Watson-Victoria_Azarenka,2,F-DTL,12,2,1,0,1,6,6
20140807-W-Montreal-R16-Heather_Watson-Victoria_Azarenka,2,F-IO,21,8,3,1,4,14,7
20140807-W-Montreal-R16-Heather_Watson-Victoria_Azarenka,2,B-XC,32,3,2,0,1,19,13
20140807-W-Montreal-R16-Heather_Watson-Victoria_Azarenka,2,B-DTM,34,0,0,0,0,25,9
20140807-W-Montreal-R16-Heather_Watson-Victoria_Azarenka,2,B-DTL,9,3,1,1,1,5,4
20140807-W-Montreal-R16-Heather_Watson-Victoria_Azarenka,2,B-IO,9,1,1,0,0,5,4
20140807-W-Montreal-R16-Heather_Watson-Victoria_Azarenka,2,S-XC,5,1,0,0,1,3,2
20140807-W-Montreal-R16-Heather_Watson-Victoria_Azarenka,2,S-DTM,5,0,0,0,0,2,3
20140807-W-Montreal-R16-Heather_Watson-Victoria_Azarenka,2,S-DTL,2,0,0,0,0,1,1
20140807-W-Montreal-R16-Heather_Watson-Victoria_Azarenka,2,S-IO,1,0,0,0,0,0,1
20130826-W-US_Open-R128-Ying_Ying_Duan-Caroline_Wozniacki,1,F-XC,54,17,4,1,12,16,38
20130826-W-US_Open-R128-Ying_Ying_Duan-Caroline_Wozniacki,1,F-DTM,19,2,1,0,1,7,12
20130826-W-US_Open-R128-Ying_Ying_Duan-Caroline_Wozniacki,1,F-DTL,10,6,0,0,6,2,8
20130826-W-US_Open-R128-Ying_Ying_Duan-Caroline_Wozniacki,1,F-IO,24,14,5,1,8,12,12
20130826-W-US_Open-R128-Ying_Ying_Duan-Caroline_Wozniacki,1,F-II,2,2,0,1,1,1,1
20130826-W-US_Open-R128-Ying_Ying_Duan-Caroline_Wozniacki,1,B-XC,32,12,3,1,8,16,16
20130826-W-US_Open-R128-Ying_Ying_Duan-Caroline_Wozniacki,1,B-DTM,20,2,0,0,2,7,13
20130826-W-US_Open-R128-Ying_Ying_Duan-Caroline_Wozniacki,1,B-DTL,9,5,4,0,1,6,3
20130826-W-US_Open-R128-Ying_Ying_Duan-Caroline_Wozniacki,1,B-IO,7,5,2,1,2,4,3
20130826-W-US_Open-R128-Ying_Ying_Duan-Caroline_Wozniacki,2,F-XC,27,7,2,0,5,18,9
20130826-W-US_Open-R128-Ying_Ying_Duan-Caroline_Wozniacki,2,F-DTM,31,0,0,0,0,19,12
20130826-W-US_Open-R128-Ying_Ying_Duan-Caroline_Wozniacki,2,F-DTL,16,3,2,1,0,12,4
20130826-W-US_Open-R128-Ying_Ying_Duan-Caroline_Wozniacki,2,F-IO,8,1,1,0,0,4,4
20130826-W-US_Open-R128-Ying_Ying_Duan-Caroline_Wozniacki,2,B-XC,16,1,0,0,1,5,11
20130826-W-US_Open-R128-Ying_Ying_Duan-Caroline_Wozniacki,2,B-DTM,30,2,0,0,2,19,11
20130826-W-US_Open-R128-Ying_Ying_Duan-Caroline_Wozniacki,2,B-DTL,5,2,2,0,0,2,3
20130826-W-US_Open-R128-Ying_Ying_Duan-Caroline_Wozniacki,2,B-IO,6,0,0,0,0,5,1
20130826-W-US_Open-R128-Ying_Ying_Duan-Caroline_Wozniacki,2,S-XC,2,0,0,0,0,2,0
20130826-W-US_Open-R128-Ying_Ying_Duan-Caroline_Wozniacki,2,S-DTM,3,0,0,0,0,2,1
20130402-W-Charleston-R32-Camila_Giorgi-Serena_Williams,1,F-XC,33,9,3,2,4,19,14
20130402-W-Charleston-R32-Camila_Giorgi-Serena_Williams,1,F-DTM,19,3,0,0,3,8,11
20130402-W-Charleston-R32-Camila_Giorgi-Serena_Williams,1,F-DTL,2,2,1,0,1,1,1
20130402-W-Charleston-R32-Camila_Giorgi-Serena_Williams,1,F-IO,7,4,2,1,1,6,1
20130402-W-Charleston-R32-Camila_Giorgi-Serena_Williams,1,B-XC,17,5,3,1,1,10,7
20130402-W-Charleston-R32-Camila_Giorgi-Serena_Williams,1,B-DTM,21,2,0,0,2,12,9
20130402-W-Charleston-R32-Camila_Giorgi-Serena_Williams,1,B-DTL,6,3,1,1,1,5,1
20130402-W-Charleston-R32-Camila_Giorgi-Serena_Williams,1,B-IO,8,3,1,1,1,4,4
20130402-W-Charleston-R32-Camila_Giorgi-Serena_Williams,1,S-DTM,1,0,0,0,0,1,0
20130402-W-Charleston-R32-Camila_Giorgi-Serena_Williams,1,S-DTL,1,0,0,0,0,0,1
20130402-W-Charleston-R32-Camila_Giorgi-Serena_Williams,2,F-XC,27,11,3,3,5,15,12
20130402-W-Charleston-R32-Camila_Giorgi-Serena_Williams,2,F-DTM,21,3,0,1,2,7,14
20130402-W-Charleston-R32-Camila_Giorgi-Serena_Williams,2,F-DTL,9,3,1,1,1,6,3
20130402-W-Charleston-R32-Camila_Giorgi-Serena_Williams,2,F-IO,12,5,1,1,3,3,9
20130402-W-Charleston-R32-Camila_Giorgi-Serena_Williams,2,B-XC,14,5,1,2,2,6,8
20130402-W-Charleston-R32-Camila_Giorgi-Serena_Williams,2,B-DTM,12,0,0,0,0,5,7
20130402-W-Charleston-R32-Camila_Giorgi-Serena_Williams,2,B-DTL,5,2,1,0,1,3,2
20130402-W-Charleston-R32-Camila_Giorgi-Serena_Williams,2,B-IO,6,2,1,1,0,3,3
20130402-W-Charleston-R32-Camila_Giorgi-Serena_Williams,2,S-DTM,1,0,0,0,0,0,1
20140916-W-Tokyo-R32-Madison_Keys-Lucie_Safarova,1,F-XC,28,12,5,3,4,17,11
20140916-W-Tokyo-R32-Madison_Keys-Lucie_Safarova,1,F-DTM,27,6,0,0,6,8,19
20140916-W-Tokyo-R32-Madison_Keys-Lucie_Safarova,1,F-DTL,8,5,2,1,2,4,4
20140916-W-Tokyo-R32-Madison_Keys-Lucie_Safarova,1,F-IO,21,13,7,4,2,15,6
20140916-W-Tokyo-R32-Madison_Keys-Lucie_Safarova,1,F-II,1,1,0,0,1,0,1
20140916-W-Tokyo-R32-Madison_Keys-Lucie_Safarova,1,B-XC,32,10,3,1,6,14,18
20140916-W-Tokyo-R32-Madison_Keys-Lucie_Safarova,1,B-DTM,34,4,0,0,4,16,18
20140916-W-Tokyo-R32-Madison_Keys-Lucie_Safarova,1,B-DTL,16,11,1,2,8,7,9
20140916-W-Tokyo-R32-Madison_Keys-Lucie_Safarova,1,B-IO,5,2,1,1,0,4,1
20140916-W-Tokyo-R32-Madison_Keys-Lucie_Safarova,1,S-XC,1,0,0,0,0,1,0
20140916-W-Tokyo-R32-Madison_Keys-Lucie_Safarova,1,S-DTM,4,0,0,0,0,1,3
20140916-W-Tokyo-R32-Madison_Keys-Lucie_Safarova,1,S-DTL,2,0,0,0,0,0,2
20140916-W-Tokyo-R32-Madison_Keys-Lucie_Safarova,2,F-XC,53,13,3,5,5,27,26
20140916-W-Tokyo-R32-Madison_Keys-Lucie_Safarova,2,F-DTM,24,1,0,0,1,13,11
20140916-W-Tokyo-R32-Madison_Keys-Lucie_Safarova,2,F-DTL,12,6,1,0,5,4,8
20140916-W-Tokyo-R32-Madison_Keys-Lucie_Safarova,2,F-IO,18,10,5,2,3,11,7
20140916-W-Tokyo-R32-Madison_Keys-Lucie_Safarova,2,F-II,1,1,1,0,0,1,0
20140916-W-Tokyo-R32-Madison_Keys-Lucie_Safarova,2,B-XC,13,4,2,1,1,10,3
20140916-W-Tokyo-R32-Madison_Keys-Lucie_Safarova,2,B-DTM,28,3,0,0,3,9,19
20140916-W-Tokyo-R32-Madison_Keys-Lucie_Safarova,2,B-DTL,5,0,0,0,0,2,3
20140916-W-Tokyo-R32-Madison_Keys-Lucie_Safarova,2,B-IO,13,4,1,2,1,8,5
20140916-W-Tokyo-R32-Madison_Keys-Lucie_Safarova,2,S-DTM,3,0,0,0,0,0,3
20140916-W-Tokyo-R32-Madison_Keys-Lucie_Safarova,2,S-DTL,3,0,0,0,0,0,3
20140320-W-Miami-R64-Shuai_Peng-Angelique_Kerber,1,F-XC,31,3,1,0,2,13,18
20140320-W-Miami-R64-Shuai_Peng-Angelique_Kerber,1,F-DTM,25,1,0,0,1,5,20
20140320-W-Miami-R64-Shuai_Peng-Angelique_Kerber,1,F-DTL,28,10,5,1,4,12,16
20140320-W-Miami-R64-Shuai_Peng-Angelique_Kerber,1,F-IO,27,8,3,0,5,16,11
20140320-W-Miami-R64-Shuai_Peng-Angelique_Kerber,1,B-XC,56,20,8,4,8,26,30
20140320-W-Miami-R64-Shuai_Peng-Angelique_Kerber,1,B-DTM,29,4,0,2,2,11,18
20140320-W-Miami-R64-Shuai_Peng-Angelique_Kerber,1,B-DTL,26,11,6,0,5,10,16
20140320-W-Miami-R64-Shuai_Peng-Angelique_Kerber,1,B-IO,24,10,6,2,2,14,10
20140320-W-Miami-R64-Shuai_Peng-Angelique_Kerber,1,S-DTL,1,0,0,0,0,0,1
20140320-W-Miami-R64-Shuai_Peng-Angelique_Kerber,2,F-XC,64,10,3,2,5,46,18
20140320-W-Miami-R64-Shuai_Peng-Angelique_Kerber,2,F-DTM,21,2,0,1,1,7,14
20140320-W-Miami-R64-Shuai_Peng-Angelique_Kerber,2,F-DTL,18,10,4,2,4,10,8
20140320-W-Miami-R64-Shuai_Peng-Angelique_Kerber,2,F-IO,21,7,4,1,2,18,3
20140320-W-Miami-R64-Shuai_Peng-Angelique_Kerber,2,F-II,1,0,0,0,0,1,0
20140320-W-Miami-R64-Shuai_Peng-Angelique_Kerber,2,B-XC,47,9,3,0,6,29,18
20140320-W-Miami-R64-Shuai_Peng-Angelique_Kerber,2,B-DTM,42,1,0,0,1,24,18
20140320-W-Miami-R64-Shuai_Peng-Angelique_Kerber,2,B-DTL,7,5,4,1,0,6,1
20140320-W-Miami-R64-Shuai_Peng-Angelique_Kerber,2,B-IO,6,3,1,2,0,5,1
20140320-W-Miami-R64-Shuai_Peng-Angelique_Kerber,2,S-XC,3,0,0,0,0,1,2
20140320-W-Miami-R64-Shuai_Peng-Angelique_Kerber,2,S-DTM,6,0,0,0,0,1,5
20140320-W-Miami-R64-Shuai_Peng-Angelique_Kerber,2,S-DTL,1,0,0,0,0,1,0
20140320-W-Miami-R64-Shuai_Peng-Angelique_Kerber,2,S-IO,1,0,0,0,0,0,1
20140808-W-Montreal-QF-Agnieszka_Radwanska-Victoria_Azarenka,1,F-XC,25,5,3,1,1,18,7
20140808-W-Montreal-QF-Agnieszka_Radwanska-Victoria_Azarenka,1,F-DTM,21,0,0,0,0,15,6
20140808-W-Montreal-QF-Agnieszka_Radwanska-Victoria_Azarenka,1,F-DTL,4,2,2,0,0,3,1
20140808-W-Montreal-QF-Agnieszka_Radwanska-Victoria_Azarenka,1,F-IO,8,0,0,0,0,6,2
20140808-W-Montreal-QF-Agnieszka_Radwanska-Victoria_Azarenka,1,B-XC,16,2,0,1,1,13,3
20140808-W-Montreal-QF-Agnieszka_Radwanska-Victoria_Azarenka,1,B-DTM,21,0,0,0,0,13,8
20140808-W-Montreal-QF-Agnieszka_Radwanska-Victoria_Azarenka,1,B-DTL,3,1,1,0,0,2,1
20140808-W-Montreal-QF-Agnieszka_Radwanska-Victoria_Azarenka,1,S-XC,8,1,1,0,0,6,2
20140808-W-Montreal-QF-Agnieszka_Radwanska-Victoria_Azarenka,1,S-DTM,6,0,0,0,0,5,1
20140808-W-Montreal-QF-Agnieszka_Radwanska-Victoria_Azarenka,1,S-DTL,3,0,0,0,0,1,2
20140808-W-Montreal-QF-Agnieszka_Radwanska-Victoria_Azarenka,1,S-IO,1,1,0,1,0,1,0
20140808-W-Montreal-QF-Agnieszka_Radwanska-Victoria_Azarenka,2,F-XC,22,6,1,1,4,6,16
20140808-W-Montreal-QF-Agnieszka_Radwanska-Victoria_Azarenka,2,F-DTM,6,1,0,0,1,1,5
20140808-W-Montreal-QF-Agnieszka_Radwanska-Victoria_Azarenka,2,F-DTL,12,4,1,0,3,6,6
20140808-W-Montreal-QF-Agnieszka_Radwanska-Victoria_Azarenka,2,F-IO,24,7,3,0,4,8,16
20140808-W-Montreal-QF-Agnieszka_Radwanska-Victoria_Azarenka,2,B-XC,21,3,1,1,1,6,15
20140808-W-Montreal-QF-Agnieszka_Radwanska-Victoria_Azarenka,2,B-DTM,18,3,0,0,3,1,17
20140808-W-Montreal-QF-Agnieszka_Radwanska-Victoria_Azarenka,2,B-DTL,10,3,0,0,3,4,6
20140808-W-Montreal-QF-Agnieszka_Radwanska-Victoria_Azarenka,2,B-IO,15,7,3,2,2,6,9
20140808-W-Montreal-QF-Agnieszka_Radwanska-Victoria_Azarenka,2,S-XC,2,0,0,0,0,1,1
20140808-W-Montreal-QF-Agnieszka_Radwanska-Victoria_Azarenka,2,S-DTM,5,0,0,0,0,1,4
20140808-W-Montreal-QF-Agnieszka_Radwanska-Victoria_Azarenka,2,S-DTL,2,0,0,0,0,0,2
20140808-W-Montreal-QF-Agnieszka_Radwanska-Victoria_Azarenka,2,S-IO,1,1,0,0,1,0,1
20140609-W-Birmingham-R32-Donna_Vekic-Belinda_Bencic,1,F-XC,23,4,1,2,1,13,10
20140609-W-Birmingham-R32-Donna_Vekic-Belinda_Bencic,1,F-DTM,18,3,0,0,3,7,11
20140609-W-Birmingham-R32-Donna_Vekic-Belinda_Bencic,1,F-DTL,6,2,1,0,1,4,2
20140609-W-Birmingham-R32-Donna_Vekic-Belinda_Bencic,1,F-IO,14,8,5,0,3,7,7
20140609-W-Birmingham-R32-Donna_Vekic-Belinda_Bencic,1,F-II,1,0,0,0,0,0,1
20140609-W-Birmingham-R32-Donna_Vekic-Belinda_Bencic,1,B-XC,24,7,1,2,4,12,12
20140609-W-Birmingham-R32-Donna_Vekic-Belinda_Bencic,1,B-DTM,17,3,1,0,2,7,10
20140609-W-Birmingham-R32-Donna_Vekic-Belinda_Bencic,1,B-DTL,2,2,0,1,1,1,1
20140609-W-Birmingham-R32-Donna_Vekic-Belinda_Bencic,1,B-IO,5,1,0,0,1,1,4
20140609-W-Birmingham-R32-Donna_Vekic-Belinda_Bencic,1,S-XC,1,0,0,0,0,1,0
20140609-W-Birmingham-R32-Donna_Vekic-Belinda_Bencic,1,S-DTM,1,0,0,0,0,1,0
20140609-W-Birmingham-R32-Donna_Vekic-Belinda_Bencic,2,F-XC,21,5,2,0,3,9,12
20140609-W-Birmingham-R32-Donna_Vekic-Belinda_Bencic,2,F-DTM,16,3,1,0,2,10,6
20140609-W-Birmingham-R32-Donna_Vekic-Belinda_Bencic,2,F-DTL,11,3,1,1,1,7,4
20140609-W-Birmingham-R32-Donna_Vekic-Belinda_Bencic,2,F-IO,15,4,2,2,0,9,6
20140609-W-Birmingham-R32-Donna_Vekic-Belinda_Bencic,2,B-XC,14,8,2,2,4,7,7
20140609-W-Birmingham-R32-Donna_Vekic-Belinda_Bencic,2,B-DTM,16,1,0,0,1,9,7
20140609-W-Birmingham-R32-Donna_Vekic-Belinda_Bencic,2,B-DTL,12,6,3,0,3,5,7
20140609-W-Birmingham-R32-Donna_Vekic-Belinda_Bencic,2,B-IO,15,7,2,2,3,7,8
20140609-W-Birmingham-R32-Donna_Vekic-Belinda_Bencic,2,S-XC,1,0,0,0,0,0,1
20140804-W-Montreal-R64-Sloane_Stephens-Aleksandra_Wozniak,1,F-XC,25,8,3,2,3,19,6
20140804-W-Montreal-R64-Sloane_Stephens-Aleksandra_Wozniak,1,F-DTM,16,3,0,0,3,12,4
20140804-W-Montreal-R64-Sloane_Stephens-Aleksandra_Wozniak,1,F-IO,19,9,2,2,5,12,7
20140804-W-Montreal-R64-Sloane_Stephens-Aleksandra_Wozniak,1,F-II,2,1,0,0,1,0,2
20140804-W-Montreal-R64-Sloane_Stephens-Aleksandra_Wozniak,1,B-XC,10,3,1,0,2,5,5
20140804-W-Montreal-R64-Sloane_Stephens-Aleksandra_Wozniak,1,B-DTM,19,3,0,1,2,10,9
20140804-W-Montreal-R64-Sloane_Stephens-Aleksandra_Wozniak,1,B-DTL,6,3,1,0,2,2,4
20140804-W-Montreal-R64-Sloane_Stephens-Aleksandra_Wozniak,1,B-IO,3,1,0,0,1,2,1
20140804-W-Montreal-R64-Sloane_Stephens-Aleksandra_Wozniak,1,S-DTM,1,0,0,0,0,1,0
20140804-W-Montreal-R64-Sloane_Stephens-Aleksandra_Wozniak,2,F-XC,21,6,0,1,5,5,16
20140804-W-Montreal-R64-Sloane_Stephens-Aleksandra_Wozniak,2,F-DTM,17,3,0,1,2,7,10
20140804-W-Montreal-R64-Sloane_Stephens-Aleksandra_Wozniak,2,F-DTL,8,1,0,1,0,3,5
20140804-W-Montreal-R64-Sloane_Stephens-Aleksandra_Wozniak,2,F-IO,11,4,0,0,4,3,8
20140804-W-Montreal-R64-Sloane_Stephens-Aleksandra_Wozniak,2,B-XC,13,4,0,0,4,6,7
20140804-W-Montreal-R64-Sloane_Stephens-Aleksandra_Wozniak,2,B-DTM,15,5,0,2,3,5,10
20140804-W-Montreal-R64-Sloane_Stephens-Aleksandra_Wozniak,2,B-DTL,1,0,0,0,0,0,1
20140804-W-Montreal-R64-Sloane_Stephens-Aleksandra_Wozniak,2,B-IO,3,1,0,0,1,1,2
20140804-W-Montreal-R64-Sloane_Stephens-Aleksandra_Wozniak,2,S-DTM,1,0,0,0,0,0,1
20130221-W-Dubai-QF-Agnieszka_Radwanska-Petra_Kvitova,1,F-XC,18,2,1,0,1,7,11
20130221-W-Dubai-QF-Agnieszka_Radwanska-Petra_Kvitova,1,F-DTM,29,3,0,1,2,14,15
20130221-W-Dubai-QF-Agnieszka_Radwanska-Petra_Kvitova,1,F-DTL,6,2,1,0,1,3,3
20130221-W-Dubai-QF-Agnieszka_Radwanska-Petra_Kvitova,1,F-IO,8,3,0,1,2,3,5
20130221-W-Dubai-QF-Agnieszka_Radwanska-Petra_Kvitova,1,B-XC,14,5,3,1,1,11,3
20130221-W-Dubai-QF-Agnieszka_Radwanska-Petra_Kvitova,1,B-DTM,16,0,0,0,0,9,7
20130221-W-Dubai-QF-Agnieszka_Radwanska-Petra_Kvitova,1,B-DTL,5,1,0,1,0,5,0
20130221-W-Dubai-QF-Agnieszka_Radwanska-Petra_Kvitova,1,S-XC,3,0,0,0,0,2,1
20130221-W-Dubai-QF-Agnieszka_Radwanska-Petra_Kvitova,1,S-DTM,3,1,0,0,1,2,1
20130221-W-Dubai-QF-Agnieszka_Radwanska-Petra_Kvitova,1,S-DTL,1,0,0,0,0,1,0
20130221-W-Dubai-QF-Agnieszka_Radwanska-Petra_Kvitova,1,S-IO,1,0,0,0,0,0,1
20130221-W-Dubai-QF-Agnieszka_Radwanska-Petra_Kvitova,2,F-XC,26,11,4,2,5,13,13
20130221-W-Dubai-QF-Agnieszka_Radwanska-Petra_Kvitova,2,F-DTM,8,0,0,0,0,2,6
20130221-W-Dubai-QF-Agnieszka_Radwanska-Petra_Kvitova,2,F-DTL,15,9,3,2,4,7,8
20130221-W-Dubai-QF-Agnieszka_Radwanska-Petra_Kvitova,2,F-IO,22,11,6,0,5,11,11
20130221-W-Dubai-QF-Agnieszka_Radwanska-Petra_Kvitova,2,B-XC,21,7,3,1,3,13,8
20130221-W-Dubai-QF-Agnieszka_Radwanska-Petra_Kvitova,2,B-DTM,10,1,0,0,1,5,5
20130221-W-Dubai-QF-Agnieszka_Radwanska-Petra_Kvitova,2,B-DTL,10,3,3,0,0,4,6
20130221-W-Dubai-QF-Agnieszka_Radwanska-Petra_Kvitova,2,B-IO,13,11,5,2,4,7,6
20130221-W-Dubai-QF-Agnieszka_Radwanska-Petra_Kvitova,2,S-DTM,5,1,0,0,1,3,2
20130221-W-Dubai-QF-Agnieszka_Radwanska-Petra_Kvitova,2,S-DTL,1,0,0,0,0,0,1
20130221-W-Dubai-QF-Agnieszka_Radwanska-Petra_Kvitova,2,S-IO,4,2,0,0,2,1,3
20140201-W-Paris_Open-SF-Alize_Cornet-Sara_Errani,1,F-XC,77,13,5,3,5,41,36
20140201-W-Paris_Open-SF-Alize_Cornet-Sara_Errani,1,F-DTM,43,6,0,1,5,19,24
20140201-W-Paris_Open-SF-Alize_Cornet-Sara_Errani,1,F-DTL,24,1,1,0,0,12,12
20140201-W-Paris_Open-SF-Alize_Cornet-Sara_Errani,1,F-IO,57,11,3,2,6,28,29
20140201-W-Paris_Open-SF-Alize_Cornet-Sara_Errani,1,F-II,5,1,1,0,0,2,3
20140201-W-Paris_Open-SF-Alize_Cornet-Sara_Errani,1,B-XC,181,16,5,3,8,88,93
20140201-W-Paris_Open-SF-Alize_Cornet-Sara_Errani,1,B-DTM,102,6,0,0,6,54,48
20140201-W-Paris_Open-SF-Alize_Cornet-Sara_Errani,1,B-DTL,26,11,7,1,3,17,9
20140201-W-Paris_Open-SF-Alize_Cornet-Sara_Errani,1,B-IO,18,8,4,1,3,11,7
20140201-W-Paris_Open-SF-Alize_Cornet-Sara_Errani,1,S-XC,13,1,0,0,1,4,9
20140201-W-Paris_Open-SF-Alize_Cornet-Sara_Errani,1,S-DTM,6,0,0,0,0,1,5
20140201-W-Paris_Open-SF-Alize_Cornet-Sara_Errani,1,S-IO,1,0,0,0,0,0,1
20140201-W-Paris_Open-SF-Alize_Cornet-Sara_Errani,2,F-XC,71,10,2,3,5,39,32
20140201-W-Paris_Open-SF-Alize_Cornet-Sara_Errani,2,F-DTM,40,4,0,0,4,18,22
20140201-W-Paris_Open-SF-Alize_Cornet-Sara_Errani,2,F-DTL,33,5,2,1,2,19,14
20140201-W-Paris_Open-SF-Alize_Cornet-Sara_Errani,2,F-IO,65,6,2,2,2,35,30
20140201-W-Paris_Open-SF-Alize_Cornet-Sara_Errani,2,F-II,7,2,0,1,1,3,4
20140201-W-Paris_Open-SF-Alize_Cornet-Sara_Errani,2,B-XC,145,14,2,3,9,67,78
20140201-W-Paris_Open-SF-Alize_Cornet-Sara_Errani,2,B-DTM,115,5,0,1,4,48,67
20140201-W-Paris_Open-SF-Alize_Cornet-Sara_Errani,2,B-DTL,25,10,5,4,1,17,8
20140201-W-Paris_Open-SF-Alize_Cornet-Sara_Errani,2,B-IO,7,2,2,0,0,5,2
20140201-W-Paris_Open-SF-Alize_Cornet-Sara_Errani,2,S-XC,23,3,0,1,2,13,10
20140201-W-Paris_Open-SF-Alize_Cornet-Sara_Errani,2,S-DTM,14,0,0,0,0,10,4
20140201-W-Paris_Open-SF-Alize_Cornet-Sara_Errani,2,S-DTL,4,0,0,0,0,2,2
20140201-W-Paris_Open-SF-Alize_Cornet-Sara_Errani,2,S-IO,1,0,0,0,0,1,0
20140816-W-Cincinnati-SF-Ana_Ivanovic-Maria_Sharapova,1,F-XC,40,13,3,2,8,17,23
20140816-W-Cincinnati-SF-Ana_Ivanovic-Maria_Sharapova,1,F-DTM,14,3,0,0,3,7,7
20140816-W-Cincinnati-SF-Ana_Ivanovic-Maria_Sharapova,1,F-DTL,11,3,1,1,1,8,3
20140816-W-Cincinnati-SF-Ana_Ivanovic-Maria_Sharapova,1,F-IO,18,9,4,1,4,9,9
20140816-W-Cincinnati-SF-Ana_Ivanovic-Maria_Sharapova,1,F-II,3,3,3,0,0,3,0
20140816-W-Cincinnati-SF-Ana_Ivanovic-Maria_Sharapova,1,B-XC,40,9,3,1,5,17,23
20140816-W-Cincinnati-SF-Ana_Ivanovic-Maria_Sharapova,1,B-DTM,34,4,1,1,2,18,16
20140816-W-Cincinnati-SF-Ana_Ivanovic-Maria_Sharapova,1,B-DTL,15,5,1,0,4,5,10
20140816-W-Cincinnati-SF-Ana_Ivanovic-Maria_Sharapova,1,B-IO,8,2,0,1,1,3,5
20140816-W-Cincinnati-SF-Ana_Ivanovic-Maria_Sharapova,1,S-XC,5,0,0,0,0,1,4
20140816-W-Cincinnati-SF-Ana_Ivanovic-Maria_Sharapova,1,S-DTM,12,0,0,0,0,6,6
20140816-W-Cincinnati-SF-Ana_Ivanovic-Maria_Sharapova,1,S-DTL,7,0,0,0,0,3,4
20140816-W-Cincinnati-SF-Ana_Ivanovic-Maria_Sharapova,2,F-XC,48,23,7,4,12,23,25
20140816-W-Cincinnati-SF-Ana_Ivanovic-Maria_Sharapova,2,F-DTM,23,2,0,0,2,11,12
20140816-W-Cincinnati-SF-Ana_Ivanovic-Maria_Sharapova,2,F-DTL,15,6,0,3,3,8,7
20140816-W-Cincinnati-SF-Ana_Ivanovic-Maria_Sharapova,2,F-IO,24,13,8,2,3,16,8
20140816-W-Cincinnati-SF-Ana_Ivanovic-Maria_Sharapova,2,B-XC,65,11,2,3,6,36,29
20140816-W-Cincinnati-SF-Ana_Ivanovic-Maria_Sharapova,2,B-DTM,39,5,0,4,1,25,14
20140816-W-Cincinnati-SF-Ana_Ivanovic-Maria_Sharapova,2,B-DTL,5,3,0,2,1,3,2
20140816-W-Cincinnati-SF-Ana_Ivanovic-Maria_Sharapova,2,B-IO,4,3,1,0,2,2,2
20140816-W-Cincinnati-SF-Ana_Ivanovic-Maria_Sharapova,2,S-XC,2,0,0,0,0,1,1
20140816-W-Cincinnati-SF-Ana_Ivanovic-Maria_Sharapova,2,S-DTM,1,0,0,0,0,0,1
20140816-W-Cincinnati-SF-Ana_Ivanovic-Maria_Sharapova,2,S-DTL,1,1,0,0,1,0,1
20140809-W-Montreal-SF-Serena_Williams-Venus_Williams,1,F-XC,34,9,0,5,4,14,20
20140809-W-Montreal-SF-Serena_Williams-Venus_Williams,1,F-DTM,12,2,0,0,2,6,6
20140809-W-Montreal-SF-Serena_Williams-Venus_Williams,1,F-DTL,2,2,1,0,1,1,1
20140809-W-Montreal-SF-Serena_Williams-Venus_Williams,1,F-IO,10,9,4,1,4,5,5
20140809-W-Montreal-SF-Serena_Williams-Venus_Williams,1,F-II,1,0,0,0,0,1,0
20140809-W-Montreal-SF-Serena_Williams-Venus_Williams,1,B-XC,32,12,2,3,7,16,16
20140809-W-Montreal-SF-Serena_Williams-Venus_Williams,1,B-DTM,36,4,0,0,4,13,23
20140809-W-Montreal-SF-Serena_Williams-Venus_Williams,1,B-DTL,12,4,0,0,4,5,7
20140809-W-Montreal-SF-Serena_Williams-Venus_Williams,1,B-IO,10,4,1,2,1,6,4
20140809-W-Montreal-SF-Serena_Williams-Venus_Williams,1,S-DTL,1,0,0,0,0,0,1
20140809-W-Montreal-SF-Serena_Williams-Venus_Williams,2,F-XC,32,13,6,6,1,24,8
20140809-W-Montreal-SF-Serena_Williams-Venus_Williams,2,F-DTM,40,8,0,1,7,18,22
20140809-W-Montreal-SF-Serena_Williams-Venus_Williams,2,F-DTL,8,5,2,1,2,6,2
20140809-W-Montreal-SF-Serena_Williams-Venus_Williams,2,F-IO,15,5,2,1,2,12,3
20140809-W-Montreal-SF-Serena_Williams-Venus_Williams,2,B-XC,32,4,1,1,2,16,16
20140809-W-Montreal-SF-Serena_Williams-Venus_Williams,2,B-DTM,17,2,0,1,1,8,9
20140809-W-Montreal-SF-Serena_Williams-Venus_Williams,2,B-DTL,3,1,0,0,1,2,1
20140809-W-Montreal-SF-Serena_Williams-Venus_Williams,2,B-IO,4,1,1,0,0,4,0
20140809-W-Montreal-SF-Serena_Williams-Venus_Williams,2,S-DTM,2,0,0,0,0,0,2
20150105-W-Brisbane-R32-Dominika_Cibulkova-Madison_Keys,1,F-XC,17,3,0,2,1,8,9
20150105-W-Brisbane-R32-Dominika_Cibulkova-Madison_Keys,1,F-DTM,12,1,0,0,1,6,6
20150105-W-Brisbane-R32-Dominika_Cibulkova-Madison_Keys,1,F-DTL,9,5,1,2,2,6,3
20150105-W-Brisbane-R32-Dominika_Cibulkova-Madison_Keys,1,F-IO,16,2,1,0,1,8,8
20150105-W-Brisbane-R32-Dominika_Cibulkova-Madison_Keys,1,F-II,1,1,1,0,0,1,0
20150105-W-Brisbane-R32-Dominika_Cibulkova-Madison_Keys,1,B-XC,23,4,2,0,2,14,9
20150105-W-Brisbane-R32-Dominika_Cibulkova-Madison_Keys,1,B-DTM,23,2,0,1,1,6,17
20150105-W-Brisbane-R32-Dominika_Cibulkova-Madison_Keys,1,B-DTL,3,1,1,0,0,2,1
20150105-W-Brisbane-R32-Dominika_Cibulkova-Madison_Keys,1,B-IO,5,2,0,2,0,3,2
20150105-W-Brisbane-R32-Dominika_Cibulkova-Madison_Keys,1,S-XC,3,1,0,0,1,1,2
20150105-W-Brisbane-R32-Dominika_Cibulkova-Madison_Keys,1,S-DTM,2,0,0,0,0,0,2
20150105-W-Brisbane-R32-Dominika_Cibulkova-Madison_Keys,1,S-DTL,2,0,0,0,0,0,2
20150105-W-Brisbane-R32-Dominika_Cibulkova-Madison_Keys,2,F-XC,28,9,6,0,3,16,12
20150105-W-Brisbane-R32-Dominika_Cibulkova-Madison_Keys,2,F-DTM,7,0,0,0,0,5,2
20150105-W-Brisbane-R32-Dominika_Cibulkova-Madison_Keys,2,F-DTL,6,2,2,0,0,4,2
20150105-W-Brisbane-R32-Dominika_Cibulkova-Madison_Keys,2,F-IO,10,4,3,0,1,4,6
20150105-W-Brisbane-R32-Dominika_Cibulkova-Madison_Keys,2,B-XC,31,12,2,2,8,18,13
20150105-W-Brisbane-R32-Dominika_Cibulkova-Madison_Keys,2,B-DTM,21,2,0,1,1,9,12
20150105-W-Brisbane-R32-Dominika_Cibulkova-Madison_Keys,2,B-DTL,7,4,4,0,0,4,3
20150105-W-Brisbane-R32-Dominika_Cibulkova-Madison_Keys,2,B-IO,3,3,3,0,0,3,0
20150105-W-Brisbane-R32-Dominika_Cibulkova-Madison_Keys,2,S-XC,3,0,0,0,0,1,2
20150105-W-Brisbane-R32-Dominika_Cibulkova-Madison_Keys,2,S-DTM,1,0,0,0,0,0,1
20140831-W-US_Open-R16-Belinda_Bencic-Jelena_Jankovic,1,F-XC,56,11,2,3,6,29,27
20140831-W-US_Open-R16-Belinda_Bencic-Jelena_Jankovic,1,F-DTM,44,4,1,0,3,19,25
20140831-W-US_Open-R16-Belinda_Bencic-Jelena_Jankovic,1,F-DTL,16,6,2,0,4,11,5
20140831-W-US_Open-R16-Belinda_Bencic-Jelena_Jankovic,1,F-IO,18,4,2,1,1,13,5
20140831-W-US_Open-R16-Belinda_Bencic-Jelena_Jankovic,1,B-XC,65,15,4,4,7,38,27
20140831-W-US_Open-R16-Belinda_Bencic-Jelena_Jankovic,1,B-DTM,50,4,0,1,3,27,23
20140831-W-US_Open-R16-Belinda_Bencic-Jelena_Jankovic,1,B-DTL,21,5,3,1,1,12,9
20140831-W-US_Open-R16-Belinda_Bencic-Jelena_Jankovic,1,B-IO,20,4,3,1,0,14,6
20140831-W-US_Open-R16-Belinda_Bencic-Jelena_Jankovic,1,S-DTL,1,0,0,0,0,0,1
20140831-W-US_Open-R16-Belinda_Bencic-Jelena_Jankovic,2,F-XC,39,6,2,1,3,21,18
20140831-W-US_Open-R16-Belinda_Bencic-Jelena_Jankovic,2,F-DTM,43,4,1,0,3,16,27
20140831-W-US_Open-R16-Belinda_Bencic-Jelena_Jankovic,2,F-DTL,38,9,5,1,3,17,21
20140831-W-US_Open-R16-Belinda_Bencic-Jelena_Jankovic,2,F-IO,31,6,2,0,4,17,14
20140831-W-US_Open-R16-Belinda_Bencic-Jelena_Jankovic,2,F-II,1,0,0,0,0,0,1
20140831-W-US_Open-R16-Belinda_Bencic-Jelena_Jankovic,2,B-XC,42,9,5,0,4,17,25
20140831-W-US_Open-R16-Belinda_Bencic-Jelena_Jankovic,2,B-DTM,32,0,0,0,0,11,21
20140831-W-US_Open-R16-Belinda_Bencic-Jelena_Jankovic,2,B-DTL,22,9,2,2,5,9,13
20140831-W-US_Open-R16-Belinda_Bencic-Jelena_Jankovic,2,B-IO,25,7,3,1,3,12,13
20140831-W-US_Open-R16-Belinda_Bencic-Jelena_Jankovic,2,S-XC,8,2,0,1,1,5,3
20140831-W-US_Open-R16-Belinda_Bencic-Jelena_Jankovic,2,S-DTM,13,1,0,0,1,3,10
20140702-W-Wimbledon-QF-Eugenie_Bouchard-Angelique_Kerber,1,F-XC,29,6,2,0,4,14,15
20140702-W-Wimbledon-QF-Eugenie_Bouchard-Angelique_Kerber,1,F-DTM,9,1,0,0,1,7,2
20140702-W-Wimbledon-QF-Eugenie_Bouchard-Angelique_Kerber,1,F-DTL,13,6,2,2,2,7,6
20140702-W-Wimbledon-QF-Eugenie_Bouchard-Angelique_Kerber,1,F-IO,22,9,6,0,3,15,7
20140702-W-Wimbledon-QF-Eugenie_Bouchard-Angelique_Kerber,1,F-II,1,1,0,1,0,1,0
20140702-W-Wimbledon-QF-Eugenie_Bouchard-Angelique_Kerber,1,B-XC,33,8,3,1,4,23,10
20140702-W-Wimbledon-QF-Eugenie_Bouchard-Angelique_Kerber,1,B-DTM,16,0,0,0,0,11,5
20140702-W-Wimbledon-QF-Eugenie_Bouchard-Angelique_Kerber,1,B-DTL,10,3,0,1,2,5,5
20140702-W-Wimbledon-QF-Eugenie_Bouchard-Angelique_Kerber,1,B-IO,2,1,1,0,0,2,0
20140702-W-Wimbledon-QF-Eugenie_Bouchard-Angelique_Kerber,1,S-XC,1,0,0,0,0,0,1
20140702-W-Wimbledon-QF-Eugenie_Bouchard-Angelique_Kerber,1,S-DTM,1,0,0,0,0,0,1
20140702-W-Wimbledon-QF-Eugenie_Bouchard-Angelique_Kerber,2,F-XC,44,6,1,3,2,18,26
20140702-W-Wimbledon-QF-Eugenie_Bouchard-Angelique_Kerber,2,F-DTM,9,0,0,0,0,3,6
20140702-W-Wimbledon-QF-Eugenie_Bouchard-Angelique_Kerber,2,F-DTL,21,15,9,2,4,13,8
20140702-W-Wimbledon-QF-Eugenie_Bouchard-Angelique_Kerber,2,F-IO,13,6,3,0,3,6,7
20140702-W-Wimbledon-QF-Eugenie_Bouchard-Angelique_Kerber,2,B-XC,19,4,0,0,4,7,12
20140702-W-Wimbledon-QF-Eugenie_Bouchard-Angelique_Kerber,2,B-DTM,17,1,1,0,0,9,8
20140702-W-Wimbledon-QF-Eugenie_Bouchard-Angelique_Kerber,2,B-DTL,6,1,1,0,0,5,1
20140702-W-Wimbledon-QF-Eugenie_Bouchard-Angelique_Kerber,2,B-IO,9,3,0,1,2,3,6
20140702-W-Wimbledon-QF-Eugenie_Bouchard-Angelique_Kerber,2,B-II,1,0,0,0,0,1,0
20140702-W-Wimbledon-QF-Eugenie_Bouchard-Angelique_Kerber,2,S-DTM,4,1,0,0,1,1,3
20140109-W-Sydney-SF-Madison_Keys-Angelique_Kerber,1,F-XC,13,4,2,0,2,5,8
20140109-W-Sydney-SF-Madison_Keys-Angelique_Kerber,1,F-DTM,26,3,0,0,3,6,20
20140109-W-Sydney-SF-Madison_Keys-Angelique_Kerber,1,F-DTL,7,3,2,0,1,3,4
20140109-W-Sydney-SF-Madison_Keys-Angelique_Kerber,1,F-IO,21,9,5,1,3,9,12
20140109-W-Sydney-SF-Madison_Keys-Angelique_Kerber,1,F-II,2,1,0,0,1,0,2
20140109-W-Sydney-SF-Madison_Keys-Angelique_Kerber,1,B-XC,23,9,2,2,5,9,14
20140109-W-Sydney-SF-Madison_Keys-Angelique_Kerber,1,B-DTM,24,5,0,1,4,8,16
20140109-W-Sydney-SF-Madison_Keys-Angelique_Kerber,1,B-IO,2,0,0,0,0,0,2
20140109-W-Sydney-SF-Madison_Keys-Angelique_Kerber,1,S-XC,2,0,0,0,0,1,1
20140109-W-Sydney-SF-Madison_Keys-Angelique_Kerber,1,S-DTM,3,0,0,0,0,0,3
20140109-W-Sydney-SF-Madison_Keys-Angelique_Kerber,1,S-DTL,2,1,0,0,1,0,2
20140109-W-Sydney-SF-Madison_Keys-Angelique_Kerber,2,F-XC,37,8,2,4,2,25,12
20140109-W-Sydney-SF-Madison_Keys-Angelique_Kerber,2,F-DTM,15,0,0,0,0,12,3
20140109-W-Sydney-SF-Madison_Keys-Angelique_Kerber,2,F-DTL,9,6,4,1,1,7,2
20140109-W-Sydney-SF-Madison_Keys-Angelique_Kerber,2,F-IO,18,8,1,3,4,10,8
20140109-W-Sydney-SF-Madison_Keys-Angelique_Kerber,2,B-XC,16,5,2,3,0,13,3
20140109-W-Sydney-SF-Madison_Keys-Angelique_Kerber,2,B-DTM,14,0,0,0,0,10,4
20140109-W-Sydney-SF-Madison_Keys-Angelique_Kerber,2,B-DTL,1,0,0,0,0,1,0
20140109-W-Sydney-SF-Madison_Keys-Angelique_Kerber,2,B-IO,6,0,0,0,0,3,3
20140109-W-Sydney-SF-Madison_Keys-Angelique_Kerber,2,S-DTL,1,0,0,0,0,1,0
20140916-W-Tokyo-R32-Elina_Svitolina-Barbora_Strycova,1,F-XC,44,12,4,5,3,27,17
20140916-W-Tokyo-R32-Elina_Svitolina-Barbora_Strycova,1,F-DTM,28,1,0,0,1,13,15
20140916-W-Tokyo-R32-Elina_Svitolina-Barbora_Strycova,1,F-DTL,12,6,3,1,2,7,5
20140916-W-Tokyo-R32-Elina_Svitolina-Barbora_Strycova,1,F-IO,17,5,2,2,1,10,7
20140916-W-Tokyo-R32-Elina_Svitolina-Barbora_Strycova,1,F-II,1,0,0,0,0,0,1
20140916-W-Tokyo-R32-Elina_Svitolina-Barbora_Strycova,1,B-XC,24,5,3,0,2,10,14
20140916-W-Tokyo-R32-Elina_Svitolina-Barbora_Strycova,1,B-DTM,35,3,0,1,2,21,14
20140916-W-Tokyo-R32-Elina_Svitolina-Barbora_Strycova,1,B-DTL,12,4,1,1,2,6,6
20140916-W-Tokyo-R32-Elina_Svitolina-Barbora_Strycova,1,B-IO,2,1,0,0,1,0,2
20140916-W-Tokyo-R32-Elina_Svitolina-Barbora_Strycova,1,S-XC,2,0,0,0,0,0,2
20140916-W-Tokyo-R32-Elina_Svitolina-Barbora_Strycova,1,S-DTM,4,1,0,0,1,0,4
20140916-W-Tokyo-R32-Elina_Svitolina-Barbora_Strycova,1,S-DTL,1,0,0,0,0,0,1
20140916-W-Tokyo-R32-Elina_Svitolina-Barbora_Strycova,2,F-XC,54,9,3,0,6,21,33
20140916-W-Tokyo-R32-Elina_Svitolina-Barbora_Strycova,2,F-DTM,19,1,0,0,1,9,10
20140916-W-Tokyo-R32-Elina_Svitolina-Barbora_Strycova,2,F-DTL,9,6,1,2,3,5,4
20140916-W-Tokyo-R32-Elina_Svitolina-Barbora_Strycova,2,F-IO,11,3,0,0,3,4,7
20140916-W-Tokyo-R32-Elina_Svitolina-Barbora_Strycova,2,F-II,1,1,0,1,0,1,0
20140916-W-Tokyo-R32-Elina_Svitolina-Barbora_Strycova,2,B-XC,25,2,0,0,2,11,14
20140916-W-Tokyo-R32-Elina_Svitolina-Barbora_Strycova,2,B-DTM,22,3,0,0,3,10,12
20140916-W-Tokyo-R32-Elina_Svitolina-Barbora_Strycova,2,B-DTL,5,1,0,1,0,2,3
20140916-W-Tokyo-R32-Elina_Svitolina-Barbora_Strycova,2,B-IO,7,2,0,2,0,5,2
20140916-W-Tokyo-R32-Elina_Svitolina-Barbora_Strycova,2,S-XC,7,0,0,0,0,3,4
20140916-W-Tokyo-R32-Elina_Svitolina-Barbora_Strycova,2,S-DTM,6,0,0,0,0,2,4
20140916-W-Tokyo-R32-Elina_Svitolina-Barbora_Strycova,2,S-DTL,2,0,0,0,0,1,1
20150105-W-Brisbane-R32-Sabine_Lisicki-Yaroslava_Shvedova,1,F-XC,37,15,9,2,4,21,16
20150105-W-Brisbane-R32-Sabine_Lisicki-Yaroslava_Shvedova,1,F-DTM,8,4,1,0,3,3,5
20150105-W-Brisbane-R32-Sabine_Lisicki-Yaroslava_Shvedova,1,F-DTL,12,8,3,2,3,6,6
20150105-W-Brisbane-R32-Sabine_Lisicki-Yaroslava_Shvedova,1,F-IO,15,8,3,2,3,9,6
20150105-W-Brisbane-R32-Sabine_Lisicki-Yaroslava_Shvedova,1,B-XC,29,5,1,1,3,19,10
20150105-W-Brisbane-R32-Sabine_Lisicki-Yaroslava_Shvedova,1,B-DTM,12,3,1,0,2,3,9
20150105-W-Brisbane-R32-Sabine_Lisicki-Yaroslava_Shvedova,1,B-DTL,13,6,5,0,1,7,6
20150105-W-Brisbane-R32-Sabine_Lisicki-Yaroslava_Shvedova,1,B-IO,6,3,2,0,1,3,3
20150105-W-Brisbane-R32-Sabine_Lisicki-Yaroslava_Shvedova,1,S-XC,2,0,0,0,0,1,1
20150105-W-Brisbane-R32-Sabine_Lisicki-Yaroslava_Shvedova,1,S-DTM,1,0,0,0,0,0,1
20150105-W-Brisbane-R32-Sabine_Lisicki-Yaroslava_Shvedova,1,S-DTL,1,0,0,0,0,1,0
20150105-W-Brisbane-R32-Sabine_Lisicki-Yaroslava_Shvedova,2,F-XC,33,11,1,4,6,21,12
20150105-W-Brisbane-R32-Sabine_Lisicki-Yaroslava_Shvedova,2,F-DTM,8,0,0,0,0,6,2
20150105-W-Brisbane-R32-Sabine_Lisicki-Yaroslava_Shvedova,2,F-DTL,15,6,3,1,2,7,8
20150105-W-Brisbane-R32-Sabine_Lisicki-Yaroslava_Shvedova,2,F-IO,6,5,2,2,1,4,2
20150105-W-Brisbane-R32-Sabine_Lisicki-Yaroslava_Shvedova,2,F-II,1,1,0,0,1,0,1
20150105-W-Brisbane-R32-Sabine_Lisicki-Yaroslava_Shvedova,2,B-XC,41,7,1,2,4,16,25
20150105-W-Brisbane-R32-Sabine_Lisicki-Yaroslava_Shvedova,2,B-DTM,14,1,0,1,0,6,8
20150105-W-Brisbane-R32-Sabine_Lisicki-Yaroslava_Shvedova,2,B-DTL,10,6,1,1,4,2,8
20150105-W-Brisbane-R32-Sabine_Lisicki-Yaroslava_Shvedova,2,B-IO,1,0,0,0,0,1,0
20150105-W-Brisbane-R32-Sabine_Lisicki-Yaroslava_Shvedova,2,S-XC,1,0,0,0,0,1,0
20150105-W-Brisbane-R32-Sabine_Lisicki-Yaroslava_Shvedova,2,S-DTM,1,0,0,0,0,0,1
20150105-W-Brisbane-R32-Sabine_Lisicki-Yaroslava_Shvedova,2,S-DTL,1,0,0,0,0,1,0
20150107-W-Auckland-R16-Caroline_Wozniacki-Taylor_Townsend,1,F-XC,30,3,0,1,2,18,12
20150107-W-Auckland-R16-Caroline_Wozniacki-Taylor_Townsend,1,F-DTM,19,2,0,0,2,9,10
20150107-W-Auckland-R16-Caroline_Wozniacki-Taylor_Townsend,1,F-DTL,10,2,1,0,1,6,4
20150107-W-Auckland-R16-Caroline_Wozniacki-Taylor_Townsend,1,F-IO,13,4,2,0,2,6,7
20150107-W-Auckland-R16-Caroline_Wozniacki-Taylor_Townsend,1,B-XC,35,5,2,3,0,22,13
20150107-W-Auckland-R16-Caroline_Wozniacki-Taylor_Townsend,1,B-DTM,17,2,0,0,2,8,9
20150107-W-Auckland-R16-Caroline_Wozniacki-Taylor_Townsend,1,B-DTL,13,2,0,2,0,8,5
20150107-W-Auckland-R16-Caroline_Wozniacki-Taylor_Townsend,1,B-IO,14,5,1,2,2,7,7
20150107-W-Auckland-R16-Caroline_Wozniacki-Taylor_Townsend,1,S-XC,2,0,0,0,0,1,1
20150107-W-Auckland-R16-Caroline_Wozniacki-Taylor_Townsend,1,S-DTM,2,0,0,0,0,1,1
20150107-W-Auckland-R16-Caroline_Wozniacki-Taylor_Townsend,1,S-DTL,1,0,0,0,0,0,1
20150107-W-Auckland-R16-Caroline_Wozniacki-Taylor_Townsend,2,F-XC,50,14,5,4,5,27,23
20150107-W-Auckland-R16-Caroline_Wozniacki-Taylor_Townsend,2,F-DTM,13,2,0,0,2,4,9
20150107-W-Auckland-R16-Caroline_Wozniacki-Taylor_Townsend,2,F-DTL,16,6,1,2,3,7,9
20150107-W-Auckland-R16-Caroline_Wozniacki-Taylor_Townsend,2,F-IO,14,7,1,1,5,6,8
20150107-W-Auckland-R16-Caroline_Wozniacki-Taylor_Townsend,2,F-II,2,1,0,0,1,0,2
20150107-W-Auckland-R16-Caroline_Wozniacki-Taylor_Townsend,2,B-XC,29,8,0,1,7,12,17
20150107-W-Auckland-R16-Caroline_Wozniacki-Taylor_Townsend,2,B-DTM,18,2,0,0,2,9,9
20150107-W-Auckland-R16-Caroline_Wozniacki-Taylor_Townsend,2,B-DTL,10,2,0,1,1,3,7
20150107-W-Auckland-R16-Caroline_Wozniacki-Taylor_Townsend,2,B-IO,1,1,0,0,1,0,1
20150107-W-Auckland-R16-Caroline_Wozniacki-Taylor_Townsend,2,B-II,2,1,1,0,0,2,0
20150107-W-Auckland-R16-Caroline_Wozniacki-Taylor_Townsend,2,S-XC,1,0,0,0,0,1,0
20150107-W-Auckland-R16-Caroline_Wozniacki-Taylor_Townsend,2,S-DTM,2,0,0,0,0,0,2
20150107-W-Auckland-R16-Caroline_Wozniacki-Taylor_Townsend,2,S-DTL,2,1,0,1,0,1,1
20150107-W-Brisbane-R16-Ana_Ivanovic-Jarmila_Gajdosova,1,F-XC,19,5,3,1,1,14,5
20150107-W-Brisbane-R16-Ana_Ivanovic-Jarmila_Gajdosova,1,F-DTM,10,1,0,0,1,6,4
20150107-W-Brisbane-R16-Ana_Ivanovic-Jarmila_Gajdosova,1,F-DTL,12,8,4,1,3,7,5
20150107-W-Brisbane-R16-Ana_Ivanovic-Jarmila_Gajdosova,1,F-IO,10,1,1,0,0,7,3
20150107-W-Brisbane-R16-Ana_Ivanovic-Jarmila_Gajdosova,1,F-II,2,2,1,0,1,1,1
20150107-W-Brisbane-R16-Ana_Ivanovic-Jarmila_Gajdosova,1,B-XC,10,5,4,0,1,7,3
20150107-W-Brisbane-R16-Ana_Ivanovic-Jarmila_Gajdosova,1,B-DTM,6,1,0,0,1,3,3
20150107-W-Brisbane-R16-Ana_Ivanovic-Jarmila_Gajdosova,1,B-DTL,14,3,1,0,2,5,9
20150107-W-Brisbane-R16-Ana_Ivanovic-Jarmila_Gajdosova,1,B-IO,5,0,0,0,0,5,0
20150107-W-Brisbane-R16-Ana_Ivanovic-Jarmila_Gajdosova,1,S-DTM,5,0,0,0,0,2,3
20150107-W-Brisbane-R16-Ana_Ivanovic-Jarmila_Gajdosova,1,S-DTL,3,0,0,0,0,1,2
20150107-W-Brisbane-R16-Ana_Ivanovic-Jarmila_Gajdosova,1,S-IO,1,0,0,0,0,1,0
20150107-W-Brisbane-R16-Ana_Ivanovic-Jarmila_Gajdosova,2,F-XC,17,4,1,1,2,7,10
20150107-W-Brisbane-R16-Ana_Ivanovic-Jarmila_Gajdosova,2,F-DTM,11,6,0,1,5,2,9
20150107-W-Brisbane-R16-Ana_Ivanovic-Jarmila_Gajdosova,2,F-DTL,19,5,1,2,2,10,9
20150107-W-Brisbane-R16-Ana_Ivanovic-Jarmila_Gajdosova,2,F-IO,8,4,0,2,2,5,3
20150107-W-Brisbane-R16-Ana_Ivanovic-Jarmila_Gajdosova,2,F-II,2,0,0,0,0,0,2
20150107-W-Brisbane-R16-Ana_Ivanovic-Jarmila_Gajdosova,2,B-XC,11,4,2,1,1,5,6
20150107-W-Brisbane-R16-Ana_Ivanovic-Jarmila_Gajdosova,2,B-DTM,16,3,1,0,2,8,8
20150107-W-Brisbane-R16-Ana_Ivanovic-Jarmila_Gajdosova,2,B-DTL,8,4,2,0,2,3,5
20150107-W-Brisbane-R16-Ana_Ivanovic-Jarmila_Gajdosova,2,B-IO,3,0,0,0,0,1,2
20150107-W-Brisbane-R16-Ana_Ivanovic-Jarmila_Gajdosova,2,S-XC,1,0,0,0,0,0,1
20150108-W-Brisbane-QF-Elina_Svitolina-Angelique_Kerber,1,F-XC,51,10,7,0,3,28,23
20150108-W-Brisbane-QF-Elina_Svitolina-Angelique_Kerber,1,F-DTM,47,4,1,1,2,21,26
20150108-W-Brisbane-QF-Elina_Svitolina-Angelique_Kerber,1,F-DTL,9,2,2,0,0,4,5
20150108-W-Brisbane-QF-Elina_Svitolina-Angelique_Kerber,1,F-IO,18,9,3,0,6,11,7
20150108-W-Brisbane-QF-Elina_Svitolina-Angelique_Kerber,1,F-II,1,1,0,0,1,0,1
20150108-W-Brisbane-QF-Elina_Svitolina-Angelique_Kerber,1,B-XC,73,23,9,5,9,33,40
20150108-W-Brisbane-QF-Elina_Svitolina-Angelique_Kerber,1,B-DTM,51,6,0,1,5,20,31
20150108-W-Brisbane-QF-Elina_Svitolina-Angelique_Kerber,1,B-DTL,6,3,2,0,1,4,2
20150108-W-Brisbane-QF-Elina_Svitolina-Angelique_Kerber,1,B-IO,6,2,0,0,2,2,4
20150108-W-Brisbane-QF-Elina_Svitolina-Angelique_Kerber,1,B-II,1,1,1,0,0,1,0
20150108-W-Brisbane-QF-Elina_Svitolina-Angelique_Kerber,1,S-XC,8,1,1,0,0,4,4
20150108-W-Brisbane-QF-Elina_Svitolina-Angelique_Kerber,1,S-DTM,10,0,0,0,0,4,6
20150108-W-Brisbane-QF-Elina_Svitolina-Angelique_Kerber,1,S-DTL,1,1,0,1,0,1,0
20150108-W-Brisbane-QF-Elina_Svitolina-Angelique_Kerber,2,F-XC,90,17,5,6,6,55,35
20150108-W-Brisbane-QF-Elina_Svitolina-Angelique_Kerber,2,F-DTM,30,4,1,2,1,18,12
20150108-W-Brisbane-QF-Elina_Svitolina-Angelique_Kerber,2,F-DTL,33,16,7,3,6,17,16
20150108-W-Brisbane-QF-Elina_Svitolina-Angelique_Kerber,2,F-IO,36,19,5,2,12,16,20
20150108-W-Brisbane-QF-Elina_Svitolina-Angelique_Kerber,2,B-XC,41,8,3,2,3,26,15
20150108-W-Brisbane-QF-Elina_Svitolina-Angelique_Kerber,2,B-DTM,40,3,0,0,3,17,23
20150108-W-Brisbane-QF-Elina_Svitolina-Angelique_Kerber,2,B-DTL,5,1,1,0,0,4,1
20150108-W-Brisbane-QF-Elina_Svitolina-Angelique_Kerber,2,B-IO,17,3,2,0,1,13,4
20150108-W-Brisbane-QF-Elina_Svitolina-Angelique_Kerber,2,B-II,3,1,0,0,1,0,3
20150108-W-Brisbane-QF-Elina_Svitolina-Angelique_Kerber,2,S-XC,2,0,0,0,0,1,1
20150108-W-Brisbane-QF-Elina_Svitolina-Angelique_Kerber,2,S-DTM,6,0,0,0,0,2,4
20150108-W-Brisbane-QF-Elina_Svitolina-Angelique_Kerber,2,S-IO,1,0,0,0,0,0,1
20140909-W-Tashkent-R32-Jelena_Ostapenko-Shahar_Peer,1,F-XC,48,15,5,3,7,21,27
20140909-W-Tashkent-R32-Jelena_Ostapenko-Shahar_Peer,1,F-DTM,13,0,0,0,0,6,7
20140909-W-Tashkent-R32-Jelena_Ostapenko-Shahar_Peer,1,F-DTL,7,4,2,1,1,4,3
20140909-W-Tashkent-R32-Jelena_Ostapenko-Shahar_Peer,1,F-IO,10,5,4,1,0,9,1
20140909-W-Tashkent-R32-Jelena_Ostapenko-Shahar_Peer,1,B-XC,37,13,3,5,5,19,18
20140909-W-Tashkent-R32-Jelena_Ostapenko-Shahar_Peer,1,B-DTM,27,2,0,0,2,13,14
20140909-W-Tashkent-R32-Jelena_Ostapenko-Shahar_Peer,1,B-DTL,11,6,1,1,4,3,8
20140909-W-Tashkent-R32-Jelena_Ostapenko-Shahar_Peer,1,B-IO,7,7,3,3,1,6,1
20140909-W-Tashkent-R32-Jelena_Ostapenko-Shahar_Peer,1,S-XC,1,0,0,0,0,1,0
20140909-W-Tashkent-R32-Jelena_Ostapenko-Shahar_Peer,2,F-XC,25,1,0,1,0,18,7
20140909-W-Tashkent-R32-Jelena_Ostapenko-Shahar_Peer,2,F-DTM,26,1,0,0,1,9,17
20140909-W-Tashkent-R32-Jelena_Ostapenko-Shahar_Peer,2,F-DTL,10,2,0,1,1,6,4
20140909-W-Tashkent-R32-Jelena_Ostapenko-Shahar_Peer,2,F-IO,14,3,0,0,3,5,9
20140909-W-Tashkent-R32-Jelena_Ostapenko-Shahar_Peer,2,B-XC,22,7,4,2,1,14,8
20140909-W-Tashkent-R32-Jelena_Ostapenko-Shahar_Peer,2,B-DTM,29,1,0,0,1,11,18
20140909-W-Tashkent-R32-Jelena_Ostapenko-Shahar_Peer,2,B-DTL,4,1,0,0,1,2,2
20140909-W-Tashkent-R32-Jelena_Ostapenko-Shahar_Peer,2,B-IO,10,2,1,0,1,5,5
20140909-W-Tashkent-R32-Jelena_Ostapenko-Shahar_Peer,2,S-DTM,1,0,0,0,0,1,0
20140909-W-Tashkent-R32-Jelena_Ostapenko-Shahar_Peer,2,S-DTL,1,0,0,0,0,0,1
20150105-W-Auckland-R32-Daniela_Hantuchova-Sara_Errani,1,F-XC,18,5,3,2,0,9,9
20150105-W-Auckland-R32-Daniela_Hantuchova-Sara_Errani,1,F-DTM,13,1,0,0,1,6,7
20150105-W-Auckland-R32-Daniela_Hantuchova-Sara_Errani,1,F-DTL,9,4,1,1,2,6,3
20150105-W-Auckland-R32-Daniela_Hantuchova-Sara_Errani,1,F-IO,27,7,3,0,4,15,12
20150105-W-Auckland-R32-Daniela_Hantuchova-Sara_Errani,1,F-II,1,1,1,0,0,1,0
20150105-W-Auckland-R32-Daniela_Hantuchova-Sara_Errani,1,B-XC,24,3,2,0,1,13,11
20150105-W-Auckland-R32-Daniela_Hantuchova-Sara_Errani,1,B-DTM,25,4,0,0,4,13,12
20150105-W-Auckland-R32-Daniela_Hantuchova-Sara_Errani,1,B-DTL,9,7,5,0,2,6,3
20150105-W-Auckland-R32-Daniela_Hantuchova-Sara_Errani,1,B-IO,13,11,8,0,3,9,4
20150105-W-Auckland-R32-Daniela_Hantuchova-Sara_Errani,1,S-XC,2,0,0,0,0,0,2
20150105-W-Auckland-R32-Daniela_Hantuchova-Sara_Errani,1,S-DTM,1,0,0,0,0,1,0
20150105-W-Auckland-R32-Daniela_Hantuchova-Sara_Errani,1,S-DTL,1,1,0,0,1,0,1
20150105-W-Auckland-R32-Daniela_Hantuchova-Sara_Errani,2,F-XC,21,4,1,2,1,15,6
20150105-W-Auckland-R32-Daniela_Hantuchova-Sara_Errani,2,F-DTM,16,0,0,0,0,6,10
20150105-W-Auckland-R32-Daniela_Hantuchova-Sara_Errani,2,F-DTL,5,0,0,0,0,3,2
20150105-W-Auckland-R32-Daniela_Hantuchova-Sara_Errani,2,F-IO,9,1,0,0,1,5,4
20150105-W-Auckland-R32-Daniela_Hantuchova-Sara_Errani,2,F-II,2,1,1,0,0,1,1
20150105-W-Auckland-R32-Daniela_Hantuchova-Sara_Errani,2,B-XC,24,4,0,1,3,10,14
20150105-W-Auckland-R32-Daniela_Hantuchova-Sara_Errani,2,B-DTM,37,1,0,0,1,16,21
20150105-W-Auckland-R32-Daniela_Hantuchova-Sara_Errani,2,B-DTL,8,5,2,3,0,6,2
20150105-W-Auckland-R32-Daniela_Hantuchova-Sara_Errani,2,S-XC,2,1,0,0,1,1,1
20150105-W-Auckland-R32-Daniela_Hantuchova-Sara_Errani,2,S-DTM,4,0,0,0,0,1,3
20150105-W-Auckland-R32-Daniela_Hantuchova-Sara_Errani,2,S-DTL,2,1,0,0,1,0,2
20130219-W-Dubai-R32-Samantha_Stosur-Ekaterina_Makarova,1,F-XC,21,6,1,1,4,14,7
20130219-W-Dubai-R32-Samantha_Stosur-Ekaterina_Makarova,1,F-DTM,20,2,0,1,1,10,10
20130219-W-Dubai-R32-Samantha_Stosur-Ekaterina_Makarova,1,F-DTL,6,2,0,0,2,3,3
20130219-W-Dubai-R32-Samantha_Stosur-Ekaterina_Makarova,1,F-IO,31,16,2,5,9,13,18
20130219-W-Dubai-R32-Samantha_Stosur-Ekaterina_Makarova,1,F-II,3,2,1,0,1,1,2
20130219-W-Dubai-R32-Samantha_Stosur-Ekaterina_Makarova,1,B-XC,5,0,0,0,0,3,2
20130219-W-Dubai-R32-Samantha_Stosur-Ekaterina_Makarova,1,B-DTM,23,4,0,0,4,12,11
20130219-W-Dubai-R32-Samantha_Stosur-Ekaterina_Makarova,1,B-DTL,12,8,1,1,6,5,7
20130219-W-Dubai-R32-Samantha_Stosur-Ekaterina_Makarova,1,B-IO,2,1,0,0,1,0,2
20130219-W-Dubai-R32-Samantha_Stosur-Ekaterina_Makarova,1,S-XC,22,2,0,1,1,11,11
20130219-W-Dubai-R32-Samantha_Stosur-Ekaterina_Makarova,1,S-DTM,11,2,0,0,2,6,5
20130219-W-Dubai-R32-Samantha_Stosur-Ekaterina_Makarova,1,S-DTL,2,0,0,0,0,2,0
20130219-W-Dubai-R32-Samantha_Stosur-Ekaterina_Makarova,2,F-XC,50,5,1,0,4,25,25
20130219-W-Dubai-R32-Samantha_Stosur-Ekaterina_Makarova,2,F-DTM,9,1,0,0,1,5,4
20130219-W-Dubai-R32-Samantha_Stosur-Ekaterina_Makarova,2,F-DTL,9,5,0,1,4,3,6
20130219-W-Dubai-R32-Samantha_Stosur-Ekaterina_Makarova,2,F-IO,3,3,1,0,2,1,2
20130219-W-Dubai-R32-Samantha_Stosur-Ekaterina_Makarova,2,B-XC,20,4,0,2,2,6,14
20130219-W-Dubai-R32-Samantha_Stosur-Ekaterina_Makarova,2,B-DTM,30,5,0,0,5,14,16
20130219-W-Dubai-R32-Samantha_Stosur-Ekaterina_Makarova,2,B-DTL,13,3,1,0,2,5,8
20130219-W-Dubai-R32-Samantha_Stosur-Ekaterina_Makarova,2,B-IO,13,2,0,0,2,5,8
20150109-W-Brisbane-SF-Maria_Sharapova-Elina_Svitolina,1,F-XC,36,9,5,1,3,17,19
20150109-W-Brisbane-SF-Maria_Sharapova-Elina_Svitolina,1,F-DTM,18,0,0,0,0,7,11
20150109-W-Brisbane-SF-Maria_Sharapova-Elina_Svitolina,1,F-DTL,7,3,1,0,2,2,5
20150109-W-Brisbane-SF-Maria_Sharapova-Elina_Svitolina,1,F-IO,17,8,6,0,2,12,5
20150109-W-Brisbane-SF-Maria_Sharapova-Elina_Svitolina,1,F-II,1,0,0,0,0,1,0
20150109-W-Brisbane-SF-Maria_Sharapova-Elina_Svitolina,1,B-XC,50,20,4,7,9,19,31
20150109-W-Brisbane-SF-Maria_Sharapova-Elina_Svitolina,1,B-DTM,21,3,0,0,3,8,13
20150109-W-Brisbane-SF-Maria_Sharapova-Elina_Svitolina,1,B-DTL,11,3,2,0,1,5,6
20150109-W-Brisbane-SF-Maria_Sharapova-Elina_Svitolina,1,B-IO,5,0,0,0,0,3,2
20150109-W-Brisbane-SF-Maria_Sharapova-Elina_Svitolina,1,S-XC,1,0,0,0,0,0,1
20150109-W-Brisbane-SF-Maria_Sharapova-Elina_Svitolina,1,S-DTM,2,0,0,0,0,1,1
20150109-W-Brisbane-SF-Maria_Sharapova-Elina_Svitolina,1,S-IO,1,1,0,1,0,1,0
20150109-W-Brisbane-SF-Maria_Sharapova-Elina_Svitolina,2,F-XC,17,2,1,0,1,13,4
20150109-W-Brisbane-SF-Maria_Sharapova-Elina_Svitolina,2,F-DTM,37,5,0,0,5,15,22
20150109-W-Brisbane-SF-Maria_Sharapova-Elina_Svitolina,2,F-DTL,9,5,3,2,0,8,1
20150109-W-Brisbane-SF-Maria_Sharapova-Elina_Svitolina,2,F-IO,5,1,1,0,0,4,1
20150109-W-Brisbane-SF-Maria_Sharapova-Elina_Svitolina,2,B-XC,36,5,0,1,4,23,13
20150109-W-Brisbane-SF-Maria_Sharapova-Elina_Svitolina,2,B-DTM,33,3,0,1,2,15,18
20150109-W-Brisbane-SF-Maria_Sharapova-Elina_Svitolina,2,B-DTL,3,1,0,0,1,2,1
20150109-W-Brisbane-SF-Maria_Sharapova-Elina_Svitolina,2,B-IO,1,0,0,0,0,1,0
20150109-W-Brisbane-SF-Maria_Sharapova-Elina_Svitolina,2,S-XC,5,0,0,0,0,3,2
20150109-W-Brisbane-SF-Maria_Sharapova-Elina_Svitolina,2,S-DTM,4,0,0,0,0,2,2
20150109-W-Brisbane-SF-Maria_Sharapova-Elina_Svitolina,2,S-DTL,1,0,0,0,0,0,1
20141101-W-Sofia-SF-Flavia_Pennetta-Carla_Suarez_Navarro,1,F-XC,41,9,3,0,6,24,17
20141101-W-Sofia-SF-Flavia_Pennetta-Carla_Suarez_Navarro,1,F-DTM,45,5,1,0,4,21,24
20141101-W-Sofia-SF-Flavia_Pennetta-Carla_Suarez_Navarro,1,F-DTL,18,1,1,0,0,9,9
20141101-W-Sofia-SF-Flavia_Pennetta-Carla_Suarez_Navarro,1,F-IO,30,5,3,1,1,24,6
20141101-W-Sofia-SF-Flavia_Pennetta-Carla_Suarez_Navarro,1,B-XC,40,12,6,2,4,23,17
20141101-W-Sofia-SF-Flavia_Pennetta-Carla_Suarez_Navarro,1,B-DTM,28,3,0,1,2,15,13
20141101-W-Sofia-SF-Flavia_Pennetta-Carla_Suarez_Navarro,1,B-DTL,13,10,5,1,4,8,5
20141101-W-Sofia-SF-Flavia_Pennetta-Carla_Suarez_Navarro,1,B-IO,3,1,0,0,1,1,2
20141101-W-Sofia-SF-Flavia_Pennetta-Carla_Suarez_Navarro,1,S-DTM,3,0,0,0,0,0,3
20141101-W-Sofia-SF-Flavia_Pennetta-Carla_Suarez_Navarro,1,S-DTL,2,2,1,0,1,1,1
20141101-W-Sofia-SF-Flavia_Pennetta-Carla_Suarez_Navarro,2,F-XC,45,8,1,2,5,18,27
20141101-W-Sofia-SF-Flavia_Pennetta-Carla_Suarez_Navarro,2,F-DTM,49,3,0,1,2,18,31
20141101-W-Sofia-SF-Flavia_Pennetta-Carla_Suarez_Navarro,2,F-DTL,7,4,2,0,2,4,3
20141101-W-Sofia-SF-Flavia_Pennetta-Carla_Suarez_Navarro,2,F-IO,17,6,4,0,2,12,5
20141101-W-Sofia-SF-Flavia_Pennetta-Carla_Suarez_Navarro,2,F-II,1,0,0,0,0,1,0
20141101-W-Sofia-SF-Flavia_Pennetta-Carla_Suarez_Navarro,2,B-XC,33,9,2,2,5,14,19
20141101-W-Sofia-SF-Flavia_Pennetta-Carla_Suarez_Navarro,2,B-DTM,32,5,0,0,5,12,20
20141101-W-Sofia-SF-Flavia_Pennetta-Carla_Suarez_Navarro,2,B-DTL,9,3,1,0,2,3,6
20141101-W-Sofia-SF-Flavia_Pennetta-Carla_Suarez_Navarro,2,B-IO,6,4,1,0,3,2,4
20141101-W-Sofia-SF-Flavia_Pennetta-Carla_Suarez_Navarro,2,S-XC,4,0,0,0,0,1,3
20141101-W-Sofia-SF-Flavia_Pennetta-Carla_Suarez_Navarro,2,S-DTM,11,1,0,0,1,4,7
20141101-W-Sofia-SF-Flavia_Pennetta-Carla_Suarez_Navarro,2,S-DTL,6,0,0,0,0,1,5
20150108-W-Shenzhen-QF-Tereza_Smitkova-Petra_Kvitova,1,F-XC,31,13,3,4,6,15,16
20150108-W-Shenzhen-QF-Tereza_Smitkova-Petra_Kvitova,1,F-DTM,17,4,0,1,3,10,7
20150108-W-Shenzhen-QF-Tereza_Smitkova-Petra_Kvitova,1,F-DTL,8,4,0,1,3,1,7
20150108-W-Shenzhen-QF-Tereza_Smitkova-Petra_Kvitova,1,F-IO,20,5,1,1,3,9,11
20150108-W-Shenzhen-QF-Tereza_Smitkova-Petra_Kvitova,1,B-XC,17,3,2,0,1,12,5
20150108-W-Shenzhen-QF-Tereza_Smitkova-Petra_Kvitova,1,B-DTM,35,2,0,0,2,17,18
20150108-W-Shenzhen-QF-Tereza_Smitkova-Petra_Kvitova,1,B-DTL,2,1,0,0,1,1,1
20150108-W-Shenzhen-QF-Tereza_Smitkova-Petra_Kvitova,1,B-IO,8,7,3,0,4,4,4
20150108-W-Shenzhen-QF-Tereza_Smitkova-Petra_Kvitova,1,S-XC,1,0,0,0,0,0,1
20150108-W-Shenzhen-QF-Tereza_Smitkova-Petra_Kvitova,1,S-DTL,1,0,0,0,0,1,0
20150108-W-Shenzhen-QF-Tereza_Smitkova-Petra_Kvitova,2,F-XC,31,7,4,1,2,17,14
20150108-W-Shenzhen-QF-Tereza_Smitkova-Petra_Kvitova,2,F-DTM,16,2,0,0,2,7,9
20150108-W-Shenzhen-QF-Tereza_Smitkova-Petra_Kvitova,2,F-DTL,13,5,2,1,2,9,4
20150108-W-Shenzhen-QF-Tereza_Smitkova-Petra_Kvitova,2,F-IO,13,8,5,0,3,7,6
20150108-W-Shenzhen-QF-Tereza_Smitkova-Petra_Kvitova,2,B-XC,26,11,3,3,5,14,12
20150108-W-Shenzhen-QF-Tereza_Smitkova-Petra_Kvitova,2,B-DTM,29,3,0,1,2,12,17
20150108-W-Shenzhen-QF-Tereza_Smitkova-Petra_Kvitova,2,B-DTL,1,0,0,0,0,1,0
20150108-W-Shenzhen-QF-Tereza_Smitkova-Petra_Kvitova,2,B-IO,6,4,1,0,3,2,4
20150108-W-Shenzhen-QF-Tereza_Smitkova-Petra_Kvitova,2,S-XC,1,0,0,0,0,0,1
20150108-W-Shenzhen-QF-Tereza_Smitkova-Petra_Kvitova,2,S-DTM,5,1,0,1,0,3,2
20150108-W-Shenzhen-QF-Tereza_Smitkova-Petra_Kvitova,2,S-DTL,2,1,0,1,0,1,1
20150113-W-Sydney-R16-Agnieszka_Radwanska-Garbine_Muguruza,1,F-XC,34,6,0,3,3,19,15
20150113-W-Sydney-R16-Agnieszka_Radwanska-Garbine_Muguruza,1,F-DTM,49,2,0,0,2,25,24
20150113-W-Sydney-R16-Agnieszka_Radwanska-Garbine_Muguruza,1,F-DTL,7,2,0,1,1,4,3
20150113-W-Sydney-R16-Agnieszka_Radwanska-Garbine_Muguruza,1,F-IO,31,11,3,3,5,15,16
20150113-W-Sydney-R16-Agnieszka_Radwanska-Garbine_Muguruza,1,F-II,1,0,0,0,0,1,0
20150113-W-Sydney-R16-Agnieszka_Radwanska-Garbine_Muguruza,1,B-XC,22,7,3,0,4,11,11
20150113-W-Sydney-R16-Agnieszka_Radwanska-Garbine_Muguruza,1,B-DTM,52,4,1,0,3,26,26
20150113-W-Sydney-R16-Agnieszka_Radwanska-Garbine_Muguruza,1,B-DTL,4,0,0,0,0,2,2
20150113-W-Sydney-R16-Agnieszka_Radwanska-Garbine_Muguruza,1,B-IO,9,2,1,0,1,6,3
20150113-W-Sydney-R16-Agnieszka_Radwanska-Garbine_Muguruza,1,S-XC,1,1,0,0,1,0,1
20150113-W-Sydney-R16-Agnieszka_Radwanska-Garbine_Muguruza,1,S-DTM,5,0,0,0,0,2,3
20150113-W-Sydney-R16-Agnieszka_Radwanska-Garbine_Muguruza,1,S-DTL,2,2,1,0,1,1,1
20150113-W-Sydney-R16-Agnieszka_Radwanska-Garbine_Muguruza,2,F-XC,52,15,4,4,7,27,25
20150113-W-Sydney-R16-Agnieszka_Radwanska-Garbine_Muguruza,2,F-DTM,37,5,0,0,5,14,23
20150113-W-Sydney-R16-Agnieszka_Radwanska-Garbine_Muguruza,2,F-DTL,10,6,4,0,2,6,4
20150113-W-Sydney-R16-Agnieszka_Radwanska-Garbine_Muguruza,2,F-IO,13,6,3,0,3,5,8
20150113-W-Sydney-R16-Agnieszka_Radwanska-Garbine_Muguruza,2,B-XC,43,7,1,2,4,24,19
20150113-W-Sydney-R16-Agnieszka_Radwanska-Garbine_Muguruza,2,B-DTM,41,4,0,0,4,20,21
20150113-W-Sydney-R16-Agnieszka_Radwanska-Garbine_Muguruza,2,B-DTL,11,6,3,1,2,7,4
20150113-W-Sydney-R16-Agnieszka_Radwanska-Garbine_Muguruza,2,B-IO,20,10,6,1,3,12,8
20150113-W-Sydney-R16-Agnieszka_Radwanska-Garbine_Muguruza,2,S-XC,2,0,0,0,0,0,2
20150119-W-Australian_Open-R128-Magdalena_Rybarikova-Ana_Konjuh,1,F-XC,4,3,0,2,1,2,2
20150119-W-Australian_Open-R128-Magdalena_Rybarikova-Ana_Konjuh,1,F-DTM,21,2,0,1,1,10,11
20150119-W-Australian_Open-R128-Magdalena_Rybarikova-Ana_Konjuh,1,F-DTL,11,4,2,0,2,4,7
20150119-W-Australian_Open-R128-Magdalena_Rybarikova-Ana_Konjuh,1,F-IO,7,2,0,0,2,4,3
20150119-W-Australian_Open-R128-Magdalena_Rybarikova-Ana_Konjuh,1,B-XC,11,2,0,0,2,5,6
20150119-W-Australian_Open-R128-Magdalena_Rybarikova-Ana_Konjuh,1,B-DTM,17,0,0,0,0,7,10
20150119-W-Australian_Open-R128-Magdalena_Rybarikova-Ana_Konjuh,1,B-IO,1,1,0,1,0,1,0
20150119-W-Australian_Open-R128-Magdalena_Rybarikova-Ana_Konjuh,1,S-XC,8,0,0,0,0,5,3
20150119-W-Australian_Open-R128-Magdalena_Rybarikova-Ana_Konjuh,1,S-DTM,18,2,0,0,2,11,7
20150119-W-Australian_Open-R128-Magdalena_Rybarikova-Ana_Konjuh,1,S-DTL,1,0,0,0,0,1,0
20150119-W-Australian_Open-R128-Magdalena_Rybarikova-Ana_Konjuh,1,S-IO,1,0,0,0,0,1,0
20150119-W-Australian_Open-R128-Magdalena_Rybarikova-Ana_Konjuh,2,F-XC,23,13,5,2,6,15,8
20150119-W-Australian_Open-R128-Magdalena_Rybarikova-Ana_Konjuh,2,F-DTM,6,2,0,0,2,3,3
20150119-W-Australian_Open-R128-Magdalena_Rybarikova-Ana_Konjuh,2,F-DTL,1,1,0,0,1,0,1
20150119-W-Australian_Open-R128-Magdalena_Rybarikova-Ana_Konjuh,2,F-IO,10,5,1,2,2,5,5
20150119-W-Australian_Open-R128-Magdalena_Rybarikova-Ana_Konjuh,2,F-II,1,1,0,0,1,0,1
20150119-W-Australian_Open-R128-Magdalena_Rybarikova-Ana_Konjuh,2,B-XC,40,11,4,1,6,20,20
20150119-W-Australian_Open-R128-Magdalena_Rybarikova-Ana_Konjuh,2,B-DTM,15,3,0,0,3,4,11
20150119-W-Australian_Open-R128-Magdalena_Rybarikova-Ana_Konjuh,2,B-DTL,9,4,1,0,3,3,6
20150119-W-Australian_Open-R128-Magdalena_Rybarikova-Ana_Konjuh,2,B-IO,8,0,0,0,0,5,3
20150119-W-Australian_Open-R128-Magdalena_Rybarikova-Ana_Konjuh,2,S-DTM,4,0,0,0,0,1,3
20150119-W-Australian_Open-R128-Magdalena_Rybarikova-Ana_Konjuh,2,S-DTL,1,1,0,0,1,0,1
20141020-W-Singapore-RR-Caroline_Wozniacki-Petra_Kvitova,1,F-XC,8,2,1,1,0,3,5
20141020-W-Singapore-RR-Caroline_Wozniacki-Petra_Kvitova,1,F-DTM,19,3,1,0,2,11,8
20141020-W-Singapore-RR-Caroline_Wozniacki-Petra_Kvitova,1,F-DTL,9,2,0,0,2,5,4
20141020-W-Singapore-RR-Caroline_Wozniacki-Petra_Kvitova,1,F-IO,5,2,0,2,0,5,0
20141020-W-Singapore-RR-Caroline_Wozniacki-Petra_Kvitova,1,B-XC,6,1,0,1,0,5,1
20141020-W-Singapore-RR-Caroline_Wozniacki-Petra_Kvitova,1,B-DTM,14,1,1,0,0,11,3
20141020-W-Singapore-RR-Caroline_Wozniacki-Petra_Kvitova,1,B-DTL,3,1,0,1,0,3,0
20141020-W-Singapore-RR-Caroline_Wozniacki-Petra_Kvitova,1,B-IO,7,3,1,1,1,4,3
20141020-W-Singapore-RR-Caroline_Wozniacki-Petra_Kvitova,1,B-II,1,1,0,1,0,1,0
20141020-W-Singapore-RR-Caroline_Wozniacki-Petra_Kvitova,1,S-DTM,3,0,0,0,0,1,2
20141020-W-Singapore-RR-Caroline_Wozniacki-Petra_Kvitova,1,S-DTL,2,0,0,0,0,2,0
20141020-W-Singapore-RR-Caroline_Wozniacki-Petra_Kvitova,2,F-XC,21,9,1,1,7,3,18
20141020-W-Singapore-RR-Caroline_Wozniacki-Petra_Kvitova,2,F-DTM,5,0,0,0,0,3,2
20141020-W-Singapore-RR-Caroline_Wozniacki-Petra_Kvitova,2,F-DTL,11,6,2,0,4,5,6
20141020-W-Singapore-RR-Caroline_Wozniacki-Petra_Kvitova,2,F-IO,16,9,3,1,5,7,9
20141020-W-Singapore-RR-Caroline_Wozniacki-Petra_Kvitova,2,B-XC,13,6,1,2,3,6,7
20141020-W-Singapore-RR-Caroline_Wozniacki-Petra_Kvitova,2,B-DTM,10,2,1,0,1,3,7
20141020-W-Singapore-RR-Caroline_Wozniacki-Petra_Kvitova,2,B-DTL,3,2,1,0,1,2,1
20141020-W-Singapore-RR-Caroline_Wozniacki-Petra_Kvitova,2,B-IO,6,2,0,1,1,2,4
20141020-W-Singapore-RR-Caroline_Wozniacki-Petra_Kvitova,2,S-XC,2,1,1,0,0,2,0
20141020-W-Singapore-RR-Caroline_Wozniacki-Petra_Kvitova,2,S-DTM,2,0,0,0,0,1,1
20150119-W-Australian_Open-R128-Julia_Goerges-Belinda_Bencic,1,F-XC,31,8,5,1,2,20,11
20150119-W-Australian_Open-R128-Julia_Goerges-Belinda_Bencic,1,F-DTM,12,0,0,0,0,7,5
20150119-W-Australian_Open-R128-Julia_Goerges-Belinda_Bencic,1,F-DTL,7,5,2,0,3,4,3
20150119-W-Australian_Open-R128-Julia_Goerges-Belinda_Bencic,1,F-IO,18,11,4,3,4,12,6
20150119-W-Australian_Open-R128-Julia_Goerges-Belinda_Bencic,1,B-XC,16,3,1,0,2,11,5
20150119-W-Australian_Open-R128-Julia_Goerges-Belinda_Bencic,1,B-DTM,17,2,0,0,2,9,8
20150119-W-Australian_Open-R128-Julia_Goerges-Belinda_Bencic,1,B-DTL,7,6,3,1,2,5,2
20150119-W-Australian_Open-R128-Julia_Goerges-Belinda_Bencic,1,B-IO,5,2,1,0,1,3,2
20150119-W-Australian_Open-R128-Julia_Goerges-Belinda_Bencic,1,S-XC,1,0,0,0,0,1,0
20150119-W-Australian_Open-R128-Julia_Goerges-Belinda_Bencic,1,S-DTM,4,0,0,0,0,3,1
20150119-W-Australian_Open-R128-Julia_Goerges-Belinda_Bencic,2,F-XC,18,5,1,1,3,7,11
20150119-W-Australian_Open-R128-Julia_Goerges-Belinda_Bencic,2,F-DTM,18,2,0,0,2,3,15
20150119-W-Australian_Open-R128-Julia_Goerges-Belinda_Bencic,2,F-DTL,5,0,0,0,0,2,3
20150119-W-Australian_Open-R128-Julia_Goerges-Belinda_Bencic,2,F-IO,9,0,0,0,0,3,6
20150119-W-Australian_Open-R128-Julia_Goerges-Belinda_Bencic,2,B-XC,17,5,0,2,3,5,12
20150119-W-Australian_Open-R128-Julia_Goerges-Belinda_Bencic,2,B-DTM,23,1,0,0,1,8,15
20150119-W-Australian_Open-R128-Julia_Goerges-Belinda_Bencic,2,B-DTL,5,2,0,1,1,1,4
20150119-W-Australian_Open-R128-Julia_Goerges-Belinda_Bencic,2,B-IO,4,2,0,0,2,2,2
20150119-W-Australian_Open-R128-Julia_Goerges-Belinda_Bencic,2,S-XC,1,0,0,0,0,0,1
20150119-W-Australian_Open-R128-Julia_Goerges-Belinda_Bencic,2,S-DTM,1,0,0,0,0,0,1
20150122-W-Australian_Open-R64-Daniela_Hantuchova-Garbine_Muguruza,1,F-XC,32,11,4,3,4,19,13
20150122-W-Australian_Open-R64-Daniela_Hantuchova-Garbine_Muguruza,1,F-DTM,26,3,0,0,3,9,17
20150122-W-Australian_Open-R64-Daniela_Hantuchova-Garbine_Muguruza,1,F-DTL,3,2,1,0,1,2,1
20150122-W-Australian_Open-R64-Daniela_Hantuchova-Garbine_Muguruza,1,F-IO,16,9,2,1,6,7,9
20150122-W-Australian_Open-R64-Daniela_Hantuchova-Garbine_Muguruza,1,B-XC,13,2,1,1,0,8,5
20150122-W-Australian_Open-R64-Daniela_Hantuchova-Garbine_Muguruza,1,B-DTM,23,2,0,1,1,8,15
20150122-W-Australian_Open-R64-Daniela_Hantuchova-Garbine_Muguruza,1,B-DTL,8,7,2,0,5,3,5
20150122-W-Australian_Open-R64-Daniela_Hantuchova-Garbine_Muguruza,1,B-IO,10,8,4,1,3,6,4
20150122-W-Australian_Open-R64-Daniela_Hantuchova-Garbine_Muguruza,1,S-XC,1,0,0,0,0,1,0
20150122-W-Australian_Open-R64-Daniela_Hantuchova-Garbine_Muguruza,1,S-DTM,3,0,0,0,0,1,2
20150122-W-Australian_Open-R64-Daniela_Hantuchova-Garbine_Muguruza,1,S-DTL,2,0,0,0,0,0,2
20150122-W-Australian_Open-R64-Daniela_Hantuchova-Garbine_Muguruza,2,F-XC,26,8,3,2,3,13,13
20150122-W-Australian_Open-R64-Daniela_Hantuchova-Garbine_Muguruza,2,F-DTM,28,2,1,0,1,15,13
20150122-W-Australian_Open-R64-Daniela_Hantuchova-Garbine_Muguruza,2,F-DTL,5,1,1,0,0,2,3
20150122-W-Australian_Open-R64-Daniela_Hantuchova-Garbine_Muguruza,2,F-IO,8,4,3,1,0,5,3
20150122-W-Australian_Open-R64-Daniela_Hantuchova-Garbine_Muguruza,2,B-XC,22,5,2,1,2,14,8
20150122-W-Australian_Open-R64-Daniela_Hantuchova-Garbine_Muguruza,2,B-DTM,28,3,0,0,3,13,15
20150122-W-Australian_Open-R64-Daniela_Hantuchova-Garbine_Muguruza,2,B-DTL,5,2,0,0,2,1,4
20150122-W-Australian_Open-R64-Daniela_Hantuchova-Garbine_Muguruza,2,B-IO,11,8,1,2,5,4,7
20150122-W-Australian_Open-R64-Daniela_Hantuchova-Garbine_Muguruza,2,S-DTM,2,0,0,0,0,1,1
20150125-W-Australian_Open-R16-Eugenie_Bouchard-Irina_Camelia_Begu,1,F-XC,63,23,11,4,8,43,20
20150125-W-Australian_Open-R16-Eugenie_Bouchard-Irina_Camelia_Begu,1,F-DTM,47,6,1,0,5,22,25
20150125-W-Australian_Open-R16-Eugenie_Bouchard-Irina_Camelia_Begu,1,F-DTL,14,7,3,1,3,7,7
20150125-W-Australian_Open-R16-Eugenie_Bouchard-Irina_Camelia_Begu,1,F-IO,24,14,5,4,5,15,9
20150125-W-Australian_Open-R16-Eugenie_Bouchard-Irina_Camelia_Begu,1,F-II,1,1,1,0,0,1,0
20150125-W-Australian_Open-R16-Eugenie_Bouchard-Irina_Camelia_Begu,1,B-XC,30,11,3,2,6,19,11
20150125-W-Australian_Open-R16-Eugenie_Bouchard-Irina_Camelia_Begu,1,B-DTM,36,8,0,3,5,24,12
20150125-W-Australian_Open-R16-Eugenie_Bouchard-Irina_Camelia_Begu,1,B-DTL,4,3,1,0,2,1,3
20150125-W-Australian_Open-R16-Eugenie_Bouchard-Irina_Camelia_Begu,1,B-IO,4,0,0,0,0,2,2
20150125-W-Australian_Open-R16-Eugenie_Bouchard-Irina_Camelia_Begu,1,S-XC,3,0,0,0,0,2,1
20150125-W-Australian_Open-R16-Eugenie_Bouchard-Irina_Camelia_Begu,1,S-DTM,2,0,0,0,0,2,0
20150125-W-Australian_Open-R16-Eugenie_Bouchard-Irina_Camelia_Begu,1,S-DTL,1,0,0,0,0,0,1
20150125-W-Australian_Open-R16-Eugenie_Bouchard-Irina_Camelia_Begu,2,F-XC,39,9,1,3,5,20,19
20150125-W-Australian_Open-R16-Eugenie_Bouchard-Irina_Camelia_Begu,2,F-DTM,56,4,0,0,4,17,39
20150125-W-Australian_Open-R16-Eugenie_Bouchard-Irina_Camelia_Begu,2,F-DTL,8,2,2,0,0,4,4
20150125-W-Australian_Open-R16-Eugenie_Bouchard-Irina_Camelia_Begu,2,F-IO,20,7,3,1,3,11,9
20150125-W-Australian_Open-R16-Eugenie_Bouchard-Irina_Camelia_Begu,2,B-XC,19,5,1,2,2,7,12
20150125-W-Australian_Open-R16-Eugenie_Bouchard-Irina_Camelia_Begu,2,B-DTM,36,4,1,0,3,10,26
20150125-W-Australian_Open-R16-Eugenie_Bouchard-Irina_Camelia_Begu,2,B-DTL,11,5,0,2,3,4,7
20150125-W-Australian_Open-R16-Eugenie_Bouchard-Irina_Camelia_Begu,2,B-IO,16,3,0,1,2,6,10
20150125-W-Australian_Open-R16-Eugenie_Bouchard-Irina_Camelia_Begu,2,S-XC,1,0,0,0,0,0,1
20150125-W-Australian_Open-R16-Eugenie_Bouchard-Irina_Camelia_Begu,2,S-DTM,6,1,0,0,1,2,4
20150125-W-Australian_Open-R16-Eugenie_Bouchard-Irina_Camelia_Begu,2,S-DTL,1,0,0,0,0,1,0
20150119-W-Australian_Open-R128-Carina_Witthoeft-Carla_Suarez_Navarro,1,F-XC,33,9,2,4,3,22,11
20150119-W-Australian_Open-R128-Carina_Witthoeft-Carla_Suarez_Navarro,1,F-DTM,20,3,0,1,2,11,9
20150119-W-Australian_Open-R128-Carina_Witthoeft-Carla_Suarez_Navarro,1,F-DTL,3,2,1,1,0,3,0
20150119-W-Australian_Open-R128-Carina_Witthoeft-Carla_Suarez_Navarro,1,F-IO,6,2,1,0,1,4,2
20150119-W-Australian_Open-R128-Carina_Witthoeft-Carla_Suarez_Navarro,1,B-XC,33,6,1,2,3,22,11
20150119-W-Australian_Open-R128-Carina_Witthoeft-Carla_Suarez_Navarro,1,B-DTM,32,0,0,0,0,24,8
20150119-W-Australian_Open-R128-Carina_Witthoeft-Carla_Suarez_Navarro,1,B-DTL,8,7,3,1,3,5,3
20150119-W-Australian_Open-R128-Carina_Witthoeft-Carla_Suarez_Navarro,1,B-IO,7,3,0,0,3,2,5
20150119-W-Australian_Open-R128-Carina_Witthoeft-Carla_Suarez_Navarro,2,F-XC,21,7,2,2,3,6,15
20150119-W-Australian_Open-R128-Carina_Witthoeft-Carla_Suarez_Navarro,2,F-DTM,35,0,0,0,0,13,22
20150119-W-Australian_Open-R128-Carina_Witthoeft-Carla_Suarez_Navarro,2,F-DTL,9,2,1,0,1,5,4
20150119-W-Australian_Open-R128-Carina_Witthoeft-Carla_Suarez_Navarro,2,F-IO,7,2,1,1,0,3,4
20150119-W-Australian_Open-R128-Carina_Witthoeft-Carla_Suarez_Navarro,2,B-XC,21,7,2,0,5,5,16
20150119-W-Australian_Open-R128-Carina_Witthoeft-Carla_Suarez_Navarro,2,B-DTM,33,6,0,1,5,12,21
20150119-W-Australian_Open-R128-Carina_Witthoeft-Carla_Suarez_Navarro,2,B-DTL,2,1,0,0,1,1,1
20150119-W-Australian_Open-R128-Carina_Witthoeft-Carla_Suarez_Navarro,2,B-IO,4,3,1,0,2,1,3
20150119-W-Australian_Open-R128-Carina_Witthoeft-Carla_Suarez_Navarro,2,S-XC,7,2,0,1,1,1,6
20150119-W-Australian_Open-R128-Carina_Witthoeft-Carla_Suarez_Navarro,2,S-DTM,3,0,0,0,0,1,2
20150119-W-Australian_Open-R128-Carina_Witthoeft-Carla_Suarez_Navarro,2,S-IO,1,0,0,0,0,1,0
20150122-W-Australian_Open-R64-Samantha_Stosur-Coco_Vandeweghe,1,F-XC,15,6,3,2,1,11,4
20150122-W-Australian_Open-R64-Samantha_Stosur-Coco_Vandeweghe,1,F-DTM,19,5,0,1,4,6,13
20150122-W-Australian_Open-R64-Samantha_Stosur-Coco_Vandeweghe,1,F-DTL,5,2,1,0,1,3,2
20150122-W-Australian_Open-R64-Samantha_Stosur-Coco_Vandeweghe,1,F-IO,12,3,1,1,1,5,7
20150122-W-Australian_Open-R64-Samantha_Stosur-Coco_Vandeweghe,1,F-II,1,1,0,0,1,0,1
20150122-W-Australian_Open-R64-Samantha_Stosur-Coco_Vandeweghe,1,B-XC,3,1,1,0,0,1,2
20150122-W-Australian_Open-R64-Samantha_Stosur-Coco_Vandeweghe,1,B-DTM,8,1,0,0,1,3,5
20150122-W-Australian_Open-R64-Samantha_Stosur-Coco_Vandeweghe,1,B-DTL,3,1,0,0,1,0,3
20150122-W-Australian_Open-R64-Samantha_Stosur-Coco_Vandeweghe,1,B-IO,2,1,0,0,1,0,2
20150122-W-Australian_Open-R64-Samantha_Stosur-Coco_Vandeweghe,1,S-XC,5,1,0,1,0,4,1
20150122-W-Australian_Open-R64-Samantha_Stosur-Coco_Vandeweghe,1,S-DTM,4,1,0,0,1,0,4
20150122-W-Australian_Open-R64-Samantha_Stosur-Coco_Vandeweghe,1,S-DTL,1,0,0,0,0,0,1
20150122-W-Australian_Open-R64-Samantha_Stosur-Coco_Vandeweghe,2,F-XC,18,9,5,3,1,14,4
20150122-W-Australian_Open-R64-Samantha_Stosur-Coco_Vandeweghe,2,F-DTM,12,1,0,0,1,5,7
20150122-W-Australian_Open-R64-Samantha_Stosur-Coco_Vandeweghe,2,F-DTL,5,3,3,0,0,4,1
20150122-W-Australian_Open-R64-Samantha_Stosur-Coco_Vandeweghe,2,F-IO,6,1,0,0,1,4,2
20150122-W-Australian_Open-R64-Samantha_Stosur-Coco_Vandeweghe,2,B-XC,8,2,0,0,2,4,4
20150122-W-Australian_Open-R64-Samantha_Stosur-Coco_Vandeweghe,2,B-DTM,11,2,0,0,2,6,5
20150122-W-Australian_Open-R64-Samantha_Stosur-Coco_Vandeweghe,2,B-DTL,1,1,1,0,0,1,0
20150122-W-Australian_Open-R64-Samantha_Stosur-Coco_Vandeweghe,2,B-IO,2,1,0,0,1,1,1
20150122-W-Australian_Open-R64-Samantha_Stosur-Coco_Vandeweghe,2,S-XC,1,0,0,0,0,0,1
20150122-W-Australian_Open-R64-Samantha_Stosur-Coco_Vandeweghe,2,S-DTM,2,0,0,0,0,1,1
20150122-W-Australian_Open-R64-Samantha_Stosur-Coco_Vandeweghe,2,S-DTL,3,0,0,0,0,2,1
20150120-W-Australian_Open-R128-Agnieszka_Radwanska-Kurumi_Nara,1,F-XC,19,4,2,0,2,10,9
20150120-W-Australian_Open-R128-Agnieszka_Radwanska-Kurumi_Nara,1,F-DTM,18,3,0,1,2,11,7
20150120-W-Australian_Open-R128-Agnieszka_Radwanska-Kurumi_Nara,1,F-DTL,6,0,0,0,0,4,2
20150120-W-Australian_Open-R128-Agnieszka_Radwanska-Kurumi_Nara,1,F-IO,12,4,2,0,2,8,4
20150120-W-Australian_Open-R128-Agnieszka_Radwanska-Kurumi_Nara,1,F-II,1,1,0,1,0,1,0
20150120-W-Australian_Open-R128-Agnieszka_Radwanska-Kurumi_Nara,1,B-XC,20,2,0,1,1,12,8
20150120-W-Australian_Open-R128-Agnieszka_Radwanska-Kurumi_Nara,1,B-DTM,40,1,0,0,1,19,21
20150120-W-Australian_Open-R128-Agnieszka_Radwanska-Kurumi_Nara,1,B-DTL,9,3,1,1,1,5,4
20150120-W-Australian_Open-R128-Agnieszka_Radwanska-Kurumi_Nara,1,B-IO,2,0,0,0,0,1,1
20150120-W-Australian_Open-R128-Agnieszka_Radwanska-Kurumi_Nara,1,S-XC,2,0,0,0,0,0,2
20150120-W-Australian_Open-R128-Agnieszka_Radwanska-Kurumi_Nara,1,S-DTM,7,1,0,0,1,2,5
20150120-W-Australian_Open-R128-Agnieszka_Radwanska-Kurumi_Nara,1,S-DTL,2,1,0,1,0,2,0
20150120-W-Australian_Open-R128-Agnieszka_Radwanska-Kurumi_Nara,1,S-IO,1,0,0,0,0,0,1
20150120-W-Australian_Open-R128-Agnieszka_Radwanska-Kurumi_Nara,2,F-XC,18,6,1,1,4,8,10
20150120-W-Australian_Open-R128-Agnieszka_Radwanska-Kurumi_Nara,2,F-DTM,23,4,0,0,4,10,13
20150120-W-Australian_Open-R128-Agnieszka_Radwanska-Kurumi_Nara,2,F-DTL,16,5,1,1,3,8,8
20150120-W-Australian_Open-R128-Agnieszka_Radwanska-Kurumi_Nara,2,F-IO,14,2,0,0,2,5,9
20150120-W-Australian_Open-R128-Agnieszka_Radwanska-Kurumi_Nara,2,B-XC,29,5,1,1,3,16,13
20150120-W-Australian_Open-R128-Agnieszka_Radwanska-Kurumi_Nara,2,B-DTM,23,5,0,0,5,5,18
20150120-W-Australian_Open-R128-Agnieszka_Radwanska-Kurumi_Nara,2,B-DTL,10,3,1,0,2,5,5
20150120-W-Australian_Open-R128-Agnieszka_Radwanska-Kurumi_Nara,2,B-IO,11,3,1,0,2,5,6
20150120-W-Australian_Open-R128-Agnieszka_Radwanska-Kurumi_Nara,2,S-XC,1,0,0,0,0,1,0
20150120-W-Australian_Open-R128-Agnieszka_Radwanska-Kurumi_Nara,2,S-DTM,4,0,0,0,0,1,3
20150119-W-Australian_Open-R128-Monica_Puig-Arina_Rodionova,1,F-XC,27,11,6,3,2,20,7
20150119-W-Australian_Open-R128-Monica_Puig-Arina_Rodionova,1,F-DTM,21,3,0,0,3,12,9
20150119-W-Australian_Open-R128-Monica_Puig-Arina_Rodionova,1,F-DTL,12,4,3,0,1,7,5
20150119-W-Australian_Open-R128-Monica_Puig-Arina_Rodionova,1,F-IO,9,3,2,1,0,6,3
20150119-W-Australian_Open-R128-Monica_Puig-Arina_Rodionova,1,F-II,1,0,0,0,0,0,1
20150119-W-Australian_Open-R128-Monica_Puig-Arina_Rodionova,1,B-XC,11,5,1,2,2,7,4
20150119-W-Australian_Open-R128-Monica_Puig-Arina_Rodionova,1,B-DTM,22,2,0,0,2,11,11
20150119-W-Australian_Open-R128-Monica_Puig-Arina_Rodionova,1,B-DTL,3,2,2,0,0,2,1
20150119-W-Australian_Open-R128-Monica_Puig-Arina_Rodionova,1,B-IO,6,2,2,0,0,5,1
20150119-W-Australian_Open-R128-Monica_Puig-Arina_Rodionova,1,S-XC,1,1,0,0,1,0,1
20150119-W-Australian_Open-R128-Monica_Puig-Arina_Rodionova,1,S-DTM,3,0,0,0,0,2,1
20150119-W-Australian_Open-R128-Monica_Puig-Arina_Rodionova,1,S-DTL,1,0,0,0,0,1,0
20150119-W-Australian_Open-R128-Monica_Puig-Arina_Rodionova,2,F-XC,19,2,0,1,1,6,13
20150119-W-Australian_Open-R128-Monica_Puig-Arina_Rodionova,2,F-DTM,19,2,1,0,1,5,14
20150119-W-Australian_Open-R128-Monica_Puig-Arina_Rodionova,2,F-DTL,6,1,0,0,1,2,4
20150119-W-Australian_Open-R128-Monica_Puig-Arina_Rodionova,2,F-IO,11,5,1,1,3,3,8
20150119-W-Australian_Open-R128-Monica_Puig-Arina_Rodionova,2,B-XC,11,2,1,0,1,8,3
20150119-W-Australian_Open-R128-Monica_Puig-Arina_Rodionova,2,B-DTM,13,1,0,0,1,5,8
20150119-W-Australian_Open-R128-Monica_Puig-Arina_Rodionova,2,B-DTL,2,0,0,0,0,2,0
20150119-W-Australian_Open-R128-Monica_Puig-Arina_Rodionova,2,B-IO,13,3,0,1,2,8,5
20150119-W-Australian_Open-R128-Monica_Puig-Arina_Rodionova,2,S-XC,4,1,0,1,0,2,2
20150119-W-Australian_Open-R128-Monica_Puig-Arina_Rodionova,2,S-DTM,7,0,0,0,0,2,5
20150119-W-Australian_Open-R128-Monica_Puig-Arina_Rodionova,2,S-DTL,1,0,0,0,0,0,1
20150120-W-Australian_Open-R128-Andrea_Petkovic-Madison_Brengle,1,F-XC,85,15,5,4,6,47,38
20150120-W-Australian_Open-R128-Andrea_Petkovic-Madison_Brengle,1,F-DTM,87,12,0,0,12,35,52
20150120-W-Australian_Open-R128-Andrea_Petkovic-Madison_Brengle,1,F-DTL,13,7,2,2,3,7,6
20150120-W-Australian_Open-R128-Andrea_Petkovic-Madison_Brengle,1,F-IO,24,9,4,1,4,15,9
20150120-W-Australian_Open-R128-Andrea_Petkovic-Madison_Brengle,1,F-II,1,1,1,0,0,1,0
20150120-W-Australian_Open-R128-Andrea_Petkovic-Madison_Brengle,1,B-XC,63,14,7,1,6,29,34
20150120-W-Australian_Open-R128-Andrea_Petkovic-Madison_Brengle,1,B-DTM,92,8,0,1,7,33,59
20150120-W-Australian_Open-R128-Andrea_Petkovic-Madison_Brengle,1,B-DTL,20,5,1,2,2,11,9
20150120-W-Australian_Open-R128-Andrea_Petkovic-Madison_Brengle,1,B-IO,12,4,0,3,1,5,7
20150120-W-Australian_Open-R128-Andrea_Petkovic-Madison_Brengle,1,S-XC,6,1,0,0,1,2,4
20150120-W-Australian_Open-R128-Andrea_Petkovic-Madison_Brengle,1,S-DTM,13,0,0,0,0,3,10
20150120-W-Australian_Open-R128-Andrea_Petkovic-Madison_Brengle,1,S-DTL,3,0,0,0,0,1,2
20150120-W-Australian_Open-R128-Andrea_Petkovic-Madison_Brengle,2,F-XC,60,14,4,2,8,33,27
20150120-W-Australian_Open-R128-Andrea_Petkovic-Madison_Brengle,2,F-DTM,78,11,1,1,9,41,37
20150120-W-Australian_Open-R128-Andrea_Petkovic-Madison_Brengle,2,F-DTL,22,3,1,0,2,12,10
20150120-W-Australian_Open-R128-Andrea_Petkovic-Madison_Brengle,2,F-IO,46,4,0,0,4,28,18
20150120-W-Australian_Open-R128-Andrea_Petkovic-Madison_Brengle,2,B-XC,61,13,5,4,4,33,28
20150120-W-Australian_Open-R128-Andrea_Petkovic-Madison_Brengle,2,B-DTM,70,3,0,1,2,42,28
20150120-W-Australian_Open-R128-Andrea_Petkovic-Madison_Brengle,2,B-DTL,7,2,1,0,1,4,3
20150120-W-Australian_Open-R128-Andrea_Petkovic-Madison_Brengle,2,B-IO,22,7,6,0,1,15,7
20150120-W-Australian_Open-R128-Andrea_Petkovic-Madison_Brengle,2,S-XC,4,0,0,0,0,2,2
20150120-W-Australian_Open-R128-Andrea_Petkovic-Madison_Brengle,2,S-DTM,4,0,0,0,0,2,2
20150120-W-Australian_Open-R128-Andrea_Petkovic-Madison_Brengle,2,S-DTL,1,0,0,0,0,1,0
20150213-W-Antwerp-QF-Mona_Barthel-Barbora_Strycova,1,F-XC,51,7,1,3,3,24,27
20150213-W-Antwerp-QF-Mona_Barthel-Barbora_Strycova,1,F-DTM,6,0,0,0,0,5,1
20150213-W-Antwerp-QF-Mona_Barthel-Barbora_Strycova,1,F-DTL,24,5,0,0,5,10,14
20150213-W-Antwerp-QF-Mona_Barthel-Barbora_Strycova,1,F-IO,7,1,0,0,1,3,4
20150213-W-Antwerp-QF-Mona_Barthel-Barbora_Strycova,1,B-XC,37,5,2,0,3,18,19
20150213-W-Antwerp-QF-Mona_Barthel-Barbora_Strycova,1,B-DTM,9,1,0,0,1,4,5
20150213-W-Antwerp-QF-Mona_Barthel-Barbora_Strycova,1,B-DTL,17,7,2,0,5,6,11
20150213-W-Antwerp-QF-Mona_Barthel-Barbora_Strycova,1,B-IO,9,2,1,1,0,6,3
20150213-W-Antwerp-QF-Mona_Barthel-Barbora_Strycova,1,B-II,1,0,0,0,0,0,1
20150213-W-Antwerp-QF-Mona_Barthel-Barbora_Strycova,1,S-XC,5,1,0,1,0,2,3
20150213-W-Antwerp-QF-Mona_Barthel-Barbora_Strycova,1,S-DTL,2,0,0,0,0,1,1
20150213-W-Antwerp-QF-Mona_Barthel-Barbora_Strycova,2,F-XC,51,8,2,0,6,26,25
20150213-W-Antwerp-QF-Mona_Barthel-Barbora_Strycova,2,F-DTM,10,0,0,0,0,5,5
20150213-W-Antwerp-QF-Mona_Barthel-Barbora_Strycova,2,F-DTL,12,1,0,1,0,9,3
20150213-W-Antwerp-QF-Mona_Barthel-Barbora_Strycova,2,F-IO,9,4,0,1,3,3,6
20150213-W-Antwerp-QF-Mona_Barthel-Barbora_Strycova,2,F-II,3,1,0,0,1,1,2
20150213-W-Antwerp-QF-Mona_Barthel-Barbora_Strycova,2,B-XC,38,5,2,1,2,21,17
20150213-W-Antwerp-QF-Mona_Barthel-Barbora_Strycova,2,B-DTM,10,1,0,0,1,4,6
20150213-W-Antwerp-QF-Mona_Barthel-Barbora_Strycova,2,B-DTL,4,2,1,0,1,2,2
20150213-W-Antwerp-QF-Mona_Barthel-Barbora_Strycova,2,B-IO,4,1,0,0,1,2,2
20150213-W-Antwerp-QF-Mona_Barthel-Barbora_Strycova,2,S-XC,5,1,0,0,1,3,2
20150213-W-Antwerp-QF-Mona_Barthel-Barbora_Strycova,2,S-DTM,4,0,0,0,0,1,3
20150213-W-Antwerp-QF-Mona_Barthel-Barbora_Strycova,2,S-DTL,4,0,0,0,0,2,2
20150210-W-Antwerp-R32-Alize_Cornet-Belinda_Bencic,1,F-XC,47,8,4,0,4,32,15
20150210-W-Antwerp-R32-Alize_Cornet-Belinda_Bencic,1,F-DTM,56,2,0,0,2,19,37
20150210-W-Antwerp-R32-Alize_Cornet-Belinda_Bencic,1,F-DTL,22,5,1,0,4,8,14
20150210-W-Antwerp-R32-Alize_Cornet-Belinda_Bencic,1,F-IO,19,1,0,0,1,11,8
20150210-W-Antwerp-R32-Alize_Cornet-Belinda_Bencic,1,B-XC,100,15,4,3,8,57,43
20150210-W-Antwerp-R32-Alize_Cornet-Belinda_Bencic,1,B-DTM,94,12,2,1,9,59,35
20150210-W-Antwerp-R32-Alize_Cornet-Belinda_Bencic,1,B-DTL,8,5,2,0,3,5,3
20150210-W-Antwerp-R32-Alize_Cornet-Belinda_Bencic,1,B-IO,8,3,1,0,2,4,4
20150210-W-Antwerp-R32-Alize_Cornet-Belinda_Bencic,1,S-XC,12,0,0,0,0,6,6
20150210-W-Antwerp-R32-Alize_Cornet-Belinda_Bencic,1,S-DTM,21,0,0,0,0,14,7
20150210-W-Antwerp-R32-Alize_Cornet-Belinda_Bencic,1,S-IO,1,1,1,0,0,1,0
20150210-W-Antwerp-R32-Alize_Cornet-Belinda_Bencic,2,F-XC,39,6,0,1,5,19,20
20150210-W-Antwerp-R32-Alize_Cornet-Belinda_Bencic,2,F-DTM,40,3,1,0,2,18,22
20150210-W-Antwerp-R32-Alize_Cornet-Belinda_Bencic,2,F-DTL,11,2,0,0,2,1,10
20150210-W-Antwerp-R32-Alize_Cornet-Belinda_Bencic,2,F-IO,26,3,2,0,1,13,13
20150210-W-Antwerp-R32-Alize_Cornet-Belinda_Bencic,2,B-XC,113,6,0,1,5,48,65
20150210-W-Antwerp-R32-Alize_Cornet-Belinda_Bencic,2,B-DTM,80,5,0,0,5,30,50
20150210-W-Antwerp-R32-Alize_Cornet-Belinda_Bencic,2,B-DTL,30,8,2,2,4,15,15
20150210-W-Antwerp-R32-Alize_Cornet-Belinda_Bencic,2,B-IO,44,9,0,2,7,18,26
20150210-W-Antwerp-R32-Alize_Cornet-Belinda_Bencic,2,S-XC,1,0,0,0,0,0,1
20150210-W-Antwerp-R32-Alize_Cornet-Belinda_Bencic,2,S-DTM,2,0,0,0,0,0,2
20150124-W-Australian_Open-R32-Petra_Kvitova-Madison_Keys,1,F-XC,19,5,2,0,3,8,11
20150124-W-Australian_Open-R32-Petra_Kvitova-Madison_Keys,1,F-DTM,17,1,0,0,1,8,9
20150124-W-Australian_Open-R32-Petra_Kvitova-Madison_Keys,1,F-DTL,3,3,2,1,0,3,0
20150124-W-Australian_Open-R32-Petra_Kvitova-Madison_Keys,1,F-IO,15,5,3,1,1,9,6
20150124-W-Australian_Open-R32-Petra_Kvitova-Madison_Keys,1,B-XC,17,6,3,1,2,8,9
20150124-W-Australian_Open-R32-Petra_Kvitova-Madison_Keys,1,B-DTM,25,3,0,0,3,12,13
20150124-W-Australian_Open-R32-Petra_Kvitova-Madison_Keys,1,B-DTL,6,2,0,0,2,4,2
20150124-W-Australian_Open-R32-Petra_Kvitova-Madison_Keys,1,B-IO,8,5,0,1,4,3,5
20150124-W-Australian_Open-R32-Petra_Kvitova-Madison_Keys,1,S-XC,2,1,0,0,1,0,2
20150124-W-Australian_Open-R32-Petra_Kvitova-Madison_Keys,1,S-DTM,2,0,0,0,0,0,2
20150124-W-Australian_Open-R32-Petra_Kvitova-Madison_Keys,2,F-XC,18,8,1,5,2,11,7
20150124-W-Australian_Open-R32-Petra_Kvitova-Madison_Keys,2,F-DTM,41,8,0,3,5,22,19
20150124-W-Australian_Open-R32-Petra_Kvitova-Madison_Keys,2,F-DTL,2,2,1,1,0,2,0
20150124-W-Australian_Open-R32-Petra_Kvitova-Madison_Keys,2,F-IO,15,6,3,0,3,9,6
20150124-W-Australian_Open-R32-Petra_Kvitova-Madison_Keys,2,B-XC,9,4,1,0,3,4,5
20150124-W-Australian_Open-R32-Petra_Kvitova-Madison_Keys,2,B-DTM,20,3,0,1,2,7,13
20150124-W-Australian_Open-R32-Petra_Kvitova-Madison_Keys,2,B-DTL,5,3,1,0,2,1,4
20150124-W-Australian_Open-R32-Petra_Kvitova-Madison_Keys,2,B-IO,4,1,0,0,1,3,1
20150124-W-Australian_Open-R32-Petra_Kvitova-Madison_Keys,2,S-DTM,4,0,0,0,0,2,2
20150127-W-Australian_Open-QF-Eugenie_Bouchard-Maria_Sharapova,1,F-XC,27,8,2,1,5,10,17
20150127-W-Australian_Open-QF-Eugenie_Bouchard-Maria_Sharapova,1,F-DTM,19,2,0,0,2,6,13
20150127-W-Australian_Open-QF-Eugenie_Bouchard-Maria_Sharapova,1,F-DTL,1,0,0,0,0,0,1
20150127-W-Australian_Open-QF-Eugenie_Bouchard-Maria_Sharapova,1,F-IO,13,5,2,0,3,5,8
20150127-W-Australian_Open-QF-Eugenie_Bouchard-Maria_Sharapova,1,B-XC,24,10,3,2,5,10,14
20150127-W-Australian_Open-QF-Eugenie_Bouchard-Maria_Sharapova,1,B-DTM,27,2,0,0,2,9,18
20150127-W-Australian_Open-QF-Eugenie_Bouchard-Maria_Sharapova,1,B-DTL,9,7,1,3,3,6,3
20150127-W-Australian_Open-QF-Eugenie_Bouchard-Maria_Sharapova,1,B-IO,5,4,1,0,3,2,3
20150127-W-Australian_Open-QF-Eugenie_Bouchard-Maria_Sharapova,1,S-DTM,2,0,0,0,0,1,1
20150127-W-Australian_Open-QF-Eugenie_Bouchard-Maria_Sharapova,1,S-DTL,1,0,0,0,0,1,0
20150127-W-Australian_Open-QF-Eugenie_Bouchard-Maria_Sharapova,2,F-XC,20,3,2,0,1,13,7
20150127-W-Australian_Open-QF-Eugenie_Bouchard-Maria_Sharapova,2,F-DTM,26,1,0,0,1,16,10
20150127-W-Australian_Open-QF-Eugenie_Bouchard-Maria_Sharapova,2,F-DTL,8,4,2,1,1,4,4
20150127-W-Australian_Open-QF-Eugenie_Bouchard-Maria_Sharapova,2,F-IO,12,7,4,2,1,8,4
20150127-W-Australian_Open-QF-Eugenie_Bouchard-Maria_Sharapova,2,B-XC,22,3,2,1,0,16,6
20150127-W-Australian_Open-QF-Eugenie_Bouchard-Maria_Sharapova,2,B-DTM,20,4,0,1,3,13,7
20150127-W-Australian_Open-QF-Eugenie_Bouchard-Maria_Sharapova,2,B-DTL,2,2,1,0,1,1,1
20150127-W-Australian_Open-QF-Eugenie_Bouchard-Maria_Sharapova,2,B-IO,2,1,1,0,0,1,1
20150127-W-Australian_Open-QF-Eugenie_Bouchard-Maria_Sharapova,2,S-XC,2,0,0,0,0,1,1
20150127-W-Australian_Open-QF-Eugenie_Bouchard-Maria_Sharapova,2,S-DTL,1,0,0,0,0,1,0
20150129-W-Australian_Open-SF-Maria_Sharapova-Ekaterina_Makarova,1,F-XC,32,7,1,3,3,25,7
20150129-W-Australian_Open-SF-Maria_Sharapova-Ekaterina_Makarova,1,F-DTM,27,3,0,0,3,18,9
20150129-W-Australian_Open-SF-Maria_Sharapova-Ekaterina_Makarova,1,F-DTL,12,4,3,0,1,8,4
20150129-W-Australian_Open-SF-Maria_Sharapova-Ekaterina_Makarova,1,F-IO,15,8,5,1,2,12,3
20150129-W-Australian_Open-SF-Maria_Sharapova-Ekaterina_Makarova,1,B-XC,25,6,4,0,2,18,7
20150129-W-Australian_Open-SF-Maria_Sharapova-Ekaterina_Makarova,1,B-DTM,21,2,0,0,2,15,6
20150129-W-Australian_Open-SF-Maria_Sharapova-Ekaterina_Makarova,1,B-DTL,3,0,0,0,0,3,0
20150129-W-Australian_Open-SF-Maria_Sharapova-Ekaterina_Makarova,1,B-IO,1,1,1,0,0,1,0
20150129-W-Australian_Open-SF-Maria_Sharapova-Ekaterina_Makarova,1,S-XC,1,0,0,0,0,1,0
20150129-W-Australian_Open-SF-Maria_Sharapova-Ekaterina_Makarova,1,S-DTM,1,0,0,0,0,0,1
20150129-W-Australian_Open-SF-Maria_Sharapova-Ekaterina_Makarova,2,F-XC,29,4,1,1,2,12,17
20150129-W-Australian_Open-SF-Maria_Sharapova-Ekaterina_Makarova,2,F-DTM,30,6,0,0,6,4,26
20150129-W-Australian_Open-SF-Maria_Sharapova-Ekaterina_Makarova,2,F-DTL,16,10,5,1,4,9,7
20150129-W-Australian_Open-SF-Maria_Sharapova-Ekaterina_Makarova,2,F-IO,11,2,0,0,2,2,9
20150129-W-Australian_Open-SF-Maria_Sharapova-Ekaterina_Makarova,2,B-XC,26,3,0,2,1,8,18
20150129-W-Australian_Open-SF-Maria_Sharapova-Ekaterina_Makarova,2,B-DTM,23,2,0,0,2,6,17
20150129-W-Australian_Open-SF-Maria_Sharapova-Ekaterina_Makarova,2,B-DTL,6,4,1,0,3,2,4
20150129-W-Australian_Open-SF-Maria_Sharapova-Ekaterina_Makarova,2,B-IO,6,4,0,1,3,2,4
20150129-W-Australian_Open-SF-Maria_Sharapova-Ekaterina_Makarova,2,S-DTM,1,0,0,0,0,0,1
20150216-W-Dubai-R32-Caroline_Wozniacki-Samantha_Stosur,1,F-XC,70,11,1,2,8,40,30
20150216-W-Dubai-R32-Caroline_Wozniacki-Samantha_Stosur,1,F-DTM,29,1,0,0,1,15,14
20150216-W-Dubai-R32-Caroline_Wozniacki-Samantha_Stosur,1,F-DTL,55,9,2,3,4,35,20
20150216-W-Dubai-R32-Caroline_Wozniacki-Samantha_Stosur,1,F-IO,31,4,1,0,3,17,14
20150216-W-Dubai-R32-Caroline_Wozniacki-Samantha_Stosur,1,B-XC,129,27,5,6,16,71,58
20150216-W-Dubai-R32-Caroline_Wozniacki-Samantha_Stosur,1,B-DTM,33,1,0,0,1,18,15
20150216-W-Dubai-R32-Caroline_Wozniacki-Samantha_Stosur,1,B-DTL,22,9,5,1,3,15,7
20150216-W-Dubai-R32-Caroline_Wozniacki-Samantha_Stosur,1,B-IO,11,5,4,1,0,8,3
20150216-W-Dubai-R32-Caroline_Wozniacki-Samantha_Stosur,1,S-XC,9,4,0,0,4,4,5
20150216-W-Dubai-R32-Caroline_Wozniacki-Samantha_Stosur,1,S-DTM,2,0,0,0,0,0,2
20150216-W-Dubai-R32-Caroline_Wozniacki-Samantha_Stosur,1,S-DTL,2,0,0,0,0,2,0
20150216-W-Dubai-R32-Caroline_Wozniacki-Samantha_Stosur,1,S-IO,1,0,0,0,0,0,1
20150216-W-Dubai-R32-Caroline_Wozniacki-Samantha_Stosur,2,F-XC,52,14,5,1,7,22,30
20150216-W-Dubai-R32-Caroline_Wozniacki-Samantha_Stosur,2,F-DTM,39,3,0,0,3,15,24
20150216-W-Dubai-R32-Caroline_Wozniacki-Samantha_Stosur,2,F-DTL,30,12,5,0,7,13,17
20150216-W-Dubai-R32-Caroline_Wozniacki-Samantha_Stosur,2,F-IO,81,10,5,0,5,42,39
20150216-W-Dubai-R32-Caroline_Wozniacki-Samantha_Stosur,2,F-II,15,5,1,0,4,5,10
20150216-W-Dubai-R32-Caroline_Wozniacki-Samantha_Stosur,2,B-XC,25,4,1,0,3,10,15
20150216-W-Dubai-R32-Caroline_Wozniacki-Samantha_Stosur,2,B-DTM,38,4,0,0,4,12,26
20150216-W-Dubai-R32-Caroline_Wozniacki-Samantha_Stosur,2,B-DTL,44,6,1,0,5,17,27
20150216-W-Dubai-R32-Caroline_Wozniacki-Samantha_Stosur,2,B-IO,4,0,0,0,0,2,2
20150216-W-Dubai-R32-Caroline_Wozniacki-Samantha_Stosur,2,S-XC,27,1,0,0,1,9,18
20150216-W-Dubai-R32-Caroline_Wozniacki-Samantha_Stosur,2,S-DTM,16,0,0,0,0,10,6
20150216-W-Dubai-R32-Caroline_Wozniacki-Samantha_Stosur,2,S-DTL,12,2,0,0,2,1,11
20150216-W-Dubai-R64-Jarmila_Gajdosova-Garbine_Muguruza,1,F-XC,27,11,2,0,9,8,19
20150216-W-Dubai-R64-Jarmila_Gajdosova-Garbine_Muguruza,1,F-DTM,19,3,0,2,1,6,13
20150216-W-Dubai-R64-Jarmila_Gajdosova-Garbine_Muguruza,1,F-DTL,17,6,0,1,5,7,10
20150216-W-Dubai-R64-Jarmila_Gajdosova-Garbine_Muguruza,1,F-IO,21,12,4,2,6,10,11
20150216-W-Dubai-R64-Jarmila_Gajdosova-Garbine_Muguruza,1,F-II,1,1,1,0,0,1,0
20150216-W-Dubai-R64-Jarmila_Gajdosova-Garbine_Muguruza,1,B-XC,9,4,1,2,1,3,6
20150216-W-Dubai-R64-Jarmila_Gajdosova-Garbine_Muguruza,1,B-DTM,11,2,0,0,2,4,7
20150216-W-Dubai-R64-Jarmila_Gajdosova-Garbine_Muguruza,1,B-DTL,8,5,2,1,2,3,5
20150216-W-Dubai-R64-Jarmila_Gajdosova-Garbine_Muguruza,1,B-IO,4,3,0,0,3,0,4
20150216-W-Dubai-R64-Jarmila_Gajdosova-Garbine_Muguruza,1,S-DTM,1,0,0,0,0,0,1
20150216-W-Dubai-R64-Jarmila_Gajdosova-Garbine_Muguruza,2,F-XC,20,4,2,1,1,14,6
20150216-W-Dubai-R64-Jarmila_Gajdosova-Garbine_Muguruza,2,F-DTM,15,0,0,0,0,11,4
20150216-W-Dubai-R64-Jarmila_Gajdosova-Garbine_Muguruza,2,F-DTL,3,1,0,0,1,1,2
20150216-W-Dubai-R64-Jarmila_Gajdosova-Garbine_Muguruza,2,F-IO,5,2,1,0,1,3,2
20150216-W-Dubai-R64-Jarmila_Gajdosova-Garbine_Muguruza,2,B-XC,21,8,5,0,3,14,7
20150216-W-Dubai-R64-Jarmila_Gajdosova-Garbine_Muguruza,2,B-DTM,15,1,0,0,1,8,7
20150216-W-Dubai-R64-Jarmila_Gajdosova-Garbine_Muguruza,2,B-DTL,8,2,2,0,0,7,1
20150216-W-Dubai-R64-Jarmila_Gajdosova-Garbine_Muguruza,2,B-IO,9,3,1,1,1,6,3
20150216-W-Dubai-R64-Jarmila_Gajdosova-Garbine_Muguruza,2,S-XC,1,0,0,0,0,0,1
20150223-W-Doha-R32-Victoria_Azarenka-Angelique_Kerber,1,F-XC,32,5,2,3,0,23,9
20150223-W-Doha-R32-Victoria_Azarenka-Angelique_Kerber,1,F-DTM,16,0,0,0,0,10,6
20150223-W-Doha-R32-Victoria_Azarenka-Angelique_Kerber,1,F-DTL,11,4,3,0,1,8,3
20150223-W-Doha-R32-Victoria_Azarenka-Angelique_Kerber,1,F-IO,12,5,2,0,3,6,6
20150223-W-Doha-R32-Victoria_Azarenka-Angelique_Kerber,1,B-XC,17,5,3,0,2,9,8
20150223-W-Doha-R32-Victoria_Azarenka-Angelique_Kerber,1,B-DTM,13,3,0,0,3,3,10
20150223-W-Doha-R32-Victoria_Azarenka-Angelique_Kerber,1,B-DTL,4,3,2,0,1,3,1
20150223-W-Doha-R32-Victoria_Azarenka-Angelique_Kerber,1,B-IO,4,2,1,0,1,3,1
20150223-W-Doha-R32-Victoria_Azarenka-Angelique_Kerber,1,S-XC,1,0,0,0,0,0,1
20150223-W-Doha-R32-Victoria_Azarenka-Angelique_Kerber,1,S-DTM,2,0,0,0,0,0,2
20150223-W-Doha-R32-Victoria_Azarenka-Angelique_Kerber,1,S-DTL,1,1,0,0,1,0,1
20150223-W-Doha-R32-Victoria_Azarenka-Angelique_Kerber,1,S-IO,2,0,0,0,0,2,0
20150223-W-Doha-R32-Victoria_Azarenka-Angelique_Kerber,2,F-XC,20,6,1,1,4,11,9
20150223-W-Doha-R32-Victoria_Azarenka-Angelique_Kerber,2,F-DTM,9,1,0,0,1,2,7
20150223-W-Doha-R32-Victoria_Azarenka-Angelique_Kerber,2,F-DTL,7,6,3,1,2,4,3
20150223-W-Doha-R32-Victoria_Azarenka-Angelique_Kerber,2,F-IO,9,3,2,0,1,7,2
20150223-W-Doha-R32-Victoria_Azarenka-Angelique_Kerber,2,F-II,1,1,0,0,1,0,1
20150223-W-Doha-R32-Victoria_Azarenka-Angelique_Kerber,2,B-XC,19,4,1,1,2,6,13
20150223-W-Doha-R32-Victoria_Azarenka-Angelique_Kerber,2,B-DTM,24,3,0,0,3,7,17
20150223-W-Doha-R32-Victoria_Azarenka-Angelique_Kerber,2,B-DTL,5,4,0,1,3,2,3
20150223-W-Doha-R32-Victoria_Azarenka-Angelique_Kerber,2,B-IO,4,2,0,0,2,1,3
20150223-W-Doha-R32-Victoria_Azarenka-Angelique_Kerber,2,S-XC,3,1,0,0,1,1,2
20150223-W-Doha-R32-Victoria_Azarenka-Angelique_Kerber,2,S-DTM,3,0,0,0,0,0,3
20150212-W-Antwerp-R16-Kristina_Mladenovic-Lucie_Safarova,1,F-XC,13,3,2,0,1,5,8
20150212-W-Antwerp-R16-Kristina_Mladenovic-Lucie_Safarova,1,F-DTM,17,2,1,0,1,5,12
20150212-W-Antwerp-R16-Kristina_Mladenovic-Lucie_Safarova,1,F-DTL,4,0,0,0,0,2,2
20150212-W-Antwerp-R16-Kristina_Mladenovic-Lucie_Safarova,1,F-IO,9,2,2,0,0,7,2
20150212-W-Antwerp-R16-Kristina_Mladenovic-Lucie_Safarova,1,F-II,1,1,0,1,0,1,0
20150212-W-Antwerp-R16-Kristina_Mladenovic-Lucie_Safarova,1,B-XC,11,3,1,1,1,4,7
20150212-W-Antwerp-R16-Kristina_Mladenovic-Lucie_Safarova,1,B-DTM,19,5,0,0,5,6,13
20150212-W-Antwerp-R16-Kristina_Mladenovic-Lucie_Safarova,1,B-DTL,4,2,0,0,2,0,4
20150212-W-Antwerp-R16-Kristina_Mladenovic-Lucie_Safarova,1,B-IO,3,0,0,0,0,1,2
20150212-W-Antwerp-R16-Kristina_Mladenovic-Lucie_Safarova,1,S-XC,1,1,1,0,0,1,0
20150212-W-Antwerp-R16-Kristina_Mladenovic-Lucie_Safarova,1,S-DTM,2,0,0,0,0,0,2
20150212-W-Antwerp-R16-Kristina_Mladenovic-Lucie_Safarova,1,S-DTL,1,0,0,0,0,0,1
20150212-W-Antwerp-R16-Kristina_Mladenovic-Lucie_Safarova,2,F-XC,27,8,4,2,2,20,7
20150212-W-Antwerp-R16-Kristina_Mladenovic-Lucie_Safarova,2,F-DTM,13,0,0,0,0,7,6
20150212-W-Antwerp-R16-Kristina_Mladenovic-Lucie_Safarova,2,F-DTL,3,2,1,0,1,1,2
20150212-W-Antwerp-R16-Kristina_Mladenovic-Lucie_Safarova,2,F-IO,8,4,3,1,0,8,0
20150212-W-Antwerp-R16-Kristina_Mladenovic-Lucie_Safarova,2,B-XC,6,3,2,1,0,5,1
20150212-W-Antwerp-R16-Kristina_Mladenovic-Lucie_Safarova,2,B-DTM,14,2,0,0,2,8,6
20150212-W-Antwerp-R16-Kristina_Mladenovic-Lucie_Safarova,2,B-DTL,10,6,4,0,2,8,2
20150212-W-Antwerp-R16-Kristina_Mladenovic-Lucie_Safarova,2,B-IO,3,0,0,0,0,2,1
20150212-W-Antwerp-R16-Kristina_Mladenovic-Lucie_Safarova,2,S-XC,2,0,0,0,0,0,2
20150217-W-Dubai-R32-Elina_Svitolina-Petra_Kvitova,1,F-XC,22,5,2,0,3,11,11
20150217-W-Dubai-R32-Elina_Svitolina-Petra_Kvitova,1,F-DTM,47,8,3,0,5,18,29
20150217-W-Dubai-R32-Elina_Svitolina-Petra_Kvitova,1,F-DTL,2,1,1,0,0,1,1
20150217-W-Dubai-R32-Elina_Svitolina-Petra_Kvitova,1,F-IO,8,6,0,2,4,2,6
20150217-W-Dubai-R32-Elina_Svitolina-Petra_Kvitova,1,B-XC,18,8,3,0,5,6,12
20150217-W-Dubai-R32-Elina_Svitolina-Petra_Kvitova,1,B-DTM,32,3,0,0,3,16,16
20150217-W-Dubai-R32-Elina_Svitolina-Petra_Kvitova,1,B-DTL,1,0,0,0,0,0,1
20150217-W-Dubai-R32-Elina_Svitolina-Petra_Kvitova,1,B-IO,1,0,0,0,0,0,1
20150217-W-Dubai-R32-Elina_Svitolina-Petra_Kvitova,1,S-XC,2,0,0,0,0,1,1
20150217-W-Dubai-R32-Elina_Svitolina-Petra_Kvitova,1,S-DTM,2,0,0,0,0,1,1
20150217-W-Dubai-R32-Elina_Svitolina-Petra_Kvitova,1,S-DTL,1,1,0,0,1,0,1
20150217-W-Dubai-R32-Elina_Svitolina-Petra_Kvitova,2,F-XC,32,15,5,2,8,17,15
20150217-W-Dubai-R32-Elina_Svitolina-Petra_Kvitova,2,F-DTM,21,4,0,0,4,11,10
20150217-W-Dubai-R32-Elina_Svitolina-Petra_Kvitova,2,F-DTL,6,3,1,1,1,5,1
20150217-W-Dubai-R32-Elina_Svitolina-Petra_Kvitova,2,F-IO,29,18,7,2,9,13,16
20150217-W-Dubai-R32-Elina_Svitolina-Petra_Kvitova,2,F-II,2,1,0,0,1,1,1
20150217-W-Dubai-R32-Elina_Svitolina-Petra_Kvitova,2,B-XC,37,15,5,1,9,18,19
20150217-W-Dubai-R32-Elina_Svitolina-Petra_Kvitova,2,B-DTM,20,2,0,0,2,13,7
20150217-W-Dubai-R32-Elina_Svitolina-Petra_Kvitova,2,B-DTL,2,1,0,0,1,0,2
20150217-W-Dubai-R32-Elina_Svitolina-Petra_Kvitova,2,B-IO,10,3,0,1,2,4,6
20150217-W-Dubai-R32-Elina_Svitolina-Petra_Kvitova,2,B-II,1,0,0,0,0,0,1
20150217-W-Dubai-R32-Elina_Svitolina-Petra_Kvitova,2,S-XC,1,0,0,0,0,0,1
20150217-W-Dubai-R32-Elina_Svitolina-Petra_Kvitova,2,S-DTM,2,0,0,0,0,2,0
20150228-W-Doha-F-Victoria_Azarenka-Lucie_Safarova,1,F-XC,27,3,0,1,2,12,15
20150228-W-Doha-F-Victoria_Azarenka-Lucie_Safarova,1,F-DTM,10,0,0,0,0,5,5
20150228-W-Doha-F-Victoria_Azarenka-Lucie_Safarova,1,F-DTL,6,3,1,1,1,4,2
20150228-W-Doha-F-Victoria_Azarenka-Lucie_Safarova,1,F-IO,15,7,1,4,2,11,4
20150228-W-Doha-F-Victoria_Azarenka-Lucie_Safarova,1,B-XC,20,10,3,2,5,6,14
20150228-W-Doha-F-Victoria_Azarenka-Lucie_Safarova,1,B-DTM,16,2,0,1,1,7,9
20150228-W-Doha-F-Victoria_Azarenka-Lucie_Safarova,1,B-DTL,3,0,0,0,0,1,2
20150228-W-Doha-F-Victoria_Azarenka-Lucie_Safarova,1,B-IO,10,6,2,0,4,4,6
20150228-W-Doha-F-Victoria_Azarenka-Lucie_Safarova,1,S-XC,1,0,0,0,0,1,0
20150228-W-Doha-F-Victoria_Azarenka-Lucie_Safarova,1,S-DTM,4,0,0,0,0,3,1
20150228-W-Doha-F-Victoria_Azarenka-Lucie_Safarova,1,S-DTL,1,1,0,1,0,1,0
20150228-W-Doha-F-Victoria_Azarenka-Lucie_Safarova,2,F-XC,25,9,4,0,5,12,13
20150228-W-Doha-F-Victoria_Azarenka-Lucie_Safarova,2,F-DTM,15,0,0,0,0,10,5
20150228-W-Doha-F-Victoria_Azarenka-Lucie_Safarova,2,F-DTL,7,6,5,1,0,7,0
20150228-W-Doha-F-Victoria_Azarenka-Lucie_Safarova,2,F-IO,8,4,1,3,0,5,3
20150228-W-Doha-F-Victoria_Azarenka-Lucie_Safarova,2,B-XC,16,4,4,0,0,8,8
20150228-W-Doha-F-Victoria_Azarenka-Lucie_Safarova,2,B-DTM,29,2,0,0,2,13,16
20150228-W-Doha-F-Victoria_Azarenka-Lucie_Safarova,2,B-DTL,6,3,3,0,0,5,1
20150228-W-Doha-F-Victoria_Azarenka-Lucie_Safarova,2,B-IO,3,1,0,0,1,0,3
20150228-W-Doha-F-Victoria_Azarenka-Lucie_Safarova,2,S-XC,1,0,0,0,0,0,1
20150228-W-Doha-F-Victoria_Azarenka-Lucie_Safarova,2,S-DTM,3,0,0,0,0,2,1
20150227-W-Doha-SF-Lucie_Safarova-Carla_Suarez_Navarro,1,F-XC,49,10,4,2,4,27,22
20150227-W-Doha-SF-Lucie_Safarova-Carla_Suarez_Navarro,1,F-DTM,20,0,0,0,0,12,8
20150227-W-Doha-SF-Lucie_Safarova-Carla_Suarez_Navarro,1,F-DTL,11,4,2,2,0,10,1
20150227-W-Doha-SF-Lucie_Safarova-Carla_Suarez_Navarro,1,F-IO,16,6,2,0,4,9,7
20150227-W-Doha-SF-Lucie_Safarova-Carla_Suarez_Navarro,1,F-II,1,1,0,0,1,0,1
20150227-W-Doha-SF-Lucie_Safarova-Carla_Suarez_Navarro,1,B-XC,40,10,2,1,7,25,15
20150227-W-Doha-SF-Lucie_Safarova-Carla_Suarez_Navarro,1,B-DTM,50,4,1,0,3,33,17
20150227-W-Doha-SF-Lucie_Safarova-Carla_Suarez_Navarro,1,B-DTL,7,2,2,0,0,4,3
20150227-W-Doha-SF-Lucie_Safarova-Carla_Suarez_Navarro,1,B-IO,6,4,2,2,0,6,0
20150227-W-Doha-SF-Lucie_Safarova-Carla_Suarez_Navarro,1,S-XC,1,1,0,0,1,0,1
20150227-W-Doha-SF-Lucie_Safarova-Carla_Suarez_Navarro,1,S-DTM,3,1,0,0,1,1,2
20150227-W-Doha-SF-Lucie_Safarova-Carla_Suarez_Navarro,1,S-DTL,1,0,0,0,0,0,1
20150227-W-Doha-SF-Lucie_Safarova-Carla_Suarez_Navarro,2,F-XC,58,8,2,0,6,21,37
20150227-W-Doha-SF-Lucie_Safarova-Carla_Suarez_Navarro,2,F-DTM,42,6,0,0,6,10,32
20150227-W-Doha-SF-Lucie_Safarova-Carla_Suarez_Navarro,2,F-DTL,5,1,1,0,0,3,2
20150227-W-Doha-SF-Lucie_Safarova-Carla_Suarez_Navarro,2,F-IO,14,8,2,1,5,5,9
20150227-W-Doha-SF-Lucie_Safarova-Carla_Suarez_Navarro,2,B-XC,13,5,2,1,2,6,7
20150227-W-Doha-SF-Lucie_Safarova-Carla_Suarez_Navarro,2,B-DTM,30,1,0,0,1,17,13
20150227-W-Doha-SF-Lucie_Safarova-Carla_Suarez_Navarro,2,B-DTL,4,1,1,0,0,1,3
20150227-W-Doha-SF-Lucie_Safarova-Carla_Suarez_Navarro,2,B-IO,6,1,0,0,1,3,3
20150227-W-Doha-SF-Lucie_Safarova-Carla_Suarez_Navarro,2,S-XC,13,0,0,0,0,5,8
20150227-W-Doha-SF-Lucie_Safarova-Carla_Suarez_Navarro,2,S-DTM,10,2,0,0,2,2,8
20150227-W-Doha-SF-Lucie_Safarova-Carla_Suarez_Navarro,2,S-DTL,3,1,0,0,1,0,3
20150227-W-Doha-SF-Lucie_Safarova-Carla_Suarez_Navarro,2,S-IO,1,0,0,0,0,0,1
20150219-W-Dubai-QF-Lucie_Safarova-Karolina_Pliskova,1,F-XC,61,13,2,3,8,29,32
20150219-W-Dubai-QF-Lucie_Safarova-Karolina_Pliskova,1,F-DTM,60,5,1,0,4,31,29
20150219-W-Dubai-QF-Lucie_Safarova-Karolina_Pliskova,1,F-DTL,11,7,3,1,3,6,5
20150219-W-Dubai-QF-Lucie_Safarova-Karolina_Pliskova,1,F-IO,13,7,4,2,1,9,4
20150219-W-Dubai-QF-Lucie_Safarova-Karolina_Pliskova,1,B-XC,26,8,1,5,2,18,8
20150219-W-Dubai-QF-Lucie_Safarova-Karolina_Pliskova,1,B-DTM,38,6,0,0,6,10,28
20150219-W-Dubai-QF-Lucie_Safarova-Karolina_Pliskova,1,B-DTL,11,2,1,0,1,5,6
20150219-W-Dubai-QF-Lucie_Safarova-Karolina_Pliskova,1,B-IO,8,2,0,0,2,4,4
20150219-W-Dubai-QF-Lucie_Safarova-Karolina_Pliskova,1,S-DTM,3,0,0,0,0,0,3
20150219-W-Dubai-QF-Lucie_Safarova-Karolina_Pliskova,1,S-DTL,2,1,0,1,0,1,1
20150219-W-Dubai-QF-Lucie_Safarova-Karolina_Pliskova,1,S-IO,1,1,0,0,1,0,1
20150219-W-Dubai-QF-Lucie_Safarova-Karolina_Pliskova,2,F-XC,25,10,3,2,5,13,12
20150219-W-Dubai-QF-Lucie_Safarova-Karolina_Pliskova,2,F-DTM,34,6,1,1,4,18,16
20150219-W-Dubai-QF-Lucie_Safarova-Karolina_Pliskova,2,F-DTL,4,2,0,0,2,1,3
20150219-W-Dubai-QF-Lucie_Safarova-Karolina_Pliskova,2,F-IO,17,5,4,0,1,9,8
20150219-W-Dubai-QF-Lucie_Safarova-Karolina_Pliskova,2,B-XC,46,9,2,1,6,26,20
20150219-W-Dubai-QF-Lucie_Safarova-Karolina_Pliskova,2,B-DTM,51,9,0,0,9,21,30
20150219-W-Dubai-QF-Lucie_Safarova-Karolina_Pliskova,2,B-DTL,8,2,1,0,1,5,3
20150219-W-Dubai-QF-Lucie_Safarova-Karolina_Pliskova,2,B-IO,16,6,0,1,5,8,8
20150219-W-Dubai-QF-Lucie_Safarova-Karolina_Pliskova,2,B-II,1,0,0,0,0,0,1
20150219-W-Dubai-QF-Lucie_Safarova-Karolina_Pliskova,2,S-DTM,4,0,0,0,0,1,3
20140419-W-Fed_Cup_World_Group_SF-RR-Sara_Errani-Lucie_Safarova,1,F-XC,32,2,0,1,1,16,16
20140419-W-Fed_Cup_World_Group_SF-RR-Sara_Errani-Lucie_Safarova,1,F-DTM,25,2,0,0,2,5,20
20140419-W-Fed_Cup_World_Group_SF-RR-Sara_Errani-Lucie_Safarova,1,F-DTL,4,2,0,1,1,2,2
20140419-W-Fed_Cup_World_Group_SF-RR-Sara_Errani-Lucie_Safarova,1,F-IO,4,0,0,0,0,1,3
20140419-W-Fed_Cup_World_Group_SF-RR-Sara_Errani-Lucie_Safarova,1,B-XC,18,6,0,2,4,9,9
20140419-W-Fed_Cup_World_Group_SF-RR-Sara_Errani-Lucie_Safarova,1,B-DTM,22,2,0,0,2,8,14
20140419-W-Fed_Cup_World_Group_SF-RR-Sara_Errani-Lucie_Safarova,1,B-DTL,5,1,0,1,0,2,3
20140419-W-Fed_Cup_World_Group_SF-RR-Sara_Errani-Lucie_Safarova,1,B-IO,5,2,0,1,1,2,3
20140419-W-Fed_Cup_World_Group_SF-RR-Sara_Errani-Lucie_Safarova,1,S-XC,3,0,0,0,0,0,3
20140419-W-Fed_Cup_World_Group_SF-RR-Sara_Errani-Lucie_Safarova,1,S-DTM,3,0,0,0,0,3,0
20140419-W-Fed_Cup_World_Group_SF-RR-Sara_Errani-Lucie_Safarova,2,F-XC,31,9,3,1,5,16,15
20140419-W-Fed_Cup_World_Group_SF-RR-Sara_Errani-Lucie_Safarova,2,F-DTM,12,1,0,0,1,8,4
20140419-W-Fed_Cup_World_Group_SF-RR-Sara_Errani-Lucie_Safarova,2,F-DTL,8,5,4,1,0,7,1
20140419-W-Fed_Cup_World_Group_SF-RR-Sara_Errani-Lucie_Safarova,2,F-IO,25,11,5,3,3,18,7
20140419-W-Fed_Cup_World_Group_SF-RR-Sara_Errani-Lucie_Safarova,2,F-II,5,2,0,2,0,4,1
20140419-W-Fed_Cup_World_Group_SF-RR-Sara_Errani-Lucie_Safarova,2,B-XC,22,2,1,0,1,13,9
20140419-W-Fed_Cup_World_Group_SF-RR-Sara_Errani-Lucie_Safarova,2,B-DTM,22,2,0,0,2,12,10
20140419-W-Fed_Cup_World_Group_SF-RR-Sara_Errani-Lucie_Safarova,2,B-DTL,9,5,2,1,2,5,4
20140419-W-Fed_Cup_World_Group_SF-RR-Sara_Errani-Lucie_Safarova,2,B-IO,2,1,1,0,0,2,0
20140419-W-Fed_Cup_World_Group_SF-RR-Sara_Errani-Lucie_Safarova,2,B-II,1,0,0,0,0,1,0
20140419-W-Fed_Cup_World_Group_SF-RR-Sara_Errani-Lucie_Safarova,2,S-DTM,2,0,0,0,0,2,0
20150207-W-ITF_Midland-SF-Louisa_Chirico-Katerina_Vankova,1,F-XC,19,5,2,3,0,16,3
20150207-W-ITF_Midland-SF-Louisa_Chirico-Katerina_Vankova,1,F-DTM,21,3,0,0,3,15,6
20150207-W-ITF_Midland-SF-Louisa_Chirico-Katerina_Vankova,1,F-DTL,6,2,2,0,0,4,2
20150207-W-ITF_Midland-SF-Louisa_Chirico-Katerina_Vankova,1,F-IO,16,7,3,2,2,13,3
20150207-W-ITF_Midland-SF-Louisa_Chirico-Katerina_Vankova,1,B-XC,2,2,1,1,0,2,0
20150207-W-ITF_Midland-SF-Louisa_Chirico-Katerina_Vankova,1,B-DTM,12,0,0,0,0,10,2
20150207-W-ITF_Midland-SF-Louisa_Chirico-Katerina_Vankova,1,B-DTL,4,3,1,0,2,2,2
20150207-W-ITF_Midland-SF-Louisa_Chirico-Katerina_Vankova,1,B-IO,3,1,1,0,0,3,0
20150207-W-ITF_Midland-SF-Louisa_Chirico-Katerina_Vankova,1,S-DTM,4,0,0,0,0,3,1
20150207-W-ITF_Midland-SF-Louisa_Chirico-Katerina_Vankova,1,S-DTL,2,0,0,0,0,2,0
20150207-W-ITF_Midland-SF-Louisa_Chirico-Katerina_Vankova,2,F-XC,17,7,1,1,5,5,12
20150207-W-ITF_Midland-SF-Louisa_Chirico-Katerina_Vankova,2,F-DTM,17,5,0,1,4,3,14
20150207-W-ITF_Midland-SF-Louisa_Chirico-Katerina_Vankova,2,F-DTL,4,1,1,0,0,2,2
20150207-W-ITF_Midland-SF-Louisa_Chirico-Katerina_Vankova,2,F-IO,9,4,3,0,1,3,6
20150207-W-ITF_Midland-SF-Louisa_Chirico-Katerina_Vankova,2,B-XC,8,0,0,0,0,0,8
20150207-W-ITF_Midland-SF-Louisa_Chirico-Katerina_Vankova,2,B-DTM,24,7,0,0,7,5,19
20150207-W-ITF_Midland-SF-Louisa_Chirico-Katerina_Vankova,2,B-DTL,2,1,0,0,1,0,2
20150207-W-ITF_Midland-SF-Louisa_Chirico-Katerina_Vankova,2,B-IO,7,4,1,0,3,1,6
20150207-W-ITF_Midland-SF-Louisa_Chirico-Katerina_Vankova,2,S-XC,3,1,0,1,0,1,2
20150207-W-ITF_Midland-SF-Louisa_Chirico-Katerina_Vankova,2,S-DTM,3,0,0,0,0,1,2
20150207-W-ITF_Midland-SF-Louisa_Chirico-Katerina_Vankova,2,S-DTL,1,0,0,0,0,0,1
20150220-W-ITF_Altenkirchen-QF-Ana_Vrljic-Oceane_Dodin,1,F-XC,37,8,4,2,2,20,17
20150220-W-ITF_Altenkirchen-QF-Ana_Vrljic-Oceane_Dodin,1,F-DTM,19,5,0,0,5,6,13
20150220-W-ITF_Altenkirchen-QF-Ana_Vrljic-Oceane_Dodin,1,F-DTL,9,5,1,0,4,3,6
20150220-W-ITF_Altenkirchen-QF-Ana_Vrljic-Oceane_Dodin,1,F-IO,12,3,2,0,1,8,4
20150220-W-ITF_Altenkirchen-QF-Ana_Vrljic-Oceane_Dodin,1,B-XC,7,1,1,0,0,2,5
20150220-W-ITF_Altenkirchen-QF-Ana_Vrljic-Oceane_Dodin,1,B-DTM,2,1,0,0,1,0,2
20150220-W-ITF_Altenkirchen-QF-Ana_Vrljic-Oceane_Dodin,1,B-DTL,5,5,1,1,3,2,3
20150220-W-ITF_Altenkirchen-QF-Ana_Vrljic-Oceane_Dodin,1,B-IO,1,1,1,0,0,1,0
20150220-W-ITF_Altenkirchen-QF-Ana_Vrljic-Oceane_Dodin,1,S-XC,12,1,0,0,1,3,9
20150220-W-ITF_Altenkirchen-QF-Ana_Vrljic-Oceane_Dodin,1,S-DTM,26,2,0,0,2,8,18
20150220-W-ITF_Altenkirchen-QF-Ana_Vrljic-Oceane_Dodin,1,S-DTL,1,0,0,0,0,0,1
20150220-W-ITF_Altenkirchen-QF-Ana_Vrljic-Oceane_Dodin,1,S-IO,6,3,1,0,2,2,4
20150220-W-ITF_Altenkirchen-QF-Ana_Vrljic-Oceane_Dodin,2,F-XC,26,4,3,1,0,22,4
20150220-W-ITF_Altenkirchen-QF-Ana_Vrljic-Oceane_Dodin,2,F-DTM,22,2,0,0,2,10,12
20150220-W-ITF_Altenkirchen-QF-Ana_Vrljic-Oceane_Dodin,2,F-DTL,12,6,1,1,4,7,5
20150220-W-ITF_Altenkirchen-QF-Ana_Vrljic-Oceane_Dodin,2,F-IO,10,5,1,2,2,7,3
20150220-W-ITF_Altenkirchen-QF-Ana_Vrljic-Oceane_Dodin,2,B-XC,28,4,2,2,0,21,7
20150220-W-ITF_Altenkirchen-QF-Ana_Vrljic-Oceane_Dodin,2,B-DTM,32,5,0,1,4,13,19
20150220-W-ITF_Altenkirchen-QF-Ana_Vrljic-Oceane_Dodin,2,B-DTL,8,4,3,0,1,4,4
20150220-W-ITF_Altenkirchen-QF-Ana_Vrljic-Oceane_Dodin,2,B-IO,9,2,2,0,0,7,2
20150220-W-ITF_Altenkirchen-QF-Ana_Vrljic-Oceane_Dodin,2,S-DTM,3,0,0,0,0,0,3
20150220-W-ITF_Altenkirchen-QF-Ana_Vrljic-Oceane_Dodin,2,S-DTL,1,0,0,0,0,0,1
20130117-W-Australian_Open-R64-Laura_Robson-Petra_Kvitova,1,F-XC,35,7,2,3,2,21,14
20130117-W-Australian_Open-R64-Laura_Robson-Petra_Kvitova,1,F-DTM,38,8,0,0,8,16,22
20130117-W-Australian_Open-R64-Laura_Robson-Petra_Kvitova,1,F-DTL,9,3,1,1,1,5,4
20130117-W-Australian_Open-R64-Laura_Robson-Petra_Kvitova,1,F-IO,14,10,2,1,7,4,10
20130117-W-Australian_Open-R64-Laura_Robson-Petra_Kvitova,1,F-II,1,1,1,0,0,1,0
20130117-W-Australian_Open-R64-Laura_Robson-Petra_Kvitova,1,B-XC,20,7,2,3,2,8,12
20130117-W-Australian_Open-R64-Laura_Robson-Petra_Kvitova,1,B-DTM,42,4,0,0,4,16,26
20130117-W-Australian_Open-R64-Laura_Robson-Petra_Kvitova,1,B-DTL,11,5,1,0,4,2,9
20130117-W-Australian_Open-R64-Laura_Robson-Petra_Kvitova,1,B-IO,6,1,0,1,0,4,2
20130117-W-Australian_Open-R64-Laura_Robson-Petra_Kvitova,1,S-DTM,3,0,0,0,0,2,1
20130117-W-Australian_Open-R64-Laura_Robson-Petra_Kvitova,1,S-DTL,2,0,0,0,0,1,1
20130117-W-Australian_Open-R64-Laura_Robson-Petra_Kvitova,2,F-XC,29,14,4,6,4,19,10
20130117-W-Australian_Open-R64-Laura_Robson-Petra_Kvitova,2,F-DTM,36,6,0,0,6,15,21
20130117-W-Australian_Open-R64-Laura_Robson-Petra_Kvitova,2,F-DTL,14,9,1,2,6,6,8
20130117-W-Australian_Open-R64-Laura_Robson-Petra_Kvitova,2,F-IO,29,10,6,1,3,19,10
20130117-W-Australian_Open-R64-Laura_Robson-Petra_Kvitova,2,B-XC,26,12,5,5,2,18,8
20130117-W-Australian_Open-R64-Laura_Robson-Petra_Kvitova,2,B-DTM,34,5,0,0,5,15,19
20130117-W-Australian_Open-R64-Laura_Robson-Petra_Kvitova,2,B-DTL,6,6,0,4,2,4,2
20130117-W-Australian_Open-R64-Laura_Robson-Petra_Kvitova,2,B-IO,9,5,0,0,5,2,7
20130117-W-Australian_Open-R64-Laura_Robson-Petra_Kvitova,2,S-XC,3,0,0,0,0,1,2
20130117-W-Australian_Open-R64-Laura_Robson-Petra_Kvitova,2,S-DTM,3,0,0,0,0,2,1
20130117-W-Australian_Open-R64-Laura_Robson-Petra_Kvitova,2,S-IO,2,1,0,0,1,0,2
20140325-W-Miami-QF-Maria_Sharapova-Petra_Kvitova,1,F-XC,16,9,2,2,5,9,7
20140325-W-Miami-QF-Maria_Sharapova-Petra_Kvitova,1,F-DTM,26,6,1,0,5,11,15
20140325-W-Miami-QF-Maria_Sharapova-Petra_Kvitova,1,F-DTL,9,7,3,3,1,8,1
20140325-W-Miami-QF-Maria_Sharapova-Petra_Kvitova,1,F-IO,7,1,1,0,0,5,2
20140325-W-Miami-QF-Maria_Sharapova-Petra_Kvitova,1,B-XC,15,5,2,1,2,8,7
20140325-W-Miami-QF-Maria_Sharapova-Petra_Kvitova,1,B-DTM,28,3,0,0,3,16,12
20140325-W-Miami-QF-Maria_Sharapova-Petra_Kvitova,1,B-DTL,2,2,1,0,1,1,1
20140325-W-Miami-QF-Maria_Sharapova-Petra_Kvitova,1,B-IO,1,0,0,0,0,0,1
20140325-W-Miami-QF-Maria_Sharapova-Petra_Kvitova,1,S-DTM,1,0,0,0,0,0,1
20140325-W-Miami-QF-Maria_Sharapova-Petra_Kvitova,2,F-XC,28,16,4,4,8,13,15
20140325-W-Miami-QF-Maria_Sharapova-Petra_Kvitova,2,F-DTM,30,4,1,0,3,12,18
20140325-W-Miami-QF-Maria_Sharapova-Petra_Kvitova,2,F-DTL,4,4,1,0,3,1,3
20140325-W-Miami-QF-Maria_Sharapova-Petra_Kvitova,2,F-IO,15,8,5,0,3,9,6
20140325-W-Miami-QF-Maria_Sharapova-Petra_Kvitova,2,B-XC,12,5,0,2,3,6,6
20140325-W-Miami-QF-Maria_Sharapova-Petra_Kvitova,2,B-DTM,17,4,1,0,3,10,7
20140325-W-Miami-QF-Maria_Sharapova-Petra_Kvitova,2,B-DTL,1,0,0,0,0,1,0
20140325-W-Miami-QF-Maria_Sharapova-Petra_Kvitova,2,B-IO,3,1,0,0,1,1,2
20140325-W-Miami-QF-Maria_Sharapova-Petra_Kvitova,2,S-XC,1,0,0,0,0,0,1
20130513-W-Rome-R64-Venus_Williams-Laura_Robson,1,F-XC,34,8,2,1,5,15,19
20130513-W-Rome-R64-Venus_Williams-Laura_Robson,1,F-DTM,20,6,0,1,5,8,12
20130513-W-Rome-R64-Venus_Williams-Laura_Robson,1,F-DTL,5,2,1,0,1,2,3
20130513-W-Rome-R64-Venus_Williams-Laura_Robson,1,F-IO,8,6,2,1,3,3,5
20130513-W-Rome-R64-Venus_Williams-Laura_Robson,1,B-XC,14,6,0,1,5,5,9
20130513-W-Rome-R64-Venus_Williams-Laura_Robson,1,B-DTM,8,1,0,0,1,2,6
20130513-W-Rome-R64-Venus_Williams-Laura_Robson,1,B-DTL,4,2,2,0,0,3,1
20130513-W-Rome-R64-Venus_Williams-Laura_Robson,1,B-IO,2,0,0,0,0,2,0
20130513-W-Rome-R64-Venus_Williams-Laura_Robson,1,S-DTM,1,0,0,0,0,0,1
20130513-W-Rome-R64-Venus_Williams-Laura_Robson,1,S-DTL,1,0,0,0,0,0,1
20130513-W-Rome-R64-Venus_Williams-Laura_Robson,2,F-XC,17,10,4,1,5,10,7
20130513-W-Rome-R64-Venus_Williams-Laura_Robson,2,F-DTM,13,2,0,1,1,6,7
20130513-W-Rome-R64-Venus_Williams-Laura_Robson,2,F-DTL,7,5,3,0,2,3,4
20130513-W-Rome-R64-Venus_Williams-Laura_Robson,2,F-IO,15,6,5,0,1,10,5
20130513-W-Rome-R64-Venus_Williams-Laura_Robson,2,B-XC,12,2,1,0,1,6,6
20130513-W-Rome-R64-Venus_Williams-Laura_Robson,2,B-DTM,25,5,0,2,3,13,12
20130513-W-Rome-R64-Venus_Williams-Laura_Robson,2,B-DTL,4,3,1,0,2,2,2
20150311-W-Indian_Wells-R128-Sloane_Stephens-Chanelle_Scheepers,1,F-XC,35,10,0,6,4,23,12
20150311-W-Indian_Wells-R128-Sloane_Stephens-Chanelle_Scheepers,1,F-DTM,35,3,0,0,3,14,21
20150311-W-Indian_Wells-R128-Sloane_Stephens-Chanelle_Scheepers,1,F-IO,8,6,3,1,2,5,3
20150311-W-Indian_Wells-R128-Sloane_Stephens-Chanelle_Scheepers,1,F-II,1,1,1,0,0,1,0
20150311-W-Indian_Wells-R128-Sloane_Stephens-Chanelle_Scheepers,1,B-XC,33,6,0,1,5,17,16
20150311-W-Indian_Wells-R128-Sloane_Stephens-Chanelle_Scheepers,1,B-DTM,54,11,0,0,11,29,25
20150311-W-Indian_Wells-R128-Sloane_Stephens-Chanelle_Scheepers,1,B-DTL,8,4,3,1,0,6,2
20150311-W-Indian_Wells-R128-Sloane_Stephens-Chanelle_Scheepers,1,B-IO,6,2,1,0,1,3,3
20150311-W-Indian_Wells-R128-Sloane_Stephens-Chanelle_Scheepers,1,S-XC,1,0,0,0,0,0,1
20150311-W-Indian_Wells-R128-Sloane_Stephens-Chanelle_Scheepers,1,S-DTM,3,0,0,0,0,1,2
20150311-W-Indian_Wells-R128-Sloane_Stephens-Chanelle_Scheepers,1,S-DTL,1,1,0,0,1,0,1
20150311-W-Indian_Wells-R128-Sloane_Stephens-Chanelle_Scheepers,1,S-IO,3,1,0,0,1,1,2
20150311-W-Indian_Wells-R128-Sloane_Stephens-Chanelle_Scheepers,2,F-XC,25,9,2,3,4,9,16
20150311-W-Indian_Wells-R128-Sloane_Stephens-Chanelle_Scheepers,2,F-DTM,48,8,0,1,7,19,29
20150311-W-Indian_Wells-R128-Sloane_Stephens-Chanelle_Scheepers,2,F-DTL,17,5,0,1,4,8,9
20150311-W-Indian_Wells-R128-Sloane_Stephens-Chanelle_Scheepers,2,F-IO,24,4,1,1,2,9,15
20150311-W-Indian_Wells-R128-Sloane_Stephens-Chanelle_Scheepers,2,B-XC,27,5,0,2,3,11,16
20150311-W-Indian_Wells-R128-Sloane_Stephens-Chanelle_Scheepers,2,B-DTM,27,1,0,0,1,18,9
20150311-W-Indian_Wells-R128-Sloane_Stephens-Chanelle_Scheepers,2,B-DTL,6,4,1,1,2,2,4
20150311-W-Indian_Wells-R128-Sloane_Stephens-Chanelle_Scheepers,2,B-IO,5,1,1,0,0,3,2
20150311-W-Indian_Wells-R128-Sloane_Stephens-Chanelle_Scheepers,2,S-DTM,1,0,0,0,0,1,0
20150311-W-Indian_Wells-R128-Sloane_Stephens-Chanelle_Scheepers,2,S-DTL,2,0,0,0,0,0,2
20150307-W-Monterrey-SF-Caroline_Garcia-Ana_Ivanovic,1,F-XC,14,6,5,1,0,11,3
20150307-W-Monterrey-SF-Caroline_Garcia-Ana_Ivanovic,1,F-DTM,9,1,1,0,0,4,5
20150307-W-Monterrey-SF-Caroline_Garcia-Ana_Ivanovic,1,F-DTL,2,1,1,0,0,1,1
20150307-W-Monterrey-SF-Caroline_Garcia-Ana_Ivanovic,1,F-IO,5,4,2,1,1,4,1
20150307-W-Monterrey-SF-Caroline_Garcia-Ana_Ivanovic,1,F-II,1,1,0,1,0,1,0
20150307-W-Monterrey-SF-Caroline_Garcia-Ana_Ivanovic,1,B-XC,16,7,1,2,4,10,6
20150307-W-Monterrey-SF-Caroline_Garcia-Ana_Ivanovic,1,B-DTM,17,3,0,1,2,6,11
20150307-W-Monterrey-SF-Caroline_Garcia-Ana_Ivanovic,1,B-DTL,2,2,1,0,1,1,1
20150307-W-Monterrey-SF-Caroline_Garcia-Ana_Ivanovic,1,B-IO,1,1,1,0,0,1,0
20150307-W-Monterrey-SF-Caroline_Garcia-Ana_Ivanovic,1,S-XC,1,0,0,0,0,1,0
20150307-W-Monterrey-SF-Caroline_Garcia-Ana_Ivanovic,1,S-DTM,1,0,0,0,0,1,0
20150307-W-Monterrey-SF-Caroline_Garcia-Ana_Ivanovic,1,S-DTL,2,1,0,0,1,0,2
20150307-W-Monterrey-SF-Caroline_Garcia-Ana_Ivanovic,2,F-XC,15,9,6,0,3,10,5
20150307-W-Monterrey-SF-Caroline_Garcia-Ana_Ivanovic,2,F-DTM,6,0,0,0,0,2,4
20150307-W-Monterrey-SF-Caroline_Garcia-Ana_Ivanovic,2,F-DTL,6,2,0,0,2,2,4
20150307-W-Monterrey-SF-Caroline_Garcia-Ana_Ivanovic,2,F-IO,7,3,1,2,0,5,2
20150307-W-Monterrey-SF-Caroline_Garcia-Ana_Ivanovic,2,B-XC,12,4,1,1,2,8,4
20150307-W-Monterrey-SF-Caroline_Garcia-Ana_Ivanovic,2,B-DTM,10,0,0,0,0,4,6
20150307-W-Monterrey-SF-Caroline_Garcia-Ana_Ivanovic,2,B-DTL,3,2,0,0,2,1,2
20150307-W-Monterrey-SF-Caroline_Garcia-Ana_Ivanovic,2,B-IO,1,0,0,0,0,0,1
20150307-W-Monterrey-SF-Caroline_Garcia-Ana_Ivanovic,2,S-XC,1,0,0,0,0,1,0
20150307-W-Monterrey-SF-Caroline_Garcia-Ana_Ivanovic,2,S-DTM,5,1,0,0,1,0,5
20110508-W-Madrid-F-Petra_Kvitova-Victoria_Azarenka,1,F-XC,37,17,8,1,8,22,15
20110508-W-Madrid-F-Petra_Kvitova-Victoria_Azarenka,1,F-DTM,18,0,0,0,0,8,10
20110508-W-Madrid-F-Petra_Kvitova-Victoria_Azarenka,1,F-DTL,13,7,4,2,1,10,3
20110508-W-Madrid-F-Petra_Kvitova-Victoria_Azarenka,1,F-IO,12,5,2,0,3,7,5
20110508-W-Madrid-F-Petra_Kvitova-Victoria_Azarenka,1,B-XC,32,17,7,2,8,21,11
20110508-W-Madrid-F-Petra_Kvitova-Victoria_Azarenka,1,B-DTM,28,6,0,0,6,13,15
20110508-W-Madrid-F-Petra_Kvitova-Victoria_Azarenka,1,B-DTL,6,3,1,0,2,3,3
20110508-W-Madrid-F-Petra_Kvitova-Victoria_Azarenka,1,B-IO,9,6,3,0,3,5,4
20110508-W-Madrid-F-Petra_Kvitova-Victoria_Azarenka,1,S-DTM,5,0,0,0,0,1,4
20110508-W-Madrid-F-Petra_Kvitova-Victoria_Azarenka,1,S-IO,1,0,0,0,0,0,1
20110508-W-Madrid-F-Petra_Kvitova-Victoria_Azarenka,2,F-XC,26,8,1,2,5,9,17
20110508-W-Madrid-F-Petra_Kvitova-Victoria_Azarenka,2,F-DTM,26,1,0,0,1,10,16
20110508-W-Madrid-F-Petra_Kvitova-Victoria_Azarenka,2,F-DTL,11,5,1,1,3,3,8
20110508-W-Madrid-F-Petra_Kvitova-Victoria_Azarenka,2,F-IO,8,3,1,0,2,4,4
20110508-W-Madrid-F-Petra_Kvitova-Victoria_Azarenka,2,B-XC,13,2,1,0,1,5,8
20110508-W-Madrid-F-Petra_Kvitova-Victoria_Azarenka,2,B-DTM,33,1,0,0,1,20,13
20110508-W-Madrid-F-Petra_Kvitova-Victoria_Azarenka,2,B-DTL,7,3,1,0,2,3,4
20110508-W-Madrid-F-Petra_Kvitova-Victoria_Azarenka,2,B-IO,10,2,0,0,2,6,4
20110508-W-Madrid-F-Petra_Kvitova-Victoria_Azarenka,2,S-DTM,4,0,0,0,0,0,4
20110508-W-Madrid-F-Petra_Kvitova-Victoria_Azarenka,2,S-DTL,2,0,0,0,0,1,1
20110508-W-Madrid-F-Petra_Kvitova-Victoria_Azarenka,2,S-IO,1,0,0,0,0,0,1
20140307-W-Indian_Wells-R64-Shuai_Peng-Eugenie_Bouchard,1,F-XC,3,2,0,0,2,0,3
20140307-W-Indian_Wells-R64-Shuai_Peng-Eugenie_Bouchard,1,F-DTM,14,2,0,0,2,3,11
20140307-W-Indian_Wells-R64-Shuai_Peng-Eugenie_Bouchard,1,F-DTL,9,2,0,0,2,4,5
20140307-W-Indian_Wells-R64-Shuai_Peng-Eugenie_Bouchard,1,F-IO,8,2,0,0,2,4,4
20140307-W-Indian_Wells-R64-Shuai_Peng-Eugenie_Bouchard,1,B-XC,16,4,1,1,2,3,13
20140307-W-Indian_Wells-R64-Shuai_Peng-Eugenie_Bouchard,1,B-DTM,16,2,0,0,2,4,12
20140307-W-Indian_Wells-R64-Shuai_Peng-Eugenie_Bouchard,1,B-DTL,11,4,3,1,0,5,6
20140307-W-Indian_Wells-R64-Shuai_Peng-Eugenie_Bouchard,1,B-IO,8,6,2,0,4,2,6
20140307-W-Indian_Wells-R64-Shuai_Peng-Eugenie_Bouchard,1,S-DTM,1,0,0,0,0,0,1
20140307-W-Indian_Wells-R64-Shuai_Peng-Eugenie_Bouchard,2,F-XC,12,5,5,0,0,10,2
20140307-W-Indian_Wells-R64-Shuai_Peng-Eugenie_Bouchard,2,F-DTM,7,2,0,0,2,5,2
20140307-W-Indian_Wells-R64-Shuai_Peng-Eugenie_Bouchard,2,F-DTL,6,3,3,0,0,5,1
20140307-W-Indian_Wells-R64-Shuai_Peng-Eugenie_Bouchard,2,F-IO,9,4,3,1,0,8,1
20140307-W-Indian_Wells-R64-Shuai_Peng-Eugenie_Bouchard,2,B-XC,17,5,2,0,3,12,5
20140307-W-Indian_Wells-R64-Shuai_Peng-Eugenie_Bouchard,2,B-DTM,21,4,0,0,4,11,10
20140307-W-Indian_Wells-R64-Shuai_Peng-Eugenie_Bouchard,2,B-DTL,6,2,1,0,1,4,2
20140307-W-Indian_Wells-R64-Shuai_Peng-Eugenie_Bouchard,2,B-IO,1,0,0,0,0,0,1
20140307-W-Indian_Wells-R64-Shuai_Peng-Eugenie_Bouchard,2,S-DTL,1,0,0,0,0,0,1
20150313-W-Indian_Wells-R64-Agnieszka_Radwanska-Alison_Riske,1,F-XC,18,3,1,1,1,13,5
20150313-W-Indian_Wells-R64-Agnieszka_Radwanska-Alison_Riske,1,F-DTM,17,1,0,0,1,9,8
20150313-W-Indian_Wells-R64-Agnieszka_Radwanska-Alison_Riske,1,F-DTL,7,2,1,0,1,6,1
20150313-W-Indian_Wells-R64-Agnieszka_Radwanska-Alison_Riske,1,F-IO,22,5,3,0,2,13,9
20150313-W-Indian_Wells-R64-Agnieszka_Radwanska-Alison_Riske,1,F-II,1,1,1,0,0,1,0
20150313-W-Indian_Wells-R64-Agnieszka_Radwanska-Alison_Riske,1,B-XC,19,5,2,1,2,11,8
20150313-W-Indian_Wells-R64-Agnieszka_Radwanska-Alison_Riske,1,B-DTM,27,2,1,0,1,18,9
20150313-W-Indian_Wells-R64-Agnieszka_Radwanska-Alison_Riske,1,B-DTL,5,3,0,0,3,0,5
20150313-W-Indian_Wells-R64-Agnieszka_Radwanska-Alison_Riske,1,B-IO,9,1,0,0,1,8,1
20150313-W-Indian_Wells-R64-Agnieszka_Radwanska-Alison_Riske,1,S-XC,3,0,0,0,0,1,2
20150313-W-Indian_Wells-R64-Agnieszka_Radwanska-Alison_Riske,1,S-DTM,4,0,0,0,0,4,0
20150313-W-Indian_Wells-R64-Agnieszka_Radwanska-Alison_Riske,1,S-DTL,1,0,0,0,0,1,0
20150313-W-Indian_Wells-R64-Agnieszka_Radwanska-Alison_Riske,1,S-IO,1,0,0,0,0,0,1
20150313-W-Indian_Wells-R64-Agnieszka_Radwanska-Alison_Riske,2,F-XC,25,8,2,2,4,8,17
20150313-W-Indian_Wells-R64-Agnieszka_Radwanska-Alison_Riske,2,F-DTM,31,4,0,0,4,9,22
20150313-W-Indian_Wells-R64-Agnieszka_Radwanska-Alison_Riske,2,F-DTL,3,3,0,2,1,2,1
20150313-W-Indian_Wells-R64-Agnieszka_Radwanska-Alison_Riske,2,F-IO,15,5,1,2,2,10,5
20150313-W-Indian_Wells-R64-Agnieszka_Radwanska-Alison_Riske,2,B-XC,28,2,1,0,1,10,18
20150313-W-Indian_Wells-R64-Agnieszka_Radwanska-Alison_Riske,2,B-DTM,27,7,1,0,6,9,18
20150313-W-Indian_Wells-R64-Agnieszka_Radwanska-Alison_Riske,2,B-DTL,10,4,1,1,2,5,5
20150313-W-Indian_Wells-R64-Agnieszka_Radwanska-Alison_Riske,2,B-IO,5,2,0,0,2,2,3
20150313-W-Indian_Wells-R64-Agnieszka_Radwanska-Alison_Riske,2,S-XC,3,0,0,0,0,2,1
20150313-W-Indian_Wells-R64-Agnieszka_Radwanska-Alison_Riske,2,S-DTM,5,0,0,0,0,2,3
20150315-W-Indian_Wells-R32-Agnieszka_Radwanska-Heather_Watson,1,F-XC,36,9,2,2,5,18,18
20150315-W-Indian_Wells-R32-Agnieszka_Radwanska-Heather_Watson,1,F-DTM,15,1,0,0,1,7,8
20150315-W-Indian_Wells-R32-Agnieszka_Radwanska-Heather_Watson,1,F-DTL,8,2,0,0,2,3,5
20150315-W-Indian_Wells-R32-Agnieszka_Radwanska-Heather_Watson,1,F-IO,15,4,1,2,1,10,5
20150315-W-Indian_Wells-R32-Agnieszka_Radwanska-Heather_Watson,1,F-II,2,0,0,0,0,1,1
20150315-W-Indian_Wells-R32-Agnieszka_Radwanska-Heather_Watson,1,B-XC,45,6,1,1,4,20,25
20150315-W-Indian_Wells-R32-Agnieszka_Radwanska-Heather_Watson,1,B-DTM,36,4,0,0,4,16,20
20150315-W-Indian_Wells-R32-Agnieszka_Radwanska-Heather_Watson,1,B-DTL,7,2,1,0,1,4,3
20150315-W-Indian_Wells-R32-Agnieszka_Radwanska-Heather_Watson,1,B-IO,5,1,0,1,0,3,2
20150315-W-Indian_Wells-R32-Agnieszka_Radwanska-Heather_Watson,1,S-XC,3,0,0,0,0,1,2
20150315-W-Indian_Wells-R32-Agnieszka_Radwanska-Heather_Watson,1,S-DTM,2,0,0,0,0,0,2
20150315-W-Indian_Wells-R32-Agnieszka_Radwanska-Heather_Watson,1,S-DTL,1,0,0,0,0,0,1
20150315-W-Indian_Wells-R32-Agnieszka_Radwanska-Heather_Watson,1,S-IO,1,0,0,0,0,1,0
20150315-W-Indian_Wells-R32-Agnieszka_Radwanska-Heather_Watson,2,F-XC,46,11,4,3,4,25,21
20150315-W-Indian_Wells-R32-Agnieszka_Radwanska-Heather_Watson,2,F-DTM,20,2,0,1,1,8,12
20150315-W-Indian_Wells-R32-Agnieszka_Radwanska-Heather_Watson,2,F-DTL,8,3,2,0,1,5,3
20150315-W-Indian_Wells-R32-Agnieszka_Radwanska-Heather_Watson,2,F-IO,8,4,2,1,1,6,2
20150315-W-Indian_Wells-R32-Agnieszka_Radwanska-Heather_Watson,2,B-XC,59,6,0,0,6,32,27
20150315-W-Indian_Wells-R32-Agnieszka_Radwanska-Heather_Watson,2,B-DTM,21,1,0,0,1,10,11
20150315-W-Indian_Wells-R32-Agnieszka_Radwanska-Heather_Watson,2,B-DTL,5,2,2,0,0,5,0
20150315-W-Indian_Wells-R32-Agnieszka_Radwanska-Heather_Watson,2,B-IO,4,2,0,0,2,1,3
20150315-W-Indian_Wells-R32-Agnieszka_Radwanska-Heather_Watson,2,S-XC,2,0,0,0,0,1,1
20150315-W-Indian_Wells-R32-Agnieszka_Radwanska-Heather_Watson,2,S-DTM,4,0,0,0,0,0,4
20150315-W-Indian_Wells-R32-Agnieszka_Radwanska-Heather_Watson,2,S-DTL,3,2,1,1,0,2,1
20150131-W-Australian_Open-F-Maria_Sharapova-Serena_Williams,1,F-XC,22,10,6,1,3,12,10
20150131-W-Australian_Open-F-Maria_Sharapova-Serena_Williams,1,F-DTM,23,1,0,0,1,9,14
20150131-W-Australian_Open-F-Maria_Sharapova-Serena_Williams,1,F-DTL,7,4,2,0,2,3,4
20150131-W-Australian_Open-F-Maria_Sharapova-Serena_Williams,1,F-IO,15,3,1,2,0,12,3
20150131-W-Australian_Open-F-Maria_Sharapova-Serena_Williams,1,B-XC,18,5,1,0,4,9,9
20150131-W-Australian_Open-F-Maria_Sharapova-Serena_Williams,1,B-DTM,22,2,0,0,2,10,12
20150131-W-Australian_Open-F-Maria_Sharapova-Serena_Williams,1,B-DTL,5,1,1,0,0,4,1
20150131-W-Australian_Open-F-Maria_Sharapova-Serena_Williams,1,B-IO,5,2,1,0,1,2,3
20150131-W-Australian_Open-F-Maria_Sharapova-Serena_Williams,1,S-XC,2,0,0,0,0,0,2
20150131-W-Australian_Open-F-Maria_Sharapova-Serena_Williams,1,S-DTM,1,0,0,0,0,0,1
20150131-W-Australian_Open-F-Maria_Sharapova-Serena_Williams,1,S-DTL,1,0,0,0,0,1,0
20150131-W-Australian_Open-F-Maria_Sharapova-Serena_Williams,1,S-IO,1,0,0,0,0,0,1
20150131-W-Australian_Open-F-Maria_Sharapova-Serena_Williams,2,F-XC,25,10,3,2,5,13,12
20150131-W-Australian_Open-F-Maria_Sharapova-Serena_Williams,2,F-DTM,20,4,1,1,2,9,11
20150131-W-Australian_Open-F-Maria_Sharapova-Serena_Williams,2,F-DTL,4,3,2,1,0,3,1
20150131-W-Australian_Open-F-Maria_Sharapova-Serena_Williams,2,F-IO,9,4,2,2,0,8,1
20150131-W-Australian_Open-F-Maria_Sharapova-Serena_Williams,2,B-XC,22,10,4,2,4,13,9
20150131-W-Australian_Open-F-Maria_Sharapova-Serena_Williams,2,B-DTM,25,5,0,0,5,7,18
20150131-W-Australian_Open-F-Maria_Sharapova-Serena_Williams,2,B-DTL,8,3,1,0,2,4,4
20150131-W-Australian_Open-F-Maria_Sharapova-Serena_Williams,2,B-IO,6,2,0,1,1,3,3
20150131-W-Australian_Open-F-Maria_Sharapova-Serena_Williams,2,S-XC,3,0,0,0,0,1,2
20150131-W-Australian_Open-F-Maria_Sharapova-Serena_Williams,2,S-DTM,2,0,0,0,0,2,0
20150131-W-Australian_Open-F-Maria_Sharapova-Serena_Williams,2,S-DTL,1,0,0,0,0,0,1
20150316-W-Indian_Wells-R32-Caroline_Wozniacki-Belinda_Bencic,1,F-XC,42,5,1,0,4,17,25
20150316-W-Indian_Wells-R32-Caroline_Wozniacki-Belinda_Bencic,1,F-DTM,52,3,0,0,3,29,23
20150316-W-Indian_Wells-R32-Caroline_Wozniacki-Belinda_Bencic,1,F-DTL,18,4,2,1,1,9,9
20150316-W-Indian_Wells-R32-Caroline_Wozniacki-Belinda_Bencic,1,F-IO,18,8,1,1,6,7,11
20150316-W-Indian_Wells-R32-Caroline_Wozniacki-Belinda_Bencic,1,B-XC,47,6,2,1,3,28,19
20150316-W-Indian_Wells-R32-Caroline_Wozniacki-Belinda_Bencic,1,B-DTM,57,4,0,0,4,26,31
20150316-W-Indian_Wells-R32-Caroline_Wozniacki-Belinda_Bencic,1,B-DTL,16,6,1,1,4,7,9
20150316-W-Indian_Wells-R32-Caroline_Wozniacki-Belinda_Bencic,1,B-IO,24,6,2,1,3,14,10
20150316-W-Indian_Wells-R32-Caroline_Wozniacki-Belinda_Bencic,1,S-XC,3,0,0,0,0,3,0
20150316-W-Indian_Wells-R32-Caroline_Wozniacki-Belinda_Bencic,1,S-DTM,9,1,0,0,1,1,8
20150316-W-Indian_Wells-R32-Caroline_Wozniacki-Belinda_Bencic,1,S-DTL,3,1,0,0,1,1,2
20150316-W-Indian_Wells-R32-Caroline_Wozniacki-Belinda_Bencic,1,S-IO,2,2,0,0,2,0,2
20150316-W-Indian_Wells-R32-Caroline_Wozniacki-Belinda_Bencic,2,F-XC,51,6,2,1,3,28,23
20150316-W-Indian_Wells-R32-Caroline_Wozniacki-Belinda_Bencic,2,F-DTM,57,5,1,0,4,31,26
20150316-W-Indian_Wells-R32-Caroline_Wozniacki-Belinda_Bencic,2,F-DTL,11,4,2,0,2,7,4
20150316-W-Indian_Wells-R32-Caroline_Wozniacki-Belinda_Bencic,2,F-IO,27,4,2,0,2,14,13
20150316-W-Indian_Wells-R32-Caroline_Wozniacki-Belinda_Bencic,2,B-XC,60,7,2,0,5,32,28
20150316-W-Indian_Wells-R32-Caroline_Wozniacki-Belinda_Bencic,2,B-DTM,41,5,0,0,5,15,26
20150316-W-Indian_Wells-R32-Caroline_Wozniacki-Belinda_Bencic,2,B-DTL,11,5,3,2,0,7,4
20150316-W-Indian_Wells-R32-Caroline_Wozniacki-Belinda_Bencic,2,B-IO,16,5,1,0,4,7,9
20150311-W-Indian_Wells-R128-Monica_Puig-Nicole_Gibbs,1,F-XC,28,5,0,0,5,18,10
20150311-W-Indian_Wells-R128-Monica_Puig-Nicole_Gibbs,1,F-DTM,35,2,0,0,2,19,16
20150311-W-Indian_Wells-R128-Monica_Puig-Nicole_Gibbs,1,F-DTL,6,0,0,0,0,5,1
20150311-W-Indian_Wells-R128-Monica_Puig-Nicole_Gibbs,1,F-IO,16,3,3,0,0,9,7
20150311-W-Indian_Wells-R128-Monica_Puig-Nicole_Gibbs,1,B-XC,44,7,0,2,5,23,21
20150311-W-Indian_Wells-R128-Monica_Puig-Nicole_Gibbs,1,B-DTM,53,2,0,0,2,26,27
20150311-W-Indian_Wells-R128-Monica_Puig-Nicole_Gibbs,1,B-DTL,5,2,0,0,2,2,3
20150311-W-Indian_Wells-R128-Monica_Puig-Nicole_Gibbs,1,B-IO,10,4,0,1,3,5,5
20150311-W-Indian_Wells-R128-Monica_Puig-Nicole_Gibbs,1,S-XC,5,1,0,0,1,2,3
20150311-W-Indian_Wells-R128-Monica_Puig-Nicole_Gibbs,1,S-DTM,3,0,0,0,0,1,2
20150311-W-Indian_Wells-R128-Monica_Puig-Nicole_Gibbs,1,S-DTL,1,1,0,0,1,0,1
20150311-W-Indian_Wells-R128-Monica_Puig-Nicole_Gibbs,1,S-IO,1,0,0,0,0,1,0
20150311-W-Indian_Wells-R128-Monica_Puig-Nicole_Gibbs,2,F-XC,44,14,4,1,9,17,27
20150311-W-Indian_Wells-R128-Monica_Puig-Nicole_Gibbs,2,F-DTM,31,5,0,0,5,12,19
20150311-W-Indian_Wells-R128-Monica_Puig-Nicole_Gibbs,2,F-DTL,5,0,0,0,0,2,3
20150311-W-Indian_Wells-R128-Monica_Puig-Nicole_Gibbs,2,F-IO,38,7,2,1,4,19,19
20150311-W-Indian_Wells-R128-Monica_Puig-Nicole_Gibbs,2,F-II,4,0,0,0,0,1,3
20150311-W-Indian_Wells-R128-Monica_Puig-Nicole_Gibbs,2,B-XC,37,9,1,0,8,17,20
20150311-W-Indian_Wells-R128-Monica_Puig-Nicole_Gibbs,2,B-DTM,38,5,1,0,4,19,19
20150311-W-Indian_Wells-R128-Monica_Puig-Nicole_Gibbs,2,B-DTL,2,0,0,0,0,1,1
20150311-W-Indian_Wells-R128-Monica_Puig-Nicole_Gibbs,2,B-IO,5,1,0,0,1,3,2
20150311-W-Indian_Wells-R128-Monica_Puig-Nicole_Gibbs,2,S-XC,7,1,0,0,1,2,5
20150311-W-Indian_Wells-R128-Monica_Puig-Nicole_Gibbs,2,S-DTM,5,1,0,0,1,1,4
20150314-W-Indian_Wells-R64-Kirsten_Flipkens-Victoria_Azarenka,1,F-XC,28,11,2,1,8,8,20
20150314-W-Indian_Wells-R64-Kirsten_Flipkens-Victoria_Azarenka,1,F-DTM,12,2,1,0,1,3,9
20150314-W-Indian_Wells-R64-Kirsten_Flipkens-Victoria_Azarenka,1,F-DTL,10,6,2,1,3,4,6
20150314-W-Indian_Wells-R64-Kirsten_Flipkens-Victoria_Azarenka,1,F-IO,12,3,0,0,3,3,9
20150314-W-Indian_Wells-R64-Kirsten_Flipkens-Victoria_Azarenka,1,B-XC,9,3,0,0,3,1,8
20150314-W-Indian_Wells-R64-Kirsten_Flipkens-Victoria_Azarenka,1,B-DTM,6,1,0,0,1,3,3
20150314-W-Indian_Wells-R64-Kirsten_Flipkens-Victoria_Azarenka,1,B-DTL,6,2,1,1,0,2,4
20150314-W-Indian_Wells-R64-Kirsten_Flipkens-Victoria_Azarenka,1,B-IO,2,2,0,0,2,0,2
20150314-W-Indian_Wells-R64-Kirsten_Flipkens-Victoria_Azarenka,1,S-XC,11,1,0,0,1,4,7
20150314-W-Indian_Wells-R64-Kirsten_Flipkens-Victoria_Azarenka,1,S-DTM,17,0,0,0,0,5,12
20150314-W-Indian_Wells-R64-Kirsten_Flipkens-Victoria_Azarenka,1,S-DTL,9,0,0,0,0,3,6
20150314-W-Indian_Wells-R64-Kirsten_Flipkens-Victoria_Azarenka,1,S-IO,2,0,0,0,0,1,1
20150314-W-Indian_Wells-R64-Kirsten_Flipkens-Victoria_Azarenka,2,F-XC,27,7,3,1,3,19,8
20150314-W-Indian_Wells-R64-Kirsten_Flipkens-Victoria_Azarenka,2,F-DTM,7,0,0,0,0,5,2
20150314-W-Indian_Wells-R64-Kirsten_Flipkens-Victoria_Azarenka,2,F-DTL,19,3,1,0,2,13,6
20150314-W-Indian_Wells-R64-Kirsten_Flipkens-Victoria_Azarenka,2,F-IO,19,5,1,0,4,11,8
20150314-W-Indian_Wells-R64-Kirsten_Flipkens-Victoria_Azarenka,2,B-XC,28,5,3,1,1,19,9
20150314-W-Indian_Wells-R64-Kirsten_Flipkens-Victoria_Azarenka,2,B-DTM,6,3,0,0,3,2,4
20150314-W-Indian_Wells-R64-Kirsten_Flipkens-Victoria_Azarenka,2,B-DTL,6,0,0,0,0,4,2
20150314-W-Indian_Wells-R64-Kirsten_Flipkens-Victoria_Azarenka,2,B-IO,7,5,2,1,2,5,2
20150314-W-Indian_Wells-R64-Kirsten_Flipkens-Victoria_Azarenka,2,S-XC,2,0,0,0,0,1,1
20150314-W-Indian_Wells-R64-Kirsten_Flipkens-Victoria_Azarenka,2,S-DTM,3,0,0,0,0,3,0
20150320-W-Indian_Wells-SF-Sabine_Lisicki-Jelena_Jankovic,1,F-XC,36,11,5,0,6,18,18
20150320-W-Indian_Wells-SF-Sabine_Lisicki-Jelena_Jankovic,1,F-DTM,33,6,1,0,5,17,16
20150320-W-Indian_Wells-SF-Sabine_Lisicki-Jelena_Jankovic,1,F-DTL,6,4,1,0,3,2,4
20150320-W-Indian_Wells-SF-Sabine_Lisicki-Jelena_Jankovic,1,F-IO,15,5,3,0,2,8,7
20150320-W-Indian_Wells-SF-Sabine_Lisicki-Jelena_Jankovic,1,F-II,1,0,0,0,0,1,0
20150320-W-Indian_Wells-SF-Sabine_Lisicki-Jelena_Jankovic,1,B-XC,58,12,6,0,6,26,32
20150320-W-Indian_Wells-SF-Sabine_Lisicki-Jelena_Jankovic,1,B-DTM,69,15,0,1,14,24,45
20150320-W-Indian_Wells-SF-Sabine_Lisicki-Jelena_Jankovic,1,B-DTL,12,3,1,0,2,3,9
20150320-W-Indian_Wells-SF-Sabine_Lisicki-Jelena_Jankovic,1,B-IO,10,5,2,1,2,5,5
20150320-W-Indian_Wells-SF-Sabine_Lisicki-Jelena_Jankovic,1,S-DTM,4,0,0,0,0,2,2
20150320-W-Indian_Wells-SF-Sabine_Lisicki-Jelena_Jankovic,1,S-DTL,5,0,0,0,0,1,4
20150320-W-Indian_Wells-SF-Sabine_Lisicki-Jelena_Jankovic,1,S-IO,3,0,0,0,0,0,3
20150320-W-Indian_Wells-SF-Sabine_Lisicki-Jelena_Jankovic,2,F-XC,20,2,1,0,1,13,7
20150320-W-Indian_Wells-SF-Sabine_Lisicki-Jelena_Jankovic,2,F-DTM,24,1,0,0,1,13,11
20150320-W-Indian_Wells-SF-Sabine_Lisicki-Jelena_Jankovic,2,F-DTL,29,7,1,2,4,17,12
20150320-W-Indian_Wells-SF-Sabine_Lisicki-Jelena_Jankovic,2,F-IO,37,3,0,0,3,18,19
20150320-W-Indian_Wells-SF-Sabine_Lisicki-Jelena_Jankovic,2,B-XC,42,6,3,2,1,29,13
20150320-W-Indian_Wells-SF-Sabine_Lisicki-Jelena_Jankovic,2,B-DTM,41,4,0,0,4,18,23
20150320-W-Indian_Wells-SF-Sabine_Lisicki-Jelena_Jankovic,2,B-DTL,4,1,0,1,0,4,0
20150320-W-Indian_Wells-SF-Sabine_Lisicki-Jelena_Jankovic,2,B-IO,24,10,7,0,3,13,11
20150320-W-Indian_Wells-SF-Sabine_Lisicki-Jelena_Jankovic,2,S-XC,6,0,0,0,0,2,4
20150320-W-Indian_Wells-SF-Sabine_Lisicki-Jelena_Jankovic,2,S-DTM,4,0,0,0,0,2,2
20150320-W-Indian_Wells-SF-Sabine_Lisicki-Jelena_Jankovic,2,S-IO,1,1,0,0,1,0,1
20150314-W-Indian_Wells-R64-Madison_Brengle-Flavia_Pennetta,1,F-XC,42,13,5,3,5,19,23
20150314-W-Indian_Wells-R64-Madison_Brengle-Flavia_Pennetta,1,F-DTM,37,3,0,0,3,11,26
20150314-W-Indian_Wells-R64-Madison_Brengle-Flavia_Pennetta,1,F-DTL,15,6,0,2,4,3,12
20150314-W-Indian_Wells-R64-Madison_Brengle-Flavia_Pennetta,1,F-IO,29,8,3,1,4,12,17
20150314-W-Indian_Wells-R64-Madison_Brengle-Flavia_Pennetta,1,B-XC,36,5,3,0,2,14,22
20150314-W-Indian_Wells-R64-Madison_Brengle-Flavia_Pennetta,1,B-DTM,34,2,0,0,2,13,21
20150314-W-Indian_Wells-R64-Madison_Brengle-Flavia_Pennetta,1,B-DTL,6,4,2,0,2,2,4
20150314-W-Indian_Wells-R64-Madison_Brengle-Flavia_Pennetta,1,B-IO,11,5,2,0,3,4,7
20150314-W-Indian_Wells-R64-Madison_Brengle-Flavia_Pennetta,1,S-XC,3,0,0,0,0,1,2
20150314-W-Indian_Wells-R64-Madison_Brengle-Flavia_Pennetta,1,S-DTM,6,0,0,0,0,3,3
20150314-W-Indian_Wells-R64-Madison_Brengle-Flavia_Pennetta,2,F-XC,41,5,2,1,2,30,11
20150314-W-Indian_Wells-R64-Madison_Brengle-Flavia_Pennetta,2,F-DTM,42,2,0,1,1,26,16
20150314-W-Indian_Wells-R64-Madison_Brengle-Flavia_Pennetta,2,F-DTL,7,2,1,0,1,6,1
20150314-W-Indian_Wells-R64-Madison_Brengle-Flavia_Pennetta,2,F-IO,13,7,7,0,0,10,3
20150314-W-Indian_Wells-R64-Madison_Brengle-Flavia_Pennetta,2,F-II,1,0,0,0,0,1,0
20150314-W-Indian_Wells-R64-Madison_Brengle-Flavia_Pennetta,2,B-XC,37,7,2,1,4,23,14
20150314-W-Indian_Wells-R64-Madison_Brengle-Flavia_Pennetta,2,B-DTM,51,9,0,1,8,28,23
20150314-W-Indian_Wells-R64-Madison_Brengle-Flavia_Pennetta,2,B-DTL,8,4,1,2,1,7,1
20150314-W-Indian_Wells-R64-Madison_Brengle-Flavia_Pennetta,2,B-IO,4,1,0,0,1,3,1
20150314-W-Indian_Wells-R64-Madison_Brengle-Flavia_Pennetta,2,S-XC,1,0,0,0,0,1,0
20150314-W-Indian_Wells-R64-Madison_Brengle-Flavia_Pennetta,2,S-DTM,3,0,0,0,0,1,2
20150314-W-Indian_Wells-R64-Madison_Brengle-Flavia_Pennetta,2,S-DTL,2,0,0,0,0,1,1
20150316-W-Indian_Wells-R32-Eugenie_Bouchard-Coco_Vandeweghe,1,F-XC,16,8,3,1,4,9,7
20150316-W-Indian_Wells-R32-Eugenie_Bouchard-Coco_Vandeweghe,1,F-DTM,15,2,0,0,2,8,7
20150316-W-Indian_Wells-R32-Eugenie_Bouchard-Coco_Vandeweghe,1,F-DTL,4,1,1,0,0,3,1
20150316-W-Indian_Wells-R32-Eugenie_Bouchard-Coco_Vandeweghe,1,F-IO,7,6,4,1,1,5,2
20150316-W-Indian_Wells-R32-Eugenie_Bouchard-Coco_Vandeweghe,1,B-XC,13,7,1,1,5,6,7
20150316-W-Indian_Wells-R32-Eugenie_Bouchard-Coco_Vandeweghe,1,B-DTM,12,2,0,0,2,5,7
20150316-W-Indian_Wells-R32-Eugenie_Bouchard-Coco_Vandeweghe,1,B-IO,5,3,0,2,1,2,3
20150316-W-Indian_Wells-R32-Eugenie_Bouchard-Coco_Vandeweghe,2,F-XC,17,7,1,1,5,7,10
20150316-W-Indian_Wells-R32-Eugenie_Bouchard-Coco_Vandeweghe,2,F-DTM,13,4,0,0,4,3,10
20150316-W-Indian_Wells-R32-Eugenie_Bouchard-Coco_Vandeweghe,2,F-DTL,2,1,1,0,0,2,0
20150316-W-Indian_Wells-R32-Eugenie_Bouchard-Coco_Vandeweghe,2,F-IO,3,0,0,0,0,2,1
20150316-W-Indian_Wells-R32-Eugenie_Bouchard-Coco_Vandeweghe,2,B-XC,11,5,2,0,3,7,4
20150316-W-Indian_Wells-R32-Eugenie_Bouchard-Coco_Vandeweghe,2,B-DTM,17,4,0,0,4,6,11
20150316-W-Indian_Wells-R32-Eugenie_Bouchard-Coco_Vandeweghe,2,B-DTL,3,1,1,0,0,1,2
20150316-W-Indian_Wells-R32-Eugenie_Bouchard-Coco_Vandeweghe,2,S-DTM,1,0,0,0,0,1,0
20150316-W-Indian_Wells-R32-Eugenie_Bouchard-Coco_Vandeweghe,2,S-DTL,1,0,0,0,0,1,0
20150314-W-Indian_Wells-R64-Ana_Ivanovic-Yulia_Putintseva,1,F-XC,31,13,9,3,1,22,9
20150314-W-Indian_Wells-R64-Ana_Ivanovic-Yulia_Putintseva,1,F-DTM,20,0,0,0,0,11,9
20150314-W-Indian_Wells-R64-Ana_Ivanovic-Yulia_Putintseva,1,F-DTL,5,2,0,0,2,1,4
20150314-W-Indian_Wells-R64-Ana_Ivanovic-Yulia_Putintseva,1,F-IO,19,5,1,1,3,13,6
20150314-W-Indian_Wells-R64-Ana_Ivanovic-Yulia_Putintseva,1,F-II,7,4,2,0,2,4,3
20150314-W-Indian_Wells-R64-Ana_Ivanovic-Yulia_Putintseva,1,B-XC,17,4,2,1,1,10,7
20150314-W-Indian_Wells-R64-Ana_Ivanovic-Yulia_Putintseva,1,B-DTM,26,2,0,0,2,12,14
20150314-W-Indian_Wells-R64-Ana_Ivanovic-Yulia_Putintseva,1,B-DTL,4,1,1,0,0,3,1
20150314-W-Indian_Wells-R64-Ana_Ivanovic-Yulia_Putintseva,1,S-XC,7,1,0,0,1,2,5
20150314-W-Indian_Wells-R64-Ana_Ivanovic-Yulia_Putintseva,1,S-DTM,7,0,0,0,0,3,4
20150314-W-Indian_Wells-R64-Ana_Ivanovic-Yulia_Putintseva,1,S-DTL,4,0,0,0,0,3,1
20150314-W-Indian_Wells-R64-Ana_Ivanovic-Yulia_Putintseva,1,S-IO,2,0,0,0,0,0,2
20150314-W-Indian_Wells-R64-Ana_Ivanovic-Yulia_Putintseva,2,F-XC,23,11,2,2,7,12,11
20150314-W-Indian_Wells-R64-Ana_Ivanovic-Yulia_Putintseva,2,F-DTM,30,0,0,0,0,12,18
20150314-W-Indian_Wells-R64-Ana_Ivanovic-Yulia_Putintseva,2,F-DTL,12,2,0,0,2,5,7
20150314-W-Indian_Wells-R64-Ana_Ivanovic-Yulia_Putintseva,2,F-IO,20,5,2,0,3,9,11
20150314-W-Indian_Wells-R64-Ana_Ivanovic-Yulia_Putintseva,2,F-II,1,0,0,0,0,0,1
20150314-W-Indian_Wells-R64-Ana_Ivanovic-Yulia_Putintseva,2,B-XC,24,3,1,0,2,13,11
20150314-W-Indian_Wells-R64-Ana_Ivanovic-Yulia_Putintseva,2,B-DTM,27,4,0,0,4,10,17
20150314-W-Indian_Wells-R64-Ana_Ivanovic-Yulia_Putintseva,2,B-DTL,4,2,2,0,0,4,0
20150314-W-Indian_Wells-R64-Ana_Ivanovic-Yulia_Putintseva,2,B-IO,2,0,0,0,0,0,2
20150314-W-Indian_Wells-R64-Ana_Ivanovic-Yulia_Putintseva,2,S-XC,4,0,0,0,0,0,4
20150314-W-Indian_Wells-R64-Ana_Ivanovic-Yulia_Putintseva,2,S-DTM,5,0,0,0,0,2,3
20150314-W-Indian_Wells-R64-Ana_Ivanovic-Yulia_Putintseva,2,S-DTL,2,1,1,0,0,2,0
20150220-W-Dubai-SF-Garbine_Muguruza-Karolina_Pliskova,1,F-XC,49,13,8,0,5,30,19
20150220-W-Dubai-SF-Garbine_Muguruza-Karolina_Pliskova,1,F-DTM,58,12,0,1,11,24,34
20150220-W-Dubai-SF-Garbine_Muguruza-Karolina_Pliskova,1,F-DTL,11,4,3,0,1,8,3
20150220-W-Dubai-SF-Garbine_Muguruza-Karolina_Pliskova,1,F-IO,25,6,3,0,3,18,7
20150220-W-Dubai-SF-Garbine_Muguruza-Karolina_Pliskova,1,B-XC,40,11,4,0,7,19,21
20150220-W-Dubai-SF-Garbine_Muguruza-Karolina_Pliskova,1,B-DTM,58,6,0,0,6,26,32
20150220-W-Dubai-SF-Garbine_Muguruza-Karolina_Pliskova,1,B-DTL,8,5,4,0,1,5,3
20150220-W-Dubai-SF-Garbine_Muguruza-Karolina_Pliskova,1,B-IO,20,10,3,2,5,13,7
20150220-W-Dubai-SF-Garbine_Muguruza-Karolina_Pliskova,1,S-XC,1,0,0,0,0,1,0
20150220-W-Dubai-SF-Garbine_Muguruza-Karolina_Pliskova,1,S-DTM,1,0,0,0,0,1,0
20150220-W-Dubai-SF-Garbine_Muguruza-Karolina_Pliskova,1,S-IO,1,0,0,0,0,1,0
20150220-W-Dubai-SF-Garbine_Muguruza-Karolina_Pliskova,2,F-XC,38,14,7,1,6,18,20
20150220-W-Dubai-SF-Garbine_Muguruza-Karolina_Pliskova,2,F-DTM,58,8,0,0,8,25,33
20150220-W-Dubai-SF-Garbine_Muguruza-Karolina_Pliskova,2,F-DTL,9,2,2,0,0,6,3
20150220-W-Dubai-SF-Garbine_Muguruza-Karolina_Pliskova,2,F-IO,24,13,6,0,7,12,12
20150220-W-Dubai-SF-Garbine_Muguruza-Karolina_Pliskova,2,B-XC,31,6,2,0,4,15,16
20150220-W-Dubai-SF-Garbine_Muguruza-Karolina_Pliskova,2,B-DTM,67,10,0,1,9,29,38
20150220-W-Dubai-SF-Garbine_Muguruza-Karolina_Pliskova,2,B-DTL,8,4,1,1,2,4,4
20150220-W-Dubai-SF-Garbine_Muguruza-Karolina_Pliskova,2,B-IO,10,4,1,0,3,5,5
20150220-W-Dubai-SF-Garbine_Muguruza-Karolina_Pliskova,2,S-XC,7,0,0,0,0,3,4
20150220-W-Dubai-SF-Garbine_Muguruza-Karolina_Pliskova,2,S-DTM,7,0,0,0,0,2,5
20150317-W-Indian_Wells-R16-Timea_Bacsinszky-Elina_Svitolina,1,F-XC,51,12,3,2,7,26,25
20150317-W-Indian_Wells-R16-Timea_Bacsinszky-Elina_Svitolina,1,F-DTM,48,1,0,0,1,25,23
20150317-W-Indian_Wells-R16-Timea_Bacsinszky-Elina_Svitolina,1,F-DTL,30,5,4,0,1,18,12
20150317-W-Indian_Wells-R16-Timea_Bacsinszky-Elina_Svitolina,1,F-IO,24,6,3,0,3,12,12
20150317-W-Indian_Wells-R16-Timea_Bacsinszky-Elina_Svitolina,1,B-XC,52,13,5,2,6,32,20
20150317-W-Indian_Wells-R16-Timea_Bacsinszky-Elina_Svitolina,1,B-DTM,43,2,0,0,2,23,20
20150317-W-Indian_Wells-R16-Timea_Bacsinszky-Elina_Svitolina,1,B-DTL,16,6,1,0,5,8,8
20150317-W-Indian_Wells-R16-Timea_Bacsinszky-Elina_Svitolina,1,B-IO,26,4,0,0,4,11,15
20150317-W-Indian_Wells-R16-Timea_Bacsinszky-Elina_Svitolina,1,S-XC,8,2,1,0,1,3,5
20150317-W-Indian_Wells-R16-Timea_Bacsinszky-Elina_Svitolina,1,S-DTM,11,1,0,0,1,4,7
20150317-W-Indian_Wells-R16-Timea_Bacsinszky-Elina_Svitolina,1,S-DTL,4,0,0,0,0,3,1
20150317-W-Indian_Wells-R16-Timea_Bacsinszky-Elina_Svitolina,1,S-IO,1,0,0,0,0,0,1
20150317-W-Indian_Wells-R16-Timea_Bacsinszky-Elina_Svitolina,2,F-XC,81,11,5,1,5,39,42
20150317-W-Indian_Wells-R16-Timea_Bacsinszky-Elina_Svitolina,2,F-DTM,71,11,0,0,11,31,40
20150317-W-Indian_Wells-R16-Timea_Bacsinszky-Elina_Svitolina,2,F-DTL,11,5,2,0,3,3,8
20150317-W-Indian_Wells-R16-Timea_Bacsinszky-Elina_Svitolina,2,F-IO,16,4,1,0,3,8,8
20150317-W-Indian_Wells-R16-Timea_Bacsinszky-Elina_Svitolina,2,F-II,4,1,0,0,1,3,1
20150317-W-Indian_Wells-R16-Timea_Bacsinszky-Elina_Svitolina,2,B-XC,51,5,0,1,4,27,24
20150317-W-Indian_Wells-R16-Timea_Bacsinszky-Elina_Svitolina,2,B-DTM,48,4,0,0,4,22,26
20150317-W-Indian_Wells-R16-Timea_Bacsinszky-Elina_Svitolina,2,B-DTL,13,6,1,0,5,4,9
20150317-W-Indian_Wells-R16-Timea_Bacsinszky-Elina_Svitolina,2,B-IO,13,4,0,0,4,6,7
20150317-W-Indian_Wells-R16-Timea_Bacsinszky-Elina_Svitolina,2,S-XC,2,0,0,0,0,1,1
20150317-W-Indian_Wells-R16-Timea_Bacsinszky-Elina_Svitolina,2,S-DTM,14,2,0,0,2,6,8
20150317-W-Indian_Wells-R16-Timea_Bacsinszky-Elina_Svitolina,2,S-DTL,2,0,0,0,0,1,1
20150328-W-Miami-R32-Paula_Badosa-Karolina_Pliskova,1,F-XC,13,4,0,0,4,4,9
20150328-W-Miami-R32-Paula_Badosa-Karolina_Pliskova,1,F-DTM,17,1,0,0,1,5,12
20150328-W-Miami-R32-Paula_Badosa-Karolina_Pliskova,1,F-DTL,8,0,0,0,0,1,7
20150328-W-Miami-R32-Paula_Badosa-Karolina_Pliskova,1,F-IO,14,7,2,0,5,4,10
20150328-W-Miami-R32-Paula_Badosa-Karolina_Pliskova,1,B-XC,21,8,2,1,5,9,12
20150328-W-Miami-R32-Paula_Badosa-Karolina_Pliskova,1,B-DTM,19,2,0,1,1,7,12
20150328-W-Miami-R32-Paula_Badosa-Karolina_Pliskova,1,B-DTL,4,0,0,0,0,2,2
20150328-W-Miami-R32-Paula_Badosa-Karolina_Pliskova,1,B-IO,3,2,1,0,1,1,2
20150328-W-Miami-R32-Paula_Badosa-Karolina_Pliskova,1,S-XC,2,0,0,0,0,1,1
20150328-W-Miami-R32-Paula_Badosa-Karolina_Pliskova,1,S-DTM,2,0,0,0,0,0,2
20150328-W-Miami-R32-Paula_Badosa-Karolina_Pliskova,2,F-XC,22,10,5,0,5,15,7
20150328-W-Miami-R32-Paula_Badosa-Karolina_Pliskova,2,F-DTM,16,2,1,0,1,11,5
20150328-W-Miami-R32-Paula_Badosa-Karolina_Pliskova,2,F-DTL,3,2,1,0,1,1,2
20150328-W-Miami-R32-Paula_Badosa-Karolina_Pliskova,2,F-IO,13,7,5,1,1,10,3
20150328-W-Miami-R32-Paula_Badosa-Karolina_Pliskova,2,B-XC,26,6,1,2,3,15,11
20150328-W-Miami-R32-Paula_Badosa-Karolina_Pliskova,2,B-DTM,17,3,0,2,1,10,7
20150328-W-Miami-R32-Paula_Badosa-Karolina_Pliskova,2,B-DTL,7,4,3,0,1,6,1
20150328-W-Miami-R32-Paula_Badosa-Karolina_Pliskova,2,B-IO,4,3,3,0,0,4,0
20150328-W-Miami-R32-Paula_Badosa-Karolina_Pliskova,2,S-XC,1,0,0,0,0,1,0
20150330-W-Miami-R16-Agnieszka_Radwanska-Carla_Suarez_Navarro,1,F-XC,47,8,3,0,5,20,27
20150330-W-Miami-R16-Agnieszka_Radwanska-Carla_Suarez_Navarro,1,F-DTM,49,5,0,0,5,9,40
20150330-W-Miami-R16-Agnieszka_Radwanska-Carla_Suarez_Navarro,1,F-DTL,17,4,1,1,2,4,13
20150330-W-Miami-R16-Agnieszka_Radwanska-Carla_Suarez_Navarro,1,F-IO,35,7,2,3,2,19,16
20150330-W-Miami-R16-Agnieszka_Radwanska-Carla_Suarez_Navarro,1,F-II,3,1,0,0,1,2,1
20150330-W-Miami-R16-Agnieszka_Radwanska-Carla_Suarez_Navarro,1,B-XC,59,6,2,1,3,24,35
20150330-W-Miami-R16-Agnieszka_Radwanska-Carla_Suarez_Navarro,1,B-DTM,42,4,0,1,3,13,29
20150330-W-Miami-R16-Agnieszka_Radwanska-Carla_Suarez_Navarro,1,B-DTL,13,5,1,1,3,7,6
20150330-W-Miami-R16-Agnieszka_Radwanska-Carla_Suarez_Navarro,1,B-IO,16,3,2,0,1,10,6
20150330-W-Miami-R16-Agnieszka_Radwanska-Carla_Suarez_Navarro,1,S-XC,11,1,1,0,0,4,7
20150330-W-Miami-R16-Agnieszka_Radwanska-Carla_Suarez_Navarro,1,S-DTM,6,0,0,0,0,2,4
20150330-W-Miami-R16-Agnieszka_Radwanska-Carla_Suarez_Navarro,1,S-DTL,5,2,1,0,1,3,2
20150330-W-Miami-R16-Agnieszka_Radwanska-Carla_Suarez_Navarro,1,S-IO,4,0,0,0,0,0,4
20150330-W-Miami-R16-Agnieszka_Radwanska-Carla_Suarez_Navarro,2,F-XC,70,8,3,0,5,49,21
20150330-W-Miami-R16-Agnieszka_Radwanska-Carla_Suarez_Navarro,2,F-DTM,35,4,0,0,4,20,15
20150330-W-Miami-R16-Agnieszka_Radwanska-Carla_Suarez_Navarro,2,F-DTL,17,8,4,0,4,11,6
20150330-W-Miami-R16-Agnieszka_Radwanska-Carla_Suarez_Navarro,2,F-IO,22,7,5,1,1,14,8
20150330-W-Miami-R16-Agnieszka_Radwanska-Carla_Suarez_Navarro,2,F-II,3,3,3,0,0,3,0
20150330-W-Miami-R16-Agnieszka_Radwanska-Carla_Suarez_Navarro,2,B-XC,56,9,5,1,3,40,16
20150330-W-Miami-R16-Agnieszka_Radwanska-Carla_Suarez_Navarro,2,B-DTM,42,4,0,0,4,24,18
20150330-W-Miami-R16-Agnieszka_Radwanska-Carla_Suarez_Navarro,2,B-DTL,13,7,4,1,2,7,6
20150330-W-Miami-R16-Agnieszka_Radwanska-Carla_Suarez_Navarro,2,B-IO,4,4,2,1,1,3,1
20150330-W-Miami-R16-Agnieszka_Radwanska-Carla_Suarez_Navarro,2,S-XC,31,2,0,2,0,16,15
20150330-W-Miami-R16-Agnieszka_Radwanska-Carla_Suarez_Navarro,2,S-DTM,16,1,1,0,0,12,4
20150330-W-Miami-R16-Agnieszka_Radwanska-Carla_Suarez_Navarro,2,S-DTL,6,1,1,0,0,3,3
20150402-W-Miami-SF-Andrea_Petkovic-Carla_Suarez_Navarro,1,F-XC,60,12,2,1,9,26,34
20150402-W-Miami-SF-Andrea_Petkovic-Carla_Suarez_Navarro,1,F-DTM,34,6,0,0,6,21,13
20150402-W-Miami-SF-Andrea_Petkovic-Carla_Suarez_Navarro,1,F-DTL,3,1,1,0,0,1,2
20150402-W-Miami-SF-Andrea_Petkovic-Carla_Suarez_Navarro,1,F-IO,14,6,2,1,3,8,6
20150402-W-Miami-SF-Andrea_Petkovic-Carla_Suarez_Navarro,1,F-II,3,1,0,0,1,1,2
20150402-W-Miami-SF-Andrea_Petkovic-Carla_Suarez_Navarro,1,B-XC,39,9,1,3,5,19,20
20150402-W-Miami-SF-Andrea_Petkovic-Carla_Suarez_Navarro,1,B-DTM,68,4,0,1,3,39,29
20150402-W-Miami-SF-Andrea_Petkovic-Carla_Suarez_Navarro,1,B-DTL,2,1,1,0,0,2,0
20150402-W-Miami-SF-Andrea_Petkovic-Carla_Suarez_Navarro,1,B-IO,2,1,0,0,1,1,1
20150402-W-Miami-SF-Andrea_Petkovic-Carla_Suarez_Navarro,1,S-XC,4,0,0,0,0,2,2
20150402-W-Miami-SF-Andrea_Petkovic-Carla_Suarez_Navarro,1,S-DTM,7,0,0,0,0,0,7
20150402-W-Miami-SF-Andrea_Petkovic-Carla_Suarez_Navarro,2,F-XC,53,13,7,3,3,34,19
20150402-W-Miami-SF-Andrea_Petkovic-Carla_Suarez_Navarro,2,F-DTM,50,3,0,0,3,22,28
20150402-W-Miami-SF-Andrea_Petkovic-Carla_Suarez_Navarro,2,F-DTL,7,3,1,0,2,3,4
20150402-W-Miami-SF-Andrea_Petkovic-Carla_Suarez_Navarro,2,F-IO,30,10,4,2,4,17,13
20150402-W-Miami-SF-Andrea_Petkovic-Carla_Suarez_Navarro,2,B-XC,28,4,0,0,4,11,17
20150402-W-Miami-SF-Andrea_Petkovic-Carla_Suarez_Navarro,2,B-DTM,36,4,0,0,4,14,22
20150402-W-Miami-SF-Andrea_Petkovic-Carla_Suarez_Navarro,2,B-DTL,1,1,0,0,1,0,1
20150402-W-Miami-SF-Andrea_Petkovic-Carla_Suarez_Navarro,2,B-IO,3,3,0,1,2,1,2
20150402-W-Miami-SF-Andrea_Petkovic-Carla_Suarez_Navarro,2,S-XC,16,0,0,0,0,9,7
20150402-W-Miami-SF-Andrea_Petkovic-Carla_Suarez_Navarro,2,S-DTM,7,1,0,0,1,3,4
20150408-W-Charleston-R32-Eugenie_Bouchard-Lauren_Davis,1,F-XC,19,10,3,1,6,6,13
20150408-W-Charleston-R32-Eugenie_Bouchard-Lauren_Davis,1,F-DTM,12,3,0,0,3,1,11
20150408-W-Charleston-R32-Eugenie_Bouchard-Lauren_Davis,1,F-DTL,10,5,0,1,4,3,7
20150408-W-Charleston-R32-Eugenie_Bouchard-Lauren_Davis,1,F-IO,18,9,3,5,1,11,7
20150408-W-Charleston-R32-Eugenie_Bouchard-Lauren_Davis,1,B-XC,19,9,1,3,5,8,11
20150408-W-Charleston-R32-Eugenie_Bouchard-Lauren_Davis,1,B-DTM,18,4,0,0,4,4,14
20150408-W-Charleston-R32-Eugenie_Bouchard-Lauren_Davis,1,B-DTL,2,1,0,0,1,1,1
20150408-W-Charleston-R32-Eugenie_Bouchard-Lauren_Davis,1,B-IO,3,0,0,0,0,1,2
20150408-W-Charleston-R32-Eugenie_Bouchard-Lauren_Davis,1,S-DTM,2,0,0,0,0,0,2
20150408-W-Charleston-R32-Eugenie_Bouchard-Lauren_Davis,2,F-XC,15,1,1,0,0,13,2
20150408-W-Charleston-R32-Eugenie_Bouchard-Lauren_Davis,2,F-DTM,27,1,0,0,1,20,7
20150408-W-Charleston-R32-Eugenie_Bouchard-Lauren_Davis,2,F-DTL,7,2,0,0,2,4,3
20150408-W-Charleston-R32-Eugenie_Bouchard-Lauren_Davis,2,F-IO,8,4,2,2,0,8,0
20150408-W-Charleston-R32-Eugenie_Bouchard-Lauren_Davis,2,B-XC,13,4,3,1,0,10,3
20150408-W-Charleston-R32-Eugenie_Bouchard-Lauren_Davis,2,B-DTM,17,2,0,1,1,9,8
20150408-W-Charleston-R32-Eugenie_Bouchard-Lauren_Davis,2,B-DTL,4,2,2,0,0,4,0
20150408-W-Charleston-R32-Eugenie_Bouchard-Lauren_Davis,2,B-IO,2,1,1,0,0,2,0
20150408-W-Charleston-R32-Eugenie_Bouchard-Lauren_Davis,2,S-XC,1,0,0,0,0,0,1
20150408-W-Charleston-R32-Eugenie_Bouchard-Lauren_Davis,2,S-DTM,6,0,0,0,0,3,3
20150408-W-Charleston-R32-Eugenie_Bouchard-Lauren_Davis,2,S-DTL,1,0,0,0,0,1,0
20150408-W-Charleston-R32-Kateryna_Bondarenko-Madison_Keys,1,F-XC,12,3,1,1,1,6,6
20150408-W-Charleston-R32-Kateryna_Bondarenko-Madison_Keys,1,F-DTM,8,2,0,0,2,1,7
20150408-W-Charleston-R32-Kateryna_Bondarenko-Madison_Keys,1,F-DTL,8,1,0,0,1,1,7
20150408-W-Charleston-R32-Kateryna_Bondarenko-Madison_Keys,1,F-IO,13,1,0,0,1,6,7
20150408-W-Charleston-R32-Kateryna_Bondarenko-Madison_Keys,1,B-XC,21,8,0,2,6,10,11
20150408-W-Charleston-R32-Kateryna_Bondarenko-Madison_Keys,1,B-DTM,8,1,0,0,1,2,6
20150408-W-Charleston-R32-Kateryna_Bondarenko-Madison_Keys,1,B-DTL,4,1,0,0,1,1,3
20150408-W-Charleston-R32-Kateryna_Bondarenko-Madison_Keys,1,B-IO,4,3,1,0,2,2,2
20150408-W-Charleston-R32-Kateryna_Bondarenko-Madison_Keys,1,S-DTM,2,0,0,0,0,0,2
20150408-W-Charleston-R32-Kateryna_Bondarenko-Madison_Keys,2,F-XC,17,8,1,2,5,10,7
20150408-W-Charleston-R32-Kateryna_Bondarenko-Madison_Keys,2,F-DTM,4,0,0,0,0,2,2
20150408-W-Charleston-R32-Kateryna_Bondarenko-Madison_Keys,2,F-DTL,2,2,2,0,0,2,0
20150408-W-Charleston-R32-Kateryna_Bondarenko-Madison_Keys,2,F-IO,4,2,1,1,0,4,0
20150408-W-Charleston-R32-Kateryna_Bondarenko-Madison_Keys,2,F-II,1,1,1,0,0,1,0
20150408-W-Charleston-R32-Kateryna_Bondarenko-Madison_Keys,2,B-XC,22,8,4,2,2,15,7
20150408-W-Charleston-R32-Kateryna_Bondarenko-Madison_Keys,2,B-DTM,18,2,0,0,2,7,11
20150408-W-Charleston-R32-Kateryna_Bondarenko-Madison_Keys,2,B-DTL,8,6,4,0,2,5,3
20150408-W-Charleston-R32-Kateryna_Bondarenko-Madison_Keys,2,B-IO,2,1,1,0,0,2,0
20150408-W-Charleston-R32-Kateryna_Bondarenko-Madison_Keys,2,S-DTM,1,0,0,0,0,1,0
20140731-W-Stanford-R16-Venus_Williams-Victoria_Azarenka,1,F-XC,34,8,5,1,2,22,12
20140731-W-Stanford-R16-Venus_Williams-Victoria_Azarenka,1,F-DTM,42,3,0,0,3,24,18
20140731-W-Stanford-R16-Venus_Williams-Victoria_Azarenka,1,F-DTL,6,4,2,0,2,4,2
20140731-W-Stanford-R16-Venus_Williams-Victoria_Azarenka,1,F-IO,17,10,3,0,7,8,9
20140731-W-Stanford-R16-Venus_Williams-Victoria_Azarenka,1,B-XC,42,7,1,2,4,25,17
20140731-W-Stanford-R16-Venus_Williams-Victoria_Azarenka,1,B-DTM,35,2,0,0,2,23,12
20140731-W-Stanford-R16-Venus_Williams-Victoria_Azarenka,1,B-DTL,7,4,2,0,2,3,4
20140731-W-Stanford-R16-Venus_Williams-Victoria_Azarenka,1,B-IO,7,4,1,0,3,3,4
20140731-W-Stanford-R16-Venus_Williams-Victoria_Azarenka,1,S-XC,3,0,0,0,0,2,1
20140731-W-Stanford-R16-Venus_Williams-Victoria_Azarenka,1,S-DTM,6,0,0,0,0,4,2
20140731-W-Stanford-R16-Venus_Williams-Victoria_Azarenka,2,F-XC,25,3,1,1,1,11,14
20140731-W-Stanford-R16-Venus_Williams-Victoria_Azarenka,2,F-DTM,25,4,0,0,4,10,15
20140731-W-Stanford-R16-Venus_Williams-Victoria_Azarenka,2,F-DTL,10,2,1,0,1,5,5
20140731-W-Stanford-R16-Venus_Williams-Victoria_Azarenka,2,F-IO,32,12,1,0,11,10,22
20140731-W-Stanford-R16-Venus_Williams-Victoria_Azarenka,2,B-XC,18,3,1,0,2,7,11
20140731-W-Stanford-R16-Venus_Williams-Victoria_Azarenka,2,B-DTM,44,6,0,0,6,16,28
20140731-W-Stanford-R16-Venus_Williams-Victoria_Azarenka,2,B-DTL,11,5,1,2,2,5,6
20140731-W-Stanford-R16-Venus_Williams-Victoria_Azarenka,2,B-IO,21,12,5,1,6,8,13
20140731-W-Stanford-R16-Venus_Williams-Victoria_Azarenka,2,S-XC,2,0,0,0,0,1,1
20140731-W-Stanford-R16-Venus_Williams-Victoria_Azarenka,2,S-DTM,6,1,0,0,1,1,5
20140731-W-Stanford-R16-Venus_Williams-Victoria_Azarenka,2,S-DTL,2,0,0,0,0,0,2
20150404-W-Miami-F-Serena_Williams-Carla_Suarez_Navarro,1,F-XC,26,14,10,1,3,21,5
20150404-W-Miami-F-Serena_Williams-Carla_Suarez_Navarro,1,F-DTM,6,2,0,0,2,3,3
20150404-W-Miami-F-Serena_Williams-Carla_Suarez_Navarro,1,F-DTL,2,1,0,0,1,1,1
20150404-W-Miami-F-Serena_Williams-Carla_Suarez_Navarro,1,F-IO,12,4,1,0,3,9,3
20150404-W-Miami-F-Serena_Williams-Carla_Suarez_Navarro,1,B-XC,27,6,4,0,2,20,7
20150404-W-Miami-F-Serena_Williams-Carla_Suarez_Navarro,1,B-DTM,16,3,1,0,2,6,10
20150404-W-Miami-F-Serena_Williams-Carla_Suarez_Navarro,1,B-DTL,3,1,0,1,0,3,0
20150404-W-Miami-F-Serena_Williams-Carla_Suarez_Navarro,1,B-IO,5,0,0,0,0,2,3
20150404-W-Miami-F-Serena_Williams-Carla_Suarez_Navarro,1,S-XC,1,0,0,0,0,1,0
20150404-W-Miami-F-Serena_Williams-Carla_Suarez_Navarro,1,S-DTM,1,0,0,0,0,1,0
20150404-W-Miami-F-Serena_Williams-Carla_Suarez_Navarro,1,S-DTL,1,0,0,0,0,1,0
20150404-W-Miami-F-Serena_Williams-Carla_Suarez_Navarro,1,S-IO,2,1,0,0,1,0,2
20150404-W-Miami-F-Serena_Williams-Carla_Suarez_Navarro,2,F-XC,17,5,2,0,3,6,11
20150404-W-Miami-F-Serena_Williams-Carla_Suarez_Navarro,2,F-DTM,17,1,0,0,1,3,14
20150404-W-Miami-F-Serena_Williams-Carla_Suarez_Navarro,2,F-DTL,5,1,1,0,0,3,2
20150404-W-Miami-F-Serena_Williams-Carla_Suarez_Navarro,2,F-IO,5,0,0,0,0,3,2
20150404-W-Miami-F-Serena_Williams-Carla_Suarez_Navarro,2,B-XC,10,2,0,0,2,2,8
20150404-W-Miami-F-Serena_Williams-Carla_Suarez_Navarro,2,B-DTM,23,5,0,0,5,7,16
20150404-W-Miami-F-Serena_Williams-Carla_Suarez_Navarro,2,B-DTL,2,2,0,0,2,0,2
20150404-W-Miami-F-Serena_Williams-Carla_Suarez_Navarro,2,B-IO,2,0,0,0,0,0,2
20150404-W-Miami-F-Serena_Williams-Carla_Suarez_Navarro,2,S-XC,6,2,0,0,2,2,4
20150404-W-Miami-F-Serena_Williams-Carla_Suarez_Navarro,2,S-DTM,12,2,0,0,2,4,8
20150404-W-Miami-F-Serena_Williams-Carla_Suarez_Navarro,2,S-DTL,2,0,0,0,0,1,1
20150105-W-Brisbane-R32-Elina_Svitolina-Magdalena_Rybarikova,1,F-XC,25,6,4,0,2,16,9
20150105-W-Brisbane-R32-Elina_Svitolina-Magdalena_Rybarikova,1,F-DTM,20,3,0,0,3,8,12
20150105-W-Brisbane-R32-Elina_Svitolina-Magdalena_Rybarikova,1,F-DTL,4,1,0,0,1,1,3
20150105-W-Brisbane-R32-Elina_Svitolina-Magdalena_Rybarikova,1,F-IO,13,8,2,1,5,6,7
20150105-W-Brisbane-R32-Elina_Svitolina-Magdalena_Rybarikova,1,F-II,1,1,0,0,1,0,1
20150105-W-Brisbane-R32-Elina_Svitolina-Magdalena_Rybarikova,1,B-XC,22,3,2,0,1,8,14
20150105-W-Brisbane-R32-Elina_Svitolina-Magdalena_Rybarikova,1,B-DTM,20,2,0,0,2,15,5
20150105-W-Brisbane-R32-Elina_Svitolina-Magdalena_Rybarikova,1,B-DTL,8,3,0,0,3,2,6
20150105-W-Brisbane-R32-Elina_Svitolina-Magdalena_Rybarikova,1,B-IO,1,0,0,0,0,0,1
20150105-W-Brisbane-R32-Elina_Svitolina-Magdalena_Rybarikova,1,S-XC,4,1,0,0,1,0,4
20150105-W-Brisbane-R32-Elina_Svitolina-Magdalena_Rybarikova,1,S-DTM,2,0,0,0,0,2,0
20150105-W-Brisbane-R32-Elina_Svitolina-Magdalena_Rybarikova,2,F-XC,10,4,0,0,4,3,7
20150105-W-Brisbane-R32-Elina_Svitolina-Magdalena_Rybarikova,2,F-DTM,18,3,0,0,3,6,12
20150105-W-Brisbane-R32-Elina_Svitolina-Magdalena_Rybarikova,2,F-DTL,8,4,1,0,3,5,3
20150105-W-Brisbane-R32-Elina_Svitolina-Magdalena_Rybarikova,2,F-IO,21,6,1,0,5,11,10
20150105-W-Brisbane-R32-Elina_Svitolina-Magdalena_Rybarikova,2,B-XC,18,6,0,0,6,7,11
20150105-W-Brisbane-R32-Elina_Svitolina-Magdalena_Rybarikova,2,B-DTM,13,4,0,0,4,2,11
20150105-W-Brisbane-R32-Elina_Svitolina-Magdalena_Rybarikova,2,B-DTL,4,0,0,0,0,3,1
20150105-W-Brisbane-R32-Elina_Svitolina-Magdalena_Rybarikova,2,B-IO,3,1,0,0,1,1,2
20150105-W-Brisbane-R32-Elina_Svitolina-Magdalena_Rybarikova,2,S-XC,7,0,0,0,0,2,5
20150105-W-Brisbane-R32-Elina_Svitolina-Magdalena_Rybarikova,2,S-DTM,11,0,0,0,0,4,7
20150105-W-Brisbane-R32-Elina_Svitolina-Magdalena_Rybarikova,2,S-DTL,5,0,0,0,0,4,1
20150105-W-Brisbane-R32-Elina_Svitolina-Magdalena_Rybarikova,2,S-IO,4,2,1,0,1,2,2
20141022-W-Singapore-RR-Ana_Ivanovic-Eugenie_Bouchard,1,F-XC,21,8,4,2,2,18,3
20141022-W-Singapore-RR-Ana_Ivanovic-Eugenie_Bouchard,1,F-DTM,18,2,0,0,2,7,11
20141022-W-Singapore-RR-Ana_Ivanovic-Eugenie_Bouchard,1,F-DTL,9,5,2,0,3,5,4
20141022-W-Singapore-RR-Ana_Ivanovic-Eugenie_Bouchard,1,F-IO,11,4,2,2,0,11,0
20141022-W-Singapore-RR-Ana_Ivanovic-Eugenie_Bouchard,1,F-II,2,0,0,0,0,2,0
20141022-W-Singapore-RR-Ana_Ivanovic-Eugenie_Bouchard,1,B-XC,20,4,0,0,4,11,9
20141022-W-Singapore-RR-Ana_Ivanovic-Eugenie_Bouchard,1,B-DTM,16,3,0,0,3,6,10
20141022-W-Singapore-RR-Ana_Ivanovic-Eugenie_Bouchard,1,B-DTL,7,3,0,1,2,3,4
20141022-W-Singapore-RR-Ana_Ivanovic-Eugenie_Bouchard,1,B-IO,5,4,2,0,2,2,3
20141022-W-Singapore-RR-Ana_Ivanovic-Eugenie_Bouchard,1,S-XC,4,0,0,0,0,3,1
20141022-W-Singapore-RR-Ana_Ivanovic-Eugenie_Bouchard,1,S-DTM,9,0,0,0,0,4,5
20141022-W-Singapore-RR-Ana_Ivanovic-Eugenie_Bouchard,1,S-DTL,6,0,0,0,0,3,3
20141022-W-Singapore-RR-Ana_Ivanovic-Eugenie_Bouchard,1,S-IO,1,0,0,0,0,1,0
20141022-W-Singapore-RR-Ana_Ivanovic-Eugenie_Bouchard,2,F-XC,26,11,4,1,6,12,14
20141022-W-Singapore-RR-Ana_Ivanovic-Eugenie_Bouchard,2,F-DTM,13,2,1,0,1,3,10
20141022-W-Singapore-RR-Ana_Ivanovic-Eugenie_Bouchard,2,F-DTL,6,1,0,0,1,4,2
20141022-W-Singapore-RR-Ana_Ivanovic-Eugenie_Bouchard,2,F-IO,20,8,4,1,3,13,7
20141022-W-Singapore-RR-Ana_Ivanovic-Eugenie_Bouchard,2,B-XC,43,11,0,1,10,15,28
20141022-W-Singapore-RR-Ana_Ivanovic-Eugenie_Bouchard,2,B-DTM,10,2,0,0,2,3,7
20141022-W-Singapore-RR-Ana_Ivanovic-Eugenie_Bouchard,2,B-DTL,5,3,1,0,2,1,4
20141022-W-Singapore-RR-Ana_Ivanovic-Eugenie_Bouchard,2,B-IO,1,0,0,0,0,0,1
20141022-W-Singapore-RR-Ana_Ivanovic-Eugenie_Bouchard,2,S-XC,1,0,0,0,0,0,1
20141022-W-Singapore-RR-Ana_Ivanovic-Eugenie_Bouchard,2,S-DTM,2,0,0,0,0,0,2
20140422-W-Stuttgart-R32-Maria_Sharapova-Lucie_Safarova,1,F-XC,54,11,4,1,6,37,17
20140422-W-Stuttgart-R32-Maria_Sharapova-Lucie_Safarova,1,F-DTM,26,5,0,0,5,9,17
20140422-W-Stuttgart-R32-Maria_Sharapova-Lucie_Safarova,1,F-DTL,11,6,3,1,2,6,5
20140422-W-Stuttgart-R32-Maria_Sharapova-Lucie_Safarova,1,F-IO,28,13,7,2,4,19,9
20140422-W-Stuttgart-R32-Maria_Sharapova-Lucie_Safarova,1,F-II,1,1,1,0,0,1,0
20140422-W-Stuttgart-R32-Maria_Sharapova-Lucie_Safarova,1,B-XC,45,14,4,0,10,24,21
20140422-W-Stuttgart-R32-Maria_Sharapova-Lucie_Safarova,1,B-DTM,38,3,1,0,2,22,16
20140422-W-Stuttgart-R32-Maria_Sharapova-Lucie_Safarova,1,B-DTL,7,4,3,0,1,5,2
20140422-W-Stuttgart-R32-Maria_Sharapova-Lucie_Safarova,1,B-IO,10,3,0,0,3,5,5
20140422-W-Stuttgart-R32-Maria_Sharapova-Lucie_Safarova,1,S-XC,4,2,0,0,2,0,4
20140422-W-Stuttgart-R32-Maria_Sharapova-Lucie_Safarova,1,S-DTM,6,1,0,0,1,3,3
20140422-W-Stuttgart-R32-Maria_Sharapova-Lucie_Safarova,1,S-DTL,2,0,0,0,0,0,2
20140422-W-Stuttgart-R32-Maria_Sharapova-Lucie_Safarova,2,F-XC,46,14,9,1,4,27,19
20140422-W-Stuttgart-R32-Maria_Sharapova-Lucie_Safarova,2,F-DTM,42,6,1,0,5,19,23
20140422-W-Stuttgart-R32-Maria_Sharapova-Lucie_Safarova,2,F-DTL,24,16,6,0,10,8,16
20140422-W-Stuttgart-R32-Maria_Sharapova-Lucie_Safarova,2,F-IO,25,15,5,1,9,9,16
20140422-W-Stuttgart-R32-Maria_Sharapova-Lucie_Safarova,2,B-XC,20,8,4,0,4,9,11
20140422-W-Stuttgart-R32-Maria_Sharapova-Lucie_Safarova,2,B-DTM,40,8,0,0,8,14,26
20140422-W-Stuttgart-R32-Maria_Sharapova-Lucie_Safarova,2,B-DTL,18,8,3,0,5,9,9
20140422-W-Stuttgart-R32-Maria_Sharapova-Lucie_Safarova,2,B-IO,10,5,1,1,3,4,6
20140422-W-Stuttgart-R32-Maria_Sharapova-Lucie_Safarova,2,S-XC,1,0,0,0,0,0,1
20140422-W-Stuttgart-R32-Maria_Sharapova-Lucie_Safarova,2,S-DTM,4,0,0,0,0,1,3
20140422-W-Stuttgart-R32-Maria_Sharapova-Lucie_Safarova,2,S-DTL,6,2,0,0,2,0,6
20150409-W-Charleston-QF-Lauren_Davis-Madison_Keys,1,F-XC,9,1,1,0,0,8,1
20150409-W-Charleston-QF-Lauren_Davis-Madison_Keys,1,F-DTM,20,0,0,0,0,9,11
20150409-W-Charleston-QF-Lauren_Davis-Madison_Keys,1,F-DTL,11,2,0,0,2,5,6
20150409-W-Charleston-QF-Lauren_Davis-Madison_Keys,1,F-IO,10,0,0,0,0,6,4
20150409-W-Charleston-QF-Lauren_Davis-Madison_Keys,1,B-XC,29,6,1,0,5,14,15
20150409-W-Charleston-QF-Lauren_Davis-Madison_Keys,1,B-DTM,25,0,0,0,0,15,10
20150409-W-Charleston-QF-Lauren_Davis-Madison_Keys,1,B-DTL,6,3,0,1,2,2,4
20150409-W-Charleston-QF-Lauren_Davis-Madison_Keys,1,B-IO,2,2,0,0,2,0,2
20150409-W-Charleston-QF-Lauren_Davis-Madison_Keys,1,S-XC,3,1,0,0,1,1,2
20150409-W-Charleston-QF-Lauren_Davis-Madison_Keys,1,S-DTM,4,0,0,0,0,1,3
20150409-W-Charleston-QF-Lauren_Davis-Madison_Keys,1,S-DTL,1,0,0,0,0,1,0
20150409-W-Charleston-QF-Lauren_Davis-Madison_Keys,2,F-XC,33,12,4,1,7,18,15
20150409-W-Charleston-QF-Lauren_Davis-Madison_Keys,2,F-DTM,7,0,0,0,0,2,5
20150409-W-Charleston-QF-Lauren_Davis-Madison_Keys,2,F-DTL,3,2,1,0,1,2,1
20150409-W-Charleston-QF-Lauren_Davis-Madison_Keys,2,F-IO,24,4,2,1,1,14,10
20150409-W-Charleston-QF-Lauren_Davis-Madison_Keys,2,F-II,2,2,1,0,1,1,1
20150409-W-Charleston-QF-Lauren_Davis-Madison_Keys,2,B-XC,40,15,6,2,7,23,17
20150409-W-Charleston-QF-Lauren_Davis-Madison_Keys,2,B-DTM,16,2,0,0,2,4,12
20150409-W-Charleston-QF-Lauren_Davis-Madison_Keys,2,B-DTL,4,4,2,0,2,2,2
20150409-W-Charleston-QF-Lauren_Davis-Madison_Keys,2,B-IO,4,1,0,0,1,1,3
20150409-W-Charleston-QF-Lauren_Davis-Madison_Keys,2,S-DTL,2,0,0,0,0,0,2
20140317-W-Miami-R32-Caroline_Wozniacki-Sloane_Stephens,1,F-XC,18,0,0,0,0,12,6
20140317-W-Miami-R32-Caroline_Wozniacki-Sloane_Stephens,1,F-DTM,18,1,0,0,1,12,6
20140317-W-Miami-R32-Caroline_Wozniacki-Sloane_Stephens,1,F-DTL,14,2,1,0,1,12,2
20140317-W-Miami-R32-Caroline_Wozniacki-Sloane_Stephens,1,F-IO,11,2,0,0,2,7,4
20140317-W-Miami-R32-Caroline_Wozniacki-Sloane_Stephens,1,B-XC,39,8,2,2,4,25,14
20140317-W-Miami-R32-Caroline_Wozniacki-Sloane_Stephens,1,B-DTM,21,1,0,1,0,17,4
20140317-W-Miami-R32-Caroline_Wozniacki-Sloane_Stephens,1,B-DTL,4,1,1,0,0,3,1
20140317-W-Miami-R32-Caroline_Wozniacki-Sloane_Stephens,1,B-IO,2,0,0,0,0,2,0
20140317-W-Miami-R32-Caroline_Wozniacki-Sloane_Stephens,1,S-DTM,1,0,0,0,0,0,1
20140317-W-Miami-R32-Caroline_Wozniacki-Sloane_Stephens,1,S-IO,1,0,0,0,0,1,0
20140317-W-Miami-R32-Caroline_Wozniacki-Sloane_Stephens,2,F-XC,29,9,1,0,8,4,25
20140317-W-Miami-R32-Caroline_Wozniacki-Sloane_Stephens,2,F-DTM,15,2,0,0,2,3,12
20140317-W-Miami-R32-Caroline_Wozniacki-Sloane_Stephens,2,F-DTL,3,0,0,0,0,1,2
20140317-W-Miami-R32-Caroline_Wozniacki-Sloane_Stephens,2,F-IO,16,7,2,0,5,4,12
20140317-W-Miami-R32-Caroline_Wozniacki-Sloane_Stephens,2,F-II,1,1,0,0,1,0,1
20140317-W-Miami-R32-Caroline_Wozniacki-Sloane_Stephens,2,B-XC,24,8,2,0,6,5,19
20140317-W-Miami-R32-Caroline_Wozniacki-Sloane_Stephens,2,B-DTM,28,8,0,1,7,8,20
20140317-W-Miami-R32-Caroline_Wozniacki-Sloane_Stephens,2,B-DTL,16,9,1,0,8,5,11
20140317-W-Miami-R32-Caroline_Wozniacki-Sloane_Stephens,2,B-IO,7,1,1,0,0,3,4
20140317-W-Miami-R32-Caroline_Wozniacki-Sloane_Stephens,2,S-XC,1,0,0,0,0,0,1
20140317-W-Miami-R32-Caroline_Wozniacki-Sloane_Stephens,2,S-DTM,4,0,0,0,0,1,3
20150422-W-Stuttgart-R32-Zarina_Diyas-Sabine_Lisicki,1,F-XC,22,4,1,2,1,12,10
20150422-W-Stuttgart-R32-Zarina_Diyas-Sabine_Lisicki,1,F-DTM,31,4,0,1,3,19,12
20150422-W-Stuttgart-R32-Zarina_Diyas-Sabine_Lisicki,1,F-DTL,7,1,0,1,0,5,2
20150422-W-Stuttgart-R32-Zarina_Diyas-Sabine_Lisicki,1,F-IO,13,0,0,0,0,8,5
20150422-W-Stuttgart-R32-Zarina_Diyas-Sabine_Lisicki,1,F-II,1,0,0,0,0,1,0
20150422-W-Stuttgart-R32-Zarina_Diyas-Sabine_Lisicki,1,B-XC,15,2,0,0,2,7,8
20150422-W-Stuttgart-R32-Zarina_Diyas-Sabine_Lisicki,1,B-DTM,24,3,0,1,2,13,11
20150422-W-Stuttgart-R32-Zarina_Diyas-Sabine_Lisicki,1,B-DTL,1,1,1,0,0,1,0
20150422-W-Stuttgart-R32-Zarina_Diyas-Sabine_Lisicki,1,B-IO,2,0,0,0,0,0,2
20150422-W-Stuttgart-R32-Zarina_Diyas-Sabine_Lisicki,1,S-XC,1,0,0,0,0,1,0
20150422-W-Stuttgart-R32-Zarina_Diyas-Sabine_Lisicki,1,S-DTM,2,0,0,0,0,1,1
20150422-W-Stuttgart-R32-Zarina_Diyas-Sabine_Lisicki,1,S-DTL,1,1,0,0,1,0,1
20150422-W-Stuttgart-R32-Zarina_Diyas-Sabine_Lisicki,2,F-XC,28,11,1,4,6,11,17
20150422-W-Stuttgart-R32-Zarina_Diyas-Sabine_Lisicki,2,F-DTM,20,3,0,0,3,9,11
20150422-W-Stuttgart-R32-Zarina_Diyas-Sabine_Lisicki,2,F-DTL,2,1,1,0,0,2,0
20150422-W-Stuttgart-R32-Zarina_Diyas-Sabine_Lisicki,2,F-IO,12,7,3,1,3,8,4
20150422-W-Stuttgart-R32-Zarina_Diyas-Sabine_Lisicki,2,F-II,1,1,1,0,0,1,0
20150422-W-Stuttgart-R32-Zarina_Diyas-Sabine_Lisicki,2,B-XC,25,7,0,2,5,13,12
20150422-W-Stuttgart-R32-Zarina_Diyas-Sabine_Lisicki,2,B-DTM,31,8,0,0,8,9,22
20150422-W-Stuttgart-R32-Zarina_Diyas-Sabine_Lisicki,2,B-DTL,2,1,0,0,1,0,2
20150422-W-Stuttgart-R32-Zarina_Diyas-Sabine_Lisicki,2,B-IO,3,2,1,0,1,1,2
20150422-W-Stuttgart-R32-Zarina_Diyas-Sabine_Lisicki,2,S-XC,5,0,0,0,0,1,4
20150422-W-Stuttgart-R32-Zarina_Diyas-Sabine_Lisicki,2,S-DTM,5,0,0,0,0,2,3
20150422-W-Stuttgart-R32-Zarina_Diyas-Sabine_Lisicki,2,S-DTL,2,0,0,0,0,1,1
20150423-W-Stuttgart-R16-Carina_Witthoeft-Caroline_Garcia,1,F-XC,43,10,1,5,4,23,20
20150423-W-Stuttgart-R16-Carina_Witthoeft-Caroline_Garcia,1,F-DTM,25,3,0,0,3,10,15
20150423-W-Stuttgart-R16-Carina_Witthoeft-Caroline_Garcia,1,F-DTL,2,0,0,0,0,0,2
20150423-W-Stuttgart-R16-Carina_Witthoeft-Caroline_Garcia,1,F-IO,16,5,1,1,3,9,7
20150423-W-Stuttgart-R16-Carina_Witthoeft-Caroline_Garcia,1,F-II,1,0,0,0,0,1,0
20150423-W-Stuttgart-R16-Carina_Witthoeft-Caroline_Garcia,1,B-XC,47,6,0,1,5,24,23
20150423-W-Stuttgart-R16-Carina_Witthoeft-Caroline_Garcia,1,B-DTM,32,4,0,0,4,13,19
20150423-W-Stuttgart-R16-Carina_Witthoeft-Caroline_Garcia,1,B-DTL,4,3,2,0,1,3,1
20150423-W-Stuttgart-R16-Carina_Witthoeft-Caroline_Garcia,1,B-IO,1,0,0,0,0,0,1
20150423-W-Stuttgart-R16-Carina_Witthoeft-Caroline_Garcia,1,S-XC,2,0,0,0,0,1,1
20150423-W-Stuttgart-R16-Carina_Witthoeft-Caroline_Garcia,1,S-DTM,5,0,0,0,0,1,4
20150423-W-Stuttgart-R16-Carina_Witthoeft-Caroline_Garcia,2,F-XC,38,12,6,2,4,20,18
20150423-W-Stuttgart-R16-Carina_Witthoeft-Caroline_Garcia,2,F-DTM,22,5,1,0,4,13,9
20150423-W-Stuttgart-R16-Carina_Witthoeft-Caroline_Garcia,2,F-DTL,12,6,0,1,5,4,8
20150423-W-Stuttgart-R16-Carina_Witthoeft-Caroline_Garcia,2,F-IO,21,10,5,3,2,15,6
20150423-W-Stuttgart-R16-Carina_Witthoeft-Caroline_Garcia,2,B-XC,53,13,3,1,9,23,30
20150423-W-Stuttgart-R16-Carina_Witthoeft-Caroline_Garcia,2,B-DTM,31,3,1,0,2,15,16
20150423-W-Stuttgart-R16-Carina_Witthoeft-Caroline_Garcia,2,B-DTL,10,8,2,1,5,4,6
20150423-W-Stuttgart-R16-Carina_Witthoeft-Caroline_Garcia,2,B-IO,7,4,1,0,3,4,3
20150423-W-Stuttgart-R16-Carina_Witthoeft-Caroline_Garcia,2,S-DTM,3,0,0,0,0,0,3
20150327-W-Miami-R64-Jelena_Jankovic-Victoria_Azarenka,1,F-XC,31,5,0,1,4,13,18
20150327-W-Miami-R64-Jelena_Jankovic-Victoria_Azarenka,1,F-DTM,42,5,0,1,4,11,31
20150327-W-Miami-R64-Jelena_Jankovic-Victoria_Azarenka,1,F-DTL,12,2,0,1,1,6,6
20150327-W-Miami-R64-Jelena_Jankovic-Victoria_Azarenka,1,F-IO,14,5,0,3,2,8,6
20150327-W-Miami-R64-Jelena_Jankovic-Victoria_Azarenka,1,B-XC,19,7,2,0,5,8,11
20150327-W-Miami-R64-Jelena_Jankovic-Victoria_Azarenka,1,B-DTM,33,7,0,2,5,11,22
20150327-W-Miami-R64-Jelena_Jankovic-Victoria_Azarenka,1,B-DTL,7,5,0,4,1,5,2
20150327-W-Miami-R64-Jelena_Jankovic-Victoria_Azarenka,1,B-IO,9,4,3,0,1,5,4
20150327-W-Miami-R64-Jelena_Jankovic-Victoria_Azarenka,1,S-XC,2,0,0,0,0,0,2
20150327-W-Miami-R64-Jelena_Jankovic-Victoria_Azarenka,1,S-DTM,4,0,0,0,0,0,4
20150327-W-Miami-R64-Jelena_Jankovic-Victoria_Azarenka,2,F-XC,39,5,1,1,3,21,18
20150327-W-Miami-R64-Jelena_Jankovic-Victoria_Azarenka,2,F-DTM,29,3,0,0,3,14,15
20150327-W-Miami-R64-Jelena_Jankovic-Victoria_Azarenka,2,F-DTL,4,2,2,0,0,4,0
20150327-W-Miami-R64-Jelena_Jankovic-Victoria_Azarenka,2,F-IO,23,10,7,2,1,18,5
20150327-W-Miami-R64-Jelena_Jankovic-Victoria_Azarenka,2,B-XC,29,6,2,3,1,19,10
20150327-W-Miami-R64-Jelena_Jankovic-Victoria_Azarenka,2,B-DTM,28,2,0,1,1,18,10
20150327-W-Miami-R64-Jelena_Jankovic-Victoria_Azarenka,2,B-DTL,6,1,0,0,1,3,3
20150327-W-Miami-R64-Jelena_Jankovic-Victoria_Azarenka,2,B-IO,11,2,1,0,1,5,6
20150327-W-Miami-R64-Jelena_Jankovic-Victoria_Azarenka,2,S-XC,2,0,0,0,0,2,0
20150327-W-Miami-R64-Jelena_Jankovic-Victoria_Azarenka,2,S-DTL,1,0,0,0,0,1,0
20150327-W-Miami-R64-Jelena_Jankovic-Victoria_Azarenka,2,S-IO,1,1,0,0,1,0,1
20150421-W-Stuttgart-R32-Garbine_Muguruza-Barbora_Strycova,1,F-XC,49,9,1,2,6,29,20
20150421-W-Stuttgart-R32-Garbine_Muguruza-Barbora_Strycova,1,F-DTM,11,1,0,0,1,6,5
20150421-W-Stuttgart-R32-Garbine_Muguruza-Barbora_Strycova,1,F-DTL,11,6,1,0,5,2,9
20150421-W-Stuttgart-R32-Garbine_Muguruza-Barbora_Strycova,1,F-IO,2,0,0,0,0,2,0
20150421-W-Stuttgart-R32-Garbine_Muguruza-Barbora_Strycova,1,B-XC,27,5,3,1,1,18,9
20150421-W-Stuttgart-R32-Garbine_Muguruza-Barbora_Strycova,1,B-DTM,21,2,0,0,2,7,14
20150421-W-Stuttgart-R32-Garbine_Muguruza-Barbora_Strycova,1,B-DTL,12,2,2,0,0,8,4
20150421-W-Stuttgart-R32-Garbine_Muguruza-Barbora_Strycova,1,B-IO,12,3,2,0,1,8,4
20150421-W-Stuttgart-R32-Garbine_Muguruza-Barbora_Strycova,2,F-XC,42,9,0,0,9,17,25
20150421-W-Stuttgart-R32-Garbine_Muguruza-Barbora_Strycova,2,F-DTM,12,3,0,0,3,3,9
20150421-W-Stuttgart-R32-Garbine_Muguruza-Barbora_Strycova,2,F-DTL,13,2,1,0,1,4,9
20150421-W-Stuttgart-R32-Garbine_Muguruza-Barbora_Strycova,2,F-IO,6,4,0,2,2,4,2
20150421-W-Stuttgart-R32-Garbine_Muguruza-Barbora_Strycova,2,B-XC,19,0,0,0,0,13,6
20150421-W-Stuttgart-R32-Garbine_Muguruza-Barbora_Strycova,2,B-DTM,14,1,0,0,1,4,10
20150421-W-Stuttgart-R32-Garbine_Muguruza-Barbora_Strycova,2,B-DTL,3,0,0,0,0,1,2
20150421-W-Stuttgart-R32-Garbine_Muguruza-Barbora_Strycova,2,S-XC,2,0,0,0,0,1,1
20150421-W-Stuttgart-R32-Garbine_Muguruza-Barbora_Strycova,2,S-DTM,7,0,0,0,0,2,5
20150421-W-Stuttgart-R32-Caroline_Garcia-Ana_Ivanovic,1,F-XC,21,8,3,3,2,13,8
20150421-W-Stuttgart-R32-Caroline_Garcia-Ana_Ivanovic,1,F-DTM,8,1,1,0,0,3,5
20150421-W-Stuttgart-R32-Caroline_Garcia-Ana_Ivanovic,1,F-DTL,6,2,2,0,0,3,3
20150421-W-Stuttgart-R32-Caroline_Garcia-Ana_Ivanovic,1,F-IO,5,3,2,0,1,3,2
20150421-W-Stuttgart-R32-Caroline_Garcia-Ana_Ivanovic,1,F-II,1,1,1,0,0,1,0
20150421-W-Stuttgart-R32-Caroline_Garcia-Ana_Ivanovic,1,B-XC,49,13,3,2,8,25,24
20150421-W-Stuttgart-R32-Caroline_Garcia-Ana_Ivanovic,1,B-DTM,27,2,0,0,2,11,16
20150421-W-Stuttgart-R32-Caroline_Garcia-Ana_Ivanovic,1,B-DTL,8,4,2,1,1,4,4
20150421-W-Stuttgart-R32-Caroline_Garcia-Ana_Ivanovic,1,B-IO,2,2,2,0,0,2,0
20150421-W-Stuttgart-R32-Caroline_Garcia-Ana_Ivanovic,1,S-DTM,1,0,0,0,0,0,1
20150421-W-Stuttgart-R32-Caroline_Garcia-Ana_Ivanovic,2,F-XC,14,7,0,2,5,8,6
20150421-W-Stuttgart-R32-Caroline_Garcia-Ana_Ivanovic,2,F-DTM,7,0,0,0,0,2,5
20150421-W-Stuttgart-R32-Caroline_Garcia-Ana_Ivanovic,2,F-DTL,12,4,2,1,1,8,4
20150421-W-Stuttgart-R32-Caroline_Garcia-Ana_Ivanovic,2,F-IO,17,6,3,0,3,11,6
20150421-W-Stuttgart-R32-Caroline_Garcia-Ana_Ivanovic,2,F-II,2,1,1,0,0,2,0
20150421-W-Stuttgart-R32-Caroline_Garcia-Ana_Ivanovic,2,B-XC,37,10,3,1,6,18,19
20150421-W-Stuttgart-R32-Caroline_Garcia-Ana_Ivanovic,2,B-DTM,21,2,0,0,2,9,12
20150421-W-Stuttgart-R32-Caroline_Garcia-Ana_Ivanovic,2,B-DTL,12,9,2,1,6,4,8
20150421-W-Stuttgart-R32-Caroline_Garcia-Ana_Ivanovic,2,B-IO,1,0,0,0,0,0,1
20150421-W-Stuttgart-R32-Caroline_Garcia-Ana_Ivanovic,2,S-XC,2,0,0,0,0,1,1
20150421-W-Stuttgart-R32-Caroline_Garcia-Ana_Ivanovic,2,S-DTM,7,0,0,0,0,3,4
20150421-W-Stuttgart-R32-Caroline_Garcia-Ana_Ivanovic,2,S-DTL,5,1,0,1,0,1,4
20150421-W-Stuttgart-R32-Caroline_Garcia-Ana_Ivanovic,2,S-IO,1,0,0,0,0,0,1
20140929-W-Beijing-R64-Sabine_Lisicki-Shilin_Xu,1,F-XC,21,9,3,3,3,12,9
20140929-W-Beijing-R64-Sabine_Lisicki-Shilin_Xu,1,F-DTM,10,2,0,1,1,5,5
20140929-W-Beijing-R64-Sabine_Lisicki-Shilin_Xu,1,F-DTL,6,3,2,1,0,6,0
20140929-W-Beijing-R64-Sabine_Lisicki-Shilin_Xu,1,F-IO,15,7,4,0,3,8,7
20140929-W-Beijing-R64-Sabine_Lisicki-Shilin_Xu,1,B-XC,10,3,1,1,1,7,3
20140929-W-Beijing-R64-Sabine_Lisicki-Shilin_Xu,1,B-DTM,17,6,0,0,6,4,13
20140929-W-Beijing-R64-Sabine_Lisicki-Shilin_Xu,1,B-DTL,4,3,1,0,2,1,3
20140929-W-Beijing-R64-Sabine_Lisicki-Shilin_Xu,1,B-IO,3,2,0,0,2,0,3
20140929-W-Beijing-R64-Sabine_Lisicki-Shilin_Xu,1,S-DTL,1,0,0,0,0,1,0
20140929-W-Beijing-R64-Sabine_Lisicki-Shilin_Xu,2,F-XC,20,7,2,1,4,6,14
20140929-W-Beijing-R64-Sabine_Lisicki-Shilin_Xu,2,F-DTM,14,4,0,0,4,7,7
20140929-W-Beijing-R64-Sabine_Lisicki-Shilin_Xu,2,F-DTL,4,3,2,0,1,3,1
20140929-W-Beijing-R64-Sabine_Lisicki-Shilin_Xu,2,F-IO,13,10,3,1,6,5,8
20140929-W-Beijing-R64-Sabine_Lisicki-Shilin_Xu,2,B-XC,20,6,1,1,4,11,9
20140929-W-Beijing-R64-Sabine_Lisicki-Shilin_Xu,2,B-DTM,26,4,0,0,4,8,18
20140929-W-Beijing-R64-Sabine_Lisicki-Shilin_Xu,2,B-DTL,4,1,0,1,0,2,2
20140929-W-Beijing-R64-Sabine_Lisicki-Shilin_Xu,2,B-IO,2,2,1,0,1,1,1
20140929-W-Beijing-R64-Sabine_Lisicki-Shilin_Xu,2,S-XC,1,0,0,0,0,0,1
20140929-W-Beijing-R64-Sabine_Lisicki-Shilin_Xu,2,S-DTM,4,0,0,0,0,1,3
20150217-W-Dubai-R32-Sabine_Lisicki-Monica_Niculescu,1,F-XC,52,15,7,3,5,31,21
20150217-W-Dubai-R32-Sabine_Lisicki-Monica_Niculescu,1,F-DTM,35,9,2,0,7,17,18
20150217-W-Dubai-R32-Sabine_Lisicki-Monica_Niculescu,1,F-DTL,3,1,0,0,1,1,2
20150217-W-Dubai-R32-Sabine_Lisicki-Monica_Niculescu,1,F-IO,25,13,5,2,6,16,9
20150217-W-Dubai-R32-Sabine_Lisicki-Monica_Niculescu,1,F-II,1,1,0,0,1,0,1
20150217-W-Dubai-R32-Sabine_Lisicki-Monica_Niculescu,1,B-XC,37,6,4,1,1,20,17
20150217-W-Dubai-R32-Sabine_Lisicki-Monica_Niculescu,1,B-DTM,23,0,0,0,0,10,13
20150217-W-Dubai-R32-Sabine_Lisicki-Monica_Niculescu,1,B-DTL,7,3,1,0,2,4,3
20150217-W-Dubai-R32-Sabine_Lisicki-Monica_Niculescu,1,B-IO,4,2,1,0,1,2,2
20150217-W-Dubai-R32-Sabine_Lisicki-Monica_Niculescu,1,S-DTM,6,1,0,0,1,3,3
20150217-W-Dubai-R32-Sabine_Lisicki-Monica_Niculescu,2,F-XC,2,2,1,1,0,2,0
20150217-W-Dubai-R32-Sabine_Lisicki-Monica_Niculescu,2,F-DTM,2,0,0,0,0,0,2
20150217-W-Dubai-R32-Sabine_Lisicki-Monica_Niculescu,2,F-DTL,2,2,0,1,1,1,1
20150217-W-Dubai-R32-Sabine_Lisicki-Monica_Niculescu,2,F-IO,1,0,0,0,0,1,0
20150217-W-Dubai-R32-Sabine_Lisicki-Monica_Niculescu,2,B-XC,27,4,0,0,4,12,15
20150217-W-Dubai-R32-Sabine_Lisicki-Monica_Niculescu,2,B-DTM,59,4,0,0,4,28,31
20150217-W-Dubai-R32-Sabine_Lisicki-Monica_Niculescu,2,B-DTL,6,4,1,1,2,4,2
20150217-W-Dubai-R32-Sabine_Lisicki-Monica_Niculescu,2,B-IO,9,4,1,0,3,4,5
20150217-W-Dubai-R32-Sabine_Lisicki-Monica_Niculescu,2,S-XC,3,1,0,1,0,3,0
20150217-W-Dubai-R32-Sabine_Lisicki-Monica_Niculescu,2,S-DTM,2,0,0,0,0,0,2
20130826-W-US_Open-R128-Eugenie_Bouchard-Karolina_Pliskova,1,F-XC,48,16,5,3,8,33,15
20130826-W-US_Open-R128-Eugenie_Bouchard-Karolina_Pliskova,1,F-DTM,37,3,0,0,3,25,12
20130826-W-US_Open-R128-Eugenie_Bouchard-Karolina_Pliskova,1,F-DTL,19,7,1,2,4,12,7
20130826-W-US_Open-R128-Eugenie_Bouchard-Karolina_Pliskova,1,F-IO,15,4,1,0,3,5,10
20130826-W-US_Open-R128-Eugenie_Bouchard-Karolina_Pliskova,1,B-XC,39,9,3,0,6,18,21
20130826-W-US_Open-R128-Eugenie_Bouchard-Karolina_Pliskova,1,B-DTM,40,3,0,0,3,26,14
20130826-W-US_Open-R128-Eugenie_Bouchard-Karolina_Pliskova,1,B-DTL,10,6,6,0,0,6,4
20130826-W-US_Open-R128-Eugenie_Bouchard-Karolina_Pliskova,1,B-IO,6,2,1,0,1,4,2
20130826-W-US_Open-R128-Eugenie_Bouchard-Karolina_Pliskova,1,S-XC,2,1,1,0,0,1,1
20130826-W-US_Open-R128-Eugenie_Bouchard-Karolina_Pliskova,1,S-DTM,2,0,0,0,0,0,2
20130826-W-US_Open-R128-Eugenie_Bouchard-Karolina_Pliskova,2,F-XC,51,22,6,4,12,19,32
20130826-W-US_Open-R128-Eugenie_Bouchard-Karolina_Pliskova,2,F-DTM,33,8,0,0,8,12,21
20130826-W-US_Open-R128-Eugenie_Bouchard-Karolina_Pliskova,2,F-DTL,7,7,1,0,6,1,6
20130826-W-US_Open-R128-Eugenie_Bouchard-Karolina_Pliskova,2,F-IO,25,12,7,0,5,13,12
20130826-W-US_Open-R128-Eugenie_Bouchard-Karolina_Pliskova,2,B-XC,41,7,0,1,6,20,21
20130826-W-US_Open-R128-Eugenie_Bouchard-Karolina_Pliskova,2,B-DTM,38,4,0,0,4,8,30
20130826-W-US_Open-R128-Eugenie_Bouchard-Karolina_Pliskova,2,B-DTL,9,6,2,1,3,4,5
20130826-W-US_Open-R128-Eugenie_Bouchard-Karolina_Pliskova,2,B-IO,19,6,1,1,4,7,12
20130826-W-US_Open-R128-Eugenie_Bouchard-Karolina_Pliskova,2,S-XC,10,1,0,0,1,4,6
20130826-W-US_Open-R128-Eugenie_Bouchard-Karolina_Pliskova,2,S-DTM,4,0,0,0,0,2,2
20150325-W-Miami-R128-Daniela_Hantuchova-Belinda_Bencic,1,F-XC,48,18,8,1,9,23,25
20150325-W-Miami-R128-Daniela_Hantuchova-Belinda_Bencic,1,F-DTM,18,4,0,0,4,5,13
20150325-W-Miami-R128-Daniela_Hantuchova-Belinda_Bencic,1,F-DTL,10,5,3,0,2,5,5
20150325-W-Miami-R128-Daniela_Hantuchova-Belinda_Bencic,1,F-IO,21,9,3,1,5,11,10
20150325-W-Miami-R128-Daniela_Hantuchova-Belinda_Bencic,1,B-XC,36,14,4,1,9,17,19
20150325-W-Miami-R128-Daniela_Hantuchova-Belinda_Bencic,1,B-DTM,21,0,0,0,0,10,11
20150325-W-Miami-R128-Daniela_Hantuchova-Belinda_Bencic,1,B-DTL,8,6,2,2,2,6,2
20150325-W-Miami-R128-Daniela_Hantuchova-Belinda_Bencic,1,B-IO,11,6,2,0,4,5,6
20150325-W-Miami-R128-Daniela_Hantuchova-Belinda_Bencic,1,S-XC,4,0,0,0,0,1,3
20150325-W-Miami-R128-Daniela_Hantuchova-Belinda_Bencic,1,S-DTM,4,0,0,0,0,2,2
20150325-W-Miami-R128-Daniela_Hantuchova-Belinda_Bencic,2,F-XC,20,3,2,0,1,12,8
20150325-W-Miami-R128-Daniela_Hantuchova-Belinda_Bencic,2,F-DTM,23,1,1,0,0,14,9
20150325-W-Miami-R128-Daniela_Hantuchova-Belinda_Bencic,2,F-DTL,19,4,1,1,2,9,10
20150325-W-Miami-R128-Daniela_Hantuchova-Belinda_Bencic,2,F-IO,6,1,1,0,0,4,2
20150325-W-Miami-R128-Daniela_Hantuchova-Belinda_Bencic,2,B-XC,25,6,3,0,3,15,10
20150325-W-Miami-R128-Daniela_Hantuchova-Belinda_Bencic,2,B-DTM,26,2,0,0,2,15,11
20150325-W-Miami-R128-Daniela_Hantuchova-Belinda_Bencic,2,B-DTL,12,5,2,1,2,6,6
20150325-W-Miami-R128-Daniela_Hantuchova-Belinda_Bencic,2,B-IO,16,2,1,0,1,6,10
20150325-W-Miami-R128-Daniela_Hantuchova-Belinda_Bencic,2,S-DTM,1,0,0,0,0,0,1
20150325-W-Miami-R128-Daniela_Hantuchova-Belinda_Bencic,2,S-DTL,1,0,0,0,0,0,1
20140619-W-Eastbourne-QF-Ekaterina_Makarova-Angelique_Kerber,1,F-XC,27,5,1,0,4,12,15
20140619-W-Eastbourne-QF-Ekaterina_Makarova-Angelique_Kerber,1,F-DTM,12,2,0,0,2,3,9
20140619-W-Eastbourne-QF-Ekaterina_Makarova-Angelique_Kerber,1,F-DTL,25,8,1,1,6,14,11
20140619-W-Eastbourne-QF-Ekaterina_Makarova-Angelique_Kerber,1,F-IO,12,4,1,0,3,4,8
20140619-W-Eastbourne-QF-Ekaterina_Makarova-Angelique_Kerber,1,B-XC,20,3,2,0,1,10,10
20140619-W-Eastbourne-QF-Ekaterina_Makarova-Angelique_Kerber,1,B-DTM,18,2,0,0,2,6,12
20140619-W-Eastbourne-QF-Ekaterina_Makarova-Angelique_Kerber,1,B-DTL,10,3,1,0,2,5,5
20140619-W-Eastbourne-QF-Ekaterina_Makarova-Angelique_Kerber,1,B-IO,21,10,5,0,5,10,11
20140619-W-Eastbourne-QF-Ekaterina_Makarova-Angelique_Kerber,1,S-XC,1,1,0,0,1,0,1
20140619-W-Eastbourne-QF-Ekaterina_Makarova-Angelique_Kerber,1,S-DTM,7,1,0,0,1,2,5
20140619-W-Eastbourne-QF-Ekaterina_Makarova-Angelique_Kerber,1,S-DTL,5,2,0,0,2,1,4
20140619-W-Eastbourne-QF-Ekaterina_Makarova-Angelique_Kerber,1,S-IO,2,0,0,0,0,1,1
20140619-W-Eastbourne-QF-Ekaterina_Makarova-Angelique_Kerber,2,F-XC,49,10,5,2,3,25,24
20140619-W-Eastbourne-QF-Ekaterina_Makarova-Angelique_Kerber,2,F-DTM,18,3,0,0,3,8,10
20140619-W-Eastbourne-QF-Ekaterina_Makarova-Angelique_Kerber,2,F-DTL,11,7,4,0,3,8,3
20140619-W-Eastbourne-QF-Ekaterina_Makarova-Angelique_Kerber,2,F-IO,10,7,5,0,2,8,2
20140619-W-Eastbourne-QF-Ekaterina_Makarova-Angelique_Kerber,2,B-XC,23,4,2,1,1,14,9
20140619-W-Eastbourne-QF-Ekaterina_Makarova-Angelique_Kerber,2,B-DTM,30,1,0,0,1,13,17
20140619-W-Eastbourne-QF-Ekaterina_Makarova-Angelique_Kerber,2,B-DTL,3,1,0,1,0,3,0
20140619-W-Eastbourne-QF-Ekaterina_Makarova-Angelique_Kerber,2,B-IO,4,0,0,0,0,2,2
20140619-W-Eastbourne-QF-Ekaterina_Makarova-Angelique_Kerber,2,B-II,1,0,0,0,0,1,0
20140619-W-Eastbourne-QF-Ekaterina_Makarova-Angelique_Kerber,2,S-XC,5,0,0,0,0,1,4
20140619-W-Eastbourne-QF-Ekaterina_Makarova-Angelique_Kerber,2,S-DTM,7,0,0,0,0,2,5
20140619-W-Eastbourne-QF-Ekaterina_Makarova-Angelique_Kerber,2,S-DTL,2,1,0,1,0,2,0
20150427-W-Prague-Q3-Danka_Kovinic-Marketa_Vondrousova,1,F-XC,18,7,1,2,4,9,9
20150427-W-Prague-Q3-Danka_Kovinic-Marketa_Vondrousova,1,F-DTM,19,2,0,0,2,10,9
20150427-W-Prague-Q3-Danka_Kovinic-Marketa_Vondrousova,1,F-DTL,1,1,0,0,1,0,1
20150427-W-Prague-Q3-Danka_Kovinic-Marketa_Vondrousova,1,F-IO,9,6,3,1,2,5,4
20150427-W-Prague-Q3-Danka_Kovinic-Marketa_Vondrousova,1,F-II,1,0,0,0,0,1,0
20150427-W-Prague-Q3-Danka_Kovinic-Marketa_Vondrousova,1,B-XC,11,5,1,0,4,3,8
20150427-W-Prague-Q3-Danka_Kovinic-Marketa_Vondrousova,1,B-DTM,20,2,0,0,2,11,9
20150427-W-Prague-Q3-Danka_Kovinic-Marketa_Vondrousova,1,B-DTL,4,3,1,1,1,3,1
20150427-W-Prague-Q3-Danka_Kovinic-Marketa_Vondrousova,1,B-IO,1,1,1,0,0,1,0
20150427-W-Prague-Q3-Danka_Kovinic-Marketa_Vondrousova,1,S-DTM,2,1,0,0,1,0,2
20150427-W-Prague-Q3-Danka_Kovinic-Marketa_Vondrousova,1,S-DTL,1,0,0,0,0,0,1
20150427-W-Prague-Q3-Danka_Kovinic-Marketa_Vondrousova,2,F-XC,31,11,4,2,5,20,11
20150427-W-Prague-Q3-Danka_Kovinic-Marketa_Vondrousova,2,F-DTM,21,8,0,0,8,6,15
20150427-W-Prague-Q3-Danka_Kovinic-Marketa_Vondrousova,2,F-DTL,6,2,1,0,1,3,3
20150427-W-Prague-Q3-Danka_Kovinic-Marketa_Vondrousova,2,F-IO,13,7,2,2,3,8,5
20150427-W-Prague-Q3-Danka_Kovinic-Marketa_Vondrousova,2,B-XC,15,9,2,0,7,6,9
20150427-W-Prague-Q3-Danka_Kovinic-Marketa_Vondrousova,2,B-DTM,15,4,0,0,4,6,9
20150427-W-Prague-Q3-Danka_Kovinic-Marketa_Vondrousova,2,B-DTL,1,1,0,1,0,1,0
20150427-W-Prague-Q3-Danka_Kovinic-Marketa_Vondrousova,2,B-IO,2,0,0,0,0,1,1
20150427-W-Prague-Q3-Danka_Kovinic-Marketa_Vondrousova,2,S-DTM,3,0,0,0,0,1,2
20150428-W-Marrakech-R32-Daria_Kasatkina-Garbine_Muguruza,1,F-XC,31,9,1,3,5,14,17
20150428-W-Marrakech-R32-Daria_Kasatkina-Garbine_Muguruza,1,F-DTM,20,4,0,1,3,9,11
20150428-W-Marrakech-R32-Daria_Kasatkina-Garbine_Muguruza,1,F-DTL,6,2,0,0,2,4,2
20150428-W-Marrakech-R32-Daria_Kasatkina-Garbine_Muguruza,1,F-IO,15,5,1,2,2,6,9
20150428-W-Marrakech-R32-Daria_Kasatkina-Garbine_Muguruza,1,B-XC,15,2,0,0,2,7,8
20150428-W-Marrakech-R32-Daria_Kasatkina-Garbine_Muguruza,1,B-DTM,29,2,0,0,2,16,13
20150428-W-Marrakech-R32-Daria_Kasatkina-Garbine_Muguruza,1,B-DTL,2,1,0,0,1,1,1
20150428-W-Marrakech-R32-Daria_Kasatkina-Garbine_Muguruza,1,B-IO,3,0,0,0,0,2,1
20150428-W-Marrakech-R32-Daria_Kasatkina-Garbine_Muguruza,1,S-XC,3,1,0,0,1,0,3
20150428-W-Marrakech-R32-Daria_Kasatkina-Garbine_Muguruza,1,S-DTM,2,0,0,0,0,0,2
20150428-W-Marrakech-R32-Daria_Kasatkina-Garbine_Muguruza,2,F-XC,42,17,4,3,10,20,22
20150428-W-Marrakech-R32-Daria_Kasatkina-Garbine_Muguruza,2,F-DTM,15,1,0,0,1,8,7
20150428-W-Marrakech-R32-Daria_Kasatkina-Garbine_Muguruza,2,F-DTL,4,0,0,0,0,3,1
20150428-W-Marrakech-R32-Daria_Kasatkina-Garbine_Muguruza,2,F-IO,9,1,1,0,0,6,3
20150428-W-Marrakech-R32-Daria_Kasatkina-Garbine_Muguruza,2,B-XC,27,11,4,2,5,16,11
20150428-W-Marrakech-R32-Daria_Kasatkina-Garbine_Muguruza,2,B-DTM,27,1,0,0,1,13,14
20150428-W-Marrakech-R32-Daria_Kasatkina-Garbine_Muguruza,2,B-DTL,6,4,4,0,0,4,2
20150428-W-Marrakech-R32-Daria_Kasatkina-Garbine_Muguruza,2,B-IO,8,4,2,0,2,4,4
20150427-W-Prague-R32-Katerina_Siniakova-Irina_Camelia_Begu,1,F-XC,30,5,2,1,2,26,4
20150427-W-Prague-R32-Katerina_Siniakova-Irina_Camelia_Begu,1,F-DTM,21,2,0,0,2,11,10
20150427-W-Prague-R32-Katerina_Siniakova-Irina_Camelia_Begu,1,F-DTL,6,2,0,1,1,4,2
20150427-W-Prague-R32-Katerina_Siniakova-Irina_Camelia_Begu,1,F-IO,8,3,0,0,3,3,5
20150427-W-Prague-R32-Katerina_Siniakova-Irina_Camelia_Begu,1,B-XC,28,6,4,1,1,20,8
20150427-W-Prague-R32-Katerina_Siniakova-Irina_Camelia_Begu,1,B-DTM,16,1,0,0,1,10,6
20150427-W-Prague-R32-Katerina_Siniakova-Irina_Camelia_Begu,1,B-DTL,6,4,2,1,1,4,2
20150427-W-Prague-R32-Katerina_Siniakova-Irina_Camelia_Begu,1,B-IO,6,4,2,0,2,2,4
20150427-W-Prague-R32-Katerina_Siniakova-Irina_Camelia_Begu,1,S-DTM,2,0,0,0,0,1,1
20150427-W-Prague-R32-Katerina_Siniakova-Irina_Camelia_Begu,1,S-DTL,2,0,0,0,0,0,2
20150427-W-Prague-R32-Katerina_Siniakova-Irina_Camelia_Begu,2,F-XC,26,9,3,2,4,10,16
20150427-W-Prague-R32-Katerina_Siniakova-Irina_Camelia_Begu,2,F-DTM,22,3,0,0,3,6,16
20150427-W-Prague-R32-Katerina_Siniakova-Irina_Camelia_Begu,2,F-DTL,2,2,0,0,2,0,2
20150427-W-Prague-R32-Katerina_Siniakova-Irina_Camelia_Begu,2,F-IO,9,2,0,0,2,3,6
20150427-W-Prague-R32-Katerina_Siniakova-Irina_Camelia_Begu,2,B-XC,28,8,5,2,1,17,11
20150427-W-Prague-R32-Katerina_Siniakova-Irina_Camelia_Begu,2,B-DTM,21,2,0,0,2,2,19
20150427-W-Prague-R32-Katerina_Siniakova-Irina_Camelia_Begu,2,B-DTL,8,6,0,1,5,2,6
20150427-W-Prague-R32-Katerina_Siniakova-Irina_Camelia_Begu,2,B-IO,8,3,0,2,1,3,5
20150427-W-Prague-R32-Katerina_Siniakova-Irina_Camelia_Begu,2,S-XC,2,1,0,1,0,1,1
20150427-W-Prague-R32-Katerina_Siniakova-Irina_Camelia_Begu,2,S-DTM,5,0,0,0,0,2,3
20150427-W-Prague-R32-Katerina_Siniakova-Irina_Camelia_Begu,2,S-DTL,1,1,0,0,1,0,1
20150427-W-Prague-R32-Katerina_Siniakova-Irina_Camelia_Begu,2,S-IO,1,0,0,0,0,1,0
20150406-W-Charleston-R64-Silvia_Soler_Espinosa-Shelby_Rogers,1,F-XC,32,11,5,2,4,21,11
20150406-W-Charleston-R64-Silvia_Soler_Espinosa-Shelby_Rogers,1,F-DTM,29,7,0,0,7,7,22
20150406-W-Charleston-R64-Silvia_Soler_Espinosa-Shelby_Rogers,1,F-DTL,4,1,0,0,1,1,3
20150406-W-Charleston-R64-Silvia_Soler_Espinosa-Shelby_Rogers,1,F-IO,33,7,3,0,4,23,10
20150406-W-Charleston-R64-Silvia_Soler_Espinosa-Shelby_Rogers,1,F-II,5,5,3,0,2,3,2
20150406-W-Charleston-R64-Silvia_Soler_Espinosa-Shelby_Rogers,1,B-XC,8,5,0,1,4,4,4
20150406-W-Charleston-R64-Silvia_Soler_Espinosa-Shelby_Rogers,1,B-DTM,17,3,0,0,3,5,12
20150406-W-Charleston-R64-Silvia_Soler_Espinosa-Shelby_Rogers,1,B-DTL,3,2,0,1,1,1,2
20150406-W-Charleston-R64-Silvia_Soler_Espinosa-Shelby_Rogers,1,B-IO,1,0,0,0,0,0,1
20150406-W-Charleston-R64-Silvia_Soler_Espinosa-Shelby_Rogers,1,S-XC,6,0,0,0,0,2,4
20150406-W-Charleston-R64-Silvia_Soler_Espinosa-Shelby_Rogers,1,S-DTM,14,3,0,0,3,2,12
20150406-W-Charleston-R64-Silvia_Soler_Espinosa-Shelby_Rogers,1,S-DTL,1,0,0,0,0,0,1
20150406-W-Charleston-R64-Silvia_Soler_Espinosa-Shelby_Rogers,2,F-XC,25,12,8,1,3,18,7
20150406-W-Charleston-R64-Silvia_Soler_Espinosa-Shelby_Rogers,2,F-DTM,28,0,0,0,0,15,13
20150406-W-Charleston-R64-Silvia_Soler_Espinosa-Shelby_Rogers,2,F-DTL,14,6,2,1,3,6,8
20150406-W-Charleston-R64-Silvia_Soler_Espinosa-Shelby_Rogers,2,F-IO,17,3,1,1,1,11,6
20150406-W-Charleston-R64-Silvia_Soler_Espinosa-Shelby_Rogers,2,F-II,2,0,0,0,0,2,0
20150406-W-Charleston-R64-Silvia_Soler_Espinosa-Shelby_Rogers,2,B-XC,20,2,0,0,2,11,9
20150406-W-Charleston-R64-Silvia_Soler_Espinosa-Shelby_Rogers,2,B-DTM,17,0,0,0,0,7,10
20150406-W-Charleston-R64-Silvia_Soler_Espinosa-Shelby_Rogers,2,B-DTL,5,2,1,0,1,2,3
20150406-W-Charleston-R64-Silvia_Soler_Espinosa-Shelby_Rogers,2,B-IO,7,4,1,2,1,4,3
20150406-W-Charleston-R64-Silvia_Soler_Espinosa-Shelby_Rogers,2,S-XC,5,0,0,0,0,2,3
20150406-W-Charleston-R64-Silvia_Soler_Espinosa-Shelby_Rogers,2,S-DTM,4,2,0,0,2,2,2
20150406-W-Charleston-R64-Silvia_Soler_Espinosa-Shelby_Rogers,2,S-DTL,2,0,0,0,0,0,2
20150424-W-ITF_Dothan-QF-Louisa_Chirico-Jessica_Pegula,1,F-XC,48,15,2,1,12,21,27
20150424-W-ITF_Dothan-QF-Louisa_Chirico-Jessica_Pegula,1,F-DTM,42,6,0,0,6,14,28
20150424-W-ITF_Dothan-QF-Louisa_Chirico-Jessica_Pegula,1,F-DTL,12,3,1,0,2,7,5
20150424-W-ITF_Dothan-QF-Louisa_Chirico-Jessica_Pegula,1,F-IO,24,3,1,0,2,14,10
20150424-W-ITF_Dothan-QF-Louisa_Chirico-Jessica_Pegula,1,F-II,1,0,0,0,0,1,0
20150424-W-ITF_Dothan-QF-Louisa_Chirico-Jessica_Pegula,1,B-XC,45,10,2,1,7,17,28
20150424-W-ITF_Dothan-QF-Louisa_Chirico-Jessica_Pegula,1,B-DTM,55,7,0,1,6,24,31
20150424-W-ITF_Dothan-QF-Louisa_Chirico-Jessica_Pegula,1,B-DTL,7,4,1,1,2,3,4
20150424-W-ITF_Dothan-QF-Louisa_Chirico-Jessica_Pegula,1,B-IO,6,2,1,0,1,4,2
20150424-W-ITF_Dothan-QF-Louisa_Chirico-Jessica_Pegula,1,S-XC,2,0,0,0,0,0,2
20150424-W-ITF_Dothan-QF-Louisa_Chirico-Jessica_Pegula,1,S-DTM,7,1,0,0,1,2,5
20150424-W-ITF_Dothan-QF-Louisa_Chirico-Jessica_Pegula,1,S-DTL,2,0,0,0,0,0,2
20150424-W-ITF_Dothan-QF-Louisa_Chirico-Jessica_Pegula,2,F-XC,47,17,7,1,9,26,21
20150424-W-ITF_Dothan-QF-Louisa_Chirico-Jessica_Pegula,2,F-DTM,51,10,0,1,9,28,23
20150424-W-ITF_Dothan-QF-Louisa_Chirico-Jessica_Pegula,2,F-DTL,9,4,2,0,2,3,6
20150424-W-ITF_Dothan-QF-Louisa_Chirico-Jessica_Pegula,2,F-IO,44,16,5,3,8,25,19
20150424-W-ITF_Dothan-QF-Louisa_Chirico-Jessica_Pegula,2,F-II,1,0,0,0,0,1,0
20150424-W-ITF_Dothan-QF-Louisa_Chirico-Jessica_Pegula,2,B-XC,44,10,4,0,6,25,19
20150424-W-ITF_Dothan-QF-Louisa_Chirico-Jessica_Pegula,2,B-DTM,57,6,0,0,6,32,25
20150424-W-ITF_Dothan-QF-Louisa_Chirico-Jessica_Pegula,2,B-DTL,5,2,0,0,2,1,4
20150424-W-ITF_Dothan-QF-Louisa_Chirico-Jessica_Pegula,2,B-IO,7,5,2,1,2,5,2
20150424-W-ITF_Dothan-QF-Louisa_Chirico-Jessica_Pegula,2,S-XC,2,0,0,0,0,0,2
20150424-W-ITF_Dothan-QF-Louisa_Chirico-Jessica_Pegula,2,S-DTM,2,1,0,0,1,0,2
20150503-W-Madrid-R64-Maria_Sharapova-Timea_Bacsinszky,1,F-XC,30,8,4,1,3,15,15
20150503-W-Madrid-R64-Maria_Sharapova-Timea_Bacsinszky,1,F-DTM,14,0,0,0,0,11,3
20150503-W-Madrid-R64-Maria_Sharapova-Timea_Bacsinszky,1,F-DTL,4,2,1,0,1,2,2
20150503-W-Madrid-R64-Maria_Sharapova-Timea_Bacsinszky,1,F-IO,24,11,7,2,2,16,8
20150503-W-Madrid-R64-Maria_Sharapova-Timea_Bacsinszky,1,B-XC,27,8,4,1,3,14,13
20150503-W-Madrid-R64-Maria_Sharapova-Timea_Bacsinszky,1,B-DTM,25,0,0,0,0,17,8
20150503-W-Madrid-R64-Maria_Sharapova-Timea_Bacsinszky,1,B-DTL,7,4,2,1,1,4,3
20150503-W-Madrid-R64-Maria_Sharapova-Timea_Bacsinszky,1,B-IO,9,0,0,0,0,8,1
20150503-W-Madrid-R64-Maria_Sharapova-Timea_Bacsinszky,1,S-DTM,2,0,0,0,0,1,1
20150503-W-Madrid-R64-Maria_Sharapova-Timea_Bacsinszky,2,F-XC,17,4,0,3,1,8,9
20150503-W-Madrid-R64-Maria_Sharapova-Timea_Bacsinszky,2,F-DTM,16,0,0,0,0,7,9
20150503-W-Madrid-R64-Maria_Sharapova-Timea_Bacsinszky,2,F-DTL,8,1,0,0,1,3,5
20150503-W-Madrid-R64-Maria_Sharapova-Timea_Bacsinszky,2,F-IO,9,2,0,1,1,3,6
20150503-W-Madrid-R64-Maria_Sharapova-Timea_Bacsinszky,2,B-XC,23,4,0,0,4,9,14
20150503-W-Madrid-R64-Maria_Sharapova-Timea_Bacsinszky,2,B-DTM,23,3,0,1,2,4,19
20150503-W-Madrid-R64-Maria_Sharapova-Timea_Bacsinszky,2,B-DTL,9,7,6,0,1,7,2
20150503-W-Madrid-R64-Maria_Sharapova-Timea_Bacsinszky,2,B-IO,5,2,0,0,2,3,2
20150503-W-Madrid-R64-Maria_Sharapova-Timea_Bacsinszky,2,S-XC,5,0,0,0,0,1,4
20150503-W-Madrid-R64-Maria_Sharapova-Timea_Bacsinszky,2,S-DTM,4,0,0,0,0,1,3
20150503-W-Madrid-R64-Maria_Sharapova-Timea_Bacsinszky,2,S-DTL,1,0,0,0,0,1,0
20150502-W-Prague-F-Karolina_Pliskova-Lucie_Hradecka,1,F-XC,22,7,3,2,2,14,8
20150502-W-Prague-F-Karolina_Pliskova-Lucie_Hradecka,1,F-DTM,13,2,0,0,2,4,9
20150502-W-Prague-F-Karolina_Pliskova-Lucie_Hradecka,1,F-DTL,5,3,1,0,2,2,3
20150502-W-Prague-F-Karolina_Pliskova-Lucie_Hradecka,1,F-IO,15,8,4,1,3,8,7
20150502-W-Prague-F-Karolina_Pliskova-Lucie_Hradecka,1,F-II,1,1,0,0,1,0,1
20150502-W-Prague-F-Karolina_Pliskova-Lucie_Hradecka,1,B-XC,24,5,0,1,4,12,12
20150502-W-Prague-F-Karolina_Pliskova-Lucie_Hradecka,1,B-DTM,27,3,0,1,2,14,13
20150502-W-Prague-F-Karolina_Pliskova-Lucie_Hradecka,1,B-DTL,7,2,0,1,1,4,3
20150502-W-Prague-F-Karolina_Pliskova-Lucie_Hradecka,1,B-IO,6,2,1,1,0,4,2
20150502-W-Prague-F-Karolina_Pliskova-Lucie_Hradecka,1,S-XC,5,1,0,0,1,1,4
20150502-W-Prague-F-Karolina_Pliskova-Lucie_Hradecka,1,S-DTM,1,0,0,0,0,0,1
20150502-W-Prague-F-Karolina_Pliskova-Lucie_Hradecka,1,S-DTL,1,0,0,0,0,1,0
20150502-W-Prague-F-Karolina_Pliskova-Lucie_Hradecka,2,F-XC,35,19,6,3,10,21,14
20150502-W-Prague-F-Karolina_Pliskova-Lucie_Hradecka,2,F-DTM,22,4,1,0,3,9,13
20150502-W-Prague-F-Karolina_Pliskova-Lucie_Hradecka,2,F-DTL,6,3,1,0,2,1,5
20150502-W-Prague-F-Karolina_Pliskova-Lucie_Hradecka,2,F-IO,14,3,3,0,0,10,4
20150502-W-Prague-F-Karolina_Pliskova-Lucie_Hradecka,2,F-II,1,1,0,0,1,0,1
20150502-W-Prague-F-Karolina_Pliskova-Lucie_Hradecka,2,B-XC,24,7,1,1,5,12,12
20150502-W-Prague-F-Karolina_Pliskova-Lucie_Hradecka,2,B-DTM,21,2,0,0,2,10,11
20150502-W-Prague-F-Karolina_Pliskova-Lucie_Hradecka,2,B-DTL,11,8,2,3,3,6,5
20150502-W-Prague-F-Karolina_Pliskova-Lucie_Hradecka,2,B-IO,6,5,2,0,3,2,4
20150502-W-Prague-F-Karolina_Pliskova-Lucie_Hradecka,2,S-XC,3,0,0,0,0,2,1
20150502-W-Prague-F-Karolina_Pliskova-Lucie_Hradecka,2,S-DTM,1,0,0,0,0,0,1
20150508-W-Madrid-SF-Serena_Williams-Petra_Kvitova,1,F-XC,25,12,2,1,9,9,16
20150508-W-Madrid-SF-Serena_Williams-Petra_Kvitova,1,F-DTM,8,4,0,0,4,3,5
20150508-W-Madrid-SF-Serena_Williams-Petra_Kvitova,1,F-DTL,6,3,3,0,0,4,2
20150508-W-Madrid-SF-Serena_Williams-Petra_Kvitova,1,F-IO,10,5,2,1,2,7,3
20150508-W-Madrid-SF-Serena_Williams-Petra_Kvitova,1,B-XC,17,6,1,2,3,12,5
20150508-W-Madrid-SF-Serena_Williams-Petra_Kvitova,1,B-DTM,14,4,0,0,4,3,11
20150508-W-Madrid-SF-Serena_Williams-Petra_Kvitova,1,B-DTL,8,2,0,0,2,3,5
20150508-W-Madrid-SF-Serena_Williams-Petra_Kvitova,1,B-IO,4,4,2,0,2,2,2
20150508-W-Madrid-SF-Serena_Williams-Petra_Kvitova,1,S-XC,3,0,0,0,0,2,1
20150508-W-Madrid-SF-Serena_Williams-Petra_Kvitova,1,S-DTM,1,0,0,0,0,0,1
20150508-W-Madrid-SF-Serena_Williams-Petra_Kvitova,1,S-DTL,1,1,0,0,1,0,1
20150508-W-Madrid-SF-Serena_Williams-Petra_Kvitova,2,F-XC,22,3,0,0,3,10,12
20150508-W-Madrid-SF-Serena_Williams-Petra_Kvitova,2,F-DTM,9,0,0,0,0,4,5
20150508-W-Madrid-SF-Serena_Williams-Petra_Kvitova,2,F-DTL,8,5,1,0,4,1,7
20150508-W-Madrid-SF-Serena_Williams-Petra_Kvitova,2,F-IO,7,5,4,1,0,6,1
20150508-W-Madrid-SF-Serena_Williams-Petra_Kvitova,2,B-XC,12,4,3,0,1,8,4
20150508-W-Madrid-SF-Serena_Williams-Petra_Kvitova,2,B-DTM,8,1,0,0,1,3,5
20150508-W-Madrid-SF-Serena_Williams-Petra_Kvitova,2,B-DTL,4,1,0,0,1,2,2
20150508-W-Madrid-SF-Serena_Williams-Petra_Kvitova,2,B-IO,1,1,0,0,1,0,1
20150508-W-Madrid-SF-Serena_Williams-Petra_Kvitova,2,S-XC,1,0,0,0,0,0,1
20150508-W-Madrid-SF-Serena_Williams-Petra_Kvitova,2,S-DTM,4,0,0,0,0,0,4
20150503-W-ITF_Wiesbaden-F-Tereza_Martincova-Anastasija_Sevastova,1,F-XC,13,5,2,0,3,4,9
20150503-W-ITF_Wiesbaden-F-Tereza_Martincova-Anastasija_Sevastova,1,F-DTM,13,1,0,0,1,6,7
20150503-W-ITF_Wiesbaden-F-Tereza_Martincova-Anastasija_Sevastova,1,F-DTL,8,2,0,0,2,3,5
20150503-W-ITF_Wiesbaden-F-Tereza_Martincova-Anastasija_Sevastova,1,F-IO,8,2,0,0,2,2,6
20150503-W-ITF_Wiesbaden-F-Tereza_Martincova-Anastasija_Sevastova,1,F-II,1,0,0,0,0,1,0
20150503-W-ITF_Wiesbaden-F-Tereza_Martincova-Anastasija_Sevastova,1,B-XC,23,3,0,0,3,6,17
20150503-W-ITF_Wiesbaden-F-Tereza_Martincova-Anastasija_Sevastova,1,B-DTM,10,1,0,0,1,4,6
20150503-W-ITF_Wiesbaden-F-Tereza_Martincova-Anastasija_Sevastova,1,B-DTL,9,4,1,0,3,2,7
20150503-W-ITF_Wiesbaden-F-Tereza_Martincova-Anastasija_Sevastova,1,B-IO,4,0,0,0,0,3,1
20150503-W-ITF_Wiesbaden-F-Tereza_Martincova-Anastasija_Sevastova,1,S-XC,2,0,0,0,0,0,2
20150503-W-ITF_Wiesbaden-F-Tereza_Martincova-Anastasija_Sevastova,1,S-DTM,4,1,0,0,1,2,2
20150503-W-ITF_Wiesbaden-F-Tereza_Martincova-Anastasija_Sevastova,1,S-DTL,7,2,0,0,2,2,5
20150503-W-ITF_Wiesbaden-F-Tereza_Martincova-Anastasija_Sevastova,2,F-XC,31,13,2,2,9,14,17
20150503-W-ITF_Wiesbaden-F-Tereza_Martincova-Anastasija_Sevastova,2,F-DTM,8,0,0,0,0,4,4
20150503-W-ITF_Wiesbaden-F-Tereza_Martincova-Anastasija_Sevastova,2,F-DTL,5,1,1,0,0,5,0
20150503-W-ITF_Wiesbaden-F-Tereza_Martincova-Anastasija_Sevastova,2,F-IO,8,4,3,0,1,5,3
20150503-W-ITF_Wiesbaden-F-Tereza_Martincova-Anastasija_Sevastova,2,B-XC,18,5,2,0,3,10,8
20150503-W-ITF_Wiesbaden-F-Tereza_Martincova-Anastasija_Sevastova,2,B-DTM,10,1,0,0,1,4,6
20150503-W-ITF_Wiesbaden-F-Tereza_Martincova-Anastasija_Sevastova,2,B-DTL,5,2,2,0,0,4,1
20150503-W-ITF_Wiesbaden-F-Tereza_Martincova-Anastasija_Sevastova,2,B-IO,2,0,0,0,0,2,0
20150503-W-ITF_Wiesbaden-F-Tereza_Martincova-Anastasija_Sevastova,2,S-XC,5,0,0,0,0,5,0
20150503-W-ITF_Wiesbaden-F-Tereza_Martincova-Anastasija_Sevastova,2,S-DTM,5,0,0,0,0,3,2
20150503-W-ITF_Wiesbaden-F-Tereza_Martincova-Anastasija_Sevastova,2,S-DTL,1,0,0,0,0,0,1
20150503-W-ITF_Wiesbaden-F-Tereza_Martincova-Anastasija_Sevastova,2,S-IO,1,1,0,0,1,0,1
20150502-W-ITF_Charlottesville-SF-Elizaveta_Ianchuk-Allie_Kiick,1,F-XC,44,13,5,0,8,20,24
20150502-W-ITF_Charlottesville-SF-Elizaveta_Ianchuk-Allie_Kiick,1,F-DTM,14,1,0,0,1,6,8
20150502-W-ITF_Charlottesville-SF-Elizaveta_Ianchuk-Allie_Kiick,1,F-DTL,10,2,0,0,2,4,6
20150502-W-ITF_Charlottesville-SF-Elizaveta_Ianchuk-Allie_Kiick,1,F-IO,16,7,2,0,5,6,10
20150502-W-ITF_Charlottesville-SF-Elizaveta_Ianchuk-Allie_Kiick,1,B-XC,40,7,1,2,4,24,16
20150502-W-ITF_Charlottesville-SF-Elizaveta_Ianchuk-Allie_Kiick,1,B-DTM,7,3,0,0,3,3,4
20150502-W-ITF_Charlottesville-SF-Elizaveta_Ianchuk-Allie_Kiick,1,B-DTL,7,3,1,0,2,3,4
20150502-W-ITF_Charlottesville-SF-Elizaveta_Ianchuk-Allie_Kiick,1,B-IO,6,3,3,0,0,5,1
20150502-W-ITF_Charlottesville-SF-Elizaveta_Ianchuk-Allie_Kiick,1,S-XC,1,0,0,0,0,1,0
20150502-W-ITF_Charlottesville-SF-Elizaveta_Ianchuk-Allie_Kiick,1,S-DTL,1,0,0,0,0,0,1
20150502-W-ITF_Charlottesville-SF-Elizaveta_Ianchuk-Allie_Kiick,2,F-XC,34,9,2,2,5,17,17
20150502-W-ITF_Charlottesville-SF-Elizaveta_Ianchuk-Allie_Kiick,2,F-DTM,23,0,0,0,0,15,8
20150502-W-ITF_Charlottesville-SF-Elizaveta_Ianchuk-Allie_Kiick,2,F-DTL,8,2,1,0,1,4,4
20150502-W-ITF_Charlottesville-SF-Elizaveta_Ianchuk-Allie_Kiick,2,F-IO,9,2,0,0,2,2,7
20150502-W-ITF_Charlottesville-SF-Elizaveta_Ianchuk-Allie_Kiick,2,F-II,1,1,0,0,1,0,1
20150502-W-ITF_Charlottesville-SF-Elizaveta_Ianchuk-Allie_Kiick,2,B-XC,18,1,0,1,0,7,11
20150502-W-ITF_Charlottesville-SF-Elizaveta_Ianchuk-Allie_Kiick,2,B-DTM,25,1,0,0,1,12,13
20150502-W-ITF_Charlottesville-SF-Elizaveta_Ianchuk-Allie_Kiick,2,B-DTL,16,6,1,0,5,8,8
20150502-W-ITF_Charlottesville-SF-Elizaveta_Ianchuk-Allie_Kiick,2,B-IO,3,1,0,0,1,0,3
20150502-W-ITF_Charlottesville-SF-Elizaveta_Ianchuk-Allie_Kiick,2,S-XC,3,0,0,0,0,1,2
20150502-W-ITF_Charlottesville-SF-Elizaveta_Ianchuk-Allie_Kiick,2,S-DTM,6,1,0,0,1,3,3
20150527-W-Roland_Garros-R64-Vitalia_Diatchenko-Maria_Sharapova,1,F-XC,13,5,1,0,4,5,8
20150527-W-Roland_Garros-R64-Vitalia_Diatchenko-Maria_Sharapova,1,F-DTM,8,0,0,0,0,4,4
20150527-W-Roland_Garros-R64-Vitalia_Diatchenko-Maria_Sharapova,1,F-DTL,4,2,0,1,1,2,2
20150527-W-Roland_Garros-R64-Vitalia_Diatchenko-Maria_Sharapova,1,F-IO,16,8,5,2,1,10,6
20150527-W-Roland_Garros-R64-Vitalia_Diatchenko-Maria_Sharapova,1,B-XC,14,4,3,0,1,6,8
20150527-W-Roland_Garros-R64-Vitalia_Diatchenko-Maria_Sharapova,1,B-DTM,19,6,0,1,5,6,13
20150527-W-Roland_Garros-R64-Vitalia_Diatchenko-Maria_Sharapova,1,B-DTL,6,2,0,0,2,1,5
20150527-W-Roland_Garros-R64-Vitalia_Diatchenko-Maria_Sharapova,1,B-IO,9,4,1,1,2,3,6
20150527-W-Roland_Garros-R64-Vitalia_Diatchenko-Maria_Sharapova,2,F-XC,18,4,2,2,0,12,6
20150527-W-Roland_Garros-R64-Vitalia_Diatchenko-Maria_Sharapova,2,F-DTM,17,3,1,1,1,12,5
20150527-W-Roland_Garros-R64-Vitalia_Diatchenko-Maria_Sharapova,2,F-DTL,4,1,1,0,0,3,1
20150527-W-Roland_Garros-R64-Vitalia_Diatchenko-Maria_Sharapova,2,F-IO,4,3,3,0,0,4,0
20150527-W-Roland_Garros-R64-Vitalia_Diatchenko-Maria_Sharapova,2,B-XC,15,3,1,1,1,12,3
20150527-W-Roland_Garros-R64-Vitalia_Diatchenko-Maria_Sharapova,2,B-DTM,14,1,0,1,0,7,7
20150527-W-Roland_Garros-R64-Vitalia_Diatchenko-Maria_Sharapova,2,B-DTL,1,1,0,0,1,0,1
20150527-W-Roland_Garros-R64-Vitalia_Diatchenko-Maria_Sharapova,2,B-IO,1,0,0,0,0,1,0
20150527-W-Roland_Garros-R64-Vitalia_Diatchenko-Maria_Sharapova,2,S-DTM,1,0,0,0,0,0,1
20150530-W-Roland_Garros-R32-Victoria_Azarenka-Serena_Williams,1,F-XC,1,1,1,0,0,1,0
20150530-W-Roland_Garros-R32-Victoria_Azarenka-Serena_Williams,1,F-IO,1,1,1,0,0,1,0
20150530-W-Roland_Garros-R32-Victoria_Azarenka-Serena_Williams,2,F-XC,1,1,1,0,0,1,0
20150530-W-Roland_Garros-R32-Victoria_Azarenka-Serena_Williams,2,B-DTL,1,1,1,0,0,1,0
20150529-W-Roland_Garros-R32-Ana_Ivanovic-Donna_Vekic,1,F-XC,24,10,5,2,3,11,13
20150529-W-Roland_Garros-R32-Ana_Ivanovic-Donna_Vekic,1,F-DTM,9,0,0,0,0,7,2
20150529-W-Roland_Garros-R32-Ana_Ivanovic-Donna_Vekic,1,F-DTL,5,3,3,0,0,4,1
20150529-W-Roland_Garros-R32-Ana_Ivanovic-Donna_Vekic,1,F-IO,8,4,1,1,2,5,3
20150529-W-Roland_Garros-R32-Ana_Ivanovic-Donna_Vekic,1,F-II,2,1,0,0,1,1,1
20150529-W-Roland_Garros-R32-Ana_Ivanovic-Donna_Vekic,1,B-XC,11,0,0,0,0,9,2
20150529-W-Roland_Garros-R32-Ana_Ivanovic-Donna_Vekic,1,B-DTM,10,0,0,0,0,7,3
20150529-W-Roland_Garros-R32-Ana_Ivanovic-Donna_Vekic,1,B-DTL,4,3,1,1,1,3,1
20150529-W-Roland_Garros-R32-Ana_Ivanovic-Donna_Vekic,1,B-IO,1,1,0,0,1,0,1
20150529-W-Roland_Garros-R32-Ana_Ivanovic-Donna_Vekic,1,S-XC,2,0,0,0,0,1,1
20150529-W-Roland_Garros-R32-Ana_Ivanovic-Donna_Vekic,1,S-DTM,4,0,0,0,0,3,1
20150529-W-Roland_Garros-R32-Ana_Ivanovic-Donna_Vekic,1,S-DTL,2,0,0,0,0,1,1
20150529-W-Roland_Garros-R32-Ana_Ivanovic-Donna_Vekic,1,S-II,1,0,0,0,0,0,1
20150529-W-Roland_Garros-R32-Ana_Ivanovic-Donna_Vekic,2,F-XC,17,4,1,1,2,8,9
20150529-W-Roland_Garros-R32-Ana_Ivanovic-Donna_Vekic,2,F-DTM,11,1,0,0,1,4,7
20150529-W-Roland_Garros-R32-Ana_Ivanovic-Donna_Vekic,2,F-DTL,5,2,0,2,0,4,1
20150529-W-Roland_Garros-R32-Ana_Ivanovic-Donna_Vekic,2,F-IO,8,3,2,0,1,3,5
20150529-W-Roland_Garros-R32-Ana_Ivanovic-Donna_Vekic,2,B-XC,13,2,0,0,2,4,9
20150529-W-Roland_Garros-R32-Ana_Ivanovic-Donna_Vekic,2,B-DTM,16,3,0,0,3,4,12
20150529-W-Roland_Garros-R32-Ana_Ivanovic-Donna_Vekic,2,B-DTL,4,3,1,1,1,3,1
20150529-W-Roland_Garros-R32-Ana_Ivanovic-Donna_Vekic,2,S-DTM,2,0,0,0,0,0,2
20150529-W-Roland_Garros-R32-Ana_Ivanovic-Donna_Vekic,2,S-DTL,2,0,0,0,0,0,2
20150602-W-Roland_Garros-QF-Ana_Ivanovic-Elina_Svitolina,1,F-XC,34,12,5,1,6,25,9
20150602-W-Roland_Garros-QF-Ana_Ivanovic-Elina_Svitolina,1,F-DTM,20,3,0,1,2,8,12
20150602-W-Roland_Garros-QF-Ana_Ivanovic-Elina_Svitolina,1,F-DTL,7,5,2,0,3,4,3
20150602-W-Roland_Garros-QF-Ana_Ivanovic-Elina_Svitolina,1,F-IO,33,16,10,4,2,24,9
20150602-W-Roland_Garros-QF-Ana_Ivanovic-Elina_Svitolina,1,F-II,4,3,1,0,2,1,3
20150602-W-Roland_Garros-QF-Ana_Ivanovic-Elina_Svitolina,1,B-XC,31,1,0,0,1,19,12
20150602-W-Roland_Garros-QF-Ana_Ivanovic-Elina_Svitolina,1,B-DTM,15,1,0,0,1,10,5
20150602-W-Roland_Garros-QF-Ana_Ivanovic-Elina_Svitolina,1,B-DTL,8,1,1,0,0,5,3
20150602-W-Roland_Garros-QF-Ana_Ivanovic-Elina_Svitolina,1,B-IO,1,0,0,0,0,0,1
20150602-W-Roland_Garros-QF-Ana_Ivanovic-Elina_Svitolina,1,S-XC,3,0,0,0,0,2,1
20150602-W-Roland_Garros-QF-Ana_Ivanovic-Elina_Svitolina,1,S-DTM,3,0,0,0,0,2,1
20150602-W-Roland_Garros-QF-Ana_Ivanovic-Elina_Svitolina,1,S-DTL,5,2,0,0,2,2,3
20150602-W-Roland_Garros-QF-Ana_Ivanovic-Elina_Svitolina,2,F-XC,15,4,1,0,3,8,7
20150602-W-Roland_Garros-QF-Ana_Ivanovic-Elina_Svitolina,2,F-DTM,22,4,0,1,3,6,16
20150602-W-Roland_Garros-QF-Ana_Ivanovic-Elina_Svitolina,2,F-DTL,4,2,0,1,1,1,3
20150602-W-Roland_Garros-QF-Ana_Ivanovic-Elina_Svitolina,2,F-IO,10,3,0,0,3,4,6
20150602-W-Roland_Garros-QF-Ana_Ivanovic-Elina_Svitolina,2,F-II,1,0,0,0,0,1,0
20150602-W-Roland_Garros-QF-Ana_Ivanovic-Elina_Svitolina,2,B-XC,44,2,0,1,1,24,20
20150602-W-Roland_Garros-QF-Ana_Ivanovic-Elina_Svitolina,2,B-DTM,30,3,0,0,3,11,19
20150602-W-Roland_Garros-QF-Ana_Ivanovic-Elina_Svitolina,2,B-DTL,1,1,1,0,0,1,0
20150602-W-Roland_Garros-QF-Ana_Ivanovic-Elina_Svitolina,2,B-II,1,1,0,1,0,1,0
20150602-W-Roland_Garros-QF-Ana_Ivanovic-Elina_Svitolina,2,S-XC,4,1,0,0,1,0,4
20150602-W-Roland_Garros-QF-Ana_Ivanovic-Elina_Svitolina,2,S-DTM,4,1,0,0,1,0,4
20150608-W-s_Hertogenbosch-R32-Michaella_Krajicek-Oceane_Dodin,1,F-XC,25,8,4,1,3,10,15
20150608-W-s_Hertogenbosch-R32-Michaella_Krajicek-Oceane_Dodin,1,F-DTM,14,1,0,0,1,3,11
20150608-W-s_Hertogenbosch-R32-Michaella_Krajicek-Oceane_Dodin,1,F-DTL,3,1,1,0,0,1,2
20150608-W-s_Hertogenbosch-R32-Michaella_Krajicek-Oceane_Dodin,1,F-IO,8,3,0,1,2,3,5
20150608-W-s_Hertogenbosch-R32-Michaella_Krajicek-Oceane_Dodin,1,B-XC,19,3,1,0,2,10,9
20150608-W-s_Hertogenbosch-R32-Michaella_Krajicek-Oceane_Dodin,1,B-DTM,7,0,0,0,0,2,5
20150608-W-s_Hertogenbosch-R32-Michaella_Krajicek-Oceane_Dodin,1,B-DTL,3,3,2,0,1,2,1
20150608-W-s_Hertogenbosch-R32-Michaella_Krajicek-Oceane_Dodin,1,B-IO,2,1,0,0,1,0,2
20150608-W-s_Hertogenbosch-R32-Michaella_Krajicek-Oceane_Dodin,1,S-XC,2,0,0,0,0,1,1
20150608-W-s_Hertogenbosch-R32-Michaella_Krajicek-Oceane_Dodin,1,S-DTM,4,0,0,0,0,1,3
20150608-W-s_Hertogenbosch-R32-Michaella_Krajicek-Oceane_Dodin,1,S-IO,1,0,0,0,0,1,0
20150608-W-s_Hertogenbosch-R32-Michaella_Krajicek-Oceane_Dodin,2,F-XC,10,3,2,1,0,7,3
20150608-W-s_Hertogenbosch-R32-Michaella_Krajicek-Oceane_Dodin,2,F-DTM,20,2,0,1,1,13,7
20150608-W-s_Hertogenbosch-R32-Michaella_Krajicek-Oceane_Dodin,2,F-DTL,6,2,0,0,2,1,5
20150608-W-s_Hertogenbosch-R32-Michaella_Krajicek-Oceane_Dodin,2,F-IO,5,2,2,0,0,4,1
20150608-W-s_Hertogenbosch-R32-Michaella_Krajicek-Oceane_Dodin,2,B-XC,17,3,1,1,1,9,8
20150608-W-s_Hertogenbosch-R32-Michaella_Krajicek-Oceane_Dodin,2,B-DTM,28,4,0,2,2,19,9
20150608-W-s_Hertogenbosch-R32-Michaella_Krajicek-Oceane_Dodin,2,B-DTL,6,4,3,1,0,6,0
20150608-W-s_Hertogenbosch-R32-Michaella_Krajicek-Oceane_Dodin,2,B-IO,2,1,1,0,0,1,1
20150608-W-s_Hertogenbosch-R32-Michaella_Krajicek-Oceane_Dodin,2,S-DTM,1,0,0,0,0,0,1
20150517-W-Rome-F-Maria_Sharapova-Carla_Suarez_Navarro,1,F-XC,66,19,6,3,10,41,25
20150517-W-Rome-F-Maria_Sharapova-Carla_Suarez_Navarro,1,F-DTM,32,6,0,0,6,8,24
20150517-W-Rome-F-Maria_Sharapova-Carla_Suarez_Navarro,1,F-DTL,9,4,0,2,2,5,4
20150517-W-Rome-F-Maria_Sharapova-Carla_Suarez_Navarro,1,F-IO,26,12,8,2,2,17,9
20150517-W-Rome-F-Maria_Sharapova-Carla_Suarez_Navarro,1,F-II,4,1,1,0,0,3,1
20150517-W-Rome-F-Maria_Sharapova-Carla_Suarez_Navarro,1,B-XC,89,18,4,1,13,36,53
20150517-W-Rome-F-Maria_Sharapova-Carla_Suarez_Navarro,1,B-DTM,26,3,1,0,2,11,15
20150517-W-Rome-F-Maria_Sharapova-Carla_Suarez_Navarro,1,B-DTL,7,5,0,1,4,3,4
20150517-W-Rome-F-Maria_Sharapova-Carla_Suarez_Navarro,1,B-IO,8,6,2,1,3,3,5
20150517-W-Rome-F-Maria_Sharapova-Carla_Suarez_Navarro,1,S-DTM,3,0,0,0,0,3,0
20150517-W-Rome-F-Maria_Sharapova-Carla_Suarez_Navarro,2,F-XC,53,17,3,2,12,21,32
20150517-W-Rome-F-Maria_Sharapova-Carla_Suarez_Navarro,2,F-DTM,32,2,0,0,2,16,16
20150517-W-Rome-F-Maria_Sharapova-Carla_Suarez_Navarro,2,F-DTL,15,2,0,0,2,7,8
20150517-W-Rome-F-Maria_Sharapova-Carla_Suarez_Navarro,2,F-IO,10,5,1,1,3,6,4
20150517-W-Rome-F-Maria_Sharapova-Carla_Suarez_Navarro,2,F-II,1,1,0,0,1,0,1
20150517-W-Rome-F-Maria_Sharapova-Carla_Suarez_Navarro,2,B-XC,61,15,3,6,6,35,26
20150517-W-Rome-F-Maria_Sharapova-Carla_Suarez_Navarro,2,B-DTM,39,2,0,0,2,20,19
20150517-W-Rome-F-Maria_Sharapova-Carla_Suarez_Navarro,2,B-DTL,7,3,1,0,2,4,3
20150517-W-Rome-F-Maria_Sharapova-Carla_Suarez_Navarro,2,B-IO,1,1,0,0,1,0,1
20150517-W-Rome-F-Maria_Sharapova-Carla_Suarez_Navarro,2,B-II,2,0,0,0,0,2,0
20150517-W-Rome-F-Maria_Sharapova-Carla_Suarez_Navarro,2,S-XC,22,3,0,1,2,15,7
20150517-W-Rome-F-Maria_Sharapova-Carla_Suarez_Navarro,2,S-DTM,18,1,0,0,1,6,12
20150517-W-Rome-F-Maria_Sharapova-Carla_Suarez_Navarro,2,S-DTL,1,1,1,0,0,1,0
20150604-W-Roland_Garros-SF-Ana_Ivanovic-Lucie_Safarova,1,F-XC,46,12,4,1,7,18,28
20150604-W-Roland_Garros-SF-Ana_Ivanovic-Lucie_Safarova,1,F-DTM,19,3,0,0,3,9,10
20150604-W-Roland_Garros-SF-Ana_Ivanovic-Lucie_Safarova,1,F-DTL,5,3,3,0,0,4,1
20150604-W-Roland_Garros-SF-Ana_Ivanovic-Lucie_Safarova,1,F-IO,16,10,4,2,4,9,7
20150604-W-Roland_Garros-SF-Ana_Ivanovic-Lucie_Safarova,1,F-II,1,1,0,1,0,1,0
20150604-W-Roland_Garros-SF-Ana_Ivanovic-Lucie_Safarova,1,B-XC,21,4,3,0,1,8,13
20150604-W-Roland_Garros-SF-Ana_Ivanovic-Lucie_Safarova,1,B-DTM,38,1,0,0,1,19,19
20150604-W-Roland_Garros-SF-Ana_Ivanovic-Lucie_Safarova,1,B-DTL,15,2,0,0,2,4,11
20150604-W-Roland_Garros-SF-Ana_Ivanovic-Lucie_Safarova,1,B-IO,11,3,1,0,2,7,4
20150604-W-Roland_Garros-SF-Ana_Ivanovic-Lucie_Safarova,1,S-XC,3,1,0,0,1,0,3
20150604-W-Roland_Garros-SF-Ana_Ivanovic-Lucie_Safarova,1,S-DTM,8,1,0,0,1,2,6
20150604-W-Roland_Garros-SF-Ana_Ivanovic-Lucie_Safarova,1,S-DTL,2,0,0,0,0,1,1
20150604-W-Roland_Garros-SF-Ana_Ivanovic-Lucie_Safarova,1,S-II,1,0,0,0,0,1,0
20150604-W-Roland_Garros-SF-Ana_Ivanovic-Lucie_Safarova,2,F-XC,60,10,3,2,5,35,25
20150604-W-Roland_Garros-SF-Ana_Ivanovic-Lucie_Safarova,2,F-DTM,24,0,0,0,0,12,12
20150604-W-Roland_Garros-SF-Ana_Ivanovic-Lucie_Safarova,2,F-DTL,7,5,2,1,2,5,2
20150604-W-Roland_Garros-SF-Ana_Ivanovic-Lucie_Safarova,2,F-IO,22,16,11,2,3,17,5
20150604-W-Roland_Garros-SF-Ana_Ivanovic-Lucie_Safarova,2,F-II,4,0,0,0,0,3,1
20150604-W-Roland_Garros-SF-Ana_Ivanovic-Lucie_Safarova,2,B-XC,32,10,4,1,5,17,15
20150604-W-Roland_Garros-SF-Ana_Ivanovic-Lucie_Safarova,2,B-DTM,34,1,0,0,1,15,19
20150604-W-Roland_Garros-SF-Ana_Ivanovic-Lucie_Safarova,2,B-DTL,19,2,0,0,2,12,7
20150604-W-Roland_Garros-SF-Ana_Ivanovic-Lucie_Safarova,2,B-IO,5,2,0,1,1,4,1
20150604-W-Roland_Garros-SF-Ana_Ivanovic-Lucie_Safarova,2,S-XC,1,1,1,0,0,1,0
20150604-W-Roland_Garros-SF-Ana_Ivanovic-Lucie_Safarova,2,S-DTM,2,1,1,0,0,2,0
20150604-W-Roland_Garros-SF-Ana_Ivanovic-Lucie_Safarova,2,S-DTL,1,0,0,0,0,0,1
20150606-W-Roland_Garros-F-Serena_Williams-Lucie_Safarova,1,F-XC,46,9,0,4,5,26,20
20150606-W-Roland_Garros-F-Serena_Williams-Lucie_Safarova,1,F-DTM,12,1,0,0,1,3,9
20150606-W-Roland_Garros-F-Serena_Williams-Lucie_Safarova,1,F-DTL,10,6,1,3,2,7,3
20150606-W-Roland_Garros-F-Serena_Williams-Lucie_Safarova,1,F-IO,13,5,1,1,3,6,7
20150606-W-Roland_Garros-F-Serena_Williams-Lucie_Safarova,1,B-XC,29,13,6,2,5,19,10
20150606-W-Roland_Garros-F-Serena_Williams-Lucie_Safarova,1,B-DTM,17,1,0,0,1,10,7
20150606-W-Roland_Garros-F-Serena_Williams-Lucie_Safarova,1,B-DTL,14,7,2,0,5,8,6
20150606-W-Roland_Garros-F-Serena_Williams-Lucie_Safarova,1,B-IO,14,4,2,1,1,10,4
20150606-W-Roland_Garros-F-Serena_Williams-Lucie_Safarova,1,S-DTM,1,0,0,0,0,0,1
20150606-W-Roland_Garros-F-Serena_Williams-Lucie_Safarova,1,S-DTL,2,0,0,0,0,1,1
20150606-W-Roland_Garros-F-Serena_Williams-Lucie_Safarova,2,F-XC,31,10,3,2,5,13,18
20150606-W-Roland_Garros-F-Serena_Williams-Lucie_Safarova,2,F-DTM,19,0,0,0,0,10,9
20150606-W-Roland_Garros-F-Serena_Williams-Lucie_Safarova,2,F-DTL,14,7,3,0,4,5,9
20150606-W-Roland_Garros-F-Serena_Williams-Lucie_Safarova,2,F-IO,15,5,3,2,0,8,7
20150606-W-Roland_Garros-F-Serena_Williams-Lucie_Safarova,2,F-II,1,0,0,0,0,1,0
20150606-W-Roland_Garros-F-Serena_Williams-Lucie_Safarova,2,B-XC,24,2,1,0,1,8,16
20150606-W-Roland_Garros-F-Serena_Williams-Lucie_Safarova,2,B-DTM,42,5,0,0,5,16,26
20150606-W-Roland_Garros-F-Serena_Williams-Lucie_Safarova,2,B-DTL,11,5,1,0,4,3,8
20150606-W-Roland_Garros-F-Serena_Williams-Lucie_Safarova,2,S-DTM,2,0,0,0,0,1,1
20150606-W-Roland_Garros-F-Serena_Williams-Lucie_Safarova,2,S-DTL,1,0,0,0,0,0,1
20150604-W-Roland_Garros-SF-Serena_Williams-Timea_Bacsinszky,1,F-XC,37,10,3,1,6,21,16
20150604-W-Roland_Garros-SF-Serena_Williams-Timea_Bacsinszky,1,F-DTM,11,2,0,0,2,3,8
20150604-W-Roland_Garros-SF-Serena_Williams-Timea_Bacsinszky,1,F-DTL,10,7,3,0,4,5,5
20150604-W-Roland_Garros-SF-Serena_Williams-Timea_Bacsinszky,1,F-IO,17,8,3,1,4,10,7
20150604-W-Roland_Garros-SF-Serena_Williams-Timea_Bacsinszky,1,B-XC,31,14,5,2,7,17,14
20150604-W-Roland_Garros-SF-Serena_Williams-Timea_Bacsinszky,1,B-DTM,19,0,0,0,0,11,8
20150604-W-Roland_Garros-SF-Serena_Williams-Timea_Bacsinszky,1,B-DTL,13,3,1,1,1,5,8
20150604-W-Roland_Garros-SF-Serena_Williams-Timea_Bacsinszky,1,B-IO,9,1,0,0,1,4,5
20150604-W-Roland_Garros-SF-Serena_Williams-Timea_Bacsinszky,1,S-XC,2,0,0,0,0,0,2
20150604-W-Roland_Garros-SF-Serena_Williams-Timea_Bacsinszky,1,S-DTM,4,0,0,0,0,2,2
20150604-W-Roland_Garros-SF-Serena_Williams-Timea_Bacsinszky,2,F-XC,30,10,4,0,6,16,14
20150604-W-Roland_Garros-SF-Serena_Williams-Timea_Bacsinszky,2,F-DTM,22,3,0,0,3,5,17
20150604-W-Roland_Garros-SF-Serena_Williams-Timea_Bacsinszky,2,F-DTL,18,7,2,1,4,9,9
20150604-W-Roland_Garros-SF-Serena_Williams-Timea_Bacsinszky,2,F-IO,15,5,0,1,4,5,10
20150604-W-Roland_Garros-SF-Serena_Williams-Timea_Bacsinszky,2,B-XC,16,2,1,0,1,9,7
20150604-W-Roland_Garros-SF-Serena_Williams-Timea_Bacsinszky,2,B-DTM,13,1,0,1,0,7,6
20150604-W-Roland_Garros-SF-Serena_Williams-Timea_Bacsinszky,2,B-DTL,8,4,2,0,2,4,4
20150604-W-Roland_Garros-SF-Serena_Williams-Timea_Bacsinszky,2,B-IO,8,3,2,0,1,4,4
20150604-W-Roland_Garros-SF-Serena_Williams-Timea_Bacsinszky,2,S-DTM,2,0,0,0,0,1,1
20150614-W-s_Hertogenbosch-F-Camila_Giorgi-Belinda_Bencic,1,F-XC,34,12,7,1,4,22,12
20150614-W-s_Hertogenbosch-F-Camila_Giorgi-Belinda_Bencic,1,F-DTM,16,4,1,0,3,11,5
20150614-W-s_Hertogenbosch-F-Camila_Giorgi-Belinda_Bencic,1,F-DTL,4,1,0,1,0,3,1
20150614-W-s_Hertogenbosch-F-Camila_Giorgi-Belinda_Bencic,1,F-IO,8,3,2,0,1,2,6
20150614-W-s_Hertogenbosch-F-Camila_Giorgi-Belinda_Bencic,1,F-II,1,0,0,0,0,0,1
20150614-W-s_Hertogenbosch-F-Camila_Giorgi-Belinda_Bencic,1,B-XC,32,9,3,2,4,20,12
20150614-W-s_Hertogenbosch-F-Camila_Giorgi-Belinda_Bencic,1,B-DTM,17,1,0,1,0,6,11
20150614-W-s_Hertogenbosch-F-Camila_Giorgi-Belinda_Bencic,1,B-DTL,3,1,0,0,1,1,2
20150614-W-s_Hertogenbosch-F-Camila_Giorgi-Belinda_Bencic,1,B-IO,4,2,1,0,1,2,2
20150614-W-s_Hertogenbosch-F-Camila_Giorgi-Belinda_Bencic,1,S-XC,1,1,1,0,0,1,0
20150614-W-s_Hertogenbosch-F-Camila_Giorgi-Belinda_Bencic,1,S-DTM,1,0,0,0,0,0,1
20150614-W-s_Hertogenbosch-F-Camila_Giorgi-Belinda_Bencic,1,S-DTL,1,1,0,1,0,1,0
20150614-W-s_Hertogenbosch-F-Camila_Giorgi-Belinda_Bencic,2,F-XC,13,3,1,0,2,4,9
20150614-W-s_Hertogenbosch-F-Camila_Giorgi-Belinda_Bencic,2,F-DTM,17,1,0,0,1,10,7
20150614-W-s_Hertogenbosch-F-Camila_Giorgi-Belinda_Bencic,2,F-DTL,7,2,0,0,2,3,4
20150614-W-s_Hertogenbosch-F-Camila_Giorgi-Belinda_Bencic,2,F-IO,9,3,1,0,2,6,3
20150614-W-s_Hertogenbosch-F-Camila_Giorgi-Belinda_Bencic,2,B-XC,21,8,1,1,6,9,12
20150614-W-s_Hertogenbosch-F-Camila_Giorgi-Belinda_Bencic,2,B-DTM,15,4,0,1,3,5,10
20150614-W-s_Hertogenbosch-F-Camila_Giorgi-Belinda_Bencic,2,B-DTL,12,4,1,2,1,8,4
20150614-W-s_Hertogenbosch-F-Camila_Giorgi-Belinda_Bencic,2,B-IO,8,1,0,0,1,3,5
20150614-W-s_Hertogenbosch-F-Camila_Giorgi-Belinda_Bencic,2,S-XC,1,0,0,0,0,0,1
20150614-W-s_Hertogenbosch-F-Camila_Giorgi-Belinda_Bencic,2,S-DTM,1,0,0,0,0,0,1
20150617-W-Birmingham-R32-Sabine_Lisicki-Belinda_Bencic,1,F-XC,12,7,4,0,3,6,6
20150617-W-Birmingham-R32-Sabine_Lisicki-Belinda_Bencic,1,F-DTM,11,4,1,0,3,5,6
20150617-W-Birmingham-R32-Sabine_Lisicki-Belinda_Bencic,1,F-DTL,4,3,3,0,0,3,1
20150617-W-Birmingham-R32-Sabine_Lisicki-Belinda_Bencic,1,F-IO,9,6,2,0,4,4,5
20150617-W-Birmingham-R32-Sabine_Lisicki-Belinda_Bencic,1,F-II,1,1,1,0,0,1,0
20150617-W-Birmingham-R32-Sabine_Lisicki-Belinda_Bencic,1,B-XC,9,4,0,1,3,3,6
20150617-W-Birmingham-R32-Sabine_Lisicki-Belinda_Bencic,1,B-DTM,11,5,0,0,5,2,9
20150617-W-Birmingham-R32-Sabine_Lisicki-Belinda_Bencic,1,B-DTL,1,1,0,0,1,0,1
20150617-W-Birmingham-R32-Sabine_Lisicki-Belinda_Bencic,1,B-IO,6,4,0,0,4,2,4
20150617-W-Birmingham-R32-Sabine_Lisicki-Belinda_Bencic,1,S-XC,3,0,0,0,0,2,1
20150617-W-Birmingham-R32-Sabine_Lisicki-Belinda_Bencic,1,S-DTM,4,0,0,0,0,2,2
20150617-W-Birmingham-R32-Sabine_Lisicki-Belinda_Bencic,1,S-DTL,1,0,0,0,0,1,0
20150617-W-Birmingham-R32-Sabine_Lisicki-Belinda_Bencic,2,F-XC,9,3,1,0,2,4,5
20150617-W-Birmingham-R32-Sabine_Lisicki-Belinda_Bencic,2,F-DTM,8,1,1,0,0,5,3
20150617-W-Birmingham-R32-Sabine_Lisicki-Belinda_Bencic,2,F-DTL,3,2,1,0,1,2,1
20150617-W-Birmingham-R32-Sabine_Lisicki-Belinda_Bencic,2,F-IO,9,3,0,0,3,5,4
20150617-W-Birmingham-R32-Sabine_Lisicki-Belinda_Bencic,2,B-XC,13,7,0,2,5,4,9
20150617-W-Birmingham-R32-Sabine_Lisicki-Belinda_Bencic,2,B-DTM,16,0,0,0,0,8,8
20150617-W-Birmingham-R32-Sabine_Lisicki-Belinda_Bencic,2,B-DTL,3,1,1,0,0,2,1
20150617-W-Birmingham-R32-Sabine_Lisicki-Belinda_Bencic,2,B-IO,5,2,1,0,1,2,3
20150617-W-Birmingham-R32-Sabine_Lisicki-Belinda_Bencic,2,S-XC,2,0,0,0,0,0,2
20150617-W-Birmingham-R32-Ana_Ivanovic-Michelle_Larcher_De_Brito,1,F-XC,34,12,6,0,6,20,14
20150617-W-Birmingham-R32-Ana_Ivanovic-Michelle_Larcher_De_Brito,1,F-DTM,15,3,0,0,3,5,10
20150617-W-Birmingham-R32-Ana_Ivanovic-Michelle_Larcher_De_Brito,1,F-DTL,12,6,1,1,4,5,7
20150617-W-Birmingham-R32-Ana_Ivanovic-Michelle_Larcher_De_Brito,1,F-IO,11,7,3,2,2,7,4
20150617-W-Birmingham-R32-Ana_Ivanovic-Michelle_Larcher_De_Brito,1,F-II,2,2,1,0,1,1,1
20150617-W-Birmingham-R32-Ana_Ivanovic-Michelle_Larcher_De_Brito,1,B-XC,32,9,2,0,7,11,21
20150617-W-Birmingham-R32-Ana_Ivanovic-Michelle_Larcher_De_Brito,1,B-DTM,30,3,0,0,3,8,22
20150617-W-Birmingham-R32-Ana_Ivanovic-Michelle_Larcher_De_Brito,1,B-DTL,7,4,1,0,3,2,5
20150617-W-Birmingham-R32-Ana_Ivanovic-Michelle_Larcher_De_Brito,1,B-IO,3,1,0,0,1,2,1
20150617-W-Birmingham-R32-Ana_Ivanovic-Michelle_Larcher_De_Brito,1,S-XC,11,3,0,0,3,4,7
20150617-W-Birmingham-R32-Ana_Ivanovic-Michelle_Larcher_De_Brito,1,S-DTM,15,1,0,0,1,3,12
20150617-W-Birmingham-R32-Ana_Ivanovic-Michelle_Larcher_De_Brito,1,S-DTL,7,1,0,1,0,4,3
20150617-W-Birmingham-R32-Ana_Ivanovic-Michelle_Larcher_De_Brito,2,F-XC,46,16,6,4,6,27,19
20150617-W-Birmingham-R32-Ana_Ivanovic-Michelle_Larcher_De_Brito,2,F-DTM,25,5,0,0,5,14,11
20150617-W-Birmingham-R32-Ana_Ivanovic-Michelle_Larcher_De_Brito,2,F-DTL,12,6,0,4,2,6,6
20150617-W-Birmingham-R32-Ana_Ivanovic-Michelle_Larcher_De_Brito,2,F-IO,37,14,6,2,6,29,8
20150617-W-Birmingham-R32-Ana_Ivanovic-Michelle_Larcher_De_Brito,2,F-II,1,0,0,0,0,1,0
20150617-W-Birmingham-R32-Ana_Ivanovic-Michelle_Larcher_De_Brito,2,B-XC,48,6,1,0,5,25,23
20150617-W-Birmingham-R32-Ana_Ivanovic-Michelle_Larcher_De_Brito,2,B-DTM,18,2,1,0,1,10,8
20150617-W-Birmingham-R32-Ana_Ivanovic-Michelle_Larcher_De_Brito,2,B-DTL,3,1,0,0,1,0,3
20150617-W-Birmingham-R32-Ana_Ivanovic-Michelle_Larcher_De_Brito,2,B-IO,2,1,0,0,1,1,1
20150617-W-Birmingham-R32-Ana_Ivanovic-Michelle_Larcher_De_Brito,2,S-XC,1,0,0,0,0,1,0
20150617-W-Birmingham-R32-Ana_Ivanovic-Michelle_Larcher_De_Brito,2,S-DTM,1,0,0,0,0,1,0
20150601-W-Roland_Garros-R16-Petra_Kvitova-Timea_Bacsinszky,1,F-XC,34,13,2,1,10,13,21
20150601-W-Roland_Garros-R16-Petra_Kvitova-Timea_Bacsinszky,1,F-DTM,27,8,0,1,7,9,18
20150601-W-Roland_Garros-R16-Petra_Kvitova-Timea_Bacsinszky,1,F-DTL,4,2,0,1,1,2,2
20150601-W-Roland_Garros-R16-Petra_Kvitova-Timea_Bacsinszky,1,F-IO,28,13,5,2,6,14,14
20150601-W-Roland_Garros-R16-Petra_Kvitova-Timea_Bacsinszky,1,F-II,1,0,0,0,0,1,0
20150601-W-Roland_Garros-R16-Petra_Kvitova-Timea_Bacsinszky,1,B-XC,33,11,1,0,10,7,26
20150601-W-Roland_Garros-R16-Petra_Kvitova-Timea_Bacsinszky,1,B-DTM,22,4,0,1,3,9,13
20150601-W-Roland_Garros-R16-Petra_Kvitova-Timea_Bacsinszky,1,B-DTL,1,1,1,0,0,1,0
20150601-W-Roland_Garros-R16-Petra_Kvitova-Timea_Bacsinszky,1,B-IO,4,1,0,0,1,0,4
20150601-W-Roland_Garros-R16-Petra_Kvitova-Timea_Bacsinszky,1,S-XC,1,0,0,0,0,0,1
20150601-W-Roland_Garros-R16-Petra_Kvitova-Timea_Bacsinszky,1,S-DTM,1,0,0,0,0,0,1
20150601-W-Roland_Garros-R16-Petra_Kvitova-Timea_Bacsinszky,2,F-XC,20,3,0,0,3,12,8
20150601-W-Roland_Garros-R16-Petra_Kvitova-Timea_Bacsinszky,2,F-DTM,27,6,0,1,5,11,16
20150601-W-Roland_Garros-R16-Petra_Kvitova-Timea_Bacsinszky,2,F-DTL,6,2,2,0,0,4,2
20150601-W-Roland_Garros-R16-Petra_Kvitova-Timea_Bacsinszky,2,F-IO,11,3,2,0,1,7,4
20150601-W-Roland_Garros-R16-Petra_Kvitova-Timea_Bacsinszky,2,B-XC,18,7,4,1,2,15,3
20150601-W-Roland_Garros-R16-Petra_Kvitova-Timea_Bacsinszky,2,B-DTM,23,4,0,0,4,10,13
20150601-W-Roland_Garros-R16-Petra_Kvitova-Timea_Bacsinszky,2,B-DTL,3,1,0,0,1,2,1
20150601-W-Roland_Garros-R16-Petra_Kvitova-Timea_Bacsinszky,2,B-IO,7,4,0,1,3,4,3
20150601-W-Roland_Garros-R16-Petra_Kvitova-Timea_Bacsinszky,2,S-XC,1,1,0,0,1,0,1
20150601-W-Roland_Garros-R16-Petra_Kvitova-Timea_Bacsinszky,2,S-DTM,3,0,0,0,0,2,1
20150530-W-Roland_Garros-R32-Madison_Keys-Timea_Bacsinszky,1,F-XC,27,9,2,0,7,7,20
20150530-W-Roland_Garros-R32-Madison_Keys-Timea_Bacsinszky,1,F-DTM,8,2,0,0,2,2,6
20150530-W-Roland_Garros-R32-Madison_Keys-Timea_Bacsinszky,1,F-DTL,3,2,2,0,0,2,1
20150530-W-Roland_Garros-R32-Madison_Keys-Timea_Bacsinszky,1,F-IO,11,7,2,2,3,5,6
20150530-W-Roland_Garros-R32-Madison_Keys-Timea_Bacsinszky,1,F-II,2,2,1,0,1,1,1
20150530-W-Roland_Garros-R32-Madison_Keys-Timea_Bacsinszky,1,B-XC,17,4,0,1,3,8,9
20150530-W-Roland_Garros-R32-Madison_Keys-Timea_Bacsinszky,1,B-DTM,24,10,0,1,9,3,21
20150530-W-Roland_Garros-R32-Madison_Keys-Timea_Bacsinszky,1,B-DTL,8,6,3,0,3,3,5
20150530-W-Roland_Garros-R32-Madison_Keys-Timea_Bacsinszky,1,B-IO,6,2,0,0,2,0,6
20150530-W-Roland_Garros-R32-Madison_Keys-Timea_Bacsinszky,1,S-XC,1,0,0,0,0,0,1
20150530-W-Roland_Garros-R32-Madison_Keys-Timea_Bacsinszky,1,S-DTM,1,0,0,0,0,0,1
20150530-W-Roland_Garros-R32-Madison_Keys-Timea_Bacsinszky,2,F-XC,15,6,2,1,3,10,5
20150530-W-Roland_Garros-R32-Madison_Keys-Timea_Bacsinszky,2,F-DTM,16,0,0,0,0,15,1
20150530-W-Roland_Garros-R32-Madison_Keys-Timea_Bacsinszky,2,F-DTL,11,2,0,0,2,5,6
20150530-W-Roland_Garros-R32-Madison_Keys-Timea_Bacsinszky,2,F-IO,14,4,2,0,2,10,4
20150530-W-Roland_Garros-R32-Madison_Keys-Timea_Bacsinszky,2,B-XC,24,8,3,2,3,15,9
20150530-W-Roland_Garros-R32-Madison_Keys-Timea_Bacsinszky,2,B-DTM,10,2,0,1,1,7,3
20150530-W-Roland_Garros-R32-Madison_Keys-Timea_Bacsinszky,2,B-DTL,6,1,1,0,0,5,1
20150530-W-Roland_Garros-R32-Madison_Keys-Timea_Bacsinszky,2,B-IO,6,3,2,1,0,6,0
20150530-W-Roland_Garros-R32-Madison_Keys-Timea_Bacsinszky,2,S-XC,1,0,0,0,0,1,0
20150530-W-Roland_Garros-R32-Madison_Keys-Timea_Bacsinszky,2,S-DTM,2,0,0,0,0,1,1
20150530-W-Roland_Garros-R32-Madison_Keys-Timea_Bacsinszky,2,S-DTL,1,0,0,0,0,0,1
20150615-W-Nottingham-F-Monica_Niculescu-Ana_Konjuh,1,F-DTM,1,0,0,0,0,1,0
20150615-W-Nottingham-F-Monica_Niculescu-Ana_Konjuh,1,B-XC,24,3,0,0,3,15,9
20150615-W-Nottingham-F-Monica_Niculescu-Ana_Konjuh,1,B-DTM,58,6,0,1,5,37,21
20150615-W-Nottingham-F-Monica_Niculescu-Ana_Konjuh,1,B-DTL,6,3,0,2,1,4,2
20150615-W-Nottingham-F-Monica_Niculescu-Ana_Konjuh,1,B-IO,9,2,0,0,2,6,3
20150615-W-Nottingham-F-Monica_Niculescu-Ana_Konjuh,1,S-XC,3,0,0,0,0,2,1
20150615-W-Nottingham-F-Monica_Niculescu-Ana_Konjuh,1,S-DTM,15,1,0,0,1,6,9
20150615-W-Nottingham-F-Monica_Niculescu-Ana_Konjuh,1,S-IO,1,0,0,0,0,1,0
20150615-W-Nottingham-F-Monica_Niculescu-Ana_Konjuh,2,F-XC,54,19,8,1,10,22,32
20150615-W-Nottingham-F-Monica_Niculescu-Ana_Konjuh,2,F-DTM,15,4,0,0,4,3,12
20150615-W-Nottingham-F-Monica_Niculescu-Ana_Konjuh,2,F-DTL,15,5,2,1,2,8,7
20150615-W-Nottingham-F-Monica_Niculescu-Ana_Konjuh,2,F-IO,28,13,1,3,9,9,19
20150615-W-Nottingham-F-Monica_Niculescu-Ana_Konjuh,2,F-II,1,0,0,0,0,0,1
20150615-W-Nottingham-F-Monica_Niculescu-Ana_Konjuh,2,B-XC,63,12,2,2,8,25,38
20150615-W-Nottingham-F-Monica_Niculescu-Ana_Konjuh,2,B-DTM,28,3,0,0,3,6,22
20150615-W-Nottingham-F-Monica_Niculescu-Ana_Konjuh,2,B-DTL,5,3,0,0,3,1,4
20150615-W-Nottingham-F-Monica_Niculescu-Ana_Konjuh,2,B-IO,7,1,0,1,0,3,4
20150615-W-Nottingham-F-Monica_Niculescu-Ana_Konjuh,2,S-XC,4,0,0,0,0,0,4
20150615-W-Nottingham-F-Monica_Niculescu-Ana_Konjuh,2,S-DTM,1,0,0,0,0,0,1
20150615-W-Nottingham-F-Monica_Niculescu-Ana_Konjuh,2,S-DTL,1,0,0,0,0,0,1
20150619-W-Birmingham-QF-Katerina_Siniakova-Angelique_Kerber,1,F-XC,30,10,4,2,4,16,14
20150619-W-Birmingham-QF-Katerina_Siniakova-Angelique_Kerber,1,F-DTM,27,5,0,0,5,13,14
20150619-W-Birmingham-QF-Katerina_Siniakova-Angelique_Kerber,1,F-DTL,13,8,4,1,3,7,6
20150619-W-Birmingham-QF-Katerina_Siniakova-Angelique_Kerber,1,F-IO,13,3,0,0,3,6,7
20150619-W-Birmingham-QF-Katerina_Siniakova-Angelique_Kerber,1,B-XC,32,12,7,2,3,25,7
20150619-W-Birmingham-QF-Katerina_Siniakova-Angelique_Kerber,1,B-DTM,22,3,0,0,3,13,9
20150619-W-Birmingham-QF-Katerina_Siniakova-Angelique_Kerber,1,B-DTL,9,5,3,0,2,5,4
20150619-W-Birmingham-QF-Katerina_Siniakova-Angelique_Kerber,1,B-IO,13,3,1,0,2,6,7
20150619-W-Birmingham-QF-Katerina_Siniakova-Angelique_Kerber,1,S-DTM,2,0,0,0,0,0,2
20150619-W-Birmingham-QF-Katerina_Siniakova-Angelique_Kerber,1,S-DTL,4,0,0,0,0,0,4
20150619-W-Birmingham-QF-Katerina_Siniakova-Angelique_Kerber,2,F-XC,41,9,2,1,6,14,27
20150619-W-Birmingham-QF-Katerina_Siniakova-Angelique_Kerber,2,F-DTM,27,4,0,1,3,11,16
20150619-W-Birmingham-QF-Katerina_Siniakova-Angelique_Kerber,2,F-DTL,9,5,2,1,2,6,3
20150619-W-Birmingham-QF-Katerina_Siniakova-Angelique_Kerber,2,F-IO,16,6,3,1,2,11,5
20150619-W-Birmingham-QF-Katerina_Siniakova-Angelique_Kerber,2,B-XC,21,7,4,1,2,10,11
20150619-W-Birmingham-QF-Katerina_Siniakova-Angelique_Kerber,2,B-DTM,28,3,0,0,3,13,15
20150619-W-Birmingham-QF-Katerina_Siniakova-Angelique_Kerber,2,B-DTL,2,0,0,0,0,1,1
20150619-W-Birmingham-QF-Katerina_Siniakova-Angelique_Kerber,2,B-IO,3,1,1,0,0,2,1
20150619-W-Birmingham-QF-Katerina_Siniakova-Angelique_Kerber,2,S-XC,6,2,2,0,0,3,3
20150619-W-Birmingham-QF-Katerina_Siniakova-Angelique_Kerber,2,S-DTM,8,0,0,0,0,3,5
20150619-W-Birmingham-QF-Katerina_Siniakova-Angelique_Kerber,2,S-DTL,1,0,0,0,0,0,1
20150618-W-Birmingham-R16-Kristina_Mladenovic-Barbora_Strycova,1,F-XC,22,6,2,4,0,16,6
20150618-W-Birmingham-R16-Kristina_Mladenovic-Barbora_Strycova,1,F-DTM,18,3,1,0,2,11,7
20150618-W-Birmingham-R16-Kristina_Mladenovic-Barbora_Strycova,1,F-DTL,4,1,1,0,0,3,1
20150618-W-Birmingham-R16-Kristina_Mladenovic-Barbora_Strycova,1,F-IO,17,9,3,2,4,12,5
20150618-W-Birmingham-R16-Kristina_Mladenovic-Barbora_Strycova,1,F-II,2,1,0,0,1,1,1
20150618-W-Birmingham-R16-Kristina_Mladenovic-Barbora_Strycova,1,B-XC,20,4,2,1,1,14,6
20150618-W-Birmingham-R16-Kristina_Mladenovic-Barbora_Strycova,1,B-DTM,16,3,0,0,3,9,7
20150618-W-Birmingham-R16-Kristina_Mladenovic-Barbora_Strycova,1,B-DTL,10,5,4,1,0,8,2
20150618-W-Birmingham-R16-Kristina_Mladenovic-Barbora_Strycova,1,B-IO,9,1,1,0,0,8,1
20150618-W-Birmingham-R16-Kristina_Mladenovic-Barbora_Strycova,1,S-XC,4,0,0,0,0,4,0
20150618-W-Birmingham-R16-Kristina_Mladenovic-Barbora_Strycova,1,S-DTM,5,0,0,0,0,4,1
20150618-W-Birmingham-R16-Kristina_Mladenovic-Barbora_Strycova,1,S-DTL,2,1,0,1,0,1,1
20150618-W-Birmingham-R16-Kristina_Mladenovic-Barbora_Strycova,1,S-IO,1,0,0,0,0,1,0
20150618-W-Birmingham-R16-Kristina_Mladenovic-Barbora_Strycova,2,F-XC,17,4,1,2,1,6,11
20150618-W-Birmingham-R16-Kristina_Mladenovic-Barbora_Strycova,2,F-DTM,18,5,0,0,5,4,14
20150618-W-Birmingham-R16-Kristina_Mladenovic-Barbora_Strycova,2,F-DTL,2,1,0,0,1,0,2
20150618-W-Birmingham-R16-Kristina_Mladenovic-Barbora_Strycova,2,F-IO,6,4,2,1,1,4,2
20150618-W-Birmingham-R16-Kristina_Mladenovic-Barbora_Strycova,2,B-XC,20,4,0,2,2,6,14
20150618-W-Birmingham-R16-Kristina_Mladenovic-Barbora_Strycova,2,B-DTM,27,8,0,1,7,6,21
20150618-W-Birmingham-R16-Kristina_Mladenovic-Barbora_Strycova,2,B-DTL,6,4,2,1,1,3,3
20150618-W-Birmingham-R16-Kristina_Mladenovic-Barbora_Strycova,2,B-IO,1,0,0,0,0,1,0
20150618-W-Birmingham-R16-Kristina_Mladenovic-Barbora_Strycova,2,S-XC,2,1,0,0,1,0,2
20150618-W-Birmingham-R16-Kristina_Mladenovic-Barbora_Strycova,2,S-DTM,7,0,0,0,0,3,4
20150618-W-Birmingham-R16-Kristina_Mladenovic-Barbora_Strycova,2,S-DTL,1,1,0,0,1,0,1
20140921-W-Guangzhou-F-Alize_Cornet-Monica_Niculescu,1,F-XC,66,5,1,2,2,28,38
20140921-W-Guangzhou-F-Alize_Cornet-Monica_Niculescu,1,F-DTM,35,2,0,1,1,14,21
20140921-W-Guangzhou-F-Alize_Cornet-Monica_Niculescu,1,F-DTL,9,3,0,0,3,1,8
20140921-W-Guangzhou-F-Alize_Cornet-Monica_Niculescu,1,F-IO,20,2,0,0,2,7,13
20140921-W-Guangzhou-F-Alize_Cornet-Monica_Niculescu,1,F-II,2,0,0,0,0,1,1
20140921-W-Guangzhou-F-Alize_Cornet-Monica_Niculescu,1,B-XC,57,7,1,4,2,28,29
20140921-W-Guangzhou-F-Alize_Cornet-Monica_Niculescu,1,B-DTM,48,3,1,1,1,22,26
20140921-W-Guangzhou-F-Alize_Cornet-Monica_Niculescu,1,B-DTL,8,2,1,1,0,3,5
20140921-W-Guangzhou-F-Alize_Cornet-Monica_Niculescu,1,B-IO,6,1,0,1,0,4,2
20140921-W-Guangzhou-F-Alize_Cornet-Monica_Niculescu,1,S-XC,6,1,0,0,1,0,6
20140921-W-Guangzhou-F-Alize_Cornet-Monica_Niculescu,1,S-DTM,1,0,0,0,0,0,1
20140921-W-Guangzhou-F-Alize_Cornet-Monica_Niculescu,1,S-DTL,2,0,0,0,0,2,0
20140921-W-Guangzhou-F-Alize_Cornet-Monica_Niculescu,1,S-IO,2,0,0,0,0,0,2
20140921-W-Guangzhou-F-Alize_Cornet-Monica_Niculescu,2,F-XC,5,4,4,0,0,5,0
20140921-W-Guangzhou-F-Alize_Cornet-Monica_Niculescu,2,F-DTM,2,0,0,0,0,1,1
20140921-W-Guangzhou-F-Alize_Cornet-Monica_Niculescu,2,F-DTL,8,3,1,2,0,3,5
20140921-W-Guangzhou-F-Alize_Cornet-Monica_Niculescu,2,F-IO,2,1,0,1,0,2,0
20140921-W-Guangzhou-F-Alize_Cornet-Monica_Niculescu,2,B-XC,58,8,3,1,4,33,25
20140921-W-Guangzhou-F-Alize_Cornet-Monica_Niculescu,2,B-DTM,73,3,0,0,3,42,31
20140921-W-Guangzhou-F-Alize_Cornet-Monica_Niculescu,2,B-DTL,13,2,0,1,1,9,4
20140921-W-Guangzhou-F-Alize_Cornet-Monica_Niculescu,2,B-IO,9,1,1,0,0,6,3
20140921-W-Guangzhou-F-Alize_Cornet-Monica_Niculescu,2,S-XC,1,0,0,0,0,0,1
20140921-W-Guangzhou-F-Alize_Cornet-Monica_Niculescu,2,S-DTM,3,0,0,0,0,3,0
20140921-W-Guangzhou-F-Alize_Cornet-Monica_Niculescu,2,S-IO,2,0,0,0,0,1,1
20150620-W-Birmingham-SF-Kristina_Mladenovic-Karolina_Pliskova,1,F-XC,16,11,3,3,5,9,7
20150620-W-Birmingham-SF-Kristina_Mladenovic-Karolina_Pliskova,1,F-DTM,7,0,0,0,0,4,3
20150620-W-Birmingham-SF-Kristina_Mladenovic-Karolina_Pliskova,1,F-DTL,3,1,1,0,0,2,1
20150620-W-Birmingham-SF-Kristina_Mladenovic-Karolina_Pliskova,1,F-IO,17,6,3,0,3,9,8
20150620-W-Birmingham-SF-Kristina_Mladenovic-Karolina_Pliskova,1,B-XC,12,4,0,0,4,3,9
20150620-W-Birmingham-SF-Kristina_Mladenovic-Karolina_Pliskova,1,B-DTM,17,5,0,0,5,5,12
20150620-W-Birmingham-SF-Kristina_Mladenovic-Karolina_Pliskova,1,B-DTL,2,1,1,0,0,1,1
20150620-W-Birmingham-SF-Kristina_Mladenovic-Karolina_Pliskova,1,B-IO,2,1,1,0,0,1,1
20150620-W-Birmingham-SF-Kristina_Mladenovic-Karolina_Pliskova,1,S-XC,3,1,0,0,1,1,2
20150620-W-Birmingham-SF-Kristina_Mladenovic-Karolina_Pliskova,1,S-DTM,6,0,0,0,0,4,2
20150620-W-Birmingham-SF-Kristina_Mladenovic-Karolina_Pliskova,1,S-DTL,1,1,0,1,0,1,0
20150620-W-Birmingham-SF-Kristina_Mladenovic-Karolina_Pliskova,2,F-XC,9,1,1,0,0,4,5
20150620-W-Birmingham-SF-Kristina_Mladenovic-Karolina_Pliskova,2,F-DTM,8,1,0,0,1,4,4
20150620-W-Birmingham-SF-Kristina_Mladenovic-Karolina_Pliskova,2,F-DTL,3,3,0,0,3,0,3
20150620-W-Birmingham-SF-Kristina_Mladenovic-Karolina_Pliskova,2,F-IO,13,7,4,0,3,9,4
20150620-W-Birmingham-SF-Kristina_Mladenovic-Karolina_Pliskova,2,B-XC,12,1,0,0,1,7,5
20150620-W-Birmingham-SF-Kristina_Mladenovic-Karolina_Pliskova,2,B-DTM,15,2,1,0,1,7,8
20150620-W-Birmingham-SF-Kristina_Mladenovic-Karolina_Pliskova,2,B-DTL,5,2,2,0,0,4,1
20150620-W-Birmingham-SF-Kristina_Mladenovic-Karolina_Pliskova,2,B-IO,8,3,1,0,2,5,3
20150620-W-Birmingham-SF-Kristina_Mladenovic-Karolina_Pliskova,2,S-XC,4,0,0,0,0,2,2
20150620-W-Birmingham-SF-Kristina_Mladenovic-Karolina_Pliskova,2,S-DTM,5,1,0,1,0,2,3
20150616-W-Birmingham-R64-Aleksandra_Krunic-Heather_Watson,1,F-XC,26,9,2,3,4,13,13
20150616-W-Birmingham-R64-Aleksandra_Krunic-Heather_Watson,1,F-DTM,23,3,0,0,3,8,15
20150616-W-Birmingham-R64-Aleksandra_Krunic-Heather_Watson,1,F-DTL,13,8,2,1,5,5,8
20150616-W-Birmingham-R64-Aleksandra_Krunic-Heather_Watson,1,F-IO,9,6,3,2,1,8,1
20150616-W-Birmingham-R64-Aleksandra_Krunic-Heather_Watson,1,B-XC,15,2,0,0,2,5,10
20150616-W-Birmingham-R64-Aleksandra_Krunic-Heather_Watson,1,B-DTM,28,1,0,0,1,14,14
20150616-W-Birmingham-R64-Aleksandra_Krunic-Heather_Watson,1,B-DTL,5,2,0,0,2,2,3
20150616-W-Birmingham-R64-Aleksandra_Krunic-Heather_Watson,1,B-IO,7,3,0,0,3,2,5
20150616-W-Birmingham-R64-Aleksandra_Krunic-Heather_Watson,1,S-XC,12,2,1,0,1,8,4
20150616-W-Birmingham-R64-Aleksandra_Krunic-Heather_Watson,1,S-DTM,8,0,0,0,0,3,5
20150616-W-Birmingham-R64-Aleksandra_Krunic-Heather_Watson,1,S-DTL,3,1,1,0,0,1,2
20150616-W-Birmingham-R64-Aleksandra_Krunic-Heather_Watson,1,S-IO,1,0,0,0,0,1,0
20150616-W-Birmingham-R64-Aleksandra_Krunic-Heather_Watson,2,F-XC,42,13,4,1,8,26,16
20150616-W-Birmingham-R64-Aleksandra_Krunic-Heather_Watson,2,F-DTM,13,3,0,0,3,7,6
20150616-W-Birmingham-R64-Aleksandra_Krunic-Heather_Watson,2,F-DTL,9,2,1,1,0,5,4
20150616-W-Birmingham-R64-Aleksandra_Krunic-Heather_Watson,2,F-IO,17,4,0,1,3,7,10
20150616-W-Birmingham-R64-Aleksandra_Krunic-Heather_Watson,2,F-II,2,1,0,1,0,1,1
20150616-W-Birmingham-R64-Aleksandra_Krunic-Heather_Watson,2,B-XC,32,9,2,2,5,18,14
20150616-W-Birmingham-R64-Aleksandra_Krunic-Heather_Watson,2,B-DTM,22,0,0,0,0,14,8
20150616-W-Birmingham-R64-Aleksandra_Krunic-Heather_Watson,2,B-DTL,5,4,0,1,3,2,3
20150616-W-Birmingham-R64-Aleksandra_Krunic-Heather_Watson,2,B-IO,3,2,0,1,1,1,2
20150616-W-Birmingham-R64-Aleksandra_Krunic-Heather_Watson,2,S-DTM,2,0,0,0,0,0,2
20150616-W-Birmingham-R64-Aleksandra_Krunic-Heather_Watson,2,S-DTL,1,0,0,0,0,0,1
20150614-W-Nottingham-SF-Agnieszka_Radwanska-Monica_Niculescu,1,F-XC,47,19,11,3,5,30,17
20150614-W-Nottingham-SF-Agnieszka_Radwanska-Monica_Niculescu,1,F-DTM,24,0,0,0,0,14,10
20150614-W-Nottingham-SF-Agnieszka_Radwanska-Monica_Niculescu,1,F-DTL,14,2,2,0,0,10,4
20150614-W-Nottingham-SF-Agnieszka_Radwanska-Monica_Niculescu,1,F-IO,27,2,0,1,1,16,11
20150614-W-Nottingham-SF-Agnieszka_Radwanska-Monica_Niculescu,1,F-II,1,0,0,0,0,0,1
20150614-W-Nottingham-SF-Agnieszka_Radwanska-Monica_Niculescu,1,B-XC,63,4,0,1,3,29,34
20150614-W-Nottingham-SF-Agnieszka_Radwanska-Monica_Niculescu,1,B-DTM,45,1,0,0,1,21,24
20150614-W-Nottingham-SF-Agnieszka_Radwanska-Monica_Niculescu,1,B-DTL,10,2,0,0,2,3,7
20150614-W-Nottingham-SF-Agnieszka_Radwanska-Monica_Niculescu,1,B-IO,6,2,0,0,2,1,5
20150614-W-Nottingham-SF-Agnieszka_Radwanska-Monica_Niculescu,1,S-XC,14,4,2,0,2,5,9
20150614-W-Nottingham-SF-Agnieszka_Radwanska-Monica_Niculescu,1,S-DTM,3,1,0,0,1,1,2
20150614-W-Nottingham-SF-Agnieszka_Radwanska-Monica_Niculescu,1,S-DTL,5,0,0,0,0,3,2
20150614-W-Nottingham-SF-Agnieszka_Radwanska-Monica_Niculescu,1,S-IO,2,1,0,1,0,2,0
20150614-W-Nottingham-SF-Agnieszka_Radwanska-Monica_Niculescu,2,F-DTL,1,0,0,0,0,0,1
20150614-W-Nottingham-SF-Agnieszka_Radwanska-Monica_Niculescu,2,B-XC,62,5,0,2,3,33,29
20150614-W-Nottingham-SF-Agnieszka_Radwanska-Monica_Niculescu,2,B-DTM,56,5,0,1,4,21,35
20150614-W-Nottingham-SF-Agnieszka_Radwanska-Monica_Niculescu,2,B-DTL,9,4,2,1,1,8,1
20150614-W-Nottingham-SF-Agnieszka_Radwanska-Monica_Niculescu,2,B-IO,15,4,1,2,1,7,8
20150614-W-Nottingham-SF-Agnieszka_Radwanska-Monica_Niculescu,2,S-XC,7,2,0,0,2,3,4
20150614-W-Nottingham-SF-Agnieszka_Radwanska-Monica_Niculescu,2,S-DTM,6,0,0,0,0,4,2
20150614-W-Nottingham-SF-Agnieszka_Radwanska-Monica_Niculescu,2,S-DTL,2,1,0,0,1,0,2
20150614-W-Nottingham-SF-Agnieszka_Radwanska-Monica_Niculescu,2,S-IO,4,0,0,0,0,1,3
20150622-W-Eastbourne-R64-Irina_Camelia_Begu-Barbora_Strycova,1,F-XC,46,10,3,2,5,22,24
20150622-W-Eastbourne-R64-Irina_Camelia_Begu-Barbora_Strycova,1,F-DTM,18,3,0,0,3,7,11
20150622-W-Eastbourne-R64-Irina_Camelia_Begu-Barbora_Strycova,1,F-DTL,4,1,0,0,1,2,2
20150622-W-Eastbourne-R64-Irina_Camelia_Begu-Barbora_Strycova,1,F-IO,16,6,2,1,3,9,7
20150622-W-Eastbourne-R64-Irina_Camelia_Begu-Barbora_Strycova,1,B-XC,26,7,2,1,4,12,14
20150622-W-Eastbourne-R64-Irina_Camelia_Begu-Barbora_Strycova,1,B-DTM,14,5,0,0,5,4,10
20150622-W-Eastbourne-R64-Irina_Camelia_Begu-Barbora_Strycova,1,B-DTL,3,1,0,0,1,0,3
20150622-W-Eastbourne-R64-Irina_Camelia_Begu-Barbora_Strycova,1,B-IO,4,1,1,0,0,2,2
20150622-W-Eastbourne-R64-Irina_Camelia_Begu-Barbora_Strycova,1,S-XC,2,1,1,0,0,1,1
20150622-W-Eastbourne-R64-Irina_Camelia_Begu-Barbora_Strycova,1,S-DTL,1,0,0,0,0,0,1
20150622-W-Eastbourne-R64-Irina_Camelia_Begu-Barbora_Strycova,1,S-IO,2,0,0,0,0,1,1
20150622-W-Eastbourne-R64-Irina_Camelia_Begu-Barbora_Strycova,2,F-XC,29,2,0,0,2,18,11
20150622-W-Eastbourne-R64-Irina_Camelia_Begu-Barbora_Strycova,2,F-DTM,19,7,0,0,7,7,12
20150622-W-Eastbourne-R64-Irina_Camelia_Begu-Barbora_Strycova,2,F-DTL,11,2,0,1,1,7,4
20150622-W-Eastbourne-R64-Irina_Camelia_Begu-Barbora_Strycova,2,F-IO,2,0,0,0,0,1,1
20150622-W-Eastbourne-R64-Irina_Camelia_Begu-Barbora_Strycova,2,B-XC,12,2,0,0,2,8,4
20150622-W-Eastbourne-R64-Irina_Camelia_Begu-Barbora_Strycova,2,B-DTM,18,2,0,0,2,5,13
20150622-W-Eastbourne-R64-Irina_Camelia_Begu-Barbora_Strycova,2,B-DTL,5,2,1,1,0,4,1
20150622-W-Eastbourne-R64-Irina_Camelia_Begu-Barbora_Strycova,2,B-IO,1,0,0,0,0,0,1
20150622-W-Eastbourne-R64-Irina_Camelia_Begu-Barbora_Strycova,2,S-XC,3,0,0,0,0,2,1
20150622-W-Eastbourne-R64-Irina_Camelia_Begu-Barbora_Strycova,2,S-DTM,11,0,0,0,0,3,8
20150622-W-Eastbourne-R64-Irina_Camelia_Begu-Barbora_Strycova,2,S-IO,1,0,0,0,0,0,1
20150531-W-Roland_Garros-R16-Alize_Cornet-Elina_Svitolina,1,F-XC,53,8,3,0,5,29,24
20150531-W-Roland_Garros-R16-Alize_Cornet-Elina_Svitolina,1,F-DTM,45,8,0,0,8,13,32
20150531-W-Roland_Garros-R16-Alize_Cornet-Elina_Svitolina,1,F-DTL,17,3,2,0,1,7,10
20150531-W-Roland_Garros-R16-Alize_Cornet-Elina_Svitolina,1,F-IO,23,6,3,1,2,12,11
20150531-W-Roland_Garros-R16-Alize_Cornet-Elina_Svitolina,1,F-II,2,0,0,0,0,2,0
20150531-W-Roland_Garros-R16-Alize_Cornet-Elina_Svitolina,1,B-XC,96,13,3,2,8,41,55
20150531-W-Roland_Garros-R16-Alize_Cornet-Elina_Svitolina,1,B-DTM,92,5,0,0,5,31,61
20150531-W-Roland_Garros-R16-Alize_Cornet-Elina_Svitolina,1,B-DTL,12,4,2,0,2,7,5
20150531-W-Roland_Garros-R16-Alize_Cornet-Elina_Svitolina,1,B-IO,11,2,0,1,1,9,2
20150531-W-Roland_Garros-R16-Alize_Cornet-Elina_Svitolina,1,S-XC,8,0,0,0,0,4,4
20150531-W-Roland_Garros-R16-Alize_Cornet-Elina_Svitolina,1,S-DTM,14,1,0,1,0,7,7
20150531-W-Roland_Garros-R16-Alize_Cornet-Elina_Svitolina,1,S-DTL,1,1,0,0,1,0,1
20150531-W-Roland_Garros-R16-Alize_Cornet-Elina_Svitolina,2,F-XC,57,9,1,2,6,31,26
20150531-W-Roland_Garros-R16-Alize_Cornet-Elina_Svitolina,2,F-DTM,52,3,0,0,3,23,29
20150531-W-Roland_Garros-R16-Alize_Cornet-Elina_Svitolina,2,F-DTL,11,3,0,0,3,3,8
20150531-W-Roland_Garros-R16-Alize_Cornet-Elina_Svitolina,2,F-IO,27,5,4,1,0,21,6
20150531-W-Roland_Garros-R16-Alize_Cornet-Elina_Svitolina,2,F-II,2,1,1,0,0,1,1
20150531-W-Roland_Garros-R16-Alize_Cornet-Elina_Svitolina,2,B-XC,106,7,1,1,5,58,48
20150531-W-Roland_Garros-R16-Alize_Cornet-Elina_Svitolina,2,B-DTM,79,3,0,0,3,48,31
20150531-W-Roland_Garros-R16-Alize_Cornet-Elina_Svitolina,2,B-DTL,13,5,2,0,3,8,5
20150531-W-Roland_Garros-R16-Alize_Cornet-Elina_Svitolina,2,B-IO,10,1,1,0,0,9,1
20150531-W-Roland_Garros-R16-Alize_Cornet-Elina_Svitolina,2,S-XC,9,3,1,1,1,2,7
20150531-W-Roland_Garros-R16-Alize_Cornet-Elina_Svitolina,2,S-DTM,11,1,0,0,1,7,4
20150531-W-Roland_Garros-R16-Alize_Cornet-Elina_Svitolina,2,S-DTL,2,1,0,1,0,2,0
20150531-W-Roland_Garros-R16-Alize_Cornet-Elina_Svitolina,2,S-IO,1,0,0,0,0,1,0
20150425-W-Stuttgart-SF-Madison_Brengle-Angelique_Kerber,1,F-XC,38,4,1,2,1,17,21
20150425-W-Stuttgart-SF-Madison_Brengle-Angelique_Kerber,1,F-DTM,13,2,0,0,2,3,10
20150425-W-Stuttgart-SF-Madison_Brengle-Angelique_Kerber,1,F-DTL,9,3,3,0,0,5,4
20150425-W-Stuttgart-SF-Madison_Brengle-Angelique_Kerber,1,F-IO,3,0,0,0,0,0,3
20150425-W-Stuttgart-SF-Madison_Brengle-Angelique_Kerber,1,B-XC,33,14,2,2,10,12,21
20150425-W-Stuttgart-SF-Madison_Brengle-Angelique_Kerber,1,B-DTM,9,0,0,0,0,6,3
20150425-W-Stuttgart-SF-Madison_Brengle-Angelique_Kerber,1,B-DTL,10,6,1,0,5,2,8
20150425-W-Stuttgart-SF-Madison_Brengle-Angelique_Kerber,1,B-IO,6,3,1,1,1,2,4
20150425-W-Stuttgart-SF-Madison_Brengle-Angelique_Kerber,1,S-XC,4,3,1,0,2,2,2
20150425-W-Stuttgart-SF-Madison_Brengle-Angelique_Kerber,1,S-DTM,7,0,0,0,0,2,5
20150425-W-Stuttgart-SF-Madison_Brengle-Angelique_Kerber,1,S-DTL,1,0,0,0,0,1,0
20150425-W-Stuttgart-SF-Madison_Brengle-Angelique_Kerber,2,F-XC,34,5,2,0,3,21,13
20150425-W-Stuttgart-SF-Madison_Brengle-Angelique_Kerber,2,F-DTM,11,0,0,0,0,5,6
20150425-W-Stuttgart-SF-Madison_Brengle-Angelique_Kerber,2,F-DTL,11,6,4,0,2,9,2
20150425-W-Stuttgart-SF-Madison_Brengle-Angelique_Kerber,2,F-IO,17,7,4,2,1,11,6
20150425-W-Stuttgart-SF-Madison_Brengle-Angelique_Kerber,2,B-XC,24,4,2,1,1,12,12
20150425-W-Stuttgart-SF-Madison_Brengle-Angelique_Kerber,2,B-DTM,25,2,0,0,2,16,9
20150425-W-Stuttgart-SF-Madison_Brengle-Angelique_Kerber,2,B-DTL,13,5,2,0,3,7,6
20150425-W-Stuttgart-SF-Madison_Brengle-Angelique_Kerber,2,B-IO,5,2,1,0,1,3,2
20150425-W-Stuttgart-SF-Madison_Brengle-Angelique_Kerber,2,S-XC,1,0,0,0,0,0,1
20150425-W-Stuttgart-SF-Madison_Brengle-Angelique_Kerber,2,S-DTM,4,0,0,0,0,4,0
20150425-W-Stuttgart-SF-Madison_Brengle-Angelique_Kerber,2,S-DTL,2,0,0,0,0,1,1
20150425-W-Stuttgart-SF-Madison_Brengle-Angelique_Kerber,2,S-IO,1,0,0,0,0,1,0
20150623-W-Eastbourne-R32-Madison_Keys-Belinda_Bencic,1,F-XC,21,12,3,1,8,8,13
20150623-W-Eastbourne-R32-Madison_Keys-Belinda_Bencic,1,F-DTM,7,3,0,0,3,2,5
20150623-W-Eastbourne-R32-Madison_Keys-Belinda_Bencic,1,F-DTL,3,3,1,0,2,1,2
20150623-W-Eastbourne-R32-Madison_Keys-Belinda_Bencic,1,F-IO,9,6,3,0,3,4,5
20150623-W-Eastbourne-R32-Madison_Keys-Belinda_Bencic,1,F-II,1,1,0,0,1,0,1
20150623-W-Eastbourne-R32-Madison_Keys-Belinda_Bencic,1,B-XC,16,4,1,0,3,7,9
20150623-W-Eastbourne-R32-Madison_Keys-Belinda_Bencic,1,B-DTM,7,1,0,0,1,1,6
20150623-W-Eastbourne-R32-Madison_Keys-Belinda_Bencic,1,B-DTL,1,0,0,0,0,0,1
20150623-W-Eastbourne-R32-Madison_Keys-Belinda_Bencic,1,B-IO,2,1,1,0,0,1,1
20150623-W-Eastbourne-R32-Madison_Keys-Belinda_Bencic,1,S-XC,1,0,0,0,0,0,1
20150623-W-Eastbourne-R32-Madison_Keys-Belinda_Bencic,1,S-DTM,2,0,0,0,0,0,2
20150623-W-Eastbourne-R32-Madison_Keys-Belinda_Bencic,2,F-XC,11,2,0,2,0,8,3
20150623-W-Eastbourne-R32-Madison_Keys-Belinda_Bencic,2,F-DTM,8,2,2,0,0,5,3
20150623-W-Eastbourne-R32-Madison_Keys-Belinda_Bencic,2,F-DTL,5,2,1,0,1,4,1
20150623-W-Eastbourne-R32-Madison_Keys-Belinda_Bencic,2,F-IO,7,1,0,1,0,6,1
20150623-W-Eastbourne-R32-Madison_Keys-Belinda_Bencic,2,B-XC,5,1,0,0,1,3,2
20150623-W-Eastbourne-R32-Madison_Keys-Belinda_Bencic,2,B-DTM,9,3,0,0,3,3,6
20150623-W-Eastbourne-R32-Madison_Keys-Belinda_Bencic,2,B-DTL,4,1,0,0,1,3,1
20150623-W-Eastbourne-R32-Madison_Keys-Belinda_Bencic,2,B-IO,2,2,0,1,1,1,1
20150623-W-Eastbourne-R32-Madison_Keys-Belinda_Bencic,2,S-DTM,1,0,0,0,0,1,0
20150623-W-Eastbourne-R32-Madison_Keys-Belinda_Bencic,2,S-DTL,1,0,0,0,0,0,1
20150412-W-Charleston-F-Madison_Keys-Angelique_Kerber,1,F-XC,91,19,6,1,12,45,46
20150412-W-Charleston-F-Madison_Keys-Angelique_Kerber,1,F-DTM,37,6,0,0,6,10,27
20150412-W-Charleston-F-Madison_Keys-Angelique_Kerber,1,F-DTL,11,5,3,0,2,7,4
20150412-W-Charleston-F-Madison_Keys-Angelique_Kerber,1,F-IO,43,28,14,4,10,25,18
20150412-W-Charleston-F-Madison_Keys-Angelique_Kerber,1,F-II,2,1,0,0,1,1,1
20150412-W-Charleston-F-Madison_Keys-Angelique_Kerber,1,B-XC,104,24,5,2,17,36,68
20150412-W-Charleston-F-Madison_Keys-Angelique_Kerber,1,B-DTM,56,10,0,0,10,18,38
20150412-W-Charleston-F-Madison_Keys-Angelique_Kerber,1,B-DTL,12,12,2,0,10,2,10
20150412-W-Charleston-F-Madison_Keys-Angelique_Kerber,1,B-IO,12,7,4,0,3,6,6
20150412-W-Charleston-F-Madison_Keys-Angelique_Kerber,1,S-XC,3,0,0,0,0,0,3
20150412-W-Charleston-F-Madison_Keys-Angelique_Kerber,1,S-DTM,2,1,0,1,0,1,1
20150412-W-Charleston-F-Madison_Keys-Angelique_Kerber,1,S-DTL,2,0,0,0,0,1,1
20150412-W-Charleston-F-Madison_Keys-Angelique_Kerber,1,S-IO,2,0,0,0,0,1,1
20150412-W-Charleston-F-Madison_Keys-Angelique_Kerber,2,F-XC,105,8,1,1,6,65,40
20150412-W-Charleston-F-Madison_Keys-Angelique_Kerber,2,F-DTM,50,4,1,0,3,26,24
20150412-W-Charleston-F-Madison_Keys-Angelique_Kerber,2,F-DTL,26,12,5,3,4,19,7
20150412-W-Charleston-F-Madison_Keys-Angelique_Kerber,2,F-IO,20,6,2,2,2,11,9
20150412-W-Charleston-F-Madison_Keys-Angelique_Kerber,2,B-XC,49,8,2,1,5,24,25
20150412-W-Charleston-F-Madison_Keys-Angelique_Kerber,2,B-DTM,55,2,0,0,2,34,21
20150412-W-Charleston-F-Madison_Keys-Angelique_Kerber,2,B-DTL,8,0,0,0,0,4,4
20150412-W-Charleston-F-Madison_Keys-Angelique_Kerber,2,B-IO,17,0,0,0,0,15,2
20150412-W-Charleston-F-Madison_Keys-Angelique_Kerber,2,S-XC,6,1,0,0,1,1,5
20150412-W-Charleston-F-Madison_Keys-Angelique_Kerber,2,S-DTM,6,0,0,0,0,2,4
20150412-W-Charleston-F-Madison_Keys-Angelique_Kerber,2,S-DTL,3,0,0,0,0,1,2
20150412-W-Charleston-F-Madison_Keys-Angelique_Kerber,2,S-IO,4,2,1,0,1,3,1
20150512-W-Rome-R64-Flavia_Pennetta-Elina_Svitolina,1,F-XC,36,5,0,1,4,12,24
20150512-W-Rome-R64-Flavia_Pennetta-Elina_Svitolina,1,F-DTM,32,1,1,0,0,15,17
20150512-W-Rome-R64-Flavia_Pennetta-Elina_Svitolina,1,F-DTL,9,2,1,0,1,3,6
20150512-W-Rome-R64-Flavia_Pennetta-Elina_Svitolina,1,F-IO,8,3,1,0,2,4,4
20150512-W-Rome-R64-Flavia_Pennetta-Elina_Svitolina,1,B-XC,53,12,2,3,7,23,30
20150512-W-Rome-R64-Flavia_Pennetta-Elina_Svitolina,1,B-DTM,43,2,0,0,2,18,25
20150512-W-Rome-R64-Flavia_Pennetta-Elina_Svitolina,1,B-DTL,15,7,2,1,4,6,9
20150512-W-Rome-R64-Flavia_Pennetta-Elina_Svitolina,1,B-IO,4,2,0,0,2,1,3
20150512-W-Rome-R64-Flavia_Pennetta-Elina_Svitolina,1,S-DTM,3,0,0,0,0,0,3
20150512-W-Rome-R64-Flavia_Pennetta-Elina_Svitolina,2,F-XC,31,10,4,2,4,19,12
20150512-W-Rome-R64-Flavia_Pennetta-Elina_Svitolina,2,F-DTM,29,2,0,1,1,19,10
20150512-W-Rome-R64-Flavia_Pennetta-Elina_Svitolina,2,F-DTL,9,3,0,0,3,3,6
20150512-W-Rome-R64-Flavia_Pennetta-Elina_Svitolina,2,F-IO,27,6,5,0,1,20,7
20150512-W-Rome-R64-Flavia_Pennetta-Elina_Svitolina,2,B-XC,31,6,3,1,2,17,14
20150512-W-Rome-R64-Flavia_Pennetta-Elina_Svitolina,2,B-DTM,35,4,0,0,4,18,17
20150512-W-Rome-R64-Flavia_Pennetta-Elina_Svitolina,2,B-DTL,15,7,3,2,2,12,3
20150512-W-Rome-R64-Flavia_Pennetta-Elina_Svitolina,2,B-IO,10,4,1,0,3,7,3
20150512-W-Rome-R64-Flavia_Pennetta-Elina_Svitolina,2,S-XC,3,1,1,0,0,2,1
20150512-W-Rome-R64-Flavia_Pennetta-Elina_Svitolina,2,S-DTM,3,0,0,0,0,0,3
20150611-W-s_Hertogenbosch-R16-Jelena_Jankovic-Andrea_Hlavackova,1,F-XC,4,1,0,1,0,2,2
20150611-W-s_Hertogenbosch-R16-Jelena_Jankovic-Andrea_Hlavackova,1,F-DTM,5,1,0,0,1,2,3
20150611-W-s_Hertogenbosch-R16-Jelena_Jankovic-Andrea_Hlavackova,1,F-DTL,8,5,0,2,3,3,5
20150611-W-s_Hertogenbosch-R16-Jelena_Jankovic-Andrea_Hlavackova,1,F-IO,10,6,1,1,4,5,5
20150611-W-s_Hertogenbosch-R16-Jelena_Jankovic-Andrea_Hlavackova,1,B-XC,8,1,0,0,1,5,3
20150611-W-s_Hertogenbosch-R16-Jelena_Jankovic-Andrea_Hlavackova,1,B-DTM,10,2,0,1,1,5,5
20150611-W-s_Hertogenbosch-R16-Jelena_Jankovic-Andrea_Hlavackova,1,B-DTL,5,3,3,0,0,4,1
20150611-W-s_Hertogenbosch-R16-Jelena_Jankovic-Andrea_Hlavackova,1,B-IO,6,3,1,1,1,5,1
20150611-W-s_Hertogenbosch-R16-Jelena_Jankovic-Andrea_Hlavackova,1,S-XC,5,0,0,0,0,2,3
20150611-W-s_Hertogenbosch-R16-Jelena_Jankovic-Andrea_Hlavackova,1,S-DTM,2,0,0,0,0,2,0
20150611-W-s_Hertogenbosch-R16-Jelena_Jankovic-Andrea_Hlavackova,2,F-XC,17,7,1,1,5,9,8
20150611-W-s_Hertogenbosch-R16-Jelena_Jankovic-Andrea_Hlavackova,2,F-DTM,7,2,0,1,1,3,4
20150611-W-s_Hertogenbosch-R16-Jelena_Jankovic-Andrea_Hlavackova,2,F-DTL,1,1,1,0,0,1,0
20150611-W-s_Hertogenbosch-R16-Jelena_Jankovic-Andrea_Hlavackova,2,F-IO,7,3,2,0,1,3,4
20150611-W-s_Hertogenbosch-R16-Jelena_Jankovic-Andrea_Hlavackova,2,F-II,2,1,0,1,0,2,0
20150611-W-s_Hertogenbosch-R16-Jelena_Jankovic-Andrea_Hlavackova,2,B-XC,15,7,4,1,2,9,6
20150611-W-s_Hertogenbosch-R16-Jelena_Jankovic-Andrea_Hlavackova,2,B-DTM,12,1,0,0,1,4,8
20150611-W-s_Hertogenbosch-R16-Jelena_Jankovic-Andrea_Hlavackova,2,B-DTL,6,5,1,0,4,2,4
20150611-W-s_Hertogenbosch-R16-Jelena_Jankovic-Andrea_Hlavackova,2,B-IO,1,0,0,0,0,1,0
20150611-W-s_Hertogenbosch-R16-Anastasia_Pavlyuchenkova-Kiki_Bertens,1,F-XC,19,6,2,1,3,9,10
20150611-W-s_Hertogenbosch-R16-Anastasia_Pavlyuchenkova-Kiki_Bertens,1,F-DTM,18,1,0,0,1,11,7
20150611-W-s_Hertogenbosch-R16-Anastasia_Pavlyuchenkova-Kiki_Bertens,1,F-DTL,10,4,1,0,3,4,6
20150611-W-s_Hertogenbosch-R16-Anastasia_Pavlyuchenkova-Kiki_Bertens,1,F-IO,11,5,1,0,4,3,8
20150611-W-s_Hertogenbosch-R16-Anastasia_Pavlyuchenkova-Kiki_Bertens,1,F-II,1,0,0,0,0,0,1
20150611-W-s_Hertogenbosch-R16-Anastasia_Pavlyuchenkova-Kiki_Bertens,1,B-XC,16,5,0,0,5,6,10
20150611-W-s_Hertogenbosch-R16-Anastasia_Pavlyuchenkova-Kiki_Bertens,1,B-DTM,13,2,0,1,1,4,9
20150611-W-s_Hertogenbosch-R16-Anastasia_Pavlyuchenkova-Kiki_Bertens,1,B-DTL,4,0,0,0,0,0,4
20150611-W-s_Hertogenbosch-R16-Anastasia_Pavlyuchenkova-Kiki_Bertens,1,B-IO,5,1,0,0,1,1,4
20150611-W-s_Hertogenbosch-R16-Anastasia_Pavlyuchenkova-Kiki_Bertens,1,S-XC,4,2,0,1,1,2,2
20150611-W-s_Hertogenbosch-R16-Anastasia_Pavlyuchenkova-Kiki_Bertens,2,F-XC,18,4,0,1,3,9,9
20150611-W-s_Hertogenbosch-R16-Anastasia_Pavlyuchenkova-Kiki_Bertens,2,F-DTM,18,3,1,1,1,10,8
20150611-W-s_Hertogenbosch-R16-Anastasia_Pavlyuchenkova-Kiki_Bertens,2,F-DTL,11,5,3,0,2,7,4
20150611-W-s_Hertogenbosch-R16-Anastasia_Pavlyuchenkova-Kiki_Bertens,2,F-IO,10,4,1,1,2,6,4
20150611-W-s_Hertogenbosch-R16-Anastasia_Pavlyuchenkova-Kiki_Bertens,2,F-II,1,1,1,0,0,1,0
20150611-W-s_Hertogenbosch-R16-Anastasia_Pavlyuchenkova-Kiki_Bertens,2,B-XC,8,3,2,0,1,6,2
20150611-W-s_Hertogenbosch-R16-Anastasia_Pavlyuchenkova-Kiki_Bertens,2,B-DTM,13,3,0,0,3,7,6
20150611-W-s_Hertogenbosch-R16-Anastasia_Pavlyuchenkova-Kiki_Bertens,2,B-DTL,4,2,0,0,2,0,4
20150611-W-s_Hertogenbosch-R16-Anastasia_Pavlyuchenkova-Kiki_Bertens,2,B-IO,3,1,0,0,1,1,2
20150611-W-s_Hertogenbosch-R16-Anastasia_Pavlyuchenkova-Kiki_Bertens,2,S-XC,8,1,0,0,1,5,3
20150611-W-s_Hertogenbosch-R16-Anastasia_Pavlyuchenkova-Kiki_Bertens,2,S-DTM,9,1,0,1,0,6,3
20150611-W-s_Hertogenbosch-R16-Anastasia_Pavlyuchenkova-Kiki_Bertens,2,S-DTL,1,0,0,0,0,0,1
20150611-W-s_Hertogenbosch-R16-Anastasia_Pavlyuchenkova-Kiki_Bertens,2,S-IO,1,0,0,0,0,0,1
20150621-W-Birmingham-F-Karolina_Pliskova-Angelique_Kerber,1,F-XC,58,15,8,4,3,33,25
20150621-W-Birmingham-F-Karolina_Pliskova-Angelique_Kerber,1,F-DTM,13,2,0,0,2,2,11
20150621-W-Birmingham-F-Karolina_Pliskova-Angelique_Kerber,1,F-DTL,26,11,2,2,7,10,16
20150621-W-Birmingham-F-Karolina_Pliskova-Angelique_Kerber,1,F-IO,39,16,4,4,8,18,21
20150621-W-Birmingham-F-Karolina_Pliskova-Angelique_Kerber,1,F-II,3,1,0,1,0,1,2
20150621-W-Birmingham-F-Karolina_Pliskova-Angelique_Kerber,1,B-XC,55,16,9,1,6,18,37
20150621-W-Birmingham-F-Karolina_Pliskova-Angelique_Kerber,1,B-DTM,29,1,0,1,0,10,19
20150621-W-Birmingham-F-Karolina_Pliskova-Angelique_Kerber,1,B-DTL,26,12,3,3,6,12,14
20150621-W-Birmingham-F-Karolina_Pliskova-Angelique_Kerber,1,B-IO,18,6,2,3,1,12,6
20150621-W-Birmingham-F-Karolina_Pliskova-Angelique_Kerber,1,S-XC,9,1,0,0,1,1,8
20150621-W-Birmingham-F-Karolina_Pliskova-Angelique_Kerber,1,S-DTM,11,0,0,0,0,1,10
20150621-W-Birmingham-F-Karolina_Pliskova-Angelique_Kerber,1,S-DTL,1,0,0,0,0,1,0
20150621-W-Birmingham-F-Karolina_Pliskova-Angelique_Kerber,1,S-IO,2,0,0,0,0,1,1
20150621-W-Birmingham-F-Karolina_Pliskova-Angelique_Kerber,2,F-XC,70,8,3,2,3,46,24
20150621-W-Birmingham-F-Karolina_Pliskova-Angelique_Kerber,2,F-DTM,23,0,0,0,0,13,10
20150621-W-Birmingham-F-Karolina_Pliskova-Angelique_Kerber,2,F-DTL,27,16,10,5,1,23,4
20150621-W-Birmingham-F-Karolina_Pliskova-Angelique_Kerber,2,F-IO,18,10,4,5,1,14,4
20150621-W-Birmingham-F-Karolina_Pliskova-Angelique_Kerber,2,B-XC,51,8,2,3,3,28,23
20150621-W-Birmingham-F-Karolina_Pliskova-Angelique_Kerber,2,B-DTM,36,2,0,0,2,21,15
20150621-W-Birmingham-F-Karolina_Pliskova-Angelique_Kerber,2,B-DTL,14,4,1,2,1,10,4
20150621-W-Birmingham-F-Karolina_Pliskova-Angelique_Kerber,2,B-IO,6,1,0,1,0,5,1
20150621-W-Birmingham-F-Karolina_Pliskova-Angelique_Kerber,2,S-XC,5,0,0,0,0,1,4
20150621-W-Birmingham-F-Karolina_Pliskova-Angelique_Kerber,2,S-DTM,10,1,0,0,1,4,6
20150621-W-Birmingham-F-Karolina_Pliskova-Angelique_Kerber,2,S-DTL,3,0,0,0,0,1,2
20150625-W-Eastbourne-QF-Belinda_Bencic-Johanna_Konta,1,F-XC,31,6,4,0,2,21,10
20150625-W-Eastbourne-QF-Belinda_Bencic-Johanna_Konta,1,F-DTM,34,4,1,0,3,24,10
20150625-W-Eastbourne-QF-Belinda_Bencic-Johanna_Konta,1,F-DTL,17,5,1,3,1,8,9
20150625-W-Eastbourne-QF-Belinda_Bencic-Johanna_Konta,1,F-IO,27,8,6,0,2,23,4
20150625-W-Eastbourne-QF-Belinda_Bencic-Johanna_Konta,1,B-XC,33,6,2,3,1,21,12
20150625-W-Eastbourne-QF-Belinda_Bencic-Johanna_Konta,1,B-DTM,37,4,0,2,2,23,14
20150625-W-Eastbourne-QF-Belinda_Bencic-Johanna_Konta,1,B-DTL,15,4,1,2,1,11,4
20150625-W-Eastbourne-QF-Belinda_Bencic-Johanna_Konta,1,B-IO,17,3,0,0,3,9,8
20150625-W-Eastbourne-QF-Belinda_Bencic-Johanna_Konta,1,S-XC,3,0,0,0,0,1,2
20150625-W-Eastbourne-QF-Belinda_Bencic-Johanna_Konta,2,F-XC,47,15,5,3,7,20,27
20150625-W-Eastbourne-QF-Belinda_Bencic-Johanna_Konta,2,F-DTM,18,2,0,0,2,4,14
20150625-W-Eastbourne-QF-Belinda_Bencic-Johanna_Konta,2,F-DTL,8,4,2,0,2,3,5
20150625-W-Eastbourne-QF-Belinda_Bencic-Johanna_Konta,2,F-IO,18,5,2,0,3,7,11
20150625-W-Eastbourne-QF-Belinda_Bencic-Johanna_Konta,2,F-II,2,2,1,1,0,2,0
20150625-W-Eastbourne-QF-Belinda_Bencic-Johanna_Konta,2,B-XC,43,13,5,0,8,18,25
20150625-W-Eastbourne-QF-Belinda_Bencic-Johanna_Konta,2,B-DTM,32,5,0,1,4,7,25
20150625-W-Eastbourne-QF-Belinda_Bencic-Johanna_Konta,2,B-DTL,12,7,5,0,2,8,4
20150625-W-Eastbourne-QF-Belinda_Bencic-Johanna_Konta,2,B-IO,7,3,0,0,3,1,6
20150625-W-Eastbourne-QF-Belinda_Bencic-Johanna_Konta,2,S-XC,6,0,0,0,0,1,5
20150625-W-Eastbourne-QF-Belinda_Bencic-Johanna_Konta,2,S-DTM,9,1,0,0,1,2,7
20150625-W-Eastbourne-QF-Belinda_Bencic-Johanna_Konta,2,S-DTL,1,1,1,0,0,1,0
20150630-W-Wimbledon-R128-Elina_Svitolina-Misaki_Doi,1,F-XC,28,6,1,0,5,13,15
20150630-W-Wimbledon-R128-Elina_Svitolina-Misaki_Doi,1,F-DTM,43,4,0,0,4,19,24
20150630-W-Wimbledon-R128-Elina_Svitolina-Misaki_Doi,1,F-DTL,8,2,2,0,0,5,3
20150630-W-Wimbledon-R128-Elina_Svitolina-Misaki_Doi,1,F-IO,14,5,2,1,2,10,4
20150630-W-Wimbledon-R128-Elina_Svitolina-Misaki_Doi,1,B-XC,33,8,3,0,5,19,14
20150630-W-Wimbledon-R128-Elina_Svitolina-Misaki_Doi,1,B-DTM,48,3,0,0,3,22,26
20150630-W-Wimbledon-R128-Elina_Svitolina-Misaki_Doi,1,B-DTL,1,1,1,0,0,1,0
20150630-W-Wimbledon-R128-Elina_Svitolina-Misaki_Doi,1,B-IO,6,2,1,0,1,4,2
20150630-W-Wimbledon-R128-Elina_Svitolina-Misaki_Doi,1,S-XC,1,0,0,0,0,0,1
20150630-W-Wimbledon-R128-Elina_Svitolina-Misaki_Doi,1,S-DTM,1,0,0,0,0,1,0
20150630-W-Wimbledon-R128-Elina_Svitolina-Misaki_Doi,1,S-DTL,3,0,0,0,0,1,2
20150630-W-Wimbledon-R128-Elina_Svitolina-Misaki_Doi,2,F-XC,62,17,6,2,9,31,31
20150630-W-Wimbledon-R128-Elina_Svitolina-Misaki_Doi,2,F-DTM,41,10,0,0,10,10,31
20150630-W-Wimbledon-R128-Elina_Svitolina-Misaki_Doi,2,F-DTL,13,3,1,0,2,7,6
20150630-W-Wimbledon-R128-Elina_Svitolina-Misaki_Doi,2,F-IO,58,18,9,3,6,38,20
20150630-W-Wimbledon-R128-Elina_Svitolina-Misaki_Doi,2,F-II,2,1,1,0,0,2,0
20150630-W-Wimbledon-R128-Elina_Svitolina-Misaki_Doi,2,B-XC,17,9,3,2,4,10,7
20150630-W-Wimbledon-R128-Elina_Svitolina-Misaki_Doi,2,B-DTM,15,5,0,0,5,3,12
20150630-W-Wimbledon-R128-Elina_Svitolina-Misaki_Doi,2,B-DTL,6,1,1,0,0,4,2
20150630-W-Wimbledon-R128-Elina_Svitolina-Misaki_Doi,2,B-IO,2,0,0,0,0,2,0
20150630-W-Wimbledon-R128-Elina_Svitolina-Misaki_Doi,2,S-XC,2,0,0,0,0,0,2
20150630-W-Wimbledon-R128-Elina_Svitolina-Misaki_Doi,2,S-DTM,6,0,0,0,0,1,5
20040703-W-Wimbledon-F-Maria_Sharapova-Serena_Williams,1,F-XC,31,8,2,1,5,20,11
20040703-W-Wimbledon-F-Maria_Sharapova-Serena_Williams,1,F-DTM,19,3,2,0,1,14,5
20040703-W-Wimbledon-F-Maria_Sharapova-Serena_Williams,1,F-DTL,13,6,2,1,3,8,5
20040703-W-Wimbledon-F-Maria_Sharapova-Serena_Williams,1,F-IO,8,2,1,0,1,4,4
20040703-W-Wimbledon-F-Maria_Sharapova-Serena_Williams,1,B-XC,25,7,3,1,3,17,8
20040703-W-Wimbledon-F-Maria_Sharapova-Serena_Williams,1,B-DTM,22,3,0,3,0,14,8
20040703-W-Wimbledon-F-Maria_Sharapova-Serena_Williams,1,B-DTL,3,3,0,1,2,1,2
20040703-W-Wimbledon-F-Maria_Sharapova-Serena_Williams,1,B-IO,3,0,0,0,0,2,1
20040703-W-Wimbledon-F-Maria_Sharapova-Serena_Williams,1,S-DTM,2,0,0,0,0,1,1
20040703-W-Wimbledon-F-Maria_Sharapova-Serena_Williams,2,F-XC,39,9,1,0,8,13,26
20040703-W-Wimbledon-F-Maria_Sharapova-Serena_Williams,2,F-DTM,15,2,0,0,2,4,11
20040703-W-Wimbledon-F-Maria_Sharapova-Serena_Williams,2,F-DTL,1,0,0,0,0,1,0
20040703-W-Wimbledon-F-Maria_Sharapova-Serena_Williams,2,F-IO,7,1,0,0,1,2,5
20040703-W-Wimbledon-F-Maria_Sharapova-Serena_Williams,2,B-XC,23,8,2,1,5,11,12
20040703-W-Wimbledon-F-Maria_Sharapova-Serena_Williams,2,B-DTM,26,1,0,0,1,5,21
20040703-W-Wimbledon-F-Maria_Sharapova-Serena_Williams,2,B-DTL,6,4,3,0,1,3,3
20040703-W-Wimbledon-F-Maria_Sharapova-Serena_Williams,2,B-IO,2,0,0,0,0,0,2
20040703-W-Wimbledon-F-Maria_Sharapova-Serena_Williams,2,S-XC,1,0,0,0,0,1,0
20150630-W-Wimbledon-R128-Petra_Kvitova-Kiki_Bertens,1,F-XC,8,5,3,1,1,7,1
20150630-W-Wimbledon-R128-Petra_Kvitova-Kiki_Bertens,1,F-DTM,5,0,0,0,0,4,1
20150630-W-Wimbledon-R128-Petra_Kvitova-Kiki_Bertens,1,F-IO,8,4,1,3,0,7,1
20150630-W-Wimbledon-R128-Petra_Kvitova-Kiki_Bertens,1,B-XC,10,4,0,3,1,8,2
20150630-W-Wimbledon-R128-Petra_Kvitova-Kiki_Bertens,1,B-DTM,6,0,0,0,0,4,2
20150630-W-Wimbledon-R128-Petra_Kvitova-Kiki_Bertens,1,B-DTL,2,2,2,0,0,2,0
20150630-W-Wimbledon-R128-Petra_Kvitova-Kiki_Bertens,1,B-IO,2,1,0,1,0,2,0
20150630-W-Wimbledon-R128-Petra_Kvitova-Kiki_Bertens,1,S-DTM,1,0,0,0,0,1,0
20150630-W-Wimbledon-R128-Petra_Kvitova-Kiki_Bertens,2,F-XC,8,2,0,1,1,2,6
20150630-W-Wimbledon-R128-Petra_Kvitova-Kiki_Bertens,2,F-DTM,13,3,1,0,2,3,10
20150630-W-Wimbledon-R128-Petra_Kvitova-Kiki_Bertens,2,F-DTL,3,3,1,1,1,2,1
20150630-W-Wimbledon-R128-Petra_Kvitova-Kiki_Bertens,2,F-IO,3,2,0,0,2,1,2
20150630-W-Wimbledon-R128-Petra_Kvitova-Kiki_Bertens,2,B-XC,1,1,0,0,1,0,1
20150630-W-Wimbledon-R128-Petra_Kvitova-Kiki_Bertens,2,B-DTM,8,2,0,0,2,2,6
20150630-W-Wimbledon-R128-Petra_Kvitova-Kiki_Bertens,2,B-DTL,3,2,0,0,2,0,3
20150630-W-Wimbledon-R128-Petra_Kvitova-Kiki_Bertens,2,B-IO,2,0,0,0,0,0,2
20150630-W-Wimbledon-R128-Petra_Kvitova-Kiki_Bertens,2,S-DTM,2,0,0,0,0,1,1
20150701-W-Wimbledon-R64-Coco_Vandeweghe-Karolina_Pliskova,1,F-XC,23,11,7,1,3,14,9
20150701-W-Wimbledon-R64-Coco_Vandeweghe-Karolina_Pliskova,1,F-DTM,19,0,0,0,0,13,6
20150701-W-Wimbledon-R64-Coco_Vandeweghe-Karolina_Pliskova,1,F-DTL,11,6,0,0,6,3,8
20150701-W-Wimbledon-R64-Coco_Vandeweghe-Karolina_Pliskova,1,F-IO,2,2,0,0,2,0,2
20150701-W-Wimbledon-R64-Coco_Vandeweghe-Karolina_Pliskova,1,B-XC,17,5,3,1,1,14,3
20150701-W-Wimbledon-R64-Coco_Vandeweghe-Karolina_Pliskova,1,B-DTM,19,3,0,1,2,13,6
20150701-W-Wimbledon-R64-Coco_Vandeweghe-Karolina_Pliskova,1,B-DTL,1,1,0,0,1,0,1
20150701-W-Wimbledon-R64-Coco_Vandeweghe-Karolina_Pliskova,1,B-IO,3,1,1,0,0,2,1
20150701-W-Wimbledon-R64-Coco_Vandeweghe-Karolina_Pliskova,1,S-XC,3,1,0,0,1,2,1
20150701-W-Wimbledon-R64-Coco_Vandeweghe-Karolina_Pliskova,1,S-DTM,3,1,0,0,1,2,1
20150701-W-Wimbledon-R64-Coco_Vandeweghe-Karolina_Pliskova,1,S-DTL,3,0,0,0,0,3,0
20150701-W-Wimbledon-R64-Coco_Vandeweghe-Karolina_Pliskova,1,S-IO,1,0,0,0,0,1,0
20150701-W-Wimbledon-R64-Coco_Vandeweghe-Karolina_Pliskova,2,F-XC,25,10,4,1,5,9,16
20150701-W-Wimbledon-R64-Coco_Vandeweghe-Karolina_Pliskova,2,F-DTM,11,2,0,0,2,2,9
20150701-W-Wimbledon-R64-Coco_Vandeweghe-Karolina_Pliskova,2,F-DTL,1,1,0,0,1,0,1
20150701-W-Wimbledon-R64-Coco_Vandeweghe-Karolina_Pliskova,2,F-IO,15,8,1,1,6,4,11
20150701-W-Wimbledon-R64-Coco_Vandeweghe-Karolina_Pliskova,2,B-XC,17,7,1,0,6,5,12
20150701-W-Wimbledon-R64-Coco_Vandeweghe-Karolina_Pliskova,2,B-DTM,17,4,0,1,3,4,13
20150701-W-Wimbledon-R64-Coco_Vandeweghe-Karolina_Pliskova,2,B-DTL,3,3,1,1,1,2,1
20150701-W-Wimbledon-R64-Coco_Vandeweghe-Karolina_Pliskova,2,B-IO,11,5,4,0,1,9,2
20150701-W-Wimbledon-R64-Coco_Vandeweghe-Karolina_Pliskova,2,S-XC,6,1,0,1,0,3,3
20150701-W-Wimbledon-R64-Coco_Vandeweghe-Karolina_Pliskova,2,S-DTM,1,0,0,0,0,0,1
20150701-W-Wimbledon-R64-Coco_Vandeweghe-Karolina_Pliskova,2,S-IO,1,0,0,0,0,0,1
20150703-W-Wimbledon-R32-Maria_Sharapova-Irina_Camelia_Begu,1,F-XC,12,2,0,1,1,6,6
20150703-W-Wimbledon-R32-Maria_Sharapova-Irina_Camelia_Begu,1,F-DTM,18,4,0,1,3,9,9
20150703-W-Wimbledon-R32-Maria_Sharapova-Irina_Camelia_Begu,1,F-DTL,6,1,0,1,0,4,2
20150703-W-Wimbledon-R32-Maria_Sharapova-Irina_Camelia_Begu,1,F-IO,13,5,4,0,1,11,2
20150703-W-Wimbledon-R32-Maria_Sharapova-Irina_Camelia_Begu,1,B-XC,16,5,0,0,5,8,8
20150703-W-Wimbledon-R32-Maria_Sharapova-Irina_Camelia_Begu,1,B-DTM,24,1,0,0,1,14,10
20150703-W-Wimbledon-R32-Maria_Sharapova-Irina_Camelia_Begu,1,B-DTL,7,2,1,1,0,5,2
20150703-W-Wimbledon-R32-Maria_Sharapova-Irina_Camelia_Begu,1,S-DTM,1,0,0,0,0,1,0
20150703-W-Wimbledon-R32-Maria_Sharapova-Irina_Camelia_Begu,2,F-XC,22,8,3,0,5,11,11
20150703-W-Wimbledon-R32-Maria_Sharapova-Irina_Camelia_Begu,2,F-DTM,13,2,0,0,2,4,9
20150703-W-Wimbledon-R32-Maria_Sharapova-Irina_Camelia_Begu,2,F-DTL,5,2,0,0,2,2,3
20150703-W-Wimbledon-R32-Maria_Sharapova-Irina_Camelia_Begu,2,F-IO,24,5,2,2,1,13,11
20150703-W-Wimbledon-R32-Maria_Sharapova-Irina_Camelia_Begu,2,B-XC,18,8,1,1,6,6,12
20150703-W-Wimbledon-R32-Maria_Sharapova-Irina_Camelia_Begu,2,B-DTM,13,2,0,0,2,3,10
20150703-W-Wimbledon-R32-Maria_Sharapova-Irina_Camelia_Begu,2,B-DTL,1,0,0,0,0,0,1
20150703-W-Wimbledon-R32-Maria_Sharapova-Irina_Camelia_Begu,2,B-IO,6,3,0,0,3,2,4
20150703-W-Wimbledon-R32-Maria_Sharapova-Irina_Camelia_Begu,2,S-XC,2,0,0,0,0,0,2
20150703-W-Wimbledon-R32-Maria_Sharapova-Irina_Camelia_Begu,2,S-DTM,7,2,0,1,1,2,5
20150703-W-Wimbledon-R32-Maria_Sharapova-Irina_Camelia_Begu,2,S-DTL,4,0,0,0,0,3,1
20150701-W-Wimbledon-R64-Kristina_Mladenovic-Jelena_Ostapenko,1,F-XC,11,4,2,0,2,4,7
20150701-W-Wimbledon-R64-Kristina_Mladenovic-Jelena_Ostapenko,1,F-DTM,3,1,0,0,1,0,3
20150701-W-Wimbledon-R64-Kristina_Mladenovic-Jelena_Ostapenko,1,F-DTL,4,2,1,0,1,3,1
20150701-W-Wimbledon-R64-Kristina_Mladenovic-Jelena_Ostapenko,1,F-IO,5,1,1,0,0,3,2
20150701-W-Wimbledon-R64-Kristina_Mladenovic-Jelena_Ostapenko,1,B-XC,5,1,1,0,0,2,3
20150701-W-Wimbledon-R64-Kristina_Mladenovic-Jelena_Ostapenko,1,B-DTM,21,4,0,0,4,6,15
20150701-W-Wimbledon-R64-Kristina_Mladenovic-Jelena_Ostapenko,1,B-DTL,1,0,0,0,0,1,0
20150701-W-Wimbledon-R64-Kristina_Mladenovic-Jelena_Ostapenko,1,B-IO,2,1,0,0,1,0,2
20150701-W-Wimbledon-R64-Kristina_Mladenovic-Jelena_Ostapenko,1,S-XC,1,0,0,0,0,1,0
20150701-W-Wimbledon-R64-Kristina_Mladenovic-Jelena_Ostapenko,1,S-DTM,10,1,0,0,1,1,9
20150701-W-Wimbledon-R64-Kristina_Mladenovic-Jelena_Ostapenko,2,F-XC,18,11,4,3,4,10,8
20150701-W-Wimbledon-R64-Kristina_Mladenovic-Jelena_Ostapenko,2,F-DTM,4,0,0,0,0,0,4
20150701-W-Wimbledon-R64-Kristina_Mladenovic-Jelena_Ostapenko,2,F-DTL,7,5,2,2,1,6,1
20150701-W-Wimbledon-R64-Kristina_Mladenovic-Jelena_Ostapenko,2,F-IO,9,3,2,0,1,5,4
20150701-W-Wimbledon-R64-Kristina_Mladenovic-Jelena_Ostapenko,2,B-XC,25,6,1,0,5,13,12
20150701-W-Wimbledon-R64-Kristina_Mladenovic-Jelena_Ostapenko,2,B-DTM,19,5,0,0,5,11,8
20150701-W-Wimbledon-R64-Kristina_Mladenovic-Jelena_Ostapenko,2,B-DTL,5,5,2,0,3,2,3
20150701-W-Wimbledon-R64-Kristina_Mladenovic-Jelena_Ostapenko,2,B-IO,1,1,0,0,1,0,1
20150701-W-Wimbledon-R64-Kristina_Mladenovic-Jelena_Ostapenko,2,S-DTM,2,0,0,0,0,1,1
20150706-W-Wimbledon-R16-Venus_Williams-Serena_Williams,1,F-XC,18,8,4,1,3,9,9
20150706-W-Wimbledon-R16-Venus_Williams-Serena_Williams,1,F-DTM,19,4,0,1,3,7,12
20150706-W-Wimbledon-R16-Venus_Williams-Serena_Williams,1,F-DTL,4,3,2,0,1,3,1
20150706-W-Wimbledon-R16-Venus_Williams-Serena_Williams,1,F-IO,12,5,3,1,1,8,4
20150706-W-Wimbledon-R16-Venus_Williams-Serena_Williams,1,B-XC,10,3,0,1,2,4,6
20150706-W-Wimbledon-R16-Venus_Williams-Serena_Williams,1,B-DTM,20,1,0,0,1,7,13
20150706-W-Wimbledon-R16-Venus_Williams-Serena_Williams,1,B-DTL,3,1,0,0,1,0,3
20150706-W-Wimbledon-R16-Venus_Williams-Serena_Williams,1,S-DTM,3,0,0,0,0,2,1
20150706-W-Wimbledon-R16-Venus_Williams-Serena_Williams,2,F-XC,13,8,5,1,2,8,5
20150706-W-Wimbledon-R16-Venus_Williams-Serena_Williams,2,F-DTM,18,4,0,1,3,9,9
20150706-W-Wimbledon-R16-Venus_Williams-Serena_Williams,2,F-DTL,2,2,2,0,0,2,0
20150706-W-Wimbledon-R16-Venus_Williams-Serena_Williams,2,F-IO,7,5,3,1,1,6,1
20150706-W-Wimbledon-R16-Venus_Williams-Serena_Williams,2,B-XC,11,5,3,1,1,7,4
20150706-W-Wimbledon-R16-Venus_Williams-Serena_Williams,2,B-DTM,24,3,2,0,1,11,13
20150706-W-Wimbledon-R16-Venus_Williams-Serena_Williams,2,B-DTL,3,1,1,0,0,3,0
20150706-W-Wimbledon-R16-Venus_Williams-Serena_Williams,2,B-IO,6,4,3,1,0,5,1
20150706-W-Wimbledon-R16-Venus_Williams-Serena_Williams,2,S-XC,1,0,0,0,0,0,1
20150706-W-Wimbledon-R16-Venus_Williams-Serena_Williams,2,S-DTM,1,0,0,0,0,0,1
20150706-W-Wimbledon-R16-Caroline_Wozniacki-Garbine_Muguruza,1,F-XC,29,5,2,0,3,12,17
20150706-W-Wimbledon-R16-Caroline_Wozniacki-Garbine_Muguruza,1,F-DTM,38,2,0,0,2,16,22
20150706-W-Wimbledon-R16-Caroline_Wozniacki-Garbine_Muguruza,1,F-DTL,16,2,2,0,0,8,8
20150706-W-Wimbledon-R16-Caroline_Wozniacki-Garbine_Muguruza,1,F-IO,20,2,1,0,1,10,10
20150706-W-Wimbledon-R16-Caroline_Wozniacki-Garbine_Muguruza,1,B-XC,30,7,1,0,6,17,13
20150706-W-Wimbledon-R16-Caroline_Wozniacki-Garbine_Muguruza,1,B-DTM,38,2,0,0,2,19,19
20150706-W-Wimbledon-R16-Caroline_Wozniacki-Garbine_Muguruza,1,B-DTL,7,2,0,1,1,2,5
20150706-W-Wimbledon-R16-Caroline_Wozniacki-Garbine_Muguruza,1,B-IO,16,4,2,1,1,11,5
20150706-W-Wimbledon-R16-Caroline_Wozniacki-Garbine_Muguruza,1,S-XC,1,0,0,0,0,1,0
20150706-W-Wimbledon-R16-Caroline_Wozniacki-Garbine_Muguruza,1,S-DTM,8,0,0,0,0,3,5
20150706-W-Wimbledon-R16-Caroline_Wozniacki-Garbine_Muguruza,1,S-DTL,2,0,0,0,0,2,0
20150706-W-Wimbledon-R16-Caroline_Wozniacki-Garbine_Muguruza,1,S-IO,2,0,0,0,0,1,1
20150706-W-Wimbledon-R16-Caroline_Wozniacki-Garbine_Muguruza,2,F-XC,49,10,0,4,6,27,22
20150706-W-Wimbledon-R16-Caroline_Wozniacki-Garbine_Muguruza,2,F-DTM,35,5,0,0,5,17,18
20150706-W-Wimbledon-R16-Caroline_Wozniacki-Garbine_Muguruza,2,F-DTL,5,1,1,0,0,2,3
20150706-W-Wimbledon-R16-Caroline_Wozniacki-Garbine_Muguruza,2,F-IO,10,7,4,1,2,6,4
20150706-W-Wimbledon-R16-Caroline_Wozniacki-Garbine_Muguruza,2,B-XC,51,16,6,2,8,25,26
20150706-W-Wimbledon-R16-Caroline_Wozniacki-Garbine_Muguruza,2,B-DTM,38,5,1,0,4,14,24
20150706-W-Wimbledon-R16-Caroline_Wozniacki-Garbine_Muguruza,2,B-DTL,9,5,2,0,3,4,5
20150706-W-Wimbledon-R16-Caroline_Wozniacki-Garbine_Muguruza,2,B-IO,16,7,2,0,5,8,8
20150706-W-Wimbledon-R16-Caroline_Wozniacki-Garbine_Muguruza,2,S-XC,1,0,0,0,0,1,0
20150706-W-Wimbledon-R16-Caroline_Wozniacki-Garbine_Muguruza,2,S-DTM,2,0,0,0,0,0,2
20150706-W-Wimbledon-R16-Caroline_Wozniacki-Garbine_Muguruza,2,S-DTL,2,0,0,0,0,1,1
20150707-W-Wimbledon-QF-Garbine_Muguruza-Timea_Bacsinszky,1,F-XC,34,8,3,2,3,26,8
20150707-W-Wimbledon-QF-Garbine_Muguruza-Timea_Bacsinszky,1,F-DTM,26,3,0,0,3,13,13
20150707-W-Wimbledon-QF-Garbine_Muguruza-Timea_Bacsinszky,1,F-DTL,4,3,2,0,1,2,2
20150707-W-Wimbledon-QF-Garbine_Muguruza-Timea_Bacsinszky,1,F-IO,6,2,1,0,1,2,4
20150707-W-Wimbledon-QF-Garbine_Muguruza-Timea_Bacsinszky,1,B-XC,25,10,4,1,5,10,15
20150707-W-Wimbledon-QF-Garbine_Muguruza-Timea_Bacsinszky,1,B-DTM,31,1,0,0,1,20,11
20150707-W-Wimbledon-QF-Garbine_Muguruza-Timea_Bacsinszky,1,B-DTL,13,2,0,1,1,8,5
20150707-W-Wimbledon-QF-Garbine_Muguruza-Timea_Bacsinszky,1,B-IO,18,4,2,0,2,12,6
20150707-W-Wimbledon-QF-Garbine_Muguruza-Timea_Bacsinszky,1,S-XC,1,0,0,0,0,0,1
20150707-W-Wimbledon-QF-Garbine_Muguruza-Timea_Bacsinszky,1,S-DTM,2,0,0,0,0,0,2
20150707-W-Wimbledon-QF-Garbine_Muguruza-Timea_Bacsinszky,2,F-XC,21,4,1,0,3,10,11
20150707-W-Wimbledon-QF-Garbine_Muguruza-Timea_Bacsinszky,2,F-DTM,24,4,0,0,4,7,17
20150707-W-Wimbledon-QF-Garbine_Muguruza-Timea_Bacsinszky,2,F-DTL,15,4,0,0,4,2,13
20150707-W-Wimbledon-QF-Garbine_Muguruza-Timea_Bacsinszky,2,F-IO,14,4,1,0,3,5,9
20150707-W-Wimbledon-QF-Garbine_Muguruza-Timea_Bacsinszky,2,B-XC,25,8,4,2,2,18,7
20150707-W-Wimbledon-QF-Garbine_Muguruza-Timea_Bacsinszky,2,B-DTM,18,2,0,0,2,3,15
20150707-W-Wimbledon-QF-Garbine_Muguruza-Timea_Bacsinszky,2,B-DTL,6,3,1,2,0,4,2
20150707-W-Wimbledon-QF-Garbine_Muguruza-Timea_Bacsinszky,2,B-IO,18,11,4,2,5,10,8
20150707-W-Wimbledon-QF-Garbine_Muguruza-Timea_Bacsinszky,2,S-XC,2,1,1,0,0,1,1
20150707-W-Wimbledon-QF-Garbine_Muguruza-Timea_Bacsinszky,2,S-DTM,4,0,0,0,0,2,2
20150704-W-Wimbledon-R32-Camila_Giorgi-Caroline_Wozniacki,1,F-XC,23,9,2,2,5,9,14
20150704-W-Wimbledon-R32-Camila_Giorgi-Caroline_Wozniacki,1,F-DTM,15,5,0,1,4,5,10
20150704-W-Wimbledon-R32-Camila_Giorgi-Caroline_Wozniacki,1,F-DTL,3,2,1,0,1,1,2
20150704-W-Wimbledon-R32-Camila_Giorgi-Caroline_Wozniacki,1,F-IO,6,2,1,0,1,3,3
20150704-W-Wimbledon-R32-Camila_Giorgi-Caroline_Wozniacki,1,F-II,1,0,0,0,0,0,1
20150704-W-Wimbledon-R32-Camila_Giorgi-Caroline_Wozniacki,1,B-XC,26,11,4,1,6,11,15
20150704-W-Wimbledon-R32-Camila_Giorgi-Caroline_Wozniacki,1,B-DTM,18,4,0,3,1,12,6
20150704-W-Wimbledon-R32-Camila_Giorgi-Caroline_Wozniacki,1,B-DTL,2,1,1,0,0,2,0
20150704-W-Wimbledon-R32-Camila_Giorgi-Caroline_Wozniacki,1,B-IO,7,5,3,0,2,4,3
20150704-W-Wimbledon-R32-Camila_Giorgi-Caroline_Wozniacki,1,S-XC,1,0,0,0,0,0,1
20150704-W-Wimbledon-R32-Camila_Giorgi-Caroline_Wozniacki,1,S-DTL,1,0,0,0,0,1,0
20150704-W-Wimbledon-R32-Camila_Giorgi-Caroline_Wozniacki,2,F-XC,13,4,2,2,0,8,5
20150704-W-Wimbledon-R32-Camila_Giorgi-Caroline_Wozniacki,2,F-DTM,21,1,0,1,0,10,11
20150704-W-Wimbledon-R32-Camila_Giorgi-Caroline_Wozniacki,2,F-DTL,7,0,0,0,0,2,5
20150704-W-Wimbledon-R32-Camila_Giorgi-Caroline_Wozniacki,2,F-IO,3,1,0,0,1,0,3
20150704-W-Wimbledon-R32-Camila_Giorgi-Caroline_Wozniacki,2,B-XC,16,4,2,2,0,12,4
20150704-W-Wimbledon-R32-Camila_Giorgi-Caroline_Wozniacki,2,B-DTM,23,3,0,3,0,16,7
20150704-W-Wimbledon-R32-Camila_Giorgi-Caroline_Wozniacki,2,B-DTL,1,1,0,0,1,0,1
20150704-W-Wimbledon-R32-Camila_Giorgi-Caroline_Wozniacki,2,B-IO,6,4,0,2,2,3,3
20150704-W-Wimbledon-R32-Camila_Giorgi-Caroline_Wozniacki,2,B-II,1,0,0,0,0,1,0
20150704-W-Wimbledon-R32-Camila_Giorgi-Caroline_Wozniacki,2,S-XC,1,0,0,0,0,1,0
20150704-W-Wimbledon-R32-Camila_Giorgi-Caroline_Wozniacki,2,S-DTM,5,0,0,0,0,2,3
20150704-W-Wimbledon-R32-Camila_Giorgi-Caroline_Wozniacki,2,S-DTL,2,0,0,0,0,1,1
20150707-W-Wimbledon-QF-Victoria_Azarenka-Serena_Williams,1,F-XC,25,7,3,1,3,13,12
20150707-W-Wimbledon-QF-Victoria_Azarenka-Serena_Williams,1,F-DTM,28,3,0,1,2,15,13
20150707-W-Wimbledon-QF-Victoria_Azarenka-Serena_Williams,1,F-DTL,12,6,2,1,3,7,5
20150707-W-Wimbledon-QF-Victoria_Azarenka-Serena_Williams,1,F-IO,19,7,0,4,3,12,7
20150707-W-Wimbledon-QF-Victoria_Azarenka-Serena_Williams,1,F-II,1,0,0,0,0,1,0
20150707-W-Wimbledon-QF-Victoria_Azarenka-Serena_Williams,1,B-XC,17,1,0,1,0,8,9
20150707-W-Wimbledon-QF-Victoria_Azarenka-Serena_Williams,1,B-DTM,34,2,0,1,1,20,14
20150707-W-Wimbledon-QF-Victoria_Azarenka-Serena_Williams,1,B-DTL,5,3,3,0,0,5,0
20150707-W-Wimbledon-QF-Victoria_Azarenka-Serena_Williams,1,B-IO,5,2,1,1,0,4,1
20150707-W-Wimbledon-QF-Victoria_Azarenka-Serena_Williams,1,S-DTM,9,0,0,0,0,3,6
20150707-W-Wimbledon-QF-Victoria_Azarenka-Serena_Williams,2,F-XC,31,11,3,3,5,18,13
20150707-W-Wimbledon-QF-Victoria_Azarenka-Serena_Williams,2,F-DTM,22,4,0,2,2,11,11
20150707-W-Wimbledon-QF-Victoria_Azarenka-Serena_Williams,2,F-DTL,6,2,1,0,1,2,4
20150707-W-Wimbledon-QF-Victoria_Azarenka-Serena_Williams,2,F-IO,9,7,3,0,4,4,5
20150707-W-Wimbledon-QF-Victoria_Azarenka-Serena_Williams,2,B-XC,22,7,2,3,2,12,10
20150707-W-Wimbledon-QF-Victoria_Azarenka-Serena_Williams,2,B-DTM,38,6,0,1,5,12,26
20150707-W-Wimbledon-QF-Victoria_Azarenka-Serena_Williams,2,B-DTL,10,7,3,1,3,5,5
20150707-W-Wimbledon-QF-Victoria_Azarenka-Serena_Williams,2,B-IO,11,2,2,0,0,4,7
20150707-W-Wimbledon-QF-Victoria_Azarenka-Serena_Williams,2,S-XC,2,1,1,0,0,1,1
20150707-W-Wimbledon-QF-Victoria_Azarenka-Serena_Williams,2,S-DTM,3,1,0,0,1,0,3
20150707-W-Wimbledon-QF-Victoria_Azarenka-Serena_Williams,2,S-IO,1,0,0,0,0,1,0
20150706-W-Wimbledon-R16-Coco_Vandeweghe-Lucie_Safarova,1,F-XC,16,11,4,3,4,10,6
20150706-W-Wimbledon-R16-Coco_Vandeweghe-Lucie_Safarova,1,F-DTM,24,3,0,0,3,13,11
20150706-W-Wimbledon-R16-Coco_Vandeweghe-Lucie_Safarova,1,F-DTL,7,3,3,0,0,4,3
20150706-W-Wimbledon-R16-Coco_Vandeweghe-Lucie_Safarova,1,F-IO,4,2,2,0,0,3,1
20150706-W-Wimbledon-R16-Coco_Vandeweghe-Lucie_Safarova,1,B-XC,22,8,1,5,2,14,8
20150706-W-Wimbledon-R16-Coco_Vandeweghe-Lucie_Safarova,1,B-DTM,32,5,0,1,4,15,17
20150706-W-Wimbledon-R16-Coco_Vandeweghe-Lucie_Safarova,1,B-DTL,5,4,1,0,3,2,3
20150706-W-Wimbledon-R16-Coco_Vandeweghe-Lucie_Safarova,1,B-IO,1,0,0,0,0,0,1
20150706-W-Wimbledon-R16-Coco_Vandeweghe-Lucie_Safarova,1,S-XC,3,0,0,0,0,1,2
20150706-W-Wimbledon-R16-Coco_Vandeweghe-Lucie_Safarova,1,S-DTM,3,0,0,0,0,2,1
20150706-W-Wimbledon-R16-Coco_Vandeweghe-Lucie_Safarova,1,S-DTL,4,1,0,0,1,2,2
20150706-W-Wimbledon-R16-Coco_Vandeweghe-Lucie_Safarova,1,S-IO,1,1,0,0,1,0,1
20150706-W-Wimbledon-R16-Coco_Vandeweghe-Lucie_Safarova,2,F-XC,44,13,9,2,2,27,17
20150706-W-Wimbledon-R16-Coco_Vandeweghe-Lucie_Safarova,2,F-DTM,24,2,0,0,2,12,12
20150706-W-Wimbledon-R16-Coco_Vandeweghe-Lucie_Safarova,2,F-DTL,14,11,3,2,6,8,6
20150706-W-Wimbledon-R16-Coco_Vandeweghe-Lucie_Safarova,2,F-IO,12,9,3,1,5,4,8
20150706-W-Wimbledon-R16-Coco_Vandeweghe-Lucie_Safarova,2,F-II,1,0,0,0,0,1,0
20150706-W-Wimbledon-R16-Coco_Vandeweghe-Lucie_Safarova,2,B-XC,19,5,2,0,3,8,11
20150706-W-Wimbledon-R16-Coco_Vandeweghe-Lucie_Safarova,2,B-DTM,13,2,0,0,2,6,7
20150706-W-Wimbledon-R16-Coco_Vandeweghe-Lucie_Safarova,2,B-DTL,3,3,1,0,2,1,2
20150706-W-Wimbledon-R16-Coco_Vandeweghe-Lucie_Safarova,2,B-IO,5,2,0,1,1,3,2
20150706-W-Wimbledon-R16-Coco_Vandeweghe-Lucie_Safarova,2,S-DTM,1,0,0,0,0,1,0
20150706-W-Wimbledon-R16-Coco_Vandeweghe-Lucie_Safarova,2,S-DTL,1,0,0,0,0,0,1
20150707-W-Wimbledon-QF-Agnieszka_Radwanska-Madison_Keys,1,F-XC,30,3,2,0,1,13,17
20150707-W-Wimbledon-QF-Agnieszka_Radwanska-Madison_Keys,1,F-DTM,34,6,0,0,6,12,22
20150707-W-Wimbledon-QF-Agnieszka_Radwanska-Madison_Keys,1,F-DTL,16,6,2,3,1,11,5
20150707-W-Wimbledon-QF-Agnieszka_Radwanska-Madison_Keys,1,F-IO,28,6,2,3,1,19,9
20150707-W-Wimbledon-QF-Agnieszka_Radwanska-Madison_Keys,1,B-XC,11,4,1,1,2,6,5
20150707-W-Wimbledon-QF-Agnieszka_Radwanska-Madison_Keys,1,B-DTM,42,1,0,0,1,28,14
20150707-W-Wimbledon-QF-Agnieszka_Radwanska-Madison_Keys,1,B-DTL,5,2,0,1,1,3,2
20150707-W-Wimbledon-QF-Agnieszka_Radwanska-Madison_Keys,1,B-IO,7,1,0,1,0,6,1
20150707-W-Wimbledon-QF-Agnieszka_Radwanska-Madison_Keys,1,S-XC,1,0,0,0,0,1,0
20150707-W-Wimbledon-QF-Agnieszka_Radwanska-Madison_Keys,1,S-DTM,6,0,0,0,0,2,4
20150707-W-Wimbledon-QF-Agnieszka_Radwanska-Madison_Keys,1,S-DTL,2,0,0,0,0,1,1
20150707-W-Wimbledon-QF-Agnieszka_Radwanska-Madison_Keys,1,S-IO,2,1,0,0,1,0,2
20150707-W-Wimbledon-QF-Agnieszka_Radwanska-Madison_Keys,2,F-XC,50,19,8,3,8,33,17
20150707-W-Wimbledon-QF-Agnieszka_Radwanska-Madison_Keys,2,F-DTM,31,3,0,0,3,12,19
20150707-W-Wimbledon-QF-Agnieszka_Radwanska-Madison_Keys,2,F-DTL,14,5,2,0,3,9,5
20150707-W-Wimbledon-QF-Agnieszka_Radwanska-Madison_Keys,2,F-IO,42,25,12,2,11,21,21
20150707-W-Wimbledon-QF-Agnieszka_Radwanska-Madison_Keys,2,F-II,2,1,1,0,0,2,0
20150707-W-Wimbledon-QF-Agnieszka_Radwanska-Madison_Keys,2,B-XC,19,4,1,1,2,7,12
20150707-W-Wimbledon-QF-Agnieszka_Radwanska-Madison_Keys,2,B-DTM,40,10,1,2,7,15,25
20150707-W-Wimbledon-QF-Agnieszka_Radwanska-Madison_Keys,2,B-DTL,11,7,0,0,7,3,8
20150707-W-Wimbledon-QF-Agnieszka_Radwanska-Madison_Keys,2,B-IO,8,1,0,1,0,4,4
20150707-W-Wimbledon-QF-Agnieszka_Radwanska-Madison_Keys,2,S-XC,2,1,0,1,0,2,0
20150707-W-Wimbledon-QF-Agnieszka_Radwanska-Madison_Keys,2,S-DTM,4,0,0,0,0,2,2
20150707-W-Wimbledon-QF-Agnieszka_Radwanska-Madison_Keys,2,S-DTL,1,0,0,0,0,0,1
20150711-W-Wimbledon-F-Serena_Williams-Garbine_Muguruza,1,F-XC,14,5,1,2,2,7,7
20150711-W-Wimbledon-F-Serena_Williams-Garbine_Muguruza,1,F-DTM,13,1,0,0,1,5,8
20150711-W-Wimbledon-F-Serena_Williams-Garbine_Muguruza,1,F-DTL,5,2,0,1,1,2,3
20150711-W-Wimbledon-F-Serena_Williams-Garbine_Muguruza,1,F-IO,8,6,3,2,1,7,1
20150711-W-Wimbledon-F-Serena_Williams-Garbine_Muguruza,1,B-XC,11,4,1,2,1,6,5
20150711-W-Wimbledon-F-Serena_Williams-Garbine_Muguruza,1,B-DTM,16,3,0,2,1,8,8
20150711-W-Wimbledon-F-Serena_Williams-Garbine_Muguruza,1,B-DTL,10,2,1,1,0,7,3
20150711-W-Wimbledon-F-Serena_Williams-Garbine_Muguruza,1,B-IO,7,4,2,1,1,5,2
20150711-W-Wimbledon-F-Serena_Williams-Garbine_Muguruza,1,S-DTM,1,0,0,0,0,0,1
20150711-W-Wimbledon-F-Serena_Williams-Garbine_Muguruza,2,F-XC,26,10,1,8,1,17,9
20150711-W-Wimbledon-F-Serena_Williams-Garbine_Muguruza,2,F-DTM,18,3,0,0,3,7,11
20150711-W-Wimbledon-F-Serena_Williams-Garbine_Muguruza,2,F-DTL,3,2,0,0,2,1,2
20150711-W-Wimbledon-F-Serena_Williams-Garbine_Muguruza,2,F-IO,4,2,2,0,0,3,1
20150711-W-Wimbledon-F-Serena_Williams-Garbine_Muguruza,2,B-XC,13,5,1,4,0,7,6
20150711-W-Wimbledon-F-Serena_Williams-Garbine_Muguruza,2,B-DTM,19,2,0,2,0,6,13
20150711-W-Wimbledon-F-Serena_Williams-Garbine_Muguruza,2,B-DTL,2,1,1,0,0,2,0
20150711-W-Wimbledon-F-Serena_Williams-Garbine_Muguruza,2,B-IO,3,2,0,0,2,0,3
20100605-W-Roland_Garros-F-Samantha_Stosur-Francesca_Schiavone,1,F-XC,26,15,8,4,3,17,9
20100605-W-Roland_Garros-F-Samantha_Stosur-Francesca_Schiavone,1,F-DTM,14,2,0,1,1,6,8
20100605-W-Roland_Garros-F-Samantha_Stosur-Francesca_Schiavone,1,F-DTL,8,4,3,0,1,4,4
20100605-W-Roland_Garros-F-Samantha_Stosur-Francesca_Schiavone,1,F-IO,31,10,1,5,4,17,14
20100605-W-Roland_Garros-F-Samantha_Stosur-Francesca_Schiavone,1,F-II,6,6,4,1,1,5,1
20100605-W-Roland_Garros-F-Samantha_Stosur-Francesca_Schiavone,1,B-XC,9,2,0,1,1,3,6
20100605-W-Roland_Garros-F-Samantha_Stosur-Francesca_Schiavone,1,B-DTM,11,0,0,0,0,2,9
20100605-W-Roland_Garros-F-Samantha_Stosur-Francesca_Schiavone,1,B-DTL,5,3,0,1,2,2,3
20100605-W-Roland_Garros-F-Samantha_Stosur-Francesca_Schiavone,1,B-IO,1,1,1,0,0,1,0
20100605-W-Roland_Garros-F-Samantha_Stosur-Francesca_Schiavone,1,S-XC,5,1,0,1,0,2,3
20100605-W-Roland_Garros-F-Samantha_Stosur-Francesca_Schiavone,1,S-DTM,6,0,0,0,0,1,5
20100605-W-Roland_Garros-F-Samantha_Stosur-Francesca_Schiavone,1,S-DTL,2,1,1,0,0,2,0
20100605-W-Roland_Garros-F-Samantha_Stosur-Francesca_Schiavone,1,S-IO,1,0,0,0,0,1,0
20100605-W-Roland_Garros-F-Samantha_Stosur-Francesca_Schiavone,2,F-XC,19,6,3,2,1,13,6
20100605-W-Roland_Garros-F-Samantha_Stosur-Francesca_Schiavone,2,F-DTM,8,0,0,0,0,3,5
20100605-W-Roland_Garros-F-Samantha_Stosur-Francesca_Schiavone,2,F-DTL,7,1,0,1,0,4,3
20100605-W-Roland_Garros-F-Samantha_Stosur-Francesca_Schiavone,2,F-IO,19,4,1,0,3,11,8
20100605-W-Roland_Garros-F-Samantha_Stosur-Francesca_Schiavone,2,F-II,4,2,2,0,0,3,1
20100605-W-Roland_Garros-F-Samantha_Stosur-Francesca_Schiavone,2,B-XC,22,4,1,2,1,13,9
20100605-W-Roland_Garros-F-Samantha_Stosur-Francesca_Schiavone,2,B-DTM,10,2,0,1,1,8,2
20100605-W-Roland_Garros-F-Samantha_Stosur-Francesca_Schiavone,2,B-DTL,3,0,0,0,0,2,1
20100605-W-Roland_Garros-F-Samantha_Stosur-Francesca_Schiavone,2,B-IO,3,3,3,0,0,3,0
20100605-W-Roland_Garros-F-Samantha_Stosur-Francesca_Schiavone,2,S-XC,6,1,0,0,1,3,3
20100605-W-Roland_Garros-F-Samantha_Stosur-Francesca_Schiavone,2,S-DTM,8,1,0,1,0,4,4
20100605-W-Roland_Garros-F-Samantha_Stosur-Francesca_Schiavone,2,S-DTL,2,0,0,0,0,0,2
20100605-W-Roland_Garros-F-Samantha_Stosur-Francesca_Schiavone,2,S-II,1,0,0,0,0,1,0
20110604-W-Roland_Garros-F-Francesca_Schiavone-Na_Li,1,F-XC,28,5,0,3,2,12,16
20110604-W-Roland_Garros-F-Francesca_Schiavone-Na_Li,1,F-DTM,17,1,0,1,0,4,13
20110604-W-Roland_Garros-F-Francesca_Schiavone-Na_Li,1,F-DTL,14,6,3,2,1,10,4
20110604-W-Roland_Garros-F-Francesca_Schiavone-Na_Li,1,F-IO,14,6,3,1,2,7,7
20110604-W-Roland_Garros-F-Francesca_Schiavone-Na_Li,1,F-II,3,3,0,2,1,2,1
20110604-W-Roland_Garros-F-Francesca_Schiavone-Na_Li,1,B-XC,15,1,0,0,1,7,8
20110604-W-Roland_Garros-F-Francesca_Schiavone-Na_Li,1,B-DTM,23,1,0,0,1,9,14
20110604-W-Roland_Garros-F-Francesca_Schiavone-Na_Li,1,B-DTL,7,2,1,1,0,4,3
20110604-W-Roland_Garros-F-Francesca_Schiavone-Na_Li,1,B-IO,4,1,0,1,0,2,2
20110604-W-Roland_Garros-F-Francesca_Schiavone-Na_Li,1,S-XC,9,1,0,1,0,5,4
20110604-W-Roland_Garros-F-Francesca_Schiavone-Na_Li,1,S-DTM,25,1,0,0,1,5,20
20110604-W-Roland_Garros-F-Francesca_Schiavone-Na_Li,1,S-DTL,5,0,0,0,0,1,4
20110604-W-Roland_Garros-F-Francesca_Schiavone-Na_Li,1,S-IO,2,1,0,0,1,0,2
20110604-W-Roland_Garros-F-Francesca_Schiavone-Na_Li,1,S-II,1,0,0,0,0,0,1
20110604-W-Roland_Garros-F-Francesca_Schiavone-Na_Li,2,F-XC,48,20,7,10,3,34,14
20110604-W-Roland_Garros-F-Francesca_Schiavone-Na_Li,2,F-DTM,27,5,1,3,1,15,12
20110604-W-Roland_Garros-F-Francesca_Schiavone-Na_Li,2,F-DTL,8,1,0,1,0,6,2
20110604-W-Roland_Garros-F-Francesca_Schiavone-Na_Li,2,F-IO,23,12,7,1,4,17,6
20110604-W-Roland_Garros-F-Francesca_Schiavone-Na_Li,2,B-XC,46,6,2,2,2,28,18
20110604-W-Roland_Garros-F-Francesca_Schiavone-Na_Li,2,B-DTM,25,4,0,1,3,15,10
20110604-W-Roland_Garros-F-Francesca_Schiavone-Na_Li,2,B-DTL,1,0,0,0,0,0,1
20110604-W-Roland_Garros-F-Francesca_Schiavone-Na_Li,2,B-IO,9,6,4,2,0,7,2
20110604-W-Roland_Garros-F-Francesca_Schiavone-Na_Li,2,S-XC,3,0,0,0,0,2,1
20110604-W-Roland_Garros-F-Francesca_Schiavone-Na_Li,2,S-DTM,2,0,0,0,0,1,1
20110604-W-Roland_Garros-F-Francesca_Schiavone-Na_Li,2,S-DTL,1,0,0,0,0,0,1
20110604-W-Roland_Garros-F-Francesca_Schiavone-Na_Li,2,S-IO,1,1,1,0,0,1,0
20150704-W-Wimbledon-R32-Timea_Bacsinszky-Sabine_Lisicki,1,F-XC,10,3,2,0,1,7,3
20150704-W-Wimbledon-R32-Timea_Bacsinszky-Sabine_Lisicki,1,F-DTM,11,1,0,0,1,6,5
20150704-W-Wimbledon-R32-Timea_Bacsinszky-Sabine_Lisicki,1,F-DTL,7,3,1,0,2,3,4
20150704-W-Wimbledon-R32-Timea_Bacsinszky-Sabine_Lisicki,1,F-IO,12,3,0,1,2,8,4
20150704-W-Wimbledon-R32-Timea_Bacsinszky-Sabine_Lisicki,1,B-XC,15,6,1,4,1,12,3
20150704-W-Wimbledon-R32-Timea_Bacsinszky-Sabine_Lisicki,1,B-DTM,13,1,1,0,0,10,3
20150704-W-Wimbledon-R32-Timea_Bacsinszky-Sabine_Lisicki,1,B-DTL,3,2,1,0,1,2,1
20150704-W-Wimbledon-R32-Timea_Bacsinszky-Sabine_Lisicki,1,B-IO,13,5,3,1,1,7,6
20150704-W-Wimbledon-R32-Timea_Bacsinszky-Sabine_Lisicki,1,S-XC,1,0,0,0,0,1,0
20150704-W-Wimbledon-R32-Timea_Bacsinszky-Sabine_Lisicki,1,S-DTM,3,0,0,0,0,0,3
20150704-W-Wimbledon-R32-Timea_Bacsinszky-Sabine_Lisicki,1,S-DTL,1,0,0,0,0,0,1
20150704-W-Wimbledon-R32-Timea_Bacsinszky-Sabine_Lisicki,2,F-XC,23,7,0,0,7,7,16
20150704-W-Wimbledon-R32-Timea_Bacsinszky-Sabine_Lisicki,2,F-DTM,12,3,0,0,3,3,9
20150704-W-Wimbledon-R32-Timea_Bacsinszky-Sabine_Lisicki,2,F-DTL,5,3,1,1,1,3,2
20150704-W-Wimbledon-R32-Timea_Bacsinszky-Sabine_Lisicki,2,F-IO,9,7,3,2,2,6,3
20150704-W-Wimbledon-R32-Timea_Bacsinszky-Sabine_Lisicki,2,F-II,1,1,0,0,1,0,1
20150704-W-Wimbledon-R32-Timea_Bacsinszky-Sabine_Lisicki,2,B-XC,15,5,0,1,4,3,12
20150704-W-Wimbledon-R32-Timea_Bacsinszky-Sabine_Lisicki,2,B-DTM,16,3,0,0,3,8,8
20150704-W-Wimbledon-R32-Timea_Bacsinszky-Sabine_Lisicki,2,B-DTL,2,0,0,0,0,1,1
20150704-W-Wimbledon-R32-Timea_Bacsinszky-Sabine_Lisicki,2,B-IO,3,2,1,0,1,1,2
20150704-W-Wimbledon-R32-Timea_Bacsinszky-Sabine_Lisicki,2,S-DTM,5,0,0,0,0,0,5
20150704-W-Wimbledon-R32-Timea_Bacsinszky-Sabine_Lisicki,2,S-DTL,1,1,0,0,1,0,1
20150704-W-Wimbledon-R32-Timea_Bacsinszky-Sabine_Lisicki,2,S-IO,1,0,0,0,0,1,0
20120610-W-Roland_Garros-F-Maria_Sharapova-Sara_Errani,1,F-XC,39,12,4,4,4,24,15
20120610-W-Roland_Garros-F-Maria_Sharapova-Sara_Errani,1,F-DTM,24,0,0,0,0,10,14
20120610-W-Roland_Garros-F-Maria_Sharapova-Sara_Errani,1,F-DTL,15,6,3,2,1,8,7
20120610-W-Roland_Garros-F-Maria_Sharapova-Sara_Errani,1,F-IO,20,11,6,0,5,9,11
20120610-W-Roland_Garros-F-Maria_Sharapova-Sara_Errani,1,F-II,1,1,0,1,0,1,0
20120610-W-Roland_Garros-F-Maria_Sharapova-Sara_Errani,1,B-XC,51,8,3,2,3,29,22
20120610-W-Roland_Garros-F-Maria_Sharapova-Sara_Errani,1,B-DTM,33,2,0,2,0,14,19
20120610-W-Roland_Garros-F-Maria_Sharapova-Sara_Errani,1,B-DTL,19,10,9,0,1,12,7
20120610-W-Roland_Garros-F-Maria_Sharapova-Sara_Errani,1,B-IO,5,2,0,1,1,2,3
20120610-W-Roland_Garros-F-Maria_Sharapova-Sara_Errani,1,S-DTM,1,0,0,0,0,1,0
20120610-W-Roland_Garros-F-Maria_Sharapova-Sara_Errani,2,F-XC,43,3,0,2,1,23,20
20120610-W-Roland_Garros-F-Maria_Sharapova-Sara_Errani,2,F-DTM,22,1,0,0,1,10,12
20120610-W-Roland_Garros-F-Maria_Sharapova-Sara_Errani,2,F-DTL,7,1,1,0,0,4,3
20120610-W-Roland_Garros-F-Maria_Sharapova-Sara_Errani,2,F-IO,14,3,2,0,1,7,7
20120610-W-Roland_Garros-F-Maria_Sharapova-Sara_Errani,2,F-II,2,1,0,1,0,2,0
20120610-W-Roland_Garros-F-Maria_Sharapova-Sara_Errani,2,B-XC,43,5,0,3,2,22,21
20120610-W-Roland_Garros-F-Maria_Sharapova-Sara_Errani,2,B-DTM,24,1,0,0,1,14,10
20120610-W-Roland_Garros-F-Maria_Sharapova-Sara_Errani,2,B-DTL,8,3,1,2,0,4,4
20120610-W-Roland_Garros-F-Maria_Sharapova-Sara_Errani,2,S-XC,6,0,0,0,0,2,4
20120610-W-Roland_Garros-F-Maria_Sharapova-Sara_Errani,2,S-DTM,6,1,0,1,0,2,4
20120610-W-Roland_Garros-F-Maria_Sharapova-Sara_Errani,2,S-DTL,1,0,0,0,0,1,0
20150709-W-Wimbledon-SF-Maria_Sharapova-Serena_Williams,1,F-XC,15,4,1,1,2,9,6
20150709-W-Wimbledon-SF-Maria_Sharapova-Serena_Williams,1,F-DTM,20,2,0,0,2,9,11
20150709-W-Wimbledon-SF-Maria_Sharapova-Serena_Williams,1,F-DTL,5,4,2,0,2,3,2
20150709-W-Wimbledon-SF-Maria_Sharapova-Serena_Williams,1,F-IO,10,2,1,0,1,4,6
20150709-W-Wimbledon-SF-Maria_Sharapova-Serena_Williams,1,B-XC,17,3,0,1,2,9,8
20150709-W-Wimbledon-SF-Maria_Sharapova-Serena_Williams,1,B-DTM,14,1,0,1,0,8,6
20150709-W-Wimbledon-SF-Maria_Sharapova-Serena_Williams,1,B-DTL,2,2,0,0,2,0,2
20150709-W-Wimbledon-SF-Maria_Sharapova-Serena_Williams,1,B-IO,3,1,0,1,0,2,1
20150709-W-Wimbledon-SF-Maria_Sharapova-Serena_Williams,1,S-XC,1,0,0,0,0,0,1
20150709-W-Wimbledon-SF-Maria_Sharapova-Serena_Williams,1,S-DTM,2,1,0,0,1,0,2
20150709-W-Wimbledon-SF-Maria_Sharapova-Serena_Williams,2,F-XC,18,7,2,1,4,8,10
20150709-W-Wimbledon-SF-Maria_Sharapova-Serena_Williams,2,F-DTM,5,1,1,0,0,1,4
20150709-W-Wimbledon-SF-Maria_Sharapova-Serena_Williams,2,F-DTL,4,3,1,0,2,1,3
20150709-W-Wimbledon-SF-Maria_Sharapova-Serena_Williams,2,F-IO,9,6,2,1,3,4,5
20150709-W-Wimbledon-SF-Maria_Sharapova-Serena_Williams,2,B-XC,19,8,3,0,5,11,8
20150709-W-Wimbledon-SF-Maria_Sharapova-Serena_Williams,2,B-DTM,22,1,0,0,1,13,9
20150709-W-Wimbledon-SF-Maria_Sharapova-Serena_Williams,2,B-DTL,4,1,0,0,1,2,2
20150709-W-Wimbledon-SF-Maria_Sharapova-Serena_Williams,2,B-IO,6,2,1,0,1,3,3
20150709-W-Wimbledon-SF-Maria_Sharapova-Serena_Williams,2,S-DTM,1,0,0,0,0,0,1
20150721-W-ITF_Sacramento-R32-Karina_Kristina_Vyrlan-Catherine_Cartan_Bellis,1,F-XC,13,4,0,1,3,6,7
20150721-W-ITF_Sacramento-R32-Karina_Kristina_Vyrlan-Catherine_Cartan_Bellis,1,F-DTM,38,4,0,0,4,15,23
20150721-W-ITF_Sacramento-R32-Karina_Kristina_Vyrlan-Catherine_Cartan_Bellis,1,F-DTL,9,2,1,0,1,4,5
20150721-W-ITF_Sacramento-R32-Karina_Kristina_Vyrlan-Catherine_Cartan_Bellis,1,F-IO,15,4,1,0,3,6,9
20150721-W-ITF_Sacramento-R32-Karina_Kristina_Vyrlan-Catherine_Cartan_Bellis,1,F-II,1,1,0,1,0,1,0
20150721-W-ITF_Sacramento-R32-Karina_Kristina_Vyrlan-Catherine_Cartan_Bellis,1,B-XC,24,6,2,0,4,11,13
20150721-W-ITF_Sacramento-R32-Karina_Kristina_Vyrlan-Catherine_Cartan_Bellis,1,B-DTM,19,2,0,0,2,6,13
20150721-W-ITF_Sacramento-R32-Karina_Kristina_Vyrlan-Catherine_Cartan_Bellis,1,B-DTL,3,1,0,0,1,1,2
20150721-W-ITF_Sacramento-R32-Karina_Kristina_Vyrlan-Catherine_Cartan_Bellis,1,B-IO,5,1,0,0,1,3,2
20150721-W-ITF_Sacramento-R32-Karina_Kristina_Vyrlan-Catherine_Cartan_Bellis,1,S-DTM,3,0,0,0,0,0,3
20150721-W-ITF_Sacramento-R32-Karina_Kristina_Vyrlan-Catherine_Cartan_Bellis,1,S-IO,1,1,0,0,1,0,1
20150721-W-ITF_Sacramento-R32-Karina_Kristina_Vyrlan-Catherine_Cartan_Bellis,2,F-XC,30,8,5,0,3,17,13
20150721-W-ITF_Sacramento-R32-Karina_Kristina_Vyrlan-Catherine_Cartan_Bellis,2,F-DTM,26,4,0,1,3,13,13
20150721-W-ITF_Sacramento-R32-Karina_Kristina_Vyrlan-Catherine_Cartan_Bellis,2,F-DTL,5,3,1,0,2,3,2
20150721-W-ITF_Sacramento-R32-Karina_Kristina_Vyrlan-Catherine_Cartan_Bellis,2,F-IO,19,7,5,1,1,15,4
20150721-W-ITF_Sacramento-R32-Karina_Kristina_Vyrlan-Catherine_Cartan_Bellis,2,F-II,1,1,1,0,0,1,0
20150721-W-ITF_Sacramento-R32-Karina_Kristina_Vyrlan-Catherine_Cartan_Bellis,2,B-XC,10,5,1,2,2,8,2
20150721-W-ITF_Sacramento-R32-Karina_Kristina_Vyrlan-Catherine_Cartan_Bellis,2,B-DTM,28,3,0,0,3,12,16
20150721-W-ITF_Sacramento-R32-Karina_Kristina_Vyrlan-Catherine_Cartan_Bellis,2,B-DTL,10,5,2,1,2,7,3
20150721-W-ITF_Sacramento-R32-Karina_Kristina_Vyrlan-Catherine_Cartan_Bellis,2,S-XC,1,0,0,0,0,0,1
20150721-W-ITF_Sacramento-R32-Karina_Kristina_Vyrlan-Catherine_Cartan_Bellis,2,S-DTM,2,1,0,0,1,1,1
20150721-W-ITF_Sacramento-R32-Karina_Kristina_Vyrlan-Catherine_Cartan_Bellis,2,S-DTL,1,0,0,0,0,1,0
20150721-W-ITF_Sacramento-R32-Karina_Kristina_Vyrlan-Catherine_Cartan_Bellis,2,S-IO,1,0,0,0,0,1,0
20150702-W-Wimbledon-R64-Anastasia_Pavlyuchenkova-Angelique_Kerber,1,F-XC,27,6,4,0,2,15,12
20150702-W-Wimbledon-R64-Anastasia_Pavlyuchenkova-Angelique_Kerber,1,F-DTM,13,5,2,1,2,7,6
20150702-W-Wimbledon-R64-Anastasia_Pavlyuchenkova-Angelique_Kerber,1,F-DTL,18,9,2,3,4,6,12
20150702-W-Wimbledon-R64-Anastasia_Pavlyuchenkova-Angelique_Kerber,1,F-IO,11,2,1,0,1,6,5
20150702-W-Wimbledon-R64-Anastasia_Pavlyuchenkova-Angelique_Kerber,1,B-XC,18,3,2,0,1,6,12
20150702-W-Wimbledon-R64-Anastasia_Pavlyuchenkova-Angelique_Kerber,1,B-DTM,6,1,0,0,1,0,6
20150702-W-Wimbledon-R64-Anastasia_Pavlyuchenkova-Angelique_Kerber,1,B-DTL,9,5,0,0,5,3,6
20150702-W-Wimbledon-R64-Anastasia_Pavlyuchenkova-Angelique_Kerber,1,B-IO,3,1,0,1,0,1,2
20150702-W-Wimbledon-R64-Anastasia_Pavlyuchenkova-Angelique_Kerber,1,S-DTM,2,0,0,0,0,1,1
20150702-W-Wimbledon-R64-Anastasia_Pavlyuchenkova-Angelique_Kerber,1,S-DTL,4,1,0,1,0,1,3
20150702-W-Wimbledon-R64-Anastasia_Pavlyuchenkova-Angelique_Kerber,1,S-IO,1,0,0,0,0,1,0
20150702-W-Wimbledon-R64-Anastasia_Pavlyuchenkova-Angelique_Kerber,2,F-XC,20,6,3,1,2,15,5
20150702-W-Wimbledon-R64-Anastasia_Pavlyuchenkova-Angelique_Kerber,2,F-DTM,11,0,0,0,0,7,4
20150702-W-Wimbledon-R64-Anastasia_Pavlyuchenkova-Angelique_Kerber,2,F-DTL,11,6,5,1,0,10,1
20150702-W-Wimbledon-R64-Anastasia_Pavlyuchenkova-Angelique_Kerber,2,F-IO,9,4,1,2,1,6,3
20150702-W-Wimbledon-R64-Anastasia_Pavlyuchenkova-Angelique_Kerber,2,B-XC,23,7,3,3,1,17,6
20150702-W-Wimbledon-R64-Anastasia_Pavlyuchenkova-Angelique_Kerber,2,B-DTM,11,1,0,0,1,6,5
20150702-W-Wimbledon-R64-Anastasia_Pavlyuchenkova-Angelique_Kerber,2,B-DTL,8,3,2,0,1,6,2
20150702-W-Wimbledon-R64-Anastasia_Pavlyuchenkova-Angelique_Kerber,2,B-IO,4,2,1,0,1,2,2
20150702-W-Wimbledon-R64-Anastasia_Pavlyuchenkova-Angelique_Kerber,2,S-XC,2,0,0,0,0,1,1
20150702-W-Wimbledon-R64-Anastasia_Pavlyuchenkova-Angelique_Kerber,2,S-DTM,7,2,0,0,2,2,5
20150702-W-Wimbledon-R64-Anastasia_Pavlyuchenkova-Angelique_Kerber,2,S-DTL,2,0,0,0,0,1,1
20150805-W-Stanford-R32-Kateryna_Bondarenko-Elina_Svitolina,1,F-XC,93,15,4,1,10,48,45
20150805-W-Stanford-R32-Kateryna_Bondarenko-Elina_Svitolina,1,F-DTM,68,7,0,1,6,37,31
20150805-W-Stanford-R32-Kateryna_Bondarenko-Elina_Svitolina,1,F-DTL,17,5,2,1,2,10,7
20150805-W-Stanford-R32-Kateryna_Bondarenko-Elina_Svitolina,1,F-IO,34,7,2,0,5,17,17
20150805-W-Stanford-R32-Kateryna_Bondarenko-Elina_Svitolina,1,B-XC,101,14,4,5,5,52,49
20150805-W-Stanford-R32-Kateryna_Bondarenko-Elina_Svitolina,1,B-DTM,71,5,0,0,5,39,32
20150805-W-Stanford-R32-Kateryna_Bondarenko-Elina_Svitolina,1,B-DTL,21,11,6,0,5,13,8
20150805-W-Stanford-R32-Kateryna_Bondarenko-Elina_Svitolina,1,B-IO,39,14,2,3,9,16,23
20150805-W-Stanford-R32-Kateryna_Bondarenko-Elina_Svitolina,1,S-XC,1,0,0,0,0,0,1
20150805-W-Stanford-R32-Kateryna_Bondarenko-Elina_Svitolina,1,S-DTM,8,2,1,0,1,3,5
20150805-W-Stanford-R32-Kateryna_Bondarenko-Elina_Svitolina,2,F-XC,66,10,3,2,5,34,32
20150805-W-Stanford-R32-Kateryna_Bondarenko-Elina_Svitolina,2,F-DTM,95,7,0,1,6,37,58
20150805-W-Stanford-R32-Kateryna_Bondarenko-Elina_Svitolina,2,F-DTL,14,10,6,0,4,10,4
20150805-W-Stanford-R32-Kateryna_Bondarenko-Elina_Svitolina,2,F-IO,29,8,4,1,3,17,12
20150805-W-Stanford-R32-Kateryna_Bondarenko-Elina_Svitolina,2,F-II,1,1,1,0,0,1,0
20150805-W-Stanford-R32-Kateryna_Bondarenko-Elina_Svitolina,2,B-XC,71,12,1,2,9,34,37
20150805-W-Stanford-R32-Kateryna_Bondarenko-Elina_Svitolina,2,B-DTM,105,6,0,1,5,50,55
20150805-W-Stanford-R32-Kateryna_Bondarenko-Elina_Svitolina,2,B-DTL,14,6,2,1,3,6,8
20150805-W-Stanford-R32-Kateryna_Bondarenko-Elina_Svitolina,2,B-IO,12,7,1,3,3,7,5
20150805-W-Stanford-R32-Kateryna_Bondarenko-Elina_Svitolina,2,S-XC,7,0,0,0,0,2,5
20150805-W-Stanford-R32-Kateryna_Bondarenko-Elina_Svitolina,2,S-DTM,12,0,0,0,0,3,9
20150805-W-Stanford-R32-Kateryna_Bondarenko-Elina_Svitolina,2,S-DTL,1,0,0,0,0,1,0
20150803-W-Stanford-R32-Madison_Keys-Aleksandra_Krunic,1,F-XC,12,8,3,1,4,7,5
20150803-W-Stanford-R32-Madison_Keys-Aleksandra_Krunic,1,F-DTM,6,2,0,1,1,5,1
20150803-W-Stanford-R32-Madison_Keys-Aleksandra_Krunic,1,F-DTL,1,1,1,0,0,1,0
20150803-W-Stanford-R32-Madison_Keys-Aleksandra_Krunic,1,F-IO,13,6,5,0,1,10,3
20150803-W-Stanford-R32-Madison_Keys-Aleksandra_Krunic,1,B-XC,10,3,1,0,2,5,5
20150803-W-Stanford-R32-Madison_Keys-Aleksandra_Krunic,1,B-DTM,8,2,0,1,1,5,3
20150803-W-Stanford-R32-Madison_Keys-Aleksandra_Krunic,1,B-DTL,4,3,2,0,1,3,1
20150803-W-Stanford-R32-Madison_Keys-Aleksandra_Krunic,1,B-IO,1,0,0,0,0,0,1
20150803-W-Stanford-R32-Madison_Keys-Aleksandra_Krunic,1,S-XC,1,0,0,0,0,0,1
20150803-W-Stanford-R32-Madison_Keys-Aleksandra_Krunic,2,F-XC,7,4,2,0,2,3,4
20150803-W-Stanford-R32-Madison_Keys-Aleksandra_Krunic,2,F-DTM,8,2,0,0,2,2,6
20150803-W-Stanford-R32-Madison_Keys-Aleksandra_Krunic,2,F-DTL,1,0,0,0,0,0,1
20150803-W-Stanford-R32-Madison_Keys-Aleksandra_Krunic,2,F-IO,4,2,0,1,1,2,2
20150803-W-Stanford-R32-Madison_Keys-Aleksandra_Krunic,2,F-II,1,1,1,0,0,1,0
20150803-W-Stanford-R32-Madison_Keys-Aleksandra_Krunic,2,B-XC,7,1,0,0,1,4,3
20150803-W-Stanford-R32-Madison_Keys-Aleksandra_Krunic,2,B-DTM,11,1,0,0,1,2,9
20150803-W-Stanford-R32-Madison_Keys-Aleksandra_Krunic,2,B-IO,2,1,0,0,1,1,1
20150803-W-Stanford-R32-Madison_Keys-Aleksandra_Krunic,2,S-XC,2,0,0,0,0,0,2
20150803-W-Stanford-R32-Madison_Keys-Aleksandra_Krunic,2,S-DTM,3,0,0,0,0,1,2
20150707-W-Wimbledon-QF-Maria_Sharapova-Coco_Vandeweghe,1,F-XC,31,6,0,4,2,16,15
20150707-W-Wimbledon-QF-Maria_Sharapova-Coco_Vandeweghe,1,F-DTM,44,0,0,0,0,15,29
20150707-W-Wimbledon-QF-Maria_Sharapova-Coco_Vandeweghe,1,F-DTL,15,6,2,2,2,7,8
20150707-W-Wimbledon-QF-Maria_Sharapova-Coco_Vandeweghe,1,F-IO,31,13,5,1,7,12,19
20150707-W-Wimbledon-QF-Maria_Sharapova-Coco_Vandeweghe,1,F-II,1,0,0,0,0,1,0
20150707-W-Wimbledon-QF-Maria_Sharapova-Coco_Vandeweghe,1,B-XC,24,2,0,1,1,12,12
20150707-W-Wimbledon-QF-Maria_Sharapova-Coco_Vandeweghe,1,B-DTM,40,4,1,0,3,12,28
20150707-W-Wimbledon-QF-Maria_Sharapova-Coco_Vandeweghe,1,B-DTL,7,2,1,0,1,4,3
20150707-W-Wimbledon-QF-Maria_Sharapova-Coco_Vandeweghe,1,B-IO,7,2,1,1,0,5,2
20150707-W-Wimbledon-QF-Maria_Sharapova-Coco_Vandeweghe,1,S-DTM,5,1,0,0,1,2,3
20150707-W-Wimbledon-QF-Maria_Sharapova-Coco_Vandeweghe,1,S-DTL,1,0,0,0,0,0,1
20150707-W-Wimbledon-QF-Maria_Sharapova-Coco_Vandeweghe,1,S-IO,1,0,0,0,0,1,0
20150707-W-Wimbledon-QF-Maria_Sharapova-Coco_Vandeweghe,2,F-XC,55,22,9,6,7,36,19
20150707-W-Wimbledon-QF-Maria_Sharapova-Coco_Vandeweghe,2,F-DTM,43,4,0,0,4,23,20
20150707-W-Wimbledon-QF-Maria_Sharapova-Coco_Vandeweghe,2,F-DTL,9,5,1,1,3,5,4
20150707-W-Wimbledon-QF-Maria_Sharapova-Coco_Vandeweghe,2,F-IO,17,10,4,3,3,12,5
20150707-W-Wimbledon-QF-Maria_Sharapova-Coco_Vandeweghe,2,F-II,1,1,1,0,0,1,0
20150707-W-Wimbledon-QF-Maria_Sharapova-Coco_Vandeweghe,2,B-XC,35,12,6,0,6,20,15
20150707-W-Wimbledon-QF-Maria_Sharapova-Coco_Vandeweghe,2,B-DTM,41,8,0,0,8,16,25
20150707-W-Wimbledon-QF-Maria_Sharapova-Coco_Vandeweghe,2,B-DTL,9,4,1,1,2,5,4
20150707-W-Wimbledon-QF-Maria_Sharapova-Coco_Vandeweghe,2,B-IO,8,2,1,0,1,5,3
20150707-W-Wimbledon-QF-Maria_Sharapova-Coco_Vandeweghe,2,S-XC,1,0,0,0,0,1,0
20150707-W-Wimbledon-QF-Maria_Sharapova-Coco_Vandeweghe,2,S-DTM,9,1,0,0,1,5,4
20150707-W-Wimbledon-QF-Maria_Sharapova-Coco_Vandeweghe,2,S-DTL,2,1,0,0,1,1,1
20150707-W-Wimbledon-QF-Maria_Sharapova-Coco_Vandeweghe,2,S-IO,1,0,0,0,0,1,0
20150528-W-Roland_Garros-R64-Caroline_Wozniacki-Julia_Goerges,1,F-XC,35,7,1,4,2,21,14
20150528-W-Roland_Garros-R64-Caroline_Wozniacki-Julia_Goerges,1,F-DTM,24,2,0,0,2,13,11
20150528-W-Roland_Garros-R64-Caroline_Wozniacki-Julia_Goerges,1,F-DTL,21,3,3,0,0,12,9
20150528-W-Roland_Garros-R64-Caroline_Wozniacki-Julia_Goerges,1,F-IO,21,4,1,1,2,11,10
20150528-W-Roland_Garros-R64-Caroline_Wozniacki-Julia_Goerges,1,B-XC,56,4,0,0,4,36,20
20150528-W-Roland_Garros-R64-Caroline_Wozniacki-Julia_Goerges,1,B-DTM,22,2,0,0,2,12,10
20150528-W-Roland_Garros-R64-Caroline_Wozniacki-Julia_Goerges,1,B-DTL,13,7,1,1,5,6,7
20150528-W-Roland_Garros-R64-Caroline_Wozniacki-Julia_Goerges,1,B-IO,8,3,2,0,1,5,3
20150528-W-Roland_Garros-R64-Caroline_Wozniacki-Julia_Goerges,1,S-XC,2,0,0,0,0,1,1
20150528-W-Roland_Garros-R64-Caroline_Wozniacki-Julia_Goerges,1,S-DTM,4,0,0,0,0,0,4
20150528-W-Roland_Garros-R64-Caroline_Wozniacki-Julia_Goerges,1,S-DTL,3,0,0,0,0,1,2
20150528-W-Roland_Garros-R64-Caroline_Wozniacki-Julia_Goerges,2,F-XC,52,15,2,5,8,24,28
20150528-W-Roland_Garros-R64-Caroline_Wozniacki-Julia_Goerges,2,F-DTM,13,1,0,0,1,5,8
20150528-W-Roland_Garros-R64-Caroline_Wozniacki-Julia_Goerges,2,F-DTL,19,8,5,1,2,12,7
20150528-W-Roland_Garros-R64-Caroline_Wozniacki-Julia_Goerges,2,F-IO,31,17,10,1,6,17,14
20150528-W-Roland_Garros-R64-Caroline_Wozniacki-Julia_Goerges,2,F-II,7,3,2,0,1,4,3
20150528-W-Roland_Garros-R64-Caroline_Wozniacki-Julia_Goerges,2,B-XC,46,6,1,1,4,19,27
20150528-W-Roland_Garros-R64-Caroline_Wozniacki-Julia_Goerges,2,B-DTM,31,2,0,0,2,9,22
20150528-W-Roland_Garros-R64-Caroline_Wozniacki-Julia_Goerges,2,B-DTL,20,8,3,1,4,11,9
20150528-W-Roland_Garros-R64-Caroline_Wozniacki-Julia_Goerges,2,B-IO,2,2,0,0,2,0,2
20150528-W-Roland_Garros-R64-Caroline_Wozniacki-Julia_Goerges,2,S-XC,3,0,0,0,0,1,2
20150528-W-Roland_Garros-R64-Caroline_Wozniacki-Julia_Goerges,2,S-DTM,6,0,0,0,0,2,4
20150528-W-Roland_Garros-R64-Caroline_Wozniacki-Julia_Goerges,2,S-DTL,1,0,0,0,0,0,1
20150807-W-Stanford-QF-Agnieszka_Radwanska-Angelique_Kerber,1,F-XC,87,12,4,2,6,43,44
20150807-W-Stanford-QF-Agnieszka_Radwanska-Angelique_Kerber,1,F-DTM,34,1,0,0,1,15,19
20150807-W-Stanford-QF-Agnieszka_Radwanska-Angelique_Kerber,1,F-DTL,19,10,3,2,5,10,9
20150807-W-Stanford-QF-Agnieszka_Radwanska-Angelique_Kerber,1,F-IO,39,13,5,3,5,22,17
20150807-W-Stanford-QF-Agnieszka_Radwanska-Angelique_Kerber,1,F-II,1,0,0,0,0,1,0
20150807-W-Stanford-QF-Agnieszka_Radwanska-Angelique_Kerber,1,B-XC,57,8,2,0,6,30,27
20150807-W-Stanford-QF-Agnieszka_Radwanska-Angelique_Kerber,1,B-DTM,50,1,0,0,1,23,27
20150807-W-Stanford-QF-Agnieszka_Radwanska-Angelique_Kerber,1,B-DTL,19,6,2,0,4,10,9
20150807-W-Stanford-QF-Agnieszka_Radwanska-Angelique_Kerber,1,B-IO,9,0,0,0,0,7,2
20150807-W-Stanford-QF-Agnieszka_Radwanska-Angelique_Kerber,1,S-XC,4,2,1,1,0,2,2
20150807-W-Stanford-QF-Agnieszka_Radwanska-Angelique_Kerber,1,S-DTM,15,2,0,1,1,6,9
20150807-W-Stanford-QF-Agnieszka_Radwanska-Angelique_Kerber,1,S-DTL,10,2,0,1,1,3,7
20150807-W-Stanford-QF-Agnieszka_Radwanska-Angelique_Kerber,1,S-IO,2,0,0,0,0,1,1
20150807-W-Stanford-QF-Agnieszka_Radwanska-Angelique_Kerber,2,F-XC,95,12,5,5,2,57,38
20150807-W-Stanford-QF-Agnieszka_Radwanska-Angelique_Kerber,2,F-DTM,41,3,0,3,0,16,25
20150807-W-Stanford-QF-Agnieszka_Radwanska-Angelique_Kerber,2,F-DTL,29,13,6,2,5,15,14
20150807-W-Stanford-QF-Agnieszka_Radwanska-Angelique_Kerber,2,F-IO,28,11,3,2,6,13,15
20150807-W-Stanford-QF-Agnieszka_Radwanska-Angelique_Kerber,2,F-II,1,1,0,1,0,1,0
20150807-W-Stanford-QF-Agnieszka_Radwanska-Angelique_Kerber,2,B-XC,69,8,4,1,3,42,27
20150807-W-Stanford-QF-Agnieszka_Radwanska-Angelique_Kerber,2,B-DTM,56,5,0,0,5,24,32
20150807-W-Stanford-QF-Agnieszka_Radwanska-Angelique_Kerber,2,B-DTL,21,12,4,3,5,13,8
20150807-W-Stanford-QF-Agnieszka_Radwanska-Angelique_Kerber,2,B-IO,18,5,3,0,2,9,9
20150807-W-Stanford-QF-Agnieszka_Radwanska-Angelique_Kerber,2,S-XC,4,0,0,0,0,1,3
20150807-W-Stanford-QF-Agnieszka_Radwanska-Angelique_Kerber,2,S-DTM,12,0,0,0,0,5,7
20150807-W-Stanford-QF-Agnieszka_Radwanska-Angelique_Kerber,2,S-DTL,3,0,0,0,0,2,1
20150807-W-Stanford-QF-Agnieszka_Radwanska-Angelique_Kerber,2,S-IO,1,0,0,0,0,0,1
20150812-W-Toronto-R32-Petra_Kvitova-Victoria_Azarenka,1,F-XC,22,9,1,0,8,8,14
20150812-W-Toronto-R32-Petra_Kvitova-Victoria_Azarenka,1,F-DTM,15,2,0,0,2,5,10
20150812-W-Toronto-R32-Petra_Kvitova-Victoria_Azarenka,1,F-DTL,7,5,2,2,1,5,2
20150812-W-Toronto-R32-Petra_Kvitova-Victoria_Azarenka,1,F-IO,16,9,5,0,4,11,5
20150812-W-Toronto-R32-Petra_Kvitova-Victoria_Azarenka,1,F-II,1,1,1,0,0,1,0
20150812-W-Toronto-R32-Petra_Kvitova-Victoria_Azarenka,1,B-XC,37,11,1,1,9,17,20
20150812-W-Toronto-R32-Petra_Kvitova-Victoria_Azarenka,1,B-DTM,31,4,0,1,3,12,19
20150812-W-Toronto-R32-Petra_Kvitova-Victoria_Azarenka,1,B-DTL,2,1,0,0,1,1,1
20150812-W-Toronto-R32-Petra_Kvitova-Victoria_Azarenka,1,B-IO,5,2,1,0,1,1,4
20150812-W-Toronto-R32-Petra_Kvitova-Victoria_Azarenka,1,S-XC,1,0,0,0,0,0,1
20150812-W-Toronto-R32-Petra_Kvitova-Victoria_Azarenka,1,S-DTM,3,0,0,0,0,1,2
20150812-W-Toronto-R32-Petra_Kvitova-Victoria_Azarenka,1,S-IO,1,0,0,0,0,1,0
20150812-W-Toronto-R32-Petra_Kvitova-Victoria_Azarenka,2,F-XC,33,9,2,2,5,16,17
20150812-W-Toronto-R32-Petra_Kvitova-Victoria_Azarenka,2,F-DTM,27,3,0,0,3,14,13
20150812-W-Toronto-R32-Petra_Kvitova-Victoria_Azarenka,2,F-DTL,15,7,3,0,4,5,10
20150812-W-Toronto-R32-Petra_Kvitova-Victoria_Azarenka,2,F-IO,11,2,1,0,1,8,3
20150812-W-Toronto-R32-Petra_Kvitova-Victoria_Azarenka,2,B-XC,8,4,1,3,0,7,1
20150812-W-Toronto-R32-Petra_Kvitova-Victoria_Azarenka,2,B-DTM,17,3,0,0,3,8,9
20150812-W-Toronto-R32-Petra_Kvitova-Victoria_Azarenka,2,B-DTL,2,1,1,0,0,1,1
20150812-W-Toronto-R32-Petra_Kvitova-Victoria_Azarenka,2,B-IO,3,0,0,0,0,2,1
20150812-W-Toronto-R32-Petra_Kvitova-Victoria_Azarenka,2,S-DTM,5,0,0,0,0,1,4
20150812-W-Toronto-R32-Petra_Kvitova-Victoria_Azarenka,2,S-DTL,2,0,0,0,0,1,1
20150811-W-Toronto-R64-Eugenie_Bouchard-Belinda_Bencic,1,F-XC,46,15,6,1,8,20,26
20150811-W-Toronto-R64-Eugenie_Bouchard-Belinda_Bencic,1,F-DTM,26,5,0,0,5,10,16
20150811-W-Toronto-R64-Eugenie_Bouchard-Belinda_Bencic,1,F-DTL,15,8,6,0,2,8,7
20150811-W-Toronto-R64-Eugenie_Bouchard-Belinda_Bencic,1,F-IO,27,16,4,2,10,12,15
20150811-W-Toronto-R64-Eugenie_Bouchard-Belinda_Bencic,1,B-XC,43,8,4,1,3,24,19
20150811-W-Toronto-R64-Eugenie_Bouchard-Belinda_Bencic,1,B-DTM,43,7,0,0,7,8,35
20150811-W-Toronto-R64-Eugenie_Bouchard-Belinda_Bencic,1,B-DTL,10,6,3,0,3,3,7
20150811-W-Toronto-R64-Eugenie_Bouchard-Belinda_Bencic,1,B-IO,4,2,1,0,1,2,2
20150811-W-Toronto-R64-Eugenie_Bouchard-Belinda_Bencic,1,S-XC,1,0,0,0,0,0,1
20150811-W-Toronto-R64-Eugenie_Bouchard-Belinda_Bencic,1,S-DTM,2,0,0,0,0,2,0
20150811-W-Toronto-R64-Eugenie_Bouchard-Belinda_Bencic,1,S-DTL,1,0,0,0,0,0,1
20150811-W-Toronto-R64-Eugenie_Bouchard-Belinda_Bencic,2,F-XC,25,7,0,5,2,17,8
20150811-W-Toronto-R64-Eugenie_Bouchard-Belinda_Bencic,2,F-DTM,27,2,1,0,1,15,12
20150811-W-Toronto-R64-Eugenie_Bouchard-Belinda_Bencic,2,F-DTL,18,3,2,0,1,12,6
20150811-W-Toronto-R64-Eugenie_Bouchard-Belinda_Bencic,2,F-IO,23,6,1,1,4,13,10
20150811-W-Toronto-R64-Eugenie_Bouchard-Belinda_Bencic,2,B-XC,28,7,2,2,3,15,13
20150811-W-Toronto-R64-Eugenie_Bouchard-Belinda_Bencic,2,B-DTM,31,1,0,0,1,16,15
20150811-W-Toronto-R64-Eugenie_Bouchard-Belinda_Bencic,2,B-DTL,16,5,3,1,1,11,5
20150811-W-Toronto-R64-Eugenie_Bouchard-Belinda_Bencic,2,B-IO,20,7,3,2,2,13,7
20150811-W-Toronto-R64-Eugenie_Bouchard-Belinda_Bencic,2,S-DTM,1,0,0,0,0,1,0
20150527-W-Roland_Garros-R64-Elina_Svitolina-Yulia_Putintseva,1,F-XC,50,15,8,1,6,24,26
20150527-W-Roland_Garros-R64-Elina_Svitolina-Yulia_Putintseva,1,F-DTM,42,5,0,0,5,14,28
20150527-W-Roland_Garros-R64-Elina_Svitolina-Yulia_Putintseva,1,F-DTL,13,5,1,1,3,4,9
20150527-W-Roland_Garros-R64-Elina_Svitolina-Yulia_Putintseva,1,F-IO,69,15,9,3,3,40,29
20150527-W-Roland_Garros-R64-Elina_Svitolina-Yulia_Putintseva,1,F-II,5,2,2,0,0,4,1
20150527-W-Roland_Garros-R64-Elina_Svitolina-Yulia_Putintseva,1,B-XC,146,17,5,3,9,67,79
20150527-W-Roland_Garros-R64-Elina_Svitolina-Yulia_Putintseva,1,B-DTM,75,1,0,0,1,28,47
20150527-W-Roland_Garros-R64-Elina_Svitolina-Yulia_Putintseva,1,B-DTL,26,10,5,1,4,11,15
20150527-W-Roland_Garros-R64-Elina_Svitolina-Yulia_Putintseva,1,B-IO,23,7,1,1,5,7,16
20150527-W-Roland_Garros-R64-Elina_Svitolina-Yulia_Putintseva,1,S-XC,6,1,0,0,1,1,5
20150527-W-Roland_Garros-R64-Elina_Svitolina-Yulia_Putintseva,1,S-DTM,10,1,0,0,1,4,6
20150527-W-Roland_Garros-R64-Elina_Svitolina-Yulia_Putintseva,1,S-DTL,2,0,0,0,0,0,2
20150527-W-Roland_Garros-R64-Elina_Svitolina-Yulia_Putintseva,1,S-IO,1,0,0,0,0,0,1
20150527-W-Roland_Garros-R64-Elina_Svitolina-Yulia_Putintseva,2,F-XC,39,10,5,3,2,29,10
20150527-W-Roland_Garros-R64-Elina_Svitolina-Yulia_Putintseva,2,F-DTM,42,2,0,0,2,20,22
20150527-W-Roland_Garros-R64-Elina_Svitolina-Yulia_Putintseva,2,F-DTL,46,8,1,2,5,26,20
20150527-W-Roland_Garros-R64-Elina_Svitolina-Yulia_Putintseva,2,F-IO,51,8,4,1,3,39,12
20150527-W-Roland_Garros-R64-Elina_Svitolina-Yulia_Putintseva,2,F-II,3,0,0,0,0,1,2
20150527-W-Roland_Garros-R64-Elina_Svitolina-Yulia_Putintseva,2,B-XC,73,6,4,0,2,39,34
20150527-W-Roland_Garros-R64-Elina_Svitolina-Yulia_Putintseva,2,B-DTM,78,3,0,0,3,45,33
20150527-W-Roland_Garros-R64-Elina_Svitolina-Yulia_Putintseva,2,B-DTL,27,14,10,0,4,21,6
20150527-W-Roland_Garros-R64-Elina_Svitolina-Yulia_Putintseva,2,B-IO,5,3,2,0,1,3,2
20150527-W-Roland_Garros-R64-Elina_Svitolina-Yulia_Putintseva,2,S-XC,47,4,1,0,3,22,25
20150527-W-Roland_Garros-R64-Elina_Svitolina-Yulia_Putintseva,2,S-DTM,23,1,0,0,1,10,13
20150527-W-Roland_Garros-R64-Elina_Svitolina-Yulia_Putintseva,2,S-DTL,4,0,0,0,0,1,3
20150527-W-Roland_Garros-R64-Elina_Svitolina-Yulia_Putintseva,2,S-IO,1,0,0,0,0,1,0
20150630-W-Wimbledon-R128-Sachia_Vickery-Ekaterina_Makarova,1,F-XC,37,8,1,2,5,17,20
20150630-W-Wimbledon-R128-Sachia_Vickery-Ekaterina_Makarova,1,F-DTM,26,0,0,0,0,11,15
20150630-W-Wimbledon-R128-Sachia_Vickery-Ekaterina_Makarova,1,F-DTL,3,2,0,0,2,0,3
20150630-W-Wimbledon-R128-Sachia_Vickery-Ekaterina_Makarova,1,F-IO,4,1,1,0,0,2,2
20150630-W-Wimbledon-R128-Sachia_Vickery-Ekaterina_Makarova,1,B-XC,18,8,2,1,5,7,11
20150630-W-Wimbledon-R128-Sachia_Vickery-Ekaterina_Makarova,1,B-DTM,26,6,0,0,6,8,18
20150630-W-Wimbledon-R128-Sachia_Vickery-Ekaterina_Makarova,1,B-DTL,2,2,1,0,1,1,1
20150630-W-Wimbledon-R128-Sachia_Vickery-Ekaterina_Makarova,1,B-IO,6,2,0,0,2,1,5
20150630-W-Wimbledon-R128-Sachia_Vickery-Ekaterina_Makarova,1,S-DTM,4,1,0,0,1,1,3
20150630-W-Wimbledon-R128-Sachia_Vickery-Ekaterina_Makarova,2,F-XC,12,5,1,1,3,9,3
20150630-W-Wimbledon-R128-Sachia_Vickery-Ekaterina_Makarova,2,F-DTM,12,0,0,0,0,8,4
20150630-W-Wimbledon-R128-Sachia_Vickery-Ekaterina_Makarova,2,F-DTL,8,4,2,1,1,6,2
20150630-W-Wimbledon-R128-Sachia_Vickery-Ekaterina_Makarova,2,F-IO,18,7,1,2,4,10,8
20150630-W-Wimbledon-R128-Sachia_Vickery-Ekaterina_Makarova,2,B-XC,33,9,0,4,5,20,13
20150630-W-Wimbledon-R128-Sachia_Vickery-Ekaterina_Makarova,2,B-DTM,15,2,0,0,2,9,6
20150630-W-Wimbledon-R128-Sachia_Vickery-Ekaterina_Makarova,2,B-DTL,13,4,2,0,2,7,6
20150630-W-Wimbledon-R128-Sachia_Vickery-Ekaterina_Makarova,2,B-IO,10,2,2,0,0,6,4
20150630-W-Wimbledon-R128-Sachia_Vickery-Ekaterina_Makarova,2,S-DTM,2,0,0,0,0,1,1
20150630-W-Wimbledon-R128-Sachia_Vickery-Ekaterina_Makarova,2,S-DTL,2,0,0,0,0,1,1
20130524-W-Strasbourg-SF-Alize_Cornet-Eugenie_Bouchard,1,F-XC,82,16,5,5,6,53,29
20130524-W-Strasbourg-SF-Alize_Cornet-Eugenie_Bouchard,1,F-DTM,25,2,2,0,0,13,12
20130524-W-Strasbourg-SF-Alize_Cornet-Eugenie_Bouchard,1,F-DTL,46,11,4,3,4,26,20
20130524-W-Strasbourg-SF-Alize_Cornet-Eugenie_Bouchard,1,F-IO,15,2,0,0,2,10,5
20130524-W-Strasbourg-SF-Alize_Cornet-Eugenie_Bouchard,1,F-II,3,2,1,1,0,2,1
20130524-W-Strasbourg-SF-Alize_Cornet-Eugenie_Bouchard,1,B-XC,106,12,1,5,6,52,54
20130524-W-Strasbourg-SF-Alize_Cornet-Eugenie_Bouchard,1,B-DTM,37,2,0,0,2,16,21
20130524-W-Strasbourg-SF-Alize_Cornet-Eugenie_Bouchard,1,B-DTL,20,5,2,0,3,9,11
20130524-W-Strasbourg-SF-Alize_Cornet-Eugenie_Bouchard,1,B-IO,7,2,0,0,2,4,3
20130524-W-Strasbourg-SF-Alize_Cornet-Eugenie_Bouchard,1,S-XC,19,2,0,0,2,5,14
20130524-W-Strasbourg-SF-Alize_Cornet-Eugenie_Bouchard,1,S-DTM,9,1,0,1,0,5,4
20130524-W-Strasbourg-SF-Alize_Cornet-Eugenie_Bouchard,1,S-DTL,2,0,0,0,0,0,2
20130524-W-Strasbourg-SF-Alize_Cornet-Eugenie_Bouchard,2,F-XC,108,24,6,6,12,47,61
20130524-W-Strasbourg-SF-Alize_Cornet-Eugenie_Bouchard,2,F-DTM,15,0,0,0,0,6,9
20130524-W-Strasbourg-SF-Alize_Cornet-Eugenie_Bouchard,2,F-DTL,19,6,0,0,6,8,11
20130524-W-Strasbourg-SF-Alize_Cornet-Eugenie_Bouchard,2,F-IO,49,22,11,1,10,29,20
20130524-W-Strasbourg-SF-Alize_Cornet-Eugenie_Bouchard,2,F-II,9,4,2,1,1,7,2
20130524-W-Strasbourg-SF-Alize_Cornet-Eugenie_Bouchard,2,B-XC,131,22,2,2,18,67,64
20130524-W-Strasbourg-SF-Alize_Cornet-Eugenie_Bouchard,2,B-DTM,28,2,0,0,2,8,20
20130524-W-Strasbourg-SF-Alize_Cornet-Eugenie_Bouchard,2,B-DTL,36,11,5,2,4,20,16
20130524-W-Strasbourg-SF-Alize_Cornet-Eugenie_Bouchard,2,B-IO,8,3,3,0,0,6,2
20130524-W-Strasbourg-SF-Alize_Cornet-Eugenie_Bouchard,2,S-XC,4,0,0,0,0,3,1
20130524-W-Strasbourg-SF-Alize_Cornet-Eugenie_Bouchard,2,S-DTM,1,0,0,0,0,0,1
20130524-W-Strasbourg-SF-Alize_Cornet-Eugenie_Bouchard,2,S-DTL,1,0,0,0,0,0,1
20150824-W-New_Haven-R32-Lucie_Safarova-Daria_Gavrilova,1,F-XC,46,14,4,7,3,34,12
20150824-W-New_Haven-R32-Lucie_Safarova-Daria_Gavrilova,1,F-DTM,11,1,0,0,1,8,3
20150824-W-New_Haven-R32-Lucie_Safarova-Daria_Gavrilova,1,F-DTL,7,1,0,0,1,5,2
20150824-W-New_Haven-R32-Lucie_Safarova-Daria_Gavrilova,1,F-IO,20,4,1,1,2,13,7
20150824-W-New_Haven-R32-Lucie_Safarova-Daria_Gavrilova,1,F-II,3,2,2,0,0,3,0
20150824-W-New_Haven-R32-Lucie_Safarova-Daria_Gavrilova,1,B-XC,30,6,2,0,4,22,8
20150824-W-New_Haven-R32-Lucie_Safarova-Daria_Gavrilova,1,B-DTM,27,4,0,0,4,14,13
20150824-W-New_Haven-R32-Lucie_Safarova-Daria_Gavrilova,1,B-DTL,5,2,1,1,0,5,0
20150824-W-New_Haven-R32-Lucie_Safarova-Daria_Gavrilova,1,B-IO,2,0,0,0,0,2,0
20150824-W-New_Haven-R32-Lucie_Safarova-Daria_Gavrilova,1,S-DTM,3,0,0,0,0,1,2
20150824-W-New_Haven-R32-Lucie_Safarova-Daria_Gavrilova,1,S-DTL,2,1,0,0,1,0,2
20150824-W-New_Haven-R32-Lucie_Safarova-Daria_Gavrilova,2,F-XC,39,5,0,1,4,8,31
20150824-W-New_Haven-R32-Lucie_Safarova-Daria_Gavrilova,2,F-DTM,17,2,0,0,2,7,10
20150824-W-New_Haven-R32-Lucie_Safarova-Daria_Gavrilova,2,F-DTL,8,6,1,0,5,2,6
20150824-W-New_Haven-R32-Lucie_Safarova-Daria_Gavrilova,2,F-IO,17,10,1,2,7,5,12
20150824-W-New_Haven-R32-Lucie_Safarova-Daria_Gavrilova,2,B-XC,10,2,0,0,2,0,10
20150824-W-New_Haven-R32-Lucie_Safarova-Daria_Gavrilova,2,B-DTM,21,4,0,0,4,6,15
20150824-W-New_Haven-R32-Lucie_Safarova-Daria_Gavrilova,2,B-DTL,4,2,1,0,1,3,1
20150824-W-New_Haven-R32-Lucie_Safarova-Daria_Gavrilova,2,B-IO,3,1,0,0,1,1,2
20150824-W-New_Haven-R32-Lucie_Safarova-Daria_Gavrilova,2,S-XC,1,0,0,0,0,0,1
20150824-W-New_Haven-R32-Lucie_Safarova-Daria_Gavrilova,2,S-DTM,14,0,0,0,0,2,12
20150824-W-New_Haven-R32-Lucie_Safarova-Daria_Gavrilova,2,S-DTL,2,1,0,0,1,1,1
20150813-W-Toronto-R16-Daria_Gavrilova-Roberta_Vinci,1,F-XC,34,13,5,0,8,17,17
20150813-W-Toronto-R16-Daria_Gavrilova-Roberta_Vinci,1,F-DTM,12,1,0,0,1,6,6
20150813-W-Toronto-R16-Daria_Gavrilova-Roberta_Vinci,1,F-DTL,8,3,1,0,2,4,4
20150813-W-Toronto-R16-Daria_Gavrilova-Roberta_Vinci,1,F-IO,32,15,2,2,11,15,17
20150813-W-Toronto-R16-Daria_Gavrilova-Roberta_Vinci,1,F-II,12,3,2,0,1,6,6
20150813-W-Toronto-R16-Daria_Gavrilova-Roberta_Vinci,1,B-XC,17,2,0,0,2,8,9
20150813-W-Toronto-R16-Daria_Gavrilova-Roberta_Vinci,1,B-DTM,8,1,0,0,1,3,5
20150813-W-Toronto-R16-Daria_Gavrilova-Roberta_Vinci,1,B-DTL,7,4,2,0,2,2,5
20150813-W-Toronto-R16-Daria_Gavrilova-Roberta_Vinci,1,B-IO,3,0,0,0,0,1,2
20150813-W-Toronto-R16-Daria_Gavrilova-Roberta_Vinci,1,S-XC,5,0,0,0,0,1,4
20150813-W-Toronto-R16-Daria_Gavrilova-Roberta_Vinci,1,S-DTM,3,0,0,0,0,2,1
20150813-W-Toronto-R16-Daria_Gavrilova-Roberta_Vinci,1,S-DTL,2,0,0,0,0,0,2
20150813-W-Toronto-R16-Daria_Gavrilova-Roberta_Vinci,2,F-XC,30,10,2,4,4,15,15
20150813-W-Toronto-R16-Daria_Gavrilova-Roberta_Vinci,2,F-DTM,20,2,0,0,2,12,8
20150813-W-Toronto-R16-Daria_Gavrilova-Roberta_Vinci,2,F-DTL,19,6,1,1,4,10,9
20150813-W-Toronto-R16-Daria_Gavrilova-Roberta_Vinci,2,F-IO,15,4,0,0,4,7,8
20150813-W-Toronto-R16-Daria_Gavrilova-Roberta_Vinci,2,F-II,2,1,1,0,0,2,0
20150813-W-Toronto-R16-Daria_Gavrilova-Roberta_Vinci,2,B-DTL,1,0,0,0,0,0,1
20150813-W-Toronto-R16-Daria_Gavrilova-Roberta_Vinci,2,S-XC,17,1,0,0,1,9,8
20150813-W-Toronto-R16-Daria_Gavrilova-Roberta_Vinci,2,S-DTM,16,2,0,0,2,4,12
20150813-W-Toronto-R16-Daria_Gavrilova-Roberta_Vinci,2,S-DTL,6,2,0,1,1,4,2
20150820-W-Cincinnati-R16-Elina_Svitolina-Caroline_Garcia,1,F-XC,25,10,4,4,2,20,5
20150820-W-Cincinnati-R16-Elina_Svitolina-Caroline_Garcia,1,F-DTM,40,2,0,1,1,26,14
20150820-W-Cincinnati-R16-Elina_Svitolina-Caroline_Garcia,1,F-DTL,8,3,2,0,1,5,3
20150820-W-Cincinnati-R16-Elina_Svitolina-Caroline_Garcia,1,F-IO,5,1,0,1,0,5,0
20150820-W-Cincinnati-R16-Elina_Svitolina-Caroline_Garcia,1,B-XC,28,4,1,0,3,16,12
20150820-W-Cincinnati-R16-Elina_Svitolina-Caroline_Garcia,1,B-DTM,25,3,0,1,2,16,9
20150820-W-Cincinnati-R16-Elina_Svitolina-Caroline_Garcia,1,B-DTL,3,1,1,0,0,2,1
20150820-W-Cincinnati-R16-Elina_Svitolina-Caroline_Garcia,1,B-IO,1,0,0,0,0,1,0
20150820-W-Cincinnati-R16-Elina_Svitolina-Caroline_Garcia,1,S-XC,3,0,0,0,0,2,1
20150820-W-Cincinnati-R16-Elina_Svitolina-Caroline_Garcia,1,S-DTM,4,0,0,0,0,2,2
20150820-W-Cincinnati-R16-Elina_Svitolina-Caroline_Garcia,2,F-XC,36,9,0,3,6,14,22
20150820-W-Cincinnati-R16-Elina_Svitolina-Caroline_Garcia,2,F-DTM,26,2,0,0,2,6,20
20150820-W-Cincinnati-R16-Elina_Svitolina-Caroline_Garcia,2,F-DTL,3,1,0,0,1,1,2
20150820-W-Cincinnati-R16-Elina_Svitolina-Caroline_Garcia,2,F-IO,13,5,2,0,3,7,6
20150820-W-Cincinnati-R16-Elina_Svitolina-Caroline_Garcia,2,B-XC,37,9,3,0,6,13,24
20150820-W-Cincinnati-R16-Elina_Svitolina-Caroline_Garcia,2,B-DTM,22,2,0,0,2,4,18
20150820-W-Cincinnati-R16-Elina_Svitolina-Caroline_Garcia,2,B-DTL,7,0,0,0,0,0,7
20150820-W-Cincinnati-R16-Elina_Svitolina-Caroline_Garcia,2,B-IO,5,4,0,0,4,1,4
20150820-W-Cincinnati-R16-Elina_Svitolina-Caroline_Garcia,2,S-XC,1,0,0,0,0,1,0
20150820-W-Cincinnati-R16-Elina_Svitolina-Caroline_Garcia,2,S-DTM,1,0,0,0,0,1,0
20150820-W-Cincinnati-R16-Elina_Svitolina-Caroline_Garcia,2,S-DTL,2,0,0,0,0,1,1
20150821-W-Cincinnati-QF-Lucie_Safarova-Elina_Svitolina,1,F-XC,65,18,7,5,6,40,25
20150821-W-Cincinnati-QF-Lucie_Safarova-Elina_Svitolina,1,F-DTM,35,9,1,0,8,17,18
20150821-W-Cincinnati-QF-Lucie_Safarova-Elina_Svitolina,1,F-DTL,16,6,2,1,3,9,7
20150821-W-Cincinnati-QF-Lucie_Safarova-Elina_Svitolina,1,F-IO,24,15,6,2,7,12,12
20150821-W-Cincinnati-QF-Lucie_Safarova-Elina_Svitolina,1,B-XC,29,6,0,1,5,9,20
20150821-W-Cincinnati-QF-Lucie_Safarova-Elina_Svitolina,1,B-DTM,36,4,0,0,4,8,28
20150821-W-Cincinnati-QF-Lucie_Safarova-Elina_Svitolina,1,B-DTL,14,7,2,1,4,7,7
20150821-W-Cincinnati-QF-Lucie_Safarova-Elina_Svitolina,1,B-IO,6,4,2,0,2,3,3
20150821-W-Cincinnati-QF-Lucie_Safarova-Elina_Svitolina,1,S-DTM,3,0,0,0,0,1,2
20150821-W-Cincinnati-QF-Lucie_Safarova-Elina_Svitolina,1,S-DTL,2,0,0,0,0,0,2
20150821-W-Cincinnati-QF-Lucie_Safarova-Elina_Svitolina,2,F-XC,42,3,1,1,1,31,11
20150821-W-Cincinnati-QF-Lucie_Safarova-Elina_Svitolina,2,F-DTM,35,0,0,0,0,26,9
20150821-W-Cincinnati-QF-Lucie_Safarova-Elina_Svitolina,2,F-DTL,5,2,1,1,0,3,2
20150821-W-Cincinnati-QF-Lucie_Safarova-Elina_Svitolina,2,F-IO,12,6,3,1,2,7,5
20150821-W-Cincinnati-QF-Lucie_Safarova-Elina_Svitolina,2,F-II,1,1,1,0,0,1,0
20150821-W-Cincinnati-QF-Lucie_Safarova-Elina_Svitolina,2,B-XC,42,6,0,4,2,22,20
20150821-W-Cincinnati-QF-Lucie_Safarova-Elina_Svitolina,2,B-DTM,43,5,0,0,5,13,30
20150821-W-Cincinnati-QF-Lucie_Safarova-Elina_Svitolina,2,B-DTL,7,3,2,0,1,4,3
20150821-W-Cincinnati-QF-Lucie_Safarova-Elina_Svitolina,2,B-IO,4,2,1,0,1,1,3
20150821-W-Cincinnati-QF-Lucie_Safarova-Elina_Svitolina,2,S-DTM,1,0,0,0,0,1,0
20150709-W-Wimbledon-SF-Agnieszka_Radwanska-Garbine_Muguruza,1,F-XC,55,5,1,2,2,28,27
20150709-W-Wimbledon-SF-Agnieszka_Radwanska-Garbine_Muguruza,1,F-DTM,36,2,0,0,2,14,22
20150709-W-Wimbledon-SF-Agnieszka_Radwanska-Garbine_Muguruza,1,F-DTL,18,3,0,1,2,9,9
20150709-W-Wimbledon-SF-Agnieszka_Radwanska-Garbine_Muguruza,1,F-IO,35,6,3,1,2,21,14
20150709-W-Wimbledon-SF-Agnieszka_Radwanska-Garbine_Muguruza,1,F-II,1,1,1,0,0,1,0
20150709-W-Wimbledon-SF-Agnieszka_Radwanska-Garbine_Muguruza,1,B-XC,26,3,0,0,3,14,12
20150709-W-Wimbledon-SF-Agnieszka_Radwanska-Garbine_Muguruza,1,B-DTM,44,5,0,1,4,20,24
20150709-W-Wimbledon-SF-Agnieszka_Radwanska-Garbine_Muguruza,1,B-DTL,10,4,0,2,2,7,3
20150709-W-Wimbledon-SF-Agnieszka_Radwanska-Garbine_Muguruza,1,B-IO,5,1,0,0,1,3,2
20150709-W-Wimbledon-SF-Agnieszka_Radwanska-Garbine_Muguruza,1,S-XC,6,1,1,0,0,4,2
20150709-W-Wimbledon-SF-Agnieszka_Radwanska-Garbine_Muguruza,1,S-DTM,7,0,0,0,0,3,4
20150709-W-Wimbledon-SF-Agnieszka_Radwanska-Garbine_Muguruza,1,S-IO,4,0,0,0,0,4,0
20150709-W-Wimbledon-SF-Agnieszka_Radwanska-Garbine_Muguruza,2,F-XC,56,12,6,2,4,33,23
20150709-W-Wimbledon-SF-Agnieszka_Radwanska-Garbine_Muguruza,2,F-DTM,40,5,0,0,5,13,27
20150709-W-Wimbledon-SF-Agnieszka_Radwanska-Garbine_Muguruza,2,F-DTL,17,10,4,1,5,8,9
20150709-W-Wimbledon-SF-Agnieszka_Radwanska-Garbine_Muguruza,2,F-IO,15,8,6,0,2,8,7
20150709-W-Wimbledon-SF-Agnieszka_Radwanska-Garbine_Muguruza,2,B-XC,52,19,5,6,8,27,25
20150709-W-Wimbledon-SF-Agnieszka_Radwanska-Garbine_Muguruza,2,B-DTM,49,4,0,0,4,21,28
20150709-W-Wimbledon-SF-Agnieszka_Radwanska-Garbine_Muguruza,2,B-DTL,24,8,1,3,4,10,14
20150709-W-Wimbledon-SF-Agnieszka_Radwanska-Garbine_Muguruza,2,B-IO,18,4,1,1,2,11,7
20150709-W-Wimbledon-SF-Agnieszka_Radwanska-Garbine_Muguruza,2,S-XC,1,0,0,0,0,0,1
20150709-W-Wimbledon-SF-Agnieszka_Radwanska-Garbine_Muguruza,2,S-DTL,1,0,0,0,0,0,1
20150505-W-Madrid-R32-Petra_Kvitova-Coco_Vandeweghe,1,F-XC,28,7,1,4,2,23,5
20150505-W-Madrid-R32-Petra_Kvitova-Coco_Vandeweghe,1,F-DTM,28,3,0,0,3,17,11
20150505-W-Madrid-R32-Petra_Kvitova-Coco_Vandeweghe,1,F-DTL,6,4,3,0,1,3,3
20150505-W-Madrid-R32-Petra_Kvitova-Coco_Vandeweghe,1,F-IO,8,3,0,0,3,2,6
20150505-W-Madrid-R32-Petra_Kvitova-Coco_Vandeweghe,1,B-XC,23,5,2,1,2,13,10
20150505-W-Madrid-R32-Petra_Kvitova-Coco_Vandeweghe,1,B-DTM,20,4,0,0,4,7,13
20150505-W-Madrid-R32-Petra_Kvitova-Coco_Vandeweghe,1,B-DTL,6,4,0,0,4,1,5
20150505-W-Madrid-R32-Petra_Kvitova-Coco_Vandeweghe,1,B-IO,7,2,0,0,2,4,3
20150505-W-Madrid-R32-Petra_Kvitova-Coco_Vandeweghe,1,S-XC,1,0,0,0,0,0,1
20150505-W-Madrid-R32-Petra_Kvitova-Coco_Vandeweghe,1,S-DTM,2,0,0,0,0,1,1
20150505-W-Madrid-R32-Petra_Kvitova-Coco_Vandeweghe,1,S-DTL,4,0,0,0,0,2,2
20150505-W-Madrid-R32-Petra_Kvitova-Coco_Vandeweghe,1,S-IO,1,0,0,0,0,1,0
20150505-W-Madrid-R32-Petra_Kvitova-Coco_Vandeweghe,2,F-XC,34,13,7,2,4,18,16
20150505-W-Madrid-R32-Petra_Kvitova-Coco_Vandeweghe,2,F-DTM,19,5,1,0,4,10,9
20150505-W-Madrid-R32-Petra_Kvitova-Coco_Vandeweghe,2,F-DTL,8,3,1,0,2,4,4
20150505-W-Madrid-R32-Petra_Kvitova-Coco_Vandeweghe,2,F-IO,16,8,4,1,3,10,6
20150505-W-Madrid-R32-Petra_Kvitova-Coco_Vandeweghe,2,B-XC,19,5,0,1,4,4,15
20150505-W-Madrid-R32-Petra_Kvitova-Coco_Vandeweghe,2,B-DTM,22,7,0,1,6,6,16
20150505-W-Madrid-R32-Petra_Kvitova-Coco_Vandeweghe,2,B-DTL,4,2,0,0,2,2,2
20150505-W-Madrid-R32-Petra_Kvitova-Coco_Vandeweghe,2,B-IO,1,0,0,0,0,1,0
20150505-W-Madrid-R32-Petra_Kvitova-Coco_Vandeweghe,2,S-XC,2,2,0,0,2,0,2
20150505-W-Madrid-R32-Petra_Kvitova-Coco_Vandeweghe,2,S-DTM,4,2,0,0,2,1,3
20150505-W-Madrid-R32-Petra_Kvitova-Coco_Vandeweghe,2,S-DTL,3,0,0,0,0,1,2
20150822-W-Cincinnati-SF-Serena_Williams-Elina_Svitolina,1,F-XC,29,11,0,4,7,17,12
20150822-W-Cincinnati-SF-Serena_Williams-Elina_Svitolina,1,F-DTM,10,1,0,0,1,8,2
20150822-W-Cincinnati-SF-Serena_Williams-Elina_Svitolina,1,F-DTL,7,3,1,0,2,5,2
20150822-W-Cincinnati-SF-Serena_Williams-Elina_Svitolina,1,F-IO,21,8,7,0,1,17,4
20150822-W-Cincinnati-SF-Serena_Williams-Elina_Svitolina,1,B-XC,35,12,3,3,6,19,16
20150822-W-Cincinnati-SF-Serena_Williams-Elina_Svitolina,1,B-DTM,12,1,0,0,1,5,7
20150822-W-Cincinnati-SF-Serena_Williams-Elina_Svitolina,1,B-DTL,13,2,1,0,1,8,5
20150822-W-Cincinnati-SF-Serena_Williams-Elina_Svitolina,1,B-IO,12,3,0,2,1,10,2
20150822-W-Cincinnati-SF-Serena_Williams-Elina_Svitolina,1,S-DTM,5,0,0,0,0,4,1
20150822-W-Cincinnati-SF-Serena_Williams-Elina_Svitolina,1,S-DTL,1,0,0,0,0,1,0
20150822-W-Cincinnati-SF-Serena_Williams-Elina_Svitolina,2,F-XC,28,8,2,0,6,11,17
20150822-W-Cincinnati-SF-Serena_Williams-Elina_Svitolina,2,F-DTM,24,3,0,0,3,6,18
20150822-W-Cincinnati-SF-Serena_Williams-Elina_Svitolina,2,F-DTL,12,6,4,0,2,6,6
20150822-W-Cincinnati-SF-Serena_Williams-Elina_Svitolina,2,F-IO,6,1,1,0,0,3,3
20150822-W-Cincinnati-SF-Serena_Williams-Elina_Svitolina,2,B-XC,26,4,0,0,4,12,14
20150822-W-Cincinnati-SF-Serena_Williams-Elina_Svitolina,2,B-DTM,26,1,1,0,0,10,16
20150822-W-Cincinnati-SF-Serena_Williams-Elina_Svitolina,2,B-DTL,1,0,0,0,0,0,1
20150822-W-Cincinnati-SF-Serena_Williams-Elina_Svitolina,2,B-IO,1,1,1,0,0,1,0
20150822-W-Cincinnati-SF-Serena_Williams-Elina_Svitolina,2,S-XC,2,0,0,0,0,0,2
20150822-W-Cincinnati-SF-Serena_Williams-Elina_Svitolina,2,S-DTM,2,0,0,0,0,0,2
20150822-W-Cincinnati-SF-Serena_Williams-Elina_Svitolina,2,S-DTL,2,1,1,0,0,1,1
20150828-W-New_Haven-SF-Lesia_Tsurenko-Lucie_Safarova,1,F-XC,26,6,2,2,2,21,5
20150828-W-New_Haven-SF-Lesia_Tsurenko-Lucie_Safarova,1,F-DTM,42,6,0,0,6,19,23
20150828-W-New_Haven-SF-Lesia_Tsurenko-Lucie_Safarova,1,F-DTL,4,1,1,0,0,3,1
20150828-W-New_Haven-SF-Lesia_Tsurenko-Lucie_Safarova,1,F-IO,19,2,0,1,1,6,13
20150828-W-New_Haven-SF-Lesia_Tsurenko-Lucie_Safarova,1,B-XC,24,6,1,0,5,10,14
20150828-W-New_Haven-SF-Lesia_Tsurenko-Lucie_Safarova,1,B-DTM,45,7,0,1,6,12,33
20150828-W-New_Haven-SF-Lesia_Tsurenko-Lucie_Safarova,1,B-DTL,10,3,1,1,1,5,5
20150828-W-New_Haven-SF-Lesia_Tsurenko-Lucie_Safarova,1,B-IO,9,4,0,0,4,3,6
20150828-W-New_Haven-SF-Lesia_Tsurenko-Lucie_Safarova,1,S-XC,1,0,0,0,0,0,1
20150828-W-New_Haven-SF-Lesia_Tsurenko-Lucie_Safarova,1,S-DTM,6,0,0,0,0,2,4
20150828-W-New_Haven-SF-Lesia_Tsurenko-Lucie_Safarova,1,S-DTL,1,1,0,0,1,0,1
20150828-W-New_Haven-SF-Lesia_Tsurenko-Lucie_Safarova,2,F-XC,52,8,3,2,3,36,16
20150828-W-New_Haven-SF-Lesia_Tsurenko-Lucie_Safarova,2,F-DTM,38,5,0,0,5,20,18
20150828-W-New_Haven-SF-Lesia_Tsurenko-Lucie_Safarova,2,F-DTL,21,13,4,3,6,8,13
20150828-W-New_Haven-SF-Lesia_Tsurenko-Lucie_Safarova,2,F-IO,11,5,1,1,3,4,7
20150828-W-New_Haven-SF-Lesia_Tsurenko-Lucie_Safarova,2,B-XC,13,2,0,0,2,4,9
20150828-W-New_Haven-SF-Lesia_Tsurenko-Lucie_Safarova,2,B-DTM,44,2,0,0,2,26,18
20150828-W-New_Haven-SF-Lesia_Tsurenko-Lucie_Safarova,2,B-DTL,5,2,0,0,2,1,4
20150828-W-New_Haven-SF-Lesia_Tsurenko-Lucie_Safarova,2,B-IO,9,1,0,0,1,3,6
20150828-W-New_Haven-SF-Lesia_Tsurenko-Lucie_Safarova,2,S-XC,1,0,0,0,0,0,1
20150828-W-New_Haven-SF-Lesia_Tsurenko-Lucie_Safarova,2,S-DTM,2,0,0,0,0,1,1
20150826-W-New_Haven-R16-Petra_Kvitova-Madison_Keys,1,F-XC,29,11,3,5,3,21,8
20150826-W-New_Haven-R16-Petra_Kvitova-Madison_Keys,1,F-DTM,24,5,0,0,5,12,12
20150826-W-New_Haven-R16-Petra_Kvitova-Madison_Keys,1,F-DTL,5,1,1,0,0,3,2
20150826-W-New_Haven-R16-Petra_Kvitova-Madison_Keys,1,F-IO,17,9,6,0,3,12,5
20150826-W-New_Haven-R16-Petra_Kvitova-Madison_Keys,1,B-XC,22,3,0,0,3,8,14
20150826-W-New_Haven-R16-Petra_Kvitova-Madison_Keys,1,B-DTM,24,8,0,3,5,10,14
20150826-W-New_Haven-R16-Petra_Kvitova-Madison_Keys,1,B-DTL,6,1,0,0,1,3,3
20150826-W-New_Haven-R16-Petra_Kvitova-Madison_Keys,1,B-IO,7,3,0,1,2,3,4
20150826-W-New_Haven-R16-Petra_Kvitova-Madison_Keys,1,S-XC,2,0,0,0,0,2,0
20150826-W-New_Haven-R16-Petra_Kvitova-Madison_Keys,1,S-DTM,2,0,0,0,0,1,1
20150826-W-New_Haven-R16-Petra_Kvitova-Madison_Keys,1,S-DTL,1,1,1,0,0,1,0
20150826-W-New_Haven-R16-Petra_Kvitova-Madison_Keys,2,F-XC,26,11,1,3,7,12,14
20150826-W-New_Haven-R16-Petra_Kvitova-Madison_Keys,2,F-DTM,38,6,0,1,5,19,19
20150826-W-New_Haven-R16-Petra_Kvitova-Madison_Keys,2,F-DTL,6,4,3,0,1,3,3
20150826-W-New_Haven-R16-Petra_Kvitova-Madison_Keys,2,F-IO,10,7,3,0,4,6,4
20150826-W-New_Haven-R16-Petra_Kvitova-Madison_Keys,2,B-XC,13,4,2,1,1,6,7
20150826-W-New_Haven-R16-Petra_Kvitova-Madison_Keys,2,B-DTM,28,6,0,1,5,11,17
20150826-W-New_Haven-R16-Petra_Kvitova-Madison_Keys,2,B-DTL,2,2,0,0,2,0,2
20150826-W-New_Haven-R16-Petra_Kvitova-Madison_Keys,2,B-IO,5,3,0,0,3,2,3
20150826-W-New_Haven-R16-Petra_Kvitova-Madison_Keys,2,S-DTM,5,0,0,0,0,1,4
20150826-W-New_Haven-R16-Petra_Kvitova-Madison_Keys,2,S-DTL,1,0,0,0,0,1,0
20150831-W-US_Open-R128-Eugenie_Bouchard-Alison_Riske,1,F-XC,53,13,3,4,6,26,27
20150831-W-US_Open-R128-Eugenie_Bouchard-Alison_Riske,1,F-DTM,8,1,0,0,1,3,5
20150831-W-US_Open-R128-Eugenie_Bouchard-Alison_Riske,1,F-DTL,15,9,3,4,2,10,5
20150831-W-US_Open-R128-Eugenie_Bouchard-Alison_Riske,1,F-IO,18,6,3,0,3,8,10
20150831-W-US_Open-R128-Eugenie_Bouchard-Alison_Riske,1,B-XC,30,6,1,0,5,11,19
20150831-W-US_Open-R128-Eugenie_Bouchard-Alison_Riske,1,B-DTM,16,2,0,0,2,7,9
20150831-W-US_Open-R128-Eugenie_Bouchard-Alison_Riske,1,B-DTL,11,6,3,1,2,5,6
20150831-W-US_Open-R128-Eugenie_Bouchard-Alison_Riske,1,B-IO,5,3,0,2,1,2,3
20150831-W-US_Open-R128-Eugenie_Bouchard-Alison_Riske,1,S-XC,1,0,0,0,0,1,0
20150831-W-US_Open-R128-Eugenie_Bouchard-Alison_Riske,1,S-DTL,1,0,0,0,0,0,1
20150831-W-US_Open-R128-Eugenie_Bouchard-Alison_Riske,2,F-XC,44,6,0,0,6,20,24
20150831-W-US_Open-R128-Eugenie_Bouchard-Alison_Riske,2,F-DTM,16,3,0,0,3,6,10
20150831-W-US_Open-R128-Eugenie_Bouchard-Alison_Riske,2,F-DTL,14,5,2,1,2,10,4
20150831-W-US_Open-R128-Eugenie_Bouchard-Alison_Riske,2,F-IO,8,2,1,0,1,3,5
20150831-W-US_Open-R128-Eugenie_Bouchard-Alison_Riske,2,F-II,2,0,0,0,0,1,1
20150831-W-US_Open-R128-Eugenie_Bouchard-Alison_Riske,2,B-XC,26,4,0,2,2,14,12
20150831-W-US_Open-R128-Eugenie_Bouchard-Alison_Riske,2,B-DTM,19,2,0,1,1,13,6
20150831-W-US_Open-R128-Eugenie_Bouchard-Alison_Riske,2,B-DTL,18,5,1,1,3,9,9
20150831-W-US_Open-R128-Eugenie_Bouchard-Alison_Riske,2,B-IO,1,1,0,0,1,0,1
20150831-W-US_Open-R128-Eugenie_Bouchard-Alison_Riske,2,S-XC,3,0,0,0,0,3,0
20150831-W-US_Open-R128-Eugenie_Bouchard-Alison_Riske,2,S-DTM,3,0,0,0,0,0,3
20150831-W-US_Open-R128-Eugenie_Bouchard-Alison_Riske,2,S-DTL,1,0,0,0,0,1,0
20150902-W-US_Open-R64-Eugenie_Bouchard-Polona_Hercog,1,F-XC,108,20,3,7,10,57,51
20150902-W-US_Open-R64-Eugenie_Bouchard-Polona_Hercog,1,F-DTM,28,1,0,0,1,16,12
20150902-W-US_Open-R64-Eugenie_Bouchard-Polona_Hercog,1,F-DTL,23,5,5,0,0,15,8
20150902-W-US_Open-R64-Eugenie_Bouchard-Polona_Hercog,1,F-IO,52,12,2,3,7,22,30
20150902-W-US_Open-R64-Eugenie_Bouchard-Polona_Hercog,1,F-II,8,2,1,0,1,5,3
20150902-W-US_Open-R64-Eugenie_Bouchard-Polona_Hercog,1,B-XC,75,8,0,0,8,32,43
20150902-W-US_Open-R64-Eugenie_Bouchard-Polona_Hercog,1,B-DTM,31,3,0,0,3,16,15
20150902-W-US_Open-R64-Eugenie_Bouchard-Polona_Hercog,1,B-DTL,11,3,1,0,2,7,4
20150902-W-US_Open-R64-Eugenie_Bouchard-Polona_Hercog,1,B-IO,6,2,1,0,1,2,4
20150902-W-US_Open-R64-Eugenie_Bouchard-Polona_Hercog,1,S-XC,4,0,0,0,0,1,3
20150902-W-US_Open-R64-Eugenie_Bouchard-Polona_Hercog,1,S-DTM,5,2,0,0,2,0,5
20150902-W-US_Open-R64-Eugenie_Bouchard-Polona_Hercog,1,S-DTL,1,0,0,0,0,0,1
20150902-W-US_Open-R64-Eugenie_Bouchard-Polona_Hercog,2,F-XC,104,27,5,8,14,45,59
20150902-W-US_Open-R64-Eugenie_Bouchard-Polona_Hercog,2,F-DTM,45,3,0,0,3,26,19
20150902-W-US_Open-R64-Eugenie_Bouchard-Polona_Hercog,2,F-DTL,21,8,4,0,4,10,11
20150902-W-US_Open-R64-Eugenie_Bouchard-Polona_Hercog,2,F-IO,28,11,7,0,4,15,13
20150902-W-US_Open-R64-Eugenie_Bouchard-Polona_Hercog,2,F-II,2,0,0,0,0,0,2
20150902-W-US_Open-R64-Eugenie_Bouchard-Polona_Hercog,2,B-XC,21,2,0,0,2,12,9
20150902-W-US_Open-R64-Eugenie_Bouchard-Polona_Hercog,2,B-DTM,16,2,0,0,2,9,7
20150902-W-US_Open-R64-Eugenie_Bouchard-Polona_Hercog,2,B-DTL,2,1,0,0,1,0,2
20150902-W-US_Open-R64-Eugenie_Bouchard-Polona_Hercog,2,B-IO,1,0,0,0,0,0,1
20150902-W-US_Open-R64-Eugenie_Bouchard-Polona_Hercog,2,B-II,1,1,1,0,0,1,0
20150902-W-US_Open-R64-Eugenie_Bouchard-Polona_Hercog,2,S-XC,57,2,0,0,2,32,25
20150902-W-US_Open-R64-Eugenie_Bouchard-Polona_Hercog,2,S-DTM,42,3,0,0,3,16,26
20150902-W-US_Open-R64-Eugenie_Bouchard-Polona_Hercog,2,S-DTL,5,2,1,0,1,4,1
20150902-W-US_Open-R64-Eugenie_Bouchard-Polona_Hercog,2,S-IO,4,1,0,0,1,1,3
20150719-W-Bastad-F-Mona_Barthel-Johanna_Larsson,1,F-XC,62,14,6,4,4,37,25
20150719-W-Bastad-F-Mona_Barthel-Johanna_Larsson,1,F-DTM,31,3,0,0,3,13,18
20150719-W-Bastad-F-Mona_Barthel-Johanna_Larsson,1,F-DTL,22,7,0,3,4,13,9
20150719-W-Bastad-F-Mona_Barthel-Johanna_Larsson,1,F-IO,17,3,0,1,2,10,7
20150719-W-Bastad-F-Mona_Barthel-Johanna_Larsson,1,B-XC,62,11,1,3,7,35,27
20150719-W-Bastad-F-Mona_Barthel-Johanna_Larsson,1,B-DTM,30,5,0,0,5,11,19
20150719-W-Bastad-F-Mona_Barthel-Johanna_Larsson,1,B-DTL,10,6,2,2,2,7,3
20150719-W-Bastad-F-Mona_Barthel-Johanna_Larsson,1,B-IO,14,7,3,1,3,9,5
20150719-W-Bastad-F-Mona_Barthel-Johanna_Larsson,2,F-XC,55,7,2,3,2,28,27
20150719-W-Bastad-F-Mona_Barthel-Johanna_Larsson,2,F-DTM,32,4,1,0,3,8,24
20150719-W-Bastad-F-Mona_Barthel-Johanna_Larsson,2,F-DTL,13,3,1,2,0,10,3
20150719-W-Bastad-F-Mona_Barthel-Johanna_Larsson,2,F-IO,13,6,2,2,2,9,4
20150719-W-Bastad-F-Mona_Barthel-Johanna_Larsson,2,F-II,3,1,0,0,1,2,1
20150719-W-Bastad-F-Mona_Barthel-Johanna_Larsson,2,B-XC,36,9,2,3,4,19,17
20150719-W-Bastad-F-Mona_Barthel-Johanna_Larsson,2,B-DTM,46,3,0,0,3,17,29
20150719-W-Bastad-F-Mona_Barthel-Johanna_Larsson,2,B-DTL,11,3,1,1,1,6,5
20150719-W-Bastad-F-Mona_Barthel-Johanna_Larsson,2,B-IO,6,2,0,1,1,4,2
20150719-W-Bastad-F-Mona_Barthel-Johanna_Larsson,2,S-XC,7,1,1,0,0,2,5
20150719-W-Bastad-F-Mona_Barthel-Johanna_Larsson,2,S-DTM,14,0,0,0,0,5,9
20150719-W-Bastad-F-Mona_Barthel-Johanna_Larsson,2,S-DTL,3,0,0,0,0,1,2
20150904-W-US_Open-R32-Dominika_Cibulkova-Eugenie_Bouchard,1,F-XC,58,19,8,5,6,35,23
20150904-W-US_Open-R32-Dominika_Cibulkova-Eugenie_Bouchard,1,F-DTM,35,4,0,3,1,18,17
20150904-W-US_Open-R32-Dominika_Cibulkova-Eugenie_Bouchard,1,F-DTL,34,17,9,5,3,23,11
20150904-W-US_Open-R32-Dominika_Cibulkova-Eugenie_Bouchard,1,F-IO,20,9,5,4,0,18,2
20150904-W-US_Open-R32-Dominika_Cibulkova-Eugenie_Bouchard,1,F-II,3,1,0,0,1,2,1
20150904-W-US_Open-R32-Dominika_Cibulkova-Eugenie_Bouchard,1,B-XC,33,9,1,4,4,16,17
20150904-W-US_Open-R32-Dominika_Cibulkova-Eugenie_Bouchard,1,B-DTM,31,3,0,1,2,15,16
20150904-W-US_Open-R32-Dominika_Cibulkova-Eugenie_Bouchard,1,B-DTL,18,9,3,3,3,10,8
20150904-W-US_Open-R32-Dominika_Cibulkova-Eugenie_Bouchard,1,B-IO,5,2,1,0,1,3,2
20150904-W-US_Open-R32-Dominika_Cibulkova-Eugenie_Bouchard,1,S-XC,1,0,0,0,0,0,1
20150904-W-US_Open-R32-Dominika_Cibulkova-Eugenie_Bouchard,1,S-DTM,1,1,0,1,0,1,0
20150904-W-US_Open-R32-Dominika_Cibulkova-Eugenie_Bouchard,1,S-DTL,5,0,0,0,0,0,5
20150904-W-US_Open-R32-Dominika_Cibulkova-Eugenie_Bouchard,2,F-XC,55,20,7,8,5,30,25
20150904-W-US_Open-R32-Dominika_Cibulkova-Eugenie_Bouchard,2,F-DTM,21,0,0,0,0,6,15
20150904-W-US_Open-R32-Dominika_Cibulkova-Eugenie_Bouchard,2,F-DTL,22,8,4,3,1,12,10
20150904-W-US_Open-R32-Dominika_Cibulkova-Eugenie_Bouchard,2,F-IO,23,12,5,0,7,11,12
20150904-W-US_Open-R32-Dominika_Cibulkova-Eugenie_Bouchard,2,F-II,1,0,0,0,0,1,0
20150904-W-US_Open-R32-Dominika_Cibulkova-Eugenie_Bouchard,2,B-XC,33,6,2,2,2,20,13
20150904-W-US_Open-R32-Dominika_Cibulkova-Eugenie_Bouchard,2,B-DTM,36,2,0,2,0,16,20
20150904-W-US_Open-R32-Dominika_Cibulkova-Eugenie_Bouchard,2,B-DTL,8,4,3,1,0,5,3
20150904-W-US_Open-R32-Dominika_Cibulkova-Eugenie_Bouchard,2,B-IO,7,2,1,0,1,5,2
20150904-W-US_Open-R32-Dominika_Cibulkova-Eugenie_Bouchard,2,S-XC,1,0,0,0,0,1,0
20150904-W-US_Open-R32-Dominika_Cibulkova-Eugenie_Bouchard,2,S-DTM,3,0,0,0,0,0,3
19950828-W-US_Open-QF-Steffi_Graf-Amy_Frazier,1,F-XC,29,10,1,4,5,15,14
19950828-W-US_Open-QF-Steffi_Graf-Amy_Frazier,1,F-DTM,12,1,0,0,1,6,6
19950828-W-US_Open-QF-Steffi_Graf-Amy_Frazier,1,F-DTL,5,1,1,0,0,4,1
19950828-W-US_Open-QF-Steffi_Graf-Amy_Frazier,1,F-IO,9,4,1,2,1,5,4
19950828-W-US_Open-QF-Steffi_Graf-Amy_Frazier,1,F-II,1,1,0,1,0,1,0
19950828-W-US_Open-QF-Steffi_Graf-Amy_Frazier,1,B-XC,1,1,1,0,0,1,0
19950828-W-US_Open-QF-Steffi_Graf-Amy_Frazier,1,B-DTM,1,0,0,0,0,0,1
19950828-W-US_Open-QF-Steffi_Graf-Amy_Frazier,1,B-DTL,2,1,1,0,0,1,1
19950828-W-US_Open-QF-Steffi_Graf-Amy_Frazier,1,S-XC,16,2,0,0,2,3,13
19950828-W-US_Open-QF-Steffi_Graf-Amy_Frazier,1,S-DTM,24,2,0,0,2,16,8
19950828-W-US_Open-QF-Steffi_Graf-Amy_Frazier,1,S-DTL,10,2,0,1,1,5,5
19950828-W-US_Open-QF-Steffi_Graf-Amy_Frazier,1,S-IO,3,1,0,1,0,2,1
19950828-W-US_Open-QF-Steffi_Graf-Amy_Frazier,2,F-XC,29,9,0,5,4,14,15
19950828-W-US_Open-QF-Steffi_Graf-Amy_Frazier,2,F-DTM,15,1,0,1,0,7,8
19950828-W-US_Open-QF-Steffi_Graf-Amy_Frazier,2,F-DTL,5,3,0,1,2,1,4
19950828-W-US_Open-QF-Steffi_Graf-Amy_Frazier,2,B-XC,38,6,0,3,3,20,18
19950828-W-US_Open-QF-Steffi_Graf-Amy_Frazier,2,B-DTM,8,1,0,0,1,5,3
19950828-W-US_Open-QF-Steffi_Graf-Amy_Frazier,2,B-DTL,6,5,4,0,1,4,2
19950828-W-US_Open-QF-Steffi_Graf-Amy_Frazier,2,B-IO,4,3,2,0,1,3,1
19950828-W-US_Open-QF-Steffi_Graf-Amy_Frazier,2,S-DTM,4,0,0,0,0,1,3
19950828-W-US_Open-QF-Steffi_Graf-Amy_Frazier,2,S-DTL,1,0,0,0,0,0,1
19900827-W-US_Open-R16-Steffi_Graf-Jennifer_Capriati,1,F-XC,53,8,0,3,5,35,18
19900827-W-US_Open-R16-Steffi_Graf-Jennifer_Capriati,1,F-DTM,24,0,0,0,0,12,12
19900827-W-US_Open-R16-Steffi_Graf-Jennifer_Capriati,1,F-DTL,7,3,2,0,1,3,4
19900827-W-US_Open-R16-Steffi_Graf-Jennifer_Capriati,1,F-IO,8,5,3,1,1,6,2
19900827-W-US_Open-R16-Steffi_Graf-Jennifer_Capriati,1,F-II,2,2,0,2,0,2,0
19900827-W-US_Open-R16-Steffi_Graf-Jennifer_Capriati,1,B-XC,1,0,0,0,0,1,0
19900827-W-US_Open-R16-Steffi_Graf-Jennifer_Capriati,1,B-DTM,2,0,0,0,0,0,2
19900827-W-US_Open-R16-Steffi_Graf-Jennifer_Capriati,1,B-DTL,1,1,0,0,1,0,1
19900827-W-US_Open-R16-Steffi_Graf-Jennifer_Capriati,1,B-IO,1,0,0,0,0,0,1
19900827-W-US_Open-R16-Steffi_Graf-Jennifer_Capriati,1,S-XC,19,1,0,1,0,9,10
19900827-W-US_Open-R16-Steffi_Graf-Jennifer_Capriati,1,S-DTM,36,1,0,0,1,20,16
19900827-W-US_Open-R16-Steffi_Graf-Jennifer_Capriati,1,S-DTL,8,2,0,2,0,8,0
19900827-W-US_Open-R16-Steffi_Graf-Jennifer_Capriati,1,S-IO,9,3,1,2,0,5,4
19900827-W-US_Open-R16-Steffi_Graf-Jennifer_Capriati,2,F-XC,45,9,2,1,6,13,32
19900827-W-US_Open-R16-Steffi_Graf-Jennifer_Capriati,2,F-DTM,56,5,0,0,5,27,29
19900827-W-US_Open-R16-Steffi_Graf-Jennifer_Capriati,2,F-DTL,7,4,0,0,4,1,6
19900827-W-US_Open-R16-Steffi_Graf-Jennifer_Capriati,2,F-IO,9,2,1,0,1,4,5
19900827-W-US_Open-R16-Steffi_Graf-Jennifer_Capriati,2,B-XC,18,4,1,1,2,7,11
19900827-W-US_Open-R16-Steffi_Graf-Jennifer_Capriati,2,B-DTM,24,4,0,1,3,10,14
19900827-W-US_Open-R16-Steffi_Graf-Jennifer_Capriati,2,B-DTL,5,1,1,0,0,3,2
19900827-W-US_Open-R16-Steffi_Graf-Jennifer_Capriati,2,B-IO,2,1,1,0,0,2,0
19900827-W-US_Open-R16-Steffi_Graf-Jennifer_Capriati,2,S-XC,5,1,0,0,1,1,4
19900827-W-US_Open-R16-Steffi_Graf-Jennifer_Capriati,2,S-DTM,1,0,0,0,0,1,0
19900827-W-US_Open-R16-Steffi_Graf-Jennifer_Capriati,2,S-IO,1,0,0,0,0,1,0
19821129-W-Australian_Open-F-Martina_Navratilova-Chris_Evert,1,F-XC,43,3,1,0,2,16,27
19821129-W-Australian_Open-F-Martina_Navratilova-Chris_Evert,1,F-DTM,36,3,0,0,3,10,26
19821129-W-Australian_Open-F-Martina_Navratilova-Chris_Evert,1,F-DTL,11,6,1,3,2,8,3
19821129-W-Australian_Open-F-Martina_Navratilova-Chris_Evert,1,F-IO,6,3,1,1,1,3,3
19821129-W-Australian_Open-F-Martina_Navratilova-Chris_Evert,1,B-XC,7,4,1,1,2,2,5
19821129-W-Australian_Open-F-Martina_Navratilova-Chris_Evert,1,B-DTM,3,1,0,0,1,0,3
19821129-W-Australian_Open-F-Martina_Navratilova-Chris_Evert,1,B-DTL,1,0,0,0,0,1,0
19821129-W-Australian_Open-F-Martina_Navratilova-Chris_Evert,1,B-IO,3,0,0,0,0,1,2
19821129-W-Australian_Open-F-Martina_Navratilova-Chris_Evert,1,S-XC,24,4,3,0,1,14,10
19821129-W-Australian_Open-F-Martina_Navratilova-Chris_Evert,1,S-DTM,55,4,0,1,3,17,38
19821129-W-Australian_Open-F-Martina_Navratilova-Chris_Evert,1,S-DTL,13,2,1,0,1,7,6
19821129-W-Australian_Open-F-Martina_Navratilova-Chris_Evert,1,S-IO,10,1,0,0,1,6,4
19821129-W-Australian_Open-F-Martina_Navratilova-Chris_Evert,2,F-XC,48,10,3,3,4,26,22
19821129-W-Australian_Open-F-Martina_Navratilova-Chris_Evert,2,F-DTM,28,2,0,0,2,9,19
19821129-W-Australian_Open-F-Martina_Navratilova-Chris_Evert,2,F-DTL,2,2,0,1,1,1,1
19821129-W-Australian_Open-F-Martina_Navratilova-Chris_Evert,2,F-IO,6,1,0,0,1,2,4
19821129-W-Australian_Open-F-Martina_Navratilova-Chris_Evert,2,B-XC,70,12,4,8,0,40,30
19821129-W-Australian_Open-F-Martina_Navratilova-Chris_Evert,2,B-DTM,48,2,0,1,1,29,19
19821129-W-Australian_Open-F-Martina_Navratilova-Chris_Evert,2,B-DTL,3,1,1,0,0,3,0
19821129-W-Australian_Open-F-Martina_Navratilova-Chris_Evert,2,B-IO,9,1,0,0,1,6,3
19821129-W-Australian_Open-F-Martina_Navratilova-Chris_Evert,2,S-DTM,14,1,0,1,0,11,3
19821129-W-Australian_Open-F-Martina_Navratilova-Chris_Evert,2,S-DTL,1,0,0,0,0,1,0
19821129-W-Australian_Open-F-Martina_Navratilova-Chris_Evert,2,S-IO,2,0,0,0,0,1,1
20150824-W-New_Haven-R32-Eugenie_Bouchard-Roberta_Vinci,1,F-XC,16,4,2,0,2,7,9
20150824-W-New_Haven-R32-Eugenie_Bouchard-Roberta_Vinci,1,F-DTM,10,1,0,0,1,1,9
20150824-W-New_Haven-R32-Eugenie_Bouchard-Roberta_Vinci,1,F-DTL,7,4,1,1,2,2,5
20150824-W-New_Haven-R32-Eugenie_Bouchard-Roberta_Vinci,1,F-IO,23,4,1,1,2,8,15
20150824-W-New_Haven-R32-Eugenie_Bouchard-Roberta_Vinci,1,B-XC,36,6,0,1,5,12,24
20150824-W-New_Haven-R32-Eugenie_Bouchard-Roberta_Vinci,1,B-DTM,13,2,0,1,1,5,8
20150824-W-New_Haven-R32-Eugenie_Bouchard-Roberta_Vinci,1,B-DTL,6,3,0,0,3,1,5
20150824-W-New_Haven-R32-Eugenie_Bouchard-Roberta_Vinci,1,B-IO,3,1,0,1,0,1,2
20150824-W-New_Haven-R32-Eugenie_Bouchard-Roberta_Vinci,1,S-DTM,3,1,0,0,1,1,2
20150824-W-New_Haven-R32-Eugenie_Bouchard-Roberta_Vinci,2,F-XC,13,4,2,0,2,10,3
20150824-W-New_Haven-R32-Eugenie_Bouchard-Roberta_Vinci,2,F-DTM,10,0,0,0,0,5,5
20150824-W-New_Haven-R32-Eugenie_Bouchard-Roberta_Vinci,2,F-DTL,8,2,2,0,0,6,2
20150824-W-New_Haven-R32-Eugenie_Bouchard-Roberta_Vinci,2,F-IO,13,4,2,0,2,9,4
20150824-W-New_Haven-R32-Eugenie_Bouchard-Roberta_Vinci,2,B-DTM,4,1,0,0,1,1,3
20150824-W-New_Haven-R32-Eugenie_Bouchard-Roberta_Vinci,2,B-DTL,1,0,0,0,0,0,1
20150824-W-New_Haven-R32-Eugenie_Bouchard-Roberta_Vinci,2,S-XC,22,3,1,1,1,16,6
20150824-W-New_Haven-R32-Eugenie_Bouchard-Roberta_Vinci,2,S-DTM,25,2,0,0,2,16,9
20150824-W-New_Haven-R32-Eugenie_Bouchard-Roberta_Vinci,2,S-DTL,8,2,2,0,0,7,1
20150824-W-New_Haven-R32-Eugenie_Bouchard-Roberta_Vinci,2,S-IO,1,0,0,0,0,0,1
20150808-W-Stanford-SF-Angelique_Kerber-Elina_Svitolina,1,F-XC,56,9,2,3,4,33,23
20150808-W-Stanford-SF-Angelique_Kerber-Elina_Svitolina,1,F-DTM,30,2,1,0,1,21,9
20150808-W-Stanford-SF-Angelique_Kerber-Elina_Svitolina,1,F-DTL,21,11,5,2,4,11,10
20150808-W-Stanford-SF-Angelique_Kerber-Elina_Svitolina,1,F-IO,10,6,3,2,1,6,4
20150808-W-Stanford-SF-Angelique_Kerber-Elina_Svitolina,1,B-XC,28,9,2,2,5,16,12
20150808-W-Stanford-SF-Angelique_Kerber-Elina_Svitolina,1,B-DTM,25,1,0,0,1,14,11
20150808-W-Stanford-SF-Angelique_Kerber-Elina_Svitolina,1,B-DTL,4,1,1,0,0,2,2
20150808-W-Stanford-SF-Angelique_Kerber-Elina_Svitolina,1,B-IO,9,0,0,0,0,5,4
20150808-W-Stanford-SF-Angelique_Kerber-Elina_Svitolina,1,S-XC,2,0,0,0,0,0,2
20150808-W-Stanford-SF-Angelique_Kerber-Elina_Svitolina,1,S-DTM,4,0,0,0,0,2,2
20150808-W-Stanford-SF-Angelique_Kerber-Elina_Svitolina,1,S-IO,1,0,0,0,0,1,0
20150808-W-Stanford-SF-Angelique_Kerber-Elina_Svitolina,2,F-XC,31,4,3,0,1,14,17
20150808-W-Stanford-SF-Angelique_Kerber-Elina_Svitolina,2,F-DTM,31,1,0,0,1,12,19
20150808-W-Stanford-SF-Angelique_Kerber-Elina_Svitolina,2,F-DTL,1,1,1,0,0,1,0
20150808-W-Stanford-SF-Angelique_Kerber-Elina_Svitolina,2,F-IO,8,5,1,1,3,4,4
20150808-W-Stanford-SF-Angelique_Kerber-Elina_Svitolina,2,B-XC,40,6,2,0,4,16,24
20150808-W-Stanford-SF-Angelique_Kerber-Elina_Svitolina,2,B-DTM,35,6,0,1,5,10,25
20150808-W-Stanford-SF-Angelique_Kerber-Elina_Svitolina,2,B-DTL,8,2,0,0,2,4,4
20150808-W-Stanford-SF-Angelique_Kerber-Elina_Svitolina,2,B-IO,7,3,0,0,3,0,7
20150808-W-Stanford-SF-Angelique_Kerber-Elina_Svitolina,2,S-XC,5,0,0,0,0,2,3
20150808-W-Stanford-SF-Angelique_Kerber-Elina_Svitolina,2,S-DTM,1,0,0,0,0,1,0
20150808-W-Stanford-SF-Angelique_Kerber-Elina_Svitolina,2,S-IO,1,0,0,0,0,0,1
20150829-W-New_Haven-F-Petra_Kvitova-Lucie_Safarova,1,F-XC,37,15,5,5,5,24,13
20150829-W-New_Haven-F-Petra_Kvitova-Lucie_Safarova,1,F-DTM,27,3,0,0,3,17,10
20150829-W-New_Haven-F-Petra_Kvitova-Lucie_Safarova,1,F-DTL,8,2,2,0,0,6,2
20150829-W-New_Haven-F-Petra_Kvitova-Lucie_Safarova,1,F-IO,17,4,0,1,3,12,5
20150829-W-New_Haven-F-Petra_Kvitova-Lucie_Safarova,1,F-II,1,0,0,0,0,1,0
20150829-W-New_Haven-F-Petra_Kvitova-Lucie_Safarova,1,B-XC,27,14,4,2,8,15,12
20150829-W-New_Haven-F-Petra_Kvitova-Lucie_Safarova,1,B-DTM,21,5,0,2,3,8,13
20150829-W-New_Haven-F-Petra_Kvitova-Lucie_Safarova,1,B-DTL,2,1,1,0,0,2,0
20150829-W-New_Haven-F-Petra_Kvitova-Lucie_Safarova,1,B-IO,1,1,0,0,1,0,1
20150829-W-New_Haven-F-Petra_Kvitova-Lucie_Safarova,1,S-XC,4,0,0,0,0,3,1
20150829-W-New_Haven-F-Petra_Kvitova-Lucie_Safarova,1,S-DTM,3,0,0,0,0,1,2
20150829-W-New_Haven-F-Petra_Kvitova-Lucie_Safarova,2,F-XC,31,10,4,4,2,16,15
20150829-W-New_Haven-F-Petra_Kvitova-Lucie_Safarova,2,F-DTM,28,3,0,0,3,7,21
20150829-W-New_Haven-F-Petra_Kvitova-Lucie_Safarova,2,F-DTL,13,5,3,1,1,8,5
20150829-W-New_Haven-F-Petra_Kvitova-Lucie_Safarova,2,F-IO,14,6,5,0,1,11,3
20150829-W-New_Haven-F-Petra_Kvitova-Lucie_Safarova,2,F-II,2,1,0,1,0,1,1
20150829-W-New_Haven-F-Petra_Kvitova-Lucie_Safarova,2,B-XC,15,6,1,1,4,7,8
20150829-W-New_Haven-F-Petra_Kvitova-Lucie_Safarova,2,B-DTM,27,5,0,1,4,9,18
20150829-W-New_Haven-F-Petra_Kvitova-Lucie_Safarova,2,B-DTL,12,9,1,1,7,4,8
20150829-W-New_Haven-F-Petra_Kvitova-Lucie_Safarova,2,B-IO,9,1,0,0,1,5,4
20150829-W-New_Haven-F-Petra_Kvitova-Lucie_Safarova,2,S-XC,1,0,0,0,0,0,1
20150829-W-New_Haven-F-Petra_Kvitova-Lucie_Safarova,2,S-DTM,4,0,0,0,0,0,4
20150829-W-New_Haven-F-Petra_Kvitova-Lucie_Safarova,2,S-DTL,2,0,0,0,0,1,1
20150831-W-US_Open-R128-Dominika_Cibulkova-Ana_Ivanovic,1,F-XC,23,9,4,1,4,15,8
20150831-W-US_Open-R128-Dominika_Cibulkova-Ana_Ivanovic,1,F-DTM,17,0,0,0,0,11,6
20150831-W-US_Open-R128-Dominika_Cibulkova-Ana_Ivanovic,1,F-DTL,9,5,2,2,1,7,2
20150831-W-US_Open-R128-Dominika_Cibulkova-Ana_Ivanovic,1,F-IO,28,12,6,1,5,19,9
20150831-W-US_Open-R128-Dominika_Cibulkova-Ana_Ivanovic,1,F-II,2,1,0,1,0,2,0
20150831-W-US_Open-R128-Dominika_Cibulkova-Ana_Ivanovic,1,B-XC,38,12,1,3,8,20,18
20150831-W-US_Open-R128-Dominika_Cibulkova-Ana_Ivanovic,1,B-DTM,32,8,0,0,8,14,18
20150831-W-US_Open-R128-Dominika_Cibulkova-Ana_Ivanovic,1,B-DTL,3,1,0,0,1,1,2
20150831-W-US_Open-R128-Dominika_Cibulkova-Ana_Ivanovic,1,B-IO,3,3,1,2,0,3,0
20150831-W-US_Open-R128-Dominika_Cibulkova-Ana_Ivanovic,1,S-DTM,1,0,0,0,0,1,0
20150831-W-US_Open-R128-Dominika_Cibulkova-Ana_Ivanovic,1,S-IO,2,0,0,0,0,1,1
20150831-W-US_Open-R128-Dominika_Cibulkova-Ana_Ivanovic,2,F-XC,30,16,8,2,6,15,15
20150831-W-US_Open-R128-Dominika_Cibulkova-Ana_Ivanovic,2,F-DTM,24,2,0,0,2,7,17
20150831-W-US_Open-R128-Dominika_Cibulkova-Ana_Ivanovic,2,F-DTL,7,2,1,0,1,3,4
20150831-W-US_Open-R128-Dominika_Cibulkova-Ana_Ivanovic,2,F-IO,17,5,0,2,3,8,9
20150831-W-US_Open-R128-Dominika_Cibulkova-Ana_Ivanovic,2,F-II,1,0,0,0,0,1,0
20150831-W-US_Open-R128-Dominika_Cibulkova-Ana_Ivanovic,2,B-XC,21,4,0,0,4,9,12
20150831-W-US_Open-R128-Dominika_Cibulkova-Ana_Ivanovic,2,B-DTM,19,3,0,0,3,8,11
20150831-W-US_Open-R128-Dominika_Cibulkova-Ana_Ivanovic,2,S-XC,7,0,0,0,0,1,6
20150831-W-US_Open-R128-Dominika_Cibulkova-Ana_Ivanovic,2,S-DTM,9,0,0,0,0,2,7
20150831-W-US_Open-R128-Dominika_Cibulkova-Ana_Ivanovic,2,S-DTL,2,0,0,0,0,1,1
20140903-W-US_Open-QF-Serena_Williams-Flavia_Pennetta,1,F-XC,13,7,5,1,1,10,3
20140903-W-US_Open-QF-Serena_Williams-Flavia_Pennetta,1,F-DTM,16,3,1,0,2,5,11
20140903-W-US_Open-QF-Serena_Williams-Flavia_Pennetta,1,F-DTL,4,3,2,1,0,4,0
20140903-W-US_Open-QF-Serena_Williams-Flavia_Pennetta,1,F-IO,3,2,1,1,0,3,0
20140903-W-US_Open-QF-Serena_Williams-Flavia_Pennetta,1,F-II,1,1,1,0,0,1,0
20140903-W-US_Open-QF-Serena_Williams-Flavia_Pennetta,1,B-XC,14,8,4,2,2,10,4
20140903-W-US_Open-QF-Serena_Williams-Flavia_Pennetta,1,B-DTM,20,2,0,0,2,13,7
20140903-W-US_Open-QF-Serena_Williams-Flavia_Pennetta,1,B-DTL,8,2,1,0,1,3,5
20140903-W-US_Open-QF-Serena_Williams-Flavia_Pennetta,1,B-IO,9,4,1,1,2,6,3
20140903-W-US_Open-QF-Serena_Williams-Flavia_Pennetta,2,F-XC,14,4,1,1,2,8,6
20140903-W-US_Open-QF-Serena_Williams-Flavia_Pennetta,2,F-DTM,20,4,0,0,4,5,15
20140903-W-US_Open-QF-Serena_Williams-Flavia_Pennetta,2,F-DTL,6,1,0,1,0,4,2
20140903-W-US_Open-QF-Serena_Williams-Flavia_Pennetta,2,F-IO,10,4,1,0,3,2,8
20140903-W-US_Open-QF-Serena_Williams-Flavia_Pennetta,2,B-XC,11,5,1,3,1,5,6
20140903-W-US_Open-QF-Serena_Williams-Flavia_Pennetta,2,B-DTM,17,4,0,0,4,5,12
20140903-W-US_Open-QF-Serena_Williams-Flavia_Pennetta,2,B-DTL,2,1,1,0,0,1,1
20140903-W-US_Open-QF-Serena_Williams-Flavia_Pennetta,2,B-IO,2,1,0,0,1,1,1
20140903-W-US_Open-QF-Serena_Williams-Flavia_Pennetta,2,S-DTM,3,0,0,0,0,1,2
20140903-W-US_Open-QF-Serena_Williams-Flavia_Pennetta,2,S-DTL,1,0,0,0,0,0,1
20000117-W-Australian_Open-R64-Martina_Hingis-Justine_Henin,1,F-XC,18,6,3,1,2,11,7
20000117-W-Australian_Open-R64-Martina_Hingis-Justine_Henin,1,F-DTM,34,1,0,1,0,26,8
20000117-W-Australian_Open-R64-Martina_Hingis-Justine_Henin,1,F-DTL,6,2,1,1,0,4,2
20000117-W-Australian_Open-R64-Martina_Hingis-Justine_Henin,1,F-IO,18,4,0,3,1,10,8
20000117-W-Australian_Open-R64-Martina_Hingis-Justine_Henin,1,B-XC,27,1,0,0,1,19,8
20000117-W-Australian_Open-R64-Martina_Hingis-Justine_Henin,1,B-DTM,42,2,1,1,0,25,17
20000117-W-Australian_Open-R64-Martina_Hingis-Justine_Henin,1,B-DTL,6,6,5,0,1,5,1
20000117-W-Australian_Open-R64-Martina_Hingis-Justine_Henin,1,B-IO,15,7,3,3,1,11,4
20000117-W-Australian_Open-R64-Martina_Hingis-Justine_Henin,1,S-XC,2,0,0,0,0,2,0
20000117-W-Australian_Open-R64-Martina_Hingis-Justine_Henin,1,S-DTM,3,1,0,0,1,0,3
20000117-W-Australian_Open-R64-Martina_Hingis-Justine_Henin,2,F-XC,16,4,2,1,1,9,7
20000117-W-Australian_Open-R64-Martina_Hingis-Justine_Henin,2,F-DTM,35,3,0,0,3,12,23
20000117-W-Australian_Open-R64-Martina_Hingis-Justine_Henin,2,F-DTL,7,3,1,0,2,2,5
20000117-W-Australian_Open-R64-Martina_Hingis-Justine_Henin,2,F-IO,16,7,4,0,3,8,8
20000117-W-Australian_Open-R64-Martina_Hingis-Justine_Henin,2,B-XC,15,5,2,2,1,6,9
20000117-W-Australian_Open-R64-Martina_Hingis-Justine_Henin,2,B-DTM,37,2,0,1,1,13,24
20000117-W-Australian_Open-R64-Martina_Hingis-Justine_Henin,2,B-DTL,2,2,1,0,1,1,1
20000117-W-Australian_Open-R64-Martina_Hingis-Justine_Henin,2,B-IO,3,2,1,0,1,1,2
20000117-W-Australian_Open-R64-Martina_Hingis-Justine_Henin,2,S-XC,15,1,0,0,1,5,10
20000117-W-Australian_Open-R64-Martina_Hingis-Justine_Henin,2,S-DTM,22,1,0,0,1,9,13
20000117-W-Australian_Open-R64-Martina_Hingis-Justine_Henin,2,S-DTL,1,0,0,0,0,0,1
20000117-W-Australian_Open-R64-Martina_Hingis-Justine_Henin,2,S-IO,2,0,0,0,0,1,1
20150911-W-US_Open-SF-Serena_Williams-Roberta_Vinci,1,F-XC,39,8,3,2,3,21,18
20150911-W-US_Open-SF-Serena_Williams-Roberta_Vinci,1,F-DTM,11,0,0,0,0,4,7
20150911-W-US_Open-SF-Serena_Williams-Roberta_Vinci,1,F-DTL,11,5,2,1,2,5,6
20150911-W-US_Open-SF-Serena_Williams-Roberta_Vinci,1,F-IO,17,5,1,1,3,9,8
20150911-W-US_Open-SF-Serena_Williams-Roberta_Vinci,1,F-II,1,1,1,0,0,1,0
20150911-W-US_Open-SF-Serena_Williams-Roberta_Vinci,1,B-XC,55,18,2,4,12,23,32
20150911-W-US_Open-SF-Serena_Williams-Roberta_Vinci,1,B-DTM,15,0,0,0,0,6,9
20150911-W-US_Open-SF-Serena_Williams-Roberta_Vinci,1,B-DTL,25,2,1,0,1,9,16
20150911-W-US_Open-SF-Serena_Williams-Roberta_Vinci,1,B-IO,12,6,1,0,5,2,10
20150911-W-US_Open-SF-Serena_Williams-Roberta_Vinci,1,S-DTL,2,0,0,0,0,1,1
20150911-W-US_Open-SF-Serena_Williams-Roberta_Vinci,1,S-IO,1,0,0,0,0,0,1
20150911-W-US_Open-SF-Serena_Williams-Roberta_Vinci,2,F-XC,44,11,3,3,5,25,19
20150911-W-US_Open-SF-Serena_Williams-Roberta_Vinci,2,F-DTM,21,0,0,0,0,15,6
20150911-W-US_Open-SF-Serena_Williams-Roberta_Vinci,2,F-DTL,22,5,1,1,3,14,8
20150911-W-US_Open-SF-Serena_Williams-Roberta_Vinci,2,F-IO,20,5,1,3,1,13,7
20150911-W-US_Open-SF-Serena_Williams-Roberta_Vinci,2,F-II,1,1,1,0,0,1,0
20150911-W-US_Open-SF-Serena_Williams-Roberta_Vinci,2,B-XC,5,1,0,0,1,3,2
20150911-W-US_Open-SF-Serena_Williams-Roberta_Vinci,2,B-DTM,2,0,0,0,0,0,2
20150911-W-US_Open-SF-Serena_Williams-Roberta_Vinci,2,B-DTL,2,0,0,0,0,0,2
20150911-W-US_Open-SF-Serena_Williams-Roberta_Vinci,2,S-XC,27,1,0,1,0,15,12
20150911-W-US_Open-SF-Serena_Williams-Roberta_Vinci,2,S-DTM,29,0,0,0,0,20,9
20150911-W-US_Open-SF-Serena_Williams-Roberta_Vinci,2,S-DTL,4,1,0,0,1,1,3
20131016-W-Luxembourg-R32-Andrea_Petkovic-Eugenie_Bouchard,1,F-XC,55,14,4,4,6,33,22
20131016-W-Luxembourg-R32-Andrea_Petkovic-Eugenie_Bouchard,1,F-DTM,40,6,0,0,6,8,32
20131016-W-Luxembourg-R32-Andrea_Petkovic-Eugenie_Bouchard,1,F-DTL,10,4,0,2,2,6,4
20131016-W-Luxembourg-R32-Andrea_Petkovic-Eugenie_Bouchard,1,F-IO,9,5,2,1,2,5,4
20131016-W-Luxembourg-R32-Andrea_Petkovic-Eugenie_Bouchard,1,F-II,4,3,1,1,1,2,2
20131016-W-Luxembourg-R32-Andrea_Petkovic-Eugenie_Bouchard,1,B-XC,32,7,0,2,5,15,17
20131016-W-Luxembourg-R32-Andrea_Petkovic-Eugenie_Bouchard,1,B-DTM,37,3,0,0,3,10,27
20131016-W-Luxembourg-R32-Andrea_Petkovic-Eugenie_Bouchard,1,B-DTL,5,3,2,0,1,2,3
20131016-W-Luxembourg-R32-Andrea_Petkovic-Eugenie_Bouchard,1,B-IO,3,3,1,0,2,1,2
20131016-W-Luxembourg-R32-Andrea_Petkovic-Eugenie_Bouchard,1,S-XC,2,1,1,0,0,1,1
20131016-W-Luxembourg-R32-Andrea_Petkovic-Eugenie_Bouchard,1,S-DTM,6,0,0,0,0,1,5
20131016-W-Luxembourg-R32-Andrea_Petkovic-Eugenie_Bouchard,1,S-DTL,2,0,0,0,0,0,2
20131016-W-Luxembourg-R32-Andrea_Petkovic-Eugenie_Bouchard,2,F-XC,53,16,5,1,10,24,29
20131016-W-Luxembourg-R32-Andrea_Petkovic-Eugenie_Bouchard,2,F-DTM,30,3,0,1,2,16,14
20131016-W-Luxembourg-R32-Andrea_Petkovic-Eugenie_Bouchard,2,F-DTL,13,6,4,0,2,6,7
20131016-W-Luxembourg-R32-Andrea_Petkovic-Eugenie_Bouchard,2,F-IO,27,8,3,3,2,21,6
20131016-W-Luxembourg-R32-Andrea_Petkovic-Eugenie_Bouchard,2,B-XC,31,6,1,0,5,17,14
20131016-W-Luxembourg-R32-Andrea_Petkovic-Eugenie_Bouchard,2,B-DTM,26,4,1,0,3,14,12
20131016-W-Luxembourg-R32-Andrea_Petkovic-Eugenie_Bouchard,2,B-DTL,9,5,3,0,2,5,4
20131016-W-Luxembourg-R32-Andrea_Petkovic-Eugenie_Bouchard,2,B-IO,5,2,1,0,1,3,2
20131016-W-Luxembourg-R32-Andrea_Petkovic-Eugenie_Bouchard,2,S-DTM,3,0,0,0,0,2,1
20150902-W-US_Open-R64-Mariana_Duque_Marino-Oceane_Dodin,1,F-XC,27,6,4,1,1,20,7
20150902-W-US_Open-R64-Mariana_Duque_Marino-Oceane_Dodin,1,F-DTM,41,7,1,1,5,24,17
20150902-W-US_Open-R64-Mariana_Duque_Marino-Oceane_Dodin,1,F-DTL,6,2,1,0,1,2,4
20150902-W-US_Open-R64-Mariana_Duque_Marino-Oceane_Dodin,1,F-IO,25,11,4,1,6,13,12
20150902-W-US_Open-R64-Mariana_Duque_Marino-Oceane_Dodin,1,B-XC,6,1,0,0,1,2,4
20150902-W-US_Open-R64-Mariana_Duque_Marino-Oceane_Dodin,1,B-DTM,13,0,0,0,0,5,8
20150902-W-US_Open-R64-Mariana_Duque_Marino-Oceane_Dodin,1,B-DTL,2,0,0,0,0,1,1
20150902-W-US_Open-R64-Mariana_Duque_Marino-Oceane_Dodin,1,B-IO,5,1,0,0,1,3,2
20150902-W-US_Open-R64-Mariana_Duque_Marino-Oceane_Dodin,1,S-XC,2,0,0,0,0,0,2
20150902-W-US_Open-R64-Mariana_Duque_Marino-Oceane_Dodin,1,S-DTM,15,2,0,0,2,9,6
20150902-W-US_Open-R64-Mariana_Duque_Marino-Oceane_Dodin,1,S-DTL,4,0,0,0,0,1,3
20150902-W-US_Open-R64-Mariana_Duque_Marino-Oceane_Dodin,1,S-IO,3,1,0,0,1,2,1
20150902-W-US_Open-R64-Mariana_Duque_Marino-Oceane_Dodin,2,F-XC,35,15,5,3,7,17,18
20150902-W-US_Open-R64-Mariana_Duque_Marino-Oceane_Dodin,2,F-DTM,36,5,0,2,3,10,26
20150902-W-US_Open-R64-Mariana_Duque_Marino-Oceane_Dodin,2,F-DTL,13,8,2,1,5,4,9
20150902-W-US_Open-R64-Mariana_Duque_Marino-Oceane_Dodin,2,F-IO,10,6,1,0,5,3,7
20150902-W-US_Open-R64-Mariana_Duque_Marino-Oceane_Dodin,2,B-XC,28,9,4,1,4,17,11
20150902-W-US_Open-R64-Mariana_Duque_Marino-Oceane_Dodin,2,B-DTM,34,4,0,0,4,14,20
20150902-W-US_Open-R64-Mariana_Duque_Marino-Oceane_Dodin,2,B-DTL,4,3,1,1,1,2,2
20150902-W-US_Open-R64-Mariana_Duque_Marino-Oceane_Dodin,2,B-IO,11,5,1,0,4,5,6
20150902-W-US_Open-R64-Mariana_Duque_Marino-Oceane_Dodin,2,S-XC,1,1,1,0,0,1,0
20150902-W-US_Open-R64-Mariana_Duque_Marino-Oceane_Dodin,2,S-DTM,2,0,0,0,0,1,1
20150902-W-US_Open-R64-Mariana_Duque_Marino-Oceane_Dodin,2,S-DTL,3,0,0,0,0,1,2
20150831-W-US_Open-R128-Alison_Van_Uytvanck-Jessica_Pegula,1,F-XC,22,8,4,1,3,13,9
20150831-W-US_Open-R128-Alison_Van_Uytvanck-Jessica_Pegula,1,F-DTM,22,2,0,0,2,10,12
20150831-W-US_Open-R128-Alison_Van_Uytvanck-Jessica_Pegula,1,F-DTL,10,3,1,0,2,3,7
20150831-W-US_Open-R128-Alison_Van_Uytvanck-Jessica_Pegula,1,F-IO,11,5,1,1,3,5,6
20150831-W-US_Open-R128-Alison_Van_Uytvanck-Jessica_Pegula,1,F-II,1,1,0,1,0,1,0
20150831-W-US_Open-R128-Alison_Van_Uytvanck-Jessica_Pegula,1,B-XC,4,3,0,0,3,0,4
20150831-W-US_Open-R128-Alison_Van_Uytvanck-Jessica_Pegula,1,B-DTM,28,5,0,1,4,11,17
20150831-W-US_Open-R128-Alison_Van_Uytvanck-Jessica_Pegula,1,B-DTL,5,4,1,0,3,1,4
20150831-W-US_Open-R128-Alison_Van_Uytvanck-Jessica_Pegula,1,B-IO,2,0,0,0,0,1,1
20150831-W-US_Open-R128-Alison_Van_Uytvanck-Jessica_Pegula,1,S-XC,7,2,0,0,2,1,6
20150831-W-US_Open-R128-Alison_Van_Uytvanck-Jessica_Pegula,1,S-DTM,12,1,0,0,1,4,8
20150831-W-US_Open-R128-Alison_Van_Uytvanck-Jessica_Pegula,1,S-DTL,1,0,0,0,0,1,0
20150831-W-US_Open-R128-Alison_Van_Uytvanck-Jessica_Pegula,2,F-XC,25,8,1,1,6,15,10
20150831-W-US_Open-R128-Alison_Van_Uytvanck-Jessica_Pegula,2,F-DTM,18,2,0,0,2,8,10
20150831-W-US_Open-R128-Alison_Van_Uytvanck-Jessica_Pegula,2,F-DTL,6,4,2,1,1,5,1
20150831-W-US_Open-R128-Alison_Van_Uytvanck-Jessica_Pegula,2,F-IO,13,7,3,2,2,10,3
20150831-W-US_Open-R128-Alison_Van_Uytvanck-Jessica_Pegula,2,B-XC,14,3,2,0,1,12,2
20150831-W-US_Open-R128-Alison_Van_Uytvanck-Jessica_Pegula,2,B-DTM,33,8,0,3,5,16,17
20150831-W-US_Open-R128-Alison_Van_Uytvanck-Jessica_Pegula,2,B-DTL,2,2,2,0,0,2,0
20150831-W-US_Open-R128-Alison_Van_Uytvanck-Jessica_Pegula,2,B-IO,5,2,1,1,0,3,2
20150831-W-US_Open-R128-Alison_Van_Uytvanck-Jessica_Pegula,2,S-XC,4,1,1,0,0,4,0
20150831-W-US_Open-R128-Alison_Van_Uytvanck-Jessica_Pegula,2,S-DTM,6,1,0,0,1,4,2
19991101-W-Leipzig-R16-Sandrine_Testud-Anna_Kournikova,1,F-XC,11,5,3,2,0,8,3
19991101-W-Leipzig-R16-Sandrine_Testud-Anna_Kournikova,1,F-DTM,10,1,0,0,1,3,7
19991101-W-Leipzig-R16-Sandrine_Testud-Anna_Kournikova,1,F-DTL,6,2,0,1,1,3,3
19991101-W-Leipzig-R16-Sandrine_Testud-Anna_Kournikova,1,F-IO,9,2,0,0,2,3,6
19991101-W-Leipzig-R16-Sandrine_Testud-Anna_Kournikova,1,B-XC,42,9,1,1,7,15,27
19991101-W-Leipzig-R16-Sandrine_Testud-Anna_Kournikova,1,B-DTM,13,1,0,0,1,7,6
19991101-W-Leipzig-R16-Sandrine_Testud-Anna_Kournikova,1,B-DTL,4,3,1,0,2,2,2
19991101-W-Leipzig-R16-Sandrine_Testud-Anna_Kournikova,1,B-IO,2,2,0,0,2,0,2
19991101-W-Leipzig-R16-Sandrine_Testud-Anna_Kournikova,1,S-DTM,3,0,0,0,0,0,3
19991101-W-Leipzig-R16-Sandrine_Testud-Anna_Kournikova,1,S-DTL,1,0,0,0,0,0,1
19991101-W-Leipzig-R16-Sandrine_Testud-Anna_Kournikova,2,F-XC,17,10,7,0,3,10,7
19991101-W-Leipzig-R16-Sandrine_Testud-Anna_Kournikova,2,F-DTM,7,1,0,0,1,3,4
19991101-W-Leipzig-R16-Sandrine_Testud-Anna_Kournikova,2,F-DTL,2,2,1,0,1,1,1
19991101-W-Leipzig-R16-Sandrine_Testud-Anna_Kournikova,2,F-IO,16,9,6,1,2,12,4
19991101-W-Leipzig-R16-Sandrine_Testud-Anna_Kournikova,2,F-II,4,2,2,0,0,4,0
19991101-W-Leipzig-R16-Sandrine_Testud-Anna_Kournikova,2,B-XC,27,3,1,0,2,16,11
19991101-W-Leipzig-R16-Sandrine_Testud-Anna_Kournikova,2,B-DTM,20,2,0,1,1,13,7
19991101-W-Leipzig-R16-Sandrine_Testud-Anna_Kournikova,2,B-DTL,8,5,2,0,3,3,5
19991101-W-Leipzig-R16-Sandrine_Testud-Anna_Kournikova,2,S-XC,3,0,0,0,0,0,3
19991101-W-Leipzig-R16-Sandrine_Testud-Anna_Kournikova,2,S-DTM,3,0,0,0,0,0,3
20150802-W-Baku-F-Margarita_Gasparyan-Patricia_Maria_Tig,1,F-XC,62,8,2,1,5,31,31
20150802-W-Baku-F-Margarita_Gasparyan-Patricia_Maria_Tig,1,F-DTM,20,0,0,0,0,9,11
20150802-W-Baku-F-Margarita_Gasparyan-Patricia_Maria_Tig,1,F-DTL,51,18,5,3,10,22,29
20150802-W-Baku-F-Margarita_Gasparyan-Patricia_Maria_Tig,1,F-IO,18,6,2,2,2,13,5
20150802-W-Baku-F-Margarita_Gasparyan-Patricia_Maria_Tig,1,B-XC,39,9,3,4,2,18,21
20150802-W-Baku-F-Margarita_Gasparyan-Patricia_Maria_Tig,1,B-DTM,15,1,0,0,1,4,11
20150802-W-Baku-F-Margarita_Gasparyan-Patricia_Maria_Tig,1,B-DTL,22,7,1,2,4,11,11
20150802-W-Baku-F-Margarita_Gasparyan-Patricia_Maria_Tig,1,B-IO,9,2,0,0,2,3,6
20150802-W-Baku-F-Margarita_Gasparyan-Patricia_Maria_Tig,1,S-XC,10,2,0,1,1,4,6
20150802-W-Baku-F-Margarita_Gasparyan-Patricia_Maria_Tig,1,S-DTM,9,0,0,0,0,4,5
20150802-W-Baku-F-Margarita_Gasparyan-Patricia_Maria_Tig,2,F-XC,102,24,7,1,16,51,51
20150802-W-Baku-F-Margarita_Gasparyan-Patricia_Maria_Tig,2,F-DTM,17,4,0,2,2,5,12
20150802-W-Baku-F-Margarita_Gasparyan-Patricia_Maria_Tig,2,F-DTL,15,8,3,1,4,7,8
20150802-W-Baku-F-Margarita_Gasparyan-Patricia_Maria_Tig,2,F-IO,27,7,2,2,3,16,11
20150802-W-Baku-F-Margarita_Gasparyan-Patricia_Maria_Tig,2,B-XC,48,9,3,2,4,29,19
20150802-W-Baku-F-Margarita_Gasparyan-Patricia_Maria_Tig,2,B-DTM,21,2,0,0,2,12,9
20150802-W-Baku-F-Margarita_Gasparyan-Patricia_Maria_Tig,2,B-DTL,13,7,2,0,5,5,8
20150802-W-Baku-F-Margarita_Gasparyan-Patricia_Maria_Tig,2,S-XC,8,1,0,0,1,3,5
20150802-W-Baku-F-Margarita_Gasparyan-Patricia_Maria_Tig,2,S-DTM,5,0,0,0,0,3,2
20150802-W-Baku-F-Margarita_Gasparyan-Patricia_Maria_Tig,2,S-DTL,2,0,0,0,0,1,1
20150802-W-Baku-F-Margarita_Gasparyan-Patricia_Maria_Tig,2,S-IO,1,0,0,0,0,0,1
20120730-W-Olympics-R16-Vera_Zvonareva-Serena_Williams,1,F-XC,5,0,0,0,0,4,1
20120730-W-Olympics-R16-Vera_Zvonareva-Serena_Williams,1,F-DTM,9,1,0,0,1,3,6
20120730-W-Olympics-R16-Vera_Zvonareva-Serena_Williams,1,F-DTL,10,4,2,0,2,7,3
20120730-W-Olympics-R16-Vera_Zvonareva-Serena_Williams,1,F-IO,7,3,1,1,1,3,4
20120730-W-Olympics-R16-Vera_Zvonareva-Serena_Williams,1,B-XC,9,1,0,1,0,6,3
20120730-W-Olympics-R16-Vera_Zvonareva-Serena_Williams,1,B-DTM,15,3,0,1,2,5,10
20120730-W-Olympics-R16-Vera_Zvonareva-Serena_Williams,1,B-DTL,2,1,0,0,1,0,2
20120730-W-Olympics-R16-Vera_Zvonareva-Serena_Williams,1,S-DTM,1,0,0,0,0,0,1
20120730-W-Olympics-R16-Vera_Zvonareva-Serena_Williams,1,S-DTL,1,0,0,0,0,1,0
20120730-W-Olympics-R16-Vera_Zvonareva-Serena_Williams,2,F-XC,14,8,7,1,0,11,3
20120730-W-Olympics-R16-Vera_Zvonareva-Serena_Williams,2,F-DTM,3,2,0,1,1,2,1
20120730-W-Olympics-R16-Vera_Zvonareva-Serena_Williams,2,F-DTL,3,3,1,0,2,1,2
20120730-W-Olympics-R16-Vera_Zvonareva-Serena_Williams,2,F-IO,4,2,2,0,0,3,1
20120730-W-Olympics-R16-Vera_Zvonareva-Serena_Williams,2,B-XC,16,6,2,1,3,7,9
20120730-W-Olympics-R16-Vera_Zvonareva-Serena_Williams,2,B-DTM,8,2,0,0,2,2,6
20120730-W-Olympics-R16-Vera_Zvonareva-Serena_Williams,2,B-DTL,4,3,1,0,2,2,2
20120730-W-Olympics-R16-Vera_Zvonareva-Serena_Williams,2,B-IO,5,3,1,0,2,1,4
20120730-W-Olympics-R16-Vera_Zvonareva-Serena_Williams,2,S-XC,1,0,0,0,0,1,0
20120730-W-Olympics-R16-Vera_Zvonareva-Serena_Williams,2,S-DTM,1,0,0,0,0,0,1
20150912-W-US_Open-F-Roberta_Vinci-Flavia_Pennetta,1,F-XC,44,6,3,1,2,24,20
20150912-W-US_Open-F-Roberta_Vinci-Flavia_Pennetta,1,F-DTM,38,3,0,1,2,14,24
20150912-W-US_Open-F-Roberta_Vinci-Flavia_Pennetta,1,F-DTL,7,4,3,0,1,6,1
20150912-W-US_Open-F-Roberta_Vinci-Flavia_Pennetta,1,F-IO,29,7,2,1,4,13,16
20150912-W-US_Open-F-Roberta_Vinci-Flavia_Pennetta,1,F-II,5,1,0,0,1,1,4
20150912-W-US_Open-F-Roberta_Vinci-Flavia_Pennetta,1,B-XC,5,3,1,1,1,3,2
20150912-W-US_Open-F-Roberta_Vinci-Flavia_Pennetta,1,B-DTM,5,1,0,0,1,3,2
20150912-W-US_Open-F-Roberta_Vinci-Flavia_Pennetta,1,B-DTL,1,0,0,0,0,0,1
20150912-W-US_Open-F-Roberta_Vinci-Flavia_Pennetta,1,S-XC,54,1,0,1,0,20,34
20150912-W-US_Open-F-Roberta_Vinci-Flavia_Pennetta,1,S-DTM,75,10,0,0,10,19,56
20150912-W-US_Open-F-Roberta_Vinci-Flavia_Pennetta,1,S-DTL,12,2,0,0,2,3,9
20150912-W-US_Open-F-Roberta_Vinci-Flavia_Pennetta,1,S-IO,6,4,0,1,3,2,4
20150912-W-US_Open-F-Roberta_Vinci-Flavia_Pennetta,2,F-XC,26,8,1,2,5,15,11
20150912-W-US_Open-F-Roberta_Vinci-Flavia_Pennetta,2,F-DTM,62,2,0,1,1,34,28
20150912-W-US_Open-F-Roberta_Vinci-Flavia_Pennetta,2,F-DTL,18,2,2,0,0,11,7
20150912-W-US_Open-F-Roberta_Vinci-Flavia_Pennetta,2,F-IO,13,3,2,1,0,10,3
20150912-W-US_Open-F-Roberta_Vinci-Flavia_Pennetta,2,B-XC,97,8,2,2,4,68,29
20150912-W-US_Open-F-Roberta_Vinci-Flavia_Pennetta,2,B-DTM,44,7,2,1,4,21,23
20150912-W-US_Open-F-Roberta_Vinci-Flavia_Pennetta,2,B-DTL,12,10,5,1,4,7,5
20150912-W-US_Open-F-Roberta_Vinci-Flavia_Pennetta,2,B-IO,7,3,1,1,1,5,2
20150912-W-US_Open-F-Roberta_Vinci-Flavia_Pennetta,2,S-XC,5,1,0,0,1,2,3
20150912-W-US_Open-F-Roberta_Vinci-Flavia_Pennetta,2,S-DTM,4,1,0,0,1,3,1
20150909-W-US_Open-QF-Venus_Williams-Serena_Williams,1,F-XC,17,10,5,0,5,8,9
20150909-W-US_Open-QF-Venus_Williams-Serena_Williams,1,F-DTM,17,2,0,0,2,10,7
20150909-W-US_Open-QF-Venus_Williams-Serena_Williams,1,F-DTL,4,3,1,0,2,1,3
20150909-W-US_Open-QF-Venus_Williams-Serena_Williams,1,F-IO,13,7,2,2,3,7,6
20150909-W-US_Open-QF-Venus_Williams-Serena_Williams,1,B-XC,22,5,2,0,3,9,13
20150909-W-US_Open-QF-Venus_Williams-Serena_Williams,1,B-DTM,19,1,0,0,1,6,13
20150909-W-US_Open-QF-Venus_Williams-Serena_Williams,1,B-DTL,3,3,0,2,1,2,1
20150909-W-US_Open-QF-Venus_Williams-Serena_Williams,1,B-IO,2,2,1,0,1,1,1
20150909-W-US_Open-QF-Venus_Williams-Serena_Williams,1,S-XC,1,0,0,0,0,0,1
20150909-W-US_Open-QF-Venus_Williams-Serena_Williams,1,S-DTM,1,0,0,0,0,0,1
20150909-W-US_Open-QF-Venus_Williams-Serena_Williams,2,F-XC,18,8,4,0,4,9,9
20150909-W-US_Open-QF-Venus_Williams-Serena_Williams,2,F-DTM,17,4,2,0,2,8,9
20150909-W-US_Open-QF-Venus_Williams-Serena_Williams,2,F-DTL,1,1,0,0,1,0,1
20150909-W-US_Open-QF-Venus_Williams-Serena_Williams,2,F-IO,6,4,0,2,2,4,2
20150909-W-US_Open-QF-Venus_Williams-Serena_Williams,2,B-XC,24,9,2,1,6,13,11
20150909-W-US_Open-QF-Venus_Williams-Serena_Williams,2,B-DTM,23,7,0,2,5,11,12
20150909-W-US_Open-QF-Venus_Williams-Serena_Williams,2,B-DTL,11,8,7,0,1,9,2
20150909-W-US_Open-QF-Venus_Williams-Serena_Williams,2,B-IO,4,2,1,1,0,3,1
20150818-W-Cincinnati-R32-Anna_Karolina_Schmiedlova-Agnieszka_Radwanska,1,F-XC,54,8,6,1,1,35,19
20150818-W-Cincinnati-R32-Anna_Karolina_Schmiedlova-Agnieszka_Radwanska,1,F-DTM,52,4,2,0,2,32,20
20150818-W-Cincinnati-R32-Anna_Karolina_Schmiedlova-Agnieszka_Radwanska,1,F-DTL,15,6,2,0,4,9,6
20150818-W-Cincinnati-R32-Anna_Karolina_Schmiedlova-Agnieszka_Radwanska,1,F-IO,26,6,1,1,4,15,11
20150818-W-Cincinnati-R32-Anna_Karolina_Schmiedlova-Agnieszka_Radwanska,1,F-II,1,0,0,0,0,0,1
20150818-W-Cincinnati-R32-Anna_Karolina_Schmiedlova-Agnieszka_Radwanska,1,B-XC,79,16,4,4,8,52,27
20150818-W-Cincinnati-R32-Anna_Karolina_Schmiedlova-Agnieszka_Radwanska,1,B-DTM,47,2,0,1,1,25,22
20150818-W-Cincinnati-R32-Anna_Karolina_Schmiedlova-Agnieszka_Radwanska,1,B-DTL,16,6,6,0,0,12,4
20150818-W-Cincinnati-R32-Anna_Karolina_Schmiedlova-Agnieszka_Radwanska,1,B-IO,17,6,2,1,3,10,7
20150818-W-Cincinnati-R32-Anna_Karolina_Schmiedlova-Agnieszka_Radwanska,1,B-II,1,0,0,0,0,0,1
20150818-W-Cincinnati-R32-Anna_Karolina_Schmiedlova-Agnieszka_Radwanska,1,S-XC,1,0,0,0,0,0,1
20150818-W-Cincinnati-R32-Anna_Karolina_Schmiedlova-Agnieszka_Radwanska,1,S-DTM,3,0,0,0,0,2,1
20150818-W-Cincinnati-R32-Anna_Karolina_Schmiedlova-Agnieszka_Radwanska,1,S-DTL,2,2,2,0,0,2,0
20150818-W-Cincinnati-R32-Anna_Karolina_Schmiedlova-Agnieszka_Radwanska,2,F-XC,58,12,1,3,8,24,34
20150818-W-Cincinnati-R32-Anna_Karolina_Schmiedlova-Agnieszka_Radwanska,2,F-DTM,53,2,0,0,2,20,33
20150818-W-Cincinnati-R32-Anna_Karolina_Schmiedlova-Agnieszka_Radwanska,2,F-DTL,14,5,2,1,2,8,6
20150818-W-Cincinnati-R32-Anna_Karolina_Schmiedlova-Agnieszka_Radwanska,2,F-IO,24,8,0,3,5,11,13
20150818-W-Cincinnati-R32-Anna_Karolina_Schmiedlova-Agnieszka_Radwanska,2,B-XC,52,7,0,3,4,15,37
20150818-W-Cincinnati-R32-Anna_Karolina_Schmiedlova-Agnieszka_Radwanska,2,B-DTM,58,5,0,0,5,20,38
20150818-W-Cincinnati-R32-Anna_Karolina_Schmiedlova-Agnieszka_Radwanska,2,B-DTL,17,5,0,3,2,9,8
20150818-W-Cincinnati-R32-Anna_Karolina_Schmiedlova-Agnieszka_Radwanska,2,B-IO,6,1,0,0,1,1,5
20150818-W-Cincinnati-R32-Anna_Karolina_Schmiedlova-Agnieszka_Radwanska,2,B-II,1,0,0,0,0,1,0
20150818-W-Cincinnati-R32-Anna_Karolina_Schmiedlova-Agnieszka_Radwanska,2,S-XC,2,0,0,0,0,0,2
20150818-W-Cincinnati-R32-Anna_Karolina_Schmiedlova-Agnieszka_Radwanska,2,S-DTM,6,0,0,0,0,2,4
20150923-W-Tokyo-R16-Garbine_Muguruza-Barbora_Strycova,1,F-XC,58,11,2,3,6,39,19
20150923-W-Tokyo-R16-Garbine_Muguruza-Barbora_Strycova,1,F-DTM,17,4,0,0,4,8,9
20150923-W-Tokyo-R16-Garbine_Muguruza-Barbora_Strycova,1,F-DTL,10,4,3,0,1,6,4
20150923-W-Tokyo-R16-Garbine_Muguruza-Barbora_Strycova,1,F-IO,13,3,2,0,1,9,4
20150923-W-Tokyo-R16-Garbine_Muguruza-Barbora_Strycova,1,F-II,1,0,0,0,0,1,0
20150923-W-Tokyo-R16-Garbine_Muguruza-Barbora_Strycova,1,B-XC,45,11,3,3,5,23,22
20150923-W-Tokyo-R16-Garbine_Muguruza-Barbora_Strycova,1,B-DTM,35,6,0,1,5,16,19
20150923-W-Tokyo-R16-Garbine_Muguruza-Barbora_Strycova,1,B-DTL,14,10,6,1,3,9,5
20150923-W-Tokyo-R16-Garbine_Muguruza-Barbora_Strycova,1,B-IO,18,8,1,4,3,11,7
20150923-W-Tokyo-R16-Garbine_Muguruza-Barbora_Strycova,2,F-XC,45,8,2,0,6,18,27
20150923-W-Tokyo-R16-Garbine_Muguruza-Barbora_Strycova,2,F-DTM,26,0,0,0,0,9,17
20150923-W-Tokyo-R16-Garbine_Muguruza-Barbora_Strycova,2,F-DTL,21,6,0,0,6,6,15
20150923-W-Tokyo-R16-Garbine_Muguruza-Barbora_Strycova,2,F-IO,6,2,0,1,1,2,4
20150923-W-Tokyo-R16-Garbine_Muguruza-Barbora_Strycova,2,F-II,1,1,0,1,0,1,0
20150923-W-Tokyo-R16-Garbine_Muguruza-Barbora_Strycova,2,B-XC,30,8,1,1,6,14,16
20150923-W-Tokyo-R16-Garbine_Muguruza-Barbora_Strycova,2,B-DTM,26,3,0,0,3,9,17
20150923-W-Tokyo-R16-Garbine_Muguruza-Barbora_Strycova,2,B-DTL,2,1,0,0,1,1,1
20150923-W-Tokyo-R16-Garbine_Muguruza-Barbora_Strycova,2,B-IO,2,0,0,0,0,1,1
20150923-W-Tokyo-R16-Garbine_Muguruza-Barbora_Strycova,2,S-XC,2,0,0,0,0,2,0
20150923-W-Tokyo-R16-Garbine_Muguruza-Barbora_Strycova,2,S-DTM,2,0,0,0,0,1,1
20150827-W-Seoul-F-Aliaksandra_Sasnovich-Irina_Camelia_Begu,1,F-XC,27,3,1,1,1,11,16
20150827-W-Seoul-F-Aliaksandra_Sasnovich-Irina_Camelia_Begu,1,F-DTM,16,3,0,1,2,10,6
20150827-W-Seoul-F-Aliaksandra_Sasnovich-Irina_Camelia_Begu,1,F-DTL,19,5,0,1,4,7,12
20150827-W-Seoul-F-Aliaksandra_Sasnovich-Irina_Camelia_Begu,1,F-IO,14,5,1,2,2,4,10
20150827-W-Seoul-F-Aliaksandra_Sasnovich-Irina_Camelia_Begu,1,F-II,1,0,0,0,0,0,1
20150827-W-Seoul-F-Aliaksandra_Sasnovich-Irina_Camelia_Begu,1,B-XC,18,3,0,1,2,4,14
20150827-W-Seoul-F-Aliaksandra_Sasnovich-Irina_Camelia_Begu,1,B-DTM,14,0,0,0,0,5,9
20150827-W-Seoul-F-Aliaksandra_Sasnovich-Irina_Camelia_Begu,1,B-DTL,11,2,1,0,1,4,7
20150827-W-Seoul-F-Aliaksandra_Sasnovich-Irina_Camelia_Begu,1,B-IO,7,0,0,0,0,4,3
20150827-W-Seoul-F-Aliaksandra_Sasnovich-Irina_Camelia_Begu,1,B-II,1,0,0,0,0,1,0
20150827-W-Seoul-F-Aliaksandra_Sasnovich-Irina_Camelia_Begu,1,S-XC,1,0,0,0,0,1,0
20150827-W-Seoul-F-Aliaksandra_Sasnovich-Irina_Camelia_Begu,2,F-XC,38,6,1,2,3,22,16
20150827-W-Seoul-F-Aliaksandra_Sasnovich-Irina_Camelia_Begu,2,F-DTM,21,2,0,0,2,9,12
20150827-W-Seoul-F-Aliaksandra_Sasnovich-Irina_Camelia_Begu,2,F-DTL,7,2,1,0,1,6,1
20150827-W-Seoul-F-Aliaksandra_Sasnovich-Irina_Camelia_Begu,2,F-IO,7,3,1,1,1,4,3
20150827-W-Seoul-F-Aliaksandra_Sasnovich-Irina_Camelia_Begu,2,F-II,3,0,0,0,0,2,1
20150827-W-Seoul-F-Aliaksandra_Sasnovich-Irina_Camelia_Begu,2,B-XC,25,7,1,3,3,17,8
20150827-W-Seoul-F-Aliaksandra_Sasnovich-Irina_Camelia_Begu,2,B-DTM,14,0,0,0,0,7,7
20150827-W-Seoul-F-Aliaksandra_Sasnovich-Irina_Camelia_Begu,2,B-DTL,10,6,2,0,4,6,4
20150827-W-Seoul-F-Aliaksandra_Sasnovich-Irina_Camelia_Begu,2,B-IO,2,2,0,1,1,1,1
20150827-W-Seoul-F-Aliaksandra_Sasnovich-Irina_Camelia_Begu,2,S-XC,1,0,0,0,0,1,0
20150827-W-Seoul-F-Aliaksandra_Sasnovich-Irina_Camelia_Begu,2,S-DTM,1,0,0,0,0,1,0
20150827-W-Seoul-F-Aliaksandra_Sasnovich-Irina_Camelia_Begu,2,S-DTL,2,1,0,0,1,0,2
20150827-W-Seoul-F-Aliaksandra_Sasnovich-Irina_Camelia_Begu,2,S-IO,1,1,0,0,1,0,1
19901008-W-Zurich-F-Steffi_Graf-Gabriela_Sabatini,1,F-XC,32,5,3,1,1,19,13
19901008-W-Zurich-F-Steffi_Graf-Gabriela_Sabatini,1,F-DTM,16,1,0,0,1,9,7
19901008-W-Zurich-F-Steffi_Graf-Gabriela_Sabatini,1,F-DTL,5,1,1,0,0,3,2
19901008-W-Zurich-F-Steffi_Graf-Gabriela_Sabatini,1,F-IO,21,10,5,3,2,11,10
19901008-W-Zurich-F-Steffi_Graf-Gabriela_Sabatini,1,F-II,9,3,1,1,1,5,4
19901008-W-Zurich-F-Steffi_Graf-Gabriela_Sabatini,1,B-XC,7,2,0,0,2,3,4
19901008-W-Zurich-F-Steffi_Graf-Gabriela_Sabatini,1,B-DTM,5,0,0,0,0,1,4
19901008-W-Zurich-F-Steffi_Graf-Gabriela_Sabatini,1,S-XC,55,13,1,7,5,29,26
19901008-W-Zurich-F-Steffi_Graf-Gabriela_Sabatini,1,S-DTM,13,3,0,0,3,6,7
19901008-W-Zurich-F-Steffi_Graf-Gabriela_Sabatini,1,S-DTL,13,1,0,0,1,5,8
19901008-W-Zurich-F-Steffi_Graf-Gabriela_Sabatini,1,S-IO,1,0,0,0,0,0,1
19901008-W-Zurich-F-Steffi_Graf-Gabriela_Sabatini,2,F-XC,21,3,1,0,2,8,13
19901008-W-Zurich-F-Steffi_Graf-Gabriela_Sabatini,2,F-DTM,21,1,0,0,1,11,10
19901008-W-Zurich-F-Steffi_Graf-Gabriela_Sabatini,2,F-DTL,20,5,0,2,3,8,12
19901008-W-Zurich-F-Steffi_Graf-Gabriela_Sabatini,2,F-IO,10,2,0,1,1,7,3
19901008-W-Zurich-F-Steffi_Graf-Gabriela_Sabatini,2,B-XC,17,1,1,0,0,8,9
19901008-W-Zurich-F-Steffi_Graf-Gabriela_Sabatini,2,B-DTM,10,0,0,0,0,3,7
19901008-W-Zurich-F-Steffi_Graf-Gabriela_Sabatini,2,B-DTL,5,5,3,0,2,3,2
19901008-W-Zurich-F-Steffi_Graf-Gabriela_Sabatini,2,B-IO,3,1,0,0,1,2,1
19901008-W-Zurich-F-Steffi_Graf-Gabriela_Sabatini,2,S-XC,41,5,0,1,4,18,23
19901008-W-Zurich-F-Steffi_Graf-Gabriela_Sabatini,2,S-DTM,12,2,0,1,1,6,6
19901008-W-Zurich-F-Steffi_Graf-Gabriela_Sabatini,2,S-DTL,5,1,0,1,0,3,2
20151005-W-Beijing-R16-Kateryna_Bondarenko-Madison_Keys,1,F-XC,10,2,0,1,1,6,4
20151005-W-Beijing-R16-Kateryna_Bondarenko-Madison_Keys,1,F-DTM,12,2,0,0,2,6,6
20151005-W-Beijing-R16-Kateryna_Bondarenko-Madison_Keys,1,F-DTL,8,1,0,0,1,3,5
20151005-W-Beijing-R16-Kateryna_Bondarenko-Madison_Keys,1,F-IO,10,2,0,1,1,5,5
20151005-W-Beijing-R16-Kateryna_Bondarenko-Madison_Keys,1,B-XC,33,10,1,0,9,12,21
20151005-W-Beijing-R16-Kateryna_Bondarenko-Madison_Keys,1,B-DTM,18,1,0,0,1,7,11
20151005-W-Beijing-R16-Kateryna_Bondarenko-Madison_Keys,1,B-DTL,9,5,2,0,3,6,3
20151005-W-Beijing-R16-Kateryna_Bondarenko-Madison_Keys,1,B-IO,3,3,2,0,1,2,1
20151005-W-Beijing-R16-Kateryna_Bondarenko-Madison_Keys,2,F-XC,18,8,2,2,4,9,9
20151005-W-Beijing-R16-Kateryna_Bondarenko-Madison_Keys,2,F-DTM,14,4,0,0,4,6,8
20151005-W-Beijing-R16-Kateryna_Bondarenko-Madison_Keys,2,F-DTL,6,4,1,0,3,1,5
20151005-W-Beijing-R16-Kateryna_Bondarenko-Madison_Keys,2,F-IO,14,10,3,3,4,8,6
20151005-W-Beijing-R16-Kateryna_Bondarenko-Madison_Keys,2,B-XC,24,4,0,0,4,14,10
20151005-W-Beijing-R16-Kateryna_Bondarenko-Madison_Keys,2,B-DTM,24,4,0,0,4,8,16
20151005-W-Beijing-R16-Kateryna_Bondarenko-Madison_Keys,2,B-DTL,8,5,2,0,3,3,5
20151005-W-Beijing-R16-Kateryna_Bondarenko-Madison_Keys,2,B-IO,6,2,1,0,1,3,3
20151005-W-Beijing-R16-Kateryna_Bondarenko-Madison_Keys,2,S-XC,1,0,0,0,0,0,1
20151006-W-Beijing-R16-Irina_Falconi-Garbine_Muguruza,1,F-XC,27,7,3,1,3,13,14
20151006-W-Beijing-R16-Irina_Falconi-Garbine_Muguruza,1,F-DTM,16,5,0,0,5,7,9
20151006-W-Beijing-R16-Irina_Falconi-Garbine_Muguruza,1,F-DTL,7,1,0,0,1,4,3
20151006-W-Beijing-R16-Irina_Falconi-Garbine_Muguruza,1,F-IO,17,5,1,0,4,8,9
20151006-W-Beijing-R16-Irina_Falconi-Garbine_Muguruza,1,B-XC,6,3,1,0,2,2,4
20151006-W-Beijing-R16-Irina_Falconi-Garbine_Muguruza,1,B-DTM,16,0,0,0,0,6,10
20151006-W-Beijing-R16-Irina_Falconi-Garbine_Muguruza,1,B-DTL,11,4,0,0,4,5,6
20151006-W-Beijing-R16-Irina_Falconi-Garbine_Muguruza,1,B-IO,1,0,0,0,0,0,1
20151006-W-Beijing-R16-Irina_Falconi-Garbine_Muguruza,1,S-XC,4,2,0,0,2,1,3
20151006-W-Beijing-R16-Irina_Falconi-Garbine_Muguruza,1,S-DTM,5,1,0,1,0,4,1
20151006-W-Beijing-R16-Irina_Falconi-Garbine_Muguruza,1,S-DTL,2,0,0,0,0,1,1
20151006-W-Beijing-R16-Irina_Falconi-Garbine_Muguruza,2,F-XC,32,5,3,0,2,16,16
20151006-W-Beijing-R16-Irina_Falconi-Garbine_Muguruza,2,F-DTM,11,4,0,1,3,6,5
20151006-W-Beijing-R16-Irina_Falconi-Garbine_Muguruza,2,F-DTL,14,8,2,1,5,7,7
20151006-W-Beijing-R16-Irina_Falconi-Garbine_Muguruza,2,F-IO,10,4,1,0,3,3,7
20151006-W-Beijing-R16-Irina_Falconi-Garbine_Muguruza,2,B-XC,30,9,1,2,6,16,14
20151006-W-Beijing-R16-Irina_Falconi-Garbine_Muguruza,2,B-DTM,9,1,0,0,1,5,4
20151006-W-Beijing-R16-Irina_Falconi-Garbine_Muguruza,2,B-DTL,4,4,1,1,2,2,2
20151006-W-Beijing-R16-Irina_Falconi-Garbine_Muguruza,2,B-IO,5,2,1,0,1,1,4
20151006-W-Beijing-R16-Irina_Falconi-Garbine_Muguruza,2,S-DTM,1,0,0,0,0,0,1
20120730-W-Olympics-R64-Serena_Williams-Jelena_Jankovic,1,F-XC,26,10,1,4,5,14,12
20120730-W-Olympics-R64-Serena_Williams-Jelena_Jankovic,1,F-DTM,13,0,0,0,0,4,9
20120730-W-Olympics-R64-Serena_Williams-Jelena_Jankovic,1,F-DTL,4,1,0,0,1,1,3
20120730-W-Olympics-R64-Serena_Williams-Jelena_Jankovic,1,F-IO,10,5,3,1,1,7,3
20120730-W-Olympics-R64-Serena_Williams-Jelena_Jankovic,1,B-XC,18,5,1,2,2,10,8
20120730-W-Olympics-R64-Serena_Williams-Jelena_Jankovic,1,B-DTM,6,0,0,0,0,2,4
20120730-W-Olympics-R64-Serena_Williams-Jelena_Jankovic,1,B-DTL,9,2,1,0,1,5,4
20120730-W-Olympics-R64-Serena_Williams-Jelena_Jankovic,1,B-IO,5,3,1,1,1,2,3
20120730-W-Olympics-R64-Serena_Williams-Jelena_Jankovic,1,S-DTM,1,0,0,0,0,1,0
20120730-W-Olympics-R64-Serena_Williams-Jelena_Jankovic,2,F-XC,10,2,0,0,2,6,4
20120730-W-Olympics-R64-Serena_Williams-Jelena_Jankovic,2,F-DTM,14,0,0,0,0,6,8
20120730-W-Olympics-R64-Serena_Williams-Jelena_Jankovic,2,F-DTL,12,3,0,0,3,5,7
20120730-W-Olympics-R64-Serena_Williams-Jelena_Jankovic,2,F-IO,7,5,2,2,1,5,2
20120730-W-Olympics-R64-Serena_Williams-Jelena_Jankovic,2,B-XC,11,2,2,0,0,6,5
20120730-W-Olympics-R64-Serena_Williams-Jelena_Jankovic,2,B-DTM,19,3,1,1,1,14,5
20120730-W-Olympics-R64-Serena_Williams-Jelena_Jankovic,2,B-DTL,6,2,1,0,1,2,4
20120730-W-Olympics-R64-Serena_Williams-Jelena_Jankovic,2,B-IO,9,3,1,1,1,5,4
20120730-W-Olympics-R64-Serena_Williams-Jelena_Jankovic,2,S-DTM,8,0,0,0,0,3,5
20120730-W-Olympics-R64-Serena_Williams-Jelena_Jankovic,2,S-DTL,1,0,0,0,0,0,1
20121103-W-Fed_Cup_World_Group_F-RR-Jelena_Jankovic-Lucie_Safarova,1,F-XC,10,4,0,1,3,4,6
20121103-W-Fed_Cup_World_Group_F-RR-Jelena_Jankovic-Lucie_Safarova,1,F-DTM,10,2,0,0,2,2,8
20121103-W-Fed_Cup_World_Group_F-RR-Jelena_Jankovic-Lucie_Safarova,1,F-DTL,14,6,0,2,4,7,7
20121103-W-Fed_Cup_World_Group_F-RR-Jelena_Jankovic-Lucie_Safarova,1,F-IO,7,3,0,2,1,5,2
20121103-W-Fed_Cup_World_Group_F-RR-Jelena_Jankovic-Lucie_Safarova,1,B-XC,31,4,0,3,1,15,16
20121103-W-Fed_Cup_World_Group_F-RR-Jelena_Jankovic-Lucie_Safarova,1,B-DTM,16,2,0,0,2,6,10
20121103-W-Fed_Cup_World_Group_F-RR-Jelena_Jankovic-Lucie_Safarova,1,B-DTL,11,4,0,1,3,3,8
20121103-W-Fed_Cup_World_Group_F-RR-Jelena_Jankovic-Lucie_Safarova,1,B-IO,8,0,0,0,0,2,6
20121103-W-Fed_Cup_World_Group_F-RR-Jelena_Jankovic-Lucie_Safarova,1,S-XC,1,0,0,0,0,0,1
20121103-W-Fed_Cup_World_Group_F-RR-Jelena_Jankovic-Lucie_Safarova,1,S-DTM,5,0,0,0,0,0,5
20121103-W-Fed_Cup_World_Group_F-RR-Jelena_Jankovic-Lucie_Safarova,1,S-IO,1,0,0,0,0,1,0
20121103-W-Fed_Cup_World_Group_F-RR-Jelena_Jankovic-Lucie_Safarova,2,F-XC,34,7,1,4,2,22,12
20121103-W-Fed_Cup_World_Group_F-RR-Jelena_Jankovic-Lucie_Safarova,2,F-DTM,16,4,0,0,4,7,9
20121103-W-Fed_Cup_World_Group_F-RR-Jelena_Jankovic-Lucie_Safarova,2,F-DTL,15,10,5,2,3,9,6
20121103-W-Fed_Cup_World_Group_F-RR-Jelena_Jankovic-Lucie_Safarova,2,F-IO,15,4,4,0,0,12,3
20121103-W-Fed_Cup_World_Group_F-RR-Jelena_Jankovic-Lucie_Safarova,2,B-XC,9,1,0,0,1,6,3
20121103-W-Fed_Cup_World_Group_F-RR-Jelena_Jankovic-Lucie_Safarova,2,B-DTM,8,0,0,0,0,4,4
20121103-W-Fed_Cup_World_Group_F-RR-Jelena_Jankovic-Lucie_Safarova,2,B-DTL,5,3,2,0,1,3,2
20121103-W-Fed_Cup_World_Group_F-RR-Jelena_Jankovic-Lucie_Safarova,2,B-IO,3,2,2,0,0,3,0
20121103-W-Fed_Cup_World_Group_F-RR-Jelena_Jankovic-Lucie_Safarova,2,S-DTM,5,0,0,0,0,2,3
20121103-W-Fed_Cup_World_Group_F-RR-Jelena_Jankovic-Lucie_Safarova,2,S-DTL,1,0,0,0,0,1,0
20151006-W-Beijing-R32-Ana_Ivanovic-Venus_Williams,1,F-XC,19,6,4,2,0,14,5
20151006-W-Beijing-R32-Ana_Ivanovic-Venus_Williams,1,F-DTM,12,4,0,0,4,5,7
20151006-W-Beijing-R32-Ana_Ivanovic-Venus_Williams,1,F-DTL,2,1,1,0,0,2,0
20151006-W-Beijing-R32-Ana_Ivanovic-Venus_Williams,1,F-IO,17,8,5,1,2,13,4
20151006-W-Beijing-R32-Ana_Ivanovic-Venus_Williams,1,F-II,2,1,0,0,1,1,1
20151006-W-Beijing-R32-Ana_Ivanovic-Venus_Williams,1,B-XC,25,6,2,1,3,16,9
20151006-W-Beijing-R32-Ana_Ivanovic-Venus_Williams,1,B-DTM,24,1,0,0,1,14,10
20151006-W-Beijing-R32-Ana_Ivanovic-Venus_Williams,1,B-DTL,5,2,1,0,1,4,1
20151006-W-Beijing-R32-Ana_Ivanovic-Venus_Williams,1,B-IO,1,1,1,0,0,1,0
20151006-W-Beijing-R32-Ana_Ivanovic-Venus_Williams,1,S-XC,4,1,0,1,0,4,0
20151006-W-Beijing-R32-Ana_Ivanovic-Venus_Williams,1,S-DTM,11,0,0,0,0,9,2
20151006-W-Beijing-R32-Ana_Ivanovic-Venus_Williams,1,S-DTL,3,1,1,0,0,3,0
20151006-W-Beijing-R32-Ana_Ivanovic-Venus_Williams,2,F-XC,17,7,2,1,4,7,10
20151006-W-Beijing-R32-Ana_Ivanovic-Venus_Williams,2,F-DTM,21,5,0,1,4,7,14
20151006-W-Beijing-R32-Ana_Ivanovic-Venus_Williams,2,F-DTL,3,1,0,0,1,0,3
20151006-W-Beijing-R32-Ana_Ivanovic-Venus_Williams,2,F-IO,18,8,1,3,4,6,12
20151006-W-Beijing-R32-Ana_Ivanovic-Venus_Williams,2,B-XC,41,5,0,0,5,13,28
20151006-W-Beijing-R32-Ana_Ivanovic-Venus_Williams,2,B-DTM,22,4,0,1,3,6,16
20151006-W-Beijing-R32-Ana_Ivanovic-Venus_Williams,2,B-DTL,1,1,1,0,0,1,0
20151006-W-Beijing-R32-Ana_Ivanovic-Venus_Williams,2,B-IO,3,3,1,0,2,1,2
20151006-W-Beijing-R32-Ana_Ivanovic-Venus_Williams,2,S-XC,4,0,0,0,0,0,4
20151006-W-Beijing-R32-Ana_Ivanovic-Venus_Williams,2,S-DTM,6,0,0,0,0,1,5
20151021-W-Moscow-R16-Anastasija_Sevastova-Karolina_Pliskova,1,F-XC,49,18,7,3,8,25,24
20151021-W-Moscow-R16-Anastasija_Sevastova-Karolina_Pliskova,1,F-DTM,22,3,0,0,3,6,16
20151021-W-Moscow-R16-Anastasija_Sevastova-Karolina_Pliskova,1,F-DTL,12,4,3,0,1,9,3
20151021-W-Moscow-R16-Anastasija_Sevastova-Karolina_Pliskova,1,F-IO,29,11,3,2,6,19,10
20151021-W-Moscow-R16-Anastasija_Sevastova-Karolina_Pliskova,1,F-II,3,3,2,1,0,3,0
20151021-W-Moscow-R16-Anastasija_Sevastova-Karolina_Pliskova,1,B-XC,55,8,3,1,4,34,21
20151021-W-Moscow-R16-Anastasija_Sevastova-Karolina_Pliskova,1,B-DTM,28,2,1,0,1,13,15
20151021-W-Moscow-R16-Anastasija_Sevastova-Karolina_Pliskova,1,B-DTL,10,8,6,0,2,7,3
20151021-W-Moscow-R16-Anastasija_Sevastova-Karolina_Pliskova,1,B-IO,4,2,1,0,1,1,3
20151021-W-Moscow-R16-Anastasija_Sevastova-Karolina_Pliskova,1,S-XC,11,0,0,0,0,5,6
20151021-W-Moscow-R16-Anastasija_Sevastova-Karolina_Pliskova,1,S-DTM,15,1,0,0,1,8,7
20151021-W-Moscow-R16-Anastasija_Sevastova-Karolina_Pliskova,1,S-DTL,4,1,1,0,0,2,2
20151021-W-Moscow-R16-Anastasija_Sevastova-Karolina_Pliskova,1,S-IO,1,0,0,0,0,1,0
20151021-W-Moscow-R16-Anastasija_Sevastova-Karolina_Pliskova,2,F-XC,23,6,1,1,4,10,13
20151021-W-Moscow-R16-Anastasija_Sevastova-Karolina_Pliskova,2,F-DTM,16,0,0,0,0,13,3
20151021-W-Moscow-R16-Anastasija_Sevastova-Karolina_Pliskova,2,F-DTL,13,8,2,2,4,6,7
20151021-W-Moscow-R16-Anastasija_Sevastova-Karolina_Pliskova,2,F-IO,20,8,3,1,4,11,9
20151021-W-Moscow-R16-Anastasija_Sevastova-Karolina_Pliskova,2,B-XC,44,8,2,0,6,18,26
20151021-W-Moscow-R16-Anastasija_Sevastova-Karolina_Pliskova,2,B-DTM,52,7,1,1,5,23,29
20151021-W-Moscow-R16-Anastasija_Sevastova-Karolina_Pliskova,2,B-DTL,15,8,2,3,3,8,7
20151021-W-Moscow-R16-Anastasija_Sevastova-Karolina_Pliskova,2,B-IO,9,2,1,0,1,7,2
20151021-W-Moscow-R16-Anastasija_Sevastova-Karolina_Pliskova,2,S-XC,17,4,0,1,3,6,11
20151021-W-Moscow-R16-Anastasija_Sevastova-Karolina_Pliskova,2,S-DTM,7,0,0,0,0,1,6
20151011-W-Beijing-F-Timea_Bacsinszky-Garbine_Muguruza,1,F-XC,16,6,3,0,3,9,7
20151011-W-Beijing-F-Timea_Bacsinszky-Garbine_Muguruza,1,F-DTM,33,2,0,0,2,17,16
20151011-W-Beijing-F-Timea_Bacsinszky-Garbine_Muguruza,1,F-DTL,7,2,0,0,2,4,3
20151011-W-Beijing-F-Timea_Bacsinszky-Garbine_Muguruza,1,F-IO,11,3,1,1,1,8,3
20151011-W-Beijing-F-Timea_Bacsinszky-Garbine_Muguruza,1,B-XC,31,9,4,1,4,15,16
20151011-W-Beijing-F-Timea_Bacsinszky-Garbine_Muguruza,1,B-DTM,35,5,0,2,3,15,20
20151011-W-Beijing-F-Timea_Bacsinszky-Garbine_Muguruza,1,B-DTL,4,1,1,0,0,3,1
20151011-W-Beijing-F-Timea_Bacsinszky-Garbine_Muguruza,1,B-IO,14,7,4,0,3,7,7
20151011-W-Beijing-F-Timea_Bacsinszky-Garbine_Muguruza,1,S-DTM,2,0,0,0,0,0,2
20151011-W-Beijing-F-Timea_Bacsinszky-Garbine_Muguruza,1,S-IO,2,0,0,0,0,0,2
20151011-W-Beijing-F-Timea_Bacsinszky-Garbine_Muguruza,2,F-XC,20,5,0,2,3,11,9
20151011-W-Beijing-F-Timea_Bacsinszky-Garbine_Muguruza,2,F-DTM,25,4,0,1,3,12,13
20151011-W-Beijing-F-Timea_Bacsinszky-Garbine_Muguruza,2,F-DTL,5,3,2,0,1,3,2
20151011-W-Beijing-F-Timea_Bacsinszky-Garbine_Muguruza,2,F-IO,9,7,5,0,2,6,3
20151011-W-Beijing-F-Timea_Bacsinszky-Garbine_Muguruza,2,B-XC,31,9,4,1,4,17,14
20151011-W-Beijing-F-Timea_Bacsinszky-Garbine_Muguruza,2,B-DTM,58,9,0,2,7,27,31
20151011-W-Beijing-F-Timea_Bacsinszky-Garbine_Muguruza,2,B-DTL,4,2,2,0,0,4,0
20151011-W-Beijing-F-Timea_Bacsinszky-Garbine_Muguruza,2,B-IO,16,5,1,0,4,6,10
20151011-W-Beijing-F-Timea_Bacsinszky-Garbine_Muguruza,2,B-II,1,1,0,1,0,1,0
20151016-W-Hong_Kong-QF-Venus_Williams-Alize_Cornet,1,F-XC,21,8,5,2,1,15,6
20151016-W-Hong_Kong-QF-Venus_Williams-Alize_Cornet,1,F-DTM,14,3,0,1,2,9,5
20151016-W-Hong_Kong-QF-Venus_Williams-Alize_Cornet,1,F-DTL,4,1,1,0,0,2,2
20151016-W-Hong_Kong-QF-Venus_Williams-Alize_Cornet,1,F-IO,18,9,5,1,3,9,9
20151016-W-Hong_Kong-QF-Venus_Williams-Alize_Cornet,1,B-XC,19,5,0,1,4,9,10
20151016-W-Hong_Kong-QF-Venus_Williams-Alize_Cornet,1,B-DTM,14,4,0,0,4,5,9
20151016-W-Hong_Kong-QF-Venus_Williams-Alize_Cornet,1,B-DTL,4,2,2,0,0,3,1
20151016-W-Hong_Kong-QF-Venus_Williams-Alize_Cornet,1,B-IO,3,1,0,1,0,2,1
20151016-W-Hong_Kong-QF-Venus_Williams-Alize_Cornet,1,S-XC,1,0,0,0,0,1,0
20151016-W-Hong_Kong-QF-Venus_Williams-Alize_Cornet,1,S-DTM,1,1,0,1,0,1,0
20151016-W-Hong_Kong-QF-Venus_Williams-Alize_Cornet,2,F-XC,9,2,0,0,2,4,5
20151016-W-Hong_Kong-QF-Venus_Williams-Alize_Cornet,2,F-DTM,22,1,0,1,0,8,14
20151016-W-Hong_Kong-QF-Venus_Williams-Alize_Cornet,2,F-DTL,2,1,0,0,1,0,2
20151016-W-Hong_Kong-QF-Venus_Williams-Alize_Cornet,2,F-IO,3,0,0,0,0,2,1
20151016-W-Hong_Kong-QF-Venus_Williams-Alize_Cornet,2,B-XC,18,5,1,0,4,7,11
20151016-W-Hong_Kong-QF-Venus_Williams-Alize_Cornet,2,B-DTM,27,2,0,0,2,12,15
20151016-W-Hong_Kong-QF-Venus_Williams-Alize_Cornet,2,S-XC,1,0,0,0,0,1,0
20151016-W-Hong_Kong-QF-Venus_Williams-Alize_Cornet,2,S-DTM,2,0,0,0,0,2,0
20151016-W-Hong_Kong-QF-Venus_Williams-Alize_Cornet,2,S-DTL,1,1,1,0,0,1,0
20150730-W-Baku-R16-Karin_Knapp-Anett_Kontaveit,1,F-XC,19,5,0,5,0,17,2
20150730-W-Baku-R16-Karin_Knapp-Anett_Kontaveit,1,F-DTM,11,3,0,1,2,7,4
20150730-W-Baku-R16-Karin_Knapp-Anett_Kontaveit,1,F-DTL,3,3,3,0,0,3,0
20150730-W-Baku-R16-Karin_Knapp-Anett_Kontaveit,1,F-IO,11,4,2,1,1,8,3
20150730-W-Baku-R16-Karin_Knapp-Anett_Kontaveit,1,B-XC,4,1,0,1,0,4,0
20150730-W-Baku-R16-Karin_Knapp-Anett_Kontaveit,1,B-DTM,11,2,0,0,2,6,5
20150730-W-Baku-R16-Karin_Knapp-Anett_Kontaveit,1,B-IO,2,1,0,0,1,0,2
20150730-W-Baku-R16-Karin_Knapp-Anett_Kontaveit,1,S-DTM,2,0,0,0,0,0,2
20150730-W-Baku-R16-Karin_Knapp-Anett_Kontaveit,1,S-IO,1,0,0,0,0,1,0
20150730-W-Baku-R16-Karin_Knapp-Anett_Kontaveit,2,F-XC,15,4,1,0,3,3,12
20150730-W-Baku-R16-Karin_Knapp-Anett_Kontaveit,2,F-DTM,15,2,0,0,2,4,11
20150730-W-Baku-R16-Karin_Knapp-Anett_Kontaveit,2,F-DTL,8,6,0,1,5,2,6
20150730-W-Baku-R16-Karin_Knapp-Anett_Kontaveit,2,F-IO,3,1,0,0,1,1,2
20150730-W-Baku-R16-Karin_Knapp-Anett_Kontaveit,2,B-XC,6,3,1,0,2,1,5
20150730-W-Baku-R16-Karin_Knapp-Anett_Kontaveit,2,B-DTM,8,3,0,0,3,1,7
20150730-W-Baku-R16-Karin_Knapp-Anett_Kontaveit,2,B-DTL,2,1,0,0,1,0,2
20150730-W-Baku-R16-Karin_Knapp-Anett_Kontaveit,2,B-IO,4,3,0,1,2,1,3
20150730-W-Baku-R16-Karin_Knapp-Anett_Kontaveit,2,S-DTM,4,0,0,0,0,1,3
20150121-W-Australian_Open-R64-Eugenie_Bouchard-Kiki_Bertens,1,F-XC,25,10,3,5,2,17,8
20150121-W-Australian_Open-R64-Eugenie_Bouchard-Kiki_Bertens,1,F-DTM,5,0,0,0,0,2,3
20150121-W-Australian_Open-R64-Eugenie_Bouchard-Kiki_Bertens,1,F-DTL,3,1,0,1,0,1,2
20150121-W-Australian_Open-R64-Eugenie_Bouchard-Kiki_Bertens,1,F-IO,14,9,5,0,4,8,6
20150121-W-Australian_Open-R64-Eugenie_Bouchard-Kiki_Bertens,1,B-XC,15,6,2,2,2,10,5
20150121-W-Australian_Open-R64-Eugenie_Bouchard-Kiki_Bertens,1,B-DTM,8,3,0,0,3,3,5
20150121-W-Australian_Open-R64-Eugenie_Bouchard-Kiki_Bertens,1,B-DTL,3,0,0,0,0,2,1
20150121-W-Australian_Open-R64-Eugenie_Bouchard-Kiki_Bertens,1,B-IO,4,3,1,0,2,1,3
20150121-W-Australian_Open-R64-Eugenie_Bouchard-Kiki_Bertens,2,F-XC,7,2,0,0,2,2,5
20150121-W-Australian_Open-R64-Eugenie_Bouchard-Kiki_Bertens,2,F-DTM,21,3,0,0,3,5,16
20150121-W-Australian_Open-R64-Eugenie_Bouchard-Kiki_Bertens,2,F-DTL,6,2,0,2,0,5,1
20150121-W-Australian_Open-R64-Eugenie_Bouchard-Kiki_Bertens,2,F-IO,7,3,1,0,2,2,5
20150121-W-Australian_Open-R64-Eugenie_Bouchard-Kiki_Bertens,2,B-XC,6,3,0,0,3,2,4
20150121-W-Australian_Open-R64-Eugenie_Bouchard-Kiki_Bertens,2,B-DTM,13,2,0,0,2,1,12
20150121-W-Australian_Open-R64-Eugenie_Bouchard-Kiki_Bertens,2,B-DTL,2,1,1,0,0,1,1
20150121-W-Australian_Open-R64-Eugenie_Bouchard-Kiki_Bertens,2,B-IO,2,1,0,0,1,1,1
20150121-W-Australian_Open-R64-Eugenie_Bouchard-Kiki_Bertens,2,S-XC,1,0,0,0,0,0,1
20150121-W-Australian_Open-R64-Eugenie_Bouchard-Kiki_Bertens,2,S-DTM,4,1,0,0,1,2,2
20150821-W-Cincinnati-QF-Ana_Ivanovic-Serena_Williams,1,F-XC,25,9,1,4,4,11,14
20150821-W-Cincinnati-QF-Ana_Ivanovic-Serena_Williams,1,F-DTM,13,1,0,0,1,5,8
20150821-W-Cincinnati-QF-Ana_Ivanovic-Serena_Williams,1,F-DTL,13,5,1,1,3,6,7
20150821-W-Cincinnati-QF-Ana_Ivanovic-Serena_Williams,1,F-IO,16,10,3,3,4,6,10
20150821-W-Cincinnati-QF-Ana_Ivanovic-Serena_Williams,1,B-XC,16,4,1,1,2,6,10
20150821-W-Cincinnati-QF-Ana_Ivanovic-Serena_Williams,1,B-DTM,26,1,0,0,1,11,15
20150821-W-Cincinnati-QF-Ana_Ivanovic-Serena_Williams,1,B-DTL,10,4,1,0,3,4,6
20150821-W-Cincinnati-QF-Ana_Ivanovic-Serena_Williams,1,B-IO,4,0,0,0,0,1,3
20150821-W-Cincinnati-QF-Ana_Ivanovic-Serena_Williams,1,S-DTM,2,0,0,0,0,0,2
20150821-W-Cincinnati-QF-Ana_Ivanovic-Serena_Williams,1,S-DTL,1,0,0,0,0,1,0
20150821-W-Cincinnati-QF-Ana_Ivanovic-Serena_Williams,1,S-IO,2,1,0,0,1,0,2
20150821-W-Cincinnati-QF-Ana_Ivanovic-Serena_Williams,2,F-XC,33,9,5,2,2,21,12
20150821-W-Cincinnati-QF-Ana_Ivanovic-Serena_Williams,2,F-DTM,18,4,0,0,4,8,10
20150821-W-Cincinnati-QF-Ana_Ivanovic-Serena_Williams,2,F-DTL,12,7,3,0,4,6,6
20150821-W-Cincinnati-QF-Ana_Ivanovic-Serena_Williams,2,F-IO,4,1,1,0,0,3,1
20150821-W-Cincinnati-QF-Ana_Ivanovic-Serena_Williams,2,B-XC,27,8,2,2,4,18,9
20150821-W-Cincinnati-QF-Ana_Ivanovic-Serena_Williams,2,B-DTM,17,2,0,1,1,10,7
20150821-W-Cincinnati-QF-Ana_Ivanovic-Serena_Williams,2,B-DTL,7,5,1,0,4,2,5
20150821-W-Cincinnati-QF-Ana_Ivanovic-Serena_Williams,2,B-IO,6,3,0,0,3,2,4
20150821-W-Cincinnati-QF-Ana_Ivanovic-Serena_Williams,2,S-XC,1,0,0,0,0,0,1
20150821-W-Cincinnati-QF-Ana_Ivanovic-Serena_Williams,2,S-DTM,5,1,1,0,0,4,1
20130704-W-Wimbledon-SF-Agnieszka_Radwanska-Sabine_Lisicki,1,F-XC,28,9,0,8,1,14,14
20130704-W-Wimbledon-SF-Agnieszka_Radwanska-Sabine_Lisicki,1,F-DTM,14,2,0,1,1,7,7
20130704-W-Wimbledon-SF-Agnieszka_Radwanska-Sabine_Lisicki,1,F-DTL,14,4,1,1,2,5,9
20130704-W-Wimbledon-SF-Agnieszka_Radwanska-Sabine_Lisicki,1,F-IO,24,9,1,3,5,13,11
20130704-W-Wimbledon-SF-Agnieszka_Radwanska-Sabine_Lisicki,1,B-XC,35,3,0,1,2,19,16
20130704-W-Wimbledon-SF-Agnieszka_Radwanska-Sabine_Lisicki,1,B-DTM,21,0,0,0,0,9,12
20130704-W-Wimbledon-SF-Agnieszka_Radwanska-Sabine_Lisicki,1,B-DTL,10,6,4,2,0,8,2
20130704-W-Wimbledon-SF-Agnieszka_Radwanska-Sabine_Lisicki,1,B-IO,8,2,2,0,0,8,0
20130704-W-Wimbledon-SF-Agnieszka_Radwanska-Sabine_Lisicki,1,S-XC,10,2,2,0,0,6,4
20130704-W-Wimbledon-SF-Agnieszka_Radwanska-Sabine_Lisicki,1,S-DTM,4,0,0,0,0,0,4
20130704-W-Wimbledon-SF-Agnieszka_Radwanska-Sabine_Lisicki,1,S-DTL,1,0,0,0,0,1,0
20130704-W-Wimbledon-SF-Agnieszka_Radwanska-Sabine_Lisicki,1,S-IO,1,1,0,1,0,1,0
20130704-W-Wimbledon-SF-Agnieszka_Radwanska-Sabine_Lisicki,2,F-XC,40,17,7,6,4,26,14
20130704-W-Wimbledon-SF-Agnieszka_Radwanska-Sabine_Lisicki,2,F-DTM,17,6,3,0,3,10,7
20130704-W-Wimbledon-SF-Agnieszka_Radwanska-Sabine_Lisicki,2,F-DTL,19,13,8,2,3,12,7
20130704-W-Wimbledon-SF-Agnieszka_Radwanska-Sabine_Lisicki,2,F-IO,18,6,1,3,2,11,7
20130704-W-Wimbledon-SF-Agnieszka_Radwanska-Sabine_Lisicki,2,F-II,2,2,0,0,2,0,2
20130704-W-Wimbledon-SF-Agnieszka_Radwanska-Sabine_Lisicki,2,B-XC,40,11,4,4,3,21,19
20130704-W-Wimbledon-SF-Agnieszka_Radwanska-Sabine_Lisicki,2,B-DTM,29,2,0,1,1,9,20
20130704-W-Wimbledon-SF-Agnieszka_Radwanska-Sabine_Lisicki,2,B-DTL,15,10,1,2,7,7,8
20130704-W-Wimbledon-SF-Agnieszka_Radwanska-Sabine_Lisicki,2,B-IO,7,4,1,2,1,5,2
20130704-W-Wimbledon-SF-Agnieszka_Radwanska-Sabine_Lisicki,2,S-XC,2,0,0,0,0,0,2
20130704-W-Wimbledon-SF-Agnieszka_Radwanska-Sabine_Lisicki,2,S-DTM,3,0,0,0,0,1,2
20130704-W-Wimbledon-SF-Agnieszka_Radwanska-Sabine_Lisicki,2,S-DTL,1,0,0,0,0,1,0
20150905-W-US_Open-R32-Angelique_Kerber-Victoria_Azarenka,1,F-XC,91,11,2,4,5,49,42
20150905-W-US_Open-R32-Angelique_Kerber-Victoria_Azarenka,1,F-DTM,32,2,0,0,2,16,16
20150905-W-US_Open-R32-Angelique_Kerber-Victoria_Azarenka,1,F-DTL,29,16,10,3,3,20,9
20150905-W-US_Open-R32-Angelique_Kerber-Victoria_Azarenka,1,F-IO,34,16,7,4,5,24,10
20150905-W-US_Open-R32-Angelique_Kerber-Victoria_Azarenka,1,B-XC,93,22,8,5,9,54,39
20150905-W-US_Open-R32-Angelique_Kerber-Victoria_Azarenka,1,B-DTM,79,4,0,0,4,33,46
20150905-W-US_Open-R32-Angelique_Kerber-Victoria_Azarenka,1,B-DTL,3,2,1,1,0,3,0
20150905-W-US_Open-R32-Angelique_Kerber-Victoria_Azarenka,1,B-IO,10,5,2,0,3,5,5
20150905-W-US_Open-R32-Angelique_Kerber-Victoria_Azarenka,1,S-XC,3,2,2,0,0,2,1
20150905-W-US_Open-R32-Angelique_Kerber-Victoria_Azarenka,1,S-DTM,7,0,0,0,0,1,6
20150905-W-US_Open-R32-Angelique_Kerber-Victoria_Azarenka,1,S-DTL,3,1,1,0,0,1,2
20150905-W-US_Open-R32-Angelique_Kerber-Victoria_Azarenka,1,S-IO,2,0,0,0,0,2,0
20150905-W-US_Open-R32-Angelique_Kerber-Victoria_Azarenka,2,F-XC,89,11,4,1,6,44,45
20150905-W-US_Open-R32-Angelique_Kerber-Victoria_Azarenka,2,F-DTM,50,3,0,0,3,19,31
20150905-W-US_Open-R32-Angelique_Kerber-Victoria_Azarenka,2,F-DTL,37,6,4,1,1,21,16
20150905-W-US_Open-R32-Angelique_Kerber-Victoria_Azarenka,2,F-IO,39,11,8,2,1,25,14
20150905-W-US_Open-R32-Angelique_Kerber-Victoria_Azarenka,2,B-XC,68,13,4,3,6,29,39
20150905-W-US_Open-R32-Angelique_Kerber-Victoria_Azarenka,2,B-DTM,29,3,0,1,2,11,18
20150905-W-US_Open-R32-Angelique_Kerber-Victoria_Azarenka,2,B-DTL,22,8,5,0,3,15,7
20150905-W-US_Open-R32-Angelique_Kerber-Victoria_Azarenka,2,B-IO,18,4,2,0,2,12,6
20150905-W-US_Open-R32-Angelique_Kerber-Victoria_Azarenka,2,S-XC,3,2,0,0,2,1,2
20150905-W-US_Open-R32-Angelique_Kerber-Victoria_Azarenka,2,S-DTM,7,0,0,0,0,1,6
20150905-W-US_Open-R32-Angelique_Kerber-Victoria_Azarenka,2,S-DTL,10,0,0,0,0,5,5
20150905-W-US_Open-R32-Angelique_Kerber-Victoria_Azarenka,2,S-IO,2,0,0,0,0,0,2
20120520-W-Rome-F-Na_Li-Maria_Sharapova,1,F-XC,72,17,3,6,8,39,33
20120520-W-Rome-F-Na_Li-Maria_Sharapova,1,F-DTM,61,5,0,0,5,27,34
20120520-W-Rome-F-Na_Li-Maria_Sharapova,1,F-DTL,25,8,2,1,5,13,12
20120520-W-Rome-F-Na_Li-Maria_Sharapova,1,F-IO,28,9,4,0,5,15,13
20120520-W-Rome-F-Na_Li-Maria_Sharapova,1,B-XC,49,12,3,2,7,29,20
20120520-W-Rome-F-Na_Li-Maria_Sharapova,1,B-DTM,55,8,0,2,6,24,31
20120520-W-Rome-F-Na_Li-Maria_Sharapova,1,B-DTL,14,9,1,4,4,10,4
20120520-W-Rome-F-Na_Li-Maria_Sharapova,1,B-IO,9,5,3,2,0,7,2
20120520-W-Rome-F-Na_Li-Maria_Sharapova,1,S-XC,2,0,0,0,0,0,2
20120520-W-Rome-F-Na_Li-Maria_Sharapova,1,S-DTM,12,0,0,0,0,5,7
20120520-W-Rome-F-Na_Li-Maria_Sharapova,2,F-XC,73,19,5,6,8,38,35
20120520-W-Rome-F-Na_Li-Maria_Sharapova,2,F-DTM,54,5,0,1,4,26,28
20120520-W-Rome-F-Na_Li-Maria_Sharapova,2,F-DTL,11,6,0,2,4,3,8
20120520-W-Rome-F-Na_Li-Maria_Sharapova,2,F-IO,19,8,5,1,2,13,6
20120520-W-Rome-F-Na_Li-Maria_Sharapova,2,B-XC,66,13,2,2,9,31,35
20120520-W-Rome-F-Na_Li-Maria_Sharapova,2,B-DTM,70,10,0,2,7,37,33
20120520-W-Rome-F-Na_Li-Maria_Sharapova,2,B-DTL,15,5,2,0,3,4,11
20120520-W-Rome-F-Na_Li-Maria_Sharapova,2,B-IO,17,8,3,1,4,8,9
20050604-W-Roland_Garros-F-Mary_Pierce-Justine_Henin,1,F-XC,13,5,1,0,4,4,9
20050604-W-Roland_Garros-F-Mary_Pierce-Justine_Henin,1,F-DTM,9,1,0,0,1,3,6
20050604-W-Roland_Garros-F-Mary_Pierce-Justine_Henin,1,F-DTL,7,1,0,0,1,3,4
20050604-W-Roland_Garros-F-Mary_Pierce-Justine_Henin,1,F-IO,9,4,0,1,3,4,5
20050604-W-Roland_Garros-F-Mary_Pierce-Justine_Henin,1,B-XC,12,1,0,0,1,6,6
20050604-W-Roland_Garros-F-Mary_Pierce-Justine_Henin,1,B-DTM,10,1,0,0,1,1,9
20050604-W-Roland_Garros-F-Mary_Pierce-Justine_Henin,1,B-DTL,11,8,3,3,2,7,4
20050604-W-Roland_Garros-F-Mary_Pierce-Justine_Henin,1,B-IO,9,3,1,0,2,2,7
20050604-W-Roland_Garros-F-Mary_Pierce-Justine_Henin,1,S-XC,2,0,0,0,0,1,1
20050604-W-Roland_Garros-F-Mary_Pierce-Justine_Henin,2,F-XC,17,9,2,3,4,10,7
20050604-W-Roland_Garros-F-Mary_Pierce-Justine_Henin,2,F-DTM,14,0,0,0,0,9,5
20050604-W-Roland_Garros-F-Mary_Pierce-Justine_Henin,2,F-DTL,3,1,1,0,0,2,1
20050604-W-Roland_Garros-F-Mary_Pierce-Justine_Henin,2,F-IO,13,4,2,1,1,9,4
20050604-W-Roland_Garros-F-Mary_Pierce-Justine_Henin,2,B-XC,14,3,1,2,0,8,6
20050604-W-Roland_Garros-F-Mary_Pierce-Justine_Henin,2,B-DTM,9,1,0,0,1,5,4
20050604-W-Roland_Garros-F-Mary_Pierce-Justine_Henin,2,B-DTL,3,3,1,0,2,1,2
20050604-W-Roland_Garros-F-Mary_Pierce-Justine_Henin,2,B-IO,1,0,0,0,0,1,0
20050604-W-Roland_Garros-F-Mary_Pierce-Justine_Henin,2,S-XC,3,0,0,0,0,2,1
20050604-W-Roland_Garros-F-Mary_Pierce-Justine_Henin,2,S-DTM,7,0,0,0,0,6,1
20150418-W-Fed_Cup_World_Group_PO-RR-Camila_Giorgi-Serena_Williams,1,F-XC,12,9,3,2,4,6,6
20150418-W-Fed_Cup_World_Group_PO-RR-Camila_Giorgi-Serena_Williams,1,F-DTM,15,2,1,0,1,5,10
20150418-W-Fed_Cup_World_Group_PO-RR-Camila_Giorgi-Serena_Williams,1,F-DTL,1,1,0,0,1,0,1
20150418-W-Fed_Cup_World_Group_PO-RR-Camila_Giorgi-Serena_Williams,1,F-IO,9,3,2,0,1,7,2
20150418-W-Fed_Cup_World_Group_PO-RR-Camila_Giorgi-Serena_Williams,1,B-XC,10,1,0,1,0,7,3
20150418-W-Fed_Cup_World_Group_PO-RR-Camila_Giorgi-Serena_Williams,1,B-DTM,16,1,0,1,0,7,9
20150418-W-Fed_Cup_World_Group_PO-RR-Camila_Giorgi-Serena_Williams,1,B-DTL,6,3,2,0,1,3,3
20150418-W-Fed_Cup_World_Group_PO-RR-Camila_Giorgi-Serena_Williams,1,B-IO,1,1,1,0,0,1,0
20150418-W-Fed_Cup_World_Group_PO-RR-Camila_Giorgi-Serena_Williams,1,S-DTM,1,0,0,0,0,0,1
20150418-W-Fed_Cup_World_Group_PO-RR-Camila_Giorgi-Serena_Williams,2,F-XC,15,7,5,0,2,11,4
20150418-W-Fed_Cup_World_Group_PO-RR-Camila_Giorgi-Serena_Williams,2,F-DTM,12,4,1,1,2,6,6
20150418-W-Fed_Cup_World_Group_PO-RR-Camila_Giorgi-Serena_Williams,2,F-DTL,2,0,0,0,0,2,0
20150418-W-Fed_Cup_World_Group_PO-RR-Camila_Giorgi-Serena_Williams,2,F-IO,2,1,1,0,0,1,1
20150418-W-Fed_Cup_World_Group_PO-RR-Camila_Giorgi-Serena_Williams,2,B-XC,21,8,3,4,1,12,9
20150418-W-Fed_Cup_World_Group_PO-RR-Camila_Giorgi-Serena_Williams,2,B-DTM,15,4,1,1,2,7,8
20150418-W-Fed_Cup_World_Group_PO-RR-Camila_Giorgi-Serena_Williams,2,B-DTL,5,2,1,1,0,4,1
20150418-W-Fed_Cup_World_Group_PO-RR-Camila_Giorgi-Serena_Williams,2,S-XC,2,1,1,0,0,1,1
20150418-W-Fed_Cup_World_Group_PO-RR-Camila_Giorgi-Serena_Williams,2,S-DTM,2,0,0,0,0,0,2
20150811-W-Toronto-R64-Dominika_Cibulkova-Sloane_Stephens,1,F-XC,57,7,2,1,4,29,28
20150811-W-Toronto-R64-Dominika_Cibulkova-Sloane_Stephens,1,F-DTM,41,7,0,1,6,22,19
20150811-W-Toronto-R64-Dominika_Cibulkova-Sloane_Stephens,1,F-DTL,16,7,1,2,4,8,8
20150811-W-Toronto-R64-Dominika_Cibulkova-Sloane_Stephens,1,F-IO,30,7,2,2,3,15,15
20150811-W-Toronto-R64-Dominika_Cibulkova-Sloane_Stephens,1,F-II,1,1,0,1,0,1,0
20150811-W-Toronto-R64-Dominika_Cibulkova-Sloane_Stephens,1,B-XC,38,6,1,2,3,22,16
20150811-W-Toronto-R64-Dominika_Cibulkova-Sloane_Stephens,1,B-DTM,29,1,0,0,1,14,15
20150811-W-Toronto-R64-Dominika_Cibulkova-Sloane_Stephens,1,B-DTL,3,1,0,0,1,2,1
20150811-W-Toronto-R64-Dominika_Cibulkova-Sloane_Stephens,1,B-IO,6,3,2,0,1,2,4
20150811-W-Toronto-R64-Dominika_Cibulkova-Sloane_Stephens,1,S-XC,4,0,0,0,0,3,1
20150811-W-Toronto-R64-Dominika_Cibulkova-Sloane_Stephens,1,S-DTM,5,0,0,0,0,2,3
20150811-W-Toronto-R64-Dominika_Cibulkova-Sloane_Stephens,1,S-DTL,1,0,0,0,0,1,0
20150811-W-Toronto-R64-Dominika_Cibulkova-Sloane_Stephens,2,F-XC,41,11,2,2,7,18,23
20150811-W-Toronto-R64-Dominika_Cibulkova-Sloane_Stephens,2,F-DTM,39,6,1,0,5,18,21
20150811-W-Toronto-R64-Dominika_Cibulkova-Sloane_Stephens,2,F-DTL,8,6,1,0,5,2,6
20150811-W-Toronto-R64-Dominika_Cibulkova-Sloane_Stephens,2,F-IO,19,6,2,0,4,8,11
20150811-W-Toronto-R64-Dominika_Cibulkova-Sloane_Stephens,2,F-II,1,0,0,0,0,0,1
20150811-W-Toronto-R64-Dominika_Cibulkova-Sloane_Stephens,2,B-XC,23,3,1,0,2,10,13
20150811-W-Toronto-R64-Dominika_Cibulkova-Sloane_Stephens,2,B-DTM,58,8,0,0,8,28,30
20150811-W-Toronto-R64-Dominika_Cibulkova-Sloane_Stephens,2,B-DTL,16,10,3,2,5,8,8
20150811-W-Toronto-R64-Dominika_Cibulkova-Sloane_Stephens,2,B-IO,5,2,0,0,2,2,3
20150811-W-Toronto-R64-Dominika_Cibulkova-Sloane_Stephens,2,S-XC,4,0,0,0,0,0,4
20150811-W-Toronto-R64-Dominika_Cibulkova-Sloane_Stephens,2,S-DTM,4,1,0,0,1,0,4
20150409-W-Katowice-R16-Katerina_Siniakova-Anna_Karolina_Schmiedlova,1,F-XC,94,18,4,1,13,44,50
20150409-W-Katowice-R16-Katerina_Siniakova-Anna_Karolina_Schmiedlova,1,F-DTM,54,5,0,0,5,20,34
20150409-W-Katowice-R16-Katerina_Siniakova-Anna_Karolina_Schmiedlova,1,F-DTL,31,14,2,4,8,15,16
20150409-W-Katowice-R16-Katerina_Siniakova-Anna_Karolina_Schmiedlova,1,F-IO,26,3,0,0,3,11,15
20150409-W-Katowice-R16-Katerina_Siniakova-Anna_Karolina_Schmiedlova,1,F-II,1,1,0,0,1,0,1
20150409-W-Katowice-R16-Katerina_Siniakova-Anna_Karolina_Schmiedlova,1,B-XC,89,17,4,5,8,37,52
20150409-W-Katowice-R16-Katerina_Siniakova-Anna_Karolina_Schmiedlova,1,B-DTM,46,2,0,1,1,20,26
20150409-W-Katowice-R16-Katerina_Siniakova-Anna_Karolina_Schmiedlova,1,B-DTL,36,12,2,3,7,18,18
20150409-W-Katowice-R16-Katerina_Siniakova-Anna_Karolina_Schmiedlova,1,B-IO,19,6,0,2,4,10,9
20150409-W-Katowice-R16-Katerina_Siniakova-Anna_Karolina_Schmiedlova,1,S-DTM,4,0,0,0,0,0,4
20150409-W-Katowice-R16-Katerina_Siniakova-Anna_Karolina_Schmiedlova,1,S-DTL,3,0,0,0,0,0,3
20150409-W-Katowice-R16-Katerina_Siniakova-Anna_Karolina_Schmiedlova,2,F-XC,103,17,4,4,9,56,47
20150409-W-Katowice-R16-Katerina_Siniakova-Anna_Karolina_Schmiedlova,2,F-DTM,80,3,0,1,2,43,37
20150409-W-Katowice-R16-Katerina_Siniakova-Anna_Karolina_Schmiedlova,2,F-DTL,15,4,0,0,4,6,9
20150409-W-Katowice-R16-Katerina_Siniakova-Anna_Karolina_Schmiedlova,2,F-IO,12,4,0,0,4,7,5
20150409-W-Katowice-R16-Katerina_Siniakova-Anna_Karolina_Schmiedlova,2,B-XC,99,13,2,7,4,58,41
20150409-W-Katowice-R16-Katerina_Siniakova-Anna_Karolina_Schmiedlova,2,B-DTM,52,2,0,0,2,31,21
20150409-W-Katowice-R16-Katerina_Siniakova-Anna_Karolina_Schmiedlova,2,B-DTL,14,4,1,1,2,10,4
20150409-W-Katowice-R16-Katerina_Siniakova-Anna_Karolina_Schmiedlova,2,B-IO,9,1,0,0,1,4,5
20150409-W-Katowice-R16-Katerina_Siniakova-Anna_Karolina_Schmiedlova,2,S-XC,4,0,0,0,0,1,3
20150409-W-Katowice-R16-Katerina_Siniakova-Anna_Karolina_Schmiedlova,2,S-DTM,5,0,0,0,0,1,4
20150409-W-Katowice-R16-Katerina_Siniakova-Anna_Karolina_Schmiedlova,2,S-DTL,2,0,0,0,0,0,2
20140103-W-Auckland-QF-Jamie_Hampton-Lauren_Davis,1,F-XC,50,21,9,1,11,26,24
20140103-W-Auckland-QF-Jamie_Hampton-Lauren_Davis,1,F-DTM,39,10,0,1,9,16,23
20140103-W-Auckland-QF-Jamie_Hampton-Lauren_Davis,1,F-DTL,10,3,2,0,1,4,6
20140103-W-Auckland-QF-Jamie_Hampton-Lauren_Davis,1,F-IO,29,12,2,3,7,13,16
20140103-W-Auckland-QF-Jamie_Hampton-Lauren_Davis,1,B-XC,38,11,3,4,4,18,20
20140103-W-Auckland-QF-Jamie_Hampton-Lauren_Davis,1,B-DTM,36,7,0,0,7,8,28
20140103-W-Auckland-QF-Jamie_Hampton-Lauren_Davis,1,B-DTL,5,4,1,2,1,4,1
20140103-W-Auckland-QF-Jamie_Hampton-Lauren_Davis,1,B-IO,10,5,1,1,3,5,5
20140103-W-Auckland-QF-Jamie_Hampton-Lauren_Davis,1,S-XC,7,2,0,0,2,0,7
20140103-W-Auckland-QF-Jamie_Hampton-Lauren_Davis,1,S-DTM,7,0,0,0,0,1,6
20140103-W-Auckland-QF-Jamie_Hampton-Lauren_Davis,2,F-XC,28,9,4,1,4,19,9
20140103-W-Auckland-QF-Jamie_Hampton-Lauren_Davis,2,F-DTM,69,10,0,1,9,34,35
20140103-W-Auckland-QF-Jamie_Hampton-Lauren_Davis,2,F-DTL,10,2,1,1,0,6,4
20140103-W-Auckland-QF-Jamie_Hampton-Lauren_Davis,2,F-IO,7,2,1,0,1,4,3
20140103-W-Auckland-QF-Jamie_Hampton-Lauren_Davis,2,B-XC,25,8,1,2,5,16,9
20140103-W-Auckland-QF-Jamie_Hampton-Lauren_Davis,2,B-DTM,43,2,0,0,2,26,17
20140103-W-Auckland-QF-Jamie_Hampton-Lauren_Davis,2,B-DTL,6,3,0,3,0,5,1
20140103-W-Auckland-QF-Jamie_Hampton-Lauren_Davis,2,B-IO,11,4,2,0,2,7,4
20140103-W-Auckland-QF-Jamie_Hampton-Lauren_Davis,2,S-XC,8,0,0,0,0,4,4
20140103-W-Auckland-QF-Jamie_Hampton-Lauren_Davis,2,S-DTM,9,3,0,2,1,4,5
20140103-W-Auckland-QF-Jamie_Hampton-Lauren_Davis,2,S-DTL,5,0,0,0,0,2,3
19830523-W-Roland_Garros-F-Mima_Jausovec-Chris_Evert,1,F-XC,49,6,0,0,6,11,38
19830523-W-Roland_Garros-F-Mima_Jausovec-Chris_Evert,1,F-DTM,21,1,0,0,1,7,14
19830523-W-Roland_Garros-F-Mima_Jausovec-Chris_Evert,1,F-DTL,15,6,0,1,5,6,9
19830523-W-Roland_Garros-F-Mima_Jausovec-Chris_Evert,1,F-IO,12,1,0,0,1,4,8
19830523-W-Roland_Garros-F-Mima_Jausovec-Chris_Evert,1,F-II,2,0,0,0,0,0,2
19830523-W-Roland_Garros-F-Mima_Jausovec-Chris_Evert,1,B-XC,3,0,0,0,0,1,2
19830523-W-Roland_Garros-F-Mima_Jausovec-Chris_Evert,1,B-DTM,4,1,0,0,1,0,4
19830523-W-Roland_Garros-F-Mima_Jausovec-Chris_Evert,1,B-DTL,2,1,0,0,1,0,2
19830523-W-Roland_Garros-F-Mima_Jausovec-Chris_Evert,1,S-XC,44,2,0,1,1,18,26
19830523-W-Roland_Garros-F-Mima_Jausovec-Chris_Evert,1,S-DTM,31,1,0,0,1,8,23
19830523-W-Roland_Garros-F-Mima_Jausovec-Chris_Evert,1,S-DTL,27,1,0,1,0,7,20
19830523-W-Roland_Garros-F-Mima_Jausovec-Chris_Evert,1,S-IO,8,1,0,0,1,3,5
19830523-W-Roland_Garros-F-Mima_Jausovec-Chris_Evert,2,F-XC,52,9,3,3,3,33,19
19830523-W-Roland_Garros-F-Mima_Jausovec-Chris_Evert,2,F-DTM,30,4,1,1,2,22,8
19830523-W-Roland_Garros-F-Mima_Jausovec-Chris_Evert,2,F-DTL,26,3,3,0,0,21,5
19830523-W-Roland_Garros-F-Mima_Jausovec-Chris_Evert,2,F-IO,26,3,1,1,1,17,9
19830523-W-Roland_Garros-F-Mima_Jausovec-Chris_Evert,2,B-XC,64,7,1,1,5,40,24
19830523-W-Roland_Garros-F-Mima_Jausovec-Chris_Evert,2,B-DTM,10,2,0,0,2,6,4
19830523-W-Roland_Garros-F-Mima_Jausovec-Chris_Evert,2,B-DTL,16,1,0,0,1,11,5
19830523-W-Roland_Garros-F-Mima_Jausovec-Chris_Evert,2,B-IO,8,0,0,0,0,6,2
19830523-W-Roland_Garros-F-Mima_Jausovec-Chris_Evert,2,S-XC,2,0,0,0,0,1,1
19830523-W-Roland_Garros-F-Mima_Jausovec-Chris_Evert,2,S-DTM,2,0,0,0,0,2,0
19830523-W-Roland_Garros-F-Mima_Jausovec-Chris_Evert,2,S-DTL,1,0,0,0,0,0,1
20090912-W-US_Open-SF-Kim_Clijsters-Serena_Williams,1,B-DTL,7,4,1,2,1,3,4
20090912-W-US_Open-SF-Kim_Clijsters-Serena_Williams,1,B-IO,1,1,0,1,0,1,0
20090912-W-US_Open-SF-Kim_Clijsters-Serena_Williams,1,S-XC,11,0,0,0,0,7,4
20090912-W-US_Open-SF-Kim_Clijsters-Serena_Williams,1,S-DTM,3,0,0,0,0,1,2
20090912-W-US_Open-SF-Kim_Clijsters-Serena_Williams,1,S-DTL,3,0,0,0,0,1,2
20090912-W-US_Open-SF-Kim_Clijsters-Serena_Williams,2,F-XC,34,11,2,2,7,11,23
20090912-W-US_Open-SF-Kim_Clijsters-Serena_Williams,2,F-DTM,8,1,0,0,1,2,6
20090912-W-US_Open-SF-Kim_Clijsters-Serena_Williams,2,F-DTL,20,5,3,1,1,11,9
20090912-W-US_Open-SF-Kim_Clijsters-Serena_Williams,2,F-IO,8,5,2,3,0,6,2
20090912-W-US_Open-SF-Kim_Clijsters-Serena_Williams,2,B-XC,44,8,0,0,8,10,34
20090912-W-US_Open-SF-Kim_Clijsters-Serena_Williams,2,B-DTM,24,1,0,0,1,7,17
20090912-W-US_Open-SF-Kim_Clijsters-Serena_Williams,2,B-DTL,18,8,1,3,4,6,12
20090912-W-US_Open-SF-Kim_Clijsters-Serena_Williams,2,B-IO,7,2,0,0,2,4,3
20090912-W-US_Open-SF-Kim_Clijsters-Serena_Williams,2,S-XC,4,0,0,0,0,1,3
20090912-W-US_Open-SF-Kim_Clijsters-Serena_Williams,2,S-DTM,2,0,0,0,0,1,1
19810420-W-Amelia_Island-F-Martina_Navratilova-Chris_Evert,1,F-XC,54,13,4,4,5,36,18
19810420-W-Amelia_Island-F-Martina_Navratilova-Chris_Evert,1,F-XC,17,5,1,1,3,5,12
19810420-W-Amelia_Island-F-Martina_Navratilova-Chris_Evert,1,F-DTM,3,0,0,0,0,0,3
19810420-W-Amelia_Island-F-Martina_Navratilova-Chris_Evert,1,F-DTL,3,2,0,0,2,0,3
19810420-W-Amelia_Island-F-Martina_Navratilova-Chris_Evert,1,F-IO,4,1,0,0,1,0,4
19810420-W-Amelia_Island-F-Martina_Navratilova-Chris_Evert,1,B-XC,1,0,0,0,0,0,1
19810420-W-Amelia_Island-F-Martina_Navratilova-Chris_Evert,1,B-DTM,4,0,0,0,0,2,2
19810420-W-Amelia_Island-F-Martina_Navratilova-Chris_Evert,1,S-XC,32,4,0,0,4,7,25
19810420-W-Amelia_Island-F-Martina_Navratilova-Chris_Evert,1,S-DTM,16,0,0,0,0,3,13
19810420-W-Amelia_Island-F-Martina_Navratilova-Chris_Evert,1,S-DTL,13,0,0,0,0,2,11
19810420-W-Amelia_Island-F-Martina_Navratilova-Chris_Evert,1,S-IO,2,0,0,0,0,1,1
19810420-W-Amelia_Island-F-Martina_Navratilova-Chris_Evert,2,F-XC,49,5,1,2,2,38,11
19810420-W-Amelia_Island-F-Martina_Navratilova-Chris_Evert,2,F-DTM,12,2,0,0,2,5,7
19810420-W-Amelia_Island-F-Martina_Navratilova-Chris_Evert,2,F-DTL,7,5,1,3,1,6,1
19810420-W-Amelia_Island-F-Martina_Navratilova-Chris_Evert,2,F-IO,3,0,0,0,0,1,2
19810420-W-Amelia_Island-F-Martina_Navratilova-Chris_Evert,2,B-XC,22,8,3,2,3,17,5
19810420-W-Amelia_Island-F-Martina_Navratilova-Chris_Evert,2,B-DTM,11,0,0,0,0,8,3
19810420-W-Amelia_Island-F-Martina_Navratilova-Chris_Evert,2,B-DTL,4,0,0,0,0,3,1
19810420-W-Amelia_Island-F-Martina_Navratilova-Chris_Evert,2,B-IO,3,1,1,0,0,3,0
19810420-W-Amelia_Island-F-Martina_Navratilova-Chris_Evert,2,S-DTM,2,0,0,0,0,2,0
19810420-W-Amelia_Island-F-Martina_Navratilova-Chris_Evert,2,S-DTL,1,0,0,0,0,1,0
20120810-W-Montreal-R16-Marion_Bartoli-Petra_Kvitova,1,F-XC,10,1,0,1,0,4,6
20120810-W-Montreal-R16-Marion_Bartoli-Petra_Kvitova,1,F-DTM,23,3,0,0,3,3,20
20120810-W-Montreal-R16-Marion_Bartoli-Petra_Kvitova,1,F-DTL,3,0,0,0,0,1,2
20120810-W-Montreal-R16-Marion_Bartoli-Petra_Kvitova,1,F-IO,3,1,0,0,1,0,3
20120810-W-Montreal-R16-Marion_Bartoli-Petra_Kvitova,1,B-XC,14,5,1,0,4,3,11
20120810-W-Montreal-R16-Marion_Bartoli-Petra_Kvitova,1,B-DTM,22,3,0,1,2,10,12
20120810-W-Montreal-R16-Marion_Bartoli-Petra_Kvitova,1,B-DTL,4,2,1,0,1,1,3
20120810-W-Montreal-R16-Marion_Bartoli-Petra_Kvitova,1,B-IO,2,0,0,0,0,2,0
20120810-W-Montreal-R16-Marion_Bartoli-Petra_Kvitova,1,S-DTM,1,0,0,0,0,0,1
20120810-W-Montreal-R16-Marion_Bartoli-Petra_Kvitova,2,F-XC,20,5,4,0,1,14,6
20120810-W-Montreal-R16-Marion_Bartoli-Petra_Kvitova,2,F-DTM,9,2,1,1,0,7,2
20120810-W-Montreal-R16-Marion_Bartoli-Petra_Kvitova,2,F-DTL,8,3,2,0,1,6,2
20120810-W-Montreal-R16-Marion_Bartoli-Petra_Kvitova,2,F-IO,6,3,1,1,1,4,2
20120810-W-Montreal-R16-Marion_Bartoli-Petra_Kvitova,2,B-XC,15,3,1,2,0,11,4
20120810-W-Montreal-R16-Marion_Bartoli-Petra_Kvitova,2,B-DTM,9,2,0,0,2,7,2
20120810-W-Montreal-R16-Marion_Bartoli-Petra_Kvitova,2,B-DTL,4,3,2,0,1,3,1
20120810-W-Montreal-R16-Marion_Bartoli-Petra_Kvitova,2,B-IO,11,6,3,0,3,6,5
20120810-W-Montreal-R16-Marion_Bartoli-Petra_Kvitova,2,S-XC,2,1,0,1,0,2,0
20120810-W-Montreal-R16-Marion_Bartoli-Petra_Kvitova,2,S-DTM,1,0,0,0,0,0,1
20120810-W-Montreal-R16-Marion_Bartoli-Petra_Kvitova,2,S-IO,4,0,0,0,0,3,1
20150903-W-US_Open-R64-Caroline_Wozniacki-Petra_Cetkovska,1,F-XC,74,8,0,4,4,26,48
20150903-W-US_Open-R64-Caroline_Wozniacki-Petra_Cetkovska,1,F-DTM,65,2,0,0,2,21,44
20150903-W-US_Open-R64-Caroline_Wozniacki-Petra_Cetkovska,1,F-DTL,43,2,1,0,1,22,21
20150903-W-US_Open-R64-Caroline_Wozniacki-Petra_Cetkovska,1,F-IO,37,3,1,0,2,17,20
20150903-W-US_Open-R64-Caroline_Wozniacki-Petra_Cetkovska,1,B-XC,94,7,2,0,5,45,49
20150903-W-US_Open-R64-Caroline_Wozniacki-Petra_Cetkovska,1,B-DTM,75,6,0,0,6,25,50
20150903-W-US_Open-R64-Caroline_Wozniacki-Petra_Cetkovska,1,B-DTL,13,4,2,1,1,9,4
20150903-W-US_Open-R64-Caroline_Wozniacki-Petra_Cetkovska,1,B-IO,42,14,3,5,6,25,17
20150903-W-US_Open-R64-Caroline_Wozniacki-Petra_Cetkovska,1,S-XC,10,0,0,0,0,3,7
20150903-W-US_Open-R64-Caroline_Wozniacki-Petra_Cetkovska,1,S-DTM,8,0,0,0,0,2,6
20150903-W-US_Open-R64-Caroline_Wozniacki-Petra_Cetkovska,1,S-DTL,4,1,0,1,0,3,1
20150903-W-US_Open-R64-Caroline_Wozniacki-Petra_Cetkovska,1,S-IO,1,1,0,0,1,0,1
20150903-W-US_Open-R64-Caroline_Wozniacki-Petra_Cetkovska,2,F-XC,98,28,10,5,13,62,36
20150903-W-US_Open-R64-Caroline_Wozniacki-Petra_Cetkovska,2,F-DTM,52,5,0,0,5,26,26
20150903-W-US_Open-R64-Caroline_Wozniacki-Petra_Cetkovska,2,F-DTL,28,10,7,0,3,18,10
20150903-W-US_Open-R64-Caroline_Wozniacki-Petra_Cetkovska,2,F-IO,44,13,7,1,5,28,16
20150903-W-US_Open-R64-Caroline_Wozniacki-Petra_Cetkovska,2,F-II,4,1,1,0,0,3,1
20150903-W-US_Open-R64-Caroline_Wozniacki-Petra_Cetkovska,2,B-XC,57,14,5,2,7,39,18
20150903-W-US_Open-R64-Caroline_Wozniacki-Petra_Cetkovska,2,B-DTM,74,3,0,0,3,38,36
20150903-W-US_Open-R64-Caroline_Wozniacki-Petra_Cetkovska,2,B-DTL,39,16,5,1,10,18,21
20150903-W-US_Open-R64-Caroline_Wozniacki-Petra_Cetkovska,2,B-IO,16,3,2,0,1,12,4
20150903-W-US_Open-R64-Caroline_Wozniacki-Petra_Cetkovska,2,S-XC,24,0,0,0,0,10,14
20150903-W-US_Open-R64-Caroline_Wozniacki-Petra_Cetkovska,2,S-DTM,20,1,0,0,1,8,12
20150903-W-US_Open-R64-Caroline_Wozniacki-Petra_Cetkovska,2,S-DTL,7,1,1,0,0,6,1
20150903-W-US_Open-R64-Caroline_Wozniacki-Petra_Cetkovska,2,S-IO,2,0,0,0,0,2,0
20151107-W-Zhuhai-SF-Elina_Svitolina-Karolina_Pliskova,1,F-XC,12,2,0,2,0,7,5
20151107-W-Zhuhai-SF-Elina_Svitolina-Karolina_Pliskova,1,F-DTM,29,1,0,0,1,9,20
20151107-W-Zhuhai-SF-Elina_Svitolina-Karolina_Pliskova,1,F-DTL,8,2,1,1,0,4,4
20151107-W-Zhuhai-SF-Elina_Svitolina-Karolina_Pliskova,1,F-IO,6,2,2,0,0,3,3
20151107-W-Zhuhai-SF-Elina_Svitolina-Karolina_Pliskova,1,F-II,2,1,1,0,0,1,1
20151107-W-Zhuhai-SF-Elina_Svitolina-Karolina_Pliskova,1,B-XC,20,3,1,0,2,10,10
20151107-W-Zhuhai-SF-Elina_Svitolina-Karolina_Pliskova,1,B-DTM,15,3,0,0,3,3,12
20151107-W-Zhuhai-SF-Elina_Svitolina-Karolina_Pliskova,1,B-DTL,3,1,0,0,1,1,2
20151107-W-Zhuhai-SF-Elina_Svitolina-Karolina_Pliskova,1,B-IO,5,3,1,0,2,3,2
20151107-W-Zhuhai-SF-Elina_Svitolina-Karolina_Pliskova,1,S-DTM,4,0,0,0,0,0,4
20151107-W-Zhuhai-SF-Elina_Svitolina-Karolina_Pliskova,1,S-DTL,1,0,0,0,0,0,1
20151107-W-Zhuhai-SF-Elina_Svitolina-Karolina_Pliskova,2,F-XC,22,5,3,0,2,13,9
20151107-W-Zhuhai-SF-Elina_Svitolina-Karolina_Pliskova,2,F-DTM,13,0,0,0,0,6,7
20151107-W-Zhuhai-SF-Elina_Svitolina-Karolina_Pliskova,2,F-DTL,2,1,0,0,1,1,1
20151107-W-Zhuhai-SF-Elina_Svitolina-Karolina_Pliskova,2,F-IO,21,11,6,3,2,17,4
20151107-W-Zhuhai-SF-Elina_Svitolina-Karolina_Pliskova,2,F-II,1,0,0,0,0,0,1
20151107-W-Zhuhai-SF-Elina_Svitolina-Karolina_Pliskova,2,B-XC,13,6,2,2,2,8,5
20151107-W-Zhuhai-SF-Elina_Svitolina-Karolina_Pliskova,2,B-DTM,17,2,1,0,1,11,6
20151107-W-Zhuhai-SF-Elina_Svitolina-Karolina_Pliskova,2,B-DTL,12,2,0,0,2,7,5
20151107-W-Zhuhai-SF-Elina_Svitolina-Karolina_Pliskova,2,B-IO,4,0,0,0,0,4,0
20151107-W-Zhuhai-SF-Elina_Svitolina-Karolina_Pliskova,2,S-XC,3,0,0,0,0,1,2
20151107-W-Zhuhai-SF-Elina_Svitolina-Karolina_Pliskova,2,S-DTM,2,0,0,0,0,2,0
20151107-W-Zhuhai-SF-Elina_Svitolina-Karolina_Pliskova,2,S-IO,1,0,0,0,0,1,0
20070908-W-US_Open-F-Svetlana_Kuznetsova-Justine_Henin,1,F-XC,49,12,3,1,8,16,33
20070908-W-US_Open-F-Svetlana_Kuznetsova-Justine_Henin,1,F-DTM,11,1,0,0,1,3,8
20070908-W-US_Open-F-Svetlana_Kuznetsova-Justine_Henin,1,F-DTL,15,6,0,1,5,7,8
20070908-W-US_Open-F-Svetlana_Kuznetsova-Justine_Henin,1,F-IO,19,3,0,0,3,6,13
20070908-W-US_Open-F-Svetlana_Kuznetsova-Justine_Henin,1,F-II,3,3,1,0,2,1,2
20070908-W-US_Open-F-Svetlana_Kuznetsova-Justine_Henin,1,B-XC,32,8,0,1,7,9,23
20070908-W-US_Open-F-Svetlana_Kuznetsova-Justine_Henin,1,B-DTM,21,0,0,0,0,4,17
20070908-W-US_Open-F-Svetlana_Kuznetsova-Justine_Henin,1,B-DTL,13,3,1,0,2,5,8
20070908-W-US_Open-F-Svetlana_Kuznetsova-Justine_Henin,1,B-IO,8,2,0,0,2,2,6
20070908-W-US_Open-F-Svetlana_Kuznetsova-Justine_Henin,1,S-DTM,3,0,0,0,0,0,3
20070908-W-US_Open-F-Svetlana_Kuznetsova-Justine_Henin,2,F-XC,36,9,2,4,3,24,12
20070908-W-US_Open-F-Svetlana_Kuznetsova-Justine_Henin,2,F-DTM,26,0,0,0,0,16,10
20070908-W-US_Open-F-Svetlana_Kuznetsova-Justine_Henin,2,F-DTL,17,3,1,0,2,14,3
20070908-W-US_Open-F-Svetlana_Kuznetsova-Justine_Henin,2,F-IO,11,1,0,0,1,9,2
20070908-W-US_Open-F-Svetlana_Kuznetsova-Justine_Henin,2,F-II,2,1,1,0,0,2,0
20070908-W-US_Open-F-Svetlana_Kuznetsova-Justine_Henin,2,B-XC,24,7,1,1,5,12,12
20070908-W-US_Open-F-Svetlana_Kuznetsova-Justine_Henin,2,B-DTM,23,1,0,0,1,14,9
20070908-W-US_Open-F-Svetlana_Kuznetsova-Justine_Henin,2,B-DTL,8,2,0,0,2,6,2
20070908-W-US_Open-F-Svetlana_Kuznetsova-Justine_Henin,2,B-IO,3,2,0,0,2,1,2
20070908-W-US_Open-F-Svetlana_Kuznetsova-Justine_Henin,2,S-XC,3,0,0,0,0,2,1
20070908-W-US_Open-F-Svetlana_Kuznetsova-Justine_Henin,2,S-DTM,10,0,0,0,0,5,5
20070908-W-US_Open-F-Svetlana_Kuznetsova-Justine_Henin,2,S-DTL,1,0,0,0,0,1,0
20070908-W-US_Open-F-Svetlana_Kuznetsova-Justine_Henin,2,S-IO,2,1,0,1,0,2,0
20110910-W-US_Open-F-Serena_Williams-Samantha_Stosur,1,F-XC,39,13,3,2,8,14,25
20110910-W-US_Open-F-Serena_Williams-Samantha_Stosur,1,F-DTM,10,1,0,0,1,3,7
20110910-W-US_Open-F-Serena_Williams-Samantha_Stosur,1,F-DTL,11,3,3,0,0,7,4
20110910-W-US_Open-F-Serena_Williams-Samantha_Stosur,1,F-IO,11,3,1,0,2,7,4
20110910-W-US_Open-F-Serena_Williams-Samantha_Stosur,1,B-XC,37,8,1,0,7,10,27
20110910-W-US_Open-F-Serena_Williams-Samantha_Stosur,1,B-DTM,10,1,1,0,0,4,6
20110910-W-US_Open-F-Serena_Williams-Samantha_Stosur,1,B-DTL,14,6,1,1,4,5,9
20110910-W-US_Open-F-Serena_Williams-Samantha_Stosur,1,B-IO,9,2,1,0,1,6,3
20110910-W-US_Open-F-Serena_Williams-Samantha_Stosur,1,S-XC,2,0,0,0,0,1,1
20110910-W-US_Open-F-Serena_Williams-Samantha_Stosur,1,S-DTM,3,1,0,0,1,0,3
20110910-W-US_Open-F-Serena_Williams-Samantha_Stosur,2,F-XC,26,2,1,1,0,19,7
20110910-W-US_Open-F-Serena_Williams-Samantha_Stosur,2,F-DTM,13,1,0,0,1,6,7
20110910-W-US_Open-F-Serena_Williams-Samantha_Stosur,2,F-DTL,23,7,1,1,5,12,11
20110910-W-US_Open-F-Serena_Williams-Samantha_Stosur,2,F-IO,18,4,3,0,1,13,5
20110910-W-US_Open-F-Serena_Williams-Samantha_Stosur,2,F-II,3,1,0,0,1,0,3
20110910-W-US_Open-F-Serena_Williams-Samantha_Stosur,2,B-XC,15,2,1,0,1,9,6
20110910-W-US_Open-F-Serena_Williams-Samantha_Stosur,2,B-DTM,11,1,0,0,1,5,6
20110910-W-US_Open-F-Serena_Williams-Samantha_Stosur,2,B-DTL,4,1,1,0,0,3,1
20110910-W-US_Open-F-Serena_Williams-Samantha_Stosur,2,S-XC,11,2,0,0,2,7,4
20110910-W-US_Open-F-Serena_Williams-Samantha_Stosur,2,S-DTM,6,0,0,0,0,3,3
20110910-W-US_Open-F-Serena_Williams-Samantha_Stosur,2,S-DTL,4,0,0,0,0,3,1
19870223-W-Key_Biscayne-F-Chris_Evert-Steffi_Graf,1,F-XC,34,5,0,1,4,12,22
19870223-W-Key_Biscayne-F-Chris_Evert-Steffi_Graf,1,F-DTM,35,2,0,0,2,11,24
19870223-W-Key_Biscayne-F-Chris_Evert-Steffi_Graf,1,F-DTL,23,2,1,0,1,11,12
19870223-W-Key_Biscayne-F-Chris_Evert-Steffi_Graf,1,F-IO,17,3,0,0,3,5,12
19870223-W-Key_Biscayne-F-Chris_Evert-Steffi_Graf,1,B-XC,68,6,0,1,5,26,42
19870223-W-Key_Biscayne-F-Chris_Evert-Steffi_Graf,1,B-DTM,12,0,0,0,0,4,8
19870223-W-Key_Biscayne-F-Chris_Evert-Steffi_Graf,1,B-DTL,13,3,2,0,1,4,9
19870223-W-Key_Biscayne-F-Chris_Evert-Steffi_Graf,1,B-IO,6,0,0,0,0,2,4
19870223-W-Key_Biscayne-F-Chris_Evert-Steffi_Graf,1,S-XC,4,0,0,0,0,0,4
19870223-W-Key_Biscayne-F-Chris_Evert-Steffi_Graf,1,S-DTM,4,0,0,0,0,1,3
19870223-W-Key_Biscayne-F-Chris_Evert-Steffi_Graf,1,S-DTL,1,0,0,0,0,0,1
19870223-W-Key_Biscayne-F-Chris_Evert-Steffi_Graf,2,F-XC,47,8,1,4,3,32,15
19870223-W-Key_Biscayne-F-Chris_Evert-Steffi_Graf,2,F-DTM,19,2,0,2,0,12,7
19870223-W-Key_Biscayne-F-Chris_Evert-Steffi_Graf,2,F-DTL,8,2,0,1,1,6,2
19870223-W-Key_Biscayne-F-Chris_Evert-Steffi_Graf,2,F-IO,27,6,4,1,1,17,10
19870223-W-Key_Biscayne-F-Chris_Evert-Steffi_Graf,2,F-II,7,2,0,1,1,2,5
19870223-W-Key_Biscayne-F-Chris_Evert-Steffi_Graf,2,B-XC,5,1,0,1,0,4,1
19870223-W-Key_Biscayne-F-Chris_Evert-Steffi_Graf,2,B-DTM,5,4,0,0,4,0,5
19870223-W-Key_Biscayne-F-Chris_Evert-Steffi_Graf,2,B-DTL,1,1,1,0,0,1,0
19870223-W-Key_Biscayne-F-Chris_Evert-Steffi_Graf,2,S-XC,46,1,0,0,1,29,17
19870223-W-Key_Biscayne-F-Chris_Evert-Steffi_Graf,2,S-DTM,41,1,0,0,1,26,15
19870223-W-Key_Biscayne-F-Chris_Evert-Steffi_Graf,2,S-DTL,25,9,4,2,3,14,11
19870223-W-Key_Biscayne-F-Chris_Evert-Steffi_Graf,2,S-IO,9,0,0,0,0,7,2
19820831-W-US_Open-F-Hana_Mandlikova-Chris_Evert,1,F-XC,42,11,4,3,4,12,30
19820831-W-US_Open-F-Hana_Mandlikova-Chris_Evert,1,F-DTM,12,0,0,0,0,7,5
19820831-W-US_Open-F-Hana_Mandlikova-Chris_Evert,1,F-DTL,5,3,0,2,1,4,1
19820831-W-US_Open-F-Hana_Mandlikova-Chris_Evert,1,F-IO,12,3,0,1,2,6,6
19820831-W-US_Open-F-Hana_Mandlikova-Chris_Evert,1,B-XC,44,8,2,3,3,15,29
19820831-W-US_Open-F-Hana_Mandlikova-Chris_Evert,1,B-DTM,18,1,0,0,1,5,13
19820831-W-US_Open-F-Hana_Mandlikova-Chris_Evert,1,B-DTL,11,5,0,0,5,3,8
19820831-W-US_Open-F-Hana_Mandlikova-Chris_Evert,1,B-IO,3,1,0,0,1,0,3
19820831-W-US_Open-F-Hana_Mandlikova-Chris_Evert,1,S-XC,8,0,0,0,0,2,6
19820831-W-US_Open-F-Hana_Mandlikova-Chris_Evert,1,S-DTM,13,1,0,0,1,5,8
19820831-W-US_Open-F-Hana_Mandlikova-Chris_Evert,1,S-DTL,9,2,0,0,2,6,3
19820831-W-US_Open-F-Hana_Mandlikova-Chris_Evert,1,S-IO,3,0,0,0,0,0,3
19820831-W-US_Open-F-Hana_Mandlikova-Chris_Evert,2,F-XC,39,10,5,4,1,23,16
19820831-W-US_Open-F-Hana_Mandlikova-Chris_Evert,2,F-DTM,16,3,0,0,3,9,7
19820831-W-US_Open-F-Hana_Mandlikova-Chris_Evert,2,F-DTL,13,3,1,2,0,12,1
19820831-W-US_Open-F-Hana_Mandlikova-Chris_Evert,2,F-IO,23,1,0,1,0,14,9
19820831-W-US_Open-F-Hana_Mandlikova-Chris_Evert,2,B-XC,57,5,0,4,1,41,16
19820831-W-US_Open-F-Hana_Mandlikova-Chris_Evert,2,B-DTM,24,2,0,2,0,17,7
19820831-W-US_Open-F-Hana_Mandlikova-Chris_Evert,2,B-DTL,3,1,0,0,1,2,1
19820831-W-US_Open-F-Hana_Mandlikova-Chris_Evert,2,B-IO,4,1,0,1,0,4,0
19820831-W-US_Open-F-Hana_Mandlikova-Chris_Evert,2,S-XC,2,0,0,0,0,1,1
19820831-W-US_Open-F-Hana_Mandlikova-Chris_Evert,2,S-DTM,2,0,0,0,0,0,2
19820831-W-US_Open-F-Hana_Mandlikova-Chris_Evert,2,S-IO,1,0,0,0,0,1,0
20090704-W-Wimbledon-F-Venus_Williams-Serena_Williams,1,F-XC,28,7,3,1,3,10,18
20090704-W-Wimbledon-F-Venus_Williams-Serena_Williams,1,F-DTM,15,2,0,1,1,6,9
20090704-W-Wimbledon-F-Venus_Williams-Serena_Williams,1,F-DTL,7,2,0,0,2,4,3
20090704-W-Wimbledon-F-Venus_Williams-Serena_Williams,1,F-IO,10,3,0,2,1,6,4
20090704-W-Wimbledon-F-Venus_Williams-Serena_Williams,1,B-XC,23,6,0,3,3,9,14
20090704-W-Wimbledon-F-Venus_Williams-Serena_Williams,1,B-DTM,18,2,1,1,0,11,7
20090704-W-Wimbledon-F-Venus_Williams-Serena_Williams,1,B-DTL,6,3,1,0,2,1,5
20090704-W-Wimbledon-F-Venus_Williams-Serena_Williams,1,B-IO,3,1,0,0,1,0,3
20090704-W-Wimbledon-F-Venus_Williams-Serena_Williams,1,S-XC,1,0,0,0,0,1,0
20090704-W-Wimbledon-F-Venus_Williams-Serena_Williams,1,S-DTL,1,0,0,0,0,0,1
20090704-W-Wimbledon-F-Venus_Williams-Serena_Williams,2,F-XC,27,11,3,6,2,20,7
20090704-W-Wimbledon-F-Venus_Williams-Serena_Williams,2,F-DTM,10,1,0,0,1,5,5
20090704-W-Wimbledon-F-Venus_Williams-Serena_Williams,2,F-DTL,11,7,4,3,0,10,1
20090704-W-Wimbledon-F-Venus_Williams-Serena_Williams,2,F-IO,8,5,2,1,2,5,3
20090704-W-Wimbledon-F-Venus_Williams-Serena_Williams,2,F-II,1,1,0,1,0,1,0
20090704-W-Wimbledon-F-Venus_Williams-Serena_Williams,2,B-XC,21,3,1,0,2,10,11
20090704-W-Wimbledon-F-Venus_Williams-Serena_Williams,2,B-DTM,17,1,0,1,0,12,5
20090704-W-Wimbledon-F-Venus_Williams-Serena_Williams,2,B-DTL,7,2,1,1,0,6,1
20090704-W-Wimbledon-F-Venus_Williams-Serena_Williams,2,B-IO,6,2,0,1,1,3,3
20090704-W-Wimbledon-F-Venus_Williams-Serena_Williams,2,S-XC,1,0,0,0,0,0,1
20090704-W-Wimbledon-F-Venus_Williams-Serena_Williams,2,S-DTM,3,0,0,0,0,1,2
20110123-W-Australian_Open-R16-Francesca_Schiavone-Svetlana_Kuznetsova,1,F-XC,103,15,6,4,5,59,44
20110123-W-Australian_Open-R16-Francesca_Schiavone-Svetlana_Kuznetsova,1,F-DTM,55,4,0,1,3,20,35
20110123-W-Australian_Open-R16-Francesca_Schiavone-Svetlana_Kuznetsova,1,F-DTL,48,14,2,4,8,23,25
20110123-W-Australian_Open-R16-Francesca_Schiavone-Svetlana_Kuznetsova,1,F-IO,59,21,7,4,10,33,26
20110123-W-Australian_Open-R16-Francesca_Schiavone-Svetlana_Kuznetsova,1,F-II,12,6,4,1,1,5,7
20110123-W-Australian_Open-R16-Francesca_Schiavone-Svetlana_Kuznetsova,1,B-XC,80,12,3,4,5,43,37
20110123-W-Australian_Open-R16-Francesca_Schiavone-Svetlana_Kuznetsova,1,B-DTM,64,3,0,1,2,25,39
20110123-W-Australian_Open-R16-Francesca_Schiavone-Svetlana_Kuznetsova,1,B-DTL,21,8,6,1,1,14,7
20110123-W-Australian_Open-R16-Francesca_Schiavone-Svetlana_Kuznetsova,1,B-IO,5,1,0,0,1,3,2
20110123-W-Australian_Open-R16-Francesca_Schiavone-Svetlana_Kuznetsova,1,S-XC,77,2,1,1,0,41,36
20110123-W-Australian_Open-R16-Francesca_Schiavone-Svetlana_Kuznetsova,1,S-DTM,31,2,0,0,2,7,24
20110123-W-Australian_Open-R16-Francesca_Schiavone-Svetlana_Kuznetsova,1,S-DTL,14,4,2,0,2,7,7
20110123-W-Australian_Open-R16-Francesca_Schiavone-Svetlana_Kuznetsova,1,S-IO,4,0,0,0,0,2,2
20110123-W-Australian_Open-R16-Francesca_Schiavone-Svetlana_Kuznetsova,2,F-XC,111,28,13,10,5,66,45
20110123-W-Australian_Open-R16-Francesca_Schiavone-Svetlana_Kuznetsova,2,F-DTM,60,3,0,1,2,30,30
20110123-W-Australian_Open-R16-Francesca_Schiavone-Svetlana_Kuznetsova,2,F-DTL,54,11,3,3,5,24,30
20110123-W-Australian_Open-R16-Francesca_Schiavone-Svetlana_Kuznetsova,2,F-IO,57,12,2,4,6,32,25
20110123-W-Australian_Open-R16-Francesca_Schiavone-Svetlana_Kuznetsova,2,F-II,7,4,3,0,1,4,3
20110123-W-Australian_Open-R16-Francesca_Schiavone-Svetlana_Kuznetsova,2,B-XC,146,27,9,5,13,71,75
20110123-W-Australian_Open-R16-Francesca_Schiavone-Svetlana_Kuznetsova,2,B-DTM,64,5,1,1,3,33,31
20110123-W-Australian_Open-R16-Francesca_Schiavone-Svetlana_Kuznetsova,2,B-DTL,39,16,8,0,8,22,17
20110123-W-Australian_Open-R16-Francesca_Schiavone-Svetlana_Kuznetsova,2,B-IO,8,4,2,1,1,5,3
20110123-W-Australian_Open-R16-Francesca_Schiavone-Svetlana_Kuznetsova,2,S-XC,16,2,0,0,2,6,10
20110123-W-Australian_Open-R16-Francesca_Schiavone-Svetlana_Kuznetsova,2,S-DTM,9,1,0,1,0,3,6
20110123-W-Australian_Open-R16-Francesca_Schiavone-Svetlana_Kuznetsova,2,S-DTL,6,3,1,0,2,2,4
20110123-W-Australian_Open-R16-Francesca_Schiavone-Svetlana_Kuznetsova,2,S-IO,1,0,0,0,0,1,0
20070621-W-Eastbourne-R16-Agnieszka_Radwanska-Justine_Henin,1,F-XC,22,5,3,0,2,10,12
20070621-W-Eastbourne-R16-Agnieszka_Radwanska-Justine_Henin,1,F-DTM,14,1,0,0,1,4,10
20070621-W-Eastbourne-R16-Agnieszka_Radwanska-Justine_Henin,1,F-DTL,9,1,0,0,1,4,5
20070621-W-Eastbourne-R16-Agnieszka_Radwanska-Justine_Henin,1,F-IO,14,4,0,2,2,7,7
20070621-W-Eastbourne-R16-Agnieszka_Radwanska-Justine_Henin,1,B-XC,15,0,0,0,0,5,10
20070621-W-Eastbourne-R16-Agnieszka_Radwanska-Justine_Henin,1,B-DTM,23,4,0,0,4,6,17
20070621-W-Eastbourne-R16-Agnieszka_Radwanska-Justine_Henin,1,B-DTL,5,2,0,1,1,2,3
20070621-W-Eastbourne-R16-Agnieszka_Radwanska-Justine_Henin,1,B-IO,6,3,0,1,2,2,4
20070621-W-Eastbourne-R16-Agnieszka_Radwanska-Justine_Henin,1,S-XC,1,0,0,0,0,0,1
20070621-W-Eastbourne-R16-Agnieszka_Radwanska-Justine_Henin,1,S-DTM,3,0,0,0,0,0,3
20070621-W-Eastbourne-R16-Agnieszka_Radwanska-Justine_Henin,1,S-DTL,2,0,0,0,0,1,1
20070621-W-Eastbourne-R16-Agnieszka_Radwanska-Justine_Henin,1,S-IO,3,1,1,0,0,1,2
20070621-W-Eastbourne-R16-Agnieszka_Radwanska-Justine_Henin,2,F-XC,28,9,5,1,3,17,11
20070621-W-Eastbourne-R16-Agnieszka_Radwanska-Justine_Henin,2,F-DTM,13,0,0,0,0,9,4
20070621-W-Eastbourne-R16-Agnieszka_Radwanska-Justine_Henin,2,F-DTL,9,3,0,0,3,5,4
20070621-W-Eastbourne-R16-Agnieszka_Radwanska-Justine_Henin,2,F-IO,10,4,2,1,1,8,2
20070621-W-Eastbourne-R16-Agnieszka_Radwanska-Justine_Henin,2,F-II,1,0,0,0,0,1,0
20070621-W-Eastbourne-R16-Agnieszka_Radwanska-Justine_Henin,2,B-XC,14,5,2,1,2,11,3
20070621-W-Eastbourne-R16-Agnieszka_Radwanska-Justine_Henin,2,B-DTM,9,0,0,0,0,5,4
20070621-W-Eastbourne-R16-Agnieszka_Radwanska-Justine_Henin,2,B-DTL,6,4,0,0,4,2,4
20070621-W-Eastbourne-R16-Agnieszka_Radwanska-Justine_Henin,2,B-IO,5,2,1,0,1,2,3
20070621-W-Eastbourne-R16-Agnieszka_Radwanska-Justine_Henin,2,S-XC,5,1,1,0,0,2,3
20070621-W-Eastbourne-R16-Agnieszka_Radwanska-Justine_Henin,2,S-DTM,14,1,0,0,1,7,7
20070621-W-Eastbourne-R16-Agnieszka_Radwanska-Justine_Henin,2,S-DTL,1,0,0,0,0,1,0
20070623-W-Eastbourne-SF-Justine_Henin-Marion_Bartoli,1,F-XC,22,6,4,1,1,19,3
20070623-W-Eastbourne-SF-Justine_Henin-Marion_Bartoli,1,F-DTM,20,1,0,0,1,10,10
20070623-W-Eastbourne-SF-Justine_Henin-Marion_Bartoli,1,F-DTL,5,4,1,0,3,2,3
20070623-W-Eastbourne-SF-Justine_Henin-Marion_Bartoli,1,F-IO,4,4,1,3,0,4,0
20070623-W-Eastbourne-SF-Justine_Henin-Marion_Bartoli,1,F-II,1,1,1,0,0,1,0
20070623-W-Eastbourne-SF-Justine_Henin-Marion_Bartoli,1,B-XC,7,6,2,3,1,6,1
20070623-W-Eastbourne-SF-Justine_Henin-Marion_Bartoli,1,B-DTM,8,0,0,0,0,5,3
20070623-W-Eastbourne-SF-Justine_Henin-Marion_Bartoli,1,B-DTL,2,1,0,1,0,2,0
20070623-W-Eastbourne-SF-Justine_Henin-Marion_Bartoli,1,B-IO,3,2,2,0,0,3,0
20070623-W-Eastbourne-SF-Justine_Henin-Marion_Bartoli,1,S-XC,5,0,0,0,0,2,3
20070623-W-Eastbourne-SF-Justine_Henin-Marion_Bartoli,1,S-DTM,11,0,0,0,0,3,8
20070623-W-Eastbourne-SF-Justine_Henin-Marion_Bartoli,1,S-DTL,3,1,0,0,1,2,1
20070623-W-Eastbourne-SF-Justine_Henin-Marion_Bartoli,1,S-IO,3,0,0,0,0,1,2
20070623-W-Eastbourne-SF-Justine_Henin-Marion_Bartoli,2,F-XC,32,10,2,5,3,16,16
20070623-W-Eastbourne-SF-Justine_Henin-Marion_Bartoli,2,F-DTM,13,3,0,0,3,5,8
20070623-W-Eastbourne-SF-Justine_Henin-Marion_Bartoli,2,F-DTL,7,4,0,0,4,1,6
20070623-W-Eastbourne-SF-Justine_Henin-Marion_Bartoli,2,F-IO,12,1,1,0,0,7,5
20070623-W-Eastbourne-SF-Justine_Henin-Marion_Bartoli,2,B-XC,18,6,0,2,4,7,11
20070623-W-Eastbourne-SF-Justine_Henin-Marion_Bartoli,2,B-DTM,10,3,0,1,2,3,7
20070623-W-Eastbourne-SF-Justine_Henin-Marion_Bartoli,2,B-DTL,4,1,1,0,0,1,3
20070623-W-Eastbourne-SF-Justine_Henin-Marion_Bartoli,2,B-IO,2,1,0,0,1,0,2
20070623-W-Eastbourne-SF-Justine_Henin-Marion_Bartoli,2,S-DTM,1,0,0,0,0,0,1
20070506-W-Warsaw-F-Alona_Bondarenko-Justine_Henin,1,F-XC,33,5,0,2,3,10,23
20070506-W-Warsaw-F-Alona_Bondarenko-Justine_Henin,1,F-DTM,18,2,0,0,2,5,13
20070506-W-Warsaw-F-Alona_Bondarenko-Justine_Henin,1,F-DTL,7,4,1,1,2,3,4
20070506-W-Warsaw-F-Alona_Bondarenko-Justine_Henin,1,F-IO,8,1,1,0,0,4,4
20070506-W-Warsaw-F-Alona_Bondarenko-Justine_Henin,1,B-XC,40,5,0,1,4,17,23
20070506-W-Warsaw-F-Alona_Bondarenko-Justine_Henin,1,B-DTM,24,3,0,1,2,6,18
20070506-W-Warsaw-F-Alona_Bondarenko-Justine_Henin,1,B-DTL,6,0,0,0,0,2,4
20070506-W-Warsaw-F-Alona_Bondarenko-Justine_Henin,1,B-IO,9,4,1,0,3,3,6
20070506-W-Warsaw-F-Alona_Bondarenko-Justine_Henin,1,S-XC,1,0,0,0,0,0,1
20070506-W-Warsaw-F-Alona_Bondarenko-Justine_Henin,1,S-DTM,2,0,0,0,0,0,2
20070506-W-Warsaw-F-Alona_Bondarenko-Justine_Henin,1,S-DTL,1,0,0,0,0,0,1
20070506-W-Warsaw-F-Alona_Bondarenko-Justine_Henin,2,F-XC,35,7,3,2,2,26,9
20070506-W-Warsaw-F-Alona_Bondarenko-Justine_Henin,2,F-DTM,16,0,0,0,0,11,5
20070506-W-Warsaw-F-Alona_Bondarenko-Justine_Henin,2,F-DTL,16,5,2,1,2,12,4
20070506-W-Warsaw-F-Alona_Bondarenko-Justine_Henin,2,F-IO,19,8,5,1,2,15,4
20070506-W-Warsaw-F-Alona_Bondarenko-Justine_Henin,2,B-XC,24,8,1,2,5,12,12
20070506-W-Warsaw-F-Alona_Bondarenko-Justine_Henin,2,B-DTM,11,1,1,0,0,7,4
20070506-W-Warsaw-F-Alona_Bondarenko-Justine_Henin,2,B-DTL,7,2,0,1,1,4,3
20070506-W-Warsaw-F-Alona_Bondarenko-Justine_Henin,2,B-IO,6,2,1,0,1,4,2
20070506-W-Warsaw-F-Alona_Bondarenko-Justine_Henin,2,S-XC,6,0,0,0,0,3,3
20070506-W-Warsaw-F-Alona_Bondarenko-Justine_Henin,2,S-DTM,8,0,0,0,0,6,2
20070506-W-Warsaw-F-Alona_Bondarenko-Justine_Henin,2,S-DTL,2,0,0,0,0,1,1
20150513-W-Rome_Masters-R32-Ana_Ivanovic-Daria_Gavrilova,1,F-XC,75,28,10,4,14,39,36
20150513-W-Rome_Masters-R32-Ana_Ivanovic-Daria_Gavrilova,1,F-DTM,27,3,0,1,2,13,14
20150513-W-Rome_Masters-R32-Ana_Ivanovic-Daria_Gavrilova,1,F-DTL,31,16,5,2,9,16,15
20150513-W-Rome_Masters-R32-Ana_Ivanovic-Daria_Gavrilova,1,F-IO,47,21,16,2,3,36,11
20150513-W-Rome_Masters-R32-Ana_Ivanovic-Daria_Gavrilova,1,F-II,13,6,1,2,3,7,6
20150513-W-Rome_Masters-R32-Ana_Ivanovic-Daria_Gavrilova,1,B-XC,57,8,0,3,5,29,28
20150513-W-Rome_Masters-R32-Ana_Ivanovic-Daria_Gavrilova,1,B-DTM,19,4,0,1,3,7,12
20150513-W-Rome_Masters-R32-Ana_Ivanovic-Daria_Gavrilova,1,B-DTL,13,3,0,2,1,7,6
20150513-W-Rome_Masters-R32-Ana_Ivanovic-Daria_Gavrilova,1,B-IO,2,0,0,0,0,0,2
20150513-W-Rome_Masters-R32-Ana_Ivanovic-Daria_Gavrilova,1,S-XC,8,1,0,0,1,4,4
20150513-W-Rome_Masters-R32-Ana_Ivanovic-Daria_Gavrilova,1,S-DTM,7,0,0,0,0,1,6
20150513-W-Rome_Masters-R32-Ana_Ivanovic-Daria_Gavrilova,1,S-DTL,6,2,0,0,2,1,5
20150513-W-Rome_Masters-R32-Ana_Ivanovic-Daria_Gavrilova,2,F-XC,57,15,7,5,3,40,17
20150513-W-Rome_Masters-R32-Ana_Ivanovic-Daria_Gavrilova,2,F-DTM,29,6,0,4,2,15,14
20150513-W-Rome_Masters-R32-Ana_Ivanovic-Daria_Gavrilova,2,F-DTL,16,2,0,0,2,6,10
20150513-W-Rome_Masters-R32-Ana_Ivanovic-Daria_Gavrilova,2,F-IO,33,8,4,2,2,24,9
20150513-W-Rome_Masters-R32-Ana_Ivanovic-Daria_Gavrilova,2,F-II,8,5,1,2,2,6,2
20150513-W-Rome_Masters-R32-Ana_Ivanovic-Daria_Gavrilova,2,B-XC,57,6,2,0,4,27,30
20150513-W-Rome_Masters-R32-Ana_Ivanovic-Daria_Gavrilova,2,B-DTM,24,2,0,0,2,7,17
20150513-W-Rome_Masters-R32-Ana_Ivanovic-Daria_Gavrilova,2,B-DTL,9,6,3,1,2,7,2
20150513-W-Rome_Masters-R32-Ana_Ivanovic-Daria_Gavrilova,2,B-IO,4,1,0,0,1,1,3
20150513-W-Rome_Masters-R32-Ana_Ivanovic-Daria_Gavrilova,2,S-XC,9,0,0,0,0,4,5
20150513-W-Rome_Masters-R32-Ana_Ivanovic-Daria_Gavrilova,2,S-DTM,22,0,0,0,0,8,14
20150513-W-Rome_Masters-R32-Ana_Ivanovic-Daria_Gavrilova,2,S-DTL,1,0,0,0,0,1,0
20150513-W-Rome_Masters-R32-Ana_Ivanovic-Daria_Gavrilova,2,S-IO,1,0,0,0,0,0,1
20151027-W-Singapore-RR-Flavia_Pennetta-Agnieszka_Radwanska,1,F-XC,39,5,2,1,2,23,16
20151027-W-Singapore-RR-Flavia_Pennetta-Agnieszka_Radwanska,1,F-DTM,22,3,0,1,2,10,12
20151027-W-Singapore-RR-Flavia_Pennetta-Agnieszka_Radwanska,1,F-DTL,16,4,2,0,2,11,5
20151027-W-Singapore-RR-Flavia_Pennetta-Agnieszka_Radwanska,1,F-IO,9,2,2,0,0,7,2
20151027-W-Singapore-RR-Flavia_Pennetta-Agnieszka_Radwanska,1,F-II,3,0,0,0,0,3,0
20151027-W-Singapore-RR-Flavia_Pennetta-Agnieszka_Radwanska,1,B-XC,42,6,0,1,5,22,20
20151027-W-Singapore-RR-Flavia_Pennetta-Agnieszka_Radwanska,1,B-DTM,21,2,0,0,2,11,10
20151027-W-Singapore-RR-Flavia_Pennetta-Agnieszka_Radwanska,1,B-DTL,19,12,10,0,2,13,6
20151027-W-Singapore-RR-Flavia_Pennetta-Agnieszka_Radwanska,1,B-IO,1,0,0,0,0,1,0
20151027-W-Singapore-RR-Flavia_Pennetta-Agnieszka_Radwanska,1,S-XC,2,1,0,1,0,1,1
20151027-W-Singapore-RR-Flavia_Pennetta-Agnieszka_Radwanska,1,S-DTM,4,0,0,0,0,3,1
20151027-W-Singapore-RR-Flavia_Pennetta-Agnieszka_Radwanska,1,S-DTL,2,0,0,0,0,1,1
20151027-W-Singapore-RR-Flavia_Pennetta-Agnieszka_Radwanska,2,F-XC,48,13,7,4,2,26,22
20151027-W-Singapore-RR-Flavia_Pennetta-Agnieszka_Radwanska,2,F-DTM,14,2,0,1,1,3,11
20151027-W-Singapore-RR-Flavia_Pennetta-Agnieszka_Radwanska,2,F-DTL,13,6,0,0,6,2,11
20151027-W-Singapore-RR-Flavia_Pennetta-Agnieszka_Radwanska,2,F-IO,14,7,3,3,1,9,5
20151027-W-Singapore-RR-Flavia_Pennetta-Agnieszka_Radwanska,2,B-XC,42,2,1,0,1,18,24
20151027-W-Singapore-RR-Flavia_Pennetta-Agnieszka_Radwanska,2,B-DTM,21,1,0,0,1,11,10
20151027-W-Singapore-RR-Flavia_Pennetta-Agnieszka_Radwanska,2,B-DTL,12,4,1,2,1,9,3
20151027-W-Singapore-RR-Flavia_Pennetta-Agnieszka_Radwanska,2,B-IO,5,2,1,0,1,1,4
20151027-W-Singapore-RR-Flavia_Pennetta-Agnieszka_Radwanska,2,S-XC,7,2,1,1,0,4,3
20151027-W-Singapore-RR-Flavia_Pennetta-Agnieszka_Radwanska,2,S-DTM,3,0,0,0,0,0,3
20151027-W-Singapore-RR-Flavia_Pennetta-Agnieszka_Radwanska,2,S-DTL,1,0,0,0,0,0,1
20151027-W-Singapore-RR-Flavia_Pennetta-Agnieszka_Radwanska,2,S-IO,2,0,0,0,0,0,2
20150516-W-Rome-SF-Maria_Sharapova-Daria_Gavrilova,1,F-XC,59,13,5,3,5,38,21
20150516-W-Rome-SF-Maria_Sharapova-Daria_Gavrilova,1,F-DTM,18,0,0,0,0,6,12
20150516-W-Rome-SF-Maria_Sharapova-Daria_Gavrilova,1,F-DTL,12,6,3,1,2,8,4
20150516-W-Rome-SF-Maria_Sharapova-Daria_Gavrilova,1,F-IO,22,8,1,1,6,13,9
20150516-W-Rome-SF-Maria_Sharapova-Daria_Gavrilova,1,F-II,1,0,0,0,0,1,0
20150516-W-Rome-SF-Maria_Sharapova-Daria_Gavrilova,1,B-XC,46,6,2,2,2,31,15
20150516-W-Rome-SF-Maria_Sharapova-Daria_Gavrilova,1,B-DTM,21,0,0,0,0,8,13
20150516-W-Rome-SF-Maria_Sharapova-Daria_Gavrilova,1,B-DTL,7,3,1,1,1,4,3
20150516-W-Rome-SF-Maria_Sharapova-Daria_Gavrilova,1,B-IO,3,2,1,0,1,2,1
20150516-W-Rome-SF-Maria_Sharapova-Daria_Gavrilova,1,S-DTM,3,0,0,0,0,1,2
20150516-W-Rome-SF-Maria_Sharapova-Daria_Gavrilova,1,S-DTL,1,0,0,0,0,0,1
20150516-W-Rome-SF-Maria_Sharapova-Daria_Gavrilova,1,S-IO,1,1,0,1,0,1,0
20150516-W-Rome-SF-Maria_Sharapova-Daria_Gavrilova,2,F-XC,37,7,2,3,2,21,16
20150516-W-Rome-SF-Maria_Sharapova-Daria_Gavrilova,2,F-DTM,20,0,0,0,0,8,12
20150516-W-Rome-SF-Maria_Sharapova-Daria_Gavrilova,2,F-DTL,22,7,0,3,4,9,13
20150516-W-Rome-SF-Maria_Sharapova-Daria_Gavrilova,2,F-IO,15,4,3,0,1,10,5
20150516-W-Rome-SF-Maria_Sharapova-Daria_Gavrilova,2,F-II,1,0,0,0,0,1,0
20150516-W-Rome-SF-Maria_Sharapova-Daria_Gavrilova,2,B-XC,26,2,0,0,2,12,14
20150516-W-Rome-SF-Maria_Sharapova-Daria_Gavrilova,2,B-DTM,28,2,0,1,1,15,13
20150516-W-Rome-SF-Maria_Sharapova-Daria_Gavrilova,2,B-DTL,7,3,1,0,2,2,5
20150516-W-Rome-SF-Maria_Sharapova-Daria_Gavrilova,2,B-IO,9,4,1,1,2,6,3
20150516-W-Rome-SF-Maria_Sharapova-Daria_Gavrilova,2,S-XC,2,0,0,0,0,0,2
20150516-W-Rome-SF-Maria_Sharapova-Daria_Gavrilova,2,S-DTM,19,0,0,0,0,5,14
20150516-W-Rome-SF-Maria_Sharapova-Daria_Gavrilova,2,S-DTL,4,0,0,0,0,0,4
20150516-W-Rome-SF-Maria_Sharapova-Daria_Gavrilova,2,S-IO,1,0,0,0,0,0,1
19890416-W-Amelia_Island-SF-Steffi_Graf-Arantxa_Sanchez_Vicario,1,F-XC,52,13,3,3,7,28,24
19890416-W-Amelia_Island-SF-Steffi_Graf-Arantxa_Sanchez_Vicario,1,F-DTM,10,0,0,0,0,5,5
19890416-W-Amelia_Island-SF-Steffi_Graf-Arantxa_Sanchez_Vicario,1,F-DTL,5,2,1,0,1,4,1
19890416-W-Amelia_Island-SF-Steffi_Graf-Arantxa_Sanchez_Vicario,1,F-IO,43,11,3,4,4,28,15
19890416-W-Amelia_Island-SF-Steffi_Graf-Arantxa_Sanchez_Vicario,1,F-II,9,4,0,1,3,4,5
19890416-W-Amelia_Island-SF-Steffi_Graf-Arantxa_Sanchez_Vicario,1,B-XC,3,2,1,0,1,2,1
19890416-W-Amelia_Island-SF-Steffi_Graf-Arantxa_Sanchez_Vicario,1,B-DTM,1,0,0,0,0,1,0
19890416-W-Amelia_Island-SF-Steffi_Graf-Arantxa_Sanchez_Vicario,1,S-XC,49,7,0,3,4,20,29
19890416-W-Amelia_Island-SF-Steffi_Graf-Arantxa_Sanchez_Vicario,1,S-DTM,13,2,0,0,2,7,6
19890416-W-Amelia_Island-SF-Steffi_Graf-Arantxa_Sanchez_Vicario,1,S-DTL,26,2,0,0,2,14,12
19890416-W-Amelia_Island-SF-Steffi_Graf-Arantxa_Sanchez_Vicario,1,S-IO,2,0,0,0,0,1,1
19890416-W-Amelia_Island-SF-Steffi_Graf-Arantxa_Sanchez_Vicario,2,F-XC,35,8,3,1,4,15,20
19890416-W-Amelia_Island-SF-Steffi_Graf-Arantxa_Sanchez_Vicario,2,F-DTM,31,4,0,0,4,11,20
19890416-W-Amelia_Island-SF-Steffi_Graf-Arantxa_Sanchez_Vicario,2,F-DTL,20,3,0,0,3,12,8
19890416-W-Amelia_Island-SF-Steffi_Graf-Arantxa_Sanchez_Vicario,2,F-IO,9,0,0,0,0,4,5
19890416-W-Amelia_Island-SF-Steffi_Graf-Arantxa_Sanchez_Vicario,2,F-II,1,1,1,0,0,1,0
19890416-W-Amelia_Island-SF-Steffi_Graf-Arantxa_Sanchez_Vicario,2,B-XC,52,7,0,1,6,22,30
19890416-W-Amelia_Island-SF-Steffi_Graf-Arantxa_Sanchez_Vicario,2,B-DTM,12,0,0,0,0,4,8
19890416-W-Amelia_Island-SF-Steffi_Graf-Arantxa_Sanchez_Vicario,2,B-DTL,4,3,0,0,3,0,4
19890416-W-Amelia_Island-SF-Steffi_Graf-Arantxa_Sanchez_Vicario,2,S-XC,21,1,0,0,1,12,9
19890416-W-Amelia_Island-SF-Steffi_Graf-Arantxa_Sanchez_Vicario,2,S-DTM,6,0,0,0,0,2,4
19890416-W-Amelia_Island-SF-Steffi_Graf-Arantxa_Sanchez_Vicario,2,S-DTL,8,0,0,0,0,4,4
20131020-W-Luxembourg-F-Caroline_Wozniacki-Annika_Beck,1,F-XC,32,4,0,0,4,18,14
20131020-W-Luxembourg-F-Caroline_Wozniacki-Annika_Beck,1,F-DTM,18,2,1,0,1,12,6
20131020-W-Luxembourg-F-Caroline_Wozniacki-Annika_Beck,1,F-DTL,21,6,2,0,4,15,6
20131020-W-Luxembourg-F-Caroline_Wozniacki-Annika_Beck,1,F-IO,21,1,0,1,0,15,6
20131020-W-Luxembourg-F-Caroline_Wozniacki-Annika_Beck,1,F-II,1,1,0,1,0,1,0
20131020-W-Luxembourg-F-Caroline_Wozniacki-Annika_Beck,1,B-XC,79,8,1,1,6,39,40
20131020-W-Luxembourg-F-Caroline_Wozniacki-Annika_Beck,1,B-DTM,26,1,0,0,1,15,11
20131020-W-Luxembourg-F-Caroline_Wozniacki-Annika_Beck,1,B-DTL,20,3,1,1,1,13,7
20131020-W-Luxembourg-F-Caroline_Wozniacki-Annika_Beck,1,B-IO,14,5,1,2,2,10,4
20131020-W-Luxembourg-F-Caroline_Wozniacki-Annika_Beck,1,S-XC,5,1,0,0,1,2,3
20131020-W-Luxembourg-F-Caroline_Wozniacki-Annika_Beck,1,S-DTM,5,0,0,0,0,3,2
20131020-W-Luxembourg-F-Caroline_Wozniacki-Annika_Beck,1,S-DTL,1,0,0,0,0,1,0
20131020-W-Luxembourg-F-Caroline_Wozniacki-Annika_Beck,2,F-XC,44,12,2,1,9,13,31
20131020-W-Luxembourg-F-Caroline_Wozniacki-Annika_Beck,2,F-DTM,14,0,0,0,0,4,10
20131020-W-Luxembourg-F-Caroline_Wozniacki-Annika_Beck,2,F-DTL,26,5,1,0,4,11,15
20131020-W-Luxembourg-F-Caroline_Wozniacki-Annika_Beck,2,F-IO,27,2,0,1,1,12,15
20131020-W-Luxembourg-F-Caroline_Wozniacki-Annika_Beck,2,F-II,4,1,0,0,1,1,3
20131020-W-Luxembourg-F-Caroline_Wozniacki-Annika_Beck,2,B-XC,64,7,0,1,6,24,40
20131020-W-Luxembourg-F-Caroline_Wozniacki-Annika_Beck,2,B-DTM,41,2,0,1,1,16,25
20131020-W-Luxembourg-F-Caroline_Wozniacki-Annika_Beck,2,B-DTL,20,8,1,1,6,9,11
20131020-W-Luxembourg-F-Caroline_Wozniacki-Annika_Beck,2,B-IO,3,0,0,0,0,2,1
20131020-W-Luxembourg-F-Caroline_Wozniacki-Annika_Beck,2,S-XC,1,0,0,0,0,1,0
20131020-W-Luxembourg-F-Caroline_Wozniacki-Annika_Beck,2,S-DTM,1,0,0,0,0,1,0
20150902-W-US_Open-R64-Serena_Williams-Kiki_Bertens,1,F-XC,34,10,2,6,2,24,10
20150902-W-US_Open-R64-Serena_Williams-Kiki_Bertens,1,F-DTM,12,1,0,0,1,9,3
20150902-W-US_Open-R64-Serena_Williams-Kiki_Bertens,1,F-DTL,7,1,0,0,1,4,3
20150902-W-US_Open-R64-Serena_Williams-Kiki_Bertens,1,F-IO,15,1,1,0,0,13,2
20150902-W-US_Open-R64-Serena_Williams-Kiki_Bertens,1,B-XC,29,8,1,2,5,14,15
20150902-W-US_Open-R64-Serena_Williams-Kiki_Bertens,1,B-DTM,13,0,0,0,0,7,6
20150902-W-US_Open-R64-Serena_Williams-Kiki_Bertens,1,B-DTL,6,4,1,1,2,4,2
20150902-W-US_Open-R64-Serena_Williams-Kiki_Bertens,1,B-IO,5,1,0,0,1,1,4
20150902-W-US_Open-R64-Serena_Williams-Kiki_Bertens,2,F-XC,34,15,4,1,10,10,24
20150902-W-US_Open-R64-Serena_Williams-Kiki_Bertens,2,F-DTM,13,1,0,0,1,5,8
20150902-W-US_Open-R64-Serena_Williams-Kiki_Bertens,2,F-DTL,11,8,3,0,5,4,7
20150902-W-US_Open-R64-Serena_Williams-Kiki_Bertens,2,F-IO,14,9,3,1,5,5,9
20150902-W-US_Open-R64-Serena_Williams-Kiki_Bertens,2,B-XC,19,7,0,1,6,9,10
20150902-W-US_Open-R64-Serena_Williams-Kiki_Bertens,2,B-DTM,22,3,0,0,3,8,14
20150902-W-US_Open-R64-Serena_Williams-Kiki_Bertens,2,B-DTL,6,3,1,1,1,3,3
20150902-W-US_Open-R64-Serena_Williams-Kiki_Bertens,2,B-IO,3,1,1,0,0,2,1
20150902-W-US_Open-R64-Serena_Williams-Kiki_Bertens,2,S-XC,5,1,0,0,1,1,4
20150902-W-US_Open-R64-Serena_Williams-Kiki_Bertens,2,S-DTM,7,0,0,0,0,3,4
20150902-W-US_Open-R64-Serena_Williams-Kiki_Bertens,2,S-DTL,1,0,0,0,0,1,0
20140222-W-Dubai-SF-Serena_Williams-Alize_Cornet,1,F-XC,41,7,1,0,6,17,24
20140222-W-Dubai-SF-Serena_Williams-Alize_Cornet,1,F-DTM,11,2,0,0,2,7,4
20140222-W-Dubai-SF-Serena_Williams-Alize_Cornet,1,F-DTL,7,1,1,0,0,6,1
20140222-W-Dubai-SF-Serena_Williams-Alize_Cornet,1,F-IO,9,5,2,2,1,5,4
20140222-W-Dubai-SF-Serena_Williams-Alize_Cornet,1,B-XC,45,15,2,4,9,17,28
20140222-W-Dubai-SF-Serena_Williams-Alize_Cornet,1,B-DTM,17,3,0,0,3,5,12
20140222-W-Dubai-SF-Serena_Williams-Alize_Cornet,1,B-DTL,11,3,1,0,2,6,5
20140222-W-Dubai-SF-Serena_Williams-Alize_Cornet,1,B-IO,20,6,0,2,4,7,13
20140222-W-Dubai-SF-Serena_Williams-Alize_Cornet,1,S-XC,1,0,0,0,0,1,0
20140222-W-Dubai-SF-Serena_Williams-Alize_Cornet,1,S-DTM,1,0,0,0,0,0,1
20140222-W-Dubai-SF-Serena_Williams-Alize_Cornet,1,S-DTL,1,0,0,0,0,1,0
20140222-W-Dubai-SF-Serena_Williams-Alize_Cornet,2,F-XC,25,3,2,0,1,13,12
20140222-W-Dubai-SF-Serena_Williams-Alize_Cornet,2,F-DTM,32,3,0,0,3,15,17
20140222-W-Dubai-SF-Serena_Williams-Alize_Cornet,2,F-DTL,25,4,2,1,1,15,10
20140222-W-Dubai-SF-Serena_Williams-Alize_Cornet,2,F-IO,10,2,0,0,2,6,4
20140222-W-Dubai-SF-Serena_Williams-Alize_Cornet,2,B-XC,15,4,1,1,2,8,7
20140222-W-Dubai-SF-Serena_Williams-Alize_Cornet,2,B-DTM,27,1,0,1,0,21,6
20140222-W-Dubai-SF-Serena_Williams-Alize_Cornet,2,B-DTL,8,3,2,0,1,5,3
20140222-W-Dubai-SF-Serena_Williams-Alize_Cornet,2,B-IO,1,0,0,0,0,1,0
20140222-W-Dubai-SF-Serena_Williams-Alize_Cornet,2,S-XC,2,0,0,0,0,0,2
20140222-W-Dubai-SF-Serena_Williams-Alize_Cornet,2,S-DTM,3,0,0,0,0,2,1
20150527-W-Roland_Garros-R64-Camila_Giorgi-Garbine_Muguruza,1,F-XC,34,18,4,4,10,18,16
20150527-W-Roland_Garros-R64-Camila_Giorgi-Garbine_Muguruza,1,F-DTM,19,3,0,1,2,9,10
20150527-W-Roland_Garros-R64-Camila_Giorgi-Garbine_Muguruza,1,F-DTL,3,1,0,0,1,0,3
20150527-W-Roland_Garros-R64-Camila_Giorgi-Garbine_Muguruza,1,F-IO,4,3,1,0,2,2,2
20150527-W-Roland_Garros-R64-Camila_Giorgi-Garbine_Muguruza,1,B-XC,26,11,4,0,7,12,14
20150527-W-Roland_Garros-R64-Camila_Giorgi-Garbine_Muguruza,1,B-DTM,12,2,0,1,1,5,7
20150527-W-Roland_Garros-R64-Camila_Giorgi-Garbine_Muguruza,1,B-DTL,6,1,0,0,1,4,2
20150527-W-Roland_Garros-R64-Camila_Giorgi-Garbine_Muguruza,1,B-IO,7,1,0,1,0,5,2
20150527-W-Roland_Garros-R64-Camila_Giorgi-Garbine_Muguruza,1,S-DTM,1,0,0,0,0,1,0
20150527-W-Roland_Garros-R64-Camila_Giorgi-Garbine_Muguruza,2,F-XC,19,5,1,1,3,7,12
20150527-W-Roland_Garros-R64-Camila_Giorgi-Garbine_Muguruza,2,F-DTM,10,0,0,0,0,6,4
20150527-W-Roland_Garros-R64-Camila_Giorgi-Garbine_Muguruza,2,F-DTL,8,2,2,0,0,4,4
20150527-W-Roland_Garros-R64-Camila_Giorgi-Garbine_Muguruza,2,F-IO,3,1,0,0,1,1,2
20150527-W-Roland_Garros-R64-Camila_Giorgi-Garbine_Muguruza,2,B-XC,12,2,0,0,2,5,7
20150527-W-Roland_Garros-R64-Camila_Giorgi-Garbine_Muguruza,2,B-DTM,24,3,0,2,1,13,11
20150527-W-Roland_Garros-R64-Camila_Giorgi-Garbine_Muguruza,2,B-DTL,7,3,2,0,1,4,3
20150527-W-Roland_Garros-R64-Camila_Giorgi-Garbine_Muguruza,2,B-IO,5,4,0,0,4,0,5
20150109-W-Auckland-QF-Julia_Goerges-Caroline_Wozniacki,1,F-XC,42,18,3,4,11,16,26
20150109-W-Auckland-QF-Julia_Goerges-Caroline_Wozniacki,1,F-DTM,12,1,0,0,1,3,9
20150109-W-Auckland-QF-Julia_Goerges-Caroline_Wozniacki,1,F-DTL,4,4,2,0,2,2,2
20150109-W-Auckland-QF-Julia_Goerges-Caroline_Wozniacki,1,F-IO,30,18,5,4,9,16,14
20150109-W-Auckland-QF-Julia_Goerges-Caroline_Wozniacki,1,F-II,5,2,1,0,1,1,4
20150109-W-Auckland-QF-Julia_Goerges-Caroline_Wozniacki,1,B-XC,17,4,0,0,4,4,13
20150109-W-Auckland-QF-Julia_Goerges-Caroline_Wozniacki,1,B-DTM,14,1,0,0,1,6,8
20150109-W-Auckland-QF-Julia_Goerges-Caroline_Wozniacki,1,B-DTL,18,8,2,0,6,9,9
20150109-W-Auckland-QF-Julia_Goerges-Caroline_Wozniacki,1,B-IO,1,0,0,0,0,0,1
20150109-W-Auckland-QF-Julia_Goerges-Caroline_Wozniacki,1,S-DTM,1,0,0,0,0,0,1
20150109-W-Auckland-QF-Julia_Goerges-Caroline_Wozniacki,2,F-XC,24,5,1,3,1,17,7
20150109-W-Auckland-QF-Julia_Goerges-Caroline_Wozniacki,2,F-DTM,18,2,0,0,2,9,9
20150109-W-Auckland-QF-Julia_Goerges-Caroline_Wozniacki,2,F-DTL,13,1,0,0,1,8,5
20150109-W-Auckland-QF-Julia_Goerges-Caroline_Wozniacki,2,F-IO,10,2,0,0,2,6,4
20150109-W-Auckland-QF-Julia_Goerges-Caroline_Wozniacki,2,B-XC,19,1,1,0,0,12,7
20150109-W-Auckland-QF-Julia_Goerges-Caroline_Wozniacki,2,B-DTM,15,0,0,0,0,8,7
20150109-W-Auckland-QF-Julia_Goerges-Caroline_Wozniacki,2,B-DTL,7,1,0,0,1,5,2
20150109-W-Auckland-QF-Julia_Goerges-Caroline_Wozniacki,2,B-IO,9,5,1,2,2,5,4
20150109-W-Auckland-QF-Julia_Goerges-Caroline_Wozniacki,2,S-DTL,1,1,0,1,0,1,0
20150109-W-Auckland-QF-Julia_Goerges-Caroline_Wozniacki,2,S-II,1,0,0,0,0,1,0
20131019-W-Luxembourg-SF-Sabine_Lisicki-Caroline_Wozniacki,1,F-XC,24,8,3,1,4,13,11
20131019-W-Luxembourg-SF-Sabine_Lisicki-Caroline_Wozniacki,1,F-DTM,1,0,0,0,0,0,1
20131019-W-Luxembourg-SF-Sabine_Lisicki-Caroline_Wozniacki,1,F-DTL,11,2,2,0,0,6,5
20131019-W-Luxembourg-SF-Sabine_Lisicki-Caroline_Wozniacki,1,F-IO,15,3,1,1,1,5,10
20131019-W-Luxembourg-SF-Sabine_Lisicki-Caroline_Wozniacki,1,F-II,1,1,0,0,1,0,1
20131019-W-Luxembourg-SF-Sabine_Lisicki-Caroline_Wozniacki,1,B-XC,25,7,1,0,5,15,10
20131019-W-Luxembourg-SF-Sabine_Lisicki-Caroline_Wozniacki,1,B-DTM,7,0,0,0,0,3,4
20131019-W-Luxembourg-SF-Sabine_Lisicki-Caroline_Wozniacki,1,B-DTL,11,6,1,0,5,3,8
20131019-W-Luxembourg-SF-Sabine_Lisicki-Caroline_Wozniacki,1,B-IO,6,1,1,0,0,1,5
20131019-W-Luxembourg-SF-Sabine_Lisicki-Caroline_Wozniacki,1,S-XC,1,1,0,0,1,0,1
20131019-W-Luxembourg-SF-Sabine_Lisicki-Caroline_Wozniacki,1,S-DTM,2,0,0,0,0,0,2
20131019-W-Luxembourg-SF-Sabine_Lisicki-Caroline_Wozniacki,1,S-DTL,1,0,0,0,0,0,1
20131019-W-Luxembourg-SF-Sabine_Lisicki-Caroline_Wozniacki,2,F-XC,20,4,1,1,2,10,10
20131019-W-Luxembourg-SF-Sabine_Lisicki-Caroline_Wozniacki,2,F-DTM,7,0,0,0,0,5,2
20131019-W-Luxembourg-SF-Sabine_Lisicki-Caroline_Wozniacki,2,F-DTL,18,3,1,1,1,11,7
20131019-W-Luxembourg-SF-Sabine_Lisicki-Caroline_Wozniacki,2,F-IO,4,0,0,0,0,2,2
20131019-W-Luxembourg-SF-Sabine_Lisicki-Caroline_Wozniacki,2,B-XC,29,5,0,3,2,17,12
20131019-W-Luxembourg-SF-Sabine_Lisicki-Caroline_Wozniacki,2,B-DTM,13,0,0,0,0,5,8
20131019-W-Luxembourg-SF-Sabine_Lisicki-Caroline_Wozniacki,2,B-DTL,4,2,1,0,1,1,3
20131019-W-Luxembourg-SF-Sabine_Lisicki-Caroline_Wozniacki,2,B-IO,5,1,0,0,1,4,1
20131019-W-Luxembourg-SF-Sabine_Lisicki-Caroline_Wozniacki,2,S-XC,4,1,0,1,0,4,0
20131019-W-Luxembourg-SF-Sabine_Lisicki-Caroline_Wozniacki,2,S-DTM,4,0,0,0,0,1,3
20150925-W-Tokyo-QF-Belinda_Bencic-Garbine_Muguruza,1,F-XC,40,6,3,0,3,24,16
20150925-W-Tokyo-QF-Belinda_Bencic-Garbine_Muguruza,1,F-DTM,18,0,0,0,0,9,9
20150925-W-Tokyo-QF-Belinda_Bencic-Garbine_Muguruza,1,F-DTL,9,3,1,1,1,8,1
20150925-W-Tokyo-QF-Belinda_Bencic-Garbine_Muguruza,1,F-IO,12,6,3,1,2,10,2
20150925-W-Tokyo-QF-Belinda_Bencic-Garbine_Muguruza,1,B-XC,31,5,2,1,2,15,16
20150925-W-Tokyo-QF-Belinda_Bencic-Garbine_Muguruza,1,B-DTM,19,0,0,0,0,13,6
20150925-W-Tokyo-QF-Belinda_Bencic-Garbine_Muguruza,1,B-DTL,14,3,0,1,2,8,6
20150925-W-Tokyo-QF-Belinda_Bencic-Garbine_Muguruza,1,B-IO,13,3,0,1,2,8,5
20150925-W-Tokyo-QF-Belinda_Bencic-Garbine_Muguruza,1,S-XC,1,0,0,0,0,0,1
20150925-W-Tokyo-QF-Belinda_Bencic-Garbine_Muguruza,2,F-XC,49,17,4,1,12,16,33
20150925-W-Tokyo-QF-Belinda_Bencic-Garbine_Muguruza,2,F-DTM,16,0,0,0,0,7,9
20150925-W-Tokyo-QF-Belinda_Bencic-Garbine_Muguruza,2,F-DTL,21,14,4,3,7,12,9
20150925-W-Tokyo-QF-Belinda_Bencic-Garbine_Muguruza,2,F-IO,10,4,1,0,3,2,8
20150925-W-Tokyo-QF-Belinda_Bencic-Garbine_Muguruza,2,B-XC,43,10,3,1,6,22,21
20150925-W-Tokyo-QF-Belinda_Bencic-Garbine_Muguruza,2,B-DTM,20,3,1,0,2,6,14
20150925-W-Tokyo-QF-Belinda_Bencic-Garbine_Muguruza,2,B-DTL,13,6,3,0,3,7,6
20150925-W-Tokyo-QF-Belinda_Bencic-Garbine_Muguruza,2,B-IO,11,4,2,0,2,5,6
20150925-W-Tokyo-QF-Belinda_Bencic-Garbine_Muguruza,2,S-XC,1,1,0,0,1,0,1
20151006-W-Beijing-R32-Mariana_Duque_Marino-Timea_Bacsinszky,1,F-XC,32,13,3,1,9,11,21
20151006-W-Beijing-R32-Mariana_Duque_Marino-Timea_Bacsinszky,1,F-DTM,26,1,0,0,1,10,16
20151006-W-Beijing-R32-Mariana_Duque_Marino-Timea_Bacsinszky,1,F-DTL,16,8,0,0,8,4,12
20151006-W-Beijing-R32-Mariana_Duque_Marino-Timea_Bacsinszky,1,F-IO,10,3,2,1,0,5,5
20151006-W-Beijing-R32-Mariana_Duque_Marino-Timea_Bacsinszky,1,F-II,2,1,0,1,0,1,1
20151006-W-Beijing-R32-Mariana_Duque_Marino-Timea_Bacsinszky,1,B-XC,10,0,0,0,0,6,4
20151006-W-Beijing-R32-Mariana_Duque_Marino-Timea_Bacsinszky,1,B-DTM,17,6,0,0,6,6,11
20151006-W-Beijing-R32-Mariana_Duque_Marino-Timea_Bacsinszky,1,B-DTL,11,3,1,0,2,6,5
20151006-W-Beijing-R32-Mariana_Duque_Marino-Timea_Bacsinszky,1,B-IO,11,3,0,2,1,6,5
20151006-W-Beijing-R32-Mariana_Duque_Marino-Timea_Bacsinszky,1,S-XC,5,1,1,0,0,5,0
20151006-W-Beijing-R32-Mariana_Duque_Marino-Timea_Bacsinszky,1,S-DTM,11,1,0,0,1,4,7
20151006-W-Beijing-R32-Mariana_Duque_Marino-Timea_Bacsinszky,1,S-DTL,9,2,0,0,2,2,7
20151006-W-Beijing-R32-Mariana_Duque_Marino-Timea_Bacsinszky,1,S-IO,1,0,0,0,0,0,1
20151006-W-Beijing-R32-Mariana_Duque_Marino-Timea_Bacsinszky,2,F-XC,41,9,3,2,4,29,12
20151006-W-Beijing-R32-Mariana_Duque_Marino-Timea_Bacsinszky,2,F-DTM,23,3,0,0,3,11,12
20151006-W-Beijing-R32-Mariana_Duque_Marino-Timea_Bacsinszky,2,F-DTL,16,2,2,0,0,10,6
20151006-W-Beijing-R32-Mariana_Duque_Marino-Timea_Bacsinszky,2,F-IO,11,2,1,0,1,6,5
20151006-W-Beijing-R32-Mariana_Duque_Marino-Timea_Bacsinszky,2,B-XC,24,6,3,1,2,16,8
20151006-W-Beijing-R32-Mariana_Duque_Marino-Timea_Bacsinszky,2,B-DTM,17,3,0,0,3,6,11
20151006-W-Beijing-R32-Mariana_Duque_Marino-Timea_Bacsinszky,2,B-DTL,10,6,2,1,3,4,6
20151006-W-Beijing-R32-Mariana_Duque_Marino-Timea_Bacsinszky,2,B-IO,9,3,3,0,0,6,3
20151006-W-Beijing-R32-Mariana_Duque_Marino-Timea_Bacsinszky,2,S-XC,1,0,0,0,0,0,1
20151006-W-Beijing-R32-Mariana_Duque_Marino-Timea_Bacsinszky,2,S-DTM,2,0,0,0,0,2,0
20141027-W-Sofia-RR-Alize_Cornet-Garbine_Muguruza,1,F-XC,35,12,5,1,6,16,19
20141027-W-Sofia-RR-Alize_Cornet-Garbine_Muguruza,1,F-DTM,26,2,0,1,1,14,12
20141027-W-Sofia-RR-Alize_Cornet-Garbine_Muguruza,1,F-DTL,17,3,1,1,1,8,9
20141027-W-Sofia-RR-Alize_Cornet-Garbine_Muguruza,1,F-IO,17,4,1,0,3,7,10
20141027-W-Sofia-RR-Alize_Cornet-Garbine_Muguruza,1,B-XC,34,9,3,0,6,13,21
20141027-W-Sofia-RR-Alize_Cornet-Garbine_Muguruza,1,B-DTM,26,2,0,0,2,16,10
20141027-W-Sofia-RR-Alize_Cornet-Garbine_Muguruza,1,B-DTL,2,1,1,0,0,1,1
20141027-W-Sofia-RR-Alize_Cornet-Garbine_Muguruza,1,B-IO,3,2,1,1,0,2,1
20141027-W-Sofia-RR-Alize_Cornet-Garbine_Muguruza,1,S-XC,4,0,0,0,0,2,2
20141027-W-Sofia-RR-Alize_Cornet-Garbine_Muguruza,1,S-DTM,2,0,0,0,0,2,0
20141027-W-Sofia-RR-Alize_Cornet-Garbine_Muguruza,2,F-XC,36,8,2,1,5,17,19
20141027-W-Sofia-RR-Alize_Cornet-Garbine_Muguruza,2,F-DTM,17,2,0,0,2,9,8
20141027-W-Sofia-RR-Alize_Cornet-Garbine_Muguruza,2,F-DTL,8,4,1,2,1,4,4
20141027-W-Sofia-RR-Alize_Cornet-Garbine_Muguruza,2,F-IO,11,7,1,2,4,5,6
20141027-W-Sofia-RR-Alize_Cornet-Garbine_Muguruza,2,B-XC,40,8,1,2,5,22,18
20141027-W-Sofia-RR-Alize_Cornet-Garbine_Muguruza,2,B-DTM,28,1,0,1,0,16,12
20141027-W-Sofia-RR-Alize_Cornet-Garbine_Muguruza,2,B-DTL,13,9,4,1,4,7,6
20141027-W-Sofia-RR-Alize_Cornet-Garbine_Muguruza,2,B-IO,14,5,0,0,5,5,9
20141027-W-Sofia-RR-Alize_Cornet-Garbine_Muguruza,2,S-IO,1,0,0,0,0,1,0
20130807-W-Toronto-R32-Eugenie_Bouchard-Petra_Kvitova,1,F-XC,20,4,0,0,4,8,12
20130807-W-Toronto-R32-Eugenie_Bouchard-Petra_Kvitova,1,F-DTM,15,3,0,0,3,9,6
20130807-W-Toronto-R32-Eugenie_Bouchard-Petra_Kvitova,1,F-DTL,4,2,1,1,0,2,2
20130807-W-Toronto-R32-Eugenie_Bouchard-Petra_Kvitova,1,F-IO,14,4,2,0,2,4,10
20130807-W-Toronto-R32-Eugenie_Bouchard-Petra_Kvitova,1,B-XC,26,8,0,6,2,12,14
20130807-W-Toronto-R32-Eugenie_Bouchard-Petra_Kvitova,1,B-DTM,20,6,0,1,5,8,12
20130807-W-Toronto-R32-Eugenie_Bouchard-Petra_Kvitova,1,B-DTL,4,2,0,0,2,1,3
20130807-W-Toronto-R32-Eugenie_Bouchard-Petra_Kvitova,1,B-IO,12,8,3,1,4,7,5
20130807-W-Toronto-R32-Eugenie_Bouchard-Petra_Kvitova,1,S-XC,1,0,0,0,0,0,1
20130807-W-Toronto-R32-Eugenie_Bouchard-Petra_Kvitova,1,S-DTM,5,0,0,0,0,3,2
20130807-W-Toronto-R32-Eugenie_Bouchard-Petra_Kvitova,2,F-XC,38,10,5,1,4,20,18
20130807-W-Toronto-R32-Eugenie_Bouchard-Petra_Kvitova,2,F-DTM,15,1,0,0,1,10,5
20130807-W-Toronto-R32-Eugenie_Bouchard-Petra_Kvitova,2,F-DTL,9,6,3,2,1,7,2
20130807-W-Toronto-R32-Eugenie_Bouchard-Petra_Kvitova,2,F-IO,14,6,3,2,1,11,3
20130807-W-Toronto-R32-Eugenie_Bouchard-Petra_Kvitova,2,F-II,1,0,0,0,0,1,0
20130807-W-Toronto-R32-Eugenie_Bouchard-Petra_Kvitova,2,B-XC,20,8,1,1,6,8,12
20130807-W-Toronto-R32-Eugenie_Bouchard-Petra_Kvitova,2,B-DTM,17,1,0,0,1,8,9
20130807-W-Toronto-R32-Eugenie_Bouchard-Petra_Kvitova,2,B-DTL,5,3,1,0,2,3,2
20130807-W-Toronto-R32-Eugenie_Bouchard-Petra_Kvitova,2,B-IO,7,3,1,1,1,4,3
20130807-W-Toronto-R32-Eugenie_Bouchard-Petra_Kvitova,2,S-DTM,4,0,0,0,0,1,3
20130807-W-Toronto-R32-Eugenie_Bouchard-Petra_Kvitova,2,S-DTL,1,0,0,0,0,0,1
20130807-W-Toronto-R32-Eugenie_Bouchard-Petra_Kvitova,2,S-IO,1,0,0,0,0,0,1
20151031-W-Singapore-SF-Maria_Sharapova-Petra_Kvitova,1,F-XC,16,2,1,0,1,5,11
20151031-W-Singapore-SF-Maria_Sharapova-Petra_Kvitova,1,F-DTM,11,1,0,0,1,4,7
20151031-W-Singapore-SF-Maria_Sharapova-Petra_Kvitova,1,F-DTL,19,10,2,4,4,7,12
20151031-W-Singapore-SF-Maria_Sharapova-Petra_Kvitova,1,F-IO,16,5,4,0,1,11,5
20151031-W-Singapore-SF-Maria_Sharapova-Petra_Kvitova,1,B-XC,24,3,0,0,3,7,17
20151031-W-Singapore-SF-Maria_Sharapova-Petra_Kvitova,1,B-DTM,28,5,0,0,5,11,17
20151031-W-Singapore-SF-Maria_Sharapova-Petra_Kvitova,1,B-DTL,11,6,2,1,3,4,7
20151031-W-Singapore-SF-Maria_Sharapova-Petra_Kvitova,1,B-IO,8,2,0,1,1,3,5
20151031-W-Singapore-SF-Maria_Sharapova-Petra_Kvitova,1,S-XC,1,0,0,0,0,0,1
20151031-W-Singapore-SF-Maria_Sharapova-Petra_Kvitova,1,S-DTM,4,0,0,0,0,2,2
20151031-W-Singapore-SF-Maria_Sharapova-Petra_Kvitova,1,S-DTL,2,0,0,0,0,1,1
20151031-W-Singapore-SF-Maria_Sharapova-Petra_Kvitova,2,F-XC,48,15,5,4,6,34,14
20151031-W-Singapore-SF-Maria_Sharapova-Petra_Kvitova,2,F-DTM,22,4,1,0,3,10,12
20151031-W-Singapore-SF-Maria_Sharapova-Petra_Kvitova,2,F-DTL,9,4,3,0,1,6,3
20151031-W-Singapore-SF-Maria_Sharapova-Petra_Kvitova,2,F-IO,6,5,2,0,3,3,3
20151031-W-Singapore-SF-Maria_Sharapova-Petra_Kvitova,2,B-XC,24,9,4,4,1,18,6
20151031-W-Singapore-SF-Maria_Sharapova-Petra_Kvitova,2,B-DTM,21,3,0,0,3,8,13
20151031-W-Singapore-SF-Maria_Sharapova-Petra_Kvitova,2,B-IO,11,4,2,1,1,7,4
20151031-W-Singapore-SF-Maria_Sharapova-Petra_Kvitova,2,S-XC,5,1,0,0,1,2,3
20151031-W-Singapore-SF-Maria_Sharapova-Petra_Kvitova,2,S-DTM,3,0,0,0,0,2,1
20151031-W-Singapore-SF-Maria_Sharapova-Petra_Kvitova,2,S-DTL,1,0,0,0,0,1,0
20151031-W-Singapore-SF-Maria_Sharapova-Petra_Kvitova,2,S-IO,2,0,0,0,0,1,1
20151107-W-Zhuhai-RR-Elina_Svitolina-Carla_Suarez_Navarro,1,F-XC,44,14,4,4,6,23,21
20151107-W-Zhuhai-RR-Elina_Svitolina-Carla_Suarez_Navarro,1,F-DTM,66,3,0,0,3,26,40
20151107-W-Zhuhai-RR-Elina_Svitolina-Carla_Suarez_Navarro,1,F-DTL,17,5,1,1,3,9,8
20151107-W-Zhuhai-RR-Elina_Svitolina-Carla_Suarez_Navarro,1,F-IO,22,3,1,1,1,12,10
20151107-W-Zhuhai-RR-Elina_Svitolina-Carla_Suarez_Navarro,1,B-XC,67,2,0,1,1,30,37
20151107-W-Zhuhai-RR-Elina_Svitolina-Carla_Suarez_Navarro,1,B-DTM,73,4,0,1,3,36,37
20151107-W-Zhuhai-RR-Elina_Svitolina-Carla_Suarez_Navarro,1,B-DTL,13,6,0,1,5,3,10
20151107-W-Zhuhai-RR-Elina_Svitolina-Carla_Suarez_Navarro,1,B-IO,12,4,2,0,2,7,5
20151107-W-Zhuhai-RR-Elina_Svitolina-Carla_Suarez_Navarro,1,S-XC,4,1,0,0,1,3,1
20151107-W-Zhuhai-RR-Elina_Svitolina-Carla_Suarez_Navarro,1,S-DTM,6,0,0,0,0,2,4
20151107-W-Zhuhai-RR-Elina_Svitolina-Carla_Suarez_Navarro,1,S-DTL,1,0,0,0,0,0,1
20151107-W-Zhuhai-RR-Elina_Svitolina-Carla_Suarez_Navarro,2,F-XC,83,23,9,4,10,45,38
20151107-W-Zhuhai-RR-Elina_Svitolina-Carla_Suarez_Navarro,2,F-DTM,35,6,0,1,5,17,18
20151107-W-Zhuhai-RR-Elina_Svitolina-Carla_Suarez_Navarro,2,F-DTL,23,8,2,4,2,17,6
20151107-W-Zhuhai-RR-Elina_Svitolina-Carla_Suarez_Navarro,2,F-IO,53,21,11,1,9,25,28
20151107-W-Zhuhai-RR-Elina_Svitolina-Carla_Suarez_Navarro,2,F-II,2,2,1,0,1,1,1
20151107-W-Zhuhai-RR-Elina_Svitolina-Carla_Suarez_Navarro,2,B-XC,56,13,3,0,10,34,22
20151107-W-Zhuhai-RR-Elina_Svitolina-Carla_Suarez_Navarro,2,B-DTM,63,10,0,0,10,30,33
20151107-W-Zhuhai-RR-Elina_Svitolina-Carla_Suarez_Navarro,2,B-DTL,14,6,3,1,2,9,5
20151107-W-Zhuhai-RR-Elina_Svitolina-Carla_Suarez_Navarro,2,B-IO,17,9,2,2,5,9,8
20151107-W-Zhuhai-RR-Elina_Svitolina-Carla_Suarez_Navarro,2,S-XC,15,1,1,0,0,7,8
20151107-W-Zhuhai-RR-Elina_Svitolina-Carla_Suarez_Navarro,2,S-DTM,8,1,0,0,1,5,3
20151107-W-Zhuhai-RR-Elina_Svitolina-Carla_Suarez_Navarro,2,S-DTL,2,0,0,0,0,1,1
20150529-W-Roland_Garros-R32-Garbine_Muguruza-Angelique_Kerber,1,F-XC,61,15,2,4,9,39,22
20150529-W-Roland_Garros-R32-Garbine_Muguruza-Angelique_Kerber,1,F-DTM,19,2,0,1,1,11,8
20150529-W-Roland_Garros-R32-Garbine_Muguruza-Angelique_Kerber,1,F-DTL,21,12,6,2,4,15,6
20150529-W-Roland_Garros-R32-Garbine_Muguruza-Angelique_Kerber,1,F-IO,20,5,1,4,0,12,8
20150529-W-Roland_Garros-R32-Garbine_Muguruza-Angelique_Kerber,1,B-XC,53,13,7,2,4,31,22
20150529-W-Roland_Garros-R32-Garbine_Muguruza-Angelique_Kerber,1,B-DTM,30,0,0,0,0,15,15
20150529-W-Roland_Garros-R32-Garbine_Muguruza-Angelique_Kerber,1,B-DTL,18,7,4,1,2,12,6
20150529-W-Roland_Garros-R32-Garbine_Muguruza-Angelique_Kerber,1,B-IO,10,5,2,1,2,6,4
20150529-W-Roland_Garros-R32-Garbine_Muguruza-Angelique_Kerber,1,B-II,2,0,0,0,0,1,1
20150529-W-Roland_Garros-R32-Garbine_Muguruza-Angelique_Kerber,1,S-XC,1,1,1,0,0,1,0
20150529-W-Roland_Garros-R32-Garbine_Muguruza-Angelique_Kerber,1,S-DTM,2,0,0,0,0,0,2
20150529-W-Roland_Garros-R32-Garbine_Muguruza-Angelique_Kerber,1,S-IO,1,0,0,0,0,1,0
20150529-W-Roland_Garros-R32-Garbine_Muguruza-Angelique_Kerber,2,F-XC,63,10,5,1,4,33,30
20150529-W-Roland_Garros-R32-Garbine_Muguruza-Angelique_Kerber,2,F-DTM,26,0,0,0,0,9,17
20150529-W-Roland_Garros-R32-Garbine_Muguruza-Angelique_Kerber,2,F-DTL,18,10,6,0,4,9,9
20150529-W-Roland_Garros-R32-Garbine_Muguruza-Angelique_Kerber,2,F-IO,19,8,4,2,2,11,8
20150529-W-Roland_Garros-R32-Garbine_Muguruza-Angelique_Kerber,2,F-II,1,0,0,0,0,0,1
20150529-W-Roland_Garros-R32-Garbine_Muguruza-Angelique_Kerber,2,B-XC,42,9,2,2,5,14,28
20150529-W-Roland_Garros-R32-Garbine_Muguruza-Angelique_Kerber,2,B-DTM,36,5,0,4,1,16,20
20150529-W-Roland_Garros-R32-Garbine_Muguruza-Angelique_Kerber,2,B-DTL,6,2,0,1,1,4,2
20150529-W-Roland_Garros-R32-Garbine_Muguruza-Angelique_Kerber,2,B-IO,8,1,0,0,1,2,6
20150529-W-Roland_Garros-R32-Garbine_Muguruza-Angelique_Kerber,2,B-II,1,0,0,0,0,0,1
20150529-W-Roland_Garros-R32-Garbine_Muguruza-Angelique_Kerber,2,S-XC,4,0,0,0,0,0,4
20150529-W-Roland_Garros-R32-Garbine_Muguruza-Angelique_Kerber,2,S-IO,1,0,0,0,0,1,0
20141027-W-Sofia-RR-Ekaterina_Makarova-Garbine_Muguruza,1,F-XC,31,6,2,0,4,12,19
20141027-W-Sofia-RR-Ekaterina_Makarova-Garbine_Muguruza,1,F-DTM,12,0,0,0,0,5,7
20141027-W-Sofia-RR-Ekaterina_Makarova-Garbine_Muguruza,1,F-DTL,10,3,1,1,1,3,7
20141027-W-Sofia-RR-Ekaterina_Makarova-Garbine_Muguruza,1,F-IO,9,4,1,2,1,5,4
20141027-W-Sofia-RR-Ekaterina_Makarova-Garbine_Muguruza,1,B-XC,22,6,0,2,4,7,15
20141027-W-Sofia-RR-Ekaterina_Makarova-Garbine_Muguruza,1,B-DTM,13,3,0,0,3,2,11
20141027-W-Sofia-RR-Ekaterina_Makarova-Garbine_Muguruza,1,B-DTL,6,2,1,0,1,3,3
20141027-W-Sofia-RR-Ekaterina_Makarova-Garbine_Muguruza,1,B-IO,3,1,0,0,1,2,1
20141027-W-Sofia-RR-Ekaterina_Makarova-Garbine_Muguruza,1,S-XC,1,0,0,0,0,0,1
20141027-W-Sofia-RR-Ekaterina_Makarova-Garbine_Muguruza,1,S-DTM,2,0,0,0,0,0,2
20141027-W-Sofia-RR-Ekaterina_Makarova-Garbine_Muguruza,1,S-II,1,0,0,0,0,0,1
20141027-W-Sofia-RR-Ekaterina_Makarova-Garbine_Muguruza,2,F-XC,23,5,1,2,2,16,7
20141027-W-Sofia-RR-Ekaterina_Makarova-Garbine_Muguruza,2,F-DTM,14,0,0,0,0,8,6
20141027-W-Sofia-RR-Ekaterina_Makarova-Garbine_Muguruza,2,F-DTL,9,6,3,2,1,7,2
20141027-W-Sofia-RR-Ekaterina_Makarova-Garbine_Muguruza,2,F-IO,7,2,1,0,1,5,2
20141027-W-Sofia-RR-Ekaterina_Makarova-Garbine_Muguruza,2,B-XC,26,8,1,1,6,14,12
20141027-W-Sofia-RR-Ekaterina_Makarova-Garbine_Muguruza,2,B-DTM,16,1,0,0,1,11,5
20141027-W-Sofia-RR-Ekaterina_Makarova-Garbine_Muguruza,2,B-DTL,9,8,5,0,3,6,3
20141027-W-Sofia-RR-Ekaterina_Makarova-Garbine_Muguruza,2,B-IO,3,1,1,0,0,2,1
20141027-W-Sofia-RR-Ekaterina_Makarova-Garbine_Muguruza,2,B-II,1,0,0,0,0,1,0
20141027-W-Sofia-RR-Ekaterina_Makarova-Garbine_Muguruza,2,S-DTM,1,0,0,0,0,0,1
20150525-W-Roland_Garros-R128-Petra_Martic-Garbine_Muguruza,1,F-XC,36,7,4,0,3,21,15
20150525-W-Roland_Garros-R128-Petra_Martic-Garbine_Muguruza,1,F-DTM,10,4,0,0,4,3,7
20150525-W-Roland_Garros-R128-Petra_Martic-Garbine_Muguruza,1,F-DTL,12,4,2,1,1,7,5
20150525-W-Roland_Garros-R128-Petra_Martic-Garbine_Muguruza,1,F-IO,9,0,0,0,0,7,2
20150525-W-Roland_Garros-R128-Petra_Martic-Garbine_Muguruza,1,F-II,4,2,2,0,0,4,0
20150525-W-Roland_Garros-R128-Petra_Martic-Garbine_Muguruza,1,B-XC,13,6,2,1,3,7,6
20150525-W-Roland_Garros-R128-Petra_Martic-Garbine_Muguruza,1,B-DTM,12,4,0,0,4,6,6
20150525-W-Roland_Garros-R128-Petra_Martic-Garbine_Muguruza,1,B-DTL,5,2,0,0,2,2,3
20150525-W-Roland_Garros-R128-Petra_Martic-Garbine_Muguruza,1,B-IO,1,1,0,0,1,0,1
20150525-W-Roland_Garros-R128-Petra_Martic-Garbine_Muguruza,1,S-XC,8,1,0,0,1,2,6
20150525-W-Roland_Garros-R128-Petra_Martic-Garbine_Muguruza,1,S-DTM,2,0,0,0,0,0,2
20150525-W-Roland_Garros-R128-Petra_Martic-Garbine_Muguruza,1,S-DTL,2,0,0,0,0,2,0
20150525-W-Roland_Garros-R128-Petra_Martic-Garbine_Muguruza,1,S-II,1,0,0,0,0,0,1
20150525-W-Roland_Garros-R128-Petra_Martic-Garbine_Muguruza,2,F-XC,34,5,3,0,2,17,17
20150525-W-Roland_Garros-R128-Petra_Martic-Garbine_Muguruza,2,F-DTM,9,1,0,0,1,3,6
20150525-W-Roland_Garros-R128-Petra_Martic-Garbine_Muguruza,2,F-DTL,10,4,0,0,4,5,5
20150525-W-Roland_Garros-R128-Petra_Martic-Garbine_Muguruza,2,F-IO,8,2,0,2,0,6,2
20150525-W-Roland_Garros-R128-Petra_Martic-Garbine_Muguruza,2,B-XC,28,5,4,0,1,15,13
20150525-W-Roland_Garros-R128-Petra_Martic-Garbine_Muguruza,2,B-DTM,12,0,0,0,0,5,7
20150525-W-Roland_Garros-R128-Petra_Martic-Garbine_Muguruza,2,B-DTL,5,4,4,0,0,5,0
20150525-W-Roland_Garros-R128-Petra_Martic-Garbine_Muguruza,2,B-IO,4,1,1,0,0,3,1
20150525-W-Roland_Garros-R128-Petra_Martic-Garbine_Muguruza,2,S-DTM,2,0,0,0,0,1,1
20141027-W-Sofia-RR-Flavia_Pennetta-Garbine_Muguruza,1,F-XC,71,16,3,2,11,30,41
20141027-W-Sofia-RR-Flavia_Pennetta-Garbine_Muguruza,1,F-DTM,32,2,0,1,1,16,16
20141027-W-Sofia-RR-Flavia_Pennetta-Garbine_Muguruza,1,F-DTL,13,5,2,1,2,8,5
20141027-W-Sofia-RR-Flavia_Pennetta-Garbine_Muguruza,1,F-IO,10,6,2,0,4,4,6
20141027-W-Sofia-RR-Flavia_Pennetta-Garbine_Muguruza,1,F-II,1,1,1,0,0,1,0
20141027-W-Sofia-RR-Flavia_Pennetta-Garbine_Muguruza,1,B-XC,30,7,1,1,5,12,18
20141027-W-Sofia-RR-Flavia_Pennetta-Garbine_Muguruza,1,B-DTM,31,3,0,0,3,12,19
20141027-W-Sofia-RR-Flavia_Pennetta-Garbine_Muguruza,1,B-DTL,8,4,2,1,1,6,2
20141027-W-Sofia-RR-Flavia_Pennetta-Garbine_Muguruza,1,B-IO,3,1,1,0,0,2,1
20141027-W-Sofia-RR-Flavia_Pennetta-Garbine_Muguruza,1,S-XC,1,1,0,1,0,1,0
20141027-W-Sofia-RR-Flavia_Pennetta-Garbine_Muguruza,1,S-DTM,1,0,0,0,0,0,1
20141027-W-Sofia-RR-Flavia_Pennetta-Garbine_Muguruza,1,S-IO,2,0,0,0,0,1,1
20141027-W-Sofia-RR-Flavia_Pennetta-Garbine_Muguruza,2,F-XC,68,17,3,4,10,34,34
20141027-W-Sofia-RR-Flavia_Pennetta-Garbine_Muguruza,2,F-DTM,18,3,0,0,3,10,8
20141027-W-Sofia-RR-Flavia_Pennetta-Garbine_Muguruza,2,F-DTL,19,10,7,0,3,12,7
20141027-W-Sofia-RR-Flavia_Pennetta-Garbine_Muguruza,2,F-IO,14,8,4,1,3,9,5
20141027-W-Sofia-RR-Flavia_Pennetta-Garbine_Muguruza,2,B-XC,24,6,0,0,6,8,16
20141027-W-Sofia-RR-Flavia_Pennetta-Garbine_Muguruza,2,B-DTM,33,4,0,1,3,16,17
20141027-W-Sofia-RR-Flavia_Pennetta-Garbine_Muguruza,2,B-DTL,9,4,1,1,2,6,3
20141027-W-Sofia-RR-Flavia_Pennetta-Garbine_Muguruza,2,B-IO,20,6,1,2,3,13,7
20150531-W-Roland_Garros-R16-Garbine_Muguruza-Flavia_Pennetta,1,F-XC,36,11,6,2,3,23,13
20150531-W-Roland_Garros-R16-Garbine_Muguruza-Flavia_Pennetta,1,F-DTM,13,1,0,0,1,7,6
20150531-W-Roland_Garros-R16-Garbine_Muguruza-Flavia_Pennetta,1,F-DTL,7,3,2,0,1,6,1
20150531-W-Roland_Garros-R16-Garbine_Muguruza-Flavia_Pennetta,1,F-IO,9,2,0,1,1,5,4
20150531-W-Roland_Garros-R16-Garbine_Muguruza-Flavia_Pennetta,1,F-II,1,1,1,0,0,1,0
20150531-W-Roland_Garros-R16-Garbine_Muguruza-Flavia_Pennetta,1,B-XC,69,20,3,6,11,45,24
20150531-W-Roland_Garros-R16-Garbine_Muguruza-Flavia_Pennetta,1,B-DTM,41,4,0,0,4,20,21
20150531-W-Roland_Garros-R16-Garbine_Muguruza-Flavia_Pennetta,1,B-DTL,20,8,6,2,0,17,3
20150531-W-Roland_Garros-R16-Garbine_Muguruza-Flavia_Pennetta,1,B-IO,12,4,2,0,2,9,3
20150531-W-Roland_Garros-R16-Garbine_Muguruza-Flavia_Pennetta,1,S-DTL,1,1,0,0,1,0,1
20150531-W-Roland_Garros-R16-Garbine_Muguruza-Flavia_Pennetta,2,F-XC,31,7,2,3,2,14,17
20150531-W-Roland_Garros-R16-Garbine_Muguruza-Flavia_Pennetta,2,F-DTM,15,0,0,0,0,5,10
20150531-W-Roland_Garros-R16-Garbine_Muguruza-Flavia_Pennetta,2,F-DTL,22,1,1,0,0,6,16
20150531-W-Roland_Garros-R16-Garbine_Muguruza-Flavia_Pennetta,2,F-IO,23,3,1,1,1,10,13
20150531-W-Roland_Garros-R16-Garbine_Muguruza-Flavia_Pennetta,2,B-XC,58,5,2,0,3,19,39
20150531-W-Roland_Garros-R16-Garbine_Muguruza-Flavia_Pennetta,2,B-DTM,21,1,0,0,1,9,12
20150531-W-Roland_Garros-R16-Garbine_Muguruza-Flavia_Pennetta,2,B-DTL,10,5,3,0,2,4,6
20150531-W-Roland_Garros-R16-Garbine_Muguruza-Flavia_Pennetta,2,B-IO,1,1,1,0,0,1,0
20150531-W-Roland_Garros-R16-Garbine_Muguruza-Flavia_Pennetta,2,S-XC,3,0,0,0,0,0,3
20150531-W-Roland_Garros-R16-Garbine_Muguruza-Flavia_Pennetta,2,S-DTM,2,0,0,0,0,0,2
20150219-W-Dubai-R16-Agnieszka_Radwanska-Garbine_Muguruza,1,F-XC,20,2,2,0,0,8,12
20150219-W-Dubai-R16-Agnieszka_Radwanska-Garbine_Muguruza,1,F-DTM,20,3,0,1,2,9,11
20150219-W-Dubai-R16-Agnieszka_Radwanska-Garbine_Muguruza,1,F-DTL,12,3,1,0,2,7,5
20150219-W-Dubai-R16-Agnieszka_Radwanska-Garbine_Muguruza,1,F-IO,15,3,0,0,3,6,9
20150219-W-Dubai-R16-Agnieszka_Radwanska-Garbine_Muguruza,1,B-XC,22,5,1,1,3,10,12
20150219-W-Dubai-R16-Agnieszka_Radwanska-Garbine_Muguruza,1,B-DTM,15,0,0,0,0,7,8
20150219-W-Dubai-R16-Agnieszka_Radwanska-Garbine_Muguruza,1,B-DTL,3,2,1,0,1,2,1
20150219-W-Dubai-R16-Agnieszka_Radwanska-Garbine_Muguruza,1,B-IO,7,2,1,0,1,2,5
20150219-W-Dubai-R16-Agnieszka_Radwanska-Garbine_Muguruza,2,F-XC,34,5,2,1,2,20,14
20150219-W-Dubai-R16-Agnieszka_Radwanska-Garbine_Muguruza,2,F-DTM,7,0,0,0,0,3,4
20150219-W-Dubai-R16-Agnieszka_Radwanska-Garbine_Muguruza,2,F-DTL,8,2,2,0,0,7,1
20150219-W-Dubai-R16-Agnieszka_Radwanska-Garbine_Muguruza,2,F-IO,8,3,1,2,0,7,1
20150219-W-Dubai-R16-Agnieszka_Radwanska-Garbine_Muguruza,2,B-XC,31,7,2,0,5,12,19
20150219-W-Dubai-R16-Agnieszka_Radwanska-Garbine_Muguruza,2,B-DTM,15,2,0,0,2,9,6
20150219-W-Dubai-R16-Agnieszka_Radwanska-Garbine_Muguruza,2,B-DTL,11,6,5,1,0,8,3
20150219-W-Dubai-R16-Agnieszka_Radwanska-Garbine_Muguruza,2,B-IO,5,3,0,0,3,1,4
20150219-W-Dubai-R16-Agnieszka_Radwanska-Garbine_Muguruza,2,S-XC,1,0,0,0,0,0,1
20150219-W-Dubai-R16-Agnieszka_Radwanska-Garbine_Muguruza,2,S-DTL,1,1,0,1,0,1,0
20151025-W-Singapore-RR-Lucie_Safarova-Garbine_Muguruza,1,F-XC,54,12,2,5,5,29,25
20151025-W-Singapore-RR-Lucie_Safarova-Garbine_Muguruza,1,F-DTM,30,3,0,0,3,11,19
20151025-W-Singapore-RR-Lucie_Safarova-Garbine_Muguruza,1,F-DTL,13,8,3,0,5,4,9
20151025-W-Singapore-RR-Lucie_Safarova-Garbine_Muguruza,1,F-IO,17,5,3,0,2,7,10
20151025-W-Singapore-RR-Lucie_Safarova-Garbine_Muguruza,1,B-XC,20,3,1,2,0,12,8
20151025-W-Singapore-RR-Lucie_Safarova-Garbine_Muguruza,1,B-DTM,18,2,0,1,1,6,12
20151025-W-Singapore-RR-Lucie_Safarova-Garbine_Muguruza,1,B-DTL,6,1,1,0,0,1,5
20151025-W-Singapore-RR-Lucie_Safarova-Garbine_Muguruza,1,B-IO,10,3,2,0,1,5,5
20151025-W-Singapore-RR-Lucie_Safarova-Garbine_Muguruza,1,B-II,2,1,0,1,0,1,1
20151025-W-Singapore-RR-Lucie_Safarova-Garbine_Muguruza,1,S-DTM,2,0,0,0,0,0,2
20151025-W-Singapore-RR-Lucie_Safarova-Garbine_Muguruza,2,F-XC,35,15,3,4,8,19,16
20151025-W-Singapore-RR-Lucie_Safarova-Garbine_Muguruza,2,F-DTM,11,0,0,0,0,7,4
20151025-W-Singapore-RR-Lucie_Safarova-Garbine_Muguruza,2,F-DTL,11,3,1,0,2,5,6
20151025-W-Singapore-RR-Lucie_Safarova-Garbine_Muguruza,2,F-IO,16,9,5,2,2,11,5
20151025-W-Singapore-RR-Lucie_Safarova-Garbine_Muguruza,2,B-XC,30,8,2,3,3,18,12
20151025-W-Singapore-RR-Lucie_Safarova-Garbine_Muguruza,2,B-DTM,30,2,0,1,1,15,15
20151025-W-Singapore-RR-Lucie_Safarova-Garbine_Muguruza,2,B-DTL,9,5,1,0,4,4,5
20151025-W-Singapore-RR-Lucie_Safarova-Garbine_Muguruza,2,B-IO,8,5,1,1,3,4,4
20151025-W-Singapore-RR-Lucie_Safarova-Garbine_Muguruza,2,S-DTM,3,0,0,0,0,3,0
20151025-W-Singapore-RR-Lucie_Safarova-Garbine_Muguruza,2,S-IO,1,0,0,0,0,1,0
20121023-W-Luxembourg-QF-Andrea_Petkovic-Ksenia_Pervak,1,F-XC,37,8,1,3,4,23,14
20121023-W-Luxembourg-QF-Andrea_Petkovic-Ksenia_Pervak,1,F-DTM,15,2,0,0,2,9,6
20121023-W-Luxembourg-QF-Andrea_Petkovic-Ksenia_Pervak,1,F-DTL,6,2,2,0,0,3,3
20121023-W-Luxembourg-QF-Andrea_Petkovic-Ksenia_Pervak,1,F-IO,25,6,2,2,2,15,10
20121023-W-Luxembourg-QF-Andrea_Petkovic-Ksenia_Pervak,1,F-II,1,0,0,0,0,0,1
20121023-W-Luxembourg-QF-Andrea_Petkovic-Ksenia_Pervak,1,B-XC,58,7,2,3,2,31,27
20121023-W-Luxembourg-QF-Andrea_Petkovic-Ksenia_Pervak,1,B-DTM,20,2,0,1,1,8,12
20121023-W-Luxembourg-QF-Andrea_Petkovic-Ksenia_Pervak,1,B-DTL,11,3,0,1,2,5,6
20121023-W-Luxembourg-QF-Andrea_Petkovic-Ksenia_Pervak,1,B-IO,5,0,0,0,0,2,3
20121023-W-Luxembourg-QF-Andrea_Petkovic-Ksenia_Pervak,1,S-XC,10,0,0,0,0,6,4
20121023-W-Luxembourg-QF-Andrea_Petkovic-Ksenia_Pervak,1,S-DTM,7,0,0,0,0,2,5
20121023-W-Luxembourg-QF-Andrea_Petkovic-Ksenia_Pervak,1,S-DTL,2,0,0,0,0,0,2
20121023-W-Luxembourg-QF-Andrea_Petkovic-Ksenia_Pervak,1,S-II,1,0,0,0,0,0,1
20121023-W-Luxembourg-QF-Andrea_Petkovic-Ksenia_Pervak,2,F-XC,71,7,0,1,6,36,35
20121023-W-Luxembourg-QF-Andrea_Petkovic-Ksenia_Pervak,2,F-DTM,23,2,0,0,2,8,15
20121023-W-Luxembourg-QF-Andrea_Petkovic-Ksenia_Pervak,2,F-DTL,21,8,3,2,3,13,8
20121023-W-Luxembourg-QF-Andrea_Petkovic-Ksenia_Pervak,2,F-IO,14,2,0,0,2,5,9
20121023-W-Luxembourg-QF-Andrea_Petkovic-Ksenia_Pervak,2,F-II,1,0,0,0,0,0,1
20121023-W-Luxembourg-QF-Andrea_Petkovic-Ksenia_Pervak,2,B-XC,23,4,0,3,1,12,11
20121023-W-Luxembourg-QF-Andrea_Petkovic-Ksenia_Pervak,2,B-DTM,18,0,0,0,0,6,12
20121023-W-Luxembourg-QF-Andrea_Petkovic-Ksenia_Pervak,2,B-DTL,8,2,1,0,1,3,5
20121023-W-Luxembourg-QF-Andrea_Petkovic-Ksenia_Pervak,2,B-IO,10,3,0,1,2,5,5
20121023-W-Luxembourg-QF-Andrea_Petkovic-Ksenia_Pervak,2,B-II,1,0,0,0,0,1,0
20121023-W-Luxembourg-QF-Andrea_Petkovic-Ksenia_Pervak,2,S-DTM,2,0,0,0,0,2,0
20121023-W-Luxembourg-QF-Andrea_Petkovic-Ksenia_Pervak,2,S-DTL,2,0,0,0,0,1,1
20121023-W-Luxembourg-QF-Andrea_Petkovic-Ksenia_Pervak,2,S-IO,2,0,0,0,0,2,0
20141027-W-Sofia-RR-Tsvetana_Pironkova-Dominika_Cibulkova,1,F-XC,36,6,0,0,6,11,25
20141027-W-Sofia-RR-Tsvetana_Pironkova-Dominika_Cibulkova,1,F-DTM,45,3,0,0,3,13,32
20141027-W-Sofia-RR-Tsvetana_Pironkova-Dominika_Cibulkova,1,F-DTL,42,9,1,2,6,11,31
20141027-W-Sofia-RR-Tsvetana_Pironkova-Dominika_Cibulkova,1,F-IO,20,3,1,1,1,8,12
20141027-W-Sofia-RR-Tsvetana_Pironkova-Dominika_Cibulkova,1,F-II,1,0,0,0,0,0,1
20141027-W-Sofia-RR-Tsvetana_Pironkova-Dominika_Cibulkova,1,B-XC,47,7,1,0,6,20,27
20141027-W-Sofia-RR-Tsvetana_Pironkova-Dominika_Cibulkova,1,B-DTM,26,3,0,0,3,8,18
20141027-W-Sofia-RR-Tsvetana_Pironkova-Dominika_Cibulkova,1,B-DTL,20,6,2,1,3,8,12
20141027-W-Sofia-RR-Tsvetana_Pironkova-Dominika_Cibulkova,1,B-IO,11,3,0,1,2,4,7
20141027-W-Sofia-RR-Tsvetana_Pironkova-Dominika_Cibulkova,1,S-XC,2,0,0,0,0,0,2
20141027-W-Sofia-RR-Tsvetana_Pironkova-Dominika_Cibulkova,1,S-DTM,1,0,0,0,0,0,1
20141027-W-Sofia-RR-Tsvetana_Pironkova-Dominika_Cibulkova,1,S-DTL,1,0,0,0,0,0,1
20141027-W-Sofia-RR-Tsvetana_Pironkova-Dominika_Cibulkova,2,F-XC,87,16,2,4,10,61,26
20141027-W-Sofia-RR-Tsvetana_Pironkova-Dominika_Cibulkova,2,F-DTM,33,1,0,0,1,18,15
20141027-W-Sofia-RR-Tsvetana_Pironkova-Dominika_Cibulkova,2,F-DTL,14,7,1,2,4,7,7
20141027-W-Sofia-RR-Tsvetana_Pironkova-Dominika_Cibulkova,2,F-IO,26,5,3,0,2,15,11
20141027-W-Sofia-RR-Tsvetana_Pironkova-Dominika_Cibulkova,2,F-II,6,0,0,0,0,4,2
20141027-W-Sofia-RR-Tsvetana_Pironkova-Dominika_Cibulkova,2,B-XC,52,12,3,4,5,36,16
20141027-W-Sofia-RR-Tsvetana_Pironkova-Dominika_Cibulkova,2,B-DTM,20,2,0,0,2,11,9
20141027-W-Sofia-RR-Tsvetana_Pironkova-Dominika_Cibulkova,2,B-DTL,32,5,3,1,1,21,11
20141027-W-Sofia-RR-Tsvetana_Pironkova-Dominika_Cibulkova,2,B-IO,4,1,1,0,0,4,0
20141027-W-Sofia-RR-Tsvetana_Pironkova-Dominika_Cibulkova,2,S-XC,2,0,0,0,0,1,1
20141027-W-Sofia-RR-Tsvetana_Pironkova-Dominika_Cibulkova,2,S-DTM,4,0,0,0,0,2,2
20151010-W-Beijing-SF-Agnieszka_Radwanska-Garbine_Muguruza,1,F-XC,69,14,3,5,6,45,24
20151010-W-Beijing-SF-Agnieszka_Radwanska-Garbine_Muguruza,1,F-DTM,34,2,0,0,2,22,12
20151010-W-Beijing-SF-Agnieszka_Radwanska-Garbine_Muguruza,1,F-DTL,29,5,3,1,1,14,15
20151010-W-Beijing-SF-Agnieszka_Radwanska-Garbine_Muguruza,1,F-IO,36,10,2,1,7,15,21
20151010-W-Beijing-SF-Agnieszka_Radwanska-Garbine_Muguruza,1,F-II,1,1,0,0,1,0,1
20151010-W-Beijing-SF-Agnieszka_Radwanska-Garbine_Muguruza,1,B-XC,51,6,0,3,3,29,22
20151010-W-Beijing-SF-Agnieszka_Radwanska-Garbine_Muguruza,1,B-DTM,40,2,0,0,1,23,17
20151010-W-Beijing-SF-Agnieszka_Radwanska-Garbine_Muguruza,1,B-DTL,15,6,1,0,5,6,9
20151010-W-Beijing-SF-Agnieszka_Radwanska-Garbine_Muguruza,1,B-IO,16,3,1,0,2,6,10
20151010-W-Beijing-SF-Agnieszka_Radwanska-Garbine_Muguruza,1,S-XC,6,0,0,0,0,0,6
20151010-W-Beijing-SF-Agnieszka_Radwanska-Garbine_Muguruza,1,S-DTM,5,0,0,0,0,2,3
20151010-W-Beijing-SF-Agnieszka_Radwanska-Garbine_Muguruza,1,S-DTL,2,0,0,0,0,0,2
20151010-W-Beijing-SF-Agnieszka_Radwanska-Garbine_Muguruza,1,S-IO,1,0,0,0,0,1,0
20151010-W-Beijing-SF-Agnieszka_Radwanska-Garbine_Muguruza,2,F-XC,75,27,8,3,16,25,50
20151010-W-Beijing-SF-Agnieszka_Radwanska-Garbine_Muguruza,2,F-DTM,25,1,0,0,1,9,16
20151010-W-Beijing-SF-Agnieszka_Radwanska-Garbine_Muguruza,2,F-DTL,23,8,4,1,3,14,9
20151010-W-Beijing-SF-Agnieszka_Radwanska-Garbine_Muguruza,2,F-IO,20,5,1,0,4,11,9
20151010-W-Beijing-SF-Agnieszka_Radwanska-Garbine_Muguruza,2,B-XC,80,24,6,6,12,40,40
20151010-W-Beijing-SF-Agnieszka_Radwanska-Garbine_Muguruza,2,B-DTM,44,2,0,0,2,20,24
20151010-W-Beijing-SF-Agnieszka_Radwanska-Garbine_Muguruza,2,B-DTL,29,9,3,1,5,16,13
20151010-W-Beijing-SF-Agnieszka_Radwanska-Garbine_Muguruza,2,B-IO,19,6,2,0,4,8,11
20151010-W-Beijing-SF-Agnieszka_Radwanska-Garbine_Muguruza,2,S-XC,2,0,0,0,0,1,1
20151010-W-Beijing-SF-Agnieszka_Radwanska-Garbine_Muguruza,2,S-DTL,1,0,0,0,0,1,0
20151010-W-Beijing-SF-Agnieszka_Radwanska-Garbine_Muguruza,2,S-IO,2,0,0,0,0,1,1
20150615-W-Birmingham-R64-Magdalena_Rybarikova-Garbine_Muguruza,1,F-XC,15,5,0,4,1,9,6
20150615-W-Birmingham-R64-Magdalena_Rybarikova-Garbine_Muguruza,1,F-DTM,7,2,0,0,2,3,4
20150615-W-Birmingham-R64-Magdalena_Rybarikova-Garbine_Muguruza,1,F-DTL,8,5,2,0,3,4,4
20150615-W-Birmingham-R64-Magdalena_Rybarikova-Garbine_Muguruza,1,F-IO,8,2,0,1,1,5,3
20150615-W-Birmingham-R64-Magdalena_Rybarikova-Garbine_Muguruza,1,B-XC,7,2,2,0,0,5,2
20150615-W-Birmingham-R64-Magdalena_Rybarikova-Garbine_Muguruza,1,B-DTM,10,1,0,0,1,7,3
20150615-W-Birmingham-R64-Magdalena_Rybarikova-Garbine_Muguruza,1,B-DTL,9,3,2,1,0,6,3
20150615-W-Birmingham-R64-Magdalena_Rybarikova-Garbine_Muguruza,1,B-IO,1,0,0,0,0,1,0
20150615-W-Birmingham-R64-Magdalena_Rybarikova-Garbine_Muguruza,1,S-XC,6,2,0,1,1,4,2
20150615-W-Birmingham-R64-Magdalena_Rybarikova-Garbine_Muguruza,1,S-DTM,3,0,0,0,0,1,2
20150615-W-Birmingham-R64-Magdalena_Rybarikova-Garbine_Muguruza,1,S-DTL,1,0,0,0,0,1,0
20150615-W-Birmingham-R64-Magdalena_Rybarikova-Garbine_Muguruza,1,S-IO,1,1,0,0,1,0,1
20150615-W-Birmingham-R64-Magdalena_Rybarikova-Garbine_Muguruza,2,F-XC,26,12,2,3,7,10,16
20150615-W-Birmingham-R64-Magdalena_Rybarikova-Garbine_Muguruza,2,F-DTM,5,2,0,1,1,2,3
20150615-W-Birmingham-R64-Magdalena_Rybarikova-Garbine_Muguruza,2,F-DTL,9,6,0,2,4,3,6
20150615-W-Birmingham-R64-Magdalena_Rybarikova-Garbine_Muguruza,2,F-IO,7,4,4,0,0,6,1
20150615-W-Birmingham-R64-Magdalena_Rybarikova-Garbine_Muguruza,2,F-II,1,1,1,0,0,1,0
20150615-W-Birmingham-R64-Magdalena_Rybarikova-Garbine_Muguruza,2,B-XC,24,5,0,1,4,5,19
20150615-W-Birmingham-R64-Magdalena_Rybarikova-Garbine_Muguruza,2,B-DTM,4,0,0,0,0,2,2
20150615-W-Birmingham-R64-Magdalena_Rybarikova-Garbine_Muguruza,2,B-DTL,6,3,0,1,2,4,2
20150615-W-Birmingham-R64-Magdalena_Rybarikova-Garbine_Muguruza,2,B-IO,9,3,1,0,2,4,5
20150615-W-Birmingham-R64-Magdalena_Rybarikova-Garbine_Muguruza,2,S-XC,2,0,0,0,0,0,2
20150615-W-Birmingham-R64-Magdalena_Rybarikova-Garbine_Muguruza,2,S-DTM,2,0,0,0,0,1,1
20130718-W-Bastad-SF-Serena_Williams-Klara_Koukalova,1,F-XC,22,6,1,2,3,15,7
20130718-W-Bastad-SF-Serena_Williams-Klara_Koukalova,1,F-DTM,13,0,0,0,0,6,7
20130718-W-Bastad-SF-Serena_Williams-Klara_Koukalova,1,F-DTL,11,2,2,0,0,8,3
20130718-W-Bastad-SF-Serena_Williams-Klara_Koukalova,1,F-IO,6,0,0,0,0,3,3
20130718-W-Bastad-SF-Serena_Williams-Klara_Koukalova,1,F-II,1,1,0,1,0,1,0
20130718-W-Bastad-SF-Serena_Williams-Klara_Koukalova,1,B-XC,20,5,0,0,5,9,11
20130718-W-Bastad-SF-Serena_Williams-Klara_Koukalova,1,B-DTM,23,2,0,0,2,13,10
20130718-W-Bastad-SF-Serena_Williams-Klara_Koukalova,1,B-DTL,12,7,0,3,4,5,7
20130718-W-Bastad-SF-Serena_Williams-Klara_Koukalova,1,B-IO,5,2,0,1,1,3,2
20130718-W-Bastad-SF-Serena_Williams-Klara_Koukalova,1,S-XC,1,0,0,0,0,0,1
20130718-W-Bastad-SF-Serena_Williams-Klara_Koukalova,1,S-DTL,1,0,0,0,0,0,1
20130718-W-Bastad-SF-Serena_Williams-Klara_Koukalova,2,F-XC,39,11,3,1,7,15,24
20130718-W-Bastad-SF-Serena_Williams-Klara_Koukalova,2,F-DTM,13,2,0,0,2,4,9
20130718-W-Bastad-SF-Serena_Williams-Klara_Koukalova,2,F-DTL,9,3,1,0,2,3,6
20130718-W-Bastad-SF-Serena_Williams-Klara_Koukalova,2,F-IO,11,4,4,0,0,8,3
20130718-W-Bastad-SF-Serena_Williams-Klara_Koukalova,2,F-II,1,0,0,0,0,0,1
20130718-W-Bastad-SF-Serena_Williams-Klara_Koukalova,2,B-XC,26,7,0,1,6,10,16
20130718-W-Bastad-SF-Serena_Williams-Klara_Koukalova,2,B-DTM,17,1,0,0,1,6,11
20130718-W-Bastad-SF-Serena_Williams-Klara_Koukalova,2,B-DTL,5,2,1,0,1,1,4
20130718-W-Bastad-SF-Serena_Williams-Klara_Koukalova,2,B-IO,3,2,1,0,1,2,1
20130718-W-Bastad-SF-Serena_Williams-Klara_Koukalova,2,S-XC,3,2,0,1,1,1,2
20130718-W-Bastad-SF-Serena_Williams-Klara_Koukalova,2,S-DTM,2,0,0,0,0,0,2
20130718-W-Bastad-SF-Serena_Williams-Klara_Koukalova,2,S-DTL,1,1,0,0,1,0,1
20130718-W-Bastad-SF-Serena_Williams-Klara_Koukalova,2,S-IO,1,0,0,0,0,0,1
20140603-W-Roland_Garros-QF-Maria_Sharapova-Garbine_Muguruza,1,F-XC,68,17,3,1,13,34,34
20140603-W-Roland_Garros-QF-Maria_Sharapova-Garbine_Muguruza,1,F-DTM,41,1,0,1,0,27,14
20140603-W-Roland_Garros-QF-Maria_Sharapova-Garbine_Muguruza,1,F-DTL,17,8,1,2,5,11,6
20140603-W-Roland_Garros-QF-Maria_Sharapova-Garbine_Muguruza,1,F-IO,39,12,6,2,4,21,18
20140603-W-Roland_Garros-QF-Maria_Sharapova-Garbine_Muguruza,1,B-XC,32,10,1,2,7,15,17
20140603-W-Roland_Garros-QF-Maria_Sharapova-Garbine_Muguruza,1,B-DTM,22,0,0,0,0,15,7
20140603-W-Roland_Garros-QF-Maria_Sharapova-Garbine_Muguruza,1,B-DTL,8,5,2,1,2,5,3
20140603-W-Roland_Garros-QF-Maria_Sharapova-Garbine_Muguruza,1,B-IO,9,1,0,0,1,7,2
20140603-W-Roland_Garros-QF-Maria_Sharapova-Garbine_Muguruza,1,S-XC,2,0,0,0,0,1,1
20140603-W-Roland_Garros-QF-Maria_Sharapova-Garbine_Muguruza,1,S-DTM,3,0,0,0,0,1,2
20140603-W-Roland_Garros-QF-Maria_Sharapova-Garbine_Muguruza,1,S-DTL,1,0,0,0,0,0,1
20140603-W-Roland_Garros-QF-Maria_Sharapova-Garbine_Muguruza,2,F-XC,67,17,2,3,12,26,41
20140603-W-Roland_Garros-QF-Maria_Sharapova-Garbine_Muguruza,2,F-DTM,43,5,0,0,5,19,24
20140603-W-Roland_Garros-QF-Maria_Sharapova-Garbine_Muguruza,2,F-DTL,11,7,4,1,2,7,4
20140603-W-Roland_Garros-QF-Maria_Sharapova-Garbine_Muguruza,2,F-IO,13,5,3,0,2,4,9
20140603-W-Roland_Garros-QF-Maria_Sharapova-Garbine_Muguruza,2,B-XC,33,6,1,1,4,16,17
20140603-W-Roland_Garros-QF-Maria_Sharapova-Garbine_Muguruza,2,B-DTM,48,6,0,0,6,20,28
20140603-W-Roland_Garros-QF-Maria_Sharapova-Garbine_Muguruza,2,B-DTL,13,8,4,0,4,8,5
20140603-W-Roland_Garros-QF-Maria_Sharapova-Garbine_Muguruza,2,B-IO,10,5,1,1,3,4,6
20140603-W-Roland_Garros-QF-Maria_Sharapova-Garbine_Muguruza,2,S-XC,1,0,0,0,0,0,1
20140603-W-Roland_Garros-QF-Maria_Sharapova-Garbine_Muguruza,2,S-DTM,5,1,0,0,1,0,5
20151025-W-Singapore-RR-Angelique_Kerber-Garbine_Muguruza,1,F-XC,46,11,4,2,5,24,22
20151025-W-Singapore-RR-Angelique_Kerber-Garbine_Muguruza,1,F-DTM,9,1,1,0,0,3,6
20151025-W-Singapore-RR-Angelique_Kerber-Garbine_Muguruza,1,F-DTL,17,8,3,1,4,9,8
20151025-W-Singapore-RR-Angelique_Kerber-Garbine_Muguruza,1,F-IO,15,7,2,1,4,7,8
20151025-W-Singapore-RR-Angelique_Kerber-Garbine_Muguruza,1,B-XC,42,5,2,1,2,21,21
20151025-W-Singapore-RR-Angelique_Kerber-Garbine_Muguruza,1,B-DTM,25,1,0,1,0,8,17
20151025-W-Singapore-RR-Angelique_Kerber-Garbine_Muguruza,1,B-DTL,7,2,0,1,1,2,5
20151025-W-Singapore-RR-Angelique_Kerber-Garbine_Muguruza,1,B-IO,8,1,1,0,0,3,5
20151025-W-Singapore-RR-Angelique_Kerber-Garbine_Muguruza,1,B-II,3,1,0,1,0,2,1
20151025-W-Singapore-RR-Angelique_Kerber-Garbine_Muguruza,1,S-XC,1,0,0,0,0,1,0
20151025-W-Singapore-RR-Angelique_Kerber-Garbine_Muguruza,1,S-DTM,6,0,0,0,0,0,6
20151025-W-Singapore-RR-Angelique_Kerber-Garbine_Muguruza,1,S-DTL,2,1,0,0,1,0,2
20151025-W-Singapore-RR-Angelique_Kerber-Garbine_Muguruza,2,F-XC,51,4,1,0,3,32,19
20151025-W-Singapore-RR-Angelique_Kerber-Garbine_Muguruza,2,F-DTM,12,0,0,0,0,6,6
20151025-W-Singapore-RR-Angelique_Kerber-Garbine_Muguruza,2,F-DTL,21,11,5,1,5,11,10
20151025-W-Singapore-RR-Angelique_Kerber-Garbine_Muguruza,2,F-IO,13,4,4,0,0,9,4
20151025-W-Singapore-RR-Angelique_Kerber-Garbine_Muguruza,2,B-XC,38,7,1,2,4,21,17
20151025-W-Singapore-RR-Angelique_Kerber-Garbine_Muguruza,2,B-DTM,11,0,0,0,0,5,6
20151025-W-Singapore-RR-Angelique_Kerber-Garbine_Muguruza,2,B-DTL,12,9,5,2,2,10,2
20151025-W-Singapore-RR-Angelique_Kerber-Garbine_Muguruza,2,B-IO,9,3,0,3,0,6,3
20151025-W-Singapore-RR-Angelique_Kerber-Garbine_Muguruza,2,S-DTM,2,0,0,0,0,1,1
20150715-W-Bastad-R32-Ysaline_Bonaventure-Serena_Williams,1,F-XC,8,5,1,1,3,5,3
20150715-W-Bastad-R32-Ysaline_Bonaventure-Serena_Williams,1,F-DTM,9,1,0,0,1,4,5
20150715-W-Bastad-R32-Ysaline_Bonaventure-Serena_Williams,1,F-IO,20,5,1,1,3,7,13
20150715-W-Bastad-R32-Ysaline_Bonaventure-Serena_Williams,1,F-II,6,4,2,0,2,4,2
20150715-W-Bastad-R32-Ysaline_Bonaventure-Serena_Williams,1,B-XC,2,2,0,1,1,1,1
20150715-W-Bastad-R32-Ysaline_Bonaventure-Serena_Williams,1,B-DTM,13,1,0,0,1,4,9
20150715-W-Bastad-R32-Ysaline_Bonaventure-Serena_Williams,1,B-IO,6,4,0,0,4,1,5
20150715-W-Bastad-R32-Ysaline_Bonaventure-Serena_Williams,1,B-II,5,3,0,1,2,3,2
20150715-W-Bastad-R32-Ysaline_Bonaventure-Serena_Williams,1,S-DTM,2,0,0,0,0,1,1
20150715-W-Bastad-R32-Ysaline_Bonaventure-Serena_Williams,1,S-DTL,1,0,0,0,0,1,0
20150715-W-Bastad-R32-Ysaline_Bonaventure-Serena_Williams,2,F-XC,12,4,0,0,4,3,9
20150715-W-Bastad-R32-Ysaline_Bonaventure-Serena_Williams,2,F-DTM,12,1,0,0,1,6,6
20150715-W-Bastad-R32-Ysaline_Bonaventure-Serena_Williams,2,F-DTL,2,1,1,0,0,1,1
20150715-W-Bastad-R32-Ysaline_Bonaventure-Serena_Williams,2,F-IO,7,4,1,2,1,6,1
20150715-W-Bastad-R32-Ysaline_Bonaventure-Serena_Williams,2,B-XC,20,5,3,1,1,10,10
20150715-W-Bastad-R32-Ysaline_Bonaventure-Serena_Williams,2,B-DTM,7,0,0,0,0,3,4
20150715-W-Bastad-R32-Ysaline_Bonaventure-Serena_Williams,2,B-DTL,2,2,1,0,1,1,1
20150715-W-Bastad-R32-Ysaline_Bonaventure-Serena_Williams,2,B-IO,6,2,1,0,1,3,3
20150715-W-Bastad-R32-Ysaline_Bonaventure-Serena_Williams,2,S-DTM,4,0,0,0,0,4,0
20150715-W-Bastad-R32-Ysaline_Bonaventure-Serena_Williams,2,S-DTL,1,0,0,0,0,0,1
20150831-W-US_Open-R128-Serena_Williams-Vitalia_Diatchenko,1,F-XC,1,0,0,0,0,1,0
20150831-W-US_Open-R128-Serena_Williams-Vitalia_Diatchenko,1,F-IO,4,2,2,0,0,4,0
20150831-W-US_Open-R128-Serena_Williams-Vitalia_Diatchenko,1,B-XC,5,2,1,0,1,4,1
20150831-W-US_Open-R128-Serena_Williams-Vitalia_Diatchenko,1,B-DTM,1,0,0,0,0,1,0
20150831-W-US_Open-R128-Serena_Williams-Vitalia_Diatchenko,1,B-IO,1,0,0,0,0,1,0
20150831-W-US_Open-R128-Serena_Williams-Vitalia_Diatchenko,2,F-XC,1,1,0,0,1,0,1
20150831-W-US_Open-R128-Serena_Williams-Vitalia_Diatchenko,2,F-DTM,3,0,0,0,0,0,3
20150831-W-US_Open-R128-Serena_Williams-Vitalia_Diatchenko,2,F-DTL,1,0,0,0,0,0,1
20150831-W-US_Open-R128-Serena_Williams-Vitalia_Diatchenko,2,F-IO,1,1,0,0,1,0,1
20150831-W-US_Open-R128-Serena_Williams-Vitalia_Diatchenko,2,B-XC,2,1,0,0,1,0,2
20150831-W-US_Open-R128-Serena_Williams-Vitalia_Diatchenko,2,B-DTM,3,0,0,0,0,0,3
20150831-W-US_Open-R128-Serena_Williams-Vitalia_Diatchenko,2,B-IO,4,4,1,0,3,1,3
20150831-W-US_Open-R128-Serena_Williams-Vitalia_Diatchenko,2,S-DTM,1,0,0,0,0,0,1
20150602-W-Roland_Garros-QF-Serena_Williams-Sara_Errani,1,F-XC,17,6,3,0,3,11,6
20150602-W-Roland_Garros-QF-Serena_Williams-Sara_Errani,1,F-DTM,4,0,0,0,0,3,1
20150602-W-Roland_Garros-QF-Serena_Williams-Sara_Errani,1,F-DTL,10,4,1,1,2,6,4
20150602-W-Roland_Garros-QF-Serena_Williams-Sara_Errani,1,F-IO,10,2,1,0,1,5,5
20150602-W-Roland_Garros-QF-Serena_Williams-Sara_Errani,1,B-XC,21,4,1,1,2,12,9
20150602-W-Roland_Garros-QF-Serena_Williams-Sara_Errani,1,B-DTM,13,0,0,0,0,8,5
20150602-W-Roland_Garros-QF-Serena_Williams-Sara_Errani,1,B-DTL,23,10,6,1,3,15,8
20150602-W-Roland_Garros-QF-Serena_Williams-Sara_Errani,1,B-IO,6,0,0,0,0,2,4
20150602-W-Roland_Garros-QF-Serena_Williams-Sara_Errani,1,B-II,1,1,1,0,0,1,0
20150602-W-Roland_Garros-QF-Serena_Williams-Sara_Errani,1,S-DTM,2,0,0,0,0,0,2
20150602-W-Roland_Garros-QF-Serena_Williams-Sara_Errani,2,F-XC,20,4,2,1,1,8,12
20150602-W-Roland_Garros-QF-Serena_Williams-Sara_Errani,2,F-DTM,12,1,0,0,1,5,7
20150602-W-Roland_Garros-QF-Serena_Williams-Sara_Errani,2,F-DTL,13,1,1,0,0,9,4
20150602-W-Roland_Garros-QF-Serena_Williams-Sara_Errani,2,F-IO,5,1,1,0,0,2,3
20150602-W-Roland_Garros-QF-Serena_Williams-Sara_Errani,2,B-XC,22,9,1,0,8,9,13
20150602-W-Roland_Garros-QF-Serena_Williams-Sara_Errani,2,B-DTM,15,2,0,1,1,5,10
20150602-W-Roland_Garros-QF-Serena_Williams-Sara_Errani,2,B-DTL,5,1,0,1,0,3,2
20150602-W-Roland_Garros-QF-Serena_Williams-Sara_Errani,2,B-IO,1,0,0,0,0,1,0
20150602-W-Roland_Garros-QF-Serena_Williams-Sara_Errani,2,S-XC,1,0,0,0,0,0,1
20150602-W-Roland_Garros-QF-Serena_Williams-Sara_Errani,2,S-DTM,5,0,0,0,0,2,3
20150602-W-Roland_Garros-QF-Serena_Williams-Sara_Errani,2,S-DTL,1,0,0,0,0,0,1
20150906-W-US_Open-R16-Serena_Williams-Madison_Keys,1,F-XC,15,4,1,2,1,9,6
20150906-W-US_Open-R16-Serena_Williams-Madison_Keys,1,F-DTM,7,1,0,0,1,3,4
20150906-W-US_Open-R16-Serena_Williams-Madison_Keys,1,F-DTL,5,1,0,0,1,1,4
20150906-W-US_Open-R16-Serena_Williams-Madison_Keys,1,F-IO,4,1,0,1,0,4,0
20150906-W-US_Open-R16-Serena_Williams-Madison_Keys,1,B-XC,20,6,0,1,5,7,13
20150906-W-US_Open-R16-Serena_Williams-Madison_Keys,1,B-DTM,6,1,1,0,0,3,3
20150906-W-US_Open-R16-Serena_Williams-Madison_Keys,1,B-DTL,7,2,0,0,2,3,4
20150906-W-US_Open-R16-Serena_Williams-Madison_Keys,1,S-DTL,1,0,0,0,0,1,0
20150906-W-US_Open-R16-Serena_Williams-Madison_Keys,2,F-XC,25,9,4,0,5,13,12
20150906-W-US_Open-R16-Serena_Williams-Madison_Keys,2,F-DTM,6,1,0,1,0,2,4
20150906-W-US_Open-R16-Serena_Williams-Madison_Keys,2,F-DTL,7,4,3,0,1,5,2
20150906-W-US_Open-R16-Serena_Williams-Madison_Keys,2,F-IO,7,5,1,2,2,5,2
20150906-W-US_Open-R16-Serena_Williams-Madison_Keys,2,B-XC,16,6,2,0,4,8,8
20150906-W-US_Open-R16-Serena_Williams-Madison_Keys,2,B-DTM,6,1,0,0,1,3,3
20150906-W-US_Open-R16-Serena_Williams-Madison_Keys,2,B-DTL,5,5,1,0,4,1,4
20150906-W-US_Open-R16-Serena_Williams-Madison_Keys,2,B-IO,2,0,0,0,0,1,1
20150906-W-US_Open-R16-Serena_Williams-Madison_Keys,2,S-XC,1,0,0,0,0,1,0
20140526-W-Roland_Garros-R128-Serena_Williams-Alize_Lim,1,F-XC,26,7,2,2,3,14,12
20140526-W-Roland_Garros-R128-Serena_Williams-Alize_Lim,1,F-DTM,4,0,0,0,0,3,1
20140526-W-Roland_Garros-R128-Serena_Williams-Alize_Lim,1,F-DTL,11,5,0,1,4,6,5
20140526-W-Roland_Garros-R128-Serena_Williams-Alize_Lim,1,F-IO,11,6,3,0,3,6,5
20140526-W-Roland_Garros-R128-Serena_Williams-Alize_Lim,1,B-XC,32,13,4,3,6,15,17
20140526-W-Roland_Garros-R128-Serena_Williams-Alize_Lim,1,B-DTM,13,2,0,1,1,6,7
20140526-W-Roland_Garros-R128-Serena_Williams-Alize_Lim,1,B-DTL,10,7,3,0,4,5,5
20140526-W-Roland_Garros-R128-Serena_Williams-Alize_Lim,1,B-IO,17,10,5,1,3,10,7
20140526-W-Roland_Garros-R128-Serena_Williams-Alize_Lim,2,F-XC,22,2,0,1,1,11,11
20140526-W-Roland_Garros-R128-Serena_Williams-Alize_Lim,2,F-DTM,5,0,0,0,0,1,4
20140526-W-Roland_Garros-R128-Serena_Williams-Alize_Lim,2,F-DTL,12,3,1,0,2,4,8
20140526-W-Roland_Garros-R128-Serena_Williams-Alize_Lim,2,F-IO,12,4,0,1,3,6,6
20140526-W-Roland_Garros-R128-Serena_Williams-Alize_Lim,2,B-XC,16,3,2,0,1,12,4
20140526-W-Roland_Garros-R128-Serena_Williams-Alize_Lim,2,B-DTM,22,2,0,0,2,9,13
20140526-W-Roland_Garros-R128-Serena_Williams-Alize_Lim,2,B-DTL,6,2,1,0,1,3,3
20140526-W-Roland_Garros-R128-Serena_Williams-Alize_Lim,2,B-IO,1,0,0,0,0,0,1
20140526-W-Roland_Garros-R128-Serena_Williams-Alize_Lim,2,S-DTM,2,0,0,0,0,1,1
20140526-W-Roland_Garros-R128-Serena_Williams-Alize_Lim,2,S-DTL,1,0,0,0,0,0,1
20150904-W-US_Open-R32-Bethanie_Mattek_Sands-Serena_Williams,1,F-XC,12,4,1,2,1,7,5
20150904-W-US_Open-R32-Bethanie_Mattek_Sands-Serena_Williams,1,F-DTM,9,0,0,0,0,2,7
20150904-W-US_Open-R32-Bethanie_Mattek_Sands-Serena_Williams,1,F-DTL,11,1,0,1,0,5,6
20150904-W-US_Open-R32-Bethanie_Mattek_Sands-Serena_Williams,1,F-IO,9,2,0,1,1,4,5
20150904-W-US_Open-R32-Bethanie_Mattek_Sands-Serena_Williams,1,F-II,1,0,0,0,0,0,1
20150904-W-US_Open-R32-Bethanie_Mattek_Sands-Serena_Williams,1,B-XC,11,2,1,0,1,2,9
20150904-W-US_Open-R32-Bethanie_Mattek_Sands-Serena_Williams,1,B-DTM,12,0,0,0,0,6,6
20150904-W-US_Open-R32-Bethanie_Mattek_Sands-Serena_Williams,1,B-DTL,7,2,1,0,1,3,4
20150904-W-US_Open-R32-Bethanie_Mattek_Sands-Serena_Williams,1,B-IO,3,1,0,0,1,1,2
20150904-W-US_Open-R32-Bethanie_Mattek_Sands-Serena_Williams,1,S-XC,7,0,0,0,0,1,6
20150904-W-US_Open-R32-Bethanie_Mattek_Sands-Serena_Williams,1,S-DTM,5,0,0,0,0,2,3
20150904-W-US_Open-R32-Bethanie_Mattek_Sands-Serena_Williams,1,S-DTL,1,0,0,0,0,0,1
20150904-W-US_Open-R32-Bethanie_Mattek_Sands-Serena_Williams,2,F-XC,21,8,4,2,2,13,8
20150904-W-US_Open-R32-Bethanie_Mattek_Sands-Serena_Williams,2,F-DTM,5,1,1,0,0,3,2
20150904-W-US_Open-R32-Bethanie_Mattek_Sands-Serena_Williams,2,F-DTL,9,5,3,2,0,6,3
20150904-W-US_Open-R32-Bethanie_Mattek_Sands-Serena_Williams,2,F-IO,13,6,3,1,2,10,3
20150904-W-US_Open-R32-Bethanie_Mattek_Sands-Serena_Williams,2,B-XC,35,15,8,1,6,23,12
20150904-W-US_Open-R32-Bethanie_Mattek_Sands-Serena_Williams,2,B-DTM,6,0,0,0,0,3,3
20150904-W-US_Open-R32-Bethanie_Mattek_Sands-Serena_Williams,2,B-DTL,12,6,3,2,1,10,2
20150904-W-US_Open-R32-Bethanie_Mattek_Sands-Serena_Williams,2,B-IO,6,2,0,1,1,3,3
20150904-W-US_Open-R32-Bethanie_Mattek_Sands-Serena_Williams,2,S-XC,1,0,0,0,0,1,0
20150904-W-US_Open-R32-Bethanie_Mattek_Sands-Serena_Williams,2,S-DTL,1,0,0,0,0,0,1
20150813-W-Toronto-R16-Serena_Williams-Andrea_Petkovic,1,F-XC,16,4,1,1,2,10,6
20150813-W-Toronto-R16-Serena_Williams-Andrea_Petkovic,1,F-DTM,8,0,0,0,0,4,4
20150813-W-Toronto-R16-Serena_Williams-Andrea_Petkovic,1,F-DTL,5,2,1,0,1,4,1
20150813-W-Toronto-R16-Serena_Williams-Andrea_Petkovic,1,F-IO,3,2,2,0,0,3,0
20150813-W-Toronto-R16-Serena_Williams-Andrea_Petkovic,1,B-XC,24,8,3,1,4,16,8
20150813-W-Toronto-R16-Serena_Williams-Andrea_Petkovic,1,B-DTM,7,1,0,0,1,2,5
20150813-W-Toronto-R16-Serena_Williams-Andrea_Petkovic,1,B-DTL,11,4,3,0,1,7,4
20150813-W-Toronto-R16-Serena_Williams-Andrea_Petkovic,1,B-IO,5,2,0,1,1,4,1
20150813-W-Toronto-R16-Serena_Williams-Andrea_Petkovic,1,S-DTM,1,0,0,0,0,1,0
20150813-W-Toronto-R16-Serena_Williams-Andrea_Petkovic,2,F-XC,17,3,0,2,1,6,11
20150813-W-Toronto-R16-Serena_Williams-Andrea_Petkovic,2,F-DTM,10,1,0,0,1,3,7
20150813-W-Toronto-R16-Serena_Williams-Andrea_Petkovic,2,F-DTL,12,2,1,0,1,4,8
20150813-W-Toronto-R16-Serena_Williams-Andrea_Petkovic,2,F-IO,10,4,1,2,1,6,4
20150813-W-Toronto-R16-Serena_Williams-Andrea_Petkovic,2,B-XC,13,2,0,1,1,6,7
20150813-W-Toronto-R16-Serena_Williams-Andrea_Petkovic,2,B-DTM,13,2,0,0,2,4,9
20150813-W-Toronto-R16-Serena_Williams-Andrea_Petkovic,2,B-DTL,2,2,0,1,1,1,1
20150813-W-Toronto-R16-Serena_Williams-Andrea_Petkovic,2,S-XC,2,1,0,0,1,0,2
20150813-W-Toronto-R16-Serena_Williams-Andrea_Petkovic,2,S-DTM,1,0,0,0,0,0,1
20080530-W-Roland_Garros-R32-Serena_Williams-Katarina_Srebotnik,1,F-XC,39,15,2,1,12,7,32
20080530-W-Roland_Garros-R32-Serena_Williams-Katarina_Srebotnik,1,F-DTM,6,0,0,0,0,1,5
20080530-W-Roland_Garros-R32-Serena_Williams-Katarina_Srebotnik,1,F-DTL,19,8,3,1,4,6,13
20080530-W-Roland_Garros-R32-Serena_Williams-Katarina_Srebotnik,1,F-IO,3,0,0,0,0,2,1
20080530-W-Roland_Garros-R32-Serena_Williams-Katarina_Srebotnik,1,F-II,1,1,0,1,0,1,0
20080530-W-Roland_Garros-R32-Serena_Williams-Katarina_Srebotnik,1,B-XC,21,3,2,0,1,9,12
20080530-W-Roland_Garros-R32-Serena_Williams-Katarina_Srebotnik,1,B-DTM,11,1,0,0,1,1,10
20080530-W-Roland_Garros-R32-Serena_Williams-Katarina_Srebotnik,1,B-DTL,12,3,1,1,1,4,8
20080530-W-Roland_Garros-R32-Serena_Williams-Katarina_Srebotnik,1,B-IO,9,4,2,0,2,4,5
20080530-W-Roland_Garros-R32-Serena_Williams-Katarina_Srebotnik,1,S-XC,1,0,0,0,0,0,1
20080530-W-Roland_Garros-R32-Serena_Williams-Katarina_Srebotnik,1,S-DTM,4,0,0,0,0,1,3
20080530-W-Roland_Garros-R32-Serena_Williams-Katarina_Srebotnik,1,S-DTL,2,0,0,0,0,0,2
20080530-W-Roland_Garros-R32-Serena_Williams-Katarina_Srebotnik,1,S-IO,1,0,0,0,0,0,1
20080530-W-Roland_Garros-R32-Serena_Williams-Katarina_Srebotnik,2,F-XC,42,8,2,3,3,34,8
20080530-W-Roland_Garros-R32-Serena_Williams-Katarina_Srebotnik,2,F-DTM,7,1,0,0,1,5,2
20080530-W-Roland_Garros-R32-Serena_Williams-Katarina_Srebotnik,2,F-DTL,18,6,4,1,1,15,3
20080530-W-Roland_Garros-R32-Serena_Williams-Katarina_Srebotnik,2,F-IO,9,1,1,0,0,7,2
20080530-W-Roland_Garros-R32-Serena_Williams-Katarina_Srebotnik,2,F-II,2,1,1,0,0,2,0
20080530-W-Roland_Garros-R32-Serena_Williams-Katarina_Srebotnik,2,B-XC,6,3,0,0,3,2,4
20080530-W-Roland_Garros-R32-Serena_Williams-Katarina_Srebotnik,2,B-DTM,14,2,1,0,1,8,6
20080530-W-Roland_Garros-R32-Serena_Williams-Katarina_Srebotnik,2,B-DTL,2,1,0,0,1,1,1
20080530-W-Roland_Garros-R32-Serena_Williams-Katarina_Srebotnik,2,B-IO,1,0,0,0,0,1,0
20080530-W-Roland_Garros-R32-Serena_Williams-Katarina_Srebotnik,2,S-XC,9,0,0,0,0,7,2
20080530-W-Roland_Garros-R32-Serena_Williams-Katarina_Srebotnik,2,S-DTM,8,0,0,0,0,5,3
20080530-W-Roland_Garros-R32-Serena_Williams-Katarina_Srebotnik,2,S-DTL,3,0,0,0,0,2,1
20080530-W-Roland_Garros-R32-Serena_Williams-Katarina_Srebotnik,2,S-IO,2,0,0,0,0,2,0
19880424-W-Houston-F-Chris_Evert-Martina_Navratilova,1,F-XC,103,9,3,3,3,65,38
19880424-W-Houston-F-Chris_Evert-Martina_Navratilova,1,F-DTM,16,1,0,1,0,10,6
19880424-W-Houston-F-Chris_Evert-Martina_Navratilova,1,F-DTL,16,4,2,1,1,8,8
19880424-W-Houston-F-Chris_Evert-Martina_Navratilova,1,F-IO,6,2,1,0,1,2,4
19880424-W-Houston-F-Chris_Evert-Martina_Navratilova,1,B-XC,40,4,1,1,2,16,24
19880424-W-Houston-F-Chris_Evert-Martina_Navratilova,1,B-DTM,29,1,0,0,1,12,17
19880424-W-Houston-F-Chris_Evert-Martina_Navratilova,1,B-DTL,26,4,2,0,2,11,15
19880424-W-Houston-F-Chris_Evert-Martina_Navratilova,1,B-IO,11,0,0,0,0,5,6
19880424-W-Houston-F-Chris_Evert-Martina_Navratilova,1,S-XC,1,0,0,0,0,0,1
19880424-W-Houston-F-Chris_Evert-Martina_Navratilova,1,S-DTL,1,0,0,0,0,0,1
19880424-W-Houston-F-Chris_Evert-Martina_Navratilova,2,F-XC,45,4,0,2,2,23,22
19880424-W-Houston-F-Chris_Evert-Martina_Navratilova,2,F-DTM,14,1,0,1,0,9,5
19880424-W-Houston-F-Chris_Evert-Martina_Navratilova,2,F-DTL,10,5,3,0,2,5,5
19880424-W-Houston-F-Chris_Evert-Martina_Navratilova,2,F-IO,16,3,1,1,1,6,10
19880424-W-Houston-F-Chris_Evert-Martina_Navratilova,2,F-II,2,0,0,0,0,2,0
19880424-W-Houston-F-Chris_Evert-Martina_Navratilova,2,B-XC,12,1,1,0,0,4,8
19880424-W-Houston-F-Chris_Evert-Martina_Navratilova,2,B-DTM,8,3,0,0,3,4,4
19880424-W-Houston-F-Chris_Evert-Martina_Navratilova,2,B-DTL,4,3,1,0,2,1,3
19880424-W-Houston-F-Chris_Evert-Martina_Navratilova,2,S-XC,62,8,1,1,6,22,40
19880424-W-Houston-F-Chris_Evert-Martina_Navratilova,2,S-DTM,25,3,0,0,3,10,15
19880424-W-Houston-F-Chris_Evert-Martina_Navratilova,2,S-DTL,31,5,0,0,5,18,13
19880424-W-Houston-F-Chris_Evert-Martina_Navratilova,2,S-IO,6,0,0,0,0,4,2
20130518-W-Rome-SF-Serena_Williams-Simona_Halep,1,F-XC,29,6,5,1,0,23,6
20130518-W-Rome-SF-Serena_Williams-Simona_Halep,1,F-DTM,9,1,0,1,0,7,2
20130518-W-Rome-SF-Serena_Williams-Simona_Halep,1,F-DTL,6,3,1,0,2,3,3
20130518-W-Rome-SF-Serena_Williams-Simona_Halep,1,F-IO,8,1,0,0,1,6,2
20130518-W-Rome-SF-Serena_Williams-Simona_Halep,1,B-XC,21,5,2,1,2,13,8
20130518-W-Rome-SF-Serena_Williams-Simona_Halep,1,B-DTM,9,0,0,0,0,7,2
20130518-W-Rome-SF-Serena_Williams-Simona_Halep,1,B-DTL,7,1,1,0,0,7,0
20130518-W-Rome-SF-Serena_Williams-Simona_Halep,1,B-IO,10,3,1,1,1,5,5
20130518-W-Rome-SF-Serena_Williams-Simona_Halep,1,S-DTM,1,0,0,0,0,1,0
20130518-W-Rome-SF-Serena_Williams-Simona_Halep,2,F-XC,24,3,0,3,0,9,15
20130518-W-Rome-SF-Serena_Williams-Simona_Halep,2,F-DTM,8,1,0,0,1,4,4
20130518-W-Rome-SF-Serena_Williams-Simona_Halep,2,F-DTL,5,1,0,0,1,2,3
20130518-W-Rome-SF-Serena_Williams-Simona_Halep,2,F-IO,8,2,1,0,1,1,7
20130518-W-Rome-SF-Serena_Williams-Simona_Halep,2,B-XC,19,7,2,1,4,5,14
20130518-W-Rome-SF-Serena_Williams-Simona_Halep,2,B-DTM,11,2,0,1,1,3,8
20130518-W-Rome-SF-Serena_Williams-Simona_Halep,2,B-DTL,5,0,0,0,0,2,3
20130518-W-Rome-SF-Serena_Williams-Simona_Halep,2,B-IO,3,1,0,0,1,0,3
20130518-W-Rome-SF-Serena_Williams-Simona_Halep,2,S-DTM,7,0,0,0,0,3,4
20130518-W-Rome-SF-Serena_Williams-Simona_Halep,2,S-DTL,2,0,0,0,0,0,2
20120114-W-Hobart-F-Mona_Barthel-Yanina_Wickmayer,1,F-XC,34,6,4,2,0,22,12
20120114-W-Hobart-F-Mona_Barthel-Yanina_Wickmayer,1,F-DTM,27,1,0,0,1,8,19
20120114-W-Hobart-F-Mona_Barthel-Yanina_Wickmayer,1,F-DTL,9,5,2,1,2,5,4
20120114-W-Hobart-F-Mona_Barthel-Yanina_Wickmayer,1,F-IO,9,2,2,0,0,6,3
20120114-W-Hobart-F-Mona_Barthel-Yanina_Wickmayer,1,B-XC,23,4,1,2,1,12,11
20120114-W-Hobart-F-Mona_Barthel-Yanina_Wickmayer,1,B-DTM,19,1,0,0,1,9,10
20120114-W-Hobart-F-Mona_Barthel-Yanina_Wickmayer,1,B-DTL,8,3,3,0,0,7,1
20120114-W-Hobart-F-Mona_Barthel-Yanina_Wickmayer,1,B-IO,3,2,1,0,1,2,1
20120114-W-Hobart-F-Mona_Barthel-Yanina_Wickmayer,1,S-XC,2,0,0,0,0,0,2
20120114-W-Hobart-F-Mona_Barthel-Yanina_Wickmayer,1,S-DTM,4,0,0,0,0,1,3
20120114-W-Hobart-F-Mona_Barthel-Yanina_Wickmayer,1,S-DTL,1,1,1,0,0,1,0
20120114-W-Hobart-F-Mona_Barthel-Yanina_Wickmayer,2,F-XC,53,15,3,3,9,30,23
20120114-W-Hobart-F-Mona_Barthel-Yanina_Wickmayer,2,F-DTM,15,2,0,0,2,6,9
20120114-W-Hobart-F-Mona_Barthel-Yanina_Wickmayer,2,F-DTL,9,5,1,0,4,2,7
20120114-W-Hobart-F-Mona_Barthel-Yanina_Wickmayer,2,F-IO,18,8,5,2,1,12,6
20120114-W-Hobart-F-Mona_Barthel-Yanina_Wickmayer,2,B-XC,31,7,2,1,4,14,17
20120114-W-Hobart-F-Mona_Barthel-Yanina_Wickmayer,2,B-DTM,13,0,0,0,0,5,8
20120114-W-Hobart-F-Mona_Barthel-Yanina_Wickmayer,2,B-DTL,6,2,0,0,2,3,3
20120114-W-Hobart-F-Mona_Barthel-Yanina_Wickmayer,2,B-IO,10,6,5,0,1,7,3
20120114-W-Hobart-F-Mona_Barthel-Yanina_Wickmayer,2,S-XC,1,0,0,0,0,0,1
20130120-W-Australian_Open-R16-Ana_Ivanovic-Agnieszka_Radwanska,1,F-XC,35,16,5,1,10,18,17
20130120-W-Australian_Open-R16-Ana_Ivanovic-Agnieszka_Radwanska,1,F-DTM,15,2,1,0,1,6,9
20130120-W-Australian_Open-R16-Ana_Ivanovic-Agnieszka_Radwanska,1,F-DTL,10,5,3,1,1,5,5
20130120-W-Australian_Open-R16-Ana_Ivanovic-Agnieszka_Radwanska,1,F-IO,25,8,4,0,4,15,10
20130120-W-Australian_Open-R16-Ana_Ivanovic-Agnieszka_Radwanska,1,F-II,5,2,1,1,0,4,1
20130120-W-Australian_Open-R16-Ana_Ivanovic-Agnieszka_Radwanska,1,B-XC,18,4,3,0,1,7,11
20130120-W-Australian_Open-R16-Ana_Ivanovic-Agnieszka_Radwanska,1,B-DTM,12,0,0,0,0,7,5
20130120-W-Australian_Open-R16-Ana_Ivanovic-Agnieszka_Radwanska,1,B-DTL,7,2,2,0,0,5,2
20130120-W-Australian_Open-R16-Ana_Ivanovic-Agnieszka_Radwanska,1,B-IO,5,1,0,0,1,2,3
20130120-W-Australian_Open-R16-Ana_Ivanovic-Agnieszka_Radwanska,1,S-DTM,2,0,0,0,0,1,1
20130120-W-Australian_Open-R16-Ana_Ivanovic-Agnieszka_Radwanska,1,S-DTL,1,0,0,0,0,0,1
20130120-W-Australian_Open-R16-Ana_Ivanovic-Agnieszka_Radwanska,2,F-XC,12,0,0,0,0,7,5
20130120-W-Australian_Open-R16-Ana_Ivanovic-Agnieszka_Radwanska,2,F-DTM,18,0,0,0,0,6,12
20130120-W-Australian_Open-R16-Ana_Ivanovic-Agnieszka_Radwanska,2,F-DTL,7,1,0,1,0,4,3
20130120-W-Australian_Open-R16-Ana_Ivanovic-Agnieszka_Radwanska,2,F-IO,10,2,1,1,0,7,3
20130120-W-Australian_Open-R16-Ana_Ivanovic-Agnieszka_Radwanska,2,F-II,1,0,0,0,0,0,1
20130120-W-Australian_Open-R16-Ana_Ivanovic-Agnieszka_Radwanska,2,B-XC,14,1,0,1,0,7,7
20130120-W-Australian_Open-R16-Ana_Ivanovic-Agnieszka_Radwanska,2,B-DTM,21,2,0,2,0,11,10
20130120-W-Australian_Open-R16-Ana_Ivanovic-Agnieszka_Radwanska,2,B-DTL,9,5,4,0,1,8,1
20130120-W-Australian_Open-R16-Ana_Ivanovic-Agnieszka_Radwanska,2,B-IO,3,1,0,0,1,1,2
20130120-W-Australian_Open-R16-Ana_Ivanovic-Agnieszka_Radwanska,2,S-XC,6,1,0,0,1,3,3
20130120-W-Australian_Open-R16-Ana_Ivanovic-Agnieszka_Radwanska,2,S-DTM,7,1,0,0,1,1,6
20130120-W-Australian_Open-R16-Ana_Ivanovic-Agnieszka_Radwanska,2,S-DTL,3,0,0,0,0,1,2
20120113-W-Hobart-SF-Angelique_Kerber-Mona_Barthel,1,F-XC,55,10,1,3,6,20,35
20120113-W-Hobart-SF-Angelique_Kerber-Mona_Barthel,1,F-DTM,22,0,0,0,0,10,12
20120113-W-Hobart-SF-Angelique_Kerber-Mona_Barthel,1,F-DTL,17,9,2,2,5,8,9
20120113-W-Hobart-SF-Angelique_Kerber-Mona_Barthel,1,F-IO,17,3,1,1,1,6,11
20120113-W-Hobart-SF-Angelique_Kerber-Mona_Barthel,1,B-XC,37,12,4,5,3,16,21
20120113-W-Hobart-SF-Angelique_Kerber-Mona_Barthel,1,B-DTM,28,1,0,1,0,12,16
20120113-W-Hobart-SF-Angelique_Kerber-Mona_Barthel,1,B-DTL,9,2,2,0,0,2,7
20120113-W-Hobart-SF-Angelique_Kerber-Mona_Barthel,1,B-IO,6,1,0,1,0,3,3
20120113-W-Hobart-SF-Angelique_Kerber-Mona_Barthel,1,S-XC,2,0,0,0,0,2,0
20120113-W-Hobart-SF-Angelique_Kerber-Mona_Barthel,1,S-DTM,5,0,0,0,0,2,3
20120113-W-Hobart-SF-Angelique_Kerber-Mona_Barthel,1,S-DTL,1,0,0,0,0,0,1
20120113-W-Hobart-SF-Angelique_Kerber-Mona_Barthel,2,F-XC,44,6,0,2,4,26,18
20120113-W-Hobart-SF-Angelique_Kerber-Mona_Barthel,2,F-DTM,25,1,0,0,1,14,11
20120113-W-Hobart-SF-Angelique_Kerber-Mona_Barthel,2,F-DTL,8,1,0,0,1,6,2
20120113-W-Hobart-SF-Angelique_Kerber-Mona_Barthel,2,F-IO,13,7,4,2,1,9,4
20120113-W-Hobart-SF-Angelique_Kerber-Mona_Barthel,2,B-XC,50,14,7,3,4,30,20
20120113-W-Hobart-SF-Angelique_Kerber-Mona_Barthel,2,B-DTM,25,0,0,0,0,17,8
20120113-W-Hobart-SF-Angelique_Kerber-Mona_Barthel,2,B-DTL,15,7,5,2,0,10,5
20120113-W-Hobart-SF-Angelique_Kerber-Mona_Barthel,2,B-IO,12,6,2,2,2,8,4
20120113-W-Hobart-SF-Angelique_Kerber-Mona_Barthel,2,S-XC,2,0,0,0,0,2,0
20120113-W-Hobart-SF-Angelique_Kerber-Mona_Barthel,2,S-DTM,3,0,0,0,0,2,1
20120113-W-Hobart-SF-Angelique_Kerber-Mona_Barthel,2,S-DTL,2,1,1,0,0,1,1
19930130-W-Australian_Open-F-Steffi_Graf-Monica_Seles,1,F-XC,73,20,9,5,6,40,33
19930130-W-Australian_Open-F-Steffi_Graf-Monica_Seles,1,F-DTM,31,2,0,0,2,13,18
19930130-W-Australian_Open-F-Steffi_Graf-Monica_Seles,1,F-DTL,13,3,0,0,3,5,8
19930130-W-Australian_Open-F-Steffi_Graf-Monica_Seles,1,F-IO,43,13,4,4,5,27,16
19930130-W-Australian_Open-F-Steffi_Graf-Monica_Seles,1,F-II,9,2,2,0,0,7,2
19930130-W-Australian_Open-F-Steffi_Graf-Monica_Seles,1,B-XC,4,2,2,0,0,3,1
19930130-W-Australian_Open-F-Steffi_Graf-Monica_Seles,1,B-DTM,1,0,0,0,0,0,1
19930130-W-Australian_Open-F-Steffi_Graf-Monica_Seles,1,S-XC,98,8,0,2,6,40,58
19930130-W-Australian_Open-F-Steffi_Graf-Monica_Seles,1,S-DTM,35,2,0,0,2,16,19
19930130-W-Australian_Open-F-Steffi_Graf-Monica_Seles,1,S-DTL,17,4,1,1,2,5,12
19930130-W-Australian_Open-F-Steffi_Graf-Monica_Seles,1,S-IO,6,0,0,0,0,5,1
19930130-W-Australian_Open-F-Steffi_Graf-Monica_Seles,2,F-XC,143,13,5,1,7,79,64
19930130-W-Australian_Open-F-Steffi_Graf-Monica_Seles,2,F-DTM,28,3,0,0,3,6,22
19930130-W-Australian_Open-F-Steffi_Graf-Monica_Seles,2,F-DTL,22,8,4,1,3,13,9
19930130-W-Australian_Open-F-Steffi_Graf-Monica_Seles,2,F-IO,15,7,2,2,3,9,6
19930130-W-Australian_Open-F-Steffi_Graf-Monica_Seles,2,B-XC,51,12,0,4,8,28,23
19930130-W-Australian_Open-F-Steffi_Graf-Monica_Seles,2,B-DTM,24,1,0,0,1,12,12
19930130-W-Australian_Open-F-Steffi_Graf-Monica_Seles,2,B-DTL,19,5,2,1,2,9,10
19930130-W-Australian_Open-F-Steffi_Graf-Monica_Seles,2,B-IO,12,2,0,0,2,5,7
19930130-W-Australian_Open-F-Steffi_Graf-Monica_Seles,2,B-II,1,1,1,0,0,1,0
19930130-W-Australian_Open-F-Steffi_Graf-Monica_Seles,2,S-XC,1,0,0,0,0,1,0
19930130-W-Australian_Open-F-Steffi_Graf-Monica_Seles,2,S-DTM,1,0,0,0,0,1,0
19930130-W-Australian_Open-F-Steffi_Graf-Monica_Seles,2,S-DTL,2,0,0,0,0,1,1
20140623-W-Wimbledon-R128-Maria_Sharapova-Samantha_Murray,1,F-XC,11,5,1,4,0,9,2
20140623-W-Wimbledon-R128-Maria_Sharapova-Samantha_Murray,1,F-DTM,6,1,0,0,1,1,5
20140623-W-Wimbledon-R128-Maria_Sharapova-Samantha_Murray,1,F-DTL,7,4,1,1,2,5,2
20140623-W-Wimbledon-R128-Maria_Sharapova-Samantha_Murray,1,F-IO,7,4,3,1,0,7,0
20140623-W-Wimbledon-R128-Maria_Sharapova-Samantha_Murray,1,F-II,1,1,1,0,0,1,0
20140623-W-Wimbledon-R128-Maria_Sharapova-Samantha_Murray,1,B-XC,14,1,0,0,1,11,3
20140623-W-Wimbledon-R128-Maria_Sharapova-Samantha_Murray,1,B-DTM,14,2,0,1,1,8,6
20140623-W-Wimbledon-R128-Maria_Sharapova-Samantha_Murray,1,B-DTL,3,0,0,0,0,1,2
20140623-W-Wimbledon-R128-Maria_Sharapova-Samantha_Murray,1,B-IO,4,2,1,0,1,2,2
20140623-W-Wimbledon-R128-Maria_Sharapova-Samantha_Murray,1,S-DTM,1,0,0,0,0,1,0
20140623-W-Wimbledon-R128-Maria_Sharapova-Samantha_Murray,2,F-XC,6,2,1,0,1,4,2
20140623-W-Wimbledon-R128-Maria_Sharapova-Samantha_Murray,2,F-DTM,6,1,0,0,1,1,5
20140623-W-Wimbledon-R128-Maria_Sharapova-Samantha_Murray,2,F-DTL,3,1,1,0,0,2,1
20140623-W-Wimbledon-R128-Maria_Sharapova-Samantha_Murray,2,F-IO,11,3,1,1,1,4,7
20140623-W-Wimbledon-R128-Maria_Sharapova-Samantha_Murray,2,B-XC,12,4,0,0,4,3,9
20140623-W-Wimbledon-R128-Maria_Sharapova-Samantha_Murray,2,B-DTM,13,1,0,0,1,1,12
20140623-W-Wimbledon-R128-Maria_Sharapova-Samantha_Murray,2,B-DTL,2,2,0,0,2,0,2
20140623-W-Wimbledon-R128-Maria_Sharapova-Samantha_Murray,2,B-IO,1,1,1,0,0,1,0
20140623-W-Wimbledon-R128-Maria_Sharapova-Samantha_Murray,2,S-DTM,1,0,0,0,0,0,1
20140623-W-Wimbledon-R128-Maria_Sharapova-Samantha_Murray,2,S-DTL,1,0,0,0,0,1,0
20120730-W-Olympics-R64-Maria_Sharapova-Shahar_Peer,1,F-XC,24,9,5,1,3,17,7
20120730-W-Olympics-R64-Maria_Sharapova-Shahar_Peer,1,F-DTM,13,2,0,0,2,8,5
20120730-W-Olympics-R64-Maria_Sharapova-Shahar_Peer,1,F-DTL,3,2,1,0,1,2,1
20120730-W-Olympics-R64-Maria_Sharapova-Shahar_Peer,1,F-IO,10,4,3,0,1,9,1
20120730-W-Olympics-R64-Maria_Sharapova-Shahar_Peer,1,B-XC,18,9,5,2,2,11,7
20120730-W-Olympics-R64-Maria_Sharapova-Shahar_Peer,1,B-DTM,8,2,0,0,2,1,7
20120730-W-Olympics-R64-Maria_Sharapova-Shahar_Peer,1,B-DTL,5,2,1,1,0,4,1
20120730-W-Olympics-R64-Maria_Sharapova-Shahar_Peer,1,S-DTM,1,0,0,0,0,0,1
20120730-W-Olympics-R64-Maria_Sharapova-Shahar_Peer,2,F-XC,17,4,1,0,3,6,11
20120730-W-Olympics-R64-Maria_Sharapova-Shahar_Peer,2,F-DTM,16,3,0,0,3,3,13
20120730-W-Olympics-R64-Maria_Sharapova-Shahar_Peer,2,F-DTL,2,0,0,0,0,1,1
20120730-W-Olympics-R64-Maria_Sharapova-Shahar_Peer,2,F-IO,4,2,0,1,1,1,3
20120730-W-Olympics-R64-Maria_Sharapova-Shahar_Peer,2,B-XC,8,3,1,1,1,3,5
20120730-W-Olympics-R64-Maria_Sharapova-Shahar_Peer,2,B-DTM,7,1,0,0,1,5,2
20120730-W-Olympics-R64-Maria_Sharapova-Shahar_Peer,2,B-DTL,2,1,0,1,0,1,1
20120730-W-Olympics-R64-Maria_Sharapova-Shahar_Peer,2,B-IO,2,0,0,0,0,0,2
20120730-W-Olympics-R64-Maria_Sharapova-Shahar_Peer,2,S-XC,4,0,0,0,0,2,2
20120730-W-Olympics-R64-Maria_Sharapova-Shahar_Peer,2,S-DTM,8,1,0,0,1,0,8
20120730-W-Olympics-R64-Maria_Sharapova-Shahar_Peer,2,S-DTL,1,0,0,0,0,1,0
20120730-W-Olympics-R64-Maria_Sharapova-Shahar_Peer,2,S-IO,2,0,0,0,0,2,0
20130626-W-Wimbledon-R64-Eugenie_Bouchard-Ana_Ivanovic,1,F-XC,28,14,3,7,4,15,13
20130626-W-Wimbledon-R64-Eugenie_Bouchard-Ana_Ivanovic,1,F-DTM,10,1,0,0,1,5,5
20130626-W-Wimbledon-R64-Eugenie_Bouchard-Ana_Ivanovic,1,F-DTL,7,2,1,1,0,3,4
20130626-W-Wimbledon-R64-Eugenie_Bouchard-Ana_Ivanovic,1,F-IO,10,4,4,0,0,7,3
20130626-W-Wimbledon-R64-Eugenie_Bouchard-Ana_Ivanovic,1,B-XC,20,5,1,2,2,13,7
20130626-W-Wimbledon-R64-Eugenie_Bouchard-Ana_Ivanovic,1,B-DTM,9,2,0,1,1,5,4
20130626-W-Wimbledon-R64-Eugenie_Bouchard-Ana_Ivanovic,1,B-DTL,1,1,0,1,0,1,0
20130626-W-Wimbledon-R64-Eugenie_Bouchard-Ana_Ivanovic,1,B-IO,3,2,1,0,1,2,1
20130626-W-Wimbledon-R64-Eugenie_Bouchard-Ana_Ivanovic,1,S-XC,1,0,0,0,0,0,1
20130626-W-Wimbledon-R64-Eugenie_Bouchard-Ana_Ivanovic,1,S-DTM,1,0,0,0,0,0,1
20130626-W-Wimbledon-R64-Eugenie_Bouchard-Ana_Ivanovic,2,F-XC,19,3,2,1,0,16,3
20130626-W-Wimbledon-R64-Eugenie_Bouchard-Ana_Ivanovic,2,F-DTM,5,1,0,0,1,1,4
20130626-W-Wimbledon-R64-Eugenie_Bouchard-Ana_Ivanovic,2,F-DTL,7,3,1,1,1,3,4
20130626-W-Wimbledon-R64-Eugenie_Bouchard-Ana_Ivanovic,2,F-IO,7,3,2,1,0,3,4
20130626-W-Wimbledon-R64-Eugenie_Bouchard-Ana_Ivanovic,2,F-II,2,1,0,1,0,2,0
20130626-W-Wimbledon-R64-Eugenie_Bouchard-Ana_Ivanovic,2,B-XC,13,3,1,1,1,6,7
20130626-W-Wimbledon-R64-Eugenie_Bouchard-Ana_Ivanovic,2,B-DTM,10,0,0,0,0,3,7
20130626-W-Wimbledon-R64-Eugenie_Bouchard-Ana_Ivanovic,2,B-DTL,6,2,2,0,0,5,1
20130626-W-Wimbledon-R64-Eugenie_Bouchard-Ana_Ivanovic,2,B-IO,2,1,0,0,1,0,2
20130626-W-Wimbledon-R64-Eugenie_Bouchard-Ana_Ivanovic,2,S-DTM,5,0,0,0,0,2,3
20130626-W-Wimbledon-R64-Eugenie_Bouchard-Ana_Ivanovic,2,S-DTL,3,0,0,0,0,0,3
20150123-W-Australian_Open-R32-Zarina_Diyas-Maria_Sharapova,1,F-XC,14,3,0,3,0,6,8
20150123-W-Australian_Open-R32-Zarina_Diyas-Maria_Sharapova,1,F-DTM,25,3,0,1,2,10,15
20150123-W-Australian_Open-R32-Zarina_Diyas-Maria_Sharapova,1,F-DTL,5,2,1,0,1,3,2
20150123-W-Australian_Open-R32-Zarina_Diyas-Maria_Sharapova,1,F-IO,6,2,0,1,1,3,3
20150123-W-Australian_Open-R32-Zarina_Diyas-Maria_Sharapova,1,F-II,1,1,1,0,0,1,0
20150123-W-Australian_Open-R32-Zarina_Diyas-Maria_Sharapova,1,B-XC,13,2,2,0,0,5,8
20150123-W-Australian_Open-R32-Zarina_Diyas-Maria_Sharapova,1,B-DTM,26,1,0,1,0,11,15
20150123-W-Australian_Open-R32-Zarina_Diyas-Maria_Sharapova,1,B-DTL,5,4,1,0,3,2,3
20150123-W-Australian_Open-R32-Zarina_Diyas-Maria_Sharapova,1,B-IO,6,2,1,1,0,4,2
20150123-W-Australian_Open-R32-Zarina_Diyas-Maria_Sharapova,1,S-XC,3,0,0,0,0,0,3
20150123-W-Australian_Open-R32-Zarina_Diyas-Maria_Sharapova,1,S-DTM,4,0,0,0,0,0,4
20150123-W-Australian_Open-R32-Zarina_Diyas-Maria_Sharapova,1,S-DTL,1,0,0,0,0,0,1
20150123-W-Australian_Open-R32-Zarina_Diyas-Maria_Sharapova,2,F-XC,33,10,2,4,4,21,12
20150123-W-Australian_Open-R32-Zarina_Diyas-Maria_Sharapova,2,F-DTM,10,0,0,0,0,5,5
20150123-W-Australian_Open-R32-Zarina_Diyas-Maria_Sharapova,2,F-DTL,4,1,0,0,1,2,2
20150123-W-Australian_Open-R32-Zarina_Diyas-Maria_Sharapova,2,F-IO,16,5,5,0,0,13,3
20150123-W-Australian_Open-R32-Zarina_Diyas-Maria_Sharapova,2,F-II,2,1,1,0,0,2,0
20150123-W-Australian_Open-R32-Zarina_Diyas-Maria_Sharapova,2,B-XC,19,3,1,2,0,15,4
20150123-W-Australian_Open-R32-Zarina_Diyas-Maria_Sharapova,2,B-DTM,13,1,0,0,1,2,11
20150123-W-Australian_Open-R32-Zarina_Diyas-Maria_Sharapova,2,B-DTL,1,1,0,1,0,1,0
20150123-W-Australian_Open-R32-Zarina_Diyas-Maria_Sharapova,2,B-IO,2,1,1,0,0,2,0
20150123-W-Australian_Open-R32-Zarina_Diyas-Maria_Sharapova,2,S-XC,1,0,0,0,0,0,1
20150123-W-Australian_Open-R32-Zarina_Diyas-Maria_Sharapova,2,S-DTM,1,0,0,0,0,1,0
19860216-W-Boca_Raton-F-Steffi_Graf-Chris_Evert,1,F-XC,44,8,1,2,5,21,23
19860216-W-Boca_Raton-F-Steffi_Graf-Chris_Evert,1,F-DTM,22,2,0,0,2,8,14
19860216-W-Boca_Raton-F-Steffi_Graf-Chris_Evert,1,F-DTL,21,9,1,4,4,10,11
19860216-W-Boca_Raton-F-Steffi_Graf-Chris_Evert,1,F-IO,34,13,5,2,6,14,20
19860216-W-Boca_Raton-F-Steffi_Graf-Chris_Evert,1,F-II,7,2,0,1,1,5,2
19860216-W-Boca_Raton-F-Steffi_Graf-Chris_Evert,1,B-XC,35,4,1,1,2,11,24
19860216-W-Boca_Raton-F-Steffi_Graf-Chris_Evert,1,B-DTM,17,1,0,0,1,5,12
19860216-W-Boca_Raton-F-Steffi_Graf-Chris_Evert,1,B-DTL,4,3,1,1,1,3,1
19860216-W-Boca_Raton-F-Steffi_Graf-Chris_Evert,1,S-XC,122,7,0,0,7,40,82
19860216-W-Boca_Raton-F-Steffi_Graf-Chris_Evert,1,S-DTM,42,5,0,0,4,9,33
19860216-W-Boca_Raton-F-Steffi_Graf-Chris_Evert,1,S-DTL,18,4,0,1,3,7,11
19860216-W-Boca_Raton-F-Steffi_Graf-Chris_Evert,1,S-IO,2,0,0,0,0,2,0
19860216-W-Boca_Raton-F-Steffi_Graf-Chris_Evert,2,F-XC,40,7,2,1,4,23,17
19860216-W-Boca_Raton-F-Steffi_Graf-Chris_Evert,2,F-DTM,13,0,0,0,0,6,7
19860216-W-Boca_Raton-F-Steffi_Graf-Chris_Evert,2,F-DTL,17,2,0,2,0,10,7
19860216-W-Boca_Raton-F-Steffi_Graf-Chris_Evert,2,F-IO,37,3,0,1,2,23,14
19860216-W-Boca_Raton-F-Steffi_Graf-Chris_Evert,2,B-XC,147,11,1,5,5,103,44
19860216-W-Boca_Raton-F-Steffi_Graf-Chris_Evert,2,B-DTM,25,0,0,0,0,17,8
19860216-W-Boca_Raton-F-Steffi_Graf-Chris_Evert,2,B-DTL,23,7,1,2,4,8,15
19860216-W-Boca_Raton-F-Steffi_Graf-Chris_Evert,2,B-IO,6,0,0,0,0,3,3
19860216-W-Boca_Raton-F-Steffi_Graf-Chris_Evert,2,S-XC,19,0,0,0,0,13,6
19860216-W-Boca_Raton-F-Steffi_Graf-Chris_Evert,2,S-DTM,5,1,0,1,0,2,3
19860216-W-Boca_Raton-F-Steffi_Graf-Chris_Evert,2,S-DTL,1,0,0,0,0,1,0
20020823-W-New_Haven-SF-Venus_Williams-Daniela_Hantuchova,1,F-XC,18,5,4,1,0,12,6
20020823-W-New_Haven-SF-Venus_Williams-Daniela_Hantuchova,1,F-DTM,6,0,0,0,0,3,3
20020823-W-New_Haven-SF-Venus_Williams-Daniela_Hantuchova,1,F-DTL,6,3,1,1,1,4,2
20020823-W-New_Haven-SF-Venus_Williams-Daniela_Hantuchova,1,F-IO,5,2,0,0,2,2,3
20020823-W-New_Haven-SF-Venus_Williams-Daniela_Hantuchova,1,B-XC,19,7,4,0,3,12,7
20020823-W-New_Haven-SF-Venus_Williams-Daniela_Hantuchova,1,B-DTM,12,3,0,1,2,6,6
20020823-W-New_Haven-SF-Venus_Williams-Daniela_Hantuchova,1,B-DTL,2,1,0,1,0,2,0
20020823-W-New_Haven-SF-Venus_Williams-Daniela_Hantuchova,1,B-IO,4,3,2,0,1,3,1
20020823-W-New_Haven-SF-Venus_Williams-Daniela_Hantuchova,1,S-XC,3,0,0,0,0,2,1
20020823-W-New_Haven-SF-Venus_Williams-Daniela_Hantuchova,2,F-XC,21,10,3,3,4,9,12
20020823-W-New_Haven-SF-Venus_Williams-Daniela_Hantuchova,2,F-DTM,9,0,0,0,0,5,4
20020823-W-New_Haven-SF-Venus_Williams-Daniela_Hantuchova,2,F-DTL,6,1,1,0,0,5,1
20020823-W-New_Haven-SF-Venus_Williams-Daniela_Hantuchova,2,F-IO,6,4,2,1,1,3,3
20020823-W-New_Haven-SF-Venus_Williams-Daniela_Hantuchova,2,B-XC,18,1,0,0,1,5,13
20020823-W-New_Haven-SF-Venus_Williams-Daniela_Hantuchova,2,B-DTM,8,2,0,0,2,3,5
20020823-W-New_Haven-SF-Venus_Williams-Daniela_Hantuchova,2,B-DTL,8,3,0,0,3,2,6
20020823-W-New_Haven-SF-Venus_Williams-Daniela_Hantuchova,2,B-IO,4,1,1,0,0,3,1
20020823-W-New_Haven-SF-Venus_Williams-Daniela_Hantuchova,2,S-DTM,1,0,0,0,0,1,0
20140110-W-Hobart-F-Garbine_Muguruza-Klara_Koukalova,1,F-XC,31,8,4,4,0,26,5
20140110-W-Hobart-F-Garbine_Muguruza-Klara_Koukalova,1,F-DTM,33,7,0,3,4,17,16
20140110-W-Hobart-F-Garbine_Muguruza-Klara_Koukalova,1,F-DTL,8,3,1,1,1,5,3
20140110-W-Hobart-F-Garbine_Muguruza-Klara_Koukalova,1,F-IO,13,8,2,2,4,7,6
20140110-W-Hobart-F-Garbine_Muguruza-Klara_Koukalova,1,B-XC,18,4,1,0,3,8,10
20140110-W-Hobart-F-Garbine_Muguruza-Klara_Koukalova,1,B-DTM,27,3,1,2,0,18,9
20140110-W-Hobart-F-Garbine_Muguruza-Klara_Koukalova,1,B-DTL,10,2,1,0,1,6,4
20140110-W-Hobart-F-Garbine_Muguruza-Klara_Koukalova,1,B-IO,9,3,2,0,1,6,3
20140110-W-Hobart-F-Garbine_Muguruza-Klara_Koukalova,2,F-XC,31,4,1,2,1,11,20
20140110-W-Hobart-F-Garbine_Muguruza-Klara_Koukalova,2,F-DTM,35,4,2,0,2,14,21
20140110-W-Hobart-F-Garbine_Muguruza-Klara_Koukalova,2,F-DTL,12,3,0,0,3,3,9
20140110-W-Hobart-F-Garbine_Muguruza-Klara_Koukalova,2,F-IO,6,3,2,0,1,4,2
20140110-W-Hobart-F-Garbine_Muguruza-Klara_Koukalova,2,B-XC,14,2,0,0,2,5,9
20140110-W-Hobart-F-Garbine_Muguruza-Klara_Koukalova,2,B-DTM,21,4,0,1,3,7,14
20140110-W-Hobart-F-Garbine_Muguruza-Klara_Koukalova,2,B-DTL,7,1,1,0,0,3,4
20140110-W-Hobart-F-Garbine_Muguruza-Klara_Koukalova,2,B-IO,2,1,0,1,0,1,1
20140110-W-Hobart-F-Garbine_Muguruza-Klara_Koukalova,2,S-XC,1,0,0,0,0,1,0
20140110-W-Hobart-F-Garbine_Muguruza-Klara_Koukalova,2,S-DTM,2,1,0,1,0,2,0
20060903-W-US_Open-R16-Justine_Henin-Shahar_Peer,1,F-XC,20,6,3,2,1,16,4
20060903-W-US_Open-R16-Justine_Henin-Shahar_Peer,1,F-DTM,15,1,0,1,0,12,3
20060903-W-US_Open-R16-Justine_Henin-Shahar_Peer,1,F-DTL,1,0,0,0,0,1,0
20060903-W-US_Open-R16-Justine_Henin-Shahar_Peer,1,F-IO,8,3,1,1,1,7,1
20060903-W-US_Open-R16-Justine_Henin-Shahar_Peer,1,F-II,1,1,0,1,0,1,0
20060903-W-US_Open-R16-Justine_Henin-Shahar_Peer,1,B-XC,5,1,0,1,0,5,0
20060903-W-US_Open-R16-Justine_Henin-Shahar_Peer,1,B-DTM,11,2,0,2,0,9,2
20060903-W-US_Open-R16-Justine_Henin-Shahar_Peer,1,B-DTL,4,3,1,1,1,3,1
20060903-W-US_Open-R16-Justine_Henin-Shahar_Peer,1,B-IO,2,0,0,0,0,1,1
20060903-W-US_Open-R16-Justine_Henin-Shahar_Peer,1,S-XC,5,0,0,0,0,3,2
20060903-W-US_Open-R16-Justine_Henin-Shahar_Peer,1,S-DTM,5,0,0,0,0,3,2
20060903-W-US_Open-R16-Justine_Henin-Shahar_Peer,2,F-XC,17,9,1,2,6,4,13
20060903-W-US_Open-R16-Justine_Henin-Shahar_Peer,2,F-DTM,22,1,0,0,1,7,15
20060903-W-US_Open-R16-Justine_Henin-Shahar_Peer,2,F-DTL,5,1,0,1,0,2,3
20060903-W-US_Open-R16-Justine_Henin-Shahar_Peer,2,F-IO,11,3,0,0,3,1,10
20060903-W-US_Open-R16-Justine_Henin-Shahar_Peer,2,F-II,1,0,0,0,0,0,1
20060903-W-US_Open-R16-Justine_Henin-Shahar_Peer,2,B-XC,13,3,0,1,2,2,11
20060903-W-US_Open-R16-Justine_Henin-Shahar_Peer,2,B-DTM,11,1,0,0,1,0,11
20060903-W-US_Open-R16-Justine_Henin-Shahar_Peer,2,B-DTL,3,0,0,0,0,0,3
20060903-W-US_Open-R16-Justine_Henin-Shahar_Peer,2,B-IO,4,2,0,1,1,2,2
20060903-W-US_Open-R16-Justine_Henin-Shahar_Peer,2,S-XC,3,0,0,0,0,1,2
20060903-W-US_Open-R16-Justine_Henin-Shahar_Peer,2,S-DTM,1,0,0,0,0,0,1
20060903-W-US_Open-R16-Justine_Henin-Shahar_Peer,2,S-DTL,1,0,0,0,0,0,1
20070902-W-US_Open-R16-Dinara_Safina-Justine_Henin,1,F-XC,20,4,3,0,1,9,11
20070902-W-US_Open-R16-Dinara_Safina-Justine_Henin,1,F-DTM,13,5,0,2,3,3,10
20070902-W-US_Open-R16-Dinara_Safina-Justine_Henin,1,F-DTL,10,5,0,2,3,4,6
20070902-W-US_Open-R16-Dinara_Safina-Justine_Henin,1,F-IO,9,3,2,0,1,3,6
20070902-W-US_Open-R16-Dinara_Safina-Justine_Henin,1,B-XC,18,3,1,0,2,11,7
20070902-W-US_Open-R16-Dinara_Safina-Justine_Henin,1,B-DTM,10,2,0,0,2,3,7
20070902-W-US_Open-R16-Dinara_Safina-Justine_Henin,1,B-DTL,1,1,0,0,1,0,1
20070902-W-US_Open-R16-Dinara_Safina-Justine_Henin,1,B-IO,7,4,1,0,3,2,5
20070902-W-US_Open-R16-Dinara_Safina-Justine_Henin,1,S-XC,4,0,0,0,0,1,3
20070902-W-US_Open-R16-Dinara_Safina-Justine_Henin,1,S-DTL,2,0,0,0,0,0,2
20070902-W-US_Open-R16-Dinara_Safina-Justine_Henin,1,S-IO,3,0,0,0,0,0,3
20070902-W-US_Open-R16-Dinara_Safina-Justine_Henin,2,F-XC,16,2,1,1,0,11,5
20070902-W-US_Open-R16-Dinara_Safina-Justine_Henin,2,F-DTM,17,1,0,0,1,10,7
20070902-W-US_Open-R16-Dinara_Safina-Justine_Henin,2,F-DTL,6,3,1,1,1,4,2
20070902-W-US_Open-R16-Dinara_Safina-Justine_Henin,2,F-IO,4,2,1,1,0,4,0
20070902-W-US_Open-R16-Dinara_Safina-Justine_Henin,2,F-II,1,1,0,0,1,0,1
20070902-W-US_Open-R16-Dinara_Safina-Justine_Henin,2,B-XC,11,5,1,2,2,6,5
20070902-W-US_Open-R16-Dinara_Safina-Justine_Henin,2,B-DTM,19,3,0,2,1,10,9
20070902-W-US_Open-R16-Dinara_Safina-Justine_Henin,2,B-DTL,4,2,1,1,0,3,1
20070902-W-US_Open-R16-Dinara_Safina-Justine_Henin,2,B-IO,1,1,0,0,1,0,1
20070902-W-US_Open-R16-Dinara_Safina-Justine_Henin,2,S-XC,2,0,0,0,0,1,1
20070902-W-US_Open-R16-Dinara_Safina-Justine_Henin,2,S-DTM,5,0,0,0,0,3,2
20070831-W-US_Open-R32-Justine_Henin-Ekaterina_Makarova,1,F-XC,28,6,3,2,1,23,5
20070831-W-US_Open-R32-Justine_Henin-Ekaterina_Makarova,1,F-DTM,16,1,0,0,1,10,6
20070831-W-US_Open-R32-Justine_Henin-Ekaterina_Makarova,1,F-DTL,3,1,1,0,0,2,1
20070831-W-US_Open-R32-Justine_Henin-Ekaterina_Makarova,1,F-IO,8,3,1,2,0,8,0
20070831-W-US_Open-R32-Justine_Henin-Ekaterina_Makarova,1,F-II,1,1,1,0,0,1,0
20070831-W-US_Open-R32-Justine_Henin-Ekaterina_Makarova,1,B-XC,13,3,0,1,2,7,6
20070831-W-US_Open-R32-Justine_Henin-Ekaterina_Makarova,1,B-DTM,5,2,0,1,1,4,1
20070831-W-US_Open-R32-Justine_Henin-Ekaterina_Makarova,1,B-DTL,3,1,1,0,0,3,0
20070831-W-US_Open-R32-Justine_Henin-Ekaterina_Makarova,1,B-IO,2,0,0,0,0,1,1
20070831-W-US_Open-R32-Justine_Henin-Ekaterina_Makarova,1,S-XC,4,1,1,0,0,4,0
20070831-W-US_Open-R32-Justine_Henin-Ekaterina_Makarova,1,S-DTM,2,0,0,0,0,0,2
20070831-W-US_Open-R32-Justine_Henin-Ekaterina_Makarova,2,F-XC,15,5,1,1,3,6,9
20070831-W-US_Open-R32-Justine_Henin-Ekaterina_Makarova,2,F-DTM,19,1,0,0,1,5,14
20070831-W-US_Open-R32-Justine_Henin-Ekaterina_Makarova,2,F-DTL,9,4,2,1,1,3,6
20070831-W-US_Open-R32-Justine_Henin-Ekaterina_Makarova,2,F-IO,5,3,0,1,2,1,4
20070831-W-US_Open-R32-Justine_Henin-Ekaterina_Makarova,2,B-XC,25,9,1,1,7,9,16
20070831-W-US_Open-R32-Justine_Henin-Ekaterina_Makarova,2,B-DTM,18,0,0,0,0,6,12
20070831-W-US_Open-R32-Justine_Henin-Ekaterina_Makarova,2,B-DTL,14,6,0,0,6,3,11
20070831-W-US_Open-R32-Justine_Henin-Ekaterina_Makarova,2,B-IO,9,4,2,1,1,4,5
20070831-W-US_Open-R32-Justine_Henin-Ekaterina_Makarova,2,S-DTL,1,0,0,0,0,0,1
20160104-W-Brisbane-R32-Sara_Errani-Belinda_Bencic,1,F-XC,24,3,1,0,2,10,14
20160104-W-Brisbane-R32-Sara_Errani-Belinda_Bencic,1,F-DTM,32,1,0,0,1,10,22
20160104-W-Brisbane-R32-Sara_Errani-Belinda_Bencic,1,F-DTL,5,2,0,1,1,2,3
20160104-W-Brisbane-R32-Sara_Errani-Belinda_Bencic,1,F-IO,4,3,1,0,2,1,3
20160104-W-Brisbane-R32-Sara_Errani-Belinda_Bencic,1,B-XC,11,1,1,0,0,5,6
20160104-W-Brisbane-R32-Sara_Errani-Belinda_Bencic,1,B-DTM,35,4,0,1,3,12,23
20160104-W-Brisbane-R32-Sara_Errani-Belinda_Bencic,1,B-DTL,5,1,1,0,0,1,4
20160104-W-Brisbane-R32-Sara_Errani-Belinda_Bencic,1,B-IO,1,0,0,0,0,0,1
20160104-W-Brisbane-R32-Sara_Errani-Belinda_Bencic,1,S-DTM,9,0,0,0,0,1,8
20160104-W-Brisbane-R32-Sara_Errani-Belinda_Bencic,1,S-DTL,5,0,0,0,0,1,4
20160104-W-Brisbane-R32-Sara_Errani-Belinda_Bencic,1,S-IO,1,0,0,0,0,1,0
20160104-W-Brisbane-R32-Sara_Errani-Belinda_Bencic,2,F-XC,34,10,8,2,0,26,8
20160104-W-Brisbane-R32-Sara_Errani-Belinda_Bencic,2,F-DTM,24,1,0,1,0,14,10
20160104-W-Brisbane-R32-Sara_Errani-Belinda_Bencic,2,F-DTL,9,3,2,0,1,7,2
20160104-W-Brisbane-R32-Sara_Errani-Belinda_Bencic,2,F-IO,17,8,3,0,5,8,9
20160104-W-Brisbane-R32-Sara_Errani-Belinda_Bencic,2,B-XC,14,0,0,0,0,13,1
20160104-W-Brisbane-R32-Sara_Errani-Belinda_Bencic,2,B-DTM,23,4,0,0,4,11,12
20160104-W-Brisbane-R32-Sara_Errani-Belinda_Bencic,2,B-DTL,4,2,2,0,0,4,0
20160104-W-Brisbane-R32-Sara_Errani-Belinda_Bencic,2,B-IO,11,6,4,1,1,8,3
20160104-W-Brisbane-R32-Roberta_Vinci-Jelena_Jankovic,1,F-XC,50,9,3,3,3,33,17
20160104-W-Brisbane-R32-Roberta_Vinci-Jelena_Jankovic,1,F-DTM,41,2,0,1,1,18,23
20160104-W-Brisbane-R32-Roberta_Vinci-Jelena_Jankovic,1,F-DTL,16,9,4,1,4,11,5
20160104-W-Brisbane-R32-Roberta_Vinci-Jelena_Jankovic,1,F-IO,19,8,6,0,2,12,7
20160104-W-Brisbane-R32-Roberta_Vinci-Jelena_Jankovic,1,F-II,1,0,0,0,0,0,1
20160104-W-Brisbane-R32-Roberta_Vinci-Jelena_Jankovic,1,B-XC,3,2,0,2,0,2,1
20160104-W-Brisbane-R32-Roberta_Vinci-Jelena_Jankovic,1,B-DTM,8,0,0,0,0,7,1
20160104-W-Brisbane-R32-Roberta_Vinci-Jelena_Jankovic,1,B-DTL,1,1,1,0,0,1,0
20160104-W-Brisbane-R32-Roberta_Vinci-Jelena_Jankovic,1,S-XC,42,1,0,1,0,27,15
20160104-W-Brisbane-R32-Roberta_Vinci-Jelena_Jankovic,1,S-DTM,66,4,0,0,4,21,45
20160104-W-Brisbane-R32-Roberta_Vinci-Jelena_Jankovic,1,S-DTL,20,5,3,0,2,12,8
20160104-W-Brisbane-R32-Roberta_Vinci-Jelena_Jankovic,1,S-IO,7,0,0,0,0,3,4
20160104-W-Brisbane-R32-Roberta_Vinci-Jelena_Jankovic,2,F-XC,44,9,3,3,3,21,23
20160104-W-Brisbane-R32-Roberta_Vinci-Jelena_Jankovic,2,F-DTM,31,2,0,0,2,12,19
20160104-W-Brisbane-R32-Roberta_Vinci-Jelena_Jankovic,2,F-DTL,24,4,0,0,4,10,14
20160104-W-Brisbane-R32-Roberta_Vinci-Jelena_Jankovic,2,F-IO,33,3,1,0,2,16,17
20160104-W-Brisbane-R32-Roberta_Vinci-Jelena_Jankovic,2,F-II,1,1,1,0,0,1,0
20160104-W-Brisbane-R32-Roberta_Vinci-Jelena_Jankovic,2,B-XC,51,8,3,1,4,29,22
20160104-W-Brisbane-R32-Roberta_Vinci-Jelena_Jankovic,2,B-DTM,31,1,0,0,1,15,16
20160104-W-Brisbane-R32-Roberta_Vinci-Jelena_Jankovic,2,B-DTL,24,11,7,1,3,14,10
20160104-W-Brisbane-R32-Roberta_Vinci-Jelena_Jankovic,2,B-IO,21,10,7,1,2,16,5
20160104-W-Brisbane-R32-Roberta_Vinci-Jelena_Jankovic,2,S-XC,4,0,0,0,0,2,2
20160104-W-Brisbane-R32-Roberta_Vinci-Jelena_Jankovic,2,S-DTM,5,0,0,0,0,0,5
20160104-W-Brisbane-R32-Roberta_Vinci-Jelena_Jankovic,2,S-DTL,1,0,0,0,0,0,1
20160104-W-Brisbane-R32-Roberta_Vinci-Jelena_Jankovic,2,S-IO,4,1,0,1,0,3,1
20160103-W-Brisbane-R32-Anastasia_Pavlyuchenkova-Timea_Bacsinszky,1,F-XC,25,11,7,2,2,22,3
20160103-W-Brisbane-R32-Anastasia_Pavlyuchenkova-Timea_Bacsinszky,1,F-DTM,11,2,1,0,1,9,2
20160103-W-Brisbane-R32-Anastasia_Pavlyuchenkova-Timea_Bacsinszky,1,F-DTL,7,5,4,0,1,5,2
20160103-W-Brisbane-R32-Anastasia_Pavlyuchenkova-Timea_Bacsinszky,1,F-IO,6,5,4,1,0,6,0
20160103-W-Brisbane-R32-Anastasia_Pavlyuchenkova-Timea_Bacsinszky,1,B-XC,10,5,3,1,1,8,2
20160103-W-Brisbane-R32-Anastasia_Pavlyuchenkova-Timea_Bacsinszky,1,B-DTM,18,0,0,0,0,8,10
20160103-W-Brisbane-R32-Anastasia_Pavlyuchenkova-Timea_Bacsinszky,1,B-DTL,3,2,1,1,0,2,1
20160103-W-Brisbane-R32-Anastasia_Pavlyuchenkova-Timea_Bacsinszky,1,B-IO,7,3,2,0,1,5,2
20160103-W-Brisbane-R32-Anastasia_Pavlyuchenkova-Timea_Bacsinszky,2,F-XC,12,4,2,2,0,7,5
20160103-W-Brisbane-R32-Anastasia_Pavlyuchenkova-Timea_Bacsinszky,2,F-DTM,12,1,0,0,1,3,9
20160103-W-Brisbane-R32-Anastasia_Pavlyuchenkova-Timea_Bacsinszky,2,F-DTL,5,3,1,0,2,1,4
20160103-W-Brisbane-R32-Anastasia_Pavlyuchenkova-Timea_Bacsinszky,2,F-IO,5,3,1,0,2,1,4
20160103-W-Brisbane-R32-Anastasia_Pavlyuchenkova-Timea_Bacsinszky,2,B-XC,5,2,0,0,2,2,3
20160103-W-Brisbane-R32-Anastasia_Pavlyuchenkova-Timea_Bacsinszky,2,B-DTM,18,4,0,0,4,4,14
20160103-W-Brisbane-R32-Anastasia_Pavlyuchenkova-Timea_Bacsinszky,2,B-IO,5,2,2,0,0,2,3
20160103-W-Brisbane-R32-Anastasia_Pavlyuchenkova-Timea_Bacsinszky,2,S-XC,2,0,0,0,0,2,0
20160103-W-Brisbane-R32-Anastasia_Pavlyuchenkova-Timea_Bacsinszky,2,S-DTM,1,0,0,0,0,0,1
20160103-W-Brisbane-R32-Anastasia_Pavlyuchenkova-Timea_Bacsinszky,2,S-DTL,1,0,0,0,0,0,1
20160103-W-Brisbane-R32-Anastasia_Pavlyuchenkova-Timea_Bacsinszky,2,S-IO,1,0,0,0,0,1,0
20150123-W-Australian_Open-R32-Eugenie_Bouchard-Caroline_Garcia,1,F-XC,26,9,4,3,2,15,11
20150123-W-Australian_Open-R32-Eugenie_Bouchard-Caroline_Garcia,1,F-DTM,10,2,0,0,2,3,7
20150123-W-Australian_Open-R32-Eugenie_Bouchard-Caroline_Garcia,1,F-DTL,4,3,1,1,1,2,2
20150123-W-Australian_Open-R32-Eugenie_Bouchard-Caroline_Garcia,1,F-IO,9,4,2,1,1,5,4
20150123-W-Australian_Open-R32-Eugenie_Bouchard-Caroline_Garcia,1,B-XC,21,7,1,3,3,10,11
20150123-W-Australian_Open-R32-Eugenie_Bouchard-Caroline_Garcia,1,B-DTM,22,6,0,2,4,7,15
20150123-W-Australian_Open-R32-Eugenie_Bouchard-Caroline_Garcia,1,B-DTL,4,3,1,1,1,2,2
20150123-W-Australian_Open-R32-Eugenie_Bouchard-Caroline_Garcia,1,B-IO,3,1,0,0,1,1,2
20150123-W-Australian_Open-R32-Eugenie_Bouchard-Caroline_Garcia,1,S-XC,3,0,0,0,0,3,0
20150123-W-Australian_Open-R32-Eugenie_Bouchard-Caroline_Garcia,1,S-DTM,2,0,0,0,0,1,1
20150123-W-Australian_Open-R32-Eugenie_Bouchard-Caroline_Garcia,1,S-DTL,1,1,0,0,1,0,1
20150123-W-Australian_Open-R32-Eugenie_Bouchard-Caroline_Garcia,1,S-IO,1,0,0,0,0,1,0
20150123-W-Australian_Open-R32-Eugenie_Bouchard-Caroline_Garcia,2,F-XC,25,8,1,3,4,12,13
20150123-W-Australian_Open-R32-Eugenie_Bouchard-Caroline_Garcia,2,F-DTM,21,5,0,3,2,13,8
20150123-W-Australian_Open-R32-Eugenie_Bouchard-Caroline_Garcia,2,F-DTL,9,3,1,1,1,5,4
20150123-W-Australian_Open-R32-Eugenie_Bouchard-Caroline_Garcia,2,F-IO,8,4,4,0,0,6,2
20150123-W-Australian_Open-R32-Eugenie_Bouchard-Caroline_Garcia,2,B-XC,26,9,0,4,5,13,13
20150123-W-Australian_Open-R32-Eugenie_Bouchard-Caroline_Garcia,2,B-DTM,9,2,0,0,2,2,7
20150123-W-Australian_Open-R32-Eugenie_Bouchard-Caroline_Garcia,2,B-DTL,5,2,1,0,1,4,1
20150123-W-Australian_Open-R32-Eugenie_Bouchard-Caroline_Garcia,2,B-IO,2,1,0,0,1,1,1
20150123-W-Australian_Open-R32-Eugenie_Bouchard-Caroline_Garcia,2,S-XC,1,0,0,0,0,1,0
20150123-W-Australian_Open-R32-Eugenie_Bouchard-Caroline_Garcia,2,S-DTM,1,0,0,0,0,0,1
20160104-W-Brisbane-R32-Elena_Vesnina-Victoria_Azarenka,1,F-XC,37,12,1,3,8,14,23
20160104-W-Brisbane-R32-Elena_Vesnina-Victoria_Azarenka,1,F-DTM,6,0,0,0,0,1,5
20160104-W-Brisbane-R32-Elena_Vesnina-Victoria_Azarenka,1,F-DTL,16,7,2,2,3,9,7
20160104-W-Brisbane-R32-Elena_Vesnina-Victoria_Azarenka,1,F-IO,10,1,0,0,1,3,7
20160104-W-Brisbane-R32-Elena_Vesnina-Victoria_Azarenka,1,B-XC,32,8,3,1,4,15,17
20160104-W-Brisbane-R32-Elena_Vesnina-Victoria_Azarenka,1,B-DTM,9,1,0,0,1,3,6
20160104-W-Brisbane-R32-Elena_Vesnina-Victoria_Azarenka,1,B-DTL,17,9,4,1,4,8,9
20160104-W-Brisbane-R32-Elena_Vesnina-Victoria_Azarenka,1,B-IO,6,2,0,0,2,2,4
20160104-W-Brisbane-R32-Elena_Vesnina-Victoria_Azarenka,1,S-DTM,1,0,0,0,0,0,1
20160104-W-Brisbane-R32-Elena_Vesnina-Victoria_Azarenka,1,S-DTL,3,0,0,0,0,0,3
20160104-W-Brisbane-R32-Elena_Vesnina-Victoria_Azarenka,2,F-XC,29,5,1,1,3,16,13
20160104-W-Brisbane-R32-Elena_Vesnina-Victoria_Azarenka,2,F-DTM,7,1,0,1,0,4,3
20160104-W-Brisbane-R32-Elena_Vesnina-Victoria_Azarenka,2,F-DTL,16,6,2,2,2,8,8
20160104-W-Brisbane-R32-Elena_Vesnina-Victoria_Azarenka,2,F-IO,6,1,0,0,1,2,4
20160104-W-Brisbane-R32-Elena_Vesnina-Victoria_Azarenka,2,B-XC,27,6,1,2,3,17,10
20160104-W-Brisbane-R32-Elena_Vesnina-Victoria_Azarenka,2,B-DTM,23,1,0,1,0,13,10
20160104-W-Brisbane-R32-Elena_Vesnina-Victoria_Azarenka,2,B-DTL,6,3,3,0,0,4,2
20160104-W-Brisbane-R32-Elena_Vesnina-Victoria_Azarenka,2,B-IO,6,2,2,0,0,4,2
20160104-W-Brisbane-R32-Elena_Vesnina-Victoria_Azarenka,2,S-XC,3,0,0,0,0,2,1
20160104-W-Brisbane-R32-Elena_Vesnina-Victoria_Azarenka,2,S-DTM,4,0,0,0,0,2,2
20160104-W-Brisbane-R32-Elena_Vesnina-Victoria_Azarenka,2,S-DTL,2,0,0,0,0,0,2
20160104-W-Auckland-R32-Jelena_Ostapenko-Johanna_Larsson,1,F-XC,47,21,9,6,6,30,17
20160104-W-Auckland-R32-Jelena_Ostapenko-Johanna_Larsson,1,F-DTM,20,3,0,0,3,9,11
20160104-W-Auckland-R32-Jelena_Ostapenko-Johanna_Larsson,1,F-DTL,3,2,2,0,0,3,0
20160104-W-Auckland-R32-Jelena_Ostapenko-Johanna_Larsson,1,F-IO,18,10,6,0,4,10,8
20160104-W-Auckland-R32-Jelena_Ostapenko-Johanna_Larsson,1,B-XC,33,14,1,5,8,19,14
20160104-W-Auckland-R32-Jelena_Ostapenko-Johanna_Larsson,1,B-DTM,16,1,0,1,0,13,3
20160104-W-Auckland-R32-Jelena_Ostapenko-Johanna_Larsson,1,B-DTL,2,1,0,0,1,1,1
20160104-W-Auckland-R32-Jelena_Ostapenko-Johanna_Larsson,1,B-IO,2,0,0,0,0,2,0
20160104-W-Auckland-R32-Jelena_Ostapenko-Johanna_Larsson,1,S-XC,1,0,0,0,0,0,1
20160104-W-Auckland-R32-Jelena_Ostapenko-Johanna_Larsson,1,S-DTM,1,0,0,0,0,1,0
20160104-W-Auckland-R32-Jelena_Ostapenko-Johanna_Larsson,2,F-XC,15,0,0,0,0,5,10
20160104-W-Auckland-R32-Jelena_Ostapenko-Johanna_Larsson,2,F-DTM,32,5,0,1,4,15,17
20160104-W-Auckland-R32-Jelena_Ostapenko-Johanna_Larsson,2,F-DTL,2,0,0,0,0,1,1
20160104-W-Auckland-R32-Jelena_Ostapenko-Johanna_Larsson,2,F-IO,5,1,1,0,0,1,4
20160104-W-Auckland-R32-Jelena_Ostapenko-Johanna_Larsson,2,B-XC,8,2,0,1,1,2,6
20160104-W-Auckland-R32-Jelena_Ostapenko-Johanna_Larsson,2,B-DTM,17,1,0,0,1,7,10
20160104-W-Auckland-R32-Jelena_Ostapenko-Johanna_Larsson,2,B-DTL,3,1,1,0,0,1,2
20160104-W-Auckland-R32-Jelena_Ostapenko-Johanna_Larsson,2,B-IO,2,2,1,1,0,2,0
20160104-W-Auckland-R32-Jelena_Ostapenko-Johanna_Larsson,2,S-XC,11,2,0,0,2,6,5
20160104-W-Auckland-R32-Jelena_Ostapenko-Johanna_Larsson,2,S-DTM,16,0,0,0,0,5,11
20160104-W-Auckland-R32-Jelena_Ostapenko-Johanna_Larsson,2,S-DTL,3,1,0,0,1,1,2
20160104-W-Auckland-R32-Jelena_Ostapenko-Johanna_Larsson,2,S-IO,1,0,0,0,0,0,1
20160104-W-Auckland-R32-Polona_Hercog-Sloane_Stephens,1,F-XC,36,11,1,3,7,16,20
20160104-W-Auckland-R32-Polona_Hercog-Sloane_Stephens,1,F-DTM,45,8,0,1,7,15,30
20160104-W-Auckland-R32-Polona_Hercog-Sloane_Stephens,1,F-DTL,5,4,0,1,3,1,4
20160104-W-Auckland-R32-Polona_Hercog-Sloane_Stephens,1,F-IO,21,6,1,2,3,8,13
20160104-W-Auckland-R32-Polona_Hercog-Sloane_Stephens,1,F-II,3,3,0,1,2,1,2
20160104-W-Auckland-R32-Polona_Hercog-Sloane_Stephens,1,B-XC,23,4,1,0,3,10,13
20160104-W-Auckland-R32-Polona_Hercog-Sloane_Stephens,1,B-DTM,16,0,0,0,0,9,7
20160104-W-Auckland-R32-Polona_Hercog-Sloane_Stephens,1,B-DTL,1,1,0,0,1,0,1
20160104-W-Auckland-R32-Polona_Hercog-Sloane_Stephens,1,B-IO,1,0,0,0,0,1,0
20160104-W-Auckland-R32-Polona_Hercog-Sloane_Stephens,1,S-XC,11,0,0,0,0,4,7
20160104-W-Auckland-R32-Polona_Hercog-Sloane_Stephens,1,S-DTM,11,0,0,0,0,3,8
20160104-W-Auckland-R32-Polona_Hercog-Sloane_Stephens,2,F-XC,30,10,1,3,6,11,19
20160104-W-Auckland-R32-Polona_Hercog-Sloane_Stephens,2,F-DTM,37,1,0,1,0,23,14
20160104-W-Auckland-R32-Polona_Hercog-Sloane_Stephens,2,F-DTL,1,0,0,0,0,0,1
20160104-W-Auckland-R32-Polona_Hercog-Sloane_Stephens,2,F-IO,17,4,1,1,2,11,6
20160104-W-Auckland-R32-Polona_Hercog-Sloane_Stephens,2,B-XC,36,2,1,0,1,21,15
20160104-W-Auckland-R32-Polona_Hercog-Sloane_Stephens,2,B-DTM,25,5,0,0,5,13,12
20160104-W-Auckland-R32-Polona_Hercog-Sloane_Stephens,2,B-DTL,4,2,1,0,1,3,1
20160104-W-Auckland-R32-Polona_Hercog-Sloane_Stephens,2,B-IO,7,4,3,1,0,6,1
20160104-W-Auckland-R32-Polona_Hercog-Sloane_Stephens,2,S-XC,3,0,0,0,0,2,1
20160104-W-Auckland-R32-Polona_Hercog-Sloane_Stephens,2,S-DTM,3,0,0,0,0,2,1
20160105-W-Auckland-R32-Venus_Williams-Daria_Kasatkina,1,F-XC,47,13,4,2,7,23,24
20160105-W-Auckland-R32-Venus_Williams-Daria_Kasatkina,1,F-DTM,50,10,0,0,10,16,34
20160105-W-Auckland-R32-Venus_Williams-Daria_Kasatkina,1,F-DTL,10,5,2,0,3,6,4
20160105-W-Auckland-R32-Venus_Williams-Daria_Kasatkina,1,F-IO,43,27,11,1,15,18,25
20160105-W-Auckland-R32-Venus_Williams-Daria_Kasatkina,1,B-XC,41,8,2,0,6,26,15
20160105-W-Auckland-R32-Venus_Williams-Daria_Kasatkina,1,B-DTM,32,2,0,0,2,15,17
20160105-W-Auckland-R32-Venus_Williams-Daria_Kasatkina,1,B-DTL,6,5,2,0,3,2,4
20160105-W-Auckland-R32-Venus_Williams-Daria_Kasatkina,1,B-IO,11,4,2,0,2,5,6
20160105-W-Auckland-R32-Venus_Williams-Daria_Kasatkina,1,S-XC,3,0,0,0,0,2,1
20160105-W-Auckland-R32-Venus_Williams-Daria_Kasatkina,1,S-DTM,8,1,0,0,1,1,7
20160105-W-Auckland-R32-Venus_Williams-Daria_Kasatkina,2,F-XC,29,6,3,1,2,19,10
20160105-W-Auckland-R32-Venus_Williams-Daria_Kasatkina,2,F-DTM,48,9,1,0,8,26,22
20160105-W-Auckland-R32-Venus_Williams-Daria_Kasatkina,2,F-DTL,9,5,3,0,2,3,6
20160105-W-Auckland-R32-Venus_Williams-Daria_Kasatkina,2,F-IO,33,8,2,1,5,18,15
20160105-W-Auckland-R32-Venus_Williams-Daria_Kasatkina,2,F-II,1,1,1,0,0,1,0
20160105-W-Auckland-R32-Venus_Williams-Daria_Kasatkina,2,B-XC,18,5,1,0,4,7,11
20160105-W-Auckland-R32-Venus_Williams-Daria_Kasatkina,2,B-DTM,65,4,1,0,3,37,28
20160105-W-Auckland-R32-Venus_Williams-Daria_Kasatkina,2,B-DTL,12,5,2,1,2,4,8
20160105-W-Auckland-R32-Venus_Williams-Daria_Kasatkina,2,B-IO,8,5,2,2,1,6,2
20160105-W-Auckland-R32-Venus_Williams-Daria_Kasatkina,2,B-II,1,1,0,0,1,0,1
20160105-W-Auckland-R32-Venus_Williams-Daria_Kasatkina,2,S-XC,8,1,0,0,1,3,5
20160105-W-Auckland-R32-Venus_Williams-Daria_Kasatkina,2,S-DTM,15,0,0,0,0,8,7
20160105-W-Auckland-R32-Venus_Williams-Daria_Kasatkina,2,S-IO,1,1,1,0,0,1,0
20160105-W-Brisbane-R16-Samantha_Stosur-Carla_Suarez_Navarro,1,F-XC,34,13,5,2,6,18,16
20160105-W-Brisbane-R16-Samantha_Stosur-Carla_Suarez_Navarro,1,F-DTM,14,2,0,1,1,7,7
20160105-W-Brisbane-R16-Samantha_Stosur-Carla_Suarez_Navarro,1,F-DTL,6,4,1,1,2,2,4
20160105-W-Brisbane-R16-Samantha_Stosur-Carla_Suarez_Navarro,1,F-IO,31,10,5,1,4,22,9
20160105-W-Brisbane-R16-Samantha_Stosur-Carla_Suarez_Navarro,1,F-II,7,3,0,0,3,2,5
20160105-W-Brisbane-R16-Samantha_Stosur-Carla_Suarez_Navarro,1,B-XC,10,1,0,0,1,2,8
20160105-W-Brisbane-R16-Samantha_Stosur-Carla_Suarez_Navarro,1,B-DTM,24,1,0,0,1,12,12
20160105-W-Brisbane-R16-Samantha_Stosur-Carla_Suarez_Navarro,1,B-DTL,11,5,3,2,0,5,6
20160105-W-Brisbane-R16-Samantha_Stosur-Carla_Suarez_Navarro,1,B-IO,4,4,1,0,3,1,3
20160105-W-Brisbane-R16-Samantha_Stosur-Carla_Suarez_Navarro,1,S-XC,16,2,0,0,2,6,10
20160105-W-Brisbane-R16-Samantha_Stosur-Carla_Suarez_Navarro,1,S-DTM,12,2,0,0,2,4,8
20160105-W-Brisbane-R16-Samantha_Stosur-Carla_Suarez_Navarro,1,S-DTL,2,1,0,0,1,1,1
20160105-W-Brisbane-R16-Samantha_Stosur-Carla_Suarez_Navarro,2,F-XC,30,11,5,4,2,18,12
20160105-W-Brisbane-R16-Samantha_Stosur-Carla_Suarez_Navarro,2,F-DTM,36,5,1,0,4,20,16
20160105-W-Brisbane-R16-Samantha_Stosur-Carla_Suarez_Navarro,2,F-DTL,8,1,0,0,1,4,4
20160105-W-Brisbane-R16-Samantha_Stosur-Carla_Suarez_Navarro,2,F-IO,22,8,2,4,2,12,10
20160105-W-Brisbane-R16-Samantha_Stosur-Carla_Suarez_Navarro,2,F-II,2,1,1,0,0,1,1
20160105-W-Brisbane-R16-Samantha_Stosur-Carla_Suarez_Navarro,2,B-XC,30,9,3,1,5,17,13
20160105-W-Brisbane-R16-Samantha_Stosur-Carla_Suarez_Navarro,2,B-DTM,21,2,0,1,1,11,10
20160105-W-Brisbane-R16-Samantha_Stosur-Carla_Suarez_Navarro,2,B-DTL,4,4,2,0,2,2,2
20160105-W-Brisbane-R16-Samantha_Stosur-Carla_Suarez_Navarro,2,B-IO,4,2,0,2,0,4,0
20160105-W-Brisbane-R16-Samantha_Stosur-Carla_Suarez_Navarro,2,S-XC,13,5,0,0,5,5,8
20160105-W-Brisbane-R16-Samantha_Stosur-Carla_Suarez_Navarro,2,S-DTM,4,0,0,0,0,1,3
20070829-W-US_Open-R64-Tsvetana_Pironkova-Justine_Henin,1,F-XC,23,5,2,1,2,12,11
20070829-W-US_Open-R64-Tsvetana_Pironkova-Justine_Henin,1,F-DTM,28,1,0,0,1,12,16
20070829-W-US_Open-R64-Tsvetana_Pironkova-Justine_Henin,1,F-DTL,4,1,0,0,1,2,2
20070829-W-US_Open-R64-Tsvetana_Pironkova-Justine_Henin,1,F-IO,11,5,3,1,1,9,2
20070829-W-US_Open-R64-Tsvetana_Pironkova-Justine_Henin,1,B-XC,29,7,0,1,6,16,13
20070829-W-US_Open-R64-Tsvetana_Pironkova-Justine_Henin,1,B-DTM,22,3,1,0,2,10,12
20070829-W-US_Open-R64-Tsvetana_Pironkova-Justine_Henin,1,B-DTL,8,4,2,1,1,7,1
20070829-W-US_Open-R64-Tsvetana_Pironkova-Justine_Henin,1,B-IO,2,0,0,0,0,2,0
20070829-W-US_Open-R64-Tsvetana_Pironkova-Justine_Henin,1,S-XC,2,0,0,0,0,1,1
20070829-W-US_Open-R64-Tsvetana_Pironkova-Justine_Henin,1,S-DTM,2,0,0,0,0,1,1
20070829-W-US_Open-R64-Tsvetana_Pironkova-Justine_Henin,2,F-XC,43,11,5,2,4,27,16
20070829-W-US_Open-R64-Tsvetana_Pironkova-Justine_Henin,2,F-DTM,22,0,0,0,0,9,13
20070829-W-US_Open-R64-Tsvetana_Pironkova-Justine_Henin,2,F-DTL,3,2,2,0,0,2,1
20070829-W-US_Open-R64-Tsvetana_Pironkova-Justine_Henin,2,F-IO,12,3,1,2,0,7,5
20070829-W-US_Open-R64-Tsvetana_Pironkova-Justine_Henin,2,F-II,1,1,0,1,0,1,0
20070829-W-US_Open-R64-Tsvetana_Pironkova-Justine_Henin,2,B-XC,13,2,0,0,2,4,9
20070829-W-US_Open-R64-Tsvetana_Pironkova-Justine_Henin,2,B-DTM,13,1,0,0,1,8,5
20070829-W-US_Open-R64-Tsvetana_Pironkova-Justine_Henin,2,B-DTL,5,3,1,1,1,3,2
20070829-W-US_Open-R64-Tsvetana_Pironkova-Justine_Henin,2,B-IO,1,0,0,0,0,0,1
20070829-W-US_Open-R64-Tsvetana_Pironkova-Justine_Henin,2,S-XC,2,0,0,0,0,0,2
20070829-W-US_Open-R64-Tsvetana_Pironkova-Justine_Henin,2,S-DTM,7,1,0,0,1,1,6
20160107-W-Brisbane-QF-Varvara_Lepchenko-Carla_Suarez_Navarro,1,F-XC,56,18,7,0,11,26,30
20160107-W-Brisbane-QF-Varvara_Lepchenko-Carla_Suarez_Navarro,1,F-DTM,56,3,0,0,3,23,33
20160107-W-Brisbane-QF-Varvara_Lepchenko-Carla_Suarez_Navarro,1,F-DTL,13,2,0,1,1,5,8
20160107-W-Brisbane-QF-Varvara_Lepchenko-Carla_Suarez_Navarro,1,F-IO,45,22,10,3,9,24,21
20160107-W-Brisbane-QF-Varvara_Lepchenko-Carla_Suarez_Navarro,1,B-XC,60,11,1,5,5,25,35
20160107-W-Brisbane-QF-Varvara_Lepchenko-Carla_Suarez_Navarro,1,B-DTM,82,9,0,1,8,28,54
20160107-W-Brisbane-QF-Varvara_Lepchenko-Carla_Suarez_Navarro,1,B-DTL,17,5,1,2,2,6,11
20160107-W-Brisbane-QF-Varvara_Lepchenko-Carla_Suarez_Navarro,1,B-IO,12,6,3,1,2,9,3
20160107-W-Brisbane-QF-Varvara_Lepchenko-Carla_Suarez_Navarro,1,S-DTM,1,0,0,0,0,0,1
20160107-W-Brisbane-QF-Varvara_Lepchenko-Carla_Suarez_Navarro,1,S-DTL,1,0,0,0,0,0,1
20160107-W-Brisbane-QF-Varvara_Lepchenko-Carla_Suarez_Navarro,1,S-IO,1,1,0,0,1,0,1
20160107-W-Brisbane-QF-Varvara_Lepchenko-Carla_Suarez_Navarro,2,F-XC,97,19,4,8,7,62,35
20160107-W-Brisbane-QF-Varvara_Lepchenko-Carla_Suarez_Navarro,2,F-DTM,52,4,0,2,2,24,28
20160107-W-Brisbane-QF-Varvara_Lepchenko-Carla_Suarez_Navarro,2,F-DTL,19,9,4,3,2,13,6
20160107-W-Brisbane-QF-Varvara_Lepchenko-Carla_Suarez_Navarro,2,F-IO,23,11,4,2,5,15,8
20160107-W-Brisbane-QF-Varvara_Lepchenko-Carla_Suarez_Navarro,2,F-II,1,0,0,0,0,1,0
20160107-W-Brisbane-QF-Varvara_Lepchenko-Carla_Suarez_Navarro,2,B-XC,38,17,6,5,6,24,14
20160107-W-Brisbane-QF-Varvara_Lepchenko-Carla_Suarez_Navarro,2,B-DTM,49,5,0,0,5,23,26
20160107-W-Brisbane-QF-Varvara_Lepchenko-Carla_Suarez_Navarro,2,B-DTL,2,0,0,0,0,2,0
20160107-W-Brisbane-QF-Varvara_Lepchenko-Carla_Suarez_Navarro,2,B-IO,12,5,2,1,2,7,5
20160107-W-Brisbane-QF-Varvara_Lepchenko-Carla_Suarez_Navarro,2,S-XC,8,1,0,0,1,2,6
20160107-W-Brisbane-QF-Varvara_Lepchenko-Carla_Suarez_Navarro,2,S-DTM,23,2,0,0,2,12,11
20160107-W-Brisbane-QF-Varvara_Lepchenko-Carla_Suarez_Navarro,2,S-DTL,1,0,0,0,0,0,1
20160107-W-Brisbane-QF-Varvara_Lepchenko-Carla_Suarez_Navarro,2,S-IO,1,0,0,0,0,1,0
20160107-W-Brisbane-QF-Anastasia_Pavlyuchenkova-Angelique_Kerber,1,F-XC,28,7,2,0,5,11,17
20160107-W-Brisbane-QF-Anastasia_Pavlyuchenkova-Angelique_Kerber,1,F-DTM,11,1,0,1,0,3,8
20160107-W-Brisbane-QF-Anastasia_Pavlyuchenkova-Angelique_Kerber,1,F-DTL,8,4,1,2,1,4,4
20160107-W-Brisbane-QF-Anastasia_Pavlyuchenkova-Angelique_Kerber,1,F-IO,13,5,4,0,1,6,7
20160107-W-Brisbane-QF-Anastasia_Pavlyuchenkova-Angelique_Kerber,1,B-XC,21,11,5,2,4,9,12
20160107-W-Brisbane-QF-Anastasia_Pavlyuchenkova-Angelique_Kerber,1,B-DTM,13,2,0,0,2,3,10
20160107-W-Brisbane-QF-Anastasia_Pavlyuchenkova-Angelique_Kerber,1,B-DTL,6,4,0,0,4,2,4
20160107-W-Brisbane-QF-Anastasia_Pavlyuchenkova-Angelique_Kerber,1,B-IO,8,6,2,1,3,3,5
20160107-W-Brisbane-QF-Anastasia_Pavlyuchenkova-Angelique_Kerber,1,S-XC,2,0,0,0,0,0,2
20160107-W-Brisbane-QF-Anastasia_Pavlyuchenkova-Angelique_Kerber,1,S-DTM,1,0,0,0,0,0,1
20160107-W-Brisbane-QF-Anastasia_Pavlyuchenkova-Angelique_Kerber,1,S-DTL,1,0,0,0,0,1,0
20160107-W-Brisbane-QF-Anastasia_Pavlyuchenkova-Angelique_Kerber,2,F-XC,23,7,4,2,1,18,5
20160107-W-Brisbane-QF-Anastasia_Pavlyuchenkova-Angelique_Kerber,2,F-DTM,12,0,0,0,0,7,5
20160107-W-Brisbane-QF-Anastasia_Pavlyuchenkova-Angelique_Kerber,2,F-DTL,3,3,3,0,0,3,0
20160107-W-Brisbane-QF-Anastasia_Pavlyuchenkova-Angelique_Kerber,2,F-IO,8,4,2,1,1,7,1
20160107-W-Brisbane-QF-Anastasia_Pavlyuchenkova-Angelique_Kerber,2,B-XC,21,7,2,2,3,12,9
20160107-W-Brisbane-QF-Anastasia_Pavlyuchenkova-Angelique_Kerber,2,B-DTM,17,1,0,1,0,13,4
20160107-W-Brisbane-QF-Anastasia_Pavlyuchenkova-Angelique_Kerber,2,B-DTL,3,3,2,0,1,2,1
20160107-W-Brisbane-QF-Anastasia_Pavlyuchenkova-Angelique_Kerber,2,B-IO,4,3,3,0,0,4,0
20160107-W-Brisbane-QF-Anastasia_Pavlyuchenkova-Angelique_Kerber,2,S-XC,2,0,0,0,0,0,2
20160107-W-Brisbane-QF-Anastasia_Pavlyuchenkova-Angelique_Kerber,2,S-DTM,3,0,0,0,0,0,3
20160107-W-Brisbane-QF-Anastasia_Pavlyuchenkova-Angelique_Kerber,2,S-DTL,1,0,0,0,0,1,0
20150121-W-Australian_Open-R64-Agnieszka_Radwanska-Johanna_Larsson,1,F-XC,26,5,3,0,2,16,10
20150121-W-Australian_Open-R64-Agnieszka_Radwanska-Johanna_Larsson,1,F-DTM,14,2,0,0,2,8,6
20150121-W-Australian_Open-R64-Agnieszka_Radwanska-Johanna_Larsson,1,F-DTL,10,4,2,1,1,7,3
20150121-W-Australian_Open-R64-Agnieszka_Radwanska-Johanna_Larsson,1,F-IO,10,0,0,0,0,9,1
20150121-W-Australian_Open-R64-Agnieszka_Radwanska-Johanna_Larsson,1,B-XC,17,1,1,0,0,11,6
20150121-W-Australian_Open-R64-Agnieszka_Radwanska-Johanna_Larsson,1,B-DTM,18,0,0,0,0,13,5
20150121-W-Australian_Open-R64-Agnieszka_Radwanska-Johanna_Larsson,1,B-DTL,7,2,0,2,0,6,1
20150121-W-Australian_Open-R64-Agnieszka_Radwanska-Johanna_Larsson,1,B-IO,6,2,2,0,0,5,1
20150121-W-Australian_Open-R64-Agnieszka_Radwanska-Johanna_Larsson,1,S-XC,3,2,0,1,1,2,1
20150121-W-Australian_Open-R64-Agnieszka_Radwanska-Johanna_Larsson,1,S-DTM,2,0,0,0,0,1,1
20150121-W-Australian_Open-R64-Agnieszka_Radwanska-Johanna_Larsson,1,S-DTL,2,0,0,0,0,2,0
20150121-W-Australian_Open-R64-Agnieszka_Radwanska-Johanna_Larsson,2,F-XC,37,7,0,0,7,12,25
20150121-W-Australian_Open-R64-Agnieszka_Radwanska-Johanna_Larsson,2,F-DTM,14,1,0,0,1,4,10
20150121-W-Australian_Open-R64-Agnieszka_Radwanska-Johanna_Larsson,2,F-DTL,4,1,0,0,1,2,2
20150121-W-Australian_Open-R64-Agnieszka_Radwanska-Johanna_Larsson,2,F-IO,10,3,0,0,3,1,9
20150121-W-Australian_Open-R64-Agnieszka_Radwanska-Johanna_Larsson,2,F-II,2,0,0,0,0,0,2
20150121-W-Australian_Open-R64-Agnieszka_Radwanska-Johanna_Larsson,2,B-XC,17,3,0,0,3,4,13
20150121-W-Australian_Open-R64-Agnieszka_Radwanska-Johanna_Larsson,2,B-DTM,9,1,0,0,1,3,6
20150121-W-Australian_Open-R64-Agnieszka_Radwanska-Johanna_Larsson,2,B-DTL,3,2,1,0,1,1,2
20150121-W-Australian_Open-R64-Agnieszka_Radwanska-Johanna_Larsson,2,S-XC,11,0,0,0,0,3,8
20150121-W-Australian_Open-R64-Agnieszka_Radwanska-Johanna_Larsson,2,S-DTM,6,1,0,0,1,2,4
20150121-W-Australian_Open-R64-Agnieszka_Radwanska-Johanna_Larsson,2,S-DTL,1,0,0,0,0,0,1
20150121-W-Australian_Open-R64-Agnieszka_Radwanska-Johanna_Larsson,2,S-IO,1,0,0,0,0,0,1
20160108-W-Brisbane-SF-Carla_Suarez_Navarro-Angelique_Kerber,1,F-XC,40,9,2,4,3,15,25
20160108-W-Brisbane-SF-Carla_Suarez_Navarro-Angelique_Kerber,1,F-DTM,30,3,1,1,1,11,19
20160108-W-Brisbane-SF-Carla_Suarez_Navarro-Angelique_Kerber,1,F-DTL,8,1,1,0,0,3,5
20160108-W-Brisbane-SF-Carla_Suarez_Navarro-Angelique_Kerber,1,F-IO,7,4,1,1,2,3,4
20160108-W-Brisbane-SF-Carla_Suarez_Navarro-Angelique_Kerber,1,B-XC,21,5,1,2,2,10,11
20160108-W-Brisbane-SF-Carla_Suarez_Navarro-Angelique_Kerber,1,B-DTM,30,3,0,0,3,11,19
20160108-W-Brisbane-SF-Carla_Suarez_Navarro-Angelique_Kerber,1,B-DTL,5,1,1,0,0,4,1
20160108-W-Brisbane-SF-Carla_Suarez_Navarro-Angelique_Kerber,1,B-IO,4,1,1,0,0,2,2
20160108-W-Brisbane-SF-Carla_Suarez_Navarro-Angelique_Kerber,1,S-XC,13,1,0,0,1,7,6
20160108-W-Brisbane-SF-Carla_Suarez_Navarro-Angelique_Kerber,1,S-DTM,12,1,0,0,1,4,8
20160108-W-Brisbane-SF-Carla_Suarez_Navarro-Angelique_Kerber,1,S-DTL,3,1,0,0,1,1,2
20160108-W-Brisbane-SF-Carla_Suarez_Navarro-Angelique_Kerber,1,S-IO,1,0,0,0,0,0,1
20160108-W-Brisbane-SF-Carla_Suarez_Navarro-Angelique_Kerber,2,F-XC,48,8,4,3,1,28,20
20160108-W-Brisbane-SF-Carla_Suarez_Navarro-Angelique_Kerber,2,F-DTM,22,0,0,0,0,15,7
20160108-W-Brisbane-SF-Carla_Suarez_Navarro-Angelique_Kerber,2,F-DTL,10,8,3,1,4,6,4
20160108-W-Brisbane-SF-Carla_Suarez_Navarro-Angelique_Kerber,2,F-IO,18,10,6,1,3,13,5
20160108-W-Brisbane-SF-Carla_Suarez_Navarro-Angelique_Kerber,2,B-XC,33,9,5,1,3,20,13
20160108-W-Brisbane-SF-Carla_Suarez_Navarro-Angelique_Kerber,2,B-DTM,34,3,0,0,3,21,13
20160108-W-Brisbane-SF-Carla_Suarez_Navarro-Angelique_Kerber,2,B-DTL,4,3,1,1,1,3,1
20160108-W-Brisbane-SF-Carla_Suarez_Navarro-Angelique_Kerber,2,B-IO,7,5,2,1,2,4,3
20160108-W-Brisbane-SF-Carla_Suarez_Navarro-Angelique_Kerber,2,S-XC,1,0,0,0,0,1,0
20160108-W-Brisbane-SF-Carla_Suarez_Navarro-Angelique_Kerber,2,S-DTM,4,0,0,0,0,3,1
20160108-W-Brisbane-SF-Carla_Suarez_Navarro-Angelique_Kerber,2,S-DTL,1,0,0,0,0,1,0
20160108-W-Brisbane-SF-Carla_Suarez_Navarro-Angelique_Kerber,2,S-IO,1,0,0,0,0,1,0
20160109-W-Brisbane-F-Angelique_Kerber-Victoria_Azarenka,1,F-XC,39,10,7,0,3,17,22
20160109-W-Brisbane-F-Angelique_Kerber-Victoria_Azarenka,1,F-DTM,24,2,0,0,2,9,15
20160109-W-Brisbane-F-Angelique_Kerber-Victoria_Azarenka,1,F-DTL,10,7,2,0,5,3,7
20160109-W-Brisbane-F-Angelique_Kerber-Victoria_Azarenka,1,F-IO,7,4,0,1,3,2,5
20160109-W-Brisbane-F-Angelique_Kerber-Victoria_Azarenka,1,B-XC,25,6,3,1,2,14,11
20160109-W-Brisbane-F-Angelique_Kerber-Victoria_Azarenka,1,B-DTM,34,2,0,0,2,13,21
20160109-W-Brisbane-F-Angelique_Kerber-Victoria_Azarenka,1,B-DTL,9,3,2,0,1,6,3
20160109-W-Brisbane-F-Angelique_Kerber-Victoria_Azarenka,1,B-IO,6,4,3,1,0,5,1
20160109-W-Brisbane-F-Angelique_Kerber-Victoria_Azarenka,1,S-XC,1,0,0,0,0,0,1
20160109-W-Brisbane-F-Angelique_Kerber-Victoria_Azarenka,1,S-DTM,2,0,0,0,0,1,1
20160109-W-Brisbane-F-Angelique_Kerber-Victoria_Azarenka,1,S-DTL,1,0,0,0,0,0,1
20160109-W-Brisbane-F-Angelique_Kerber-Victoria_Azarenka,2,F-XC,30,3,1,1,1,16,14
20160109-W-Brisbane-F-Angelique_Kerber-Victoria_Azarenka,2,F-DTM,19,2,1,0,1,10,9
20160109-W-Brisbane-F-Angelique_Kerber-Victoria_Azarenka,2,F-DTL,5,3,1,1,1,3,2
20160109-W-Brisbane-F-Angelique_Kerber-Victoria_Azarenka,2,F-IO,11,4,3,1,0,7,4
20160109-W-Brisbane-F-Angelique_Kerber-Victoria_Azarenka,2,B-XC,30,7,2,2,3,21,9
20160109-W-Brisbane-F-Angelique_Kerber-Victoria_Azarenka,2,B-DTM,21,1,0,1,0,12,9
20160109-W-Brisbane-F-Angelique_Kerber-Victoria_Azarenka,2,B-DTL,4,2,2,0,0,2,2
20160109-W-Brisbane-F-Angelique_Kerber-Victoria_Azarenka,2,B-IO,10,5,3,1,1,7,3
20160109-W-Brisbane-F-Angelique_Kerber-Victoria_Azarenka,2,S-XC,2,1,0,0,1,1,1
20160109-W-Brisbane-F-Angelique_Kerber-Victoria_Azarenka,2,S-DTM,7,0,0,0,0,2,5
20160109-W-Brisbane-F-Angelique_Kerber-Victoria_Azarenka,2,S-DTL,2,0,0,0,0,0,2
20160109-W-Brisbane-F-Angelique_Kerber-Victoria_Azarenka,2,S-IO,3,0,0,0,0,2,1
20150410-W-Katowice-QF-Anna_Karolina_Schmiedlova-Alize_Cornet,1,F-XC,28,7,1,5,1,18,10
20150410-W-Katowice-QF-Anna_Karolina_Schmiedlova-Alize_Cornet,1,F-DTM,9,2,0,1,1,8,1
20150410-W-Katowice-QF-Anna_Karolina_Schmiedlova-Alize_Cornet,1,F-DTL,3,1,1,0,0,1,2
20150410-W-Katowice-QF-Anna_Karolina_Schmiedlova-Alize_Cornet,1,F-IO,2,2,2,0,0,2,0
20150410-W-Katowice-QF-Anna_Karolina_Schmiedlova-Alize_Cornet,1,B-XC,45,13,1,11,1,35,10
20150410-W-Katowice-QF-Anna_Karolina_Schmiedlova-Alize_Cornet,1,B-DTM,18,1,0,1,0,11,7
20150410-W-Katowice-QF-Anna_Karolina_Schmiedlova-Alize_Cornet,1,B-DTL,8,1,0,1,0,5,3
20150410-W-Katowice-QF-Anna_Karolina_Schmiedlova-Alize_Cornet,1,B-IO,7,3,1,1,1,4,3
20150410-W-Katowice-QF-Anna_Karolina_Schmiedlova-Alize_Cornet,1,S-XC,3,0,0,0,0,1,2
20150410-W-Katowice-QF-Anna_Karolina_Schmiedlova-Alize_Cornet,1,S-DTM,2,0,0,0,0,0,2
20150410-W-Katowice-QF-Anna_Karolina_Schmiedlova-Alize_Cornet,2,F-XC,20,3,2,0,1,9,11
20150410-W-Katowice-QF-Anna_Karolina_Schmiedlova-Alize_Cornet,2,F-DTM,16,0,0,0,0,4,12
20150410-W-Katowice-QF-Anna_Karolina_Schmiedlova-Alize_Cornet,2,F-DTL,10,2,0,1,1,5,5
20150410-W-Katowice-QF-Anna_Karolina_Schmiedlova-Alize_Cornet,2,F-IO,12,3,1,1,1,6,6
20150410-W-Katowice-QF-Anna_Karolina_Schmiedlova-Alize_Cornet,2,B-XC,27,0,0,0,0,6,21
20150410-W-Katowice-QF-Anna_Karolina_Schmiedlova-Alize_Cornet,2,B-DTM,13,1,0,0,1,5,8
20150410-W-Katowice-QF-Anna_Karolina_Schmiedlova-Alize_Cornet,2,B-DTL,2,1,0,0,1,1,1
20150410-W-Katowice-QF-Anna_Karolina_Schmiedlova-Alize_Cornet,2,B-IO,1,0,0,0,0,0,1
20150410-W-Katowice-QF-Anna_Karolina_Schmiedlova-Alize_Cornet,2,S-XC,3,1,0,1,0,1,2
20150410-W-Katowice-QF-Anna_Karolina_Schmiedlova-Alize_Cornet,2,S-DTM,2,0,0,0,0,0,2
20150412-W-Katowice-F-Anna_Karolina_Schmiedlova-Camila_Giorgi,1,F-XC,29,3,1,2,0,20,9
20150412-W-Katowice-F-Anna_Karolina_Schmiedlova-Camila_Giorgi,1,F-DTM,24,2,0,2,0,17,7
20150412-W-Katowice-F-Anna_Karolina_Schmiedlova-Camila_Giorgi,1,F-DTL,13,2,0,0,2,6,7
20150412-W-Katowice-F-Anna_Karolina_Schmiedlova-Camila_Giorgi,1,F-IO,5,2,1,0,1,4,1
20150412-W-Katowice-F-Anna_Karolina_Schmiedlova-Camila_Giorgi,1,B-XC,66,13,4,9,0,52,14
20150412-W-Katowice-F-Anna_Karolina_Schmiedlova-Camila_Giorgi,1,B-DTM,31,1,0,0,1,17,14
20150412-W-Katowice-F-Anna_Karolina_Schmiedlova-Camila_Giorgi,1,B-DTL,6,3,2,1,0,5,1
20150412-W-Katowice-F-Anna_Karolina_Schmiedlova-Camila_Giorgi,1,B-IO,3,0,0,0,0,3,0
20150412-W-Katowice-F-Anna_Karolina_Schmiedlova-Camila_Giorgi,1,S-DTM,3,0,0,0,0,1,2
20150412-W-Katowice-F-Anna_Karolina_Schmiedlova-Camila_Giorgi,2,F-XC,39,10,4,2,4,16,23
20150412-W-Katowice-F-Anna_Karolina_Schmiedlova-Camila_Giorgi,2,F-DTM,22,2,0,0,2,4,18
20150412-W-Katowice-F-Anna_Karolina_Schmiedlova-Camila_Giorgi,2,F-DTL,8,2,2,0,0,5,3
20150412-W-Katowice-F-Anna_Karolina_Schmiedlova-Camila_Giorgi,2,F-IO,13,7,2,3,2,7,6
20150412-W-Katowice-F-Anna_Karolina_Schmiedlova-Camila_Giorgi,2,B-XC,56,13,4,5,4,18,38
20150412-W-Katowice-F-Anna_Karolina_Schmiedlova-Camila_Giorgi,2,B-DTM,35,8,0,1,7,9,26
20150412-W-Katowice-F-Anna_Karolina_Schmiedlova-Camila_Giorgi,2,B-DTL,11,5,1,0,4,5,6
20150412-W-Katowice-F-Anna_Karolina_Schmiedlova-Camila_Giorgi,2,B-IO,9,3,1,0,2,2,7
20150412-W-Katowice-F-Anna_Karolina_Schmiedlova-Camila_Giorgi,2,S-XC,1,0,0,0,0,0,1
20140528-W-Roland_Garros-R64-Anna_Karolina_Schmiedlova-Venus_Williams,1,F-XC,59,14,6,6,2,33,26
20140528-W-Roland_Garros-R64-Anna_Karolina_Schmiedlova-Venus_Williams,1,F-DTM,38,3,0,1,2,19,19
20140528-W-Roland_Garros-R64-Anna_Karolina_Schmiedlova-Venus_Williams,1,F-DTL,19,6,3,1,2,13,6
20140528-W-Roland_Garros-R64-Anna_Karolina_Schmiedlova-Venus_Williams,1,F-IO,17,6,2,2,2,11,6
20140528-W-Roland_Garros-R64-Anna_Karolina_Schmiedlova-Venus_Williams,1,B-XC,75,16,3,9,4,38,37
20140528-W-Roland_Garros-R64-Anna_Karolina_Schmiedlova-Venus_Williams,1,B-DTM,23,0,0,0,0,10,13
20140528-W-Roland_Garros-R64-Anna_Karolina_Schmiedlova-Venus_Williams,1,B-DTL,9,4,3,0,1,6,3
20140528-W-Roland_Garros-R64-Anna_Karolina_Schmiedlova-Venus_Williams,1,B-IO,4,0,0,0,0,2,2
20140528-W-Roland_Garros-R64-Anna_Karolina_Schmiedlova-Venus_Williams,1,S-XC,2,0,0,0,0,1,1
20140528-W-Roland_Garros-R64-Anna_Karolina_Schmiedlova-Venus_Williams,1,S-DTM,5,0,0,0,0,2,3
20140528-W-Roland_Garros-R64-Anna_Karolina_Schmiedlova-Venus_Williams,2,F-XC,61,15,7,1,7,29,32
20140528-W-Roland_Garros-R64-Anna_Karolina_Schmiedlova-Venus_Williams,2,F-DTM,25,4,0,1,3,15,10
20140528-W-Roland_Garros-R64-Anna_Karolina_Schmiedlova-Venus_Williams,2,F-DTL,11,6,1,2,3,7,4
20140528-W-Roland_Garros-R64-Anna_Karolina_Schmiedlova-Venus_Williams,2,F-IO,28,11,1,7,3,19,9
20140528-W-Roland_Garros-R64-Anna_Karolina_Schmiedlova-Venus_Williams,2,F-II,2,0,0,0,0,1,1
20140528-W-Roland_Garros-R64-Anna_Karolina_Schmiedlova-Venus_Williams,2,B-XC,60,9,3,3,3,34,26
20140528-W-Roland_Garros-R64-Anna_Karolina_Schmiedlova-Venus_Williams,2,B-DTM,21,0,0,0,0,6,15
20140528-W-Roland_Garros-R64-Anna_Karolina_Schmiedlova-Venus_Williams,2,B-DTL,30,13,4,5,4,12,18
20140528-W-Roland_Garros-R64-Anna_Karolina_Schmiedlova-Venus_Williams,2,B-IO,8,3,0,1,2,4,4
20140528-W-Roland_Garros-R64-Anna_Karolina_Schmiedlova-Venus_Williams,2,S-XC,1,0,0,0,0,0,1
20140528-W-Roland_Garros-R64-Anna_Karolina_Schmiedlova-Venus_Williams,2,S-DTM,3,0,0,0,0,1,2
20140528-W-Roland_Garros-R64-Anna_Karolina_Schmiedlova-Venus_Williams,2,S-DTL,3,0,0,0,0,2,1
19880124-W-Australian_Open-F-Steffi_Graf-Chris_Evert,1,F-XC,61,7,2,3,2,28,33
19880124-W-Australian_Open-F-Steffi_Graf-Chris_Evert,1,F-DTM,26,2,0,1,1,13,13
19880124-W-Australian_Open-F-Steffi_Graf-Chris_Evert,1,F-DTL,14,6,5,0,1,6,8
19880124-W-Australian_Open-F-Steffi_Graf-Chris_Evert,1,F-IO,18,6,3,3,0,15,3
19880124-W-Australian_Open-F-Steffi_Graf-Chris_Evert,1,F-II,8,2,1,1,0,4,4
19880124-W-Australian_Open-F-Steffi_Graf-Chris_Evert,1,B-XC,38,6,0,4,2,22,16
19880124-W-Australian_Open-F-Steffi_Graf-Chris_Evert,1,B-DTM,12,0,0,0,0,6,6
19880124-W-Australian_Open-F-Steffi_Graf-Chris_Evert,1,B-DTL,3,0,0,0,0,1,2
19880124-W-Australian_Open-F-Steffi_Graf-Chris_Evert,1,B-IO,1,1,1,0,0,1,0
19880124-W-Australian_Open-F-Steffi_Graf-Chris_Evert,1,S-XC,29,6,0,2,4,12,17
19880124-W-Australian_Open-F-Steffi_Graf-Chris_Evert,1,S-DTM,50,4,0,0,4,23,27
19880124-W-Australian_Open-F-Steffi_Graf-Chris_Evert,1,S-DTL,38,3,0,0,3,11,27
19880124-W-Australian_Open-F-Steffi_Graf-Chris_Evert,1,S-IO,1,0,0,0,0,1,0
19880124-W-Australian_Open-F-Steffi_Graf-Chris_Evert,2,F-XC,54,11,0,8,3,33,21
19880124-W-Australian_Open-F-Steffi_Graf-Chris_Evert,2,F-DTM,37,2,0,1,1,16,21
19880124-W-Australian_Open-F-Steffi_Graf-Chris_Evert,2,F-DTL,41,5,0,0,5,25,16
19880124-W-Australian_Open-F-Steffi_Graf-Chris_Evert,2,F-IO,26,2,0,0,2,10,16
19880124-W-Australian_Open-F-Steffi_Graf-Chris_Evert,2,B-XC,90,12,3,1,8,51,39
19880124-W-Australian_Open-F-Steffi_Graf-Chris_Evert,2,B-DTM,23,3,1,0,2,10,13
19880124-W-Australian_Open-F-Steffi_Graf-Chris_Evert,2,B-DTL,2,1,0,1,0,1,1
19880124-W-Australian_Open-F-Steffi_Graf-Chris_Evert,2,B-IO,9,1,0,0,1,7,2
19880124-W-Australian_Open-F-Steffi_Graf-Chris_Evert,2,S-XC,2,0,0,0,0,0,2
19880124-W-Australian_Open-F-Steffi_Graf-Chris_Evert,2,S-DTM,1,0,0,0,0,1,0
20160112-W-Hobart-R16-Dominika_Cibulkova-Kimberly_Birrell,1,F-XC,13,8,2,5,1,11,2
20160112-W-Hobart-R16-Dominika_Cibulkova-Kimberly_Birrell,1,F-DTM,8,1,0,0,1,5,3
20160112-W-Hobart-R16-Dominika_Cibulkova-Kimberly_Birrell,1,F-DTL,1,0,0,0,0,1,0
20160112-W-Hobart-R16-Dominika_Cibulkova-Kimberly_Birrell,1,F-IO,8,4,0,3,1,7,1
20160112-W-Hobart-R16-Dominika_Cibulkova-Kimberly_Birrell,1,B-XC,10,4,1,3,0,7,3
20160112-W-Hobart-R16-Dominika_Cibulkova-Kimberly_Birrell,1,B-DTM,9,2,0,1,1,3,6
20160112-W-Hobart-R16-Dominika_Cibulkova-Kimberly_Birrell,1,B-DTL,2,1,0,1,0,1,1
20160112-W-Hobart-R16-Dominika_Cibulkova-Kimberly_Birrell,1,B-IO,1,0,0,0,0,1,0
20160112-W-Hobart-R16-Dominika_Cibulkova-Kimberly_Birrell,2,F-XC,10,5,3,0,2,5,5
20160112-W-Hobart-R16-Dominika_Cibulkova-Kimberly_Birrell,2,F-DTM,10,1,0,0,1,2,8
20160112-W-Hobart-R16-Dominika_Cibulkova-Kimberly_Birrell,2,F-IO,5,2,0,0,2,2,3
20160112-W-Hobart-R16-Dominika_Cibulkova-Kimberly_Birrell,2,B-XC,7,0,0,0,0,4,3
20160112-W-Hobart-R16-Dominika_Cibulkova-Kimberly_Birrell,2,B-DTM,12,2,0,0,2,0,12
20160112-W-Hobart-R16-Dominika_Cibulkova-Kimberly_Birrell,2,B-DTL,1,1,1,0,0,1,0
20160112-W-Hobart-R16-Dominika_Cibulkova-Kimberly_Birrell,2,B-IO,3,1,1,0,0,2,1
20160112-W-Hobart-R16-Dominika_Cibulkova-Kimberly_Birrell,2,S-DTM,1,0,0,0,0,0,1
20050911-W-US_Open-F-Mary_Pierce-Kim_Clijsters,1,F-XC,34,7,2,3,2,20,14
20050911-W-US_Open-F-Mary_Pierce-Kim_Clijsters,1,F-DTM,15,1,0,1,0,9,6
20050911-W-US_Open-F-Mary_Pierce-Kim_Clijsters,1,F-DTL,12,4,0,0,4,4,8
20050911-W-US_Open-F-Mary_Pierce-Kim_Clijsters,1,F-IO,13,6,0,2,4,4,9
20050911-W-US_Open-F-Mary_Pierce-Kim_Clijsters,1,B-XC,20,2,0,1,1,7,13
20050911-W-US_Open-F-Mary_Pierce-Kim_Clijsters,1,B-DTM,22,3,0,1,2,7,15
20050911-W-US_Open-F-Mary_Pierce-Kim_Clijsters,1,B-DTL,12,2,1,0,1,3,9
20050911-W-US_Open-F-Mary_Pierce-Kim_Clijsters,1,B-IO,12,4,0,2,2,4,8
20050911-W-US_Open-F-Mary_Pierce-Kim_Clijsters,1,S-XC,1,0,0,0,0,0,1
20050911-W-US_Open-F-Mary_Pierce-Kim_Clijsters,2,F-XC,44,11,2,3,6,21,23
20050911-W-US_Open-F-Mary_Pierce-Kim_Clijsters,2,F-DTM,20,3,0,3,0,11,9
20050911-W-US_Open-F-Mary_Pierce-Kim_Clijsters,2,F-DTL,5,1,1,0,0,3,2
20050911-W-US_Open-F-Mary_Pierce-Kim_Clijsters,2,F-IO,10,6,4,0,2,8,2
20050911-W-US_Open-F-Mary_Pierce-Kim_Clijsters,2,B-XC,29,4,0,3,1,21,8
20050911-W-US_Open-F-Mary_Pierce-Kim_Clijsters,2,B-DTM,8,0,0,0,0,4,4
20050911-W-US_Open-F-Mary_Pierce-Kim_Clijsters,2,B-DTL,3,0,0,0,0,1,2
20050911-W-US_Open-F-Mary_Pierce-Kim_Clijsters,2,B-IO,1,1,0,0,1,0,1
20050911-W-US_Open-F-Mary_Pierce-Kim_Clijsters,2,S-XC,2,0,0,0,0,1,1
20050911-W-US_Open-F-Mary_Pierce-Kim_Clijsters,2,S-DTM,2,1,1,0,0,1,1
20050911-W-US_Open-F-Mary_Pierce-Kim_Clijsters,2,S-DTL,2,0,0,0,0,1,1
20090131-W-Australian_Open-F-Serena_Williams-Dinara_Safina,1,F-XC,20,7,2,4,1,13,7
20090131-W-Australian_Open-F-Serena_Williams-Dinara_Safina,1,F-DTM,6,2,0,2,0,5,1
20090131-W-Australian_Open-F-Serena_Williams-Dinara_Safina,1,F-DTL,4,3,2,1,0,4,0
20090131-W-Australian_Open-F-Serena_Williams-Dinara_Safina,1,F-IO,4,3,3,0,0,4,0
20090131-W-Australian_Open-F-Serena_Williams-Dinara_Safina,1,B-XC,16,1,1,0,0,7,9
20090131-W-Australian_Open-F-Serena_Williams-Dinara_Safina,1,B-DTM,14,1,0,0,1,6,8
20090131-W-Australian_Open-F-Serena_Williams-Dinara_Safina,1,B-DTL,7,4,2,0,2,4,3
20090131-W-Australian_Open-F-Serena_Williams-Dinara_Safina,1,B-IO,2,0,0,0,0,2,0
20090131-W-Australian_Open-F-Serena_Williams-Dinara_Safina,1,S-DTM,3,0,0,0,0,1,2
20090131-W-Australian_Open-F-Serena_Williams-Dinara_Safina,2,F-XC,16,5,3,1,1,8,8
20090131-W-Australian_Open-F-Serena_Williams-Dinara_Safina,2,F-DTM,4,0,0,0,0,1,3
20090131-W-Australian_Open-F-Serena_Williams-Dinara_Safina,2,F-DTL,9,4,3,0,1,5,4
20090131-W-Australian_Open-F-Serena_Williams-Dinara_Safina,2,F-IO,5,1,0,0,1,3,2
20090131-W-Australian_Open-F-Serena_Williams-Dinara_Safina,2,B-XC,23,7,3,1,3,16,7
20090131-W-Australian_Open-F-Serena_Williams-Dinara_Safina,2,B-DTM,11,3,0,0,3,3,8
20090131-W-Australian_Open-F-Serena_Williams-Dinara_Safina,2,B-DTL,4,1,1,0,0,2,2
20090131-W-Australian_Open-F-Serena_Williams-Dinara_Safina,2,B-IO,2,0,0,0,0,0,2
20090131-W-Australian_Open-F-Serena_Williams-Dinara_Safina,2,S-XC,1,0,0,0,0,0,1
20090131-W-Australian_Open-F-Serena_Williams-Dinara_Safina,2,S-DTM,3,0,0,0,0,1,2
20090131-W-Australian_Open-F-Serena_Williams-Dinara_Safina,2,S-IO,1,1,0,1,0,1,0
20060917-W-Fed_Cup_World_Group_F-RR-Justine_Henin-Francesca_Schiavone,1,F-XC,54,17,7,5,5,32,22
20060917-W-Fed_Cup_World_Group_F-RR-Justine_Henin-Francesca_Schiavone,1,F-DTM,39,6,0,1,5,24,15
20060917-W-Fed_Cup_World_Group_F-RR-Justine_Henin-Francesca_Schiavone,1,F-DTL,12,4,2,1,1,9,3
20060917-W-Fed_Cup_World_Group_F-RR-Justine_Henin-Francesca_Schiavone,1,F-IO,18,7,0,1,6,7,11
20060917-W-Fed_Cup_World_Group_F-RR-Justine_Henin-Francesca_Schiavone,1,F-II,1,0,0,0,0,1,0
20060917-W-Fed_Cup_World_Group_F-RR-Justine_Henin-Francesca_Schiavone,1,B-XC,19,8,1,3,4,11,8
20060917-W-Fed_Cup_World_Group_F-RR-Justine_Henin-Francesca_Schiavone,1,B-DTM,21,2,1,1,0,10,11
20060917-W-Fed_Cup_World_Group_F-RR-Justine_Henin-Francesca_Schiavone,1,B-DTL,3,1,0,0,1,2,1
20060917-W-Fed_Cup_World_Group_F-RR-Justine_Henin-Francesca_Schiavone,1,S-XC,11,0,0,0,0,8,3
20060917-W-Fed_Cup_World_Group_F-RR-Justine_Henin-Francesca_Schiavone,1,S-DTM,2,0,0,0,0,1,1
20060917-W-Fed_Cup_World_Group_F-RR-Justine_Henin-Francesca_Schiavone,2,F-XC,43,5,3,0,2,19,24
20060917-W-Fed_Cup_World_Group_F-RR-Justine_Henin-Francesca_Schiavone,2,F-DTM,28,1,0,0,1,16,12
20060917-W-Fed_Cup_World_Group_F-RR-Justine_Henin-Francesca_Schiavone,2,F-DTL,13,4,1,2,1,6,7
20060917-W-Fed_Cup_World_Group_F-RR-Justine_Henin-Francesca_Schiavone,2,F-IO,29,8,3,1,4,12,17
20060917-W-Fed_Cup_World_Group_F-RR-Justine_Henin-Francesca_Schiavone,2,F-II,5,3,0,1,2,1,4
20060917-W-Fed_Cup_World_Group_F-RR-Justine_Henin-Francesca_Schiavone,2,B-XC,10,1,0,0,1,5,5
20060917-W-Fed_Cup_World_Group_F-RR-Justine_Henin-Francesca_Schiavone,2,B-DTM,17,2,0,0,2,6,11
20060917-W-Fed_Cup_World_Group_F-RR-Justine_Henin-Francesca_Schiavone,2,B-DTL,4,2,0,1,1,2,2
20060917-W-Fed_Cup_World_Group_F-RR-Justine_Henin-Francesca_Schiavone,2,B-IO,4,1,0,0,1,1,3
20060917-W-Fed_Cup_World_Group_F-RR-Justine_Henin-Francesca_Schiavone,2,S-XC,7,0,0,0,0,2,5
20060917-W-Fed_Cup_World_Group_F-RR-Justine_Henin-Francesca_Schiavone,2,S-DTM,5,1,0,0,1,2,3
20060917-W-Fed_Cup_World_Group_F-RR-Justine_Henin-Francesca_Schiavone,2,S-DTL,2,0,0,0,0,0,2
20060917-W-Fed_Cup_World_Group_F-RR-Justine_Henin-Francesca_Schiavone,2,S-IO,3,0,0,0,0,1,2
20120829-W-US_Open-R64-Maria_Sharapova-Lourdes_Dominguez_Lino,1,F-XC,25,9,0,5,4,16,9
20120829-W-US_Open-R64-Maria_Sharapova-Lourdes_Dominguez_Lino,1,F-DTM,4,0,0,0,0,3,1
20120829-W-US_Open-R64-Maria_Sharapova-Lourdes_Dominguez_Lino,1,F-DTL,8,4,1,3,0,7,1
20120829-W-US_Open-R64-Maria_Sharapova-Lourdes_Dominguez_Lino,1,F-IO,29,8,3,2,3,20,9
20120829-W-US_Open-R64-Maria_Sharapova-Lourdes_Dominguez_Lino,1,F-II,2,2,0,2,0,2,0
20120829-W-US_Open-R64-Maria_Sharapova-Lourdes_Dominguez_Lino,1,B-XC,13,5,4,0,1,10,3
20120829-W-US_Open-R64-Maria_Sharapova-Lourdes_Dominguez_Lino,1,B-DTM,2,0,0,0,0,2,0
20120829-W-US_Open-R64-Maria_Sharapova-Lourdes_Dominguez_Lino,1,B-DTL,6,4,3,1,0,5,1
20120829-W-US_Open-R64-Maria_Sharapova-Lourdes_Dominguez_Lino,1,B-IO,1,1,1,0,0,1,0
20120829-W-US_Open-R64-Maria_Sharapova-Lourdes_Dominguez_Lino,1,S-XC,1,0,0,0,0,0,1
20120829-W-US_Open-R64-Maria_Sharapova-Lourdes_Dominguez_Lino,1,S-DTM,1,0,0,0,0,1,0
20120829-W-US_Open-R64-Maria_Sharapova-Lourdes_Dominguez_Lino,1,S-DTL,1,1,1,0,0,1,0
20120829-W-US_Open-R64-Maria_Sharapova-Lourdes_Dominguez_Lino,2,F-XC,11,0,0,0,0,3,8
20120829-W-US_Open-R64-Maria_Sharapova-Lourdes_Dominguez_Lino,2,F-DTM,11,0,0,0,0,4,7
20120829-W-US_Open-R64-Maria_Sharapova-Lourdes_Dominguez_Lino,2,F-DTL,2,0,0,0,0,0,2
20120829-W-US_Open-R64-Maria_Sharapova-Lourdes_Dominguez_Lino,2,F-IO,2,1,0,1,0,1,1
20120829-W-US_Open-R64-Maria_Sharapova-Lourdes_Dominguez_Lino,2,B-DTL,1,0,0,0,0,0,1
20120829-W-US_Open-R64-Maria_Sharapova-Lourdes_Dominguez_Lino,2,S-XC,19,1,0,0,1,5,14
20120829-W-US_Open-R64-Maria_Sharapova-Lourdes_Dominguez_Lino,2,S-DTM,20,0,0,0,0,8,12
20120829-W-US_Open-R64-Maria_Sharapova-Lourdes_Dominguez_Lino,2,S-DTL,5,0,0,0,0,0,5
20120829-W-US_Open-R64-Maria_Sharapova-Lourdes_Dominguez_Lino,2,S-IO,2,1,0,0,1,0,2
20100130-W-Australian_Open-F-Serena_Williams-Justine_Henin,1,F-XC,30,7,0,3,4,19,11
20100130-W-Australian_Open-F-Serena_Williams-Justine_Henin,1,F-DTM,15,2,0,1,1,8,7
20100130-W-Australian_Open-F-Serena_Williams-Justine_Henin,1,F-DTL,11,4,4,0,0,9,2
20100130-W-Australian_Open-F-Serena_Williams-Justine_Henin,1,F-IO,17,10,4,2,4,10,7
20100130-W-Australian_Open-F-Serena_Williams-Justine_Henin,1,B-XC,50,12,4,3,5,22,28
20100130-W-Australian_Open-F-Serena_Williams-Justine_Henin,1,B-DTM,27,5,0,3,2,13,14
20100130-W-Australian_Open-F-Serena_Williams-Justine_Henin,1,B-DTL,4,1,0,0,1,2,2
20100130-W-Australian_Open-F-Serena_Williams-Justine_Henin,1,B-IO,5,2,1,0,1,2,3
20100130-W-Australian_Open-F-Serena_Williams-Justine_Henin,1,S-XC,4,1,0,1,0,2,2
20100130-W-Australian_Open-F-Serena_Williams-Justine_Henin,1,S-DTM,2,0,0,0,0,1,1
20100130-W-Australian_Open-F-Serena_Williams-Justine_Henin,1,S-DTL,2,0,0,0,0,1,1
20100130-W-Australian_Open-F-Serena_Williams-Justine_Henin,2,F-XC,27,8,3,2,3,9,18
20100130-W-Australian_Open-F-Serena_Williams-Justine_Henin,2,F-DTM,36,4,0,2,2,16,20
20100130-W-Australian_Open-F-Serena_Williams-Justine_Henin,2,F-DTL,4,3,1,0,2,1,3
20100130-W-Australian_Open-F-Serena_Williams-Justine_Henin,2,F-IO,15,7,3,2,2,7,8
20100130-W-Australian_Open-F-Serena_Williams-Justine_Henin,2,F-II,2,1,0,0,1,1,1
20100130-W-Australian_Open-F-Serena_Williams-Justine_Henin,2,B-XC,32,10,4,1,5,17,15
20100130-W-Australian_Open-F-Serena_Williams-Justine_Henin,2,B-DTM,17,2,0,1,1,10,7
20100130-W-Australian_Open-F-Serena_Williams-Justine_Henin,2,B-DTL,6,5,3,1,1,4,2
20100130-W-Australian_Open-F-Serena_Williams-Justine_Henin,2,S-XC,14,0,0,0,0,6,8
20100130-W-Australian_Open-F-Serena_Williams-Justine_Henin,2,S-DTM,13,1,0,0,1,8,5
20100130-W-Australian_Open-F-Serena_Williams-Justine_Henin,2,S-DTL,1,0,0,0,0,0,1
19880605-W-Roland_Garros-F-Steffi_Graf-Natalia_Zvereva,1,F-XC,25,9,5,3,1,20,5
19880605-W-Roland_Garros-F-Steffi_Graf-Natalia_Zvereva,1,F-DTM,2,0,0,0,0,1,1
19880605-W-Roland_Garros-F-Steffi_Graf-Natalia_Zvereva,1,F-DTL,3,1,0,1,0,3,0
19880605-W-Roland_Garros-F-Steffi_Graf-Natalia_Zvereva,1,F-IO,12,2,1,0,1,11,1
19880605-W-Roland_Garros-F-Steffi_Graf-Natalia_Zvereva,1,F-II,4,4,2,2,0,4,0
19880605-W-Roland_Garros-F-Steffi_Graf-Natalia_Zvereva,1,B-XC,6,1,0,0,1,4,2
19880605-W-Roland_Garros-F-Steffi_Graf-Natalia_Zvereva,1,B-DTM,3,1,0,0,1,2,1
19880605-W-Roland_Garros-F-Steffi_Graf-Natalia_Zvereva,1,B-DTL,2,1,1,0,0,2,0
19880605-W-Roland_Garros-F-Steffi_Graf-Natalia_Zvereva,1,B-IO,1,1,0,1,0,1,0
19880605-W-Roland_Garros-F-Steffi_Graf-Natalia_Zvereva,1,S-XC,14,2,1,1,0,12,2
19880605-W-Roland_Garros-F-Steffi_Graf-Natalia_Zvereva,1,S-DTM,1,0,0,0,0,1,0
19880605-W-Roland_Garros-F-Steffi_Graf-Natalia_Zvereva,1,S-DTL,9,1,1,0,0,7,2
19880605-W-Roland_Garros-F-Steffi_Graf-Natalia_Zvereva,1,S-IO,1,0,0,0,0,0,1
19880605-W-Roland_Garros-F-Steffi_Graf-Natalia_Zvereva,2,F-XC,7,1,0,0,1,2,5
19880605-W-Roland_Garros-F-Steffi_Graf-Natalia_Zvereva,2,F-DTM,12,0,0,0,0,3,9
19880605-W-Roland_Garros-F-Steffi_Graf-Natalia_Zvereva,2,F-DTL,8,2,0,0,2,3,5
19880605-W-Roland_Garros-F-Steffi_Graf-Natalia_Zvereva,2,F-IO,2,0,0,0,0,1,1
19880605-W-Roland_Garros-F-Steffi_Graf-Natalia_Zvereva,2,B-XC,20,2,1,0,1,2,18
19880605-W-Roland_Garros-F-Steffi_Graf-Natalia_Zvereva,2,B-DTM,8,1,0,0,1,4,4
19880605-W-Roland_Garros-F-Steffi_Graf-Natalia_Zvereva,2,B-DTL,3,2,1,0,1,1,2
19880605-W-Roland_Garros-F-Steffi_Graf-Natalia_Zvereva,2,B-IO,3,0,0,0,0,0,3
19880605-W-Roland_Garros-F-Steffi_Graf-Natalia_Zvereva,2,S-XC,5,1,0,0,1,0,5
19880605-W-Roland_Garros-F-Steffi_Graf-Natalia_Zvereva,2,S-DTM,6,1,0,0,1,1,5
19880605-W-Roland_Garros-F-Steffi_Graf-Natalia_Zvereva,2,S-DTL,1,0,0,0,0,0,1
20070127-W-Australian_Open-F-Serena_Williams-Maria_Sharapova,1,F-XC,15,7,4,2,1,9,6
20070127-W-Australian_Open-F-Serena_Williams-Maria_Sharapova,1,F-DTM,6,1,0,1,0,5,1
20070127-W-Australian_Open-F-Serena_Williams-Maria_Sharapova,1,F-DTL,2,1,0,1,0,2,0
20070127-W-Australian_Open-F-Serena_Williams-Maria_Sharapova,1,F-IO,2,0,0,0,0,1,1
20070127-W-Australian_Open-F-Serena_Williams-Maria_Sharapova,1,B-XC,15,6,3,0,3,9,6
20070127-W-Australian_Open-F-Serena_Williams-Maria_Sharapova,1,B-DTM,9,1,0,1,0,6,3
20070127-W-Australian_Open-F-Serena_Williams-Maria_Sharapova,1,B-DTL,6,4,4,0,0,5,1
20070127-W-Australian_Open-F-Serena_Williams-Maria_Sharapova,1,B-IO,1,1,1,0,0,1,0
20070127-W-Australian_Open-F-Serena_Williams-Maria_Sharapova,1,S-XC,2,0,0,0,0,1,1
20070127-W-Australian_Open-F-Serena_Williams-Maria_Sharapova,2,F-XC,10,6,2,2,2,5,5
20070127-W-Australian_Open-F-Serena_Williams-Maria_Sharapova,2,F-DTM,10,0,0,0,0,4,6
20070127-W-Australian_Open-F-Serena_Williams-Maria_Sharapova,2,F-DTL,4,2,0,2,0,3,1
20070127-W-Australian_Open-F-Serena_Williams-Maria_Sharapova,2,F-IO,7,2,1,0,1,3,4
20070127-W-Australian_Open-F-Serena_Williams-Maria_Sharapova,2,F-II,2,1,0,0,1,0,2
20070127-W-Australian_Open-F-Serena_Williams-Maria_Sharapova,2,B-XC,9,1,0,0,1,2,7
20070127-W-Australian_Open-F-Serena_Williams-Maria_Sharapova,2,B-DTM,4,0,0,0,0,1,3
20070127-W-Australian_Open-F-Serena_Williams-Maria_Sharapova,2,B-DTL,3,1,0,1,0,2,1
20070127-W-Australian_Open-F-Serena_Williams-Maria_Sharapova,2,B-IO,1,0,0,0,0,0,1
20070127-W-Australian_Open-F-Serena_Williams-Maria_Sharapova,2,S-DTL,2,0,0,0,0,0,2
20040131-W-Australian_Open-F-Kim_Clijsters-Justine_Henin,1,F-XC,47,13,0,8,5,21,26
20040131-W-Australian_Open-F-Kim_Clijsters-Justine_Henin,1,F-DTM,28,2,0,1,1,15,13
20040131-W-Australian_Open-F-Kim_Clijsters-Justine_Henin,1,F-DTL,10,2,0,0,2,5,5
20040131-W-Australian_Open-F-Kim_Clijsters-Justine_Henin,1,F-IO,31,10,2,3,5,13,18
20040131-W-Australian_Open-F-Kim_Clijsters-Justine_Henin,1,B-XC,44,8,0,1,7,16,28
20040131-W-Australian_Open-F-Kim_Clijsters-Justine_Henin,1,B-DTM,29,3,0,0,3,10,19
20040131-W-Australian_Open-F-Kim_Clijsters-Justine_Henin,1,B-DTL,19,8,4,1,3,11,8
20040131-W-Australian_Open-F-Kim_Clijsters-Justine_Henin,1,B-IO,8,4,0,1,3,3,5
20040131-W-Australian_Open-F-Kim_Clijsters-Justine_Henin,1,S-XC,3,0,0,0,0,0,3
20040131-W-Australian_Open-F-Kim_Clijsters-Justine_Henin,1,S-DTM,4,0,0,0,0,3,1
20040131-W-Australian_Open-F-Kim_Clijsters-Justine_Henin,2,F-XC,49,15,3,6,6,30,19
20040131-W-Australian_Open-F-Kim_Clijsters-Justine_Henin,2,F-DTM,27,1,0,0,1,15,12
20040131-W-Australian_Open-F-Kim_Clijsters-Justine_Henin,2,F-DTL,9,5,2,0,3,5,4
20040131-W-Australian_Open-F-Kim_Clijsters-Justine_Henin,2,F-IO,21,6,1,3,2,13,8
20040131-W-Australian_Open-F-Kim_Clijsters-Justine_Henin,2,F-II,3,1,0,1,0,3,0
20040131-W-Australian_Open-F-Kim_Clijsters-Justine_Henin,2,B-XC,37,7,3,1,3,20,17
20040131-W-Australian_Open-F-Kim_Clijsters-Justine_Henin,2,B-DTM,28,1,0,0,1,15,13
20040131-W-Australian_Open-F-Kim_Clijsters-Justine_Henin,2,B-DTL,7,3,2,0,1,4,3
20040131-W-Australian_Open-F-Kim_Clijsters-Justine_Henin,2,B-IO,3,3,2,0,1,2,1
20040131-W-Australian_Open-F-Kim_Clijsters-Justine_Henin,2,S-XC,19,0,0,0,0,11,8
20040131-W-Australian_Open-F-Kim_Clijsters-Justine_Henin,2,S-DTM,14,1,0,0,1,7,7
20040131-W-Australian_Open-F-Kim_Clijsters-Justine_Henin,2,S-DTL,1,0,0,0,0,1,0
19880910-W-US_Open-F-Steffi_Graf-Gabriela_Sabatini,1,F-XC,38,13,4,3,6,18,20
19880910-W-US_Open-F-Steffi_Graf-Gabriela_Sabatini,1,F-DTM,32,2,0,0,2,16,16
19880910-W-US_Open-F-Steffi_Graf-Gabriela_Sabatini,1,F-DTL,6,2,0,0,2,0,6
19880910-W-US_Open-F-Steffi_Graf-Gabriela_Sabatini,1,F-IO,42,12,4,5,3,29,13
19880910-W-US_Open-F-Steffi_Graf-Gabriela_Sabatini,1,F-II,9,3,1,0,2,2,7
19880910-W-US_Open-F-Steffi_Graf-Gabriela_Sabatini,1,B-XC,6,1,0,0,1,3,3
19880910-W-US_Open-F-Steffi_Graf-Gabriela_Sabatini,1,B-DTM,4,1,0,1,0,2,2
19880910-W-US_Open-F-Steffi_Graf-Gabriela_Sabatini,1,B-DTL,2,1,1,0,0,1,1
19880910-W-US_Open-F-Steffi_Graf-Gabriela_Sabatini,1,B-IO,1,0,0,0,0,0,1
19880910-W-US_Open-F-Steffi_Graf-Gabriela_Sabatini,1,S-XC,99,9,0,3,6,53,46
19880910-W-US_Open-F-Steffi_Graf-Gabriela_Sabatini,1,S-DTM,29,3,0,0,3,14,15
19880910-W-US_Open-F-Steffi_Graf-Gabriela_Sabatini,1,S-DTL,6,2,1,0,1,2,4
19880910-W-US_Open-F-Steffi_Graf-Gabriela_Sabatini,1,S-IO,1,0,0,0,0,0,1
19880910-W-US_Open-F-Steffi_Graf-Gabriela_Sabatini,2,F-XC,22,3,0,3,0,15,7
19880910-W-US_Open-F-Steffi_Graf-Gabriela_Sabatini,2,F-DTM,23,0,0,0,0,13,10
19880910-W-US_Open-F-Steffi_Graf-Gabriela_Sabatini,2,F-DTL,15,1,0,0,1,8,7
19880910-W-US_Open-F-Steffi_Graf-Gabriela_Sabatini,2,F-IO,27,4,1,0,3,13,14
19880910-W-US_Open-F-Steffi_Graf-Gabriela_Sabatini,2,F-II,1,1,0,1,0,1,0
19880910-W-US_Open-F-Steffi_Graf-Gabriela_Sabatini,2,B-XC,83,8,1,1,6,35,48
19880910-W-US_Open-F-Steffi_Graf-Gabriela_Sabatini,2,B-DTM,35,4,0,2,2,15,20
19880910-W-US_Open-F-Steffi_Graf-Gabriela_Sabatini,2,B-DTL,12,4,2,0,2,5,7
19880910-W-US_Open-F-Steffi_Graf-Gabriela_Sabatini,2,B-IO,4,1,1,0,0,3,1
19880910-W-US_Open-F-Steffi_Graf-Gabriela_Sabatini,2,S-XC,14,1,0,1,0,7,7
19880910-W-US_Open-F-Steffi_Graf-Gabriela_Sabatini,2,S-DTM,6,0,0,0,0,3,3
19880910-W-US_Open-F-Steffi_Graf-Gabriela_Sabatini,2,S-DTL,3,0,0,0,0,1,2
20060128-W-Australian_Open-F-Amelie_Mauresmo-Justine_Henin,1,F-XC,39,5,0,3,2,31,8
20060128-W-Australian_Open-F-Amelie_Mauresmo-Justine_Henin,1,F-DTM,19,0,0,0,0,10,9
20060128-W-Australian_Open-F-Amelie_Mauresmo-Justine_Henin,1,F-DTL,12,2,0,0,2,5,7
20060128-W-Australian_Open-F-Amelie_Mauresmo-Justine_Henin,1,F-IO,21,1,0,1,0,16,5
20060128-W-Australian_Open-F-Amelie_Mauresmo-Justine_Henin,1,B-XC,37,1,0,0,1,22,15
20060128-W-Australian_Open-F-Amelie_Mauresmo-Justine_Henin,1,B-DTM,16,1,0,0,1,9,7
20060128-W-Australian_Open-F-Amelie_Mauresmo-Justine_Henin,1,B-DTL,8,4,2,1,1,7,1
20060128-W-Australian_Open-F-Amelie_Mauresmo-Justine_Henin,1,B-IO,2,1,0,0,1,1,1
20060128-W-Australian_Open-F-Amelie_Mauresmo-Justine_Henin,1,S-XC,8,0,0,0,0,4,4
20060128-W-Australian_Open-F-Amelie_Mauresmo-Justine_Henin,1,S-DTM,6,2,0,1,1,4,2
20060128-W-Australian_Open-F-Amelie_Mauresmo-Justine_Henin,1,S-DTL,2,1,0,1,0,1,1
20060128-W-Australian_Open-F-Amelie_Mauresmo-Justine_Henin,2,F-XC,37,7,0,0,7,12,25
20060128-W-Australian_Open-F-Amelie_Mauresmo-Justine_Henin,2,F-DTM,16,1,0,0,1,4,12
20060128-W-Australian_Open-F-Amelie_Mauresmo-Justine_Henin,2,F-DTL,2,0,0,0,0,0,2
20060128-W-Australian_Open-F-Amelie_Mauresmo-Justine_Henin,2,F-IO,7,3,0,1,2,2,5
20060128-W-Australian_Open-F-Amelie_Mauresmo-Justine_Henin,2,F-II,1,0,0,0,0,1,0
20060128-W-Australian_Open-F-Amelie_Mauresmo-Justine_Henin,2,B-XC,42,4,0,1,3,20,22
20060128-W-Australian_Open-F-Amelie_Mauresmo-Justine_Henin,2,B-DTM,30,2,0,0,2,4,26
20060128-W-Australian_Open-F-Amelie_Mauresmo-Justine_Henin,2,B-DTL,6,2,1,1,0,5,1
20060128-W-Australian_Open-F-Amelie_Mauresmo-Justine_Henin,2,B-IO,3,3,0,0,3,0,3
20060128-W-Australian_Open-F-Amelie_Mauresmo-Justine_Henin,2,S-XC,12,2,0,2,0,5,7
20060128-W-Australian_Open-F-Amelie_Mauresmo-Justine_Henin,2,S-DTM,7,1,0,0,1,1,6
20060128-W-Australian_Open-F-Amelie_Mauresmo-Justine_Henin,2,S-DTL,2,2,0,1,1,1,1
20050129-W-Australian_Open-F-Serena_Williams-Lindsay_Davenport,1,F-XC,26,12,7,3,2,19,7
20050129-W-Australian_Open-F-Serena_Williams-Lindsay_Davenport,1,F-DTM,8,1,0,1,0,6,2
20050129-W-Australian_Open-F-Serena_Williams-Lindsay_Davenport,1,F-DTL,13,4,1,2,1,7,6
20050129-W-Australian_Open-F-Serena_Williams-Lindsay_Davenport,1,F-IO,5,1,0,1,0,2,3
20050129-W-Australian_Open-F-Serena_Williams-Lindsay_Davenport,1,B-XC,29,3,0,2,1,16,13
20050129-W-Australian_Open-F-Serena_Williams-Lindsay_Davenport,1,B-DTM,22,2,1,0,1,11,11
20050129-W-Australian_Open-F-Serena_Williams-Lindsay_Davenport,1,B-DTL,12,8,4,3,1,7,5
20050129-W-Australian_Open-F-Serena_Williams-Lindsay_Davenport,1,B-IO,7,4,3,1,0,6,1
20050129-W-Australian_Open-F-Serena_Williams-Lindsay_Davenport,1,S-XC,3,0,0,0,0,2,1
20050129-W-Australian_Open-F-Serena_Williams-Lindsay_Davenport,1,S-DTM,1,0,0,0,0,0,1
20050129-W-Australian_Open-F-Serena_Williams-Lindsay_Davenport,2,F-XC,23,3,1,1,1,10,13
20050129-W-Australian_Open-F-Serena_Williams-Lindsay_Davenport,2,F-DTM,4,0,0,0,0,2,2
20050129-W-Australian_Open-F-Serena_Williams-Lindsay_Davenport,2,F-DTL,5,4,1,1,2,3,2
20050129-W-Australian_Open-F-Serena_Williams-Lindsay_Davenport,2,F-IO,11,3,1,1,1,4,7
20050129-W-Australian_Open-F-Serena_Williams-Lindsay_Davenport,2,B-XC,37,8,1,4,3,20,17
20050129-W-Australian_Open-F-Serena_Williams-Lindsay_Davenport,2,B-DTM,12,0,0,0,0,4,8
20050129-W-Australian_Open-F-Serena_Williams-Lindsay_Davenport,2,B-DTL,10,7,5,0,2,7,3
20050129-W-Australian_Open-F-Serena_Williams-Lindsay_Davenport,2,B-IO,5,2,0,1,1,2,3
20050129-W-Australian_Open-F-Serena_Williams-Lindsay_Davenport,2,S-XC,1,0,0,0,0,0,1
20050129-W-Australian_Open-F-Serena_Williams-Lindsay_Davenport,2,S-DTM,4,0,0,0,0,1,3
19970125-W-Australian_Open-F-Martina_Hingis-Mary_Pierce,1,F-XC,24,8,3,2,3,17,7
19970125-W-Australian_Open-F-Martina_Hingis-Mary_Pierce,1,F-DTM,13,1,1,0,0,8,5
19970125-W-Australian_Open-F-Martina_Hingis-Mary_Pierce,1,F-DTL,16,4,3,0,1,9,7
19970125-W-Australian_Open-F-Martina_Hingis-Mary_Pierce,1,F-IO,16,2,0,0,2,10,6
19970125-W-Australian_Open-F-Martina_Hingis-Mary_Pierce,1,F-II,1,1,1,0,0,1,0
19970125-W-Australian_Open-F-Martina_Hingis-Mary_Pierce,1,B-XC,23,3,2,0,1,17,6
19970125-W-Australian_Open-F-Martina_Hingis-Mary_Pierce,1,B-DTM,13,0,0,0,0,9,4
19970125-W-Australian_Open-F-Martina_Hingis-Mary_Pierce,1,B-DTL,13,7,4,1,2,10,3
19970125-W-Australian_Open-F-Martina_Hingis-Mary_Pierce,1,B-IO,3,3,3,0,0,3,0
19970125-W-Australian_Open-F-Martina_Hingis-Mary_Pierce,1,S-DTM,2,0,0,0,0,1,1
19970125-W-Australian_Open-F-Martina_Hingis-Mary_Pierce,2,F-XC,29,11,4,1,6,14,15
19970125-W-Australian_Open-F-Martina_Hingis-Mary_Pierce,2,F-DTM,6,0,0,0,0,1,5
19970125-W-Australian_Open-F-Martina_Hingis-Mary_Pierce,2,F-DTL,10,2,0,0,2,0,10
19970125-W-Australian_Open-F-Martina_Hingis-Mary_Pierce,2,F-IO,8,3,2,0,1,4,4
19970125-W-Australian_Open-F-Martina_Hingis-Mary_Pierce,2,F-II,1,0,0,0,0,0,1
19970125-W-Australian_Open-F-Martina_Hingis-Mary_Pierce,2,B-XC,33,10,3,1,6,11,22
19970125-W-Australian_Open-F-Martina_Hingis-Mary_Pierce,2,B-DTM,15,0,0,0,0,7,8
19970125-W-Australian_Open-F-Martina_Hingis-Mary_Pierce,2,B-DTL,17,5,1,0,4,5,12
19970125-W-Australian_Open-F-Martina_Hingis-Mary_Pierce,2,B-IO,3,2,2,0,0,2,1
19970125-W-Australian_Open-F-Martina_Hingis-Mary_Pierce,2,S-XC,3,1,0,0,1,1,2
19970125-W-Australian_Open-F-Martina_Hingis-Mary_Pierce,2,S-DTM,4,0,0,0,0,0,4
19970125-W-Australian_Open-F-Martina_Hingis-Mary_Pierce,2,S-DTL,2,0,0,0,0,0,2
20000129-W-Australian_Open-F-Martina_Hingis-Lindsay_Davenport,1,F-XC,20,4,3,0,1,10,10
20000129-W-Australian_Open-F-Martina_Hingis-Lindsay_Davenport,1,F-DTM,22,3,0,0,3,8,14
20000129-W-Australian_Open-F-Martina_Hingis-Lindsay_Davenport,1,F-DTL,13,2,0,0,2,5,8
20000129-W-Australian_Open-F-Martina_Hingis-Lindsay_Davenport,1,F-IO,21,4,2,1,1,12,9
20000129-W-Australian_Open-F-Martina_Hingis-Lindsay_Davenport,1,F-II,1,0,0,0,0,1,0
20000129-W-Australian_Open-F-Martina_Hingis-Lindsay_Davenport,1,B-XC,25,6,0,1,5,6,19
20000129-W-Australian_Open-F-Martina_Hingis-Lindsay_Davenport,1,B-DTM,34,4,0,1,3,12,22
20000129-W-Australian_Open-F-Martina_Hingis-Lindsay_Davenport,1,B-DTL,12,4,0,2,2,6,6
20000129-W-Australian_Open-F-Martina_Hingis-Lindsay_Davenport,1,B-IO,10,1,1,0,0,5,5
20000129-W-Australian_Open-F-Martina_Hingis-Lindsay_Davenport,1,S-XC,3,0,0,0,0,0,3
20000129-W-Australian_Open-F-Martina_Hingis-Lindsay_Davenport,1,S-DTM,5,0,0,0,0,0,5
20000129-W-Australian_Open-F-Martina_Hingis-Lindsay_Davenport,1,S-DTL,1,0,0,0,0,0,1
20000129-W-Australian_Open-F-Martina_Hingis-Lindsay_Davenport,2,F-XC,38,13,5,4,4,23,15
20000129-W-Australian_Open-F-Martina_Hingis-Lindsay_Davenport,2,F-DTM,17,1,0,0,1,10,7
20000129-W-Australian_Open-F-Martina_Hingis-Lindsay_Davenport,2,F-DTL,10,3,2,0,1,6,4
20000129-W-Australian_Open-F-Martina_Hingis-Lindsay_Davenport,2,F-IO,11,3,1,0,2,8,3
20000129-W-Australian_Open-F-Martina_Hingis-Lindsay_Davenport,2,B-XC,52,13,0,8,5,34,18
20000129-W-Australian_Open-F-Martina_Hingis-Lindsay_Davenport,2,B-DTM,28,5,0,0,5,12,16
20000129-W-Australian_Open-F-Martina_Hingis-Lindsay_Davenport,2,B-DTL,9,6,6,0,0,8,1
20000129-W-Australian_Open-F-Martina_Hingis-Lindsay_Davenport,2,B-IO,6,3,0,3,0,6,0
20000129-W-Australian_Open-F-Martina_Hingis-Lindsay_Davenport,2,S-XC,2,0,0,0,0,0,2
20000129-W-Australian_Open-F-Martina_Hingis-Lindsay_Davenport,2,S-IO,1,1,1,0,0,1,0
20160123-W-Australian_Open-R32-Victoria_Azarenka-Naomi_Osaka,1,F-XC,32,6,5,1,0,23,9
20160123-W-Australian_Open-R32-Victoria_Azarenka-Naomi_Osaka,1,F-DTM,8,0,0,0,0,4,4
20160123-W-Australian_Open-R32-Victoria_Azarenka-Naomi_Osaka,1,F-DTL,7,2,2,0,0,7,0
20160123-W-Australian_Open-R32-Victoria_Azarenka-Naomi_Osaka,1,F-IO,16,6,2,1,3,9,7
20160123-W-Australian_Open-R32-Victoria_Azarenka-Naomi_Osaka,1,B-XC,33,7,2,2,3,17,16
20160123-W-Australian_Open-R32-Victoria_Azarenka-Naomi_Osaka,1,B-DTM,16,0,0,0,0,9,7
20160123-W-Australian_Open-R32-Victoria_Azarenka-Naomi_Osaka,1,B-DTL,3,3,1,2,0,3,0
20160123-W-Australian_Open-R32-Victoria_Azarenka-Naomi_Osaka,1,B-IO,10,5,0,3,2,5,5
20160123-W-Australian_Open-R32-Victoria_Azarenka-Naomi_Osaka,1,S-XC,6,1,0,0,1,5,1
20160123-W-Australian_Open-R32-Victoria_Azarenka-Naomi_Osaka,1,S-DTM,2,0,0,0,0,0,2
20160123-W-Australian_Open-R32-Victoria_Azarenka-Naomi_Osaka,2,F-XC,15,3,0,1,2,5,10
20160123-W-Australian_Open-R32-Victoria_Azarenka-Naomi_Osaka,2,F-DTM,15,1,0,0,1,7,8
20160123-W-Australian_Open-R32-Victoria_Azarenka-Naomi_Osaka,2,F-DTL,7,1,0,0,1,4,3
20160123-W-Australian_Open-R32-Victoria_Azarenka-Naomi_Osaka,2,F-IO,12,7,2,0,5,4,8
20160123-W-Australian_Open-R32-Victoria_Azarenka-Naomi_Osaka,2,B-XC,28,4,0,1,3,11,17
20160123-W-Australian_Open-R32-Victoria_Azarenka-Naomi_Osaka,2,B-DTM,31,2,0,1,1,15,16
20160123-W-Australian_Open-R32-Victoria_Azarenka-Naomi_Osaka,2,B-DTL,11,3,0,2,1,3,8
20160123-W-Australian_Open-R32-Victoria_Azarenka-Naomi_Osaka,2,B-IO,4,0,0,0,0,0,4
20160123-W-Australian_Open-R32-Victoria_Azarenka-Naomi_Osaka,2,S-XC,1,0,0,0,0,0,1
20160123-W-Australian_Open-R32-Victoria_Azarenka-Naomi_Osaka,2,S-DTM,1,0,0,0,0,0,1
20160123-W-Australian_Open-R32-Victoria_Azarenka-Naomi_Osaka,2,S-DTL,1,0,0,0,0,0,1
19880704-W-Wimbledon-F-Martina_Navratilova-Steffi_Graf,1,F-XC,10,1,0,1,0,3,7
19880704-W-Wimbledon-F-Martina_Navratilova-Steffi_Graf,1,F-DTM,7,0,0,0,0,2,5
19880704-W-Wimbledon-F-Martina_Navratilova-Steffi_Graf,1,F-DTL,3,1,0,0,1,1,2
19880704-W-Wimbledon-F-Martina_Navratilova-Steffi_Graf,1,F-IO,1,0,0,0,0,0,1
19880704-W-Wimbledon-F-Martina_Navratilova-Steffi_Graf,1,B-XC,4,2,2,0,0,2,2
19880704-W-Wimbledon-F-Martina_Navratilova-Steffi_Graf,1,B-DTM,2,1,0,0,1,0,2
19880704-W-Wimbledon-F-Martina_Navratilova-Steffi_Graf,1,B-DTL,1,0,0,0,0,0,1
19880704-W-Wimbledon-F-Martina_Navratilova-Steffi_Graf,1,B-IO,1,0,0,0,0,0,1
19880704-W-Wimbledon-F-Martina_Navratilova-Steffi_Graf,1,S-XC,15,3,0,1,2,5,10
19880704-W-Wimbledon-F-Martina_Navratilova-Steffi_Graf,1,S-DTM,11,1,0,0,1,3,8
19880704-W-Wimbledon-F-Martina_Navratilova-Steffi_Graf,1,S-DTL,12,3,0,1,2,6,6
19880704-W-Wimbledon-F-Martina_Navratilova-Steffi_Graf,1,S-IO,5,1,0,1,0,4,1
19880704-W-Wimbledon-F-Martina_Navratilova-Steffi_Graf,2,F-XC,28,7,4,1,2,19,9
19880704-W-Wimbledon-F-Martina_Navratilova-Steffi_Graf,2,F-DTM,5,1,1,0,0,4,1
19880704-W-Wimbledon-F-Martina_Navratilova-Steffi_Graf,2,F-DTL,8,4,3,0,1,5,3
19880704-W-Wimbledon-F-Martina_Navratilova-Steffi_Graf,2,F-IO,12,3,1,1,1,10,2
19880704-W-Wimbledon-F-Martina_Navratilova-Steffi_Graf,2,F-II,4,1,1,0,0,3,1
19880704-W-Wimbledon-F-Martina_Navratilova-Steffi_Graf,2,B-XC,4,3,1,1,1,3,1
19880704-W-Wimbledon-F-Martina_Navratilova-Steffi_Graf,2,B-DTM,1,1,1,0,0,1,0
19880704-W-Wimbledon-F-Martina_Navratilova-Steffi_Graf,2,B-DTL,2,1,0,0,1,0,2
19880704-W-Wimbledon-F-Martina_Navratilova-Steffi_Graf,2,B-IO,3,3,1,0,2,1,2
19880704-W-Wimbledon-F-Martina_Navratilova-Steffi_Graf,2,S-XC,6,2,0,0,2,3,3
19880704-W-Wimbledon-F-Martina_Navratilova-Steffi_Graf,2,S-DTM,6,1,0,0,1,1,5
19880704-W-Wimbledon-F-Martina_Navratilova-Steffi_Graf,2,S-DTL,16,2,1,1,0,9,7
19880704-W-Wimbledon-F-Martina_Navratilova-Steffi_Graf,2,S-IO,6,1,0,1,0,5,1
20160122-W-Australian_Open-R32-Serena_Williams-Daria_Kasatkina,1,F-XC,8,5,2,2,1,6,2
20160122-W-Australian_Open-R32-Serena_Williams-Daria_Kasatkina,1,F-DTM,2,0,0,0,0,1,1
20160122-W-Australian_Open-R32-Serena_Williams-Daria_Kasatkina,1,F-DTL,4,3,2,0,1,2,2
20160122-W-Australian_Open-R32-Serena_Williams-Daria_Kasatkina,1,F-IO,4,2,2,0,0,4,0
20160122-W-Australian_Open-R32-Serena_Williams-Daria_Kasatkina,1,B-XC,8,2,0,0,2,4,4
20160122-W-Australian_Open-R32-Serena_Williams-Daria_Kasatkina,1,B-DTM,9,2,0,1,1,5,4
20160122-W-Australian_Open-R32-Serena_Williams-Daria_Kasatkina,1,B-DTL,5,1,0,0,1,2,3
20160122-W-Australian_Open-R32-Serena_Williams-Daria_Kasatkina,1,B-IO,2,1,0,0,1,0,2
20160122-W-Australian_Open-R32-Serena_Williams-Daria_Kasatkina,1,S-DTL,1,1,0,1,0,1,0
20160122-W-Australian_Open-R32-Serena_Williams-Daria_Kasatkina,2,F-XC,6,0,0,0,0,3,3
20160122-W-Australian_Open-R32-Serena_Williams-Daria_Kasatkina,2,F-DTM,8,1,0,0,1,3,5
20160122-W-Australian_Open-R32-Serena_Williams-Daria_Kasatkina,2,F-DTL,2,1,1,0,0,2,0
20160122-W-Australian_Open-R32-Serena_Williams-Daria_Kasatkina,2,F-IO,6,4,2,0,2,4,2
20160122-W-Australian_Open-R32-Serena_Williams-Daria_Kasatkina,2,B-XC,6,2,0,0,2,2,4
20160122-W-Australian_Open-R32-Serena_Williams-Daria_Kasatkina,2,B-DTM,4,1,0,0,1,2,2
20160122-W-Australian_Open-R32-Serena_Williams-Daria_Kasatkina,2,B-IO,2,1,0,0,1,0,2
20160122-W-Australian_Open-R32-Serena_Williams-Daria_Kasatkina,2,S-XC,5,1,0,0,1,2,3
20160122-W-Australian_Open-R32-Serena_Williams-Daria_Kasatkina,2,S-DTM,2,0,0,0,0,0,2
20160121-W-Australian_Open-R64-Danka_Kovinic-Victoria_Azarenka,1,F-XC,21,2,1,1,0,6,15
20160121-W-Australian_Open-R64-Danka_Kovinic-Victoria_Azarenka,1,F-DTM,8,1,0,0,1,2,6
20160121-W-Australian_Open-R64-Danka_Kovinic-Victoria_Azarenka,1,F-DTL,9,2,1,0,1,5,4
20160121-W-Australian_Open-R64-Danka_Kovinic-Victoria_Azarenka,1,F-IO,6,4,1,0,3,1,5
20160121-W-Australian_Open-R64-Danka_Kovinic-Victoria_Azarenka,1,B-XC,21,3,0,1,2,6,15
20160121-W-Australian_Open-R64-Danka_Kovinic-Victoria_Azarenka,1,B-DTM,27,3,0,0,3,5,22
20160121-W-Australian_Open-R64-Danka_Kovinic-Victoria_Azarenka,1,B-DTL,6,5,3,1,1,4,2
20160121-W-Australian_Open-R64-Danka_Kovinic-Victoria_Azarenka,1,B-IO,2,0,0,0,0,1,1
20160121-W-Australian_Open-R64-Danka_Kovinic-Victoria_Azarenka,1,S-XC,2,0,0,0,0,1,1
20160121-W-Australian_Open-R64-Danka_Kovinic-Victoria_Azarenka,1,S-DTM,6,0,0,0,0,1,5
20160121-W-Australian_Open-R64-Danka_Kovinic-Victoria_Azarenka,1,S-DTL,1,1,0,1,0,1,0
20160121-W-Australian_Open-R64-Danka_Kovinic-Victoria_Azarenka,2,F-XC,21,8,1,7,0,16,5
20160121-W-Australian_Open-R64-Danka_Kovinic-Victoria_Azarenka,2,F-DTM,6,0,0,0,0,4,2
20160121-W-Australian_Open-R64-Danka_Kovinic-Victoria_Azarenka,2,F-DTL,16,3,3,0,0,14,2
20160121-W-Australian_Open-R64-Danka_Kovinic-Victoria_Azarenka,2,F-IO,13,3,0,2,1,8,5
20160121-W-Australian_Open-R64-Danka_Kovinic-Victoria_Azarenka,2,B-XC,22,4,2,2,0,20,2
20160121-W-Australian_Open-R64-Danka_Kovinic-Victoria_Azarenka,2,B-DTM,14,1,0,0,1,9,5
20160121-W-Australian_Open-R64-Danka_Kovinic-Victoria_Azarenka,2,B-DTL,3,1,1,0,0,2,1
20160121-W-Australian_Open-R64-Danka_Kovinic-Victoria_Azarenka,2,B-IO,3,1,1,0,0,3,0
20160121-W-Australian_Open-R64-Danka_Kovinic-Victoria_Azarenka,2,S-XC,1,0,0,0,0,1,0
20160121-W-Australian_Open-R64-Danka_Kovinic-Victoria_Azarenka,2,S-DTM,2,0,0,0,0,1,1
20160121-W-Australian_Open-R64-Danka_Kovinic-Victoria_Azarenka,2,S-DTL,2,0,0,0,0,2,0
20010127-W-Australian_Open-F-Martina_Hingis-Jennifer_Capriati,1,F-XC,30,4,0,2,2,20,10
20010127-W-Australian_Open-F-Martina_Hingis-Jennifer_Capriati,1,F-DTM,20,1,0,1,0,8,12
20010127-W-Australian_Open-F-Martina_Hingis-Jennifer_Capriati,1,F-DTL,22,4,1,1,2,7,15
20010127-W-Australian_Open-F-Martina_Hingis-Jennifer_Capriati,1,F-IO,40,7,1,2,4,23,17
20010127-W-Australian_Open-F-Martina_Hingis-Jennifer_Capriati,1,B-XC,43,7,0,3,4,23,20
20010127-W-Australian_Open-F-Martina_Hingis-Jennifer_Capriati,1,B-DTM,28,4,0,1,3,10,18
20010127-W-Australian_Open-F-Martina_Hingis-Jennifer_Capriati,1,B-DTL,10,4,0,2,2,4,6
20010127-W-Australian_Open-F-Martina_Hingis-Jennifer_Capriati,1,B-IO,13,6,2,1,3,7,6
20010127-W-Australian_Open-F-Martina_Hingis-Jennifer_Capriati,1,S-XC,5,0,0,0,0,2,3
20010127-W-Australian_Open-F-Martina_Hingis-Jennifer_Capriati,1,S-DTM,3,0,0,0,0,0,3
20010127-W-Australian_Open-F-Martina_Hingis-Jennifer_Capriati,2,F-XC,36,3,0,1,2,19,17
20010127-W-Australian_Open-F-Martina_Hingis-Jennifer_Capriati,2,F-DTM,18,0,0,0,0,7,11
20010127-W-Australian_Open-F-Martina_Hingis-Jennifer_Capriati,2,F-DTL,9,4,3,0,1,4,5
20010127-W-Australian_Open-F-Martina_Hingis-Jennifer_Capriati,2,F-IO,11,5,4,1,0,8,3
20010127-W-Australian_Open-F-Martina_Hingis-Jennifer_Capriati,2,F-II,1,0,0,0,0,0,1
20010127-W-Australian_Open-F-Martina_Hingis-Jennifer_Capriati,2,B-XC,52,5,1,3,1,36,16
20010127-W-Australian_Open-F-Martina_Hingis-Jennifer_Capriati,2,B-DTM,47,4,0,1,3,20,27
20010127-W-Australian_Open-F-Martina_Hingis-Jennifer_Capriati,2,B-DTL,17,8,2,3,3,10,7
20010127-W-Australian_Open-F-Martina_Hingis-Jennifer_Capriati,2,B-IO,6,0,0,0,0,3,3
20010127-W-Australian_Open-F-Martina_Hingis-Jennifer_Capriati,2,S-XC,3,0,0,0,0,1,2
20010127-W-Australian_Open-F-Martina_Hingis-Jennifer_Capriati,2,S-DTM,5,0,0,0,0,0,5
20010127-W-Australian_Open-F-Martina_Hingis-Jennifer_Capriati,2,S-DTL,5,1,1,0,0,3,2
20160128-W-Australian_Open-SF-Agnieszka_Radwanska-Serena_Williams,1,F-XC,18,1,1,0,0,10,8
20160128-W-Australian_Open-SF-Agnieszka_Radwanska-Serena_Williams,1,F-DTM,12,0,0,0,0,5,7
20160128-W-Australian_Open-SF-Agnieszka_Radwanska-Serena_Williams,1,F-DTL,6,1,0,0,1,4,2
20160128-W-Australian_Open-SF-Agnieszka_Radwanska-Serena_Williams,1,F-IO,11,2,1,1,0,8,3
20160128-W-Australian_Open-SF-Agnieszka_Radwanska-Serena_Williams,1,B-XC,12,3,0,1,2,4,8
20160128-W-Australian_Open-SF-Agnieszka_Radwanska-Serena_Williams,1,B-DTM,9,1,0,0,1,3,6
20160128-W-Australian_Open-SF-Agnieszka_Radwanska-Serena_Williams,1,B-DTL,2,0,0,0,0,2,0
20160128-W-Australian_Open-SF-Agnieszka_Radwanska-Serena_Williams,1,B-IO,1,0,0,0,0,1,0
20160128-W-Australian_Open-SF-Agnieszka_Radwanska-Serena_Williams,1,S-XC,4,0,0,0,0,1,3
20160128-W-Australian_Open-SF-Agnieszka_Radwanska-Serena_Williams,1,S-DTM,8,0,0,0,0,2,6
20160128-W-Australian_Open-SF-Agnieszka_Radwanska-Serena_Williams,1,S-DTL,1,0,0,0,0,0,1
20160128-W-Australian_Open-SF-Agnieszka_Radwanska-Serena_Williams,2,F-XC,22,9,4,0,5,9,13
20160128-W-Australian_Open-SF-Agnieszka_Radwanska-Serena_Williams,2,F-DTM,7,0,0,0,0,4,3
20160128-W-Australian_Open-SF-Agnieszka_Radwanska-Serena_Williams,2,F-DTL,9,2,1,0,1,7,2
20160128-W-Australian_Open-SF-Agnieszka_Radwanska-Serena_Williams,2,F-IO,9,5,2,2,1,6,3
20160128-W-Australian_Open-SF-Agnieszka_Radwanska-Serena_Williams,2,F-II,1,1,1,0,0,1,0
20160128-W-Australian_Open-SF-Agnieszka_Radwanska-Serena_Williams,2,B-XC,18,5,1,1,3,8,10
20160128-W-Australian_Open-SF-Agnieszka_Radwanska-Serena_Williams,2,B-DTM,10,1,0,0,1,2,8
20160128-W-Australian_Open-SF-Agnieszka_Radwanska-Serena_Williams,2,B-DTL,8,5,3,1,1,5,3
20160128-W-Australian_Open-SF-Agnieszka_Radwanska-Serena_Williams,2,B-IO,4,0,0,0,0,2,2
20160128-W-Australian_Open-SF-Agnieszka_Radwanska-Serena_Williams,2,S-DTM,1,1,0,0,1,0,1
20160128-W-Australian_Open-SF-Agnieszka_Radwanska-Serena_Williams,2,S-DTL,1,0,0,0,0,1,0
19990704-W-Wimbledon-F-Steffi_Graf-Lindsay_Davenport,1,F-XC,35,17,10,2,5,25,10
19990704-W-Wimbledon-F-Steffi_Graf-Lindsay_Davenport,1,F-DTM,13,0,0,0,0,6,7
19990704-W-Wimbledon-F-Steffi_Graf-Lindsay_Davenport,1,F-DTL,11,6,4,2,0,10,1
19990704-W-Wimbledon-F-Steffi_Graf-Lindsay_Davenport,1,F-IO,16,5,1,1,3,5,11
19990704-W-Wimbledon-F-Steffi_Graf-Lindsay_Davenport,1,F-II,3,0,0,0,0,3,0
19990704-W-Wimbledon-F-Steffi_Graf-Lindsay_Davenport,1,B-XC,2,0,0,0,0,1,1
19990704-W-Wimbledon-F-Steffi_Graf-Lindsay_Davenport,1,B-DTM,4,2,0,1,1,3,1
19990704-W-Wimbledon-F-Steffi_Graf-Lindsay_Davenport,1,B-DTL,2,0,0,0,0,0,2
19990704-W-Wimbledon-F-Steffi_Graf-Lindsay_Davenport,1,B-IO,1,1,0,0,1,0,1
19990704-W-Wimbledon-F-Steffi_Graf-Lindsay_Davenport,1,S-XC,26,9,3,1,5,10,16
19990704-W-Wimbledon-F-Steffi_Graf-Lindsay_Davenport,1,S-DTM,18,3,0,0,3,3,15
19990704-W-Wimbledon-F-Steffi_Graf-Lindsay_Davenport,1,S-DTL,13,2,1,0,1,6,7
19990704-W-Wimbledon-F-Steffi_Graf-Lindsay_Davenport,1,S-IO,3,0,0,0,0,1,2
19990704-W-Wimbledon-F-Steffi_Graf-Lindsay_Davenport,2,F-XC,16,4,0,2,2,5,11
19990704-W-Wimbledon-F-Steffi_Graf-Lindsay_Davenport,2,F-DTM,14,2,0,1,1,9,5
19990704-W-Wimbledon-F-Steffi_Graf-Lindsay_Davenport,2,F-DTL,20,6,3,0,3,10,10
19990704-W-Wimbledon-F-Steffi_Graf-Lindsay_Davenport,2,F-IO,7,3,2,1,0,6,1
19990704-W-Wimbledon-F-Steffi_Graf-Lindsay_Davenport,2,B-XC,41,9,2,3,4,30,11
19990704-W-Wimbledon-F-Steffi_Graf-Lindsay_Davenport,2,B-DTM,16,2,0,0,2,5,11
19990704-W-Wimbledon-F-Steffi_Graf-Lindsay_Davenport,2,B-DTL,5,2,1,0,1,1,4
19990704-W-Wimbledon-F-Steffi_Graf-Lindsay_Davenport,2,B-IO,2,0,0,0,0,1,1
19990704-W-Wimbledon-F-Steffi_Graf-Lindsay_Davenport,2,S-XC,4,0,0,0,0,1,3
19990704-W-Wimbledon-F-Steffi_Graf-Lindsay_Davenport,2,S-DTM,4,0,0,0,0,2,2
19990704-W-Wimbledon-F-Steffi_Graf-Lindsay_Davenport,2,S-DTL,2,1,1,0,0,1,1
19990704-W-Wimbledon-F-Steffi_Graf-Lindsay_Davenport,2,S-IO,1,0,0,0,0,1,0
20160124-W-Australian_Open-R16-Serena_Williams-Margarita_Gasparyan,1,F-XC,13,8,2,4,2,9,4
20160124-W-Australian_Open-R16-Serena_Williams-Margarita_Gasparyan,1,F-DTM,3,0,0,0,0,3,0
20160124-W-Australian_Open-R16-Serena_Williams-Margarita_Gasparyan,1,F-DTL,5,3,2,1,0,5,0
20160124-W-Australian_Open-R16-Serena_Williams-Margarita_Gasparyan,1,F-IO,9,5,1,3,1,7,2
20160124-W-Australian_Open-R16-Serena_Williams-Margarita_Gasparyan,1,B-XC,15,2,0,0,2,8,7
20160124-W-Australian_Open-R16-Serena_Williams-Margarita_Gasparyan,1,B-DTM,6,3,0,1,2,4,2
20160124-W-Australian_Open-R16-Serena_Williams-Margarita_Gasparyan,1,B-DTL,2,0,0,0,0,2,0
20160124-W-Australian_Open-R16-Serena_Williams-Margarita_Gasparyan,1,B-IO,5,4,0,0,4,1,4
20160124-W-Australian_Open-R16-Serena_Williams-Margarita_Gasparyan,1,S-XC,2,0,0,0,0,2,0
20160124-W-Australian_Open-R16-Serena_Williams-Margarita_Gasparyan,1,S-DTM,2,1,0,0,1,1,1
20160124-W-Australian_Open-R16-Serena_Williams-Margarita_Gasparyan,2,F-XC,9,3,1,0,2,1,8
20160124-W-Australian_Open-R16-Serena_Williams-Margarita_Gasparyan,2,F-DTM,6,0,0,0,0,2,4
20160124-W-Australian_Open-R16-Serena_Williams-Margarita_Gasparyan,2,F-DTL,10,5,1,1,3,5,5
20160124-W-Australian_Open-R16-Serena_Williams-Margarita_Gasparyan,2,F-IO,5,2,0,1,1,1,4
20160124-W-Australian_Open-R16-Serena_Williams-Margarita_Gasparyan,2,B-XC,8,4,1,0,3,2,6
20160124-W-Australian_Open-R16-Serena_Williams-Margarita_Gasparyan,2,B-DTM,6,0,0,0,0,2,4
20160124-W-Australian_Open-R16-Serena_Williams-Margarita_Gasparyan,2,B-DTL,5,2,1,1,0,3,2
20160124-W-Australian_Open-R16-Serena_Williams-Margarita_Gasparyan,2,S-XC,4,0,0,0,0,1,3
20160124-W-Australian_Open-R16-Serena_Williams-Margarita_Gasparyan,2,S-DTM,2,0,0,0,0,0,2
20160124-W-Australian_Open-R16-Serena_Williams-Margarita_Gasparyan,2,S-DTL,2,1,0,0,1,0,2
19990130-W-Australian_Open-F-Amelie_Mauresmo-Martina_Hingis,1,F-XC,48,11,5,1,5,23,25
19990130-W-Australian_Open-F-Amelie_Mauresmo-Martina_Hingis,1,F-DTM,16,2,0,0,2,6,10
19990130-W-Australian_Open-F-Amelie_Mauresmo-Martina_Hingis,1,F-DTL,22,10,5,1,4,11,11
19990130-W-Australian_Open-F-Amelie_Mauresmo-Martina_Hingis,1,F-IO,22,5,3,1,1,11,11
19990130-W-Australian_Open-F-Amelie_Mauresmo-Martina_Hingis,1,F-II,3,0,0,0,0,1,2
19990130-W-Australian_Open-F-Amelie_Mauresmo-Martina_Hingis,1,B-XC,27,5,2,0,3,11,16
19990130-W-Australian_Open-F-Amelie_Mauresmo-Martina_Hingis,1,B-DTM,31,2,0,0,2,17,14
19990130-W-Australian_Open-F-Amelie_Mauresmo-Martina_Hingis,1,B-DTL,17,6,1,1,4,7,10
19990130-W-Australian_Open-F-Amelie_Mauresmo-Martina_Hingis,1,B-IO,9,4,3,0,1,5,4
19990130-W-Australian_Open-F-Amelie_Mauresmo-Martina_Hingis,1,S-XC,5,0,0,0,0,2,3
19990130-W-Australian_Open-F-Amelie_Mauresmo-Martina_Hingis,1,S-DTM,15,2,0,0,2,6,9
19990130-W-Australian_Open-F-Amelie_Mauresmo-Martina_Hingis,1,S-DTL,2,0,0,0,0,1,1
19990130-W-Australian_Open-F-Amelie_Mauresmo-Martina_Hingis,1,S-IO,2,1,0,0,1,0,2
19990130-W-Australian_Open-F-Amelie_Mauresmo-Martina_Hingis,2,F-XC,42,7,1,2,4,24,18
19990130-W-Australian_Open-F-Amelie_Mauresmo-Martina_Hingis,2,F-DTM,23,2,0,0,2,9,14
19990130-W-Australian_Open-F-Amelie_Mauresmo-Martina_Hingis,2,F-DTL,19,8,3,1,4,10,9
19990130-W-Australian_Open-F-Amelie_Mauresmo-Martina_Hingis,2,F-IO,21,4,2,1,1,14,7
19990130-W-Australian_Open-F-Amelie_Mauresmo-Martina_Hingis,2,B-XC,45,5,3,2,0,23,22
19990130-W-Australian_Open-F-Amelie_Mauresmo-Martina_Hingis,2,B-DTM,27,3,1,1,1,19,8
19990130-W-Australian_Open-F-Amelie_Mauresmo-Martina_Hingis,2,B-DTL,6,3,1,0,2,2,4
19990130-W-Australian_Open-F-Amelie_Mauresmo-Martina_Hingis,2,B-IO,8,2,0,1,1,3,5
19990130-W-Australian_Open-F-Amelie_Mauresmo-Martina_Hingis,2,S-XC,1,0,0,0,0,1,0
19990130-W-Australian_Open-F-Amelie_Mauresmo-Martina_Hingis,2,S-DTM,4,0,0,0,0,1,3
19980131-W-Australian_Open-F-Martina_Hingis-Conchita_Martinez,1,F-XC,50,3,1,0,2,26,24
19980131-W-Australian_Open-F-Martina_Hingis-Conchita_Martinez,1,F-DTM,25,0,0,0,0,13,12
19980131-W-Australian_Open-F-Martina_Hingis-Conchita_Martinez,1,F-DTL,34,4,1,2,1,23,11
19980131-W-Australian_Open-F-Martina_Hingis-Conchita_Martinez,1,F-IO,15,1,1,0,0,6,9
19980131-W-Australian_Open-F-Martina_Hingis-Conchita_Martinez,1,B-XC,104,8,5,1,2,68,36
19980131-W-Australian_Open-F-Martina_Hingis-Conchita_Martinez,1,B-DTM,26,3,0,0,3,13,13
19980131-W-Australian_Open-F-Martina_Hingis-Conchita_Martinez,1,B-DTL,20,9,6,0,3,11,9
19980131-W-Australian_Open-F-Martina_Hingis-Conchita_Martinez,1,B-IO,4,2,2,0,0,2,2
19980131-W-Australian_Open-F-Martina_Hingis-Conchita_Martinez,1,S-XC,4,0,0,0,0,2,2
19980131-W-Australian_Open-F-Martina_Hingis-Conchita_Martinez,1,S-DTM,3,0,0,0,0,0,3
19980131-W-Australian_Open-F-Martina_Hingis-Conchita_Martinez,1,S-DTL,1,0,0,0,0,0,1
19980131-W-Australian_Open-F-Martina_Hingis-Conchita_Martinez,2,F-XC,49,9,3,3,3,26,23
19980131-W-Australian_Open-F-Martina_Hingis-Conchita_Martinez,2,F-DTM,14,0,0,0,0,8,6
19980131-W-Australian_Open-F-Martina_Hingis-Conchita_Martinez,2,F-DTL,27,7,3,0,4,13,14
19980131-W-Australian_Open-F-Martina_Hingis-Conchita_Martinez,2,F-IO,25,8,4,1,3,14,11
19980131-W-Australian_Open-F-Martina_Hingis-Conchita_Martinez,2,F-II,12,4,0,0,4,4,8
19980131-W-Australian_Open-F-Martina_Hingis-Conchita_Martinez,2,B-XC,41,5,0,2,3,15,26
19980131-W-Australian_Open-F-Martina_Hingis-Conchita_Martinez,2,B-DTM,15,2,0,0,2,5,10
19980131-W-Australian_Open-F-Martina_Hingis-Conchita_Martinez,2,B-DTL,17,7,3,1,3,8,9
19980131-W-Australian_Open-F-Martina_Hingis-Conchita_Martinez,2,B-IO,3,2,1,1,0,2,1
19980131-W-Australian_Open-F-Martina_Hingis-Conchita_Martinez,2,S-XC,48,2,0,0,2,18,30
19980131-W-Australian_Open-F-Martina_Hingis-Conchita_Martinez,2,S-DTM,25,1,0,0,1,8,17
19980131-W-Australian_Open-F-Martina_Hingis-Conchita_Martinez,2,S-DTL,27,2,0,0,2,12,15
19980131-W-Australian_Open-F-Martina_Hingis-Conchita_Martinez,2,S-IO,5,0,0,0,0,2,3
20151024-W-Moscow-F-Svetlana_Kuznetsova-Anastasia_Pavlyuchenkova,1,F-XC,17,5,2,1,2,10,7
20151024-W-Moscow-F-Svetlana_Kuznetsova-Anastasia_Pavlyuchenkova,1,F-DTM,8,1,0,1,0,5,3
20151024-W-Moscow-F-Svetlana_Kuznetsova-Anastasia_Pavlyuchenkova,1,F-DTL,7,2,1,0,1,4,3
20151024-W-Moscow-F-Svetlana_Kuznetsova-Anastasia_Pavlyuchenkova,1,F-IO,7,5,3,2,0,6,1
20151024-W-Moscow-F-Svetlana_Kuznetsova-Anastasia_Pavlyuchenkova,1,B-XC,17,5,2,1,2,10,7
20151024-W-Moscow-F-Svetlana_Kuznetsova-Anastasia_Pavlyuchenkova,1,B-DTM,7,0,0,0,0,5,2
20151024-W-Moscow-F-Svetlana_Kuznetsova-Anastasia_Pavlyuchenkova,1,B-DTL,7,6,4,0,2,4,3
20151024-W-Moscow-F-Svetlana_Kuznetsova-Anastasia_Pavlyuchenkova,1,B-IO,1,0,0,0,0,1,0
20151024-W-Moscow-F-Svetlana_Kuznetsova-Anastasia_Pavlyuchenkova,1,S-XC,6,2,1,0,1,3,3
20151024-W-Moscow-F-Svetlana_Kuznetsova-Anastasia_Pavlyuchenkova,1,S-DTM,2,0,0,0,0,2,0
20151024-W-Moscow-F-Svetlana_Kuznetsova-Anastasia_Pavlyuchenkova,1,S-IO,1,1,1,0,0,1,0
20151024-W-Moscow-F-Svetlana_Kuznetsova-Anastasia_Pavlyuchenkova,2,F-XC,20,3,0,0,3,8,12
20151024-W-Moscow-F-Svetlana_Kuznetsova-Anastasia_Pavlyuchenkova,2,F-DTM,2,0,0,0,0,1,1
20151024-W-Moscow-F-Svetlana_Kuznetsova-Anastasia_Pavlyuchenkova,2,F-DTL,9,6,1,1,4,2,7
20151024-W-Moscow-F-Svetlana_Kuznetsova-Anastasia_Pavlyuchenkova,2,F-IO,8,5,1,0,4,3,5
20151024-W-Moscow-F-Svetlana_Kuznetsova-Anastasia_Pavlyuchenkova,2,F-II,1,0,0,0,0,1,0
20151024-W-Moscow-F-Svetlana_Kuznetsova-Anastasia_Pavlyuchenkova,2,B-XC,27,12,5,2,5,14,13
20151024-W-Moscow-F-Svetlana_Kuznetsova-Anastasia_Pavlyuchenkova,2,B-DTM,14,3,1,0,2,4,10
20151024-W-Moscow-F-Svetlana_Kuznetsova-Anastasia_Pavlyuchenkova,2,B-DTL,5,4,2,1,1,3,2
20151024-W-Moscow-F-Svetlana_Kuznetsova-Anastasia_Pavlyuchenkova,2,B-IO,2,1,0,0,1,1,1
20151024-W-Moscow-F-Svetlana_Kuznetsova-Anastasia_Pavlyuchenkova,2,S-DTM,1,0,0,0,0,0,1
20150216-W-Dubai-R64-Anastasia_Pavlyuchenkova-Karolina_Pliskova,1,F-XC,15,5,2,0,3,7,8
20150216-W-Dubai-R64-Anastasia_Pavlyuchenkova-Karolina_Pliskova,1,F-DTM,5,3,0,0,3,1,4
20150216-W-Dubai-R64-Anastasia_Pavlyuchenkova-Karolina_Pliskova,1,F-DTL,6,4,1,0,3,2,4
20150216-W-Dubai-R64-Anastasia_Pavlyuchenkova-Karolina_Pliskova,1,F-IO,14,7,1,2,4,6,8
20150216-W-Dubai-R64-Anastasia_Pavlyuchenkova-Karolina_Pliskova,1,F-II,1,0,0,0,0,0,1
20150216-W-Dubai-R64-Anastasia_Pavlyuchenkova-Karolina_Pliskova,1,B-XC,9,3,2,1,0,4,5
20150216-W-Dubai-R64-Anastasia_Pavlyuchenkova-Karolina_Pliskova,1,B-DTM,13,1,0,0,1,4,9
20150216-W-Dubai-R64-Anastasia_Pavlyuchenkova-Karolina_Pliskova,1,B-DTL,9,4,1,0,3,3,6
20150216-W-Dubai-R64-Anastasia_Pavlyuchenkova-Karolina_Pliskova,1,B-IO,5,2,0,0,2,1,4
20150216-W-Dubai-R64-Anastasia_Pavlyuchenkova-Karolina_Pliskova,1,S-DTM,1,0,0,0,0,0,1
20150216-W-Dubai-R64-Anastasia_Pavlyuchenkova-Karolina_Pliskova,2,F-XC,15,6,2,2,2,10,5
20150216-W-Dubai-R64-Anastasia_Pavlyuchenkova-Karolina_Pliskova,2,F-DTM,14,4,0,1,3,7,7
20150216-W-Dubai-R64-Anastasia_Pavlyuchenkova-Karolina_Pliskova,2,F-DTL,3,1,1,0,0,1,2
20150216-W-Dubai-R64-Anastasia_Pavlyuchenkova-Karolina_Pliskova,2,F-IO,13,5,4,0,1,12,1
20150216-W-Dubai-R64-Anastasia_Pavlyuchenkova-Karolina_Pliskova,2,B-XC,12,2,0,1,1,8,4
20150216-W-Dubai-R64-Anastasia_Pavlyuchenkova-Karolina_Pliskova,2,B-DTM,13,2,0,0,2,6,7
20150216-W-Dubai-R64-Anastasia_Pavlyuchenkova-Karolina_Pliskova,2,B-DTL,3,1,1,0,0,2,1
20150216-W-Dubai-R64-Anastasia_Pavlyuchenkova-Karolina_Pliskova,2,B-IO,1,1,1,0,0,1,0
20150216-W-Dubai-R64-Anastasia_Pavlyuchenkova-Karolina_Pliskova,2,S-XC,1,0,0,0,0,0,1
20150216-W-Dubai-R64-Anastasia_Pavlyuchenkova-Karolina_Pliskova,2,S-DTM,1,0,0,0,0,1,0
20150216-W-Dubai-R64-Anastasia_Pavlyuchenkova-Karolina_Pliskova,2,S-DTL,1,0,0,0,0,1,0
20151002-W-Wuhan-SF-Angelique_Kerber-Garbine_Muguruza,1,F-XC,51,8,5,1,2,26,25
20151002-W-Wuhan-SF-Angelique_Kerber-Garbine_Muguruza,1,F-DTM,33,1,0,0,1,14,19
20151002-W-Wuhan-SF-Angelique_Kerber-Garbine_Muguruza,1,F-DTL,18,8,4,1,3,10,8
20151002-W-Wuhan-SF-Angelique_Kerber-Garbine_Muguruza,1,F-IO,24,13,7,1,5,11,13
20151002-W-Wuhan-SF-Angelique_Kerber-Garbine_Muguruza,1,B-XC,38,6,1,1,4,18,20
20151002-W-Wuhan-SF-Angelique_Kerber-Garbine_Muguruza,1,B-DTM,54,3,0,0,3,23,31
20151002-W-Wuhan-SF-Angelique_Kerber-Garbine_Muguruza,1,B-DTL,9,4,3,0,1,7,2
20151002-W-Wuhan-SF-Angelique_Kerber-Garbine_Muguruza,1,B-IO,11,1,0,0,1,2,9
20151002-W-Wuhan-SF-Angelique_Kerber-Garbine_Muguruza,1,S-XC,2,2,0,0,2,0,2
20151002-W-Wuhan-SF-Angelique_Kerber-Garbine_Muguruza,1,S-DTM,3,0,0,0,0,0,3
20151002-W-Wuhan-SF-Angelique_Kerber-Garbine_Muguruza,1,S-DTL,1,0,0,0,0,0,1
20151002-W-Wuhan-SF-Angelique_Kerber-Garbine_Muguruza,2,F-XC,71,21,5,3,13,33,38
20151002-W-Wuhan-SF-Angelique_Kerber-Garbine_Muguruza,2,F-DTM,35,4,0,1,3,23,12
20151002-W-Wuhan-SF-Angelique_Kerber-Garbine_Muguruza,2,F-DTL,11,7,2,0,5,3,8
20151002-W-Wuhan-SF-Angelique_Kerber-Garbine_Muguruza,2,F-IO,19,9,2,4,3,12,7
20151002-W-Wuhan-SF-Angelique_Kerber-Garbine_Muguruza,2,B-XC,52,18,8,4,6,30,22
20151002-W-Wuhan-SF-Angelique_Kerber-Garbine_Muguruza,2,B-DTM,38,2,0,0,2,24,14
20151002-W-Wuhan-SF-Angelique_Kerber-Garbine_Muguruza,2,B-DTL,8,5,3,0,2,6,2
20151002-W-Wuhan-SF-Angelique_Kerber-Garbine_Muguruza,2,B-IO,7,3,2,0,1,3,4
20151002-W-Wuhan-SF-Angelique_Kerber-Garbine_Muguruza,2,S-DTM,4,0,0,0,0,1,3
20150807-W-Cincinnati-R64-Alison_Riske-Elina_Svitolina,1,F-XC,78,13,4,2,7,36,42
20150807-W-Cincinnati-R64-Alison_Riske-Elina_Svitolina,1,F-DTM,53,10,0,0,10,22,31
20150807-W-Cincinnati-R64-Alison_Riske-Elina_Svitolina,1,F-DTL,23,6,1,1,4,10,13
20150807-W-Cincinnati-R64-Alison_Riske-Elina_Svitolina,1,F-IO,26,8,2,2,4,12,14
20150807-W-Cincinnati-R64-Alison_Riske-Elina_Svitolina,1,B-XC,59,7,0,1,6,22,37
20150807-W-Cincinnati-R64-Alison_Riske-Elina_Svitolina,1,B-DTM,60,6,0,0,6,26,34
20150807-W-Cincinnati-R64-Alison_Riske-Elina_Svitolina,1,B-DTL,18,5,3,0,2,9,9
20150807-W-Cincinnati-R64-Alison_Riske-Elina_Svitolina,1,B-IO,22,6,1,1,4,11,11
20150807-W-Cincinnati-R64-Alison_Riske-Elina_Svitolina,1,S-XC,4,1,0,1,0,3,1
20150807-W-Cincinnati-R64-Alison_Riske-Elina_Svitolina,2,F-XC,71,4,1,2,1,41,30
20150807-W-Cincinnati-R64-Alison_Riske-Elina_Svitolina,2,F-DTM,78,4,0,0,4,40,38
20150807-W-Cincinnati-R64-Alison_Riske-Elina_Svitolina,2,F-DTL,10,5,1,0,4,3,7
20150807-W-Cincinnati-R64-Alison_Riske-Elina_Svitolina,2,F-IO,12,6,2,1,3,8,4
20150807-W-Cincinnati-R64-Alison_Riske-Elina_Svitolina,2,B-XC,56,10,1,4,5,28,28
20150807-W-Cincinnati-R64-Alison_Riske-Elina_Svitolina,2,B-DTM,59,8,0,2,6,32,27
20150807-W-Cincinnati-R64-Alison_Riske-Elina_Svitolina,2,B-DTL,10,7,5,0,2,6,4
20150807-W-Cincinnati-R64-Alison_Riske-Elina_Svitolina,2,B-IO,5,1,1,0,0,2,3
20150807-W-Cincinnati-R64-Alison_Riske-Elina_Svitolina,2,S-XC,3,0,0,0,0,2,1
20150807-W-Cincinnati-R64-Alison_Riske-Elina_Svitolina,2,S-DTM,20,0,0,0,0,9,11
20150807-W-Cincinnati-R64-Alison_Riske-Elina_Svitolina,2,S-DTL,1,0,0,0,0,1,0
20160126-W-Australian_Open-QF-Serena_Williams-Maria_Sharapova,1,F-XC,15,9,2,3,4,8,7
20160126-W-Australian_Open-QF-Serena_Williams-Maria_Sharapova,1,F-DTM,10,2,1,0,1,4,6
20160126-W-Australian_Open-QF-Serena_Williams-Maria_Sharapova,1,F-DTL,5,5,1,2,2,3,2
20160126-W-Australian_Open-QF-Serena_Williams-Maria_Sharapova,1,F-IO,10,5,4,0,1,7,3
20160126-W-Australian_Open-QF-Serena_Williams-Maria_Sharapova,1,B-XC,13,3,2,0,1,6,7
20160126-W-Australian_Open-QF-Serena_Williams-Maria_Sharapova,1,B-DTM,13,0,0,0,0,8,5
20160126-W-Australian_Open-QF-Serena_Williams-Maria_Sharapova,1,B-DTL,3,2,1,0,1,1,2
20160126-W-Australian_Open-QF-Serena_Williams-Maria_Sharapova,1,B-IO,5,2,1,0,1,3,2
20160126-W-Australian_Open-QF-Serena_Williams-Maria_Sharapova,1,S-DTM,1,0,0,0,0,0,1
20160126-W-Australian_Open-QF-Serena_Williams-Maria_Sharapova,2,F-XC,18,8,4,2,2,10,8
20160126-W-Australian_Open-QF-Serena_Williams-Maria_Sharapova,2,F-DTM,8,1,0,0,1,2,6
20160126-W-Australian_Open-QF-Serena_Williams-Maria_Sharapova,2,F-DTL,6,1,0,1,0,2,4
20160126-W-Australian_Open-QF-Serena_Williams-Maria_Sharapova,2,F-IO,9,5,1,3,1,7,2
20160126-W-Australian_Open-QF-Serena_Williams-Maria_Sharapova,2,B-XC,9,2,0,0,2,5,4
20160126-W-Australian_Open-QF-Serena_Williams-Maria_Sharapova,2,B-DTM,15,1,0,0,1,6,9
20160126-W-Australian_Open-QF-Serena_Williams-Maria_Sharapova,2,B-DTL,4,3,1,2,0,4,0
20160126-W-Australian_Open-QF-Serena_Williams-Maria_Sharapova,2,B-IO,3,1,0,0,1,1,2
20120802-W-Olympics-QF-Kim_Clijsters-Maria_Sharapova,1,F-XC,34,9,2,3,4,19,15
20120802-W-Olympics-QF-Kim_Clijsters-Maria_Sharapova,1,F-DTM,16,1,0,0,1,3,13
20120802-W-Olympics-QF-Kim_Clijsters-Maria_Sharapova,1,F-DTL,11,3,1,0,2,5,6
20120802-W-Olympics-QF-Kim_Clijsters-Maria_Sharapova,1,F-IO,10,7,1,3,3,7,3
20120802-W-Olympics-QF-Kim_Clijsters-Maria_Sharapova,1,B-XC,18,4,0,1,3,8,10
20120802-W-Olympics-QF-Kim_Clijsters-Maria_Sharapova,1,B-DTM,19,1,0,0,1,8,11
20120802-W-Olympics-QF-Kim_Clijsters-Maria_Sharapova,1,B-DTL,2,1,0,0,1,0,2
20120802-W-Olympics-QF-Kim_Clijsters-Maria_Sharapova,1,B-IO,4,1,0,0,1,1,3
20120802-W-Olympics-QF-Kim_Clijsters-Maria_Sharapova,1,S-XC,6,0,0,0,0,2,4
20120802-W-Olympics-QF-Kim_Clijsters-Maria_Sharapova,1,S-DTM,3,2,0,0,2,1,2
20120802-W-Olympics-QF-Kim_Clijsters-Maria_Sharapova,2,F-XC,30,13,1,3,9,14,16
20120802-W-Olympics-QF-Kim_Clijsters-Maria_Sharapova,2,F-DTM,13,2,1,0,1,8,5
20120802-W-Olympics-QF-Kim_Clijsters-Maria_Sharapova,2,F-DTL,9,4,2,1,1,6,3
20120802-W-Olympics-QF-Kim_Clijsters-Maria_Sharapova,2,F-IO,18,11,8,1,2,12,6
20120802-W-Olympics-QF-Kim_Clijsters-Maria_Sharapova,2,B-XC,25,9,2,3,4,17,8
20120802-W-Olympics-QF-Kim_Clijsters-Maria_Sharapova,2,B-DTM,19,2,0,0,2,8,11
20120802-W-Olympics-QF-Kim_Clijsters-Maria_Sharapova,2,B-DTL,14,5,1,1,3,7,7
20120802-W-Olympics-QF-Kim_Clijsters-Maria_Sharapova,2,B-IO,6,0,0,0,0,4,2
20120802-W-Olympics-QF-Kim_Clijsters-Maria_Sharapova,2,S-DTL,1,0,0,0,0,0,1
19980704-W-Wimbledon-F-Nathalie_Tauziat-Jana_Novotna,1,F-XC,7,2,1,0,1,2,5
19980704-W-Wimbledon-F-Nathalie_Tauziat-Jana_Novotna,1,F-DTM,4,1,0,0,1,1,3
19980704-W-Wimbledon-F-Nathalie_Tauziat-Jana_Novotna,1,F-DTL,6,3,1,1,1,3,3
19980704-W-Wimbledon-F-Nathalie_Tauziat-Jana_Novotna,1,F-IO,3,2,0,0,2,1,2
19980704-W-Wimbledon-F-Nathalie_Tauziat-Jana_Novotna,1,B-XC,6,5,1,1,3,2,4
19980704-W-Wimbledon-F-Nathalie_Tauziat-Jana_Novotna,1,B-DTM,2,0,0,0,0,1,1
19980704-W-Wimbledon-F-Nathalie_Tauziat-Jana_Novotna,1,B-DTL,3,1,0,0,1,0,3
19980704-W-Wimbledon-F-Nathalie_Tauziat-Jana_Novotna,1,B-IO,3,2,0,0,2,0,3
19980704-W-Wimbledon-F-Nathalie_Tauziat-Jana_Novotna,1,S-XC,3,0,0,0,0,2,1
19980704-W-Wimbledon-F-Nathalie_Tauziat-Jana_Novotna,1,S-DTM,7,0,0,0,0,4,3
19980704-W-Wimbledon-F-Nathalie_Tauziat-Jana_Novotna,1,S-DTL,2,1,0,0,1,0,2
19980704-W-Wimbledon-F-Nathalie_Tauziat-Jana_Novotna,1,S-IO,1,0,0,0,0,1,0
19980704-W-Wimbledon-F-Nathalie_Tauziat-Jana_Novotna,2,F-XC,10,4,0,1,3,7,3
19980704-W-Wimbledon-F-Nathalie_Tauziat-Jana_Novotna,2,F-DTM,2,1,0,1,0,2,0
19980704-W-Wimbledon-F-Nathalie_Tauziat-Jana_Novotna,2,F-DTL,2,1,1,0,0,1,1
19980704-W-Wimbledon-F-Nathalie_Tauziat-Jana_Novotna,2,F-IO,2,1,1,0,0,2,0
19980704-W-Wimbledon-F-Nathalie_Tauziat-Jana_Novotna,2,B-XC,2,2,0,0,2,0,2
19980704-W-Wimbledon-F-Nathalie_Tauziat-Jana_Novotna,2,B-DTM,1,0,0,0,0,0,1
19980704-W-Wimbledon-F-Nathalie_Tauziat-Jana_Novotna,2,S-XC,8,1,1,0,0,7,1
19980704-W-Wimbledon-F-Nathalie_Tauziat-Jana_Novotna,2,S-DTM,9,0,0,0,0,2,7
19980704-W-Wimbledon-F-Nathalie_Tauziat-Jana_Novotna,2,S-DTL,2,0,0,0,0,1,1
19980704-W-Wimbledon-F-Nathalie_Tauziat-Jana_Novotna,2,S-IO,2,1,1,0,0,2,0
20060610-W-Roland_Garros-F-Svetlana_Kuznetsova-Justine_Henin,1,F-XC,45,13,2,1,10,25,20
20060610-W-Roland_Garros-F-Svetlana_Kuznetsova-Justine_Henin,1,F-DTM,37,3,0,0,3,22,15
20060610-W-Roland_Garros-F-Svetlana_Kuznetsova-Justine_Henin,1,F-DTL,10,3,1,0,2,5,5
20060610-W-Roland_Garros-F-Svetlana_Kuznetsova-Justine_Henin,1,F-IO,41,12,6,3,3,24,17
20060610-W-Roland_Garros-F-Svetlana_Kuznetsova-Justine_Henin,1,F-II,9,3,1,0,2,4,5
20060610-W-Roland_Garros-F-Svetlana_Kuznetsova-Justine_Henin,1,B-XC,30,5,0,3,2,18,12
20060610-W-Roland_Garros-F-Svetlana_Kuznetsova-Justine_Henin,1,B-DTM,20,2,0,0,2,14,6
20060610-W-Roland_Garros-F-Svetlana_Kuznetsova-Justine_Henin,1,B-DTL,13,2,2,0,0,9,4
20060610-W-Roland_Garros-F-Svetlana_Kuznetsova-Justine_Henin,1,B-IO,5,0,0,0,0,3,2
20060610-W-Roland_Garros-F-Svetlana_Kuznetsova-Justine_Henin,1,S-XC,3,0,0,0,0,2,1
20060610-W-Roland_Garros-F-Svetlana_Kuznetsova-Justine_Henin,1,S-DTM,2,0,0,0,0,1,1
20060610-W-Roland_Garros-F-Svetlana_Kuznetsova-Justine_Henin,1,S-DTL,2,0,0,0,0,1,1
20060610-W-Roland_Garros-F-Svetlana_Kuznetsova-Justine_Henin,2,F-XC,37,13,3,2,8,14,23
20060610-W-Roland_Garros-F-Svetlana_Kuznetsova-Justine_Henin,2,F-DTM,38,4,0,2,2,17,21
20060610-W-Roland_Garros-F-Svetlana_Kuznetsova-Justine_Henin,2,F-DTL,16,3,3,0,0,6,10
20060610-W-Roland_Garros-F-Svetlana_Kuznetsova-Justine_Henin,2,F-IO,20,3,0,1,2,7,13
20060610-W-Roland_Garros-F-Svetlana_Kuznetsova-Justine_Henin,2,F-II,1,0,0,0,0,0,1
20060610-W-Roland_Garros-F-Svetlana_Kuznetsova-Justine_Henin,2,B-XC,26,6,2,0,4,11,15
20060610-W-Roland_Garros-F-Svetlana_Kuznetsova-Justine_Henin,2,B-DTM,38,3,0,0,3,19,19
20060610-W-Roland_Garros-F-Svetlana_Kuznetsova-Justine_Henin,2,B-DTL,5,0,0,0,0,2,3
20060610-W-Roland_Garros-F-Svetlana_Kuznetsova-Justine_Henin,2,B-IO,5,4,1,0,3,2,3
20060610-W-Roland_Garros-F-Svetlana_Kuznetsova-Justine_Henin,2,S-XC,10,1,0,0,1,3,7
20060610-W-Roland_Garros-F-Svetlana_Kuznetsova-Justine_Henin,2,S-DTM,11,0,0,0,0,3,8
20060610-W-Roland_Garros-F-Svetlana_Kuznetsova-Justine_Henin,2,S-DTL,1,0,0,0,0,0,1
20120803-W-Olympics-SF-Serena_Williams-Victoria_Azarenka,1,F-XC,18,4,1,1,2,10,8
20120803-W-Olympics-SF-Serena_Williams-Victoria_Azarenka,1,F-DTM,13,0,0,0,0,7,6
20120803-W-Olympics-SF-Serena_Williams-Victoria_Azarenka,1,F-DTL,7,4,3,0,1,4,3
20120803-W-Olympics-SF-Serena_Williams-Victoria_Azarenka,1,F-IO,5,2,1,0,1,2,3
20120803-W-Olympics-SF-Serena_Williams-Victoria_Azarenka,1,B-XC,15,5,3,0,2,11,4
20120803-W-Olympics-SF-Serena_Williams-Victoria_Azarenka,1,B-DTM,13,0,0,0,0,8,5
20120803-W-Olympics-SF-Serena_Williams-Victoria_Azarenka,1,B-DTL,10,5,2,1,2,6,4
20120803-W-Olympics-SF-Serena_Williams-Victoria_Azarenka,1,B-IO,6,1,1,0,0,5,1
20120803-W-Olympics-SF-Serena_Williams-Victoria_Azarenka,1,S-XC,2,0,0,0,0,1,1
20120803-W-Olympics-SF-Serena_Williams-Victoria_Azarenka,1,S-DTM,2,0,0,0,0,1,1
20120803-W-Olympics-SF-Serena_Williams-Victoria_Azarenka,1,S-DTL,1,0,0,0,0,0,1
20120803-W-Olympics-SF-Serena_Williams-Victoria_Azarenka,2,F-XC,19,6,2,1,3,11,8
20120803-W-Olympics-SF-Serena_Williams-Victoria_Azarenka,2,F-DTM,11,3,1,0,2,3,8
20120803-W-Olympics-SF-Serena_Williams-Victoria_Azarenka,2,F-DTL,9,4,2,0,2,3,6
20120803-W-Olympics-SF-Serena_Williams-Victoria_Azarenka,2,F-IO,17,6,3,0,3,6,11
20120803-W-Olympics-SF-Serena_Williams-Victoria_Azarenka,2,B-XC,13,2,0,0,2,3,10
20120803-W-Olympics-SF-Serena_Williams-Victoria_Azarenka,2,B-DTM,12,2,0,1,1,4,8
20120803-W-Olympics-SF-Serena_Williams-Victoria_Azarenka,2,B-DTL,3,0,0,0,0,1,2
20120803-W-Olympics-SF-Serena_Williams-Victoria_Azarenka,2,B-IO,7,0,0,0,0,3,4
20120803-W-Olympics-SF-Serena_Williams-Victoria_Azarenka,2,S-DTL,2,1,0,0,1,0,2
20120803-W-Olympics-SF-Serena_Williams-Victoria_Azarenka,2,S-IO,1,0,0,0,0,1,0
20120731-W-Olympics-R32-Aleksandra_Wozniak-Venus_Williams,1,F-XC,26,7,0,2,5,10,16
20120731-W-Olympics-R32-Aleksandra_Wozniak-Venus_Williams,1,F-DTM,16,1,0,0,1,11,5
20120731-W-Olympics-R32-Aleksandra_Wozniak-Venus_Williams,1,F-DTL,12,4,1,2,1,6,6
20120731-W-Olympics-R32-Aleksandra_Wozniak-Venus_Williams,1,F-IO,13,3,1,0,2,6,7
20120731-W-Olympics-R32-Aleksandra_Wozniak-Venus_Williams,1,B-XC,12,4,3,0,1,7,5
20120731-W-Olympics-R32-Aleksandra_Wozniak-Venus_Williams,1,B-DTM,15,2,0,1,1,8,7
20120731-W-Olympics-R32-Aleksandra_Wozniak-Venus_Williams,1,B-DTL,3,1,0,0,1,1,2
20120731-W-Olympics-R32-Aleksandra_Wozniak-Venus_Williams,1,B-IO,1,0,0,0,0,1,0
20120731-W-Olympics-R32-Aleksandra_Wozniak-Venus_Williams,1,S-XC,3,0,0,0,0,1,2
20120731-W-Olympics-R32-Aleksandra_Wozniak-Venus_Williams,1,S-DTM,3,0,0,0,0,0,3
20120731-W-Olympics-R32-Aleksandra_Wozniak-Venus_Williams,2,F-XC,34,10,5,1,4,15,19
20120731-W-Olympics-R32-Aleksandra_Wozniak-Venus_Williams,2,F-DTM,13,1,1,0,0,6,7
20120731-W-Olympics-R32-Aleksandra_Wozniak-Venus_Williams,2,F-DTL,7,5,2,0,3,4,3
20120731-W-Olympics-R32-Aleksandra_Wozniak-Venus_Williams,2,F-IO,13,8,4,2,2,10,3
20120731-W-Olympics-R32-Aleksandra_Wozniak-Venus_Williams,2,B-XC,11,2,0,0,2,4,7
20120731-W-Olympics-R32-Aleksandra_Wozniak-Venus_Williams,2,B-DTM,16,1,0,0,1,8,8
20120731-W-Olympics-R32-Aleksandra_Wozniak-Venus_Williams,2,B-DTL,12,6,4,1,1,8,4
20120731-W-Olympics-R32-Aleksandra_Wozniak-Venus_Williams,2,B-IO,5,2,1,0,1,3,2
20120731-W-Olympics-R32-Aleksandra_Wozniak-Venus_Williams,2,S-DTM,1,0,0,0,0,1,0
20120731-W-Olympics-R32-Aleksandra_Wozniak-Venus_Williams,2,S-DTL,1,1,1,0,0,1,0
20110112-W-Hobart-R16-Alicia_Molik-Sara_Errani,1,F-XC,20,7,2,1,4,12,8
20110112-W-Hobart-R16-Alicia_Molik-Sara_Errani,1,F-DTM,3,2,0,0,2,0,3
20110112-W-Hobart-R16-Alicia_Molik-Sara_Errani,1,F-DTL,7,4,1,1,2,4,3
20110112-W-Hobart-R16-Alicia_Molik-Sara_Errani,1,F-IO,11,2,1,0,1,5,6
20110112-W-Hobart-R16-Alicia_Molik-Sara_Errani,1,F-II,9,2,1,0,1,5,4
20110112-W-Hobart-R16-Alicia_Molik-Sara_Errani,1,B-XC,19,2,0,0,2,10,9
20110112-W-Hobart-R16-Alicia_Molik-Sara_Errani,1,B-DTM,12,0,0,0,0,5,7
20110112-W-Hobart-R16-Alicia_Molik-Sara_Errani,1,B-DTL,3,0,0,0,0,0,3
20110112-W-Hobart-R16-Alicia_Molik-Sara_Errani,1,S-XC,23,4,2,0,2,12,11
20110112-W-Hobart-R16-Alicia_Molik-Sara_Errani,1,S-DTM,12,1,0,0,1,3,9
20110112-W-Hobart-R16-Alicia_Molik-Sara_Errani,1,S-DTL,9,2,0,0,2,3,6
20110112-W-Hobart-R16-Alicia_Molik-Sara_Errani,2,F-XC,19,6,4,2,0,11,8
20110112-W-Hobart-R16-Alicia_Molik-Sara_Errani,2,F-DTM,12,0,0,0,0,6,6
20110112-W-Hobart-R16-Alicia_Molik-Sara_Errani,2,F-DTL,7,2,0,1,1,3,4
20110112-W-Hobart-R16-Alicia_Molik-Sara_Errani,2,F-IO,16,1,1,0,0,12,4
20110112-W-Hobart-R16-Alicia_Molik-Sara_Errani,2,F-II,3,2,2,0,0,2,1
20110112-W-Hobart-R16-Alicia_Molik-Sara_Errani,2,B-XC,26,3,0,1,2,15,11
20110112-W-Hobart-R16-Alicia_Molik-Sara_Errani,2,B-DTM,11,1,1,0,0,6,5
20110112-W-Hobart-R16-Alicia_Molik-Sara_Errani,2,B-DTL,2,2,0,1,1,1,1
20110112-W-Hobart-R16-Alicia_Molik-Sara_Errani,2,S-XC,16,2,1,0,1,6,10
20110112-W-Hobart-R16-Alicia_Molik-Sara_Errani,2,S-DTM,3,0,0,0,0,2,1
20110112-W-Hobart-R16-Alicia_Molik-Sara_Errani,2,S-DTL,2,1,0,0,1,0,2
20110112-W-Hobart-R16-Alicia_Molik-Sara_Errani,2,S-IO,1,0,0,0,0,1,0
20130413-W-Katowice-F-Petra_Kvitova-Roberta_Vinci,1,F-XC,35,13,2,5,6,15,20
20130413-W-Katowice-F-Petra_Kvitova-Roberta_Vinci,1,F-DTM,11,1,0,0,1,4,7
20130413-W-Katowice-F-Petra_Kvitova-Roberta_Vinci,1,F-DTL,21,14,4,1,9,6,15
20130413-W-Katowice-F-Petra_Kvitova-Roberta_Vinci,1,F-IO,11,4,2,0,2,7,4
20130413-W-Katowice-F-Petra_Kvitova-Roberta_Vinci,1,F-II,1,0,0,0,0,0,1
20130413-W-Katowice-F-Petra_Kvitova-Roberta_Vinci,1,B-XC,21,4,1,1,2,10,11
20130413-W-Katowice-F-Petra_Kvitova-Roberta_Vinci,1,B-DTM,12,0,0,0,0,4,8
20130413-W-Katowice-F-Petra_Kvitova-Roberta_Vinci,1,B-DTL,8,4,0,3,1,4,4
20130413-W-Katowice-F-Petra_Kvitova-Roberta_Vinci,1,B-IO,5,3,2,1,0,3,2
20130413-W-Katowice-F-Petra_Kvitova-Roberta_Vinci,1,S-XC,4,1,0,1,0,2,2
20130413-W-Katowice-F-Petra_Kvitova-Roberta_Vinci,1,S-DTM,2,0,0,0,0,0,2
20130413-W-Katowice-F-Petra_Kvitova-Roberta_Vinci,1,S-DTL,2,0,0,0,0,0,2
20130413-W-Katowice-F-Petra_Kvitova-Roberta_Vinci,1,S-IO,1,1,0,0,1,0,1
20130413-W-Katowice-F-Petra_Kvitova-Roberta_Vinci,2,F-XC,32,8,2,3,3,20,12
20130413-W-Katowice-F-Petra_Kvitova-Roberta_Vinci,2,F-DTM,17,2,2,0,0,11,6
20130413-W-Katowice-F-Petra_Kvitova-Roberta_Vinci,2,F-DTL,9,4,1,3,0,6,3
20130413-W-Katowice-F-Petra_Kvitova-Roberta_Vinci,2,F-IO,14,6,3,3,0,10,4
20130413-W-Katowice-F-Petra_Kvitova-Roberta_Vinci,2,B-DTM,1,0,0,0,0,0,1
20130413-W-Katowice-F-Petra_Kvitova-Roberta_Vinci,2,B-DTL,1,1,0,0,1,0,1
20130413-W-Katowice-F-Petra_Kvitova-Roberta_Vinci,2,S-XC,19,3,1,1,1,14,5
20130413-W-Katowice-F-Petra_Kvitova-Roberta_Vinci,2,S-DTM,14,0,0,0,0,7,7
20130413-W-Katowice-F-Petra_Kvitova-Roberta_Vinci,2,S-DTL,3,0,0,0,0,2,1
20130413-W-Katowice-F-Petra_Kvitova-Roberta_Vinci,2,S-IO,3,2,1,1,0,2,1
20150225-W-Doha-R16-Ekaterina_Makarova-Lucie_Safarova,1,F-XC,47,17,2,5,10,20,27
20150225-W-Doha-R16-Ekaterina_Makarova-Lucie_Safarova,1,F-DTM,25,1,0,0,1,11,14
20150225-W-Doha-R16-Ekaterina_Makarova-Lucie_Safarova,1,F-DTL,31,15,3,4,8,15,16
20150225-W-Doha-R16-Ekaterina_Makarova-Lucie_Safarova,1,F-IO,27,12,0,6,6,13,14
20150225-W-Doha-R16-Ekaterina_Makarova-Lucie_Safarova,1,B-XC,44,7,0,2,5,20,24
20150225-W-Doha-R16-Ekaterina_Makarova-Lucie_Safarova,1,B-DTM,33,2,0,0,2,11,22
20150225-W-Doha-R16-Ekaterina_Makarova-Lucie_Safarova,1,B-DTL,13,5,4,0,1,8,5
20150225-W-Doha-R16-Ekaterina_Makarova-Lucie_Safarova,1,B-IO,8,4,1,1,2,4,4
20150225-W-Doha-R16-Ekaterina_Makarova-Lucie_Safarova,1,S-DTM,1,0,0,0,0,0,1
20150225-W-Doha-R16-Ekaterina_Makarova-Lucie_Safarova,2,F-XC,64,13,7,3,3,36,28
20150225-W-Doha-R16-Ekaterina_Makarova-Lucie_Safarova,2,F-DTM,36,2,0,0,2,16,20
20150225-W-Doha-R16-Ekaterina_Makarova-Lucie_Safarova,2,F-DTL,18,9,7,0,2,13,5
20150225-W-Doha-R16-Ekaterina_Makarova-Lucie_Safarova,2,F-IO,9,6,4,2,0,8,1
20150225-W-Doha-R16-Ekaterina_Makarova-Lucie_Safarova,2,F-II,2,2,1,1,0,2,0
20150225-W-Doha-R16-Ekaterina_Makarova-Lucie_Safarova,2,B-XC,30,8,5,1,2,20,10
20150225-W-Doha-R16-Ekaterina_Makarova-Lucie_Safarova,2,B-DTM,38,4,1,0,3,19,19
20150225-W-Doha-R16-Ekaterina_Makarova-Lucie_Safarova,2,B-DTL,26,6,0,1,5,13,13
20150225-W-Doha-R16-Ekaterina_Makarova-Lucie_Safarova,2,B-IO,9,2,1,0,1,5,4
20150225-W-Doha-R16-Ekaterina_Makarova-Lucie_Safarova,2,S-DTM,8,0,0,0,0,3,5
20150225-W-Doha-R16-Ekaterina_Makarova-Lucie_Safarova,2,S-DTL,1,0,0,0,0,0,1
20050702-W-Wimbledon-F-Venus_Williams-Lindsay_Davenport,1,F-XC,76,19,12,2,5,57,19
20050702-W-Wimbledon-F-Venus_Williams-Lindsay_Davenport,1,F-DTM,55,5,1,1,3,32,23
20050702-W-Wimbledon-F-Venus_Williams-Lindsay_Davenport,1,F-DTL,16,7,3,1,3,10,6
20050702-W-Wimbledon-F-Venus_Williams-Lindsay_Davenport,1,F-IO,24,11,4,1,6,11,13
20050702-W-Wimbledon-F-Venus_Williams-Lindsay_Davenport,1,F-II,1,0,0,0,0,1,0
20050702-W-Wimbledon-F-Venus_Williams-Lindsay_Davenport,1,B-XC,64,10,4,3,3,46,18
20050702-W-Wimbledon-F-Venus_Williams-Lindsay_Davenport,1,B-DTM,56,9,0,4,5,33,23
20050702-W-Wimbledon-F-Venus_Williams-Lindsay_Davenport,1,B-DTL,12,6,4,1,1,10,2
20050702-W-Wimbledon-F-Venus_Williams-Lindsay_Davenport,1,B-IO,17,8,4,2,2,10,7
20050702-W-Wimbledon-F-Venus_Williams-Lindsay_Davenport,1,S-DTM,2,0,0,0,0,0,2
20050702-W-Wimbledon-F-Venus_Williams-Lindsay_Davenport,1,S-DTL,1,1,1,0,0,1,0
20050702-W-Wimbledon-F-Venus_Williams-Lindsay_Davenport,2,F-XC,75,22,7,5,10,28,47
20050702-W-Wimbledon-F-Venus_Williams-Lindsay_Davenport,2,F-DTM,46,7,0,1,6,14,32
20050702-W-Wimbledon-F-Venus_Williams-Lindsay_Davenport,2,F-DTL,14,9,3,2,4,7,7
20050702-W-Wimbledon-F-Venus_Williams-Lindsay_Davenport,2,F-IO,16,9,4,4,1,11,5
20050702-W-Wimbledon-F-Venus_Williams-Lindsay_Davenport,2,B-XC,60,14,0,5,9,22,38
20050702-W-Wimbledon-F-Venus_Williams-Lindsay_Davenport,2,B-DTM,55,2,0,0,2,16,39
20050702-W-Wimbledon-F-Venus_Williams-Lindsay_Davenport,2,B-DTL,20,9,5,2,2,9,11
20050702-W-Wimbledon-F-Venus_Williams-Lindsay_Davenport,2,B-IO,21,5,1,2,2,11,10
20050702-W-Wimbledon-F-Venus_Williams-Lindsay_Davenport,2,S-XC,3,0,0,0,0,1,2
20050702-W-Wimbledon-F-Venus_Williams-Lindsay_Davenport,2,S-DTM,6,0,0,0,0,1,5
20050702-W-Wimbledon-F-Venus_Williams-Lindsay_Davenport,2,S-DTL,1,0,0,0,0,1,0
20160213-W-Kaohsiung-SF-Misaki_Doi-Su_Wei_Hsieh,1,F-XC,18,6,1,3,2,10,8
20160213-W-Kaohsiung-SF-Misaki_Doi-Su_Wei_Hsieh,1,F-DTM,10,2,0,0,2,5,5
20160213-W-Kaohsiung-SF-Misaki_Doi-Su_Wei_Hsieh,1,F-DTL,1,0,0,0,0,1,0
20160213-W-Kaohsiung-SF-Misaki_Doi-Su_Wei_Hsieh,1,F-IO,8,5,2,1,2,5,3
20160213-W-Kaohsiung-SF-Misaki_Doi-Su_Wei_Hsieh,1,B-XC,10,5,3,2,0,10,0
20160213-W-Kaohsiung-SF-Misaki_Doi-Su_Wei_Hsieh,1,B-DTM,7,2,0,1,1,2,5
20160213-W-Kaohsiung-SF-Misaki_Doi-Su_Wei_Hsieh,1,S-XC,5,0,0,0,0,3,2
20160213-W-Kaohsiung-SF-Misaki_Doi-Su_Wei_Hsieh,1,S-DTM,3,0,0,0,0,3,0
20160213-W-Kaohsiung-SF-Misaki_Doi-Su_Wei_Hsieh,2,F-XC,10,3,2,0,1,4,6
20160213-W-Kaohsiung-SF-Misaki_Doi-Su_Wei_Hsieh,2,F-DTM,7,3,0,0,3,1,6
20160213-W-Kaohsiung-SF-Misaki_Doi-Su_Wei_Hsieh,2,F-DTL,2,2,0,0,2,0,2
20160213-W-Kaohsiung-SF-Misaki_Doi-Su_Wei_Hsieh,2,F-IO,7,2,0,1,1,5,2
20160213-W-Kaohsiung-SF-Misaki_Doi-Su_Wei_Hsieh,2,B-XC,11,5,2,1,2,8,3
20160213-W-Kaohsiung-SF-Misaki_Doi-Su_Wei_Hsieh,2,B-DTM,12,2,0,0,2,3,9
20160213-W-Kaohsiung-SF-Misaki_Doi-Su_Wei_Hsieh,2,B-DTL,1,1,0,0,1,0,1
20160213-W-Kaohsiung-SF-Misaki_Doi-Su_Wei_Hsieh,2,B-IO,9,5,2,0,3,2,7
20160213-W-Kaohsiung-SF-Misaki_Doi-Su_Wei_Hsieh,2,S-DTM,1,0,0,0,0,0,1
19890128-W-Australian_Open-F-Helena_Sukova-Steffi_Graf,1,F-XC,16,5,1,3,1,9,7
19890128-W-Australian_Open-F-Helena_Sukova-Steffi_Graf,1,F-DTM,13,2,2,0,0,8,5
19890128-W-Australian_Open-F-Helena_Sukova-Steffi_Graf,1,F-DTL,4,3,0,0,3,1,3
19890128-W-Australian_Open-F-Helena_Sukova-Steffi_Graf,1,F-IO,8,4,0,2,2,5,3
19890128-W-Australian_Open-F-Helena_Sukova-Steffi_Graf,1,B-XC,3,0,0,0,0,0,3
19890128-W-Australian_Open-F-Helena_Sukova-Steffi_Graf,1,B-DTM,2,0,0,0,0,1,1
19890128-W-Australian_Open-F-Helena_Sukova-Steffi_Graf,1,B-DTL,1,0,0,0,0,0,1
19890128-W-Australian_Open-F-Helena_Sukova-Steffi_Graf,1,B-IO,1,0,0,0,0,1,0
19890128-W-Australian_Open-F-Helena_Sukova-Steffi_Graf,1,S-XC,16,1,1,0,0,8,8
19890128-W-Australian_Open-F-Helena_Sukova-Steffi_Graf,1,S-DTM,10,2,0,1,1,7,3
19890128-W-Australian_Open-F-Helena_Sukova-Steffi_Graf,1,S-DTL,3,0,0,0,0,2,1
19890128-W-Australian_Open-F-Helena_Sukova-Steffi_Graf,1,S-IO,5,3,0,0,3,1,4
19890128-W-Australian_Open-F-Helena_Sukova-Steffi_Graf,2,F-XC,25,9,3,4,2,12,13
19890128-W-Australian_Open-F-Helena_Sukova-Steffi_Graf,2,F-DTM,19,2,1,0,1,9,10
19890128-W-Australian_Open-F-Helena_Sukova-Steffi_Graf,2,F-DTL,9,5,2,2,1,6,3
19890128-W-Australian_Open-F-Helena_Sukova-Steffi_Graf,2,F-IO,9,3,0,3,0,5,4
19890128-W-Australian_Open-F-Helena_Sukova-Steffi_Graf,2,F-II,1,1,0,0,1,0,1
19890128-W-Australian_Open-F-Helena_Sukova-Steffi_Graf,2,B-XC,3,2,1,0,1,2,1
19890128-W-Australian_Open-F-Helena_Sukova-Steffi_Graf,2,B-DTM,7,3,0,1,2,1,6
19890128-W-Australian_Open-F-Helena_Sukova-Steffi_Graf,2,B-DTL,6,5,3,1,1,4,2
19890128-W-Australian_Open-F-Helena_Sukova-Steffi_Graf,2,B-IO,2,1,1,0,0,2,0
19890128-W-Australian_Open-F-Helena_Sukova-Steffi_Graf,2,S-XC,11,2,0,1,1,5,6
19890128-W-Australian_Open-F-Helena_Sukova-Steffi_Graf,2,S-DTM,9,1,0,0,1,4,5
19890128-W-Australian_Open-F-Helena_Sukova-Steffi_Graf,2,S-DTL,2,1,0,1,0,2,0
19890128-W-Australian_Open-F-Helena_Sukova-Steffi_Graf,2,S-IO,4,2,0,1,1,3,1
19890909-W-US_Open-F-Martina_Navratilova-Steffi_Graf,1,F-XC,33,4,1,0,3,16,17
19890909-W-US_Open-F-Martina_Navratilova-Steffi_Graf,1,F-DTM,12,1,1,0,0,4,8
19890909-W-US_Open-F-Martina_Navratilova-Steffi_Graf,1,F-DTL,1,1,1,0,0,1,0
19890909-W-US_Open-F-Martina_Navratilova-Steffi_Graf,1,F-IO,4,0,0,0,0,3,1
19890909-W-US_Open-F-Martina_Navratilova-Steffi_Graf,1,B-XC,4,2,0,1,1,2,2
19890909-W-US_Open-F-Martina_Navratilova-Steffi_Graf,1,B-DTM,4,0,0,0,0,0,4
19890909-W-US_Open-F-Martina_Navratilova-Steffi_Graf,1,B-DTL,2,1,1,0,0,1,1
19890909-W-US_Open-F-Martina_Navratilova-Steffi_Graf,1,B-IO,2,0,0,0,0,2,0
19890909-W-US_Open-F-Martina_Navratilova-Steffi_Graf,1,S-XC,15,0,0,0,0,4,11
19890909-W-US_Open-F-Martina_Navratilova-Steffi_Graf,1,S-DTM,12,1,0,0,1,2,10
19890909-W-US_Open-F-Martina_Navratilova-Steffi_Graf,1,S-DTL,6,1,0,0,1,1,5
19890909-W-US_Open-F-Martina_Navratilova-Steffi_Graf,1,S-IO,5,1,0,0,1,2,3
19890909-W-US_Open-F-Martina_Navratilova-Steffi_Graf,2,F-XC,35,10,3,3,4,26,9
19890909-W-US_Open-F-Martina_Navratilova-Steffi_Graf,2,F-DTM,16,1,0,1,0,13,3
19890909-W-US_Open-F-Martina_Navratilova-Steffi_Graf,2,F-DTL,7,4,2,1,1,4,3
19890909-W-US_Open-F-Martina_Navratilova-Steffi_Graf,2,F-IO,30,10,5,3,2,22,8
19890909-W-US_Open-F-Martina_Navratilova-Steffi_Graf,2,F-II,3,3,3,0,0,3,0
19890909-W-US_Open-F-Martina_Navratilova-Steffi_Graf,2,B-XC,10,4,2,1,1,6,4
19890909-W-US_Open-F-Martina_Navratilova-Steffi_Graf,2,B-DTM,9,3,0,1,2,3,6
19890909-W-US_Open-F-Martina_Navratilova-Steffi_Graf,2,B-DTL,5,3,3,0,0,3,2
19890909-W-US_Open-F-Martina_Navratilova-Steffi_Graf,2,B-IO,3,1,0,1,0,1,2
19890909-W-US_Open-F-Martina_Navratilova-Steffi_Graf,2,S-XC,14,4,2,0,2,6,8
19890909-W-US_Open-F-Martina_Navratilova-Steffi_Graf,2,S-DTM,8,0,0,0,0,2,6
19890909-W-US_Open-F-Martina_Navratilova-Steffi_Graf,2,S-DTL,11,3,0,1,2,7,4
19890909-W-US_Open-F-Martina_Navratilova-Steffi_Graf,2,S-IO,4,0,0,0,0,3,1
19890909-W-US_Open-F-Martina_Navratilova-Steffi_Graf,2,S-II,2,0,0,0,0,1,1
19870913-W-US_Open-F-Steffi_Graf-Martina_Navratilova,1,F-XC,32,14,4,2,8,11,21
19870913-W-US_Open-F-Steffi_Graf-Martina_Navratilova,1,F-DTM,15,3,1,0,2,7,8
19870913-W-US_Open-F-Steffi_Graf-Martina_Navratilova,1,F-DTL,8,5,1,2,2,4,4
19870913-W-US_Open-F-Steffi_Graf-Martina_Navratilova,1,F-IO,26,12,4,0,8,9,17
19870913-W-US_Open-F-Steffi_Graf-Martina_Navratilova,1,F-II,1,1,1,0,0,1,0
19870913-W-US_Open-F-Steffi_Graf-Martina_Navratilova,1,B-XC,5,3,0,1,2,2,3
19870913-W-US_Open-F-Steffi_Graf-Martina_Navratilova,1,B-DTM,6,3,0,1,2,3,3
19870913-W-US_Open-F-Steffi_Graf-Martina_Navratilova,1,B-DTL,4,3,2,0,1,2,2
19870913-W-US_Open-F-Steffi_Graf-Martina_Navratilova,1,B-IO,1,1,1,0,0,1,0
19870913-W-US_Open-F-Steffi_Graf-Martina_Navratilova,1,S-XC,14,0,0,0,0,7,7
19870913-W-US_Open-F-Steffi_Graf-Martina_Navratilova,1,S-DTM,17,1,0,0,1,9,8
19870913-W-US_Open-F-Steffi_Graf-Martina_Navratilova,1,S-DTL,10,3,0,1,2,4,6
19870913-W-US_Open-F-Steffi_Graf-Martina_Navratilova,1,S-IO,4,2,0,0,2,0,4
19870913-W-US_Open-F-Steffi_Graf-Martina_Navratilova,1,S-II,1,0,0,0,0,0,1
19870913-W-US_Open-F-Steffi_Graf-Martina_Navratilova,2,F-XC,31,4,2,0,2,17,14
19870913-W-US_Open-F-Steffi_Graf-Martina_Navratilova,2,F-DTM,11,1,0,1,0,6,5
19870913-W-US_Open-F-Steffi_Graf-Martina_Navratilova,2,F-DTL,2,1,1,0,0,1,1
19870913-W-US_Open-F-Steffi_Graf-Martina_Navratilova,2,F-IO,6,2,0,0,2,2,4
19870913-W-US_Open-F-Steffi_Graf-Martina_Navratilova,2,F-II,1,1,0,0,1,0,1
19870913-W-US_Open-F-Steffi_Graf-Martina_Navratilova,2,B-XC,3,2,0,0,2,1,2
19870913-W-US_Open-F-Steffi_Graf-Martina_Navratilova,2,B-DTM,1,0,0,0,0,1,0
19870913-W-US_Open-F-Steffi_Graf-Martina_Navratilova,2,B-IO,1,0,0,0,0,0,1
19870913-W-US_Open-F-Steffi_Graf-Martina_Navratilova,2,S-XC,14,2,1,0,1,11,3
19870913-W-US_Open-F-Steffi_Graf-Martina_Navratilova,2,S-DTM,19,0,0,0,0,14,5
19870913-W-US_Open-F-Steffi_Graf-Martina_Navratilova,2,S-DTL,4,1,0,0,1,2,2
19870913-W-US_Open-F-Steffi_Graf-Martina_Navratilova,2,S-IO,5,0,0,0,0,3,2
19870913-W-US_Open-F-Steffi_Graf-Martina_Navratilova,2,S-II,1,0,0,0,0,1,0
20110615-W-Eastbourne-R16-Venus_Williams-Ana_Ivanovic,1,F-XC,7,1,1,0,0,7,0
20110615-W-Eastbourne-R16-Venus_Williams-Ana_Ivanovic,1,F-DTM,6,1,1,0,0,6,0
20110615-W-Eastbourne-R16-Venus_Williams-Ana_Ivanovic,1,F-DTL,2,1,0,0,1,1,1
20110615-W-Eastbourne-R16-Venus_Williams-Ana_Ivanovic,1,F-IO,5,1,0,1,0,3,2
20110615-W-Eastbourne-R16-Venus_Williams-Ana_Ivanovic,1,B-XC,7,0,0,0,0,3,4
20110615-W-Eastbourne-R16-Venus_Williams-Ana_Ivanovic,1,B-DTM,4,0,0,0,0,2,2
20110615-W-Eastbourne-R16-Venus_Williams-Ana_Ivanovic,1,B-DTL,2,1,1,0,0,1,1
20110615-W-Eastbourne-R16-Venus_Williams-Ana_Ivanovic,1,B-IO,2,2,1,0,1,1,1
20110615-W-Eastbourne-R16-Venus_Williams-Ana_Ivanovic,1,S-DTM,1,0,0,0,0,0,1
20110615-W-Eastbourne-R16-Venus_Williams-Ana_Ivanovic,2,F-XC,9,6,3,0,3,3,6
20110615-W-Eastbourne-R16-Venus_Williams-Ana_Ivanovic,2,F-DTM,7,2,0,0,2,1,6
20110615-W-Eastbourne-R16-Venus_Williams-Ana_Ivanovic,2,F-DTL,7,0,0,0,0,3,4
20110615-W-Eastbourne-R16-Venus_Williams-Ana_Ivanovic,2,F-IO,4,2,1,1,0,3,1
20110615-W-Eastbourne-R16-Venus_Williams-Ana_Ivanovic,2,B-XC,8,5,3,1,1,5,3
20110615-W-Eastbourne-R16-Venus_Williams-Ana_Ivanovic,2,B-DTM,6,2,0,0,2,0,6
20110615-W-Eastbourne-R16-Venus_Williams-Ana_Ivanovic,2,B-DTL,5,4,3,0,1,4,1
20110615-W-Eastbourne-R16-Venus_Williams-Ana_Ivanovic,2,B-IO,1,1,0,1,0,1,0
20110615-W-Eastbourne-R16-Venus_Williams-Ana_Ivanovic,2,S-DTM,4,1,1,0,0,3,1
19840908-W-US_Open-F-Chris_Evert-Martina_Navratilova,1,F-XC,58,12,3,2,7,33,25
19840908-W-US_Open-F-Chris_Evert-Martina_Navratilova,1,F-DTM,13,1,0,1,0,8,5
19840908-W-US_Open-F-Chris_Evert-Martina_Navratilova,1,F-DTL,11,7,4,2,1,7,4
19840908-W-US_Open-F-Chris_Evert-Martina_Navratilova,1,F-IO,16,5,1,2,2,8,8
19840908-W-US_Open-F-Chris_Evert-Martina_Navratilova,1,B-XC,56,11,1,2,8,29,27
19840908-W-US_Open-F-Chris_Evert-Martina_Navratilova,1,B-DTM,27,2,0,1,1,17,10
19840908-W-US_Open-F-Chris_Evert-Martina_Navratilova,1,B-DTL,9,6,4,2,0,8,1
19840908-W-US_Open-F-Chris_Evert-Martina_Navratilova,1,B-IO,13,1,0,0,1,7,6
19840908-W-US_Open-F-Chris_Evert-Martina_Navratilova,1,S-XC,2,0,0,0,0,2,0
19840908-W-US_Open-F-Chris_Evert-Martina_Navratilova,1,S-DTM,1,0,0,0,0,0,1
19840908-W-US_Open-F-Chris_Evert-Martina_Navratilova,1,S-DTL,1,0,0,0,0,1,0
19840908-W-US_Open-F-Chris_Evert-Martina_Navratilova,2,F-XC,38,8,2,0,6,16,22
19840908-W-US_Open-F-Chris_Evert-Martina_Navratilova,2,F-DTM,28,2,0,0,2,15,13
19840908-W-US_Open-F-Chris_Evert-Martina_Navratilova,2,F-DTL,11,3,0,1,2,4,7
19840908-W-US_Open-F-Chris_Evert-Martina_Navratilova,2,F-IO,9,2,1,0,1,4,5
19840908-W-US_Open-F-Chris_Evert-Martina_Navratilova,2,B-XC,4,0,0,0,0,2,2
19840908-W-US_Open-F-Chris_Evert-Martina_Navratilova,2,B-DTM,5,1,0,0,1,0,5
19840908-W-US_Open-F-Chris_Evert-Martina_Navratilova,2,B-IO,2,0,0,0,0,1,1
19840908-W-US_Open-F-Chris_Evert-Martina_Navratilova,2,S-XC,16,2,0,0,2,8,8
19840908-W-US_Open-F-Chris_Evert-Martina_Navratilova,2,S-DTM,21,1,0,0,1,4,17
19840908-W-US_Open-F-Chris_Evert-Martina_Navratilova,2,S-DTL,10,1,0,0,1,4,6
19840908-W-US_Open-F-Chris_Evert-Martina_Navratilova,2,S-IO,3,2,1,0,1,1,2
19840908-W-US_Open-F-Chris_Evert-Martina_Navratilova,2,S-II,1,0,0,0,0,0,1
20150111-W-Hobart-R32-Kurumi_Nara-Klara_Koukalova,1,F-XC,34,9,3,3,3,18,16
20150111-W-Hobart-R32-Kurumi_Nara-Klara_Koukalova,1,F-DTM,39,2,0,2,0,21,18
20150111-W-Hobart-R32-Kurumi_Nara-Klara_Koukalova,1,F-DTL,15,2,1,1,0,10,5
20150111-W-Hobart-R32-Kurumi_Nara-Klara_Koukalova,1,F-IO,9,4,2,0,2,4,5
20150111-W-Hobart-R32-Kurumi_Nara-Klara_Koukalova,1,B-XC,14,2,0,1,1,10,4
20150111-W-Hobart-R32-Kurumi_Nara-Klara_Koukalova,1,B-DTM,36,2,0,0,2,25,11
20150111-W-Hobart-R32-Kurumi_Nara-Klara_Koukalova,1,B-DTL,9,2,0,1,1,4,5
20150111-W-Hobart-R32-Kurumi_Nara-Klara_Koukalova,1,B-IO,12,5,0,2,3,6,6
20150111-W-Hobart-R32-Kurumi_Nara-Klara_Koukalova,1,S-DTM,1,0,0,0,0,1,0
20150111-W-Hobart-R32-Kurumi_Nara-Klara_Koukalova,2,F-XC,52,18,7,3,8,24,28
20150111-W-Hobart-R32-Kurumi_Nara-Klara_Koukalova,2,F-DTM,28,6,0,0,6,8,20
20150111-W-Hobart-R32-Kurumi_Nara-Klara_Koukalova,2,F-DTL,13,8,6,0,2,8,5
20150111-W-Hobart-R32-Kurumi_Nara-Klara_Koukalova,2,F-IO,11,5,2,1,2,4,7
20150111-W-Hobart-R32-Kurumi_Nara-Klara_Koukalova,2,B-XC,24,12,2,2,8,9,15
20150111-W-Hobart-R32-Kurumi_Nara-Klara_Koukalova,2,B-DTM,35,5,0,0,5,12,23
20150111-W-Hobart-R32-Kurumi_Nara-Klara_Koukalova,2,B-DTL,5,1,0,0,1,3,2
20150111-W-Hobart-R32-Kurumi_Nara-Klara_Koukalova,2,B-IO,9,3,2,0,1,6,3
20150111-W-Hobart-R32-Kurumi_Nara-Klara_Koukalova,2,S-XC,2,0,0,0,0,1,1
20150111-W-Hobart-R32-Kurumi_Nara-Klara_Koukalova,2,S-DTM,2,1,0,0,1,0,2
20150111-W-Hobart-R32-Kurumi_Nara-Klara_Koukalova,2,S-DTL,1,0,0,0,0,0,1
20150111-W-Hobart-R32-Kurumi_Nara-Klara_Koukalova,2,S-IO,1,0,0,0,0,0,1
20030125-W-Australian_Open-F-Serena_Williams-Venus_Williams,1,F-XC,81,16,8,1,7,41,40
20030125-W-Australian_Open-F-Serena_Williams-Venus_Williams,1,F-DTM,36,5,0,2,3,19,17
20030125-W-Australian_Open-F-Serena_Williams-Venus_Williams,1,F-DTL,12,7,2,1,4,4,8
20030125-W-Australian_Open-F-Serena_Williams-Venus_Williams,1,F-IO,29,13,4,3,6,15,14
20030125-W-Australian_Open-F-Serena_Williams-Venus_Williams,1,B-XC,68,6,1,0,5,34,34
20030125-W-Australian_Open-F-Serena_Williams-Venus_Williams,1,B-DTM,73,8,0,3,5,34,39
20030125-W-Australian_Open-F-Serena_Williams-Venus_Williams,1,B-DTL,14,6,3,1,2,8,6
20030125-W-Australian_Open-F-Serena_Williams-Venus_Williams,1,B-IO,16,7,2,0,5,7,9
20030125-W-Australian_Open-F-Serena_Williams-Venus_Williams,1,S-XC,2,0,0,0,0,0,2
20030125-W-Australian_Open-F-Serena_Williams-Venus_Williams,1,S-DTM,4,0,0,0,0,1,3
20030125-W-Australian_Open-F-Serena_Williams-Venus_Williams,2,F-XC,53,5,0,1,4,32,21
20030125-W-Australian_Open-F-Serena_Williams-Venus_Williams,2,F-DTM,65,7,0,1,6,29,36
20030125-W-Australian_Open-F-Serena_Williams-Venus_Williams,2,F-DTL,24,8,1,0,7,11,13
20030125-W-Australian_Open-F-Serena_Williams-Venus_Williams,2,F-IO,28,14,3,4,7,15,13
20030125-W-Australian_Open-F-Serena_Williams-Venus_Williams,2,B-XC,52,7,2,4,1,29,23
20030125-W-Australian_Open-F-Serena_Williams-Venus_Williams,2,B-DTM,58,2,0,1,1,31,27
20030125-W-Australian_Open-F-Serena_Williams-Venus_Williams,2,B-DTL,21,5,2,1,2,12,9
20030125-W-Australian_Open-F-Serena_Williams-Venus_Williams,2,B-IO,17,11,4,2,5,8,9
20030125-W-Australian_Open-F-Serena_Williams-Venus_Williams,2,S-XC,1,0,0,0,0,0,1
20030125-W-Australian_Open-F-Serena_Williams-Venus_Williams,2,S-DTM,6,0,0,0,0,3,3
20000708-W-Wimbledon-F-Venus_Williams-Lindsay_Davenport,1,F-XC,50,18,5,5,8,30,20
20000708-W-Wimbledon-F-Venus_Williams-Lindsay_Davenport,1,F-DTM,27,2,0,0,2,15,12
20000708-W-Wimbledon-F-Venus_Williams-Lindsay_Davenport,1,F-DTL,8,2,1,0,1,5,3
20000708-W-Wimbledon-F-Venus_Williams-Lindsay_Davenport,1,F-IO,5,0,0,0,0,4,1
20000708-W-Wimbledon-F-Venus_Williams-Lindsay_Davenport,1,B-XC,19,6,2,3,1,13,6
20000708-W-Wimbledon-F-Venus_Williams-Lindsay_Davenport,1,B-DTM,24,4,0,2,2,14,10
20000708-W-Wimbledon-F-Venus_Williams-Lindsay_Davenport,1,B-DTL,4,2,1,0,1,3,1
20000708-W-Wimbledon-F-Venus_Williams-Lindsay_Davenport,1,B-IO,11,7,5,0,2,7,4
20000708-W-Wimbledon-F-Venus_Williams-Lindsay_Davenport,1,S-XC,2,0,0,0,0,0,2
20000708-W-Wimbledon-F-Venus_Williams-Lindsay_Davenport,1,S-DTM,4,0,0,0,0,2,2
20000708-W-Wimbledon-F-Venus_Williams-Lindsay_Davenport,1,S-DTL,2,1,0,1,0,1,1
20000708-W-Wimbledon-F-Venus_Williams-Lindsay_Davenport,2,F-XC,41,11,6,0,5,16,25
20000708-W-Wimbledon-F-Venus_Williams-Lindsay_Davenport,2,F-DTM,14,1,0,0,1,4,10
20000708-W-Wimbledon-F-Venus_Williams-Lindsay_Davenport,2,F-DTL,9,4,2,1,1,5,4
20000708-W-Wimbledon-F-Venus_Williams-Lindsay_Davenport,2,F-IO,6,3,1,2,0,4,2
20000708-W-Wimbledon-F-Venus_Williams-Lindsay_Davenport,2,B-XC,28,10,1,4,5,11,17
20000708-W-Wimbledon-F-Venus_Williams-Lindsay_Davenport,2,B-DTM,29,1,0,0,1,8,21
20000708-W-Wimbledon-F-Venus_Williams-Lindsay_Davenport,2,B-DTL,6,2,1,0,1,2,4
20000708-W-Wimbledon-F-Venus_Williams-Lindsay_Davenport,2,B-IO,16,7,1,1,5,7,9
20000708-W-Wimbledon-F-Venus_Williams-Lindsay_Davenport,2,S-XC,1,0,0,0,0,1,0
20000708-W-Wimbledon-F-Venus_Williams-Lindsay_Davenport,2,S-DTM,7,0,0,0,0,0,7
20030705-W-Wimbledon-F-Venus_Williams-Serena_Williams,1,F-XC,39,10,5,2,3,23,16
20030705-W-Wimbledon-F-Venus_Williams-Serena_Williams,1,F-DTM,32,6,0,0,6,10,22
20030705-W-Wimbledon-F-Venus_Williams-Serena_Williams,1,F-DTL,14,7,0,3,4,8,6
20030705-W-Wimbledon-F-Venus_Williams-Serena_Williams,1,F-IO,17,6,4,1,1,13,4
20030705-W-Wimbledon-F-Venus_Williams-Serena_Williams,1,B-XC,31,6,1,3,2,16,15
20030705-W-Wimbledon-F-Venus_Williams-Serena_Williams,1,B-DTM,29,2,0,1,1,16,13
20030705-W-Wimbledon-F-Venus_Williams-Serena_Williams,1,B-DTL,6,4,1,3,0,4,2
20030705-W-Wimbledon-F-Venus_Williams-Serena_Williams,1,B-IO,19,7,3,1,3,10,9
20030705-W-Wimbledon-F-Venus_Williams-Serena_Williams,1,B-II,1,0,0,0,0,1,0
20030705-W-Wimbledon-F-Venus_Williams-Serena_Williams,1,S-XC,3,0,0,0,0,1,2
20030705-W-Wimbledon-F-Venus_Williams-Serena_Williams,1,S-DTM,11,2,0,2,0,5,6
20030705-W-Wimbledon-F-Venus_Williams-Serena_Williams,2,F-XC,45,9,1,1,7,21,24
20030705-W-Wimbledon-F-Venus_Williams-Serena_Williams,2,F-DTM,21,1,0,1,0,11,10
20030705-W-Wimbledon-F-Venus_Williams-Serena_Williams,2,F-DTL,9,3,1,2,0,6,3
20030705-W-Wimbledon-F-Venus_Williams-Serena_Williams,2,F-IO,18,11,7,1,3,14,4
20030705-W-Wimbledon-F-Venus_Williams-Serena_Williams,2,F-II,1,0,0,0,0,1,0
20030705-W-Wimbledon-F-Venus_Williams-Serena_Williams,2,B-XC,43,16,2,7,7,20,23
20030705-W-Wimbledon-F-Venus_Williams-Serena_Williams,2,B-DTM,40,3,0,1,2,19,21
20030705-W-Wimbledon-F-Venus_Williams-Serena_Williams,2,B-DTL,10,1,0,0,1,4,6
20030705-W-Wimbledon-F-Venus_Williams-Serena_Williams,2,B-IO,18,11,3,2,6,10,8
20030705-W-Wimbledon-F-Venus_Williams-Serena_Williams,2,S-XC,2,1,0,0,1,0,2
20030705-W-Wimbledon-F-Venus_Williams-Serena_Williams,2,S-DTM,7,1,0,0,1,1,6
20030705-W-Wimbledon-F-Venus_Williams-Serena_Williams,2,S-IO,1,0,0,0,0,1,0
19970705-W-Wimbledon-F-Martina_Hingis-Jana_Novotna,1,F-XC,28,9,7,1,1,12,16
19970705-W-Wimbledon-F-Martina_Hingis-Jana_Novotna,1,F-DTM,10,1,0,0,1,3,7
19970705-W-Wimbledon-F-Martina_Hingis-Jana_Novotna,1,F-DTL,12,6,1,1,4,5,7
19970705-W-Wimbledon-F-Martina_Hingis-Jana_Novotna,1,F-IO,19,5,2,0,3,8,11
19970705-W-Wimbledon-F-Martina_Hingis-Jana_Novotna,1,B-XC,30,4,0,2,2,11,19
19970705-W-Wimbledon-F-Martina_Hingis-Jana_Novotna,1,B-DTM,16,4,1,0,3,4,12
19970705-W-Wimbledon-F-Martina_Hingis-Jana_Novotna,1,B-DTL,23,16,8,2,6,11,12
19970705-W-Wimbledon-F-Martina_Hingis-Jana_Novotna,1,B-IO,23,8,4,3,1,15,8
19970705-W-Wimbledon-F-Martina_Hingis-Jana_Novotna,1,S-XC,1,0,0,0,0,0,1
19970705-W-Wimbledon-F-Martina_Hingis-Jana_Novotna,1,S-DTM,1,0,0,0,0,0,1
19970705-W-Wimbledon-F-Martina_Hingis-Jana_Novotna,1,S-DTL,1,0,0,0,0,0,1
19970705-W-Wimbledon-F-Martina_Hingis-Jana_Novotna,1,S-IO,1,0,0,0,0,0,1
19970705-W-Wimbledon-F-Martina_Hingis-Jana_Novotna,2,F-XC,20,4,3,1,0,13,7
19970705-W-Wimbledon-F-Martina_Hingis-Jana_Novotna,2,F-DTM,12,2,0,1,1,8,4
19970705-W-Wimbledon-F-Martina_Hingis-Jana_Novotna,2,F-DTL,2,0,0,0,0,2,0
19970705-W-Wimbledon-F-Martina_Hingis-Jana_Novotna,2,F-IO,3,1,0,0,1,1,2
19970705-W-Wimbledon-F-Martina_Hingis-Jana_Novotna,2,B-XC,1,0,0,0,0,1,0
19970705-W-Wimbledon-F-Martina_Hingis-Jana_Novotna,2,B-DTM,1,0,0,0,0,0,1
19970705-W-Wimbledon-F-Martina_Hingis-Jana_Novotna,2,S-XC,26,2,0,2,0,17,9
19970705-W-Wimbledon-F-Martina_Hingis-Jana_Novotna,2,S-DTM,28,2,1,0,1,15,13
19970705-W-Wimbledon-F-Martina_Hingis-Jana_Novotna,2,S-DTL,5,0,0,0,0,4,1
20110614-W-Eastbourne-R32-Ana_Ivanovic-Julia_Goerges,1,F-XC,13,4,2,2,0,9,4
20110614-W-Eastbourne-R32-Ana_Ivanovic-Julia_Goerges,1,F-DTM,10,3,1,0,2,1,9
20110614-W-Eastbourne-R32-Ana_Ivanovic-Julia_Goerges,1,F-DTL,7,3,1,0,2,2,5
20110614-W-Eastbourne-R32-Ana_Ivanovic-Julia_Goerges,1,F-IO,8,1,0,1,0,4,4
20110614-W-Eastbourne-R32-Ana_Ivanovic-Julia_Goerges,1,B-XC,4,1,0,0,1,2,2
20110614-W-Eastbourne-R32-Ana_Ivanovic-Julia_Goerges,1,B-DTM,6,0,0,0,0,2,4
20110614-W-Eastbourne-R32-Ana_Ivanovic-Julia_Goerges,1,B-DTL,5,2,0,0,2,2,3
20110614-W-Eastbourne-R32-Ana_Ivanovic-Julia_Goerges,1,B-IO,1,1,0,0,1,0,1
20110614-W-Eastbourne-R32-Ana_Ivanovic-Julia_Goerges,1,S-XC,3,0,0,0,0,1,2
20110614-W-Eastbourne-R32-Ana_Ivanovic-Julia_Goerges,1,S-DTM,1,0,0,0,0,0,1
20110614-W-Eastbourne-R32-Ana_Ivanovic-Julia_Goerges,1,S-DTL,1,0,0,0,0,1,0
20110614-W-Eastbourne-R32-Ana_Ivanovic-Julia_Goerges,1,S-IO,1,0,0,0,0,0,1
20110614-W-Eastbourne-R32-Ana_Ivanovic-Julia_Goerges,2,F-XC,19,8,2,1,5,11,8
20110614-W-Eastbourne-R32-Ana_Ivanovic-Julia_Goerges,2,F-DTM,6,3,1,0,2,2,4
20110614-W-Eastbourne-R32-Ana_Ivanovic-Julia_Goerges,2,F-DTL,7,4,1,0,3,4,3
20110614-W-Eastbourne-R32-Ana_Ivanovic-Julia_Goerges,2,F-IO,9,5,2,1,2,5,4
20110614-W-Eastbourne-R32-Ana_Ivanovic-Julia_Goerges,2,F-II,1,1,1,0,0,1,0
20110614-W-Eastbourne-R32-Ana_Ivanovic-Julia_Goerges,2,B-XC,6,2,1,0,1,3,3
20110614-W-Eastbourne-R32-Ana_Ivanovic-Julia_Goerges,2,B-DTM,11,2,0,0,2,8,3
20110614-W-Eastbourne-R32-Ana_Ivanovic-Julia_Goerges,2,B-DTL,2,1,0,0,1,1,1
20110614-W-Eastbourne-R32-Ana_Ivanovic-Julia_Goerges,2,B-IO,2,2,1,0,1,1,1
20110614-W-Eastbourne-R32-Ana_Ivanovic-Julia_Goerges,2,S-XC,1,0,0,0,0,0,1
20110614-W-Eastbourne-R32-Ana_Ivanovic-Julia_Goerges,2,S-DTM,1,1,0,0,1,0,1
20110614-W-Eastbourne-R32-Ana_Ivanovic-Julia_Goerges,2,S-DTL,1,1,0,1,0,1,0
19800906-W-US_Open-F-Hana_Mandlikova-Chris_Evert,1,F-XC,34,6,2,1,3,12,22
19800906-W-US_Open-F-Hana_Mandlikova-Chris_Evert,1,F-DTM,26,4,0,0,4,9,17
19800906-W-US_Open-F-Hana_Mandlikova-Chris_Evert,1,F-DTL,11,5,1,0,4,4,7
19800906-W-US_Open-F-Hana_Mandlikova-Chris_Evert,1,F-IO,15,4,0,1,3,5,10
19800906-W-US_Open-F-Hana_Mandlikova-Chris_Evert,1,B-XC,11,2,1,0,1,4,7
19800906-W-US_Open-F-Hana_Mandlikova-Chris_Evert,1,B-DTM,10,1,0,0,1,1,9
19800906-W-US_Open-F-Hana_Mandlikova-Chris_Evert,1,B-DTL,1,0,0,0,0,0,1
19800906-W-US_Open-F-Hana_Mandlikova-Chris_Evert,1,S-XC,17,2,0,0,2,6,11
19800906-W-US_Open-F-Hana_Mandlikova-Chris_Evert,1,S-DTM,21,2,0,0,2,12,9
19800906-W-US_Open-F-Hana_Mandlikova-Chris_Evert,1,S-DTL,7,1,0,0,1,4,3
19800906-W-US_Open-F-Hana_Mandlikova-Chris_Evert,1,S-IO,7,1,0,0,1,3,4
19800906-W-US_Open-F-Hana_Mandlikova-Chris_Evert,1,S-II,1,0,0,0,0,0,1
19800906-W-US_Open-F-Hana_Mandlikova-Chris_Evert,2,F-XC,47,8,4,4,0,32,15
19800906-W-US_Open-F-Hana_Mandlikova-Chris_Evert,2,F-DTM,31,2,0,1,1,20,11
19800906-W-US_Open-F-Hana_Mandlikova-Chris_Evert,2,F-DTL,14,6,2,2,2,7,7
19800906-W-US_Open-F-Hana_Mandlikova-Chris_Evert,2,F-IO,13,3,1,2,0,8,5
19800906-W-US_Open-F-Hana_Mandlikova-Chris_Evert,2,B-XC,56,12,3,3,6,38,18
19800906-W-US_Open-F-Hana_Mandlikova-Chris_Evert,2,B-DTM,15,1,0,1,0,7,8
19800906-W-US_Open-F-Hana_Mandlikova-Chris_Evert,2,B-DTL,2,1,1,0,0,2,0
19800906-W-US_Open-F-Hana_Mandlikova-Chris_Evert,2,B-IO,5,1,0,0,1,2,3
19800906-W-US_Open-F-Hana_Mandlikova-Chris_Evert,2,S-DTM,3,0,0,0,0,0,3
19800906-W-US_Open-F-Hana_Mandlikova-Chris_Evert,2,S-DTL,1,1,1,0,0,1,0
19890708-W-Wimbledon-F-Martina_Navratilova-Steffi_Graf,1,F-XC,16,1,0,1,0,10,6
19890708-W-Wimbledon-F-Martina_Navratilova-Steffi_Graf,1,F-DTM,1,0,0,0,0,0,1
19890708-W-Wimbledon-F-Martina_Navratilova-Steffi_Graf,1,F-IO,3,2,2,0,0,2,1
19890708-W-Wimbledon-F-Martina_Navratilova-Steffi_Graf,1,B-XC,4,2,2,0,0,3,1
19890708-W-Wimbledon-F-Martina_Navratilova-Steffi_Graf,1,B-DTM,5,0,0,0,0,2,3
19890708-W-Wimbledon-F-Martina_Navratilova-Steffi_Graf,1,B-DTL,1,1,0,0,1,0,1
19890708-W-Wimbledon-F-Martina_Navratilova-Steffi_Graf,1,S-XC,6,1,1,0,0,3,3
19890708-W-Wimbledon-F-Martina_Navratilova-Steffi_Graf,1,S-DTM,7,1,0,0,1,2,5
19890708-W-Wimbledon-F-Martina_Navratilova-Steffi_Graf,1,S-DTL,5,1,0,0,1,2,3
19890708-W-Wimbledon-F-Martina_Navratilova-Steffi_Graf,1,S-IO,3,2,0,0,2,1,2
19890708-W-Wimbledon-F-Martina_Navratilova-Steffi_Graf,2,F-XC,18,6,4,1,1,14,4
19890708-W-Wimbledon-F-Martina_Navratilova-Steffi_Graf,2,F-DTM,7,0,0,0,0,2,5
19890708-W-Wimbledon-F-Martina_Navratilova-Steffi_Graf,2,F-DTL,5,3,2,0,1,2,3
19890708-W-Wimbledon-F-Martina_Navratilova-Steffi_Graf,2,F-IO,11,7,3,1,3,7,4
19890708-W-Wimbledon-F-Martina_Navratilova-Steffi_Graf,2,F-II,2,0,0,0,0,1,1
19890708-W-Wimbledon-F-Martina_Navratilova-Steffi_Graf,2,B-XC,4,3,1,2,0,3,1
19890708-W-Wimbledon-F-Martina_Navratilova-Steffi_Graf,2,B-DTM,5,1,0,1,0,3,2
19890708-W-Wimbledon-F-Martina_Navratilova-Steffi_Graf,2,B-DTL,4,3,1,0,2,1,3
19890708-W-Wimbledon-F-Martina_Navratilova-Steffi_Graf,2,B-IO,1,1,1,0,0,1,0
19890708-W-Wimbledon-F-Martina_Navratilova-Steffi_Graf,2,S-XC,4,0,0,0,0,1,3
19890708-W-Wimbledon-F-Martina_Navratilova-Steffi_Graf,2,S-DTM,12,0,0,0,0,7,5
19890708-W-Wimbledon-F-Martina_Navratilova-Steffi_Graf,2,S-DTL,3,0,0,0,0,2,1
19890708-W-Wimbledon-F-Martina_Navratilova-Steffi_Graf,2,S-IO,3,0,0,0,0,2,1
19910706-W-Wimbledon-F-Gabriela_Sabatini-Steffi_Graf,1,F-XC,14,2,0,1,1,5,9
19910706-W-Wimbledon-F-Gabriela_Sabatini-Steffi_Graf,1,F-DTM,34,2,0,0,2,13,21
19910706-W-Wimbledon-F-Gabriela_Sabatini-Steffi_Graf,1,F-DTL,20,6,1,2,3,9,11
19910706-W-Wimbledon-F-Gabriela_Sabatini-Steffi_Graf,1,F-IO,18,5,2,0,3,11,7
19910706-W-Wimbledon-F-Gabriela_Sabatini-Steffi_Graf,1,B-XC,12,1,0,0,1,3,9
19910706-W-Wimbledon-F-Gabriela_Sabatini-Steffi_Graf,1,B-DTM,12,1,0,1,0,6,6
19910706-W-Wimbledon-F-Gabriela_Sabatini-Steffi_Graf,1,B-DTL,13,7,3,1,3,5,8
19910706-W-Wimbledon-F-Gabriela_Sabatini-Steffi_Graf,1,B-IO,2,2,0,2,0,2,0
19910706-W-Wimbledon-F-Gabriela_Sabatini-Steffi_Graf,1,S-XC,66,6,0,2,4,32,34
19910706-W-Wimbledon-F-Gabriela_Sabatini-Steffi_Graf,1,S-DTM,25,3,0,1,2,5,20
19910706-W-Wimbledon-F-Gabriela_Sabatini-Steffi_Graf,1,S-DTL,8,4,0,3,1,5,3
19910706-W-Wimbledon-F-Gabriela_Sabatini-Steffi_Graf,1,S-IO,3,1,0,1,0,2,1
19910706-W-Wimbledon-F-Gabriela_Sabatini-Steffi_Graf,2,F-XC,32,10,5,3,2,19,13
19910706-W-Wimbledon-F-Gabriela_Sabatini-Steffi_Graf,2,F-DTM,24,5,1,1,3,12,12
19910706-W-Wimbledon-F-Gabriela_Sabatini-Steffi_Graf,2,F-DTL,14,4,2,1,1,8,6
19910706-W-Wimbledon-F-Gabriela_Sabatini-Steffi_Graf,2,F-IO,67,19,8,6,5,44,23
19910706-W-Wimbledon-F-Gabriela_Sabatini-Steffi_Graf,2,F-II,17,8,2,0,6,7,10
19910706-W-Wimbledon-F-Gabriela_Sabatini-Steffi_Graf,2,B-XC,10,4,1,1,2,7,3
19910706-W-Wimbledon-F-Gabriela_Sabatini-Steffi_Graf,2,B-DTM,5,0,0,0,0,0,5
19910706-W-Wimbledon-F-Gabriela_Sabatini-Steffi_Graf,2,B-DTL,3,3,1,0,2,1,2
19910706-W-Wimbledon-F-Gabriela_Sabatini-Steffi_Graf,2,B-IO,1,1,0,0,1,0,1
19910706-W-Wimbledon-F-Gabriela_Sabatini-Steffi_Graf,2,S-XC,55,12,2,6,4,32,23
19910706-W-Wimbledon-F-Gabriela_Sabatini-Steffi_Graf,2,S-DTM,16,2,0,0,2,11,5
19910706-W-Wimbledon-F-Gabriela_Sabatini-Steffi_Graf,2,S-DTL,10,1,0,0,1,4,6
19910706-W-Wimbledon-F-Gabriela_Sabatini-Steffi_Graf,2,S-IO,6,2,1,1,0,4,2
19860705-W-Wimbledon-F-Hana_Mandlikova-Martina_Navratilova,1,F-XC,9,4,1,1,2,2,7
19860705-W-Wimbledon-F-Hana_Mandlikova-Martina_Navratilova,1,F-DTM,4,2,0,0,2,1,3
19860705-W-Wimbledon-F-Hana_Mandlikova-Martina_Navratilova,1,F-IO,2,2,1,1,0,2,0
19860705-W-Wimbledon-F-Hana_Mandlikova-Martina_Navratilova,1,F-II,1,1,1,0,0,1,0
19860705-W-Wimbledon-F-Hana_Mandlikova-Martina_Navratilova,1,B-XC,8,4,2,0,2,3,5
19860705-W-Wimbledon-F-Hana_Mandlikova-Martina_Navratilova,1,B-DTM,1,0,0,0,0,0,1
19860705-W-Wimbledon-F-Hana_Mandlikova-Martina_Navratilova,1,B-DTL,3,3,1,0,2,1,2
19860705-W-Wimbledon-F-Hana_Mandlikova-Martina_Navratilova,1,S-DTM,3,0,0,0,0,0,3
19860705-W-Wimbledon-F-Hana_Mandlikova-Martina_Navratilova,1,S-DTL,2,0,0,0,0,2,0
19860705-W-Wimbledon-F-Hana_Mandlikova-Martina_Navratilova,1,S-IO,1,1,1,0,0,1,0
19860705-W-Wimbledon-F-Hana_Mandlikova-Martina_Navratilova,2,F-XC,3,2,1,1,0,3,0
19860705-W-Wimbledon-F-Hana_Mandlikova-Martina_Navratilova,2,F-DTL,2,1,1,0,0,1,1
19860705-W-Wimbledon-F-Hana_Mandlikova-Martina_Navratilova,2,F-IO,2,0,0,0,0,2,0
19860705-W-Wimbledon-F-Hana_Mandlikova-Martina_Navratilova,2,B-XC,5,3,3,0,0,3,2
19860705-W-Wimbledon-F-Hana_Mandlikova-Martina_Navratilova,2,B-DTM,1,0,0,0,0,0,1
19860705-W-Wimbledon-F-Hana_Mandlikova-Martina_Navratilova,2,B-DTL,2,2,1,0,1,1,1
19860705-W-Wimbledon-F-Hana_Mandlikova-Martina_Navratilova,2,B-II,1,1,1,0,0,1,0
19860705-W-Wimbledon-F-Hana_Mandlikova-Martina_Navratilova,2,S-XC,1,0,0,0,0,0,1
19860705-W-Wimbledon-F-Hana_Mandlikova-Martina_Navratilova,2,S-DTM,1,0,0,0,0,0,1
19860705-W-Wimbledon-F-Hana_Mandlikova-Martina_Navratilova,2,S-DTL,1,0,0,0,0,1,0
19851207-W-Australian_Open-F-Martina_Navratilova-Chris_Evert,1,F-XC,26,6,1,1,4,14,12
19851207-W-Australian_Open-F-Martina_Navratilova-Chris_Evert,1,F-DTM,12,1,0,0,1,4,8
19851207-W-Australian_Open-F-Martina_Navratilova-Chris_Evert,1,F-DTL,5,2,0,1,1,4,1
19851207-W-Australian_Open-F-Martina_Navratilova-Chris_Evert,1,F-IO,7,2,1,1,0,5,2
19851207-W-Australian_Open-F-Martina_Navratilova-Chris_Evert,1,B-XC,6,1,0,0,1,2,4
19851207-W-Australian_Open-F-Martina_Navratilova-Chris_Evert,1,B-DTM,6,1,0,0,1,3,3
19851207-W-Australian_Open-F-Martina_Navratilova-Chris_Evert,1,B-DTL,2,2,1,0,1,1,1
19851207-W-Australian_Open-F-Martina_Navratilova-Chris_Evert,1,S-XC,13,1,0,0,1,8,5
19851207-W-Australian_Open-F-Martina_Navratilova-Chris_Evert,1,S-DTM,20,1,0,0,1,6,14
19851207-W-Australian_Open-F-Martina_Navratilova-Chris_Evert,1,S-DTL,4,1,0,1,0,4,0
19851207-W-Australian_Open-F-Martina_Navratilova-Chris_Evert,1,S-IO,2,0,0,0,0,0,2
19851207-W-Australian_Open-F-Martina_Navratilova-Chris_Evert,2,F-XC,41,15,3,6,6,23,18
19851207-W-Australian_Open-F-Martina_Navratilova-Chris_Evert,2,F-DTM,16,2,0,0,2,7,9
19851207-W-Australian_Open-F-Martina_Navratilova-Chris_Evert,2,F-DTL,8,3,1,0,2,4,4
19851207-W-Australian_Open-F-Martina_Navratilova-Chris_Evert,2,F-IO,10,3,1,1,1,7,3
19851207-W-Australian_Open-F-Martina_Navratilova-Chris_Evert,2,B-XC,35,9,3,1,5,15,20
19851207-W-Australian_Open-F-Martina_Navratilova-Chris_Evert,2,B-DTM,12,2,0,1,1,3,9
19851207-W-Australian_Open-F-Martina_Navratilova-Chris_Evert,2,B-DTL,9,3,3,0,0,7,2
19851207-W-Australian_Open-F-Martina_Navratilova-Chris_Evert,2,B-IO,10,1,1,0,0,5,5
19851207-W-Australian_Open-F-Martina_Navratilova-Chris_Evert,2,S-XC,1,0,0,0,0,1,0
19851207-W-Australian_Open-F-Martina_Navratilova-Chris_Evert,2,S-DTM,4,0,0,0,0,2,2
19851207-W-Australian_Open-F-Martina_Navratilova-Chris_Evert,2,S-DTL,2,1,0,0,1,0,2
19850706-W-Wimbledon-F-Martina_Navratilova-Chris_Evert,1,F-XC,20,4,0,0,4,8,12
19850706-W-Wimbledon-F-Martina_Navratilova-Chris_Evert,1,F-DTM,6,2,0,1,1,3,3
19850706-W-Wimbledon-F-Martina_Navratilova-Chris_Evert,1,F-DTL,6,3,0,2,1,4,2
19850706-W-Wimbledon-F-Martina_Navratilova-Chris_Evert,1,F-IO,2,1,1,0,0,2,0
19850706-W-Wimbledon-F-Martina_Navratilova-Chris_Evert,1,B-XC,2,0,0,0,0,0,2
19850706-W-Wimbledon-F-Martina_Navratilova-Chris_Evert,1,B-DTM,2,0,0,0,0,0,2
19850706-W-Wimbledon-F-Martina_Navratilova-Chris_Evert,1,B-IO,1,1,0,0,1,0,1
19850706-W-Wimbledon-F-Martina_Navratilova-Chris_Evert,1,S-XC,24,2,0,2,0,11,13
19850706-W-Wimbledon-F-Martina_Navratilova-Chris_Evert,1,S-DTM,21,1,0,0,1,7,14
19850706-W-Wimbledon-F-Martina_Navratilova-Chris_Evert,1,S-DTL,12,4,0,1,3,6,6
19850706-W-Wimbledon-F-Martina_Navratilova-Chris_Evert,1,S-IO,7,1,0,0,1,2,5
19850706-W-Wimbledon-F-Martina_Navratilova-Chris_Evert,2,F-XC,53,11,6,4,1,38,15
19850706-W-Wimbledon-F-Martina_Navratilova-Chris_Evert,2,F-DTM,21,2,0,0,2,9,12
19850706-W-Wimbledon-F-Martina_Navratilova-Chris_Evert,2,F-DTL,10,7,2,2,3,6,4
19850706-W-Wimbledon-F-Martina_Navratilova-Chris_Evert,2,F-IO,8,2,0,0,2,4,4
19850706-W-Wimbledon-F-Martina_Navratilova-Chris_Evert,2,B-XC,28,6,2,1,3,13,15
19850706-W-Wimbledon-F-Martina_Navratilova-Chris_Evert,2,B-DTM,20,2,0,0,2,12,8
19850706-W-Wimbledon-F-Martina_Navratilova-Chris_Evert,2,B-DTL,6,2,0,1,1,2,4
19850706-W-Wimbledon-F-Martina_Navratilova-Chris_Evert,2,B-IO,8,2,0,2,0,5,3
19850706-W-Wimbledon-F-Martina_Navratilova-Chris_Evert,2,S-XC,1,0,0,0,0,0,1
19850706-W-Wimbledon-F-Martina_Navratilova-Chris_Evert,2,S-DTM,1,0,0,0,0,0,1
20150119-W-Australian_Open-R128-Venus_Williams-Maria_Teresa_Torro_Flor,1,F-XC,26,7,4,1,2,16,10
20150119-W-Australian_Open-R128-Venus_Williams-Maria_Teresa_Torro_Flor,1,F-DTM,7,2,0,0,2,2,5
20150119-W-Australian_Open-R128-Venus_Williams-Maria_Teresa_Torro_Flor,1,F-DTL,5,2,2,0,0,4,1
20150119-W-Australian_Open-R128-Venus_Williams-Maria_Teresa_Torro_Flor,1,F-IO,4,1,0,1,0,2,2
20150119-W-Australian_Open-R128-Venus_Williams-Maria_Teresa_Torro_Flor,1,B-XC,22,5,0,2,3,14,8
20150119-W-Australian_Open-R128-Venus_Williams-Maria_Teresa_Torro_Flor,1,B-DTM,10,0,0,0,0,8,2
20150119-W-Australian_Open-R128-Venus_Williams-Maria_Teresa_Torro_Flor,1,B-DTL,5,3,0,1,2,3,2
20150119-W-Australian_Open-R128-Venus_Williams-Maria_Teresa_Torro_Flor,1,B-IO,1,1,1,0,0,1,0
20150119-W-Australian_Open-R128-Venus_Williams-Maria_Teresa_Torro_Flor,1,S-XC,1,0,0,0,0,0,1
20150119-W-Australian_Open-R128-Venus_Williams-Maria_Teresa_Torro_Flor,1,S-DTM,2,0,0,0,0,1,1
20150119-W-Australian_Open-R128-Venus_Williams-Maria_Teresa_Torro_Flor,1,S-DTL,1,0,0,0,0,1,0
20150119-W-Australian_Open-R128-Venus_Williams-Maria_Teresa_Torro_Flor,2,F-XC,20,6,1,0,5,6,14
20150119-W-Australian_Open-R128-Venus_Williams-Maria_Teresa_Torro_Flor,2,F-DTM,10,3,1,1,1,3,7
20150119-W-Australian_Open-R128-Venus_Williams-Maria_Teresa_Torro_Flor,2,F-DTL,8,4,2,1,1,5,3
20150119-W-Australian_Open-R128-Venus_Williams-Maria_Teresa_Torro_Flor,2,F-IO,10,5,2,0,3,4,6
20150119-W-Australian_Open-R128-Venus_Williams-Maria_Teresa_Torro_Flor,2,F-II,2,2,1,0,1,1,1
20150119-W-Australian_Open-R128-Venus_Williams-Maria_Teresa_Torro_Flor,2,B-XC,16,4,1,1,2,6,10
20150119-W-Australian_Open-R128-Venus_Williams-Maria_Teresa_Torro_Flor,2,B-DTM,16,3,0,1,2,5,11
20150119-W-Australian_Open-R128-Venus_Williams-Maria_Teresa_Torro_Flor,2,B-DTL,2,2,1,0,1,1,1
20150119-W-Australian_Open-R128-Venus_Williams-Maria_Teresa_Torro_Flor,2,B-IO,1,0,0,0,0,1,0
20150119-W-Australian_Open-R128-Venus_Williams-Maria_Teresa_Torro_Flor,2,S-XC,2,0,0,0,0,0,2
20150119-W-Australian_Open-R128-Venus_Williams-Maria_Teresa_Torro_Flor,2,S-DTL,2,0,0,0,0,0,2
20150119-W-Australian_Open-R128-Venus_Williams-Maria_Teresa_Torro_Flor,2,S-IO,1,0,0,0,0,0,1
19850907-W-US_Open-F-Hana_Mandlikova-Martina_Navratilova,1,F-XC,6,3,0,3,0,5,1
19850907-W-US_Open-F-Hana_Mandlikova-Martina_Navratilova,1,F-DTL,6,1,1,0,0,2,4
19850907-W-US_Open-F-Hana_Mandlikova-Martina_Navratilova,1,F-IO,2,2,1,1,0,2,0
19850907-W-US_Open-F-Hana_Mandlikova-Martina_Navratilova,1,B-XC,4,1,1,0,0,1,3
19850907-W-US_Open-F-Hana_Mandlikova-Martina_Navratilova,1,B-DTM,1,1,0,0,1,0,1
19850907-W-US_Open-F-Hana_Mandlikova-Martina_Navratilova,1,B-DTL,2,2,1,0,1,1,1
19850907-W-US_Open-F-Hana_Mandlikova-Martina_Navratilova,1,B-IO,1,1,1,0,0,1,0
19850907-W-US_Open-F-Hana_Mandlikova-Martina_Navratilova,1,S-XC,2,0,0,0,0,1,1
19850907-W-US_Open-F-Hana_Mandlikova-Martina_Navratilova,1,S-DTM,6,0,0,0,0,2,4
19850907-W-US_Open-F-Hana_Mandlikova-Martina_Navratilova,1,S-DTL,5,0,0,0,0,1,4
19850907-W-US_Open-F-Hana_Mandlikova-Martina_Navratilova,1,S-IO,1,0,0,0,0,0,1
19850907-W-US_Open-F-Hana_Mandlikova-Martina_Navratilova,2,F-XC,6,2,1,1,0,4,2
19850907-W-US_Open-F-Hana_Mandlikova-Martina_Navratilova,2,F-DTM,2,0,0,0,0,0,2
19850907-W-US_Open-F-Hana_Mandlikova-Martina_Navratilova,2,F-DTL,4,4,4,0,0,4,0
19850907-W-US_Open-F-Hana_Mandlikova-Martina_Navratilova,2,F-IO,6,2,1,0,1,3,3
19850907-W-US_Open-F-Hana_Mandlikova-Martina_Navratilova,2,B-XC,3,3,1,1,1,2,1
19850907-W-US_Open-F-Hana_Mandlikova-Martina_Navratilova,2,B-DTL,3,2,2,0,0,2,1
19850907-W-US_Open-F-Hana_Mandlikova-Martina_Navratilova,2,S-XC,5,3,0,0,3,1,4
19850907-W-US_Open-F-Hana_Mandlikova-Martina_Navratilova,2,S-DTL,2,1,0,0,1,1,1
20150125-W-Australian_Open-QF-Dominika_Cibulkova-Serena_Williams,1,F-XC,18,4,2,1,1,10,8
20150125-W-Australian_Open-QF-Dominika_Cibulkova-Serena_Williams,1,F-DTM,12,1,0,0,1,3,9
20150125-W-Australian_Open-QF-Dominika_Cibulkova-Serena_Williams,1,F-DTL,9,4,1,2,1,5,4
20150125-W-Australian_Open-QF-Dominika_Cibulkova-Serena_Williams,1,F-IO,11,5,2,1,2,5,6
20150125-W-Australian_Open-QF-Dominika_Cibulkova-Serena_Williams,1,B-XC,10,3,1,0,2,2,8
20150125-W-Australian_Open-QF-Dominika_Cibulkova-Serena_Williams,1,B-DTM,20,4,0,1,3,7,13
20150125-W-Australian_Open-QF-Dominika_Cibulkova-Serena_Williams,1,B-DTL,3,1,1,0,0,2,1
20150125-W-Australian_Open-QF-Dominika_Cibulkova-Serena_Williams,1,B-IO,1,1,1,0,0,1,0
20150125-W-Australian_Open-QF-Dominika_Cibulkova-Serena_Williams,1,S-XC,3,0,0,0,0,2,1
20150125-W-Australian_Open-QF-Dominika_Cibulkova-Serena_Williams,1,S-DTM,4,0,0,0,0,2,2
20150125-W-Australian_Open-QF-Dominika_Cibulkova-Serena_Williams,2,F-XC,15,4,3,0,1,9,6
20150125-W-Australian_Open-QF-Dominika_Cibulkova-Serena_Williams,2,F-DTM,9,1,0,0,1,3,6
20150125-W-Australian_Open-QF-Dominika_Cibulkova-Serena_Williams,2,F-DTL,6,2,2,0,0,5,1
20150125-W-Australian_Open-QF-Dominika_Cibulkova-Serena_Williams,2,F-IO,10,4,1,1,2,6,4
20150125-W-Australian_Open-QF-Dominika_Cibulkova-Serena_Williams,2,B-XC,17,4,1,0,3,12,5
20150125-W-Australian_Open-QF-Dominika_Cibulkova-Serena_Williams,2,B-DTM,15,1,0,0,1,9,6
20150125-W-Australian_Open-QF-Dominika_Cibulkova-Serena_Williams,2,B-DTL,4,0,0,0,0,4,0
20150125-W-Australian_Open-QF-Dominika_Cibulkova-Serena_Williams,2,B-IO,6,2,1,1,0,4,2
20150125-W-Australian_Open-QF-Dominika_Cibulkova-Serena_Williams,2,S-XC,1,0,0,0,0,0,1
20150125-W-Australian_Open-QF-Dominika_Cibulkova-Serena_Williams,2,S-DTM,2,0,0,0,0,1,1
20150125-W-Australian_Open-QF-Dominika_Cibulkova-Serena_Williams,2,S-DTL,1,0,0,0,0,0,1
20150125-W-Australian_Open-R16-Madison_Brengle-Madison_Keys,1,F-XC,21,2,0,0,2,7,14
20150125-W-Australian_Open-R16-Madison_Brengle-Madison_Keys,1,F-DTM,23,2,0,0,2,5,18
20150125-W-Australian_Open-R16-Madison_Brengle-Madison_Keys,1,F-DTL,8,2,0,0,2,2,6
20150125-W-Australian_Open-R16-Madison_Brengle-Madison_Keys,1,F-IO,7,0,0,0,0,4,3
20150125-W-Australian_Open-R16-Madison_Brengle-Madison_Keys,1,B-XC,22,4,0,3,1,8,14
20150125-W-Australian_Open-R16-Madison_Brengle-Madison_Keys,1,B-DTM,25,1,0,0,1,9,16
20150125-W-Australian_Open-R16-Madison_Brengle-Madison_Keys,1,B-DTL,5,1,0,1,0,3,2
20150125-W-Australian_Open-R16-Madison_Brengle-Madison_Keys,1,B-IO,5,3,1,0,2,2,3
20150125-W-Australian_Open-R16-Madison_Brengle-Madison_Keys,1,S-XC,3,0,0,0,0,1,2
20150125-W-Australian_Open-R16-Madison_Brengle-Madison_Keys,1,S-DTM,3,0,0,0,0,0,3
20150125-W-Australian_Open-R16-Madison_Brengle-Madison_Keys,1,S-DTL,2,1,0,1,0,1,1
20150125-W-Australian_Open-R16-Madison_Brengle-Madison_Keys,2,F-XC,35,7,2,2,3,26,9
20150125-W-Australian_Open-R16-Madison_Brengle-Madison_Keys,2,F-DTM,12,2,0,0,2,8,4
20150125-W-Australian_Open-R16-Madison_Brengle-Madison_Keys,2,F-DTL,9,5,3,1,1,5,4
20150125-W-Australian_Open-R16-Madison_Brengle-Madison_Keys,2,F-IO,28,10,6,2,2,24,4
20150125-W-Australian_Open-R16-Madison_Brengle-Madison_Keys,2,F-II,3,1,0,0,1,2,1
20150125-W-Australian_Open-R16-Madison_Brengle-Madison_Keys,2,B-XC,22,10,3,1,6,13,9
20150125-W-Australian_Open-R16-Madison_Brengle-Madison_Keys,2,B-DTM,17,3,0,0,3,9,8
20150125-W-Australian_Open-R16-Madison_Brengle-Madison_Keys,2,B-DTL,5,2,2,0,0,5,0
20150125-W-Australian_Open-R16-Madison_Brengle-Madison_Keys,2,B-IO,5,2,0,0,2,3,2
20150125-W-Australian_Open-R16-Madison_Brengle-Madison_Keys,2,S-DTM,1,0,0,0,0,0,1
20160115-W-Hobart-SF-Alize_Cornet-Johanna_Larsson,1,F-XC,23,4,1,1,2,17,6
20160115-W-Hobart-SF-Alize_Cornet-Johanna_Larsson,1,F-DTM,14,0,0,0,0,11,3
20160115-W-Hobart-SF-Alize_Cornet-Johanna_Larsson,1,F-DTL,10,2,1,1,0,8,2
20160115-W-Hobart-SF-Alize_Cornet-Johanna_Larsson,1,F-IO,13,2,2,0,0,12,1
20160115-W-Hobart-SF-Alize_Cornet-Johanna_Larsson,1,F-II,3,2,1,0,1,2,1
20160115-W-Hobart-SF-Alize_Cornet-Johanna_Larsson,1,B-XC,25,4,1,1,2,16,9
20160115-W-Hobart-SF-Alize_Cornet-Johanna_Larsson,1,B-DTM,11,0,0,0,0,9,2
20160115-W-Hobart-SF-Alize_Cornet-Johanna_Larsson,1,B-DTL,8,3,2,0,1,5,3
20160115-W-Hobart-SF-Alize_Cornet-Johanna_Larsson,1,B-IO,3,1,1,0,0,3,0
20160115-W-Hobart-SF-Alize_Cornet-Johanna_Larsson,1,S-XC,4,1,1,0,0,3,1
20160115-W-Hobart-SF-Alize_Cornet-Johanna_Larsson,1,S-DTM,2,0,0,0,0,2,0
20160115-W-Hobart-SF-Alize_Cornet-Johanna_Larsson,1,S-DTL,2,1,1,0,0,2,0
20160115-W-Hobart-SF-Alize_Cornet-Johanna_Larsson,2,F-XC,22,2,0,0,2,5,17
20160115-W-Hobart-SF-Alize_Cornet-Johanna_Larsson,2,F-DTM,23,2,0,1,1,5,18
20160115-W-Hobart-SF-Alize_Cornet-Johanna_Larsson,2,F-DTL,6,2,0,1,1,2,4
20160115-W-Hobart-SF-Alize_Cornet-Johanna_Larsson,2,F-IO,17,5,2,2,1,9,8
20160115-W-Hobart-SF-Alize_Cornet-Johanna_Larsson,2,F-II,2,0,0,0,0,0,2
20160115-W-Hobart-SF-Alize_Cornet-Johanna_Larsson,2,B-XC,21,8,0,0,8,1,20
20160115-W-Hobart-SF-Alize_Cornet-Johanna_Larsson,2,B-DTM,17,2,0,0,2,6,11
20160115-W-Hobart-SF-Alize_Cornet-Johanna_Larsson,2,B-DTL,9,4,2,0,2,3,6
20160115-W-Hobart-SF-Alize_Cornet-Johanna_Larsson,2,B-IO,2,1,0,1,0,1,1
20160115-W-Hobart-SF-Alize_Cornet-Johanna_Larsson,2,S-XC,9,1,0,1,0,5,4
20160115-W-Hobart-SF-Alize_Cornet-Johanna_Larsson,2,S-DTM,4,2,0,0,2,0,4
20160115-W-Hobart-SF-Alize_Cornet-Johanna_Larsson,2,S-DTL,1,0,0,0,0,0,1
20120902-W-US_Open-R16-Andrea_Hlavackova-Serena_Williams,1,F-XC,14,4,0,1,3,2,12
20120902-W-US_Open-R16-Andrea_Hlavackova-Serena_Williams,1,F-DTM,6,2,0,1,1,2,4
20120902-W-US_Open-R16-Andrea_Hlavackova-Serena_Williams,1,F-DTL,6,3,1,0,2,1,5
20120902-W-US_Open-R16-Andrea_Hlavackova-Serena_Williams,1,F-IO,4,3,2,0,1,2,2
20120902-W-US_Open-R16-Andrea_Hlavackova-Serena_Williams,1,F-II,1,0,0,0,0,0,1
20120902-W-US_Open-R16-Andrea_Hlavackova-Serena_Williams,1,B-XC,12,1,0,1,0,3,9
20120902-W-US_Open-R16-Andrea_Hlavackova-Serena_Williams,1,B-DTM,4,0,0,0,0,1,3
20120902-W-US_Open-R16-Andrea_Hlavackova-Serena_Williams,1,B-DTL,7,4,0,1,3,3,4
20120902-W-US_Open-R16-Andrea_Hlavackova-Serena_Williams,1,S-XC,1,0,0,0,0,0,1
20120902-W-US_Open-R16-Andrea_Hlavackova-Serena_Williams,2,F-XC,14,7,3,4,0,12,2
20120902-W-US_Open-R16-Andrea_Hlavackova-Serena_Williams,2,F-DTM,7,0,0,0,0,3,4
20120902-W-US_Open-R16-Andrea_Hlavackova-Serena_Williams,2,F-DTL,2,2,2,0,0,2,0
20120902-W-US_Open-R16-Andrea_Hlavackova-Serena_Williams,2,F-IO,4,3,1,2,0,4,0
20120902-W-US_Open-R16-Andrea_Hlavackova-Serena_Williams,2,B-XC,16,5,2,3,0,12,4
20120902-W-US_Open-R16-Andrea_Hlavackova-Serena_Williams,2,B-DTM,6,0,0,0,0,4,2
20120902-W-US_Open-R16-Andrea_Hlavackova-Serena_Williams,2,B-DTL,2,1,1,0,0,2,0
20120902-W-US_Open-R16-Andrea_Hlavackova-Serena_Williams,2,B-IO,2,1,1,0,0,2,0
20130606-W-Roland_Garros-SF-Serena_Williams-Sara_Errani,1,F-XC,14,5,3,2,0,10,4
20130606-W-Roland_Garros-SF-Serena_Williams-Sara_Errani,1,F-DTM,1,0,0,0,0,1,0
20130606-W-Roland_Garros-SF-Serena_Williams-Sara_Errani,1,F-DTL,2,0,0,0,0,2,0
20130606-W-Roland_Garros-SF-Serena_Williams-Sara_Errani,1,F-IO,6,4,3,0,1,4,2
20130606-W-Roland_Garros-SF-Serena_Williams-Sara_Errani,1,B-XC,19,6,2,1,3,12,7
20130606-W-Roland_Garros-SF-Serena_Williams-Sara_Errani,1,B-DTM,5,0,0,0,0,2,3
20130606-W-Roland_Garros-SF-Serena_Williams-Sara_Errani,1,B-DTL,9,5,4,1,0,9,0
20130606-W-Roland_Garros-SF-Serena_Williams-Sara_Errani,1,B-IO,7,5,3,0,2,4,3
20130606-W-Roland_Garros-SF-Serena_Williams-Sara_Errani,2,F-XC,9,2,1,0,1,4,5
20130606-W-Roland_Garros-SF-Serena_Williams-Sara_Errani,2,F-DTM,7,0,0,0,0,2,5
20130606-W-Roland_Garros-SF-Serena_Williams-Sara_Errani,2,F-DTL,8,0,0,0,0,4,4
20130606-W-Roland_Garros-SF-Serena_Williams-Sara_Errani,2,F-IO,5,2,1,1,0,3,2
20130606-W-Roland_Garros-SF-Serena_Williams-Sara_Errani,2,F-II,2,0,0,0,0,0,2
20130606-W-Roland_Garros-SF-Serena_Williams-Sara_Errani,2,B-XC,9,0,0,0,0,2,7
20130606-W-Roland_Garros-SF-Serena_Williams-Sara_Errani,2,B-DTM,4,0,0,0,0,3,1
20130606-W-Roland_Garros-SF-Serena_Williams-Sara_Errani,2,B-DTL,2,0,0,0,0,1,1
20160310-W-Indian_Wells-R128-Risa_Ozaki-Eugenie_Bouchard,1,F-XC,26,6,2,2,2,11,15
20160310-W-Indian_Wells-R128-Risa_Ozaki-Eugenie_Bouchard,1,F-DTM,66,7,1,2,4,29,37
20160310-W-Indian_Wells-R128-Risa_Ozaki-Eugenie_Bouchard,1,F-DTL,25,4,2,0,2,13,12
20160310-W-Indian_Wells-R128-Risa_Ozaki-Eugenie_Bouchard,1,F-IO,38,11,3,1,7,17,21
20160310-W-Indian_Wells-R128-Risa_Ozaki-Eugenie_Bouchard,1,F-II,2,1,0,1,0,1,1
20160310-W-Indian_Wells-R128-Risa_Ozaki-Eugenie_Bouchard,1,B-XC,18,2,0,0,2,5,13
20160310-W-Indian_Wells-R128-Risa_Ozaki-Eugenie_Bouchard,1,B-DTM,65,6,1,0,5,27,38
20160310-W-Indian_Wells-R128-Risa_Ozaki-Eugenie_Bouchard,1,B-DTL,17,5,0,2,3,7,10
20160310-W-Indian_Wells-R128-Risa_Ozaki-Eugenie_Bouchard,1,B-IO,8,1,0,0,1,1,7
20160310-W-Indian_Wells-R128-Risa_Ozaki-Eugenie_Bouchard,1,S-XC,2,0,0,0,0,1,1
20160310-W-Indian_Wells-R128-Risa_Ozaki-Eugenie_Bouchard,1,S-DTM,7,1,0,0,1,2,5
20160310-W-Indian_Wells-R128-Risa_Ozaki-Eugenie_Bouchard,1,S-DTL,2,0,0,0,0,0,2
20160310-W-Indian_Wells-R128-Risa_Ozaki-Eugenie_Bouchard,1,S-IO,1,0,0,0,0,0,1
20160310-W-Indian_Wells-R128-Risa_Ozaki-Eugenie_Bouchard,2,F-XC,62,10,3,2,5,35,27
20160310-W-Indian_Wells-R128-Risa_Ozaki-Eugenie_Bouchard,2,F-DTM,26,1,0,0,1,15,11
20160310-W-Indian_Wells-R128-Risa_Ozaki-Eugenie_Bouchard,2,F-DTL,14,2,1,0,1,9,5
20160310-W-Indian_Wells-R128-Risa_Ozaki-Eugenie_Bouchard,2,F-IO,44,12,3,4,5,25,19
20160310-W-Indian_Wells-R128-Risa_Ozaki-Eugenie_Bouchard,2,F-II,1,0,0,0,0,1,0
20160310-W-Indian_Wells-R128-Risa_Ozaki-Eugenie_Bouchard,2,B-XC,68,23,6,4,13,36,32
20160310-W-Indian_Wells-R128-Risa_Ozaki-Eugenie_Bouchard,2,B-DTM,57,9,0,0,9,31,26
20160310-W-Indian_Wells-R128-Risa_Ozaki-Eugenie_Bouchard,2,B-DTL,3,2,1,0,1,1,2
20160310-W-Indian_Wells-R128-Risa_Ozaki-Eugenie_Bouchard,2,B-IO,11,4,0,0,4,5,6
20160310-W-Indian_Wells-R128-Risa_Ozaki-Eugenie_Bouchard,2,S-XC,1,0,0,0,0,1,0
20160310-W-Indian_Wells-R128-Risa_Ozaki-Eugenie_Bouchard,2,S-DTM,2,0,0,0,0,0,2
20160123-W-Australian_Open-R16-Maria_Sharapova-Belinda_Bencic,1,F-XC,28,6,5,0,1,14,14
20160123-W-Australian_Open-R16-Maria_Sharapova-Belinda_Bencic,1,F-DTM,26,4,1,0,3,11,15
20160123-W-Australian_Open-R16-Maria_Sharapova-Belinda_Bencic,1,F-DTL,11,6,0,0,6,3,8
20160123-W-Australian_Open-R16-Maria_Sharapova-Belinda_Bencic,1,F-IO,34,23,9,3,11,18,16
20160123-W-Australian_Open-R16-Maria_Sharapova-Belinda_Bencic,1,F-II,1,1,0,0,1,0,1
20160123-W-Australian_Open-R16-Maria_Sharapova-Belinda_Bencic,1,B-XC,27,8,4,1,3,12,15
20160123-W-Australian_Open-R16-Maria_Sharapova-Belinda_Bencic,1,B-DTM,27,4,0,0,4,10,17
20160123-W-Australian_Open-R16-Maria_Sharapova-Belinda_Bencic,1,B-DTL,6,5,2,0,3,2,4
20160123-W-Australian_Open-R16-Maria_Sharapova-Belinda_Bencic,1,B-IO,7,5,1,2,2,3,4
20160123-W-Australian_Open-R16-Maria_Sharapova-Belinda_Bencic,1,S-XC,1,0,0,0,0,0,1
20160123-W-Australian_Open-R16-Maria_Sharapova-Belinda_Bencic,1,S-DTM,1,0,0,0,0,1,0
20160123-W-Australian_Open-R16-Maria_Sharapova-Belinda_Bencic,2,F-XC,23,7,3,1,3,16,7
20160123-W-Australian_Open-R16-Maria_Sharapova-Belinda_Bencic,2,F-DTM,21,0,0,0,0,13,8
20160123-W-Australian_Open-R16-Maria_Sharapova-Belinda_Bencic,2,F-DTL,5,3,0,3,0,5,0
20160123-W-Australian_Open-R16-Maria_Sharapova-Belinda_Bencic,2,F-IO,20,8,2,3,3,12,8
20160123-W-Australian_Open-R16-Maria_Sharapova-Belinda_Bencic,2,B-XC,21,2,0,1,1,13,8
20160123-W-Australian_Open-R16-Maria_Sharapova-Belinda_Bencic,2,B-DTM,32,1,0,0,1,18,14
20160123-W-Australian_Open-R16-Maria_Sharapova-Belinda_Bencic,2,B-DTL,13,7,2,1,4,5,8
20160123-W-Australian_Open-R16-Maria_Sharapova-Belinda_Bencic,2,B-IO,10,4,2,0,2,4,6
20160123-W-Australian_Open-R16-Maria_Sharapova-Belinda_Bencic,2,S-DTM,2,0,0,0,0,0,2
20160316-W-Indian_Wells-QF-Petra_Kvitova-Agnieszka_Radwanska,1,F-XC,45,16,3,4,9,18,27
20160316-W-Indian_Wells-QF-Petra_Kvitova-Agnieszka_Radwanska,1,F-DTM,18,2,0,0,2,6,12
20160316-W-Indian_Wells-QF-Petra_Kvitova-Agnieszka_Radwanska,1,F-DTL,4,0,0,0,0,0,4
20160316-W-Indian_Wells-QF-Petra_Kvitova-Agnieszka_Radwanska,1,F-IO,23,8,1,0,7,9,14
20160316-W-Indian_Wells-QF-Petra_Kvitova-Agnieszka_Radwanska,1,B-XC,38,10,2,3,5,15,23
20160316-W-Indian_Wells-QF-Petra_Kvitova-Agnieszka_Radwanska,1,B-DTM,19,3,0,1,2,6,13
20160316-W-Indian_Wells-QF-Petra_Kvitova-Agnieszka_Radwanska,1,B-DTL,6,3,1,0,2,3,3
20160316-W-Indian_Wells-QF-Petra_Kvitova-Agnieszka_Radwanska,1,B-IO,10,6,3,2,1,8,2
20160316-W-Indian_Wells-QF-Petra_Kvitova-Agnieszka_Radwanska,1,S-XC,7,2,1,0,1,2,5
20160316-W-Indian_Wells-QF-Petra_Kvitova-Agnieszka_Radwanska,1,S-DTM,3,0,0,0,0,0,3
20160316-W-Indian_Wells-QF-Petra_Kvitova-Agnieszka_Radwanska,1,S-DTL,2,0,0,0,0,0,2
20160316-W-Indian_Wells-QF-Petra_Kvitova-Agnieszka_Radwanska,1,S-IO,4,1,0,0,1,1,3
20160316-W-Indian_Wells-QF-Petra_Kvitova-Agnieszka_Radwanska,2,F-XC,28,4,1,2,1,15,13
20160316-W-Indian_Wells-QF-Petra_Kvitova-Agnieszka_Radwanska,2,F-DTM,35,3,1,0,2,22,13
20160316-W-Indian_Wells-QF-Petra_Kvitova-Agnieszka_Radwanska,2,F-DTL,9,3,1,2,0,7,2
20160316-W-Indian_Wells-QF-Petra_Kvitova-Agnieszka_Radwanska,2,F-IO,12,4,2,1,1,8,4
20160316-W-Indian_Wells-QF-Petra_Kvitova-Agnieszka_Radwanska,2,B-XC,8,1,0,0,1,5,3
20160316-W-Indian_Wells-QF-Petra_Kvitova-Agnieszka_Radwanska,2,B-DTM,34,3,0,0,3,21,13
20160316-W-Indian_Wells-QF-Petra_Kvitova-Agnieszka_Radwanska,2,B-DTL,8,3,1,0,2,2,6
20160316-W-Indian_Wells-QF-Petra_Kvitova-Agnieszka_Radwanska,2,B-IO,6,1,0,1,0,5,1
20160316-W-Indian_Wells-QF-Petra_Kvitova-Agnieszka_Radwanska,2,S-XC,4,0,0,0,0,2,2
20160316-W-Indian_Wells-QF-Petra_Kvitova-Agnieszka_Radwanska,2,S-DTM,8,0,0,0,0,7,1
20160316-W-Indian_Wells-QF-Petra_Kvitova-Agnieszka_Radwanska,2,S-DTL,3,0,0,0,0,3,0
20160316-W-Indian_Wells-QF-Petra_Kvitova-Agnieszka_Radwanska,2,S-IO,1,0,0,0,0,1,0
19860607-W-Roland_Garros-F-Chris_Evert-Martina_Navratilova,1,F-XC,182,19,7,4,8,74,108
19860607-W-Roland_Garros-F-Chris_Evert-Martina_Navratilova,1,F-DTM,32,1,1,0,0,21,11
19860607-W-Roland_Garros-F-Chris_Evert-Martina_Navratilova,1,F-DTL,17,6,3,2,1,8,9
19860607-W-Roland_Garros-F-Chris_Evert-Martina_Navratilova,1,F-IO,4,2,1,0,1,1,3
19860607-W-Roland_Garros-F-Chris_Evert-Martina_Navratilova,1,B-XC,79,16,3,4,9,36,43
19860607-W-Roland_Garros-F-Chris_Evert-Martina_Navratilova,1,B-DTM,46,1,0,0,1,23,23
19860607-W-Roland_Garros-F-Chris_Evert-Martina_Navratilova,1,B-DTL,25,4,3,0,1,15,10
19860607-W-Roland_Garros-F-Chris_Evert-Martina_Navratilova,1,B-IO,27,3,0,1,2,10,17
19860607-W-Roland_Garros-F-Chris_Evert-Martina_Navratilova,1,B-II,1,0,0,0,0,1,0
19860607-W-Roland_Garros-F-Chris_Evert-Martina_Navratilova,1,S-XC,4,0,0,0,0,1,3
19860607-W-Roland_Garros-F-Chris_Evert-Martina_Navratilova,1,S-DTM,4,1,0,1,0,3,1
19860607-W-Roland_Garros-F-Chris_Evert-Martina_Navratilova,1,S-DTL,6,0,0,0,0,3,3
19860607-W-Roland_Garros-F-Chris_Evert-Martina_Navratilova,2,F-XC,72,5,1,1,3,35,37
19860607-W-Roland_Garros-F-Chris_Evert-Martina_Navratilova,2,F-DTM,24,1,1,0,0,13,11
19860607-W-Roland_Garros-F-Chris_Evert-Martina_Navratilova,2,F-DTL,14,6,4,2,0,11,3
19860607-W-Roland_Garros-F-Chris_Evert-Martina_Navratilova,2,F-IO,12,3,1,0,2,5,7
19860607-W-Roland_Garros-F-Chris_Evert-Martina_Navratilova,2,F-II,1,0,0,0,0,1,0
19860607-W-Roland_Garros-F-Chris_Evert-Martina_Navratilova,2,B-XC,80,5,2,0,3,39,41
19860607-W-Roland_Garros-F-Chris_Evert-Martina_Navratilova,2,B-DTM,61,1,0,0,1,36,25
19860607-W-Roland_Garros-F-Chris_Evert-Martina_Navratilova,2,B-DTL,15,4,0,2,2,7,8
19860607-W-Roland_Garros-F-Chris_Evert-Martina_Navratilova,2,B-IO,2,2,0,0,2,0,2
19860607-W-Roland_Garros-F-Chris_Evert-Martina_Navratilova,2,S-XC,42,2,1,0,1,27,15
19860607-W-Roland_Garros-F-Chris_Evert-Martina_Navratilova,2,S-DTM,40,4,0,0,4,24,16
19860607-W-Roland_Garros-F-Chris_Evert-Martina_Navratilova,2,S-DTL,21,3,1,0,2,13,8
19860607-W-Roland_Garros-F-Chris_Evert-Martina_Navratilova,2,S-IO,4,0,0,0,0,1,3
19860607-W-Roland_Garros-F-Chris_Evert-Martina_Navratilova,2,S-II,1,1,0,0,1,0,1
19930605-W-Roland_Garros-F-Steffi_Graf-Mary_Joe_Fernandez,1,F-XC,66,13,4,3,6,33,33
19930605-W-Roland_Garros-F-Steffi_Graf-Mary_Joe_Fernandez,1,F-DTM,23,2,0,0,2,11,12
19930605-W-Roland_Garros-F-Steffi_Graf-Mary_Joe_Fernandez,1,F-DTL,12,6,2,2,2,10,2
19930605-W-Roland_Garros-F-Steffi_Graf-Mary_Joe_Fernandez,1,F-IO,44,12,3,3,6,26,18
19930605-W-Roland_Garros-F-Steffi_Graf-Mary_Joe_Fernandez,1,F-II,3,0,0,0,0,1,2
19930605-W-Roland_Garros-F-Steffi_Graf-Mary_Joe_Fernandez,1,B-XC,3,1,0,1,0,1,2
19930605-W-Roland_Garros-F-Steffi_Graf-Mary_Joe_Fernandez,1,B-DTM,6,0,0,0,0,2,4
19930605-W-Roland_Garros-F-Steffi_Graf-Mary_Joe_Fernandez,1,B-DTL,1,1,1,0,0,1,0
19930605-W-Roland_Garros-F-Steffi_Graf-Mary_Joe_Fernandez,1,B-IO,1,1,1,0,0,1,0
19930605-W-Roland_Garros-F-Steffi_Graf-Mary_Joe_Fernandez,1,S-XC,108,7,1,1,5,54,54
19930605-W-Roland_Garros-F-Steffi_Graf-Mary_Joe_Fernandez,1,S-DTM,27,2,0,0,2,17,10
19930605-W-Roland_Garros-F-Steffi_Graf-Mary_Joe_Fernandez,1,S-DTL,27,11,2,1,8,10,17
19930605-W-Roland_Garros-F-Steffi_Graf-Mary_Joe_Fernandez,1,S-IO,8,3,2,0,1,6,2
19930605-W-Roland_Garros-F-Steffi_Graf-Mary_Joe_Fernandez,2,F-XC,40,12,4,2,6,18,22
19930605-W-Roland_Garros-F-Steffi_Graf-Mary_Joe_Fernandez,2,F-DTM,51,5,0,0,5,21,30
19930605-W-Roland_Garros-F-Steffi_Graf-Mary_Joe_Fernandez,2,F-DTL,20,6,0,1,5,9,11
19930605-W-Roland_Garros-F-Steffi_Graf-Mary_Joe_Fernandez,2,F-IO,31,12,2,2,8,13,18
19930605-W-Roland_Garros-F-Steffi_Graf-Mary_Joe_Fernandez,2,F-II,3,2,1,1,0,3,0
19930605-W-Roland_Garros-F-Steffi_Graf-Mary_Joe_Fernandez,2,B-XC,78,7,0,1,6,34,44
19930605-W-Roland_Garros-F-Steffi_Graf-Mary_Joe_Fernandez,2,B-DTM,57,8,1,0,7,30,27
19930605-W-Roland_Garros-F-Steffi_Graf-Mary_Joe_Fernandez,2,B-DTL,21,12,3,4,5,7,14
19930605-W-Roland_Garros-F-Steffi_Graf-Mary_Joe_Fernandez,2,B-IO,7,5,1,1,3,3,4
19930605-W-Roland_Garros-F-Steffi_Graf-Mary_Joe_Fernandez,2,S-XC,15,1,0,0,1,6,9
19930605-W-Roland_Garros-F-Steffi_Graf-Mary_Joe_Fernandez,2,S-DTM,9,3,0,1,2,3,6
19930605-W-Roland_Garros-F-Steffi_Graf-Mary_Joe_Fernandez,2,S-DTL,4,0,0,0,0,3,1
20120804-W-Olympics-BR-Victoria_Azarenka-Maria_Kirilenko,1,F-XC,43,10,5,2,3,24,19
20120804-W-Olympics-BR-Victoria_Azarenka-Maria_Kirilenko,1,F-DTM,21,1,0,0,1,6,15
20120804-W-Olympics-BR-Victoria_Azarenka-Maria_Kirilenko,1,F-DTL,16,6,4,1,1,11,5
20120804-W-Olympics-BR-Victoria_Azarenka-Maria_Kirilenko,1,F-IO,26,8,4,0,4,15,11
20120804-W-Olympics-BR-Victoria_Azarenka-Maria_Kirilenko,1,F-II,1,0,0,0,0,0,1
20120804-W-Olympics-BR-Victoria_Azarenka-Maria_Kirilenko,1,B-XC,34,7,1,3,3,21,13
20120804-W-Olympics-BR-Victoria_Azarenka-Maria_Kirilenko,1,B-DTM,44,4,0,1,3,21,23
20120804-W-Olympics-BR-Victoria_Azarenka-Maria_Kirilenko,1,B-DTL,13,2,1,0,1,9,4
20120804-W-Olympics-BR-Victoria_Azarenka-Maria_Kirilenko,1,B-IO,11,2,1,0,1,8,3
20120804-W-Olympics-BR-Victoria_Azarenka-Maria_Kirilenko,1,S-XC,4,0,0,0,0,1,3
20120804-W-Olympics-BR-Victoria_Azarenka-Maria_Kirilenko,1,S-DTM,1,0,0,0,0,0,1
20120804-W-Olympics-BR-Victoria_Azarenka-Maria_Kirilenko,1,S-DTL,1,0,0,0,0,1,0
20120804-W-Olympics-BR-Victoria_Azarenka-Maria_Kirilenko,1,S-IO,1,0,0,0,0,0,1
20120804-W-Olympics-BR-Victoria_Azarenka-Maria_Kirilenko,2,F-XC,39,14,2,3,9,19,20
20120804-W-Olympics-BR-Victoria_Azarenka-Maria_Kirilenko,2,F-DTM,26,0,0,0,0,12,14
20120804-W-Olympics-BR-Victoria_Azarenka-Maria_Kirilenko,2,F-DTL,14,3,1,2,0,8,6
20120804-W-Olympics-BR-Victoria_Azarenka-Maria_Kirilenko,2,F-IO,26,4,0,3,1,14,12
20120804-W-Olympics-BR-Victoria_Azarenka-Maria_Kirilenko,2,B-XC,34,9,3,1,5,13,21
20120804-W-Olympics-BR-Victoria_Azarenka-Maria_Kirilenko,2,B-DTM,32,7,2,1,4,15,17
20120804-W-Olympics-BR-Victoria_Azarenka-Maria_Kirilenko,2,B-DTL,11,4,3,0,1,6,5
20120804-W-Olympics-BR-Victoria_Azarenka-Maria_Kirilenko,2,B-IO,4,1,1,0,0,3,1
20120804-W-Olympics-BR-Victoria_Azarenka-Maria_Kirilenko,2,S-XC,8,2,0,1,1,4,4
20120804-W-Olympics-BR-Victoria_Azarenka-Maria_Kirilenko,2,S-DTM,8,1,0,0,1,3,5
20120804-W-Olympics-BR-Victoria_Azarenka-Maria_Kirilenko,2,S-DTL,1,0,0,0,0,0,1
20120804-W-Olympics-BR-Victoria_Azarenka-Maria_Kirilenko,2,S-IO,1,0,0,0,0,1,0
20110317-W-Indian_Wells-SF-Caroline_Wozniacki-Maria_Sharapova,1,F-XC,83,5,0,1,4,45,38
20110317-W-Indian_Wells-SF-Caroline_Wozniacki-Maria_Sharapova,1,F-DTM,28,1,0,0,1,17,11
20110317-W-Indian_Wells-SF-Caroline_Wozniacki-Maria_Sharapova,1,F-DTL,27,6,1,4,1,17,10
20110317-W-Indian_Wells-SF-Caroline_Wozniacki-Maria_Sharapova,1,F-IO,16,3,0,0,3,6,10
20110317-W-Indian_Wells-SF-Caroline_Wozniacki-Maria_Sharapova,1,B-XC,25,5,1,2,2,16,9
20110317-W-Indian_Wells-SF-Caroline_Wozniacki-Maria_Sharapova,1,B-DTM,29,0,0,0,0,12,17
20110317-W-Indian_Wells-SF-Caroline_Wozniacki-Maria_Sharapova,1,B-DTL,9,1,1,0,0,7,2
20110317-W-Indian_Wells-SF-Caroline_Wozniacki-Maria_Sharapova,1,B-IO,9,3,1,0,2,7,2
20110317-W-Indian_Wells-SF-Caroline_Wozniacki-Maria_Sharapova,1,S-XC,1,0,0,0,0,0,1
20110317-W-Indian_Wells-SF-Caroline_Wozniacki-Maria_Sharapova,1,S-DTM,6,0,0,0,0,1,5
20110317-W-Indian_Wells-SF-Caroline_Wozniacki-Maria_Sharapova,1,S-DTL,2,0,0,0,0,1,1
20110317-W-Indian_Wells-SF-Caroline_Wozniacki-Maria_Sharapova,1,S-IO,1,0,0,0,0,1,0
20110317-W-Indian_Wells-SF-Caroline_Wozniacki-Maria_Sharapova,2,F-XC,103,18,5,0,13,41,62
20110317-W-Indian_Wells-SF-Caroline_Wozniacki-Maria_Sharapova,2,F-DTM,25,0,0,0,0,8,17
20110317-W-Indian_Wells-SF-Caroline_Wozniacki-Maria_Sharapova,2,F-DTL,20,11,5,2,4,13,7
20110317-W-Indian_Wells-SF-Caroline_Wozniacki-Maria_Sharapova,2,F-IO,13,5,2,0,3,4,9
20110317-W-Indian_Wells-SF-Caroline_Wozniacki-Maria_Sharapova,2,F-II,1,1,1,0,0,1,0
20110317-W-Indian_Wells-SF-Caroline_Wozniacki-Maria_Sharapova,2,B-XC,29,4,1,0,3,14,15
20110317-W-Indian_Wells-SF-Caroline_Wozniacki-Maria_Sharapova,2,B-DTM,22,0,0,0,0,8,14
20110317-W-Indian_Wells-SF-Caroline_Wozniacki-Maria_Sharapova,2,B-DTL,15,4,1,1,2,7,8
20110317-W-Indian_Wells-SF-Caroline_Wozniacki-Maria_Sharapova,2,B-IO,7,3,1,0,2,4,3
20110317-W-Indian_Wells-SF-Caroline_Wozniacki-Maria_Sharapova,2,S-DTM,2,0,0,0,0,1,1
20110317-W-Indian_Wells-SF-Caroline_Wozniacki-Maria_Sharapova,2,S-DTL,1,0,0,0,0,0,1
20160111-W-Hobart-R32-Bethanie_Mattek_Sands-Eugenie_Bouchard,1,F-XC,10,4,1,1,2,4,6
20160111-W-Hobart-R32-Bethanie_Mattek_Sands-Eugenie_Bouchard,1,F-DTM,9,2,0,0,2,3,6
20160111-W-Hobart-R32-Bethanie_Mattek_Sands-Eugenie_Bouchard,1,F-DTL,3,2,1,1,0,3,0
20160111-W-Hobart-R32-Bethanie_Mattek_Sands-Eugenie_Bouchard,1,F-IO,6,4,0,1,3,1,5
20160111-W-Hobart-R32-Bethanie_Mattek_Sands-Eugenie_Bouchard,1,F-II,1,0,0,0,0,0,1
20160111-W-Hobart-R32-Bethanie_Mattek_Sands-Eugenie_Bouchard,1,B-XC,7,1,0,0,1,2,5
20160111-W-Hobart-R32-Bethanie_Mattek_Sands-Eugenie_Bouchard,1,B-DTM,14,4,0,0,4,6,8
20160111-W-Hobart-R32-Bethanie_Mattek_Sands-Eugenie_Bouchard,1,B-IO,2,0,0,0,0,1,1
20160111-W-Hobart-R32-Bethanie_Mattek_Sands-Eugenie_Bouchard,1,S-XC,4,1,0,0,1,0,4
20160111-W-Hobart-R32-Bethanie_Mattek_Sands-Eugenie_Bouchard,1,S-DTM,4,0,0,0,0,1,3
20160111-W-Hobart-R32-Bethanie_Mattek_Sands-Eugenie_Bouchard,2,F-XC,18,8,6,1,1,13,5
20160111-W-Hobart-R32-Bethanie_Mattek_Sands-Eugenie_Bouchard,2,F-DTM,8,1,0,0,1,4,4
20160111-W-Hobart-R32-Bethanie_Mattek_Sands-Eugenie_Bouchard,2,F-DTL,4,2,1,1,0,4,0
20160111-W-Hobart-R32-Bethanie_Mattek_Sands-Eugenie_Bouchard,2,F-IO,8,4,1,2,1,5,3
20160111-W-Hobart-R32-Bethanie_Mattek_Sands-Eugenie_Bouchard,2,B-XC,15,5,3,0,2,9,6
20160111-W-Hobart-R32-Bethanie_Mattek_Sands-Eugenie_Bouchard,2,B-DTM,16,0,0,0,0,10,6
20160111-W-Hobart-R32-Bethanie_Mattek_Sands-Eugenie_Bouchard,2,B-DTL,5,5,3,0,2,3,2
20160111-W-Hobart-R32-Bethanie_Mattek_Sands-Eugenie_Bouchard,2,B-IO,4,2,1,0,1,2,2
19890409-W-Hilton_Head-F-Steffi_Graf-Natalia_Zvereva,1,F-XC,27,2,1,0,1,11,16
19890409-W-Hilton_Head-F-Steffi_Graf-Natalia_Zvereva,1,F-DTM,8,1,0,0,1,3,5
19890409-W-Hilton_Head-F-Steffi_Graf-Natalia_Zvereva,1,F-DTL,3,1,0,0,1,1,2
19890409-W-Hilton_Head-F-Steffi_Graf-Natalia_Zvereva,1,F-IO,25,8,5,1,2,18,7
19890409-W-Hilton_Head-F-Steffi_Graf-Natalia_Zvereva,1,F-II,4,0,0,0,0,2,2
19890409-W-Hilton_Head-F-Steffi_Graf-Natalia_Zvereva,1,B-XC,1,1,0,0,1,0,1
19890409-W-Hilton_Head-F-Steffi_Graf-Natalia_Zvereva,1,B-DTL,1,1,0,0,1,0,1
19890409-W-Hilton_Head-F-Steffi_Graf-Natalia_Zvereva,1,S-XC,49,6,0,0,6,24,25
19890409-W-Hilton_Head-F-Steffi_Graf-Natalia_Zvereva,1,S-DTM,12,2,0,0,2,7,5
19890409-W-Hilton_Head-F-Steffi_Graf-Natalia_Zvereva,1,S-DTL,31,2,2,0,0,21,10
19890409-W-Hilton_Head-F-Steffi_Graf-Natalia_Zvereva,1,S-IO,3,1,0,1,0,2,1
19890409-W-Hilton_Head-F-Steffi_Graf-Natalia_Zvereva,2,F-XC,24,7,0,1,6,13,11
19890409-W-Hilton_Head-F-Steffi_Graf-Natalia_Zvereva,2,F-DTM,13,2,0,0,2,5,8
19890409-W-Hilton_Head-F-Steffi_Graf-Natalia_Zvereva,2,F-DTL,30,3,1,0,2,9,21
19890409-W-Hilton_Head-F-Steffi_Graf-Natalia_Zvereva,2,F-IO,6,2,1,0,1,3,3
19890409-W-Hilton_Head-F-Steffi_Graf-Natalia_Zvereva,2,F-II,1,1,0,0,1,0,1
19890409-W-Hilton_Head-F-Steffi_Graf-Natalia_Zvereva,2,B-XC,46,6,1,0,5,22,24
19890409-W-Hilton_Head-F-Steffi_Graf-Natalia_Zvereva,2,B-DTM,13,2,0,0,2,4,9
19890409-W-Hilton_Head-F-Steffi_Graf-Natalia_Zvereva,2,B-DTL,7,5,1,1,3,3,4
19890409-W-Hilton_Head-F-Steffi_Graf-Natalia_Zvereva,2,B-IO,4,2,1,0,1,2,2
19890409-W-Hilton_Head-F-Steffi_Graf-Natalia_Zvereva,2,S-XC,14,1,0,1,0,6,8
19890409-W-Hilton_Head-F-Steffi_Graf-Natalia_Zvereva,2,S-DTM,9,1,0,0,1,4,5
19890409-W-Hilton_Head-F-Steffi_Graf-Natalia_Zvereva,2,S-DTL,4,1,1,0,0,2,2
19890409-W-Hilton_Head-F-Steffi_Graf-Natalia_Zvereva,2,S-IO,1,1,0,0,1,0,1
20160116-W-Hobart-F-Eugenie_Bouchard-Alize_Cornet,1,F-XC,27,9,4,1,4,10,17
20160116-W-Hobart-F-Eugenie_Bouchard-Alize_Cornet,1,F-DTM,10,0,0,0,0,4,6
20160116-W-Hobart-F-Eugenie_Bouchard-Alize_Cornet,1,F-DTL,8,4,1,1,2,4,4
20160116-W-Hobart-F-Eugenie_Bouchard-Alize_Cornet,1,F-IO,12,6,4,1,1,8,4
20160116-W-Hobart-F-Eugenie_Bouchard-Alize_Cornet,1,F-II,1,1,0,1,0,1,0
20160116-W-Hobart-F-Eugenie_Bouchard-Alize_Cornet,1,B-XC,31,8,2,0,6,13,18
20160116-W-Hobart-F-Eugenie_Bouchard-Alize_Cornet,1,B-DTM,20,2,0,0,2,8,12
20160116-W-Hobart-F-Eugenie_Bouchard-Alize_Cornet,1,B-DTL,9,5,2,1,2,4,5
20160116-W-Hobart-F-Eugenie_Bouchard-Alize_Cornet,1,B-IO,1,1,0,0,1,0,1
20160116-W-Hobart-F-Eugenie_Bouchard-Alize_Cornet,1,S-XC,2,1,0,0,1,0,2
20160116-W-Hobart-F-Eugenie_Bouchard-Alize_Cornet,1,S-IO,1,1,0,0,1,0,1
20160116-W-Hobart-F-Eugenie_Bouchard-Alize_Cornet,2,F-XC,19,3,1,1,1,13,6
20160116-W-Hobart-F-Eugenie_Bouchard-Alize_Cornet,2,F-DTM,14,4,0,0,4,8,6
20160116-W-Hobart-F-Eugenie_Bouchard-Alize_Cornet,2,F-DTL,10,2,0,1,1,8,2
20160116-W-Hobart-F-Eugenie_Bouchard-Alize_Cornet,2,F-IO,10,3,3,0,0,5,5
20160116-W-Hobart-F-Eugenie_Bouchard-Alize_Cornet,2,B-XC,22,3,1,1,1,10,12
20160116-W-Hobart-F-Eugenie_Bouchard-Alize_Cornet,2,B-DTM,20,3,0,1,2,10,10
20160116-W-Hobart-F-Eugenie_Bouchard-Alize_Cornet,2,B-DTL,2,1,1,0,0,1,1
20160116-W-Hobart-F-Eugenie_Bouchard-Alize_Cornet,2,S-DTM,4,0,0,0,0,2,2
20160116-W-Hobart-F-Eugenie_Bouchard-Alize_Cornet,2,S-DTL,1,0,0,0,0,1,0
20160116-W-Hobart-F-Eugenie_Bouchard-Alize_Cornet,2,S-IO,1,0,0,0,0,1,0
19811118-W-Perth-R16-Eva_Pfaff-Pam_Shriver,1,F-XC,9,5,2,1,2,4,5
19811118-W-Perth-R16-Eva_Pfaff-Pam_Shriver,1,F-DTM,1,0,0,0,0,0,1
19811118-W-Perth-R16-Eva_Pfaff-Pam_Shriver,1,F-DTL,1,1,0,1,0,1,0
19811118-W-Perth-R16-Eva_Pfaff-Pam_Shriver,1,B-XC,6,2,0,1,1,1,5
19811118-W-Perth-R16-Eva_Pfaff-Pam_Shriver,1,B-DTM,3,1,0,0,1,0,3
19811118-W-Perth-R16-Eva_Pfaff-Pam_Shriver,1,B-DTL,5,2,1,0,1,2,3
19811118-W-Perth-R16-Eva_Pfaff-Pam_Shriver,1,B-IO,2,2,2,0,0,2,0
19811118-W-Perth-R16-Eva_Pfaff-Pam_Shriver,1,S-XC,3,1,1,0,0,1,2
19811118-W-Perth-R16-Eva_Pfaff-Pam_Shriver,1,S-DTM,2,1,0,0,1,1,1
19811118-W-Perth-R16-Eva_Pfaff-Pam_Shriver,1,S-DTL,1,1,0,0,1,0,1
19811118-W-Perth-R16-Eva_Pfaff-Pam_Shriver,2,F-DTM,1,0,0,0,0,0,1
19811118-W-Perth-R16-Eva_Pfaff-Pam_Shriver,2,F-DTL,1,1,1,0,0,1,0
19811118-W-Perth-R16-Eva_Pfaff-Pam_Shriver,2,B-XC,1,0,0,0,0,0,1
19811118-W-Perth-R16-Eva_Pfaff-Pam_Shriver,2,B-DTM,1,1,0,1,0,1,0
19811118-W-Perth-R16-Eva_Pfaff-Pam_Shriver,2,S-DTM,4,0,0,0,0,2,2
19811118-W-Perth-R16-Eva_Pfaff-Pam_Shriver,2,S-DTL,1,1,1,0,0,1,0
19900127-W-Australian_Open-F-Steffi_Graf-Mary_Joe_Fernandez,1,F-XC,51,12,4,3,5,22,29
19900127-W-Australian_Open-F-Steffi_Graf-Mary_Joe_Fernandez,1,F-DTM,20,2,0,0,2,8,12
19900127-W-Australian_Open-F-Steffi_Graf-Mary_Joe_Fernandez,1,F-DTL,2,1,0,1,0,1,1
19900127-W-Australian_Open-F-Steffi_Graf-Mary_Joe_Fernandez,1,F-IO,17,5,1,0,4,7,10
19900127-W-Australian_Open-F-Steffi_Graf-Mary_Joe_Fernandez,1,F-II,4,1,1,0,0,3,1
19900127-W-Australian_Open-F-Steffi_Graf-Mary_Joe_Fernandez,1,B-XC,4,2,2,0,0,3,1
19900127-W-Australian_Open-F-Steffi_Graf-Mary_Joe_Fernandez,1,B-DTM,2,0,0,0,0,0,2
19900127-W-Australian_Open-F-Steffi_Graf-Mary_Joe_Fernandez,1,B-DTL,2,0,0,0,0,0,2
19900127-W-Australian_Open-F-Steffi_Graf-Mary_Joe_Fernandez,1,S-XC,48,8,3,2,3,20,28
19900127-W-Australian_Open-F-Steffi_Graf-Mary_Joe_Fernandez,1,S-DTM,32,2,0,0,2,14,18
19900127-W-Australian_Open-F-Steffi_Graf-Mary_Joe_Fernandez,1,S-DTL,20,3,0,1,2,9,11
19900127-W-Australian_Open-F-Steffi_Graf-Mary_Joe_Fernandez,1,S-IO,10,2,0,0,2,4,6
19900127-W-Australian_Open-F-Steffi_Graf-Mary_Joe_Fernandez,2,F-XC,33,8,1,3,4,21,12
19900127-W-Australian_Open-F-Steffi_Graf-Mary_Joe_Fernandez,2,F-DTM,37,9,0,1,8,17,20
19900127-W-Australian_Open-F-Steffi_Graf-Mary_Joe_Fernandez,2,F-DTL,17,2,0,0,2,7,10
19900127-W-Australian_Open-F-Steffi_Graf-Mary_Joe_Fernandez,2,F-IO,30,4,1,1,2,18,12
19900127-W-Australian_Open-F-Steffi_Graf-Mary_Joe_Fernandez,2,F-II,1,0,0,0,0,0,1
19900127-W-Australian_Open-F-Steffi_Graf-Mary_Joe_Fernandez,2,B-XC,34,4,1,0,3,20,14
19900127-W-Australian_Open-F-Steffi_Graf-Mary_Joe_Fernandez,2,B-DTM,32,0,0,0,0,20,12
19900127-W-Australian_Open-F-Steffi_Graf-Mary_Joe_Fernandez,2,B-DTL,5,2,1,0,1,2,3
19900127-W-Australian_Open-F-Steffi_Graf-Mary_Joe_Fernandez,2,B-IO,4,2,1,1,0,3,1
19900127-W-Australian_Open-F-Steffi_Graf-Mary_Joe_Fernandez,2,S-XC,6,0,0,0,0,5,1
19900127-W-Australian_Open-F-Steffi_Graf-Mary_Joe_Fernandez,2,S-DTM,7,1,0,0,1,3,4
19900127-W-Australian_Open-F-Steffi_Graf-Mary_Joe_Fernandez,2,S-DTL,7,2,1,1,0,5,2
19900127-W-Australian_Open-F-Steffi_Graf-Mary_Joe_Fernandez,2,S-IO,1,0,0,0,0,0,1
20060709-W-Wimbledon-F-Amelie_Mauresmo-Justine_Henin,1,F-XC,16,5,1,3,1,10,6
20060709-W-Wimbledon-F-Amelie_Mauresmo-Justine_Henin,1,F-DTM,29,4,0,1,3,10,19
20060709-W-Wimbledon-F-Amelie_Mauresmo-Justine_Henin,1,F-DTL,9,2,1,0,1,2,7
20060709-W-Wimbledon-F-Amelie_Mauresmo-Justine_Henin,1,F-IO,14,2,1,1,0,9,5
20060709-W-Wimbledon-F-Amelie_Mauresmo-Justine_Henin,1,B-XC,11,5,2,1,2,5,6
20060709-W-Wimbledon-F-Amelie_Mauresmo-Justine_Henin,1,B-DTM,26,5,0,1,4,9,17
20060709-W-Wimbledon-F-Amelie_Mauresmo-Justine_Henin,1,B-DTL,3,1,1,0,0,1,2
20060709-W-Wimbledon-F-Amelie_Mauresmo-Justine_Henin,1,B-IO,4,3,1,1,1,2,2
20060709-W-Wimbledon-F-Amelie_Mauresmo-Justine_Henin,1,S-XC,4,3,0,1,2,1,3
20060709-W-Wimbledon-F-Amelie_Mauresmo-Justine_Henin,1,S-DTM,18,3,0,2,1,7,11
20060709-W-Wimbledon-F-Amelie_Mauresmo-Justine_Henin,1,S-DTL,5,2,0,0,2,0,5
20060709-W-Wimbledon-F-Amelie_Mauresmo-Justine_Henin,2,F-XC,32,10,5,1,4,22,10
20060709-W-Wimbledon-F-Amelie_Mauresmo-Justine_Henin,2,F-DTM,27,8,1,2,5,14,13
20060709-W-Wimbledon-F-Amelie_Mauresmo-Justine_Henin,2,F-DTL,5,3,1,0,2,2,3
20060709-W-Wimbledon-F-Amelie_Mauresmo-Justine_Henin,2,F-IO,20,6,2,0,4,10,10
20060709-W-Wimbledon-F-Amelie_Mauresmo-Justine_Henin,2,B-XC,23,4,0,2,2,13,10
20060709-W-Wimbledon-F-Amelie_Mauresmo-Justine_Henin,2,B-DTM,23,2,0,2,0,12,11
20060709-W-Wimbledon-F-Amelie_Mauresmo-Justine_Henin,2,B-IO,2,0,0,0,0,2,0
20060709-W-Wimbledon-F-Amelie_Mauresmo-Justine_Henin,2,S-XC,4,1,0,1,0,1,3
20060709-W-Wimbledon-F-Amelie_Mauresmo-Justine_Henin,2,S-DTM,11,2,0,1,1,6,5
20160402-W-Miami-F-Svetlana_Kuznetsova-Victoria_Azarenka,1,F-XC,31,7,1,0,6,9,22
20160402-W-Miami-F-Svetlana_Kuznetsova-Victoria_Azarenka,1,F-DTM,19,2,0,0,2,7,12
20160402-W-Miami-F-Svetlana_Kuznetsova-Victoria_Azarenka,1,F-DTL,16,6,1,0,5,4,12
20160402-W-Miami-F-Svetlana_Kuznetsova-Victoria_Azarenka,1,F-IO,10,4,0,1,3,3,7
20160402-W-Miami-F-Svetlana_Kuznetsova-Victoria_Azarenka,1,F-II,1,0,0,0,0,0,1
20160402-W-Miami-F-Svetlana_Kuznetsova-Victoria_Azarenka,1,B-XC,19,4,0,1,3,4,15
20160402-W-Miami-F-Svetlana_Kuznetsova-Victoria_Azarenka,1,B-DTM,18,2,0,0,2,3,15
20160402-W-Miami-F-Svetlana_Kuznetsova-Victoria_Azarenka,1,B-DTL,10,4,1,1,2,4,6
20160402-W-Miami-F-Svetlana_Kuznetsova-Victoria_Azarenka,1,B-IO,5,0,0,0,0,0,5
20160402-W-Miami-F-Svetlana_Kuznetsova-Victoria_Azarenka,1,S-XC,8,0,0,0,0,2,6
20160402-W-Miami-F-Svetlana_Kuznetsova-Victoria_Azarenka,1,S-DTM,7,0,0,0,0,2,5
20160402-W-Miami-F-Svetlana_Kuznetsova-Victoria_Azarenka,1,S-DTL,2,0,0,0,0,0,2
20160402-W-Miami-F-Svetlana_Kuznetsova-Victoria_Azarenka,1,S-IO,1,0,0,0,0,0,1
20160402-W-Miami-F-Svetlana_Kuznetsova-Victoria_Azarenka,2,F-XC,37,9,1,5,3,24,13
20160402-W-Miami-F-Svetlana_Kuznetsova-Victoria_Azarenka,2,F-DTM,12,2,0,1,1,9,3
20160402-W-Miami-F-Svetlana_Kuznetsova-Victoria_Azarenka,2,F-DTL,17,7,3,3,1,16,1
20160402-W-Miami-F-Svetlana_Kuznetsova-Victoria_Azarenka,2,F-IO,6,1,1,0,0,4,2
20160402-W-Miami-F-Svetlana_Kuznetsova-Victoria_Azarenka,2,F-II,1,0,0,0,0,1,0
20160402-W-Miami-F-Svetlana_Kuznetsova-Victoria_Azarenka,2,B-XC,35,5,1,0,4,23,12
20160402-W-Miami-F-Svetlana_Kuznetsova-Victoria_Azarenka,2,B-DTM,13,2,0,0,2,9,4
20160402-W-Miami-F-Svetlana_Kuznetsova-Victoria_Azarenka,2,B-DTL,8,2,2,0,0,6,2
20160402-W-Miami-F-Svetlana_Kuznetsova-Victoria_Azarenka,2,B-IO,10,1,1,0,0,7,3
20160402-W-Miami-F-Svetlana_Kuznetsova-Victoria_Azarenka,2,S-XC,3,0,0,0,0,2,1
20160402-W-Miami-F-Svetlana_Kuznetsova-Victoria_Azarenka,2,S-DTM,2,0,0,0,0,1,1
20160402-W-Miami-F-Svetlana_Kuznetsova-Victoria_Azarenka,2,S-DTL,2,0,0,0,0,2,0
20160402-W-Miami-F-Svetlana_Kuznetsova-Victoria_Azarenka,2,S-IO,1,0,0,0,0,1,0
20160327-W-Miami-R32-Magda_Linette-Victoria_Azarenka,1,F-XC,38,5,2,1,2,11,27
20160327-W-Miami-R32-Magda_Linette-Victoria_Azarenka,1,F-DTM,4,1,0,0,1,1,3
20160327-W-Miami-R32-Magda_Linette-Victoria_Azarenka,1,F-DTL,6,4,0,2,2,2,4
20160327-W-Miami-R32-Magda_Linette-Victoria_Azarenka,1,F-IO,2,0,0,0,0,0,2
20160327-W-Miami-R32-Magda_Linette-Victoria_Azarenka,1,B-XC,27,5,0,1,4,10,17
20160327-W-Miami-R32-Magda_Linette-Victoria_Azarenka,1,B-DTM,18,2,1,0,1,6,12
20160327-W-Miami-R32-Magda_Linette-Victoria_Azarenka,1,B-DTL,5,3,1,0,2,1,4
20160327-W-Miami-R32-Magda_Linette-Victoria_Azarenka,1,B-IO,1,0,0,0,0,1,0
20160327-W-Miami-R32-Magda_Linette-Victoria_Azarenka,1,S-XC,1,0,0,0,0,0,1
20160327-W-Miami-R32-Magda_Linette-Victoria_Azarenka,1,S-DTM,2,1,0,0,1,0,2
20160327-W-Miami-R32-Magda_Linette-Victoria_Azarenka,1,S-DTL,1,0,0,0,0,0,1
20160327-W-Miami-R32-Magda_Linette-Victoria_Azarenka,2,F-XC,32,12,5,5,2,23,9
20160327-W-Miami-R32-Magda_Linette-Victoria_Azarenka,2,F-DTM,14,1,0,0,1,9,5
20160327-W-Miami-R32-Magda_Linette-Victoria_Azarenka,2,F-DTL,16,4,2,2,0,12,4
20160327-W-Miami-R32-Magda_Linette-Victoria_Azarenka,2,F-IO,7,1,0,0,1,5,2
20160327-W-Miami-R32-Magda_Linette-Victoria_Azarenka,2,B-XC,24,6,1,1,4,12,12
20160327-W-Miami-R32-Magda_Linette-Victoria_Azarenka,2,B-DTM,6,0,0,0,0,6,0
20160327-W-Miami-R32-Magda_Linette-Victoria_Azarenka,2,B-DTL,5,2,1,1,0,5,0
20160327-W-Miami-R32-Magda_Linette-Victoria_Azarenka,2,B-IO,4,3,1,1,1,3,1
20160327-W-Miami-R32-Magda_Linette-Victoria_Azarenka,2,S-XC,2,0,0,0,0,1,1
20160327-W-Miami-R32-Magda_Linette-Victoria_Azarenka,2,S-DTM,1,0,0,0,0,0,1
20160327-W-Miami-R32-Magda_Linette-Victoria_Azarenka,2,S-DTL,1,0,0,0,0,1,0
19970607-W-Roland_Garros-F-Martina_Hingis-Iva_Majoli,1,F-XC,19,2,0,2,0,11,8
19970607-W-Roland_Garros-F-Martina_Hingis-Iva_Majoli,1,F-DTM,49,2,0,0,2,21,28
19970607-W-Roland_Garros-F-Martina_Hingis-Iva_Majoli,1,F-DTL,17,2,0,0,2,5,12
19970607-W-Roland_Garros-F-Martina_Hingis-Iva_Majoli,1,F-IO,25,5,2,1,2,17,8
19970607-W-Roland_Garros-F-Martina_Hingis-Iva_Majoli,1,B-XC,40,8,2,1,5,22,18
19970607-W-Roland_Garros-F-Martina_Hingis-Iva_Majoli,1,B-DTM,25,3,1,0,2,10,15
19970607-W-Roland_Garros-F-Martina_Hingis-Iva_Majoli,1,B-DTL,12,4,1,1,2,8,4
19970607-W-Roland_Garros-F-Martina_Hingis-Iva_Majoli,1,B-IO,14,6,2,1,3,8,6
19970607-W-Roland_Garros-F-Martina_Hingis-Iva_Majoli,1,B-II,1,0,0,0,0,0,1
19970607-W-Roland_Garros-F-Martina_Hingis-Iva_Majoli,1,S-XC,2,0,0,0,0,0,2
19970607-W-Roland_Garros-F-Martina_Hingis-Iva_Majoli,1,S-DTM,8,1,0,0,1,0,8
19970607-W-Roland_Garros-F-Martina_Hingis-Iva_Majoli,1,S-DTL,2,0,0,0,0,0,2
19970607-W-Roland_Garros-F-Martina_Hingis-Iva_Majoli,2,F-XC,55,10,6,2,2,39,16
19970607-W-Roland_Garros-F-Martina_Hingis-Iva_Majoli,2,F-DTM,20,1,0,0,1,7,13
19970607-W-Roland_Garros-F-Martina_Hingis-Iva_Majoli,2,F-DTL,4,2,1,0,1,3,1
19970607-W-Roland_Garros-F-Martina_Hingis-Iva_Majoli,2,F-IO,23,11,3,4,4,16,7
19970607-W-Roland_Garros-F-Martina_Hingis-Iva_Majoli,2,F-II,1,0,0,0,0,0,1
19970607-W-Roland_Garros-F-Martina_Hingis-Iva_Majoli,2,B-XC,52,8,5,0,3,29,23
19970607-W-Roland_Garros-F-Martina_Hingis-Iva_Majoli,2,B-DTM,36,3,1,0,2,14,22
19970607-W-Roland_Garros-F-Martina_Hingis-Iva_Majoli,2,B-DTL,9,5,2,1,2,6,3
19970607-W-Roland_Garros-F-Martina_Hingis-Iva_Majoli,2,B-IO,9,2,0,0,2,6,3
19970607-W-Roland_Garros-F-Martina_Hingis-Iva_Majoli,2,S-DTM,2,0,0,0,0,0,2
19970607-W-Roland_Garros-F-Martina_Hingis-Iva_Majoli,2,S-DTL,3,0,0,0,0,2,1
20160404-W-Katowice-R32-Kirsten_Flipkens-Donna_Vekic,1,F-XC,18,11,3,2,6,9,9
20160404-W-Katowice-R32-Kirsten_Flipkens-Donna_Vekic,1,F-DTM,17,1,0,1,0,12,5
20160404-W-Katowice-R32-Kirsten_Flipkens-Donna_Vekic,1,F-DTL,2,0,0,0,0,1,1
20160404-W-Katowice-R32-Kirsten_Flipkens-Donna_Vekic,1,F-IO,3,1,1,0,0,2,1
20160404-W-Katowice-R32-Kirsten_Flipkens-Donna_Vekic,1,F-II,1,1,1,0,0,1,0
20160404-W-Katowice-R32-Kirsten_Flipkens-Donna_Vekic,1,B-XC,6,1,1,0,0,3,3
20160404-W-Katowice-R32-Kirsten_Flipkens-Donna_Vekic,1,B-DTM,4,1,0,0,1,1,3
20160404-W-Katowice-R32-Kirsten_Flipkens-Donna_Vekic,1,S-XC,20,2,0,0,2,11,9
20160404-W-Katowice-R32-Kirsten_Flipkens-Donna_Vekic,1,S-DTM,23,1,0,0,1,17,6
20160404-W-Katowice-R32-Kirsten_Flipkens-Donna_Vekic,1,S-DTL,1,1,0,0,1,0,1
20160404-W-Katowice-R32-Kirsten_Flipkens-Donna_Vekic,2,F-XC,16,5,1,2,2,12,4
20160404-W-Katowice-R32-Kirsten_Flipkens-Donna_Vekic,2,F-DTM,14,3,1,0,2,6,8
20160404-W-Katowice-R32-Kirsten_Flipkens-Donna_Vekic,2,F-DTL,2,0,0,0,0,0,2
20160404-W-Katowice-R32-Kirsten_Flipkens-Donna_Vekic,2,F-IO,13,6,4,0,2,7,6
20160404-W-Katowice-R32-Kirsten_Flipkens-Donna_Vekic,2,B-XC,27,7,0,1,6,10,17
20160404-W-Katowice-R32-Kirsten_Flipkens-Donna_Vekic,2,B-DTM,21,2,1,0,1,6,15
20160404-W-Katowice-R32-Kirsten_Flipkens-Donna_Vekic,2,B-DTL,3,1,0,1,0,2,1
20160404-W-Katowice-R32-Kirsten_Flipkens-Donna_Vekic,2,B-IO,13,9,0,0,9,2,11
20160404-W-Katowice-R32-Kirsten_Flipkens-Donna_Vekic,2,S-XC,1,1,0,0,1,0,1
20160404-W-Katowice-R32-Kirsten_Flipkens-Donna_Vekic,2,S-DTM,1,1,0,0,1,0,1
20160407-W-Charleston-R16-Mirjana_Lucic-Laura_Siegemund,1,F-XC,31,13,6,2,5,15,16
20160407-W-Charleston-R16-Mirjana_Lucic-Laura_Siegemund,1,F-DTM,29,6,1,1,4,12,17
20160407-W-Charleston-R16-Mirjana_Lucic-Laura_Siegemund,1,F-DTL,5,2,1,1,0,2,3
20160407-W-Charleston-R16-Mirjana_Lucic-Laura_Siegemund,1,F-IO,21,8,4,1,3,13,8
20160407-W-Charleston-R16-Mirjana_Lucic-Laura_Siegemund,1,F-II,1,0,0,0,0,1,0
20160407-W-Charleston-R16-Mirjana_Lucic-Laura_Siegemund,1,B-XC,25,6,2,1,3,14,11
20160407-W-Charleston-R16-Mirjana_Lucic-Laura_Siegemund,1,B-DTM,43,6,0,0,6,19,24
20160407-W-Charleston-R16-Mirjana_Lucic-Laura_Siegemund,1,B-DTL,5,3,1,0,2,3,2
20160407-W-Charleston-R16-Mirjana_Lucic-Laura_Siegemund,1,B-IO,4,3,2,0,1,3,1
20160407-W-Charleston-R16-Mirjana_Lucic-Laura_Siegemund,1,S-XC,2,0,0,0,0,1,1
20160407-W-Charleston-R16-Mirjana_Lucic-Laura_Siegemund,1,S-DTM,3,0,0,0,0,2,1
20160407-W-Charleston-R16-Mirjana_Lucic-Laura_Siegemund,1,S-DTL,1,0,0,0,0,0,1
20160407-W-Charleston-R16-Mirjana_Lucic-Laura_Siegemund,1,S-IO,1,0,0,0,0,0,1
20160407-W-Charleston-R16-Mirjana_Lucic-Laura_Siegemund,2,F-XC,18,6,1,3,2,12,6
20160407-W-Charleston-R16-Mirjana_Lucic-Laura_Siegemund,2,F-DTM,17,2,0,0,2,8,9
20160407-W-Charleston-R16-Mirjana_Lucic-Laura_Siegemund,2,F-DTL,5,1,0,1,0,4,1
20160407-W-Charleston-R16-Mirjana_Lucic-Laura_Siegemund,2,F-IO,18,4,2,0,2,8,10
20160407-W-Charleston-R16-Mirjana_Lucic-Laura_Siegemund,2,B-XC,17,1,0,0,1,7,10
20160407-W-Charleston-R16-Mirjana_Lucic-Laura_Siegemund,2,B-DTM,36,3,0,0,3,17,19
20160407-W-Charleston-R16-Mirjana_Lucic-Laura_Siegemund,2,B-DTL,10,6,5,0,1,8,2
20160407-W-Charleston-R16-Mirjana_Lucic-Laura_Siegemund,2,B-IO,10,4,1,0,3,4,6
20160407-W-Charleston-R16-Mirjana_Lucic-Laura_Siegemund,2,S-XC,3,1,1,0,0,2,1
20160407-W-Charleston-R16-Mirjana_Lucic-Laura_Siegemund,2,S-DTM,9,1,0,0,1,4,5
20160407-W-Charleston-R16-Mirjana_Lucic-Laura_Siegemund,2,S-IO,1,1,0,1,0,1,0
20130110-W-Hobart-QF-Kirsten_Flipkens-Monica_Niculescu,1,F-XC,64,17,3,5,9,24,40
20130110-W-Hobart-QF-Kirsten_Flipkens-Monica_Niculescu,1,F-DTM,14,1,0,0,1,6,8
20130110-W-Hobart-QF-Kirsten_Flipkens-Monica_Niculescu,1,F-DTL,19,5,2,2,1,9,10
20130110-W-Hobart-QF-Kirsten_Flipkens-Monica_Niculescu,1,F-IO,38,13,2,4,7,18,20
20130110-W-Hobart-QF-Kirsten_Flipkens-Monica_Niculescu,1,F-II,5,2,2,0,0,2,3
20130110-W-Hobart-QF-Kirsten_Flipkens-Monica_Niculescu,1,B-XC,11,3,0,2,1,8,3
20130110-W-Hobart-QF-Kirsten_Flipkens-Monica_Niculescu,1,B-DTM,12,2,0,0,2,7,5
20130110-W-Hobart-QF-Kirsten_Flipkens-Monica_Niculescu,1,B-DTL,5,5,1,1,3,2,3
20130110-W-Hobart-QF-Kirsten_Flipkens-Monica_Niculescu,1,B-IO,2,1,1,0,0,1,1
20130110-W-Hobart-QF-Kirsten_Flipkens-Monica_Niculescu,1,S-XC,54,4,2,0,2,23,31
20130110-W-Hobart-QF-Kirsten_Flipkens-Monica_Niculescu,1,S-DTM,33,0,0,0,0,20,13
20130110-W-Hobart-QF-Kirsten_Flipkens-Monica_Niculescu,1,S-DTL,5,0,0,0,0,2,3
20130110-W-Hobart-QF-Kirsten_Flipkens-Monica_Niculescu,1,S-IO,6,1,1,0,0,1,5
20130110-W-Hobart-QF-Kirsten_Flipkens-Monica_Niculescu,2,F-XC,7,3,2,1,0,5,2
20130110-W-Hobart-QF-Kirsten_Flipkens-Monica_Niculescu,2,F-DTM,5,0,0,0,0,5,0
20130110-W-Hobart-QF-Kirsten_Flipkens-Monica_Niculescu,2,F-DTL,7,3,0,2,1,5,2
20130110-W-Hobart-QF-Kirsten_Flipkens-Monica_Niculescu,2,F-IO,1,1,1,0,0,1,0
20130110-W-Hobart-QF-Kirsten_Flipkens-Monica_Niculescu,2,B-XC,69,7,1,1,5,34,35
20130110-W-Hobart-QF-Kirsten_Flipkens-Monica_Niculescu,2,B-DTM,47,1,0,0,1,24,23
20130110-W-Hobart-QF-Kirsten_Flipkens-Monica_Niculescu,2,B-DTL,30,15,7,3,5,18,12
20130110-W-Hobart-QF-Kirsten_Flipkens-Monica_Niculescu,2,B-IO,18,3,2,0,1,7,11
20130110-W-Hobart-QF-Kirsten_Flipkens-Monica_Niculescu,2,S-XC,9,0,0,0,0,1,8
20130110-W-Hobart-QF-Kirsten_Flipkens-Monica_Niculescu,2,S-DTM,8,0,0,0,0,5,3
20130110-W-Hobart-QF-Kirsten_Flipkens-Monica_Niculescu,2,S-DTL,3,1,0,1,0,2,1
20130110-W-Hobart-QF-Kirsten_Flipkens-Monica_Niculescu,2,S-IO,3,0,0,0,0,1,2
19930911-W-US_Open-F-Steffi_Graf-Helena_Sukova,1,F-XC,14,5,3,2,0,11,3
19930911-W-US_Open-F-Steffi_Graf-Helena_Sukova,1,F-DTM,3,1,0,0,1,1,2
19930911-W-US_Open-F-Steffi_Graf-Helena_Sukova,1,F-DTL,3,2,2,0,0,3,0
19930911-W-US_Open-F-Steffi_Graf-Helena_Sukova,1,F-IO,29,19,11,5,3,19,10
19930911-W-US_Open-F-Steffi_Graf-Helena_Sukova,1,F-II,1,0,0,0,0,1,0
19930911-W-US_Open-F-Steffi_Graf-Helena_Sukova,1,B-XC,7,7,4,1,2,5,2
19930911-W-US_Open-F-Steffi_Graf-Helena_Sukova,1,B-DTM,5,2,0,2,0,4,1
19930911-W-US_Open-F-Steffi_Graf-Helena_Sukova,1,B-DTL,4,3,2,0,1,2,2
19930911-W-US_Open-F-Steffi_Graf-Helena_Sukova,1,B-IO,1,0,0,0,0,0,1
19930911-W-US_Open-F-Steffi_Graf-Helena_Sukova,1,S-XC,11,2,0,0,2,3,8
19930911-W-US_Open-F-Steffi_Graf-Helena_Sukova,1,S-DTM,7,2,0,1,1,2,5
19930911-W-US_Open-F-Steffi_Graf-Helena_Sukova,1,S-DTL,7,3,1,1,1,4,3
19930911-W-US_Open-F-Steffi_Graf-Helena_Sukova,1,S-IO,1,0,0,0,0,1,0
19930911-W-US_Open-F-Steffi_Graf-Helena_Sukova,2,F-XC,1,0,0,0,0,0,1
19930911-W-US_Open-F-Steffi_Graf-Helena_Sukova,2,F-DTM,6,0,0,0,0,3,3
19930911-W-US_Open-F-Steffi_Graf-Helena_Sukova,2,F-DTL,4,2,0,0,2,1,3
19930911-W-US_Open-F-Steffi_Graf-Helena_Sukova,2,F-IO,3,0,0,0,0,2,1
19930911-W-US_Open-F-Steffi_Graf-Helena_Sukova,2,F-II,1,0,0,0,0,0,1
19930911-W-US_Open-F-Steffi_Graf-Helena_Sukova,2,B-XC,2,0,0,0,0,2,0
19930911-W-US_Open-F-Steffi_Graf-Helena_Sukova,2,B-IO,1,1,1,0,0,1,0
19930911-W-US_Open-F-Steffi_Graf-Helena_Sukova,2,S-XC,9,1,0,0,1,6,3
19930911-W-US_Open-F-Steffi_Graf-Helena_Sukova,2,S-DTM,7,1,0,0,1,1,6
19930911-W-US_Open-F-Steffi_Graf-Helena_Sukova,2,S-DTL,2,1,1,0,0,1,1
20131011-W-Linz-QF-Dominika_Cibulkova-Ana_Ivanovic,1,F-XC,35,8,2,2,4,19,16
20131011-W-Linz-QF-Dominika_Cibulkova-Ana_Ivanovic,1,F-DTM,8,0,0,0,0,1,7
20131011-W-Linz-QF-Dominika_Cibulkova-Ana_Ivanovic,1,F-DTL,10,4,0,1,3,3,7
20131011-W-Linz-QF-Dominika_Cibulkova-Ana_Ivanovic,1,F-IO,22,4,1,0,3,10,12
20131011-W-Linz-QF-Dominika_Cibulkova-Ana_Ivanovic,1,F-II,4,1,0,1,0,3,1
20131011-W-Linz-QF-Dominika_Cibulkova-Ana_Ivanovic,1,B-XC,37,6,2,2,2,23,14
20131011-W-Linz-QF-Dominika_Cibulkova-Ana_Ivanovic,1,B-DTM,14,1,0,0,1,9,5
20131011-W-Linz-QF-Dominika_Cibulkova-Ana_Ivanovic,1,B-DTL,4,3,2,0,1,2,2
20131011-W-Linz-QF-Dominika_Cibulkova-Ana_Ivanovic,1,S-XC,3,0,0,0,0,0,3
20131011-W-Linz-QF-Dominika_Cibulkova-Ana_Ivanovic,1,S-DTM,3,0,0,0,0,0,3
20131011-W-Linz-QF-Dominika_Cibulkova-Ana_Ivanovic,1,S-DTL,1,1,0,0,1,0,1
20131011-W-Linz-QF-Dominika_Cibulkova-Ana_Ivanovic,2,F-XC,33,10,2,1,7,18,15
20131011-W-Linz-QF-Dominika_Cibulkova-Ana_Ivanovic,2,F-DTM,16,0,0,0,0,3,13
20131011-W-Linz-QF-Dominika_Cibulkova-Ana_Ivanovic,2,F-DTL,12,4,2,0,2,7,5
20131011-W-Linz-QF-Dominika_Cibulkova-Ana_Ivanovic,2,F-IO,12,6,4,1,1,7,5
20131011-W-Linz-QF-Dominika_Cibulkova-Ana_Ivanovic,2,F-II,4,3,1,1,1,2,2
20131011-W-Linz-QF-Dominika_Cibulkova-Ana_Ivanovic,2,B-XC,31,8,3,1,4,15,16
20131011-W-Linz-QF-Dominika_Cibulkova-Ana_Ivanovic,2,B-DTM,13,2,0,0,2,7,6
20131011-W-Linz-QF-Dominika_Cibulkova-Ana_Ivanovic,2,B-DTL,5,4,1,2,1,3,2
20131011-W-Linz-QF-Dominika_Cibulkova-Ana_Ivanovic,2,S-XC,7,0,0,0,0,3,4
20131011-W-Linz-QF-Dominika_Cibulkova-Ana_Ivanovic,2,S-DTM,6,0,0,0,0,3,3
20131011-W-Linz-QF-Dominika_Cibulkova-Ana_Ivanovic,2,S-DTL,5,0,0,0,0,3,2
20080705-W-Wimbledon-F-Venus_Williams-Serena_Williams,1,F-XC,30,8,3,3,2,19,11
20080705-W-Wimbledon-F-Venus_Williams-Serena_Williams,1,F-DTM,35,7,2,1,4,14,21
20080705-W-Wimbledon-F-Venus_Williams-Serena_Williams,1,F-DTL,12,7,2,2,3,9,3
20080705-W-Wimbledon-F-Venus_Williams-Serena_Williams,1,F-IO,10,3,0,0,3,4,6
20080705-W-Wimbledon-F-Venus_Williams-Serena_Williams,1,B-XC,24,3,1,2,0,14,10
20080705-W-Wimbledon-F-Venus_Williams-Serena_Williams,1,B-DTM,33,3,0,0,3,10,23
20080705-W-Wimbledon-F-Venus_Williams-Serena_Williams,1,B-DTL,10,3,1,2,0,9,1
20080705-W-Wimbledon-F-Venus_Williams-Serena_Williams,1,B-IO,10,5,2,0,3,7,3
20080705-W-Wimbledon-F-Venus_Williams-Serena_Williams,1,S-XC,2,0,0,0,0,2,0
20080705-W-Wimbledon-F-Venus_Williams-Serena_Williams,1,S-DTM,2,1,1,0,0,1,1
20080705-W-Wimbledon-F-Venus_Williams-Serena_Williams,1,S-DTL,1,0,0,0,0,0,1
20080705-W-Wimbledon-F-Venus_Williams-Serena_Williams,1,S-IO,1,0,0,0,0,0,1
20080705-W-Wimbledon-F-Venus_Williams-Serena_Williams,2,F-XC,36,13,5,2,6,14,22
20080705-W-Wimbledon-F-Venus_Williams-Serena_Williams,2,F-DTM,18,2,0,0,2,11,7
20080705-W-Wimbledon-F-Venus_Williams-Serena_Williams,2,F-DTL,8,4,2,0,2,3,5
20080705-W-Wimbledon-F-Venus_Williams-Serena_Williams,2,F-IO,16,3,1,1,1,10,6
20080705-W-Wimbledon-F-Venus_Williams-Serena_Williams,2,B-XC,28,5,1,2,2,12,16
20080705-W-Wimbledon-F-Venus_Williams-Serena_Williams,2,B-DTM,24,3,0,0,3,11,13
20080705-W-Wimbledon-F-Venus_Williams-Serena_Williams,2,B-DTL,14,6,2,1,3,6,8
20080705-W-Wimbledon-F-Venus_Williams-Serena_Williams,2,B-IO,12,3,0,0,3,4,8
20080705-W-Wimbledon-F-Venus_Williams-Serena_Williams,2,S-DTM,2,0,0,0,0,1,1
20080705-W-Wimbledon-F-Venus_Williams-Serena_Williams,2,S-DTL,2,0,0,0,0,0,2
20080705-W-Wimbledon-F-Venus_Williams-Serena_Williams,2,S-IO,1,0,0,0,0,0,1
20120731-W-Olympics-R32-Laura_Robson-Maria_Sharapova,1,F-XC,10,5,0,2,3,3,7
20120731-W-Olympics-R32-Laura_Robson-Maria_Sharapova,1,F-DTM,9,3,0,0,3,3,6
20120731-W-Olympics-R32-Laura_Robson-Maria_Sharapova,1,F-DTL,20,12,4,2,6,9,11
20120731-W-Olympics-R32-Laura_Robson-Maria_Sharapova,1,F-IO,15,5,2,2,1,10,5
20120731-W-Olympics-R32-Laura_Robson-Maria_Sharapova,1,B-XC,19,2,1,0,1,9,10
20120731-W-Olympics-R32-Laura_Robson-Maria_Sharapova,1,B-DTM,13,1,0,0,1,7,6
20120731-W-Olympics-R32-Laura_Robson-Maria_Sharapova,1,B-DTL,7,3,1,0,2,5,2
20120731-W-Olympics-R32-Laura_Robson-Maria_Sharapova,1,S-XC,1,0,0,0,0,0,1
20120731-W-Olympics-R32-Laura_Robson-Maria_Sharapova,1,S-DTM,3,0,0,0,0,1,2
20120731-W-Olympics-R32-Laura_Robson-Maria_Sharapova,2,F-XC,41,14,6,1,7,23,18
20120731-W-Olympics-R32-Laura_Robson-Maria_Sharapova,2,F-DTM,11,2,0,0,2,5,6
20120731-W-Olympics-R32-Laura_Robson-Maria_Sharapova,2,F-DTL,13,6,3,0,3,7,6
20120731-W-Olympics-R32-Laura_Robson-Maria_Sharapova,2,F-IO,12,7,4,1,2,9,3
20120731-W-Olympics-R32-Laura_Robson-Maria_Sharapova,2,B-XC,17,7,2,2,3,10,7
20120731-W-Olympics-R32-Laura_Robson-Maria_Sharapova,2,B-DTM,3,2,0,0,2,0,3
20120731-W-Olympics-R32-Laura_Robson-Maria_Sharapova,2,B-DTL,4,1,1,0,0,3,1
20120731-W-Olympics-R32-Laura_Robson-Maria_Sharapova,2,B-IO,2,1,0,0,1,1,1
19970906-W-US_Open-F-Venus_Williams-Martina_Hingis,1,F-XC,38,5,2,0,3,16,22
19970906-W-US_Open-F-Venus_Williams-Martina_Hingis,1,F-DTM,10,0,0,0,0,3,7
19970906-W-US_Open-F-Venus_Williams-Martina_Hingis,1,F-DTL,6,2,1,1,0,4,2
19970906-W-US_Open-F-Venus_Williams-Martina_Hingis,1,F-IO,12,6,0,2,4,5,7
19970906-W-US_Open-F-Venus_Williams-Martina_Hingis,1,B-XC,28,5,0,0,5,13,15
19970906-W-US_Open-F-Venus_Williams-Martina_Hingis,1,B-DTM,25,4,0,0,4,7,18
19970906-W-US_Open-F-Venus_Williams-Martina_Hingis,1,B-DTL,6,3,1,1,1,3,3
19970906-W-US_Open-F-Venus_Williams-Martina_Hingis,1,B-IO,7,4,1,1,2,4,3
19970906-W-US_Open-F-Venus_Williams-Martina_Hingis,1,S-XC,4,1,1,0,0,3,1
19970906-W-US_Open-F-Venus_Williams-Martina_Hingis,1,S-DTM,1,0,0,0,0,0,1
19970906-W-US_Open-F-Venus_Williams-Martina_Hingis,1,S-IO,1,1,0,0,1,0,1
19970906-W-US_Open-F-Venus_Williams-Martina_Hingis,2,F-XC,23,4,1,0,3,11,12
19970906-W-US_Open-F-Venus_Williams-Martina_Hingis,2,F-DTM,19,1,0,0,1,15,4
19970906-W-US_Open-F-Venus_Williams-Martina_Hingis,2,F-DTL,10,3,0,2,1,5,5
19970906-W-US_Open-F-Venus_Williams-Martina_Hingis,2,F-IO,5,2,0,1,1,3,2
19970906-W-US_Open-F-Venus_Williams-Martina_Hingis,2,F-II,1,1,0,0,1,0,1
19970906-W-US_Open-F-Venus_Williams-Martina_Hingis,2,B-XC,17,1,0,0,1,9,8
19970906-W-US_Open-F-Venus_Williams-Martina_Hingis,2,B-DTM,32,2,0,1,1,17,15
19970906-W-US_Open-F-Venus_Williams-Martina_Hingis,2,B-DTL,6,3,1,1,1,3,3
19970906-W-US_Open-F-Venus_Williams-Martina_Hingis,2,B-IO,11,4,4,0,0,8,3
19970906-W-US_Open-F-Venus_Williams-Martina_Hingis,2,S-XC,1,0,0,0,0,0,1
19970906-W-US_Open-F-Venus_Williams-Martina_Hingis,2,S-DTM,5,0,0,0,0,3,2
19970906-W-US_Open-F-Venus_Williams-Martina_Hingis,2,S-DTL,2,0,0,0,0,0,2
19960907-W-US_Open-F-Monica_Seles-Steffi_Graf,1,F-XC,46,9,2,1,6,20,26
19960907-W-US_Open-F-Monica_Seles-Steffi_Graf,1,F-DTM,14,2,0,0,2,3,11
19960907-W-US_Open-F-Monica_Seles-Steffi_Graf,1,F-DTL,9,3,1,1,1,5,4
19960907-W-US_Open-F-Monica_Seles-Steffi_Graf,1,F-IO,11,6,2,0,4,6,5
19960907-W-US_Open-F-Monica_Seles-Steffi_Graf,1,B-XC,50,11,2,3,6,25,25
19960907-W-US_Open-F-Monica_Seles-Steffi_Graf,1,B-DTM,17,1,0,1,0,11,6
19960907-W-US_Open-F-Monica_Seles-Steffi_Graf,1,B-DTL,14,10,4,4,2,10,4
19960907-W-US_Open-F-Monica_Seles-Steffi_Graf,1,B-IO,10,4,3,0,1,7,3
19960907-W-US_Open-F-Monica_Seles-Steffi_Graf,1,B-II,2,1,0,0,1,0,2
19960907-W-US_Open-F-Monica_Seles-Steffi_Graf,1,S-XC,1,0,0,0,0,0,1
19960907-W-US_Open-F-Monica_Seles-Steffi_Graf,1,S-DTM,3,0,0,0,0,0,3
19960907-W-US_Open-F-Monica_Seles-Steffi_Graf,1,S-DTL,1,0,0,0,0,0,1
19960907-W-US_Open-F-Monica_Seles-Steffi_Graf,2,F-XC,48,11,4,2,5,25,23
19960907-W-US_Open-F-Monica_Seles-Steffi_Graf,2,F-DTM,23,2,0,0,2,12,11
19960907-W-US_Open-F-Monica_Seles-Steffi_Graf,2,F-DTL,9,0,0,0,0,5,4
19960907-W-US_Open-F-Monica_Seles-Steffi_Graf,2,F-IO,23,5,2,2,1,18,5
19960907-W-US_Open-F-Monica_Seles-Steffi_Graf,2,F-II,4,1,1,0,0,1,3
19960907-W-US_Open-F-Monica_Seles-Steffi_Graf,2,B-DTM,1,1,0,1,0,1,0
19960907-W-US_Open-F-Monica_Seles-Steffi_Graf,2,B-DTL,1,0,0,0,0,0,1
19960907-W-US_Open-F-Monica_Seles-Steffi_Graf,2,S-XC,24,5,3,0,2,14,10
19960907-W-US_Open-F-Monica_Seles-Steffi_Graf,2,S-DTM,18,2,0,0,2,7,11
19960907-W-US_Open-F-Monica_Seles-Steffi_Graf,2,S-DTL,12,2,0,1,1,6,6
19960907-W-US_Open-F-Monica_Seles-Steffi_Graf,2,S-IO,3,1,1,0,0,2,1
19920912-W-US_Open-F-Monica_Seles-Arantxa_Sanchez_Vicario,1,F-XC,64,16,8,3,5,34,30
19920912-W-US_Open-F-Monica_Seles-Arantxa_Sanchez_Vicario,1,F-DTM,64,2,0,0,2,34,30
19920912-W-US_Open-F-Monica_Seles-Arantxa_Sanchez_Vicario,1,F-DTL,21,3,0,2,1,12,9
19920912-W-US_Open-F-Monica_Seles-Arantxa_Sanchez_Vicario,1,F-IO,28,7,2,2,3,20,8
19920912-W-US_Open-F-Monica_Seles-Arantxa_Sanchez_Vicario,1,B-XC,64,8,1,2,5,37,27
19920912-W-US_Open-F-Monica_Seles-Arantxa_Sanchez_Vicario,1,B-DTM,36,1,0,0,1,20,16
19920912-W-US_Open-F-Monica_Seles-Arantxa_Sanchez_Vicario,1,B-DTL,6,3,0,1,2,4,2
19920912-W-US_Open-F-Monica_Seles-Arantxa_Sanchez_Vicario,1,B-IO,9,2,1,0,1,6,3
19920912-W-US_Open-F-Monica_Seles-Arantxa_Sanchez_Vicario,1,S-DTM,2,0,0,0,0,0,2
19920912-W-US_Open-F-Monica_Seles-Arantxa_Sanchez_Vicario,2,F-XC,76,15,1,2,12,29,47
19920912-W-US_Open-F-Monica_Seles-Arantxa_Sanchez_Vicario,2,F-DTM,34,2,0,0,2,13,21
19920912-W-US_Open-F-Monica_Seles-Arantxa_Sanchez_Vicario,2,F-DTL,28,8,2,1,5,12,16
19920912-W-US_Open-F-Monica_Seles-Arantxa_Sanchez_Vicario,2,F-IO,17,3,1,0,2,7,10
19920912-W-US_Open-F-Monica_Seles-Arantxa_Sanchez_Vicario,2,F-II,1,0,0,0,0,1,0
19920912-W-US_Open-F-Monica_Seles-Arantxa_Sanchez_Vicario,2,B-XC,39,11,2,4,5,20,19
19920912-W-US_Open-F-Monica_Seles-Arantxa_Sanchez_Vicario,2,B-DTM,37,3,0,2,1,17,20
19920912-W-US_Open-F-Monica_Seles-Arantxa_Sanchez_Vicario,2,B-DTL,15,5,2,0,3,8,7
19920912-W-US_Open-F-Monica_Seles-Arantxa_Sanchez_Vicario,2,B-IO,6,2,1,0,1,4,2
19920912-W-US_Open-F-Monica_Seles-Arantxa_Sanchez_Vicario,2,S-XC,12,1,1,0,0,7,5
19920912-W-US_Open-F-Monica_Seles-Arantxa_Sanchez_Vicario,2,S-DTM,19,0,0,0,0,4,15
19920912-W-US_Open-F-Monica_Seles-Arantxa_Sanchez_Vicario,2,S-DTL,1,0,0,0,0,1,0
19920912-W-US_Open-F-Monica_Seles-Arantxa_Sanchez_Vicario,2,S-IO,1,0,0,0,0,0,1
20160423-W-Stuttgart-QF-Petra_Kvitova-Garbine_Muguruza,1,F-XC,34,13,7,1,5,20,14
20160423-W-Stuttgart-QF-Petra_Kvitova-Garbine_Muguruza,1,F-DTM,28,3,0,1,2,14,14
20160423-W-Stuttgart-QF-Petra_Kvitova-Garbine_Muguruza,1,F-DTL,5,5,1,1,3,2,3
20160423-W-Stuttgart-QF-Petra_Kvitova-Garbine_Muguruza,1,F-IO,16,9,3,2,4,8,8
20160423-W-Stuttgart-QF-Petra_Kvitova-Garbine_Muguruza,1,F-II,1,1,1,0,0,1,0
20160423-W-Stuttgart-QF-Petra_Kvitova-Garbine_Muguruza,1,B-XC,21,7,4,0,3,15,6
20160423-W-Stuttgart-QF-Petra_Kvitova-Garbine_Muguruza,1,B-DTM,17,3,0,0,3,9,8
20160423-W-Stuttgart-QF-Petra_Kvitova-Garbine_Muguruza,1,B-DTL,1,0,0,0,0,1,0
20160423-W-Stuttgart-QF-Petra_Kvitova-Garbine_Muguruza,1,B-IO,4,3,0,0,3,0,4
20160423-W-Stuttgart-QF-Petra_Kvitova-Garbine_Muguruza,1,S-XC,4,2,0,0,2,1,3
20160423-W-Stuttgart-QF-Petra_Kvitova-Garbine_Muguruza,1,S-DTM,1,0,0,0,0,0,1
20160423-W-Stuttgart-QF-Petra_Kvitova-Garbine_Muguruza,1,S-DTL,2,0,0,0,0,0,2
20160423-W-Stuttgart-QF-Petra_Kvitova-Garbine_Muguruza,2,F-XC,22,9,2,0,7,7,15
20160423-W-Stuttgart-QF-Petra_Kvitova-Garbine_Muguruza,2,F-DTM,26,3,0,0,3,14,12
20160423-W-Stuttgart-QF-Petra_Kvitova-Garbine_Muguruza,2,F-DTL,8,3,1,0,2,4,4
20160423-W-Stuttgart-QF-Petra_Kvitova-Garbine_Muguruza,2,F-IO,7,6,3,0,3,3,4
20160423-W-Stuttgart-QF-Petra_Kvitova-Garbine_Muguruza,2,B-XC,17,5,2,2,1,10,7
20160423-W-Stuttgart-QF-Petra_Kvitova-Garbine_Muguruza,2,B-DTM,37,2,0,0,2,13,24
20160423-W-Stuttgart-QF-Petra_Kvitova-Garbine_Muguruza,2,B-DTL,5,3,0,1,2,2,3
20160423-W-Stuttgart-QF-Petra_Kvitova-Garbine_Muguruza,2,B-IO,5,2,0,1,1,2,3
20121027-W-WTA_Championships-SF-Victoria_Azarenka-Maria_Sharapova,1,F-XC,36,7,3,1,3,15,21
20121027-W-WTA_Championships-SF-Victoria_Azarenka-Maria_Sharapova,1,F-DTM,21,1,0,0,1,7,14
20121027-W-WTA_Championships-SF-Victoria_Azarenka-Maria_Sharapova,1,F-DTL,16,7,2,1,4,6,10
20121027-W-WTA_Championships-SF-Victoria_Azarenka-Maria_Sharapova,1,F-IO,9,2,1,1,0,4,5
20121027-W-WTA_Championships-SF-Victoria_Azarenka-Maria_Sharapova,1,B-XC,24,5,1,1,3,10,14
20121027-W-WTA_Championships-SF-Victoria_Azarenka-Maria_Sharapova,1,B-DTM,17,1,0,0,1,6,11
20121027-W-WTA_Championships-SF-Victoria_Azarenka-Maria_Sharapova,1,B-DTL,8,5,2,1,2,4,4
20121027-W-WTA_Championships-SF-Victoria_Azarenka-Maria_Sharapova,1,B-IO,2,1,0,0,1,0,2
20121027-W-WTA_Championships-SF-Victoria_Azarenka-Maria_Sharapova,1,S-XC,6,0,0,0,0,1,5
20121027-W-WTA_Championships-SF-Victoria_Azarenka-Maria_Sharapova,1,S-DTM,1,0,0,0,0,1,0
20121027-W-WTA_Championships-SF-Victoria_Azarenka-Maria_Sharapova,1,S-DTL,2,0,0,0,0,1,1
20121027-W-WTA_Championships-SF-Victoria_Azarenka-Maria_Sharapova,2,F-XC,53,12,4,2,6,33,20
20121027-W-WTA_Championships-SF-Victoria_Azarenka-Maria_Sharapova,2,F-DTM,8,0,0,0,0,4,4
20121027-W-WTA_Championships-SF-Victoria_Azarenka-Maria_Sharapova,2,F-DTL,8,2,1,0,1,5,3
20121027-W-WTA_Championships-SF-Victoria_Azarenka-Maria_Sharapova,2,F-IO,18,7,5,1,1,12,6
20121027-W-WTA_Championships-SF-Victoria_Azarenka-Maria_Sharapova,2,F-II,1,0,0,0,0,0,1
20121027-W-WTA_Championships-SF-Victoria_Azarenka-Maria_Sharapova,2,B-XC,37,8,3,3,2,26,11
20121027-W-WTA_Championships-SF-Victoria_Azarenka-Maria_Sharapova,2,B-DTM,10,3,0,0,3,4,6
20121027-W-WTA_Championships-SF-Victoria_Azarenka-Maria_Sharapova,2,B-DTL,12,5,3,0,2,9,3
20121027-W-WTA_Championships-SF-Victoria_Azarenka-Maria_Sharapova,2,S-XC,2,2,1,0,1,1,1
20121027-W-WTA_Championships-SF-Victoria_Azarenka-Maria_Sharapova,2,S-DTM,1,0,0,0,0,0,1
20160430-W-Prague-F-Samantha_Stosur-Lucie_Safarova,1,F-XC,31,6,2,1,3,15,16
20160430-W-Prague-F-Samantha_Stosur-Lucie_Safarova,1,F-DTM,22,3,0,0,3,9,13
20160430-W-Prague-F-Samantha_Stosur-Lucie_Safarova,1,F-DTL,7,3,1,0,2,1,6
20160430-W-Prague-F-Samantha_Stosur-Lucie_Safarova,1,F-IO,16,6,3,2,1,9,7
20160430-W-Prague-F-Samantha_Stosur-Lucie_Safarova,1,F-II,2,2,1,0,1,1,1
20160430-W-Prague-F-Samantha_Stosur-Lucie_Safarova,1,B-XC,3,2,2,0,0,2,1
20160430-W-Prague-F-Samantha_Stosur-Lucie_Safarova,1,B-DTM,21,0,0,0,0,6,15
20160430-W-Prague-F-Samantha_Stosur-Lucie_Safarova,1,B-DTL,4,2,0,1,1,2,2
20160430-W-Prague-F-Samantha_Stosur-Lucie_Safarova,1,B-IO,7,3,1,1,1,3,4
20160430-W-Prague-F-Samantha_Stosur-Lucie_Safarova,1,S-XC,11,0,0,0,0,4,7
20160430-W-Prague-F-Samantha_Stosur-Lucie_Safarova,1,S-DTM,14,3,0,0,3,4,10
20160430-W-Prague-F-Samantha_Stosur-Lucie_Safarova,1,S-DTL,6,0,0,0,0,3,3
20160430-W-Prague-F-Samantha_Stosur-Lucie_Safarova,2,F-XC,45,18,5,6,7,31,14
20160430-W-Prague-F-Samantha_Stosur-Lucie_Safarova,2,F-DTM,25,2,0,2,0,10,15
20160430-W-Prague-F-Samantha_Stosur-Lucie_Safarova,2,F-DTL,5,3,3,0,0,5,0
20160430-W-Prague-F-Samantha_Stosur-Lucie_Safarova,2,F-IO,9,6,2,3,1,8,1
20160430-W-Prague-F-Samantha_Stosur-Lucie_Safarova,2,F-II,2,1,0,0,1,0,2
20160430-W-Prague-F-Samantha_Stosur-Lucie_Safarova,2,B-XC,23,8,2,5,1,13,10
20160430-W-Prague-F-Samantha_Stosur-Lucie_Safarova,2,B-DTM,27,3,0,0,3,16,11
20160430-W-Prague-F-Samantha_Stosur-Lucie_Safarova,2,B-DTL,12,6,0,3,3,7,5
20160430-W-Prague-F-Samantha_Stosur-Lucie_Safarova,2,B-IO,8,3,0,0,3,5,3
20160430-W-Prague-F-Samantha_Stosur-Lucie_Safarova,2,S-DTM,1,0,0,0,0,0,1
20160430-W-Prague-F-Samantha_Stosur-Lucie_Safarova,2,S-DTL,1,0,0,0,0,0,1
20160430-W-Prague-F-Samantha_Stosur-Lucie_Safarova,2,S-IO,1,0,0,0,0,1,0
19960127-W-Australian_Open-F-Monica_Seles-Anke_Huber,1,F-XC,32,7,4,1,2,23,9
19960127-W-Australian_Open-F-Monica_Seles-Anke_Huber,1,F-DTM,29,1,0,1,0,15,14
19960127-W-Australian_Open-F-Monica_Seles-Anke_Huber,1,F-DTL,20,3,0,0,3,11,9
19960127-W-Australian_Open-F-Monica_Seles-Anke_Huber,1,F-IO,13,5,3,1,1,9,4
19960127-W-Australian_Open-F-Monica_Seles-Anke_Huber,1,B-XC,66,12,3,3,6,43,23
19960127-W-Australian_Open-F-Monica_Seles-Anke_Huber,1,B-DTM,25,3,0,0,3,13,12
19960127-W-Australian_Open-F-Monica_Seles-Anke_Huber,1,B-DTL,4,2,1,0,1,2,2
19960127-W-Australian_Open-F-Monica_Seles-Anke_Huber,1,B-IO,4,1,1,0,0,3,1
19960127-W-Australian_Open-F-Monica_Seles-Anke_Huber,1,S-XC,1,0,0,0,0,1,0
19960127-W-Australian_Open-F-Monica_Seles-Anke_Huber,2,F-XC,66,10,1,2,7,27,39
19960127-W-Australian_Open-F-Monica_Seles-Anke_Huber,2,F-DTM,34,3,0,0,3,11,23
19960127-W-Australian_Open-F-Monica_Seles-Anke_Huber,2,F-DTL,25,15,2,3,10,10,15
19960127-W-Australian_Open-F-Monica_Seles-Anke_Huber,2,F-IO,10,1,1,0,0,4,6
19960127-W-Australian_Open-F-Monica_Seles-Anke_Huber,2,F-II,1,0,0,0,0,0,1
19960127-W-Australian_Open-F-Monica_Seles-Anke_Huber,2,B-XC,36,6,2,2,2,17,19
19960127-W-Australian_Open-F-Monica_Seles-Anke_Huber,2,B-DTM,12,2,0,0,2,4,8
19960127-W-Australian_Open-F-Monica_Seles-Anke_Huber,2,B-DTL,7,5,2,1,2,4,3
19960127-W-Australian_Open-F-Monica_Seles-Anke_Huber,2,B-IO,9,3,2,1,0,7,2
19960127-W-Australian_Open-F-Monica_Seles-Anke_Huber,2,S-XC,4,1,1,0,0,2,2
19960127-W-Australian_Open-F-Monica_Seles-Anke_Huber,2,S-DTM,2,0,0,0,0,0,2
19960127-W-Australian_Open-F-Monica_Seles-Anke_Huber,2,S-DTL,1,0,0,0,0,0,1
19920704-W-Wimbledon-F-Steffi_Graf-Monica_Seles,1,F-XC,51,11,7,1,3,32,19
19920704-W-Wimbledon-F-Steffi_Graf-Monica_Seles,1,F-DTM,12,4,1,1,2,7,5
19920704-W-Wimbledon-F-Steffi_Graf-Monica_Seles,1,F-DTL,7,4,0,1,3,4,3
19920704-W-Wimbledon-F-Steffi_Graf-Monica_Seles,1,F-IO,20,4,1,2,1,12,8
19920704-W-Wimbledon-F-Steffi_Graf-Monica_Seles,1,F-II,3,2,0,1,1,1,2
19920704-W-Wimbledon-F-Steffi_Graf-Monica_Seles,1,B-XC,1,0,0,0,0,0,1
19920704-W-Wimbledon-F-Steffi_Graf-Monica_Seles,1,B-DTL,1,1,1,0,0,1,0
19920704-W-Wimbledon-F-Steffi_Graf-Monica_Seles,1,S-XC,33,4,2,1,1,21,12
19920704-W-Wimbledon-F-Steffi_Graf-Monica_Seles,1,S-DTM,21,3,0,1,2,14,7
19920704-W-Wimbledon-F-Steffi_Graf-Monica_Seles,1,S-DTL,4,1,0,1,0,2,2
19920704-W-Wimbledon-F-Steffi_Graf-Monica_Seles,2,F-XC,48,6,0,1,5,20,28
19920704-W-Wimbledon-F-Steffi_Graf-Monica_Seles,2,F-DTM,19,4,0,1,3,8,11
19920704-W-Wimbledon-F-Steffi_Graf-Monica_Seles,2,F-DTL,23,8,3,3,2,8,15
19920704-W-Wimbledon-F-Steffi_Graf-Monica_Seles,2,F-IO,8,3,0,1,2,3,5
19920704-W-Wimbledon-F-Steffi_Graf-Monica_Seles,2,B-XC,32,9,1,4,4,13,19
19920704-W-Wimbledon-F-Steffi_Graf-Monica_Seles,2,B-DTM,11,1,0,0,1,5,6
19920704-W-Wimbledon-F-Steffi_Graf-Monica_Seles,2,B-DTL,12,6,1,1,4,4,8
19920704-W-Wimbledon-F-Steffi_Graf-Monica_Seles,2,B-IO,6,2,0,1,1,2,4
19920704-W-Wimbledon-F-Steffi_Graf-Monica_Seles,2,S-DTM,4,1,0,1,0,2,2
19920704-W-Wimbledon-F-Steffi_Graf-Monica_Seles,2,S-DTL,2,1,0,0,1,0,2
19830910-W-US_Open-F-Martina_Navratilova-Chris_Evert,1,F-XC,21,1,1,0,0,9,12
19830910-W-US_Open-F-Martina_Navratilova-Chris_Evert,1,F-DTM,6,1,0,0,1,2,4
19830910-W-US_Open-F-Martina_Navratilova-Chris_Evert,1,F-DTL,3,2,1,1,0,2,1
19830910-W-US_Open-F-Martina_Navratilova-Chris_Evert,1,F-IO,2,1,0,0,1,1,1
19830910-W-US_Open-F-Martina_Navratilova-Chris_Evert,1,F-II,1,0,0,0,0,0,1
19830910-W-US_Open-F-Martina_Navratilova-Chris_Evert,1,B-XC,2,2,0,0,2,0,2
19830910-W-US_Open-F-Martina_Navratilova-Chris_Evert,1,B-DTM,2,0,0,0,0,1,1
19830910-W-US_Open-F-Martina_Navratilova-Chris_Evert,1,B-DTL,1,0,0,0,0,0,1
19830910-W-US_Open-F-Martina_Navratilova-Chris_Evert,1,S-XC,18,5,1,1,3,10,8
19830910-W-US_Open-F-Martina_Navratilova-Chris_Evert,1,S-DTM,11,0,0,0,0,4,7
19830910-W-US_Open-F-Martina_Navratilova-Chris_Evert,1,S-DTL,7,1,0,1,0,1,6
19830910-W-US_Open-F-Martina_Navratilova-Chris_Evert,1,S-IO,4,1,0,0,1,1,3
19830910-W-US_Open-F-Martina_Navratilova-Chris_Evert,2,F-XC,25,3,1,0,2,16,9
19830910-W-US_Open-F-Martina_Navratilova-Chris_Evert,2,F-DTM,9,0,0,0,0,3,6
19830910-W-US_Open-F-Martina_Navratilova-Chris_Evert,2,F-DTL,7,4,2,0,2,3,4
19830910-W-US_Open-F-Martina_Navratilova-Chris_Evert,2,F-IO,3,0,0,0,0,2,1
19830910-W-US_Open-F-Martina_Navratilova-Chris_Evert,2,B-XC,35,11,6,0,5,19,16
19830910-W-US_Open-F-Martina_Navratilova-Chris_Evert,2,B-DTM,17,2,0,2,0,12,5
19830910-W-US_Open-F-Martina_Navratilova-Chris_Evert,2,B-DTL,10,3,2,0,1,6,4
19830910-W-US_Open-F-Martina_Navratilova-Chris_Evert,2,B-IO,12,4,2,0,2,7,5
19830910-W-US_Open-F-Martina_Navratilova-Chris_Evert,2,S-XC,2,0,0,0,0,1,1
19830910-W-US_Open-F-Martina_Navratilova-Chris_Evert,2,S-DTM,3,0,0,0,0,1,2
19830910-W-US_Open-F-Martina_Navratilova-Chris_Evert,2,S-DTL,1,0,0,0,0,1,0
19910608-W-Roland_Garros-F-Monica_Seles-Arantxa_Sanchez_Vicario,1,F-XC,136,12,3,5,4,66,70
19910608-W-Roland_Garros-F-Monica_Seles-Arantxa_Sanchez_Vicario,1,F-DTM,52,0,0,0,0,24,28
19910608-W-Roland_Garros-F-Monica_Seles-Arantxa_Sanchez_Vicario,1,F-DTL,22,7,1,2,4,8,14
19910608-W-Roland_Garros-F-Monica_Seles-Arantxa_Sanchez_Vicario,1,F-IO,27,3,1,0,2,14,13
19910608-W-Roland_Garros-F-Monica_Seles-Arantxa_Sanchez_Vicario,1,B-XC,63,7,2,1,4,34,29
19910608-W-Roland_Garros-F-Monica_Seles-Arantxa_Sanchez_Vicario,1,B-DTM,21,2,0,0,2,7,14
19910608-W-Roland_Garros-F-Monica_Seles-Arantxa_Sanchez_Vicario,1,B-DTL,8,3,2,0,1,5,3
19910608-W-Roland_Garros-F-Monica_Seles-Arantxa_Sanchez_Vicario,1,B-IO,10,2,1,0,1,4,6
19910608-W-Roland_Garros-F-Monica_Seles-Arantxa_Sanchez_Vicario,1,S-DTM,2,0,0,0,0,1,1
19910608-W-Roland_Garros-F-Monica_Seles-Arantxa_Sanchez_Vicario,2,F-XC,59,7,2,2,3,31,28
19910608-W-Roland_Garros-F-Monica_Seles-Arantxa_Sanchez_Vicario,2,F-DTM,47,5,1,0,4,23,24
19910608-W-Roland_Garros-F-Monica_Seles-Arantxa_Sanchez_Vicario,2,F-DTL,24,3,0,0,3,12,12
19910608-W-Roland_Garros-F-Monica_Seles-Arantxa_Sanchez_Vicario,2,F-IO,17,3,3,0,0,14,3
19910608-W-Roland_Garros-F-Monica_Seles-Arantxa_Sanchez_Vicario,2,B-XC,105,16,4,2,10,59,46
19910608-W-Roland_Garros-F-Monica_Seles-Arantxa_Sanchez_Vicario,2,B-DTM,32,1,0,0,1,13,19
19910608-W-Roland_Garros-F-Monica_Seles-Arantxa_Sanchez_Vicario,2,B-DTL,15,8,1,1,6,6,9
19910608-W-Roland_Garros-F-Monica_Seles-Arantxa_Sanchez_Vicario,2,B-IO,6,1,0,0,1,2,4
19910608-W-Roland_Garros-F-Monica_Seles-Arantxa_Sanchez_Vicario,2,S-XC,10,1,0,0,1,6,4
19910608-W-Roland_Garros-F-Monica_Seles-Arantxa_Sanchez_Vicario,2,S-DTM,10,0,0,0,0,5,5
19910608-W-Roland_Garros-F-Monica_Seles-Arantxa_Sanchez_Vicario,2,S-DTL,6,2,0,2,0,4,2
19910608-W-Roland_Garros-F-Monica_Seles-Arantxa_Sanchez_Vicario,2,S-IO,1,0,0,0,0,1,0
19910608-W-Roland_Garros-F-Monica_Seles-Arantxa_Sanchez_Vicario,2,S-II,1,0,0,0,0,0,1
19920125-W-Australian_Open-F-Monica_Seles-Mary_Joe_Fernandez,1,F-XC,33,10,6,3,1,23,10
19920125-W-Australian_Open-F-Monica_Seles-Mary_Joe_Fernandez,1,F-DTM,15,2,1,0,1,8,7
19920125-W-Australian_Open-F-Monica_Seles-Mary_Joe_Fernandez,1,F-DTL,6,1,0,0,1,2,4
19920125-W-Australian_Open-F-Monica_Seles-Mary_Joe_Fernandez,1,F-IO,19,6,2,1,3,11,8
19920125-W-Australian_Open-F-Monica_Seles-Mary_Joe_Fernandez,1,B-XC,60,12,7,2,3,38,22
19920125-W-Australian_Open-F-Monica_Seles-Mary_Joe_Fernandez,1,B-DTM,32,2,0,0,2,13,19
19920125-W-Australian_Open-F-Monica_Seles-Mary_Joe_Fernandez,1,B-DTL,11,5,2,1,2,6,5
19920125-W-Australian_Open-F-Monica_Seles-Mary_Joe_Fernandez,1,B-IO,16,3,0,2,1,8,8
19920125-W-Australian_Open-F-Monica_Seles-Mary_Joe_Fernandez,1,B-II,1,1,1,0,0,1,0
19920125-W-Australian_Open-F-Monica_Seles-Mary_Joe_Fernandez,1,S-DTM,2,0,0,0,0,1,1
19920125-W-Australian_Open-F-Monica_Seles-Mary_Joe_Fernandez,1,S-DTL,1,0,0,0,0,0,1
19920125-W-Australian_Open-F-Monica_Seles-Mary_Joe_Fernandez,2,F-XC,35,8,0,0,8,12,23
19920125-W-Australian_Open-F-Monica_Seles-Mary_Joe_Fernandez,2,F-DTM,37,1,0,0,1,19,18
19920125-W-Australian_Open-F-Monica_Seles-Mary_Joe_Fernandez,2,F-DTL,11,5,1,1,3,3,8
19920125-W-Australian_Open-F-Monica_Seles-Mary_Joe_Fernandez,2,F-IO,23,13,3,4,6,9,14
19920125-W-Australian_Open-F-Monica_Seles-Mary_Joe_Fernandez,2,B-XC,10,2,1,0,1,7,3
19920125-W-Australian_Open-F-Monica_Seles-Mary_Joe_Fernandez,2,B-DTM,37,1,0,0,1,16,21
19920125-W-Australian_Open-F-Monica_Seles-Mary_Joe_Fernandez,2,B-DTL,10,2,0,0,2,4,6
19920125-W-Australian_Open-F-Monica_Seles-Mary_Joe_Fernandez,2,B-IO,8,0,0,0,0,3,5
19920125-W-Australian_Open-F-Monica_Seles-Mary_Joe_Fernandez,2,S-XC,2,0,0,0,0,0,2
19920125-W-Australian_Open-F-Monica_Seles-Mary_Joe_Fernandez,2,S-DTM,6,0,0,0,0,1,5
19920125-W-Australian_Open-F-Monica_Seles-Mary_Joe_Fernandez,2,S-DTL,3,1,0,1,0,3,0
19920125-W-Australian_Open-F-Monica_Seles-Mary_Joe_Fernandez,2,S-II,1,1,0,0,1,0,1
19810703-W-Wimbledon-F-Hana_Mandlikova-Chris_Evert,1,F-XC,41,9,2,3,4,13,28
19810703-W-Wimbledon-F-Hana_Mandlikova-Chris_Evert,1,F-DTM,11,1,0,0,1,6,5
19810703-W-Wimbledon-F-Hana_Mandlikova-Chris_Evert,1,F-DTL,3,2,0,0,2,0,3
19810703-W-Wimbledon-F-Hana_Mandlikova-Chris_Evert,1,F-IO,7,3,1,0,2,4,3
19810703-W-Wimbledon-F-Hana_Mandlikova-Chris_Evert,1,B-XC,20,5,2,1,2,5,15
19810703-W-Wimbledon-F-Hana_Mandlikova-Chris_Evert,1,B-DTM,10,2,1,0,1,7,3
19810703-W-Wimbledon-F-Hana_Mandlikova-Chris_Evert,1,B-DTL,6,5,1,0,4,2,4
19810703-W-Wimbledon-F-Hana_Mandlikova-Chris_Evert,1,B-IO,5,2,0,0,2,1,4
19810703-W-Wimbledon-F-Hana_Mandlikova-Chris_Evert,1,S-XC,21,5,1,1,3,8,13
19810703-W-Wimbledon-F-Hana_Mandlikova-Chris_Evert,1,S-DTM,19,1,0,0,1,7,12
19810703-W-Wimbledon-F-Hana_Mandlikova-Chris_Evert,1,S-DTL,10,1,0,1,0,3,7
19810703-W-Wimbledon-F-Hana_Mandlikova-Chris_Evert,1,S-IO,4,1,0,0,1,2,2
19810703-W-Wimbledon-F-Hana_Mandlikova-Chris_Evert,2,F-XC,25,5,2,1,2,19,6
19810703-W-Wimbledon-F-Hana_Mandlikova-Chris_Evert,2,F-DTM,22,0,0,0,0,14,8
19810703-W-Wimbledon-F-Hana_Mandlikova-Chris_Evert,2,F-DTL,6,2,0,0,2,1,5
19810703-W-Wimbledon-F-Hana_Mandlikova-Chris_Evert,2,F-IO,14,3,2,0,1,9,5
19810703-W-Wimbledon-F-Hana_Mandlikova-Chris_Evert,2,B-XC,48,7,4,2,1,31,17
19810703-W-Wimbledon-F-Hana_Mandlikova-Chris_Evert,2,B-DTM,12,1,0,0,1,7,5
19810703-W-Wimbledon-F-Hana_Mandlikova-Chris_Evert,2,B-DTL,3,2,0,2,0,3,0
19810703-W-Wimbledon-F-Hana_Mandlikova-Chris_Evert,2,B-IO,3,0,0,0,0,1,2
19810703-W-Wimbledon-F-Hana_Mandlikova-Chris_Evert,2,S-XC,1,0,0,0,0,0,1
19810703-W-Wimbledon-F-Hana_Mandlikova-Chris_Evert,2,S-DTM,2,0,0,0,0,1,1
20030906-W-US_Open-F-Kim_Clijsters-Justine_Henin,1,F-XC,60,13,1,4,8,24,36
20030906-W-US_Open-F-Kim_Clijsters-Justine_Henin,1,F-DTM,29,3,0,0,3,14,15
20030906-W-US_Open-F-Kim_Clijsters-Justine_Henin,1,F-DTL,10,7,3,0,3,4,6
20030906-W-US_Open-F-Kim_Clijsters-Justine_Henin,1,F-IO,25,8,3,1,4,11,14
20030906-W-US_Open-F-Kim_Clijsters-Justine_Henin,1,B-XC,51,3,1,0,2,25,26
20030906-W-US_Open-F-Kim_Clijsters-Justine_Henin,1,B-DTM,31,3,0,0,3,15,16
20030906-W-US_Open-F-Kim_Clijsters-Justine_Henin,1,B-DTL,9,3,0,0,3,3,6
20030906-W-US_Open-F-Kim_Clijsters-Justine_Henin,1,B-IO,15,3,0,1,2,6,9
20030906-W-US_Open-F-Kim_Clijsters-Justine_Henin,1,S-DTM,6,0,0,0,0,3,3
20030906-W-US_Open-F-Kim_Clijsters-Justine_Henin,1,S-DTL,1,1,0,0,1,0,1
20030906-W-US_Open-F-Kim_Clijsters-Justine_Henin,2,F-XC,42,7,2,1,4,26,16
20030906-W-US_Open-F-Kim_Clijsters-Justine_Henin,2,F-DTM,47,0,0,0,0,22,25
20030906-W-US_Open-F-Kim_Clijsters-Justine_Henin,2,F-DTL,10,2,1,1,0,7,3
20030906-W-US_Open-F-Kim_Clijsters-Justine_Henin,2,F-IO,21,7,2,0,5,9,12
20030906-W-US_Open-F-Kim_Clijsters-Justine_Henin,2,B-XC,24,6,1,1,4,12,12
20030906-W-US_Open-F-Kim_Clijsters-Justine_Henin,2,B-DTM,40,3,1,1,1,21,19
20030906-W-US_Open-F-Kim_Clijsters-Justine_Henin,2,B-DTL,6,3,1,0,2,4,2
20030906-W-US_Open-F-Kim_Clijsters-Justine_Henin,2,B-IO,10,2,1,0,1,4,6
20030906-W-US_Open-F-Kim_Clijsters-Justine_Henin,2,S-XC,12,1,0,1,0,8,4
20030906-W-US_Open-F-Kim_Clijsters-Justine_Henin,2,S-DTM,22,1,0,0,1,12,10
20021110-W-WTA_Tour_Championships-QF-Monica_Seles-Venus_Williams,1,F-XC,24,8,4,2,2,14,10
20021110-W-WTA_Tour_Championships-QF-Monica_Seles-Venus_Williams,1,F-DTM,13,1,0,1,0,8,5
20021110-W-WTA_Tour_Championships-QF-Monica_Seles-Venus_Williams,1,F-DTL,11,4,0,0,4,1,10
20021110-W-WTA_Tour_Championships-QF-Monica_Seles-Venus_Williams,1,F-IO,10,7,4,1,2,7,3
20021110-W-WTA_Tour_Championships-QF-Monica_Seles-Venus_Williams,1,B-XC,30,5,0,2,3,17,13
20021110-W-WTA_Tour_Championships-QF-Monica_Seles-Venus_Williams,1,B-DTM,11,1,0,0,1,5,6
20021110-W-WTA_Tour_Championships-QF-Monica_Seles-Venus_Williams,1,B-DTL,9,3,2,1,0,5,4
20021110-W-WTA_Tour_Championships-QF-Monica_Seles-Venus_Williams,1,B-IO,8,1,0,0,1,2,6
20021110-W-WTA_Tour_Championships-QF-Monica_Seles-Venus_Williams,1,S-XC,1,0,0,0,0,1,0
20021110-W-WTA_Tour_Championships-QF-Monica_Seles-Venus_Williams,1,S-DTM,4,0,0,0,0,0,4
20021110-W-WTA_Tour_Championships-QF-Monica_Seles-Venus_Williams,2,F-XC,38,19,4,2,13,15,23
20021110-W-WTA_Tour_Championships-QF-Monica_Seles-Venus_Williams,2,F-DTM,15,1,0,0,1,6,9
20021110-W-WTA_Tour_Championships-QF-Monica_Seles-Venus_Williams,2,F-DTL,15,12,6,1,5,7,8
20021110-W-WTA_Tour_Championships-QF-Monica_Seles-Venus_Williams,2,F-IO,12,8,2,4,2,8,4
20021110-W-WTA_Tour_Championships-QF-Monica_Seles-Venus_Williams,2,B-XC,29,12,7,0,5,15,14
20021110-W-WTA_Tour_Championships-QF-Monica_Seles-Venus_Williams,2,B-DTM,18,2,0,1,1,9,9
20021110-W-WTA_Tour_Championships-QF-Monica_Seles-Venus_Williams,2,B-DTL,5,4,3,0,1,4,1
20021110-W-WTA_Tour_Championships-QF-Monica_Seles-Venus_Williams,2,B-IO,9,3,0,1,2,5,4
20021110-W-WTA_Tour_Championships-QF-Monica_Seles-Venus_Williams,2,S-XC,1,1,0,0,1,0,1
20021110-W-WTA_Tour_Championships-QF-Monica_Seles-Venus_Williams,2,S-DTM,1,0,0,0,0,0,1
20021110-W-WTA_Tour_Championships-QF-Monica_Seles-Venus_Williams,2,S-IO,1,0,0,0,0,1,0
20120728-W-Olympics-R64-Ana_Ivanovic-Christina_Mchale,1,F-XC,33,12,1,5,6,19,14
20120728-W-Olympics-R64-Ana_Ivanovic-Christina_Mchale,1,F-DTM,9,0,0,0,0,6,3
20120728-W-Olympics-R64-Ana_Ivanovic-Christina_Mchale,1,F-DTL,12,8,5,1,2,8,4
20120728-W-Olympics-R64-Ana_Ivanovic-Christina_Mchale,1,F-IO,20,6,3,1,2,10,10
20120728-W-Olympics-R64-Ana_Ivanovic-Christina_Mchale,1,F-II,7,1,0,0,1,5,2
20120728-W-Olympics-R64-Ana_Ivanovic-Christina_Mchale,1,B-XC,23,6,2,0,4,11,12
20120728-W-Olympics-R64-Ana_Ivanovic-Christina_Mchale,1,B-DTM,13,1,0,0,1,4,9
20120728-W-Olympics-R64-Ana_Ivanovic-Christina_Mchale,1,B-DTL,17,4,1,0,3,8,9
20120728-W-Olympics-R64-Ana_Ivanovic-Christina_Mchale,1,B-IO,1,0,0,0,0,1,0
20120728-W-Olympics-R64-Ana_Ivanovic-Christina_Mchale,1,S-XC,1,0,0,0,0,0,1
20120728-W-Olympics-R64-Ana_Ivanovic-Christina_Mchale,1,S-DTM,6,0,0,0,0,1,5
20120728-W-Olympics-R64-Ana_Ivanovic-Christina_Mchale,1,S-DTL,7,1,0,0,1,2,5
20120728-W-Olympics-R64-Ana_Ivanovic-Christina_Mchale,2,F-XC,38,13,4,5,4,20,18
20120728-W-Olympics-R64-Ana_Ivanovic-Christina_Mchale,2,F-DTM,5,1,0,0,1,0,5
20120728-W-Olympics-R64-Ana_Ivanovic-Christina_Mchale,2,F-DTL,27,9,1,0,8,13,14
20120728-W-Olympics-R64-Ana_Ivanovic-Christina_Mchale,2,F-IO,30,14,4,4,6,17,13
20120728-W-Olympics-R64-Ana_Ivanovic-Christina_Mchale,2,F-II,1,1,0,0,1,0,1
20120728-W-Olympics-R64-Ana_Ivanovic-Christina_Mchale,2,B-XC,30,4,0,1,3,17,13
20120728-W-Olympics-R64-Ana_Ivanovic-Christina_Mchale,2,B-DTM,8,2,0,0,2,1,7
20120728-W-Olympics-R64-Ana_Ivanovic-Christina_Mchale,2,B-DTL,3,3,2,1,0,3,0
20120728-W-Olympics-R64-Ana_Ivanovic-Christina_Mchale,2,B-IO,1,0,0,0,0,1,0
20120728-W-Olympics-R64-Ana_Ivanovic-Christina_Mchale,2,S-XC,9,1,0,1,0,6,3
20120728-W-Olympics-R64-Ana_Ivanovic-Christina_Mchale,2,S-DTM,6,0,0,0,0,3,3
20120728-W-Olympics-R64-Ana_Ivanovic-Christina_Mchale,2,S-DTL,1,0,0,0,0,0,1
19841208-W-Australian_Open-F-Helena_Sukova-Chris_Evert,1,F-XC,13,1,0,0,1,2,11
19841208-W-Australian_Open-F-Helena_Sukova-Chris_Evert,1,F-DTM,26,4,0,0,4,5,21
19841208-W-Australian_Open-F-Helena_Sukova-Chris_Evert,1,F-DTL,6,4,0,0,4,1,5
19841208-W-Australian_Open-F-Helena_Sukova-Chris_Evert,1,F-IO,6,1,1,0,0,3,3
19841208-W-Australian_Open-F-Helena_Sukova-Chris_Evert,1,B-XC,6,3,1,1,1,4,2
19841208-W-Australian_Open-F-Helena_Sukova-Chris_Evert,1,B-DTM,4,0,0,0,0,2,2
19841208-W-Australian_Open-F-Helena_Sukova-Chris_Evert,1,B-DTL,2,1,0,0,1,0,2
19841208-W-Australian_Open-F-Helena_Sukova-Chris_Evert,1,S-XC,13,2,2,0,0,3,10
19841208-W-Australian_Open-F-Helena_Sukova-Chris_Evert,1,S-DTM,23,3,0,0,3,5,18
19841208-W-Australian_Open-F-Helena_Sukova-Chris_Evert,1,S-DTL,11,2,0,1,1,3,8
19841208-W-Australian_Open-F-Helena_Sukova-Chris_Evert,1,S-IO,2,0,0,0,0,0,2
19841208-W-Australian_Open-F-Helena_Sukova-Chris_Evert,2,F-XC,53,18,6,6,6,32,21
19841208-W-Australian_Open-F-Helena_Sukova-Chris_Evert,2,F-DTM,16,1,1,0,0,9,7
19841208-W-Australian_Open-F-Helena_Sukova-Chris_Evert,2,F-DTL,8,2,2,0,0,8,0
19841208-W-Australian_Open-F-Helena_Sukova-Chris_Evert,2,F-IO,15,3,1,1,1,11,4
19841208-W-Australian_Open-F-Helena_Sukova-Chris_Evert,2,B-XC,51,12,7,1,4,36,15
19841208-W-Australian_Open-F-Helena_Sukova-Chris_Evert,2,B-DTM,20,0,0,0,0,14,6
19841208-W-Australian_Open-F-Helena_Sukova-Chris_Evert,2,B-DTL,9,7,4,0,3,4,5
19841208-W-Australian_Open-F-Helena_Sukova-Chris_Evert,2,B-IO,11,2,0,1,1,6,5
19841208-W-Australian_Open-F-Helena_Sukova-Chris_Evert,2,S-XC,1,0,0,0,0,0,1
19841208-W-Australian_Open-F-Helena_Sukova-Chris_Evert,2,S-DTM,2,0,0,0,0,0,2
19841208-W-Australian_Open-F-Helena_Sukova-Chris_Evert,2,S-DTL,1,0,0,0,0,0,1
19870704-W-Wimbledon-F-Martina_Navratilova-Steffi_Graf,1,F-XC,8,1,0,0,1,3,5
19870704-W-Wimbledon-F-Martina_Navratilova-Steffi_Graf,1,F-DTM,4,0,0,0,0,0,4
19870704-W-Wimbledon-F-Martina_Navratilova-Steffi_Graf,1,F-DTL,3,3,0,1,2,1,2
19870704-W-Wimbledon-F-Martina_Navratilova-Steffi_Graf,1,B-XC,2,0,0,0,0,0,2
19870704-W-Wimbledon-F-Martina_Navratilova-Steffi_Graf,1,B-DTM,2,0,0,0,0,0,2
19870704-W-Wimbledon-F-Martina_Navratilova-Steffi_Graf,1,B-DTL,2,2,1,0,1,1,1
19870704-W-Wimbledon-F-Martina_Navratilova-Steffi_Graf,1,S-XC,4,0,0,0,0,2,2
19870704-W-Wimbledon-F-Martina_Navratilova-Steffi_Graf,1,S-DTM,10,2,0,0,2,4,6
19870704-W-Wimbledon-F-Martina_Navratilova-Steffi_Graf,1,S-DTL,2,1,0,1,0,2,0
19870704-W-Wimbledon-F-Martina_Navratilova-Steffi_Graf,1,S-IO,2,0,0,0,0,0,2
19870704-W-Wimbledon-F-Martina_Navratilova-Steffi_Graf,2,F-XC,22,5,3,0,2,12,10
19870704-W-Wimbledon-F-Martina_Navratilova-Steffi_Graf,2,F-DTM,3,1,0,0,1,1,2
19870704-W-Wimbledon-F-Martina_Navratilova-Steffi_Graf,2,F-DTL,6,3,1,1,1,3,3
19870704-W-Wimbledon-F-Martina_Navratilova-Steffi_Graf,2,F-IO,8,3,0,2,1,5,3
19870704-W-Wimbledon-F-Martina_Navratilova-Steffi_Graf,2,F-II,4,2,1,0,1,3,1
19870704-W-Wimbledon-F-Martina_Navratilova-Steffi_Graf,2,B-XC,3,1,1,0,0,2,1
19870704-W-Wimbledon-F-Martina_Navratilova-Steffi_Graf,2,B-DTM,6,1,0,0,1,2,4
19870704-W-Wimbledon-F-Martina_Navratilova-Steffi_Graf,2,B-DTL,4,4,1,0,3,1,3
19870704-W-Wimbledon-F-Martina_Navratilova-Steffi_Graf,2,B-IO,3,2,1,0,1,1,2
19870704-W-Wimbledon-F-Martina_Navratilova-Steffi_Graf,2,S-XC,11,2,1,0,1,8,3
19870704-W-Wimbledon-F-Martina_Navratilova-Steffi_Graf,2,S-DTM,5,1,0,0,1,3,2
19870704-W-Wimbledon-F-Martina_Navratilova-Steffi_Graf,2,S-DTL,2,1,0,0,1,0,2
19870704-W-Wimbledon-F-Martina_Navratilova-Steffi_Graf,2,S-IO,3,0,0,0,0,2,1
19870124-W-Australian_Open-F-Hana_Mandlikova-Martina_Navratilova,1,F-XC,2,2,1,0,1,1,1
19870124-W-Australian_Open-F-Hana_Mandlikova-Martina_Navratilova,1,F-DTM,4,0,0,0,0,0,4
19870124-W-Australian_Open-F-Hana_Mandlikova-Martina_Navratilova,1,F-DTL,3,1,0,1,0,1,2
19870124-W-Australian_Open-F-Hana_Mandlikova-Martina_Navratilova,1,F-IO,3,3,3,0,0,3,0
19870124-W-Australian_Open-F-Hana_Mandlikova-Martina_Navratilova,1,B-XC,9,4,2,1,1,3,6
19870124-W-Australian_Open-F-Hana_Mandlikova-Martina_Navratilova,1,B-DTM,4,0,0,0,0,1,3
19870124-W-Australian_Open-F-Hana_Mandlikova-Martina_Navratilova,1,B-DTL,2,2,0,1,1,1,1
19870124-W-Australian_Open-F-Hana_Mandlikova-Martina_Navratilova,1,B-IO,1,1,0,1,0,1,0
19870124-W-Australian_Open-F-Hana_Mandlikova-Martina_Navratilova,1,S-XC,1,1,1,0,0,1,0
19870124-W-Australian_Open-F-Hana_Mandlikova-Martina_Navratilova,1,S-DTM,4,2,0,0,2,1,3
19870124-W-Australian_Open-F-Hana_Mandlikova-Martina_Navratilova,1,S-DTL,1,0,0,0,0,1,0
19870124-W-Australian_Open-F-Hana_Mandlikova-Martina_Navratilova,2,F-XC,7,4,4,0,0,6,1
19870124-W-Australian_Open-F-Hana_Mandlikova-Martina_Navratilova,2,F-DTL,1,1,1,0,0,1,0
19870124-W-Australian_Open-F-Hana_Mandlikova-Martina_Navratilova,2,F-IO,1,0,0,0,0,0,1
19870124-W-Australian_Open-F-Hana_Mandlikova-Martina_Navratilova,2,B-XC,6,4,2,1,1,4,2
19870124-W-Australian_Open-F-Hana_Mandlikova-Martina_Navratilova,2,B-IO,1,1,0,0,1,0,1
19870124-W-Australian_Open-F-Hana_Mandlikova-Martina_Navratilova,2,S-DTM,1,0,0,0,0,1,0
19960608-W-Roland_Garros-F-Steffi_Graf-Arantxa_Sanchez_Vicario,1,F-XC,110,33,10,7,16,64,46
19960608-W-Roland_Garros-F-Steffi_Graf-Arantxa_Sanchez_Vicario,1,F-DTM,26,5,0,0,5,10,16
19960608-W-Roland_Garros-F-Steffi_Graf-Arantxa_Sanchez_Vicario,1,F-DTL,19,10,5,2,3,8,11
19960608-W-Roland_Garros-F-Steffi_Graf-Arantxa_Sanchez_Vicario,1,F-IO,85,19,2,9,8,51,34
19960608-W-Roland_Garros-F-Steffi_Graf-Arantxa_Sanchez_Vicario,1,F-II,26,6,3,0,3,16,10
19960608-W-Roland_Garros-F-Steffi_Graf-Arantxa_Sanchez_Vicario,1,B-XC,3,0,0,0,0,2,1
19960608-W-Roland_Garros-F-Steffi_Graf-Arantxa_Sanchez_Vicario,1,B-DTM,2,0,0,0,0,0,2
19960608-W-Roland_Garros-F-Steffi_Graf-Arantxa_Sanchez_Vicario,1,B-DTL,3,0,0,0,0,1,2
19960608-W-Roland_Garros-F-Steffi_Graf-Arantxa_Sanchez_Vicario,1,S-XC,138,15,1,4,9,67,71
19960608-W-Roland_Garros-F-Steffi_Graf-Arantxa_Sanchez_Vicario,1,S-DTM,58,5,0,0,5,20,38
19960608-W-Roland_Garros-F-Steffi_Graf-Arantxa_Sanchez_Vicario,1,S-DTL,43,7,1,0,6,19,24
19960608-W-Roland_Garros-F-Steffi_Graf-Arantxa_Sanchez_Vicario,1,S-IO,10,1,0,0,1,5,5
19960608-W-Roland_Garros-F-Steffi_Graf-Arantxa_Sanchez_Vicario,2,F-XC,60,12,4,2,6,32,28
19960608-W-Roland_Garros-F-Steffi_Graf-Arantxa_Sanchez_Vicario,2,F-DTM,69,1,0,1,0,34,35
19960608-W-Roland_Garros-F-Steffi_Graf-Arantxa_Sanchez_Vicario,2,F-DTL,42,11,3,0,8,19,23
19960608-W-Roland_Garros-F-Steffi_Graf-Arantxa_Sanchez_Vicario,2,F-IO,25,2,0,2,0,15,10
19960608-W-Roland_Garros-F-Steffi_Graf-Arantxa_Sanchez_Vicario,2,F-II,1,1,0,0,1,0,1
19960608-W-Roland_Garros-F-Steffi_Graf-Arantxa_Sanchez_Vicario,2,B-XC,153,17,3,2,12,77,76
19960608-W-Roland_Garros-F-Steffi_Graf-Arantxa_Sanchez_Vicario,2,B-DTM,43,1,0,0,1,22,21
19960608-W-Roland_Garros-F-Steffi_Graf-Arantxa_Sanchez_Vicario,2,B-DTL,23,10,6,1,3,12,11
19960608-W-Roland_Garros-F-Steffi_Graf-Arantxa_Sanchez_Vicario,2,B-IO,2,0,0,0,0,0,2
19960608-W-Roland_Garros-F-Steffi_Graf-Arantxa_Sanchez_Vicario,2,S-XC,30,2,0,0,2,18,12
19960608-W-Roland_Garros-F-Steffi_Graf-Arantxa_Sanchez_Vicario,2,S-DTM,10,0,0,0,0,5,5
19960608-W-Roland_Garros-F-Steffi_Graf-Arantxa_Sanchez_Vicario,2,S-DTL,12,2,0,1,1,7,5
19960608-W-Roland_Garros-F-Steffi_Graf-Arantxa_Sanchez_Vicario,2,S-IO,5,2,1,1,0,3,2
20120803-W-Olympics-SF-Maria_Sharapova-Maria_Kirilenko,1,F-XC,33,10,6,1,3,25,8
20120803-W-Olympics-SF-Maria_Sharapova-Maria_Kirilenko,1,F-DTM,8,2,0,0,2,3,5
20120803-W-Olympics-SF-Maria_Sharapova-Maria_Kirilenko,1,F-DTL,11,7,5,0,2,7,4
20120803-W-Olympics-SF-Maria_Sharapova-Maria_Kirilenko,1,F-IO,18,8,6,0,2,11,7
20120803-W-Olympics-SF-Maria_Sharapova-Maria_Kirilenko,1,B-XC,29,13,3,5,5,19,10
20120803-W-Olympics-SF-Maria_Sharapova-Maria_Kirilenko,1,B-DTM,8,0,0,0,0,5,3
20120803-W-Olympics-SF-Maria_Sharapova-Maria_Kirilenko,1,B-DTL,12,3,1,0,2,4,8
20120803-W-Olympics-SF-Maria_Sharapova-Maria_Kirilenko,1,B-IO,7,2,2,0,0,6,1
20120803-W-Olympics-SF-Maria_Sharapova-Maria_Kirilenko,1,S-XC,1,1,0,0,1,0,1
20120803-W-Olympics-SF-Maria_Sharapova-Maria_Kirilenko,1,S-DTL,1,1,0,0,1,0,1
20120803-W-Olympics-SF-Maria_Sharapova-Maria_Kirilenko,2,F-XC,24,0,0,0,0,9,15
20120803-W-Olympics-SF-Maria_Sharapova-Maria_Kirilenko,2,F-DTM,15,0,0,0,0,6,9
20120803-W-Olympics-SF-Maria_Sharapova-Maria_Kirilenko,2,F-DTL,13,4,1,0,3,5,8
20120803-W-Olympics-SF-Maria_Sharapova-Maria_Kirilenko,2,F-IO,3,1,0,0,1,0,3
20120803-W-Olympics-SF-Maria_Sharapova-Maria_Kirilenko,2,B-XC,20,6,0,3,3,11,9
20120803-W-Olympics-SF-Maria_Sharapova-Maria_Kirilenko,2,B-DTM,12,2,0,0,2,4,8
20120803-W-Olympics-SF-Maria_Sharapova-Maria_Kirilenko,2,B-DTL,2,1,0,0,1,0,2
20120803-W-Olympics-SF-Maria_Sharapova-Maria_Kirilenko,2,B-IO,2,0,0,0,0,0,2
20120803-W-Olympics-SF-Maria_Sharapova-Maria_Kirilenko,2,S-XC,4,0,0,0,0,3,1
20120803-W-Olympics-SF-Maria_Sharapova-Maria_Kirilenko,2,S-DTM,8,0,0,0,0,2,6
20120803-W-Olympics-SF-Maria_Sharapova-Maria_Kirilenko,2,S-DTL,1,0,0,0,0,0,1
20120803-W-Olympics-SF-Maria_Sharapova-Maria_Kirilenko,2,S-IO,1,0,0,0,0,0,1
20160111-W-Hobart-R32-Denisa_Allertova-Alize_Cornet,1,F-XC,28,9,3,2,4,16,12
20160111-W-Hobart-R32-Denisa_Allertova-Alize_Cornet,1,F-DTM,34,5,0,1,4,14,20
20160111-W-Hobart-R32-Denisa_Allertova-Alize_Cornet,1,F-DTL,4,2,1,1,0,2,2
20160111-W-Hobart-R32-Denisa_Allertova-Alize_Cornet,1,F-IO,14,8,1,3,4,7,7
20160111-W-Hobart-R32-Denisa_Allertova-Alize_Cornet,1,F-II,1,0,0,0,0,1,0
20160111-W-Hobart-R32-Denisa_Allertova-Alize_Cornet,1,B-XC,44,10,0,4,6,20,24
20160111-W-Hobart-R32-Denisa_Allertova-Alize_Cornet,1,B-DTM,42,6,0,0,6,11,31
20160111-W-Hobart-R32-Denisa_Allertova-Alize_Cornet,1,B-DTL,8,4,0,0,4,1,7
20160111-W-Hobart-R32-Denisa_Allertova-Alize_Cornet,1,B-IO,5,3,1,1,1,4,1
20160111-W-Hobart-R32-Denisa_Allertova-Alize_Cornet,1,S-DTM,3,1,0,0,1,0,3
20160111-W-Hobart-R32-Denisa_Allertova-Alize_Cornet,2,F-XC,18,6,2,3,1,9,9
20160111-W-Hobart-R32-Denisa_Allertova-Alize_Cornet,2,F-DTM,35,1,0,0,1,21,14
20160111-W-Hobart-R32-Denisa_Allertova-Alize_Cornet,2,F-DTL,10,3,2,0,1,5,5
20160111-W-Hobart-R32-Denisa_Allertova-Alize_Cornet,2,F-IO,20,7,3,0,4,12,8
20160111-W-Hobart-R32-Denisa_Allertova-Alize_Cornet,2,B-XC,25,1,1,0,0,16,9
20160111-W-Hobart-R32-Denisa_Allertova-Alize_Cornet,2,B-DTM,44,2,0,1,1,27,17
20160111-W-Hobart-R32-Denisa_Allertova-Alize_Cornet,2,B-DTL,5,3,3,0,0,4,1
20160111-W-Hobart-R32-Denisa_Allertova-Alize_Cornet,2,B-IO,8,3,1,0,2,3,5
20160111-W-Hobart-R32-Denisa_Allertova-Alize_Cornet,2,S-XC,2,0,0,0,0,1,1
20160111-W-Hobart-R32-Denisa_Allertova-Alize_Cornet,2,S-DTM,3,0,0,0,0,1,2
20160111-W-Hobart-R32-Denisa_Allertova-Alize_Cornet,2,S-IO,1,0,0,0,0,0,1
20100128-W-Australian_Open-SF-Na_Li-Serena_Williams,1,F-XC,40,11,3,4,4,22,18
20100128-W-Australian_Open-SF-Na_Li-Serena_Williams,1,F-DTM,19,2,0,0,2,4,15
20100128-W-Australian_Open-SF-Na_Li-Serena_Williams,1,F-DTL,19,10,4,1,5,9,10
20100128-W-Australian_Open-SF-Na_Li-Serena_Williams,1,F-IO,12,6,3,1,2,7,5
20100128-W-Australian_Open-SF-Na_Li-Serena_Williams,1,F-II,1,1,1,0,0,1,0
20100128-W-Australian_Open-SF-Na_Li-Serena_Williams,1,B-XC,51,14,3,5,6,30,21
20100128-W-Australian_Open-SF-Na_Li-Serena_Williams,1,B-DTM,17,2,0,0,2,7,10
20100128-W-Australian_Open-SF-Na_Li-Serena_Williams,1,B-DTL,21,14,3,6,5,13,8
20100128-W-Australian_Open-SF-Na_Li-Serena_Williams,1,B-IO,11,5,2,1,2,7,4
20100128-W-Australian_Open-SF-Na_Li-Serena_Williams,1,B-II,1,0,0,0,0,0,1
20100128-W-Australian_Open-SF-Na_Li-Serena_Williams,1,S-XC,1,0,0,0,0,0,1
20100128-W-Australian_Open-SF-Na_Li-Serena_Williams,1,S-DTM,3,0,0,0,0,2,1
20100128-W-Australian_Open-SF-Na_Li-Serena_Williams,1,S-DTL,2,0,0,0,0,0,2
20100128-W-Australian_Open-SF-Na_Li-Serena_Williams,2,F-XC,43,10,0,4,6,25,18
20100128-W-Australian_Open-SF-Na_Li-Serena_Williams,2,F-DTM,14,1,0,0,1,5,9
20100128-W-Australian_Open-SF-Na_Li-Serena_Williams,2,F-DTL,21,7,3,1,3,9,12
20100128-W-Australian_Open-SF-Na_Li-Serena_Williams,2,F-IO,10,5,2,2,1,7,3
20100128-W-Australian_Open-SF-Na_Li-Serena_Williams,2,B-XC,41,6,2,3,1,23,18
20100128-W-Australian_Open-SF-Na_Li-Serena_Williams,2,B-DTM,24,2,0,0,2,12,12
20100128-W-Australian_Open-SF-Na_Li-Serena_Williams,2,B-DTL,12,8,2,2,4,5,7
20100128-W-Australian_Open-SF-Na_Li-Serena_Williams,2,B-IO,9,3,3,0,0,7,2
20100128-W-Australian_Open-SF-Na_Li-Serena_Williams,2,S-XC,3,1,0,0,1,0,3
20100128-W-Australian_Open-SF-Na_Li-Serena_Williams,2,S-DTM,3,0,0,0,0,3,0
20110127-W-Australian_Open-SF-Caroline_Wozniacki-Na_Li,1,F-XC,118,14,4,1,9,57,61
20110127-W-Australian_Open-SF-Caroline_Wozniacki-Na_Li,1,F-DTM,47,5,0,0,5,19,28
20110127-W-Australian_Open-SF-Caroline_Wozniacki-Na_Li,1,F-DTL,46,6,2,1,3,24,22
20110127-W-Australian_Open-SF-Caroline_Wozniacki-Na_Li,1,F-IO,15,1,0,1,0,9,6
20110127-W-Australian_Open-SF-Caroline_Wozniacki-Na_Li,1,B-XC,60,4,0,2,2,28,32
20110127-W-Australian_Open-SF-Caroline_Wozniacki-Na_Li,1,B-DTM,57,1,0,0,1,27,30
20110127-W-Australian_Open-SF-Caroline_Wozniacki-Na_Li,1,B-DTL,18,5,1,2,2,10,8
20110127-W-Australian_Open-SF-Caroline_Wozniacki-Na_Li,1,B-IO,15,4,1,0,3,5,10
20110127-W-Australian_Open-SF-Caroline_Wozniacki-Na_Li,1,S-XC,4,0,0,0,0,2,2
20110127-W-Australian_Open-SF-Caroline_Wozniacki-Na_Li,1,S-DTM,7,0,0,0,0,2,5
20110127-W-Australian_Open-SF-Caroline_Wozniacki-Na_Li,1,S-DTL,1,0,0,0,0,0,1
20110127-W-Australian_Open-SF-Caroline_Wozniacki-Na_Li,2,F-XC,131,24,7,5,12,76,55
20110127-W-Australian_Open-SF-Caroline_Wozniacki-Na_Li,2,F-DTM,22,0,0,0,0,11,11
20110127-W-Australian_Open-SF-Caroline_Wozniacki-Na_Li,2,F-DTL,40,13,5,1,7,20,20
20110127-W-Australian_Open-SF-Caroline_Wozniacki-Na_Li,2,F-IO,16,2,1,1,0,11,5
20110127-W-Australian_Open-SF-Caroline_Wozniacki-Na_Li,2,B-XC,84,21,4,3,14,38,46
20110127-W-Australian_Open-SF-Caroline_Wozniacki-Na_Li,2,B-DTM,49,5,1,1,3,23,26
20110127-W-Australian_Open-SF-Caroline_Wozniacki-Na_Li,2,B-DTL,42,8,3,3,2,25,17
20110127-W-Australian_Open-SF-Caroline_Wozniacki-Na_Li,2,B-IO,25,8,4,0,4,10,15
20110127-W-Australian_Open-SF-Caroline_Wozniacki-Na_Li,2,S-XC,1,0,0,0,0,0,1
20110127-W-Australian_Open-SF-Caroline_Wozniacki-Na_Li,2,S-DTM,2,0,0,0,0,1,1
20100122-W-Australian_Open-R32-Nadia_Petrova-Kim_Clijsters,1,F-XC,8,1,1,0,0,7,1
20100122-W-Australian_Open-R32-Nadia_Petrova-Kim_Clijsters,1,F-DTM,4,1,0,0,1,3,1
20100122-W-Australian_Open-R32-Nadia_Petrova-Kim_Clijsters,1,F-DTL,18,5,2,1,2,14,4
20100122-W-Australian_Open-R32-Nadia_Petrova-Kim_Clijsters,1,F-IO,18,3,1,1,1,12,6
20100122-W-Australian_Open-R32-Nadia_Petrova-Kim_Clijsters,1,B-XC,30,2,1,0,1,21,9
20100122-W-Australian_Open-R32-Nadia_Petrova-Kim_Clijsters,1,B-DTM,20,5,0,0,5,6,14
20100122-W-Australian_Open-R32-Nadia_Petrova-Kim_Clijsters,1,B-DTL,8,1,1,0,0,7,1
20100122-W-Australian_Open-R32-Nadia_Petrova-Kim_Clijsters,1,B-IO,2,0,0,0,0,2,0
20100122-W-Australian_Open-R32-Nadia_Petrova-Kim_Clijsters,1,S-XC,2,0,0,0,0,2,0
20100122-W-Australian_Open-R32-Nadia_Petrova-Kim_Clijsters,1,S-DTM,1,0,0,0,0,1,0
20100122-W-Australian_Open-R32-Nadia_Petrova-Kim_Clijsters,2,F-XC,18,3,0,2,1,5,13
20100122-W-Australian_Open-R32-Nadia_Petrova-Kim_Clijsters,2,F-DTM,5,0,0,0,0,0,5
20100122-W-Australian_Open-R32-Nadia_Petrova-Kim_Clijsters,2,F-DTL,1,1,1,0,0,1,0
20100122-W-Australian_Open-R32-Nadia_Petrova-Kim_Clijsters,2,F-IO,5,5,0,1,4,1,4
20100122-W-Australian_Open-R32-Nadia_Petrova-Kim_Clijsters,2,B-XC,53,10,0,1,9,17,36
20100122-W-Australian_Open-R32-Nadia_Petrova-Kim_Clijsters,2,B-DTM,8,1,0,0,1,3,5
20100122-W-Australian_Open-R32-Nadia_Petrova-Kim_Clijsters,2,B-DTL,8,4,1,1,2,3,5
20100122-W-Australian_Open-R32-Nadia_Petrova-Kim_Clijsters,2,B-IO,3,1,0,0,1,1,2
20100122-W-Australian_Open-R32-Nadia_Petrova-Kim_Clijsters,2,S-XC,6,0,0,0,0,2,4
20100122-W-Australian_Open-R32-Nadia_Petrova-Kim_Clijsters,2,S-DTM,3,1,0,0,1,0,3
20100122-W-Australian_Open-R32-Nadia_Petrova-Kim_Clijsters,2,S-DTL,2,0,0,0,0,0,2
20080120-W-Australian_Open-R16-Caroline_Wozniacki-Ana_Ivanovic,1,F-XC,30,7,2,1,4,14,16
20080120-W-Australian_Open-R16-Caroline_Wozniacki-Ana_Ivanovic,1,F-DTM,23,1,0,0,1,12,11
20080120-W-Australian_Open-R16-Caroline_Wozniacki-Ana_Ivanovic,1,F-DTL,18,3,1,0,2,7,11
20080120-W-Australian_Open-R16-Caroline_Wozniacki-Ana_Ivanovic,1,F-IO,15,2,1,1,0,8,7
20080120-W-Australian_Open-R16-Caroline_Wozniacki-Ana_Ivanovic,1,B-XC,46,2,0,0,2,14,32
20080120-W-Australian_Open-R16-Caroline_Wozniacki-Ana_Ivanovic,1,B-DTM,29,2,0,0,2,9,20
20080120-W-Australian_Open-R16-Caroline_Wozniacki-Ana_Ivanovic,1,B-DTL,10,7,2,2,3,6,4
20080120-W-Australian_Open-R16-Caroline_Wozniacki-Ana_Ivanovic,1,B-IO,11,5,3,0,2,4,7
20080120-W-Australian_Open-R16-Caroline_Wozniacki-Ana_Ivanovic,1,S-XC,8,1,0,0,1,1,7
20080120-W-Australian_Open-R16-Caroline_Wozniacki-Ana_Ivanovic,1,S-DTM,2,1,0,0,1,1,1
20080120-W-Australian_Open-R16-Caroline_Wozniacki-Ana_Ivanovic,1,S-DTL,2,0,0,0,0,1,1
20080120-W-Australian_Open-R16-Caroline_Wozniacki-Ana_Ivanovic,2,F-XC,33,6,0,0,6,15,18
20080120-W-Australian_Open-R16-Caroline_Wozniacki-Ana_Ivanovic,2,F-DTM,14,0,0,0,0,8,6
20080120-W-Australian_Open-R16-Caroline_Wozniacki-Ana_Ivanovic,2,F-DTL,21,8,3,1,4,14,7
20080120-W-Australian_Open-R16-Caroline_Wozniacki-Ana_Ivanovic,2,F-IO,23,7,2,3,2,14,9
20080120-W-Australian_Open-R16-Caroline_Wozniacki-Ana_Ivanovic,2,F-II,7,1,0,0,1,5,2
20080120-W-Australian_Open-R16-Caroline_Wozniacki-Ana_Ivanovic,2,B-XC,30,5,2,0,3,20,10
20080120-W-Australian_Open-R16-Caroline_Wozniacki-Ana_Ivanovic,2,B-DTM,22,3,1,0,2,16,6
20080120-W-Australian_Open-R16-Caroline_Wozniacki-Ana_Ivanovic,2,B-DTL,20,7,3,1,3,12,8
20080120-W-Australian_Open-R16-Caroline_Wozniacki-Ana_Ivanovic,2,B-IO,7,1,0,1,0,2,5
20080120-W-Australian_Open-R16-Caroline_Wozniacki-Ana_Ivanovic,2,S-XC,7,1,0,1,0,5,2
20080120-W-Australian_Open-R16-Caroline_Wozniacki-Ana_Ivanovic,2,S-DTM,3,0,0,0,0,2,1
19940128-W-Australian_Open-F-Steffi_Graf-Arantxa_Sanchez_Vicario,1,F-XC,38,13,6,3,4,26,12
19940128-W-Australian_Open-F-Steffi_Graf-Arantxa_Sanchez_Vicario,1,F-DTM,4,1,0,0,1,2,2
19940128-W-Australian_Open-F-Steffi_Graf-Arantxa_Sanchez_Vicario,1,F-DTL,9,5,3,2,0,7,2
19940128-W-Australian_Open-F-Steffi_Graf-Arantxa_Sanchez_Vicario,1,F-IO,23,8,1,4,3,15,8
19940128-W-Australian_Open-F-Steffi_Graf-Arantxa_Sanchez_Vicario,1,F-II,10,1,1,0,0,6,4
19940128-W-Australian_Open-F-Steffi_Graf-Arantxa_Sanchez_Vicario,1,B-XC,3,0,0,0,0,1,2
19940128-W-Australian_Open-F-Steffi_Graf-Arantxa_Sanchez_Vicario,1,B-DTM,4,1,0,1,0,4,0
19940128-W-Australian_Open-F-Steffi_Graf-Arantxa_Sanchez_Vicario,1,B-DTL,2,2,1,0,1,1,1
19940128-W-Australian_Open-F-Steffi_Graf-Arantxa_Sanchez_Vicario,1,S-XC,34,3,0,0,3,22,12
19940128-W-Australian_Open-F-Steffi_Graf-Arantxa_Sanchez_Vicario,1,S-DTM,12,2,0,0,2,8,4
19940128-W-Australian_Open-F-Steffi_Graf-Arantxa_Sanchez_Vicario,1,S-DTL,14,1,0,1,0,10,4
19940128-W-Australian_Open-F-Steffi_Graf-Arantxa_Sanchez_Vicario,1,S-IO,4,0,0,0,0,3,1
19940128-W-Australian_Open-F-Steffi_Graf-Arantxa_Sanchez_Vicario,2,F-XC,21,7,0,3,4,5,16
19940128-W-Australian_Open-F-Steffi_Graf-Arantxa_Sanchez_Vicario,2,F-DTM,27,1,1,0,0,9,18
19940128-W-Australian_Open-F-Steffi_Graf-Arantxa_Sanchez_Vicario,2,F-DTL,16,4,0,0,4,4,12
19940128-W-Australian_Open-F-Steffi_Graf-Arantxa_Sanchez_Vicario,2,F-IO,7,2,1,1,0,3,4
19940128-W-Australian_Open-F-Steffi_Graf-Arantxa_Sanchez_Vicario,2,B-XC,43,3,0,2,1,14,29
19940128-W-Australian_Open-F-Steffi_Graf-Arantxa_Sanchez_Vicario,2,B-DTM,9,2,0,0,2,2,7
19940128-W-Australian_Open-F-Steffi_Graf-Arantxa_Sanchez_Vicario,2,B-DTL,7,2,0,0,2,2,5
19940128-W-Australian_Open-F-Steffi_Graf-Arantxa_Sanchez_Vicario,2,B-IO,1,1,0,0,1,0,1
19940128-W-Australian_Open-F-Steffi_Graf-Arantxa_Sanchez_Vicario,2,S-XC,10,0,0,0,0,5,5
19940128-W-Australian_Open-F-Steffi_Graf-Arantxa_Sanchez_Vicario,2,S-DTM,4,0,0,0,0,0,4
19940128-W-Australian_Open-F-Steffi_Graf-Arantxa_Sanchez_Vicario,2,S-DTL,7,1,1,0,0,4,3
19980604-W-Roland_Garros-F-Monica_Seles-Arantxa_Sanchez_Vicario,1,F-XC,95,21,8,1,12,44,51
19980604-W-Roland_Garros-F-Monica_Seles-Arantxa_Sanchez_Vicario,1,F-DTM,21,0,0,0,0,14,7
19980604-W-Roland_Garros-F-Monica_Seles-Arantxa_Sanchez_Vicario,1,F-DTL,58,11,2,3,6,29,29
19980604-W-Roland_Garros-F-Monica_Seles-Arantxa_Sanchez_Vicario,1,F-IO,17,2,2,0,0,10,7
19980604-W-Roland_Garros-F-Monica_Seles-Arantxa_Sanchez_Vicario,1,F-II,1,1,1,0,0,1,0
19980604-W-Roland_Garros-F-Monica_Seles-Arantxa_Sanchez_Vicario,1,B-XC,68,12,2,3,7,34,34
19980604-W-Roland_Garros-F-Monica_Seles-Arantxa_Sanchez_Vicario,1,B-DTM,16,0,0,0,0,6,10
19980604-W-Roland_Garros-F-Monica_Seles-Arantxa_Sanchez_Vicario,1,B-DTL,34,15,9,0,6,17,17
19980604-W-Roland_Garros-F-Monica_Seles-Arantxa_Sanchez_Vicario,1,B-IO,9,6,4,1,1,6,3
19980604-W-Roland_Garros-F-Monica_Seles-Arantxa_Sanchez_Vicario,1,B-II,1,1,0,1,0,1,0
19980604-W-Roland_Garros-F-Monica_Seles-Arantxa_Sanchez_Vicario,1,S-XC,1,0,0,0,0,0,1
19980604-W-Roland_Garros-F-Monica_Seles-Arantxa_Sanchez_Vicario,2,F-XC,57,11,4,1,6,26,31
19980604-W-Roland_Garros-F-Monica_Seles-Arantxa_Sanchez_Vicario,2,F-DTM,26,1,0,0,1,10,16
19980604-W-Roland_Garros-F-Monica_Seles-Arantxa_Sanchez_Vicario,2,F-DTL,39,7,2,2,3,17,22
19980604-W-Roland_Garros-F-Monica_Seles-Arantxa_Sanchez_Vicario,2,F-IO,19,2,0,0,2,10,9
19980604-W-Roland_Garros-F-Monica_Seles-Arantxa_Sanchez_Vicario,2,B-XC,61,16,9,2,5,39,22
19980604-W-Roland_Garros-F-Monica_Seles-Arantxa_Sanchez_Vicario,2,B-DTM,13,1,0,0,1,8,5
19980604-W-Roland_Garros-F-Monica_Seles-Arantxa_Sanchez_Vicario,2,B-DTL,11,1,1,0,0,9,2
19980604-W-Roland_Garros-F-Monica_Seles-Arantxa_Sanchez_Vicario,2,B-IO,2,1,0,0,1,1,1
19980604-W-Roland_Garros-F-Monica_Seles-Arantxa_Sanchez_Vicario,2,S-XC,37,1,1,0,0,17,20
19980604-W-Roland_Garros-F-Monica_Seles-Arantxa_Sanchez_Vicario,2,S-DTM,14,0,0,0,0,8,6
19980604-W-Roland_Garros-F-Monica_Seles-Arantxa_Sanchez_Vicario,2,S-DTL,11,0,0,0,0,4,7
19980604-W-Roland_Garros-F-Monica_Seles-Arantxa_Sanchez_Vicario,2,S-IO,1,1,0,0,1,0,1
19880403-W-Tampa-F-Arantxa_Sanchez_Vicario-Chris_Evert,1,F-XC,132,13,2,3,8,70,62
19880403-W-Tampa-F-Arantxa_Sanchez_Vicario-Chris_Evert,1,F-DTM,43,4,0,0,4,12,31
19880403-W-Tampa-F-Arantxa_Sanchez_Vicario-Chris_Evert,1,F-DTL,23,6,0,0,6,9,14
19880403-W-Tampa-F-Arantxa_Sanchez_Vicario-Chris_Evert,1,F-IO,8,1,0,0,1,4,4
19880403-W-Tampa-F-Arantxa_Sanchez_Vicario-Chris_Evert,1,B-XC,138,4,0,0,4,63,75
19880403-W-Tampa-F-Arantxa_Sanchez_Vicario-Chris_Evert,1,B-DTM,51,3,0,0,3,17,34
19880403-W-Tampa-F-Arantxa_Sanchez_Vicario-Chris_Evert,1,B-DTL,15,4,1,0,3,4,11
19880403-W-Tampa-F-Arantxa_Sanchez_Vicario-Chris_Evert,1,B-IO,4,1,0,0,1,1,3
19880403-W-Tampa-F-Arantxa_Sanchez_Vicario-Chris_Evert,1,S-XC,13,2,0,0,2,5,8
19880403-W-Tampa-F-Arantxa_Sanchez_Vicario-Chris_Evert,1,S-DTM,11,0,0,0,0,5,6
19880403-W-Tampa-F-Arantxa_Sanchez_Vicario-Chris_Evert,1,S-DTL,3,2,1,0,1,2,1
19880403-W-Tampa-F-Arantxa_Sanchez_Vicario-Chris_Evert,2,F-XC,107,14,2,3,9,57,50
19880403-W-Tampa-F-Arantxa_Sanchez_Vicario-Chris_Evert,2,F-DTM,31,4,0,0,4,11,20
19880403-W-Tampa-F-Arantxa_Sanchez_Vicario-Chris_Evert,2,F-DTL,38,2,0,1,1,20,18
19880403-W-Tampa-F-Arantxa_Sanchez_Vicario-Chris_Evert,2,F-IO,44,4,2,0,2,30,14
19880403-W-Tampa-F-Arantxa_Sanchez_Vicario-Chris_Evert,2,F-II,3,1,1,0,0,3,0
19880403-W-Tampa-F-Arantxa_Sanchez_Vicario-Chris_Evert,2,B-XC,113,9,0,1,8,66,47
19880403-W-Tampa-F-Arantxa_Sanchez_Vicario-Chris_Evert,2,B-DTM,41,4,0,0,4,19,22
19880403-W-Tampa-F-Arantxa_Sanchez_Vicario-Chris_Evert,2,B-DTL,36,5,0,1,4,18,18
19880403-W-Tampa-F-Arantxa_Sanchez_Vicario-Chris_Evert,2,B-IO,19,1,0,1,0,12,7
19880403-W-Tampa-F-Arantxa_Sanchez_Vicario-Chris_Evert,2,S-XC,6,3,0,1,2,3,3
19880403-W-Tampa-F-Arantxa_Sanchez_Vicario-Chris_Evert,2,S-DTM,4,0,0,0,0,1,3
19880403-W-Tampa-F-Arantxa_Sanchez_Vicario-Chris_Evert,2,S-DTL,1,0,0,0,0,0,1
20120728-W-Olympics-R64-Vera_Zvonareva-Sofia_Arvidsson,1,F-XC,38,13,7,1,5,24,14
20120728-W-Olympics-R64-Vera_Zvonareva-Sofia_Arvidsson,1,F-DTM,5,1,0,0,1,1,4
20120728-W-Olympics-R64-Vera_Zvonareva-Sofia_Arvidsson,1,F-DTL,21,10,3,3,4,11,10
20120728-W-Olympics-R64-Vera_Zvonareva-Sofia_Arvidsson,1,F-IO,9,4,2,1,1,8,1
20120728-W-Olympics-R64-Vera_Zvonareva-Sofia_Arvidsson,1,B-XC,25,8,2,5,1,16,9
20120728-W-Olympics-R64-Vera_Zvonareva-Sofia_Arvidsson,1,B-DTM,4,1,0,0,1,2,2
20120728-W-Olympics-R64-Vera_Zvonareva-Sofia_Arvidsson,1,B-DTL,19,9,4,1,4,8,11
20120728-W-Olympics-R64-Vera_Zvonareva-Sofia_Arvidsson,1,B-IO,11,1,0,0,1,7,4
20120728-W-Olympics-R64-Vera_Zvonareva-Sofia_Arvidsson,1,S-XC,1,0,0,0,0,0,1
20120728-W-Olympics-R64-Vera_Zvonareva-Sofia_Arvidsson,1,S-DTM,1,0,0,0,0,1,0
20120728-W-Olympics-R64-Vera_Zvonareva-Sofia_Arvidsson,1,S-DTL,3,0,0,0,0,0,3
20120728-W-Olympics-R64-Vera_Zvonareva-Sofia_Arvidsson,2,F-XC,48,13,6,5,2,26,22
20120728-W-Olympics-R64-Vera_Zvonareva-Sofia_Arvidsson,2,F-DTM,7,3,0,0,3,4,3
20120728-W-Olympics-R64-Vera_Zvonareva-Sofia_Arvidsson,2,F-DTL,18,8,5,1,2,8,10
20120728-W-Olympics-R64-Vera_Zvonareva-Sofia_Arvidsson,2,F-IO,9,5,2,0,3,5,4
20120728-W-Olympics-R64-Vera_Zvonareva-Sofia_Arvidsson,2,F-II,1,0,0,0,0,1,0
20120728-W-Olympics-R64-Vera_Zvonareva-Sofia_Arvidsson,2,B-XC,17,1,1,0,0,13,4
20120728-W-Olympics-R64-Vera_Zvonareva-Sofia_Arvidsson,2,B-DTM,15,2,0,0,2,5,10
20120728-W-Olympics-R64-Vera_Zvonareva-Sofia_Arvidsson,2,B-DTL,13,5,1,1,3,6,7
20120728-W-Olympics-R64-Vera_Zvonareva-Sofia_Arvidsson,2,B-IO,5,2,0,0,2,2,3
20120728-W-Olympics-R64-Vera_Zvonareva-Sofia_Arvidsson,2,S-XC,4,0,0,0,0,0,4
20030607-W-Roland_Garros-F-Kim_Clijsters-Justine_Henin,1,F-XC,36,10,1,2,7,21,15
20030607-W-Roland_Garros-F-Kim_Clijsters-Justine_Henin,1,F-DTM,14,1,0,0,1,9,5
20030607-W-Roland_Garros-F-Kim_Clijsters-Justine_Henin,1,F-DTL,10,4,1,1,2,5,5
20030607-W-Roland_Garros-F-Kim_Clijsters-Justine_Henin,1,F-IO,25,9,2,0,7,11,14
20030607-W-Roland_Garros-F-Kim_Clijsters-Justine_Henin,1,B-XC,43,5,0,1,4,15,28
20030607-W-Roland_Garros-F-Kim_Clijsters-Justine_Henin,1,B-DTM,19,4,0,0,4,9,10
20030607-W-Roland_Garros-F-Kim_Clijsters-Justine_Henin,1,B-DTL,5,2,2,0,0,5,0
20030607-W-Roland_Garros-F-Kim_Clijsters-Justine_Henin,1,B-IO,3,0,0,0,0,0,3
20030607-W-Roland_Garros-F-Kim_Clijsters-Justine_Henin,1,S-XC,1,0,0,0,0,0,1
20030607-W-Roland_Garros-F-Kim_Clijsters-Justine_Henin,1,S-DTM,3,0,0,0,0,0,3
20030607-W-Roland_Garros-F-Kim_Clijsters-Justine_Henin,1,S-DTL,1,0,0,0,0,0,1
20030607-W-Roland_Garros-F-Kim_Clijsters-Justine_Henin,2,F-XC,29,5,2,1,2,16,13
20030607-W-Roland_Garros-F-Kim_Clijsters-Justine_Henin,2,F-DTM,27,3,0,0,3,11,16
20030607-W-Roland_Garros-F-Kim_Clijsters-Justine_Henin,2,F-DTL,9,1,0,0,1,4,5
20030607-W-Roland_Garros-F-Kim_Clijsters-Justine_Henin,2,F-IO,12,5,3,1,1,9,3
20030607-W-Roland_Garros-F-Kim_Clijsters-Justine_Henin,2,F-II,1,1,0,1,0,1,0
20030607-W-Roland_Garros-F-Kim_Clijsters-Justine_Henin,2,B-XC,21,9,2,4,3,15,6
20030607-W-Roland_Garros-F-Kim_Clijsters-Justine_Henin,2,B-DTM,29,3,0,0,3,13,16
20030607-W-Roland_Garros-F-Kim_Clijsters-Justine_Henin,2,B-DTL,5,1,1,0,0,4,1
20030607-W-Roland_Garros-F-Kim_Clijsters-Justine_Henin,2,B-IO,3,1,0,0,1,0,3
20030607-W-Roland_Garros-F-Kim_Clijsters-Justine_Henin,2,S-XC,8,1,0,0,1,3,5
20030607-W-Roland_Garros-F-Kim_Clijsters-Justine_Henin,2,S-DTM,18,2,0,0,2,9,9
20030607-W-Roland_Garros-F-Kim_Clijsters-Justine_Henin,2,S-DTL,2,0,0,0,0,2,0
20030607-W-Roland_Garros-F-Kim_Clijsters-Justine_Henin,2,S-IO,1,0,0,0,0,0,1
20120116-W-Australian_Open-R128-Na_Li-Ksenia_Pervak,1,F-XC,68,17,8,3,6,43,25
20120116-W-Australian_Open-R128-Na_Li-Ksenia_Pervak,1,F-DTM,24,2,0,0,2,14,10
20120116-W-Australian_Open-R128-Na_Li-Ksenia_Pervak,1,F-DTL,15,7,1,1,5,6,9
20120116-W-Australian_Open-R128-Na_Li-Ksenia_Pervak,1,F-IO,15,4,0,2,2,8,7
20120116-W-Australian_Open-R128-Na_Li-Ksenia_Pervak,1,B-XC,20,5,1,3,1,12,8
20120116-W-Australian_Open-R128-Na_Li-Ksenia_Pervak,1,B-DTM,8,2,0,0,2,3,5
20120116-W-Australian_Open-R128-Na_Li-Ksenia_Pervak,1,B-DTL,9,2,1,0,1,5,4
20120116-W-Australian_Open-R128-Na_Li-Ksenia_Pervak,1,B-IO,3,2,1,1,0,2,1
20120116-W-Australian_Open-R128-Na_Li-Ksenia_Pervak,2,F-XC,27,5,1,1,3,13,14
20120116-W-Australian_Open-R128-Na_Li-Ksenia_Pervak,2,F-DTM,16,1,0,0,1,8,8
20120116-W-Australian_Open-R128-Na_Li-Ksenia_Pervak,2,F-DTL,16,5,0,1,4,6,10
20120116-W-Australian_Open-R128-Na_Li-Ksenia_Pervak,2,F-IO,7,3,2,1,0,5,2
20120116-W-Australian_Open-R128-Na_Li-Ksenia_Pervak,2,B-XC,54,6,1,1,4,23,31
20120116-W-Australian_Open-R128-Na_Li-Ksenia_Pervak,2,B-DTM,29,2,0,0,2,12,17
20120116-W-Australian_Open-R128-Na_Li-Ksenia_Pervak,2,B-DTL,6,4,1,0,3,1,5
20120116-W-Australian_Open-R128-Na_Li-Ksenia_Pervak,2,B-IO,2,1,0,0,1,0,2
20120116-W-Australian_Open-R128-Na_Li-Ksenia_Pervak,2,S-XC,2,0,0,0,0,0,2
19950128-W-Australian_Open-F-Mary_Pierce-Arantxa_Sanchez_Vicario,1,F-XC,54,5,3,2,0,30,24
19950128-W-Australian_Open-F-Mary_Pierce-Arantxa_Sanchez_Vicario,1,F-DTM,33,1,0,0,1,18,15
19950128-W-Australian_Open-F-Mary_Pierce-Arantxa_Sanchez_Vicario,1,F-DTL,20,7,4,0,3,6,14
19950128-W-Australian_Open-F-Mary_Pierce-Arantxa_Sanchez_Vicario,1,F-IO,11,6,2,0,4,6,5
19950128-W-Australian_Open-F-Mary_Pierce-Arantxa_Sanchez_Vicario,1,F-II,2,0,0,0,0,1,1
19950128-W-Australian_Open-F-Mary_Pierce-Arantxa_Sanchez_Vicario,1,B-XC,31,7,2,4,1,24,7
19950128-W-Australian_Open-F-Mary_Pierce-Arantxa_Sanchez_Vicario,1,B-DTM,33,1,0,0,1,14,19
19950128-W-Australian_Open-F-Mary_Pierce-Arantxa_Sanchez_Vicario,1,B-DTL,25,7,1,1,5,10,15
19950128-W-Australian_Open-F-Mary_Pierce-Arantxa_Sanchez_Vicario,1,B-IO,22,8,3,1,4,14,8
19950128-W-Australian_Open-F-Mary_Pierce-Arantxa_Sanchez_Vicario,2,F-XC,72,15,4,2,9,38,34
19950128-W-Australian_Open-F-Mary_Pierce-Arantxa_Sanchez_Vicario,2,F-DTM,53,7,0,0,7,16,37
19950128-W-Australian_Open-F-Mary_Pierce-Arantxa_Sanchez_Vicario,2,F-DTL,15,1,0,0,1,7,8
19950128-W-Australian_Open-F-Mary_Pierce-Arantxa_Sanchez_Vicario,2,F-IO,15,1,0,0,1,9,6
19950128-W-Australian_Open-F-Mary_Pierce-Arantxa_Sanchez_Vicario,2,B-XC,27,7,3,0,4,13,14
19950128-W-Australian_Open-F-Mary_Pierce-Arantxa_Sanchez_Vicario,2,B-DTM,27,2,0,1,1,12,15
19950128-W-Australian_Open-F-Mary_Pierce-Arantxa_Sanchez_Vicario,2,B-DTL,3,1,0,0,1,2,1
19950128-W-Australian_Open-F-Mary_Pierce-Arantxa_Sanchez_Vicario,2,B-IO,1,1,1,0,0,1,0
19950128-W-Australian_Open-F-Mary_Pierce-Arantxa_Sanchez_Vicario,2,B-II,1,0,0,0,0,0,1
19950128-W-Australian_Open-F-Mary_Pierce-Arantxa_Sanchez_Vicario,2,S-XC,10,1,1,0,0,6,4
19950128-W-Australian_Open-F-Mary_Pierce-Arantxa_Sanchez_Vicario,2,S-DTM,5,0,0,0,0,2,3
19950128-W-Australian_Open-F-Mary_Pierce-Arantxa_Sanchez_Vicario,2,S-DTL,1,0,0,0,0,0,1
20020329-W-Miami-SF-Jennifer_Capriati-Monica_Seles,1,F-XC,70,9,4,3,2,39,31
20020329-W-Miami-SF-Jennifer_Capriati-Monica_Seles,1,F-DTM,42,2,0,0,2,16,26
20020329-W-Miami-SF-Jennifer_Capriati-Monica_Seles,1,F-DTL,18,5,2,0,3,9,9
20020329-W-Miami-SF-Jennifer_Capriati-Monica_Seles,1,F-IO,12,3,1,1,1,7,5
20020329-W-Miami-SF-Jennifer_Capriati-Monica_Seles,1,F-II,3,2,2,0,0,2,1
20020329-W-Miami-SF-Jennifer_Capriati-Monica_Seles,1,B-XC,47,4,1,2,1,22,25
20020329-W-Miami-SF-Jennifer_Capriati-Monica_Seles,1,B-DTM,42,3,0,0,3,15,27
20020329-W-Miami-SF-Jennifer_Capriati-Monica_Seles,1,B-DTL,26,6,2,2,2,17,9
20020329-W-Miami-SF-Jennifer_Capriati-Monica_Seles,1,B-IO,13,3,1,0,2,7,6
20020329-W-Miami-SF-Jennifer_Capriati-Monica_Seles,1,S-XC,1,0,0,0,0,0,1
20020329-W-Miami-SF-Jennifer_Capriati-Monica_Seles,1,S-DTM,6,0,0,0,0,1,5
20020329-W-Miami-SF-Jennifer_Capriati-Monica_Seles,1,S-DTL,9,0,0,0,0,4,5
20020329-W-Miami-SF-Jennifer_Capriati-Monica_Seles,1,S-IO,1,0,0,0,0,0,1
20020329-W-Miami-SF-Jennifer_Capriati-Monica_Seles,2,F-XC,74,13,4,3,6,41,33
20020329-W-Miami-SF-Jennifer_Capriati-Monica_Seles,2,F-DTM,5,0,0,0,0,2,3
20020329-W-Miami-SF-Jennifer_Capriati-Monica_Seles,2,F-DTL,14,5,3,1,1,6,8
20020329-W-Miami-SF-Jennifer_Capriati-Monica_Seles,2,F-IO,13,3,0,1,2,7,6
20020329-W-Miami-SF-Jennifer_Capriati-Monica_Seles,2,B-XC,101,35,8,7,20,53,48
20020329-W-Miami-SF-Jennifer_Capriati-Monica_Seles,2,B-DTM,28,2,0,1,1,10,18
20020329-W-Miami-SF-Jennifer_Capriati-Monica_Seles,2,B-DTL,33,9,0,2,7,16,17
20020329-W-Miami-SF-Jennifer_Capriati-Monica_Seles,2,B-IO,30,8,4,1,3,20,10
20020329-W-Miami-SF-Jennifer_Capriati-Monica_Seles,2,S-DTM,5,0,0,0,0,2,3
20020329-W-Miami-SF-Jennifer_Capriati-Monica_Seles,2,S-DTL,3,0,0,0,0,0,3
19900609-W-Roland_Garros-F-Steffi_Graf-Monica_Seles,1,F-XC,102,15,4,2,9,45,57
19900609-W-Roland_Garros-F-Steffi_Graf-Monica_Seles,1,F-DTM,7,1,0,0,1,5,2
19900609-W-Roland_Garros-F-Steffi_Graf-Monica_Seles,1,F-DTL,15,8,4,2,2,9,6
19900609-W-Roland_Garros-F-Steffi_Graf-Monica_Seles,1,F-IO,26,8,5,2,1,15,11
19900609-W-Roland_Garros-F-Steffi_Graf-Monica_Seles,1,F-II,10,3,1,0,2,6,4
19900609-W-Roland_Garros-F-Steffi_Graf-Monica_Seles,1,B-XC,3,0,0,0,0,1,2
19900609-W-Roland_Garros-F-Steffi_Graf-Monica_Seles,1,B-DTL,1,0,0,0,0,0,1
19900609-W-Roland_Garros-F-Steffi_Graf-Monica_Seles,1,S-XC,74,2,0,1,1,30,44
19900609-W-Roland_Garros-F-Steffi_Graf-Monica_Seles,1,S-DTM,36,1,0,0,1,16,20
19900609-W-Roland_Garros-F-Steffi_Graf-Monica_Seles,1,S-DTL,48,7,0,0,7,23,25
19900609-W-Roland_Garros-F-Steffi_Graf-Monica_Seles,1,S-IO,2,0,0,0,0,1,1
19900609-W-Roland_Garros-F-Steffi_Graf-Monica_Seles,2,F-XC,98,5,1,1,3,60,38
19900609-W-Roland_Garros-F-Steffi_Graf-Monica_Seles,2,F-DTM,9,1,0,0,1,5,4
19900609-W-Roland_Garros-F-Steffi_Graf-Monica_Seles,2,F-DTL,26,8,2,2,4,15,11
19900609-W-Roland_Garros-F-Steffi_Graf-Monica_Seles,2,F-IO,6,2,0,0,2,2,4
19900609-W-Roland_Garros-F-Steffi_Graf-Monica_Seles,2,F-II,1,0,0,0,0,1,0
19900609-W-Roland_Garros-F-Steffi_Graf-Monica_Seles,2,B-XC,87,15,4,2,9,45,42
19900609-W-Roland_Garros-F-Steffi_Graf-Monica_Seles,2,B-DTM,32,1,0,0,1,14,18
19900609-W-Roland_Garros-F-Steffi_Graf-Monica_Seles,2,B-DTL,48,13,4,4,5,26,22
19900609-W-Roland_Garros-F-Steffi_Graf-Monica_Seles,2,B-IO,23,4,2,1,1,13,10
19900609-W-Roland_Garros-F-Steffi_Graf-Monica_Seles,2,S-XC,1,0,0,0,0,0,1
19900609-W-Roland_Garros-F-Steffi_Graf-Monica_Seles,2,S-DTM,4,0,0,0,0,1,3
19900609-W-Roland_Garros-F-Steffi_Graf-Monica_Seles,2,S-DTL,3,0,0,0,0,1,2
19900609-W-Roland_Garros-F-Steffi_Graf-Monica_Seles,2,S-IO,2,0,0,0,0,0,2
20150509-W-ITF_Indian_Harbour_Beach-SF-Louisa_Chirico-Maria_Sanchez,1,F-XC,43,12,5,2,5,24,19
20150509-W-ITF_Indian_Harbour_Beach-SF-Louisa_Chirico-Maria_Sanchez,1,F-DTM,25,3,0,0,3,9,16
20150509-W-ITF_Indian_Harbour_Beach-SF-Louisa_Chirico-Maria_Sanchez,1,F-DTL,10,3,1,0,2,5,5
20150509-W-ITF_Indian_Harbour_Beach-SF-Louisa_Chirico-Maria_Sanchez,1,F-IO,13,3,2,0,1,6,7
20150509-W-ITF_Indian_Harbour_Beach-SF-Louisa_Chirico-Maria_Sanchez,1,B-XC,30,11,5,2,4,17,13
20150509-W-ITF_Indian_Harbour_Beach-SF-Louisa_Chirico-Maria_Sanchez,1,B-DTM,29,4,0,0,4,12,17
20150509-W-ITF_Indian_Harbour_Beach-SF-Louisa_Chirico-Maria_Sanchez,1,B-DTL,19,11,3,4,4,12,7
20150509-W-ITF_Indian_Harbour_Beach-SF-Louisa_Chirico-Maria_Sanchez,1,B-IO,5,2,0,0,2,3,2
20150509-W-ITF_Indian_Harbour_Beach-SF-Louisa_Chirico-Maria_Sanchez,1,S-XC,1,0,0,0,0,0,1
20150509-W-ITF_Indian_Harbour_Beach-SF-Louisa_Chirico-Maria_Sanchez,1,S-DTM,3,0,0,0,0,1,2
20150509-W-ITF_Indian_Harbour_Beach-SF-Louisa_Chirico-Maria_Sanchez,1,S-DTL,1,1,0,0,1,0,1
20150509-W-ITF_Indian_Harbour_Beach-SF-Louisa_Chirico-Maria_Sanchez,2,F-XC,35,6,0,1,5,18,17
20150509-W-ITF_Indian_Harbour_Beach-SF-Louisa_Chirico-Maria_Sanchez,2,F-DTM,16,3,0,0,3,7,9
20150509-W-ITF_Indian_Harbour_Beach-SF-Louisa_Chirico-Maria_Sanchez,2,F-DTL,14,6,2,1,3,6,8
20150509-W-ITF_Indian_Harbour_Beach-SF-Louisa_Chirico-Maria_Sanchez,2,F-IO,22,7,2,1,4,10,12
20150509-W-ITF_Indian_Harbour_Beach-SF-Louisa_Chirico-Maria_Sanchez,2,B-XC,30,6,0,0,6,13,17
20150509-W-ITF_Indian_Harbour_Beach-SF-Louisa_Chirico-Maria_Sanchez,2,B-DTM,24,5,0,1,4,9,15
20150509-W-ITF_Indian_Harbour_Beach-SF-Louisa_Chirico-Maria_Sanchez,2,B-DTL,8,3,2,0,1,5,3
20150509-W-ITF_Indian_Harbour_Beach-SF-Louisa_Chirico-Maria_Sanchez,2,B-IO,5,2,1,0,1,4,1
20150509-W-ITF_Indian_Harbour_Beach-SF-Louisa_Chirico-Maria_Sanchez,2,S-XC,3,0,0,0,0,1,2
20150509-W-ITF_Indian_Harbour_Beach-SF-Louisa_Chirico-Maria_Sanchez,2,S-DTM,5,1,0,0,1,2,3
20150208-W-ITF_Midland-F-Tatjana_Maria-Louisa_Chirico,1,F-XC,21,7,4,2,1,14,7
20150208-W-ITF_Midland-F-Tatjana_Maria-Louisa_Chirico,1,F-DTM,6,0,0,0,0,1,5
20150208-W-ITF_Midland-F-Tatjana_Maria-Louisa_Chirico,1,F-DTL,2,0,0,0,0,1,1
20150208-W-ITF_Midland-F-Tatjana_Maria-Louisa_Chirico,1,F-IO,9,4,3,1,0,6,3
20150208-W-ITF_Midland-F-Tatjana_Maria-Louisa_Chirico,1,F-II,3,0,0,0,0,2,1
20150208-W-ITF_Midland-F-Tatjana_Maria-Louisa_Chirico,1,B-XC,3,0,0,0,0,2,1
20150208-W-ITF_Midland-F-Tatjana_Maria-Louisa_Chirico,1,B-DTM,2,0,0,0,0,2,0
20150208-W-ITF_Midland-F-Tatjana_Maria-Louisa_Chirico,1,S-XC,41,3,1,0,2,26,15
20150208-W-ITF_Midland-F-Tatjana_Maria-Louisa_Chirico,1,S-DTM,13,0,0,0,0,8,5
20150208-W-ITF_Midland-F-Tatjana_Maria-Louisa_Chirico,1,S-DTL,7,0,0,0,0,4,3
20150208-W-ITF_Midland-F-Tatjana_Maria-Louisa_Chirico,2,F-XC,35,10,4,1,5,17,18
20150208-W-ITF_Midland-F-Tatjana_Maria-Louisa_Chirico,2,F-DTM,12,0,0,0,0,5,7
20150208-W-ITF_Midland-F-Tatjana_Maria-Louisa_Chirico,2,F-DTL,11,3,2,0,1,7,4
20150208-W-ITF_Midland-F-Tatjana_Maria-Louisa_Chirico,2,F-IO,21,4,1,1,2,6,15
20150208-W-ITF_Midland-F-Tatjana_Maria-Louisa_Chirico,2,F-II,3,1,0,0,1,2,1
20150208-W-ITF_Midland-F-Tatjana_Maria-Louisa_Chirico,2,B-XC,31,5,1,0,4,14,17
20150208-W-ITF_Midland-F-Tatjana_Maria-Louisa_Chirico,2,B-DTM,4,0,0,0,0,0,4
20150208-W-ITF_Midland-F-Tatjana_Maria-Louisa_Chirico,2,B-DTL,13,4,0,1,3,7,6
20150208-W-ITF_Midland-F-Tatjana_Maria-Louisa_Chirico,2,B-IO,4,2,1,0,1,3,1
20150208-W-ITF_Midland-F-Tatjana_Maria-Louisa_Chirico,2,S-XC,7,1,0,0,1,4,3
20150208-W-ITF_Midland-F-Tatjana_Maria-Louisa_Chirico,2,S-DTM,1,1,0,0,1,0,1
20150208-W-ITF_Midland-F-Tatjana_Maria-Louisa_Chirico,2,S-DTL,3,3,0,0,3,0,3
20160508-W-ITF_Indian_Harbour_Beach-F-Jennifer_Brady-Taylor_Townsend,1,F-XC,55,10,2,5,3,34,21
20160508-W-ITF_Indian_Harbour_Beach-F-Jennifer_Brady-Taylor_Townsend,1,F-DTM,19,1,0,1,0,13,6
20160508-W-ITF_Indian_Harbour_Beach-F-Jennifer_Brady-Taylor_Townsend,1,F-DTL,10,5,2,0,3,4,6
20160508-W-ITF_Indian_Harbour_Beach-F-Jennifer_Brady-Taylor_Townsend,1,F-IO,16,5,2,2,1,10,6
20160508-W-ITF_Indian_Harbour_Beach-F-Jennifer_Brady-Taylor_Townsend,1,F-II,2,1,1,0,0,2,0
20160508-W-ITF_Indian_Harbour_Beach-F-Jennifer_Brady-Taylor_Townsend,1,B-XC,22,7,4,2,1,10,12
20160508-W-ITF_Indian_Harbour_Beach-F-Jennifer_Brady-Taylor_Townsend,1,B-DTM,18,5,0,0,5,8,10
20160508-W-ITF_Indian_Harbour_Beach-F-Jennifer_Brady-Taylor_Townsend,1,B-DTL,6,0,0,0,0,3,3
20160508-W-ITF_Indian_Harbour_Beach-F-Jennifer_Brady-Taylor_Townsend,1,B-IO,1,0,0,0,0,0,1
20160508-W-ITF_Indian_Harbour_Beach-F-Jennifer_Brady-Taylor_Townsend,1,S-XC,2,0,0,0,0,0,2
20160508-W-ITF_Indian_Harbour_Beach-F-Jennifer_Brady-Taylor_Townsend,1,S-DTM,8,0,0,0,0,1,7
20160508-W-ITF_Indian_Harbour_Beach-F-Jennifer_Brady-Taylor_Townsend,1,S-DTL,7,0,0,0,0,4,3
20160508-W-ITF_Indian_Harbour_Beach-F-Jennifer_Brady-Taylor_Townsend,2,F-XC,47,9,2,1,6,26,21
20160508-W-ITF_Indian_Harbour_Beach-F-Jennifer_Brady-Taylor_Townsend,2,F-DTM,15,1,1,0,0,7,8
20160508-W-ITF_Indian_Harbour_Beach-F-Jennifer_Brady-Taylor_Townsend,2,F-DTL,10,6,2,2,2,6,4
20160508-W-ITF_Indian_Harbour_Beach-F-Jennifer_Brady-Taylor_Townsend,2,F-IO,17,6,3,1,2,7,10
20160508-W-ITF_Indian_Harbour_Beach-F-Jennifer_Brady-Taylor_Townsend,2,F-II,2,1,0,0,1,1,1
20160508-W-ITF_Indian_Harbour_Beach-F-Jennifer_Brady-Taylor_Townsend,2,B-XC,26,8,2,1,5,13,13
20160508-W-ITF_Indian_Harbour_Beach-F-Jennifer_Brady-Taylor_Townsend,2,B-DTM,30,3,0,0,3,10,20
20160508-W-ITF_Indian_Harbour_Beach-F-Jennifer_Brady-Taylor_Townsend,2,B-DTL,6,3,1,0,2,1,5
20160508-W-ITF_Indian_Harbour_Beach-F-Jennifer_Brady-Taylor_Townsend,2,B-IO,1,0,0,0,0,0,1
20160508-W-ITF_Indian_Harbour_Beach-F-Jennifer_Brady-Taylor_Townsend,2,S-XC,5,0,0,0,0,1,4
20160508-W-ITF_Indian_Harbour_Beach-F-Jennifer_Brady-Taylor_Townsend,2,S-DTM,6,0,0,0,0,2,4
20160508-W-ITF_Indian_Harbour_Beach-F-Jennifer_Brady-Taylor_Townsend,2,S-DTL,1,0,0,0,0,0,1
20160508-W-ITF_Indian_Harbour_Beach-F-Jennifer_Brady-Taylor_Townsend,2,S-IO,1,0,0,0,0,0,1
19950708-W-Wimbledon-F-Steffi_Graf-Arantxa_Sanchez_Vicario,1,F-XC,65,18,3,2,13,30,35
19950708-W-Wimbledon-F-Steffi_Graf-Arantxa_Sanchez_Vicario,1,F-DTM,17,2,0,0,2,8,9
19950708-W-Wimbledon-F-Steffi_Graf-Arantxa_Sanchez_Vicario,1,F-DTL,11,5,2,1,2,8,3
19950708-W-Wimbledon-F-Steffi_Graf-Arantxa_Sanchez_Vicario,1,F-IO,50,23,11,7,5,34,16
19950708-W-Wimbledon-F-Steffi_Graf-Arantxa_Sanchez_Vicario,1,F-II,17,3,1,0,2,8,9
19950708-W-Wimbledon-F-Steffi_Graf-Arantxa_Sanchez_Vicario,1,B-XC,4,2,1,0,1,3,1
19950708-W-Wimbledon-F-Steffi_Graf-Arantxa_Sanchez_Vicario,1,B-DTM,4,0,0,0,0,2,2
19950708-W-Wimbledon-F-Steffi_Graf-Arantxa_Sanchez_Vicario,1,B-DTL,4,4,2,0,2,2,2
19950708-W-Wimbledon-F-Steffi_Graf-Arantxa_Sanchez_Vicario,1,S-XC,41,4,0,0,4,22,19
19950708-W-Wimbledon-F-Steffi_Graf-Arantxa_Sanchez_Vicario,1,S-DTM,14,1,0,0,1,7,7
19950708-W-Wimbledon-F-Steffi_Graf-Arantxa_Sanchez_Vicario,1,S-DTL,16,2,0,0,2,7,9
19950708-W-Wimbledon-F-Steffi_Graf-Arantxa_Sanchez_Vicario,2,F-XC,45,15,6,2,7,26,19
19950708-W-Wimbledon-F-Steffi_Graf-Arantxa_Sanchez_Vicario,2,F-DTM,35,1,0,0,1,16,19
19950708-W-Wimbledon-F-Steffi_Graf-Arantxa_Sanchez_Vicario,2,F-DTL,18,4,1,0,3,7,11
19950708-W-Wimbledon-F-Steffi_Graf-Arantxa_Sanchez_Vicario,2,F-IO,14,5,2,0,3,6,8
19950708-W-Wimbledon-F-Steffi_Graf-Arantxa_Sanchez_Vicario,2,F-II,1,1,1,0,0,1,0
19950708-W-Wimbledon-F-Steffi_Graf-Arantxa_Sanchez_Vicario,2,B-XC,44,10,2,3,5,22,22
19950708-W-Wimbledon-F-Steffi_Graf-Arantxa_Sanchez_Vicario,2,B-DTM,16,0,0,0,0,8,8
19950708-W-Wimbledon-F-Steffi_Graf-Arantxa_Sanchez_Vicario,2,B-DTL,3,3,0,0,3,0,3
19950708-W-Wimbledon-F-Steffi_Graf-Arantxa_Sanchez_Vicario,2,B-IO,1,1,1,0,0,1,0
19950708-W-Wimbledon-F-Steffi_Graf-Arantxa_Sanchez_Vicario,2,S-XC,22,4,0,1,3,9,13
19950708-W-Wimbledon-F-Steffi_Graf-Arantxa_Sanchez_Vicario,2,S-DTM,9,0,0,0,0,5,4
19950708-W-Wimbledon-F-Steffi_Graf-Arantxa_Sanchez_Vicario,2,S-DTL,8,2,1,0,1,3,5
19950708-W-Wimbledon-F-Steffi_Graf-Arantxa_Sanchez_Vicario,2,S-IO,1,0,0,0,0,0,1
20151105-W-ITF_Waco-R16-Grace_Min-Anna_Tatishvili,1,F-XC,43,8,0,3,5,20,23
20151105-W-ITF_Waco-R16-Grace_Min-Anna_Tatishvili,1,F-DTM,18,0,0,0,0,6,12
20151105-W-ITF_Waco-R16-Grace_Min-Anna_Tatishvili,1,F-DTL,3,1,0,0,1,1,2
20151105-W-ITF_Waco-R16-Grace_Min-Anna_Tatishvili,1,F-IO,8,3,3,0,0,7,1
20151105-W-ITF_Waco-R16-Grace_Min-Anna_Tatishvili,1,F-II,2,0,0,0,0,0,2
20151105-W-ITF_Waco-R16-Grace_Min-Anna_Tatishvili,1,B-XC,16,3,0,1,2,6,10
20151105-W-ITF_Waco-R16-Grace_Min-Anna_Tatishvili,1,B-DTM,18,5,0,0,5,7,11
20151105-W-ITF_Waco-R16-Grace_Min-Anna_Tatishvili,1,B-DTL,7,1,0,0,1,4,3
20151105-W-ITF_Waco-R16-Grace_Min-Anna_Tatishvili,1,B-IO,2,0,0,0,0,2,0
20151105-W-ITF_Waco-R16-Grace_Min-Anna_Tatishvili,1,S-XC,8,0,0,0,0,1,7
20151105-W-ITF_Waco-R16-Grace_Min-Anna_Tatishvili,1,S-DTM,11,0,0,0,0,3,8
20151105-W-ITF_Waco-R16-Grace_Min-Anna_Tatishvili,1,S-DTL,1,0,0,0,0,0,1
20151105-W-ITF_Waco-R16-Grace_Min-Anna_Tatishvili,1,S-IO,2,0,0,0,0,0,2
20151105-W-ITF_Waco-R16-Grace_Min-Anna_Tatishvili,2,F-XC,42,18,5,6,7,24,18
20151105-W-ITF_Waco-R16-Grace_Min-Anna_Tatishvili,2,F-DTM,16,1,0,1,0,8,8
20151105-W-ITF_Waco-R16-Grace_Min-Anna_Tatishvili,2,F-DTL,13,7,4,1,2,7,6
20151105-W-ITF_Waco-R16-Grace_Min-Anna_Tatishvili,2,F-IO,16,2,0,1,1,11,5
20151105-W-ITF_Waco-R16-Grace_Min-Anna_Tatishvili,2,F-II,1,1,0,1,0,1,0
20151105-W-ITF_Waco-R16-Grace_Min-Anna_Tatishvili,2,B-XC,23,3,1,0,2,13,10
20151105-W-ITF_Waco-R16-Grace_Min-Anna_Tatishvili,2,B-DTM,13,1,0,0,1,5,8
20151105-W-ITF_Waco-R16-Grace_Min-Anna_Tatishvili,2,B-DTL,8,3,2,0,1,7,1
20151105-W-ITF_Waco-R16-Grace_Min-Anna_Tatishvili,2,B-IO,3,0,0,0,0,3,0
20151105-W-ITF_Waco-R16-Grace_Min-Anna_Tatishvili,2,S-XC,1,1,1,0,0,1,0
20151105-W-ITF_Waco-R16-Grace_Min-Anna_Tatishvili,2,S-DTL,1,1,0,1,0,1,0
20060221-W-Dubai-R32-Martina_Hingis-Sania_Mirza,1,F-XC,29,6,0,4,2,19,10
20060221-W-Dubai-R32-Martina_Hingis-Sania_Mirza,1,F-DTM,23,2,0,0,2,10,13
20060221-W-Dubai-R32-Martina_Hingis-Sania_Mirza,1,F-DTL,26,2,0,1,1,15,11
20060221-W-Dubai-R32-Martina_Hingis-Sania_Mirza,1,F-IO,36,6,2,0,4,18,18
20060221-W-Dubai-R32-Martina_Hingis-Sania_Mirza,1,B-XC,39,6,2,1,3,26,13
20060221-W-Dubai-R32-Martina_Hingis-Sania_Mirza,1,B-DTM,29,3,0,1,2,19,10
20060221-W-Dubai-R32-Martina_Hingis-Sania_Mirza,1,B-DTL,13,4,2,1,1,6,7
20060221-W-Dubai-R32-Martina_Hingis-Sania_Mirza,1,B-IO,11,4,1,0,3,5,6
20060221-W-Dubai-R32-Martina_Hingis-Sania_Mirza,1,S-XC,6,1,1,0,0,2,4
20060221-W-Dubai-R32-Martina_Hingis-Sania_Mirza,1,S-DTM,6,0,0,0,0,2,4
20060221-W-Dubai-R32-Martina_Hingis-Sania_Mirza,2,F-XC,47,14,4,4,6,24,23
20060221-W-Dubai-R32-Martina_Hingis-Sania_Mirza,2,F-DTM,20,3,2,0,1,9,11
20060221-W-Dubai-R32-Martina_Hingis-Sania_Mirza,2,F-DTL,8,5,2,0,3,2,6
20060221-W-Dubai-R32-Martina_Hingis-Sania_Mirza,2,F-IO,19,6,3,1,2,9,10
20060221-W-Dubai-R32-Martina_Hingis-Sania_Mirza,2,F-II,1,0,0,0,0,0,1
20060221-W-Dubai-R32-Martina_Hingis-Sania_Mirza,2,B-XC,71,14,2,5,7,33,38
20060221-W-Dubai-R32-Martina_Hingis-Sania_Mirza,2,B-DTM,44,3,0,1,2,14,30
20060221-W-Dubai-R32-Martina_Hingis-Sania_Mirza,2,B-DTL,9,4,1,1,2,4,5
20060221-W-Dubai-R32-Martina_Hingis-Sania_Mirza,2,B-IO,5,2,1,0,1,1,4
20060221-W-Dubai-R32-Martina_Hingis-Sania_Mirza,2,S-XC,2,0,0,0,0,0,2
20060221-W-Dubai-R32-Martina_Hingis-Sania_Mirza,2,S-DTM,4,0,0,0,0,2,2
20060221-W-Dubai-R32-Martina_Hingis-Sania_Mirza,2,S-DTL,2,0,0,0,0,1,1
20060221-W-Dubai-R32-Martina_Hingis-Sania_Mirza,2,S-IO,1,0,0,0,0,1,0
20080328-W-Miami-QF-Serena_Williams-Justine_Henin,1,F-XC,29,3,2,1,0,23,6
20080328-W-Miami-QF-Serena_Williams-Justine_Henin,1,F-DTM,12,1,0,0,1,7,5
20080328-W-Miami-QF-Serena_Williams-Justine_Henin,1,F-DTL,15,4,1,2,1,10,5
20080328-W-Miami-QF-Serena_Williams-Justine_Henin,1,F-IO,8,3,1,2,0,8,0
20080328-W-Miami-QF-Serena_Williams-Justine_Henin,1,B-XC,37,6,1,3,2,26,11
20080328-W-Miami-QF-Serena_Williams-Justine_Henin,1,B-DTM,16,1,0,0,1,10,6
20080328-W-Miami-QF-Serena_Williams-Justine_Henin,1,B-DTL,10,7,4,2,1,9,1
20080328-W-Miami-QF-Serena_Williams-Justine_Henin,1,B-IO,3,0,0,0,0,2,1
20080328-W-Miami-QF-Serena_Williams-Justine_Henin,1,S-XC,3,0,0,0,0,2,1
20080328-W-Miami-QF-Serena_Williams-Justine_Henin,1,S-DTM,3,0,0,0,0,2,1
20080328-W-Miami-QF-Serena_Williams-Justine_Henin,1,S-DTL,3,0,0,0,0,3,0
20080328-W-Miami-QF-Serena_Williams-Justine_Henin,2,F-XC,37,7,2,1,4,12,25
20080328-W-Miami-QF-Serena_Williams-Justine_Henin,2,F-DTM,10,1,0,0,1,2,8
20080328-W-Miami-QF-Serena_Williams-Justine_Henin,2,F-DTL,10,1,1,0,0,3,7
20080328-W-Miami-QF-Serena_Williams-Justine_Henin,2,F-IO,12,5,2,1,2,4,8
20080328-W-Miami-QF-Serena_Williams-Justine_Henin,2,F-II,1,0,0,0,0,0,1
20080328-W-Miami-QF-Serena_Williams-Justine_Henin,2,B-XC,26,7,1,2,4,9,17
20080328-W-Miami-QF-Serena_Williams-Justine_Henin,2,B-DTM,16,5,0,1,4,4,12
20080328-W-Miami-QF-Serena_Williams-Justine_Henin,2,B-DTL,6,2,0,0,2,1,5
20080328-W-Miami-QF-Serena_Williams-Justine_Henin,2,B-IO,4,0,0,0,0,1,3
20080328-W-Miami-QF-Serena_Williams-Justine_Henin,2,S-XC,13,0,0,0,0,2,11
20080328-W-Miami-QF-Serena_Williams-Justine_Henin,2,S-DTM,4,0,0,0,0,1,3
20080328-W-Miami-QF-Serena_Williams-Justine_Henin,2,S-DTL,3,0,0,0,0,1,2
20160707-W-Wimbledon-SF-Venus_Williams-Angelique_Kerber,1,F-XC,36,10,2,4,4,11,25
20160707-W-Wimbledon-SF-Venus_Williams-Angelique_Kerber,1,F-DTM,6,0,0,0,0,3,3
20160707-W-Wimbledon-SF-Venus_Williams-Angelique_Kerber,1,F-DTL,16,6,2,1,3,7,9
20160707-W-Wimbledon-SF-Venus_Williams-Angelique_Kerber,1,F-IO,14,7,4,0,3,5,9
20160707-W-Wimbledon-SF-Venus_Williams-Angelique_Kerber,1,F-II,1,1,1,0,0,1,0
20160707-W-Wimbledon-SF-Venus_Williams-Angelique_Kerber,1,B-XC,32,11,1,6,4,15,17
20160707-W-Wimbledon-SF-Venus_Williams-Angelique_Kerber,1,B-DTM,14,3,0,2,1,7,7
20160707-W-Wimbledon-SF-Venus_Williams-Angelique_Kerber,1,B-DTL,13,7,4,1,2,8,5
20160707-W-Wimbledon-SF-Venus_Williams-Angelique_Kerber,1,B-IO,5,1,0,0,1,2,3
20160707-W-Wimbledon-SF-Venus_Williams-Angelique_Kerber,1,S-DTL,1,0,0,0,0,0,1
20160707-W-Wimbledon-SF-Venus_Williams-Angelique_Kerber,2,F-XC,43,9,3,5,1,30,13
20160707-W-Wimbledon-SF-Venus_Williams-Angelique_Kerber,2,F-DTM,14,2,0,2,0,10,4
20160707-W-Wimbledon-SF-Venus_Williams-Angelique_Kerber,2,F-DTL,7,4,2,2,0,5,2
20160707-W-Wimbledon-SF-Venus_Williams-Angelique_Kerber,2,F-IO,7,4,2,1,1,3,4
20160707-W-Wimbledon-SF-Venus_Williams-Angelique_Kerber,2,B-XC,29,7,3,3,1,23,6
20160707-W-Wimbledon-SF-Venus_Williams-Angelique_Kerber,2,B-DTM,13,1,0,1,0,10,3
20160707-W-Wimbledon-SF-Venus_Williams-Angelique_Kerber,2,B-DTL,3,3,1,1,1,2,1
20160707-W-Wimbledon-SF-Venus_Williams-Angelique_Kerber,2,B-IO,3,1,0,0,1,0,3
20160707-W-Wimbledon-SF-Venus_Williams-Angelique_Kerber,2,S-XC,2,0,0,0,0,0,2
20160707-W-Wimbledon-SF-Venus_Williams-Angelique_Kerber,2,S-DTM,2,0,0,0,0,0,2
20160707-W-Wimbledon-SF-Venus_Williams-Angelique_Kerber,2,S-DTL,2,0,0,0,0,2,0
20160709-W-Wimbledon-F-Serena_Williams-Angelique_Kerber,1,F-XC,35,8,3,2,3,21,14
20160709-W-Wimbledon-F-Serena_Williams-Angelique_Kerber,1,F-DTM,10,0,0,0,0,3,7
20160709-W-Wimbledon-F-Serena_Williams-Angelique_Kerber,1,F-DTL,20,3,0,0,3,11,9
20160709-W-Wimbledon-F-Serena_Williams-Angelique_Kerber,1,F-IO,14,5,3,1,1,8,6
20160709-W-Wimbledon-F-Serena_Williams-Angelique_Kerber,1,B-XC,39,8,4,2,2,17,22
20160709-W-Wimbledon-F-Serena_Williams-Angelique_Kerber,1,B-DTM,25,7,0,0,7,6,19
20160709-W-Wimbledon-F-Serena_Williams-Angelique_Kerber,1,B-DTL,15,6,1,1,4,9,6
20160709-W-Wimbledon-F-Serena_Williams-Angelique_Kerber,1,B-IO,10,3,0,0,3,3,7
20160709-W-Wimbledon-F-Serena_Williams-Angelique_Kerber,1,S-XC,3,1,0,1,0,1,2
20160709-W-Wimbledon-F-Serena_Williams-Angelique_Kerber,1,S-DTM,3,0,0,0,0,0,3
20160709-W-Wimbledon-F-Serena_Williams-Angelique_Kerber,1,S-IO,1,0,0,0,0,0,1
20160709-W-Wimbledon-F-Serena_Williams-Angelique_Kerber,2,F-XC,59,9,2,5,2,36,23
20160709-W-Wimbledon-F-Serena_Williams-Angelique_Kerber,2,F-DTM,17,0,0,0,0,11,6
20160709-W-Wimbledon-F-Serena_Williams-Angelique_Kerber,2,F-DTL,19,8,5,2,1,13,6
20160709-W-Wimbledon-F-Serena_Williams-Angelique_Kerber,2,F-IO,9,3,1,2,0,6,3
20160709-W-Wimbledon-F-Serena_Williams-Angelique_Kerber,2,F-II,2,1,0,0,1,0,2
20160709-W-Wimbledon-F-Serena_Williams-Angelique_Kerber,2,B-XC,24,2,0,0,2,10,14
20160709-W-Wimbledon-F-Serena_Williams-Angelique_Kerber,2,B-DTM,33,2,0,0,2,16,17
20160709-W-Wimbledon-F-Serena_Williams-Angelique_Kerber,2,B-DTL,5,4,1,1,2,2,3
20160709-W-Wimbledon-F-Serena_Williams-Angelique_Kerber,2,B-IO,6,2,1,0,1,4,2
20160709-W-Wimbledon-F-Serena_Williams-Angelique_Kerber,2,S-XC,1,0,0,0,0,1,0
20160709-W-Wimbledon-F-Serena_Williams-Angelique_Kerber,2,S-DTM,7,0,0,0,0,1,6
20160709-W-Wimbledon-F-Serena_Williams-Angelique_Kerber,2,S-DTL,1,0,0,0,0,1,0
20160707-W-Wimbledon-SF-Elena_Vesnina-Serena_Williams,1,F-XC,13,3,2,0,1,6,7
20160707-W-Wimbledon-SF-Elena_Vesnina-Serena_Williams,1,F-DTM,8,1,0,0,1,3,5
20160707-W-Wimbledon-SF-Elena_Vesnina-Serena_Williams,1,F-DTL,3,2,1,1,0,2,1
20160707-W-Wimbledon-SF-Elena_Vesnina-Serena_Williams,1,F-IO,1,1,0,0,1,0,1
20160707-W-Wimbledon-SF-Elena_Vesnina-Serena_Williams,1,B-XC,15,3,2,0,1,4,11
20160707-W-Wimbledon-SF-Elena_Vesnina-Serena_Williams,1,B-DTM,11,0,0,0,0,3,8
20160707-W-Wimbledon-SF-Elena_Vesnina-Serena_Williams,1,B-DTL,2,0,0,0,0,0,2
20160707-W-Wimbledon-SF-Elena_Vesnina-Serena_Williams,1,B-IO,2,0,0,0,0,1,1
20160707-W-Wimbledon-SF-Elena_Vesnina-Serena_Williams,1,S-XC,2,1,0,1,0,1,1
20160707-W-Wimbledon-SF-Elena_Vesnina-Serena_Williams,1,S-DTM,2,0,0,0,0,1,1
20160707-W-Wimbledon-SF-Elena_Vesnina-Serena_Williams,1,S-DTL,1,0,0,0,0,1,0
20160707-W-Wimbledon-SF-Elena_Vesnina-Serena_Williams,2,F-XC,21,9,3,3,3,13,8
20160707-W-Wimbledon-SF-Elena_Vesnina-Serena_Williams,2,F-DTM,5,1,1,0,0,3,2
20160707-W-Wimbledon-SF-Elena_Vesnina-Serena_Williams,2,F-DTL,6,3,2,0,1,4,2
20160707-W-Wimbledon-SF-Elena_Vesnina-Serena_Williams,2,F-IO,5,2,2,0,0,4,1
20160707-W-Wimbledon-SF-Elena_Vesnina-Serena_Williams,2,B-XC,11,5,2,3,0,10,1
20160707-W-Wimbledon-SF-Elena_Vesnina-Serena_Williams,2,B-DTM,3,0,0,0,0,1,2
20160707-W-Wimbledon-SF-Elena_Vesnina-Serena_Williams,2,B-DTL,3,1,1,0,0,3,0
20160707-W-Wimbledon-SF-Elena_Vesnina-Serena_Williams,2,B-IO,2,2,0,2,0,2,0
20160707-W-Wimbledon-SF-Elena_Vesnina-Serena_Williams,2,S-DTM,2,0,0,0,0,1,1
20160707-W-Wimbledon-SF-Elena_Vesnina-Serena_Williams,2,S-DTL,2,0,0,0,0,2,0
19940702-W-Wimbledon-F-Conchita_Martinez-Martina_Navratilova,1,F-XC,88,19,10,2,7,50,38
19940702-W-Wimbledon-F-Conchita_Martinez-Martina_Navratilova,1,F-DTM,18,2,0,0,2,11,7
19940702-W-Wimbledon-F-Conchita_Martinez-Martina_Navratilova,1,F-DTL,14,5,4,0,1,9,5
19940702-W-Wimbledon-F-Conchita_Martinez-Martina_Navratilova,1,F-IO,20,7,5,0,2,12,8
19940702-W-Wimbledon-F-Conchita_Martinez-Martina_Navratilova,1,F-II,2,0,0,0,0,1,1
19940702-W-Wimbledon-F-Conchita_Martinez-Martina_Navratilova,1,B-XC,38,19,13,2,4,26,12
19940702-W-Wimbledon-F-Conchita_Martinez-Martina_Navratilova,1,B-DTM,15,2,0,1,1,5,10
19940702-W-Wimbledon-F-Conchita_Martinez-Martina_Navratilova,1,B-DTL,10,5,4,0,1,6,4
19940702-W-Wimbledon-F-Conchita_Martinez-Martina_Navratilova,1,B-IO,3,2,1,0,1,1,2
19940702-W-Wimbledon-F-Conchita_Martinez-Martina_Navratilova,1,S-XC,8,2,1,0,1,3,5
19940702-W-Wimbledon-F-Conchita_Martinez-Martina_Navratilova,1,S-DTM,9,1,0,1,0,8,1
19940702-W-Wimbledon-F-Conchita_Martinez-Martina_Navratilova,1,S-DTL,14,3,0,2,1,8,6
19940702-W-Wimbledon-F-Conchita_Martinez-Martina_Navratilova,1,S-IO,10,1,0,1,0,5,5
19940702-W-Wimbledon-F-Conchita_Martinez-Martina_Navratilova,2,F-XC,34,5,2,1,2,17,17
19940702-W-Wimbledon-F-Conchita_Martinez-Martina_Navratilova,2,F-DTM,13,0,0,0,0,2,11
19940702-W-Wimbledon-F-Conchita_Martinez-Martina_Navratilova,2,F-DTL,5,4,0,1,3,1,4
19940702-W-Wimbledon-F-Conchita_Martinez-Martina_Navratilova,2,F-IO,5,1,1,0,0,3,2
19940702-W-Wimbledon-F-Conchita_Martinez-Martina_Navratilova,2,F-II,2,0,0,0,0,1,1
19940702-W-Wimbledon-F-Conchita_Martinez-Martina_Navratilova,2,B-XC,11,3,0,0,3,5,6
19940702-W-Wimbledon-F-Conchita_Martinez-Martina_Navratilova,2,B-DTM,2,0,0,0,0,2,0
19940702-W-Wimbledon-F-Conchita_Martinez-Martina_Navratilova,2,B-DTL,2,2,1,0,1,1,1
19940702-W-Wimbledon-F-Conchita_Martinez-Martina_Navratilova,2,S-XC,43,5,1,1,3,15,28
19940702-W-Wimbledon-F-Conchita_Martinez-Martina_Navratilova,2,S-DTM,37,2,0,0,2,18,19
19940702-W-Wimbledon-F-Conchita_Martinez-Martina_Navratilova,2,S-DTL,18,1,0,0,1,8,10
19940702-W-Wimbledon-F-Conchita_Martinez-Martina_Navratilova,2,S-IO,8,1,0,0,1,3,5
20010609-W-Roland_Garros-F-Jennifer_Capriati-Kim_Clijsters,1,F-XC,88,14,2,1,11,44,44
20010609-W-Roland_Garros-F-Jennifer_Capriati-Kim_Clijsters,1,F-DTM,38,7,1,1,5,16,22
20010609-W-Roland_Garros-F-Jennifer_Capriati-Kim_Clijsters,1,F-DTL,14,1,0,1,0,9,5
20010609-W-Roland_Garros-F-Jennifer_Capriati-Kim_Clijsters,1,F-IO,36,8,1,2,5,17,19
20010609-W-Roland_Garros-F-Jennifer_Capriati-Kim_Clijsters,1,F-II,8,3,2,0,1,3,5
20010609-W-Roland_Garros-F-Jennifer_Capriati-Kim_Clijsters,1,B-XC,111,14,0,0,14,47,64
20010609-W-Roland_Garros-F-Jennifer_Capriati-Kim_Clijsters,1,B-DTM,74,8,0,1,7,36,38
20010609-W-Roland_Garros-F-Jennifer_Capriati-Kim_Clijsters,1,B-DTL,10,6,3,0,3,5,5
20010609-W-Roland_Garros-F-Jennifer_Capriati-Kim_Clijsters,1,B-IO,11,5,2,2,1,8,3
20010609-W-Roland_Garros-F-Jennifer_Capriati-Kim_Clijsters,1,S-XC,10,1,0,0,1,6,4
20010609-W-Roland_Garros-F-Jennifer_Capriati-Kim_Clijsters,1,S-DTM,12,1,0,0,1,6,6
20010609-W-Roland_Garros-F-Jennifer_Capriati-Kim_Clijsters,1,S-DTL,3,1,1,0,0,2,1
20010609-W-Roland_Garros-F-Jennifer_Capriati-Kim_Clijsters,1,S-IO,1,1,0,0,1,0,1
20010609-W-Roland_Garros-F-Jennifer_Capriati-Kim_Clijsters,2,F-XC,68,15,1,4,10,31,37
20010609-W-Roland_Garros-F-Jennifer_Capriati-Kim_Clijsters,2,F-DTM,40,2,0,1,1,21,19
20010609-W-Roland_Garros-F-Jennifer_Capriati-Kim_Clijsters,2,F-DTL,44,18,4,4,10,21,23
20010609-W-Roland_Garros-F-Jennifer_Capriati-Kim_Clijsters,2,F-IO,47,18,4,3,11,22,25
20010609-W-Roland_Garros-F-Jennifer_Capriati-Kim_Clijsters,2,F-II,2,1,1,0,0,2,0
20010609-W-Roland_Garros-F-Jennifer_Capriati-Kim_Clijsters,2,B-XC,105,13,2,2,9,52,53
20010609-W-Roland_Garros-F-Jennifer_Capriati-Kim_Clijsters,2,B-DTM,51,5,0,0,5,24,27
20010609-W-Roland_Garros-F-Jennifer_Capriati-Kim_Clijsters,2,B-DTL,23,9,2,1,6,12,11
20010609-W-Roland_Garros-F-Jennifer_Capriati-Kim_Clijsters,2,B-IO,10,5,0,2,3,5,5
20010609-W-Roland_Garros-F-Jennifer_Capriati-Kim_Clijsters,2,S-XC,7,1,0,1,0,5,2
20010609-W-Roland_Garros-F-Jennifer_Capriati-Kim_Clijsters,2,S-DTM,11,1,0,0,1,4,7
20150115-W-Hobart-R16-Heather_Watson-Sloane_Stephens,1,F-XC,25,11,3,5,3,16,9
20150115-W-Hobart-R16-Heather_Watson-Sloane_Stephens,1,F-DTM,16,0,0,0,0,7,9
20150115-W-Hobart-R16-Heather_Watson-Sloane_Stephens,1,F-DTL,11,3,1,2,0,6,5
20150115-W-Hobart-R16-Heather_Watson-Sloane_Stephens,1,F-IO,13,4,0,2,2,9,4
20150115-W-Hobart-R16-Heather_Watson-Sloane_Stephens,1,B-XC,23,5,0,3,2,15,8
20150115-W-Hobart-R16-Heather_Watson-Sloane_Stephens,1,B-DTM,18,2,0,0,2,5,13
20150115-W-Hobart-R16-Heather_Watson-Sloane_Stephens,1,B-DTL,1,1,0,0,1,0,1
20150115-W-Hobart-R16-Heather_Watson-Sloane_Stephens,1,B-IO,5,2,1,1,0,4,1
20150115-W-Hobart-R16-Heather_Watson-Sloane_Stephens,1,S-XC,3,0,0,0,0,2,1
20150115-W-Hobart-R16-Heather_Watson-Sloane_Stephens,1,S-DTM,2,0,0,0,0,1,1
20150115-W-Hobart-R16-Heather_Watson-Sloane_Stephens,1,S-DTL,1,0,0,0,0,0,1
20150115-W-Hobart-R16-Heather_Watson-Sloane_Stephens,2,F-XC,27,8,3,2,3,17,10
20150115-W-Hobart-R16-Heather_Watson-Sloane_Stephens,2,F-DTM,17,1,0,0,1,5,12
20150115-W-Hobart-R16-Heather_Watson-Sloane_Stephens,2,F-DTL,3,1,1,0,0,3,0
20150115-W-Hobart-R16-Heather_Watson-Sloane_Stephens,2,F-IO,7,3,2,0,1,4,3
20150115-W-Hobart-R16-Heather_Watson-Sloane_Stephens,2,F-II,2,2,1,0,1,1,1
20150115-W-Hobart-R16-Heather_Watson-Sloane_Stephens,2,B-XC,31,6,1,4,1,19,12
20150115-W-Hobart-R16-Heather_Watson-Sloane_Stephens,2,B-DTM,28,3,0,1,2,8,20
20150115-W-Hobart-R16-Heather_Watson-Sloane_Stephens,2,B-DTL,3,1,0,0,1,1,2
20150115-W-Hobart-R16-Heather_Watson-Sloane_Stephens,2,B-IO,3,3,1,1,1,2,1
20150115-W-Hobart-R16-Heather_Watson-Sloane_Stephens,2,S-XC,2,0,0,0,0,0,2
20150115-W-Hobart-R16-Heather_Watson-Sloane_Stephens,2,S-DTM,4,0,0,0,0,2,2
19850608-W-Roland_Garros-F-Chris_Evert-Martina_Navratilova,1,F-XC,171,15,2,6,7,89,82
19850608-W-Roland_Garros-F-Chris_Evert-Martina_Navratilova,1,F-DTM,40,4,0,0,4,23,17
19850608-W-Roland_Garros-F-Chris_Evert-Martina_Navratilova,1,F-DTL,11,6,2,3,1,7,4
19850608-W-Roland_Garros-F-Chris_Evert-Martina_Navratilova,1,F-IO,14,3,1,1,1,10,4
19850608-W-Roland_Garros-F-Chris_Evert-Martina_Navratilova,1,B-XC,169,30,14,5,11,86,83
19850608-W-Roland_Garros-F-Chris_Evert-Martina_Navratilova,1,B-DTM,101,5,1,0,4,38,63
19850608-W-Roland_Garros-F-Chris_Evert-Martina_Navratilova,1,B-DTL,42,8,4,3,1,23,19
19850608-W-Roland_Garros-F-Chris_Evert-Martina_Navratilova,1,B-IO,55,4,2,0,2,29,26
19850608-W-Roland_Garros-F-Chris_Evert-Martina_Navratilova,1,S-XC,5,1,0,0,1,1,4
19850608-W-Roland_Garros-F-Chris_Evert-Martina_Navratilova,1,S-DTM,11,0,0,0,0,5,6
19850608-W-Roland_Garros-F-Chris_Evert-Martina_Navratilova,1,S-DTL,4,0,0,0,0,2,2
19850608-W-Roland_Garros-F-Chris_Evert-Martina_Navratilova,2,F-XC,164,13,3,2,8,85,79
19850608-W-Roland_Garros-F-Chris_Evert-Martina_Navratilova,2,F-DTM,35,2,0,0,2,14,21
19850608-W-Roland_Garros-F-Chris_Evert-Martina_Navratilova,2,F-DTL,8,5,1,1,3,4,4
19850608-W-Roland_Garros-F-Chris_Evert-Martina_Navratilova,2,F-IO,13,2,0,1,1,7,6
19850608-W-Roland_Garros-F-Chris_Evert-Martina_Navratilova,2,F-II,1,0,0,0,0,1,0
19850608-W-Roland_Garros-F-Chris_Evert-Martina_Navratilova,2,B-XC,45,6,1,2,3,22,23
19850608-W-Roland_Garros-F-Chris_Evert-Martina_Navratilova,2,B-DTM,16,1,0,0,1,4,12
19850608-W-Roland_Garros-F-Chris_Evert-Martina_Navratilova,2,B-DTL,7,2,1,0,1,4,3
19850608-W-Roland_Garros-F-Chris_Evert-Martina_Navratilova,2,B-IO,1,1,0,1,0,1,0
19850608-W-Roland_Garros-F-Chris_Evert-Martina_Navratilova,2,S-XC,97,10,1,2,7,49,48
19850608-W-Roland_Garros-F-Chris_Evert-Martina_Navratilova,2,S-DTM,98,1,0,0,1,50,48
19850608-W-Roland_Garros-F-Chris_Evert-Martina_Navratilova,2,S-DTL,51,6,1,1,4,26,25
19850608-W-Roland_Garros-F-Chris_Evert-Martina_Navratilova,2,S-IO,9,1,0,1,0,5,4
20100118-W-Australian_Open-R128-Maria_Kirilenko-Maria_Sharapova,1,F-XC,78,12,6,2,4,44,34
20100118-W-Australian_Open-R128-Maria_Kirilenko-Maria_Sharapova,1,F-DTM,49,4,0,1,3,25,24
20100118-W-Australian_Open-R128-Maria_Kirilenko-Maria_Sharapova,1,F-DTL,14,3,1,1,1,9,5
20100118-W-Australian_Open-R128-Maria_Kirilenko-Maria_Sharapova,1,F-IO,23,5,2,1,2,17,6
20100118-W-Australian_Open-R128-Maria_Kirilenko-Maria_Sharapova,1,B-XC,71,14,3,7,4,37,34
20100118-W-Australian_Open-R128-Maria_Kirilenko-Maria_Sharapova,1,B-DTM,45,3,0,0,3,27,18
20100118-W-Australian_Open-R128-Maria_Kirilenko-Maria_Sharapova,1,B-DTL,7,1,0,1,0,4,3
20100118-W-Australian_Open-R128-Maria_Kirilenko-Maria_Sharapova,1,B-IO,6,1,0,0,1,4,2
20100118-W-Australian_Open-R128-Maria_Kirilenko-Maria_Sharapova,1,S-XC,6,2,0,0,2,3,3
20100118-W-Australian_Open-R128-Maria_Kirilenko-Maria_Sharapova,1,S-DTM,10,0,0,0,0,3,7
20100118-W-Australian_Open-R128-Maria_Kirilenko-Maria_Sharapova,1,S-DTL,2,0,0,0,0,1,1
20100118-W-Australian_Open-R128-Maria_Kirilenko-Maria_Sharapova,1,S-IO,1,1,0,0,1,0,1
20100118-W-Australian_Open-R128-Maria_Kirilenko-Maria_Sharapova,2,F-XC,78,18,5,4,9,31,47
20100118-W-Australian_Open-R128-Maria_Kirilenko-Maria_Sharapova,2,F-DTM,31,3,0,1,2,12,19
20100118-W-Australian_Open-R128-Maria_Kirilenko-Maria_Sharapova,2,F-DTL,21,11,6,2,3,13,8
20100118-W-Australian_Open-R128-Maria_Kirilenko-Maria_Sharapova,2,F-IO,29,8,2,1,5,15,14
20100118-W-Australian_Open-R128-Maria_Kirilenko-Maria_Sharapova,2,F-II,1,0,0,0,0,1,0
20100118-W-Australian_Open-R128-Maria_Kirilenko-Maria_Sharapova,2,B-XC,75,22,3,8,11,34,41
20100118-W-Australian_Open-R128-Maria_Kirilenko-Maria_Sharapova,2,B-DTM,40,5,1,0,4,18,22
20100118-W-Australian_Open-R128-Maria_Kirilenko-Maria_Sharapova,2,B-DTL,26,13,6,2,5,16,10
20100118-W-Australian_Open-R128-Maria_Kirilenko-Maria_Sharapova,2,B-IO,10,3,0,2,1,5,5
20100118-W-Australian_Open-R128-Maria_Kirilenko-Maria_Sharapova,2,S-XC,3,0,0,0,0,2,1
20100118-W-Australian_Open-R128-Maria_Kirilenko-Maria_Sharapova,2,S-DTM,4,0,0,0,0,3,1
20100118-W-Australian_Open-R128-Maria_Kirilenko-Maria_Sharapova,2,S-IO,1,0,0,0,0,0,1
19870606-W-Roland_Garros-F-Steffi_Graf-Martina_Navratilova,1,F-XC,64,15,1,5,9,40,24
19870606-W-Roland_Garros-F-Steffi_Graf-Martina_Navratilova,1,F-DTM,23,1,1,0,0,11,12
19870606-W-Roland_Garros-F-Steffi_Graf-Martina_Navratilova,1,F-DTL,6,0,0,0,0,5,1
19870606-W-Roland_Garros-F-Steffi_Graf-Martina_Navratilova,1,F-IO,30,8,3,1,4,17,13
19870606-W-Roland_Garros-F-Steffi_Graf-Martina_Navratilova,1,F-II,8,1,0,1,0,5,3
19870606-W-Roland_Garros-F-Steffi_Graf-Martina_Navratilova,1,B-XC,22,10,7,2,1,16,6
19870606-W-Roland_Garros-F-Steffi_Graf-Martina_Navratilova,1,B-DTM,19,3,0,0,3,4,15
19870606-W-Roland_Garros-F-Steffi_Graf-Martina_Navratilova,1,B-DTL,4,3,2,1,0,3,1
19870606-W-Roland_Garros-F-Steffi_Graf-Martina_Navratilova,1,B-IO,3,1,1,0,0,2,1
19870606-W-Roland_Garros-F-Steffi_Graf-Martina_Navratilova,1,S-XC,45,3,0,1,2,22,23
19870606-W-Roland_Garros-F-Steffi_Graf-Martina_Navratilova,1,S-DTM,38,2,0,0,2,17,21
19870606-W-Roland_Garros-F-Steffi_Graf-Martina_Navratilova,1,S-DTL,15,7,4,1,2,8,7
19870606-W-Roland_Garros-F-Steffi_Graf-Martina_Navratilova,1,S-IO,5,2,0,2,0,2,3
19870606-W-Roland_Garros-F-Steffi_Graf-Martina_Navratilova,2,F-XC,73,5,0,2,3,36,37
19870606-W-Roland_Garros-F-Steffi_Graf-Martina_Navratilova,2,F-DTM,27,4,0,0,4,9,18
19870606-W-Roland_Garros-F-Steffi_Graf-Martina_Navratilova,2,F-DTL,15,7,2,3,2,6,9
19870606-W-Roland_Garros-F-Steffi_Graf-Martina_Navratilova,2,F-IO,6,4,2,1,1,4,2
19870606-W-Roland_Garros-F-Steffi_Graf-Martina_Navratilova,2,B-XC,11,2,0,0,2,5,6
19870606-W-Roland_Garros-F-Steffi_Graf-Martina_Navratilova,2,B-DTM,5,0,0,0,0,3,2
19870606-W-Roland_Garros-F-Steffi_Graf-Martina_Navratilova,2,B-DTL,2,1,1,0,0,1,1
19870606-W-Roland_Garros-F-Steffi_Graf-Martina_Navratilova,2,S-XC,25,4,0,0,4,6,19
19870606-W-Roland_Garros-F-Steffi_Graf-Martina_Navratilova,2,S-DTM,38,2,0,0,2,15,23
19870606-W-Roland_Garros-F-Steffi_Graf-Martina_Navratilova,2,S-DTL,13,1,0,0,1,6,7
19870606-W-Roland_Garros-F-Steffi_Graf-Martina_Navratilova,2,S-IO,10,4,0,1,3,3,7
20010708-W-Wimbledon-F-Venus_Williams-Justine_Henin,1,F-XC,19,3,0,1,2,10,9
20010708-W-Wimbledon-F-Venus_Williams-Justine_Henin,1,F-DTM,27,0,0,0,0,12,15
20010708-W-Wimbledon-F-Venus_Williams-Justine_Henin,1,F-DTL,4,2,0,2,0,4,0
20010708-W-Wimbledon-F-Venus_Williams-Justine_Henin,1,F-IO,12,7,5,2,0,8,4
20010708-W-Wimbledon-F-Venus_Williams-Justine_Henin,1,B-XC,25,2,1,0,1,19,6
20010708-W-Wimbledon-F-Venus_Williams-Justine_Henin,1,B-DTM,20,5,1,1,3,8,12
20010708-W-Wimbledon-F-Venus_Williams-Justine_Henin,1,B-DTL,13,7,2,1,4,8,5
20010708-W-Wimbledon-F-Venus_Williams-Justine_Henin,1,B-IO,12,5,0,3,2,5,7
20010708-W-Wimbledon-F-Venus_Williams-Justine_Henin,1,S-DTM,4,1,0,0,1,1,3
20010708-W-Wimbledon-F-Venus_Williams-Justine_Henin,2,F-XC,27,8,2,3,3,15,12
20010708-W-Wimbledon-F-Venus_Williams-Justine_Henin,2,F-DTM,40,3,0,0,3,18,22
20010708-W-Wimbledon-F-Venus_Williams-Justine_Henin,2,F-DTL,6,1,0,1,0,4,2
20010708-W-Wimbledon-F-Venus_Williams-Justine_Henin,2,F-IO,12,6,2,2,2,5,7
20010708-W-Wimbledon-F-Venus_Williams-Justine_Henin,2,B-XC,13,2,0,0,2,6,7
20010708-W-Wimbledon-F-Venus_Williams-Justine_Henin,2,B-DTM,16,3,0,0,3,7,9
20010708-W-Wimbledon-F-Venus_Williams-Justine_Henin,2,B-IO,2,0,0,0,0,2,0
20010708-W-Wimbledon-F-Venus_Williams-Justine_Henin,2,S-XC,10,1,0,1,0,3,7
20010708-W-Wimbledon-F-Venus_Williams-Justine_Henin,2,S-DTM,10,1,0,0,1,4,6
20160620-W-Eastbourne-R64-Eugenie_Bouchard-Varvara_Lepchenko,1,F-XC,16,2,2,0,0,10,6
20160620-W-Eastbourne-R64-Eugenie_Bouchard-Varvara_Lepchenko,1,F-DTM,10,1,0,0,1,6,4
20160620-W-Eastbourne-R64-Eugenie_Bouchard-Varvara_Lepchenko,1,F-DTL,8,5,3,1,1,6,2
20160620-W-Eastbourne-R64-Eugenie_Bouchard-Varvara_Lepchenko,1,F-IO,5,4,3,0,1,4,1
20160620-W-Eastbourne-R64-Eugenie_Bouchard-Varvara_Lepchenko,1,B-XC,20,9,1,4,4,10,10
20160620-W-Eastbourne-R64-Eugenie_Bouchard-Varvara_Lepchenko,1,B-DTM,15,2,0,0,2,9,6
20160620-W-Eastbourne-R64-Eugenie_Bouchard-Varvara_Lepchenko,1,B-DTL,2,1,1,0,0,2,0
20160620-W-Eastbourne-R64-Eugenie_Bouchard-Varvara_Lepchenko,1,B-IO,2,1,1,0,0,1,1
20160620-W-Eastbourne-R64-Eugenie_Bouchard-Varvara_Lepchenko,1,S-DTM,1,0,0,0,0,0,1
20160620-W-Eastbourne-R64-Eugenie_Bouchard-Varvara_Lepchenko,2,F-XC,10,2,2,0,0,5,5
20160620-W-Eastbourne-R64-Eugenie_Bouchard-Varvara_Lepchenko,2,F-DTM,10,3,0,0,3,4,6
20160620-W-Eastbourne-R64-Eugenie_Bouchard-Varvara_Lepchenko,2,F-DTL,10,5,2,0,3,4,6
20160620-W-Eastbourne-R64-Eugenie_Bouchard-Varvara_Lepchenko,2,F-IO,12,4,1,1,2,5,7
20160620-W-Eastbourne-R64-Eugenie_Bouchard-Varvara_Lepchenko,2,B-XC,6,3,0,1,2,2,4
20160620-W-Eastbourne-R64-Eugenie_Bouchard-Varvara_Lepchenko,2,B-DTM,14,4,0,0,4,3,11
20160620-W-Eastbourne-R64-Eugenie_Bouchard-Varvara_Lepchenko,2,B-DTL,7,2,2,0,0,4,3
20160620-W-Eastbourne-R64-Eugenie_Bouchard-Varvara_Lepchenko,2,B-IO,4,3,0,0,3,1,3
20160620-W-Eastbourne-R64-Eugenie_Bouchard-Varvara_Lepchenko,2,S-DTM,2,0,0,0,0,1,1
20160325-W-Miami-R64-Petra_Kvitova-Irina_Falconi,1,F-XC,29,6,3,1,2,21,8
20160325-W-Miami-R64-Petra_Kvitova-Irina_Falconi,1,F-DTM,14,1,0,0,1,11,3
20160325-W-Miami-R64-Petra_Kvitova-Irina_Falconi,1,F-DTL,4,1,0,0,1,1,3
20160325-W-Miami-R64-Petra_Kvitova-Irina_Falconi,1,F-IO,13,7,3,1,3,6,7
20160325-W-Miami-R64-Petra_Kvitova-Irina_Falconi,1,B-XC,19,6,2,0,4,7,12
20160325-W-Miami-R64-Petra_Kvitova-Irina_Falconi,1,B-DTM,14,2,0,0,2,6,8
20160325-W-Miami-R64-Petra_Kvitova-Irina_Falconi,1,B-IO,7,3,2,0,1,5,2
20160325-W-Miami-R64-Petra_Kvitova-Irina_Falconi,1,S-XC,5,1,1,0,0,4,1
20160325-W-Miami-R64-Petra_Kvitova-Irina_Falconi,1,S-DTM,3,0,0,0,0,1,2
20160325-W-Miami-R64-Petra_Kvitova-Irina_Falconi,1,S-IO,1,0,0,0,0,0,1
20160325-W-Miami-R64-Petra_Kvitova-Irina_Falconi,2,F-XC,9,4,1,1,2,5,4
20160325-W-Miami-R64-Petra_Kvitova-Irina_Falconi,2,F-DTM,34,4,0,0,4,18,16
20160325-W-Miami-R64-Petra_Kvitova-Irina_Falconi,2,F-DTL,8,5,2,1,2,6,2
20160325-W-Miami-R64-Petra_Kvitova-Irina_Falconi,2,F-IO,9,1,0,0,1,2,7
20160325-W-Miami-R64-Petra_Kvitova-Irina_Falconi,2,B-XC,7,5,1,1,3,3,4
20160325-W-Miami-R64-Petra_Kvitova-Irina_Falconi,2,B-DTM,21,3,0,0,3,6,15
20160325-W-Miami-R64-Petra_Kvitova-Irina_Falconi,2,B-DTL,5,3,0,0,3,1,4
20160325-W-Miami-R64-Petra_Kvitova-Irina_Falconi,2,B-IO,4,0,0,0,0,1,3
20160325-W-Miami-R64-Petra_Kvitova-Irina_Falconi,2,S-XC,1,0,0,0,0,0,1
20160325-W-Miami-R64-Petra_Kvitova-Irina_Falconi,2,S-DTM,8,2,0,0,2,1,7
20160325-W-Miami-R64-Petra_Kvitova-Irina_Falconi,2,S-DTL,1,0,0,0,0,1,0
20160325-W-Miami-R64-Petra_Kvitova-Irina_Falconi,2,S-IO,1,1,0,0,1,0,1
20160725-W-Montreal-R64-Petra_Kvitova-Magda_Linette,1,F-XC,14,7,4,0,3,8,6
20160725-W-Montreal-R64-Petra_Kvitova-Magda_Linette,1,F-DTM,7,3,1,1,1,4,3
20160725-W-Montreal-R64-Petra_Kvitova-Magda_Linette,1,F-IO,4,3,3,0,0,4,0
20160725-W-Montreal-R64-Petra_Kvitova-Magda_Linette,1,B-XC,16,9,4,1,4,12,4
20160725-W-Montreal-R64-Petra_Kvitova-Magda_Linette,1,B-DTM,6,3,0,0,3,0,6
20160725-W-Montreal-R64-Petra_Kvitova-Magda_Linette,1,B-DTL,2,1,1,0,0,2,0
20160725-W-Montreal-R64-Petra_Kvitova-Magda_Linette,1,B-IO,3,0,0,0,0,2,1
20160725-W-Montreal-R64-Petra_Kvitova-Magda_Linette,1,S-XC,1,0,0,0,0,0,1
20160725-W-Montreal-R64-Petra_Kvitova-Magda_Linette,1,S-DTM,2,1,0,0,1,1,1
20160725-W-Montreal-R64-Petra_Kvitova-Magda_Linette,2,F-XC,9,2,2,0,0,5,4
20160725-W-Montreal-R64-Petra_Kvitova-Magda_Linette,2,F-DTM,12,2,0,0,2,4,8
20160725-W-Montreal-R64-Petra_Kvitova-Magda_Linette,2,F-DTL,3,1,0,1,0,1,2
20160725-W-Montreal-R64-Petra_Kvitova-Magda_Linette,2,F-IO,2,1,1,0,0,1,1
20160725-W-Montreal-R64-Petra_Kvitova-Magda_Linette,2,B-XC,6,4,2,0,2,3,3
20160725-W-Montreal-R64-Petra_Kvitova-Magda_Linette,2,B-DTM,10,1,1,0,0,6,4
20160725-W-Montreal-R64-Petra_Kvitova-Magda_Linette,2,B-DTL,5,3,0,0,3,2,3
20160725-W-Montreal-R64-Petra_Kvitova-Magda_Linette,2,B-IO,1,0,0,0,0,0,1
20160725-W-Montreal-R64-Petra_Kvitova-Magda_Linette,2,S-DTM,1,0,0,0,0,0,1
20160725-W-Montreal-R64-Petra_Kvitova-Magda_Linette,2,S-DTL,2,0,0,0,0,0,2
20160719-W-Washington-R32-Camila_Giorgi-Eugenie_Bouchard,1,F-XC,14,9,4,3,2,12,2
20160719-W-Washington-R32-Camila_Giorgi-Eugenie_Bouchard,1,F-DTM,31,7,0,3,4,19,12
20160719-W-Washington-R32-Camila_Giorgi-Eugenie_Bouchard,1,F-DTL,1,0,0,0,0,0,1
20160719-W-Washington-R32-Camila_Giorgi-Eugenie_Bouchard,1,F-IO,6,5,2,1,2,4,2
20160719-W-Washington-R32-Camila_Giorgi-Eugenie_Bouchard,1,B-XC,9,2,0,0,2,5,4
20160719-W-Washington-R32-Camila_Giorgi-Eugenie_Bouchard,1,B-DTM,18,4,0,1,3,13,5
20160719-W-Washington-R32-Camila_Giorgi-Eugenie_Bouchard,1,B-DTL,2,1,0,0,1,0,2
20160719-W-Washington-R32-Camila_Giorgi-Eugenie_Bouchard,1,B-IO,3,2,1,0,1,1,2
20160719-W-Washington-R32-Camila_Giorgi-Eugenie_Bouchard,1,S-DTM,1,0,0,0,0,0,1
20160719-W-Washington-R32-Camila_Giorgi-Eugenie_Bouchard,1,S-DTL,1,0,0,0,0,0,1
20160719-W-Washington-R32-Camila_Giorgi-Eugenie_Bouchard,2,F-XC,11,8,0,1,7,1,10
20160719-W-Washington-R32-Camila_Giorgi-Eugenie_Bouchard,2,F-DTM,20,3,0,0,3,6,14
20160719-W-Washington-R32-Camila_Giorgi-Eugenie_Bouchard,2,F-DTL,4,4,3,1,0,4,0
20160719-W-Washington-R32-Camila_Giorgi-Eugenie_Bouchard,2,F-IO,8,5,1,1,3,4,4
20160719-W-Washington-R32-Camila_Giorgi-Eugenie_Bouchard,2,B-XC,12,6,1,1,4,6,6
20160719-W-Washington-R32-Camila_Giorgi-Eugenie_Bouchard,2,B-DTM,20,2,0,0,2,6,14
20160719-W-Washington-R32-Camila_Giorgi-Eugenie_Bouchard,2,B-DTL,3,3,1,0,2,1,2
20160719-W-Washington-R32-Camila_Giorgi-Eugenie_Bouchard,2,B-IO,3,3,0,1,2,1,2
20160719-W-Washington-R32-Camila_Giorgi-Eugenie_Bouchard,2,S-XC,1,1,1,0,0,1,0
20090813-W-Cincinnati-R16-Kim_Clijsters-Svetlana_Kuznetsova,1,F-XC,51,14,5,3,6,26,25
20090813-W-Cincinnati-R16-Kim_Clijsters-Svetlana_Kuznetsova,1,F-DTM,20,1,0,0,1,13,7
20090813-W-Cincinnati-R16-Kim_Clijsters-Svetlana_Kuznetsova,1,F-DTL,8,4,3,1,0,6,2
20090813-W-Cincinnati-R16-Kim_Clijsters-Svetlana_Kuznetsova,1,F-IO,20,5,4,0,1,16,4
20090813-W-Cincinnati-R16-Kim_Clijsters-Svetlana_Kuznetsova,1,B-XC,50,13,2,4,7,29,21
20090813-W-Cincinnati-R16-Kim_Clijsters-Svetlana_Kuznetsova,1,B-DTM,17,1,0,0,1,8,9
20090813-W-Cincinnati-R16-Kim_Clijsters-Svetlana_Kuznetsova,1,B-DTL,4,2,1,1,0,3,1
20090813-W-Cincinnati-R16-Kim_Clijsters-Svetlana_Kuznetsova,1,B-IO,4,2,0,0,2,0,4
20090813-W-Cincinnati-R16-Kim_Clijsters-Svetlana_Kuznetsova,1,S-XC,8,1,0,1,0,6,2
20090813-W-Cincinnati-R16-Kim_Clijsters-Svetlana_Kuznetsova,1,S-DTM,2,0,0,0,0,1,1
20090813-W-Cincinnati-R16-Kim_Clijsters-Svetlana_Kuznetsova,1,S-DTL,2,1,0,1,0,1,1
20090813-W-Cincinnati-R16-Kim_Clijsters-Svetlana_Kuznetsova,2,F-XC,37,14,1,5,8,19,18
20090813-W-Cincinnati-R16-Kim_Clijsters-Svetlana_Kuznetsova,2,F-DTM,17,3,0,1,2,6,11
20090813-W-Cincinnati-R16-Kim_Clijsters-Svetlana_Kuznetsova,2,F-DTL,18,10,1,5,4,11,7
20090813-W-Cincinnati-R16-Kim_Clijsters-Svetlana_Kuznetsova,2,F-IO,20,6,4,0,2,10,10
20090813-W-Cincinnati-R16-Kim_Clijsters-Svetlana_Kuznetsova,2,F-II,6,2,1,0,1,3,3
20090813-W-Cincinnati-R16-Kim_Clijsters-Svetlana_Kuznetsova,2,B-XC,43,12,2,4,6,17,26
20090813-W-Cincinnati-R16-Kim_Clijsters-Svetlana_Kuznetsova,2,B-DTM,30,5,0,2,3,12,18
20090813-W-Cincinnati-R16-Kim_Clijsters-Svetlana_Kuznetsova,2,B-DTL,14,7,2,1,4,5,9
20090813-W-Cincinnati-R16-Kim_Clijsters-Svetlana_Kuznetsova,2,B-IO,5,2,1,1,0,2,3
20090813-W-Cincinnati-R16-Kim_Clijsters-Svetlana_Kuznetsova,2,S-XC,2,0,0,0,0,0,2
20090813-W-Cincinnati-R16-Kim_Clijsters-Svetlana_Kuznetsova,2,S-DTM,7,0,0,0,0,1,6
20090813-W-Cincinnati-R16-Kim_Clijsters-Svetlana_Kuznetsova,2,S-DTL,2,2,1,0,1,1,1
20140119-W-Australian_Open-R16-Agnieszka_Radwanska-Garbine_Muguruza,1,F-XC,32,2,1,1,0,24,8
20140119-W-Australian_Open-R16-Agnieszka_Radwanska-Garbine_Muguruza,1,F-DTM,18,1,0,1,0,11,7
20140119-W-Australian_Open-R16-Agnieszka_Radwanska-Garbine_Muguruza,1,F-DTL,19,4,0,2,2,15,4
20140119-W-Australian_Open-R16-Agnieszka_Radwanska-Garbine_Muguruza,1,F-IO,25,5,0,2,3,14,11
20140119-W-Australian_Open-R16-Agnieszka_Radwanska-Garbine_Muguruza,1,B-XC,28,3,1,2,0,16,12
20140119-W-Australian_Open-R16-Agnieszka_Radwanska-Garbine_Muguruza,1,B-DTM,39,1,0,0,1,22,17
20140119-W-Australian_Open-R16-Agnieszka_Radwanska-Garbine_Muguruza,1,B-DTL,7,3,2,0,1,3,4
20140119-W-Australian_Open-R16-Agnieszka_Radwanska-Garbine_Muguruza,1,B-IO,6,1,0,1,0,4,2
20140119-W-Australian_Open-R16-Agnieszka_Radwanska-Garbine_Muguruza,1,S-XC,3,0,0,0,0,1,2
20140119-W-Australian_Open-R16-Agnieszka_Radwanska-Garbine_Muguruza,1,S-DTM,6,0,0,0,0,3,3
20140119-W-Australian_Open-R16-Agnieszka_Radwanska-Garbine_Muguruza,1,S-DTL,1,0,0,0,0,0,1
20140119-W-Australian_Open-R16-Agnieszka_Radwanska-Garbine_Muguruza,1,S-IO,2,1,0,1,0,2,0
20140119-W-Australian_Open-R16-Agnieszka_Radwanska-Garbine_Muguruza,2,F-XC,54,11,3,2,6,16,38
20140119-W-Australian_Open-R16-Agnieszka_Radwanska-Garbine_Muguruza,2,F-DTM,16,3,0,2,1,7,9
20140119-W-Australian_Open-R16-Agnieszka_Radwanska-Garbine_Muguruza,2,F-DTL,19,7,1,1,5,8,11
20140119-W-Australian_Open-R16-Agnieszka_Radwanska-Garbine_Muguruza,2,F-IO,16,4,1,0,3,7,9
20140119-W-Australian_Open-R16-Agnieszka_Radwanska-Garbine_Muguruza,2,B-XC,47,10,0,2,8,19,28
20140119-W-Australian_Open-R16-Agnieszka_Radwanska-Garbine_Muguruza,2,B-DTM,42,3,0,1,2,16,26
20140119-W-Australian_Open-R16-Agnieszka_Radwanska-Garbine_Muguruza,2,B-DTL,14,9,5,0,4,7,7
20140119-W-Australian_Open-R16-Agnieszka_Radwanska-Garbine_Muguruza,2,B-IO,12,5,3,1,1,7,5
19950610-W-Roland_Garros-F-Steffi_Graf-Arantxa_Sanchez_Vicario,1,F-XC,86,18,4,9,5,58,28
19950610-W-Roland_Garros-F-Steffi_Graf-Arantxa_Sanchez_Vicario,1,F-DTM,55,6,0,1,5,31,24
19950610-W-Roland_Garros-F-Steffi_Graf-Arantxa_Sanchez_Vicario,1,F-DTL,10,4,1,1,2,5,5
19950610-W-Roland_Garros-F-Steffi_Graf-Arantxa_Sanchez_Vicario,1,F-IO,45,16,6,4,6,29,16
19950610-W-Roland_Garros-F-Steffi_Graf-Arantxa_Sanchez_Vicario,1,F-II,9,3,0,2,1,8,1
19950610-W-Roland_Garros-F-Steffi_Graf-Arantxa_Sanchez_Vicario,1,B-XC,4,1,0,0,1,3,1
19950610-W-Roland_Garros-F-Steffi_Graf-Arantxa_Sanchez_Vicario,1,B-DTM,9,2,1,1,0,6,3
19950610-W-Roland_Garros-F-Steffi_Graf-Arantxa_Sanchez_Vicario,1,B-DTL,2,2,1,1,0,2,0
19950610-W-Roland_Garros-F-Steffi_Graf-Arantxa_Sanchez_Vicario,1,S-XC,55,4,1,1,2,25,30
19950610-W-Roland_Garros-F-Steffi_Graf-Arantxa_Sanchez_Vicario,1,S-DTM,64,5,0,0,5,29,35
19950610-W-Roland_Garros-F-Steffi_Graf-Arantxa_Sanchez_Vicario,1,S-DTL,14,3,0,1,2,4,10
19950610-W-Roland_Garros-F-Steffi_Graf-Arantxa_Sanchez_Vicario,1,S-IO,6,2,0,2,0,3,3
19950610-W-Roland_Garros-F-Steffi_Graf-Arantxa_Sanchez_Vicario,2,F-XC,39,7,2,2,3,15,24
19950610-W-Roland_Garros-F-Steffi_Graf-Arantxa_Sanchez_Vicario,2,F-DTM,88,4,0,0,4,32,56
19950610-W-Roland_Garros-F-Steffi_Graf-Arantxa_Sanchez_Vicario,2,F-DTL,7,1,0,1,0,5,2
19950610-W-Roland_Garros-F-Steffi_Graf-Arantxa_Sanchez_Vicario,2,F-IO,8,1,0,0,1,4,4
19950610-W-Roland_Garros-F-Steffi_Graf-Arantxa_Sanchez_Vicario,2,F-II,1,0,0,0,0,1,0
19950610-W-Roland_Garros-F-Steffi_Graf-Arantxa_Sanchez_Vicario,2,B-XC,75,12,2,7,3,36,39
19950610-W-Roland_Garros-F-Steffi_Graf-Arantxa_Sanchez_Vicario,2,B-DTM,63,3,1,0,2,30,33
19950610-W-Roland_Garros-F-Steffi_Graf-Arantxa_Sanchez_Vicario,2,B-DTL,4,3,1,0,2,2,2
19950610-W-Roland_Garros-F-Steffi_Graf-Arantxa_Sanchez_Vicario,2,B-IO,3,3,0,1,2,1,2
19950610-W-Roland_Garros-F-Steffi_Graf-Arantxa_Sanchez_Vicario,2,S-XC,27,1,0,0,1,10,17
19950610-W-Roland_Garros-F-Steffi_Graf-Arantxa_Sanchez_Vicario,2,S-DTM,17,2,0,0,2,9,8
19950610-W-Roland_Garros-F-Steffi_Graf-Arantxa_Sanchez_Vicario,2,S-DTL,3,1,1,0,0,1,2
19950610-W-Roland_Garros-F-Steffi_Graf-Arantxa_Sanchez_Vicario,2,S-IO,2,1,0,1,0,2,0
20090906-W-US_Open-R16-Flavia_Pennetta-Vera_Zvonareva,1,F-XC,144,16,1,2,13,57,87
20090906-W-US_Open-R16-Flavia_Pennetta-Vera_Zvonareva,1,F-DTM,42,3,0,0,3,13,29
20090906-W-US_Open-R16-Flavia_Pennetta-Vera_Zvonareva,1,F-DTL,59,11,4,2,5,27,32
20090906-W-US_Open-R16-Flavia_Pennetta-Vera_Zvonareva,1,F-IO,32,6,1,3,2,17,15
20090906-W-US_Open-R16-Flavia_Pennetta-Vera_Zvonareva,1,F-II,3,3,2,1,0,3,0
20090906-W-US_Open-R16-Flavia_Pennetta-Vera_Zvonareva,1,B-XC,100,9,2,3,4,63,37
20090906-W-US_Open-R16-Flavia_Pennetta-Vera_Zvonareva,1,B-DTM,73,6,0,0,6,29,44
20090906-W-US_Open-R16-Flavia_Pennetta-Vera_Zvonareva,1,B-DTL,38,14,1,4,9,19,19
20090906-W-US_Open-R16-Flavia_Pennetta-Vera_Zvonareva,1,B-IO,5,1,0,0,1,2,3
20090906-W-US_Open-R16-Flavia_Pennetta-Vera_Zvonareva,1,S-XC,2,0,0,0,0,0,2
20090906-W-US_Open-R16-Flavia_Pennetta-Vera_Zvonareva,1,S-DTM,3,0,0,0,0,1,2
20090906-W-US_Open-R16-Flavia_Pennetta-Vera_Zvonareva,1,S-DTL,1,0,0,0,0,0,1
20090906-W-US_Open-R16-Flavia_Pennetta-Vera_Zvonareva,2,F-XC,144,15,4,4,7,90,54
20090906-W-US_Open-R16-Flavia_Pennetta-Vera_Zvonareva,2,F-DTM,28,0,0,0,0,11,17
20090906-W-US_Open-R16-Flavia_Pennetta-Vera_Zvonareva,2,F-DTL,42,8,1,2,5,21,21
20090906-W-US_Open-R16-Flavia_Pennetta-Vera_Zvonareva,2,F-IO,22,7,1,2,4,12,10
20090906-W-US_Open-R16-Flavia_Pennetta-Vera_Zvonareva,2,B-XC,122,10,1,2,7,63,59
20090906-W-US_Open-R16-Flavia_Pennetta-Vera_Zvonareva,2,B-DTM,50,3,0,0,3,27,23
20090906-W-US_Open-R16-Flavia_Pennetta-Vera_Zvonareva,2,B-DTL,43,14,0,1,13,19,24
20090906-W-US_Open-R16-Flavia_Pennetta-Vera_Zvonareva,2,B-IO,29,5,1,1,3,19,10
20090906-W-US_Open-R16-Flavia_Pennetta-Vera_Zvonareva,2,S-XC,2,0,0,0,0,1,1
20090906-W-US_Open-R16-Flavia_Pennetta-Vera_Zvonareva,2,S-DTM,1,0,0,0,0,0,1
20090906-W-US_Open-R16-Flavia_Pennetta-Vera_Zvonareva,2,S-DTL,7,0,0,0,0,5,2
20090906-W-US_Open-R16-Flavia_Pennetta-Vera_Zvonareva,2,S-IO,2,1,0,1,0,2,0
20160916-W-ITF_Biarritz-QF-Carina_Witthoeft-Rebecca_Sramkova,1,F-XC,17,6,4,1,1,10,7
20160916-W-ITF_Biarritz-QF-Carina_Witthoeft-Rebecca_Sramkova,1,F-DTM,9,1,1,0,0,3,6
20160916-W-ITF_Biarritz-QF-Carina_Witthoeft-Rebecca_Sramkova,1,F-DTL,6,2,1,0,1,2,4
20160916-W-ITF_Biarritz-QF-Carina_Witthoeft-Rebecca_Sramkova,1,F-IO,6,3,2,0,1,4,2
20160916-W-ITF_Biarritz-QF-Carina_Witthoeft-Rebecca_Sramkova,1,B-XC,23,2,0,1,1,15,8
20160916-W-ITF_Biarritz-QF-Carina_Witthoeft-Rebecca_Sramkova,1,B-DTM,22,2,0,0,2,7,15
20160916-W-ITF_Biarritz-QF-Carina_Witthoeft-Rebecca_Sramkova,1,B-DTL,7,3,3,0,0,5,2
20160916-W-ITF_Biarritz-QF-Carina_Witthoeft-Rebecca_Sramkova,1,B-IO,1,0,0,0,0,1,0
20160916-W-ITF_Biarritz-QF-Carina_Witthoeft-Rebecca_Sramkova,1,S-XC,2,0,0,0,0,1,1
20160916-W-ITF_Biarritz-QF-Carina_Witthoeft-Rebecca_Sramkova,1,S-DTM,4,0,0,0,0,0,4
20160916-W-ITF_Biarritz-QF-Carina_Witthoeft-Rebecca_Sramkova,1,S-DTL,1,0,0,0,0,0,1
20160916-W-ITF_Biarritz-QF-Carina_Witthoeft-Rebecca_Sramkova,2,F-XC,16,11,8,2,1,12,4
20160916-W-ITF_Biarritz-QF-Carina_Witthoeft-Rebecca_Sramkova,2,F-DTM,2,0,0,0,0,1,1
20160916-W-ITF_Biarritz-QF-Carina_Witthoeft-Rebecca_Sramkova,2,F-DTL,4,0,0,0,0,2,2
20160916-W-ITF_Biarritz-QF-Carina_Witthoeft-Rebecca_Sramkova,2,F-IO,16,10,8,1,1,13,3
20160916-W-ITF_Biarritz-QF-Carina_Witthoeft-Rebecca_Sramkova,2,F-II,1,1,1,0,0,1,0
20160916-W-ITF_Biarritz-QF-Carina_Witthoeft-Rebecca_Sramkova,2,B-XC,16,2,2,0,0,10,6
20160916-W-ITF_Biarritz-QF-Carina_Witthoeft-Rebecca_Sramkova,2,B-DTM,8,0,0,0,0,4,4
20160916-W-ITF_Biarritz-QF-Carina_Witthoeft-Rebecca_Sramkova,2,B-DTL,10,1,0,0,1,7,3
20160916-W-ITF_Biarritz-QF-Carina_Witthoeft-Rebecca_Sramkova,2,B-IO,10,4,1,2,1,7,3
20160916-W-ITF_Biarritz-QF-Carina_Witthoeft-Rebecca_Sramkova,2,S-XC,4,0,0,0,0,1,3
20160916-W-ITF_Biarritz-QF-Carina_Witthoeft-Rebecca_Sramkova,2,S-DTM,2,0,0,0,0,0,2
20160916-W-ITF_Biarritz-QF-Carina_Witthoeft-Rebecca_Sramkova,2,S-DTL,4,2,0,0,2,0,4
20160902-W-US_Open-R32-Elina_Svitolina-Petra_Kvitova,1,F-XC,19,2,1,1,0,12,7
20160902-W-US_Open-R32-Elina_Svitolina-Petra_Kvitova,1,F-DTM,27,2,0,0,2,8,19
20160902-W-US_Open-R32-Elina_Svitolina-Petra_Kvitova,1,F-DTL,2,0,0,0,0,0,2
20160902-W-US_Open-R32-Elina_Svitolina-Petra_Kvitova,1,F-IO,7,5,2,0,3,3,4
20160902-W-US_Open-R32-Elina_Svitolina-Petra_Kvitova,1,F-II,1,1,0,1,0,1,0
20160902-W-US_Open-R32-Elina_Svitolina-Petra_Kvitova,1,B-XC,17,4,2,0,2,6,11
20160902-W-US_Open-R32-Elina_Svitolina-Petra_Kvitova,1,B-DTM,27,3,0,0,3,7,20
20160902-W-US_Open-R32-Elina_Svitolina-Petra_Kvitova,1,B-DTL,3,0,0,0,0,1,2
20160902-W-US_Open-R32-Elina_Svitolina-Petra_Kvitova,1,B-IO,2,1,1,0,0,2,0
20160902-W-US_Open-R32-Elina_Svitolina-Petra_Kvitova,1,S-DTM,4,0,0,0,0,2,2
20160902-W-US_Open-R32-Elina_Svitolina-Petra_Kvitova,1,S-DTL,1,0,0,0,0,0,1
20160902-W-US_Open-R32-Elina_Svitolina-Petra_Kvitova,2,F-XC,36,13,7,0,6,22,14
20160902-W-US_Open-R32-Elina_Svitolina-Petra_Kvitova,2,F-DTM,13,4,0,0,4,6,7
20160902-W-US_Open-R32-Elina_Svitolina-Petra_Kvitova,2,F-DTL,3,0,0,0,0,2,1
20160902-W-US_Open-R32-Elina_Svitolina-Petra_Kvitova,2,F-IO,19,9,5,2,2,14,5
20160902-W-US_Open-R32-Elina_Svitolina-Petra_Kvitova,2,B-XC,15,6,1,1,4,6,9
20160902-W-US_Open-R32-Elina_Svitolina-Petra_Kvitova,2,B-DTM,17,1,0,0,1,10,7
20160902-W-US_Open-R32-Elina_Svitolina-Petra_Kvitova,2,B-DTL,2,2,1,1,0,2,0
20160902-W-US_Open-R32-Elina_Svitolina-Petra_Kvitova,2,B-IO,3,0,0,0,0,3,0
20160902-W-US_Open-R32-Elina_Svitolina-Petra_Kvitova,2,S-XC,1,0,0,0,0,1,0
20160902-W-US_Open-R32-Elina_Svitolina-Petra_Kvitova,2,S-DTM,5,1,0,0,1,2,3
20140114-W-Hobart-QF-Camila_Giorgi-Eugenie_Bouchard,1,F-XC,25,10,3,3,4,15,10
20140114-W-Hobart-QF-Camila_Giorgi-Eugenie_Bouchard,1,F-DTM,19,6,0,0,6,9,10
20140114-W-Hobart-QF-Camila_Giorgi-Eugenie_Bouchard,1,F-DTL,4,3,0,1,2,1,3
20140114-W-Hobart-QF-Camila_Giorgi-Eugenie_Bouchard,1,F-IO,4,2,0,1,1,2,2
20140114-W-Hobart-QF-Camila_Giorgi-Eugenie_Bouchard,1,B-XC,10,5,0,2,3,5,5
20140114-W-Hobart-QF-Camila_Giorgi-Eugenie_Bouchard,1,B-DTM,11,3,0,2,1,7,4
20140114-W-Hobart-QF-Camila_Giorgi-Eugenie_Bouchard,1,B-IO,1,1,1,0,0,1,0
20140114-W-Hobart-QF-Camila_Giorgi-Eugenie_Bouchard,1,S-DTM,1,0,0,0,0,0,1
20140114-W-Hobart-QF-Camila_Giorgi-Eugenie_Bouchard,2,F-XC,17,9,5,1,3,9,8
20140114-W-Hobart-QF-Camila_Giorgi-Eugenie_Bouchard,2,F-DTM,22,1,0,1,0,8,14
20140114-W-Hobart-QF-Camila_Giorgi-Eugenie_Bouchard,2,F-DTL,3,2,1,0,1,1,2
20140114-W-Hobart-QF-Camila_Giorgi-Eugenie_Bouchard,2,F-IO,10,4,1,0,3,4,6
20140114-W-Hobart-QF-Camila_Giorgi-Eugenie_Bouchard,2,B-XC,3,3,1,0,2,1,2
20140114-W-Hobart-QF-Camila_Giorgi-Eugenie_Bouchard,2,B-DTM,12,3,0,0,3,2,10
20140114-W-Hobart-QF-Camila_Giorgi-Eugenie_Bouchard,2,B-DTL,1,0,0,0,0,1,0
20140114-W-Hobart-QF-Camila_Giorgi-Eugenie_Bouchard,2,B-IO,1,1,1,0,0,1,0
20140114-W-Hobart-QF-Camila_Giorgi-Eugenie_Bouchard,2,S-XC,1,0,0,0,0,1,0
20140114-W-Hobart-QF-Camila_Giorgi-Eugenie_Bouchard,2,S-DTM,1,0,0,0,0,1,0
20160526-W-Roland_Garros-R64-Teliana_Pereira-Serena_Williams,1,F-XC,22,5,0,1,4,6,16
20160526-W-Roland_Garros-R64-Teliana_Pereira-Serena_Williams,1,F-DTM,23,3,0,0,3,8,15
20160526-W-Roland_Garros-R64-Teliana_Pereira-Serena_Williams,1,F-DTL,13,2,0,0,2,5,8
20160526-W-Roland_Garros-R64-Teliana_Pereira-Serena_Williams,1,F-IO,14,4,0,0,4,4,10
20160526-W-Roland_Garros-R64-Teliana_Pereira-Serena_Williams,1,B-XC,18,2,0,1,1,7,11
20160526-W-Roland_Garros-R64-Teliana_Pereira-Serena_Williams,1,B-DTM,15,2,0,1,1,5,10
20160526-W-Roland_Garros-R64-Teliana_Pereira-Serena_Williams,1,B-DTL,6,4,2,0,2,3,3
20160526-W-Roland_Garros-R64-Teliana_Pereira-Serena_Williams,1,B-IO,3,0,0,0,0,3,0
20160526-W-Roland_Garros-R64-Teliana_Pereira-Serena_Williams,1,S-XC,9,0,0,0,0,0,9
20160526-W-Roland_Garros-R64-Teliana_Pereira-Serena_Williams,1,S-DTM,6,0,0,0,0,2,4
20160526-W-Roland_Garros-R64-Teliana_Pereira-Serena_Williams,2,F-XC,27,5,1,1,3,15,12
20160526-W-Roland_Garros-R64-Teliana_Pereira-Serena_Williams,2,F-DTM,9,2,1,1,0,8,1
20160526-W-Roland_Garros-R64-Teliana_Pereira-Serena_Williams,2,F-DTL,3,1,1,0,0,2,1
20160526-W-Roland_Garros-R64-Teliana_Pereira-Serena_Williams,2,F-IO,10,5,4,0,1,6,4
20160526-W-Roland_Garros-R64-Teliana_Pereira-Serena_Williams,2,B-XC,31,4,2,0,2,22,9
20160526-W-Roland_Garros-R64-Teliana_Pereira-Serena_Williams,2,B-DTM,16,1,0,0,1,10,6
20160526-W-Roland_Garros-R64-Teliana_Pereira-Serena_Williams,2,B-DTL,14,7,4,1,2,10,4
20160526-W-Roland_Garros-R64-Teliana_Pereira-Serena_Williams,2,B-IO,6,1,0,0,1,4,2
20160526-W-Roland_Garros-R64-Teliana_Pereira-Serena_Williams,2,S-XC,2,0,0,0,0,1,1
20160526-W-Roland_Garros-R64-Teliana_Pereira-Serena_Williams,2,S-DTM,2,0,0,0,0,0,2
20160303-W-Monterrey-R16-Caroline_Wozniacki-Mirjana_Lucic,1,F-XC,27,7,1,4,2,17,10
20160303-W-Monterrey-R16-Caroline_Wozniacki-Mirjana_Lucic,1,F-DTM,18,1,0,0,1,8,10
20160303-W-Monterrey-R16-Caroline_Wozniacki-Mirjana_Lucic,1,F-DTL,10,1,0,1,0,7,3
20160303-W-Monterrey-R16-Caroline_Wozniacki-Mirjana_Lucic,1,F-IO,6,2,0,1,1,4,2
20160303-W-Monterrey-R16-Caroline_Wozniacki-Mirjana_Lucic,1,B-XC,29,4,2,1,1,14,15
20160303-W-Monterrey-R16-Caroline_Wozniacki-Mirjana_Lucic,1,B-DTM,19,1,0,1,0,8,11
20160303-W-Monterrey-R16-Caroline_Wozniacki-Mirjana_Lucic,1,B-DTL,2,0,0,0,0,0,2
20160303-W-Monterrey-R16-Caroline_Wozniacki-Mirjana_Lucic,1,B-IO,3,1,1,0,0,3,0
20160303-W-Monterrey-R16-Caroline_Wozniacki-Mirjana_Lucic,1,S-XC,3,0,0,0,0,2,1
20160303-W-Monterrey-R16-Caroline_Wozniacki-Mirjana_Lucic,1,S-DTM,5,0,0,0,0,1,4
20160303-W-Monterrey-R16-Caroline_Wozniacki-Mirjana_Lucic,2,F-XC,47,14,6,4,4,27,20
20160303-W-Monterrey-R16-Caroline_Wozniacki-Mirjana_Lucic,2,F-DTM,9,1,0,0,1,4,5
20160303-W-Monterrey-R16-Caroline_Wozniacki-Mirjana_Lucic,2,F-DTL,8,7,4,1,2,5,3
20160303-W-Monterrey-R16-Caroline_Wozniacki-Mirjana_Lucic,2,F-IO,11,7,4,1,2,7,4
20160303-W-Monterrey-R16-Caroline_Wozniacki-Mirjana_Lucic,2,B-XC,42,12,3,1,8,20,22
20160303-W-Monterrey-R16-Caroline_Wozniacki-Mirjana_Lucic,2,B-DTM,16,1,0,0,1,7,9
20160303-W-Monterrey-R16-Caroline_Wozniacki-Mirjana_Lucic,2,B-DTL,9,6,2,0,4,5,4
20160303-W-Monterrey-R16-Caroline_Wozniacki-Mirjana_Lucic,2,B-IO,3,2,1,0,1,1,2
20160303-W-Monterrey-R16-Caroline_Wozniacki-Mirjana_Lucic,2,S-XC,1,0,0,0,0,1,0
20160303-W-Monterrey-R16-Caroline_Wozniacki-Mirjana_Lucic,2,S-DTL,1,1,0,0,1,0,1
20160526-W-Roland_Garros-R64-Kristina_Mladenovic-Timea_Babos,1,F-XC,22,9,4,2,3,13,9
20160526-W-Roland_Garros-R64-Kristina_Mladenovic-Timea_Babos,1,F-DTM,3,1,0,1,0,1,2
20160526-W-Roland_Garros-R64-Kristina_Mladenovic-Timea_Babos,1,F-DTL,8,1,0,1,0,5,3
20160526-W-Roland_Garros-R64-Kristina_Mladenovic-Timea_Babos,1,F-IO,24,9,5,1,3,15,9
20160526-W-Roland_Garros-R64-Kristina_Mladenovic-Timea_Babos,1,F-II,4,2,1,1,0,3,1
20160526-W-Roland_Garros-R64-Kristina_Mladenovic-Timea_Babos,1,B-XC,15,4,2,0,2,7,8
20160526-W-Roland_Garros-R64-Kristina_Mladenovic-Timea_Babos,1,B-DTM,20,2,0,0,2,12,8
20160526-W-Roland_Garros-R64-Kristina_Mladenovic-Timea_Babos,1,B-DTL,10,4,2,2,0,7,3
20160526-W-Roland_Garros-R64-Kristina_Mladenovic-Timea_Babos,1,B-IO,2,0,0,0,0,1,1
20160526-W-Roland_Garros-R64-Kristina_Mladenovic-Timea_Babos,1,S-XC,10,1,0,0,1,4,6
20160526-W-Roland_Garros-R64-Kristina_Mladenovic-Timea_Babos,1,S-DTM,8,0,0,0,0,4,4
20160526-W-Roland_Garros-R64-Kristina_Mladenovic-Timea_Babos,1,S-DTL,3,0,0,0,0,1,2
20160526-W-Roland_Garros-R64-Kristina_Mladenovic-Timea_Babos,1,S-IO,1,0,0,0,0,0,1
20160526-W-Roland_Garros-R64-Kristina_Mladenovic-Timea_Babos,2,F-XC,14,8,0,3,5,5,9
20160526-W-Roland_Garros-R64-Kristina_Mladenovic-Timea_Babos,2,F-DTM,9,1,0,0,1,4,5
20160526-W-Roland_Garros-R64-Kristina_Mladenovic-Timea_Babos,2,F-DTL,7,3,0,2,1,4,3
20160526-W-Roland_Garros-R64-Kristina_Mladenovic-Timea_Babos,2,F-IO,13,6,2,1,3,7,6
20160526-W-Roland_Garros-R64-Kristina_Mladenovic-Timea_Babos,2,B-XC,40,5,0,1,4,16,24
20160526-W-Roland_Garros-R64-Kristina_Mladenovic-Timea_Babos,2,B-DTM,17,0,0,0,0,8,9
20160526-W-Roland_Garros-R64-Kristina_Mladenovic-Timea_Babos,2,B-DTL,7,5,3,0,2,3,4
20160526-W-Roland_Garros-R64-Kristina_Mladenovic-Timea_Babos,2,B-IO,2,2,0,1,1,1,1
20160526-W-Roland_Garros-R64-Kristina_Mladenovic-Timea_Babos,2,B-II,1,1,0,1,0,1,0
20160526-W-Roland_Garros-R64-Kristina_Mladenovic-Timea_Babos,2,S-XC,7,0,0,0,0,2,5
20160526-W-Roland_Garros-R64-Kristina_Mladenovic-Timea_Babos,2,S-DTM,6,0,0,0,0,3,3
20160528-W-Roland_Garros-R32-Pauline_Parmentier-Timea_Bacsinszky,1,F-XC,61,8,3,1,4,33,28
20160528-W-Roland_Garros-R32-Pauline_Parmentier-Timea_Bacsinszky,1,F-DTM,18,4,0,0,4,2,16
20160528-W-Roland_Garros-R32-Pauline_Parmentier-Timea_Bacsinszky,1,F-DTL,6,2,0,0,2,3,3
20160528-W-Roland_Garros-R32-Pauline_Parmentier-Timea_Bacsinszky,1,F-IO,6,3,1,2,0,6,0
20160528-W-Roland_Garros-R32-Pauline_Parmentier-Timea_Bacsinszky,1,F-II,5,0,0,0,0,4,1
20160528-W-Roland_Garros-R32-Pauline_Parmentier-Timea_Bacsinszky,1,B-XC,41,7,0,2,5,10,31
20160528-W-Roland_Garros-R32-Pauline_Parmentier-Timea_Bacsinszky,1,B-DTM,31,5,0,0,5,12,19
20160528-W-Roland_Garros-R32-Pauline_Parmentier-Timea_Bacsinszky,1,B-DTL,3,2,0,0,2,1,2
20160528-W-Roland_Garros-R32-Pauline_Parmentier-Timea_Bacsinszky,1,B-IO,2,0,0,0,0,1,1
20160528-W-Roland_Garros-R32-Pauline_Parmentier-Timea_Bacsinszky,1,S-XC,6,2,0,1,1,3,3
20160528-W-Roland_Garros-R32-Pauline_Parmentier-Timea_Bacsinszky,1,S-DTM,9,1,0,0,1,0,9
20160528-W-Roland_Garros-R32-Pauline_Parmentier-Timea_Bacsinszky,1,S-DTL,2,0,0,0,0,1,1
20160528-W-Roland_Garros-R32-Pauline_Parmentier-Timea_Bacsinszky,1,S-IO,1,0,0,0,0,0,1
20160528-W-Roland_Garros-R32-Pauline_Parmentier-Timea_Bacsinszky,2,F-XC,39,11,1,4,6,21,18
20160528-W-Roland_Garros-R32-Pauline_Parmentier-Timea_Bacsinszky,2,F-DTM,16,2,0,0,2,7,9
20160528-W-Roland_Garros-R32-Pauline_Parmentier-Timea_Bacsinszky,2,F-DTL,26,7,2,0,5,17,9
20160528-W-Roland_Garros-R32-Pauline_Parmentier-Timea_Bacsinszky,2,F-IO,14,2,0,0,2,8,6
20160528-W-Roland_Garros-R32-Pauline_Parmentier-Timea_Bacsinszky,2,B-XC,47,6,1,1,4,31,16
20160528-W-Roland_Garros-R32-Pauline_Parmentier-Timea_Bacsinszky,2,B-DTM,13,2,0,2,0,7,6
20160528-W-Roland_Garros-R32-Pauline_Parmentier-Timea_Bacsinszky,2,B-DTL,8,5,3,0,2,6,2
20160528-W-Roland_Garros-R32-Pauline_Parmentier-Timea_Bacsinszky,2,B-IO,13,4,1,2,1,9,4
20160528-W-Roland_Garros-R32-Pauline_Parmentier-Timea_Bacsinszky,2,S-XC,8,0,0,0,0,6,2
20160528-W-Roland_Garros-R32-Pauline_Parmentier-Timea_Bacsinszky,2,S-DTL,2,1,0,0,1,1,1
20160122-W-Australian_Open-R32-Maria_Sharapova-Lauren_Davis,1,F-XC,37,15,6,3,6,21,16
20160122-W-Australian_Open-R32-Maria_Sharapova-Lauren_Davis,1,F-DTM,18,2,0,0,2,9,9
20160122-W-Australian_Open-R32-Maria_Sharapova-Lauren_Davis,1,F-DTL,5,1,0,1,0,5,0
20160122-W-Australian_Open-R32-Maria_Sharapova-Lauren_Davis,1,F-IO,14,10,5,1,4,9,5
20160122-W-Australian_Open-R32-Maria_Sharapova-Lauren_Davis,1,B-XC,15,5,1,2,2,11,4
20160122-W-Australian_Open-R32-Maria_Sharapova-Lauren_Davis,1,B-DTM,30,3,0,0,3,11,19
20160122-W-Australian_Open-R32-Maria_Sharapova-Lauren_Davis,1,B-DTL,3,1,1,0,0,2,1
20160122-W-Australian_Open-R32-Maria_Sharapova-Lauren_Davis,1,B-IO,7,1,1,0,0,2,5
20160122-W-Australian_Open-R32-Maria_Sharapova-Lauren_Davis,2,F-XC,22,10,1,3,6,6,16
20160122-W-Australian_Open-R32-Maria_Sharapova-Lauren_Davis,2,F-DTM,22,2,0,1,1,15,7
20160122-W-Australian_Open-R32-Maria_Sharapova-Lauren_Davis,2,F-DTL,8,2,1,0,1,3,5
20160122-W-Australian_Open-R32-Maria_Sharapova-Lauren_Davis,2,F-IO,14,3,2,0,1,8,6
20160122-W-Australian_Open-R32-Maria_Sharapova-Lauren_Davis,2,B-XC,17,7,2,2,3,12,5
20160122-W-Australian_Open-R32-Maria_Sharapova-Lauren_Davis,2,B-DTM,38,7,0,3,4,18,20
20160122-W-Australian_Open-R32-Maria_Sharapova-Lauren_Davis,2,B-DTL,2,1,0,1,0,1,1
20160122-W-Australian_Open-R32-Maria_Sharapova-Lauren_Davis,2,B-IO,8,4,0,1,3,2,6
20160122-W-Australian_Open-R32-Maria_Sharapova-Lauren_Davis,2,B-II,1,0,0,0,0,0,1
20160122-W-Australian_Open-R32-Maria_Sharapova-Lauren_Davis,2,S-XC,1,1,0,0,1,0,1
20160122-W-Australian_Open-R32-Maria_Sharapova-Lauren_Davis,2,S-DTM,5,0,0,0,0,1,4
20160723-W-Washington-SF-Jessica_Pegula-Lauren_Davis,1,F-XC,31,13,5,3,5,18,13
20160723-W-Washington-SF-Jessica_Pegula-Lauren_Davis,1,F-DTM,31,4,0,0,4,12,19
20160723-W-Washington-SF-Jessica_Pegula-Lauren_Davis,1,F-DTL,6,5,1,2,2,3,3
20160723-W-Washington-SF-Jessica_Pegula-Lauren_Davis,1,F-IO,10,5,2,0,3,4,6
20160723-W-Washington-SF-Jessica_Pegula-Lauren_Davis,1,F-II,1,0,0,0,0,1,0
20160723-W-Washington-SF-Jessica_Pegula-Lauren_Davis,1,B-XC,19,6,0,1,5,7,12
20160723-W-Washington-SF-Jessica_Pegula-Lauren_Davis,1,B-DTM,21,5,0,0,5,8,13
20160723-W-Washington-SF-Jessica_Pegula-Lauren_Davis,1,B-DTL,8,3,2,1,0,5,3
20160723-W-Washington-SF-Jessica_Pegula-Lauren_Davis,1,B-IO,3,1,0,0,1,1,2
20160723-W-Washington-SF-Jessica_Pegula-Lauren_Davis,1,S-XC,1,0,0,0,0,0,1
20160723-W-Washington-SF-Jessica_Pegula-Lauren_Davis,1,S-DTM,2,0,0,0,0,2,0
20160723-W-Washington-SF-Jessica_Pegula-Lauren_Davis,2,F-XC,26,6,2,2,2,14,12
20160723-W-Washington-SF-Jessica_Pegula-Lauren_Davis,2,F-DTM,31,5,0,0,5,15,16
20160723-W-Washington-SF-Jessica_Pegula-Lauren_Davis,2,F-DTL,7,2,0,0,2,2,5
20160723-W-Washington-SF-Jessica_Pegula-Lauren_Davis,2,F-IO,13,3,0,0,3,6,7
20160723-W-Washington-SF-Jessica_Pegula-Lauren_Davis,2,B-XC,14,5,1,2,2,9,5
20160723-W-Washington-SF-Jessica_Pegula-Lauren_Davis,2,B-DTM,19,2,0,0,2,8,11
20160723-W-Washington-SF-Jessica_Pegula-Lauren_Davis,2,B-DTL,4,3,0,2,1,3,1
20160723-W-Washington-SF-Jessica_Pegula-Lauren_Davis,2,B-IO,7,3,2,1,0,5,2
20160723-W-Washington-SF-Jessica_Pegula-Lauren_Davis,2,S-XC,3,1,0,0,1,1,2
20160630-W-Wimbledon-R64-Eugenie_Bouchard-Johanna_Konta,1,F-XC,36,10,3,6,1,24,12
20160630-W-Wimbledon-R64-Eugenie_Bouchard-Johanna_Konta,1,F-DTM,21,3,0,0,3,11,10
20160630-W-Wimbledon-R64-Eugenie_Bouchard-Johanna_Konta,1,F-DTL,13,6,0,3,3,5,8
20160630-W-Wimbledon-R64-Eugenie_Bouchard-Johanna_Konta,1,F-IO,19,6,1,1,4,10,9
20160630-W-Wimbledon-R64-Eugenie_Bouchard-Johanna_Konta,1,B-XC,33,6,3,2,1,21,12
20160630-W-Wimbledon-R64-Eugenie_Bouchard-Johanna_Konta,1,B-DTM,19,2,0,0,2,7,12
20160630-W-Wimbledon-R64-Eugenie_Bouchard-Johanna_Konta,1,B-DTL,10,4,2,1,1,6,4
20160630-W-Wimbledon-R64-Eugenie_Bouchard-Johanna_Konta,1,B-IO,5,4,1,3,0,4,1
20160630-W-Wimbledon-R64-Eugenie_Bouchard-Johanna_Konta,1,S-XC,2,0,0,0,0,1,1
20160630-W-Wimbledon-R64-Eugenie_Bouchard-Johanna_Konta,1,S-DTM,7,0,0,0,0,3,4
20160630-W-Wimbledon-R64-Eugenie_Bouchard-Johanna_Konta,2,F-XC,54,13,3,5,5,27,27
20160630-W-Wimbledon-R64-Eugenie_Bouchard-Johanna_Konta,2,F-DTM,12,2,0,0,2,6,6
20160630-W-Wimbledon-R64-Eugenie_Bouchard-Johanna_Konta,2,F-DTL,4,1,0,0,1,0,4
20160630-W-Wimbledon-R64-Eugenie_Bouchard-Johanna_Konta,2,F-IO,16,7,3,3,1,10,6
20160630-W-Wimbledon-R64-Eugenie_Bouchard-Johanna_Konta,2,B-XC,36,13,9,1,3,25,11
20160630-W-Wimbledon-R64-Eugenie_Bouchard-Johanna_Konta,2,B-DTM,29,4,0,2,2,10,19
20160630-W-Wimbledon-R64-Eugenie_Bouchard-Johanna_Konta,2,B-DTL,6,4,2,2,0,4,2
20160630-W-Wimbledon-R64-Eugenie_Bouchard-Johanna_Konta,2,B-IO,2,0,0,0,0,1,1
20160630-W-Wimbledon-R64-Eugenie_Bouchard-Johanna_Konta,2,S-XC,4,0,0,0,0,0,4
20160630-W-Wimbledon-R64-Eugenie_Bouchard-Johanna_Konta,2,S-DTM,8,0,0,0,0,2,6
20160118-W-Australian_Open-R128-Carina_Witthoeft-Saisai_Zheng,1,F-XC,38,8,2,0,6,15,23
20160118-W-Australian_Open-R128-Carina_Witthoeft-Saisai_Zheng,1,F-DTM,12,1,0,0,1,1,11
20160118-W-Australian_Open-R128-Carina_Witthoeft-Saisai_Zheng,1,F-DTL,8,5,2,0,3,4,4
20160118-W-Australian_Open-R128-Carina_Witthoeft-Saisai_Zheng,1,F-IO,30,9,4,1,4,13,17
20160118-W-Australian_Open-R128-Carina_Witthoeft-Saisai_Zheng,1,F-II,2,1,0,0,1,1,1
20160118-W-Australian_Open-R128-Carina_Witthoeft-Saisai_Zheng,1,B-XC,30,6,0,0,6,9,21
20160118-W-Australian_Open-R128-Carina_Witthoeft-Saisai_Zheng,1,B-DTM,18,0,0,0,0,7,11
20160118-W-Australian_Open-R128-Carina_Witthoeft-Saisai_Zheng,1,B-DTL,10,2,0,0,2,1,9
20160118-W-Australian_Open-R128-Carina_Witthoeft-Saisai_Zheng,1,B-IO,9,1,0,0,1,1,8
20160118-W-Australian_Open-R128-Carina_Witthoeft-Saisai_Zheng,1,S-XC,1,0,0,0,0,1,0
20160118-W-Australian_Open-R128-Carina_Witthoeft-Saisai_Zheng,1,S-DTL,1,0,0,0,0,1,0
20160118-W-Australian_Open-R128-Carina_Witthoeft-Saisai_Zheng,1,S-IO,1,0,0,0,0,0,1
20160118-W-Australian_Open-R128-Carina_Witthoeft-Saisai_Zheng,2,F-XC,20,3,2,0,1,13,7
20160118-W-Australian_Open-R128-Carina_Witthoeft-Saisai_Zheng,2,F-DTM,33,2,0,0,2,21,12
20160118-W-Australian_Open-R128-Carina_Witthoeft-Saisai_Zheng,2,F-DTL,17,5,1,3,1,11,6
20160118-W-Australian_Open-R128-Carina_Witthoeft-Saisai_Zheng,2,F-IO,10,2,1,0,1,8,2
20160118-W-Australian_Open-R128-Carina_Witthoeft-Saisai_Zheng,2,F-II,1,1,1,0,0,1,0
20160118-W-Australian_Open-R128-Carina_Witthoeft-Saisai_Zheng,2,B-XC,10,4,2,1,1,8,2
20160118-W-Australian_Open-R128-Carina_Witthoeft-Saisai_Zheng,2,B-DTM,25,1,0,0,1,15,10
20160118-W-Australian_Open-R128-Carina_Witthoeft-Saisai_Zheng,2,B-DTL,8,5,1,2,2,5,3
20160118-W-Australian_Open-R128-Carina_Witthoeft-Saisai_Zheng,2,B-IO,2,0,0,0,0,0,2
20160118-W-Australian_Open-R128-Carina_Witthoeft-Saisai_Zheng,2,S-XC,16,1,0,0,1,10,6
20160118-W-Australian_Open-R128-Carina_Witthoeft-Saisai_Zheng,2,S-DTM,7,1,0,0,1,4,3
20160118-W-Australian_Open-R128-Carina_Witthoeft-Saisai_Zheng,2,S-DTL,2,1,0,1,0,2,0
20160827-W-New_Haven-F-Agnieszka_Radwanska-Elina_Svitolina,1,F-XC,60,9,4,3,2,31,29
20160827-W-New_Haven-F-Agnieszka_Radwanska-Elina_Svitolina,1,F-DTM,31,1,0,0,1,17,14
20160827-W-New_Haven-F-Agnieszka_Radwanska-Elina_Svitolina,1,F-DTL,14,5,1,1,3,8,6
20160827-W-New_Haven-F-Agnieszka_Radwanska-Elina_Svitolina,1,F-IO,26,8,1,3,4,14,12
20160827-W-New_Haven-F-Agnieszka_Radwanska-Elina_Svitolina,1,B-XC,46,0,0,0,0,24,22
20160827-W-New_Haven-F-Agnieszka_Radwanska-Elina_Svitolina,1,B-DTM,37,0,0,0,0,21,16
20160827-W-New_Haven-F-Agnieszka_Radwanska-Elina_Svitolina,1,B-DTL,5,2,1,0,1,2,3
20160827-W-New_Haven-F-Agnieszka_Radwanska-Elina_Svitolina,1,B-IO,4,0,0,0,0,2,2
20160827-W-New_Haven-F-Agnieszka_Radwanska-Elina_Svitolina,1,S-XC,6,1,0,0,1,2,4
20160827-W-New_Haven-F-Agnieszka_Radwanska-Elina_Svitolina,1,S-DTM,14,0,0,0,0,10,4
20160827-W-New_Haven-F-Agnieszka_Radwanska-Elina_Svitolina,1,S-DTL,2,1,0,1,0,2,0
20160827-W-New_Haven-F-Agnieszka_Radwanska-Elina_Svitolina,1,S-IO,2,1,0,0,1,0,2
20160827-W-New_Haven-F-Agnieszka_Radwanska-Elina_Svitolina,2,F-XC,66,7,1,1,5,30,36
20160827-W-New_Haven-F-Agnieszka_Radwanska-Elina_Svitolina,2,F-DTM,22,2,0,0,2,9,13
20160827-W-New_Haven-F-Agnieszka_Radwanska-Elina_Svitolina,2,F-DTL,13,5,2,0,3,8,5
20160827-W-New_Haven-F-Agnieszka_Radwanska-Elina_Svitolina,2,F-IO,22,6,2,0,4,10,12
20160827-W-New_Haven-F-Agnieszka_Radwanska-Elina_Svitolina,2,F-II,1,0,0,0,0,0,1
20160827-W-New_Haven-F-Agnieszka_Radwanska-Elina_Svitolina,2,B-XC,62,6,1,1,4,25,37
20160827-W-New_Haven-F-Agnieszka_Radwanska-Elina_Svitolina,2,B-DTM,32,4,1,2,1,14,18
20160827-W-New_Haven-F-Agnieszka_Radwanska-Elina_Svitolina,2,B-DTL,14,4,0,3,1,8,6
20160827-W-New_Haven-F-Agnieszka_Radwanska-Elina_Svitolina,2,B-IO,7,4,0,0,4,3,4
20160827-W-New_Haven-F-Agnieszka_Radwanska-Elina_Svitolina,2,S-XC,11,0,0,0,0,3,8
20160827-W-New_Haven-F-Agnieszka_Radwanska-Elina_Svitolina,2,S-DTM,9,1,0,0,1,2,7
20160928-W-Wuhan-R16-Petra_Kvitova-Angelique_Kerber,1,F-XC,116,35,12,11,12,66,50
20160928-W-Wuhan-R16-Petra_Kvitova-Angelique_Kerber,1,F-DTM,29,5,1,0,4,11,18
20160928-W-Wuhan-R16-Petra_Kvitova-Angelique_Kerber,1,F-DTL,25,20,8,7,5,19,6
20160928-W-Wuhan-R16-Petra_Kvitova-Angelique_Kerber,1,F-IO,37,12,3,1,8,19,18
20160928-W-Wuhan-R16-Petra_Kvitova-Angelique_Kerber,1,F-II,3,3,2,0,1,2,1
20160928-W-Wuhan-R16-Petra_Kvitova-Angelique_Kerber,1,B-XC,92,17,3,4,10,33,59
20160928-W-Wuhan-R16-Petra_Kvitova-Angelique_Kerber,1,B-DTM,30,9,0,2,7,6,24
20160928-W-Wuhan-R16-Petra_Kvitova-Angelique_Kerber,1,B-DTL,15,8,3,0,5,4,11
20160928-W-Wuhan-R16-Petra_Kvitova-Angelique_Kerber,1,B-IO,15,6,3,0,3,7,8
20160928-W-Wuhan-R16-Petra_Kvitova-Angelique_Kerber,1,S-XC,12,1,0,0,1,5,7
20160928-W-Wuhan-R16-Petra_Kvitova-Angelique_Kerber,1,S-DTM,11,1,0,1,0,5,6
20160928-W-Wuhan-R16-Petra_Kvitova-Angelique_Kerber,1,S-DTL,3,0,0,0,0,1,2
20160928-W-Wuhan-R16-Petra_Kvitova-Angelique_Kerber,1,S-IO,1,0,0,0,0,1,0
20160928-W-Wuhan-R16-Petra_Kvitova-Angelique_Kerber,2,F-XC,109,17,4,6,7,59,50
20160928-W-Wuhan-R16-Petra_Kvitova-Angelique_Kerber,2,F-DTM,30,3,0,0,3,14,16
20160928-W-Wuhan-R16-Petra_Kvitova-Angelique_Kerber,2,F-DTL,27,10,5,3,2,16,11
20160928-W-Wuhan-R16-Petra_Kvitova-Angelique_Kerber,2,F-IO,18,5,2,2,1,13,5
20160928-W-Wuhan-R16-Petra_Kvitova-Angelique_Kerber,2,B-XC,72,7,1,3,3,51,21
20160928-W-Wuhan-R16-Petra_Kvitova-Angelique_Kerber,2,B-DTM,48,3,0,0,3,25,23
20160928-W-Wuhan-R16-Petra_Kvitova-Angelique_Kerber,2,B-DTL,9,3,0,0,3,2,7
20160928-W-Wuhan-R16-Petra_Kvitova-Angelique_Kerber,2,B-IO,5,2,2,0,0,4,1
20160928-W-Wuhan-R16-Petra_Kvitova-Angelique_Kerber,2,S-XC,10,2,0,0,2,4,6
20160928-W-Wuhan-R16-Petra_Kvitova-Angelique_Kerber,2,S-DTM,11,2,0,1,1,6,5
20160928-W-Wuhan-R16-Petra_Kvitova-Angelique_Kerber,2,S-DTL,2,0,0,0,0,1,1
20130118-W-Australian_Open-R32-Venus_Williams-Maria_Sharapova,1,F-XC,21,10,1,2,7,8,13
20130118-W-Australian_Open-R32-Venus_Williams-Maria_Sharapova,1,F-DTM,15,2,0,0,2,5,10
20130118-W-Australian_Open-R32-Venus_Williams-Maria_Sharapova,1,F-DTL,11,5,1,1,3,5,6
20130118-W-Australian_Open-R32-Venus_Williams-Maria_Sharapova,1,F-IO,10,4,1,0,3,5,5
20130118-W-Australian_Open-R32-Venus_Williams-Maria_Sharapova,1,B-XC,21,1,0,1,0,9,12
20130118-W-Australian_Open-R32-Venus_Williams-Maria_Sharapova,1,B-DTM,11,1,0,0,1,4,7
20130118-W-Australian_Open-R32-Venus_Williams-Maria_Sharapova,1,B-DTL,8,1,0,0,1,2,6
20130118-W-Australian_Open-R32-Venus_Williams-Maria_Sharapova,1,B-IO,3,0,0,0,0,1,2
20130118-W-Australian_Open-R32-Venus_Williams-Maria_Sharapova,1,S-XC,1,0,0,0,0,1,0
20130118-W-Australian_Open-R32-Venus_Williams-Maria_Sharapova,1,S-DTM,1,0,0,0,0,1,0
20130118-W-Australian_Open-R32-Venus_Williams-Maria_Sharapova,2,F-XC,29,10,2,6,2,19,10
20130118-W-Australian_Open-R32-Venus_Williams-Maria_Sharapova,2,F-DTM,6,0,0,0,0,4,2
20130118-W-Australian_Open-R32-Venus_Williams-Maria_Sharapova,2,F-DTL,9,5,3,0,2,6,3
20130118-W-Australian_Open-R32-Venus_Williams-Maria_Sharapova,2,F-IO,12,5,0,2,3,6,6
20130118-W-Australian_Open-R32-Venus_Williams-Maria_Sharapova,2,F-II,1,0,0,0,0,1,0
20130118-W-Australian_Open-R32-Venus_Williams-Maria_Sharapova,2,B-XC,21,3,0,0,3,12,9
20130118-W-Australian_Open-R32-Venus_Williams-Maria_Sharapova,2,B-DTM,14,3,0,1,2,7,7
20130118-W-Australian_Open-R32-Venus_Williams-Maria_Sharapova,2,B-DTL,9,4,1,1,2,5,4
20130118-W-Australian_Open-R32-Venus_Williams-Maria_Sharapova,2,B-IO,3,0,0,0,0,2,1
20130118-W-Australian_Open-R32-Venus_Williams-Maria_Sharapova,2,S-XC,1,0,0,0,0,0,1
20130118-W-Australian_Open-R32-Venus_Williams-Maria_Sharapova,2,S-DTM,1,0,0,0,0,0,1
20130606-W-Roland_Garros-SF-Maria_Sharapova-Victoria_Azarenka,1,F-XC,44,18,5,6,7,21,23
20130606-W-Roland_Garros-SF-Maria_Sharapova-Victoria_Azarenka,1,F-DTM,13,3,0,1,2,8,5
20130606-W-Roland_Garros-SF-Maria_Sharapova-Victoria_Azarenka,1,F-DTL,10,7,5,0,2,7,3
20130606-W-Roland_Garros-SF-Maria_Sharapova-Victoria_Azarenka,1,F-IO,12,7,6,1,0,10,2
20130606-W-Roland_Garros-SF-Maria_Sharapova-Victoria_Azarenka,1,B-XC,52,15,6,2,7,27,25
20130606-W-Roland_Garros-SF-Maria_Sharapova-Victoria_Azarenka,1,B-DTM,28,5,0,3,2,15,13
20130606-W-Roland_Garros-SF-Maria_Sharapova-Victoria_Azarenka,1,B-DTL,10,5,3,0,2,5,5
20130606-W-Roland_Garros-SF-Maria_Sharapova-Victoria_Azarenka,1,B-IO,7,1,0,0,1,2,5
20130606-W-Roland_Garros-SF-Maria_Sharapova-Victoria_Azarenka,1,S-XC,2,0,0,0,0,1,1
20130606-W-Roland_Garros-SF-Maria_Sharapova-Victoria_Azarenka,1,S-DTM,1,1,0,0,1,0,1
20130606-W-Roland_Garros-SF-Maria_Sharapova-Victoria_Azarenka,1,S-DTL,2,0,0,0,0,1,1
20130606-W-Roland_Garros-SF-Maria_Sharapova-Victoria_Azarenka,2,F-XC,33,15,3,8,4,20,13
20130606-W-Roland_Garros-SF-Maria_Sharapova-Victoria_Azarenka,2,F-DTM,17,0,0,0,0,9,8
20130606-W-Roland_Garros-SF-Maria_Sharapova-Victoria_Azarenka,2,F-DTL,11,1,0,1,0,7,4
20130606-W-Roland_Garros-SF-Maria_Sharapova-Victoria_Azarenka,2,F-IO,20,6,2,0,4,7,13
20130606-W-Roland_Garros-SF-Maria_Sharapova-Victoria_Azarenka,2,B-XC,31,4,0,1,3,12,19
20130606-W-Roland_Garros-SF-Maria_Sharapova-Victoria_Azarenka,2,B-DTM,24,3,0,1,2,12,12
20130606-W-Roland_Garros-SF-Maria_Sharapova-Victoria_Azarenka,2,B-DTL,9,3,0,2,1,4,5
20130606-W-Roland_Garros-SF-Maria_Sharapova-Victoria_Azarenka,2,B-IO,12,2,1,1,0,6,6
20130606-W-Roland_Garros-SF-Maria_Sharapova-Victoria_Azarenka,2,S-XC,1,1,0,0,1,0,1
20130606-W-Roland_Garros-SF-Maria_Sharapova-Victoria_Azarenka,2,S-DTM,1,0,0,0,0,0,1
20130606-W-Roland_Garros-SF-Maria_Sharapova-Victoria_Azarenka,2,S-DTL,2,0,0,0,0,1,1
20070607-W-Roland_Garros-SF-Ana_Ivanovic-Maria_Sharapova,1,F-XC,16,5,1,2,2,10,6
20070607-W-Roland_Garros-SF-Ana_Ivanovic-Maria_Sharapova,1,F-DTM,6,0,0,0,0,4,2
20070607-W-Roland_Garros-SF-Ana_Ivanovic-Maria_Sharapova,1,F-DTL,9,4,3,0,1,7,2
20070607-W-Roland_Garros-SF-Ana_Ivanovic-Maria_Sharapova,1,F-IO,13,6,2,1,3,7,6
20070607-W-Roland_Garros-SF-Ana_Ivanovic-Maria_Sharapova,1,B-XC,17,3,1,0,2,8,9
20070607-W-Roland_Garros-SF-Ana_Ivanovic-Maria_Sharapova,1,B-DTM,15,1,0,0,1,10,5
20070607-W-Roland_Garros-SF-Ana_Ivanovic-Maria_Sharapova,1,B-DTL,8,2,0,2,0,7,1
20070607-W-Roland_Garros-SF-Ana_Ivanovic-Maria_Sharapova,1,B-IO,2,1,0,1,0,2,0
20070607-W-Roland_Garros-SF-Ana_Ivanovic-Maria_Sharapova,1,S-XC,7,0,0,0,0,5,2
20070607-W-Roland_Garros-SF-Ana_Ivanovic-Maria_Sharapova,1,S-DTM,4,0,0,0,0,4,0
20070607-W-Roland_Garros-SF-Ana_Ivanovic-Maria_Sharapova,1,S-DTL,3,0,0,0,0,2,1
20070607-W-Roland_Garros-SF-Ana_Ivanovic-Maria_Sharapova,2,F-XC,23,8,0,3,5,7,16
20070607-W-Roland_Garros-SF-Ana_Ivanovic-Maria_Sharapova,2,F-DTM,9,3,0,0,3,2,7
20070607-W-Roland_Garros-SF-Ana_Ivanovic-Maria_Sharapova,2,F-DTL,7,3,2,0,1,4,3
20070607-W-Roland_Garros-SF-Ana_Ivanovic-Maria_Sharapova,2,F-IO,10,3,1,1,1,4,6
20070607-W-Roland_Garros-SF-Ana_Ivanovic-Maria_Sharapova,2,F-II,2,0,0,0,0,1,1
20070607-W-Roland_Garros-SF-Ana_Ivanovic-Maria_Sharapova,2,B-XC,28,5,0,1,4,11,17
20070607-W-Roland_Garros-SF-Ana_Ivanovic-Maria_Sharapova,2,B-DTM,12,0,0,0,0,6,6
20070607-W-Roland_Garros-SF-Ana_Ivanovic-Maria_Sharapova,2,B-DTL,8,4,2,0,2,3,5
20070607-W-Roland_Garros-SF-Ana_Ivanovic-Maria_Sharapova,2,B-IO,3,3,0,0,3,0,3
20070607-W-Roland_Garros-SF-Ana_Ivanovic-Maria_Sharapova,2,S-XC,2,0,0,0,0,1,1
20130120-W-Australian_Open-R16-Serena_Williams-Maria_Kirilenko,1,F-XC,19,5,2,2,1,11,8
20130120-W-Australian_Open-R16-Serena_Williams-Maria_Kirilenko,1,F-DTM,5,1,0,1,0,3,2
20130120-W-Australian_Open-R16-Serena_Williams-Maria_Kirilenko,1,F-DTL,6,3,2,0,1,3,3
20130120-W-Australian_Open-R16-Serena_Williams-Maria_Kirilenko,1,F-IO,9,2,2,0,0,9,0
20130120-W-Australian_Open-R16-Serena_Williams-Maria_Kirilenko,1,B-XC,19,3,1,2,0,13,6
20130120-W-Australian_Open-R16-Serena_Williams-Maria_Kirilenko,1,B-DTM,15,1,0,0,1,9,6
20130120-W-Australian_Open-R16-Serena_Williams-Maria_Kirilenko,1,B-DTL,6,3,1,2,0,4,2
20130120-W-Australian_Open-R16-Serena_Williams-Maria_Kirilenko,1,B-IO,4,3,1,1,1,3,1
20130120-W-Australian_Open-R16-Serena_Williams-Maria_Kirilenko,2,F-XC,13,5,2,1,2,7,6
20130120-W-Australian_Open-R16-Serena_Williams-Maria_Kirilenko,2,F-DTM,10,0,0,0,0,4,6
20130120-W-Australian_Open-R16-Serena_Williams-Maria_Kirilenko,2,F-DTL,8,3,0,1,2,3,5
20130120-W-Australian_Open-R16-Serena_Williams-Maria_Kirilenko,2,F-IO,9,2,1,0,1,3,6
20130120-W-Australian_Open-R16-Serena_Williams-Maria_Kirilenko,2,B-XC,20,4,1,0,3,6,14
20130120-W-Australian_Open-R16-Serena_Williams-Maria_Kirilenko,2,B-DTM,12,1,0,0,1,1,11
20130120-W-Australian_Open-R16-Serena_Williams-Maria_Kirilenko,2,B-DTL,5,1,0,1,0,3,2
20130120-W-Australian_Open-R16-Serena_Williams-Maria_Kirilenko,2,S-XC,3,1,0,0,1,1,2
20130120-W-Australian_Open-R16-Serena_Williams-Maria_Kirilenko,2,S-DTM,6,1,1,0,0,3,3
20110123-W-Australian_Open-R16-Andrea_Petkovic-Maria_Sharapova,1,F-XC,46,9,5,2,2,29,17
20110123-W-Australian_Open-R16-Andrea_Petkovic-Maria_Sharapova,1,F-DTM,14,1,0,0,1,7,7
20110123-W-Australian_Open-R16-Andrea_Petkovic-Maria_Sharapova,1,F-DTL,7,2,1,1,0,5,2
20110123-W-Australian_Open-R16-Andrea_Petkovic-Maria_Sharapova,1,F-IO,6,2,1,0,1,2,4
20110123-W-Australian_Open-R16-Andrea_Petkovic-Maria_Sharapova,1,B-XC,22,6,1,4,1,13,9
20110123-W-Australian_Open-R16-Andrea_Petkovic-Maria_Sharapova,1,B-DTM,19,2,0,0,2,6,13
20110123-W-Australian_Open-R16-Andrea_Petkovic-Maria_Sharapova,1,B-DTL,4,1,0,1,0,1,3
20110123-W-Australian_Open-R16-Andrea_Petkovic-Maria_Sharapova,1,B-IO,4,2,0,1,1,3,1
20110123-W-Australian_Open-R16-Andrea_Petkovic-Maria_Sharapova,1,S-XC,3,1,0,1,0,3,0
20110123-W-Australian_Open-R16-Andrea_Petkovic-Maria_Sharapova,1,S-DTM,2,0,0,0,0,2,0
20110123-W-Australian_Open-R16-Andrea_Petkovic-Maria_Sharapova,1,S-DTL,1,0,0,0,0,0,1
20110123-W-Australian_Open-R16-Andrea_Petkovic-Maria_Sharapova,2,F-XC,34,10,1,4,5,15,19
20110123-W-Australian_Open-R16-Andrea_Petkovic-Maria_Sharapova,2,F-DTM,19,2,1,0,1,11,8
20110123-W-Australian_Open-R16-Andrea_Petkovic-Maria_Sharapova,2,F-DTL,12,4,1,2,1,6,6
20110123-W-Australian_Open-R16-Andrea_Petkovic-Maria_Sharapova,2,F-IO,11,5,2,0,3,4,7
20110123-W-Australian_Open-R16-Andrea_Petkovic-Maria_Sharapova,2,B-XC,27,8,0,1,7,14,13
20110123-W-Australian_Open-R16-Andrea_Petkovic-Maria_Sharapova,2,B-DTM,15,2,0,1,1,5,10
20110123-W-Australian_Open-R16-Andrea_Petkovic-Maria_Sharapova,2,B-DTL,4,0,0,0,0,2,2
20110123-W-Australian_Open-R16-Andrea_Petkovic-Maria_Sharapova,2,B-IO,7,2,2,0,0,4,3
20121024-W-WTA_Championships-RR-Agnieszka_Radwanska-Maria_Sharapova,1,F-XC,56,11,4,2,5,30,26
20121024-W-WTA_Championships-RR-Agnieszka_Radwanska-Maria_Sharapova,1,F-DTM,70,4,2,0,2,29,41
20121024-W-WTA_Championships-RR-Agnieszka_Radwanska-Maria_Sharapova,1,F-DTL,15,4,1,0,3,6,9
20121024-W-WTA_Championships-RR-Agnieszka_Radwanska-Maria_Sharapova,1,F-IO,20,8,2,3,3,13,7
20121024-W-WTA_Championships-RR-Agnieszka_Radwanska-Maria_Sharapova,1,B-XC,41,2,0,0,2,18,23
20121024-W-WTA_Championships-RR-Agnieszka_Radwanska-Maria_Sharapova,1,B-DTM,64,4,0,2,2,32,32
20121024-W-WTA_Championships-RR-Agnieszka_Radwanska-Maria_Sharapova,1,B-DTL,9,2,0,1,1,3,6
20121024-W-WTA_Championships-RR-Agnieszka_Radwanska-Maria_Sharapova,1,B-IO,4,0,0,0,0,3,1
20121024-W-WTA_Championships-RR-Agnieszka_Radwanska-Maria_Sharapova,1,S-XC,10,1,1,0,0,4,6
20121024-W-WTA_Championships-RR-Agnieszka_Radwanska-Maria_Sharapova,1,S-DTM,18,2,0,0,2,9,9
20121024-W-WTA_Championships-RR-Agnieszka_Radwanska-Maria_Sharapova,1,S-DTL,1,0,0,0,0,0,1
20121024-W-WTA_Championships-RR-Agnieszka_Radwanska-Maria_Sharapova,1,S-IO,1,0,0,0,0,0,1
20121024-W-WTA_Championships-RR-Agnieszka_Radwanska-Maria_Sharapova,2,F-XC,83,17,8,4,5,52,31
20121024-W-WTA_Championships-RR-Agnieszka_Radwanska-Maria_Sharapova,2,F-DTM,33,0,0,0,0,12,21
20121024-W-WTA_Championships-RR-Agnieszka_Radwanska-Maria_Sharapova,2,F-DTL,19,8,2,2,4,10,9
20121024-W-WTA_Championships-RR-Agnieszka_Radwanska-Maria_Sharapova,2,F-IO,57,20,14,0,6,38,19
20121024-W-WTA_Championships-RR-Agnieszka_Radwanska-Maria_Sharapova,2,F-II,2,1,1,0,0,2,0
20121024-W-WTA_Championships-RR-Agnieszka_Radwanska-Maria_Sharapova,2,B-XC,71,17,9,1,7,42,29
20121024-W-WTA_Championships-RR-Agnieszka_Radwanska-Maria_Sharapova,2,B-DTM,32,3,0,0,3,17,15
20121024-W-WTA_Championships-RR-Agnieszka_Radwanska-Maria_Sharapova,2,B-DTL,19,5,1,0,3,13,6
20121024-W-WTA_Championships-RR-Agnieszka_Radwanska-Maria_Sharapova,2,B-IO,14,4,1,1,2,3,11
20121024-W-WTA_Championships-RR-Agnieszka_Radwanska-Maria_Sharapova,2,S-DTM,2,0,0,0,0,0,2
20121024-W-WTA_Championships-RR-Agnieszka_Radwanska-Maria_Sharapova,2,S-DTL,2,0,0,0,0,0,2
20150203-W-ITF_Midland-R32-Louisa_Chirico-Maria_Sakkari,1,F-XC,45,22,8,3,11,27,18
20150203-W-ITF_Midland-R32-Louisa_Chirico-Maria_Sakkari,1,F-DTM,27,1,0,0,1,14,13
20150203-W-ITF_Midland-R32-Louisa_Chirico-Maria_Sakkari,1,F-DTL,13,4,1,1,2,8,5
20150203-W-ITF_Midland-R32-Louisa_Chirico-Maria_Sakkari,1,F-IO,25,4,1,0,3,12,13
20150203-W-ITF_Midland-R32-Louisa_Chirico-Maria_Sakkari,1,B-XC,29,8,3,2,3,17,12
20150203-W-ITF_Midland-R32-Louisa_Chirico-Maria_Sakkari,1,B-DTM,24,4,0,0,4,13,11
20150203-W-ITF_Midland-R32-Louisa_Chirico-Maria_Sakkari,1,B-DTL,9,5,1,3,1,6,3
20150203-W-ITF_Midland-R32-Louisa_Chirico-Maria_Sakkari,1,B-IO,3,1,0,0,1,1,2
20150203-W-ITF_Midland-R32-Louisa_Chirico-Maria_Sakkari,1,S-XC,4,0,0,0,0,3,1
20150203-W-ITF_Midland-R32-Louisa_Chirico-Maria_Sakkari,1,S-DTM,4,0,0,0,0,1,3
20150203-W-ITF_Midland-R32-Louisa_Chirico-Maria_Sakkari,2,F-XC,37,16,4,3,9,15,22
20150203-W-ITF_Midland-R32-Louisa_Chirico-Maria_Sakkari,2,F-DTM,20,0,0,0,0,9,11
20150203-W-ITF_Midland-R32-Louisa_Chirico-Maria_Sakkari,2,F-DTL,9,3,0,1,2,3,6
20150203-W-ITF_Midland-R32-Louisa_Chirico-Maria_Sakkari,2,F-IO,11,1,0,0,1,3,8
20150203-W-ITF_Midland-R32-Louisa_Chirico-Maria_Sakkari,2,F-II,5,2,1,0,1,1,4
20150203-W-ITF_Midland-R32-Louisa_Chirico-Maria_Sakkari,2,B-XC,32,8,2,0,6,14,18
20150203-W-ITF_Midland-R32-Louisa_Chirico-Maria_Sakkari,2,B-DTM,41,4,0,0,4,19,22
20150203-W-ITF_Midland-R32-Louisa_Chirico-Maria_Sakkari,2,B-DTL,2,1,1,0,0,2,0
20150203-W-ITF_Midland-R32-Louisa_Chirico-Maria_Sakkari,2,B-IO,4,0,0,0,0,2,2
20150203-W-ITF_Midland-R32-Louisa_Chirico-Maria_Sakkari,2,S-XC,1,0,0,0,0,0,1
20150203-W-ITF_Midland-R32-Louisa_Chirico-Maria_Sakkari,2,S-DTM,3,0,0,0,0,0,3
20141020-W-ITF_Macon-QF-Irina_Falconi-Madison_Brengle,1,F-XC,46,2,1,0,1,30,16
20141020-W-ITF_Macon-QF-Irina_Falconi-Madison_Brengle,1,F-DTM,15,1,0,0,1,8,7
20141020-W-ITF_Macon-QF-Irina_Falconi-Madison_Brengle,1,F-DTL,29,8,3,2,3,23,6
20141020-W-ITF_Macon-QF-Irina_Falconi-Madison_Brengle,1,F-IO,21,8,4,1,3,13,8
20141020-W-ITF_Macon-QF-Irina_Falconi-Madison_Brengle,1,F-II,1,1,1,0,0,1,0
20141020-W-ITF_Macon-QF-Irina_Falconi-Madison_Brengle,1,B-XC,31,9,3,1,5,19,12
20141020-W-ITF_Macon-QF-Irina_Falconi-Madison_Brengle,1,B-DTM,20,0,0,0,0,13,7
20141020-W-ITF_Macon-QF-Irina_Falconi-Madison_Brengle,1,B-DTL,42,13,5,1,7,27,15
20141020-W-ITF_Macon-QF-Irina_Falconi-Madison_Brengle,1,B-IO,6,2,1,0,1,3,3
20141020-W-ITF_Macon-QF-Irina_Falconi-Madison_Brengle,1,S-XC,19,0,0,0,0,16,3
20141020-W-ITF_Macon-QF-Irina_Falconi-Madison_Brengle,1,S-DTM,10,0,0,0,0,10,0
20141020-W-ITF_Macon-QF-Irina_Falconi-Madison_Brengle,1,S-DTL,8,0,0,0,0,8,0
20141020-W-ITF_Macon-QF-Irina_Falconi-Madison_Brengle,1,S-IO,2,0,0,0,0,2,0
20141020-W-ITF_Macon-QF-Irina_Falconi-Madison_Brengle,2,F-XC,65,5,2,0,3,22,43
20141020-W-ITF_Macon-QF-Irina_Falconi-Madison_Brengle,2,F-DTM,15,0,0,0,0,6,9
20141020-W-ITF_Macon-QF-Irina_Falconi-Madison_Brengle,2,F-DTL,29,3,1,0,2,8,21
20141020-W-ITF_Macon-QF-Irina_Falconi-Madison_Brengle,2,F-IO,23,2,1,0,1,8,15
20141020-W-ITF_Macon-QF-Irina_Falconi-Madison_Brengle,2,B-XC,65,7,1,1,5,19,46
20141020-W-ITF_Macon-QF-Irina_Falconi-Madison_Brengle,2,B-DTM,18,1,0,0,1,4,14
20141020-W-ITF_Macon-QF-Irina_Falconi-Madison_Brengle,2,B-DTL,16,4,1,1,2,3,13
20141020-W-ITF_Macon-QF-Irina_Falconi-Madison_Brengle,2,B-IO,8,1,0,0,1,3,5
20141020-W-ITF_Macon-QF-Irina_Falconi-Madison_Brengle,2,S-XC,2,0,0,0,0,0,2
20141020-W-ITF_Macon-QF-Irina_Falconi-Madison_Brengle,2,S-DTM,1,0,0,0,0,1,0
20120120-W-Australian_Open-R32-Angelique_Kerber-Maria_Sharapova,1,F-XC,37,7,2,2,3,22,15
20120120-W-Australian_Open-R32-Angelique_Kerber-Maria_Sharapova,1,F-DTM,16,1,0,1,0,10,6
20120120-W-Australian_Open-R32-Angelique_Kerber-Maria_Sharapova,1,F-DTL,17,11,5,2,4,10,7
20120120-W-Australian_Open-R32-Angelique_Kerber-Maria_Sharapova,1,F-IO,19,6,1,2,3,12,7
20120120-W-Australian_Open-R32-Angelique_Kerber-Maria_Sharapova,1,B-XC,15,2,1,0,1,4,11
20120120-W-Australian_Open-R32-Angelique_Kerber-Maria_Sharapova,1,B-DTM,27,0,0,0,0,10,17
20120120-W-Australian_Open-R32-Angelique_Kerber-Maria_Sharapova,1,B-DTL,5,3,0,0,3,0,5
20120120-W-Australian_Open-R32-Angelique_Kerber-Maria_Sharapova,1,B-IO,2,1,1,0,0,2,0
20120120-W-Australian_Open-R32-Angelique_Kerber-Maria_Sharapova,1,S-XC,4,1,0,0,1,1,3
20120120-W-Australian_Open-R32-Angelique_Kerber-Maria_Sharapova,1,S-DTM,3,0,0,0,0,0,3
20120120-W-Australian_Open-R32-Angelique_Kerber-Maria_Sharapova,1,S-DTL,9,2,1,0,1,5,4
20120120-W-Australian_Open-R32-Angelique_Kerber-Maria_Sharapova,1,S-IO,2,0,0,0,0,1,1
20120120-W-Australian_Open-R32-Angelique_Kerber-Maria_Sharapova,2,F-XC,41,8,6,1,1,25,16
20120120-W-Australian_Open-R32-Angelique_Kerber-Maria_Sharapova,2,F-DTM,15,3,1,0,2,9,6
20120120-W-Australian_Open-R32-Angelique_Kerber-Maria_Sharapova,2,F-DTL,15,7,3,1,3,8,7
20120120-W-Australian_Open-R32-Angelique_Kerber-Maria_Sharapova,2,F-IO,19,9,5,3,1,12,7
20120120-W-Australian_Open-R32-Angelique_Kerber-Maria_Sharapova,2,F-II,1,0,0,0,0,1,0
20120120-W-Australian_Open-R32-Angelique_Kerber-Maria_Sharapova,2,B-XC,43,12,5,3,4,19,24
20120120-W-Australian_Open-R32-Angelique_Kerber-Maria_Sharapova,2,B-DTM,8,0,0,0,0,2,6
20120120-W-Australian_Open-R32-Angelique_Kerber-Maria_Sharapova,2,B-DTL,10,5,3,0,2,5,5
20120120-W-Australian_Open-R32-Angelique_Kerber-Maria_Sharapova,2,B-IO,4,1,0,0,1,3,1
20120120-W-Australian_Open-R32-Angelique_Kerber-Maria_Sharapova,2,S-XC,3,0,0,0,0,1,2
20120120-W-Australian_Open-R32-Angelique_Kerber-Maria_Sharapova,2,S-DTM,1,0,0,0,0,0,1
20160829-W-US_Open-R128-Monica_Puig-Saisai_Zheng,1,F-XC,21,7,3,1,3,8,13
20160829-W-US_Open-R128-Monica_Puig-Saisai_Zheng,1,F-DTM,18,2,0,0,2,10,8
20160829-W-US_Open-R128-Monica_Puig-Saisai_Zheng,1,F-DTL,5,2,1,0,1,3,2
20160829-W-US_Open-R128-Monica_Puig-Saisai_Zheng,1,F-IO,20,5,2,1,2,9,11
20160829-W-US_Open-R128-Monica_Puig-Saisai_Zheng,1,B-XC,62,13,1,3,9,28,34
20160829-W-US_Open-R128-Monica_Puig-Saisai_Zheng,1,B-DTM,23,3,0,0,3,7,16
20160829-W-US_Open-R128-Monica_Puig-Saisai_Zheng,1,B-DTL,7,6,0,3,3,3,4
20160829-W-US_Open-R128-Monica_Puig-Saisai_Zheng,1,B-IO,5,3,2,1,0,4,1
20160829-W-US_Open-R128-Monica_Puig-Saisai_Zheng,2,F-XC,11,6,2,2,2,7,4
20160829-W-US_Open-R128-Monica_Puig-Saisai_Zheng,2,F-DTM,18,1,0,0,1,10,8
20160829-W-US_Open-R128-Monica_Puig-Saisai_Zheng,2,F-DTL,7,1,1,0,0,7,0
20160829-W-US_Open-R128-Monica_Puig-Saisai_Zheng,2,F-IO,15,0,0,0,0,3,12
20160829-W-US_Open-R128-Monica_Puig-Saisai_Zheng,2,B-XC,16,3,0,2,1,12,4
20160829-W-US_Open-R128-Monica_Puig-Saisai_Zheng,2,B-DTM,26,4,0,1,3,11,15
20160829-W-US_Open-R128-Monica_Puig-Saisai_Zheng,2,B-DTL,4,2,1,1,0,3,1
20160829-W-US_Open-R128-Monica_Puig-Saisai_Zheng,2,B-IO,6,1,1,0,0,3,3
20160829-W-US_Open-R128-Monica_Puig-Saisai_Zheng,2,S-XC,25,2,0,0,2,15,10
20160829-W-US_Open-R128-Monica_Puig-Saisai_Zheng,2,S-DTM,15,2,0,0,2,8,7
20160829-W-US_Open-R128-Monica_Puig-Saisai_Zheng,2,S-DTL,9,0,0,0,0,4,5
20140830-W-US_Open-R64-Ana_Ivanovic-Karolina_Pliskova,1,F-XC,37,15,6,2,7,21,16
20140830-W-US_Open-R64-Ana_Ivanovic-Karolina_Pliskova,1,F-DTM,13,3,0,2,1,7,6
20140830-W-US_Open-R64-Ana_Ivanovic-Karolina_Pliskova,1,F-DTL,8,3,2,1,0,5,3
20140830-W-US_Open-R64-Ana_Ivanovic-Karolina_Pliskova,1,F-IO,11,4,1,1,2,7,4
20140830-W-US_Open-R64-Ana_Ivanovic-Karolina_Pliskova,1,F-II,1,0,0,0,0,1,0
20140830-W-US_Open-R64-Ana_Ivanovic-Karolina_Pliskova,1,B-XC,25,6,3,1,2,14,11
20140830-W-US_Open-R64-Ana_Ivanovic-Karolina_Pliskova,1,B-DTM,19,1,0,0,1,6,13
20140830-W-US_Open-R64-Ana_Ivanovic-Karolina_Pliskova,1,B-DTL,5,1,0,0,1,1,4
20140830-W-US_Open-R64-Ana_Ivanovic-Karolina_Pliskova,1,S-XC,3,0,0,0,0,2,1
20140830-W-US_Open-R64-Ana_Ivanovic-Karolina_Pliskova,1,S-DTM,1,0,0,0,0,1,0
20140830-W-US_Open-R64-Ana_Ivanovic-Karolina_Pliskova,1,S-DTL,3,1,0,0,1,0,3
20140830-W-US_Open-R64-Ana_Ivanovic-Karolina_Pliskova,2,F-XC,29,11,4,3,4,15,14
20140830-W-US_Open-R64-Ana_Ivanovic-Karolina_Pliskova,2,F-DTM,14,1,0,1,0,8,6
20140830-W-US_Open-R64-Ana_Ivanovic-Karolina_Pliskova,2,F-DTL,5,1,0,0,1,1,4
20140830-W-US_Open-R64-Ana_Ivanovic-Karolina_Pliskova,2,F-IO,13,7,5,1,1,9,4
20140830-W-US_Open-R64-Ana_Ivanovic-Karolina_Pliskova,2,B-XC,23,2,1,0,1,12,11
20140830-W-US_Open-R64-Ana_Ivanovic-Karolina_Pliskova,2,B-DTM,20,1,0,0,1,9,11
20140830-W-US_Open-R64-Ana_Ivanovic-Karolina_Pliskova,2,B-DTL,6,3,2,1,0,3,3
20140830-W-US_Open-R64-Ana_Ivanovic-Karolina_Pliskova,2,B-IO,4,0,0,0,0,2,2
20140830-W-US_Open-R64-Ana_Ivanovic-Karolina_Pliskova,2,S-XC,5,0,0,0,0,3,2
20140830-W-US_Open-R64-Ana_Ivanovic-Karolina_Pliskova,2,S-DTM,8,0,0,0,0,2,6
20160207-W-Fed_Cup_World_Group_R1-RR-Richel_Hogenkamp-Svetlana_Kuznetsova,1,F-XC,91,20,4,9,7,52,39
20160207-W-Fed_Cup_World_Group_R1-RR-Richel_Hogenkamp-Svetlana_Kuznetsova,1,F-DTM,39,4,0,0,4,21,18
20160207-W-Fed_Cup_World_Group_R1-RR-Richel_Hogenkamp-Svetlana_Kuznetsova,1,F-DTL,34,10,6,2,2,19,15
20160207-W-Fed_Cup_World_Group_R1-RR-Richel_Hogenkamp-Svetlana_Kuznetsova,1,F-IO,44,12,3,2,7,16,28
20160207-W-Fed_Cup_World_Group_R1-RR-Richel_Hogenkamp-Svetlana_Kuznetsova,1,F-II,1,0,0,0,0,1,0
20160207-W-Fed_Cup_World_Group_R1-RR-Richel_Hogenkamp-Svetlana_Kuznetsova,1,B-XC,122,13,1,3,9,60,62
20160207-W-Fed_Cup_World_Group_R1-RR-Richel_Hogenkamp-Svetlana_Kuznetsova,1,B-DTM,65,8,1,2,5,31,34
20160207-W-Fed_Cup_World_Group_R1-RR-Richel_Hogenkamp-Svetlana_Kuznetsova,1,B-DTL,38,21,6,6,9,22,16
20160207-W-Fed_Cup_World_Group_R1-RR-Richel_Hogenkamp-Svetlana_Kuznetsova,1,B-IO,12,3,1,0,2,7,5
20160207-W-Fed_Cup_World_Group_R1-RR-Richel_Hogenkamp-Svetlana_Kuznetsova,1,B-II,1,1,0,1,0,1,0
20160207-W-Fed_Cup_World_Group_R1-RR-Richel_Hogenkamp-Svetlana_Kuznetsova,1,S-XC,31,4,0,2,2,13,18
20160207-W-Fed_Cup_World_Group_R1-RR-Richel_Hogenkamp-Svetlana_Kuznetsova,1,S-DTM,29,0,0,0,0,13,16
20160207-W-Fed_Cup_World_Group_R1-RR-Richel_Hogenkamp-Svetlana_Kuznetsova,1,S-DTL,10,3,1,0,2,5,5
20160207-W-Fed_Cup_World_Group_R1-RR-Richel_Hogenkamp-Svetlana_Kuznetsova,1,S-IO,1,0,0,0,0,0,1
20160207-W-Fed_Cup_World_Group_R1-RR-Richel_Hogenkamp-Svetlana_Kuznetsova,2,F-XC,92,14,5,3,6,44,48
20160207-W-Fed_Cup_World_Group_R1-RR-Richel_Hogenkamp-Svetlana_Kuznetsova,2,F-DTM,50,7,0,1,6,19,31
20160207-W-Fed_Cup_World_Group_R1-RR-Richel_Hogenkamp-Svetlana_Kuznetsova,2,F-DTL,36,12,0,3,9,19,17
20160207-W-Fed_Cup_World_Group_R1-RR-Richel_Hogenkamp-Svetlana_Kuznetsova,2,F-IO,77,17,4,6,7,39,38
20160207-W-Fed_Cup_World_Group_R1-RR-Richel_Hogenkamp-Svetlana_Kuznetsova,2,F-II,12,8,5,0,3,7,5
20160207-W-Fed_Cup_World_Group_R1-RR-Richel_Hogenkamp-Svetlana_Kuznetsova,2,B-XC,130,14,3,4,7,72,58
20160207-W-Fed_Cup_World_Group_R1-RR-Richel_Hogenkamp-Svetlana_Kuznetsova,2,B-DTM,49,5,0,0,5,25,24
20160207-W-Fed_Cup_World_Group_R1-RR-Richel_Hogenkamp-Svetlana_Kuznetsova,2,B-DTL,25,9,2,2,5,13,12
20160207-W-Fed_Cup_World_Group_R1-RR-Richel_Hogenkamp-Svetlana_Kuznetsova,2,B-IO,8,1,0,0,1,4,4
20160207-W-Fed_Cup_World_Group_R1-RR-Richel_Hogenkamp-Svetlana_Kuznetsova,2,S-XC,15,3,2,0,1,4,11
20160207-W-Fed_Cup_World_Group_R1-RR-Richel_Hogenkamp-Svetlana_Kuznetsova,2,S-DTM,6,0,0,0,0,3,3
20160207-W-Fed_Cup_World_Group_R1-RR-Richel_Hogenkamp-Svetlana_Kuznetsova,2,S-DTL,4,1,0,0,1,3,1
20160207-W-Fed_Cup_World_Group_R1-RR-Richel_Hogenkamp-Svetlana_Kuznetsova,2,S-IO,2,1,0,0,1,0,2
20110313-W-Indian_Wells-R32-Maria_Sharapova-Aravane_Rezai,1,F-XC,17,9,3,2,4,10,7
20110313-W-Indian_Wells-R32-Maria_Sharapova-Aravane_Rezai,1,F-DTM,13,0,0,0,0,8,5
20110313-W-Indian_Wells-R32-Maria_Sharapova-Aravane_Rezai,1,F-DTL,8,6,2,1,3,4,4
20110313-W-Indian_Wells-R32-Maria_Sharapova-Aravane_Rezai,1,F-IO,10,3,3,0,0,7,3
20110313-W-Indian_Wells-R32-Maria_Sharapova-Aravane_Rezai,1,B-XC,7,5,1,3,1,5,2
20110313-W-Indian_Wells-R32-Maria_Sharapova-Aravane_Rezai,1,B-DTM,9,0,0,0,0,6,3
20110313-W-Indian_Wells-R32-Maria_Sharapova-Aravane_Rezai,1,B-DTL,4,3,1,0,2,2,2
20110313-W-Indian_Wells-R32-Maria_Sharapova-Aravane_Rezai,1,B-IO,1,0,0,0,0,0,1
20110313-W-Indian_Wells-R32-Maria_Sharapova-Aravane_Rezai,1,S-DTM,1,0,0,0,0,1,0
20110313-W-Indian_Wells-R32-Maria_Sharapova-Aravane_Rezai,1,S-DTL,1,0,0,0,0,0,1
20110313-W-Indian_Wells-R32-Maria_Sharapova-Aravane_Rezai,2,F-XC,17,7,1,1,5,7,10
20110313-W-Indian_Wells-R32-Maria_Sharapova-Aravane_Rezai,2,F-DTM,8,3,0,0,3,2,6
20110313-W-Indian_Wells-R32-Maria_Sharapova-Aravane_Rezai,2,F-DTL,6,3,2,0,1,4,2
20110313-W-Indian_Wells-R32-Maria_Sharapova-Aravane_Rezai,2,F-IO,9,2,1,1,0,6,3
20110313-W-Indian_Wells-R32-Maria_Sharapova-Aravane_Rezai,2,F-II,1,1,1,0,0,1,0
20110313-W-Indian_Wells-R32-Maria_Sharapova-Aravane_Rezai,2,B-XC,7,5,3,1,1,5,2
20110313-W-Indian_Wells-R32-Maria_Sharapova-Aravane_Rezai,2,B-DTM,14,6,0,1,5,3,11
20110313-W-Indian_Wells-R32-Maria_Sharapova-Aravane_Rezai,2,B-DTL,7,1,0,0,1,4,3
20110313-W-Indian_Wells-R32-Maria_Sharapova-Aravane_Rezai,2,B-IO,8,3,0,1,2,3,5
20110313-W-Indian_Wells-R32-Maria_Sharapova-Aravane_Rezai,2,S-DTM,1,0,0,0,0,0,1
20110313-W-Indian_Wells-R32-Maria_Sharapova-Aravane_Rezai,2,S-DTL,1,0,0,0,0,0,1
20130826-W-US_Open-R128-Agnieszka_Radwanska-Silvia_Soler_Espinosa,1,F-XC,30,7,3,3,1,22,8
20130826-W-US_Open-R128-Agnieszka_Radwanska-Silvia_Soler_Espinosa,1,F-DTM,17,1,0,0,1,9,8
20130826-W-US_Open-R128-Agnieszka_Radwanska-Silvia_Soler_Espinosa,1,F-DTL,12,6,3,2,1,9,3
20130826-W-US_Open-R128-Agnieszka_Radwanska-Silvia_Soler_Espinosa,1,F-IO,11,0,0,0,0,6,5
20130826-W-US_Open-R128-Agnieszka_Radwanska-Silvia_Soler_Espinosa,1,B-XC,29,7,1,2,4,17,12
20130826-W-US_Open-R128-Agnieszka_Radwanska-Silvia_Soler_Espinosa,1,B-DTM,15,1,0,0,1,9,6
20130826-W-US_Open-R128-Agnieszka_Radwanska-Silvia_Soler_Espinosa,1,B-DTL,7,0,0,0,0,5,2
20130826-W-US_Open-R128-Agnieszka_Radwanska-Silvia_Soler_Espinosa,1,B-IO,3,2,0,2,0,2,1
20130826-W-US_Open-R128-Agnieszka_Radwanska-Silvia_Soler_Espinosa,1,S-XC,2,0,0,0,0,0,2
20130826-W-US_Open-R128-Agnieszka_Radwanska-Silvia_Soler_Espinosa,1,S-DTM,1,0,0,0,0,0,1
20130826-W-US_Open-R128-Agnieszka_Radwanska-Silvia_Soler_Espinosa,1,S-DTL,3,3,1,0,2,1,2
20130826-W-US_Open-R128-Agnieszka_Radwanska-Silvia_Soler_Espinosa,2,F-XC,40,9,2,3,4,13,27
20130826-W-US_Open-R128-Agnieszka_Radwanska-Silvia_Soler_Espinosa,2,F-DTM,14,3,0,1,2,5,9
20130826-W-US_Open-R128-Agnieszka_Radwanska-Silvia_Soler_Espinosa,2,F-DTL,9,1,0,0,1,4,5
20130826-W-US_Open-R128-Agnieszka_Radwanska-Silvia_Soler_Espinosa,2,F-IO,23,2,1,0,1,10,13
20130826-W-US_Open-R128-Agnieszka_Radwanska-Silvia_Soler_Espinosa,2,F-II,5,1,0,1,0,2,3
20130826-W-US_Open-R128-Agnieszka_Radwanska-Silvia_Soler_Espinosa,2,B-XC,14,4,1,1,2,6,8
20130826-W-US_Open-R128-Agnieszka_Radwanska-Silvia_Soler_Espinosa,2,B-DTM,17,2,0,0,2,5,12
20130826-W-US_Open-R128-Agnieszka_Radwanska-Silvia_Soler_Espinosa,2,B-DTL,11,3,1,0,2,5,6
20130826-W-US_Open-R128-Agnieszka_Radwanska-Silvia_Soler_Espinosa,2,B-IO,3,3,0,1,2,1,2
20130826-W-US_Open-R128-Agnieszka_Radwanska-Silvia_Soler_Espinosa,2,S-XC,7,0,0,0,0,1,6
20130826-W-US_Open-R128-Agnieszka_Radwanska-Silvia_Soler_Espinosa,2,S-DTM,5,0,0,0,0,2,3
20090125-W-Australian_Open-R16-Jelena_Dokic-Alisa_Kleybanova,1,F-XC,142,24,3,9,12,74,68
20090125-W-Australian_Open-R16-Jelena_Dokic-Alisa_Kleybanova,1,F-DTM,18,5,0,0,5,7,11
20090125-W-Australian_Open-R16-Jelena_Dokic-Alisa_Kleybanova,1,F-DTL,41,17,6,6,5,22,19
20090125-W-Australian_Open-R16-Jelena_Dokic-Alisa_Kleybanova,1,F-IO,14,7,6,0,1,12,2
20090125-W-Australian_Open-R16-Jelena_Dokic-Alisa_Kleybanova,1,F-II,1,0,0,0,0,1,0
20090125-W-Australian_Open-R16-Jelena_Dokic-Alisa_Kleybanova,1,B-XC,54,13,5,5,3,32,22
20090125-W-Australian_Open-R16-Jelena_Dokic-Alisa_Kleybanova,1,B-DTM,30,3,0,0,3,9,21
20090125-W-Australian_Open-R16-Jelena_Dokic-Alisa_Kleybanova,1,B-DTL,19,11,8,2,1,17,2
20090125-W-Australian_Open-R16-Jelena_Dokic-Alisa_Kleybanova,1,B-IO,17,7,2,0,5,6,11
20090125-W-Australian_Open-R16-Jelena_Dokic-Alisa_Kleybanova,1,S-DTM,12,0,0,0,0,6,6
20090125-W-Australian_Open-R16-Jelena_Dokic-Alisa_Kleybanova,1,S-DTL,7,1,0,0,1,1,6
20090125-W-Australian_Open-R16-Jelena_Dokic-Alisa_Kleybanova,1,S-IO,1,0,0,0,0,0,1
20090125-W-Australian_Open-R16-Jelena_Dokic-Alisa_Kleybanova,2,F-XC,137,23,7,4,12,65,72
20090125-W-Australian_Open-R16-Jelena_Dokic-Alisa_Kleybanova,2,F-DTM,36,3,0,0,3,17,19
20090125-W-Australian_Open-R16-Jelena_Dokic-Alisa_Kleybanova,2,F-DTL,32,7,4,2,1,16,16
20090125-W-Australian_Open-R16-Jelena_Dokic-Alisa_Kleybanova,2,F-IO,14,3,1,1,1,8,6
20090125-W-Australian_Open-R16-Jelena_Dokic-Alisa_Kleybanova,2,B-XC,65,19,5,5,9,30,35
20090125-W-Australian_Open-R16-Jelena_Dokic-Alisa_Kleybanova,2,B-DTM,32,4,0,0,4,16,16
20090125-W-Australian_Open-R16-Jelena_Dokic-Alisa_Kleybanova,2,B-DTL,7,5,1,2,2,3,4
20090125-W-Australian_Open-R16-Jelena_Dokic-Alisa_Kleybanova,2,B-IO,18,1,1,0,0,16,2
20090125-W-Australian_Open-R16-Jelena_Dokic-Alisa_Kleybanova,2,S-XC,7,0,0,0,0,2,5
20090125-W-Australian_Open-R16-Jelena_Dokic-Alisa_Kleybanova,2,S-DTM,6,0,0,0,0,1,5
20161024-W-Singapore-RR-Garbine_Muguruza-Karolina_Pliskova,1,F-XC,60,14,4,2,8,31,29
20161024-W-Singapore-RR-Garbine_Muguruza-Karolina_Pliskova,1,F-DTM,21,2,1,0,1,8,13
20161024-W-Singapore-RR-Garbine_Muguruza-Karolina_Pliskova,1,F-DTL,29,12,3,2,7,12,17
20161024-W-Singapore-RR-Garbine_Muguruza-Karolina_Pliskova,1,F-IO,23,10,3,3,4,16,7
20161024-W-Singapore-RR-Garbine_Muguruza-Karolina_Pliskova,1,B-XC,57,9,4,1,4,33,24
20161024-W-Singapore-RR-Garbine_Muguruza-Karolina_Pliskova,1,B-DTM,39,7,1,0,6,20,19
20161024-W-Singapore-RR-Garbine_Muguruza-Karolina_Pliskova,1,B-DTL,15,8,4,0,4,9,6
20161024-W-Singapore-RR-Garbine_Muguruza-Karolina_Pliskova,1,B-IO,12,7,3,1,3,5,7
20161024-W-Singapore-RR-Garbine_Muguruza-Karolina_Pliskova,2,F-XC,57,15,2,6,7,33,24
20161024-W-Singapore-RR-Garbine_Muguruza-Karolina_Pliskova,2,F-DTM,28,3,0,0,3,9,19
20161024-W-Singapore-RR-Garbine_Muguruza-Karolina_Pliskova,2,F-DTL,12,5,2,2,1,7,5
20161024-W-Singapore-RR-Garbine_Muguruza-Karolina_Pliskova,2,F-IO,20,7,2,2,3,7,13
20161024-W-Singapore-RR-Garbine_Muguruza-Karolina_Pliskova,2,F-II,3,1,0,0,1,0,3
20161024-W-Singapore-RR-Garbine_Muguruza-Karolina_Pliskova,2,B-XC,47,12,1,5,6,19,28
20161024-W-Singapore-RR-Garbine_Muguruza-Karolina_Pliskova,2,B-DTM,35,3,0,0,3,17,18
20161024-W-Singapore-RR-Garbine_Muguruza-Karolina_Pliskova,2,B-DTL,15,6,1,2,3,7,8
20161024-W-Singapore-RR-Garbine_Muguruza-Karolina_Pliskova,2,B-IO,7,3,1,1,1,5,2
20161024-W-Singapore-RR-Garbine_Muguruza-Karolina_Pliskova,2,B-II,1,0,0,0,0,1,0
20161024-W-Singapore-RR-Garbine_Muguruza-Karolina_Pliskova,2,S-XC,4,0,0,0,0,1,3
20161024-W-Singapore-RR-Garbine_Muguruza-Karolina_Pliskova,2,S-DTM,6,0,0,0,0,1,5
20161024-W-Singapore-RR-Garbine_Muguruza-Karolina_Pliskova,2,S-IO,1,0,0,0,0,0,1
20161024-W-Singapore-RR-Agnieszka_Radwanska-Svetlana_Kuznetsova,1,F-XC,51,10,3,3,4,35,16
20161024-W-Singapore-RR-Agnieszka_Radwanska-Svetlana_Kuznetsova,1,F-DTM,13,0,0,0,0,9,4
20161024-W-Singapore-RR-Agnieszka_Radwanska-Svetlana_Kuznetsova,1,F-DTL,24,10,3,3,4,10,14
20161024-W-Singapore-RR-Agnieszka_Radwanska-Svetlana_Kuznetsova,1,F-IO,40,6,2,1,3,22,18
20161024-W-Singapore-RR-Agnieszka_Radwanska-Svetlana_Kuznetsova,1,B-XC,137,8,1,1,6,80,57
20161024-W-Singapore-RR-Agnieszka_Radwanska-Svetlana_Kuznetsova,1,B-DTM,47,5,0,1,4,26,21
20161024-W-Singapore-RR-Agnieszka_Radwanska-Svetlana_Kuznetsova,1,B-DTL,23,9,1,4,4,11,12
20161024-W-Singapore-RR-Agnieszka_Radwanska-Svetlana_Kuznetsova,1,B-IO,9,1,0,0,1,6,3
20161024-W-Singapore-RR-Agnieszka_Radwanska-Svetlana_Kuznetsova,1,S-XC,23,2,0,0,2,11,12
20161024-W-Singapore-RR-Agnieszka_Radwanska-Svetlana_Kuznetsova,1,S-DTM,10,0,0,0,0,6,4
20161024-W-Singapore-RR-Agnieszka_Radwanska-Svetlana_Kuznetsova,1,S-DTL,5,0,0,0,0,1,4
20161024-W-Singapore-RR-Agnieszka_Radwanska-Svetlana_Kuznetsova,1,S-IO,2,0,0,0,0,2,0
20161024-W-Singapore-RR-Agnieszka_Radwanska-Svetlana_Kuznetsova,2,F-XC,48,12,3,4,5,20,28
20161024-W-Singapore-RR-Agnieszka_Radwanska-Svetlana_Kuznetsova,2,F-DTM,31,2,0,0,2,13,18
20161024-W-Singapore-RR-Agnieszka_Radwanska-Svetlana_Kuznetsova,2,F-DTL,30,9,1,1,7,10,20
20161024-W-Singapore-RR-Agnieszka_Radwanska-Svetlana_Kuznetsova,2,F-IO,45,12,6,2,4,28,17
20161024-W-Singapore-RR-Agnieszka_Radwanska-Svetlana_Kuznetsova,2,F-II,5,2,1,1,0,4,1
20161024-W-Singapore-RR-Agnieszka_Radwanska-Svetlana_Kuznetsova,2,B-XC,139,20,3,2,15,60,79
20161024-W-Singapore-RR-Agnieszka_Radwanska-Svetlana_Kuznetsova,2,B-DTM,35,4,0,0,4,10,25
20161024-W-Singapore-RR-Agnieszka_Radwanska-Svetlana_Kuznetsova,2,B-DTL,25,13,4,4,5,9,16
20161024-W-Singapore-RR-Agnieszka_Radwanska-Svetlana_Kuznetsova,2,B-IO,2,1,1,0,0,1,1
20161024-W-Singapore-RR-Agnieszka_Radwanska-Svetlana_Kuznetsova,2,S-XC,25,5,1,1,3,10,15
20161024-W-Singapore-RR-Agnieszka_Radwanska-Svetlana_Kuznetsova,2,S-DTM,14,1,0,0,1,4,10
20161024-W-Singapore-RR-Agnieszka_Radwanska-Svetlana_Kuznetsova,2,S-DTL,1,0,0,0,0,1,0
20161024-W-Singapore-RR-Agnieszka_Radwanska-Svetlana_Kuznetsova,2,S-II,1,0,0,0,0,1,0
20150207-W-Fed_Cup_World_Group_R1-RR-Agnieszka_Radwanska-Svetlana_Kuznetsova,1,F-XC,61,9,6,1,2,30,31
20150207-W-Fed_Cup_World_Group_R1-RR-Agnieszka_Radwanska-Svetlana_Kuznetsova,1,F-DTM,21,0,0,0,0,10,11
20150207-W-Fed_Cup_World_Group_R1-RR-Agnieszka_Radwanska-Svetlana_Kuznetsova,1,F-DTL,28,9,4,0,5,16,12
20150207-W-Fed_Cup_World_Group_R1-RR-Agnieszka_Radwanska-Svetlana_Kuznetsova,1,F-IO,21,7,3,2,2,10,11
20150207-W-Fed_Cup_World_Group_R1-RR-Agnieszka_Radwanska-Svetlana_Kuznetsova,1,F-II,1,1,0,0,1,0,1
20150207-W-Fed_Cup_World_Group_R1-RR-Agnieszka_Radwanska-Svetlana_Kuznetsova,1,B-XC,82,9,0,4,5,34,48
20150207-W-Fed_Cup_World_Group_R1-RR-Agnieszka_Radwanska-Svetlana_Kuznetsova,1,B-DTM,38,3,0,2,1,17,21
20150207-W-Fed_Cup_World_Group_R1-RR-Agnieszka_Radwanska-Svetlana_Kuznetsova,1,B-DTL,21,12,6,2,4,14,7
20150207-W-Fed_Cup_World_Group_R1-RR-Agnieszka_Radwanska-Svetlana_Kuznetsova,1,B-IO,4,1,0,0,1,2,2
20150207-W-Fed_Cup_World_Group_R1-RR-Agnieszka_Radwanska-Svetlana_Kuznetsova,1,S-XC,10,0,0,0,0,5,5
20150207-W-Fed_Cup_World_Group_R1-RR-Agnieszka_Radwanska-Svetlana_Kuznetsova,1,S-DTM,7,0,0,0,0,3,4
20150207-W-Fed_Cup_World_Group_R1-RR-Agnieszka_Radwanska-Svetlana_Kuznetsova,1,S-DTL,4,1,0,0,1,1,3
20150207-W-Fed_Cup_World_Group_R1-RR-Agnieszka_Radwanska-Svetlana_Kuznetsova,2,F-XC,67,13,2,4,7,31,36
20150207-W-Fed_Cup_World_Group_R1-RR-Agnieszka_Radwanska-Svetlana_Kuznetsova,2,F-DTM,24,2,1,0,1,13,11
20150207-W-Fed_Cup_World_Group_R1-RR-Agnieszka_Radwanska-Svetlana_Kuznetsova,2,F-DTL,33,7,5,1,1,23,10
20150207-W-Fed_Cup_World_Group_R1-RR-Agnieszka_Radwanska-Svetlana_Kuznetsova,2,F-IO,33,4,3,0,1,17,16
20150207-W-Fed_Cup_World_Group_R1-RR-Agnieszka_Radwanska-Svetlana_Kuznetsova,2,F-II,10,4,0,2,2,5,5
20150207-W-Fed_Cup_World_Group_R1-RR-Agnieszka_Radwanska-Svetlana_Kuznetsova,2,B-XC,63,7,2,1,4,36,27
20150207-W-Fed_Cup_World_Group_R1-RR-Agnieszka_Radwanska-Svetlana_Kuznetsova,2,B-DTM,25,0,0,0,0,11,14
20150207-W-Fed_Cup_World_Group_R1-RR-Agnieszka_Radwanska-Svetlana_Kuznetsova,2,B-DTL,26,13,3,4,6,15,11
20150207-W-Fed_Cup_World_Group_R1-RR-Agnieszka_Radwanska-Svetlana_Kuznetsova,2,B-IO,4,3,1,0,2,1,3
20150207-W-Fed_Cup_World_Group_R1-RR-Agnieszka_Radwanska-Svetlana_Kuznetsova,2,S-XC,7,0,0,0,0,4,3
20150207-W-Fed_Cup_World_Group_R1-RR-Agnieszka_Radwanska-Svetlana_Kuznetsova,2,S-DTM,5,1,0,0,1,3,2
20150207-W-Fed_Cup_World_Group_R1-RR-Agnieszka_Radwanska-Svetlana_Kuznetsova,2,S-DTL,4,2,0,0,2,1,3
20160929-W-Wuhan-QF-Agnieszka_Radwanska-Svetlana_Kuznetsova,1,F-XC,81,15,4,4,7,38,43
20160929-W-Wuhan-QF-Agnieszka_Radwanska-Svetlana_Kuznetsova,1,F-DTM,25,1,0,0,1,13,12
20160929-W-Wuhan-QF-Agnieszka_Radwanska-Svetlana_Kuznetsova,1,F-DTL,25,6,2,2,2,11,14
20160929-W-Wuhan-QF-Agnieszka_Radwanska-Svetlana_Kuznetsova,1,F-IO,32,8,3,2,3,16,16
20160929-W-Wuhan-QF-Agnieszka_Radwanska-Svetlana_Kuznetsova,1,F-II,3,1,0,1,0,2,1
20160929-W-Wuhan-QF-Agnieszka_Radwanska-Svetlana_Kuznetsova,1,B-XC,140,6,1,3,2,63,77
20160929-W-Wuhan-QF-Agnieszka_Radwanska-Svetlana_Kuznetsova,1,B-DTM,47,1,0,0,1,27,20
20160929-W-Wuhan-QF-Agnieszka_Radwanska-Svetlana_Kuznetsova,1,B-DTL,29,5,1,1,3,15,14
20160929-W-Wuhan-QF-Agnieszka_Radwanska-Svetlana_Kuznetsova,1,B-IO,5,2,0,0,2,2,3
20160929-W-Wuhan-QF-Agnieszka_Radwanska-Svetlana_Kuznetsova,1,S-XC,18,2,0,1,1,5,13
20160929-W-Wuhan-QF-Agnieszka_Radwanska-Svetlana_Kuznetsova,1,S-DTM,14,0,0,0,0,3,11
20160929-W-Wuhan-QF-Agnieszka_Radwanska-Svetlana_Kuznetsova,1,S-DTL,3,2,1,0,1,1,2
20160929-W-Wuhan-QF-Agnieszka_Radwanska-Svetlana_Kuznetsova,1,S-IO,3,0,0,0,0,3,0
20160929-W-Wuhan-QF-Agnieszka_Radwanska-Svetlana_Kuznetsova,2,F-XC,63,11,3,4,4,36,27
20160929-W-Wuhan-QF-Agnieszka_Radwanska-Svetlana_Kuznetsova,2,F-DTM,34,4,0,0,4,15,19
20160929-W-Wuhan-QF-Agnieszka_Radwanska-Svetlana_Kuznetsova,2,F-DTL,43,9,4,1,4,22,21
20160929-W-Wuhan-QF-Agnieszka_Radwanska-Svetlana_Kuznetsova,2,F-IO,55,9,5,0,4,24,31
20160929-W-Wuhan-QF-Agnieszka_Radwanska-Svetlana_Kuznetsova,2,F-II,11,3,1,0,2,6,5
20160929-W-Wuhan-QF-Agnieszka_Radwanska-Svetlana_Kuznetsova,2,B-XC,114,17,4,3,10,67,47
20160929-W-Wuhan-QF-Agnieszka_Radwanska-Svetlana_Kuznetsova,2,B-DTM,47,1,0,0,1,24,23
20160929-W-Wuhan-QF-Agnieszka_Radwanska-Svetlana_Kuznetsova,2,B-DTL,33,15,7,0,8,18,15
20160929-W-Wuhan-QF-Agnieszka_Radwanska-Svetlana_Kuznetsova,2,B-IO,4,1,1,0,0,2,2
20160929-W-Wuhan-QF-Agnieszka_Radwanska-Svetlana_Kuznetsova,2,S-XC,23,2,1,0,1,11,12
20160929-W-Wuhan-QF-Agnieszka_Radwanska-Svetlana_Kuznetsova,2,S-DTM,8,0,0,0,0,5,3
20160929-W-Wuhan-QF-Agnieszka_Radwanska-Svetlana_Kuznetsova,2,S-DTL,4,1,0,0,1,1,3
20070607-W-Roland_Garros-SF-Justine_Henin-Jelena_Jankovic,1,F-XC,57,9,1,5,3,36,21
20070607-W-Roland_Garros-SF-Justine_Henin-Jelena_Jankovic,1,F-DTM,22,1,0,0,1,11,11
20070607-W-Roland_Garros-SF-Justine_Henin-Jelena_Jankovic,1,F-DTL,16,6,2,0,4,9,7
20070607-W-Roland_Garros-SF-Justine_Henin-Jelena_Jankovic,1,F-IO,9,6,3,1,2,6,3
20070607-W-Roland_Garros-SF-Justine_Henin-Jelena_Jankovic,1,F-II,4,1,1,0,0,4,0
20070607-W-Roland_Garros-SF-Justine_Henin-Jelena_Jankovic,1,B-XC,24,7,1,3,3,13,11
20070607-W-Roland_Garros-SF-Justine_Henin-Jelena_Jankovic,1,B-DTM,19,0,0,0,0,11,8
20070607-W-Roland_Garros-SF-Justine_Henin-Jelena_Jankovic,1,B-DTL,14,8,6,0,2,10,4
20070607-W-Roland_Garros-SF-Justine_Henin-Jelena_Jankovic,1,B-IO,2,2,1,0,1,1,1
20070607-W-Roland_Garros-SF-Justine_Henin-Jelena_Jankovic,1,S-XC,11,0,0,0,0,6,5
20070607-W-Roland_Garros-SF-Justine_Henin-Jelena_Jankovic,1,S-DTM,8,0,0,0,0,4,4
20070607-W-Roland_Garros-SF-Justine_Henin-Jelena_Jankovic,1,S-DTL,2,0,0,0,0,2,0
20070607-W-Roland_Garros-SF-Justine_Henin-Jelena_Jankovic,2,F-XC,37,6,0,3,3,17,20
20070607-W-Roland_Garros-SF-Justine_Henin-Jelena_Jankovic,2,F-DTM,12,1,1,0,0,4,8
20070607-W-Roland_Garros-SF-Justine_Henin-Jelena_Jankovic,2,F-DTL,22,1,1,0,0,7,15
20070607-W-Roland_Garros-SF-Justine_Henin-Jelena_Jankovic,2,F-IO,21,4,1,1,2,12,9
20070607-W-Roland_Garros-SF-Justine_Henin-Jelena_Jankovic,2,B-XC,32,4,0,1,3,10,22
20070607-W-Roland_Garros-SF-Justine_Henin-Jelena_Jankovic,2,B-DTM,19,1,0,1,0,10,9
20070607-W-Roland_Garros-SF-Justine_Henin-Jelena_Jankovic,2,B-DTL,13,3,0,0,3,5,8
20070607-W-Roland_Garros-SF-Justine_Henin-Jelena_Jankovic,2,B-IO,16,6,1,0,5,4,12
20070607-W-Roland_Garros-SF-Justine_Henin-Jelena_Jankovic,2,S-XC,2,0,0,0,0,0,2
20070607-W-Roland_Garros-SF-Justine_Henin-Jelena_Jankovic,2,S-DTM,4,0,0,0,0,2,2
20070607-W-Roland_Garros-SF-Justine_Henin-Jelena_Jankovic,2,S-DTL,1,1,0,1,0,1,0
20160122-W-Australian_Open-R32-Kristina_Mladenovic-Daria_Gavrilova,1,F-XC,62,20,11,4,5,31,31
20160122-W-Australian_Open-R32-Kristina_Mladenovic-Daria_Gavrilova,1,F-DTM,13,2,1,0,1,5,8
20160122-W-Australian_Open-R32-Kristina_Mladenovic-Daria_Gavrilova,1,F-DTL,16,9,3,1,5,7,9
20160122-W-Australian_Open-R32-Kristina_Mladenovic-Daria_Gavrilova,1,F-IO,36,9,1,2,6,17,19
20160122-W-Australian_Open-R32-Kristina_Mladenovic-Daria_Gavrilova,1,F-II,9,6,2,1,3,5,4
20160122-W-Australian_Open-R32-Kristina_Mladenovic-Daria_Gavrilova,1,B-XC,24,5,1,1,3,9,15
20160122-W-Australian_Open-R32-Kristina_Mladenovic-Daria_Gavrilova,1,B-DTM,26,6,1,1,4,9,17
20160122-W-Australian_Open-R32-Kristina_Mladenovic-Daria_Gavrilova,1,B-DTL,3,3,0,0,3,0,3
20160122-W-Australian_Open-R32-Kristina_Mladenovic-Daria_Gavrilova,1,B-IO,4,1,1,0,0,2,2
20160122-W-Australian_Open-R32-Kristina_Mladenovic-Daria_Gavrilova,1,S-XC,5,1,0,0,1,1,4
20160122-W-Australian_Open-R32-Kristina_Mladenovic-Daria_Gavrilova,1,S-DTM,7,1,0,1,0,5,2
20160122-W-Australian_Open-R32-Kristina_Mladenovic-Daria_Gavrilova,1,S-DTL,1,0,0,0,0,0,1
20160122-W-Australian_Open-R32-Kristina_Mladenovic-Daria_Gavrilova,2,F-XC,70,22,8,9,5,49,21
20160122-W-Australian_Open-R32-Kristina_Mladenovic-Daria_Gavrilova,2,F-DTM,18,1,0,0,1,5,13
20160122-W-Australian_Open-R32-Kristina_Mladenovic-Daria_Gavrilova,2,F-DTL,21,6,4,1,1,15,6
20160122-W-Australian_Open-R32-Kristina_Mladenovic-Daria_Gavrilova,2,F-IO,31,7,2,1,4,18,13
20160122-W-Australian_Open-R32-Kristina_Mladenovic-Daria_Gavrilova,2,F-II,3,1,0,1,0,2,1
20160122-W-Australian_Open-R32-Kristina_Mladenovic-Daria_Gavrilova,2,B-XC,12,2,1,1,0,11,1
20160122-W-Australian_Open-R32-Kristina_Mladenovic-Daria_Gavrilova,2,B-DTM,26,3,0,1,2,16,10
20160122-W-Australian_Open-R32-Kristina_Mladenovic-Daria_Gavrilova,2,B-DTL,7,3,3,0,0,6,1
20160122-W-Australian_Open-R32-Kristina_Mladenovic-Daria_Gavrilova,2,B-IO,2,1,0,1,0,2,0
20160122-W-Australian_Open-R32-Kristina_Mladenovic-Daria_Gavrilova,2,S-XC,13,1,1,0,0,7,6
20160122-W-Australian_Open-R32-Kristina_Mladenovic-Daria_Gavrilova,2,S-DTM,8,1,0,0,1,2,6
20160122-W-Australian_Open-R32-Kristina_Mladenovic-Daria_Gavrilova,2,S-DTL,6,3,0,2,1,4,2
20130420-W-Fed_Cup_World_Group_PO-RR-Ana_Ivanovic-Angelique_Kerber,1,F-XC,65,21,9,2,10,39,26
20130420-W-Fed_Cup_World_Group_PO-RR-Ana_Ivanovic-Angelique_Kerber,1,F-DTM,21,2,0,1,1,13,8
20130420-W-Fed_Cup_World_Group_PO-RR-Ana_Ivanovic-Angelique_Kerber,1,F-DTL,33,17,6,3,8,19,14
20130420-W-Fed_Cup_World_Group_PO-RR-Ana_Ivanovic-Angelique_Kerber,1,F-IO,23,11,5,2,4,13,10
20130420-W-Fed_Cup_World_Group_PO-RR-Ana_Ivanovic-Angelique_Kerber,1,F-II,10,4,2,1,1,8,2
20130420-W-Fed_Cup_World_Group_PO-RR-Ana_Ivanovic-Angelique_Kerber,1,B-XC,83,11,2,1,8,47,36
20130420-W-Fed_Cup_World_Group_PO-RR-Ana_Ivanovic-Angelique_Kerber,1,B-DTM,26,1,0,0,1,18,8
20130420-W-Fed_Cup_World_Group_PO-RR-Ana_Ivanovic-Angelique_Kerber,1,B-DTL,21,5,1,3,1,11,10
20130420-W-Fed_Cup_World_Group_PO-RR-Ana_Ivanovic-Angelique_Kerber,1,B-IO,4,0,0,0,0,2,2
20130420-W-Fed_Cup_World_Group_PO-RR-Ana_Ivanovic-Angelique_Kerber,1,S-XC,17,3,1,1,1,7,10
20130420-W-Fed_Cup_World_Group_PO-RR-Ana_Ivanovic-Angelique_Kerber,1,S-DTM,5,0,0,0,0,2,3
20130420-W-Fed_Cup_World_Group_PO-RR-Ana_Ivanovic-Angelique_Kerber,1,S-DTL,4,1,0,0,1,1,3
20130420-W-Fed_Cup_World_Group_PO-RR-Ana_Ivanovic-Angelique_Kerber,1,S-IO,2,0,0,0,0,0,2
20130420-W-Fed_Cup_World_Group_PO-RR-Ana_Ivanovic-Angelique_Kerber,2,F-XC,115,11,3,1,7,47,68
20130420-W-Fed_Cup_World_Group_PO-RR-Ana_Ivanovic-Angelique_Kerber,2,F-DTM,16,0,0,0,0,7,9
20130420-W-Fed_Cup_World_Group_PO-RR-Ana_Ivanovic-Angelique_Kerber,2,F-DTL,36,13,4,2,7,17,19
20130420-W-Fed_Cup_World_Group_PO-RR-Ana_Ivanovic-Angelique_Kerber,2,F-IO,22,10,2,3,5,11,11
20130420-W-Fed_Cup_World_Group_PO-RR-Ana_Ivanovic-Angelique_Kerber,2,B-XC,51,8,2,1,5,21,30
20130420-W-Fed_Cup_World_Group_PO-RR-Ana_Ivanovic-Angelique_Kerber,2,B-DTM,22,0,0,0,0,6,16
20130420-W-Fed_Cup_World_Group_PO-RR-Ana_Ivanovic-Angelique_Kerber,2,B-DTL,16,4,4,0,0,9,7
20130420-W-Fed_Cup_World_Group_PO-RR-Ana_Ivanovic-Angelique_Kerber,2,B-IO,14,1,1,0,0,7,7
20130420-W-Fed_Cup_World_Group_PO-RR-Ana_Ivanovic-Angelique_Kerber,2,S-XC,1,0,0,0,0,0,1
20130420-W-Fed_Cup_World_Group_PO-RR-Ana_Ivanovic-Angelique_Kerber,2,S-DTM,7,0,0,0,0,3,4
20130420-W-Fed_Cup_World_Group_PO-RR-Ana_Ivanovic-Angelique_Kerber,2,S-DTL,3,0,0,0,0,2,1
20160406-W-Charleston-R32-Elena_Vesnina-Belinda_Bencic,1,F-XC,27,11,5,4,2,18,9
20160406-W-Charleston-R32-Elena_Vesnina-Belinda_Bencic,1,F-DTM,9,1,0,0,1,6,3
20160406-W-Charleston-R32-Elena_Vesnina-Belinda_Bencic,1,F-DTL,4,2,0,1,1,3,1
20160406-W-Charleston-R32-Elena_Vesnina-Belinda_Bencic,1,F-IO,6,2,0,0,2,1,5
20160406-W-Charleston-R32-Elena_Vesnina-Belinda_Bencic,1,B-XC,29,9,5,2,2,19,10
20160406-W-Charleston-R32-Elena_Vesnina-Belinda_Bencic,1,B-DTM,11,0,0,0,0,8,3
20160406-W-Charleston-R32-Elena_Vesnina-Belinda_Bencic,1,B-DTL,10,4,3,0,1,9,1
20160406-W-Charleston-R32-Elena_Vesnina-Belinda_Bencic,1,B-IO,3,2,0,0,2,1,2
20160406-W-Charleston-R32-Elena_Vesnina-Belinda_Bencic,1,S-XC,1,0,0,0,0,1,0
20160406-W-Charleston-R32-Elena_Vesnina-Belinda_Bencic,1,S-DTM,1,0,0,0,0,0,1
20160406-W-Charleston-R32-Elena_Vesnina-Belinda_Bencic,1,S-DTL,1,0,0,0,0,1,0
20160406-W-Charleston-R32-Elena_Vesnina-Belinda_Bencic,2,F-XC,16,3,1,0,2,5,11
20160406-W-Charleston-R32-Elena_Vesnina-Belinda_Bencic,2,F-DTM,8,1,0,0,1,4,4
20160406-W-Charleston-R32-Elena_Vesnina-Belinda_Bencic,2,F-DTL,8,5,1,2,2,3,5
20160406-W-Charleston-R32-Elena_Vesnina-Belinda_Bencic,2,F-IO,6,1,1,0,0,2,4
20160406-W-Charleston-R32-Elena_Vesnina-Belinda_Bencic,2,B-XC,21,3,1,0,2,6,15
20160406-W-Charleston-R32-Elena_Vesnina-Belinda_Bencic,2,B-DTM,9,0,0,0,0,4,5
20160406-W-Charleston-R32-Elena_Vesnina-Belinda_Bencic,2,B-DTL,13,5,4,0,1,6,7
20160406-W-Charleston-R32-Elena_Vesnina-Belinda_Bencic,2,B-IO,6,2,0,0,2,1,5
20160406-W-Charleston-R32-Elena_Vesnina-Belinda_Bencic,2,S-DTM,1,0,0,0,0,1,0
20130116-W-Australian_Open-R64-Julia_Goerges-Romina_Oprandi,1,F-XC,29,13,5,4,4,20,9
20130116-W-Australian_Open-R64-Julia_Goerges-Romina_Oprandi,1,F-DTM,9,0,0,0,0,6,3
20130116-W-Australian_Open-R64-Julia_Goerges-Romina_Oprandi,1,F-DTL,9,5,3,0,2,6,3
20130116-W-Australian_Open-R64-Julia_Goerges-Romina_Oprandi,1,F-IO,16,12,3,5,4,11,5
20130116-W-Australian_Open-R64-Julia_Goerges-Romina_Oprandi,1,F-II,4,3,1,1,1,3,1
20130116-W-Australian_Open-R64-Julia_Goerges-Romina_Oprandi,1,B-XC,12,4,0,0,4,2,10
20130116-W-Australian_Open-R64-Julia_Goerges-Romina_Oprandi,1,B-DTM,6,0,0,0,0,4,2
20130116-W-Australian_Open-R64-Julia_Goerges-Romina_Oprandi,1,B-DTL,6,3,1,0,2,3,3
20130116-W-Australian_Open-R64-Julia_Goerges-Romina_Oprandi,1,B-IO,2,1,1,0,0,2,0
20130116-W-Australian_Open-R64-Julia_Goerges-Romina_Oprandi,1,S-DTL,2,2,1,0,1,1,1
20130116-W-Australian_Open-R64-Julia_Goerges-Romina_Oprandi,2,F-XC,20,4,1,2,1,8,12
20130116-W-Australian_Open-R64-Julia_Goerges-Romina_Oprandi,2,F-DTM,13,4,1,0,3,5,8
20130116-W-Australian_Open-R64-Julia_Goerges-Romina_Oprandi,2,F-DTL,9,5,0,0,5,2,7
20130116-W-Australian_Open-R64-Julia_Goerges-Romina_Oprandi,2,F-IO,7,2,0,1,1,5,2
20130116-W-Australian_Open-R64-Julia_Goerges-Romina_Oprandi,2,B-XC,11,3,0,1,2,6,5
20130116-W-Australian_Open-R64-Julia_Goerges-Romina_Oprandi,2,B-DTM,8,1,0,0,1,3,5
20130116-W-Australian_Open-R64-Julia_Goerges-Romina_Oprandi,2,B-DTL,3,2,0,1,1,1,2
20130116-W-Australian_Open-R64-Julia_Goerges-Romina_Oprandi,2,B-IO,2,1,0,0,1,1,1
20130116-W-Australian_Open-R64-Julia_Goerges-Romina_Oprandi,2,S-XC,5,0,0,0,0,2,3
20130116-W-Australian_Open-R64-Julia_Goerges-Romina_Oprandi,2,S-DTM,5,0,0,0,0,1,4
20130116-W-Australian_Open-R64-Julia_Goerges-Romina_Oprandi,2,S-DTL,2,0,0,0,0,0,2
20130116-W-Australian_Open-R64-Julia_Goerges-Romina_Oprandi,2,S-IO,1,0,0,0,0,0,1
19950905-W-US_Open-QF-Monica_Seles-Jana_Novotna,1,F-XC,57,16,4,4,8,29,28
19950905-W-US_Open-QF-Monica_Seles-Jana_Novotna,1,F-DTM,16,2,0,1,1,5,11
19950905-W-US_Open-QF-Monica_Seles-Jana_Novotna,1,F-DTL,32,10,5,3,2,21,11
19950905-W-US_Open-QF-Monica_Seles-Jana_Novotna,1,F-IO,19,5,1,1,3,10,9
19950905-W-US_Open-QF-Monica_Seles-Jana_Novotna,1,B-XC,48,11,4,2,5,29,19
19950905-W-US_Open-QF-Monica_Seles-Jana_Novotna,1,B-DTM,29,5,1,1,3,14,15
19950905-W-US_Open-QF-Monica_Seles-Jana_Novotna,1,B-DTL,21,5,2,0,3,10,11
19950905-W-US_Open-QF-Monica_Seles-Jana_Novotna,1,B-IO,4,0,0,0,0,3,1
19950905-W-US_Open-QF-Monica_Seles-Jana_Novotna,1,S-XC,1,1,1,0,0,1,0
19950905-W-US_Open-QF-Monica_Seles-Jana_Novotna,1,S-DTM,3,0,0,0,0,2,1
19950905-W-US_Open-QF-Monica_Seles-Jana_Novotna,1,S-DTL,1,1,0,1,0,1,0
19950905-W-US_Open-QF-Monica_Seles-Jana_Novotna,2,F-XC,79,15,2,3,10,36,43
19950905-W-US_Open-QF-Monica_Seles-Jana_Novotna,2,F-DTM,30,3,0,1,2,11,19
19950905-W-US_Open-QF-Monica_Seles-Jana_Novotna,2,F-DTL,15,3,0,0,3,4,11
19950905-W-US_Open-QF-Monica_Seles-Jana_Novotna,2,F-IO,19,5,3,0,2,12,7
19950905-W-US_Open-QF-Monica_Seles-Jana_Novotna,2,F-II,1,1,0,1,0,1,0
19950905-W-US_Open-QF-Monica_Seles-Jana_Novotna,2,B-DTM,3,0,0,0,0,1,2
19950905-W-US_Open-QF-Monica_Seles-Jana_Novotna,2,S-XC,36,3,0,2,1,16,20
19950905-W-US_Open-QF-Monica_Seles-Jana_Novotna,2,S-DTM,21,3,0,0,3,13,8
19950905-W-US_Open-QF-Monica_Seles-Jana_Novotna,2,S-DTL,10,1,0,1,0,3,7
19950905-W-US_Open-QF-Monica_Seles-Jana_Novotna,2,S-IO,3,1,0,0,1,2,1
19960110-W-Sydney-R16-Monica_Seles-Dominique_Monami,1,F-XC,17,7,2,1,4,9,8
19960110-W-Sydney-R16-Monica_Seles-Dominique_Monami,1,F-DTM,11,1,0,0,1,4,7
19960110-W-Sydney-R16-Monica_Seles-Dominique_Monami,1,F-DTL,5,3,0,1,2,2,3
19960110-W-Sydney-R16-Monica_Seles-Dominique_Monami,1,F-IO,7,5,2,1,2,4,3
19960110-W-Sydney-R16-Monica_Seles-Dominique_Monami,1,B-XC,24,8,2,2,4,14,10
19960110-W-Sydney-R16-Monica_Seles-Dominique_Monami,1,B-DTM,14,1,0,1,0,8,6
19960110-W-Sydney-R16-Monica_Seles-Dominique_Monami,1,B-DTL,10,2,0,1,1,6,4
19960110-W-Sydney-R16-Monica_Seles-Dominique_Monami,1,B-IO,9,2,2,0,0,8,1
19960110-W-Sydney-R16-Monica_Seles-Dominique_Monami,1,S-DTL,1,0,0,0,0,0,1
19960110-W-Sydney-R16-Monica_Seles-Dominique_Monami,2,F-XC,18,5,0,0,5,7,11
19960110-W-Sydney-R16-Monica_Seles-Dominique_Monami,2,F-DTM,14,4,1,0,3,4,10
19960110-W-Sydney-R16-Monica_Seles-Dominique_Monami,2,F-DTL,6,5,2,1,2,4,2
19960110-W-Sydney-R16-Monica_Seles-Dominique_Monami,2,F-IO,5,3,1,1,1,2,3
19960110-W-Sydney-R16-Monica_Seles-Dominique_Monami,2,B-XC,19,5,4,0,1,9,10
19960110-W-Sydney-R16-Monica_Seles-Dominique_Monami,2,B-DTM,21,2,0,1,1,10,11
19960110-W-Sydney-R16-Monica_Seles-Dominique_Monami,2,B-DTL,8,3,0,0,3,1,7
19960110-W-Sydney-R16-Monica_Seles-Dominique_Monami,2,B-IO,1,0,0,0,0,0,1
19960110-W-Sydney-R16-Monica_Seles-Dominique_Monami,2,S-XC,1,1,0,0,1,0,1
19960110-W-Sydney-R16-Monica_Seles-Dominique_Monami,2,S-DTM,1,0,0,0,0,0,1
20150418-W-Fed_Cup_World_Group_SF-RR-Sabine_Lisicki-Anastasia_Pavlyuchenkova,1,F-XC,44,14,3,3,8,20,24
20150418-W-Fed_Cup_World_Group_SF-RR-Sabine_Lisicki-Anastasia_Pavlyuchenkova,1,F-DTM,24,5,0,1,4,12,12
20150418-W-Fed_Cup_World_Group_SF-RR-Sabine_Lisicki-Anastasia_Pavlyuchenkova,1,F-DTL,14,8,5,1,2,7,7
20150418-W-Fed_Cup_World_Group_SF-RR-Sabine_Lisicki-Anastasia_Pavlyuchenkova,1,F-IO,19,8,3,1,4,8,11
20150418-W-Fed_Cup_World_Group_SF-RR-Sabine_Lisicki-Anastasia_Pavlyuchenkova,1,F-II,1,1,0,1,0,1,0
20150418-W-Fed_Cup_World_Group_SF-RR-Sabine_Lisicki-Anastasia_Pavlyuchenkova,1,B-XC,31,9,6,2,1,18,13
20150418-W-Fed_Cup_World_Group_SF-RR-Sabine_Lisicki-Anastasia_Pavlyuchenkova,1,B-DTM,26,3,0,0,3,13,13
20150418-W-Fed_Cup_World_Group_SF-RR-Sabine_Lisicki-Anastasia_Pavlyuchenkova,1,B-DTL,8,5,3,0,2,4,4
20150418-W-Fed_Cup_World_Group_SF-RR-Sabine_Lisicki-Anastasia_Pavlyuchenkova,1,B-IO,3,1,0,0,1,1,2
20150418-W-Fed_Cup_World_Group_SF-RR-Sabine_Lisicki-Anastasia_Pavlyuchenkova,1,S-XC,2,0,0,0,0,2,0
20150418-W-Fed_Cup_World_Group_SF-RR-Sabine_Lisicki-Anastasia_Pavlyuchenkova,1,S-DTM,2,0,0,0,0,1,1
20150418-W-Fed_Cup_World_Group_SF-RR-Sabine_Lisicki-Anastasia_Pavlyuchenkova,1,S-DTL,1,0,0,0,0,0,1
20150418-W-Fed_Cup_World_Group_SF-RR-Sabine_Lisicki-Anastasia_Pavlyuchenkova,2,F-XC,38,6,2,3,1,20,18
20150418-W-Fed_Cup_World_Group_SF-RR-Sabine_Lisicki-Anastasia_Pavlyuchenkova,2,F-DTM,19,2,0,1,1,7,12
20150418-W-Fed_Cup_World_Group_SF-RR-Sabine_Lisicki-Anastasia_Pavlyuchenkova,2,F-DTL,17,7,2,1,4,10,7
20150418-W-Fed_Cup_World_Group_SF-RR-Sabine_Lisicki-Anastasia_Pavlyuchenkova,2,F-IO,18,7,2,1,4,9,9
20150418-W-Fed_Cup_World_Group_SF-RR-Sabine_Lisicki-Anastasia_Pavlyuchenkova,2,B-XC,33,10,2,3,5,15,18
20150418-W-Fed_Cup_World_Group_SF-RR-Sabine_Lisicki-Anastasia_Pavlyuchenkova,2,B-DTM,21,2,0,1,1,17,4
20150418-W-Fed_Cup_World_Group_SF-RR-Sabine_Lisicki-Anastasia_Pavlyuchenkova,2,B-DTL,17,8,2,3,3,10,7
20150418-W-Fed_Cup_World_Group_SF-RR-Sabine_Lisicki-Anastasia_Pavlyuchenkova,2,B-IO,8,4,0,2,2,4,4
20150418-W-Fed_Cup_World_Group_SF-RR-Sabine_Lisicki-Anastasia_Pavlyuchenkova,2,S-DTL,3,1,0,0,1,0,3
20160820-W-Cincinnati-SF-Garbine_Muguruza-Karolina_Pliskova,1,F-XC,20,7,1,1,5,8,12
20160820-W-Cincinnati-SF-Garbine_Muguruza-Karolina_Pliskova,1,F-DTM,14,3,0,0,3,3,11
20160820-W-Cincinnati-SF-Garbine_Muguruza-Karolina_Pliskova,1,F-DTL,1,1,0,0,1,0,1
20160820-W-Cincinnati-SF-Garbine_Muguruza-Karolina_Pliskova,1,F-IO,11,2,0,0,2,3,8
20160820-W-Cincinnati-SF-Garbine_Muguruza-Karolina_Pliskova,1,B-XC,13,2,0,1,1,6,7
20160820-W-Cincinnati-SF-Garbine_Muguruza-Karolina_Pliskova,1,B-DTM,11,2,0,0,2,1,10
20160820-W-Cincinnati-SF-Garbine_Muguruza-Karolina_Pliskova,1,B-DTL,5,3,2,0,1,3,2
20160820-W-Cincinnati-SF-Garbine_Muguruza-Karolina_Pliskova,1,B-IO,2,1,1,0,0,1,1
20160820-W-Cincinnati-SF-Garbine_Muguruza-Karolina_Pliskova,1,S-DTM,2,1,0,0,1,0,2
20160820-W-Cincinnati-SF-Garbine_Muguruza-Karolina_Pliskova,2,F-XC,14,7,2,0,5,7,7
20160820-W-Cincinnati-SF-Garbine_Muguruza-Karolina_Pliskova,2,F-DTM,4,0,0,0,0,3,1
20160820-W-Cincinnati-SF-Garbine_Muguruza-Karolina_Pliskova,2,F-DTL,3,1,1,0,0,1,2
20160820-W-Cincinnati-SF-Garbine_Muguruza-Karolina_Pliskova,2,F-IO,12,5,4,0,1,10,2
20160820-W-Cincinnati-SF-Garbine_Muguruza-Karolina_Pliskova,2,B-XC,10,4,0,1,3,5,5
20160820-W-Cincinnati-SF-Garbine_Muguruza-Karolina_Pliskova,2,B-DTM,15,1,0,0,1,10,5
20160820-W-Cincinnati-SF-Garbine_Muguruza-Karolina_Pliskova,2,B-DTL,4,1,1,0,0,3,1
20160820-W-Cincinnati-SF-Garbine_Muguruza-Karolina_Pliskova,2,B-IO,5,1,1,0,0,3,2
20160820-W-Cincinnati-SF-Garbine_Muguruza-Karolina_Pliskova,2,S-XC,5,2,0,1,1,3,2
20160820-W-Cincinnati-SF-Garbine_Muguruza-Karolina_Pliskova,2,S-DTM,2,0,0,0,0,2,0
20130331-W-Miami-F-Serena_Williams-Maria_Sharapova,1,F-XC,62,17,7,2,8,33,29
20130331-W-Miami-F-Serena_Williams-Maria_Sharapova,1,F-DTM,22,4,0,2,2,9,13
20130331-W-Miami-F-Serena_Williams-Maria_Sharapova,1,F-DTL,11,5,2,1,2,4,7
20130331-W-Miami-F-Serena_Williams-Maria_Sharapova,1,F-IO,9,6,3,1,2,5,4
20130331-W-Miami-F-Serena_Williams-Maria_Sharapova,1,B-XC,31,14,6,3,5,18,13
20130331-W-Miami-F-Serena_Williams-Maria_Sharapova,1,B-DTM,25,2,0,1,1,8,17
20130331-W-Miami-F-Serena_Williams-Maria_Sharapova,1,B-DTL,8,6,0,1,5,1,7
20130331-W-Miami-F-Serena_Williams-Maria_Sharapova,1,B-IO,4,3,2,0,1,2,2
20130331-W-Miami-F-Serena_Williams-Maria_Sharapova,2,F-XC,50,12,4,3,5,26,24
20130331-W-Miami-F-Serena_Williams-Maria_Sharapova,2,F-DTM,21,4,0,0,4,10,11
20130331-W-Miami-F-Serena_Williams-Maria_Sharapova,2,F-DTL,15,5,1,3,1,8,7
20130331-W-Miami-F-Serena_Williams-Maria_Sharapova,2,F-IO,9,5,3,0,2,5,4
20130331-W-Miami-F-Serena_Williams-Maria_Sharapova,2,B-XC,18,3,1,1,1,14,4
20130331-W-Miami-F-Serena_Williams-Maria_Sharapova,2,B-DTM,19,2,0,1,1,8,11
20130331-W-Miami-F-Serena_Williams-Maria_Sharapova,2,B-DTL,10,4,1,2,1,6,4
20130331-W-Miami-F-Serena_Williams-Maria_Sharapova,2,B-IO,7,2,0,1,1,5,2
20080607-W-Roland_Garros-F-Dinara_Safina-Ana_Ivanovic,1,F-XC,53,13,7,2,4,25,28
20080607-W-Roland_Garros-F-Dinara_Safina-Ana_Ivanovic,1,F-DTM,18,2,0,0,2,7,11
20080607-W-Roland_Garros-F-Dinara_Safina-Ana_Ivanovic,1,F-DTL,24,9,3,1,5,14,10
20080607-W-Roland_Garros-F-Dinara_Safina-Ana_Ivanovic,1,F-IO,20,3,0,0,3,9,11
20080607-W-Roland_Garros-F-Dinara_Safina-Ana_Ivanovic,1,B-XC,65,13,2,1,10,27,38
20080607-W-Roland_Garros-F-Dinara_Safina-Ana_Ivanovic,1,B-DTM,27,2,0,0,2,13,14
20080607-W-Roland_Garros-F-Dinara_Safina-Ana_Ivanovic,1,B-DTL,13,7,1,2,4,5,8
20080607-W-Roland_Garros-F-Dinara_Safina-Ana_Ivanovic,1,B-IO,8,6,3,1,2,5,3
20080607-W-Roland_Garros-F-Dinara_Safina-Ana_Ivanovic,1,S-XC,2,1,0,0,1,1,1
20080607-W-Roland_Garros-F-Dinara_Safina-Ana_Ivanovic,1,S-DTM,2,1,0,0,1,1,1
20080607-W-Roland_Garros-F-Dinara_Safina-Ana_Ivanovic,2,F-XC,37,12,6,0,6,20,17
20080607-W-Roland_Garros-F-Dinara_Safina-Ana_Ivanovic,2,F-DTM,19,1,0,0,1,13,6
20080607-W-Roland_Garros-F-Dinara_Safina-Ana_Ivanovic,2,F-DTL,27,3,2,1,0,19,8
20080607-W-Roland_Garros-F-Dinara_Safina-Ana_Ivanovic,2,F-IO,32,9,2,2,5,17,15
20080607-W-Roland_Garros-F-Dinara_Safina-Ana_Ivanovic,2,F-II,6,2,1,1,0,5,1
20080607-W-Roland_Garros-F-Dinara_Safina-Ana_Ivanovic,2,B-XC,29,3,0,0,3,13,16
20080607-W-Roland_Garros-F-Dinara_Safina-Ana_Ivanovic,2,B-DTM,31,1,0,0,1,20,11
20080607-W-Roland_Garros-F-Dinara_Safina-Ana_Ivanovic,2,B-DTL,28,11,3,2,6,13,15
20080607-W-Roland_Garros-F-Dinara_Safina-Ana_Ivanovic,2,B-IO,6,2,0,2,0,2,4
20080607-W-Roland_Garros-F-Dinara_Safina-Ana_Ivanovic,2,S-XC,4,1,0,1,0,3,1
20080607-W-Roland_Garros-F-Dinara_Safina-Ana_Ivanovic,2,S-DTM,10,0,0,0,0,4,6
20080607-W-Roland_Garros-F-Dinara_Safina-Ana_Ivanovic,2,S-DTL,4,1,0,0,1,1,3
20160114-W-Hobart-QF-Camila_Giorgi-Eugenie_Bouchard,1,F-XC,26,11,3,4,4,15,11
20160114-W-Hobart-QF-Camila_Giorgi-Eugenie_Bouchard,1,F-DTM,16,5,0,0,5,8,8
20160114-W-Hobart-QF-Camila_Giorgi-Eugenie_Bouchard,1,F-DTL,5,3,0,1,2,2,3
20160114-W-Hobart-QF-Camila_Giorgi-Eugenie_Bouchard,1,F-IO,5,2,0,1,1,3,2
20160114-W-Hobart-QF-Camila_Giorgi-Eugenie_Bouchard,1,B-XC,10,4,0,2,2,5,5
20160114-W-Hobart-QF-Camila_Giorgi-Eugenie_Bouchard,1,B-DTM,8,1,0,0,1,5,3
20160114-W-Hobart-QF-Camila_Giorgi-Eugenie_Bouchard,1,B-DTL,1,1,1,0,0,1,0
20160114-W-Hobart-QF-Camila_Giorgi-Eugenie_Bouchard,1,B-IO,1,1,0,1,0,1,0
20160114-W-Hobart-QF-Camila_Giorgi-Eugenie_Bouchard,1,S-DTM,1,0,0,0,0,0,1
20160114-W-Hobart-QF-Camila_Giorgi-Eugenie_Bouchard,2,F-XC,22,10,5,1,4,10,12
20160114-W-Hobart-QF-Camila_Giorgi-Eugenie_Bouchard,2,F-DTM,15,0,0,0,0,5,10
20160114-W-Hobart-QF-Camila_Giorgi-Eugenie_Bouchard,2,F-DTL,3,1,1,0,0,2,1
20160114-W-Hobart-QF-Camila_Giorgi-Eugenie_Bouchard,2,F-IO,12,6,1,2,3,5,7
20160114-W-Hobart-QF-Camila_Giorgi-Eugenie_Bouchard,2,B-XC,7,4,1,0,3,2,5
20160114-W-Hobart-QF-Camila_Giorgi-Eugenie_Bouchard,2,B-DTM,8,2,0,0,2,1,7
20160114-W-Hobart-QF-Camila_Giorgi-Eugenie_Bouchard,2,B-DTL,1,0,0,0,0,1,0
20160114-W-Hobart-QF-Camila_Giorgi-Eugenie_Bouchard,2,B-IO,1,1,1,0,0,1,0
20160114-W-Hobart-QF-Camila_Giorgi-Eugenie_Bouchard,2,S-XC,1,0,0,0,0,1,0
20160114-W-Hobart-QF-Camila_Giorgi-Eugenie_Bouchard,2,S-DTM,1,0,0,0,0,1,0
20160110-W-Hobart-R32-Maddison_Inglis-Margarita_Gasparyan,1,F-XC,33,6,3,2,1,17,16
20160110-W-Hobart-R32-Maddison_Inglis-Margarita_Gasparyan,1,F-DTM,14,4,0,2,2,8,6
20160110-W-Hobart-R32-Maddison_Inglis-Margarita_Gasparyan,1,F-DTL,12,7,3,2,2,9,3
20160110-W-Hobart-R32-Maddison_Inglis-Margarita_Gasparyan,1,F-IO,13,1,0,0,1,4,9
20160110-W-Hobart-R32-Maddison_Inglis-Margarita_Gasparyan,1,F-II,2,1,1,0,0,2,0
20160110-W-Hobart-R32-Maddison_Inglis-Margarita_Gasparyan,1,B-XC,31,8,1,2,5,17,14
20160110-W-Hobart-R32-Maddison_Inglis-Margarita_Gasparyan,1,B-DTM,17,1,0,0,1,13,4
20160110-W-Hobart-R32-Maddison_Inglis-Margarita_Gasparyan,1,B-DTL,9,4,0,1,3,4,5
20160110-W-Hobart-R32-Maddison_Inglis-Margarita_Gasparyan,1,B-IO,4,2,1,0,1,2,2
20160110-W-Hobart-R32-Maddison_Inglis-Margarita_Gasparyan,1,S-XC,4,0,0,0,0,2,2
20160110-W-Hobart-R32-Maddison_Inglis-Margarita_Gasparyan,1,S-DTM,1,0,0,0,0,0,1
20160110-W-Hobart-R32-Maddison_Inglis-Margarita_Gasparyan,1,S-DTL,1,0,0,0,0,0,1
20160110-W-Hobart-R32-Maddison_Inglis-Margarita_Gasparyan,2,F-XC,31,3,1,0,2,12,19
20160110-W-Hobart-R32-Maddison_Inglis-Margarita_Gasparyan,2,F-DTM,12,0,0,0,0,5,7
20160110-W-Hobart-R32-Maddison_Inglis-Margarita_Gasparyan,2,F-DTL,14,3,3,0,0,8,6
20160110-W-Hobart-R32-Maddison_Inglis-Margarita_Gasparyan,2,F-IO,8,6,3,1,2,6,2
20160110-W-Hobart-R32-Maddison_Inglis-Margarita_Gasparyan,2,B-XC,23,8,0,3,5,7,16
20160110-W-Hobart-R32-Maddison_Inglis-Margarita_Gasparyan,2,B-DTM,14,2,0,1,1,7,7
20160110-W-Hobart-R32-Maddison_Inglis-Margarita_Gasparyan,2,B-DTL,8,3,1,1,1,4,4
20160110-W-Hobart-R32-Maddison_Inglis-Margarita_Gasparyan,2,B-IO,7,3,1,0,2,2,5
20160110-W-Hobart-R32-Maddison_Inglis-Margarita_Gasparyan,2,S-XC,12,2,1,1,0,6,6
20160110-W-Hobart-R32-Maddison_Inglis-Margarita_Gasparyan,2,S-DTM,8,0,0,0,0,4,4
20160110-W-Hobart-R32-Maddison_Inglis-Margarita_Gasparyan,2,S-DTL,1,0,0,0,0,0,1
20160116-W-Hobart-SF-Eugenie_Bouchard-Dominika_Cibulkova,1,F-XC,27,11,7,3,1,21,6
20160116-W-Hobart-SF-Eugenie_Bouchard-Dominika_Cibulkova,1,F-DTM,48,5,0,1,4,15,33
20160116-W-Hobart-SF-Eugenie_Bouchard-Dominika_Cibulkova,1,F-DTL,4,2,0,0,2,2,2
20160116-W-Hobart-SF-Eugenie_Bouchard-Dominika_Cibulkova,1,F-IO,14,12,7,1,4,9,5
20160116-W-Hobart-SF-Eugenie_Bouchard-Dominika_Cibulkova,1,B-XC,26,9,3,3,3,13,13
20160116-W-Hobart-SF-Eugenie_Bouchard-Dominika_Cibulkova,1,B-DTM,52,5,0,2,3,27,25
20160116-W-Hobart-SF-Eugenie_Bouchard-Dominika_Cibulkova,1,B-DTL,2,1,0,0,1,1,1
20160116-W-Hobart-SF-Eugenie_Bouchard-Dominika_Cibulkova,1,B-IO,10,2,1,0,1,4,6
20160116-W-Hobart-SF-Eugenie_Bouchard-Dominika_Cibulkova,1,B-II,1,1,0,0,1,0,1
20160116-W-Hobart-SF-Eugenie_Bouchard-Dominika_Cibulkova,1,S-DTM,5,1,0,1,0,2,3
20160116-W-Hobart-SF-Eugenie_Bouchard-Dominika_Cibulkova,2,F-XC,30,13,9,3,1,22,8
20160116-W-Hobart-SF-Eugenie_Bouchard-Dominika_Cibulkova,2,F-DTM,49,5,1,1,3,22,27
20160116-W-Hobart-SF-Eugenie_Bouchard-Dominika_Cibulkova,2,F-DTL,8,4,3,1,0,4,4
20160116-W-Hobart-SF-Eugenie_Bouchard-Dominika_Cibulkova,2,F-IO,27,10,2,4,4,15,12
20160116-W-Hobart-SF-Eugenie_Bouchard-Dominika_Cibulkova,2,B-XC,12,5,1,2,2,10,2
20160116-W-Hobart-SF-Eugenie_Bouchard-Dominika_Cibulkova,2,B-DTM,49,6,1,3,2,27,22
20160116-W-Hobart-SF-Eugenie_Bouchard-Dominika_Cibulkova,2,B-DTL,4,4,1,1,2,2,2
20160116-W-Hobart-SF-Eugenie_Bouchard-Dominika_Cibulkova,2,S-DTM,8,0,0,0,0,0,8
20110602-W-Roland_Garros-SF-Na_Li-Maria_Sharapova,1,F-XC,70,27,10,8,9,47,23
20110602-W-Roland_Garros-SF-Na_Li-Maria_Sharapova,1,F-DTM,28,2,0,0,2,12,16
20110602-W-Roland_Garros-SF-Na_Li-Maria_Sharapova,1,F-DTL,20,6,5,0,1,13,7
20110602-W-Roland_Garros-SF-Na_Li-Maria_Sharapova,1,F-IO,21,5,2,1,2,14,7
20110602-W-Roland_Garros-SF-Na_Li-Maria_Sharapova,1,F-II,1,1,1,0,0,1,0
20110602-W-Roland_Garros-SF-Na_Li-Maria_Sharapova,1,B-XC,25,6,2,1,3,15,10
20110602-W-Roland_Garros-SF-Na_Li-Maria_Sharapova,1,B-DTM,18,2,0,1,1,7,11
20110602-W-Roland_Garros-SF-Na_Li-Maria_Sharapova,1,B-DTL,12,7,1,4,2,8,4
20110602-W-Roland_Garros-SF-Na_Li-Maria_Sharapova,1,B-IO,7,3,1,0,2,4,3
20110602-W-Roland_Garros-SF-Na_Li-Maria_Sharapova,1,S-XC,1,0,0,0,0,1,0
20110602-W-Roland_Garros-SF-Na_Li-Maria_Sharapova,1,S-DTM,2,0,0,0,0,2,0
20110602-W-Roland_Garros-SF-Na_Li-Maria_Sharapova,1,S-DTL,1,0,0,0,0,1,0
20110602-W-Roland_Garros-SF-Na_Li-Maria_Sharapova,2,F-XC,44,7,1,2,4,18,26
20110602-W-Roland_Garros-SF-Na_Li-Maria_Sharapova,2,F-DTM,31,5,0,1,4,11,20
20110602-W-Roland_Garros-SF-Na_Li-Maria_Sharapova,2,F-DTL,7,2,1,0,1,1,6
20110602-W-Roland_Garros-SF-Na_Li-Maria_Sharapova,2,F-IO,11,5,3,1,1,5,6
20110602-W-Roland_Garros-SF-Na_Li-Maria_Sharapova,2,B-XC,29,4,1,2,1,14,15
20110602-W-Roland_Garros-SF-Na_Li-Maria_Sharapova,2,B-DTM,40,7,0,2,5,14,26
20110602-W-Roland_Garros-SF-Na_Li-Maria_Sharapova,2,B-DTL,13,3,1,1,1,9,4
20110602-W-Roland_Garros-SF-Na_Li-Maria_Sharapova,2,B-IO,9,1,1,0,0,7,2
20170121-W-Australian_Open-R32-Serena_Williams-Nicole_Gibbs,1,F-XC,22,9,2,2,5,9,13
20170121-W-Australian_Open-R32-Serena_Williams-Nicole_Gibbs,1,F-DTM,7,1,0,0,1,5,2
20170121-W-Australian_Open-R32-Serena_Williams-Nicole_Gibbs,1,F-DTL,2,0,0,0,0,1,1
20170121-W-Australian_Open-R32-Serena_Williams-Nicole_Gibbs,1,F-IO,8,4,1,0,3,3,5
20170121-W-Australian_Open-R32-Serena_Williams-Nicole_Gibbs,1,F-II,1,1,1,0,0,1,0
20170121-W-Australian_Open-R32-Serena_Williams-Nicole_Gibbs,1,B-XC,12,3,0,1,2,7,5
20170121-W-Australian_Open-R32-Serena_Williams-Nicole_Gibbs,1,B-DTM,14,1,0,1,0,9,5
20170121-W-Australian_Open-R32-Serena_Williams-Nicole_Gibbs,1,B-DTL,1,0,0,0,0,1,0
20170121-W-Australian_Open-R32-Serena_Williams-Nicole_Gibbs,1,B-IO,3,1,0,0,1,1,2
20170121-W-Australian_Open-R32-Serena_Williams-Nicole_Gibbs,1,S-XC,2,0,0,0,0,1,1
20170121-W-Australian_Open-R32-Serena_Williams-Nicole_Gibbs,2,F-XC,16,8,5,0,3,10,6
20170121-W-Australian_Open-R32-Serena_Williams-Nicole_Gibbs,2,F-DTM,17,4,0,0,4,6,11
20170121-W-Australian_Open-R32-Serena_Williams-Nicole_Gibbs,2,F-DTL,3,1,0,1,0,3,0
20170121-W-Australian_Open-R32-Serena_Williams-Nicole_Gibbs,2,F-IO,11,8,2,1,5,4,7
20170121-W-Australian_Open-R32-Serena_Williams-Nicole_Gibbs,2,B-XC,4,0,0,0,0,2,2
20170121-W-Australian_Open-R32-Serena_Williams-Nicole_Gibbs,2,B-DTM,18,2,0,1,1,9,9
20170121-W-Australian_Open-R32-Serena_Williams-Nicole_Gibbs,2,B-DTL,2,0,0,0,0,1,1
20170121-W-Australian_Open-R32-Serena_Williams-Nicole_Gibbs,2,B-IO,2,1,0,0,1,1,1
20170121-W-Australian_Open-R32-Serena_Williams-Nicole_Gibbs,2,S-XC,5,0,0,0,0,1,4
20170121-W-Australian_Open-R32-Serena_Williams-Nicole_Gibbs,2,S-DTM,3,2,0,0,2,0,3
20170121-W-Australian_Open-R32-Serena_Williams-Nicole_Gibbs,2,S-IO,1,1,0,1,0,1,0
20160524-W-Roland_Garros-R128-Eugenie_Bouchard-Laura_Siegemund,1,F-XC,34,8,3,3,2,20,14
20160524-W-Roland_Garros-R128-Eugenie_Bouchard-Laura_Siegemund,1,F-DTM,11,1,0,0,1,6,5
20160524-W-Roland_Garros-R128-Eugenie_Bouchard-Laura_Siegemund,1,F-DTL,18,8,2,3,3,7,11
20160524-W-Roland_Garros-R128-Eugenie_Bouchard-Laura_Siegemund,1,F-IO,10,3,1,2,0,8,2
20160524-W-Roland_Garros-R128-Eugenie_Bouchard-Laura_Siegemund,1,F-II,1,0,0,0,0,0,1
20160524-W-Roland_Garros-R128-Eugenie_Bouchard-Laura_Siegemund,1,B-XC,28,5,1,4,0,18,10
20160524-W-Roland_Garros-R128-Eugenie_Bouchard-Laura_Siegemund,1,B-DTM,8,0,0,0,0,4,4
20160524-W-Roland_Garros-R128-Eugenie_Bouchard-Laura_Siegemund,1,B-DTL,4,3,2,0,1,2,2
20160524-W-Roland_Garros-R128-Eugenie_Bouchard-Laura_Siegemund,1,B-IO,2,0,0,0,0,2,0
20160524-W-Roland_Garros-R128-Eugenie_Bouchard-Laura_Siegemund,1,S-XC,1,0,0,0,0,0,1
20160524-W-Roland_Garros-R128-Eugenie_Bouchard-Laura_Siegemund,1,S-DTM,2,0,0,0,0,0,2
20160524-W-Roland_Garros-R128-Eugenie_Bouchard-Laura_Siegemund,1,S-DTL,1,0,0,0,0,0,1
20160524-W-Roland_Garros-R128-Eugenie_Bouchard-Laura_Siegemund,2,F-XC,19,1,0,0,1,10,9
20160524-W-Roland_Garros-R128-Eugenie_Bouchard-Laura_Siegemund,2,F-DTM,10,0,0,0,0,5,5
20160524-W-Roland_Garros-R128-Eugenie_Bouchard-Laura_Siegemund,2,F-DTL,12,4,1,1,2,7,5
20160524-W-Roland_Garros-R128-Eugenie_Bouchard-Laura_Siegemund,2,F-IO,8,1,0,1,0,4,4
20160524-W-Roland_Garros-R128-Eugenie_Bouchard-Laura_Siegemund,2,F-II,1,1,1,0,0,1,0
20160524-W-Roland_Garros-R128-Eugenie_Bouchard-Laura_Siegemund,2,B-XC,15,6,3,1,2,6,9
20160524-W-Roland_Garros-R128-Eugenie_Bouchard-Laura_Siegemund,2,B-DTM,6,1,0,0,1,2,4
20160524-W-Roland_Garros-R128-Eugenie_Bouchard-Laura_Siegemund,2,B-DTL,18,9,4,0,5,9,9
20160524-W-Roland_Garros-R128-Eugenie_Bouchard-Laura_Siegemund,2,B-IO,6,0,0,0,0,3,3
20160524-W-Roland_Garros-R128-Eugenie_Bouchard-Laura_Siegemund,2,B-II,1,0,0,0,0,0,1
20160524-W-Roland_Garros-R128-Eugenie_Bouchard-Laura_Siegemund,2,S-XC,7,1,0,1,0,7,0
20160524-W-Roland_Garros-R128-Eugenie_Bouchard-Laura_Siegemund,2,S-DTM,9,0,0,0,0,3,6
20160524-W-Roland_Garros-R128-Eugenie_Bouchard-Laura_Siegemund,2,S-DTL,4,0,0,0,0,1,3
20140603-W-Roland_Garros-QF-Eugenie_Bouchard-Carla_Suarez_Navarro,1,F-XC,85,12,2,4,6,53,32
20140603-W-Roland_Garros-QF-Eugenie_Bouchard-Carla_Suarez_Navarro,1,F-DTM,15,0,0,0,0,8,7
20140603-W-Roland_Garros-QF-Eugenie_Bouchard-Carla_Suarez_Navarro,1,F-DTL,19,8,2,3,3,14,5
20140603-W-Roland_Garros-QF-Eugenie_Bouchard-Carla_Suarez_Navarro,1,F-IO,29,8,3,1,4,13,16
20140603-W-Roland_Garros-QF-Eugenie_Bouchard-Carla_Suarez_Navarro,1,F-II,3,1,0,1,0,2,1
20140603-W-Roland_Garros-QF-Eugenie_Bouchard-Carla_Suarez_Navarro,1,B-XC,91,18,7,4,7,48,43
20140603-W-Roland_Garros-QF-Eugenie_Bouchard-Carla_Suarez_Navarro,1,B-DTM,31,4,0,1,3,10,21
20140603-W-Roland_Garros-QF-Eugenie_Bouchard-Carla_Suarez_Navarro,1,B-DTL,25,12,9,2,1,19,6
20140603-W-Roland_Garros-QF-Eugenie_Bouchard-Carla_Suarez_Navarro,1,B-IO,6,5,3,0,2,4,2
20140603-W-Roland_Garros-QF-Eugenie_Bouchard-Carla_Suarez_Navarro,1,S-XC,3,1,0,0,1,0,3
20140603-W-Roland_Garros-QF-Eugenie_Bouchard-Carla_Suarez_Navarro,1,S-DTM,1,0,0,0,0,0,1
20140603-W-Roland_Garros-QF-Eugenie_Bouchard-Carla_Suarez_Navarro,2,F-XC,89,21,8,7,6,43,46
20140603-W-Roland_Garros-QF-Eugenie_Bouchard-Carla_Suarez_Navarro,2,F-DTM,28,4,0,1,3,12,16
20140603-W-Roland_Garros-QF-Eugenie_Bouchard-Carla_Suarez_Navarro,2,F-DTL,32,8,2,2,4,15,17
20140603-W-Roland_Garros-QF-Eugenie_Bouchard-Carla_Suarez_Navarro,2,F-IO,17,4,4,0,0,14,3
20140603-W-Roland_Garros-QF-Eugenie_Bouchard-Carla_Suarez_Navarro,2,F-II,4,3,1,2,0,4,0
20140603-W-Roland_Garros-QF-Eugenie_Bouchard-Carla_Suarez_Navarro,2,B-XC,63,8,1,5,2,36,27
20140603-W-Roland_Garros-QF-Eugenie_Bouchard-Carla_Suarez_Navarro,2,B-DTM,23,2,0,0,2,9,14
20140603-W-Roland_Garros-QF-Eugenie_Bouchard-Carla_Suarez_Navarro,2,B-DTL,8,5,1,2,2,4,4
20140603-W-Roland_Garros-QF-Eugenie_Bouchard-Carla_Suarez_Navarro,2,B-IO,4,1,0,0,1,1,3
20140603-W-Roland_Garros-QF-Eugenie_Bouchard-Carla_Suarez_Navarro,2,B-II,1,0,0,0,0,0,1
20140603-W-Roland_Garros-QF-Eugenie_Bouchard-Carla_Suarez_Navarro,2,S-XC,24,1,0,0,1,9,15
20140603-W-Roland_Garros-QF-Eugenie_Bouchard-Carla_Suarez_Navarro,2,S-DTM,7,1,0,0,1,2,5
20140603-W-Roland_Garros-QF-Eugenie_Bouchard-Carla_Suarez_Navarro,2,S-DTL,5,2,0,2,0,3,2
20140605-W-Roland_Garros-SF-Maria_Sharapova-Eugenie_Bouchard,1,F-XC,57,18,5,8,5,34,23
20140605-W-Roland_Garros-SF-Maria_Sharapova-Eugenie_Bouchard,1,F-DTM,18,0,0,0,0,9,9
20140605-W-Roland_Garros-SF-Maria_Sharapova-Eugenie_Bouchard,1,F-DTL,32,12,6,2,4,16,16
20140605-W-Roland_Garros-SF-Maria_Sharapova-Eugenie_Bouchard,1,F-IO,8,5,2,2,1,5,3
20140605-W-Roland_Garros-SF-Maria_Sharapova-Eugenie_Bouchard,1,F-II,1,0,0,0,0,0,1
20140605-W-Roland_Garros-SF-Maria_Sharapova-Eugenie_Bouchard,1,B-XC,59,9,1,4,4,30,29
20140605-W-Roland_Garros-SF-Maria_Sharapova-Eugenie_Bouchard,1,B-DTM,35,2,0,0,2,16,19
20140605-W-Roland_Garros-SF-Maria_Sharapova-Eugenie_Bouchard,1,B-DTL,16,13,7,1,5,10,6
20140605-W-Roland_Garros-SF-Maria_Sharapova-Eugenie_Bouchard,1,B-IO,5,1,1,0,0,5,0
20140605-W-Roland_Garros-SF-Maria_Sharapova-Eugenie_Bouchard,1,B-II,1,0,0,0,0,0,1
20140605-W-Roland_Garros-SF-Maria_Sharapova-Eugenie_Bouchard,1,S-DTM,3,0,0,0,0,1,2
20140605-W-Roland_Garros-SF-Maria_Sharapova-Eugenie_Bouchard,2,F-XC,64,18,3,3,12,32,32
20140605-W-Roland_Garros-SF-Maria_Sharapova-Eugenie_Bouchard,2,F-DTM,13,1,0,0,1,5,8
20140605-W-Roland_Garros-SF-Maria_Sharapova-Eugenie_Bouchard,2,F-DTL,25,12,6,2,4,12,13
20140605-W-Roland_Garros-SF-Maria_Sharapova-Eugenie_Bouchard,2,F-IO,20,6,2,2,2,11,9
20140605-W-Roland_Garros-SF-Maria_Sharapova-Eugenie_Bouchard,2,F-II,1,0,0,0,0,1,0
20140605-W-Roland_Garros-SF-Maria_Sharapova-Eugenie_Bouchard,2,B-XC,58,14,5,4,5,34,24
20140605-W-Roland_Garros-SF-Maria_Sharapova-Eugenie_Bouchard,2,B-DTM,27,0,0,0,0,11,16
20140605-W-Roland_Garros-SF-Maria_Sharapova-Eugenie_Bouchard,2,B-DTL,24,12,5,3,4,14,10
20140605-W-Roland_Garros-SF-Maria_Sharapova-Eugenie_Bouchard,2,B-IO,7,3,1,1,1,5,2
20140605-W-Roland_Garros-SF-Maria_Sharapova-Eugenie_Bouchard,2,S-XC,3,0,0,0,0,1,2
20140605-W-Roland_Garros-SF-Maria_Sharapova-Eugenie_Bouchard,2,S-DTM,1,0,0,0,0,0,1
20140605-W-Roland_Garros-SF-Maria_Sharapova-Eugenie_Bouchard,2,S-DTL,1,0,0,0,0,0,1
20170112-W-Sydney-SF-Eugenie_Bouchard-Johanna_Konta,1,F-XC,30,9,1,3,5,15,15
20170112-W-Sydney-SF-Eugenie_Bouchard-Johanna_Konta,1,F-DTM,11,1,0,0,1,3,8
20170112-W-Sydney-SF-Eugenie_Bouchard-Johanna_Konta,1,F-DTL,7,2,0,2,0,4,3
20170112-W-Sydney-SF-Eugenie_Bouchard-Johanna_Konta,1,F-IO,6,2,1,1,0,5,1
20170112-W-Sydney-SF-Eugenie_Bouchard-Johanna_Konta,1,B-XC,19,4,1,0,3,8,11
20170112-W-Sydney-SF-Eugenie_Bouchard-Johanna_Konta,1,B-DTM,8,1,0,0,1,1,7
20170112-W-Sydney-SF-Eugenie_Bouchard-Johanna_Konta,1,B-DTL,1,1,0,0,1,0,1
20170112-W-Sydney-SF-Eugenie_Bouchard-Johanna_Konta,1,B-IO,2,1,0,0,1,0,2
20170112-W-Sydney-SF-Eugenie_Bouchard-Johanna_Konta,1,S-DTM,2,0,0,0,0,0,2
20170112-W-Sydney-SF-Eugenie_Bouchard-Johanna_Konta,1,S-DTL,1,0,0,0,0,0,1
20170112-W-Sydney-SF-Eugenie_Bouchard-Johanna_Konta,2,F-XC,28,9,3,2,4,17,11
20170112-W-Sydney-SF-Eugenie_Bouchard-Johanna_Konta,2,F-DTM,11,1,0,1,0,6,5
20170112-W-Sydney-SF-Eugenie_Bouchard-Johanna_Konta,2,F-DTL,5,2,0,0,2,2,3
20170112-W-Sydney-SF-Eugenie_Bouchard-Johanna_Konta,2,F-IO,9,6,3,1,2,6,3
20170112-W-Sydney-SF-Eugenie_Bouchard-Johanna_Konta,2,B-XC,16,4,3,1,0,12,4
20170112-W-Sydney-SF-Eugenie_Bouchard-Johanna_Konta,2,B-DTM,12,1,1,0,0,5,7
20170112-W-Sydney-SF-Eugenie_Bouchard-Johanna_Konta,2,B-DTL,6,2,1,1,0,3,3
20170112-W-Sydney-SF-Eugenie_Bouchard-Johanna_Konta,2,B-IO,3,3,0,1,2,1,2
20170112-W-Sydney-SF-Eugenie_Bouchard-Johanna_Konta,2,S-XC,1,0,0,0,0,1,0
20170112-W-Sydney-SF-Eugenie_Bouchard-Johanna_Konta,2,S-DTM,1,0,0,0,0,0,1
20170116-W-Australian_Open-R128-Louisa_Chirico-Eugenie_Bouchard,1,F-XC,19,4,2,1,1,10,9
20170116-W-Australian_Open-R128-Louisa_Chirico-Eugenie_Bouchard,1,F-DTM,15,2,0,0,2,7,8
20170116-W-Australian_Open-R128-Louisa_Chirico-Eugenie_Bouchard,1,F-DTL,9,2,1,0,1,3,6
20170116-W-Australian_Open-R128-Louisa_Chirico-Eugenie_Bouchard,1,F-IO,10,1,0,0,1,4,6
20170116-W-Australian_Open-R128-Louisa_Chirico-Eugenie_Bouchard,1,F-II,1,0,0,0,0,0,1
20170116-W-Australian_Open-R128-Louisa_Chirico-Eugenie_Bouchard,1,B-XC,19,4,0,2,2,7,12
20170116-W-Australian_Open-R128-Louisa_Chirico-Eugenie_Bouchard,1,B-DTM,17,1,0,0,1,3,14
20170116-W-Australian_Open-R128-Louisa_Chirico-Eugenie_Bouchard,1,B-DTL,7,4,2,0,2,3,4
20170116-W-Australian_Open-R128-Louisa_Chirico-Eugenie_Bouchard,1,B-IO,2,1,0,0,1,0,2
20170116-W-Australian_Open-R128-Louisa_Chirico-Eugenie_Bouchard,1,S-XC,2,0,0,0,0,0,2
20170116-W-Australian_Open-R128-Louisa_Chirico-Eugenie_Bouchard,1,S-DTM,2,0,0,0,0,1,1
20170116-W-Australian_Open-R128-Louisa_Chirico-Eugenie_Bouchard,2,F-XC,19,3,1,1,1,13,6
20170116-W-Australian_Open-R128-Louisa_Chirico-Eugenie_Bouchard,2,F-DTM,6,0,0,0,0,5,1
20170116-W-Australian_Open-R128-Louisa_Chirico-Eugenie_Bouchard,2,F-DTL,9,7,4,2,1,7,2
20170116-W-Australian_Open-R128-Louisa_Chirico-Eugenie_Bouchard,2,F-IO,5,5,3,1,1,4,1
20170116-W-Australian_Open-R128-Louisa_Chirico-Eugenie_Bouchard,2,F-II,1,0,0,0,0,1,0
20170116-W-Australian_Open-R128-Louisa_Chirico-Eugenie_Bouchard,2,B-XC,40,11,4,3,4,27,13
20170116-W-Australian_Open-R128-Louisa_Chirico-Eugenie_Bouchard,2,B-DTM,16,3,0,2,1,10,6
20170116-W-Australian_Open-R128-Louisa_Chirico-Eugenie_Bouchard,2,B-DTL,5,2,2,0,0,3,2
20170116-W-Australian_Open-R128-Louisa_Chirico-Eugenie_Bouchard,2,B-IO,3,3,1,0,2,1,2
20170116-W-Australian_Open-R128-Louisa_Chirico-Eugenie_Bouchard,2,S-XC,1,0,0,0,0,1,0
20170118-W-Australian_Open-R64-Shuai_Peng-Eugenie_Bouchard,1,F-XC,27,4,0,1,3,11,16
20170118-W-Australian_Open-R64-Shuai_Peng-Eugenie_Bouchard,1,F-DTM,13,1,0,1,0,4,9
20170118-W-Australian_Open-R64-Shuai_Peng-Eugenie_Bouchard,1,F-DTL,22,8,4,0,4,11,11
20170118-W-Australian_Open-R64-Shuai_Peng-Eugenie_Bouchard,1,F-IO,16,4,0,3,1,8,8
20170118-W-Australian_Open-R64-Shuai_Peng-Eugenie_Bouchard,1,B-XC,29,9,6,2,1,19,10
20170118-W-Australian_Open-R64-Shuai_Peng-Eugenie_Bouchard,1,B-DTM,13,2,0,1,1,5,8
20170118-W-Australian_Open-R64-Shuai_Peng-Eugenie_Bouchard,1,B-DTL,18,8,2,1,5,8,10
20170118-W-Australian_Open-R64-Shuai_Peng-Eugenie_Bouchard,1,B-IO,10,4,2,1,1,6,4
20170118-W-Australian_Open-R64-Shuai_Peng-Eugenie_Bouchard,1,S-XC,1,0,0,0,0,0,1
20170118-W-Australian_Open-R64-Shuai_Peng-Eugenie_Bouchard,2,F-XC,42,9,2,5,2,26,16
20170118-W-Australian_Open-R64-Shuai_Peng-Eugenie_Bouchard,2,F-DTM,12,2,0,1,1,5,7
20170118-W-Australian_Open-R64-Shuai_Peng-Eugenie_Bouchard,2,F-DTL,17,6,3,1,2,10,7
20170118-W-Australian_Open-R64-Shuai_Peng-Eugenie_Bouchard,2,F-IO,3,2,1,1,0,2,1
20170118-W-Australian_Open-R64-Shuai_Peng-Eugenie_Bouchard,2,F-II,1,1,0,0,1,0,1
20170118-W-Australian_Open-R64-Shuai_Peng-Eugenie_Bouchard,2,B-XC,29,4,2,0,2,17,12
20170118-W-Australian_Open-R64-Shuai_Peng-Eugenie_Bouchard,2,B-DTM,26,2,0,1,1,17,9
20170118-W-Australian_Open-R64-Shuai_Peng-Eugenie_Bouchard,2,B-DTL,7,3,2,0,1,4,3
20170118-W-Australian_Open-R64-Shuai_Peng-Eugenie_Bouchard,2,B-IO,3,1,0,1,0,3,0
20170118-W-Australian_Open-R64-Shuai_Peng-Eugenie_Bouchard,2,S-DTM,3,0,0,0,0,0,3
20170118-W-Australian_Open-R64-Shuai_Peng-Eugenie_Bouchard,2,S-DTL,1,0,0,0,0,1,0
20170120-W-Australian_Open-R32-Eugenie_Bouchard-Coco_Vandeweghe,1,F-XC,27,11,3,0,8,8,19
20170120-W-Australian_Open-R32-Eugenie_Bouchard-Coco_Vandeweghe,1,F-DTM,29,1,0,0,1,18,11
20170120-W-Australian_Open-R32-Eugenie_Bouchard-Coco_Vandeweghe,1,F-DTL,18,9,3,5,1,12,6
20170120-W-Australian_Open-R32-Eugenie_Bouchard-Coco_Vandeweghe,1,F-IO,20,10,4,5,1,13,7
20170120-W-Australian_Open-R32-Eugenie_Bouchard-Coco_Vandeweghe,1,F-II,1,1,0,0,1,0,1
20170120-W-Australian_Open-R32-Eugenie_Bouchard-Coco_Vandeweghe,1,B-XC,18,6,1,4,1,7,11
20170120-W-Australian_Open-R32-Eugenie_Bouchard-Coco_Vandeweghe,1,B-DTM,30,6,0,3,3,9,21
20170120-W-Australian_Open-R32-Eugenie_Bouchard-Coco_Vandeweghe,1,B-DTL,6,3,0,1,2,2,4
20170120-W-Australian_Open-R32-Eugenie_Bouchard-Coco_Vandeweghe,1,B-IO,2,1,1,0,0,2,0
20170120-W-Australian_Open-R32-Eugenie_Bouchard-Coco_Vandeweghe,1,S-DTM,2,0,0,0,0,0,2
20170120-W-Australian_Open-R32-Eugenie_Bouchard-Coco_Vandeweghe,2,F-XC,49,22,7,5,10,27,22
20170120-W-Australian_Open-R32-Eugenie_Bouchard-Coco_Vandeweghe,2,F-DTM,21,6,1,3,2,11,10
20170120-W-Australian_Open-R32-Eugenie_Bouchard-Coco_Vandeweghe,2,F-DTL,2,1,1,0,0,2,0
20170120-W-Australian_Open-R32-Eugenie_Bouchard-Coco_Vandeweghe,2,F-IO,7,3,1,2,0,7,0
20170120-W-Australian_Open-R32-Eugenie_Bouchard-Coco_Vandeweghe,2,F-II,1,0,0,0,0,1,0
20170120-W-Australian_Open-R32-Eugenie_Bouchard-Coco_Vandeweghe,2,B-XC,24,11,3,5,3,17,7
20170120-W-Australian_Open-R32-Eugenie_Bouchard-Coco_Vandeweghe,2,B-DTM,19,2,0,1,1,11,8
20170120-W-Australian_Open-R32-Eugenie_Bouchard-Coco_Vandeweghe,2,B-DTL,6,3,3,0,0,4,2
20170120-W-Australian_Open-R32-Eugenie_Bouchard-Coco_Vandeweghe,2,B-IO,5,3,2,1,0,4,1
20170120-W-Australian_Open-R32-Eugenie_Bouchard-Coco_Vandeweghe,2,S-XC,3,0,0,0,0,3,0
20170120-W-Australian_Open-R32-Eugenie_Bouchard-Coco_Vandeweghe,2,S-DTM,2,1,0,0,1,0,2
20170120-W-Australian_Open-R32-Eugenie_Bouchard-Coco_Vandeweghe,2,S-DTL,3,1,0,0,1,1,2
20041116-W-Tour_Championships-F-Maria_Sharapova-Serena_Williams,1,F-XC,32,10,1,4,5,19,13
20041116-W-Tour_Championships-F-Maria_Sharapova-Serena_Williams,1,F-DTM,16,1,0,0,1,3,13
20041116-W-Tour_Championships-F-Maria_Sharapova-Serena_Williams,1,F-DTL,13,5,2,2,1,6,7
20041116-W-Tour_Championships-F-Maria_Sharapova-Serena_Williams,1,F-IO,14,6,1,2,3,5,9
20041116-W-Tour_Championships-F-Maria_Sharapova-Serena_Williams,1,F-II,1,0,0,0,0,0,1
20041116-W-Tour_Championships-F-Maria_Sharapova-Serena_Williams,1,B-XC,24,8,1,4,3,15,9
20041116-W-Tour_Championships-F-Maria_Sharapova-Serena_Williams,1,B-DTM,11,4,0,1,3,2,9
20041116-W-Tour_Championships-F-Maria_Sharapova-Serena_Williams,1,B-DTL,14,6,2,1,3,6,8
20041116-W-Tour_Championships-F-Maria_Sharapova-Serena_Williams,1,B-IO,4,1,0,1,0,3,1
20041116-W-Tour_Championships-F-Maria_Sharapova-Serena_Williams,2,F-XC,43,15,4,4,7,23,20
20041116-W-Tour_Championships-F-Maria_Sharapova-Serena_Williams,2,F-DTM,13,1,1,0,0,7,6
20041116-W-Tour_Championships-F-Maria_Sharapova-Serena_Williams,2,F-DTL,8,7,2,1,4,3,5
20041116-W-Tour_Championships-F-Maria_Sharapova-Serena_Williams,2,F-IO,7,2,0,1,1,4,3
20041116-W-Tour_Championships-F-Maria_Sharapova-Serena_Williams,2,B-XC,26,5,1,2,2,16,10
20041116-W-Tour_Championships-F-Maria_Sharapova-Serena_Williams,2,B-DTM,21,3,0,2,1,15,6
20041116-W-Tour_Championships-F-Maria_Sharapova-Serena_Williams,2,B-DTL,4,3,3,0,0,3,1
20041116-W-Tour_Championships-F-Maria_Sharapova-Serena_Williams,2,B-IO,2,0,0,0,0,1,1
20041116-W-Tour_Championships-F-Maria_Sharapova-Serena_Williams,2,S-XC,1,0,0,0,0,0,1
20041116-W-Tour_Championships-F-Maria_Sharapova-Serena_Williams,2,S-DTM,2,0,0,0,0,1,1
20160522-W-Roland_Garros-R128-Heather_Watson-Nicole_Gibbs,1,F-XC,111,17,4,3,10,64,47
20160522-W-Roland_Garros-R128-Heather_Watson-Nicole_Gibbs,1,F-DTM,22,0,0,0,0,10,12
20160522-W-Roland_Garros-R128-Heather_Watson-Nicole_Gibbs,1,F-DTL,30,9,3,3,3,18,12
20160522-W-Roland_Garros-R128-Heather_Watson-Nicole_Gibbs,1,F-IO,30,9,4,2,3,19,11
20160522-W-Roland_Garros-R128-Heather_Watson-Nicole_Gibbs,1,F-II,3,3,0,0,3,0,3
20160522-W-Roland_Garros-R128-Heather_Watson-Nicole_Gibbs,1,B-XC,106,10,3,4,3,50,56
20160522-W-Roland_Garros-R128-Heather_Watson-Nicole_Gibbs,1,B-DTM,22,2,0,0,2,5,17
20160522-W-Roland_Garros-R128-Heather_Watson-Nicole_Gibbs,1,B-DTL,10,4,1,1,2,8,2
20160522-W-Roland_Garros-R128-Heather_Watson-Nicole_Gibbs,1,B-IO,6,2,1,0,1,4,2
20160522-W-Roland_Garros-R128-Heather_Watson-Nicole_Gibbs,1,S-XC,5,1,0,0,1,0,5
20160522-W-Roland_Garros-R128-Heather_Watson-Nicole_Gibbs,1,S-DTM,6,0,0,0,0,3,3
20160522-W-Roland_Garros-R128-Heather_Watson-Nicole_Gibbs,1,S-DTL,1,0,0,0,0,1,0
20160522-W-Roland_Garros-R128-Heather_Watson-Nicole_Gibbs,1,S-IO,2,0,0,0,0,1,1
20160522-W-Roland_Garros-R128-Heather_Watson-Nicole_Gibbs,2,F-XC,93,9,3,3,3,41,52
20160522-W-Roland_Garros-R128-Heather_Watson-Nicole_Gibbs,2,F-DTM,25,0,0,0,0,11,14
20160522-W-Roland_Garros-R128-Heather_Watson-Nicole_Gibbs,2,F-DTL,22,8,0,1,7,9,13
20160522-W-Roland_Garros-R128-Heather_Watson-Nicole_Gibbs,2,F-IO,18,2,0,0,2,7,11
20160522-W-Roland_Garros-R128-Heather_Watson-Nicole_Gibbs,2,F-II,2,1,0,1,0,1,1
20160522-W-Roland_Garros-R128-Heather_Watson-Nicole_Gibbs,2,B-XC,82,11,3,5,3,49,33
20160522-W-Roland_Garros-R128-Heather_Watson-Nicole_Gibbs,2,B-DTM,38,3,0,0,3,18,20
20160522-W-Roland_Garros-R128-Heather_Watson-Nicole_Gibbs,2,B-DTL,26,7,1,2,4,10,16
20160522-W-Roland_Garros-R128-Heather_Watson-Nicole_Gibbs,2,B-IO,10,2,0,0,2,5,5
20160522-W-Roland_Garros-R128-Heather_Watson-Nicole_Gibbs,2,B-II,1,1,0,1,0,1,0
20160522-W-Roland_Garros-R128-Heather_Watson-Nicole_Gibbs,2,S-XC,13,2,0,0,2,6,7
20160522-W-Roland_Garros-R128-Heather_Watson-Nicole_Gibbs,2,S-DTM,15,1,0,0,1,7,8
20160522-W-Roland_Garros-R128-Heather_Watson-Nicole_Gibbs,2,S-DTL,5,0,0,0,0,2,3
20170212-W-Fed_Cup_World_Group_R1-RR-Belinda_Bencic-Pauline_Parmentier,1,F-XC,39,6,3,3,0,25,14
20170212-W-Fed_Cup_World_Group_R1-RR-Belinda_Bencic-Pauline_Parmentier,1,F-DTM,10,1,0,1,0,6,4
20170212-W-Fed_Cup_World_Group_R1-RR-Belinda_Bencic-Pauline_Parmentier,1,F-DTL,17,6,3,2,1,14,3
20170212-W-Fed_Cup_World_Group_R1-RR-Belinda_Bencic-Pauline_Parmentier,1,F-IO,20,3,1,0,2,15,5
20170212-W-Fed_Cup_World_Group_R1-RR-Belinda_Bencic-Pauline_Parmentier,1,B-XC,37,5,3,0,2,17,20
20170212-W-Fed_Cup_World_Group_R1-RR-Belinda_Bencic-Pauline_Parmentier,1,B-DTM,21,2,0,1,1,12,9
20170212-W-Fed_Cup_World_Group_R1-RR-Belinda_Bencic-Pauline_Parmentier,1,B-DTL,9,3,0,0,3,5,4
20170212-W-Fed_Cup_World_Group_R1-RR-Belinda_Bencic-Pauline_Parmentier,1,B-IO,8,3,1,1,1,6,2
20170212-W-Fed_Cup_World_Group_R1-RR-Belinda_Bencic-Pauline_Parmentier,1,S-DTL,1,0,0,0,0,0,1
20170212-W-Fed_Cup_World_Group_R1-RR-Belinda_Bencic-Pauline_Parmentier,2,F-XC,53,19,9,3,7,23,30
20170212-W-Fed_Cup_World_Group_R1-RR-Belinda_Bencic-Pauline_Parmentier,2,F-DTM,24,2,0,0,2,7,17
20170212-W-Fed_Cup_World_Group_R1-RR-Belinda_Bencic-Pauline_Parmentier,2,F-DTL,7,2,0,0,2,3,4
20170212-W-Fed_Cup_World_Group_R1-RR-Belinda_Bencic-Pauline_Parmentier,2,F-IO,8,0,0,0,0,6,2
20170212-W-Fed_Cup_World_Group_R1-RR-Belinda_Bencic-Pauline_Parmentier,2,F-II,5,1,0,1,0,4,1
20170212-W-Fed_Cup_World_Group_R1-RR-Belinda_Bencic-Pauline_Parmentier,2,B-XC,37,9,1,2,6,14,23
20170212-W-Fed_Cup_World_Group_R1-RR-Belinda_Bencic-Pauline_Parmentier,2,B-DTM,17,2,0,1,1,10,7
20170212-W-Fed_Cup_World_Group_R1-RR-Belinda_Bencic-Pauline_Parmentier,2,B-DTL,6,1,1,0,0,3,3
20170212-W-Fed_Cup_World_Group_R1-RR-Belinda_Bencic-Pauline_Parmentier,2,S-XC,4,0,0,0,0,1,3
20170212-W-Fed_Cup_World_Group_R1-RR-Belinda_Bencic-Pauline_Parmentier,2,S-DTM,5,0,0,0,0,0,5
20161028-W-ITF_Poitiers-QF-Pauline_Parmentier-Elena_Gabriela_Ruse,1,F-XC,47,11,3,3,5,22,25
20161028-W-ITF_Poitiers-QF-Pauline_Parmentier-Elena_Gabriela_Ruse,1,F-DTM,14,2,0,1,1,8,6
20161028-W-ITF_Poitiers-QF-Pauline_Parmentier-Elena_Gabriela_Ruse,1,F-DTL,10,5,3,0,2,6,4
20161028-W-ITF_Poitiers-QF-Pauline_Parmentier-Elena_Gabriela_Ruse,1,F-IO,12,6,3,1,2,6,6
20161028-W-ITF_Poitiers-QF-Pauline_Parmentier-Elena_Gabriela_Ruse,1,F-II,2,0,0,0,0,0,2
20161028-W-ITF_Poitiers-QF-Pauline_Parmentier-Elena_Gabriela_Ruse,1,B-XC,20,7,1,2,4,9,11
20161028-W-ITF_Poitiers-QF-Pauline_Parmentier-Elena_Gabriela_Ruse,1,B-DTM,24,2,0,0,2,7,17
20161028-W-ITF_Poitiers-QF-Pauline_Parmentier-Elena_Gabriela_Ruse,1,B-DTL,4,2,1,0,1,2,2
20161028-W-ITF_Poitiers-QF-Pauline_Parmentier-Elena_Gabriela_Ruse,1,S-XC,6,0,0,0,0,2,4
20161028-W-ITF_Poitiers-QF-Pauline_Parmentier-Elena_Gabriela_Ruse,1,S-DTM,4,2,0,0,2,2,2
20161028-W-ITF_Poitiers-QF-Pauline_Parmentier-Elena_Gabriela_Ruse,2,F-XC,40,11,3,2,6,21,19
20161028-W-ITF_Poitiers-QF-Pauline_Parmentier-Elena_Gabriela_Ruse,2,F-DTM,13,3,0,1,2,6,7
20161028-W-ITF_Poitiers-QF-Pauline_Parmentier-Elena_Gabriela_Ruse,2,F-DTL,10,4,1,1,2,5,5
20161028-W-ITF_Poitiers-QF-Pauline_Parmentier-Elena_Gabriela_Ruse,2,F-IO,5,3,1,0,2,3,2
20161028-W-ITF_Poitiers-QF-Pauline_Parmentier-Elena_Gabriela_Ruse,2,B-XC,34,8,2,2,4,20,14
20161028-W-ITF_Poitiers-QF-Pauline_Parmentier-Elena_Gabriela_Ruse,2,B-DTM,20,1,0,0,1,8,12
20161028-W-ITF_Poitiers-QF-Pauline_Parmentier-Elena_Gabriela_Ruse,2,B-DTL,4,2,1,0,1,2,2
20161028-W-ITF_Poitiers-QF-Pauline_Parmentier-Elena_Gabriela_Ruse,2,B-IO,7,2,1,0,1,5,2
20161028-W-ITF_Poitiers-QF-Pauline_Parmentier-Elena_Gabriela_Ruse,2,S-XC,3,0,0,0,0,2,1
20161028-W-ITF_Poitiers-QF-Pauline_Parmentier-Elena_Gabriela_Ruse,2,S-DTM,1,0,0,0,0,1,0
20170122-W-Australian_Open-R16-Sorana_Cirstea-Garbine_Muguruza,1,F-XC,30,9,0,3,6,15,15
20170122-W-Australian_Open-R16-Sorana_Cirstea-Garbine_Muguruza,1,F-DTM,16,4,0,0,4,1,15
20170122-W-Australian_Open-R16-Sorana_Cirstea-Garbine_Muguruza,1,F-DTL,8,3,2,0,1,4,4
20170122-W-Australian_Open-R16-Sorana_Cirstea-Garbine_Muguruza,1,F-IO,14,5,0,1,4,3,11
20170122-W-Australian_Open-R16-Sorana_Cirstea-Garbine_Muguruza,1,B-XC,9,2,0,1,1,4,5
20170122-W-Australian_Open-R16-Sorana_Cirstea-Garbine_Muguruza,1,B-DTM,22,3,0,0,3,5,17
20170122-W-Australian_Open-R16-Sorana_Cirstea-Garbine_Muguruza,1,B-DTL,7,2,1,0,1,3,4
20170122-W-Australian_Open-R16-Sorana_Cirstea-Garbine_Muguruza,1,B-IO,5,2,1,0,1,4,1
20170122-W-Australian_Open-R16-Sorana_Cirstea-Garbine_Muguruza,1,S-DTM,1,0,0,0,0,1,0
20170122-W-Australian_Open-R16-Sorana_Cirstea-Garbine_Muguruza,2,F-XC,25,7,3,1,3,19,6
20170122-W-Australian_Open-R16-Sorana_Cirstea-Garbine_Muguruza,2,F-DTM,17,1,0,0,1,10,7
20170122-W-Australian_Open-R16-Sorana_Cirstea-Garbine_Muguruza,2,F-DTL,5,2,1,0,1,2,3
20170122-W-Australian_Open-R16-Sorana_Cirstea-Garbine_Muguruza,2,F-IO,9,6,1,3,2,6,3
20170122-W-Australian_Open-R16-Sorana_Cirstea-Garbine_Muguruza,2,B-XC,23,8,4,2,2,18,5
20170122-W-Australian_Open-R16-Sorana_Cirstea-Garbine_Muguruza,2,B-DTM,13,1,0,0,1,8,5
20170122-W-Australian_Open-R16-Sorana_Cirstea-Garbine_Muguruza,2,B-DTL,3,1,0,1,0,2,1
20170122-W-Australian_Open-R16-Sorana_Cirstea-Garbine_Muguruza,2,B-IO,7,2,1,1,0,6,1
20140110-W-Hobart-SF-Estrella_Cabeza_Candela-Garbine_Muguruza,1,F-XC,16,4,0,1,3,5,11
20140110-W-Hobart-SF-Estrella_Cabeza_Candela-Garbine_Muguruza,1,F-DTM,17,4,0,0,4,6,11
20140110-W-Hobart-SF-Estrella_Cabeza_Candela-Garbine_Muguruza,1,F-DTL,6,2,0,0,2,0,6
20140110-W-Hobart-SF-Estrella_Cabeza_Candela-Garbine_Muguruza,1,F-IO,4,1,0,0,1,1,3
20140110-W-Hobart-SF-Estrella_Cabeza_Candela-Garbine_Muguruza,1,B-XC,13,2,0,1,1,3,10
20140110-W-Hobart-SF-Estrella_Cabeza_Candela-Garbine_Muguruza,1,B-DTM,11,0,0,0,0,4,7
20140110-W-Hobart-SF-Estrella_Cabeza_Candela-Garbine_Muguruza,1,B-DTL,1,0,0,0,0,0,1
20140110-W-Hobart-SF-Estrella_Cabeza_Candela-Garbine_Muguruza,1,B-IO,4,1,0,0,1,3,1
20140110-W-Hobart-SF-Estrella_Cabeza_Candela-Garbine_Muguruza,1,S-XC,1,0,0,0,0,0,1
20140110-W-Hobart-SF-Estrella_Cabeza_Candela-Garbine_Muguruza,1,S-DTM,1,0,0,0,0,0,1
20140110-W-Hobart-SF-Estrella_Cabeza_Candela-Garbine_Muguruza,1,S-DTL,2,0,0,0,0,1,1
20140110-W-Hobart-SF-Estrella_Cabeza_Candela-Garbine_Muguruza,1,S-IO,1,0,0,0,0,0,1
20140110-W-Hobart-SF-Estrella_Cabeza_Candela-Garbine_Muguruza,2,F-XC,29,11,3,4,4,17,12
20140110-W-Hobart-SF-Estrella_Cabeza_Candela-Garbine_Muguruza,2,F-DTM,9,2,0,0,2,4,5
20140110-W-Hobart-SF-Estrella_Cabeza_Candela-Garbine_Muguruza,2,F-DTL,7,2,1,0,1,6,1
20140110-W-Hobart-SF-Estrella_Cabeza_Candela-Garbine_Muguruza,2,F-IO,4,1,1,0,0,3,1
20140110-W-Hobart-SF-Estrella_Cabeza_Candela-Garbine_Muguruza,2,B-XC,13,2,0,2,0,12,1
20140110-W-Hobart-SF-Estrella_Cabeza_Candela-Garbine_Muguruza,2,B-DTM,9,1,0,1,0,6,3
20140110-W-Hobart-SF-Estrella_Cabeza_Candela-Garbine_Muguruza,2,B-DTL,6,5,2,2,1,5,1
20140110-W-Hobart-SF-Estrella_Cabeza_Candela-Garbine_Muguruza,2,B-IO,4,3,1,2,0,4,0
20170120-W-Australian_Open-R32-Venus_Williams-Ying_Ying_Duan,1,F-XC,23,10,4,3,3,14,9
20170120-W-Australian_Open-R32-Venus_Williams-Ying_Ying_Duan,1,F-DTM,12,5,0,1,4,5,7
20170120-W-Australian_Open-R32-Venus_Williams-Ying_Ying_Duan,1,F-DTL,2,2,1,1,0,2,0
20170120-W-Australian_Open-R32-Venus_Williams-Ying_Ying_Duan,1,F-IO,7,4,2,0,2,5,2
20170120-W-Australian_Open-R32-Venus_Williams-Ying_Ying_Duan,1,B-XC,19,8,3,3,2,15,4
20170120-W-Australian_Open-R32-Venus_Williams-Ying_Ying_Duan,1,B-DTM,8,0,0,0,0,4,4
20170120-W-Australian_Open-R32-Venus_Williams-Ying_Ying_Duan,1,B-DTL,1,0,0,0,0,1,0
20170120-W-Australian_Open-R32-Venus_Williams-Ying_Ying_Duan,1,B-IO,2,1,1,0,0,1,1
20170120-W-Australian_Open-R32-Venus_Williams-Ying_Ying_Duan,1,S-XC,2,0,0,0,0,2,0
20170120-W-Australian_Open-R32-Venus_Williams-Ying_Ying_Duan,1,S-DTL,1,0,0,0,0,1,0
20170120-W-Australian_Open-R32-Venus_Williams-Ying_Ying_Duan,1,S-IO,1,1,0,0,1,0,1
20170120-W-Australian_Open-R32-Venus_Williams-Ying_Ying_Duan,2,F-XC,16,2,0,0,2,9,7
20170120-W-Australian_Open-R32-Venus_Williams-Ying_Ying_Duan,2,F-DTM,4,1,1,0,0,2,2
20170120-W-Australian_Open-R32-Venus_Williams-Ying_Ying_Duan,2,F-DTL,14,6,2,2,2,6,8
20170120-W-Australian_Open-R32-Venus_Williams-Ying_Ying_Duan,2,F-IO,3,1,0,0,1,0,3
20170120-W-Australian_Open-R32-Venus_Williams-Ying_Ying_Duan,2,F-II,1,0,0,0,0,0,1
20170120-W-Australian_Open-R32-Venus_Williams-Ying_Ying_Duan,2,B-XC,11,6,1,0,5,1,10
20170120-W-Australian_Open-R32-Venus_Williams-Ying_Ying_Duan,2,B-DTM,9,3,0,0,3,3,6
20170120-W-Australian_Open-R32-Venus_Williams-Ying_Ying_Duan,2,B-DTL,11,4,0,1,3,2,9
20170120-W-Australian_Open-R32-Venus_Williams-Ying_Ying_Duan,2,B-IO,6,4,0,3,1,5,1
20170120-W-Australian_Open-R32-Venus_Williams-Ying_Ying_Duan,2,S-XC,1,0,0,0,0,0,1
20170120-W-Australian_Open-R32-Venus_Williams-Ying_Ying_Duan,2,S-DTM,2,0,0,0,0,0,2
20170308-W-Indian_Wells-R128-Louisa_Chirico-Francesca_Schiavone,1,F-XC,30,5,2,3,0,23,7
20170308-W-Indian_Wells-R128-Louisa_Chirico-Francesca_Schiavone,1,F-DTM,20,0,0,0,0,13,7
20170308-W-Indian_Wells-R128-Louisa_Chirico-Francesca_Schiavone,1,F-DTL,7,1,0,1,0,6,1
20170308-W-Indian_Wells-R128-Louisa_Chirico-Francesca_Schiavone,1,F-IO,15,4,1,2,1,11,4
20170308-W-Indian_Wells-R128-Louisa_Chirico-Francesca_Schiavone,1,F-II,2,2,0,0,2,0,2
20170308-W-Indian_Wells-R128-Louisa_Chirico-Francesca_Schiavone,1,B-XC,48,6,1,2,3,26,22
20170308-W-Indian_Wells-R128-Louisa_Chirico-Francesca_Schiavone,1,B-DTM,18,1,0,0,1,11,7
20170308-W-Indian_Wells-R128-Louisa_Chirico-Francesca_Schiavone,1,B-DTL,9,3,1,1,1,5,4
20170308-W-Indian_Wells-R128-Louisa_Chirico-Francesca_Schiavone,1,B-IO,2,1,0,0,1,0,2
20170308-W-Indian_Wells-R128-Louisa_Chirico-Francesca_Schiavone,1,S-XC,5,0,0,0,0,1,4
20170308-W-Indian_Wells-R128-Louisa_Chirico-Francesca_Schiavone,1,S-DTM,13,1,0,0,1,4,9
20170308-W-Indian_Wells-R128-Louisa_Chirico-Francesca_Schiavone,1,S-DTL,4,1,0,0,1,0,4
20170308-W-Indian_Wells-R128-Louisa_Chirico-Francesca_Schiavone,2,F-XC,25,8,1,2,5,9,16
20170308-W-Indian_Wells-R128-Louisa_Chirico-Francesca_Schiavone,2,F-DTM,8,1,0,0,1,3,5
20170308-W-Indian_Wells-R128-Louisa_Chirico-Francesca_Schiavone,2,F-DTL,16,4,2,0,2,7,9
20170308-W-Indian_Wells-R128-Louisa_Chirico-Francesca_Schiavone,2,F-IO,36,7,2,1,4,20,16
20170308-W-Indian_Wells-R128-Louisa_Chirico-Francesca_Schiavone,2,F-II,4,0,0,0,0,1,3
20170308-W-Indian_Wells-R128-Louisa_Chirico-Francesca_Schiavone,2,B-XC,26,6,0,1,5,10,16
20170308-W-Indian_Wells-R128-Louisa_Chirico-Francesca_Schiavone,2,B-DTM,18,3,0,0,3,4,14
20170308-W-Indian_Wells-R128-Louisa_Chirico-Francesca_Schiavone,2,B-DTL,7,4,2,1,1,3,4
20170308-W-Indian_Wells-R128-Louisa_Chirico-Francesca_Schiavone,2,B-IO,4,2,0,0,2,1,3
20170308-W-Indian_Wells-R128-Louisa_Chirico-Francesca_Schiavone,2,S-XC,18,1,0,0,1,8,10
20170308-W-Indian_Wells-R128-Louisa_Chirico-Francesca_Schiavone,2,S-DTM,5,1,0,0,1,0,5
20170308-W-Indian_Wells-R128-Louisa_Chirico-Francesca_Schiavone,2,S-DTL,3,0,0,0,0,2,1
20170308-W-Indian_Wells-R128-Louisa_Chirico-Francesca_Schiavone,2,S-IO,3,1,0,0,1,1,2
20170311-W-ITF_Zhuhai-SF-Denisa_Allertova-Maryna_Zanevska,1,F-XC,52,12,4,6,2,39,13
20170311-W-ITF_Zhuhai-SF-Denisa_Allertova-Maryna_Zanevska,1,F-DTM,17,3,0,0,3,10,7
20170311-W-ITF_Zhuhai-SF-Denisa_Allertova-Maryna_Zanevska,1,F-DTL,7,4,0,1,3,4,3
20170311-W-ITF_Zhuhai-SF-Denisa_Allertova-Maryna_Zanevska,1,F-IO,12,6,1,3,2,10,2
20170311-W-ITF_Zhuhai-SF-Denisa_Allertova-Maryna_Zanevska,1,B-XC,37,5,1,2,2,23,14
20170311-W-ITF_Zhuhai-SF-Denisa_Allertova-Maryna_Zanevska,1,B-DTM,13,2,0,0,2,8,5
20170311-W-ITF_Zhuhai-SF-Denisa_Allertova-Maryna_Zanevska,1,B-DTL,2,0,0,0,0,2,0
20170311-W-ITF_Zhuhai-SF-Denisa_Allertova-Maryna_Zanevska,1,B-IO,3,1,1,0,0,3,0
20170311-W-ITF_Zhuhai-SF-Denisa_Allertova-Maryna_Zanevska,1,S-XC,3,1,0,0,1,0,3
20170311-W-ITF_Zhuhai-SF-Denisa_Allertova-Maryna_Zanevska,1,S-DTL,3,0,0,0,0,1,2
20170311-W-ITF_Zhuhai-SF-Denisa_Allertova-Maryna_Zanevska,2,F-XC,37,6,1,2,3,11,26
20170311-W-ITF_Zhuhai-SF-Denisa_Allertova-Maryna_Zanevska,2,F-DTM,21,2,0,0,2,5,16
20170311-W-ITF_Zhuhai-SF-Denisa_Allertova-Maryna_Zanevska,2,F-DTL,15,9,2,4,3,10,5
20170311-W-ITF_Zhuhai-SF-Denisa_Allertova-Maryna_Zanevska,2,F-IO,16,5,1,0,4,6,10
20170311-W-ITF_Zhuhai-SF-Denisa_Allertova-Maryna_Zanevska,2,B-XC,12,4,0,3,1,6,6
20170311-W-ITF_Zhuhai-SF-Denisa_Allertova-Maryna_Zanevska,2,B-DTM,15,2,0,0,2,2,13
20170311-W-ITF_Zhuhai-SF-Denisa_Allertova-Maryna_Zanevska,2,B-DTL,16,7,1,1,5,5,11
20170311-W-ITF_Zhuhai-SF-Denisa_Allertova-Maryna_Zanevska,2,B-IO,7,3,0,0,3,1,6
20170311-W-ITF_Zhuhai-SF-Denisa_Allertova-Maryna_Zanevska,2,S-XC,6,1,0,0,1,3,3
20170311-W-ITF_Zhuhai-SF-Denisa_Allertova-Maryna_Zanevska,2,S-DTM,4,0,0,0,0,0,4
20170311-W-ITF_Zhuhai-SF-Denisa_Allertova-Maryna_Zanevska,2,S-DTL,5,3,1,0,2,3,2
20160315-W-Indian_Wells-R16-Agnieszka_Radwanska-Jelena_Jankovic,1,F-XC,38,4,1,1,2,15,23
20160315-W-Indian_Wells-R16-Agnieszka_Radwanska-Jelena_Jankovic,1,F-DTM,23,0,0,0,0,15,8
20160315-W-Indian_Wells-R16-Agnieszka_Radwanska-Jelena_Jankovic,1,F-DTL,15,7,1,3,3,8,7
20160315-W-Indian_Wells-R16-Agnieszka_Radwanska-Jelena_Jankovic,1,F-IO,11,3,1,0,2,6,5
20160315-W-Indian_Wells-R16-Agnieszka_Radwanska-Jelena_Jankovic,1,B-XC,50,1,1,0,0,30,20
20160315-W-Indian_Wells-R16-Agnieszka_Radwanska-Jelena_Jankovic,1,B-DTM,40,3,0,0,3,19,21
20160315-W-Indian_Wells-R16-Agnieszka_Radwanska-Jelena_Jankovic,1,B-DTL,9,3,1,2,0,7,2
20160315-W-Indian_Wells-R16-Agnieszka_Radwanska-Jelena_Jankovic,1,B-IO,4,1,0,0,1,1,3
20160315-W-Indian_Wells-R16-Agnieszka_Radwanska-Jelena_Jankovic,1,S-XC,7,0,0,0,0,3,4
20160315-W-Indian_Wells-R16-Agnieszka_Radwanska-Jelena_Jankovic,1,S-DTM,8,1,0,0,1,3,5
20160315-W-Indian_Wells-R16-Agnieszka_Radwanska-Jelena_Jankovic,1,S-DTL,1,1,0,1,0,1,0
20160315-W-Indian_Wells-R16-Agnieszka_Radwanska-Jelena_Jankovic,2,F-XC,37,7,0,2,5,19,18
20160315-W-Indian_Wells-R16-Agnieszka_Radwanska-Jelena_Jankovic,2,F-DTM,9,1,0,0,1,6,3
20160315-W-Indian_Wells-R16-Agnieszka_Radwanska-Jelena_Jankovic,2,F-DTL,17,6,1,2,3,8,9
20160315-W-Indian_Wells-R16-Agnieszka_Radwanska-Jelena_Jankovic,2,F-IO,28,5,2,0,3,14,14
20160315-W-Indian_Wells-R16-Agnieszka_Radwanska-Jelena_Jankovic,2,B-XC,50,7,0,1,6,20,30
20160315-W-Indian_Wells-R16-Agnieszka_Radwanska-Jelena_Jankovic,2,B-DTM,34,4,0,0,4,13,21
20160315-W-Indian_Wells-R16-Agnieszka_Radwanska-Jelena_Jankovic,2,B-DTL,16,3,1,0,2,7,9
20160315-W-Indian_Wells-R16-Agnieszka_Radwanska-Jelena_Jankovic,2,B-IO,14,4,1,1,2,8,6
20160315-W-Indian_Wells-R16-Agnieszka_Radwanska-Jelena_Jankovic,2,S-XC,5,0,0,0,0,1,4
20160315-W-Indian_Wells-R16-Agnieszka_Radwanska-Jelena_Jankovic,2,S-DTM,4,1,0,0,1,2,2
20160315-W-Indian_Wells-R16-Agnieszka_Radwanska-Jelena_Jankovic,2,S-IO,1,0,0,0,0,0,1
19900408-W-Hilton_Head-F-Jennifer_Capriati-Martina_Navratilova,1,F-XC,37,7,4,0,3,18,19
19900408-W-Hilton_Head-F-Jennifer_Capriati-Martina_Navratilova,1,F-DTM,11,0,0,0,0,6,5
19900408-W-Hilton_Head-F-Jennifer_Capriati-Martina_Navratilova,1,F-DTL,8,3,1,1,1,6,2
19900408-W-Hilton_Head-F-Jennifer_Capriati-Martina_Navratilova,1,F-IO,5,3,1,1,1,4,1
19900408-W-Hilton_Head-F-Jennifer_Capriati-Martina_Navratilova,1,B-XC,44,14,7,1,6,24,20
19900408-W-Hilton_Head-F-Jennifer_Capriati-Martina_Navratilova,1,B-DTM,11,0,0,0,0,7,4
19900408-W-Hilton_Head-F-Jennifer_Capriati-Martina_Navratilova,1,B-DTL,26,3,1,0,2,16,10
19900408-W-Hilton_Head-F-Jennifer_Capriati-Martina_Navratilova,1,B-IO,20,5,3,1,1,16,4
19900408-W-Hilton_Head-F-Jennifer_Capriati-Martina_Navratilova,1,S-XC,1,0,0,0,0,0,1
19900408-W-Hilton_Head-F-Jennifer_Capriati-Martina_Navratilova,1,S-DTL,3,0,0,0,0,0,3
19900408-W-Hilton_Head-F-Jennifer_Capriati-Martina_Navratilova,2,F-XC,32,6,0,3,3,12,20
19900408-W-Hilton_Head-F-Jennifer_Capriati-Martina_Navratilova,2,F-DTM,7,1,0,0,1,2,5
19900408-W-Hilton_Head-F-Jennifer_Capriati-Martina_Navratilova,2,F-DTL,5,3,0,2,1,3,2
19900408-W-Hilton_Head-F-Jennifer_Capriati-Martina_Navratilova,2,F-IO,5,1,0,1,0,4,1
19900408-W-Hilton_Head-F-Jennifer_Capriati-Martina_Navratilova,2,B-XC,15,3,1,1,1,7,8
19900408-W-Hilton_Head-F-Jennifer_Capriati-Martina_Navratilova,2,B-DTM,7,0,0,0,0,3,4
19900408-W-Hilton_Head-F-Jennifer_Capriati-Martina_Navratilova,2,B-DTL,12,3,0,0,3,5,7
19900408-W-Hilton_Head-F-Jennifer_Capriati-Martina_Navratilova,2,B-IO,2,1,0,1,0,1,1
19900408-W-Hilton_Head-F-Jennifer_Capriati-Martina_Navratilova,2,S-XC,11,2,0,1,1,4,7
19900408-W-Hilton_Head-F-Jennifer_Capriati-Martina_Navratilova,2,S-DTM,14,1,1,0,0,6,8
19900408-W-Hilton_Head-F-Jennifer_Capriati-Martina_Navratilova,2,S-DTL,13,4,0,0,4,4,9
19900408-W-Hilton_Head-F-Jennifer_Capriati-Martina_Navratilova,2,S-IO,3,0,0,0,0,0,3
20160313-W-Indian_Wells-R32-Serena_Williams-Yulia_Putintseva,1,F-XC,14,8,3,1,4,8,6
20160313-W-Indian_Wells-R32-Serena_Williams-Yulia_Putintseva,1,F-DTM,5,3,0,0,3,0,5
20160313-W-Indian_Wells-R32-Serena_Williams-Yulia_Putintseva,1,F-DTL,4,3,1,0,2,1,3
20160313-W-Indian_Wells-R32-Serena_Williams-Yulia_Putintseva,1,F-IO,7,2,1,0,1,5,2
20160313-W-Indian_Wells-R32-Serena_Williams-Yulia_Putintseva,1,B-XC,26,10,3,2,5,12,14
20160313-W-Indian_Wells-R32-Serena_Williams-Yulia_Putintseva,1,B-DTM,10,0,0,0,0,2,8
20160313-W-Indian_Wells-R32-Serena_Williams-Yulia_Putintseva,1,B-DTL,7,2,1,1,0,5,2
20160313-W-Indian_Wells-R32-Serena_Williams-Yulia_Putintseva,1,B-IO,10,6,1,2,3,4,6
20160313-W-Indian_Wells-R32-Serena_Williams-Yulia_Putintseva,1,S-DTL,1,0,0,0,0,0,1
20160313-W-Indian_Wells-R32-Serena_Williams-Yulia_Putintseva,2,F-XC,10,4,2,1,1,7,3
20160313-W-Indian_Wells-R32-Serena_Williams-Yulia_Putintseva,2,F-DTM,12,0,0,0,0,4,8
20160313-W-Indian_Wells-R32-Serena_Williams-Yulia_Putintseva,2,F-DTL,8,0,0,0,0,6,2
20160313-W-Indian_Wells-R32-Serena_Williams-Yulia_Putintseva,2,F-IO,9,4,2,1,1,6,3
20160313-W-Indian_Wells-R32-Serena_Williams-Yulia_Putintseva,2,F-II,2,2,2,0,0,2,0
20160313-W-Indian_Wells-R32-Serena_Williams-Yulia_Putintseva,2,B-XC,11,4,1,0,3,4,7
20160313-W-Indian_Wells-R32-Serena_Williams-Yulia_Putintseva,2,B-DTM,22,1,0,0,1,10,12
20160313-W-Indian_Wells-R32-Serena_Williams-Yulia_Putintseva,2,B-DTL,1,0,0,0,0,0,1
20160313-W-Indian_Wells-R32-Serena_Williams-Yulia_Putintseva,2,B-IO,1,0,0,0,0,1,0
20160313-W-Indian_Wells-R32-Serena_Williams-Yulia_Putintseva,2,S-DTM,5,1,0,0,1,2,3
20150116-W-Hobart-SF-Heather_Watson-Alison_Riske,1,F-XC,75,13,4,7,2,51,24
20150116-W-Hobart-SF-Heather_Watson-Alison_Riske,1,F-DTM,73,5,0,2,3,36,37
20150116-W-Hobart-SF-Heather_Watson-Alison_Riske,1,F-DTL,5,3,1,0,2,3,2
20150116-W-Hobart-SF-Heather_Watson-Alison_Riske,1,F-IO,11,3,3,0,0,7,4
20150116-W-Hobart-SF-Heather_Watson-Alison_Riske,1,F-II,1,1,1,0,0,1,0
20150116-W-Hobart-SF-Heather_Watson-Alison_Riske,1,B-XC,45,16,1,2,13,19,26
20150116-W-Hobart-SF-Heather_Watson-Alison_Riske,1,B-DTM,42,4,0,3,1,30,12
20150116-W-Hobart-SF-Heather_Watson-Alison_Riske,1,B-DTL,3,1,0,0,1,0,3
20150116-W-Hobart-SF-Heather_Watson-Alison_Riske,1,B-IO,6,1,0,0,1,2,4
20150116-W-Hobart-SF-Heather_Watson-Alison_Riske,1,S-DTM,5,0,0,0,0,1,4
20150116-W-Hobart-SF-Heather_Watson-Alison_Riske,1,S-DTL,1,0,0,0,0,0,1
20150116-W-Hobart-SF-Heather_Watson-Alison_Riske,2,F-XC,80,16,4,4,8,38,42
20150116-W-Hobart-SF-Heather_Watson-Alison_Riske,2,F-DTM,72,9,1,0,8,27,45
20150116-W-Hobart-SF-Heather_Watson-Alison_Riske,2,F-DTL,11,3,1,1,1,7,4
20150116-W-Hobart-SF-Heather_Watson-Alison_Riske,2,F-IO,19,3,1,0,2,9,10
20150116-W-Hobart-SF-Heather_Watson-Alison_Riske,2,B-XC,35,8,2,3,3,21,14
20150116-W-Hobart-SF-Heather_Watson-Alison_Riske,2,B-DTM,32,1,1,0,0,11,21
20150116-W-Hobart-SF-Heather_Watson-Alison_Riske,2,B-DTL,7,5,1,1,3,3,4
20150116-W-Hobart-SF-Heather_Watson-Alison_Riske,2,B-IO,11,6,1,2,3,5,6
20150116-W-Hobart-SF-Heather_Watson-Alison_Riske,2,S-XC,3,0,0,0,0,0,3
20150116-W-Hobart-SF-Heather_Watson-Alison_Riske,2,S-DTM,2,0,0,0,0,0,2
20170321-W-Miami-R128-Carina_Witthoeft-Nicole_Gibbs,1,F-XC,62,11,0,5,6,32,30
20170321-W-Miami-R128-Carina_Witthoeft-Nicole_Gibbs,1,F-DTM,27,2,0,0,2,13,14
20170321-W-Miami-R128-Carina_Witthoeft-Nicole_Gibbs,1,F-DTL,16,5,2,1,2,8,8
20170321-W-Miami-R128-Carina_Witthoeft-Nicole_Gibbs,1,F-IO,13,4,2,0,1,9,4
20170321-W-Miami-R128-Carina_Witthoeft-Nicole_Gibbs,1,B-XC,67,3,1,0,2,44,23
20170321-W-Miami-R128-Carina_Witthoeft-Nicole_Gibbs,1,B-DTM,43,1,0,1,0,20,23
20170321-W-Miami-R128-Carina_Witthoeft-Nicole_Gibbs,1,B-DTL,17,2,0,2,0,12,5
20170321-W-Miami-R128-Carina_Witthoeft-Nicole_Gibbs,1,B-IO,2,1,0,0,1,1,1
20170321-W-Miami-R128-Carina_Witthoeft-Nicole_Gibbs,1,S-XC,3,0,0,0,0,0,3
20170321-W-Miami-R128-Carina_Witthoeft-Nicole_Gibbs,1,S-DTM,6,0,0,0,0,3,3
20170321-W-Miami-R128-Carina_Witthoeft-Nicole_Gibbs,1,S-DTL,3,1,0,0,1,1,2
20170321-W-Miami-R128-Carina_Witthoeft-Nicole_Gibbs,2,F-XC,59,16,5,2,9,30,29
20170321-W-Miami-R128-Carina_Witthoeft-Nicole_Gibbs,2,F-DTM,32,3,1,0,2,14,18
20170321-W-Miami-R128-Carina_Witthoeft-Nicole_Gibbs,2,F-DTL,9,3,0,0,3,2,7
20170321-W-Miami-R128-Carina_Witthoeft-Nicole_Gibbs,2,F-IO,26,8,1,1,6,12,14
20170321-W-Miami-R128-Carina_Witthoeft-Nicole_Gibbs,2,F-II,1,0,0,0,0,1,0
20170321-W-Miami-R128-Carina_Witthoeft-Nicole_Gibbs,2,B-XC,66,3,1,1,1,24,42
20170321-W-Miami-R128-Carina_Witthoeft-Nicole_Gibbs,2,B-DTM,46,2,0,0,2,17,29
20170321-W-Miami-R128-Carina_Witthoeft-Nicole_Gibbs,2,B-DTL,15,6,1,1,4,8,7
20170321-W-Miami-R128-Carina_Witthoeft-Nicole_Gibbs,2,B-IO,7,3,0,0,3,4,3
20170321-W-Miami-R128-Carina_Witthoeft-Nicole_Gibbs,2,S-XC,4,0,0,0,0,2,2
20170321-W-Miami-R128-Carina_Witthoeft-Nicole_Gibbs,2,S-DTM,8,0,0,0,0,2,6
20170321-W-Miami-R128-Carina_Witthoeft-Nicole_Gibbs,2,S-DTL,1,1,0,1,0,1,0
20170324-W-Miami-R64-Madison_Keys-Viktorija_Golubic,1,F-XC,36,11,5,2,4,29,7
20170324-W-Miami-R64-Madison_Keys-Viktorija_Golubic,1,F-DTM,14,1,0,0,1,11,3
20170324-W-Miami-R64-Madison_Keys-Viktorija_Golubic,1,F-DTL,4,4,2,0,2,2,2
20170324-W-Miami-R64-Madison_Keys-Viktorija_Golubic,1,F-IO,26,12,6,3,3,19,7
20170324-W-Miami-R64-Madison_Keys-Viktorija_Golubic,1,F-II,2,1,1,0,0,1,1
20170324-W-Miami-R64-Madison_Keys-Viktorija_Golubic,1,B-XC,15,5,1,2,2,12,3
20170324-W-Miami-R64-Madison_Keys-Viktorija_Golubic,1,B-DTM,15,5,0,1,4,4,11
20170324-W-Miami-R64-Madison_Keys-Viktorija_Golubic,1,B-DTL,8,5,2,2,1,7,1
20170324-W-Miami-R64-Madison_Keys-Viktorija_Golubic,1,B-IO,1,1,0,0,1,0,1
20170324-W-Miami-R64-Madison_Keys-Viktorija_Golubic,1,S-DTM,1,0,0,0,0,0,1
20170324-W-Miami-R64-Madison_Keys-Viktorija_Golubic,1,S-DTL,1,0,0,0,0,0,1
20170324-W-Miami-R64-Madison_Keys-Viktorija_Golubic,2,F-XC,16,2,0,0,2,3,13
20170324-W-Miami-R64-Madison_Keys-Viktorija_Golubic,2,F-DTM,16,0,0,0,0,6,10
20170324-W-Miami-R64-Madison_Keys-Viktorija_Golubic,2,F-DTL,13,4,1,1,2,3,10
20170324-W-Miami-R64-Madison_Keys-Viktorija_Golubic,2,F-IO,16,4,0,1,3,6,10
20170324-W-Miami-R64-Madison_Keys-Viktorija_Golubic,2,B-XC,10,4,0,0,4,3,7
20170324-W-Miami-R64-Madison_Keys-Viktorija_Golubic,2,B-DTM,18,1,0,0,1,3,15
20170324-W-Miami-R64-Madison_Keys-Viktorija_Golubic,2,B-DTL,2,2,0,0,2,0,2
20170324-W-Miami-R64-Madison_Keys-Viktorija_Golubic,2,B-IO,2,2,0,2,0,2,0
20170324-W-Miami-R64-Madison_Keys-Viktorija_Golubic,2,S-XC,5,1,0,0,1,2,3
20170324-W-Miami-R64-Madison_Keys-Viktorija_Golubic,2,S-DTM,5,0,0,0,0,1,4
20170324-W-Miami-R64-Madison_Keys-Viktorija_Golubic,2,S-DTL,1,0,0,0,0,1,0
20170326-W-Miami-R32-Shelby_Rogers-Angelique_Kerber,1,F-XC,34,11,6,1,4,18,16
20170326-W-Miami-R32-Shelby_Rogers-Angelique_Kerber,1,F-DTM,14,2,0,0,2,1,13
20170326-W-Miami-R32-Shelby_Rogers-Angelique_Kerber,1,F-DTL,11,9,3,2,4,5,6
20170326-W-Miami-R32-Shelby_Rogers-Angelique_Kerber,1,F-IO,21,9,4,1,4,9,12
20170326-W-Miami-R32-Shelby_Rogers-Angelique_Kerber,1,F-II,1,1,1,0,0,1,0
20170326-W-Miami-R32-Shelby_Rogers-Angelique_Kerber,1,B-XC,49,10,4,0,6,20,29
20170326-W-Miami-R32-Shelby_Rogers-Angelique_Kerber,1,B-DTM,18,1,0,0,1,7,11
20170326-W-Miami-R32-Shelby_Rogers-Angelique_Kerber,1,B-DTL,14,8,2,1,5,7,7
20170326-W-Miami-R32-Shelby_Rogers-Angelique_Kerber,1,B-IO,6,2,1,0,1,4,2
20170326-W-Miami-R32-Shelby_Rogers-Angelique_Kerber,1,S-XC,1,0,0,0,0,0,1
20170326-W-Miami-R32-Shelby_Rogers-Angelique_Kerber,1,S-DTM,3,0,0,0,0,1,2
20170326-W-Miami-R32-Shelby_Rogers-Angelique_Kerber,1,S-DTL,6,1,0,0,1,2,4
20170326-W-Miami-R32-Shelby_Rogers-Angelique_Kerber,2,F-XC,54,6,3,3,0,41,13
20170326-W-Miami-R32-Shelby_Rogers-Angelique_Kerber,2,F-DTM,25,2,0,0,2,11,14
20170326-W-Miami-R32-Shelby_Rogers-Angelique_Kerber,2,F-DTL,8,6,4,0,2,5,3
20170326-W-Miami-R32-Shelby_Rogers-Angelique_Kerber,2,F-IO,8,5,2,1,2,6,2
20170326-W-Miami-R32-Shelby_Rogers-Angelique_Kerber,2,B-XC,28,9,4,3,2,18,10
20170326-W-Miami-R32-Shelby_Rogers-Angelique_Kerber,2,B-DTM,18,4,0,0,4,7,11
20170326-W-Miami-R32-Shelby_Rogers-Angelique_Kerber,2,B-DTL,3,2,1,0,1,2,1
20170326-W-Miami-R32-Shelby_Rogers-Angelique_Kerber,2,B-IO,8,2,0,1,1,5,3
20170326-W-Miami-R32-Shelby_Rogers-Angelique_Kerber,2,S-DTM,9,0,0,0,0,3,6
20170326-W-Miami-R32-Shelby_Rogers-Angelique_Kerber,2,S-DTL,2,1,0,0,1,0,2
20110402-W-Miami-F-Maria_Sharapova-Victoria_Azarenka,1,F-XC,58,18,3,5,10,22,36
20110402-W-Miami-F-Maria_Sharapova-Victoria_Azarenka,1,F-DTM,42,6,0,0,6,14,28
20110402-W-Miami-F-Maria_Sharapova-Victoria_Azarenka,1,F-DTL,11,7,3,3,1,9,2
20110402-W-Miami-F-Maria_Sharapova-Victoria_Azarenka,1,F-IO,19,7,1,2,4,11,8
20110402-W-Miami-F-Maria_Sharapova-Victoria_Azarenka,1,F-II,1,1,1,0,0,1,0
20110402-W-Miami-F-Maria_Sharapova-Victoria_Azarenka,1,B-XC,39,9,1,2,6,15,24
20110402-W-Miami-F-Maria_Sharapova-Victoria_Azarenka,1,B-DTM,26,3,0,1,2,12,14
20110402-W-Miami-F-Maria_Sharapova-Victoria_Azarenka,1,B-DTL,12,1,0,0,1,4,8
20110402-W-Miami-F-Maria_Sharapova-Victoria_Azarenka,1,B-IO,10,4,1,1,2,4,6
20110402-W-Miami-F-Maria_Sharapova-Victoria_Azarenka,1,S-DTM,1,0,0,0,0,1,0
20110402-W-Miami-F-Maria_Sharapova-Victoria_Azarenka,2,F-XC,46,5,0,2,3,26,20
20110402-W-Miami-F-Maria_Sharapova-Victoria_Azarenka,2,F-DTM,35,3,1,0,2,21,14
20110402-W-Miami-F-Maria_Sharapova-Victoria_Azarenka,2,F-DTL,18,1,1,0,0,7,11
20110402-W-Miami-F-Maria_Sharapova-Victoria_Azarenka,2,F-IO,9,4,2,0,2,6,3
20110402-W-Miami-F-Maria_Sharapova-Victoria_Azarenka,2,B-XC,20,4,3,1,0,13,7
20110402-W-Miami-F-Maria_Sharapova-Victoria_Azarenka,2,B-DTM,37,3,1,0,2,21,16
20110402-W-Miami-F-Maria_Sharapova-Victoria_Azarenka,2,B-DTL,11,3,2,1,0,6,5
20110402-W-Miami-F-Maria_Sharapova-Victoria_Azarenka,2,B-IO,18,4,3,0,1,10,8
20110402-W-Miami-F-Maria_Sharapova-Victoria_Azarenka,2,S-XC,3,0,0,0,0,1,2
20110402-W-Miami-F-Maria_Sharapova-Victoria_Azarenka,2,S-DTM,1,0,0,0,0,1,0
20110402-W-Miami-F-Maria_Sharapova-Victoria_Azarenka,2,S-DTL,2,0,0,0,0,1,1
20110402-W-Miami-F-Maria_Sharapova-Victoria_Azarenka,2,S-IO,1,1,0,0,1,0,1
20170409-W-Charleston-F-Jelena_Ostapenko-Daria_Kasatkina,1,F-XC,30,10,3,1,6,14,16
20170409-W-Charleston-F-Jelena_Ostapenko-Daria_Kasatkina,1,F-DTM,4,0,0,0,0,2,2
20170409-W-Charleston-F-Jelena_Ostapenko-Daria_Kasatkina,1,F-DTL,8,5,3,0,2,4,4
20170409-W-Charleston-F-Jelena_Ostapenko-Daria_Kasatkina,1,F-IO,17,11,2,0,9,3,14
20170409-W-Charleston-F-Jelena_Ostapenko-Daria_Kasatkina,1,F-II,2,1,0,0,1,1,1
20170409-W-Charleston-F-Jelena_Ostapenko-Daria_Kasatkina,1,B-XC,42,11,2,0,9,13,29
20170409-W-Charleston-F-Jelena_Ostapenko-Daria_Kasatkina,1,B-DTM,6,0,0,0,0,3,3
20170409-W-Charleston-F-Jelena_Ostapenko-Daria_Kasatkina,1,B-DTL,16,9,5,1,3,9,7
20170409-W-Charleston-F-Jelena_Ostapenko-Daria_Kasatkina,1,B-IO,3,1,0,0,1,1,2
20170409-W-Charleston-F-Jelena_Ostapenko-Daria_Kasatkina,1,S-XC,2,1,0,0,1,0,2
20170409-W-Charleston-F-Jelena_Ostapenko-Daria_Kasatkina,2,F-XC,16,3,2,1,0,8,8
20170409-W-Charleston-F-Jelena_Ostapenko-Daria_Kasatkina,2,F-DTM,15,0,0,0,0,7,8
20170409-W-Charleston-F-Jelena_Ostapenko-Daria_Kasatkina,2,F-DTL,7,1,0,0,1,4,3
20170409-W-Charleston-F-Jelena_Ostapenko-Daria_Kasatkina,2,F-IO,10,1,1,0,0,9,1
20170409-W-Charleston-F-Jelena_Ostapenko-Daria_Kasatkina,2,B-XC,11,0,0,0,0,5,6
20170409-W-Charleston-F-Jelena_Ostapenko-Daria_Kasatkina,2,B-DTM,8,0,0,0,0,4,4
20170409-W-Charleston-F-Jelena_Ostapenko-Daria_Kasatkina,2,B-DTL,3,2,0,2,0,2,1
20170409-W-Charleston-F-Jelena_Ostapenko-Daria_Kasatkina,2,B-IO,2,1,1,0,0,2,0
20170409-W-Charleston-F-Jelena_Ostapenko-Daria_Kasatkina,2,S-XC,22,1,0,0,1,16,6
20170409-W-Charleston-F-Jelena_Ostapenko-Daria_Kasatkina,2,S-DTM,10,1,0,0,1,8,2
20170409-W-Charleston-F-Jelena_Ostapenko-Daria_Kasatkina,2,S-DTL,2,0,0,0,0,2,0
20120801-W-Olympics-R16-Sabine_Lisicki-Maria_Sharapova,1,F-XC,49,18,5,7,6,26,23
20120801-W-Olympics-R16-Sabine_Lisicki-Maria_Sharapova,1,F-DTM,15,0,0,0,0,9,6
20120801-W-Olympics-R16-Sabine_Lisicki-Maria_Sharapova,1,F-DTL,14,6,4,0,2,7,7
20120801-W-Olympics-R16-Sabine_Lisicki-Maria_Sharapova,1,F-IO,14,6,0,1,5,8,6
20120801-W-Olympics-R16-Sabine_Lisicki-Maria_Sharapova,1,F-II,1,1,0,1,0,1,0
20120801-W-Olympics-R16-Sabine_Lisicki-Maria_Sharapova,1,B-XC,26,4,1,1,2,15,11
20120801-W-Olympics-R16-Sabine_Lisicki-Maria_Sharapova,1,B-DTM,24,3,0,0,3,10,14
20120801-W-Olympics-R16-Sabine_Lisicki-Maria_Sharapova,1,B-DTL,9,6,1,1,4,2,7
20120801-W-Olympics-R16-Sabine_Lisicki-Maria_Sharapova,1,B-IO,7,2,1,0,1,5,2
20120801-W-Olympics-R16-Sabine_Lisicki-Maria_Sharapova,1,S-XC,3,0,0,0,0,0,3
20120801-W-Olympics-R16-Sabine_Lisicki-Maria_Sharapova,1,S-DTM,3,0,0,0,0,1,2
20120801-W-Olympics-R16-Sabine_Lisicki-Maria_Sharapova,2,F-XC,54,15,6,3,6,27,27
20120801-W-Olympics-R16-Sabine_Lisicki-Maria_Sharapova,2,F-DTM,11,1,0,0,1,6,5
20120801-W-Olympics-R16-Sabine_Lisicki-Maria_Sharapova,2,F-DTL,16,10,5,2,3,10,6
20120801-W-Olympics-R16-Sabine_Lisicki-Maria_Sharapova,2,F-IO,20,10,5,1,4,11,9
20120801-W-Olympics-R16-Sabine_Lisicki-Maria_Sharapova,2,F-II,1,1,0,1,0,1,0
20120801-W-Olympics-R16-Sabine_Lisicki-Maria_Sharapova,2,B-XC,42,22,4,7,11,24,18
20120801-W-Olympics-R16-Sabine_Lisicki-Maria_Sharapova,2,B-DTM,18,3,0,0,3,5,13
20120801-W-Olympics-R16-Sabine_Lisicki-Maria_Sharapova,2,B-DTL,12,3,0,0,3,6,6
20120801-W-Olympics-R16-Sabine_Lisicki-Maria_Sharapova,2,B-IO,4,1,1,0,0,2,2
20120801-W-Olympics-R16-Sabine_Lisicki-Maria_Sharapova,2,S-DTM,1,0,0,0,0,0,1
20120801-W-Olympics-R16-Sabine_Lisicki-Maria_Sharapova,2,S-DTL,3,0,0,0,0,3,0
20120801-W-Olympics-R16-Sabine_Lisicki-Maria_Sharapova,2,S-IO,1,0,0,0,0,0,1
20170407-W-Charleston-QF-Caroline_Wozniacki-Jelena_Ostapenko,1,F-XC,28,2,0,2,0,12,16
20170407-W-Charleston-QF-Caroline_Wozniacki-Jelena_Ostapenko,1,F-DTM,23,0,0,0,0,7,16
20170407-W-Charleston-QF-Caroline_Wozniacki-Jelena_Ostapenko,1,F-DTL,16,5,2,1,2,8,8
20170407-W-Charleston-QF-Caroline_Wozniacki-Jelena_Ostapenko,1,F-IO,3,1,1,0,0,2,1
20170407-W-Charleston-QF-Caroline_Wozniacki-Jelena_Ostapenko,1,B-XC,19,2,1,1,0,8,11
20170407-W-Charleston-QF-Caroline_Wozniacki-Jelena_Ostapenko,1,B-DTM,9,0,0,0,0,5,4
20170407-W-Charleston-QF-Caroline_Wozniacki-Jelena_Ostapenko,1,B-DTL,4,1,0,0,1,2,2
20170407-W-Charleston-QF-Caroline_Wozniacki-Jelena_Ostapenko,1,B-IO,6,1,0,1,0,2,4
20170407-W-Charleston-QF-Caroline_Wozniacki-Jelena_Ostapenko,1,S-XC,2,0,0,0,0,1,1
20170407-W-Charleston-QF-Caroline_Wozniacki-Jelena_Ostapenko,1,S-DTM,10,0,0,0,0,4,6
20170407-W-Charleston-QF-Caroline_Wozniacki-Jelena_Ostapenko,1,S-DTL,1,0,0,0,0,0,1
20170407-W-Charleston-QF-Caroline_Wozniacki-Jelena_Ostapenko,1,S-IO,1,0,0,0,0,1,0
20170407-W-Charleston-QF-Caroline_Wozniacki-Jelena_Ostapenko,2,F-XC,51,16,5,4,7,31,20
20170407-W-Charleston-QF-Caroline_Wozniacki-Jelena_Ostapenko,2,F-DTM,3,0,0,0,0,2,1
20170407-W-Charleston-QF-Caroline_Wozniacki-Jelena_Ostapenko,2,F-DTL,10,7,3,1,3,6,4
20170407-W-Charleston-QF-Caroline_Wozniacki-Jelena_Ostapenko,2,F-IO,23,15,12,0,3,17,6
20170407-W-Charleston-QF-Caroline_Wozniacki-Jelena_Ostapenko,2,F-II,2,1,1,0,0,1,1
20170407-W-Charleston-QF-Caroline_Wozniacki-Jelena_Ostapenko,2,B-XC,26,7,3,2,2,16,10
20170407-W-Charleston-QF-Caroline_Wozniacki-Jelena_Ostapenko,2,B-DTM,11,1,0,1,0,7,4
20170407-W-Charleston-QF-Caroline_Wozniacki-Jelena_Ostapenko,2,B-DTL,13,7,4,2,1,9,4
20170407-W-Charleston-QF-Caroline_Wozniacki-Jelena_Ostapenko,2,B-IO,7,1,1,0,0,5,2
20170407-W-Charleston-QF-Caroline_Wozniacki-Jelena_Ostapenko,2,S-DTM,2,0,0,0,0,0,2
20170309-W-Indian_Wells-R128-Eugenie_Bouchard-Annika_Beck,1,F-XC,96,22,3,7,12,42,54
20170309-W-Indian_Wells-R128-Eugenie_Bouchard-Annika_Beck,1,F-DTM,26,2,1,0,1,14,12
20170309-W-Indian_Wells-R128-Eugenie_Bouchard-Annika_Beck,1,F-DTL,19,8,0,0,8,6,13
20170309-W-Indian_Wells-R128-Eugenie_Bouchard-Annika_Beck,1,F-IO,36,10,4,3,3,20,16
20170309-W-Indian_Wells-R128-Eugenie_Bouchard-Annika_Beck,1,F-II,3,2,1,0,1,1,2
20170309-W-Indian_Wells-R128-Eugenie_Bouchard-Annika_Beck,1,B-XC,90,17,4,3,10,45,45
20170309-W-Indian_Wells-R128-Eugenie_Bouchard-Annika_Beck,1,B-DTM,51,4,0,1,3,23,28
20170309-W-Indian_Wells-R128-Eugenie_Bouchard-Annika_Beck,1,B-DTL,17,6,4,0,2,9,8
20170309-W-Indian_Wells-R128-Eugenie_Bouchard-Annika_Beck,1,B-IO,18,11,2,1,8,7,11
20170309-W-Indian_Wells-R128-Eugenie_Bouchard-Annika_Beck,1,S-XC,1,0,0,0,0,1,0
20170309-W-Indian_Wells-R128-Eugenie_Bouchard-Annika_Beck,1,S-DTM,1,0,0,0,0,0,1
20170309-W-Indian_Wells-R128-Eugenie_Bouchard-Annika_Beck,2,F-XC,56,7,3,1,3,31,25
20170309-W-Indian_Wells-R128-Eugenie_Bouchard-Annika_Beck,2,F-DTM,57,5,0,0,5,26,31
20170309-W-Indian_Wells-R128-Eugenie_Bouchard-Annika_Beck,2,F-DTL,33,10,5,4,1,20,13
20170309-W-Indian_Wells-R128-Eugenie_Bouchard-Annika_Beck,2,F-IO,35,9,4,2,3,21,14
20170309-W-Indian_Wells-R128-Eugenie_Bouchard-Annika_Beck,2,F-II,1,0,0,0,0,0,1
20170309-W-Indian_Wells-R128-Eugenie_Bouchard-Annika_Beck,2,B-XC,47,3,2,0,1,26,21
20170309-W-Indian_Wells-R128-Eugenie_Bouchard-Annika_Beck,2,B-DTM,80,12,0,2,10,32,48
20170309-W-Indian_Wells-R128-Eugenie_Bouchard-Annika_Beck,2,B-DTL,17,6,4,0,2,11,6
20170309-W-Indian_Wells-R128-Eugenie_Bouchard-Annika_Beck,2,B-IO,6,1,0,1,0,4,2
20170309-W-Indian_Wells-R128-Eugenie_Bouchard-Annika_Beck,2,S-XC,1,0,0,0,0,0,1
20170309-W-Indian_Wells-R128-Eugenie_Bouchard-Annika_Beck,2,S-DTM,6,0,0,0,0,2,4
20170309-W-Indian_Wells-R128-Eugenie_Bouchard-Annika_Beck,2,S-DTL,2,0,0,0,0,1,1
19960113-W-Sydney-F-Monica_Seles-Lindsay_Davenport,1,F-XC,59,13,6,4,3,33,26
19960113-W-Sydney-F-Monica_Seles-Lindsay_Davenport,1,F-DTM,40,8,0,3,5,17,23
19960113-W-Sydney-F-Monica_Seles-Lindsay_Davenport,1,F-DTL,22,9,4,1,4,12,10
19960113-W-Sydney-F-Monica_Seles-Lindsay_Davenport,1,F-IO,22,10,3,3,4,14,8
19960113-W-Sydney-F-Monica_Seles-Lindsay_Davenport,1,B-XC,58,18,5,6,7,35,23
19960113-W-Sydney-F-Monica_Seles-Lindsay_Davenport,1,B-DTM,32,2,0,0,2,12,20
19960113-W-Sydney-F-Monica_Seles-Lindsay_Davenport,1,B-DTL,13,6,5,1,0,9,4
19960113-W-Sydney-F-Monica_Seles-Lindsay_Davenport,1,B-IO,5,2,1,0,1,2,3
19960113-W-Sydney-F-Monica_Seles-Lindsay_Davenport,1,S-XC,2,1,1,0,0,2,0
19960113-W-Sydney-F-Monica_Seles-Lindsay_Davenport,1,S-DTM,5,0,0,0,0,1,4
19960113-W-Sydney-F-Monica_Seles-Lindsay_Davenport,1,S-DTL,1,0,0,0,0,0,1
19960113-W-Sydney-F-Monica_Seles-Lindsay_Davenport,2,F-XC,66,19,4,5,10,33,33
19960113-W-Sydney-F-Monica_Seles-Lindsay_Davenport,2,F-DTM,27,1,0,0,1,10,17
19960113-W-Sydney-F-Monica_Seles-Lindsay_Davenport,2,F-DTL,15,5,2,1,2,6,9
19960113-W-Sydney-F-Monica_Seles-Lindsay_Davenport,2,F-IO,19,5,2,2,1,13,6
19960113-W-Sydney-F-Monica_Seles-Lindsay_Davenport,2,B-XC,54,15,4,5,6,27,27
19960113-W-Sydney-F-Monica_Seles-Lindsay_Davenport,2,B-DTM,38,3,0,1,2,19,19
19960113-W-Sydney-F-Monica_Seles-Lindsay_Davenport,2,B-DTL,16,9,4,2,3,11,5
19960113-W-Sydney-F-Monica_Seles-Lindsay_Davenport,2,B-IO,11,4,2,1,1,7,4
19960113-W-Sydney-F-Monica_Seles-Lindsay_Davenport,2,S-DTM,1,0,0,0,0,1,0
19921116-W-Tour_Championships-F-Monica_Seles-Martina_Navratilova,1,F-XC,32,11,7,2,2,17,15
19921116-W-Tour_Championships-F-Monica_Seles-Martina_Navratilova,1,F-DTM,18,1,0,0,1,9,9
19921116-W-Tour_Championships-F-Monica_Seles-Martina_Navratilova,1,F-DTL,23,7,5,1,1,16,7
19921116-W-Tour_Championships-F-Monica_Seles-Martina_Navratilova,1,F-IO,20,4,2,0,2,17,3
19921116-W-Tour_Championships-F-Monica_Seles-Martina_Navratilova,1,F-II,1,0,0,0,0,1,0
19921116-W-Tour_Championships-F-Monica_Seles-Martina_Navratilova,1,B-XC,69,12,5,3,4,46,23
19921116-W-Tour_Championships-F-Monica_Seles-Martina_Navratilova,1,B-DTM,19,2,0,2,0,9,10
19921116-W-Tour_Championships-F-Monica_Seles-Martina_Navratilova,1,B-DTL,14,6,4,1,1,8,6
19921116-W-Tour_Championships-F-Monica_Seles-Martina_Navratilova,1,B-IO,10,5,4,1,0,10,0
19921116-W-Tour_Championships-F-Monica_Seles-Martina_Navratilova,1,S-XC,1,0,0,0,0,0,1
19921116-W-Tour_Championships-F-Monica_Seles-Martina_Navratilova,1,S-DTL,2,0,0,0,0,1,1
19921116-W-Tour_Championships-F-Monica_Seles-Martina_Navratilova,2,F-XC,39,8,3,2,3,18,21
19921116-W-Tour_Championships-F-Monica_Seles-Martina_Navratilova,2,F-DTM,13,2,0,0,2,3,10
19921116-W-Tour_Championships-F-Monica_Seles-Martina_Navratilova,2,F-DTL,9,5,0,2,3,6,3
19921116-W-Tour_Championships-F-Monica_Seles-Martina_Navratilova,2,F-IO,6,3,0,1,2,2,4
19921116-W-Tour_Championships-F-Monica_Seles-Martina_Navratilova,2,B-XC,8,2,0,0,2,1,7
19921116-W-Tour_Championships-F-Monica_Seles-Martina_Navratilova,2,B-DTM,1,0,0,0,0,0,1
19921116-W-Tour_Championships-F-Monica_Seles-Martina_Navratilova,2,B-DTL,4,2,0,1,1,3,1
19921116-W-Tour_Championships-F-Monica_Seles-Martina_Navratilova,2,S-XC,50,6,1,1,4,16,34
19921116-W-Tour_Championships-F-Monica_Seles-Martina_Navratilova,2,S-DTM,22,1,0,0,1,3,19
19921116-W-Tour_Championships-F-Monica_Seles-Martina_Navratilova,2,S-DTL,9,4,0,2,2,3,6
19921116-W-Tour_Championships-F-Monica_Seles-Martina_Navratilova,2,S-IO,2,0,0,0,0,1,1
20170429-W-Stuttgart-SF-Maria_Sharapova-Kristina_Mladenovic,1,F-XC,38,16,4,6,6,16,22
20170429-W-Stuttgart-SF-Maria_Sharapova-Kristina_Mladenovic,1,F-DTM,25,2,1,1,0,13,12
20170429-W-Stuttgart-SF-Maria_Sharapova-Kristina_Mladenovic,1,F-DTL,17,7,2,1,4,5,12
20170429-W-Stuttgart-SF-Maria_Sharapova-Kristina_Mladenovic,1,F-IO,16,3,0,0,3,6,10
20170429-W-Stuttgart-SF-Maria_Sharapova-Kristina_Mladenovic,1,F-II,1,1,1,0,0,1,0
20170429-W-Stuttgart-SF-Maria_Sharapova-Kristina_Mladenovic,1,B-XC,32,11,2,2,7,12,20
20170429-W-Stuttgart-SF-Maria_Sharapova-Kristina_Mladenovic,1,B-DTM,8,2,0,1,1,2,6
20170429-W-Stuttgart-SF-Maria_Sharapova-Kristina_Mladenovic,1,B-DTL,5,3,2,0,1,2,3
20170429-W-Stuttgart-SF-Maria_Sharapova-Kristina_Mladenovic,1,B-IO,5,1,1,0,0,3,2
20170429-W-Stuttgart-SF-Maria_Sharapova-Kristina_Mladenovic,2,F-XC,36,10,6,1,3,27,9
20170429-W-Stuttgart-SF-Maria_Sharapova-Kristina_Mladenovic,2,F-DTM,12,0,0,0,0,8,4
20170429-W-Stuttgart-SF-Maria_Sharapova-Kristina_Mladenovic,2,F-DTL,7,4,2,1,1,5,2
20170429-W-Stuttgart-SF-Maria_Sharapova-Kristina_Mladenovic,2,F-IO,10,5,2,2,1,6,4
20170429-W-Stuttgart-SF-Maria_Sharapova-Kristina_Mladenovic,2,F-II,1,1,1,0,0,1,0
20170429-W-Stuttgart-SF-Maria_Sharapova-Kristina_Mladenovic,2,B-XC,11,3,0,2,1,6,5
20170429-W-Stuttgart-SF-Maria_Sharapova-Kristina_Mladenovic,2,B-DTM,20,0,0,0,0,12,8
20170429-W-Stuttgart-SF-Maria_Sharapova-Kristina_Mladenovic,2,B-DTL,8,6,0,3,3,4,4
20170429-W-Stuttgart-SF-Maria_Sharapova-Kristina_Mladenovic,2,B-IO,6,2,1,0,1,3,3
20170429-W-Stuttgart-SF-Maria_Sharapova-Kristina_Mladenovic,2,S-XC,6,0,0,0,0,4,2
20170429-W-Stuttgart-SF-Maria_Sharapova-Kristina_Mladenovic,2,S-DTM,7,0,0,0,0,6,1
20170429-W-Stuttgart-SF-Maria_Sharapova-Kristina_Mladenovic,2,S-DTL,4,1,1,0,0,3,1
20170429-W-Stuttgart-SF-Maria_Sharapova-Kristina_Mladenovic,2,S-IO,2,0,0,0,0,0,2
19940127-W-Australian_Open-SF-Steffi_Graf-Kimiko_Date_Krumm,1,F-XC,30,10,7,1,2,17,13
19940127-W-Australian_Open-SF-Steffi_Graf-Kimiko_Date_Krumm,1,F-DTM,9,0,0,0,0,6,3
19940127-W-Australian_Open-SF-Steffi_Graf-Kimiko_Date_Krumm,1,F-DTL,5,3,0,2,1,4,1
19940127-W-Australian_Open-SF-Steffi_Graf-Kimiko_Date_Krumm,1,F-IO,16,1,0,1,0,12,4
19940127-W-Australian_Open-SF-Steffi_Graf-Kimiko_Date_Krumm,1,F-II,6,2,0,1,1,4,2
19940127-W-Australian_Open-SF-Steffi_Graf-Kimiko_Date_Krumm,1,B-XC,3,1,1,0,0,3,0
19940127-W-Australian_Open-SF-Steffi_Graf-Kimiko_Date_Krumm,1,B-DTM,1,0,0,0,0,1,0
19940127-W-Australian_Open-SF-Steffi_Graf-Kimiko_Date_Krumm,1,B-IO,1,1,1,0,0,1,0
19940127-W-Australian_Open-SF-Steffi_Graf-Kimiko_Date_Krumm,1,S-XC,18,2,0,0,2,12,6
19940127-W-Australian_Open-SF-Steffi_Graf-Kimiko_Date_Krumm,1,S-DTM,7,1,0,0,1,3,4
19940127-W-Australian_Open-SF-Steffi_Graf-Kimiko_Date_Krumm,1,S-DTL,12,4,0,1,3,6,6
19940127-W-Australian_Open-SF-Steffi_Graf-Kimiko_Date_Krumm,2,F-XC,25,9,2,2,5,12,13
19940127-W-Australian_Open-SF-Steffi_Graf-Kimiko_Date_Krumm,2,F-DTM,14,4,0,0,4,3,11
19940127-W-Australian_Open-SF-Steffi_Graf-Kimiko_Date_Krumm,2,F-DTL,19,8,2,4,2,11,8
19940127-W-Australian_Open-SF-Steffi_Graf-Kimiko_Date_Krumm,2,F-IO,7,4,1,1,2,3,4
19940127-W-Australian_Open-SF-Steffi_Graf-Kimiko_Date_Krumm,2,F-II,1,0,0,0,0,1,0
19940127-W-Australian_Open-SF-Steffi_Graf-Kimiko_Date_Krumm,2,B-XC,37,6,0,1,5,11,26
19940127-W-Australian_Open-SF-Steffi_Graf-Kimiko_Date_Krumm,2,B-DTM,13,2,0,0,2,2,11
19940127-W-Australian_Open-SF-Steffi_Graf-Kimiko_Date_Krumm,2,B-DTL,3,3,2,1,0,3,0
19940127-W-Australian_Open-SF-Steffi_Graf-Kimiko_Date_Krumm,2,B-IO,1,0,0,0,0,1,0
20080124-W-Australian_Open-SF-Maria_Sharapova-Jelena_Jankovic,1,F-XC,31,10,3,2,5,18,13
20080124-W-Australian_Open-SF-Maria_Sharapova-Jelena_Jankovic,1,F-DTM,9,1,0,0,1,5,4
20080124-W-Australian_Open-SF-Maria_Sharapova-Jelena_Jankovic,1,F-DTL,11,2,1,1,0,9,2
20080124-W-Australian_Open-SF-Maria_Sharapova-Jelena_Jankovic,1,F-IO,8,6,5,0,1,7,1
20080124-W-Australian_Open-SF-Maria_Sharapova-Jelena_Jankovic,1,B-XC,18,8,2,2,4,12,6
20080124-W-Australian_Open-SF-Maria_Sharapova-Jelena_Jankovic,1,B-DTM,8,0,0,0,0,7,1
20080124-W-Australian_Open-SF-Maria_Sharapova-Jelena_Jankovic,1,B-DTL,3,1,1,0,0,3,0
20080124-W-Australian_Open-SF-Maria_Sharapova-Jelena_Jankovic,1,B-IO,4,0,0,0,0,2,2
20080124-W-Australian_Open-SF-Maria_Sharapova-Jelena_Jankovic,1,S-DTM,2,0,0,0,0,1,1
20080124-W-Australian_Open-SF-Maria_Sharapova-Jelena_Jankovic,1,S-DTL,1,0,0,0,0,0,1
20080124-W-Australian_Open-SF-Maria_Sharapova-Jelena_Jankovic,2,F-XC,22,3,1,0,2,6,16
20080124-W-Australian_Open-SF-Maria_Sharapova-Jelena_Jankovic,2,F-DTM,5,2,0,0,2,1,4
20080124-W-Australian_Open-SF-Maria_Sharapova-Jelena_Jankovic,2,F-DTL,13,3,1,2,0,7,6
20080124-W-Australian_Open-SF-Maria_Sharapova-Jelena_Jankovic,2,F-IO,13,4,1,0,3,4,9
20080124-W-Australian_Open-SF-Maria_Sharapova-Jelena_Jankovic,2,B-XC,9,4,2,2,0,6,3
20080124-W-Australian_Open-SF-Maria_Sharapova-Jelena_Jankovic,2,B-DTM,11,0,0,0,0,4,7
20080124-W-Australian_Open-SF-Maria_Sharapova-Jelena_Jankovic,2,B-DTL,10,2,0,1,1,4,6
20080124-W-Australian_Open-SF-Maria_Sharapova-Jelena_Jankovic,2,B-IO,5,1,0,1,0,3,2
20080124-W-Australian_Open-SF-Maria_Sharapova-Jelena_Jankovic,2,S-XC,2,0,0,0,0,0,2
20080124-W-Australian_Open-SF-Maria_Sharapova-Jelena_Jankovic,2,S-DTM,5,0,0,0,0,0,5
20080124-W-Australian_Open-SF-Maria_Sharapova-Jelena_Jankovic,2,S-DTL,1,0,0,0,0,0,1
20170509-W-Madrid-R32-Dominika_Cibulkova-Oceane_Dodin,1,F-XC,27,8,5,2,1,14,13
20170509-W-Madrid-R32-Dominika_Cibulkova-Oceane_Dodin,1,F-DTM,6,0,0,0,0,3,3
20170509-W-Madrid-R32-Dominika_Cibulkova-Oceane_Dodin,1,F-DTL,6,2,1,0,1,3,3
20170509-W-Madrid-R32-Dominika_Cibulkova-Oceane_Dodin,1,F-IO,5,3,0,2,1,3,2
20170509-W-Madrid-R32-Dominika_Cibulkova-Oceane_Dodin,1,B-XC,17,3,2,1,0,11,6
20170509-W-Madrid-R32-Dominika_Cibulkova-Oceane_Dodin,1,B-DTM,4,1,0,0,1,1,3
20170509-W-Madrid-R32-Dominika_Cibulkova-Oceane_Dodin,1,B-DTL,2,1,0,1,0,2,0
20170509-W-Madrid-R32-Dominika_Cibulkova-Oceane_Dodin,1,S-XC,4,0,0,0,0,2,2
20170509-W-Madrid-R32-Dominika_Cibulkova-Oceane_Dodin,1,S-DTM,2,0,0,0,0,0,2
20170509-W-Madrid-R32-Dominika_Cibulkova-Oceane_Dodin,2,F-XC,15,4,1,2,1,6,9
20170509-W-Madrid-R32-Dominika_Cibulkova-Oceane_Dodin,2,F-DTM,8,2,0,0,2,4,4
20170509-W-Madrid-R32-Dominika_Cibulkova-Oceane_Dodin,2,F-DTL,8,6,4,1,1,5,3
20170509-W-Madrid-R32-Dominika_Cibulkova-Oceane_Dodin,2,F-IO,3,2,2,0,0,2,1
20170509-W-Madrid-R32-Dominika_Cibulkova-Oceane_Dodin,2,B-XC,18,6,3,2,1,13,5
20170509-W-Madrid-R32-Dominika_Cibulkova-Oceane_Dodin,2,B-DTM,12,1,0,0,1,2,10
20170509-W-Madrid-R32-Dominika_Cibulkova-Oceane_Dodin,2,B-DTL,8,3,1,0,2,3,5
20170509-W-Madrid-R32-Dominika_Cibulkova-Oceane_Dodin,2,B-IO,5,2,1,0,1,3,2
20150904-W-US_Open-R32-Venus_Williams-Belinda_Bencic,1,F-XC,26,10,3,2,5,16,10
20150904-W-US_Open-R32-Venus_Williams-Belinda_Bencic,1,F-DTM,13,3,1,0,2,4,9
20150904-W-US_Open-R32-Venus_Williams-Belinda_Bencic,1,F-DTL,6,3,1,1,1,3,3
20150904-W-US_Open-R32-Venus_Williams-Belinda_Bencic,1,F-IO,14,11,6,2,3,10,4
20150904-W-US_Open-R32-Venus_Williams-Belinda_Bencic,1,B-XC,21,6,1,2,3,9,12
20150904-W-US_Open-R32-Venus_Williams-Belinda_Bencic,1,B-DTM,18,3,1,0,2,8,10
20150904-W-US_Open-R32-Venus_Williams-Belinda_Bencic,1,B-DTL,7,3,1,0,2,3,4
20150904-W-US_Open-R32-Venus_Williams-Belinda_Bencic,1,B-IO,2,2,0,0,2,0,2
20150904-W-US_Open-R32-Venus_Williams-Belinda_Bencic,1,S-XC,1,0,0,0,0,0,1
20150904-W-US_Open-R32-Venus_Williams-Belinda_Bencic,1,S-DTM,5,1,0,0,1,1,4
20150904-W-US_Open-R32-Venus_Williams-Belinda_Bencic,2,F-XC,21,5,2,0,3,12,9
20150904-W-US_Open-R32-Venus_Williams-Belinda_Bencic,2,F-DTM,15,1,0,0,1,9,6
20150904-W-US_Open-R32-Venus_Williams-Belinda_Bencic,2,F-DTL,10,2,0,0,2,4,6
20150904-W-US_Open-R32-Venus_Williams-Belinda_Bencic,2,F-IO,14,4,0,2,2,6,8
20150904-W-US_Open-R32-Venus_Williams-Belinda_Bencic,2,B-XC,20,4,2,1,1,9,11
20150904-W-US_Open-R32-Venus_Williams-Belinda_Bencic,2,B-DTM,17,3,1,1,1,10,7
20150904-W-US_Open-R32-Venus_Williams-Belinda_Bencic,2,B-DTL,4,2,0,2,0,3,1
20150904-W-US_Open-R32-Venus_Williams-Belinda_Bencic,2,B-IO,7,3,1,1,1,5,2
20150904-W-US_Open-R32-Venus_Williams-Belinda_Bencic,2,S-DTM,1,0,0,0,0,0,1
20170326-W-Miami-R32-Madison_Keys-Lara_Arruabarrena,1,F-XC,36,12,3,3,6,18,18
20170326-W-Miami-R32-Madison_Keys-Lara_Arruabarrena,1,F-DTM,21,2,1,0,1,7,14
20170326-W-Miami-R32-Madison_Keys-Lara_Arruabarrena,1,F-DTL,3,1,0,0,1,1,2
20170326-W-Miami-R32-Madison_Keys-Lara_Arruabarrena,1,F-IO,34,17,7,4,6,18,16
20170326-W-Miami-R32-Madison_Keys-Lara_Arruabarrena,1,F-II,6,3,1,0,2,2,4
20170326-W-Miami-R32-Madison_Keys-Lara_Arruabarrena,1,B-XC,25,8,2,0,6,5,20
20170326-W-Miami-R32-Madison_Keys-Lara_Arruabarrena,1,B-DTM,19,4,0,0,4,4,15
20170326-W-Miami-R32-Madison_Keys-Lara_Arruabarrena,1,B-DTL,18,9,1,1,7,6,12
20170326-W-Miami-R32-Madison_Keys-Lara_Arruabarrena,1,B-IO,3,0,0,0,0,0,3
20170326-W-Miami-R32-Madison_Keys-Lara_Arruabarrena,1,S-XC,4,1,0,0,1,0,4
20170326-W-Miami-R32-Madison_Keys-Lara_Arruabarrena,1,S-DTM,5,0,0,0,0,1,4
20170326-W-Miami-R32-Madison_Keys-Lara_Arruabarrena,1,S-DTL,1,0,0,0,0,0,1
20170326-W-Miami-R32-Madison_Keys-Lara_Arruabarrena,2,F-XC,16,3,1,2,0,11,5
20170326-W-Miami-R32-Madison_Keys-Lara_Arruabarrena,2,F-DTM,34,3,0,0,3,19,15
20170326-W-Miami-R32-Madison_Keys-Lara_Arruabarrena,2,F-DTL,22,2,0,0,2,13,9
20170326-W-Miami-R32-Madison_Keys-Lara_Arruabarrena,2,F-IO,28,5,1,4,0,25,3
20170326-W-Miami-R32-Madison_Keys-Lara_Arruabarrena,2,F-II,1,0,0,0,0,1,0
20170326-W-Miami-R32-Madison_Keys-Lara_Arruabarrena,2,B-XC,18,4,1,1,2,14,4
20170326-W-Miami-R32-Madison_Keys-Lara_Arruabarrena,2,B-DTM,12,5,0,3,2,6,6
20170326-W-Miami-R32-Madison_Keys-Lara_Arruabarrena,2,B-DTL,1,0,0,0,0,0,1
20170326-W-Miami-R32-Madison_Keys-Lara_Arruabarrena,2,S-XC,8,1,0,0,1,5,3
20170326-W-Miami-R32-Madison_Keys-Lara_Arruabarrena,2,S-DTM,13,3,0,1,2,6,7
20170326-W-Miami-R32-Madison_Keys-Lara_Arruabarrena,2,S-DTL,6,0,0,0,0,3,3
20170118-W-Australian_Open-R64-Ashleigh_Barty-Shelby_Rogers,1,F-XC,40,11,5,5,1,27,13
20170118-W-Australian_Open-R64-Ashleigh_Barty-Shelby_Rogers,1,F-DTM,11,2,0,1,1,6,5
20170118-W-Australian_Open-R64-Ashleigh_Barty-Shelby_Rogers,1,F-DTL,9,5,4,0,1,7,2
20170118-W-Australian_Open-R64-Ashleigh_Barty-Shelby_Rogers,1,F-IO,11,5,2,2,1,7,4
20170118-W-Australian_Open-R64-Ashleigh_Barty-Shelby_Rogers,1,F-II,1,0,0,0,0,1,0
20170118-W-Australian_Open-R64-Ashleigh_Barty-Shelby_Rogers,1,B-XC,14,4,1,0,3,9,5
20170118-W-Australian_Open-R64-Ashleigh_Barty-Shelby_Rogers,1,B-DTM,11,2,0,1,1,5,6
20170118-W-Australian_Open-R64-Ashleigh_Barty-Shelby_Rogers,1,B-DTL,3,2,1,0,1,2,1
20170118-W-Australian_Open-R64-Ashleigh_Barty-Shelby_Rogers,1,S-XC,6,1,0,0,1,3,3
20170118-W-Australian_Open-R64-Ashleigh_Barty-Shelby_Rogers,1,S-DTM,4,0,0,0,0,3,1
20170118-W-Australian_Open-R64-Ashleigh_Barty-Shelby_Rogers,1,S-DTL,2,1,1,0,0,1,1
20170118-W-Australian_Open-R64-Ashleigh_Barty-Shelby_Rogers,2,F-XC,28,5,4,1,0,14,14
20170118-W-Australian_Open-R64-Ashleigh_Barty-Shelby_Rogers,2,F-DTM,20,5,1,0,4,6,14
20170118-W-Australian_Open-R64-Ashleigh_Barty-Shelby_Rogers,2,F-DTL,9,3,2,1,0,6,3
20170118-W-Australian_Open-R64-Ashleigh_Barty-Shelby_Rogers,2,F-IO,8,3,1,1,1,5,3
20170118-W-Australian_Open-R64-Ashleigh_Barty-Shelby_Rogers,2,B-XC,16,5,0,1,4,6,10
20170118-W-Australian_Open-R64-Ashleigh_Barty-Shelby_Rogers,2,B-DTM,16,1,0,1,0,6,10
20170118-W-Australian_Open-R64-Ashleigh_Barty-Shelby_Rogers,2,B-DTL,6,2,1,0,1,3,3
20170118-W-Australian_Open-R64-Ashleigh_Barty-Shelby_Rogers,2,B-IO,4,2,0,0,2,1,3
20170118-W-Australian_Open-R64-Ashleigh_Barty-Shelby_Rogers,2,S-XC,4,0,0,0,0,2,2
20170118-W-Australian_Open-R64-Ashleigh_Barty-Shelby_Rogers,2,S-DTM,3,1,0,0,1,0,3
20170118-W-Australian_Open-R64-Ashleigh_Barty-Shelby_Rogers,2,S-DTL,1,0,0,0,0,0,1
20170116-W-Australian_Open-R128-Ashleigh_Barty-Annika_Beck,1,F-XC,62,13,4,6,3,39,23
20170116-W-Australian_Open-R128-Ashleigh_Barty-Annika_Beck,1,F-DTM,14,1,0,0,1,6,8
20170116-W-Australian_Open-R128-Ashleigh_Barty-Annika_Beck,1,F-DTL,10,7,2,1,4,4,6
20170116-W-Australian_Open-R128-Ashleigh_Barty-Annika_Beck,1,F-IO,28,13,7,2,4,19,9
20170116-W-Australian_Open-R128-Ashleigh_Barty-Annika_Beck,1,F-II,7,2,0,0,2,1,6
20170116-W-Australian_Open-R128-Ashleigh_Barty-Annika_Beck,1,B-XC,38,6,1,1,4,18,20
20170116-W-Australian_Open-R128-Ashleigh_Barty-Annika_Beck,1,B-DTM,20,1,0,0,1,12,8
20170116-W-Australian_Open-R128-Ashleigh_Barty-Annika_Beck,1,B-DTL,13,8,4,1,3,8,5
20170116-W-Australian_Open-R128-Ashleigh_Barty-Annika_Beck,1,B-IO,2,1,0,1,0,2,0
20170116-W-Australian_Open-R128-Ashleigh_Barty-Annika_Beck,1,S-XC,20,5,0,0,5,9,11
20170116-W-Australian_Open-R128-Ashleigh_Barty-Annika_Beck,1,S-DTM,3,0,0,0,0,0,3
20170116-W-Australian_Open-R128-Ashleigh_Barty-Annika_Beck,1,S-DTL,4,2,0,1,1,2,2
20170116-W-Australian_Open-R128-Ashleigh_Barty-Annika_Beck,1,S-IO,2,1,0,1,0,2,0
20170116-W-Australian_Open-R128-Ashleigh_Barty-Annika_Beck,2,F-XC,28,8,4,1,3,14,14
20170116-W-Australian_Open-R128-Ashleigh_Barty-Annika_Beck,2,F-DTM,41,1,0,0,1,16,25
20170116-W-Australian_Open-R128-Ashleigh_Barty-Annika_Beck,2,F-DTL,30,7,1,2,4,17,13
20170116-W-Australian_Open-R128-Ashleigh_Barty-Annika_Beck,2,F-IO,19,7,1,2,4,12,7
20170116-W-Australian_Open-R128-Ashleigh_Barty-Annika_Beck,2,B-XC,39,4,1,2,1,17,22
20170116-W-Australian_Open-R128-Ashleigh_Barty-Annika_Beck,2,B-DTM,42,1,0,0,1,15,27
20170116-W-Australian_Open-R128-Ashleigh_Barty-Annika_Beck,2,B-DTL,6,3,2,1,0,4,2
20170116-W-Australian_Open-R128-Ashleigh_Barty-Annika_Beck,2,B-IO,5,2,0,0,2,2,3
20170116-W-Australian_Open-R128-Ashleigh_Barty-Annika_Beck,2,S-XC,1,0,0,0,0,1,0
20170116-W-Australian_Open-R128-Ashleigh_Barty-Annika_Beck,2,S-DTM,5,0,0,0,0,2,3
20170116-W-Australian_Open-R128-Ashleigh_Barty-Annika_Beck,2,S-DTL,2,0,0,0,0,1,1
20130107-W-Hobart-R32-Mona_Barthel-Ashleigh_Barty,1,F-XC,18,8,4,3,1,15,3
20130107-W-Hobart-R32-Mona_Barthel-Ashleigh_Barty,1,F-DTM,9,3,1,0,2,3,6
20130107-W-Hobart-R32-Mona_Barthel-Ashleigh_Barty,1,F-DTL,15,7,2,2,3,7,8
20130107-W-Hobart-R32-Mona_Barthel-Ashleigh_Barty,1,F-IO,11,6,2,2,2,8,3
20130107-W-Hobart-R32-Mona_Barthel-Ashleigh_Barty,1,B-XC,14,6,2,1,3,7,7
20130107-W-Hobart-R32-Mona_Barthel-Ashleigh_Barty,1,B-DTM,10,2,0,0,2,4,6
20130107-W-Hobart-R32-Mona_Barthel-Ashleigh_Barty,1,B-DTL,12,7,3,1,3,6,6
20130107-W-Hobart-R32-Mona_Barthel-Ashleigh_Barty,1,B-IO,8,6,2,1,3,4,4
20130107-W-Hobart-R32-Mona_Barthel-Ashleigh_Barty,2,F-XC,22,7,3,1,3,10,12
20130107-W-Hobart-R32-Mona_Barthel-Ashleigh_Barty,2,F-DTM,6,0,0,0,0,2,4
20130107-W-Hobart-R32-Mona_Barthel-Ashleigh_Barty,2,F-DTL,5,1,1,0,0,3,2
20130107-W-Hobart-R32-Mona_Barthel-Ashleigh_Barty,2,F-IO,5,1,1,0,0,3,2
20130107-W-Hobart-R32-Mona_Barthel-Ashleigh_Barty,2,B-XC,9,2,1,1,0,5,4
20130107-W-Hobart-R32-Mona_Barthel-Ashleigh_Barty,2,B-DTM,12,0,0,0,0,6,6
20130107-W-Hobart-R32-Mona_Barthel-Ashleigh_Barty,2,B-DTL,4,3,1,0,2,1,3
20130107-W-Hobart-R32-Mona_Barthel-Ashleigh_Barty,2,B-IO,1,0,0,0,0,1,0
20130107-W-Hobart-R32-Mona_Barthel-Ashleigh_Barty,2,S-XC,2,0,0,0,0,1,1
20130107-W-Hobart-R32-Mona_Barthel-Ashleigh_Barty,2,S-DTM,6,1,0,1,0,2,4
20130107-W-Hobart-R32-Mona_Barthel-Ashleigh_Barty,2,S-IO,1,1,0,0,1,0,1
20160526-W-Roland_Garros-R64-Ana_Ivanovic-Kurumi_Nara,1,F-XC,44,14,7,3,4,25,19
20160526-W-Roland_Garros-R64-Ana_Ivanovic-Kurumi_Nara,1,F-DTM,9,1,0,0,1,4,5
20160526-W-Roland_Garros-R64-Ana_Ivanovic-Kurumi_Nara,1,F-DTL,14,6,5,0,1,9,5
20160526-W-Roland_Garros-R64-Ana_Ivanovic-Kurumi_Nara,1,F-IO,12,4,3,0,1,9,3
20160526-W-Roland_Garros-R64-Ana_Ivanovic-Kurumi_Nara,1,F-II,11,5,3,1,1,7,4
20160526-W-Roland_Garros-R64-Ana_Ivanovic-Kurumi_Nara,1,B-XC,40,6,3,2,1,19,21
20160526-W-Roland_Garros-R64-Ana_Ivanovic-Kurumi_Nara,1,B-DTM,19,2,0,1,1,10,9
20160526-W-Roland_Garros-R64-Ana_Ivanovic-Kurumi_Nara,1,B-DTL,18,3,2,1,0,11,7
20160526-W-Roland_Garros-R64-Ana_Ivanovic-Kurumi_Nara,1,B-IO,5,1,1,0,0,2,3
20160526-W-Roland_Garros-R64-Ana_Ivanovic-Kurumi_Nara,1,S-XC,5,0,0,0,0,1,4
20160526-W-Roland_Garros-R64-Ana_Ivanovic-Kurumi_Nara,1,S-DTM,4,1,0,0,1,1,3
20160526-W-Roland_Garros-R64-Ana_Ivanovic-Kurumi_Nara,1,S-DTL,7,0,0,0,0,3,4
20160526-W-Roland_Garros-R64-Ana_Ivanovic-Kurumi_Nara,2,F-XC,39,11,4,4,3,23,16
20160526-W-Roland_Garros-R64-Ana_Ivanovic-Kurumi_Nara,2,F-DTM,13,0,0,0,0,6,7
20160526-W-Roland_Garros-R64-Ana_Ivanovic-Kurumi_Nara,2,F-DTL,29,2,0,0,2,12,17
20160526-W-Roland_Garros-R64-Ana_Ivanovic-Kurumi_Nara,2,F-IO,9,1,0,0,1,4,5
20160526-W-Roland_Garros-R64-Ana_Ivanovic-Kurumi_Nara,2,B-XC,50,11,2,5,4,26,24
20160526-W-Roland_Garros-R64-Ana_Ivanovic-Kurumi_Nara,2,B-DTM,19,0,0,0,0,10,9
20160526-W-Roland_Garros-R64-Ana_Ivanovic-Kurumi_Nara,2,B-DTL,15,4,1,2,1,10,5
20160526-W-Roland_Garros-R64-Ana_Ivanovic-Kurumi_Nara,2,B-IO,9,2,1,0,1,3,6
20160526-W-Roland_Garros-R64-Ana_Ivanovic-Kurumi_Nara,2,S-XC,3,0,0,0,0,2,1
20160526-W-Roland_Garros-R64-Ana_Ivanovic-Kurumi_Nara,2,S-DTL,1,0,0,0,0,1,0
20070708-W-Wimbledon-F-Venus_Williams-Marion_Bartoli,1,F-XC,40,8,5,0,3,23,17
20070708-W-Wimbledon-F-Venus_Williams-Marion_Bartoli,1,F-DTM,31,4,0,2,2,18,13
20070708-W-Wimbledon-F-Venus_Williams-Marion_Bartoli,1,F-DTL,7,3,0,1,2,3,4
20070708-W-Wimbledon-F-Venus_Williams-Marion_Bartoli,1,F-IO,8,4,3,0,1,6,2
20070708-W-Wimbledon-F-Venus_Williams-Marion_Bartoli,1,B-XC,34,6,5,1,0,23,11
20070708-W-Wimbledon-F-Venus_Williams-Marion_Bartoli,1,B-DTM,37,5,0,0,5,17,20
20070708-W-Wimbledon-F-Venus_Williams-Marion_Bartoli,1,B-DTL,12,4,3,0,1,10,2
20070708-W-Wimbledon-F-Venus_Williams-Marion_Bartoli,1,B-IO,5,4,1,0,3,2,3
20070708-W-Wimbledon-F-Venus_Williams-Marion_Bartoli,1,S-DTM,8,1,0,0,1,2,6
20070708-W-Wimbledon-F-Venus_Williams-Marion_Bartoli,1,S-DTL,1,1,1,0,0,1,0
20070708-W-Wimbledon-F-Venus_Williams-Marion_Bartoli,1,S-IO,1,0,0,0,0,1,0
20070708-W-Wimbledon-F-Venus_Williams-Marion_Bartoli,2,F-XC,30,4,1,2,1,11,19
20070708-W-Wimbledon-F-Venus_Williams-Marion_Bartoli,2,F-DTM,46,2,1,0,1,22,24
20070708-W-Wimbledon-F-Venus_Williams-Marion_Bartoli,2,F-DTL,9,2,1,0,1,4,5
20070708-W-Wimbledon-F-Venus_Williams-Marion_Bartoli,2,F-IO,4,0,0,0,0,3,1
20070708-W-Wimbledon-F-Venus_Williams-Marion_Bartoli,2,B-XC,39,5,2,2,1,13,26
20070708-W-Wimbledon-F-Venus_Williams-Marion_Bartoli,2,B-DTM,36,2,0,2,0,21,15
20070708-W-Wimbledon-F-Venus_Williams-Marion_Bartoli,2,B-DTL,12,4,0,1,3,4,8
20070708-W-Wimbledon-F-Venus_Williams-Marion_Bartoli,2,B-IO,8,3,0,2,1,3,5
20000902-W-US_Open-F-Venus_Williams-Lindsay_Davenport,1,F-XC,14,7,6,1,0,12,2
20000902-W-US_Open-F-Venus_Williams-Lindsay_Davenport,1,F-DTM,26,4,0,1,3,13,13
20000902-W-US_Open-F-Venus_Williams-Lindsay_Davenport,1,F-DTL,7,1,0,0,1,2,5
20000902-W-US_Open-F-Venus_Williams-Lindsay_Davenport,1,F-IO,7,4,1,1,2,5,2
20000902-W-US_Open-F-Venus_Williams-Lindsay_Davenport,1,B-XC,10,2,0,1,1,7,3
20000902-W-US_Open-F-Venus_Williams-Lindsay_Davenport,1,B-DTM,35,7,0,1,6,16,19
20000902-W-US_Open-F-Venus_Williams-Lindsay_Davenport,1,B-DTL,2,1,0,0,1,0,2
20000902-W-US_Open-F-Venus_Williams-Lindsay_Davenport,1,B-IO,6,3,2,1,0,6,0
20000902-W-US_Open-F-Venus_Williams-Lindsay_Davenport,2,F-XC,17,5,1,0,4,7,10
20000902-W-US_Open-F-Venus_Williams-Lindsay_Davenport,2,F-DTM,19,2,0,2,0,9,10
20000902-W-US_Open-F-Venus_Williams-Lindsay_Davenport,2,F-DTL,4,2,1,0,1,1,3
20000902-W-US_Open-F-Venus_Williams-Lindsay_Davenport,2,F-IO,9,4,1,0,3,4,5
20000902-W-US_Open-F-Venus_Williams-Lindsay_Davenport,2,B-XC,15,7,2,3,2,7,8
20000902-W-US_Open-F-Venus_Williams-Lindsay_Davenport,2,B-DTM,25,2,0,0,2,9,16
20000902-W-US_Open-F-Venus_Williams-Lindsay_Davenport,2,B-DTL,4,2,2,0,0,3,1
20000902-W-US_Open-F-Venus_Williams-Lindsay_Davenport,2,B-IO,11,8,2,3,3,5,6
20000902-W-US_Open-F-Venus_Williams-Lindsay_Davenport,2,S-XC,1,0,0,0,0,1,0
20000902-W-US_Open-F-Venus_Williams-Lindsay_Davenport,2,S-DTM,5,0,0,0,0,1,4
20000902-W-US_Open-F-Venus_Williams-Lindsay_Davenport,2,S-IO,1,0,0,0,0,1,0
20140529-W-Roland_Garros-R64-Ana_Ivanovic-Elina_Svitolina,1,F-XC,36,14,9,2,3,26,10
20140529-W-Roland_Garros-R64-Ana_Ivanovic-Elina_Svitolina,1,F-DTM,7,2,0,1,1,2,5
20140529-W-Roland_Garros-R64-Ana_Ivanovic-Elina_Svitolina,1,F-DTL,11,7,0,2,5,5,6
20140529-W-Roland_Garros-R64-Ana_Ivanovic-Elina_Svitolina,1,F-IO,7,3,1,1,1,6,1
20140529-W-Roland_Garros-R64-Ana_Ivanovic-Elina_Svitolina,1,F-II,3,2,2,0,0,3,0
20140529-W-Roland_Garros-R64-Ana_Ivanovic-Elina_Svitolina,1,B-XC,30,4,0,2,2,16,14
20140529-W-Roland_Garros-R64-Ana_Ivanovic-Elina_Svitolina,1,B-DTM,16,0,0,0,0,10,6
20140529-W-Roland_Garros-R64-Ana_Ivanovic-Elina_Svitolina,1,B-DTL,8,2,2,0,0,8,0
20140529-W-Roland_Garros-R64-Ana_Ivanovic-Elina_Svitolina,1,B-IO,2,0,0,0,0,2,0
20140529-W-Roland_Garros-R64-Ana_Ivanovic-Elina_Svitolina,1,S-XC,7,1,0,1,0,4,3
20140529-W-Roland_Garros-R64-Ana_Ivanovic-Elina_Svitolina,1,S-DTM,5,1,0,0,1,1,4
20140529-W-Roland_Garros-R64-Ana_Ivanovic-Elina_Svitolina,1,S-DTL,1,0,0,0,0,1,0
20140529-W-Roland_Garros-R64-Ana_Ivanovic-Elina_Svitolina,2,F-XC,20,3,3,0,0,11,9
20140529-W-Roland_Garros-R64-Ana_Ivanovic-Elina_Svitolina,2,F-DTM,14,1,0,0,1,3,11
20140529-W-Roland_Garros-R64-Ana_Ivanovic-Elina_Svitolina,2,F-DTL,10,2,1,0,1,2,8
20140529-W-Roland_Garros-R64-Ana_Ivanovic-Elina_Svitolina,2,F-IO,13,4,2,1,1,6,7
20140529-W-Roland_Garros-R64-Ana_Ivanovic-Elina_Svitolina,2,B-XC,28,5,1,2,2,14,14
20140529-W-Roland_Garros-R64-Ana_Ivanovic-Elina_Svitolina,2,B-DTM,21,5,1,1,3,5,16
20140529-W-Roland_Garros-R64-Ana_Ivanovic-Elina_Svitolina,2,B-DTL,9,3,2,1,0,7,2
20140529-W-Roland_Garros-R64-Ana_Ivanovic-Elina_Svitolina,2,B-IO,3,1,0,0,1,1,2
20140529-W-Roland_Garros-R64-Ana_Ivanovic-Elina_Svitolina,2,S-XC,1,0,0,0,0,0,1
20140529-W-Roland_Garros-R64-Ana_Ivanovic-Elina_Svitolina,2,S-DTM,3,0,0,0,0,0,3
20140529-W-Roland_Garros-R64-Ana_Ivanovic-Elina_Svitolina,2,S-DTL,1,0,0,0,0,1,0
20140529-W-Roland_Garros-R64-Ana_Ivanovic-Elina_Svitolina,2,S-IO,1,0,0,0,0,1,0
19900707-W-Wimbledon-F-Zina_Garrison-Martina_Navratilova,1,F-XC,3,2,0,1,1,1,2
19900707-W-Wimbledon-F-Zina_Garrison-Martina_Navratilova,1,F-DTM,6,1,1,0,0,2,4
19900707-W-Wimbledon-F-Zina_Garrison-Martina_Navratilova,1,F-IO,7,2,2,0,0,3,4
19900707-W-Wimbledon-F-Zina_Garrison-Martina_Navratilova,1,B-XC,2,2,0,1,1,1,1
19900707-W-Wimbledon-F-Zina_Garrison-Martina_Navratilova,1,B-DTM,4,0,0,0,0,0,4
19900707-W-Wimbledon-F-Zina_Garrison-Martina_Navratilova,1,B-IO,11,4,1,0,3,1,10
19900707-W-Wimbledon-F-Zina_Garrison-Martina_Navratilova,1,B-II,2,0,0,0,0,1,1
19900707-W-Wimbledon-F-Zina_Garrison-Martina_Navratilova,1,S-XC,3,1,0,1,0,1,2
19900707-W-Wimbledon-F-Zina_Garrison-Martina_Navratilova,1,S-DTM,1,0,0,0,0,0,1
19900707-W-Wimbledon-F-Zina_Garrison-Martina_Navratilova,1,S-II,1,0,0,0,0,0,1
19900707-W-Wimbledon-F-Zina_Garrison-Martina_Navratilova,2,F-XC,2,1,1,0,0,2,0
19900707-W-Wimbledon-F-Zina_Garrison-Martina_Navratilova,2,F-DTM,3,0,0,0,0,1,2
19900707-W-Wimbledon-F-Zina_Garrison-Martina_Navratilova,2,F-IO,7,2,2,0,0,7,0
19900707-W-Wimbledon-F-Zina_Garrison-Martina_Navratilova,2,F-II,2,2,2,0,0,2,0
19900707-W-Wimbledon-F-Zina_Garrison-Martina_Navratilova,2,B-DTM,2,2,1,0,1,1,1
19900707-W-Wimbledon-F-Zina_Garrison-Martina_Navratilova,2,B-IO,1,1,1,0,0,1,0
19900707-W-Wimbledon-F-Zina_Garrison-Martina_Navratilova,2,B-II,1,1,0,0,1,0,1
19900707-W-Wimbledon-F-Zina_Garrison-Martina_Navratilova,2,S-DTM,1,0,0,0,0,0,1
19900707-W-Wimbledon-F-Zina_Garrison-Martina_Navratilova,2,S-IO,2,1,0,1,0,2,0
19900707-W-Wimbledon-F-Zina_Garrison-Martina_Navratilova,2,S-II,2,1,0,1,0,2,0
20170528-W-Roland_Garros-R128-Angelique_Kerber-Ekaterina_Makarova,1,F-XC,54,7,3,2,2,23,31
20170528-W-Roland_Garros-R128-Angelique_Kerber-Ekaterina_Makarova,1,F-DTM,10,0,0,0,0,3,7
20170528-W-Roland_Garros-R128-Angelique_Kerber-Ekaterina_Makarova,1,F-DTL,17,10,3,0,7,7,10
20170528-W-Roland_Garros-R128-Angelique_Kerber-Ekaterina_Makarova,1,F-IO,7,3,2,0,1,6,1
20170528-W-Roland_Garros-R128-Angelique_Kerber-Ekaterina_Makarova,1,F-II,1,0,0,0,0,0,1
20170528-W-Roland_Garros-R128-Angelique_Kerber-Ekaterina_Makarova,1,B-XC,46,7,0,1,6,17,29
20170528-W-Roland_Garros-R128-Angelique_Kerber-Ekaterina_Makarova,1,B-DTM,14,0,0,0,0,5,9
20170528-W-Roland_Garros-R128-Angelique_Kerber-Ekaterina_Makarova,1,B-DTL,3,2,2,0,0,2,1
20170528-W-Roland_Garros-R128-Angelique_Kerber-Ekaterina_Makarova,1,B-IO,3,1,0,1,0,1,2
20170528-W-Roland_Garros-R128-Angelique_Kerber-Ekaterina_Makarova,1,S-XC,5,0,0,0,0,0,5
20170528-W-Roland_Garros-R128-Angelique_Kerber-Ekaterina_Makarova,1,S-DTM,4,0,0,0,0,1,3
20170528-W-Roland_Garros-R128-Angelique_Kerber-Ekaterina_Makarova,1,S-DTL,2,0,0,0,0,0,2
20170528-W-Roland_Garros-R128-Angelique_Kerber-Ekaterina_Makarova,2,F-XC,36,8,1,3,4,19,17
20170528-W-Roland_Garros-R128-Angelique_Kerber-Ekaterina_Makarova,2,F-DTM,17,1,0,0,1,11,6
20170528-W-Roland_Garros-R128-Angelique_Kerber-Ekaterina_Makarova,2,F-DTL,28,10,5,2,3,19,9
20170528-W-Roland_Garros-R128-Angelique_Kerber-Ekaterina_Makarova,2,F-IO,11,5,3,2,0,9,2
20170528-W-Roland_Garros-R128-Angelique_Kerber-Ekaterina_Makarova,2,F-II,1,1,0,1,0,1,0
20170528-W-Roland_Garros-R128-Angelique_Kerber-Ekaterina_Makarova,2,B-XC,35,5,2,1,2,22,13
20170528-W-Roland_Garros-R128-Angelique_Kerber-Ekaterina_Makarova,2,B-DTM,15,0,0,0,0,7,8
20170528-W-Roland_Garros-R128-Angelique_Kerber-Ekaterina_Makarova,2,B-DTL,19,9,4,0,5,11,8
20170528-W-Roland_Garros-R128-Angelique_Kerber-Ekaterina_Makarova,2,B-IO,8,2,0,2,0,5,3
20170528-W-Roland_Garros-R128-Angelique_Kerber-Ekaterina_Makarova,2,S-DTM,5,0,0,0,0,0,5
20170530-W-Roland_Garros-R128-Agnieszka_Radwanska-Fiona_Ferro,1,F-XC,24,3,2,0,1,16,8
20170530-W-Roland_Garros-R128-Agnieszka_Radwanska-Fiona_Ferro,1,F-DTM,10,0,0,0,0,6,4
20170530-W-Roland_Garros-R128-Agnieszka_Radwanska-Fiona_Ferro,1,F-DTL,16,2,2,0,0,15,1
20170530-W-Roland_Garros-R128-Agnieszka_Radwanska-Fiona_Ferro,1,F-IO,14,0,0,0,0,10,4
20170530-W-Roland_Garros-R128-Agnieszka_Radwanska-Fiona_Ferro,1,F-II,1,0,0,0,0,1,0
20170530-W-Roland_Garros-R128-Agnieszka_Radwanska-Fiona_Ferro,1,B-XC,46,2,0,0,2,30,16
20170530-W-Roland_Garros-R128-Agnieszka_Radwanska-Fiona_Ferro,1,B-DTM,24,0,0,0,0,15,9
20170530-W-Roland_Garros-R128-Agnieszka_Radwanska-Fiona_Ferro,1,B-DTL,12,2,0,1,1,7,5
20170530-W-Roland_Garros-R128-Agnieszka_Radwanska-Fiona_Ferro,1,B-IO,4,0,0,0,0,3,1
20170530-W-Roland_Garros-R128-Agnieszka_Radwanska-Fiona_Ferro,1,S-XC,6,0,0,0,0,2,4
20170530-W-Roland_Garros-R128-Agnieszka_Radwanska-Fiona_Ferro,1,S-DTM,1,0,0,0,0,0,1
20170530-W-Roland_Garros-R128-Agnieszka_Radwanska-Fiona_Ferro,1,S-IO,1,0,0,0,0,1,0
20170530-W-Roland_Garros-R128-Agnieszka_Radwanska-Fiona_Ferro,2,F-XC,21,5,2,0,3,6,15
20170530-W-Roland_Garros-R128-Agnieszka_Radwanska-Fiona_Ferro,2,F-DTM,14,1,0,0,1,5,9
20170530-W-Roland_Garros-R128-Agnieszka_Radwanska-Fiona_Ferro,2,F-DTL,12,4,1,0,3,5,7
20170530-W-Roland_Garros-R128-Agnieszka_Radwanska-Fiona_Ferro,2,F-IO,26,9,3,2,4,12,14
20170530-W-Roland_Garros-R128-Agnieszka_Radwanska-Fiona_Ferro,2,F-II,1,0,0,0,0,0,1
20170530-W-Roland_Garros-R128-Agnieszka_Radwanska-Fiona_Ferro,2,B-XC,38,7,0,0,7,10,28
20170530-W-Roland_Garros-R128-Agnieszka_Radwanska-Fiona_Ferro,2,B-DTM,26,6,1,1,4,7,19
20170530-W-Roland_Garros-R128-Agnieszka_Radwanska-Fiona_Ferro,2,B-DTL,20,11,7,0,4,9,11
20170530-W-Roland_Garros-R128-Agnieszka_Radwanska-Fiona_Ferro,2,B-IO,7,2,1,0,1,3,4
20170530-W-Roland_Garros-R128-Agnieszka_Radwanska-Fiona_Ferro,2,S-XC,6,1,0,0,1,2,4
20170530-W-Roland_Garros-R128-Agnieszka_Radwanska-Fiona_Ferro,2,S-DTM,6,0,0,0,0,1,5
20170530-W-Roland_Garros-R128-Agnieszka_Radwanska-Fiona_Ferro,2,S-DTL,1,1,0,1,0,1,0
20170503-W-Prague-R16-Caroline_Wozniacki-Jelena_Ostapenko,1,F-XC,54,6,0,3,3,28,26
20170503-W-Prague-R16-Caroline_Wozniacki-Jelena_Ostapenko,1,F-DTM,31,2,0,1,1,14,17
20170503-W-Prague-R16-Caroline_Wozniacki-Jelena_Ostapenko,1,F-DTL,22,5,2,2,1,12,10
20170503-W-Prague-R16-Caroline_Wozniacki-Jelena_Ostapenko,1,F-IO,16,3,0,1,2,6,10
20170503-W-Prague-R16-Caroline_Wozniacki-Jelena_Ostapenko,1,B-XC,33,5,0,1,4,13,20
20170503-W-Prague-R16-Caroline_Wozniacki-Jelena_Ostapenko,1,B-DTM,43,1,0,0,1,18,25
20170503-W-Prague-R16-Caroline_Wozniacki-Jelena_Ostapenko,1,B-DTL,7,3,1,1,1,4,3
20170503-W-Prague-R16-Caroline_Wozniacki-Jelena_Ostapenko,1,B-IO,11,4,2,1,1,5,6
20170503-W-Prague-R16-Caroline_Wozniacki-Jelena_Ostapenko,1,S-XC,3,1,0,0,1,1,2
20170503-W-Prague-R16-Caroline_Wozniacki-Jelena_Ostapenko,1,S-DTM,14,3,1,0,2,6,8
20170503-W-Prague-R16-Caroline_Wozniacki-Jelena_Ostapenko,1,S-DTL,2,0,0,0,0,1,1
20170503-W-Prague-R16-Caroline_Wozniacki-Jelena_Ostapenko,1,S-IO,1,0,0,0,0,1,0
20170503-W-Prague-R16-Caroline_Wozniacki-Jelena_Ostapenko,2,F-XC,65,20,9,4,7,36,29
20170503-W-Prague-R16-Caroline_Wozniacki-Jelena_Ostapenko,2,F-DTM,19,2,0,0,2,9,10
20170503-W-Prague-R16-Caroline_Wozniacki-Jelena_Ostapenko,2,F-DTL,23,20,13,1,6,16,7
20170503-W-Prague-R16-Caroline_Wozniacki-Jelena_Ostapenko,2,F-IO,23,13,9,0,4,14,9
20170503-W-Prague-R16-Caroline_Wozniacki-Jelena_Ostapenko,2,B-XC,51,16,5,3,8,27,24
20170503-W-Prague-R16-Caroline_Wozniacki-Jelena_Ostapenko,2,B-DTM,40,5,0,0,5,21,19
20170503-W-Prague-R16-Caroline_Wozniacki-Jelena_Ostapenko,2,B-DTL,25,17,8,1,8,12,13
20170503-W-Prague-R16-Caroline_Wozniacki-Jelena_Ostapenko,2,B-IO,14,5,2,1,2,9,5
20170503-W-Prague-R16-Caroline_Wozniacki-Jelena_Ostapenko,2,S-XC,1,0,0,0,0,1,0
20170503-W-Prague-R16-Caroline_Wozniacki-Jelena_Ostapenko,2,S-DTM,1,0,0,0,0,1,0
20170503-W-Prague-R16-Caroline_Wozniacki-Jelena_Ostapenko,2,S-DTL,1,1,0,1,0,1,0
20170422-W-Fed_Cup_World_Group_R1-RR-Angelique_Kerber-Lesia_Tsurenko,1,F-XC,57,10,4,3,3,31,26
20170422-W-Fed_Cup_World_Group_R1-RR-Angelique_Kerber-Lesia_Tsurenko,1,F-DTM,12,0,0,0,0,7,5
20170422-W-Fed_Cup_World_Group_R1-RR-Angelique_Kerber-Lesia_Tsurenko,1,F-DTL,20,12,5,2,5,11,9
20170422-W-Fed_Cup_World_Group_R1-RR-Angelique_Kerber-Lesia_Tsurenko,1,F-IO,9,3,1,0,2,6,3
20170422-W-Fed_Cup_World_Group_R1-RR-Angelique_Kerber-Lesia_Tsurenko,1,B-XC,42,8,1,5,2,29,13
20170422-W-Fed_Cup_World_Group_R1-RR-Angelique_Kerber-Lesia_Tsurenko,1,B-DTM,16,0,0,0,0,5,11
20170422-W-Fed_Cup_World_Group_R1-RR-Angelique_Kerber-Lesia_Tsurenko,1,B-DTL,11,3,2,1,0,6,5
20170422-W-Fed_Cup_World_Group_R1-RR-Angelique_Kerber-Lesia_Tsurenko,1,B-IO,1,1,0,1,0,1,0
20170422-W-Fed_Cup_World_Group_R1-RR-Angelique_Kerber-Lesia_Tsurenko,1,S-XC,6,0,0,0,0,4,2
20170422-W-Fed_Cup_World_Group_R1-RR-Angelique_Kerber-Lesia_Tsurenko,1,S-DTM,5,0,0,0,0,3,2
20170422-W-Fed_Cup_World_Group_R1-RR-Angelique_Kerber-Lesia_Tsurenko,1,S-DTL,1,0,0,0,0,0,1
20170422-W-Fed_Cup_World_Group_R1-RR-Angelique_Kerber-Lesia_Tsurenko,2,F-XC,40,3,1,0,2,16,24
20170422-W-Fed_Cup_World_Group_R1-RR-Angelique_Kerber-Lesia_Tsurenko,2,F-DTM,12,3,0,1,2,4,8
20170422-W-Fed_Cup_World_Group_R1-RR-Angelique_Kerber-Lesia_Tsurenko,2,F-DTL,21,3,0,0,3,9,12
20170422-W-Fed_Cup_World_Group_R1-RR-Angelique_Kerber-Lesia_Tsurenko,2,F-IO,6,3,2,0,1,3,3
20170422-W-Fed_Cup_World_Group_R1-RR-Angelique_Kerber-Lesia_Tsurenko,2,F-II,1,1,1,0,0,1,0
20170422-W-Fed_Cup_World_Group_R1-RR-Angelique_Kerber-Lesia_Tsurenko,2,B-XC,33,5,0,1,4,18,15
20170422-W-Fed_Cup_World_Group_R1-RR-Angelique_Kerber-Lesia_Tsurenko,2,B-DTM,12,1,0,0,1,2,10
20170422-W-Fed_Cup_World_Group_R1-RR-Angelique_Kerber-Lesia_Tsurenko,2,B-DTL,22,5,1,1,3,11,11
20170422-W-Fed_Cup_World_Group_R1-RR-Angelique_Kerber-Lesia_Tsurenko,2,B-IO,5,2,2,0,0,3,2
20170422-W-Fed_Cup_World_Group_R1-RR-Angelique_Kerber-Lesia_Tsurenko,2,S-XC,3,0,0,0,0,2,1
20170422-W-Fed_Cup_World_Group_R1-RR-Angelique_Kerber-Lesia_Tsurenko,2,S-DTM,3,0,0,0,0,2,1
20170422-W-Fed_Cup_World_Group_R1-RR-Angelique_Kerber-Lesia_Tsurenko,2,S-DTL,3,0,0,0,0,2,1
20161001-W-Wuhan-F-Petra_Kvitova-Dominika_Cibulkova,1,F-XC,21,8,3,1,4,14,7
20161001-W-Wuhan-F-Petra_Kvitova-Dominika_Cibulkova,1,F-DTM,10,1,0,0,1,7,3
20161001-W-Wuhan-F-Petra_Kvitova-Dominika_Cibulkova,1,F-IO,15,11,5,1,5,8,7
20161001-W-Wuhan-F-Petra_Kvitova-Dominika_Cibulkova,1,B-XC,11,3,1,0,2,7,4
20161001-W-Wuhan-F-Petra_Kvitova-Dominika_Cibulkova,1,B-DTM,10,2,0,0,2,6,4
20161001-W-Wuhan-F-Petra_Kvitova-Dominika_Cibulkova,1,B-DTL,4,2,1,0,1,3,1
20161001-W-Wuhan-F-Petra_Kvitova-Dominika_Cibulkova,1,B-IO,1,1,1,0,0,1,0
20161001-W-Wuhan-F-Petra_Kvitova-Dominika_Cibulkova,1,S-XC,3,0,0,0,0,2,1
20161001-W-Wuhan-F-Petra_Kvitova-Dominika_Cibulkova,1,S-DTM,2,0,0,0,0,1,1
20161001-W-Wuhan-F-Petra_Kvitova-Dominika_Cibulkova,1,S-DTL,1,0,0,0,0,1,0
20161001-W-Wuhan-F-Petra_Kvitova-Dominika_Cibulkova,2,F-XC,16,2,0,0,2,6,10
20161001-W-Wuhan-F-Petra_Kvitova-Dominika_Cibulkova,2,F-DTM,13,3,1,0,2,5,8
20161001-W-Wuhan-F-Petra_Kvitova-Dominika_Cibulkova,2,F-DTL,4,2,0,0,2,2,2
20161001-W-Wuhan-F-Petra_Kvitova-Dominika_Cibulkova,2,F-IO,5,3,0,0,3,0,5
20161001-W-Wuhan-F-Petra_Kvitova-Dominika_Cibulkova,2,B-XC,7,1,0,0,1,0,7
20161001-W-Wuhan-F-Petra_Kvitova-Dominika_Cibulkova,2,B-DTM,17,2,0,1,1,4,13
20161001-W-Wuhan-F-Petra_Kvitova-Dominika_Cibulkova,2,B-DTL,3,2,0,0,2,1,2
20161001-W-Wuhan-F-Petra_Kvitova-Dominika_Cibulkova,2,S-XC,1,1,0,0,1,0,1
20161001-W-Wuhan-F-Petra_Kvitova-Dominika_Cibulkova,2,S-DTM,3,0,0,0,0,1,2
20161001-W-Wuhan-F-Petra_Kvitova-Dominika_Cibulkova,2,S-DTL,5,0,0,0,0,0,5
20170419-W-ITF_Dothan-R32-Lizette_Cabrera-Amanda_Anisimova,1,F-XC,26,9,6,1,2,16,10
20170419-W-ITF_Dothan-R32-Lizette_Cabrera-Amanda_Anisimova,1,F-DTM,18,0,0,0,0,7,11
20170419-W-ITF_Dothan-R32-Lizette_Cabrera-Amanda_Anisimova,1,F-DTL,11,2,0,0,2,4,7
20170419-W-ITF_Dothan-R32-Lizette_Cabrera-Amanda_Anisimova,1,F-IO,22,9,1,2,6,10,12
20170419-W-ITF_Dothan-R32-Lizette_Cabrera-Amanda_Anisimova,1,B-XC,17,5,0,1,4,5,12
20170419-W-ITF_Dothan-R32-Lizette_Cabrera-Amanda_Anisimova,1,B-DTM,26,3,0,1,2,7,19
20170419-W-ITF_Dothan-R32-Lizette_Cabrera-Amanda_Anisimova,1,B-DTL,12,7,0,1,6,5,7
20170419-W-ITF_Dothan-R32-Lizette_Cabrera-Amanda_Anisimova,1,B-IO,5,2,1,0,1,3,2
20170419-W-ITF_Dothan-R32-Lizette_Cabrera-Amanda_Anisimova,1,S-XC,3,0,0,0,0,3,0
20170419-W-ITF_Dothan-R32-Lizette_Cabrera-Amanda_Anisimova,1,S-DTM,11,3,0,0,3,2,9
20170419-W-ITF_Dothan-R32-Lizette_Cabrera-Amanda_Anisimova,1,S-DTL,2,1,0,0,1,0,2
20170419-W-ITF_Dothan-R32-Lizette_Cabrera-Amanda_Anisimova,2,F-XC,37,10,1,3,6,21,16
20170419-W-ITF_Dothan-R32-Lizette_Cabrera-Amanda_Anisimova,2,F-DTM,18,3,0,1,2,9,9
20170419-W-ITF_Dothan-R32-Lizette_Cabrera-Amanda_Anisimova,2,F-DTL,11,4,1,0,3,5,6
20170419-W-ITF_Dothan-R32-Lizette_Cabrera-Amanda_Anisimova,2,F-IO,20,4,2,2,0,16,4
20170419-W-ITF_Dothan-R32-Lizette_Cabrera-Amanda_Anisimova,2,B-XC,37,13,2,2,9,20,17
20170419-W-ITF_Dothan-R32-Lizette_Cabrera-Amanda_Anisimova,2,B-DTM,19,2,0,0,2,10,9
20170419-W-ITF_Dothan-R32-Lizette_Cabrera-Amanda_Anisimova,2,B-DTL,7,5,3,0,2,3,4
20170419-W-ITF_Dothan-R32-Lizette_Cabrera-Amanda_Anisimova,2,B-IO,7,3,1,1,1,5,2
20170419-W-ITF_Dothan-R32-Lizette_Cabrera-Amanda_Anisimova,2,S-XC,1,1,1,0,0,1,0
20170419-W-ITF_Dothan-R32-Lizette_Cabrera-Amanda_Anisimova,2,S-DTM,2,0,0,0,0,1,1
20170423-W-Fed_Cup_World_Group_PO-RR-Lesia_Tsurenko-Julia_Goerges,1,F-XC,23,9,3,2,4,7,16
20170423-W-Fed_Cup_World_Group_PO-RR-Lesia_Tsurenko-Julia_Goerges,1,F-DTM,17,3,0,1,2,4,13
20170423-W-Fed_Cup_World_Group_PO-RR-Lesia_Tsurenko-Julia_Goerges,1,F-DTL,16,4,1,1,2,9,7
20170423-W-Fed_Cup_World_Group_PO-RR-Lesia_Tsurenko-Julia_Goerges,1,F-IO,17,4,1,0,3,8,9
20170423-W-Fed_Cup_World_Group_PO-RR-Lesia_Tsurenko-Julia_Goerges,1,B-XC,38,8,2,2,4,20,18
20170423-W-Fed_Cup_World_Group_PO-RR-Lesia_Tsurenko-Julia_Goerges,1,B-DTM,9,0,0,0,0,5,4
20170423-W-Fed_Cup_World_Group_PO-RR-Lesia_Tsurenko-Julia_Goerges,1,B-DTL,12,5,2,0,3,6,6
20170423-W-Fed_Cup_World_Group_PO-RR-Lesia_Tsurenko-Julia_Goerges,1,S-XC,3,0,0,0,0,2,1
20170423-W-Fed_Cup_World_Group_PO-RR-Lesia_Tsurenko-Julia_Goerges,1,S-DTM,4,0,0,0,0,2,2
20170423-W-Fed_Cup_World_Group_PO-RR-Lesia_Tsurenko-Julia_Goerges,1,S-DTL,1,0,0,0,0,1,0
20170423-W-Fed_Cup_World_Group_PO-RR-Lesia_Tsurenko-Julia_Goerges,2,F-XC,34,8,2,2,4,20,14
20170423-W-Fed_Cup_World_Group_PO-RR-Lesia_Tsurenko-Julia_Goerges,2,F-DTM,9,0,0,0,0,5,4
20170423-W-Fed_Cup_World_Group_PO-RR-Lesia_Tsurenko-Julia_Goerges,2,F-DTL,10,5,3,2,0,8,2
20170423-W-Fed_Cup_World_Group_PO-RR-Lesia_Tsurenko-Julia_Goerges,2,F-IO,17,5,3,1,1,10,7
20170423-W-Fed_Cup_World_Group_PO-RR-Lesia_Tsurenko-Julia_Goerges,2,F-II,6,3,1,0,2,3,3
20170423-W-Fed_Cup_World_Group_PO-RR-Lesia_Tsurenko-Julia_Goerges,2,B-XC,26,3,0,0,3,13,13
20170423-W-Fed_Cup_World_Group_PO-RR-Lesia_Tsurenko-Julia_Goerges,2,B-DTM,13,2,0,0,2,5,8
20170423-W-Fed_Cup_World_Group_PO-RR-Lesia_Tsurenko-Julia_Goerges,2,B-DTL,13,9,3,1,5,5,8
20170423-W-Fed_Cup_World_Group_PO-RR-Lesia_Tsurenko-Julia_Goerges,2,B-IO,2,2,2,0,0,2,0
20170423-W-Fed_Cup_World_Group_PO-RR-Lesia_Tsurenko-Julia_Goerges,2,S-XC,3,0,0,0,0,0,3
20170423-W-Fed_Cup_World_Group_PO-RR-Lesia_Tsurenko-Julia_Goerges,2,S-DTM,3,0,0,0,0,1,2
20170605-W-Roland_Garros-R16-Elina_Svitolina-Petra_Martic,1,F-XC,78,20,6,3,11,41,37
20170605-W-Roland_Garros-R16-Elina_Svitolina-Petra_Martic,1,F-DTM,64,4,0,0,4,32,32
20170605-W-Roland_Garros-R16-Elina_Svitolina-Petra_Martic,1,F-DTL,7,1,0,0,1,3,4
20170605-W-Roland_Garros-R16-Elina_Svitolina-Petra_Martic,1,F-IO,51,16,10,2,4,39,12
20170605-W-Roland_Garros-R16-Elina_Svitolina-Petra_Martic,1,F-II,1,0,0,0,0,1,0
20170605-W-Roland_Garros-R16-Elina_Svitolina-Petra_Martic,1,B-XC,66,8,1,1,6,26,40
20170605-W-Roland_Garros-R16-Elina_Svitolina-Petra_Martic,1,B-DTM,49,7,0,2,5,29,20
20170605-W-Roland_Garros-R16-Elina_Svitolina-Petra_Martic,1,B-DTL,7,4,1,0,3,2,5
20170605-W-Roland_Garros-R16-Elina_Svitolina-Petra_Martic,1,B-IO,9,4,2,1,1,8,1
20170605-W-Roland_Garros-R16-Elina_Svitolina-Petra_Martic,1,S-XC,5,0,0,0,0,3,2
20170605-W-Roland_Garros-R16-Elina_Svitolina-Petra_Martic,1,S-DTM,1,0,0,0,0,0,1
20170605-W-Roland_Garros-R16-Elina_Svitolina-Petra_Martic,1,S-DTL,2,0,0,0,0,0,2
20170605-W-Roland_Garros-R16-Elina_Svitolina-Petra_Martic,2,F-XC,56,9,4,1,4,28,28
20170605-W-Roland_Garros-R16-Elina_Svitolina-Petra_Martic,2,F-DTM,59,4,1,0,3,26,33
20170605-W-Roland_Garros-R16-Elina_Svitolina-Petra_Martic,2,F-DTL,20,6,1,0,5,8,12
20170605-W-Roland_Garros-R16-Elina_Svitolina-Petra_Martic,2,F-IO,32,9,2,3,4,16,16
20170605-W-Roland_Garros-R16-Elina_Svitolina-Petra_Martic,2,F-II,7,5,3,0,2,4,3
20170605-W-Roland_Garros-R16-Elina_Svitolina-Petra_Martic,2,B-XC,44,3,1,0,2,23,21
20170605-W-Roland_Garros-R16-Elina_Svitolina-Petra_Martic,2,B-DTM,40,2,0,0,2,14,26
20170605-W-Roland_Garros-R16-Elina_Svitolina-Petra_Martic,2,B-DTL,12,3,3,0,0,8,4
20170605-W-Roland_Garros-R16-Elina_Svitolina-Petra_Martic,2,B-IO,6,3,0,0,3,3,3
20170605-W-Roland_Garros-R16-Elina_Svitolina-Petra_Martic,2,S-XC,10,0,0,0,0,3,7
20170605-W-Roland_Garros-R16-Elina_Svitolina-Petra_Martic,2,S-DTM,14,2,0,0,2,3,11
20170605-W-Roland_Garros-R16-Elina_Svitolina-Petra_Martic,2,S-DTL,5,0,0,0,0,3,2
20170605-W-Roland_Garros-R16-Elina_Svitolina-Petra_Martic,2,S-IO,4,0,0,0,0,3,1
20160821-W-Cincinnati-F-Angelique_Kerber-Karolina_Pliskova,1,F-XC,32,4,1,1,2,15,17
20160821-W-Cincinnati-F-Angelique_Kerber-Karolina_Pliskova,1,F-DTM,18,2,0,0,2,7,11
20160821-W-Cincinnati-F-Angelique_Kerber-Karolina_Pliskova,1,F-DTL,12,8,4,0,4,8,4
20160821-W-Cincinnati-F-Angelique_Kerber-Karolina_Pliskova,1,F-IO,13,7,2,0,5,4,9
20160821-W-Cincinnati-F-Angelique_Kerber-Karolina_Pliskova,1,B-XC,22,5,1,0,4,7,15
20160821-W-Cincinnati-F-Angelique_Kerber-Karolina_Pliskova,1,B-DTM,34,3,0,0,3,4,30
20160821-W-Cincinnati-F-Angelique_Kerber-Karolina_Pliskova,1,B-DTL,4,2,1,0,1,3,1
20160821-W-Cincinnati-F-Angelique_Kerber-Karolina_Pliskova,1,B-IO,2,0,0,0,0,1,1
20160821-W-Cincinnati-F-Angelique_Kerber-Karolina_Pliskova,1,S-XC,2,0,0,0,0,0,2
20160821-W-Cincinnati-F-Angelique_Kerber-Karolina_Pliskova,1,S-DTM,2,0,0,0,0,0,2
20160821-W-Cincinnati-F-Angelique_Kerber-Karolina_Pliskova,1,S-IO,1,0,0,0,0,0,1
20160821-W-Cincinnati-F-Angelique_Kerber-Karolina_Pliskova,2,F-XC,25,6,4,1,1,19,6
20160821-W-Cincinnati-F-Angelique_Kerber-Karolina_Pliskova,2,F-DTM,14,1,0,0,1,11,3
20160821-W-Cincinnati-F-Angelique_Kerber-Karolina_Pliskova,2,F-DTL,8,5,3,0,2,5,3
20160821-W-Cincinnati-F-Angelique_Kerber-Karolina_Pliskova,2,F-IO,10,6,5,1,0,7,3
20160821-W-Cincinnati-F-Angelique_Kerber-Karolina_Pliskova,2,B-XC,18,0,0,0,0,10,8
20160821-W-Cincinnati-F-Angelique_Kerber-Karolina_Pliskova,2,B-DTM,27,2,0,0,2,18,9
20160821-W-Cincinnati-F-Angelique_Kerber-Karolina_Pliskova,2,B-DTL,10,3,2,0,1,6,4
20160821-W-Cincinnati-F-Angelique_Kerber-Karolina_Pliskova,2,B-IO,5,1,0,1,0,5,0
20160821-W-Cincinnati-F-Angelique_Kerber-Karolina_Pliskova,2,S-XC,3,0,0,0,0,0,3
20160821-W-Cincinnati-F-Angelique_Kerber-Karolina_Pliskova,2,S-DTM,2,0,0,0,0,1,1
20170422-W-Fed_Cup_World_Group_PO-RR-Julia_Goerges-Elina_Svitolina,1,F-XC,51,8,2,4,2,31,20
20170422-W-Fed_Cup_World_Group_PO-RR-Julia_Goerges-Elina_Svitolina,1,F-DTM,14,1,0,0,1,4,10
20170422-W-Fed_Cup_World_Group_PO-RR-Julia_Goerges-Elina_Svitolina,1,F-DTL,17,11,8,0,3,12,5
20170422-W-Fed_Cup_World_Group_PO-RR-Julia_Goerges-Elina_Svitolina,1,F-IO,29,12,6,2,4,17,12
20170422-W-Fed_Cup_World_Group_PO-RR-Julia_Goerges-Elina_Svitolina,1,F-II,5,3,0,2,1,3,2
20170422-W-Fed_Cup_World_Group_PO-RR-Julia_Goerges-Elina_Svitolina,1,B-XC,30,5,1,1,3,15,15
20170422-W-Fed_Cup_World_Group_PO-RR-Julia_Goerges-Elina_Svitolina,1,B-DTM,12,3,0,1,2,3,9
20170422-W-Fed_Cup_World_Group_PO-RR-Julia_Goerges-Elina_Svitolina,1,B-DTL,12,6,2,0,4,6,6
20170422-W-Fed_Cup_World_Group_PO-RR-Julia_Goerges-Elina_Svitolina,1,B-IO,3,1,0,0,1,0,3
20170422-W-Fed_Cup_World_Group_PO-RR-Julia_Goerges-Elina_Svitolina,1,S-XC,6,1,0,1,0,2,4
20170422-W-Fed_Cup_World_Group_PO-RR-Julia_Goerges-Elina_Svitolina,1,S-DTM,1,0,0,0,0,0,1
20170422-W-Fed_Cup_World_Group_PO-RR-Julia_Goerges-Elina_Svitolina,2,F-XC,41,11,2,4,5,18,23
20170422-W-Fed_Cup_World_Group_PO-RR-Julia_Goerges-Elina_Svitolina,2,F-DTM,22,0,0,0,0,13,9
20170422-W-Fed_Cup_World_Group_PO-RR-Julia_Goerges-Elina_Svitolina,2,F-DTL,8,4,2,0,2,4,4
20170422-W-Fed_Cup_World_Group_PO-RR-Julia_Goerges-Elina_Svitolina,2,F-IO,19,6,2,2,2,15,4
20170422-W-Fed_Cup_World_Group_PO-RR-Julia_Goerges-Elina_Svitolina,2,F-II,1,1,1,0,0,1,0
20170422-W-Fed_Cup_World_Group_PO-RR-Julia_Goerges-Elina_Svitolina,2,B-XC,40,7,0,4,3,23,17
20170422-W-Fed_Cup_World_Group_PO-RR-Julia_Goerges-Elina_Svitolina,2,B-DTM,18,4,0,4,0,10,8
20170422-W-Fed_Cup_World_Group_PO-RR-Julia_Goerges-Elina_Svitolina,2,B-DTL,9,6,1,2,3,4,5
20170422-W-Fed_Cup_World_Group_PO-RR-Julia_Goerges-Elina_Svitolina,2,B-IO,3,1,0,0,1,0,3
20170422-W-Fed_Cup_World_Group_PO-RR-Julia_Goerges-Elina_Svitolina,2,S-XC,3,0,0,0,0,1,2
20170422-W-Fed_Cup_World_Group_PO-RR-Julia_Goerges-Elina_Svitolina,2,S-DTM,2,0,0,0,0,1,1
20130110-W-Hobart-R16-Shuai_Peng-Monica_Niculescu,1,F-XC,127,26,8,6,12,56,71
20130110-W-Hobart-R16-Shuai_Peng-Monica_Niculescu,1,F-DTM,33,5,0,3,2,16,17
20130110-W-Hobart-R16-Shuai_Peng-Monica_Niculescu,1,F-DTL,38,11,3,3,5,21,17
20130110-W-Hobart-R16-Shuai_Peng-Monica_Niculescu,1,F-IO,44,10,4,3,3,22,22
20130110-W-Hobart-R16-Shuai_Peng-Monica_Niculescu,1,B-XC,61,18,5,5,8,28,33
20130110-W-Hobart-R16-Shuai_Peng-Monica_Niculescu,1,B-DTM,33,0,0,0,0,14,19
20130110-W-Hobart-R16-Shuai_Peng-Monica_Niculescu,1,B-DTL,31,13,5,4,4,15,16
20130110-W-Hobart-R16-Shuai_Peng-Monica_Niculescu,1,B-IO,35,7,1,4,2,22,13
20130110-W-Hobart-R16-Shuai_Peng-Monica_Niculescu,1,B-II,1,1,0,1,0,1,0
20130110-W-Hobart-R16-Shuai_Peng-Monica_Niculescu,1,S-XC,3,2,1,1,0,2,1
20130110-W-Hobart-R16-Shuai_Peng-Monica_Niculescu,1,S-DTL,2,0,0,0,0,1,1
20130110-W-Hobart-R16-Shuai_Peng-Monica_Niculescu,1,S-IO,2,0,0,0,0,1,1
20130110-W-Hobart-R16-Shuai_Peng-Monica_Niculescu,2,F-XC,13,2,0,2,0,7,6
20130110-W-Hobart-R16-Shuai_Peng-Monica_Niculescu,2,F-DTM,18,0,0,0,0,6,12
20130110-W-Hobart-R16-Shuai_Peng-Monica_Niculescu,2,F-DTL,12,3,2,1,0,10,2
20130110-W-Hobart-R16-Shuai_Peng-Monica_Niculescu,2,F-IO,3,0,0,0,0,1,2
20130110-W-Hobart-R16-Shuai_Peng-Monica_Niculescu,2,B-XC,39,10,0,7,3,25,14
20130110-W-Hobart-R16-Shuai_Peng-Monica_Niculescu,2,B-DTM,78,3,0,2,1,40,38
20130110-W-Hobart-R16-Shuai_Peng-Monica_Niculescu,2,B-DTL,12,2,2,0,0,7,5
20130110-W-Hobart-R16-Shuai_Peng-Monica_Niculescu,2,B-IO,15,2,2,0,0,7,8
20130110-W-Hobart-R16-Shuai_Peng-Monica_Niculescu,2,B-II,2,1,1,0,0,2,0
20130110-W-Hobart-R16-Shuai_Peng-Monica_Niculescu,2,S-XC,7,1,0,1,0,3,4
20130110-W-Hobart-R16-Shuai_Peng-Monica_Niculescu,2,S-DTM,12,0,0,0,0,6,6
20130110-W-Hobart-R16-Shuai_Peng-Monica_Niculescu,2,S-DTL,2,1,1,0,0,1,1
20130110-W-Hobart-R16-Shuai_Peng-Monica_Niculescu,2,S-IO,1,0,0,0,0,1,0
20160416-W-Fed_Cup_World_Group_SF-RR-Kristina_Mladenovic-Richel_Hogenkamp,1,F-XC,23,6,3,0,3,17,6
20160416-W-Fed_Cup_World_Group_SF-RR-Kristina_Mladenovic-Richel_Hogenkamp,1,F-DTM,6,0,0,0,0,4,2
20160416-W-Fed_Cup_World_Group_SF-RR-Kristina_Mladenovic-Richel_Hogenkamp,1,F-DTL,10,6,1,2,3,7,3
20160416-W-Fed_Cup_World_Group_SF-RR-Kristina_Mladenovic-Richel_Hogenkamp,1,F-IO,21,8,5,0,3,16,5
20160416-W-Fed_Cup_World_Group_SF-RR-Kristina_Mladenovic-Richel_Hogenkamp,1,F-II,7,3,1,0,2,4,3
20160416-W-Fed_Cup_World_Group_SF-RR-Kristina_Mladenovic-Richel_Hogenkamp,1,B-XC,18,3,0,2,1,14,4
20160416-W-Fed_Cup_World_Group_SF-RR-Kristina_Mladenovic-Richel_Hogenkamp,1,B-DTM,8,2,1,0,1,7,1
20160416-W-Fed_Cup_World_Group_SF-RR-Kristina_Mladenovic-Richel_Hogenkamp,1,B-DTL,2,1,0,0,1,1,1
20160416-W-Fed_Cup_World_Group_SF-RR-Kristina_Mladenovic-Richel_Hogenkamp,1,S-XC,3,0,0,0,0,3,0
20160416-W-Fed_Cup_World_Group_SF-RR-Kristina_Mladenovic-Richel_Hogenkamp,1,S-DTM,3,0,0,0,0,2,1
20160416-W-Fed_Cup_World_Group_SF-RR-Kristina_Mladenovic-Richel_Hogenkamp,1,S-DTL,1,1,0,0,1,0,1
20160416-W-Fed_Cup_World_Group_SF-RR-Kristina_Mladenovic-Richel_Hogenkamp,1,S-IO,1,0,0,0,0,1,0
20160416-W-Fed_Cup_World_Group_SF-RR-Kristina_Mladenovic-Richel_Hogenkamp,2,F-XC,30,8,1,1,6,7,23
20160416-W-Fed_Cup_World_Group_SF-RR-Kristina_Mladenovic-Richel_Hogenkamp,2,F-DTM,9,2,0,0,2,2,7
20160416-W-Fed_Cup_World_Group_SF-RR-Kristina_Mladenovic-Richel_Hogenkamp,2,F-DTL,6,2,0,0,2,1,5
20160416-W-Fed_Cup_World_Group_SF-RR-Kristina_Mladenovic-Richel_Hogenkamp,2,F-IO,11,1,1,0,0,3,8
20160416-W-Fed_Cup_World_Group_SF-RR-Kristina_Mladenovic-Richel_Hogenkamp,2,F-II,1,1,1,0,0,1,0
20160416-W-Fed_Cup_World_Group_SF-RR-Kristina_Mladenovic-Richel_Hogenkamp,2,B-XC,20,2,0,0,2,5,15
20160416-W-Fed_Cup_World_Group_SF-RR-Kristina_Mladenovic-Richel_Hogenkamp,2,B-DTM,8,0,0,0,0,1,7
20160416-W-Fed_Cup_World_Group_SF-RR-Kristina_Mladenovic-Richel_Hogenkamp,2,B-DTL,4,2,0,0,2,0,4
20160416-W-Fed_Cup_World_Group_SF-RR-Kristina_Mladenovic-Richel_Hogenkamp,2,B-IO,2,1,0,0,1,0,2
20160416-W-Fed_Cup_World_Group_SF-RR-Kristina_Mladenovic-Richel_Hogenkamp,2,S-XC,12,2,0,1,1,2,10
20160416-W-Fed_Cup_World_Group_SF-RR-Kristina_Mladenovic-Richel_Hogenkamp,2,S-DTM,5,0,0,0,0,1,4
20160416-W-Fed_Cup_World_Group_SF-RR-Kristina_Mladenovic-Richel_Hogenkamp,2,S-DTL,3,0,0,0,0,1,2
20160416-W-Fed_Cup_World_Group_SF-RR-Barbora_Strycova-Timea_Bacsinszky,1,F-XC,33,3,1,1,1,19,14
20160416-W-Fed_Cup_World_Group_SF-RR-Barbora_Strycova-Timea_Bacsinszky,1,F-DTM,2,0,0,0,0,0,2
20160416-W-Fed_Cup_World_Group_SF-RR-Barbora_Strycova-Timea_Bacsinszky,1,F-DTL,5,2,1,1,0,3,2
20160416-W-Fed_Cup_World_Group_SF-RR-Barbora_Strycova-Timea_Bacsinszky,1,F-IO,5,1,1,0,0,2,3
20160416-W-Fed_Cup_World_Group_SF-RR-Barbora_Strycova-Timea_Bacsinszky,1,F-II,3,1,1,0,0,3,0
20160416-W-Fed_Cup_World_Group_SF-RR-Barbora_Strycova-Timea_Bacsinszky,1,B-XC,40,2,0,0,2,25,15
20160416-W-Fed_Cup_World_Group_SF-RR-Barbora_Strycova-Timea_Bacsinszky,1,B-DTM,22,5,0,1,4,6,16
20160416-W-Fed_Cup_World_Group_SF-RR-Barbora_Strycova-Timea_Bacsinszky,1,B-DTL,10,1,0,0,1,5,5
20160416-W-Fed_Cup_World_Group_SF-RR-Barbora_Strycova-Timea_Bacsinszky,1,B-IO,1,0,0,0,0,1,0
20160416-W-Fed_Cup_World_Group_SF-RR-Barbora_Strycova-Timea_Bacsinszky,1,S-XC,6,0,0,0,0,4,2
20160416-W-Fed_Cup_World_Group_SF-RR-Barbora_Strycova-Timea_Bacsinszky,1,S-DTM,7,0,0,0,0,4,3
20160416-W-Fed_Cup_World_Group_SF-RR-Barbora_Strycova-Timea_Bacsinszky,1,S-DTL,2,2,0,0,2,0,2
20160416-W-Fed_Cup_World_Group_SF-RR-Barbora_Strycova-Timea_Bacsinszky,2,F-XC,16,2,0,0,2,5,11
20160416-W-Fed_Cup_World_Group_SF-RR-Barbora_Strycova-Timea_Bacsinszky,2,F-DTM,14,2,0,0,2,6,8
20160416-W-Fed_Cup_World_Group_SF-RR-Barbora_Strycova-Timea_Bacsinszky,2,F-DTL,19,4,0,0,4,8,11
20160416-W-Fed_Cup_World_Group_SF-RR-Barbora_Strycova-Timea_Bacsinszky,2,F-IO,6,1,1,0,0,5,1
20160416-W-Fed_Cup_World_Group_SF-RR-Barbora_Strycova-Timea_Bacsinszky,2,B-XC,48,8,2,1,5,24,24
20160416-W-Fed_Cup_World_Group_SF-RR-Barbora_Strycova-Timea_Bacsinszky,2,B-DTM,9,0,0,0,0,4,5
20160416-W-Fed_Cup_World_Group_SF-RR-Barbora_Strycova-Timea_Bacsinszky,2,B-DTL,5,1,0,0,1,2,3
20160416-W-Fed_Cup_World_Group_SF-RR-Barbora_Strycova-Timea_Bacsinszky,2,B-IO,9,4,0,1,3,4,5
20160416-W-Fed_Cup_World_Group_SF-RR-Barbora_Strycova-Timea_Bacsinszky,2,B-II,4,0,0,0,0,1,3
20160416-W-Fed_Cup_World_Group_SF-RR-Barbora_Strycova-Timea_Bacsinszky,2,S-XC,3,0,0,0,0,0,3
20160416-W-Fed_Cup_World_Group_SF-RR-Barbora_Strycova-Timea_Bacsinszky,2,S-DTM,1,0,0,0,0,0,1
20160416-W-Fed_Cup_World_Group_SF-RR-Barbora_Strycova-Timea_Bacsinszky,2,S-DTL,3,0,0,0,0,0,3
20161112-W-Fed_Cup_World_Group_F-RR-Kristina_Mladenovic-Karolina_Pliskova,1,F-XC,50,12,5,1,6,33,17
20161112-W-Fed_Cup_World_Group_F-RR-Kristina_Mladenovic-Karolina_Pliskova,1,F-DTM,15,4,0,1,3,5,10
20161112-W-Fed_Cup_World_Group_F-RR-Kristina_Mladenovic-Karolina_Pliskova,1,F-DTL,13,3,1,1,1,7,6
20161112-W-Fed_Cup_World_Group_F-RR-Kristina_Mladenovic-Karolina_Pliskova,1,F-IO,36,15,5,3,7,17,19
20161112-W-Fed_Cup_World_Group_F-RR-Kristina_Mladenovic-Karolina_Pliskova,1,F-II,11,6,4,2,0,8,3
20161112-W-Fed_Cup_World_Group_F-RR-Kristina_Mladenovic-Karolina_Pliskova,1,B-XC,30,6,3,1,2,13,17
20161112-W-Fed_Cup_World_Group_F-RR-Kristina_Mladenovic-Karolina_Pliskova,1,B-DTM,28,6,1,0,5,11,17
20161112-W-Fed_Cup_World_Group_F-RR-Kristina_Mladenovic-Karolina_Pliskova,1,B-DTL,17,8,4,0,4,8,9
20161112-W-Fed_Cup_World_Group_F-RR-Kristina_Mladenovic-Karolina_Pliskova,1,B-IO,7,3,0,1,2,3,4
20161112-W-Fed_Cup_World_Group_F-RR-Kristina_Mladenovic-Karolina_Pliskova,1,S-XC,23,2,0,0,2,6,17
20161112-W-Fed_Cup_World_Group_F-RR-Kristina_Mladenovic-Karolina_Pliskova,1,S-DTM,13,1,0,0,1,5,8
20161112-W-Fed_Cup_World_Group_F-RR-Kristina_Mladenovic-Karolina_Pliskova,1,S-DTL,6,1,0,0,1,2,4
20161112-W-Fed_Cup_World_Group_F-RR-Kristina_Mladenovic-Karolina_Pliskova,2,F-XC,58,16,5,6,5,30,28
20161112-W-Fed_Cup_World_Group_F-RR-Kristina_Mladenovic-Karolina_Pliskova,2,F-DTM,21,3,0,1,2,10,11
20161112-W-Fed_Cup_World_Group_F-RR-Kristina_Mladenovic-Karolina_Pliskova,2,F-DTL,12,7,4,0,3,6,6
20161112-W-Fed_Cup_World_Group_F-RR-Kristina_Mladenovic-Karolina_Pliskova,2,F-IO,26,8,4,2,2,19,7
20161112-W-Fed_Cup_World_Group_F-RR-Kristina_Mladenovic-Karolina_Pliskova,2,B-XC,63,8,1,3,4,35,28
20161112-W-Fed_Cup_World_Group_F-RR-Kristina_Mladenovic-Karolina_Pliskova,2,B-DTM,21,3,0,0,3,10,11
20161112-W-Fed_Cup_World_Group_F-RR-Kristina_Mladenovic-Karolina_Pliskova,2,B-DTL,10,7,4,1,2,6,4
20161112-W-Fed_Cup_World_Group_F-RR-Kristina_Mladenovic-Karolina_Pliskova,2,B-IO,6,3,0,1,2,2,4
20161112-W-Fed_Cup_World_Group_F-RR-Kristina_Mladenovic-Karolina_Pliskova,2,S-XC,11,1,0,1,0,7,4
20161112-W-Fed_Cup_World_Group_F-RR-Kristina_Mladenovic-Karolina_Pliskova,2,S-DTM,7,0,0,0,0,2,5
20161112-W-Fed_Cup_World_Group_F-RR-Kristina_Mladenovic-Karolina_Pliskova,2,S-DTL,1,0,0,0,0,0,1
20170617-W-s_Hertogenbosch-SF-Anett_Kontaveit-Lesia_Tsurenko,1,F-XC,57,13,4,7,2,34,23
20170617-W-s_Hertogenbosch-SF-Anett_Kontaveit-Lesia_Tsurenko,1,F-DTM,32,3,0,0,3,15,17
20170617-W-s_Hertogenbosch-SF-Anett_Kontaveit-Lesia_Tsurenko,1,F-DTL,12,11,6,0,5,6,6
20170617-W-s_Hertogenbosch-SF-Anett_Kontaveit-Lesia_Tsurenko,1,F-IO,18,11,4,4,3,9,9
20170617-W-s_Hertogenbosch-SF-Anett_Kontaveit-Lesia_Tsurenko,1,B-XC,38,10,2,0,8,13,25
20170617-W-s_Hertogenbosch-SF-Anett_Kontaveit-Lesia_Tsurenko,1,B-DTM,41,3,1,0,2,17,24
20170617-W-s_Hertogenbosch-SF-Anett_Kontaveit-Lesia_Tsurenko,1,B-DTL,21,5,2,0,3,10,11
20170617-W-s_Hertogenbosch-SF-Anett_Kontaveit-Lesia_Tsurenko,1,B-IO,16,3,0,0,3,7,9
20170617-W-s_Hertogenbosch-SF-Anett_Kontaveit-Lesia_Tsurenko,1,S-XC,1,0,0,0,0,0,1
20170617-W-s_Hertogenbosch-SF-Anett_Kontaveit-Lesia_Tsurenko,1,S-DTM,5,0,0,0,0,1,4
20170617-W-s_Hertogenbosch-SF-Anett_Kontaveit-Lesia_Tsurenko,1,S-DTL,5,0,0,0,0,2,3
20170617-W-s_Hertogenbosch-SF-Anett_Kontaveit-Lesia_Tsurenko,2,F-XC,49,21,9,4,8,24,25
20170617-W-s_Hertogenbosch-SF-Anett_Kontaveit-Lesia_Tsurenko,2,F-DTM,37,3,0,0,3,14,23
20170617-W-s_Hertogenbosch-SF-Anett_Kontaveit-Lesia_Tsurenko,2,F-DTL,28,7,1,2,4,18,10
20170617-W-s_Hertogenbosch-SF-Anett_Kontaveit-Lesia_Tsurenko,2,F-IO,28,5,1,2,2,16,12
20170617-W-s_Hertogenbosch-SF-Anett_Kontaveit-Lesia_Tsurenko,2,B-XC,22,5,3,1,1,14,8
20170617-W-s_Hertogenbosch-SF-Anett_Kontaveit-Lesia_Tsurenko,2,B-DTM,30,3,0,0,3,16,14
20170617-W-s_Hertogenbosch-SF-Anett_Kontaveit-Lesia_Tsurenko,2,B-DTL,11,5,0,3,2,7,4
20170617-W-s_Hertogenbosch-SF-Anett_Kontaveit-Lesia_Tsurenko,2,B-IO,16,7,3,2,2,12,4
20170617-W-s_Hertogenbosch-SF-Anett_Kontaveit-Lesia_Tsurenko,2,S-XC,2,0,0,0,0,2,0
20170617-W-s_Hertogenbosch-SF-Anett_Kontaveit-Lesia_Tsurenko,2,S-DTM,12,1,0,0,1,5,7
20170617-W-s_Hertogenbosch-SF-Anett_Kontaveit-Lesia_Tsurenko,2,S-DTL,1,1,1,0,0,1,0
20170519-W-ITF_Trnava-QF-Anastasia_Potapova-Kateryna_Kozlova,1,F-XC,41,9,7,0,2,33,8
20170519-W-ITF_Trnava-QF-Anastasia_Potapova-Kateryna_Kozlova,1,F-DTM,25,2,0,0,2,12,13
20170519-W-ITF_Trnava-QF-Anastasia_Potapova-Kateryna_Kozlova,1,F-DTL,9,3,2,1,0,7,2
20170519-W-ITF_Trnava-QF-Anastasia_Potapova-Kateryna_Kozlova,1,F-IO,13,4,1,2,1,11,2
20170519-W-ITF_Trnava-QF-Anastasia_Potapova-Kateryna_Kozlova,1,B-XC,40,8,1,3,4,29,11
20170519-W-ITF_Trnava-QF-Anastasia_Potapova-Kateryna_Kozlova,1,B-DTM,34,5,0,1,4,18,16
20170519-W-ITF_Trnava-QF-Anastasia_Potapova-Kateryna_Kozlova,1,B-DTL,9,4,2,1,1,6,3
20170519-W-ITF_Trnava-QF-Anastasia_Potapova-Kateryna_Kozlova,1,B-IO,8,6,5,0,1,6,2
20170519-W-ITF_Trnava-QF-Anastasia_Potapova-Kateryna_Kozlova,1,S-DTM,4,0,0,0,0,3,1
20170519-W-ITF_Trnava-QF-Anastasia_Potapova-Kateryna_Kozlova,2,F-XC,26,4,2,0,2,12,14
20170519-W-ITF_Trnava-QF-Anastasia_Potapova-Kateryna_Kozlova,2,F-DTM,23,1,0,0,1,4,19
20170519-W-ITF_Trnava-QF-Anastasia_Potapova-Kateryna_Kozlova,2,F-DTL,13,5,1,0,4,5,8
20170519-W-ITF_Trnava-QF-Anastasia_Potapova-Kateryna_Kozlova,2,F-IO,13,2,1,0,1,7,6
20170519-W-ITF_Trnava-QF-Anastasia_Potapova-Kateryna_Kozlova,2,B-XC,19,3,0,0,3,6,13
20170519-W-ITF_Trnava-QF-Anastasia_Potapova-Kateryna_Kozlova,2,B-DTM,31,5,0,1,4,8,23
20170519-W-ITF_Trnava-QF-Anastasia_Potapova-Kateryna_Kozlova,2,B-DTL,12,4,0,0,4,0,12
20170519-W-ITF_Trnava-QF-Anastasia_Potapova-Kateryna_Kozlova,2,B-IO,8,1,0,0,1,3,5
20170519-W-ITF_Trnava-QF-Anastasia_Potapova-Kateryna_Kozlova,2,S-XC,2,1,0,1,0,1,1
20170519-W-ITF_Trnava-QF-Anastasia_Potapova-Kateryna_Kozlova,2,S-DTM,6,0,0,0,0,1,5
20170519-W-ITF_Trnava-QF-Anastasia_Potapova-Kateryna_Kozlova,2,S-DTL,1,0,0,0,0,1,0
20170519-W-ITF_Trnava-QF-Anastasia_Potapova-Kateryna_Kozlova,2,S-IO,3,0,0,0,0,1,2
20161112-W-Fed_Cup_World_Group_F-RR-Petra_Kvitova-Caroline_Garcia,1,F-XC,19,4,0,0,4,9,10
20161112-W-Fed_Cup_World_Group_F-RR-Petra_Kvitova-Caroline_Garcia,1,F-DTM,8,2,0,1,1,5,3
20161112-W-Fed_Cup_World_Group_F-RR-Petra_Kvitova-Caroline_Garcia,1,F-DTL,3,3,2,0,1,2,1
20161112-W-Fed_Cup_World_Group_F-RR-Petra_Kvitova-Caroline_Garcia,1,F-IO,16,10,4,2,4,11,5
20161112-W-Fed_Cup_World_Group_F-RR-Petra_Kvitova-Caroline_Garcia,1,F-II,1,0,0,0,0,1,0
20161112-W-Fed_Cup_World_Group_F-RR-Petra_Kvitova-Caroline_Garcia,1,B-XC,16,3,0,2,1,10,6
20161112-W-Fed_Cup_World_Group_F-RR-Petra_Kvitova-Caroline_Garcia,1,B-DTM,7,0,0,0,0,2,5
20161112-W-Fed_Cup_World_Group_F-RR-Petra_Kvitova-Caroline_Garcia,1,B-DTL,4,3,2,0,1,2,2
20161112-W-Fed_Cup_World_Group_F-RR-Petra_Kvitova-Caroline_Garcia,1,B-IO,6,3,1,1,1,4,2
20161112-W-Fed_Cup_World_Group_F-RR-Petra_Kvitova-Caroline_Garcia,1,S-XC,3,0,0,0,0,0,3
20161112-W-Fed_Cup_World_Group_F-RR-Petra_Kvitova-Caroline_Garcia,1,S-DTM,1,0,0,0,0,0,1
20161112-W-Fed_Cup_World_Group_F-RR-Petra_Kvitova-Caroline_Garcia,1,S-IO,1,0,0,0,0,1,0
20161112-W-Fed_Cup_World_Group_F-RR-Petra_Kvitova-Caroline_Garcia,2,F-XC,25,8,4,3,1,15,10
20161112-W-Fed_Cup_World_Group_F-RR-Petra_Kvitova-Caroline_Garcia,2,F-DTM,18,3,0,1,2,5,13
20161112-W-Fed_Cup_World_Group_F-RR-Petra_Kvitova-Caroline_Garcia,2,F-DTL,6,2,1,0,1,3,3
20161112-W-Fed_Cup_World_Group_F-RR-Petra_Kvitova-Caroline_Garcia,2,F-IO,10,8,4,3,1,9,1
20161112-W-Fed_Cup_World_Group_F-RR-Petra_Kvitova-Caroline_Garcia,2,B-XC,19,6,3,3,0,10,9
20161112-W-Fed_Cup_World_Group_F-RR-Petra_Kvitova-Caroline_Garcia,2,B-DTM,9,1,0,0,1,3,6
20161112-W-Fed_Cup_World_Group_F-RR-Petra_Kvitova-Caroline_Garcia,2,B-DTL,2,2,0,1,1,1,1
20161112-W-Fed_Cup_World_Group_F-RR-Petra_Kvitova-Caroline_Garcia,2,B-IO,2,0,0,0,0,1,1
20161112-W-Fed_Cup_World_Group_F-RR-Petra_Kvitova-Caroline_Garcia,2,S-DTM,2,0,0,0,0,0,2
20161112-W-Fed_Cup_World_Group_F-RR-Petra_Kvitova-Caroline_Garcia,2,S-DTL,3,0,0,0,0,1,2
20170211-W-Fed_Cup_World_Group_R1-RR-Aryna_Sabalenka-Kiki_Bertens,1,F-XC,41,23,10,7,6,27,14
20170211-W-Fed_Cup_World_Group_R1-RR-Aryna_Sabalenka-Kiki_Bertens,1,F-DTM,13,3,0,0,3,6,7
20170211-W-Fed_Cup_World_Group_R1-RR-Aryna_Sabalenka-Kiki_Bertens,1,F-DTL,18,6,1,1,4,7,11
20170211-W-Fed_Cup_World_Group_R1-RR-Aryna_Sabalenka-Kiki_Bertens,1,F-IO,21,14,3,2,9,10,11
20170211-W-Fed_Cup_World_Group_R1-RR-Aryna_Sabalenka-Kiki_Bertens,1,B-XC,41,13,2,3,8,20,21
20170211-W-Fed_Cup_World_Group_R1-RR-Aryna_Sabalenka-Kiki_Bertens,1,B-DTM,11,0,0,0,0,7,4
20170211-W-Fed_Cup_World_Group_R1-RR-Aryna_Sabalenka-Kiki_Bertens,1,B-DTL,15,11,7,2,2,11,4
20170211-W-Fed_Cup_World_Group_R1-RR-Aryna_Sabalenka-Kiki_Bertens,1,B-IO,8,4,3,1,0,7,1
20170211-W-Fed_Cup_World_Group_R1-RR-Aryna_Sabalenka-Kiki_Bertens,1,S-XC,3,0,0,0,0,0,3
20170211-W-Fed_Cup_World_Group_R1-RR-Aryna_Sabalenka-Kiki_Bertens,1,S-DTM,1,0,0,0,0,0,1
20170211-W-Fed_Cup_World_Group_R1-RR-Aryna_Sabalenka-Kiki_Bertens,2,F-XC,27,10,5,2,3,15,12
20170211-W-Fed_Cup_World_Group_R1-RR-Aryna_Sabalenka-Kiki_Bertens,2,F-DTM,17,1,0,0,1,7,10
20170211-W-Fed_Cup_World_Group_R1-RR-Aryna_Sabalenka-Kiki_Bertens,2,F-DTL,9,4,1,1,2,7,2
20170211-W-Fed_Cup_World_Group_R1-RR-Aryna_Sabalenka-Kiki_Bertens,2,F-IO,8,2,1,0,1,4,4
20170211-W-Fed_Cup_World_Group_R1-RR-Aryna_Sabalenka-Kiki_Bertens,2,F-II,1,1,1,0,0,1,0
20170211-W-Fed_Cup_World_Group_R1-RR-Aryna_Sabalenka-Kiki_Bertens,2,B-XC,19,5,0,4,1,11,8
20170211-W-Fed_Cup_World_Group_R1-RR-Aryna_Sabalenka-Kiki_Bertens,2,B-DTM,25,3,0,0,3,7,18
20170211-W-Fed_Cup_World_Group_R1-RR-Aryna_Sabalenka-Kiki_Bertens,2,B-DTL,10,5,3,1,1,5,5
20170211-W-Fed_Cup_World_Group_R1-RR-Aryna_Sabalenka-Kiki_Bertens,2,S-XC,5,1,0,0,1,1,4
20170211-W-Fed_Cup_World_Group_R1-RR-Aryna_Sabalenka-Kiki_Bertens,2,S-DTM,12,2,1,0,1,4,8
20170211-W-Fed_Cup_World_Group_R1-RR-Aryna_Sabalenka-Kiki_Bertens,2,S-DTL,3,1,0,1,0,3,0
20170211-W-Fed_Cup_World_Group_R1-RR-Aryna_Sabalenka-Kiki_Bertens,2,S-IO,1,0,0,0,0,0,1
20170212-W-Fed_Cup_World_Group_R1-RR-Aryna_Sabalenka-Michaella_Krajicek,1,F-XC,32,17,9,4,4,22,10
20170212-W-Fed_Cup_World_Group_R1-RR-Aryna_Sabalenka-Michaella_Krajicek,1,F-DTM,8,1,0,0,1,3,5
20170212-W-Fed_Cup_World_Group_R1-RR-Aryna_Sabalenka-Michaella_Krajicek,1,F-DTL,10,6,3,1,2,6,4
20170212-W-Fed_Cup_World_Group_R1-RR-Aryna_Sabalenka-Michaella_Krajicek,1,F-IO,14,10,5,4,1,10,4
20170212-W-Fed_Cup_World_Group_R1-RR-Aryna_Sabalenka-Michaella_Krajicek,1,F-II,1,1,1,0,0,1,0
20170212-W-Fed_Cup_World_Group_R1-RR-Aryna_Sabalenka-Michaella_Krajicek,1,B-XC,18,6,4,1,1,13,5
20170212-W-Fed_Cup_World_Group_R1-RR-Aryna_Sabalenka-Michaella_Krajicek,1,B-DTM,8,2,0,1,1,6,2
20170212-W-Fed_Cup_World_Group_R1-RR-Aryna_Sabalenka-Michaella_Krajicek,1,B-DTL,8,4,1,0,3,5,3
20170212-W-Fed_Cup_World_Group_R1-RR-Aryna_Sabalenka-Michaella_Krajicek,1,B-IO,9,4,3,0,1,5,4
20170212-W-Fed_Cup_World_Group_R1-RR-Aryna_Sabalenka-Michaella_Krajicek,1,S-XC,1,0,0,0,0,1,0
20170212-W-Fed_Cup_World_Group_R1-RR-Aryna_Sabalenka-Michaella_Krajicek,1,S-DTM,1,0,0,0,0,0,1
20170212-W-Fed_Cup_World_Group_R1-RR-Aryna_Sabalenka-Michaella_Krajicek,2,F-XC,26,8,4,1,3,12,14
20170212-W-Fed_Cup_World_Group_R1-RR-Aryna_Sabalenka-Michaella_Krajicek,2,F-DTM,12,0,0,0,0,3,9
20170212-W-Fed_Cup_World_Group_R1-RR-Aryna_Sabalenka-Michaella_Krajicek,2,F-DTL,6,3,1,0,2,3,3
20170212-W-Fed_Cup_World_Group_R1-RR-Aryna_Sabalenka-Michaella_Krajicek,2,F-IO,2,1,1,0,0,1,1
20170212-W-Fed_Cup_World_Group_R1-RR-Aryna_Sabalenka-Michaella_Krajicek,2,F-II,2,2,0,1,1,1,1
20170212-W-Fed_Cup_World_Group_R1-RR-Aryna_Sabalenka-Michaella_Krajicek,2,B-XC,10,2,2,0,0,6,4
20170212-W-Fed_Cup_World_Group_R1-RR-Aryna_Sabalenka-Michaella_Krajicek,2,B-DTM,9,1,0,0,1,4,5
20170212-W-Fed_Cup_World_Group_R1-RR-Aryna_Sabalenka-Michaella_Krajicek,2,B-DTL,9,2,2,0,0,4,5
20170212-W-Fed_Cup_World_Group_R1-RR-Aryna_Sabalenka-Michaella_Krajicek,2,B-IO,1,1,0,1,0,1,0
20170212-W-Fed_Cup_World_Group_R1-RR-Aryna_Sabalenka-Michaella_Krajicek,2,S-DTM,4,0,0,0,0,1,3
20170212-W-Fed_Cup_World_Group_R1-RR-Aryna_Sabalenka-Michaella_Krajicek,2,S-DTL,5,1,1,0,0,4,1
20170212-W-Fed_Cup_World_Group_R1-RR-Kiki_Bertens-Aliaksandra_Sasnovich,1,F-XC,26,7,1,1,5,8,18
20170212-W-Fed_Cup_World_Group_R1-RR-Kiki_Bertens-Aliaksandra_Sasnovich,1,F-DTM,14,1,0,0,1,2,12
20170212-W-Fed_Cup_World_Group_R1-RR-Kiki_Bertens-Aliaksandra_Sasnovich,1,F-DTL,12,6,3,1,2,7,5
20170212-W-Fed_Cup_World_Group_R1-RR-Kiki_Bertens-Aliaksandra_Sasnovich,1,F-IO,9,6,1,1,4,3,6
20170212-W-Fed_Cup_World_Group_R1-RR-Kiki_Bertens-Aliaksandra_Sasnovich,1,B-XC,21,5,1,1,3,10,11
20170212-W-Fed_Cup_World_Group_R1-RR-Kiki_Bertens-Aliaksandra_Sasnovich,1,B-DTM,26,3,0,1,2,8,18
20170212-W-Fed_Cup_World_Group_R1-RR-Kiki_Bertens-Aliaksandra_Sasnovich,1,B-DTL,9,3,1,0,2,2,7
20170212-W-Fed_Cup_World_Group_R1-RR-Kiki_Bertens-Aliaksandra_Sasnovich,1,B-IO,7,2,1,0,1,3,4
20170212-W-Fed_Cup_World_Group_R1-RR-Kiki_Bertens-Aliaksandra_Sasnovich,1,S-XC,9,0,0,0,0,2,7
20170212-W-Fed_Cup_World_Group_R1-RR-Kiki_Bertens-Aliaksandra_Sasnovich,1,S-DTM,4,1,0,0,1,0,4
20170212-W-Fed_Cup_World_Group_R1-RR-Kiki_Bertens-Aliaksandra_Sasnovich,2,F-XC,24,2,0,1,1,15,9
20170212-W-Fed_Cup_World_Group_R1-RR-Kiki_Bertens-Aliaksandra_Sasnovich,2,F-DTM,14,1,1,0,0,8,6
20170212-W-Fed_Cup_World_Group_R1-RR-Kiki_Bertens-Aliaksandra_Sasnovich,2,F-DTL,5,0,0,0,0,5,0
20170212-W-Fed_Cup_World_Group_R1-RR-Kiki_Bertens-Aliaksandra_Sasnovich,2,F-IO,16,5,2,1,2,11,5
20170212-W-Fed_Cup_World_Group_R1-RR-Kiki_Bertens-Aliaksandra_Sasnovich,2,B-XC,28,4,1,1,2,15,13
20170212-W-Fed_Cup_World_Group_R1-RR-Kiki_Bertens-Aliaksandra_Sasnovich,2,B-DTM,14,2,0,1,1,8,6
20170212-W-Fed_Cup_World_Group_R1-RR-Kiki_Bertens-Aliaksandra_Sasnovich,2,B-DTL,12,5,1,1,3,8,4
20170212-W-Fed_Cup_World_Group_R1-RR-Kiki_Bertens-Aliaksandra_Sasnovich,2,B-IO,11,4,4,0,0,9,2
20170212-W-Fed_Cup_World_Group_R1-RR-Kiki_Bertens-Aliaksandra_Sasnovich,2,S-XC,1,0,0,0,0,1,0
20170212-W-Fed_Cup_World_Group_R1-RR-Kiki_Bertens-Aliaksandra_Sasnovich,2,S-DTM,1,0,0,0,0,1,0
20130107-W-Hobart-R16-Tsvetana_Pironkova-Klara_Koukalova,1,F-XC,40,8,2,2,4,23,17
20130107-W-Hobart-R16-Tsvetana_Pironkova-Klara_Koukalova,1,F-DTM,43,3,0,0,3,21,22
20130107-W-Hobart-R16-Tsvetana_Pironkova-Klara_Koukalova,1,F-DTL,24,4,2,0,2,13,11
20130107-W-Hobart-R16-Tsvetana_Pironkova-Klara_Koukalova,1,F-IO,20,2,0,0,2,13,7
20130107-W-Hobart-R16-Tsvetana_Pironkova-Klara_Koukalova,1,B-XC,56,5,1,3,1,27,29
20130107-W-Hobart-R16-Tsvetana_Pironkova-Klara_Koukalova,1,B-DTM,40,5,0,0,5,21,19
20130107-W-Hobart-R16-Tsvetana_Pironkova-Klara_Koukalova,1,B-DTL,13,4,2,0,2,6,7
20130107-W-Hobart-R16-Tsvetana_Pironkova-Klara_Koukalova,1,B-IO,16,10,2,5,3,10,6
20130107-W-Hobart-R16-Tsvetana_Pironkova-Klara_Koukalova,1,S-DTM,1,0,0,0,0,1,0
20130107-W-Hobart-R16-Tsvetana_Pironkova-Klara_Koukalova,2,F-XC,62,11,2,2,7,24,38
20130107-W-Hobart-R16-Tsvetana_Pironkova-Klara_Koukalova,2,F-DTM,35,3,0,1,2,17,18
20130107-W-Hobart-R16-Tsvetana_Pironkova-Klara_Koukalova,2,F-DTL,13,8,3,0,5,5,8
20130107-W-Hobart-R16-Tsvetana_Pironkova-Klara_Koukalova,2,F-IO,10,5,3,1,1,8,2
20130107-W-Hobart-R16-Tsvetana_Pironkova-Klara_Koukalova,2,B-XC,72,23,5,5,13,35,37
20130107-W-Hobart-R16-Tsvetana_Pironkova-Klara_Koukalova,2,B-DTM,31,3,0,1,2,12,19
20130107-W-Hobart-R16-Tsvetana_Pironkova-Klara_Koukalova,2,B-DTL,18,5,2,1,2,11,7
20130107-W-Hobart-R16-Tsvetana_Pironkova-Klara_Koukalova,2,B-IO,16,5,4,0,1,8,8
20130107-W-Hobart-R16-Tsvetana_Pironkova-Klara_Koukalova,2,S-XC,4,0,0,0,0,2,2
20130107-W-Hobart-R16-Tsvetana_Pironkova-Klara_Koukalova,2,S-DTM,9,1,0,0,1,2,7
20130107-W-Hobart-R16-Tsvetana_Pironkova-Klara_Koukalova,2,S-DTL,3,1,0,0,1,2,1
20160111-W-Hobart-R16-Camila_Giorgi-Nao_Hibino,1,F-XC,24,7,3,1,3,14,10
20160111-W-Hobart-R16-Camila_Giorgi-Nao_Hibino,1,F-DTM,15,3,0,1,2,8,7
20160111-W-Hobart-R16-Camila_Giorgi-Nao_Hibino,1,F-DTL,1,1,1,0,0,1,0
20160111-W-Hobart-R16-Camila_Giorgi-Nao_Hibino,1,F-IO,4,2,0,2,0,3,1
20160111-W-Hobart-R16-Camila_Giorgi-Nao_Hibino,1,B-XC,29,12,6,2,4,19,10
20160111-W-Hobart-R16-Camila_Giorgi-Nao_Hibino,1,B-DTM,19,5,0,1,4,10,9
20160111-W-Hobart-R16-Camila_Giorgi-Nao_Hibino,1,B-DTL,7,4,1,0,3,3,4
20160111-W-Hobart-R16-Camila_Giorgi-Nao_Hibino,1,S-XC,1,0,0,0,0,0,1
20160111-W-Hobart-R16-Camila_Giorgi-Nao_Hibino,2,F-XC,17,6,1,4,1,9,8
20160111-W-Hobart-R16-Camila_Giorgi-Nao_Hibino,2,F-DTM,19,1,0,0,1,6,13
20160111-W-Hobart-R16-Camila_Giorgi-Nao_Hibino,2,F-DTL,8,2,1,0,1,4,4
20160111-W-Hobart-R16-Camila_Giorgi-Nao_Hibino,2,F-IO,8,2,0,1,1,4,4
20160111-W-Hobart-R16-Camila_Giorgi-Nao_Hibino,2,F-II,1,1,0,0,1,0,1
20160111-W-Hobart-R16-Camila_Giorgi-Nao_Hibino,2,B-XC,21,6,1,1,4,7,14
20160111-W-Hobart-R16-Camila_Giorgi-Nao_Hibino,2,B-DTM,14,2,1,0,1,4,10
20160111-W-Hobart-R16-Camila_Giorgi-Nao_Hibino,2,B-DTL,7,3,0,2,1,5,2
20160111-W-Hobart-R16-Camila_Giorgi-Nao_Hibino,2,B-IO,3,2,0,0,2,0,3
20160111-W-Hobart-R16-Camila_Giorgi-Nao_Hibino,2,S-XC,1,0,0,0,0,0,1
20160111-W-Hobart-R16-Camila_Giorgi-Nao_Hibino,2,S-DTM,1,0,0,0,0,0,1
20140628-W-Wimbledon-R32-Maria_Sharapova-Alison_Riske,1,F-XC,28,9,3,4,2,21,7
20140628-W-Wimbledon-R32-Maria_Sharapova-Alison_Riske,1,F-DTM,15,2,0,1,1,9,6
20140628-W-Wimbledon-R32-Maria_Sharapova-Alison_Riske,1,F-DTL,19,13,7,2,4,14,5
20140628-W-Wimbledon-R32-Maria_Sharapova-Alison_Riske,1,F-IO,10,5,4,1,0,7,3
20140628-W-Wimbledon-R32-Maria_Sharapova-Alison_Riske,1,B-XC,17,4,2,1,1,12,5
20140628-W-Wimbledon-R32-Maria_Sharapova-Alison_Riske,1,B-DTM,22,0,0,0,0,12,10
20140628-W-Wimbledon-R32-Maria_Sharapova-Alison_Riske,1,B-DTL,4,2,1,0,1,3,1
20140628-W-Wimbledon-R32-Maria_Sharapova-Alison_Riske,1,B-IO,4,1,0,0,1,2,2
20140628-W-Wimbledon-R32-Maria_Sharapova-Alison_Riske,2,F-XC,32,4,0,2,2,7,25
20140628-W-Wimbledon-R32-Maria_Sharapova-Alison_Riske,2,F-DTM,15,2,0,0,2,8,7
20140628-W-Wimbledon-R32-Maria_Sharapova-Alison_Riske,2,F-DTL,2,0,0,0,0,0,2
20140628-W-Wimbledon-R32-Maria_Sharapova-Alison_Riske,2,F-IO,8,2,1,0,1,4,4
20140628-W-Wimbledon-R32-Maria_Sharapova-Alison_Riske,2,B-XC,19,3,2,1,0,7,12
20140628-W-Wimbledon-R32-Maria_Sharapova-Alison_Riske,2,B-DTM,19,1,0,0,1,7,12
20140628-W-Wimbledon-R32-Maria_Sharapova-Alison_Riske,2,B-DTL,10,5,2,1,2,4,6
20140628-W-Wimbledon-R32-Maria_Sharapova-Alison_Riske,2,B-IO,6,3,2,0,1,3,3
20140628-W-Wimbledon-R32-Maria_Sharapova-Alison_Riske,2,S-XC,2,0,0,0,0,0,2
20140628-W-Wimbledon-R32-Maria_Sharapova-Alison_Riske,2,S-DTM,1,0,0,0,0,0,1
20140628-W-Wimbledon-R32-Maria_Sharapova-Alison_Riske,2,S-DTL,2,0,0,0,0,0,2
20170517-W-Rome-R32-Anett_Kontaveit-Angelique_Kerber,1,F-XC,28,8,6,1,1,22,6
20170517-W-Rome-R32-Anett_Kontaveit-Angelique_Kerber,1,F-DTM,8,0,0,0,0,4,4
20170517-W-Rome-R32-Anett_Kontaveit-Angelique_Kerber,1,F-DTL,5,3,1,0,2,2,3
20170517-W-Rome-R32-Anett_Kontaveit-Angelique_Kerber,1,F-IO,7,5,3,0,2,4,3
20170517-W-Rome-R32-Anett_Kontaveit-Angelique_Kerber,1,B-XC,25,7,3,1,3,15,10
20170517-W-Rome-R32-Anett_Kontaveit-Angelique_Kerber,1,B-DTM,7,1,0,0,1,3,4
20170517-W-Rome-R32-Anett_Kontaveit-Angelique_Kerber,1,B-DTL,10,7,3,1,3,5,5
20170517-W-Rome-R32-Anett_Kontaveit-Angelique_Kerber,1,B-IO,4,4,4,0,0,4,0
20170517-W-Rome-R32-Anett_Kontaveit-Angelique_Kerber,1,S-XC,1,0,0,0,0,0,1
20170517-W-Rome-R32-Anett_Kontaveit-Angelique_Kerber,1,S-DTM,2,0,0,0,0,0,2
20170517-W-Rome-R32-Anett_Kontaveit-Angelique_Kerber,2,F-XC,32,6,1,1,4,16,16
20170517-W-Rome-R32-Anett_Kontaveit-Angelique_Kerber,2,F-DTM,5,0,0,0,0,2,3
20170517-W-Rome-R32-Anett_Kontaveit-Angelique_Kerber,2,F-DTL,11,8,3,2,3,6,5
20170517-W-Rome-R32-Anett_Kontaveit-Angelique_Kerber,2,F-IO,8,5,2,2,1,7,1
20170517-W-Rome-R32-Anett_Kontaveit-Angelique_Kerber,2,B-XC,19,3,0,0,3,6,13
20170517-W-Rome-R32-Anett_Kontaveit-Angelique_Kerber,2,B-DTM,11,0,0,0,0,3,8
20170517-W-Rome-R32-Anett_Kontaveit-Angelique_Kerber,2,B-DTL,5,2,0,0,2,1,4
20170517-W-Rome-R32-Anett_Kontaveit-Angelique_Kerber,2,B-IO,5,1,0,0,1,2,3
20170517-W-Rome-R32-Anett_Kontaveit-Angelique_Kerber,2,S-DTM,1,0,0,0,0,0,1
20170519-W-Rome-QF-Elina_Svitolina-Karolina_Pliskova,1,F-XC,49,9,5,2,2,30,19
20170519-W-Rome-QF-Elina_Svitolina-Karolina_Pliskova,1,F-DTM,34,3,0,0,3,21,13
20170519-W-Rome-QF-Elina_Svitolina-Karolina_Pliskova,1,F-DTL,7,2,1,0,1,5,2
20170519-W-Rome-QF-Elina_Svitolina-Karolina_Pliskova,1,F-IO,20,8,3,3,2,11,9
20170519-W-Rome-QF-Elina_Svitolina-Karolina_Pliskova,1,F-II,2,2,1,0,1,1,1
20170519-W-Rome-QF-Elina_Svitolina-Karolina_Pliskova,1,B-XC,38,9,1,4,4,17,21
20170519-W-Rome-QF-Elina_Svitolina-Karolina_Pliskova,1,B-DTM,31,4,0,0,4,12,19
20170519-W-Rome-QF-Elina_Svitolina-Karolina_Pliskova,1,B-DTL,5,3,1,0,2,2,3
20170519-W-Rome-QF-Elina_Svitolina-Karolina_Pliskova,1,B-IO,3,0,0,0,0,1,2
20170519-W-Rome-QF-Elina_Svitolina-Karolina_Pliskova,1,S-XC,8,2,0,0,2,4,4
20170519-W-Rome-QF-Elina_Svitolina-Karolina_Pliskova,1,S-DTM,3,0,0,0,0,1,2
20170519-W-Rome-QF-Elina_Svitolina-Karolina_Pliskova,1,S-DTL,1,1,0,0,1,0,1
20170519-W-Rome-QF-Elina_Svitolina-Karolina_Pliskova,2,F-XC,44,8,3,2,3,22,22
20170519-W-Rome-QF-Elina_Svitolina-Karolina_Pliskova,2,F-DTM,22,2,0,0,2,9,13
20170519-W-Rome-QF-Elina_Svitolina-Karolina_Pliskova,2,F-DTL,13,8,2,2,4,8,5
20170519-W-Rome-QF-Elina_Svitolina-Karolina_Pliskova,2,F-IO,28,11,1,2,8,14,14
20170519-W-Rome-QF-Elina_Svitolina-Karolina_Pliskova,2,F-II,1,1,1,0,0,1,0
20170519-W-Rome-QF-Elina_Svitolina-Karolina_Pliskova,2,B-XC,32,8,2,1,5,18,14
20170519-W-Rome-QF-Elina_Svitolina-Karolina_Pliskova,2,B-DTM,35,2,0,0,2,13,22
20170519-W-Rome-QF-Elina_Svitolina-Karolina_Pliskova,2,B-DTL,10,5,2,1,2,4,6
20170519-W-Rome-QF-Elina_Svitolina-Karolina_Pliskova,2,B-IO,7,3,0,0,3,2,5
20170519-W-Rome-QF-Elina_Svitolina-Karolina_Pliskova,2,S-XC,6,0,0,0,0,4,2
20170519-W-Rome-QF-Elina_Svitolina-Karolina_Pliskova,2,S-DTM,1,0,0,0,0,0,1
20170707-W-Wimbledon-R32-Dominika_Cibulkova-Ana_Konjuh,1,F-XC,47,10,5,1,4,29,18
20170707-W-Wimbledon-R32-Dominika_Cibulkova-Ana_Konjuh,1,F-DTM,18,3,0,0,3,6,12
20170707-W-Wimbledon-R32-Dominika_Cibulkova-Ana_Konjuh,1,F-DTL,11,3,2,0,1,7,4
20170707-W-Wimbledon-R32-Dominika_Cibulkova-Ana_Konjuh,1,F-IO,17,5,2,2,1,11,6
20170707-W-Wimbledon-R32-Dominika_Cibulkova-Ana_Konjuh,1,F-II,2,2,1,1,0,2,0
20170707-W-Wimbledon-R32-Dominika_Cibulkova-Ana_Konjuh,1,B-XC,19,4,1,1,2,11,8
20170707-W-Wimbledon-R32-Dominika_Cibulkova-Ana_Konjuh,1,B-DTM,34,5,0,1,4,12,22
20170707-W-Wimbledon-R32-Dominika_Cibulkova-Ana_Konjuh,1,B-DTL,14,5,2,0,3,6,8
20170707-W-Wimbledon-R32-Dominika_Cibulkova-Ana_Konjuh,1,B-IO,10,3,0,1,2,5,5
20170707-W-Wimbledon-R32-Dominika_Cibulkova-Ana_Konjuh,1,S-XC,3,0,0,0,0,3,0
20170707-W-Wimbledon-R32-Dominika_Cibulkova-Ana_Konjuh,1,S-DTM,9,0,0,0,0,3,6
20170707-W-Wimbledon-R32-Dominika_Cibulkova-Ana_Konjuh,1,S-DTL,2,1,0,0,1,1,1
20170707-W-Wimbledon-R32-Dominika_Cibulkova-Ana_Konjuh,2,F-XC,48,22,10,4,8,24,24
20170707-W-Wimbledon-R32-Dominika_Cibulkova-Ana_Konjuh,2,F-DTM,22,7,0,0,7,5,17
20170707-W-Wimbledon-R32-Dominika_Cibulkova-Ana_Konjuh,2,F-DTL,7,3,0,0,3,2,5
20170707-W-Wimbledon-R32-Dominika_Cibulkova-Ana_Konjuh,2,F-IO,16,9,3,1,5,9,7
20170707-W-Wimbledon-R32-Dominika_Cibulkova-Ana_Konjuh,2,B-XC,44,15,8,1,6,23,21
20170707-W-Wimbledon-R32-Dominika_Cibulkova-Ana_Konjuh,2,B-DTM,31,8,0,3,5,13,18
20170707-W-Wimbledon-R32-Dominika_Cibulkova-Ana_Konjuh,2,B-DTL,9,6,2,0,4,3,6
20170707-W-Wimbledon-R32-Dominika_Cibulkova-Ana_Konjuh,2,B-IO,11,8,5,1,2,6,5
20170707-W-Wimbledon-R32-Dominika_Cibulkova-Ana_Konjuh,2,S-XC,5,0,0,0,0,3,2
20170707-W-Wimbledon-R32-Dominika_Cibulkova-Ana_Konjuh,2,S-DTM,4,0,0,0,0,2,2
20170707-W-Wimbledon-R32-Dominika_Cibulkova-Ana_Konjuh,2,S-DTL,1,0,0,0,0,0,1
20170707-W-Wimbledon-R32-Dominika_Cibulkova-Ana_Konjuh,2,S-IO,1,0,0,0,0,1,0
20170704-W-Wimbledon-R128-Oceane_Dodin-Lucie_Safarova,1,F-XC,5,3,1,1,1,3,2
20170704-W-Wimbledon-R128-Oceane_Dodin-Lucie_Safarova,1,F-DTM,8,3,0,0,3,2,6
20170704-W-Wimbledon-R128-Oceane_Dodin-Lucie_Safarova,1,F-IO,2,2,1,0,1,1,1
20170704-W-Wimbledon-R128-Oceane_Dodin-Lucie_Safarova,1,B-XC,5,1,0,0,1,3,2
20170704-W-Wimbledon-R128-Oceane_Dodin-Lucie_Safarova,1,B-DTM,22,6,0,0,6,6,16
20170704-W-Wimbledon-R128-Oceane_Dodin-Lucie_Safarova,1,B-DTL,4,3,2,0,1,2,2
20170704-W-Wimbledon-R128-Oceane_Dodin-Lucie_Safarova,1,B-IO,2,2,1,1,0,2,0
20170704-W-Wimbledon-R128-Oceane_Dodin-Lucie_Safarova,2,F-XC,15,2,1,0,1,8,7
20170704-W-Wimbledon-R128-Oceane_Dodin-Lucie_Safarova,2,F-DTM,8,1,0,0,1,6,2
20170704-W-Wimbledon-R128-Oceane_Dodin-Lucie_Safarova,2,F-IO,7,6,5,1,0,7,0
20170704-W-Wimbledon-R128-Oceane_Dodin-Lucie_Safarova,2,B-XC,5,3,0,0,3,0,5
20170704-W-Wimbledon-R128-Oceane_Dodin-Lucie_Safarova,2,B-DTM,3,1,0,0,1,1,2
20170704-W-Wimbledon-R128-Oceane_Dodin-Lucie_Safarova,2,B-DTL,1,0,0,0,0,1,0
20170704-W-Wimbledon-R128-Oceane_Dodin-Lucie_Safarova,2,B-IO,4,3,2,0,1,2,2
20170711-W-Wimbledon-QF-Garbine_Muguruza-Svetlana_Kuznetsova,1,F-XC,33,6,3,1,2,21,12
20170711-W-Wimbledon-QF-Garbine_Muguruza-Svetlana_Kuznetsova,1,F-DTM,31,1,0,0,1,10,21
20170711-W-Wimbledon-QF-Garbine_Muguruza-Svetlana_Kuznetsova,1,F-DTL,11,5,2,1,2,4,7
20170711-W-Wimbledon-QF-Garbine_Muguruza-Svetlana_Kuznetsova,1,F-IO,11,3,0,2,1,3,8
20170711-W-Wimbledon-QF-Garbine_Muguruza-Svetlana_Kuznetsova,1,B-XC,40,12,2,5,5,21,19
20170711-W-Wimbledon-QF-Garbine_Muguruza-Svetlana_Kuznetsova,1,B-DTM,57,3,0,1,2,32,25
20170711-W-Wimbledon-QF-Garbine_Muguruza-Svetlana_Kuznetsova,1,B-DTL,10,2,1,1,0,8,2
20170711-W-Wimbledon-QF-Garbine_Muguruza-Svetlana_Kuznetsova,1,B-IO,7,1,0,1,0,3,4
20170711-W-Wimbledon-QF-Garbine_Muguruza-Svetlana_Kuznetsova,1,S-DTM,6,0,0,0,0,2,4
20170711-W-Wimbledon-QF-Garbine_Muguruza-Svetlana_Kuznetsova,2,F-XC,36,7,3,0,4,18,18
20170711-W-Wimbledon-QF-Garbine_Muguruza-Svetlana_Kuznetsova,2,F-DTM,36,2,0,0,2,16,20
20170711-W-Wimbledon-QF-Garbine_Muguruza-Svetlana_Kuznetsova,2,F-DTL,19,6,2,0,4,9,10
20170711-W-Wimbledon-QF-Garbine_Muguruza-Svetlana_Kuznetsova,2,F-IO,38,7,3,2,2,16,22
20170711-W-Wimbledon-QF-Garbine_Muguruza-Svetlana_Kuznetsova,2,B-XC,22,4,2,0,2,13,9
20170711-W-Wimbledon-QF-Garbine_Muguruza-Svetlana_Kuznetsova,2,B-DTM,25,1,0,0,1,15,10
20170711-W-Wimbledon-QF-Garbine_Muguruza-Svetlana_Kuznetsova,2,B-DTL,8,6,2,2,2,6,2
20170711-W-Wimbledon-QF-Garbine_Muguruza-Svetlana_Kuznetsova,2,B-IO,3,1,1,0,0,3,0
20170711-W-Wimbledon-QF-Garbine_Muguruza-Svetlana_Kuznetsova,2,S-XC,3,0,0,0,0,3,0
20170711-W-Wimbledon-QF-Garbine_Muguruza-Svetlana_Kuznetsova,2,S-DTM,5,0,0,0,0,2,3
20170711-W-Wimbledon-QF-Garbine_Muguruza-Svetlana_Kuznetsova,2,S-DTL,1,0,0,0,0,1,0
20170711-W-Wimbledon-QF-Garbine_Muguruza-Svetlana_Kuznetsova,2,S-IO,1,0,0,0,0,1,0
20170703-W-Wimbledon-R128-Elina_Svitolina-Ashleigh_Barty,1,F-XC,36,12,5,3,4,20,16
20170703-W-Wimbledon-R128-Elina_Svitolina-Ashleigh_Barty,1,F-DTM,34,2,0,1,1,17,17
20170703-W-Wimbledon-R128-Elina_Svitolina-Ashleigh_Barty,1,F-DTL,7,5,1,1,3,3,4
20170703-W-Wimbledon-R128-Elina_Svitolina-Ashleigh_Barty,1,F-IO,26,6,5,1,0,16,10
20170703-W-Wimbledon-R128-Elina_Svitolina-Ashleigh_Barty,1,B-XC,29,8,3,1,4,17,12
20170703-W-Wimbledon-R128-Elina_Svitolina-Ashleigh_Barty,1,B-DTM,39,4,0,1,3,17,22
20170703-W-Wimbledon-R128-Elina_Svitolina-Ashleigh_Barty,1,B-DTL,4,3,1,1,1,2,2
20170703-W-Wimbledon-R128-Elina_Svitolina-Ashleigh_Barty,1,B-IO,9,2,0,2,0,7,2
20170703-W-Wimbledon-R128-Elina_Svitolina-Ashleigh_Barty,1,S-XC,10,1,0,0,1,6,4
20170703-W-Wimbledon-R128-Elina_Svitolina-Ashleigh_Barty,1,S-DTM,15,0,0,0,0,5,10
20170703-W-Wimbledon-R128-Elina_Svitolina-Ashleigh_Barty,2,F-XC,46,19,9,2,8,25,21
20170703-W-Wimbledon-R128-Elina_Svitolina-Ashleigh_Barty,2,F-DTM,36,8,1,1,6,13,23
20170703-W-Wimbledon-R128-Elina_Svitolina-Ashleigh_Barty,2,F-DTL,11,6,3,2,1,6,5
20170703-W-Wimbledon-R128-Elina_Svitolina-Ashleigh_Barty,2,F-IO,24,11,8,0,3,15,9
20170703-W-Wimbledon-R128-Elina_Svitolina-Ashleigh_Barty,2,B-XC,9,4,0,0,4,2,7
20170703-W-Wimbledon-R128-Elina_Svitolina-Ashleigh_Barty,2,B-DTM,31,2,0,0,2,14,17
20170703-W-Wimbledon-R128-Elina_Svitolina-Ashleigh_Barty,2,B-DTL,4,2,0,0,2,2,2
20170703-W-Wimbledon-R128-Elina_Svitolina-Ashleigh_Barty,2,B-IO,4,1,0,0,1,2,2
20170703-W-Wimbledon-R128-Elina_Svitolina-Ashleigh_Barty,2,S-XC,18,3,1,0,2,10,8
20170703-W-Wimbledon-R128-Elina_Svitolina-Ashleigh_Barty,2,S-DTM,32,6,0,0,6,14,18
20170703-W-Wimbledon-R128-Elina_Svitolina-Ashleigh_Barty,2,S-DTL,9,2,0,0,2,4,5
20170703-W-Wimbledon-R128-Elina_Svitolina-Ashleigh_Barty,2,S-IO,4,0,0,0,0,3,1
20170710-W-Wimbledon-R16-Elina_Svitolina-Jelena_Ostapenko,1,F-XC,28,7,1,1,5,10,18
20170710-W-Wimbledon-R16-Elina_Svitolina-Jelena_Ostapenko,1,F-DTM,42,2,0,1,1,18,24
20170710-W-Wimbledon-R16-Elina_Svitolina-Jelena_Ostapenko,1,F-DTL,4,3,2,0,1,3,1
20170710-W-Wimbledon-R16-Elina_Svitolina-Jelena_Ostapenko,1,F-IO,7,2,1,0,1,4,3
20170710-W-Wimbledon-R16-Elina_Svitolina-Jelena_Ostapenko,1,B-XC,15,3,0,1,2,8,7
20170710-W-Wimbledon-R16-Elina_Svitolina-Jelena_Ostapenko,1,B-DTM,26,1,0,0,1,13,13
20170710-W-Wimbledon-R16-Elina_Svitolina-Jelena_Ostapenko,1,B-DTL,3,1,1,0,0,2,1
20170710-W-Wimbledon-R16-Elina_Svitolina-Jelena_Ostapenko,1,S-XC,3,1,0,0,1,2,1
20170710-W-Wimbledon-R16-Elina_Svitolina-Jelena_Ostapenko,1,S-DTM,10,1,0,0,1,2,8
20170710-W-Wimbledon-R16-Elina_Svitolina-Jelena_Ostapenko,2,F-XC,70,30,14,8,8,45,25
20170710-W-Wimbledon-R16-Elina_Svitolina-Jelena_Ostapenko,2,F-DTM,17,3,0,0,3,5,12
20170710-W-Wimbledon-R16-Elina_Svitolina-Jelena_Ostapenko,2,F-DTL,5,3,1,0,2,3,2
20170710-W-Wimbledon-R16-Elina_Svitolina-Jelena_Ostapenko,2,F-IO,14,4,2,0,2,9,5
20170710-W-Wimbledon-R16-Elina_Svitolina-Jelena_Ostapenko,2,B-XC,34,15,7,1,7,15,19
20170710-W-Wimbledon-R16-Elina_Svitolina-Jelena_Ostapenko,2,B-DTM,20,5,0,1,4,12,8
20170710-W-Wimbledon-R16-Elina_Svitolina-Jelena_Ostapenko,2,B-DTL,15,12,7,0,5,8,7
20170710-W-Wimbledon-R16-Elina_Svitolina-Jelena_Ostapenko,2,B-IO,12,6,3,0,3,8,4
20170710-W-Wimbledon-R16-Elina_Svitolina-Jelena_Ostapenko,2,S-XC,1,0,0,0,0,0,1
20170710-W-Wimbledon-R16-Elina_Svitolina-Jelena_Ostapenko,2,S-DTM,2,0,0,0,0,1,1
20170710-W-Wimbledon-R16-Elina_Svitolina-Jelena_Ostapenko,2,S-DTL,1,0,0,0,0,1,0
20170705-W-Wimbledon-R64-Elina_Svitolina-Francesca_Schiavone,1,F-XC,12,5,0,2,3,5,7
20170705-W-Wimbledon-R64-Elina_Svitolina-Francesca_Schiavone,1,F-DTM,6,1,0,0,1,4,2
20170705-W-Wimbledon-R64-Elina_Svitolina-Francesca_Schiavone,1,F-DTL,2,1,1,0,0,2,0
20170705-W-Wimbledon-R64-Elina_Svitolina-Francesca_Schiavone,1,F-IO,9,4,2,1,1,5,4
20170705-W-Wimbledon-R64-Elina_Svitolina-Francesca_Schiavone,1,F-II,1,1,0,0,1,0,1
20170705-W-Wimbledon-R64-Elina_Svitolina-Francesca_Schiavone,1,B-XC,10,4,1,0,3,5,5
20170705-W-Wimbledon-R64-Elina_Svitolina-Francesca_Schiavone,1,B-DTM,8,1,1,0,0,6,2
20170705-W-Wimbledon-R64-Elina_Svitolina-Francesca_Schiavone,1,B-DTL,6,4,1,3,0,5,1
20170705-W-Wimbledon-R64-Elina_Svitolina-Francesca_Schiavone,1,B-IO,4,2,2,0,0,2,2
20170705-W-Wimbledon-R64-Elina_Svitolina-Francesca_Schiavone,1,S-DTM,2,0,0,0,0,0,2
20170705-W-Wimbledon-R64-Elina_Svitolina-Francesca_Schiavone,1,S-DTL,1,0,0,0,0,0,1
20170705-W-Wimbledon-R64-Elina_Svitolina-Francesca_Schiavone,2,F-XC,7,2,0,0,2,2,5
20170705-W-Wimbledon-R64-Elina_Svitolina-Francesca_Schiavone,2,F-DTM,10,2,0,0,2,6,4
20170705-W-Wimbledon-R64-Elina_Svitolina-Francesca_Schiavone,2,F-DTL,3,1,0,1,0,2,1
20170705-W-Wimbledon-R64-Elina_Svitolina-Francesca_Schiavone,2,F-IO,6,1,0,0,1,1,5
20170705-W-Wimbledon-R64-Elina_Svitolina-Francesca_Schiavone,2,B-XC,2,0,0,0,0,1,1
20170705-W-Wimbledon-R64-Elina_Svitolina-Francesca_Schiavone,2,B-DTM,1,0,0,0,0,0,1
20170705-W-Wimbledon-R64-Elina_Svitolina-Francesca_Schiavone,2,B-IO,1,1,1,0,0,1,0
20170705-W-Wimbledon-R64-Elina_Svitolina-Francesca_Schiavone,2,S-XC,7,2,0,1,1,4,3
20170705-W-Wimbledon-R64-Elina_Svitolina-Francesca_Schiavone,2,S-DTM,7,1,0,0,1,2,5
20170705-W-Wimbledon-R64-Elina_Svitolina-Francesca_Schiavone,2,S-DTL,5,1,0,0,1,2,3
20170705-W-Wimbledon-R64-Elina_Svitolina-Francesca_Schiavone,2,S-IO,2,1,0,0,1,0,2
20170715-W-Wimbledon-F-Venus_Williams-Garbine_Muguruza,1,F-XC,34,11,5,1,5,14,20
20170715-W-Wimbledon-F-Venus_Williams-Garbine_Muguruza,1,F-DTM,23,3,0,0,3,5,18
20170715-W-Wimbledon-F-Venus_Williams-Garbine_Muguruza,1,F-DTL,10,5,0,0,5,1,9
20170715-W-Wimbledon-F-Venus_Williams-Garbine_Muguruza,1,F-IO,17,9,5,1,3,11,6
20170715-W-Wimbledon-F-Venus_Williams-Garbine_Muguruza,1,B-XC,17,4,1,1,2,9,8
20170715-W-Wimbledon-F-Venus_Williams-Garbine_Muguruza,1,B-DTM,16,1,0,0,1,3,13
20170715-W-Wimbledon-F-Venus_Williams-Garbine_Muguruza,1,B-DTL,10,3,1,0,2,3,7
20170715-W-Wimbledon-F-Venus_Williams-Garbine_Muguruza,1,B-IO,16,8,2,0,6,7,9
20170715-W-Wimbledon-F-Venus_Williams-Garbine_Muguruza,1,S-XC,2,1,0,0,1,0,2
20170715-W-Wimbledon-F-Venus_Williams-Garbine_Muguruza,1,S-DTM,3,1,0,0,1,2,1
20170715-W-Wimbledon-F-Venus_Williams-Garbine_Muguruza,2,F-XC,40,8,0,2,6,29,11
20170715-W-Wimbledon-F-Venus_Williams-Garbine_Muguruza,2,F-DTM,22,0,0,0,0,14,8
20170715-W-Wimbledon-F-Venus_Williams-Garbine_Muguruza,2,F-DTL,11,7,2,1,4,5,6
20170715-W-Wimbledon-F-Venus_Williams-Garbine_Muguruza,2,F-IO,8,2,0,1,1,6,2
20170715-W-Wimbledon-F-Venus_Williams-Garbine_Muguruza,2,B-XC,20,6,3,2,1,16,4
20170715-W-Wimbledon-F-Venus_Williams-Garbine_Muguruza,2,B-DTM,23,1,0,0,1,11,12
20170715-W-Wimbledon-F-Venus_Williams-Garbine_Muguruza,2,B-DTL,7,5,3,0,2,3,4
20170715-W-Wimbledon-F-Venus_Williams-Garbine_Muguruza,2,B-IO,6,0,0,0,0,4,2
20170715-W-Wimbledon-F-Venus_Williams-Garbine_Muguruza,2,S-DTM,2,0,0,0,0,0,2
20170715-W-Wimbledon-F-Venus_Williams-Garbine_Muguruza,2,S-DTL,1,0,0,0,0,1,0
20170711-W-Wimbledon-QF-Venus_Williams-Jelena_Ostapenko,1,F-XC,18,4,0,3,1,7,11
20170711-W-Wimbledon-QF-Venus_Williams-Jelena_Ostapenko,1,F-DTM,17,1,0,0,1,9,8
20170711-W-Wimbledon-QF-Venus_Williams-Jelena_Ostapenko,1,F-DTL,11,4,0,0,4,3,8
20170711-W-Wimbledon-QF-Venus_Williams-Jelena_Ostapenko,1,F-IO,5,2,0,0,2,2,3
20170711-W-Wimbledon-QF-Venus_Williams-Jelena_Ostapenko,1,B-XC,10,2,0,0,2,4,6
20170711-W-Wimbledon-QF-Venus_Williams-Jelena_Ostapenko,1,B-DTM,5,0,0,0,0,2,3
20170711-W-Wimbledon-QF-Venus_Williams-Jelena_Ostapenko,1,B-DTL,1,0,0,0,0,1,0
20170711-W-Wimbledon-QF-Venus_Williams-Jelena_Ostapenko,1,B-IO,3,0,0,0,0,1,2
20170711-W-Wimbledon-QF-Venus_Williams-Jelena_Ostapenko,1,S-XC,2,0,0,0,0,1,1
20170711-W-Wimbledon-QF-Venus_Williams-Jelena_Ostapenko,1,S-DTM,5,1,0,0,1,1,4
20170711-W-Wimbledon-QF-Venus_Williams-Jelena_Ostapenko,2,F-XC,33,14,4,3,7,18,15
20170711-W-Wimbledon-QF-Venus_Williams-Jelena_Ostapenko,2,F-DTM,8,1,0,0,1,5,3
20170711-W-Wimbledon-QF-Venus_Williams-Jelena_Ostapenko,2,F-DTL,8,6,5,0,1,7,1
20170711-W-Wimbledon-QF-Venus_Williams-Jelena_Ostapenko,2,F-IO,6,4,1,1,2,3,3
20170711-W-Wimbledon-QF-Venus_Williams-Jelena_Ostapenko,2,B-XC,14,5,2,0,3,8,6
20170711-W-Wimbledon-QF-Venus_Williams-Jelena_Ostapenko,2,B-DTM,10,2,0,0,2,2,8
20170711-W-Wimbledon-QF-Venus_Williams-Jelena_Ostapenko,2,B-DTL,11,8,3,0,5,5,6
20170711-W-Wimbledon-QF-Venus_Williams-Jelena_Ostapenko,2,B-IO,4,2,0,1,1,3,1
20170711-W-Wimbledon-QF-Venus_Williams-Jelena_Ostapenko,2,B-II,1,0,0,0,0,1,0
20170711-W-Wimbledon-QF-Venus_Williams-Jelena_Ostapenko,2,S-XC,1,0,0,0,0,0,1
20170711-W-Wimbledon-QF-Venus_Williams-Jelena_Ostapenko,2,S-DTM,2,0,0,0,0,2,0
20170711-W-Wimbledon-QF-Venus_Williams-Jelena_Ostapenko,2,S-DTL,1,0,0,0,0,0,1
20170707-W-Wimbledon-R32-Carina_Witthoeft-Elina_Svitolina,1,F-XC,29,5,1,1,3,12,17
20170707-W-Wimbledon-R32-Carina_Witthoeft-Elina_Svitolina,1,F-DTM,31,5,0,0,5,17,14
20170707-W-Wimbledon-R32-Carina_Witthoeft-Elina_Svitolina,1,F-DTL,10,3,0,1,2,2,8
20170707-W-Wimbledon-R32-Carina_Witthoeft-Elina_Svitolina,1,F-IO,28,12,6,3,3,19,9
20170707-W-Wimbledon-R32-Carina_Witthoeft-Elina_Svitolina,1,F-II,2,2,1,1,0,2,0
20170707-W-Wimbledon-R32-Carina_Witthoeft-Elina_Svitolina,1,B-XC,17,1,0,0,1,7,10
20170707-W-Wimbledon-R32-Carina_Witthoeft-Elina_Svitolina,1,B-DTM,35,2,0,0,2,10,25
20170707-W-Wimbledon-R32-Carina_Witthoeft-Elina_Svitolina,1,B-DTL,11,1,0,0,1,3,8
20170707-W-Wimbledon-R32-Carina_Witthoeft-Elina_Svitolina,1,S-XC,2,0,0,0,0,1,1
20170707-W-Wimbledon-R32-Carina_Witthoeft-Elina_Svitolina,1,S-DTM,8,0,0,0,0,2,6
20170707-W-Wimbledon-R32-Carina_Witthoeft-Elina_Svitolina,1,S-DTL,1,0,0,0,0,0,1
20170707-W-Wimbledon-R32-Carina_Witthoeft-Elina_Svitolina,2,F-XC,31,15,5,5,5,22,9
20170707-W-Wimbledon-R32-Carina_Witthoeft-Elina_Svitolina,2,F-DTM,27,2,0,0,2,7,20
20170707-W-Wimbledon-R32-Carina_Witthoeft-Elina_Svitolina,2,F-DTL,9,2,1,0,1,6,3
20170707-W-Wimbledon-R32-Carina_Witthoeft-Elina_Svitolina,2,F-IO,18,7,7,0,0,15,3
20170707-W-Wimbledon-R32-Carina_Witthoeft-Elina_Svitolina,2,F-II,1,1,0,1,0,1,0
20170707-W-Wimbledon-R32-Carina_Witthoeft-Elina_Svitolina,2,B-XC,27,3,2,1,0,21,6
20170707-W-Wimbledon-R32-Carina_Witthoeft-Elina_Svitolina,2,B-DTM,27,2,0,0,2,10,17
20170707-W-Wimbledon-R32-Carina_Witthoeft-Elina_Svitolina,2,B-DTL,7,6,3,0,3,3,4
20170707-W-Wimbledon-R32-Carina_Witthoeft-Elina_Svitolina,2,B-IO,7,2,2,0,0,6,1
20170707-W-Wimbledon-R32-Carina_Witthoeft-Elina_Svitolina,2,S-XC,6,0,0,0,0,3,3
20170707-W-Wimbledon-R32-Carina_Witthoeft-Elina_Svitolina,2,S-DTM,8,1,0,0,1,3,5
20170723-W-ITF_Stockton-F-Ashley_Kratzer-Sofia_Kenin,1,F-XC,22,6,0,3,3,8,14
20170723-W-ITF_Stockton-F-Ashley_Kratzer-Sofia_Kenin,1,F-DTM,10,1,0,0,1,3,7
20170723-W-ITF_Stockton-F-Ashley_Kratzer-Sofia_Kenin,1,F-DTL,3,2,2,0,0,2,1
20170723-W-ITF_Stockton-F-Ashley_Kratzer-Sofia_Kenin,1,F-IO,11,7,2,0,5,4,7
20170723-W-ITF_Stockton-F-Ashley_Kratzer-Sofia_Kenin,1,F-II,2,2,1,0,1,1,1
20170723-W-ITF_Stockton-F-Ashley_Kratzer-Sofia_Kenin,1,B-XC,21,6,1,0,5,6,15
20170723-W-ITF_Stockton-F-Ashley_Kratzer-Sofia_Kenin,1,B-DTM,5,1,0,0,1,2,3
20170723-W-ITF_Stockton-F-Ashley_Kratzer-Sofia_Kenin,1,B-DTL,4,1,0,0,1,2,2
20170723-W-ITF_Stockton-F-Ashley_Kratzer-Sofia_Kenin,1,S-XC,1,0,0,0,0,0,1
20170723-W-ITF_Stockton-F-Ashley_Kratzer-Sofia_Kenin,1,S-DTM,1,0,0,0,0,1,0
20170723-W-ITF_Stockton-F-Ashley_Kratzer-Sofia_Kenin,1,S-DTL,4,2,1,0,1,1,3
20170723-W-ITF_Stockton-F-Ashley_Kratzer-Sofia_Kenin,1,S-IO,1,0,0,0,0,0,1
20170723-W-ITF_Stockton-F-Ashley_Kratzer-Sofia_Kenin,2,F-XC,24,3,1,1,1,17,7
20170723-W-ITF_Stockton-F-Ashley_Kratzer-Sofia_Kenin,2,F-DTM,7,0,0,0,0,3,4
20170723-W-ITF_Stockton-F-Ashley_Kratzer-Sofia_Kenin,2,F-DTL,9,7,3,2,2,6,3
20170723-W-ITF_Stockton-F-Ashley_Kratzer-Sofia_Kenin,2,F-IO,1,1,1,0,0,1,0
20170723-W-ITF_Stockton-F-Ashley_Kratzer-Sofia_Kenin,2,B-XC,15,5,2,0,3,9,6
20170723-W-ITF_Stockton-F-Ashley_Kratzer-Sofia_Kenin,2,B-DTM,17,1,0,0,1,9,8
20170723-W-ITF_Stockton-F-Ashley_Kratzer-Sofia_Kenin,2,S-DTM,3,1,0,0,1,1,2
20170713-W-Wimbledon-SF-Garbine_Muguruza-Magdalena_Rybarikova,1,F-XC,33,9,1,3,5,21,12
20170713-W-Wimbledon-SF-Garbine_Muguruza-Magdalena_Rybarikova,1,F-DTM,14,1,0,0,1,11,3
20170713-W-Wimbledon-SF-Garbine_Muguruza-Magdalena_Rybarikova,1,F-DTL,7,2,1,0,1,3,4
20170713-W-Wimbledon-SF-Garbine_Muguruza-Magdalena_Rybarikova,1,F-IO,8,0,0,0,0,5,3
20170713-W-Wimbledon-SF-Garbine_Muguruza-Magdalena_Rybarikova,1,B-XC,47,7,3,4,0,33,14
20170713-W-Wimbledon-SF-Garbine_Muguruza-Magdalena_Rybarikova,1,B-DTM,28,3,0,0,3,18,10
20170713-W-Wimbledon-SF-Garbine_Muguruza-Magdalena_Rybarikova,1,B-DTL,16,7,3,2,2,13,3
20170713-W-Wimbledon-SF-Garbine_Muguruza-Magdalena_Rybarikova,1,B-IO,15,5,2,2,1,13,2
20170713-W-Wimbledon-SF-Garbine_Muguruza-Magdalena_Rybarikova,1,S-DTL,1,0,0,0,0,0,1
20170713-W-Wimbledon-SF-Garbine_Muguruza-Magdalena_Rybarikova,2,F-XC,27,4,0,1,3,9,18
20170713-W-Wimbledon-SF-Garbine_Muguruza-Magdalena_Rybarikova,2,F-DTM,33,4,0,1,3,11,22
20170713-W-Wimbledon-SF-Garbine_Muguruza-Magdalena_Rybarikova,2,F-DTL,11,1,0,0,1,0,11
20170713-W-Wimbledon-SF-Garbine_Muguruza-Magdalena_Rybarikova,2,F-IO,15,2,0,1,1,5,10
20170713-W-Wimbledon-SF-Garbine_Muguruza-Magdalena_Rybarikova,2,B-XC,19,1,0,0,1,7,12
20170713-W-Wimbledon-SF-Garbine_Muguruza-Magdalena_Rybarikova,2,B-DTM,23,1,0,0,1,2,21
20170713-W-Wimbledon-SF-Garbine_Muguruza-Magdalena_Rybarikova,2,B-DTL,5,1,0,0,1,3,2
20170713-W-Wimbledon-SF-Garbine_Muguruza-Magdalena_Rybarikova,2,B-IO,1,1,0,0,1,0,1
20170713-W-Wimbledon-SF-Garbine_Muguruza-Magdalena_Rybarikova,2,S-XC,12,1,0,0,1,5,7
20170713-W-Wimbledon-SF-Garbine_Muguruza-Magdalena_Rybarikova,2,S-DTM,8,0,0,0,0,4,4
20170713-W-Wimbledon-SF-Garbine_Muguruza-Magdalena_Rybarikova,2,S-DTL,3,0,0,0,0,2,1
20170713-W-Wimbledon-SF-Venus_Williams-Johanna_Konta,1,F-XC,19,3,3,0,0,15,4
20170713-W-Wimbledon-SF-Venus_Williams-Johanna_Konta,1,F-DTM,17,1,0,0,1,8,9
20170713-W-Wimbledon-SF-Venus_Williams-Johanna_Konta,1,F-DTL,5,3,3,0,0,3,2
20170713-W-Wimbledon-SF-Venus_Williams-Johanna_Konta,1,F-IO,14,6,2,3,1,12,2
20170713-W-Wimbledon-SF-Venus_Williams-Johanna_Konta,1,B-XC,8,3,1,0,2,3,5
20170713-W-Wimbledon-SF-Venus_Williams-Johanna_Konta,1,B-DTM,11,2,0,1,1,7,4
20170713-W-Wimbledon-SF-Venus_Williams-Johanna_Konta,1,B-DTL,4,2,0,0,2,2,2
20170713-W-Wimbledon-SF-Venus_Williams-Johanna_Konta,1,B-IO,5,5,3,1,1,4,1
20170713-W-Wimbledon-SF-Venus_Williams-Johanna_Konta,1,S-XC,1,0,0,0,0,1,0
20170713-W-Wimbledon-SF-Venus_Williams-Johanna_Konta,1,S-DTM,3,1,0,0,1,0,3
20170713-W-Wimbledon-SF-Venus_Williams-Johanna_Konta,1,S-IO,1,1,0,0,1,0,1
20170713-W-Wimbledon-SF-Venus_Williams-Johanna_Konta,2,F-XC,22,7,3,0,4,7,15
20170713-W-Wimbledon-SF-Venus_Williams-Johanna_Konta,2,F-DTM,14,3,0,0,3,3,11
20170713-W-Wimbledon-SF-Venus_Williams-Johanna_Konta,2,F-DTL,4,4,2,0,2,2,2
20170713-W-Wimbledon-SF-Venus_Williams-Johanna_Konta,2,F-IO,13,7,4,0,3,8,5
20170713-W-Wimbledon-SF-Venus_Williams-Johanna_Konta,2,B-XC,15,5,1,1,3,8,7
20170713-W-Wimbledon-SF-Venus_Williams-Johanna_Konta,2,B-DTM,15,3,0,1,2,7,8
20170713-W-Wimbledon-SF-Venus_Williams-Johanna_Konta,2,B-DTL,4,2,1,0,1,1,3
20170713-W-Wimbledon-SF-Venus_Williams-Johanna_Konta,2,B-IO,2,2,1,0,1,1,1
20170713-W-Wimbledon-SF-Venus_Williams-Johanna_Konta,2,S-DTM,1,0,0,0,0,0,1
20170713-W-Wimbledon-SF-Venus_Williams-Johanna_Konta,2,S-DTL,2,0,0,0,0,1,1
20170713-W-Wimbledon-SF-Venus_Williams-Johanna_Konta,2,S-IO,1,1,0,0,1,0,1
20170708-W-Wimbledon-R32-Anett_Kontaveit-Caroline_Wozniacki,1,F-XC,54,14,5,2,7,22,32
20170708-W-Wimbledon-R32-Anett_Kontaveit-Caroline_Wozniacki,1,F-DTM,29,6,0,2,4,9,20
20170708-W-Wimbledon-R32-Anett_Kontaveit-Caroline_Wozniacki,1,F-DTL,20,14,7,1,6,11,9
20170708-W-Wimbledon-R32-Anett_Kontaveit-Caroline_Wozniacki,1,F-IO,20,11,5,1,5,11,9
20170708-W-Wimbledon-R32-Anett_Kontaveit-Caroline_Wozniacki,1,F-II,2,1,1,0,0,1,1
20170708-W-Wimbledon-R32-Anett_Kontaveit-Caroline_Wozniacki,1,B-XC,54,22,4,7,11,28,26
20170708-W-Wimbledon-R32-Anett_Kontaveit-Caroline_Wozniacki,1,B-DTM,30,6,0,0,6,8,22
20170708-W-Wimbledon-R32-Anett_Kontaveit-Caroline_Wozniacki,1,B-DTL,29,10,5,2,3,18,11
20170708-W-Wimbledon-R32-Anett_Kontaveit-Caroline_Wozniacki,1,B-IO,9,2,1,0,1,5,4
20170708-W-Wimbledon-R32-Anett_Kontaveit-Caroline_Wozniacki,1,S-DTM,3,0,0,0,0,0,3
20170708-W-Wimbledon-R32-Anett_Kontaveit-Caroline_Wozniacki,1,S-DTL,1,0,0,0,0,0,1
20170708-W-Wimbledon-R32-Anett_Kontaveit-Caroline_Wozniacki,2,F-XC,40,8,2,2,4,26,14
20170708-W-Wimbledon-R32-Anett_Kontaveit-Caroline_Wozniacki,2,F-DTM,26,1,0,1,0,16,10
20170708-W-Wimbledon-R32-Anett_Kontaveit-Caroline_Wozniacki,2,F-DTL,36,8,2,1,5,20,16
20170708-W-Wimbledon-R32-Anett_Kontaveit-Caroline_Wozniacki,2,F-IO,22,3,0,2,1,14,8
20170708-W-Wimbledon-R32-Anett_Kontaveit-Caroline_Wozniacki,2,B-XC,23,2,1,1,0,13,10
20170708-W-Wimbledon-R32-Anett_Kontaveit-Caroline_Wozniacki,2,B-DTM,26,1,0,0,1,12,14
20170708-W-Wimbledon-R32-Anett_Kontaveit-Caroline_Wozniacki,2,B-DTL,12,7,4,2,1,9,3
20170708-W-Wimbledon-R32-Anett_Kontaveit-Caroline_Wozniacki,2,B-IO,14,7,3,0,4,8,6
20170708-W-Wimbledon-R32-Anett_Kontaveit-Caroline_Wozniacki,2,S-XC,4,0,0,0,0,2,2
20170708-W-Wimbledon-R32-Anett_Kontaveit-Caroline_Wozniacki,2,S-DTM,9,0,0,0,0,5,4
20170708-W-Wimbledon-R32-Anett_Kontaveit-Caroline_Wozniacki,2,S-DTL,1,0,0,0,0,0,1
20170622-W-Birmingham-R16-Camila_Giorgi-Elina_Svitolina,1,F-XC,60,21,8,3,10,38,22
20170622-W-Birmingham-R16-Camila_Giorgi-Elina_Svitolina,1,F-DTM,37,6,0,1,5,21,16
20170622-W-Birmingham-R16-Camila_Giorgi-Elina_Svitolina,1,F-DTL,11,6,2,2,2,6,5
20170622-W-Birmingham-R16-Camila_Giorgi-Elina_Svitolina,1,F-IO,15,5,3,1,1,9,6
20170622-W-Birmingham-R16-Camila_Giorgi-Elina_Svitolina,1,B-XC,39,10,0,3,7,25,14
20170622-W-Birmingham-R16-Camila_Giorgi-Elina_Svitolina,1,B-DTM,29,5,0,1,4,16,13
20170622-W-Birmingham-R16-Camila_Giorgi-Elina_Svitolina,1,B-DTL,9,7,5,1,1,7,2
20170622-W-Birmingham-R16-Camila_Giorgi-Elina_Svitolina,1,B-IO,14,9,6,0,3,9,5
20170622-W-Birmingham-R16-Camila_Giorgi-Elina_Svitolina,1,S-DTM,1,0,0,0,0,1,0
20170622-W-Birmingham-R16-Camila_Giorgi-Elina_Svitolina,2,F-XC,40,10,4,1,5,16,24
20170622-W-Birmingham-R16-Camila_Giorgi-Elina_Svitolina,2,F-DTM,45,5,0,0,5,13,32
20170622-W-Birmingham-R16-Camila_Giorgi-Elina_Svitolina,2,F-DTL,2,1,1,0,0,2,0
20170622-W-Birmingham-R16-Camila_Giorgi-Elina_Svitolina,2,F-IO,13,6,3,1,2,9,4
20170622-W-Birmingham-R16-Camila_Giorgi-Elina_Svitolina,2,B-XC,30,6,2,3,1,10,20
20170622-W-Birmingham-R16-Camila_Giorgi-Elina_Svitolina,2,B-DTM,51,7,0,2,5,20,31
20170622-W-Birmingham-R16-Camila_Giorgi-Elina_Svitolina,2,B-DTL,3,0,0,0,0,0,3
20170622-W-Birmingham-R16-Camila_Giorgi-Elina_Svitolina,2,B-IO,2,2,1,0,1,1,1
20170622-W-Birmingham-R16-Camila_Giorgi-Elina_Svitolina,2,S-XC,1,0,0,0,0,0,1
20170622-W-Birmingham-R16-Camila_Giorgi-Elina_Svitolina,2,S-DTM,7,2,0,0,2,3,4
20170810-W-Toronto-R16-Angelique_Kerber-Sloane_Stephens,1,F-XC,37,6,1,1,4,20,17
20170810-W-Toronto-R16-Angelique_Kerber-Sloane_Stephens,1,F-DTM,10,2,0,1,1,3,7
20170810-W-Toronto-R16-Angelique_Kerber-Sloane_Stephens,1,F-DTL,17,11,5,2,4,10,7
20170810-W-Toronto-R16-Angelique_Kerber-Sloane_Stephens,1,F-IO,16,7,2,1,4,8,8
20170810-W-Toronto-R16-Angelique_Kerber-Sloane_Stephens,1,B-XC,35,5,1,2,2,18,17
20170810-W-Toronto-R16-Angelique_Kerber-Sloane_Stephens,1,B-DTM,18,3,0,0,3,6,12
20170810-W-Toronto-R16-Angelique_Kerber-Sloane_Stephens,1,B-DTL,12,6,0,2,4,5,7
20170810-W-Toronto-R16-Angelique_Kerber-Sloane_Stephens,1,B-IO,6,2,0,0,2,3,3
20170810-W-Toronto-R16-Angelique_Kerber-Sloane_Stephens,1,S-XC,1,0,0,0,0,0,1
20170810-W-Toronto-R16-Angelique_Kerber-Sloane_Stephens,1,S-DTM,2,0,0,0,0,1,1
20170810-W-Toronto-R16-Angelique_Kerber-Sloane_Stephens,2,F-XC,36,9,3,2,4,23,13
20170810-W-Toronto-R16-Angelique_Kerber-Sloane_Stephens,2,F-DTM,21,2,0,0,2,13,8
20170810-W-Toronto-R16-Angelique_Kerber-Sloane_Stephens,2,F-DTL,15,7,7,0,0,12,3
20170810-W-Toronto-R16-Angelique_Kerber-Sloane_Stephens,2,F-IO,9,3,2,1,0,5,4
20170810-W-Toronto-R16-Angelique_Kerber-Sloane_Stephens,2,B-XC,22,5,3,1,1,11,11
20170810-W-Toronto-R16-Angelique_Kerber-Sloane_Stephens,2,B-DTM,28,2,0,2,0,15,13
20170810-W-Toronto-R16-Angelique_Kerber-Sloane_Stephens,2,B-DTL,7,3,0,0,3,3,4
20170810-W-Toronto-R16-Angelique_Kerber-Sloane_Stephens,2,B-IO,3,1,0,0,1,0,3
20170810-W-Toronto-R16-Angelique_Kerber-Sloane_Stephens,2,S-XC,3,0,0,0,0,1,2
20170810-W-Toronto-R16-Angelique_Kerber-Sloane_Stephens,2,S-DTM,4,0,0,0,0,1,3
20170810-W-Toronto-R16-Angelique_Kerber-Sloane_Stephens,2,S-IO,1,1,0,1,0,1,0
20170812-W-Toronto-SF-Elina_Svitolina-Simona_Halep,1,F-XC,21,7,1,3,3,14,7
20170812-W-Toronto-SF-Elina_Svitolina-Simona_Halep,1,F-DTM,45,1,0,0,1,28,17
20170812-W-Toronto-SF-Elina_Svitolina-Simona_Halep,1,F-DTL,2,1,1,0,0,2,0
20170812-W-Toronto-SF-Elina_Svitolina-Simona_Halep,1,F-IO,9,3,2,1,0,8,1
20170812-W-Toronto-SF-Elina_Svitolina-Simona_Halep,1,B-XC,34,8,1,5,2,20,14
20170812-W-Toronto-SF-Elina_Svitolina-Simona_Halep,1,B-DTM,45,2,0,0,2,22,23
20170812-W-Toronto-SF-Elina_Svitolina-Simona_Halep,1,B-DTL,3,1,1,0,0,2,1
20170812-W-Toronto-SF-Elina_Svitolina-Simona_Halep,1,B-IO,1,0,0,0,0,0,1
20170812-W-Toronto-SF-Elina_Svitolina-Simona_Halep,1,S-XC,7,1,0,0,1,5,2
20170812-W-Toronto-SF-Elina_Svitolina-Simona_Halep,1,S-DTM,3,0,0,0,0,2,1
20170812-W-Toronto-SF-Elina_Svitolina-Simona_Halep,2,F-XC,37,10,3,4,3,20,17
20170812-W-Toronto-SF-Elina_Svitolina-Simona_Halep,2,F-DTM,37,3,0,0,3,9,28
20170812-W-Toronto-SF-Elina_Svitolina-Simona_Halep,2,F-DTL,8,2,0,0,2,4,4
20170812-W-Toronto-SF-Elina_Svitolina-Simona_Halep,2,F-IO,36,10,2,2,6,14,22
20170812-W-Toronto-SF-Elina_Svitolina-Simona_Halep,2,F-II,2,1,0,0,1,0,2
20170812-W-Toronto-SF-Elina_Svitolina-Simona_Halep,2,B-XC,29,4,1,1,2,12,17
20170812-W-Toronto-SF-Elina_Svitolina-Simona_Halep,2,B-DTM,28,6,0,0,6,12,16
20170812-W-Toronto-SF-Elina_Svitolina-Simona_Halep,2,B-DTL,5,3,0,2,1,3,2
20170812-W-Toronto-SF-Elina_Svitolina-Simona_Halep,2,B-IO,8,5,1,1,3,3,5
20170812-W-Toronto-SF-Elina_Svitolina-Simona_Halep,2,S-DTL,1,0,0,0,0,0,1
20160924-W-ITF_Saint_Petersburg-F-Natalia_Vikhlyantseva-Donna_Vekic,1,F-XC,34,6,3,0,3,13,21
20160924-W-ITF_Saint_Petersburg-F-Natalia_Vikhlyantseva-Donna_Vekic,1,F-DTM,13,1,0,0,1,3,10
20160924-W-ITF_Saint_Petersburg-F-Natalia_Vikhlyantseva-Donna_Vekic,1,F-DTL,18,8,2,2,4,8,10
20160924-W-ITF_Saint_Petersburg-F-Natalia_Vikhlyantseva-Donna_Vekic,1,F-IO,10,3,2,0,1,5,5
20160924-W-ITF_Saint_Petersburg-F-Natalia_Vikhlyantseva-Donna_Vekic,1,B-XC,29,12,4,2,6,13,16
20160924-W-ITF_Saint_Petersburg-F-Natalia_Vikhlyantseva-Donna_Vekic,1,B-DTM,20,0,0,0,0,8,12
20160924-W-ITF_Saint_Petersburg-F-Natalia_Vikhlyantseva-Donna_Vekic,1,B-DTL,13,4,0,2,2,5,8
20160924-W-ITF_Saint_Petersburg-F-Natalia_Vikhlyantseva-Donna_Vekic,1,B-IO,5,3,1,1,1,3,2
20160924-W-ITF_Saint_Petersburg-F-Natalia_Vikhlyantseva-Donna_Vekic,1,S-DTM,1,0,0,0,0,0,1
20160924-W-ITF_Saint_Petersburg-F-Natalia_Vikhlyantseva-Donna_Vekic,1,S-DTL,1,0,0,0,0,0,1
20160924-W-ITF_Saint_Petersburg-F-Natalia_Vikhlyantseva-Donna_Vekic,2,F-XC,33,6,3,1,2,21,12
20160924-W-ITF_Saint_Petersburg-F-Natalia_Vikhlyantseva-Donna_Vekic,2,F-DTM,14,1,0,1,0,10,4
20160924-W-ITF_Saint_Petersburg-F-Natalia_Vikhlyantseva-Donna_Vekic,2,F-DTL,8,3,1,1,1,4,4
20160924-W-ITF_Saint_Petersburg-F-Natalia_Vikhlyantseva-Donna_Vekic,2,F-IO,9,5,1,3,1,7,2
20160924-W-ITF_Saint_Petersburg-F-Natalia_Vikhlyantseva-Donna_Vekic,2,B-XC,20,4,0,1,3,11,9
20160924-W-ITF_Saint_Petersburg-F-Natalia_Vikhlyantseva-Donna_Vekic,2,B-DTM,27,5,0,0,5,14,13
20160924-W-ITF_Saint_Petersburg-F-Natalia_Vikhlyantseva-Donna_Vekic,2,B-DTL,7,4,1,0,3,3,4
20160924-W-ITF_Saint_Petersburg-F-Natalia_Vikhlyantseva-Donna_Vekic,2,B-IO,5,1,0,0,1,3,2
20160924-W-ITF_Saint_Petersburg-F-Natalia_Vikhlyantseva-Donna_Vekic,2,S-XC,1,0,0,0,0,0,1
20160924-W-ITF_Saint_Petersburg-F-Natalia_Vikhlyantseva-Donna_Vekic,2,S-DTM,1,0,0,0,0,0,1
20160924-W-ITF_Saint_Petersburg-F-Natalia_Vikhlyantseva-Donna_Vekic,2,S-DTL,1,0,0,0,0,0,1
20170815-W-Cincinnati-R32-Simona_Halep-Taylor_Townsend,1,F-XC,39,8,5,2,1,31,8
20170815-W-Cincinnati-R32-Simona_Halep-Taylor_Townsend,1,F-DTM,11,1,0,1,0,11,0
20170815-W-Cincinnati-R32-Simona_Halep-Taylor_Townsend,1,F-DTL,8,2,0,0,2,4,4
20170815-W-Cincinnati-R32-Simona_Halep-Taylor_Townsend,1,F-IO,8,5,3,0,2,4,4
20170815-W-Cincinnati-R32-Simona_Halep-Taylor_Townsend,1,F-II,1,0,0,0,0,1,0
20170815-W-Cincinnati-R32-Simona_Halep-Taylor_Townsend,1,B-XC,29,10,3,3,4,14,15
20170815-W-Cincinnati-R32-Simona_Halep-Taylor_Townsend,1,B-DTM,17,1,0,1,0,11,6
20170815-W-Cincinnati-R32-Simona_Halep-Taylor_Townsend,1,B-DTL,7,4,2,0,2,4,3
20170815-W-Cincinnati-R32-Simona_Halep-Taylor_Townsend,1,B-IO,4,1,0,1,0,3,1
20170815-W-Cincinnati-R32-Simona_Halep-Taylor_Townsend,1,S-XC,1,1,1,0,0,1,0
20170815-W-Cincinnati-R32-Simona_Halep-Taylor_Townsend,1,S-DTM,2,0,0,0,0,1,1
20170815-W-Cincinnati-R32-Simona_Halep-Taylor_Townsend,1,S-DTL,2,1,0,1,0,2,0
20170815-W-Cincinnati-R32-Simona_Halep-Taylor_Townsend,2,F-XC,40,14,1,1,12,13,27
20170815-W-Cincinnati-R32-Simona_Halep-Taylor_Townsend,2,F-DTM,5,0,0,0,0,2,3
20170815-W-Cincinnati-R32-Simona_Halep-Taylor_Townsend,2,F-DTL,9,6,5,1,0,8,1
20170815-W-Cincinnati-R32-Simona_Halep-Taylor_Townsend,2,F-IO,9,3,1,0,2,1,8
20170815-W-Cincinnati-R32-Simona_Halep-Taylor_Townsend,2,F-II,3,1,0,0,1,0,3
20170815-W-Cincinnati-R32-Simona_Halep-Taylor_Townsend,2,B-XC,14,2,0,0,2,2,12
20170815-W-Cincinnati-R32-Simona_Halep-Taylor_Townsend,2,B-DTM,13,5,0,0,5,3,10
20170815-W-Cincinnati-R32-Simona_Halep-Taylor_Townsend,2,B-DTL,4,1,0,0,1,1,3
20170815-W-Cincinnati-R32-Simona_Halep-Taylor_Townsend,2,B-IO,1,0,0,0,0,0,1
20170815-W-Cincinnati-R32-Simona_Halep-Taylor_Townsend,2,S-XC,5,1,0,0,1,1,4
20170815-W-Cincinnati-R32-Simona_Halep-Taylor_Townsend,2,S-DTM,6,0,0,0,0,0,6
20170815-W-Cincinnati-R32-Simona_Halep-Taylor_Townsend,2,S-DTL,2,0,0,0,0,2,0
20170815-W-Cincinnati-R32-Simona_Halep-Taylor_Townsend,2,S-IO,1,0,0,0,0,1,0
20170907-W-US_Open-SF-Madison_Keys-Coco_Vandeweghe,1,F-XC,11,6,3,2,1,10,1
20170907-W-US_Open-SF-Madison_Keys-Coco_Vandeweghe,1,F-DTM,6,1,1,0,0,5,1
20170907-W-US_Open-SF-Madison_Keys-Coco_Vandeweghe,1,F-DTL,2,1,0,1,0,1,1
20170907-W-US_Open-SF-Madison_Keys-Coco_Vandeweghe,1,F-IO,18,9,5,2,2,13,5
20170907-W-US_Open-SF-Madison_Keys-Coco_Vandeweghe,1,F-II,1,1,1,0,0,1,0
20170907-W-US_Open-SF-Madison_Keys-Coco_Vandeweghe,1,B-XC,15,4,2,0,2,11,4
20170907-W-US_Open-SF-Madison_Keys-Coco_Vandeweghe,1,B-DTM,11,2,1,1,0,10,1
20170907-W-US_Open-SF-Madison_Keys-Coco_Vandeweghe,1,B-DTL,3,1,1,0,0,3,0
20170907-W-US_Open-SF-Madison_Keys-Coco_Vandeweghe,1,B-IO,6,5,2,1,2,4,2
20170907-W-US_Open-SF-Madison_Keys-Coco_Vandeweghe,1,S-XC,1,0,0,0,0,0,1
20170907-W-US_Open-SF-Madison_Keys-Coco_Vandeweghe,1,S-DTM,1,0,0,0,0,1,0
20170907-W-US_Open-SF-Madison_Keys-Coco_Vandeweghe,1,S-DTL,1,0,0,0,0,0,1
20170907-W-US_Open-SF-Madison_Keys-Coco_Vandeweghe,2,F-XC,8,4,2,0,2,2,6
20170907-W-US_Open-SF-Madison_Keys-Coco_Vandeweghe,2,F-DTM,14,4,0,0,4,3,11
20170907-W-US_Open-SF-Madison_Keys-Coco_Vandeweghe,2,F-DTL,5,2,0,0,2,1,4
20170907-W-US_Open-SF-Madison_Keys-Coco_Vandeweghe,2,F-IO,6,2,0,1,1,3,3
20170907-W-US_Open-SF-Madison_Keys-Coco_Vandeweghe,2,F-II,2,2,2,0,0,2,0
20170907-W-US_Open-SF-Madison_Keys-Coco_Vandeweghe,2,B-XC,12,4,0,1,3,2,10
20170907-W-US_Open-SF-Madison_Keys-Coco_Vandeweghe,2,B-DTM,8,0,0,0,0,2,6
20170907-W-US_Open-SF-Madison_Keys-Coco_Vandeweghe,2,B-DTL,1,1,0,1,0,1,0
20170907-W-US_Open-SF-Madison_Keys-Coco_Vandeweghe,2,B-IO,1,0,0,0,0,0,1
20170907-W-US_Open-SF-Madison_Keys-Coco_Vandeweghe,2,S-XC,5,1,0,0,1,1,4
20170907-W-US_Open-SF-Madison_Keys-Coco_Vandeweghe,2,S-DTM,4,0,0,0,0,0,4
20170907-W-US_Open-SF-Madison_Keys-Coco_Vandeweghe,2,S-DTL,1,1,0,0,1,0,1
20170904-W-US_Open-R16-Garbine_Muguruza-Petra_Kvitova,1,F-XC,44,9,1,1,7,19,25
20170904-W-US_Open-R16-Garbine_Muguruza-Petra_Kvitova,1,F-DTM,32,2,0,0,2,17,15
20170904-W-US_Open-R16-Garbine_Muguruza-Petra_Kvitova,1,F-DTL,12,4,0,2,2,3,9
20170904-W-US_Open-R16-Garbine_Muguruza-Petra_Kvitova,1,F-IO,11,6,1,0,5,3,8
20170904-W-US_Open-R16-Garbine_Muguruza-Petra_Kvitova,1,B-XC,15,3,1,0,2,7,8
20170904-W-US_Open-R16-Garbine_Muguruza-Petra_Kvitova,1,B-DTM,26,1,0,0,1,18,8
20170904-W-US_Open-R16-Garbine_Muguruza-Petra_Kvitova,1,B-DTL,9,3,1,0,2,4,5
20170904-W-US_Open-R16-Garbine_Muguruza-Petra_Kvitova,1,B-IO,11,2,0,2,0,5,6
20170904-W-US_Open-R16-Garbine_Muguruza-Petra_Kvitova,1,S-DTM,1,0,0,0,0,0,1
20170904-W-US_Open-R16-Garbine_Muguruza-Petra_Kvitova,1,S-DTL,1,0,0,0,0,1,0
20170904-W-US_Open-R16-Garbine_Muguruza-Petra_Kvitova,2,F-XC,45,16,3,7,6,22,23
20170904-W-US_Open-R16-Garbine_Muguruza-Petra_Kvitova,2,F-DTM,17,3,0,0,3,8,9
20170904-W-US_Open-R16-Garbine_Muguruza-Petra_Kvitova,2,F-DTL,7,4,3,0,1,5,2
20170904-W-US_Open-R16-Garbine_Muguruza-Petra_Kvitova,2,F-IO,24,13,3,5,5,15,9
20170904-W-US_Open-R16-Garbine_Muguruza-Petra_Kvitova,2,F-II,1,1,0,1,0,1,0
20170904-W-US_Open-R16-Garbine_Muguruza-Petra_Kvitova,2,B-XC,43,10,2,2,6,25,18
20170904-W-US_Open-R16-Garbine_Muguruza-Petra_Kvitova,2,B-DTM,25,2,0,0,2,9,16
20170904-W-US_Open-R16-Garbine_Muguruza-Petra_Kvitova,2,B-DTL,7,4,1,0,3,3,4
20170904-W-US_Open-R16-Garbine_Muguruza-Petra_Kvitova,2,B-IO,5,2,0,1,1,2,3
20170904-W-US_Open-R16-Garbine_Muguruza-Petra_Kvitova,2,S-XC,4,0,0,0,0,3,1
20170904-W-US_Open-R16-Garbine_Muguruza-Petra_Kvitova,2,S-DTM,2,0,0,0,0,1,1
20170902-W-US_Open-R32-Daria_Kasatkina-Jelena_Ostapenko,1,F-XC,20,7,2,4,1,13,7
20170902-W-US_Open-R32-Daria_Kasatkina-Jelena_Ostapenko,1,F-DTM,18,1,0,0,1,8,10
20170902-W-US_Open-R32-Daria_Kasatkina-Jelena_Ostapenko,1,F-DTL,6,1,1,0,0,5,1
20170902-W-US_Open-R32-Daria_Kasatkina-Jelena_Ostapenko,1,F-IO,11,4,0,0,4,4,7
20170902-W-US_Open-R32-Daria_Kasatkina-Jelena_Ostapenko,1,F-II,1,1,0,0,1,0,1
20170902-W-US_Open-R32-Daria_Kasatkina-Jelena_Ostapenko,1,B-XC,16,1,0,0,1,12,4
20170902-W-US_Open-R32-Daria_Kasatkina-Jelena_Ostapenko,1,B-DTM,13,0,0,0,0,10,3
20170902-W-US_Open-R32-Daria_Kasatkina-Jelena_Ostapenko,1,B-DTL,4,1,0,0,1,2,2
20170902-W-US_Open-R32-Daria_Kasatkina-Jelena_Ostapenko,1,B-IO,2,1,1,0,0,1,1
20170902-W-US_Open-R32-Daria_Kasatkina-Jelena_Ostapenko,1,S-XC,18,0,0,0,0,10,8
20170902-W-US_Open-R32-Daria_Kasatkina-Jelena_Ostapenko,1,S-DTM,13,0,0,0,0,10,3
20170902-W-US_Open-R32-Daria_Kasatkina-Jelena_Ostapenko,1,S-DTL,1,0,0,0,0,1,0
20170902-W-US_Open-R32-Daria_Kasatkina-Jelena_Ostapenko,2,F-XC,41,19,3,5,11,19,22
20170902-W-US_Open-R32-Daria_Kasatkina-Jelena_Ostapenko,2,F-DTM,5,0,0,0,0,4,1
20170902-W-US_Open-R32-Daria_Kasatkina-Jelena_Ostapenko,2,F-DTL,4,3,0,1,2,2,2
20170902-W-US_Open-R32-Daria_Kasatkina-Jelena_Ostapenko,2,F-IO,21,11,3,1,7,7,14
20170902-W-US_Open-R32-Daria_Kasatkina-Jelena_Ostapenko,2,F-II,1,0,0,0,0,0,1
20170902-W-US_Open-R32-Daria_Kasatkina-Jelena_Ostapenko,2,B-XC,38,5,2,1,2,12,26
20170902-W-US_Open-R32-Daria_Kasatkina-Jelena_Ostapenko,2,B-DTM,22,2,0,0,2,9,13
20170902-W-US_Open-R32-Daria_Kasatkina-Jelena_Ostapenko,2,B-DTL,18,10,3,1,6,6,12
20170902-W-US_Open-R32-Daria_Kasatkina-Jelena_Ostapenko,2,B-IO,5,3,2,0,1,2,3
20170902-W-US_Open-R32-Daria_Kasatkina-Jelena_Ostapenko,2,S-DTL,2,0,0,0,0,1,1
20170920-W-Tokyo-R16-Monica_Puig-Garbine_Muguruza,1,F-XC,26,10,3,2,5,8,18
20170920-W-Tokyo-R16-Monica_Puig-Garbine_Muguruza,1,F-DTM,15,1,0,0,1,4,11
20170920-W-Tokyo-R16-Monica_Puig-Garbine_Muguruza,1,F-DTL,12,9,3,0,6,5,7
20170920-W-Tokyo-R16-Monica_Puig-Garbine_Muguruza,1,F-IO,7,3,1,0,2,4,3
20170920-W-Tokyo-R16-Monica_Puig-Garbine_Muguruza,1,B-XC,23,7,2,3,2,9,14
20170920-W-Tokyo-R16-Monica_Puig-Garbine_Muguruza,1,B-DTM,23,2,0,0,2,8,15
20170920-W-Tokyo-R16-Monica_Puig-Garbine_Muguruza,1,B-DTL,5,1,1,0,0,3,2
20170920-W-Tokyo-R16-Monica_Puig-Garbine_Muguruza,1,B-IO,6,2,1,0,1,2,4
20170920-W-Tokyo-R16-Monica_Puig-Garbine_Muguruza,1,S-DTM,1,0,0,0,0,0,1
20170920-W-Tokyo-R16-Monica_Puig-Garbine_Muguruza,2,F-XC,21,2,0,0,2,15,6
20170920-W-Tokyo-R16-Monica_Puig-Garbine_Muguruza,2,F-DTM,16,2,0,1,1,8,8
20170920-W-Tokyo-R16-Monica_Puig-Garbine_Muguruza,2,F-DTL,8,3,1,1,1,6,2
20170920-W-Tokyo-R16-Monica_Puig-Garbine_Muguruza,2,F-IO,4,1,0,1,0,3,1
20170920-W-Tokyo-R16-Monica_Puig-Garbine_Muguruza,2,B-XC,21,3,0,2,1,13,8
20170920-W-Tokyo-R16-Monica_Puig-Garbine_Muguruza,2,B-DTM,27,1,0,0,1,14,13
20170920-W-Tokyo-R16-Monica_Puig-Garbine_Muguruza,2,B-DTL,3,3,3,0,0,3,0
20170920-W-Tokyo-R16-Monica_Puig-Garbine_Muguruza,2,B-IO,6,1,1,0,0,6,0
20170922-W-Tokyo-QF-Caroline_Garcia-Garbine_Muguruza,1,F-XC,47,8,3,1,4,21,26
20170922-W-Tokyo-QF-Caroline_Garcia-Garbine_Muguruza,1,F-DTM,16,3,1,0,2,6,10
20170922-W-Tokyo-QF-Caroline_Garcia-Garbine_Muguruza,1,F-DTL,12,9,3,1,5,5,7
20170922-W-Tokyo-QF-Caroline_Garcia-Garbine_Muguruza,1,F-IO,5,2,1,0,1,2,3
20170922-W-Tokyo-QF-Caroline_Garcia-Garbine_Muguruza,1,B-XC,26,6,1,0,5,10,16
20170922-W-Tokyo-QF-Caroline_Garcia-Garbine_Muguruza,1,B-DTM,12,3,0,2,1,6,6
20170922-W-Tokyo-QF-Caroline_Garcia-Garbine_Muguruza,1,B-DTL,5,4,1,0,3,1,4
20170922-W-Tokyo-QF-Caroline_Garcia-Garbine_Muguruza,1,B-IO,4,0,0,0,0,3,1
20170922-W-Tokyo-QF-Caroline_Garcia-Garbine_Muguruza,1,S-DTM,2,0,0,0,0,0,2
20170922-W-Tokyo-QF-Caroline_Garcia-Garbine_Muguruza,1,S-DTL,1,0,0,0,0,1,0
20170922-W-Tokyo-QF-Caroline_Garcia-Garbine_Muguruza,2,F-XC,31,5,2,1,2,20,11
20170922-W-Tokyo-QF-Caroline_Garcia-Garbine_Muguruza,2,F-DTM,14,1,0,1,0,8,6
20170922-W-Tokyo-QF-Caroline_Garcia-Garbine_Muguruza,2,F-DTL,14,4,3,1,0,11,3
20170922-W-Tokyo-QF-Caroline_Garcia-Garbine_Muguruza,2,F-IO,6,2,0,1,1,5,1
20170922-W-Tokyo-QF-Caroline_Garcia-Garbine_Muguruza,2,B-XC,22,7,2,1,4,10,12
20170922-W-Tokyo-QF-Caroline_Garcia-Garbine_Muguruza,2,B-DTM,24,1,0,0,1,11,13
20170922-W-Tokyo-QF-Caroline_Garcia-Garbine_Muguruza,2,B-DTL,7,2,0,1,1,6,1
20170922-W-Tokyo-QF-Caroline_Garcia-Garbine_Muguruza,2,B-IO,3,0,0,0,0,2,1
20170923-W-Tokyo-SF-Caroline_Wozniacki-Garbine_Muguruza,1,F-XC,27,8,2,3,3,17,10
20170923-W-Tokyo-SF-Caroline_Wozniacki-Garbine_Muguruza,1,F-DTM,15,2,0,0,2,9,6
20170923-W-Tokyo-SF-Caroline_Wozniacki-Garbine_Muguruza,1,F-DTL,14,6,4,1,1,8,6
20170923-W-Tokyo-SF-Caroline_Wozniacki-Garbine_Muguruza,1,F-IO,4,0,0,0,0,4,0
20170923-W-Tokyo-SF-Caroline_Wozniacki-Garbine_Muguruza,1,B-XC,26,2,0,1,1,17,9
20170923-W-Tokyo-SF-Caroline_Wozniacki-Garbine_Muguruza,1,B-DTM,10,0,0,0,0,6,4
20170923-W-Tokyo-SF-Caroline_Wozniacki-Garbine_Muguruza,1,B-DTL,9,3,1,1,1,6,3
20170923-W-Tokyo-SF-Caroline_Wozniacki-Garbine_Muguruza,1,B-IO,10,3,1,0,2,6,4
20170923-W-Tokyo-SF-Caroline_Wozniacki-Garbine_Muguruza,1,S-XC,2,0,0,0,0,2,0
20170923-W-Tokyo-SF-Caroline_Wozniacki-Garbine_Muguruza,1,S-IO,1,0,0,0,0,1,0
20170923-W-Tokyo-SF-Caroline_Wozniacki-Garbine_Muguruza,2,F-XC,27,6,2,1,3,12,15
20170923-W-Tokyo-SF-Caroline_Wozniacki-Garbine_Muguruza,2,F-DTM,13,1,0,0,1,3,10
20170923-W-Tokyo-SF-Caroline_Wozniacki-Garbine_Muguruza,2,F-DTL,7,4,0,1,3,2,5
20170923-W-Tokyo-SF-Caroline_Wozniacki-Garbine_Muguruza,2,F-IO,7,2,0,0,2,1,6
20170923-W-Tokyo-SF-Caroline_Wozniacki-Garbine_Muguruza,2,B-XC,34,10,1,0,9,10,24
20170923-W-Tokyo-SF-Caroline_Wozniacki-Garbine_Muguruza,2,B-DTM,16,0,0,0,0,6,10
20170923-W-Tokyo-SF-Caroline_Wozniacki-Garbine_Muguruza,2,B-DTL,11,5,1,1,3,3,8
20170923-W-Tokyo-SF-Caroline_Wozniacki-Garbine_Muguruza,2,B-IO,8,3,2,0,1,4,4
20170928-W-Wuhan-QF-Jelena_Ostapenko-Garbine_Muguruza,1,F-XC,86,23,5,8,10,49,37
20170928-W-Wuhan-QF-Jelena_Ostapenko-Garbine_Muguruza,1,F-DTM,10,0,0,0,0,6,4
20170928-W-Wuhan-QF-Jelena_Ostapenko-Garbine_Muguruza,1,F-DTL,10,6,4,1,1,7,3
20170928-W-Wuhan-QF-Jelena_Ostapenko-Garbine_Muguruza,1,F-IO,11,6,2,1,3,5,6
20170928-W-Wuhan-QF-Jelena_Ostapenko-Garbine_Muguruza,1,B-XC,51,16,4,4,8,30,21
20170928-W-Wuhan-QF-Jelena_Ostapenko-Garbine_Muguruza,1,B-DTM,24,2,0,1,1,17,7
20170928-W-Wuhan-QF-Jelena_Ostapenko-Garbine_Muguruza,1,B-DTL,17,11,3,2,6,8,9
20170928-W-Wuhan-QF-Jelena_Ostapenko-Garbine_Muguruza,1,B-IO,7,4,0,1,3,3,4
20170928-W-Wuhan-QF-Jelena_Ostapenko-Garbine_Muguruza,1,S-XC,3,0,0,0,0,1,2
20170928-W-Wuhan-QF-Jelena_Ostapenko-Garbine_Muguruza,2,F-XC,38,6,0,2,4,13,25
20170928-W-Wuhan-QF-Jelena_Ostapenko-Garbine_Muguruza,2,F-DTM,35,4,0,1,3,12,23
20170928-W-Wuhan-QF-Jelena_Ostapenko-Garbine_Muguruza,2,F-DTL,18,5,2,1,2,11,7
20170928-W-Wuhan-QF-Jelena_Ostapenko-Garbine_Muguruza,2,F-IO,7,2,0,0,2,4,3
20170928-W-Wuhan-QF-Jelena_Ostapenko-Garbine_Muguruza,2,B-XC,34,4,0,1,3,10,24
20170928-W-Wuhan-QF-Jelena_Ostapenko-Garbine_Muguruza,2,B-DTM,41,2,0,1,1,16,25
20170928-W-Wuhan-QF-Jelena_Ostapenko-Garbine_Muguruza,2,B-DTL,9,4,2,1,1,6,3
20170928-W-Wuhan-QF-Jelena_Ostapenko-Garbine_Muguruza,2,B-IO,8,2,0,1,1,5,3
20170924-W-Tokyo-F-Caroline_Wozniacki-Anastasia_Pavlyuchenkova,1,F-XC,30,6,2,3,1,20,10
20170924-W-Tokyo-F-Caroline_Wozniacki-Anastasia_Pavlyuchenkova,1,F-DTM,16,1,0,1,0,8,8
20170924-W-Tokyo-F-Caroline_Wozniacki-Anastasia_Pavlyuchenkova,1,F-DTL,15,1,0,0,1,11,4
20170924-W-Tokyo-F-Caroline_Wozniacki-Anastasia_Pavlyuchenkova,1,F-IO,6,0,0,0,0,5,1
20170924-W-Tokyo-F-Caroline_Wozniacki-Anastasia_Pavlyuchenkova,1,B-XC,17,3,1,1,1,12,5
20170924-W-Tokyo-F-Caroline_Wozniacki-Anastasia_Pavlyuchenkova,1,B-DTM,14,0,0,0,0,7,7
20170924-W-Tokyo-F-Caroline_Wozniacki-Anastasia_Pavlyuchenkova,1,B-DTL,7,5,3,2,0,6,1
20170924-W-Tokyo-F-Caroline_Wozniacki-Anastasia_Pavlyuchenkova,1,B-IO,4,2,1,1,0,4,0
20170924-W-Tokyo-F-Caroline_Wozniacki-Anastasia_Pavlyuchenkova,1,S-XC,1,0,0,0,0,1,0
20170924-W-Tokyo-F-Caroline_Wozniacki-Anastasia_Pavlyuchenkova,1,S-DTM,1,0,0,0,0,1,0
20170924-W-Tokyo-F-Caroline_Wozniacki-Anastasia_Pavlyuchenkova,2,F-XC,34,5,1,2,2,17,17
20170924-W-Tokyo-F-Caroline_Wozniacki-Anastasia_Pavlyuchenkova,2,F-DTM,10,3,0,0,3,2,8
20170924-W-Tokyo-F-Caroline_Wozniacki-Anastasia_Pavlyuchenkova,2,F-DTL,15,9,8,0,1,11,4
20170924-W-Tokyo-F-Caroline_Wozniacki-Anastasia_Pavlyuchenkova,2,F-IO,7,2,1,0,1,1,6
20170924-W-Tokyo-F-Caroline_Wozniacki-Anastasia_Pavlyuchenkova,2,F-II,1,0,0,0,0,0,1
20170924-W-Tokyo-F-Caroline_Wozniacki-Anastasia_Pavlyuchenkova,2,B-XC,24,7,3,0,4,8,16
20170924-W-Tokyo-F-Caroline_Wozniacki-Anastasia_Pavlyuchenkova,2,B-DTM,9,1,0,0,1,1,8
20170924-W-Tokyo-F-Caroline_Wozniacki-Anastasia_Pavlyuchenkova,2,B-DTL,11,5,2,0,3,3,8
20170924-W-Tokyo-F-Caroline_Wozniacki-Anastasia_Pavlyuchenkova,2,B-IO,9,3,1,1,1,6,3
20170924-W-Tokyo-F-Caroline_Wozniacki-Anastasia_Pavlyuchenkova,2,S-DTM,2,1,0,0,1,0,2
20171002-W-Beijing-R32-Caroline_Wozniacki-Anastasia_Pavlyuchenkova,1,F-XC,44,11,5,4,2,25,19
20171002-W-Beijing-R32-Caroline_Wozniacki-Anastasia_Pavlyuchenkova,1,F-DTM,29,2,0,0,2,14,15
20171002-W-Beijing-R32-Caroline_Wozniacki-Anastasia_Pavlyuchenkova,1,F-DTL,18,4,1,1,2,7,11
20171002-W-Beijing-R32-Caroline_Wozniacki-Anastasia_Pavlyuchenkova,1,F-IO,6,2,1,0,1,4,2
20171002-W-Beijing-R32-Caroline_Wozniacki-Anastasia_Pavlyuchenkova,1,F-II,1,0,0,0,0,1,0
20171002-W-Beijing-R32-Caroline_Wozniacki-Anastasia_Pavlyuchenkova,1,B-XC,31,4,2,1,1,17,14
20171002-W-Beijing-R32-Caroline_Wozniacki-Anastasia_Pavlyuchenkova,1,B-DTM,15,1,0,0,1,7,8
20171002-W-Beijing-R32-Caroline_Wozniacki-Anastasia_Pavlyuchenkova,1,B-DTL,11,6,0,3,3,4,7
20171002-W-Beijing-R32-Caroline_Wozniacki-Anastasia_Pavlyuchenkova,1,B-IO,8,3,0,0,3,1,7
20171002-W-Beijing-R32-Caroline_Wozniacki-Anastasia_Pavlyuchenkova,1,S-DTM,4,1,0,0,1,0,4
20171002-W-Beijing-R32-Caroline_Wozniacki-Anastasia_Pavlyuchenkova,2,F-XC,48,9,2,1,6,25,23
20171002-W-Beijing-R32-Caroline_Wozniacki-Anastasia_Pavlyuchenkova,2,F-DTM,13,1,0,0,1,5,8
20171002-W-Beijing-R32-Caroline_Wozniacki-Anastasia_Pavlyuchenkova,2,F-DTL,11,3,1,0,2,5,6
20171002-W-Beijing-R32-Caroline_Wozniacki-Anastasia_Pavlyuchenkova,2,F-IO,5,2,1,0,1,2,3
20171002-W-Beijing-R32-Caroline_Wozniacki-Anastasia_Pavlyuchenkova,2,B-XC,23,2,0,1,1,17,6
20171002-W-Beijing-R32-Caroline_Wozniacki-Anastasia_Pavlyuchenkova,2,B-DTM,24,2,0,0,2,7,17
20171002-W-Beijing-R32-Caroline_Wozniacki-Anastasia_Pavlyuchenkova,2,B-DTL,11,2,1,0,1,7,4
20171002-W-Beijing-R32-Caroline_Wozniacki-Anastasia_Pavlyuchenkova,2,B-IO,12,2,0,0,2,5,7
20171002-W-Beijing-R32-Caroline_Wozniacki-Anastasia_Pavlyuchenkova,2,S-XC,1,0,0,0,0,0,1
20171002-W-Beijing-R32-Caroline_Wozniacki-Anastasia_Pavlyuchenkova,2,S-DTM,2,0,0,0,0,1,1
20171002-W-Beijing-R32-Caroline_Wozniacki-Anastasia_Pavlyuchenkova,2,S-DTL,1,0,0,0,0,1,0
20170809-W-Toronto-R32-Karolina_Pliskova-Anastasia_Pavlyuchenkova,1,F-XC,22,5,1,3,1,14,8
20170809-W-Toronto-R32-Karolina_Pliskova-Anastasia_Pavlyuchenkova,1,F-DTM,8,2,0,2,0,5,3
20170809-W-Toronto-R32-Karolina_Pliskova-Anastasia_Pavlyuchenkova,1,F-DTL,3,2,1,1,0,3,0
20170809-W-Toronto-R32-Karolina_Pliskova-Anastasia_Pavlyuchenkova,1,F-IO,9,5,2,2,1,6,3
20170809-W-Toronto-R32-Karolina_Pliskova-Anastasia_Pavlyuchenkova,1,B-XC,15,3,2,1,0,9,6
20170809-W-Toronto-R32-Karolina_Pliskova-Anastasia_Pavlyuchenkova,1,B-DTM,17,2,0,2,0,10,7
20170809-W-Toronto-R32-Karolina_Pliskova-Anastasia_Pavlyuchenkova,1,B-DTL,3,2,0,1,1,2,1
20170809-W-Toronto-R32-Karolina_Pliskova-Anastasia_Pavlyuchenkova,1,B-IO,7,2,1,0,1,5,2
20170809-W-Toronto-R32-Karolina_Pliskova-Anastasia_Pavlyuchenkova,1,S-DTM,1,0,0,0,0,1,0
20170809-W-Toronto-R32-Karolina_Pliskova-Anastasia_Pavlyuchenkova,1,S-DTL,1,0,0,0,0,0,1
20170809-W-Toronto-R32-Karolina_Pliskova-Anastasia_Pavlyuchenkova,2,F-XC,21,8,4,2,2,10,11
20170809-W-Toronto-R32-Karolina_Pliskova-Anastasia_Pavlyuchenkova,2,F-DTM,14,2,0,1,1,4,10
20170809-W-Toronto-R32-Karolina_Pliskova-Anastasia_Pavlyuchenkova,2,F-DTL,9,5,1,1,3,5,4
20170809-W-Toronto-R32-Karolina_Pliskova-Anastasia_Pavlyuchenkova,2,F-IO,4,2,2,0,0,2,2
20170809-W-Toronto-R32-Karolina_Pliskova-Anastasia_Pavlyuchenkova,2,B-XC,13,3,1,0,2,4,9
20170809-W-Toronto-R32-Karolina_Pliskova-Anastasia_Pavlyuchenkova,2,B-DTM,16,3,1,0,2,4,12
20170809-W-Toronto-R32-Karolina_Pliskova-Anastasia_Pavlyuchenkova,2,B-DTL,4,3,1,0,2,1,3
20170809-W-Toronto-R32-Karolina_Pliskova-Anastasia_Pavlyuchenkova,2,B-IO,1,1,0,1,0,1,0
20170809-W-Toronto-R32-Karolina_Pliskova-Anastasia_Pavlyuchenkova,2,S-DTL,1,0,0,0,0,1,0
20171013-W-Hong_Kong-QF-Naomi_Osaka-Anastasia_Pavlyuchenkova,1,F-XC,19,6,1,1,4,8,11
20171013-W-Hong_Kong-QF-Naomi_Osaka-Anastasia_Pavlyuchenkova,1,F-DTM,20,3,0,0,3,8,12
20171013-W-Hong_Kong-QF-Naomi_Osaka-Anastasia_Pavlyuchenkova,1,F-DTL,3,2,2,0,0,2,1
20171013-W-Hong_Kong-QF-Naomi_Osaka-Anastasia_Pavlyuchenkova,1,F-IO,13,9,5,0,4,8,5
20171013-W-Hong_Kong-QF-Naomi_Osaka-Anastasia_Pavlyuchenkova,1,B-XC,21,5,1,2,2,11,10
20171013-W-Hong_Kong-QF-Naomi_Osaka-Anastasia_Pavlyuchenkova,1,B-DTM,13,2,0,0,2,4,9
20171013-W-Hong_Kong-QF-Naomi_Osaka-Anastasia_Pavlyuchenkova,1,B-DTL,3,0,0,0,0,1,2
20171013-W-Hong_Kong-QF-Naomi_Osaka-Anastasia_Pavlyuchenkova,1,B-IO,4,2,1,1,0,3,1
20171013-W-Hong_Kong-QF-Naomi_Osaka-Anastasia_Pavlyuchenkova,1,S-DTM,2,0,0,0,0,0,2
20171013-W-Hong_Kong-QF-Naomi_Osaka-Anastasia_Pavlyuchenkova,1,S-DTL,1,0,0,0,0,0,1
20171013-W-Hong_Kong-QF-Naomi_Osaka-Anastasia_Pavlyuchenkova,2,F-XC,15,7,3,1,3,9,6
20171013-W-Hong_Kong-QF-Naomi_Osaka-Anastasia_Pavlyuchenkova,2,F-DTM,16,1,0,0,1,8,8
20171013-W-Hong_Kong-QF-Naomi_Osaka-Anastasia_Pavlyuchenkova,2,F-DTL,6,3,1,1,1,4,2
20171013-W-Hong_Kong-QF-Naomi_Osaka-Anastasia_Pavlyuchenkova,2,F-IO,7,2,0,1,1,3,4
20171013-W-Hong_Kong-QF-Naomi_Osaka-Anastasia_Pavlyuchenkova,2,F-II,1,1,1,0,0,1,0
20171013-W-Hong_Kong-QF-Naomi_Osaka-Anastasia_Pavlyuchenkova,2,B-XC,18,3,0,2,1,8,10
20171013-W-Hong_Kong-QF-Naomi_Osaka-Anastasia_Pavlyuchenkova,2,B-DTM,17,0,0,0,0,10,7
20171013-W-Hong_Kong-QF-Naomi_Osaka-Anastasia_Pavlyuchenkova,2,B-DTL,7,3,1,1,1,4,3
20171013-W-Hong_Kong-QF-Naomi_Osaka-Anastasia_Pavlyuchenkova,2,B-IO,4,0,0,0,0,3,1
20171013-W-Hong_Kong-QF-Naomi_Osaka-Anastasia_Pavlyuchenkova,2,S-DTL,1,0,0,0,0,0,1
20171019-W-Moscow-QF-Julia_Goerges-Lesia_Tsurenko,1,F-XC,25,8,2,3,3,17,8
20171019-W-Moscow-QF-Julia_Goerges-Lesia_Tsurenko,1,F-DTM,9,0,0,0,0,5,4
20171019-W-Moscow-QF-Julia_Goerges-Lesia_Tsurenko,1,F-DTL,11,9,4,2,3,8,3
20171019-W-Moscow-QF-Julia_Goerges-Lesia_Tsurenko,1,F-IO,19,8,3,2,3,12,7
20171019-W-Moscow-QF-Julia_Goerges-Lesia_Tsurenko,1,F-II,3,3,0,2,1,2,1
20171019-W-Moscow-QF-Julia_Goerges-Lesia_Tsurenko,1,B-XC,35,5,0,1,4,18,17
20171019-W-Moscow-QF-Julia_Goerges-Lesia_Tsurenko,1,B-DTM,25,1,0,0,1,9,16
20171019-W-Moscow-QF-Julia_Goerges-Lesia_Tsurenko,1,B-DTL,5,3,0,0,3,1,4
20171019-W-Moscow-QF-Julia_Goerges-Lesia_Tsurenko,1,B-IO,4,1,0,1,0,2,2
20171019-W-Moscow-QF-Julia_Goerges-Lesia_Tsurenko,1,S-XC,3,0,0,0,0,1,2
20171019-W-Moscow-QF-Julia_Goerges-Lesia_Tsurenko,1,S-DTL,3,2,2,0,0,2,1
20171019-W-Moscow-QF-Julia_Goerges-Lesia_Tsurenko,2,F-XC,23,12,3,5,4,14,9
20171019-W-Moscow-QF-Julia_Goerges-Lesia_Tsurenko,2,F-DTM,16,1,0,0,1,6,10
20171019-W-Moscow-QF-Julia_Goerges-Lesia_Tsurenko,2,F-DTL,9,3,0,0,3,1,8
20171019-W-Moscow-QF-Julia_Goerges-Lesia_Tsurenko,2,F-IO,15,7,2,1,4,6,9
20171019-W-Moscow-QF-Julia_Goerges-Lesia_Tsurenko,2,B-XC,36,4,0,2,2,20,16
20171019-W-Moscow-QF-Julia_Goerges-Lesia_Tsurenko,2,B-DTM,24,3,0,0,3,12,12
20171019-W-Moscow-QF-Julia_Goerges-Lesia_Tsurenko,2,B-DTL,8,6,0,2,4,4,4
20171019-W-Moscow-QF-Julia_Goerges-Lesia_Tsurenko,2,B-IO,2,2,1,1,0,2,0
20171019-W-Moscow-QF-Julia_Goerges-Lesia_Tsurenko,2,S-XC,10,0,0,0,0,4,6
20171019-W-Moscow-QF-Julia_Goerges-Lesia_Tsurenko,2,S-DTM,11,1,0,0,1,1,10
20171019-W-Moscow-QF-Julia_Goerges-Lesia_Tsurenko,2,S-DTL,4,0,0,0,0,1,3
20171019-W-Moscow-QF-Julia_Goerges-Lesia_Tsurenko,2,S-IO,1,0,0,0,0,1,0
19881001-W-Olympics-F-Steffi_Graf-Gabriela_Sabatini,1,F-XC,64,13,3,4,6,38,26
19881001-W-Olympics-F-Steffi_Graf-Gabriela_Sabatini,1,F-DTM,13,2,1,0,1,10,3
19881001-W-Olympics-F-Steffi_Graf-Gabriela_Sabatini,1,F-DTL,11,5,2,1,2,8,3
19881001-W-Olympics-F-Steffi_Graf-Gabriela_Sabatini,1,F-IO,32,8,4,0,4,17,15
19881001-W-Olympics-F-Steffi_Graf-Gabriela_Sabatini,1,F-II,18,4,2,0,2,10,8
19881001-W-Olympics-F-Steffi_Graf-Gabriela_Sabatini,1,B-XC,13,1,0,0,1,6,7
19881001-W-Olympics-F-Steffi_Graf-Gabriela_Sabatini,1,B-DTM,2,0,0,0,0,2,0
19881001-W-Olympics-F-Steffi_Graf-Gabriela_Sabatini,1,B-DTL,3,0,0,0,0,2,1
19881001-W-Olympics-F-Steffi_Graf-Gabriela_Sabatini,1,S-XC,49,6,1,2,3,26,23
19881001-W-Olympics-F-Steffi_Graf-Gabriela_Sabatini,1,S-DTM,18,1,0,0,1,7,11
19881001-W-Olympics-F-Steffi_Graf-Gabriela_Sabatini,1,S-DTL,28,4,0,1,3,15,13
19881001-W-Olympics-F-Steffi_Graf-Gabriela_Sabatini,1,S-IO,3,0,0,0,0,3,0
19881001-W-Olympics-F-Steffi_Graf-Gabriela_Sabatini,2,F-XC,37,2,0,0,2,12,25
19881001-W-Olympics-F-Steffi_Graf-Gabriela_Sabatini,2,F-DTM,22,0,0,0,0,10,12
19881001-W-Olympics-F-Steffi_Graf-Gabriela_Sabatini,2,F-DTL,56,5,1,1,3,23,33
19881001-W-Olympics-F-Steffi_Graf-Gabriela_Sabatini,2,F-IO,14,4,1,2,1,9,5
19881001-W-Olympics-F-Steffi_Graf-Gabriela_Sabatini,2,B-XC,50,7,1,1,5,22,28
19881001-W-Olympics-F-Steffi_Graf-Gabriela_Sabatini,2,B-DTM,13,0,0,0,0,8,5
19881001-W-Olympics-F-Steffi_Graf-Gabriela_Sabatini,2,B-DTL,11,2,1,0,1,5,6
19881001-W-Olympics-F-Steffi_Graf-Gabriela_Sabatini,2,S-XC,17,1,0,1,0,6,11
19881001-W-Olympics-F-Steffi_Graf-Gabriela_Sabatini,2,S-DTM,8,0,0,0,0,2,6
19881001-W-Olympics-F-Steffi_Graf-Gabriela_Sabatini,2,S-DTL,6,0,0,0,0,2,4
20171017-W-Moscow-R32-Julia_Goerges-Polina_Monova,1,F-XC,15,9,7,1,1,12,3
20171017-W-Moscow-R32-Julia_Goerges-Polina_Monova,1,F-DTM,2,0,0,0,0,1,1
20171017-W-Moscow-R32-Julia_Goerges-Polina_Monova,1,F-DTL,11,6,3,0,3,6,5
20171017-W-Moscow-R32-Julia_Goerges-Polina_Monova,1,F-IO,12,4,1,2,1,9,3
20171017-W-Moscow-R32-Julia_Goerges-Polina_Monova,1,F-II,2,2,2,0,0,2,0
20171017-W-Moscow-R32-Julia_Goerges-Polina_Monova,1,B-XC,14,5,2,2,1,10,4
20171017-W-Moscow-R32-Julia_Goerges-Polina_Monova,1,B-DTM,12,1,0,1,0,8,4
20171017-W-Moscow-R32-Julia_Goerges-Polina_Monova,1,B-DTL,4,3,1,0,2,1,3
20171017-W-Moscow-R32-Julia_Goerges-Polina_Monova,1,B-IO,1,1,0,0,1,0,1
20171017-W-Moscow-R32-Julia_Goerges-Polina_Monova,1,S-XC,3,0,0,0,0,1,2
20171017-W-Moscow-R32-Julia_Goerges-Polina_Monova,1,S-DTM,3,0,0,0,0,0,3
20171017-W-Moscow-R32-Julia_Goerges-Polina_Monova,2,F-XC,11,4,1,1,2,6,5
20171017-W-Moscow-R32-Julia_Goerges-Polina_Monova,2,F-DTM,10,0,0,0,0,3,7
20171017-W-Moscow-R32-Julia_Goerges-Polina_Monova,2,F-DTL,2,2,1,0,1,1,1
20171017-W-Moscow-R32-Julia_Goerges-Polina_Monova,2,F-IO,2,0,0,0,0,2,0
20171017-W-Moscow-R32-Julia_Goerges-Polina_Monova,2,B-XC,24,7,1,1,5,8,16
20171017-W-Moscow-R32-Julia_Goerges-Polina_Monova,2,B-DTM,14,3,1,0,2,5,9
20171017-W-Moscow-R32-Julia_Goerges-Polina_Monova,2,B-DTL,5,3,0,1,2,1,4
20171017-W-Moscow-R32-Julia_Goerges-Polina_Monova,2,B-IO,4,4,0,1,3,1,3
20170121-W-Australian_Open-R32-Dominika_Cibulkova-Ekaterina_Makarova,1,F-XC,76,10,4,3,3,39,37
20170121-W-Australian_Open-R32-Dominika_Cibulkova-Ekaterina_Makarova,1,F-DTM,45,5,1,0,4,25,20
20170121-W-Australian_Open-R32-Dominika_Cibulkova-Ekaterina_Makarova,1,F-DTL,32,11,5,3,3,21,11
20170121-W-Australian_Open-R32-Dominika_Cibulkova-Ekaterina_Makarova,1,F-IO,42,19,9,3,7,31,11
20170121-W-Australian_Open-R32-Dominika_Cibulkova-Ekaterina_Makarova,1,F-II,3,1,1,0,0,1,2
20170121-W-Australian_Open-R32-Dominika_Cibulkova-Ekaterina_Makarova,1,B-XC,60,11,2,4,5,39,21
20170121-W-Australian_Open-R32-Dominika_Cibulkova-Ekaterina_Makarova,1,B-DTM,42,7,0,1,6,28,14
20170121-W-Australian_Open-R32-Dominika_Cibulkova-Ekaterina_Makarova,1,B-DTL,20,9,3,1,5,12,8
20170121-W-Australian_Open-R32-Dominika_Cibulkova-Ekaterina_Makarova,1,B-IO,5,1,0,0,1,2,3
20170121-W-Australian_Open-R32-Dominika_Cibulkova-Ekaterina_Makarova,1,S-XC,7,0,0,0,0,4,3
20170121-W-Australian_Open-R32-Dominika_Cibulkova-Ekaterina_Makarova,1,S-DTM,7,0,0,0,0,4,3
20170121-W-Australian_Open-R32-Dominika_Cibulkova-Ekaterina_Makarova,1,S-DTL,3,1,1,0,0,1,2
20170121-W-Australian_Open-R32-Dominika_Cibulkova-Ekaterina_Makarova,1,S-IO,2,0,0,0,0,1,1
20170121-W-Australian_Open-R32-Dominika_Cibulkova-Ekaterina_Makarova,2,F-XC,97,11,3,0,8,27,70
20170121-W-Australian_Open-R32-Dominika_Cibulkova-Ekaterina_Makarova,2,F-DTM,40,3,0,0,3,15,25
20170121-W-Australian_Open-R32-Dominika_Cibulkova-Ekaterina_Makarova,2,F-DTL,31,11,4,3,4,17,14
20170121-W-Australian_Open-R32-Dominika_Cibulkova-Ekaterina_Makarova,2,F-IO,24,4,1,0,3,9,15
20170121-W-Australian_Open-R32-Dominika_Cibulkova-Ekaterina_Makarova,2,B-XC,62,17,6,4,7,28,34
20170121-W-Australian_Open-R32-Dominika_Cibulkova-Ekaterina_Makarova,2,B-DTM,42,3,0,1,2,20,22
20170121-W-Australian_Open-R32-Dominika_Cibulkova-Ekaterina_Makarova,2,B-DTL,21,8,3,0,5,10,11
20170121-W-Australian_Open-R32-Dominika_Cibulkova-Ekaterina_Makarova,2,B-IO,7,3,2,0,1,4,3
20170121-W-Australian_Open-R32-Dominika_Cibulkova-Ekaterina_Makarova,2,S-DTM,2,0,0,0,0,1,1
20170121-W-Australian_Open-R32-Dominika_Cibulkova-Ekaterina_Makarova,2,S-DTL,1,0,0,0,0,1,0
20171026-W-Singapore-RR-Karolina_Pliskova-Jelena_Ostapenko,1,F-XC,18,7,1,2,4,6,12
20171026-W-Singapore-RR-Karolina_Pliskova-Jelena_Ostapenko,1,F-DTM,14,1,0,0,1,3,11
20171026-W-Singapore-RR-Karolina_Pliskova-Jelena_Ostapenko,1,F-DTL,4,1,0,0,1,0,4
20171026-W-Singapore-RR-Karolina_Pliskova-Jelena_Ostapenko,1,F-IO,3,2,0,1,1,1,2
20171026-W-Singapore-RR-Karolina_Pliskova-Jelena_Ostapenko,1,B-XC,14,2,0,0,2,4,10
20171026-W-Singapore-RR-Karolina_Pliskova-Jelena_Ostapenko,1,B-DTM,9,1,0,0,1,2,7
20171026-W-Singapore-RR-Karolina_Pliskova-Jelena_Ostapenko,1,B-DTL,7,3,2,0,1,4,3
20171026-W-Singapore-RR-Karolina_Pliskova-Jelena_Ostapenko,1,B-IO,1,0,0,0,0,0,1
20171026-W-Singapore-RR-Karolina_Pliskova-Jelena_Ostapenko,1,S-XC,3,0,0,0,0,2,1
20171026-W-Singapore-RR-Karolina_Pliskova-Jelena_Ostapenko,1,S-DTM,4,0,0,0,0,2,2
20171026-W-Singapore-RR-Karolina_Pliskova-Jelena_Ostapenko,1,S-DTL,1,0,0,0,0,1,0
20171026-W-Singapore-RR-Karolina_Pliskova-Jelena_Ostapenko,2,F-XC,34,17,8,5,4,25,9
20171026-W-Singapore-RR-Karolina_Pliskova-Jelena_Ostapenko,2,F-DTM,3,0,0,0,0,2,1
20171026-W-Singapore-RR-Karolina_Pliskova-Jelena_Ostapenko,2,F-DTL,5,3,2,0,1,4,1
20171026-W-Singapore-RR-Karolina_Pliskova-Jelena_Ostapenko,2,F-IO,9,6,5,0,1,6,3
20171026-W-Singapore-RR-Karolina_Pliskova-Jelena_Ostapenko,2,F-II,1,1,0,0,1,0,1
20171026-W-Singapore-RR-Karolina_Pliskova-Jelena_Ostapenko,2,B-XC,18,8,2,2,4,10,8
20171026-W-Singapore-RR-Karolina_Pliskova-Jelena_Ostapenko,2,B-DTM,11,3,0,2,1,9,2
20171026-W-Singapore-RR-Karolina_Pliskova-Jelena_Ostapenko,2,B-DTL,8,5,3,1,1,5,3
20171026-W-Singapore-RR-Karolina_Pliskova-Jelena_Ostapenko,2,B-IO,1,1,0,0,1,0,1
20170508-W-Madrid-R32-Maria_Sharapova-Eugenie_Bouchard,1,F-XC,65,25,10,6,9,37,28
20170508-W-Madrid-R32-Maria_Sharapova-Eugenie_Bouchard,1,F-DTM,15,0,0,0,0,7,8
20170508-W-Madrid-R32-Maria_Sharapova-Eugenie_Bouchard,1,F-DTL,19,8,4,1,3,15,4
20170508-W-Madrid-R32-Maria_Sharapova-Eugenie_Bouchard,1,F-IO,27,14,7,3,4,19,8
20170508-W-Madrid-R32-Maria_Sharapova-Eugenie_Bouchard,1,F-II,4,2,2,0,0,3,1
20170508-W-Madrid-R32-Maria_Sharapova-Eugenie_Bouchard,1,B-XC,46,19,4,8,7,23,23
20170508-W-Madrid-R32-Maria_Sharapova-Eugenie_Bouchard,1,B-DTM,34,1,0,0,1,18,16
20170508-W-Madrid-R32-Maria_Sharapova-Eugenie_Bouchard,1,B-DTL,19,9,5,1,3,10,9
20170508-W-Madrid-R32-Maria_Sharapova-Eugenie_Bouchard,1,B-IO,6,3,1,1,1,5,1
20170508-W-Madrid-R32-Maria_Sharapova-Eugenie_Bouchard,2,F-XC,52,13,3,9,1,28,24
20170508-W-Madrid-R32-Maria_Sharapova-Eugenie_Bouchard,2,F-DTM,11,1,0,0,1,6,5
20170508-W-Madrid-R32-Maria_Sharapova-Eugenie_Bouchard,2,F-DTL,19,7,2,4,1,10,9
20170508-W-Madrid-R32-Maria_Sharapova-Eugenie_Bouchard,2,F-IO,19,8,2,4,2,14,5
20170508-W-Madrid-R32-Maria_Sharapova-Eugenie_Bouchard,2,F-II,1,1,1,0,0,1,0
20170508-W-Madrid-R32-Maria_Sharapova-Eugenie_Bouchard,2,B-XC,51,15,1,4,10,22,29
20170508-W-Madrid-R32-Maria_Sharapova-Eugenie_Bouchard,2,B-DTM,41,1,0,0,1,17,24
20170508-W-Madrid-R32-Maria_Sharapova-Eugenie_Bouchard,2,B-DTL,9,3,2,0,1,3,6
20170508-W-Madrid-R32-Maria_Sharapova-Eugenie_Bouchard,2,B-IO,2,1,0,0,1,0,2
20170508-W-Madrid-R32-Maria_Sharapova-Eugenie_Bouchard,2,S-XC,3,0,0,0,0,1,2
20170508-W-Madrid-R32-Maria_Sharapova-Eugenie_Bouchard,2,S-DTM,1,0,0,0,0,0,1
20170508-W-Madrid-R32-Maria_Sharapova-Eugenie_Bouchard,2,S-DTL,3,1,1,0,0,2,1
20170811-W-Toronto-QF-Elina_Svitolina-Garbine_Muguruza,1,F-XC,47,12,1,3,8,20,27
20170811-W-Toronto-QF-Elina_Svitolina-Garbine_Muguruza,1,F-DTM,85,9,0,2,7,40,45
20170811-W-Toronto-QF-Elina_Svitolina-Garbine_Muguruza,1,F-DTL,6,2,2,0,0,4,2
20170811-W-Toronto-QF-Elina_Svitolina-Garbine_Muguruza,1,F-IO,14,4,2,0,2,7,7
20170811-W-Toronto-QF-Elina_Svitolina-Garbine_Muguruza,1,F-II,1,1,1,0,0,1,0
20170811-W-Toronto-QF-Elina_Svitolina-Garbine_Muguruza,1,B-XC,58,11,5,3,3,37,21
20170811-W-Toronto-QF-Elina_Svitolina-Garbine_Muguruza,1,B-DTM,55,3,1,0,2,28,27
20170811-W-Toronto-QF-Elina_Svitolina-Garbine_Muguruza,1,B-DTL,3,1,0,0,1,2,1
20170811-W-Toronto-QF-Elina_Svitolina-Garbine_Muguruza,1,B-IO,5,2,0,1,1,3,2
20170811-W-Toronto-QF-Elina_Svitolina-Garbine_Muguruza,1,S-XC,2,0,0,0,0,1,1
20170811-W-Toronto-QF-Elina_Svitolina-Garbine_Muguruza,1,S-DTM,6,0,0,0,0,2,4
20170811-W-Toronto-QF-Elina_Svitolina-Garbine_Muguruza,2,F-XC,45,11,0,2,9,25,20
20170811-W-Toronto-QF-Elina_Svitolina-Garbine_Muguruza,2,F-DTM,47,6,1,1,4,20,27
20170811-W-Toronto-QF-Elina_Svitolina-Garbine_Muguruza,2,F-DTL,9,5,1,0,4,2,7
20170811-W-Toronto-QF-Elina_Svitolina-Garbine_Muguruza,2,F-IO,32,5,1,3,1,14,18
20170811-W-Toronto-QF-Elina_Svitolina-Garbine_Muguruza,2,B-XC,52,16,5,1,10,25,27
20170811-W-Toronto-QF-Elina_Svitolina-Garbine_Muguruza,2,B-DTM,73,12,0,2,10,32,41
20170811-W-Toronto-QF-Elina_Svitolina-Garbine_Muguruza,2,B-DTL,16,6,3,1,2,6,10
20170811-W-Toronto-QF-Elina_Svitolina-Garbine_Muguruza,2,B-IO,29,7,2,3,2,15,14
20170811-W-Toronto-QF-Elina_Svitolina-Garbine_Muguruza,2,S-XC,2,0,0,0,0,0,2
20170811-W-Toronto-QF-Elina_Svitolina-Garbine_Muguruza,2,S-DTM,3,0,0,0,0,3,0
20170904-W-US_Open-R16-Madison_Keys-Elina_Svitolina,1,F-XC,38,9,1,1,7,19,19
20170904-W-US_Open-R16-Madison_Keys-Elina_Svitolina,1,F-DTM,31,6,1,0,5,16,15
20170904-W-US_Open-R16-Madison_Keys-Elina_Svitolina,1,F-DTL,8,5,3,0,2,5,3
20170904-W-US_Open-R16-Madison_Keys-Elina_Svitolina,1,F-IO,30,19,10,3,6,19,11
20170904-W-US_Open-R16-Madison_Keys-Elina_Svitolina,1,F-II,2,2,0,1,1,1,1
20170904-W-US_Open-R16-Madison_Keys-Elina_Svitolina,1,B-XC,39,8,2,2,4,26,13
20170904-W-US_Open-R16-Madison_Keys-Elina_Svitolina,1,B-DTM,36,7,0,1,6,17,19
20170904-W-US_Open-R16-Madison_Keys-Elina_Svitolina,1,B-DTL,20,11,3,1,7,13,7
20170904-W-US_Open-R16-Madison_Keys-Elina_Svitolina,1,B-IO,7,3,3,0,0,6,1
20170904-W-US_Open-R16-Madison_Keys-Elina_Svitolina,1,S-XC,5,0,0,0,0,0,5
20170904-W-US_Open-R16-Madison_Keys-Elina_Svitolina,1,S-DTM,3,0,0,0,0,2,1
20170904-W-US_Open-R16-Madison_Keys-Elina_Svitolina,2,F-XC,32,6,1,3,2,17,15
20170904-W-US_Open-R16-Madison_Keys-Elina_Svitolina,2,F-DTM,43,4,0,0,4,9,34
20170904-W-US_Open-R16-Madison_Keys-Elina_Svitolina,2,F-DTL,6,2,1,0,1,3,3
20170904-W-US_Open-R16-Madison_Keys-Elina_Svitolina,2,F-IO,28,5,3,1,1,16,12
20170904-W-US_Open-R16-Madison_Keys-Elina_Svitolina,2,F-II,1,0,0,0,0,0,1
20170904-W-US_Open-R16-Madison_Keys-Elina_Svitolina,2,B-XC,50,8,1,2,5,20,30
20170904-W-US_Open-R16-Madison_Keys-Elina_Svitolina,2,B-DTM,29,2,0,0,2,11,18
20170904-W-US_Open-R16-Madison_Keys-Elina_Svitolina,2,B-DTL,4,2,0,1,1,2,2
20170904-W-US_Open-R16-Madison_Keys-Elina_Svitolina,2,B-IO,2,1,1,0,0,2,0
20170904-W-US_Open-R16-Madison_Keys-Elina_Svitolina,2,S-XC,2,1,0,0,1,0,2
20170904-W-US_Open-R16-Madison_Keys-Elina_Svitolina,2,S-DTM,2,0,0,0,0,1,1
20180127-W-Australian_Open-F-Caroline_Wozniacki-Simona_Halep,1,F-XC,78,9,2,3,4,48,30
20180127-W-Australian_Open-F-Caroline_Wozniacki-Simona_Halep,1,F-DTM,47,5,1,1,3,21,26
20180127-W-Australian_Open-F-Caroline_Wozniacki-Simona_Halep,1,F-DTL,35,6,1,3,2,21,14
20180127-W-Australian_Open-F-Caroline_Wozniacki-Simona_Halep,1,F-IO,23,4,3,0,1,14,9
20180127-W-Australian_Open-F-Caroline_Wozniacki-Simona_Halep,1,F-II,1,0,0,0,0,1,0
20180127-W-Australian_Open-F-Caroline_Wozniacki-Simona_Halep,1,B-XC,85,13,3,7,3,54,31
20180127-W-Australian_Open-F-Caroline_Wozniacki-Simona_Halep,1,B-DTM,51,2,0,0,2,23,28
20180127-W-Australian_Open-F-Caroline_Wozniacki-Simona_Halep,1,B-DTL,28,8,3,5,0,20,8
20180127-W-Australian_Open-F-Caroline_Wozniacki-Simona_Halep,1,B-IO,17,4,1,3,0,13,4
20180127-W-Australian_Open-F-Caroline_Wozniacki-Simona_Halep,1,S-XC,3,0,0,0,0,2,1
20180127-W-Australian_Open-F-Caroline_Wozniacki-Simona_Halep,1,S-DTM,10,0,0,0,0,1,9
20180127-W-Australian_Open-F-Caroline_Wozniacki-Simona_Halep,1,S-DTL,3,0,0,0,0,1,2
20180127-W-Australian_Open-F-Caroline_Wozniacki-Simona_Halep,2,F-XC,89,25,11,12,2,51,38
20180127-W-Australian_Open-F-Caroline_Wozniacki-Simona_Halep,2,F-DTM,47,5,0,0,5,12,35
20180127-W-Australian_Open-F-Caroline_Wozniacki-Simona_Halep,2,F-DTL,44,15,3,3,9,18,26
20180127-W-Australian_Open-F-Caroline_Wozniacki-Simona_Halep,2,F-IO,27,6,1,2,3,14,13
20180127-W-Australian_Open-F-Caroline_Wozniacki-Simona_Halep,2,F-II,4,2,2,0,0,2,2
20180127-W-Australian_Open-F-Caroline_Wozniacki-Simona_Halep,2,B-XC,85,12,3,4,5,43,42
20180127-W-Australian_Open-F-Caroline_Wozniacki-Simona_Halep,2,B-DTM,61,5,0,0,5,20,41
20180127-W-Australian_Open-F-Caroline_Wozniacki-Simona_Halep,2,B-DTL,31,14,3,3,8,13,18
20180127-W-Australian_Open-F-Caroline_Wozniacki-Simona_Halep,2,B-IO,9,1,0,0,1,5,4
20180127-W-Australian_Open-F-Caroline_Wozniacki-Simona_Halep,2,S-DTM,3,0,0,0,0,1,2
20180311-W-Indian_Wells-R32-Coco_Vandeweghe-Maria_Sakkari,1,F-XC,31,14,2,3,9,13,18
20180311-W-Indian_Wells-R32-Coco_Vandeweghe-Maria_Sakkari,1,F-DTM,15,0,0,0,0,6,9
20180311-W-Indian_Wells-R32-Coco_Vandeweghe-Maria_Sakkari,1,F-DTL,4,1,0,0,1,0,4
20180311-W-Indian_Wells-R32-Coco_Vandeweghe-Maria_Sakkari,1,F-IO,11,0,0,0,0,8,3
20180311-W-Indian_Wells-R32-Coco_Vandeweghe-Maria_Sakkari,1,B-XC,17,5,0,1,4,2,15
20180311-W-Indian_Wells-R32-Coco_Vandeweghe-Maria_Sakkari,1,B-DTM,15,2,0,0,2,9,6
20180311-W-Indian_Wells-R32-Coco_Vandeweghe-Maria_Sakkari,1,B-DTL,1,0,0,0,0,0,1
20180311-W-Indian_Wells-R32-Coco_Vandeweghe-Maria_Sakkari,1,S-XC,4,0,0,0,0,3,1
20180311-W-Indian_Wells-R32-Coco_Vandeweghe-Maria_Sakkari,1,S-DTM,2,0,0,0,0,2,0
20180311-W-Indian_Wells-R32-Coco_Vandeweghe-Maria_Sakkari,1,S-DTL,2,0,0,0,0,0,2
20180311-W-Indian_Wells-R32-Coco_Vandeweghe-Maria_Sakkari,1,S-IO,1,0,0,0,0,1,0
20180311-W-Indian_Wells-R32-Coco_Vandeweghe-Maria_Sakkari,2,F-XC,26,6,2,2,2,14,12
20180311-W-Indian_Wells-R32-Coco_Vandeweghe-Maria_Sakkari,2,F-DTM,14,0,0,0,0,7,7
20180311-W-Indian_Wells-R32-Coco_Vandeweghe-Maria_Sakkari,2,F-DTL,4,0,0,0,0,2,2
20180311-W-Indian_Wells-R32-Coco_Vandeweghe-Maria_Sakkari,2,F-IO,12,3,1,0,2,7,5
20180311-W-Indian_Wells-R32-Coco_Vandeweghe-Maria_Sakkari,2,F-II,2,2,0,2,0,2,0
20180311-W-Indian_Wells-R32-Coco_Vandeweghe-Maria_Sakkari,2,B-XC,19,7,4,1,2,12,7
20180311-W-Indian_Wells-R32-Coco_Vandeweghe-Maria_Sakkari,2,B-DTM,31,7,0,2,5,14,17
20180311-W-Indian_Wells-R32-Coco_Vandeweghe-Maria_Sakkari,2,B-DTL,3,2,1,1,0,3,0
20180311-W-Indian_Wells-R32-Coco_Vandeweghe-Maria_Sakkari,2,S-DTM,2,0,0,0,0,0,2
20180311-W-Indian_Wells-R32-Coco_Vandeweghe-Maria_Sakkari,2,S-DTL,2,1,1,0,0,1,1
20180321-W-Miami-R128-Serena_Williams-Naomi_Osaka,1,F-XC,15,8,2,2,4,6,9
20180321-W-Miami-R128-Serena_Williams-Naomi_Osaka,1,F-DTM,5,1,0,0,1,1,4
20180321-W-Miami-R128-Serena_Williams-Naomi_Osaka,1,F-DTL,2,2,1,0,1,1,1
20180321-W-Miami-R128-Serena_Williams-Naomi_Osaka,1,F-IO,8,4,2,1,1,6,2
20180321-W-Miami-R128-Serena_Williams-Naomi_Osaka,1,B-XC,21,8,2,3,3,10,11
20180321-W-Miami-R128-Serena_Williams-Naomi_Osaka,1,B-DTM,10,1,0,0,1,2,8
20180321-W-Miami-R128-Serena_Williams-Naomi_Osaka,1,B-DTL,5,3,2,0,1,3,2
20180321-W-Miami-R128-Serena_Williams-Naomi_Osaka,1,B-IO,6,4,1,1,2,2,4
20180321-W-Miami-R128-Serena_Williams-Naomi_Osaka,1,S-XC,4,0,0,0,0,1,3
20180321-W-Miami-R128-Serena_Williams-Naomi_Osaka,1,S-DTM,3,0,0,0,0,0,3
20180321-W-Miami-R128-Serena_Williams-Naomi_Osaka,1,S-DTL,1,0,0,0,0,1,0
20180321-W-Miami-R128-Serena_Williams-Naomi_Osaka,2,F-XC,11,5,2,2,1,10,1
20180321-W-Miami-R128-Serena_Williams-Naomi_Osaka,2,F-DTM,10,0,0,0,0,7,3
20180321-W-Miami-R128-Serena_Williams-Naomi_Osaka,2,F-DTL,9,4,2,1,1,5,4
20180321-W-Miami-R128-Serena_Williams-Naomi_Osaka,2,F-IO,7,1,0,0,1,6,1
20180321-W-Miami-R128-Serena_Williams-Naomi_Osaka,2,B-XC,19,6,2,3,1,12,7
20180321-W-Miami-R128-Serena_Williams-Naomi_Osaka,2,B-DTM,10,2,0,1,1,4,6
20180321-W-Miami-R128-Serena_Williams-Naomi_Osaka,2,B-DTL,6,5,3,1,1,4,2
20180321-W-Miami-R128-Serena_Williams-Naomi_Osaka,2,B-IO,3,1,0,1,0,2,1
20180321-W-Miami-R128-Serena_Williams-Naomi_Osaka,2,S-DTM,1,0,0,0,0,0,1
20180313-W-Indian_Wells-R16-Marketa_Vondrousova-Petra_Martic,1,F-XC,66,12,5,2,5,32,34
20180313-W-Indian_Wells-R16-Marketa_Vondrousova-Petra_Martic,1,F-DTM,16,1,0,0,1,2,14
20180313-W-Indian_Wells-R16-Marketa_Vondrousova-Petra_Martic,1,F-DTL,9,6,3,0,3,3,6
20180313-W-Indian_Wells-R16-Marketa_Vondrousova-Petra_Martic,1,F-IO,11,5,1,2,2,7,4
20180313-W-Indian_Wells-R16-Marketa_Vondrousova-Petra_Martic,1,B-XC,36,6,1,1,4,9,27
20180313-W-Indian_Wells-R16-Marketa_Vondrousova-Petra_Martic,1,B-DTM,11,0,0,0,0,3,8
20180313-W-Indian_Wells-R16-Marketa_Vondrousova-Petra_Martic,1,B-DTL,5,2,2,0,0,3,2
20180313-W-Indian_Wells-R16-Marketa_Vondrousova-Petra_Martic,1,B-IO,9,4,0,1,3,3,6
20180313-W-Indian_Wells-R16-Marketa_Vondrousova-Petra_Martic,1,B-II,1,0,0,0,0,0,1
20180313-W-Indian_Wells-R16-Marketa_Vondrousova-Petra_Martic,1,S-DTM,2,0,0,0,0,0,2
20180313-W-Indian_Wells-R16-Marketa_Vondrousova-Petra_Martic,2,F-XC,35,9,3,4,2,26,9
20180313-W-Indian_Wells-R16-Marketa_Vondrousova-Petra_Martic,2,F-DTM,24,1,0,0,1,14,10
20180313-W-Indian_Wells-R16-Marketa_Vondrousova-Petra_Martic,2,F-DTL,18,7,3,4,0,12,6
20180313-W-Indian_Wells-R16-Marketa_Vondrousova-Petra_Martic,2,F-IO,20,6,0,2,4,15,5
20180313-W-Indian_Wells-R16-Marketa_Vondrousova-Petra_Martic,2,F-II,3,2,0,0,2,1,2
20180313-W-Indian_Wells-R16-Marketa_Vondrousova-Petra_Martic,2,B-XC,23,3,0,1,2,12,11
20180313-W-Indian_Wells-R16-Marketa_Vondrousova-Petra_Martic,2,B-DTM,21,2,0,0,2,10,11
20180313-W-Indian_Wells-R16-Marketa_Vondrousova-Petra_Martic,2,B-DTL,3,2,0,1,1,2,1
20180313-W-Indian_Wells-R16-Marketa_Vondrousova-Petra_Martic,2,B-IO,2,0,0,0,0,1,1
20180313-W-Indian_Wells-R16-Marketa_Vondrousova-Petra_Martic,2,B-II,1,0,0,0,0,1,0
20180313-W-Indian_Wells-R16-Marketa_Vondrousova-Petra_Martic,2,S-XC,3,0,0,0,0,1,2
20180313-W-Indian_Wells-R16-Marketa_Vondrousova-Petra_Martic,2,S-DTM,9,0,0,0,0,7,2
20180313-W-Indian_Wells-R16-Marketa_Vondrousova-Petra_Martic,2,S-DTL,7,0,0,0,0,4,3
20180313-W-Indian_Wells-R16-Marketa_Vondrousova-Petra_Martic,2,S-IO,1,0,0,0,0,1,0
20180321-W-Miami-R128-Lauren_Davis-Petra_Martic,1,F-XC,32,8,3,1,4,15,17
20180321-W-Miami-R128-Lauren_Davis-Petra_Martic,1,F-DTM,32,3,1,0,2,18,14
20180321-W-Miami-R128-Lauren_Davis-Petra_Martic,1,F-DTL,13,2,2,0,0,9,4
20180321-W-Miami-R128-Lauren_Davis-Petra_Martic,1,F-IO,28,9,1,4,4,15,13
20180321-W-Miami-R128-Lauren_Davis-Petra_Martic,1,B-XC,25,7,1,2,4,13,12
20180321-W-Miami-R128-Lauren_Davis-Petra_Martic,1,B-DTM,23,0,0,0,0,9,14
20180321-W-Miami-R128-Lauren_Davis-Petra_Martic,1,B-DTL,7,4,1,1,2,5,2
20180321-W-Miami-R128-Lauren_Davis-Petra_Martic,1,B-IO,6,2,1,0,1,3,3
20180321-W-Miami-R128-Lauren_Davis-Petra_Martic,1,B-II,1,1,0,0,1,0,1
20180321-W-Miami-R128-Lauren_Davis-Petra_Martic,1,S-XC,4,1,1,0,0,4,0
20180321-W-Miami-R128-Lauren_Davis-Petra_Martic,1,S-DTM,2,0,0,0,0,1,1
20180321-W-Miami-R128-Lauren_Davis-Petra_Martic,2,F-XC,26,10,2,8,0,19,7
20180321-W-Miami-R128-Lauren_Davis-Petra_Martic,2,F-DTM,24,2,0,0,2,12,12
20180321-W-Miami-R128-Lauren_Davis-Petra_Martic,2,F-DTL,4,3,1,0,2,1,3
20180321-W-Miami-R128-Lauren_Davis-Petra_Martic,2,F-IO,17,2,1,1,0,11,6
20180321-W-Miami-R128-Lauren_Davis-Petra_Martic,2,F-II,1,0,0,0,0,0,1
20180321-W-Miami-R128-Lauren_Davis-Petra_Martic,2,B-XC,18,5,1,1,3,7,11
20180321-W-Miami-R128-Lauren_Davis-Petra_Martic,2,B-DTM,27,1,0,0,1,13,14
20180321-W-Miami-R128-Lauren_Davis-Petra_Martic,2,B-DTL,5,1,0,0,1,1,4
20180321-W-Miami-R128-Lauren_Davis-Petra_Martic,2,B-IO,3,2,0,0,2,0,3
20180321-W-Miami-R128-Lauren_Davis-Petra_Martic,2,B-II,1,1,0,1,0,1,0
20180321-W-Miami-R128-Lauren_Davis-Petra_Martic,2,S-XC,6,0,0,0,0,0,6
20180321-W-Miami-R128-Lauren_Davis-Petra_Martic,2,S-DTM,12,0,0,0,0,5,7
20180321-W-Miami-R128-Lauren_Davis-Petra_Martic,2,S-DTL,7,0,0,0,0,4,3
20180321-W-Miami-R128-Lauren_Davis-Petra_Martic,2,S-IO,5,1,0,0,1,2,3
20180324-W-Miami-R32-Christina_Mchale-Garbine_Muguruza,1,F-XC,22,5,0,0,5,3,19
20180324-W-Miami-R32-Christina_Mchale-Garbine_Muguruza,1,F-DTM,21,0,0,0,0,10,11
20180324-W-Miami-R32-Christina_Mchale-Garbine_Muguruza,1,F-DTL,14,4,0,1,3,6,8
20180324-W-Miami-R32-Christina_Mchale-Garbine_Muguruza,1,F-IO,20,3,0,1,2,6,14
20180324-W-Miami-R32-Christina_Mchale-Garbine_Muguruza,1,F-II,2,1,0,0,1,1,1
20180324-W-Miami-R32-Christina_Mchale-Garbine_Muguruza,1,B-XC,7,1,0,0,1,1,6
20180324-W-Miami-R32-Christina_Mchale-Garbine_Muguruza,1,B-DTM,14,0,0,0,0,5,9
20180324-W-Miami-R32-Christina_Mchale-Garbine_Muguruza,1,B-DTL,9,4,0,1,3,4,5
20180324-W-Miami-R32-Christina_Mchale-Garbine_Muguruza,1,B-IO,2,1,0,1,0,1,1
20180324-W-Miami-R32-Christina_Mchale-Garbine_Muguruza,1,S-XC,2,0,0,0,0,0,2
20180324-W-Miami-R32-Christina_Mchale-Garbine_Muguruza,1,S-DTM,5,0,0,0,0,3,2
20180324-W-Miami-R32-Christina_Mchale-Garbine_Muguruza,2,F-XC,27,11,2,2,7,16,11
20180324-W-Miami-R32-Christina_Mchale-Garbine_Muguruza,2,F-DTM,19,2,0,0,2,13,6
20180324-W-Miami-R32-Christina_Mchale-Garbine_Muguruza,2,F-DTL,7,4,0,2,2,4,3
20180324-W-Miami-R32-Christina_Mchale-Garbine_Muguruza,2,F-IO,8,5,1,1,3,5,3
20180324-W-Miami-R32-Christina_Mchale-Garbine_Muguruza,2,B-XC,27,7,1,2,4,15,12
20180324-W-Miami-R32-Christina_Mchale-Garbine_Muguruza,2,B-DTM,12,2,0,2,0,10,2
20180324-W-Miami-R32-Christina_Mchale-Garbine_Muguruza,2,B-DTL,10,4,1,1,2,7,3
20180324-W-Miami-R32-Christina_Mchale-Garbine_Muguruza,2,B-IO,6,3,1,2,0,4,2
20180324-W-Miami-R32-Christina_Mchale-Garbine_Muguruza,2,S-DTL,1,0,0,0,0,1,0
20180323-W-Miami-R64-Danielle_Collins-Coco_Vandeweghe,1,F-XC,14,5,1,3,1,7,7
20180323-W-Miami-R64-Danielle_Collins-Coco_Vandeweghe,1,F-DTM,28,2,0,0,2,16,12
20180323-W-Miami-R64-Danielle_Collins-Coco_Vandeweghe,1,F-DTL,11,5,3,0,2,5,6
20180323-W-Miami-R64-Danielle_Collins-Coco_Vandeweghe,1,F-IO,12,6,2,1,3,6,6
20180323-W-Miami-R64-Danielle_Collins-Coco_Vandeweghe,1,B-XC,41,13,4,2,7,22,19
20180323-W-Miami-R64-Danielle_Collins-Coco_Vandeweghe,1,B-DTM,26,1,0,1,0,15,11
20180323-W-Miami-R64-Danielle_Collins-Coco_Vandeweghe,1,B-DTL,10,5,4,1,0,8,2
20180323-W-Miami-R64-Danielle_Collins-Coco_Vandeweghe,1,B-IO,5,2,0,1,1,3,2
20180323-W-Miami-R64-Danielle_Collins-Coco_Vandeweghe,1,S-XC,1,0,0,0,0,1,0
20180323-W-Miami-R64-Danielle_Collins-Coco_Vandeweghe,1,S-DTM,3,0,0,0,0,2,1
20180323-W-Miami-R64-Danielle_Collins-Coco_Vandeweghe,2,F-XC,31,9,3,3,3,20,11
20180323-W-Miami-R64-Danielle_Collins-Coco_Vandeweghe,2,F-DTM,19,4,0,1,3,5,14
20180323-W-Miami-R64-Danielle_Collins-Coco_Vandeweghe,2,F-DTL,7,3,1,0,2,3,4
20180323-W-Miami-R64-Danielle_Collins-Coco_Vandeweghe,2,F-IO,17,4,3,1,0,8,9
20180323-W-Miami-R64-Danielle_Collins-Coco_Vandeweghe,2,F-II,5,2,0,1,1,3,2
20180323-W-Miami-R64-Danielle_Collins-Coco_Vandeweghe,2,B-XC,32,7,0,3,4,16,16
20180323-W-Miami-R64-Danielle_Collins-Coco_Vandeweghe,2,B-DTM,19,4,0,1,3,8,11
20180323-W-Miami-R64-Danielle_Collins-Coco_Vandeweghe,2,B-DTL,9,4,3,1,0,6,3
20180323-W-Miami-R64-Danielle_Collins-Coco_Vandeweghe,2,B-IO,2,0,0,0,0,2,0
20180323-W-Miami-R64-Danielle_Collins-Coco_Vandeweghe,2,S-XC,3,0,0,0,0,0,3
20180323-W-Miami-R64-Danielle_Collins-Coco_Vandeweghe,2,S-DTM,5,1,0,0,1,0,5
20180323-W-Miami-R64-Danielle_Collins-Coco_Vandeweghe,2,S-IO,3,2,0,0,2,1,2
20180325-W-Miami-R32-Danielle_Collins-Donna_Vekic,1,F-XC,25,6,2,3,1,18,7
20180325-W-Miami-R32-Danielle_Collins-Donna_Vekic,1,F-DTM,13,3,0,1,2,8,5
20180325-W-Miami-R32-Danielle_Collins-Donna_Vekic,1,F-DTL,13,3,2,0,1,8,5
20180325-W-Miami-R32-Danielle_Collins-Donna_Vekic,1,F-IO,20,5,1,3,1,14,6
20180325-W-Miami-R32-Danielle_Collins-Donna_Vekic,1,F-II,2,1,0,1,0,2,0
20180325-W-Miami-R32-Danielle_Collins-Donna_Vekic,1,B-XC,28,7,4,0,3,18,10
20180325-W-Miami-R32-Danielle_Collins-Donna_Vekic,1,B-DTM,17,2,0,1,1,9,8
20180325-W-Miami-R32-Danielle_Collins-Donna_Vekic,1,B-DTL,16,10,6,0,4,8,8
20180325-W-Miami-R32-Danielle_Collins-Donna_Vekic,1,B-IO,8,4,3,1,0,7,1
20180325-W-Miami-R32-Danielle_Collins-Donna_Vekic,1,S-DTM,1,0,0,0,0,0,1
20180325-W-Miami-R32-Danielle_Collins-Donna_Vekic,2,F-XC,21,7,2,2,3,11,10
20180325-W-Miami-R32-Danielle_Collins-Donna_Vekic,2,F-DTM,22,0,0,0,0,5,17
20180325-W-Miami-R32-Danielle_Collins-Donna_Vekic,2,F-DTL,8,4,1,2,1,6,2
20180325-W-Miami-R32-Danielle_Collins-Donna_Vekic,2,F-IO,17,9,6,1,2,10,7
20180325-W-Miami-R32-Danielle_Collins-Donna_Vekic,2,F-II,2,1,1,0,0,1,1
20180325-W-Miami-R32-Danielle_Collins-Donna_Vekic,2,B-XC,24,4,2,0,2,11,13
20180325-W-Miami-R32-Danielle_Collins-Donna_Vekic,2,B-DTM,22,2,0,0,2,4,18
20180325-W-Miami-R32-Danielle_Collins-Donna_Vekic,2,B-DTL,11,5,1,0,4,2,9
20180325-W-Miami-R32-Danielle_Collins-Donna_Vekic,2,B-IO,8,4,0,0,4,4,4
20180325-W-Miami-R32-Danielle_Collins-Donna_Vekic,2,S-XC,1,0,0,0,0,0,1
20180325-W-Miami-R32-Danielle_Collins-Donna_Vekic,2,S-DTL,1,0,0,0,0,0,1
20180329-W-Miami-SF-Jelena_Ostapenko-Danielle_Collins,1,F-XC,46,16,6,4,6,34,12
20180329-W-Miami-SF-Jelena_Ostapenko-Danielle_Collins,1,F-DTM,5,0,0,0,0,3,2
20180329-W-Miami-SF-Jelena_Ostapenko-Danielle_Collins,1,F-DTL,8,5,4,0,1,6,2
20180329-W-Miami-SF-Jelena_Ostapenko-Danielle_Collins,1,F-IO,7,6,4,0,2,5,2
20180329-W-Miami-SF-Jelena_Ostapenko-Danielle_Collins,1,B-XC,36,11,4,4,3,26,10
20180329-W-Miami-SF-Jelena_Ostapenko-Danielle_Collins,1,B-DTM,14,2,0,1,1,9,5
20180329-W-Miami-SF-Jelena_Ostapenko-Danielle_Collins,1,B-DTL,13,7,5,0,2,8,5
20180329-W-Miami-SF-Jelena_Ostapenko-Danielle_Collins,1,B-IO,3,1,0,0,1,2,1
20180329-W-Miami-SF-Jelena_Ostapenko-Danielle_Collins,1,S-XC,1,0,0,0,0,1,0
20180329-W-Miami-SF-Jelena_Ostapenko-Danielle_Collins,1,S-DTM,5,0,0,0,0,2,3
20180329-W-Miami-SF-Jelena_Ostapenko-Danielle_Collins,1,S-DTL,4,0,0,0,0,2,2
20180329-W-Miami-SF-Jelena_Ostapenko-Danielle_Collins,2,F-XC,32,7,1,4,2,14,18
20180329-W-Miami-SF-Jelena_Ostapenko-Danielle_Collins,2,F-DTM,25,1,0,0,1,6,19
20180329-W-Miami-SF-Jelena_Ostapenko-Danielle_Collins,2,F-DTL,12,3,0,2,1,3,9
20180329-W-Miami-SF-Jelena_Ostapenko-Danielle_Collins,2,F-IO,7,4,0,2,2,2,5
20180329-W-Miami-SF-Jelena_Ostapenko-Danielle_Collins,2,B-XC,25,9,1,6,2,12,13
20180329-W-Miami-SF-Jelena_Ostapenko-Danielle_Collins,2,B-DTM,18,1,0,0,1,7,11
20180329-W-Miami-SF-Jelena_Ostapenko-Danielle_Collins,2,B-DTL,8,6,1,1,4,2,6
20180329-W-Miami-SF-Jelena_Ostapenko-Danielle_Collins,2,B-IO,2,0,0,0,0,1,1
20180329-W-Miami-SF-Jelena_Ostapenko-Danielle_Collins,2,B-II,1,0,0,0,0,0,1
20180329-W-Miami-SF-Jelena_Ostapenko-Danielle_Collins,2,S-XC,2,0,0,0,0,2,0
20180329-W-Miami-SF-Jelena_Ostapenko-Danielle_Collins,2,S-DTM,1,0,0,0,0,0,1
20180326-W-Miami-R16-Monica_Puig-Danielle_Collins,1,F-XC,20,4,2,1,1,11,9
20180326-W-Miami-R16-Monica_Puig-Danielle_Collins,1,F-DTM,20,0,0,0,0,11,9
20180326-W-Miami-R16-Monica_Puig-Danielle_Collins,1,F-DTL,13,7,5,1,1,10,3
20180326-W-Miami-R16-Monica_Puig-Danielle_Collins,1,F-IO,15,7,2,2,3,5,10
20180326-W-Miami-R16-Monica_Puig-Danielle_Collins,1,F-II,1,0,0,0,0,1,0
20180326-W-Miami-R16-Monica_Puig-Danielle_Collins,1,B-XC,51,6,2,2,2,21,30
20180326-W-Miami-R16-Monica_Puig-Danielle_Collins,1,B-DTM,56,5,0,1,4,27,29
20180326-W-Miami-R16-Monica_Puig-Danielle_Collins,1,B-DTL,12,8,1,4,2,7,5
20180326-W-Miami-R16-Monica_Puig-Danielle_Collins,1,B-IO,10,4,0,1,3,2,8
20180326-W-Miami-R16-Monica_Puig-Danielle_Collins,1,S-XC,1,0,0,0,0,0,1
20180326-W-Miami-R16-Monica_Puig-Danielle_Collins,1,S-DTM,1,0,0,0,0,1,0
20180326-W-Miami-R16-Monica_Puig-Danielle_Collins,1,S-DTL,1,0,0,0,0,0,1
20180326-W-Miami-R16-Monica_Puig-Danielle_Collins,2,F-XC,19,10,4,2,5,10,9
20180326-W-Miami-R16-Monica_Puig-Danielle_Collins,2,F-DTM,21,0,0,0,0,10,11
20180326-W-Miami-R16-Monica_Puig-Danielle_Collins,2,F-DTL,15,4,0,4,0,11,4
20180326-W-Miami-R16-Monica_Puig-Danielle_Collins,2,F-IO,23,7,4,0,3,9,14
20180326-W-Miami-R16-Monica_Puig-Danielle_Collins,2,F-II,1,1,1,0,0,1,0
20180326-W-Miami-R16-Monica_Puig-Danielle_Collins,2,B-XC,54,10,4,6,0,31,23
20180326-W-Miami-R16-Monica_Puig-Danielle_Collins,2,B-DTM,28,0,0,0,0,18,10
20180326-W-Miami-R16-Monica_Puig-Danielle_Collins,2,B-DTL,15,7,2,0,5,8,7
20180326-W-Miami-R16-Monica_Puig-Danielle_Collins,2,B-IO,7,4,0,0,4,1,6
20180326-W-Miami-R16-Monica_Puig-Danielle_Collins,2,S-DTM,2,0,0,0,0,1,1
20180326-W-Miami-R16-Monica_Puig-Danielle_Collins,2,S-DTL,1,0,0,0,0,1,0
20180328-W-Miami-QF-Danielle_Collins-Venus_Williams,1,F-XC,39,8,3,3,2,28,11
20180328-W-Miami-QF-Danielle_Collins-Venus_Williams,1,F-DTM,16,2,0,1,1,11,5
20180328-W-Miami-QF-Danielle_Collins-Venus_Williams,1,F-DTL,12,5,1,0,4,6,6
20180328-W-Miami-QF-Danielle_Collins-Venus_Williams,1,F-IO,15,5,2,1,2,9,6
20180328-W-Miami-QF-Danielle_Collins-Venus_Williams,1,B-XC,40,14,4,9,1,27,13
20180328-W-Miami-QF-Danielle_Collins-Venus_Williams,1,B-DTM,23,2,1,0,1,11,12
20180328-W-Miami-QF-Danielle_Collins-Venus_Williams,1,B-DTL,12,6,2,2,2,6,6
20180328-W-Miami-QF-Danielle_Collins-Venus_Williams,1,B-IO,8,2,1,1,0,7,1
20180328-W-Miami-QF-Danielle_Collins-Venus_Williams,2,F-XC,32,6,2,4,0,16,16
20180328-W-Miami-QF-Danielle_Collins-Venus_Williams,2,F-DTM,17,1,0,0,1,4,13
20180328-W-Miami-QF-Danielle_Collins-Venus_Williams,2,F-DTL,15,4,1,2,1,7,8
20180328-W-Miami-QF-Danielle_Collins-Venus_Williams,2,F-IO,18,9,4,1,4,11,7
20180328-W-Miami-QF-Danielle_Collins-Venus_Williams,2,F-II,3,1,1,0,0,1,2
20180328-W-Miami-QF-Danielle_Collins-Venus_Williams,2,B-XC,24,7,2,2,3,9,15
20180328-W-Miami-QF-Danielle_Collins-Venus_Williams,2,B-DTM,20,2,0,0,2,5,15
20180328-W-Miami-QF-Danielle_Collins-Venus_Williams,2,B-DTL,9,4,1,2,1,5,4
20180328-W-Miami-QF-Danielle_Collins-Venus_Williams,2,B-IO,12,4,1,1,2,3,9
20180328-W-Miami-QF-Danielle_Collins-Venus_Williams,2,S-XC,3,0,0,0,0,2,1
20180328-W-Miami-QF-Danielle_Collins-Venus_Williams,2,S-DTM,2,0,0,0,0,1,1
20180328-W-Miami-QF-Danielle_Collins-Venus_Williams,2,S-DTL,1,1,0,1,0,1,0
20180328-W-Miami-QF-Danielle_Collins-Venus_Williams,2,S-IO,1,0,0,0,0,0,1
20110110-W-Hobart-R32-Marion_Bartoli-Dinara_Safina,1,F-XC,66,6,2,4,0,44,22
20110110-W-Hobart-R32-Marion_Bartoli-Dinara_Safina,1,F-DTM,11,0,0,0,0,6,5
20110110-W-Hobart-R32-Marion_Bartoli-Dinara_Safina,1,F-DTL,18,5,4,1,0,12,6
20110110-W-Hobart-R32-Marion_Bartoli-Dinara_Safina,1,F-IO,8,5,4,1,0,6,2
20110110-W-Hobart-R32-Marion_Bartoli-Dinara_Safina,1,B-XC,56,10,1,6,3,41,15
20110110-W-Hobart-R32-Marion_Bartoli-Dinara_Safina,1,B-DTM,14,1,0,1,0,11,3
20110110-W-Hobart-R32-Marion_Bartoli-Dinara_Safina,1,B-DTL,17,5,2,2,1,10,7
20110110-W-Hobart-R32-Marion_Bartoli-Dinara_Safina,1,B-IO,3,0,0,0,0,2,1
20110110-W-Hobart-R32-Marion_Bartoli-Dinara_Safina,1,S-XC,2,0,0,0,0,1,1
20110110-W-Hobart-R32-Marion_Bartoli-Dinara_Safina,1,S-DTL,1,0,0,0,0,0,1
20110110-W-Hobart-R32-Marion_Bartoli-Dinara_Safina,2,F-XC,71,15,6,2,7,28,43
20110110-W-Hobart-R32-Marion_Bartoli-Dinara_Safina,2,F-DTM,6,1,0,0,1,2,4
20110110-W-Hobart-R32-Marion_Bartoli-Dinara_Safina,2,F-DTL,29,11,3,2,6,12,17
20110110-W-Hobart-R32-Marion_Bartoli-Dinara_Safina,2,F-IO,8,2,1,0,1,2,6
20110110-W-Hobart-R32-Marion_Bartoli-Dinara_Safina,2,F-II,1,1,0,0,1,0,1
20110110-W-Hobart-R32-Marion_Bartoli-Dinara_Safina,2,B-XC,45,3,1,1,1,14,31
20110110-W-Hobart-R32-Marion_Bartoli-Dinara_Safina,2,B-DTM,24,1,0,0,1,8,16
20110110-W-Hobart-R32-Marion_Bartoli-Dinara_Safina,2,B-DTL,9,4,2,0,2,5,4
20110110-W-Hobart-R32-Marion_Bartoli-Dinara_Safina,2,B-IO,9,1,0,0,1,2,7
20110110-W-Hobart-R32-Marion_Bartoli-Dinara_Safina,2,S-XC,5,0,0,0,0,2,3
20110110-W-Hobart-R32-Marion_Bartoli-Dinara_Safina,2,S-DTM,3,0,0,0,0,2,1
20110110-W-Hobart-R32-Marion_Bartoli-Dinara_Safina,2,S-IO,1,0,0,0,0,0,1
20100508-W-Rome-F-Maria_Jose_Martinez_Sanchez-Jelena_Jankovic,1,F-XC,52,10,1,2,7,24,28
20100508-W-Rome-F-Maria_Jose_Martinez_Sanchez-Jelena_Jankovic,1,F-DTM,17,2,0,0,2,11,6
20100508-W-Rome-F-Maria_Jose_Martinez_Sanchez-Jelena_Jankovic,1,F-DTL,26,8,3,1,4,16,10
20100508-W-Rome-F-Maria_Jose_Martinez_Sanchez-Jelena_Jankovic,1,F-IO,5,1,0,1,0,3,2
20100508-W-Rome-F-Maria_Jose_Martinez_Sanchez-Jelena_Jankovic,1,B-XC,65,11,3,1,7,33,32
20100508-W-Rome-F-Maria_Jose_Martinez_Sanchez-Jelena_Jankovic,1,B-DTM,23,0,0,0,0,10,13
20100508-W-Rome-F-Maria_Jose_Martinez_Sanchez-Jelena_Jankovic,1,B-DTL,20,7,5,0,2,10,10
20100508-W-Rome-F-Maria_Jose_Martinez_Sanchez-Jelena_Jankovic,1,B-IO,14,6,2,1,3,9,5
20100508-W-Rome-F-Maria_Jose_Martinez_Sanchez-Jelena_Jankovic,1,S-XC,2,1,0,0,1,0,2
20100508-W-Rome-F-Maria_Jose_Martinez_Sanchez-Jelena_Jankovic,1,S-DTM,2,0,0,0,0,0,2
20100508-W-Rome-F-Maria_Jose_Martinez_Sanchez-Jelena_Jankovic,2,F-XC,58,10,1,3,6,28,30
20100508-W-Rome-F-Maria_Jose_Martinez_Sanchez-Jelena_Jankovic,2,F-DTM,12,2,0,0,2,4,8
20100508-W-Rome-F-Maria_Jose_Martinez_Sanchez-Jelena_Jankovic,2,F-DTL,44,10,3,1,6,16,28
20100508-W-Rome-F-Maria_Jose_Martinez_Sanchez-Jelena_Jankovic,2,F-IO,37,5,1,2,2,19,18
20100508-W-Rome-F-Maria_Jose_Martinez_Sanchez-Jelena_Jankovic,2,F-II,1,1,0,0,1,0,1
20100508-W-Rome-F-Maria_Jose_Martinez_Sanchez-Jelena_Jankovic,2,B-XC,53,9,2,4,3,32,21
20100508-W-Rome-F-Maria_Jose_Martinez_Sanchez-Jelena_Jankovic,2,B-DTM,23,0,0,0,0,9,14
20100508-W-Rome-F-Maria_Jose_Martinez_Sanchez-Jelena_Jankovic,2,B-DTL,30,5,1,3,1,21,9
20100508-W-Rome-F-Maria_Jose_Martinez_Sanchez-Jelena_Jankovic,2,B-IO,14,4,2,1,1,6,8
20100508-W-Rome-F-Maria_Jose_Martinez_Sanchez-Jelena_Jankovic,2,S-XC,9,1,0,1,0,3,6
20100508-W-Rome-F-Maria_Jose_Martinez_Sanchez-Jelena_Jankovic,2,S-DTM,2,1,1,0,0,2,0
20100508-W-Rome-F-Maria_Jose_Martinez_Sanchez-Jelena_Jankovic,2,S-DTL,3,0,0,0,0,1,2
20180403-W-Charleston-R64-Ashleigh_Barty-Sofia_Kenin,1,F-XC,33,11,6,2,3,17,16
20180403-W-Charleston-R64-Ashleigh_Barty-Sofia_Kenin,1,F-DTM,5,1,0,0,1,1,4
20180403-W-Charleston-R64-Ashleigh_Barty-Sofia_Kenin,1,F-DTL,7,6,3,0,3,3,4
20180403-W-Charleston-R64-Ashleigh_Barty-Sofia_Kenin,1,F-IO,10,4,3,1,0,9,1
20180403-W-Charleston-R64-Ashleigh_Barty-Sofia_Kenin,1,F-II,1,1,0,1,0,1,0
20180403-W-Charleston-R64-Ashleigh_Barty-Sofia_Kenin,1,B-XC,9,3,0,1,2,5,4
20180403-W-Charleston-R64-Ashleigh_Barty-Sofia_Kenin,1,B-DTM,14,3,0,0,3,7,7
20180403-W-Charleston-R64-Ashleigh_Barty-Sofia_Kenin,1,B-DTL,3,2,0,0,2,0,3
20180403-W-Charleston-R64-Ashleigh_Barty-Sofia_Kenin,1,B-IO,2,0,0,0,0,0,2
20180403-W-Charleston-R64-Ashleigh_Barty-Sofia_Kenin,1,S-XC,15,3,1,0,2,10,5
20180403-W-Charleston-R64-Ashleigh_Barty-Sofia_Kenin,1,S-DTM,18,0,0,0,0,10,8
20180403-W-Charleston-R64-Ashleigh_Barty-Sofia_Kenin,1,S-DTL,7,2,0,0,2,2,5
20180403-W-Charleston-R64-Ashleigh_Barty-Sofia_Kenin,2,F-XC,34,7,1,3,3,20,14
20180403-W-Charleston-R64-Ashleigh_Barty-Sofia_Kenin,2,F-DTM,16,1,0,0,1,8,8
20180403-W-Charleston-R64-Ashleigh_Barty-Sofia_Kenin,2,F-DTL,5,2,0,1,1,2,3
20180403-W-Charleston-R64-Ashleigh_Barty-Sofia_Kenin,2,F-IO,7,4,0,1,3,1,6
20180403-W-Charleston-R64-Ashleigh_Barty-Sofia_Kenin,2,F-II,2,2,1,0,1,1,1
20180403-W-Charleston-R64-Ashleigh_Barty-Sofia_Kenin,2,B-XC,31,4,1,0,3,13,18
20180403-W-Charleston-R64-Ashleigh_Barty-Sofia_Kenin,2,B-DTM,5,0,0,0,0,2,3
20180403-W-Charleston-R64-Ashleigh_Barty-Sofia_Kenin,2,B-DTL,6,3,1,1,1,3,3
20180403-W-Charleston-R64-Ashleigh_Barty-Sofia_Kenin,2,B-IO,3,1,0,0,1,1,2
20180403-W-Charleston-R64-Ashleigh_Barty-Sofia_Kenin,2,S-XC,6,1,1,0,0,5,1
20180403-W-Charleston-R64-Ashleigh_Barty-Sofia_Kenin,2,S-DTM,2,0,0,0,0,0,2
20180403-W-Charleston-R64-Ashleigh_Barty-Sofia_Kenin,2,S-DTL,1,1,0,1,0,1,0
20180404-W-Charleston-R32-Ashleigh_Barty-Tatjana_Maria,1,F-XC,44,16,8,3,5,31,13
20180404-W-Charleston-R32-Ashleigh_Barty-Tatjana_Maria,1,F-DTM,21,2,0,0,2,15,6
20180404-W-Charleston-R32-Ashleigh_Barty-Tatjana_Maria,1,F-DTL,9,4,2,1,1,6,3
20180404-W-Charleston-R32-Ashleigh_Barty-Tatjana_Maria,1,F-IO,32,9,5,1,3,21,11
20180404-W-Charleston-R32-Ashleigh_Barty-Tatjana_Maria,1,F-II,11,5,2,1,2,8,3
20180404-W-Charleston-R32-Ashleigh_Barty-Tatjana_Maria,1,B-XC,15,3,2,0,1,7,8
20180404-W-Charleston-R32-Ashleigh_Barty-Tatjana_Maria,1,B-DTM,6,1,0,0,1,3,3
20180404-W-Charleston-R32-Ashleigh_Barty-Tatjana_Maria,1,B-DTL,3,2,2,0,0,3,0
20180404-W-Charleston-R32-Ashleigh_Barty-Tatjana_Maria,1,S-XC,17,3,1,0,2,7,10
20180404-W-Charleston-R32-Ashleigh_Barty-Tatjana_Maria,1,S-DTM,2,0,0,0,0,0,2
20180404-W-Charleston-R32-Ashleigh_Barty-Tatjana_Maria,1,S-DTL,5,2,1,0,1,4,1
20180404-W-Charleston-R32-Ashleigh_Barty-Tatjana_Maria,2,F-XC,26,7,2,2,3,8,18
20180404-W-Charleston-R32-Ashleigh_Barty-Tatjana_Maria,2,F-DTM,11,1,0,0,1,4,7
20180404-W-Charleston-R32-Ashleigh_Barty-Tatjana_Maria,2,F-DTL,6,0,0,0,0,2,4
20180404-W-Charleston-R32-Ashleigh_Barty-Tatjana_Maria,2,F-IO,11,2,1,1,0,7,4
20180404-W-Charleston-R32-Ashleigh_Barty-Tatjana_Maria,2,F-II,4,3,1,1,1,3,1
20180404-W-Charleston-R32-Ashleigh_Barty-Tatjana_Maria,2,B-XC,7,2,0,1,1,3,4
20180404-W-Charleston-R32-Ashleigh_Barty-Tatjana_Maria,2,B-DTM,9,1,0,0,1,2,7
20180404-W-Charleston-R32-Ashleigh_Barty-Tatjana_Maria,2,B-DTL,3,2,1,0,1,2,1
20180404-W-Charleston-R32-Ashleigh_Barty-Tatjana_Maria,2,B-IO,1,1,0,1,0,1,0
20180404-W-Charleston-R32-Ashleigh_Barty-Tatjana_Maria,2,S-XC,29,3,0,1,2,13,16
20180404-W-Charleston-R32-Ashleigh_Barty-Tatjana_Maria,2,S-DTM,15,0,0,0,0,7,8
20180404-W-Charleston-R32-Ashleigh_Barty-Tatjana_Maria,2,S-DTL,13,2,0,0,2,3,10
20180404-W-Charleston-R32-Ashleigh_Barty-Tatjana_Maria,2,S-IO,1,0,0,0,0,0,1
20180405-W-Charleston-R16-Ashleigh_Barty-Anastasija_Sevastova,1,F-XC,29,14,4,5,5,13,16
20180405-W-Charleston-R16-Ashleigh_Barty-Anastasija_Sevastova,1,F-DTM,6,1,0,1,0,4,2
20180405-W-Charleston-R16-Ashleigh_Barty-Anastasija_Sevastova,1,F-DTL,3,2,0,0,2,1,2
20180405-W-Charleston-R16-Ashleigh_Barty-Anastasija_Sevastova,1,F-IO,24,7,3,0,4,12,12
20180405-W-Charleston-R16-Ashleigh_Barty-Anastasija_Sevastova,1,F-II,10,6,3,2,1,6,4
20180405-W-Charleston-R16-Ashleigh_Barty-Anastasija_Sevastova,1,B-XC,19,4,0,1,3,6,13
20180405-W-Charleston-R16-Ashleigh_Barty-Anastasija_Sevastova,1,B-DTM,7,0,0,0,0,2,5
20180405-W-Charleston-R16-Ashleigh_Barty-Anastasija_Sevastova,1,B-DTL,6,5,2,1,2,3,3
20180405-W-Charleston-R16-Ashleigh_Barty-Anastasija_Sevastova,1,B-IO,1,1,0,0,1,0,1
20180405-W-Charleston-R16-Ashleigh_Barty-Anastasija_Sevastova,1,S-XC,8,0,0,0,0,2,6
20180405-W-Charleston-R16-Ashleigh_Barty-Anastasija_Sevastova,1,S-DTM,2,0,0,0,0,2,0
20180405-W-Charleston-R16-Ashleigh_Barty-Anastasija_Sevastova,1,S-DTL,2,0,0,0,0,1,1
20180405-W-Charleston-R16-Ashleigh_Barty-Anastasija_Sevastova,1,S-IO,1,1,0,0,1,0,1
20180405-W-Charleston-R16-Ashleigh_Barty-Anastasija_Sevastova,2,F-XC,20,8,4,3,1,12,8
20180405-W-Charleston-R16-Ashleigh_Barty-Anastasija_Sevastova,2,F-DTM,15,1,0,1,0,12,3
20180405-W-Charleston-R16-Ashleigh_Barty-Anastasija_Sevastova,2,F-DTL,4,1,0,1,0,3,1
20180405-W-Charleston-R16-Ashleigh_Barty-Anastasija_Sevastova,2,F-IO,6,2,0,0,2,1,5
20180405-W-Charleston-R16-Ashleigh_Barty-Anastasija_Sevastova,2,F-II,2,2,1,1,0,2,0
20180405-W-Charleston-R16-Ashleigh_Barty-Anastasija_Sevastova,2,B-XC,28,2,1,1,0,19,9
20180405-W-Charleston-R16-Ashleigh_Barty-Anastasija_Sevastova,2,B-DTM,8,0,0,0,0,1,7
20180405-W-Charleston-R16-Ashleigh_Barty-Anastasija_Sevastova,2,B-DTL,6,1,1,0,0,6,0
20180405-W-Charleston-R16-Ashleigh_Barty-Anastasija_Sevastova,2,B-IO,1,0,0,0,0,1,0
20180405-W-Charleston-R16-Ashleigh_Barty-Anastasija_Sevastova,2,S-XC,6,0,0,0,0,5,1
20180405-W-Charleston-R16-Ashleigh_Barty-Anastasija_Sevastova,2,S-DTM,1,0,0,0,0,1,0
20180405-W-Charleston-R16-Ashleigh_Barty-Anastasija_Sevastova,2,S-DTL,3,1,0,0,1,1,2
20180405-W-Charleston-R16-Ashleigh_Barty-Anastasija_Sevastova,2,S-IO,1,0,0,0,0,0,1
20180402-W-Charleston-R64-Jennifer_Brady-Naomi_Osaka,1,F-XC,23,5,2,1,2,14,9
20180402-W-Charleston-R64-Jennifer_Brady-Naomi_Osaka,1,F-DTM,11,0,0,0,0,7,4
20180402-W-Charleston-R64-Jennifer_Brady-Naomi_Osaka,1,F-DTL,5,2,1,1,0,4,1
20180402-W-Charleston-R64-Jennifer_Brady-Naomi_Osaka,1,F-IO,11,5,2,1,2,6,5
20180402-W-Charleston-R64-Jennifer_Brady-Naomi_Osaka,1,F-II,2,1,0,0,1,0,2
20180402-W-Charleston-R64-Jennifer_Brady-Naomi_Osaka,1,B-XC,29,11,2,4,5,16,13
20180402-W-Charleston-R64-Jennifer_Brady-Naomi_Osaka,1,B-DTM,13,0,0,0,0,8,5
20180402-W-Charleston-R64-Jennifer_Brady-Naomi_Osaka,1,B-DTL,6,3,1,1,1,2,4
20180402-W-Charleston-R64-Jennifer_Brady-Naomi_Osaka,1,B-IO,1,0,0,0,0,1,0
20180402-W-Charleston-R64-Jennifer_Brady-Naomi_Osaka,1,S-XC,4,0,0,0,0,1,3
20180402-W-Charleston-R64-Jennifer_Brady-Naomi_Osaka,1,S-DTM,3,1,0,0,1,0,3
20180402-W-Charleston-R64-Jennifer_Brady-Naomi_Osaka,1,S-DTL,5,0,0,0,0,2,3
20180402-W-Charleston-R64-Jennifer_Brady-Naomi_Osaka,2,F-XC,25,8,2,2,4,10,15
20180402-W-Charleston-R64-Jennifer_Brady-Naomi_Osaka,2,F-DTM,10,0,0,0,0,6,4
20180402-W-Charleston-R64-Jennifer_Brady-Naomi_Osaka,2,F-DTL,14,5,3,2,0,11,3
20180402-W-Charleston-R64-Jennifer_Brady-Naomi_Osaka,2,F-IO,14,3,2,0,1,9,5
20180402-W-Charleston-R64-Jennifer_Brady-Naomi_Osaka,2,B-XC,33,7,2,2,3,18,15
20180402-W-Charleston-R64-Jennifer_Brady-Naomi_Osaka,2,B-DTM,7,1,0,0,1,3,4
20180402-W-Charleston-R64-Jennifer_Brady-Naomi_Osaka,2,B-DTL,10,7,5,0,2,6,4
20180402-W-Charleston-R64-Jennifer_Brady-Naomi_Osaka,2,B-IO,7,4,3,0,1,3,4
20180402-W-Charleston-R64-Jennifer_Brady-Naomi_Osaka,2,S-XC,1,1,0,0,1,0,1
20180402-W-Charleston-R64-Jennifer_Brady-Naomi_Osaka,2,S-DTM,1,0,0,0,0,0,1
20180402-W-Charleston-R64-Jennifer_Brady-Naomi_Osaka,2,S-DTL,1,0,0,0,0,0,1
20180405-W-Charleston-R16-Naomi_Osaka-Julia_Goerges,1,F-XC,20,9,3,3,3,10,10
20180405-W-Charleston-R16-Naomi_Osaka-Julia_Goerges,1,F-DTM,8,1,0,0,1,4,4
20180405-W-Charleston-R16-Naomi_Osaka-Julia_Goerges,1,F-DTL,10,1,1,0,0,3,7
20180405-W-Charleston-R16-Naomi_Osaka-Julia_Goerges,1,F-IO,12,3,2,1,0,5,7
20180405-W-Charleston-R16-Naomi_Osaka-Julia_Goerges,1,B-XC,28,5,1,1,3,12,16
20180405-W-Charleston-R16-Naomi_Osaka-Julia_Goerges,1,B-DTM,12,2,0,0,2,6,6
20180405-W-Charleston-R16-Naomi_Osaka-Julia_Goerges,1,B-DTL,10,5,0,0,5,3,7
20180405-W-Charleston-R16-Naomi_Osaka-Julia_Goerges,1,B-IO,12,8,5,2,1,9,3
20180405-W-Charleston-R16-Naomi_Osaka-Julia_Goerges,1,S-DTL,2,0,0,0,0,2,0
20180405-W-Charleston-R16-Naomi_Osaka-Julia_Goerges,2,F-XC,26,8,2,2,4,13,13
20180405-W-Charleston-R16-Naomi_Osaka-Julia_Goerges,2,F-DTM,9,0,0,0,0,6,3
20180405-W-Charleston-R16-Naomi_Osaka-Julia_Goerges,2,F-DTL,6,5,3,0,2,3,3
20180405-W-Charleston-R16-Naomi_Osaka-Julia_Goerges,2,F-IO,14,12,5,0,7,6,8
20180405-W-Charleston-R16-Naomi_Osaka-Julia_Goerges,2,F-II,1,1,1,0,0,1,0
20180405-W-Charleston-R16-Naomi_Osaka-Julia_Goerges,2,B-XC,20,4,1,1,2,10,10
20180405-W-Charleston-R16-Naomi_Osaka-Julia_Goerges,2,B-DTM,10,0,0,0,0,4,6
20180405-W-Charleston-R16-Naomi_Osaka-Julia_Goerges,2,B-DTL,5,2,2,0,0,4,1
20180405-W-Charleston-R16-Naomi_Osaka-Julia_Goerges,2,B-IO,1,0,0,0,0,1,0
20180405-W-Charleston-R16-Naomi_Osaka-Julia_Goerges,2,S-XC,4,0,0,0,0,3,1
20180405-W-Charleston-R16-Naomi_Osaka-Julia_Goerges,2,S-DTM,8,0,0,0,0,5,3
20180404-W-Charleston-R32-Naomi_Osaka-Laura_Siegemund,1,F-XC,26,13,2,8,3,17,9
20180404-W-Charleston-R32-Naomi_Osaka-Laura_Siegemund,1,F-DTM,6,2,1,0,1,4,2
20180404-W-Charleston-R32-Naomi_Osaka-Laura_Siegemund,1,F-DTL,8,3,2,0,1,3,5
20180404-W-Charleston-R32-Naomi_Osaka-Laura_Siegemund,1,F-IO,16,7,2,0,5,6,10
20180404-W-Charleston-R32-Naomi_Osaka-Laura_Siegemund,1,F-II,1,1,0,0,1,0,1
20180404-W-Charleston-R32-Naomi_Osaka-Laura_Siegemund,1,B-XC,32,11,3,5,3,16,16
20180404-W-Charleston-R32-Naomi_Osaka-Laura_Siegemund,1,B-DTM,21,1,0,1,0,9,12
20180404-W-Charleston-R32-Naomi_Osaka-Laura_Siegemund,1,B-DTL,11,6,3,1,2,7,4
20180404-W-Charleston-R32-Naomi_Osaka-Laura_Siegemund,1,B-IO,13,7,3,0,4,7,6
20180404-W-Charleston-R32-Naomi_Osaka-Laura_Siegemund,1,S-XC,2,1,1,0,0,1,1
20180404-W-Charleston-R32-Naomi_Osaka-Laura_Siegemund,2,F-XC,15,5,2,2,1,10,5
20180404-W-Charleston-R32-Naomi_Osaka-Laura_Siegemund,2,F-DTM,7,1,1,0,0,5,2
20180404-W-Charleston-R32-Naomi_Osaka-Laura_Siegemund,2,F-DTL,10,5,2,2,1,5,5
20180404-W-Charleston-R32-Naomi_Osaka-Laura_Siegemund,2,F-IO,7,3,2,0,1,3,4
20180404-W-Charleston-R32-Naomi_Osaka-Laura_Siegemund,2,F-II,1,1,0,0,1,0,1
20180404-W-Charleston-R32-Naomi_Osaka-Laura_Siegemund,2,B-XC,21,2,0,1,1,13,8
20180404-W-Charleston-R32-Naomi_Osaka-Laura_Siegemund,2,B-DTM,17,3,0,1,2,11,6
20180404-W-Charleston-R32-Naomi_Osaka-Laura_Siegemund,2,B-DTL,10,6,3,2,1,7,3
20180404-W-Charleston-R32-Naomi_Osaka-Laura_Siegemund,2,B-IO,10,6,3,1,2,6,4
20180404-W-Charleston-R32-Naomi_Osaka-Laura_Siegemund,2,S-XC,7,2,0,0,2,3,4
20180404-W-Charleston-R32-Naomi_Osaka-Laura_Siegemund,2,S-DTM,7,0,0,0,0,5,2
20180426-W-Stuttgart-R16-Karolina_Pliskova-Veronika_Kudermetova,1,F-XC,16,5,3,1,1,7,9
20180426-W-Stuttgart-R16-Karolina_Pliskova-Veronika_Kudermetova,1,F-DTM,6,1,0,0,1,3,3
20180426-W-Stuttgart-R16-Karolina_Pliskova-Veronika_Kudermetova,1,F-DTL,5,5,1,2,2,3,2
20180426-W-Stuttgart-R16-Karolina_Pliskova-Veronika_Kudermetova,1,F-IO,9,9,4,3,2,7,2
20180426-W-Stuttgart-R16-Karolina_Pliskova-Veronika_Kudermetova,1,B-XC,12,3,0,1,2,7,5
20180426-W-Stuttgart-R16-Karolina_Pliskova-Veronika_Kudermetova,1,B-DTM,11,0,0,0,0,4,7
20180426-W-Stuttgart-R16-Karolina_Pliskova-Veronika_Kudermetova,1,B-DTL,7,2,2,0,0,5,2
20180426-W-Stuttgart-R16-Karolina_Pliskova-Veronika_Kudermetova,1,B-IO,7,2,1,0,1,3,4
20180426-W-Stuttgart-R16-Karolina_Pliskova-Veronika_Kudermetova,1,S-XC,4,0,0,0,0,2,2
20180426-W-Stuttgart-R16-Karolina_Pliskova-Veronika_Kudermetova,1,S-DTM,5,1,0,0,1,1,4
20180426-W-Stuttgart-R16-Karolina_Pliskova-Veronika_Kudermetova,1,S-DTL,1,0,0,0,0,0,1
20180426-W-Stuttgart-R16-Karolina_Pliskova-Veronika_Kudermetova,2,F-XC,30,10,3,6,1,21,9
20180426-W-Stuttgart-R16-Karolina_Pliskova-Veronika_Kudermetova,2,F-DTM,8,1,0,0,1,3,5
20180426-W-Stuttgart-R16-Karolina_Pliskova-Veronika_Kudermetova,2,F-DTL,10,6,4,0,2,6,4
20180426-W-Stuttgart-R16-Karolina_Pliskova-Veronika_Kudermetova,2,F-IO,12,5,2,0,3,3,9
20180426-W-Stuttgart-R16-Karolina_Pliskova-Veronika_Kudermetova,2,B-XC,18,7,2,1,4,11,7
20180426-W-Stuttgart-R16-Karolina_Pliskova-Veronika_Kudermetova,2,B-DTM,8,0,0,0,0,4,4
20180426-W-Stuttgart-R16-Karolina_Pliskova-Veronika_Kudermetova,2,B-DTL,5,5,2,0,3,2,3
20180426-W-Stuttgart-R16-Karolina_Pliskova-Veronika_Kudermetova,2,B-IO,1,0,0,0,0,0,1
20180426-W-Stuttgart-R16-Karolina_Pliskova-Veronika_Kudermetova,2,S-XC,3,0,0,0,0,1,2
20180407-W-Charleston-QF-Alize_Cornet-Kiki_Bertens,1,F-XC,76,11,2,4,5,37,39
20180407-W-Charleston-QF-Alize_Cornet-Kiki_Bertens,1,F-DTM,34,0,0,0,0,17,17
20180407-W-Charleston-QF-Alize_Cornet-Kiki_Bertens,1,F-DTL,23,5,2,0,3,11,12
20180407-W-Charleston-QF-Alize_Cornet-Kiki_Bertens,1,F-IO,28,1,0,0,1,17,11
20180407-W-Charleston-QF-Alize_Cornet-Kiki_Bertens,1,F-II,1,0,0,0,0,0,1
20180407-W-Charleston-QF-Alize_Cornet-Kiki_Bertens,1,B-XC,61,5,1,1,3,31,30
20180407-W-Charleston-QF-Alize_Cornet-Kiki_Bertens,1,B-DTM,16,0,0,0,0,5,11
20180407-W-Charleston-QF-Alize_Cornet-Kiki_Bertens,1,B-DTL,4,2,1,1,0,4,0
20180407-W-Charleston-QF-Alize_Cornet-Kiki_Bertens,1,B-IO,3,0,0,0,0,2,1
20180407-W-Charleston-QF-Alize_Cornet-Kiki_Bertens,1,S-XC,12,3,0,0,3,3,9
20180407-W-Charleston-QF-Alize_Cornet-Kiki_Bertens,1,S-DTM,8,1,0,0,1,2,6
20180407-W-Charleston-QF-Alize_Cornet-Kiki_Bertens,1,S-IO,1,1,0,1,0,1,0
20180407-W-Charleston-QF-Alize_Cornet-Kiki_Bertens,2,F-XC,53,8,2,3,3,30,23
20180407-W-Charleston-QF-Alize_Cornet-Kiki_Bertens,2,F-DTM,24,0,0,0,0,13,11
20180407-W-Charleston-QF-Alize_Cornet-Kiki_Bertens,2,F-DTL,20,4,1,1,2,10,10
20180407-W-Charleston-QF-Alize_Cornet-Kiki_Bertens,2,F-IO,28,5,1,1,3,17,11
20180407-W-Charleston-QF-Alize_Cornet-Kiki_Bertens,2,F-II,7,1,0,0,1,4,3
20180407-W-Charleston-QF-Alize_Cornet-Kiki_Bertens,2,B-XC,32,7,1,2,4,14,18
20180407-W-Charleston-QF-Alize_Cornet-Kiki_Bertens,2,B-DTM,56,4,0,0,4,24,32
20180407-W-Charleston-QF-Alize_Cornet-Kiki_Bertens,2,B-DTL,21,5,3,1,1,10,11
20180407-W-Charleston-QF-Alize_Cornet-Kiki_Bertens,2,B-IO,8,4,1,1,2,4,4
20180407-W-Charleston-QF-Alize_Cornet-Kiki_Bertens,2,S-XC,16,2,0,1,1,8,8
20180407-W-Charleston-QF-Alize_Cornet-Kiki_Bertens,2,S-DTM,5,0,0,0,0,3,2
20180407-W-Charleston-QF-Alize_Cornet-Kiki_Bertens,2,S-DTL,1,1,0,0,1,0,1
20180407-W-Charleston-QF-Alize_Cornet-Kiki_Bertens,2,S-IO,1,0,0,0,0,1,0
20180408-W-Charleston-SF-Madison_Keys-Kiki_Bertens,1,F-XC,85,14,2,4,8,34,51
20180408-W-Charleston-SF-Madison_Keys-Kiki_Bertens,1,F-DTM,38,3,0,0,3,14,24
20180408-W-Charleston-SF-Madison_Keys-Kiki_Bertens,1,F-DTL,27,13,2,2,9,11,16
20180408-W-Charleston-SF-Madison_Keys-Kiki_Bertens,1,F-IO,69,25,7,9,9,41,28
20180408-W-Charleston-SF-Madison_Keys-Kiki_Bertens,1,F-II,12,5,2,2,1,11,1
20180408-W-Charleston-SF-Madison_Keys-Kiki_Bertens,1,B-XC,70,21,3,5,13,28,42
20180408-W-Charleston-SF-Madison_Keys-Kiki_Bertens,1,B-DTM,20,3,0,0,3,6,14
20180408-W-Charleston-SF-Madison_Keys-Kiki_Bertens,1,B-DTL,15,12,6,0,6,7,8
20180408-W-Charleston-SF-Madison_Keys-Kiki_Bertens,1,B-IO,5,2,0,0,2,0,5
20180408-W-Charleston-SF-Madison_Keys-Kiki_Bertens,1,S-XC,1,0,0,0,0,0,1
20180408-W-Charleston-SF-Madison_Keys-Kiki_Bertens,1,S-DTM,2,0,0,0,0,0,2
20180408-W-Charleston-SF-Madison_Keys-Kiki_Bertens,1,S-DTL,2,0,0,0,0,1,1
20180408-W-Charleston-SF-Madison_Keys-Kiki_Bertens,2,F-XC,80,18,2,6,10,48,32
20180408-W-Charleston-SF-Madison_Keys-Kiki_Bertens,2,F-DTM,40,1,0,0,1,21,19
20180408-W-Charleston-SF-Madison_Keys-Kiki_Bertens,2,F-DTL,24,8,1,2,5,13,11
20180408-W-Charleston-SF-Madison_Keys-Kiki_Bertens,2,F-IO,27,10,5,2,3,17,10
20180408-W-Charleston-SF-Madison_Keys-Kiki_Bertens,2,F-II,4,2,0,1,1,2,2
20180408-W-Charleston-SF-Madison_Keys-Kiki_Bertens,2,B-XC,49,10,2,1,7,27,22
20180408-W-Charleston-SF-Madison_Keys-Kiki_Bertens,2,B-DTM,41,1,0,0,1,23,18
20180408-W-Charleston-SF-Madison_Keys-Kiki_Bertens,2,B-DTL,24,7,2,2,3,13,11
20180408-W-Charleston-SF-Madison_Keys-Kiki_Bertens,2,B-IO,3,2,1,0,1,2,1
20180408-W-Charleston-SF-Madison_Keys-Kiki_Bertens,2,B-II,1,0,0,0,0,0,1
20180408-W-Charleston-SF-Madison_Keys-Kiki_Bertens,2,S-XC,13,1,0,0,1,6,7
20180408-W-Charleston-SF-Madison_Keys-Kiki_Bertens,2,S-DTM,10,0,0,0,0,5,5
20180408-W-Charleston-SF-Madison_Keys-Kiki_Bertens,2,S-DTL,1,0,0,0,0,1,0
20180408-W-Charleston-SF-Madison_Keys-Kiki_Bertens,2,S-II,1,0,0,0,0,0,1
20170813-W-Toronto-F-Caroline_Wozniacki-Elina_Svitolina,1,F-XC,41,6,1,2,3,21,20
20170813-W-Toronto-F-Caroline_Wozniacki-Elina_Svitolina,1,F-DTM,19,0,0,0,0,7,12
20170813-W-Toronto-F-Caroline_Wozniacki-Elina_Svitolina,1,F-DTL,19,1,0,1,0,10,9
20170813-W-Toronto-F-Caroline_Wozniacki-Elina_Svitolina,1,F-IO,18,3,1,0,2,7,11
20170813-W-Toronto-F-Caroline_Wozniacki-Elina_Svitolina,1,B-XC,68,12,1,5,6,30,38
20170813-W-Toronto-F-Caroline_Wozniacki-Elina_Svitolina,1,B-DTM,31,1,0,0,1,15,16
20170813-W-Toronto-F-Caroline_Wozniacki-Elina_Svitolina,1,B-DTL,12,3,1,1,1,5,7
20170813-W-Toronto-F-Caroline_Wozniacki-Elina_Svitolina,1,B-IO,10,1,0,0,1,4,6
20170813-W-Toronto-F-Caroline_Wozniacki-Elina_Svitolina,1,S-XC,2,0,0,0,0,1,1
20170813-W-Toronto-F-Caroline_Wozniacki-Elina_Svitolina,1,S-DTM,3,0,0,0,0,1,2
20170813-W-Toronto-F-Caroline_Wozniacki-Elina_Svitolina,1,S-DTL,1,0,0,0,0,0,1
20170813-W-Toronto-F-Caroline_Wozniacki-Elina_Svitolina,2,F-XC,50,12,2,7,3,28,22
20170813-W-Toronto-F-Caroline_Wozniacki-Elina_Svitolina,2,F-DTM,25,2,0,1,1,17,8
20170813-W-Toronto-F-Caroline_Wozniacki-Elina_Svitolina,2,F-DTL,6,3,2,0,1,3,3
20170813-W-Toronto-F-Caroline_Wozniacki-Elina_Svitolina,2,F-IO,6,4,0,1,3,3,3
20170813-W-Toronto-F-Caroline_Wozniacki-Elina_Svitolina,2,F-II,1,1,1,0,0,1,0
20170813-W-Toronto-F-Caroline_Wozniacki-Elina_Svitolina,2,B-XC,75,5,2,2,1,41,34
20170813-W-Toronto-F-Caroline_Wozniacki-Elina_Svitolina,2,B-DTM,46,4,0,1,3,21,25
20170813-W-Toronto-F-Caroline_Wozniacki-Elina_Svitolina,2,B-DTL,10,5,1,2,2,6,4
20170813-W-Toronto-F-Caroline_Wozniacki-Elina_Svitolina,2,B-IO,5,2,0,0,2,2,3
20170813-W-Toronto-F-Caroline_Wozniacki-Elina_Svitolina,2,S-XC,3,1,0,1,0,2,1
20170813-W-Toronto-F-Caroline_Wozniacki-Elina_Svitolina,2,S-DTL,1,0,0,0,0,0,1
20180221-W-Dubai-R16-Daria_Kasatkina-Johanna_Konta,1,F-XC,78,25,9,4,12,40,38
20180221-W-Dubai-R16-Daria_Kasatkina-Johanna_Konta,1,F-DTM,27,0,0,0,0,15,12
20180221-W-Dubai-R16-Daria_Kasatkina-Johanna_Konta,1,F-DTL,22,5,3,1,1,13,9
20180221-W-Dubai-R16-Daria_Kasatkina-Johanna_Konta,1,F-IO,46,11,3,3,5,28,18
20180221-W-Dubai-R16-Daria_Kasatkina-Johanna_Konta,1,F-II,5,1,1,0,0,4,1
20180221-W-Dubai-R16-Daria_Kasatkina-Johanna_Konta,1,B-XC,56,7,2,0,5,31,25
20180221-W-Dubai-R16-Daria_Kasatkina-Johanna_Konta,1,B-DTM,21,1,0,0,1,14,7
20180221-W-Dubai-R16-Daria_Kasatkina-Johanna_Konta,1,B-DTL,17,8,1,2,5,9,8
20180221-W-Dubai-R16-Daria_Kasatkina-Johanna_Konta,1,B-IO,6,1,0,0,1,2,4
20180221-W-Dubai-R16-Daria_Kasatkina-Johanna_Konta,1,S-XC,16,0,0,0,0,7,9
20180221-W-Dubai-R16-Daria_Kasatkina-Johanna_Konta,1,S-DTM,13,0,0,0,0,7,6
20180221-W-Dubai-R16-Daria_Kasatkina-Johanna_Konta,1,S-DTL,9,1,0,1,0,7,2
20180221-W-Dubai-R16-Daria_Kasatkina-Johanna_Konta,1,S-IO,1,0,0,0,0,1,0
20180221-W-Dubai-R16-Daria_Kasatkina-Johanna_Konta,2,F-XC,93,25,7,5,13,50,43
20180221-W-Dubai-R16-Daria_Kasatkina-Johanna_Konta,2,F-DTM,27,7,1,1,5,10,17
20180221-W-Dubai-R16-Daria_Kasatkina-Johanna_Konta,2,F-DTL,33,12,1,4,7,13,20
20180221-W-Dubai-R16-Daria_Kasatkina-Johanna_Konta,2,F-IO,33,16,7,5,4,18,15
20180221-W-Dubai-R16-Daria_Kasatkina-Johanna_Konta,2,F-II,2,1,0,1,0,1,1
20180221-W-Dubai-R16-Daria_Kasatkina-Johanna_Konta,2,B-XC,90,13,1,1,11,38,52
20180221-W-Dubai-R16-Daria_Kasatkina-Johanna_Konta,2,B-DTM,32,4,0,0,4,10,22
20180221-W-Dubai-R16-Daria_Kasatkina-Johanna_Konta,2,B-DTL,28,12,1,5,6,17,11
20180221-W-Dubai-R16-Daria_Kasatkina-Johanna_Konta,2,B-IO,3,1,0,0,1,0,3
20180221-W-Dubai-R16-Daria_Kasatkina-Johanna_Konta,2,S-XC,5,1,0,0,1,3,2
20180221-W-Dubai-R16-Daria_Kasatkina-Johanna_Konta,2,S-DTM,1,0,0,0,0,1,0
20180221-W-Dubai-R16-Daria_Kasatkina-Johanna_Konta,2,S-DTL,1,1,0,0,1,0,1
20180223-W-Dubai-SF-Garbine_Muguruza-Daria_Kasatkina,1,F-XC,87,9,0,3,6,37,50
20180223-W-Dubai-SF-Garbine_Muguruza-Daria_Kasatkina,1,F-DTM,30,5,0,0,5,11,19
20180223-W-Dubai-SF-Garbine_Muguruza-Daria_Kasatkina,1,F-DTL,36,10,3,0,7,17,19
20180223-W-Dubai-SF-Garbine_Muguruza-Daria_Kasatkina,1,F-IO,25,8,1,1,6,10,15
20180223-W-Dubai-SF-Garbine_Muguruza-Daria_Kasatkina,1,B-XC,119,19,2,4,13,49,70
20180223-W-Dubai-SF-Garbine_Muguruza-Daria_Kasatkina,1,B-DTM,45,5,1,0,4,18,27
20180223-W-Dubai-SF-Garbine_Muguruza-Daria_Kasatkina,1,B-DTL,24,8,2,2,4,9,15
20180223-W-Dubai-SF-Garbine_Muguruza-Daria_Kasatkina,1,B-IO,26,6,3,0,3,18,8
20180223-W-Dubai-SF-Garbine_Muguruza-Daria_Kasatkina,1,S-XC,1,0,0,0,0,0,1
20180223-W-Dubai-SF-Garbine_Muguruza-Daria_Kasatkina,2,F-XC,104,24,6,3,15,59,45
20180223-W-Dubai-SF-Garbine_Muguruza-Daria_Kasatkina,2,F-DTM,39,2,0,0,2,20,19
20180223-W-Dubai-SF-Garbine_Muguruza-Daria_Kasatkina,2,F-DTL,25,6,1,1,4,15,10
20180223-W-Dubai-SF-Garbine_Muguruza-Daria_Kasatkina,2,F-IO,56,13,7,2,4,34,22
20180223-W-Dubai-SF-Garbine_Muguruza-Daria_Kasatkina,2,F-II,5,1,0,1,0,5,0
20180223-W-Dubai-SF-Garbine_Muguruza-Daria_Kasatkina,2,B-XC,53,3,0,1,2,29,24
20180223-W-Dubai-SF-Garbine_Muguruza-Daria_Kasatkina,2,B-DTM,49,5,0,1,4,23,26
20180223-W-Dubai-SF-Garbine_Muguruza-Daria_Kasatkina,2,B-DTL,24,7,4,0,3,13,11
20180223-W-Dubai-SF-Garbine_Muguruza-Daria_Kasatkina,2,B-IO,9,1,0,0,1,7,2
20180223-W-Dubai-SF-Garbine_Muguruza-Daria_Kasatkina,2,S-XC,8,1,0,0,1,6,2
20180223-W-Dubai-SF-Garbine_Muguruza-Daria_Kasatkina,2,S-DTM,12,0,0,0,0,4,8
20180223-W-Dubai-SF-Garbine_Muguruza-Daria_Kasatkina,2,S-DTL,6,0,0,0,0,2,4
20180315-W-Indian_Wells-QF-Angelique_Kerber-Daria_Kasatkina,1,F-XC,45,6,1,2,3,15,30
20180315-W-Indian_Wells-QF-Angelique_Kerber-Daria_Kasatkina,1,F-DTM,3,1,0,0,1,1,2
20180315-W-Indian_Wells-QF-Angelique_Kerber-Daria_Kasatkina,1,F-DTL,20,8,0,2,6,8,12
20180315-W-Indian_Wells-QF-Angelique_Kerber-Daria_Kasatkina,1,F-IO,15,7,2,1,4,6,9
20180315-W-Indian_Wells-QF-Angelique_Kerber-Daria_Kasatkina,1,F-II,2,1,0,0,1,0,2
20180315-W-Indian_Wells-QF-Angelique_Kerber-Daria_Kasatkina,1,B-XC,45,8,3,0,5,23,22
20180315-W-Indian_Wells-QF-Angelique_Kerber-Daria_Kasatkina,1,B-DTM,7,0,0,0,0,2,5
20180315-W-Indian_Wells-QF-Angelique_Kerber-Daria_Kasatkina,1,B-DTL,13,4,1,1,2,4,9
20180315-W-Indian_Wells-QF-Angelique_Kerber-Daria_Kasatkina,1,S-XC,5,0,0,0,0,2,3
20180315-W-Indian_Wells-QF-Angelique_Kerber-Daria_Kasatkina,1,S-DTM,1,0,0,0,0,0,1
20180315-W-Indian_Wells-QF-Angelique_Kerber-Daria_Kasatkina,1,S-IO,1,0,0,0,0,0,1
20180315-W-Indian_Wells-QF-Angelique_Kerber-Daria_Kasatkina,2,F-XC,44,5,1,0,4,20,24
20180315-W-Indian_Wells-QF-Angelique_Kerber-Daria_Kasatkina,2,F-DTM,11,0,0,0,0,8,3
20180315-W-Indian_Wells-QF-Angelique_Kerber-Daria_Kasatkina,2,F-DTL,16,7,5,0,2,11,5
20180315-W-Indian_Wells-QF-Angelique_Kerber-Daria_Kasatkina,2,F-IO,10,5,2,1,2,6,4
20180315-W-Indian_Wells-QF-Angelique_Kerber-Daria_Kasatkina,2,F-II,5,1,1,0,0,3,2
20180315-W-Indian_Wells-QF-Angelique_Kerber-Daria_Kasatkina,2,B-XC,18,3,3,0,0,14,4
20180315-W-Indian_Wells-QF-Angelique_Kerber-Daria_Kasatkina,2,B-DTM,6,0,0,0,0,4,2
20180315-W-Indian_Wells-QF-Angelique_Kerber-Daria_Kasatkina,2,B-DTL,5,1,1,0,0,3,2
20180315-W-Indian_Wells-QF-Angelique_Kerber-Daria_Kasatkina,2,B-IO,1,0,0,0,0,0,1
20180315-W-Indian_Wells-QF-Angelique_Kerber-Daria_Kasatkina,2,S-XC,8,1,1,0,0,6,2
20180315-W-Indian_Wells-QF-Angelique_Kerber-Daria_Kasatkina,2,S-DTM,9,0,0,0,0,7,2
20180315-W-Indian_Wells-QF-Angelique_Kerber-Daria_Kasatkina,2,S-DTL,6,0,0,0,0,3,3
20180315-W-Indian_Wells-QF-Angelique_Kerber-Daria_Kasatkina,2,S-IO,2,1,0,0,1,1,1
20151004-W-Wuhan-F-Venus_Williams-Garbine_Muguruza,1,F-XC,21,1,1,0,0,10,11
20151004-W-Wuhan-F-Venus_Williams-Garbine_Muguruza,1,F-DTM,15,3,1,0,2,11,4
20151004-W-Wuhan-F-Venus_Williams-Garbine_Muguruza,1,F-DTL,1,0,0,0,0,0,1
20151004-W-Wuhan-F-Venus_Williams-Garbine_Muguruza,1,F-IO,12,7,3,3,1,8,4
20151004-W-Wuhan-F-Venus_Williams-Garbine_Muguruza,1,B-XC,9,2,1,0,1,4,5
20151004-W-Wuhan-F-Venus_Williams-Garbine_Muguruza,1,B-DTM,16,2,0,1,1,7,9
20151004-W-Wuhan-F-Venus_Williams-Garbine_Muguruza,1,B-DTL,1,0,0,0,0,0,1
20151004-W-Wuhan-F-Venus_Williams-Garbine_Muguruza,1,B-IO,1,1,0,0,1,0,1
20151004-W-Wuhan-F-Venus_Williams-Garbine_Muguruza,1,S-DTM,2,0,0,0,0,0,2
20151004-W-Wuhan-F-Venus_Williams-Garbine_Muguruza,2,F-XC,30,12,2,2,8,12,18
20151004-W-Wuhan-F-Venus_Williams-Garbine_Muguruza,2,F-DTM,16,3,0,0,3,6,10
20151004-W-Wuhan-F-Venus_Williams-Garbine_Muguruza,2,F-DTL,4,3,0,2,1,3,1
20151004-W-Wuhan-F-Venus_Williams-Garbine_Muguruza,2,F-IO,5,5,1,1,3,2,3
20151004-W-Wuhan-F-Venus_Williams-Garbine_Muguruza,2,B-XC,16,4,1,2,1,9,7
20151004-W-Wuhan-F-Venus_Williams-Garbine_Muguruza,2,B-DTM,16,0,0,0,0,6,10
20151004-W-Wuhan-F-Venus_Williams-Garbine_Muguruza,2,B-IO,1,0,0,0,0,1,0
20170529-W-Roland_Garros-R128-Kiki_Bertens-Ajla_Tomljanovic,1,F-XC,32,7,2,2,3,12,20
20170529-W-Roland_Garros-R128-Kiki_Bertens-Ajla_Tomljanovic,1,F-DTM,29,6,1,2,3,13,16
20170529-W-Roland_Garros-R128-Kiki_Bertens-Ajla_Tomljanovic,1,F-DTL,4,3,1,0,2,1,3
20170529-W-Roland_Garros-R128-Kiki_Bertens-Ajla_Tomljanovic,1,F-IO,10,5,1,1,3,5,5
20170529-W-Roland_Garros-R128-Kiki_Bertens-Ajla_Tomljanovic,1,F-II,1,0,0,0,0,1,0
20170529-W-Roland_Garros-R128-Kiki_Bertens-Ajla_Tomljanovic,1,B-XC,15,4,0,1,3,7,8
20170529-W-Roland_Garros-R128-Kiki_Bertens-Ajla_Tomljanovic,1,B-DTM,17,1,0,0,1,11,6
20170529-W-Roland_Garros-R128-Kiki_Bertens-Ajla_Tomljanovic,1,B-DTL,9,2,0,0,2,3,6
20170529-W-Roland_Garros-R128-Kiki_Bertens-Ajla_Tomljanovic,1,B-IO,5,2,0,0,2,1,4
20170529-W-Roland_Garros-R128-Kiki_Bertens-Ajla_Tomljanovic,1,S-XC,8,2,0,0,2,0,8
20170529-W-Roland_Garros-R128-Kiki_Bertens-Ajla_Tomljanovic,1,S-DTM,7,0,0,0,0,1,6
20170529-W-Roland_Garros-R128-Kiki_Bertens-Ajla_Tomljanovic,1,S-DTL,1,0,0,0,0,0,1
20170529-W-Roland_Garros-R128-Kiki_Bertens-Ajla_Tomljanovic,2,F-XC,34,7,0,2,5,18,16
20170529-W-Roland_Garros-R128-Kiki_Bertens-Ajla_Tomljanovic,2,F-DTM,30,3,1,0,2,18,12
20170529-W-Roland_Garros-R128-Kiki_Bertens-Ajla_Tomljanovic,2,F-DTL,14,5,1,2,2,9,5
20170529-W-Roland_Garros-R128-Kiki_Bertens-Ajla_Tomljanovic,2,F-IO,17,7,2,1,4,13,4
20170529-W-Roland_Garros-R128-Kiki_Bertens-Ajla_Tomljanovic,2,F-II,3,2,0,0,2,1,2
20170529-W-Roland_Garros-R128-Kiki_Bertens-Ajla_Tomljanovic,2,B-XC,23,3,1,0,2,9,14
20170529-W-Roland_Garros-R128-Kiki_Bertens-Ajla_Tomljanovic,2,B-DTM,13,1,0,0,1,6,7
20170529-W-Roland_Garros-R128-Kiki_Bertens-Ajla_Tomljanovic,2,B-DTL,5,1,1,0,0,4,1
20170529-W-Roland_Garros-R128-Kiki_Bertens-Ajla_Tomljanovic,2,B-IO,3,1,0,0,1,1,2
20170529-W-Roland_Garros-R128-Kiki_Bertens-Ajla_Tomljanovic,2,B-II,1,0,0,0,0,1,0
20170529-W-Roland_Garros-R128-Kiki_Bertens-Ajla_Tomljanovic,2,S-DTM,1,0,0,0,0,0,1
20170529-W-Roland_Garros-R128-Kiki_Bertens-Ajla_Tomljanovic,2,S-DTL,1,0,0,0,0,1,0
20170601-W-Roland_Garros-R64-Sorana_Cirstea-Carla_Suarez_Navarro,1,F-XC,41,14,5,2,7,23,18
20170601-W-Roland_Garros-R64-Sorana_Cirstea-Carla_Suarez_Navarro,1,F-DTM,14,2,0,1,1,7,7
20170601-W-Roland_Garros-R64-Sorana_Cirstea-Carla_Suarez_Navarro,1,F-DTL,10,5,2,0,3,5,5
20170601-W-Roland_Garros-R64-Sorana_Cirstea-Carla_Suarez_Navarro,1,F-IO,16,6,0,3,3,5,11
20170601-W-Roland_Garros-R64-Sorana_Cirstea-Carla_Suarez_Navarro,1,F-II,1,0,0,0,0,0,1
20170601-W-Roland_Garros-R64-Sorana_Cirstea-Carla_Suarez_Navarro,1,B-XC,49,9,0,3,6,24,25
20170601-W-Roland_Garros-R64-Sorana_Cirstea-Carla_Suarez_Navarro,1,B-DTM,35,3,0,0,3,12,23
20170601-W-Roland_Garros-R64-Sorana_Cirstea-Carla_Suarez_Navarro,1,B-DTL,19,7,1,2,4,10,9
20170601-W-Roland_Garros-R64-Sorana_Cirstea-Carla_Suarez_Navarro,1,B-IO,12,9,5,1,3,7,5
20170601-W-Roland_Garros-R64-Sorana_Cirstea-Carla_Suarez_Navarro,1,S-XC,2,0,0,0,0,0,2
20170601-W-Roland_Garros-R64-Sorana_Cirstea-Carla_Suarez_Navarro,1,S-DTM,2,0,0,0,0,1,1
20170601-W-Roland_Garros-R64-Sorana_Cirstea-Carla_Suarez_Navarro,1,S-DTL,1,0,0,0,0,0,1
20170601-W-Roland_Garros-R64-Sorana_Cirstea-Carla_Suarez_Navarro,1,S-IO,1,0,0,0,0,1,0
20170601-W-Roland_Garros-R64-Sorana_Cirstea-Carla_Suarez_Navarro,2,F-XC,39,15,4,2,9,19,20
20170601-W-Roland_Garros-R64-Sorana_Cirstea-Carla_Suarez_Navarro,2,F-DTM,27,1,0,0,1,11,16
20170601-W-Roland_Garros-R64-Sorana_Cirstea-Carla_Suarez_Navarro,2,F-DTL,14,3,2,1,0,8,6
20170601-W-Roland_Garros-R64-Sorana_Cirstea-Carla_Suarez_Navarro,2,F-IO,18,3,0,1,2,15,3
20170601-W-Roland_Garros-R64-Sorana_Cirstea-Carla_Suarez_Navarro,2,F-II,1,1,1,0,0,1,0
20170601-W-Roland_Garros-R64-Sorana_Cirstea-Carla_Suarez_Navarro,2,B-XC,44,12,5,3,4,25,19
20170601-W-Roland_Garros-R64-Sorana_Cirstea-Carla_Suarez_Navarro,2,B-DTM,30,2,0,0,2,15,15
20170601-W-Roland_Garros-R64-Sorana_Cirstea-Carla_Suarez_Navarro,2,B-DTL,7,4,2,0,2,4,3
20170601-W-Roland_Garros-R64-Sorana_Cirstea-Carla_Suarez_Navarro,2,B-IO,1,0,0,0,0,0,1
20170601-W-Roland_Garros-R64-Sorana_Cirstea-Carla_Suarez_Navarro,2,S-XC,10,0,0,0,0,3,7
20170601-W-Roland_Garros-R64-Sorana_Cirstea-Carla_Suarez_Navarro,2,S-DTM,5,0,0,0,0,2,3
20170529-W-Roland_Garros-R128-Anett_Kontaveit-Monica_Niculescu,1,F-XC,42,13,11,0,2,23,19
20170529-W-Roland_Garros-R128-Anett_Kontaveit-Monica_Niculescu,1,F-DTM,10,1,1,0,0,7,3
20170529-W-Roland_Garros-R128-Anett_Kontaveit-Monica_Niculescu,1,F-DTL,12,8,5,0,3,6,6
20170529-W-Roland_Garros-R128-Anett_Kontaveit-Monica_Niculescu,1,F-IO,11,4,3,0,1,6,5
20170529-W-Roland_Garros-R128-Anett_Kontaveit-Monica_Niculescu,1,F-II,2,1,0,1,0,2,0
20170529-W-Roland_Garros-R128-Anett_Kontaveit-Monica_Niculescu,1,B-XC,37,4,3,0,1,21,16
20170529-W-Roland_Garros-R128-Anett_Kontaveit-Monica_Niculescu,1,B-DTM,13,1,0,0,1,7,6
20170529-W-Roland_Garros-R128-Anett_Kontaveit-Monica_Niculescu,1,B-DTL,17,5,2,1,2,11,6
20170529-W-Roland_Garros-R128-Anett_Kontaveit-Monica_Niculescu,1,B-IO,14,7,4,2,1,11,3
20170529-W-Roland_Garros-R128-Anett_Kontaveit-Monica_Niculescu,1,S-XC,3,1,1,0,0,1,2
20170529-W-Roland_Garros-R128-Anett_Kontaveit-Monica_Niculescu,1,S-DTM,1,0,0,0,0,0,1
20170529-W-Roland_Garros-R128-Anett_Kontaveit-Monica_Niculescu,1,S-DTL,3,0,0,0,0,0,3
20170529-W-Roland_Garros-R128-Anett_Kontaveit-Monica_Niculescu,2,F-XC,2,0,0,0,0,0,2
20170529-W-Roland_Garros-R128-Anett_Kontaveit-Monica_Niculescu,2,F-DTM,4,1,1,0,0,1,3
20170529-W-Roland_Garros-R128-Anett_Kontaveit-Monica_Niculescu,2,F-DTL,2,0,0,0,0,2,0
20170529-W-Roland_Garros-R128-Anett_Kontaveit-Monica_Niculescu,2,F-IO,1,0,0,0,0,1,0
20170529-W-Roland_Garros-R128-Anett_Kontaveit-Monica_Niculescu,2,F-II,2,1,0,1,0,1,1
20170529-W-Roland_Garros-R128-Anett_Kontaveit-Monica_Niculescu,2,B-XC,19,6,0,5,1,10,9
20170529-W-Roland_Garros-R128-Anett_Kontaveit-Monica_Niculescu,2,B-DTM,5,0,0,0,0,4,1
20170529-W-Roland_Garros-R128-Anett_Kontaveit-Monica_Niculescu,2,B-DTL,11,4,1,1,2,7,4
20170529-W-Roland_Garros-R128-Anett_Kontaveit-Monica_Niculescu,2,B-IO,2,1,1,0,0,2,0
20170529-W-Roland_Garros-R128-Anett_Kontaveit-Monica_Niculescu,2,B-II,1,1,1,0,0,1,0
20170529-W-Roland_Garros-R128-Anett_Kontaveit-Monica_Niculescu,2,S-XC,6,0,0,0,0,2,4
20170529-W-Roland_Garros-R128-Anett_Kontaveit-Monica_Niculescu,2,S-DTM,7,0,0,0,0,4,3
20170529-W-Roland_Garros-R128-Anett_Kontaveit-Monica_Niculescu,2,S-DTL,1,0,0,0,0,0,1
20170604-W-Roland_Garros-R32-Anastasija_Sevastova-Petra_Martic,1,F-XC,33,13,3,0,10,13,20
20170604-W-Roland_Garros-R32-Anastasija_Sevastova-Petra_Martic,1,F-DTM,13,1,0,1,0,4,9
20170604-W-Roland_Garros-R32-Anastasija_Sevastova-Petra_Martic,1,F-DTL,12,5,3,0,2,4,8
20170604-W-Roland_Garros-R32-Anastasija_Sevastova-Petra_Martic,1,F-IO,13,4,1,1,2,9,4
20170604-W-Roland_Garros-R32-Anastasija_Sevastova-Petra_Martic,1,F-II,1,0,0,0,0,1,0
20170604-W-Roland_Garros-R32-Anastasija_Sevastova-Petra_Martic,1,B-XC,26,5,0,0,5,7,19
20170604-W-Roland_Garros-R32-Anastasija_Sevastova-Petra_Martic,1,B-DTM,6,1,0,0,1,3,3
20170604-W-Roland_Garros-R32-Anastasija_Sevastova-Petra_Martic,1,B-DTL,3,0,0,0,0,0,3
20170604-W-Roland_Garros-R32-Anastasija_Sevastova-Petra_Martic,1,S-XC,3,1,0,1,0,3,0
20170604-W-Roland_Garros-R32-Anastasija_Sevastova-Petra_Martic,1,S-DTM,2,0,0,0,0,0,2
20170604-W-Roland_Garros-R32-Anastasija_Sevastova-Petra_Martic,1,S-DTL,1,1,0,0,1,0,1
20170604-W-Roland_Garros-R32-Anastasija_Sevastova-Petra_Martic,2,F-XC,26,11,3,2,6,17,9
20170604-W-Roland_Garros-R32-Anastasija_Sevastova-Petra_Martic,2,F-DTM,13,0,0,0,0,7,6
20170604-W-Roland_Garros-R32-Anastasija_Sevastova-Petra_Martic,2,F-DTL,8,3,3,0,0,5,3
20170604-W-Roland_Garros-R32-Anastasija_Sevastova-Petra_Martic,2,F-IO,8,1,0,1,0,6,2
20170604-W-Roland_Garros-R32-Anastasija_Sevastova-Petra_Martic,2,B-XC,14,2,0,1,1,6,8
20170604-W-Roland_Garros-R32-Anastasija_Sevastova-Petra_Martic,2,B-DTM,8,0,0,0,0,5,3
20170604-W-Roland_Garros-R32-Anastasija_Sevastova-Petra_Martic,2,B-DTL,3,0,0,0,0,2,1
20170604-W-Roland_Garros-R32-Anastasija_Sevastova-Petra_Martic,2,B-IO,2,0,0,0,0,1,1
20170604-W-Roland_Garros-R32-Anastasija_Sevastova-Petra_Martic,2,S-XC,6,1,0,0,1,3,3
20170604-W-Roland_Garros-R32-Anastasija_Sevastova-Petra_Martic,2,S-DTM,14,1,0,0,1,7,7
20170604-W-Roland_Garros-R32-Anastasija_Sevastova-Petra_Martic,2,S-DTL,6,2,1,1,0,5,1
20180317-W-Indian_Wells-SF-Venus_Williams-Daria_Kasatkina,1,F-XC,80,27,4,5,18,33,47
20180317-W-Indian_Wells-SF-Venus_Williams-Daria_Kasatkina,1,F-DTM,35,3,0,0,3,14,21
20180317-W-Indian_Wells-SF-Venus_Williams-Daria_Kasatkina,1,F-DTL,53,8,3,1,4,29,24
20180317-W-Indian_Wells-SF-Venus_Williams-Daria_Kasatkina,1,F-IO,67,14,7,1,6,39,28
20180317-W-Indian_Wells-SF-Venus_Williams-Daria_Kasatkina,1,F-II,6,1,0,0,1,3,3
20180317-W-Indian_Wells-SF-Venus_Williams-Daria_Kasatkina,1,B-XC,159,13,2,2,9,77,82
20180317-W-Indian_Wells-SF-Venus_Williams-Daria_Kasatkina,1,B-DTM,30,2,0,0,2,15,15
20180317-W-Indian_Wells-SF-Venus_Williams-Daria_Kasatkina,1,B-DTL,37,13,4,2,7,18,19
20180317-W-Indian_Wells-SF-Venus_Williams-Daria_Kasatkina,1,B-IO,4,1,0,0,1,2,2
20180317-W-Indian_Wells-SF-Venus_Williams-Daria_Kasatkina,1,S-XC,18,2,1,0,1,10,8
20180317-W-Indian_Wells-SF-Venus_Williams-Daria_Kasatkina,1,S-DTM,6,1,0,0,1,1,5
20180317-W-Indian_Wells-SF-Venus_Williams-Daria_Kasatkina,1,S-DTL,1,0,0,0,0,1,0
20180317-W-Indian_Wells-SF-Venus_Williams-Daria_Kasatkina,2,F-XC,72,11,6,2,3,41,31
20180317-W-Indian_Wells-SF-Venus_Williams-Daria_Kasatkina,2,F-DTM,31,1,0,0,1,21,10
20180317-W-Indian_Wells-SF-Venus_Williams-Daria_Kasatkina,2,F-DTL,22,5,2,2,1,13,9
20180317-W-Indian_Wells-SF-Venus_Williams-Daria_Kasatkina,2,F-IO,68,15,6,5,4,35,33
20180317-W-Indian_Wells-SF-Venus_Williams-Daria_Kasatkina,2,F-II,19,6,0,1,5,6,13
20180317-W-Indian_Wells-SF-Venus_Williams-Daria_Kasatkina,2,B-XC,104,6,2,1,3,54,50
20180317-W-Indian_Wells-SF-Venus_Williams-Daria_Kasatkina,2,B-DTM,54,3,0,1,2,24,30
20180317-W-Indian_Wells-SF-Venus_Williams-Daria_Kasatkina,2,B-DTL,28,4,1,0,3,14,14
20180317-W-Indian_Wells-SF-Venus_Williams-Daria_Kasatkina,2,B-IO,2,1,1,0,0,2,0
20180317-W-Indian_Wells-SF-Venus_Williams-Daria_Kasatkina,2,S-XC,42,1,0,0,1,18,24
20180317-W-Indian_Wells-SF-Venus_Williams-Daria_Kasatkina,2,S-DTM,26,0,0,0,0,14,12
20180317-W-Indian_Wells-SF-Venus_Williams-Daria_Kasatkina,2,S-DTL,9,2,1,0,1,1,8
20180524-W-Roland_Garros-Q2-Veronika_Kudermetova-Nicole_Gibbs,1,F-XC,63,18,3,3,12,34,29
20180524-W-Roland_Garros-Q2-Veronika_Kudermetova-Nicole_Gibbs,1,F-DTM,14,0,0,0,0,9,5
20180524-W-Roland_Garros-Q2-Veronika_Kudermetova-Nicole_Gibbs,1,F-DTL,9,4,2,1,1,8,1
20180524-W-Roland_Garros-Q2-Veronika_Kudermetova-Nicole_Gibbs,1,F-IO,22,6,3,0,3,15,7
20180524-W-Roland_Garros-Q2-Veronika_Kudermetova-Nicole_Gibbs,1,B-XC,44,12,2,5,5,20,24
20180524-W-Roland_Garros-Q2-Veronika_Kudermetova-Nicole_Gibbs,1,B-DTM,16,3,0,1,2,9,7
20180524-W-Roland_Garros-Q2-Veronika_Kudermetova-Nicole_Gibbs,1,B-DTL,14,8,2,3,3,10,4
20180524-W-Roland_Garros-Q2-Veronika_Kudermetova-Nicole_Gibbs,1,B-IO,15,6,2,1,3,8,7
20180524-W-Roland_Garros-Q2-Veronika_Kudermetova-Nicole_Gibbs,1,B-II,1,0,0,0,0,1,0
20180524-W-Roland_Garros-Q2-Veronika_Kudermetova-Nicole_Gibbs,1,S-XC,10,0,0,0,0,5,5
20180524-W-Roland_Garros-Q2-Veronika_Kudermetova-Nicole_Gibbs,1,S-DTM,2,0,0,0,0,1,1
20180524-W-Roland_Garros-Q2-Veronika_Kudermetova-Nicole_Gibbs,1,S-DTL,1,0,0,0,0,1,0
20180524-W-Roland_Garros-Q2-Veronika_Kudermetova-Nicole_Gibbs,2,F-XC,36,3,1,0,2,7,29
20180524-W-Roland_Garros-Q2-Veronika_Kudermetova-Nicole_Gibbs,2,F-DTM,28,1,0,0,1,15,13
20180524-W-Roland_Garros-Q2-Veronika_Kudermetova-Nicole_Gibbs,2,F-DTL,16,7,1,1,5,6,10
20180524-W-Roland_Garros-Q2-Veronika_Kudermetova-Nicole_Gibbs,2,F-IO,22,6,1,1,4,12,10
20180524-W-Roland_Garros-Q2-Veronika_Kudermetova-Nicole_Gibbs,2,F-II,2,1,1,0,0,1,1
20180524-W-Roland_Garros-Q2-Veronika_Kudermetova-Nicole_Gibbs,2,B-XC,18,4,0,1,3,4,14
20180524-W-Roland_Garros-Q2-Veronika_Kudermetova-Nicole_Gibbs,2,B-DTM,31,0,0,0,0,15,16
20180524-W-Roland_Garros-Q2-Veronika_Kudermetova-Nicole_Gibbs,2,B-DTL,6,4,1,0,3,2,4
20180524-W-Roland_Garros-Q2-Veronika_Kudermetova-Nicole_Gibbs,2,B-IO,4,0,0,0,0,2,2
20180524-W-Roland_Garros-Q2-Veronika_Kudermetova-Nicole_Gibbs,2,S-XC,12,2,0,1,1,8,4
20180524-W-Roland_Garros-Q2-Veronika_Kudermetova-Nicole_Gibbs,2,S-DTM,11,0,0,0,0,4,7
20180524-W-Roland_Garros-Q2-Veronika_Kudermetova-Nicole_Gibbs,2,S-DTL,1,0,0,0,0,1,0
20180605-W-Roland_Garros-QF-Sloane_Stephens-Daria_Kasatkina,1,F-XC,41,11,6,5,0,26,15
20180605-W-Roland_Garros-QF-Sloane_Stephens-Daria_Kasatkina,1,F-DTM,28,2,0,1,1,12,16
20180605-W-Roland_Garros-QF-Sloane_Stephens-Daria_Kasatkina,1,F-DTL,12,4,1,2,1,8,4
20180605-W-Roland_Garros-QF-Sloane_Stephens-Daria_Kasatkina,1,F-IO,28,12,4,5,3,18,10
20180605-W-Roland_Garros-QF-Sloane_Stephens-Daria_Kasatkina,1,F-II,2,0,0,0,0,1,1
20180605-W-Roland_Garros-QF-Sloane_Stephens-Daria_Kasatkina,1,B-XC,54,4,1,1,2,32,22
20180605-W-Roland_Garros-QF-Sloane_Stephens-Daria_Kasatkina,1,B-DTM,47,5,0,0,5,20,27
20180605-W-Roland_Garros-QF-Sloane_Stephens-Daria_Kasatkina,1,B-DTL,18,4,1,1,2,11,7
20180605-W-Roland_Garros-QF-Sloane_Stephens-Daria_Kasatkina,1,B-IO,2,0,0,0,0,1,1
20180605-W-Roland_Garros-QF-Sloane_Stephens-Daria_Kasatkina,1,S-XC,3,0,0,0,0,2,1
20180605-W-Roland_Garros-QF-Sloane_Stephens-Daria_Kasatkina,1,S-DTM,3,0,0,0,0,0,3
20180605-W-Roland_Garros-QF-Sloane_Stephens-Daria_Kasatkina,1,S-DTL,3,0,0,0,0,1,2
20180605-W-Roland_Garros-QF-Sloane_Stephens-Daria_Kasatkina,1,S-IO,1,0,0,0,0,1,0
20180605-W-Roland_Garros-QF-Sloane_Stephens-Daria_Kasatkina,2,F-XC,55,18,4,7,7,30,25
20180605-W-Roland_Garros-QF-Sloane_Stephens-Daria_Kasatkina,2,F-DTM,34,1,0,0,1,19,15
20180605-W-Roland_Garros-QF-Sloane_Stephens-Daria_Kasatkina,2,F-DTL,8,0,0,0,0,1,7
20180605-W-Roland_Garros-QF-Sloane_Stephens-Daria_Kasatkina,2,F-IO,47,5,0,2,3,25,22
20180605-W-Roland_Garros-QF-Sloane_Stephens-Daria_Kasatkina,2,F-II,5,2,0,0,2,0,5
20180605-W-Roland_Garros-QF-Sloane_Stephens-Daria_Kasatkina,2,B-XC,29,5,0,1,4,11,18
20180605-W-Roland_Garros-QF-Sloane_Stephens-Daria_Kasatkina,2,B-DTM,22,1,0,0,1,11,11
20180605-W-Roland_Garros-QF-Sloane_Stephens-Daria_Kasatkina,2,B-DTL,14,3,2,1,0,8,6
20180605-W-Roland_Garros-QF-Sloane_Stephens-Daria_Kasatkina,2,B-IO,4,0,0,0,0,2,2
20180605-W-Roland_Garros-QF-Sloane_Stephens-Daria_Kasatkina,2,S-XC,9,0,0,0,0,4,5
20180605-W-Roland_Garros-QF-Sloane_Stephens-Daria_Kasatkina,2,S-DTM,6,0,0,0,0,2,4
20180605-W-Roland_Garros-QF-Sloane_Stephens-Daria_Kasatkina,2,S-DTL,2,0,0,0,0,0,2
20180603-W-Roland_Garros-R16-Caroline_Wozniacki-Daria_Kasatkina,1,F-XC,126,15,0,3,12,56,70
20180603-W-Roland_Garros-R16-Caroline_Wozniacki-Daria_Kasatkina,1,F-DTM,29,1,0,0,1,10,19
20180603-W-Roland_Garros-R16-Caroline_Wozniacki-Daria_Kasatkina,1,F-DTL,58,6,2,2,2,25,33
20180603-W-Roland_Garros-R16-Caroline_Wozniacki-Daria_Kasatkina,1,F-IO,40,5,3,0,2,25,15
20180603-W-Roland_Garros-R16-Caroline_Wozniacki-Daria_Kasatkina,1,F-II,3,2,0,0,2,0,3
20180603-W-Roland_Garros-R16-Caroline_Wozniacki-Daria_Kasatkina,1,B-XC,154,12,5,1,6,70,84
20180603-W-Roland_Garros-R16-Caroline_Wozniacki-Daria_Kasatkina,1,B-DTM,23,1,0,0,1,8,15
20180603-W-Roland_Garros-R16-Caroline_Wozniacki-Daria_Kasatkina,1,B-DTL,23,5,1,2,2,17,6
20180603-W-Roland_Garros-R16-Caroline_Wozniacki-Daria_Kasatkina,1,B-IO,10,3,2,0,1,5,5
20180603-W-Roland_Garros-R16-Caroline_Wozniacki-Daria_Kasatkina,1,S-XC,6,0,0,0,0,4,2
20180603-W-Roland_Garros-R16-Caroline_Wozniacki-Daria_Kasatkina,1,S-DTM,5,0,0,0,0,5,0
20180603-W-Roland_Garros-R16-Caroline_Wozniacki-Daria_Kasatkina,1,S-DTL,1,0,0,0,0,1,0
20180603-W-Roland_Garros-R16-Caroline_Wozniacki-Daria_Kasatkina,2,F-XC,116,15,2,4,9,65,51
20180603-W-Roland_Garros-R16-Caroline_Wozniacki-Daria_Kasatkina,2,F-DTM,31,0,0,0,0,13,18
20180603-W-Roland_Garros-R16-Caroline_Wozniacki-Daria_Kasatkina,2,F-DTL,37,8,6,1,1,20,17
20180603-W-Roland_Garros-R16-Caroline_Wozniacki-Daria_Kasatkina,2,F-IO,48,8,6,0,2,27,21
20180603-W-Roland_Garros-R16-Caroline_Wozniacki-Daria_Kasatkina,2,F-II,17,5,1,2,2,12,5
20180603-W-Roland_Garros-R16-Caroline_Wozniacki-Daria_Kasatkina,2,B-XC,92,10,1,3,6,45,47
20180603-W-Roland_Garros-R16-Caroline_Wozniacki-Daria_Kasatkina,2,B-DTM,49,4,0,0,4,18,31
20180603-W-Roland_Garros-R16-Caroline_Wozniacki-Daria_Kasatkina,2,B-DTL,50,10,2,3,5,35,15
20180603-W-Roland_Garros-R16-Caroline_Wozniacki-Daria_Kasatkina,2,B-IO,5,1,0,0,1,3,2
20180603-W-Roland_Garros-R16-Caroline_Wozniacki-Daria_Kasatkina,2,S-XC,17,0,0,0,0,8,9
20180603-W-Roland_Garros-R16-Caroline_Wozniacki-Daria_Kasatkina,2,S-DTM,10,0,0,0,0,8,2
20180603-W-Roland_Garros-R16-Caroline_Wozniacki-Daria_Kasatkina,2,S-DTL,5,0,0,0,0,2,3
20180119-W-Australian_Open-R32-Elina_Svitolina-Marta_Kostyuk,1,F-XC,9,4,1,0,3,5,4
20180119-W-Australian_Open-R32-Elina_Svitolina-Marta_Kostyuk,1,F-DTM,7,0,0,0,0,5,2
20180119-W-Australian_Open-R32-Elina_Svitolina-Marta_Kostyuk,1,F-DTL,5,0,0,0,0,2,3
20180119-W-Australian_Open-R32-Elina_Svitolina-Marta_Kostyuk,1,F-IO,5,3,3,0,0,5,0
20180119-W-Australian_Open-R32-Elina_Svitolina-Marta_Kostyuk,1,B-XC,9,1,0,0,1,4,5
20180119-W-Australian_Open-R32-Elina_Svitolina-Marta_Kostyuk,1,B-DTM,11,4,0,0,4,5,6
20180119-W-Australian_Open-R32-Elina_Svitolina-Marta_Kostyuk,1,B-DTL,2,1,0,1,0,2,0
20180119-W-Australian_Open-R32-Elina_Svitolina-Marta_Kostyuk,1,B-IO,3,3,1,1,1,2,1
20180119-W-Australian_Open-R32-Elina_Svitolina-Marta_Kostyuk,1,S-XC,1,0,0,0,0,1,0
20180119-W-Australian_Open-R32-Elina_Svitolina-Marta_Kostyuk,1,S-DTL,1,0,0,0,0,0,1
20180119-W-Australian_Open-R32-Elina_Svitolina-Marta_Kostyuk,2,F-XC,11,5,1,1,3,5,6
20180119-W-Australian_Open-R32-Elina_Svitolina-Marta_Kostyuk,2,F-DTM,10,1,0,0,1,2,8
20180119-W-Australian_Open-R32-Elina_Svitolina-Marta_Kostyuk,2,F-DTL,2,1,1,0,0,1,1
20180119-W-Australian_Open-R32-Elina_Svitolina-Marta_Kostyuk,2,F-IO,13,7,3,1,3,7,6
20180119-W-Australian_Open-R32-Elina_Svitolina-Marta_Kostyuk,2,B-XC,14,6,1,1,4,5,9
20180119-W-Australian_Open-R32-Elina_Svitolina-Marta_Kostyuk,2,B-DTM,16,3,0,0,3,6,10
20180119-W-Australian_Open-R32-Elina_Svitolina-Marta_Kostyuk,2,B-DTL,4,3,1,1,1,2,2
20180119-W-Australian_Open-R32-Elina_Svitolina-Marta_Kostyuk,2,B-IO,1,1,0,0,1,0,1
20180119-W-Australian_Open-R32-Elina_Svitolina-Marta_Kostyuk,2,S-DTM,1,0,0,0,0,1,0
20180122-W-Australian_Open-QF-Elina_Svitolina-Elise_Mertens,1,F-XC,32,5,2,1,2,10,22
20180122-W-Australian_Open-QF-Elina_Svitolina-Elise_Mertens,1,F-DTM,50,4,0,0,4,13,37
20180122-W-Australian_Open-QF-Elina_Svitolina-Elise_Mertens,1,F-DTL,12,3,1,1,1,4,8
20180122-W-Australian_Open-QF-Elina_Svitolina-Elise_Mertens,1,F-IO,16,7,1,2,4,6,10
20180122-W-Australian_Open-QF-Elina_Svitolina-Elise_Mertens,1,B-XC,33,3,2,0,1,12,21
20180122-W-Australian_Open-QF-Elina_Svitolina-Elise_Mertens,1,B-DTM,34,1,0,0,1,12,22
20180122-W-Australian_Open-QF-Elina_Svitolina-Elise_Mertens,1,B-DTL,4,1,0,1,0,4,0
20180122-W-Australian_Open-QF-Elina_Svitolina-Elise_Mertens,1,B-IO,5,2,1,0,1,3,2
20180122-W-Australian_Open-QF-Elina_Svitolina-Elise_Mertens,1,S-XC,2,0,0,0,0,1,1
20180122-W-Australian_Open-QF-Elina_Svitolina-Elise_Mertens,1,S-DTM,4,0,0,0,0,2,2
20180122-W-Australian_Open-QF-Elina_Svitolina-Elise_Mertens,2,F-XC,39,4,0,2,2,26,13
20180122-W-Australian_Open-QF-Elina_Svitolina-Elise_Mertens,2,F-DTM,22,1,0,0,1,13,9
20180122-W-Australian_Open-QF-Elina_Svitolina-Elise_Mertens,2,F-DTL,11,1,0,1,0,7,4
20180122-W-Australian_Open-QF-Elina_Svitolina-Elise_Mertens,2,F-IO,23,7,2,2,3,11,12
20180122-W-Australian_Open-QF-Elina_Svitolina-Elise_Mertens,2,B-XC,30,6,3,1,2,20,10
20180122-W-Australian_Open-QF-Elina_Svitolina-Elise_Mertens,2,B-DTM,32,1,1,0,0,22,10
20180122-W-Australian_Open-QF-Elina_Svitolina-Elise_Mertens,2,B-DTL,14,7,3,3,1,12,2
20180122-W-Australian_Open-QF-Elina_Svitolina-Elise_Mertens,2,B-IO,17,3,2,0,1,15,2
20180122-W-Australian_Open-QF-Elina_Svitolina-Elise_Mertens,2,S-DTM,1,0,0,0,0,1,0
20180122-W-Australian_Open-QF-Elina_Svitolina-Elise_Mertens,2,S-IO,1,0,0,0,0,0,1
20180105-W-Brisbane-SF-Karolina_Pliskova-Elina_Svitolina,1,F-XC,26,8,5,1,2,18,8
20180105-W-Brisbane-SF-Karolina_Pliskova-Elina_Svitolina,1,F-DTM,21,2,0,0,2,15,6
20180105-W-Brisbane-SF-Karolina_Pliskova-Elina_Svitolina,1,F-DTL,12,8,4,1,3,5,7
20180105-W-Brisbane-SF-Karolina_Pliskova-Elina_Svitolina,1,F-IO,16,5,0,3,2,7,9
20180105-W-Brisbane-SF-Karolina_Pliskova-Elina_Svitolina,1,B-XC,15,4,2,0,2,9,6
20180105-W-Brisbane-SF-Karolina_Pliskova-Elina_Svitolina,1,B-DTM,28,4,0,0,4,14,14
20180105-W-Brisbane-SF-Karolina_Pliskova-Elina_Svitolina,1,B-DTL,13,7,2,1,4,6,7
20180105-W-Brisbane-SF-Karolina_Pliskova-Elina_Svitolina,1,B-IO,3,1,0,0,1,2,1
20180105-W-Brisbane-SF-Karolina_Pliskova-Elina_Svitolina,1,S-XC,3,0,0,0,0,0,3
20180105-W-Brisbane-SF-Karolina_Pliskova-Elina_Svitolina,1,S-DTM,6,0,0,0,0,1,5
20180105-W-Brisbane-SF-Karolina_Pliskova-Elina_Svitolina,1,S-IO,2,0,0,0,0,2,0
20180105-W-Brisbane-SF-Karolina_Pliskova-Elina_Svitolina,2,F-XC,43,12,2,4,6,18,25
20180105-W-Brisbane-SF-Karolina_Pliskova-Elina_Svitolina,2,F-DTM,27,5,0,0,5,7,20
20180105-W-Brisbane-SF-Karolina_Pliskova-Elina_Svitolina,2,F-DTL,3,2,2,0,0,2,1
20180105-W-Brisbane-SF-Karolina_Pliskova-Elina_Svitolina,2,F-IO,22,9,6,0,3,13,9
20180105-W-Brisbane-SF-Karolina_Pliskova-Elina_Svitolina,2,F-II,2,2,1,1,0,2,0
20180105-W-Brisbane-SF-Karolina_Pliskova-Elina_Svitolina,2,B-XC,23,6,2,1,3,13,10
20180105-W-Brisbane-SF-Karolina_Pliskova-Elina_Svitolina,2,B-DTM,22,5,0,1,4,8,14
20180105-W-Brisbane-SF-Karolina_Pliskova-Elina_Svitolina,2,B-DTL,4,2,2,0,0,3,1
20180105-W-Brisbane-SF-Karolina_Pliskova-Elina_Svitolina,2,B-IO,5,2,1,0,1,3,2
20180105-W-Brisbane-SF-Karolina_Pliskova-Elina_Svitolina,2,S-XC,2,0,0,0,0,2,0
20180105-W-Brisbane-SF-Karolina_Pliskova-Elina_Svitolina,2,S-DTM,1,0,0,0,0,0,1
20180607-W-Roland_Garros-SF-Madison_Keys-Sloane_Stephens,1,F-XC,36,12,2,4,6,16,20
20180607-W-Roland_Garros-SF-Madison_Keys-Sloane_Stephens,1,F-DTM,30,3,0,2,1,10,20
20180607-W-Roland_Garros-SF-Madison_Keys-Sloane_Stephens,1,F-DTL,9,4,1,0,3,1,8
20180607-W-Roland_Garros-SF-Madison_Keys-Sloane_Stephens,1,F-IO,29,12,5,4,3,18,11
20180607-W-Roland_Garros-SF-Madison_Keys-Sloane_Stephens,1,F-II,3,0,0,0,0,2,1
20180607-W-Roland_Garros-SF-Madison_Keys-Sloane_Stephens,1,B-XC,33,8,2,1,5,15,18
20180607-W-Roland_Garros-SF-Madison_Keys-Sloane_Stephens,1,B-DTM,34,5,0,3,2,14,20
20180607-W-Roland_Garros-SF-Madison_Keys-Sloane_Stephens,1,B-DTL,9,5,3,1,1,6,3
20180607-W-Roland_Garros-SF-Madison_Keys-Sloane_Stephens,1,B-IO,2,0,0,0,0,1,1
20180607-W-Roland_Garros-SF-Madison_Keys-Sloane_Stephens,1,S-XC,1,0,0,0,0,0,1
20180607-W-Roland_Garros-SF-Madison_Keys-Sloane_Stephens,1,S-DTM,1,1,0,0,1,0,1
20180607-W-Roland_Garros-SF-Madison_Keys-Sloane_Stephens,1,S-DTL,1,1,0,1,0,1,0
20180607-W-Roland_Garros-SF-Madison_Keys-Sloane_Stephens,2,F-XC,30,6,0,4,2,22,8
20180607-W-Roland_Garros-SF-Madison_Keys-Sloane_Stephens,2,F-DTM,36,6,0,4,2,23,13
20180607-W-Roland_Garros-SF-Madison_Keys-Sloane_Stephens,2,F-DTL,7,3,1,2,0,6,1
20180607-W-Roland_Garros-SF-Madison_Keys-Sloane_Stephens,2,F-IO,17,5,3,2,0,12,5
20180607-W-Roland_Garros-SF-Madison_Keys-Sloane_Stephens,2,F-II,1,0,0,0,0,1,0
20180607-W-Roland_Garros-SF-Madison_Keys-Sloane_Stephens,2,B-XC,24,1,0,0,1,11,13
20180607-W-Roland_Garros-SF-Madison_Keys-Sloane_Stephens,2,B-DTM,29,1,0,0,1,16,13
20180607-W-Roland_Garros-SF-Madison_Keys-Sloane_Stephens,2,B-DTL,12,6,4,2,0,12,0
20180607-W-Roland_Garros-SF-Madison_Keys-Sloane_Stephens,2,B-IO,4,0,0,0,0,4,0
20180607-W-Roland_Garros-SF-Madison_Keys-Sloane_Stephens,2,S-XC,5,0,0,0,0,0,5
20180607-W-Roland_Garros-SF-Madison_Keys-Sloane_Stephens,2,S-DTM,2,0,0,0,0,0,2
20180607-W-Roland_Garros-SF-Madison_Keys-Sloane_Stephens,2,S-DTL,1,0,0,0,0,1,0
20180202-W-St_Petersburg-QF-Petra_Kvitova-Jelena_Ostapenko,1,F-XC,18,5,2,2,1,12,6
20180202-W-St_Petersburg-QF-Petra_Kvitova-Jelena_Ostapenko,1,F-DTM,8,1,0,0,1,7,1
20180202-W-St_Petersburg-QF-Petra_Kvitova-Jelena_Ostapenko,1,F-DTL,1,1,0,0,1,0,1
20180202-W-St_Petersburg-QF-Petra_Kvitova-Jelena_Ostapenko,1,F-IO,4,2,1,0,1,2,2
20180202-W-St_Petersburg-QF-Petra_Kvitova-Jelena_Ostapenko,1,B-XC,9,4,0,0,4,2,7
20180202-W-St_Petersburg-QF-Petra_Kvitova-Jelena_Ostapenko,1,B-DTM,12,1,0,0,1,6,6
20180202-W-St_Petersburg-QF-Petra_Kvitova-Jelena_Ostapenko,1,B-DTL,2,2,1,0,1,1,1
20180202-W-St_Petersburg-QF-Petra_Kvitova-Jelena_Ostapenko,1,B-IO,2,0,0,0,0,0,2
20180202-W-St_Petersburg-QF-Petra_Kvitova-Jelena_Ostapenko,1,S-XC,2,0,0,0,0,1,1
20180202-W-St_Petersburg-QF-Petra_Kvitova-Jelena_Ostapenko,1,S-DTM,1,0,0,0,0,0,1
20180202-W-St_Petersburg-QF-Petra_Kvitova-Jelena_Ostapenko,2,F-XC,20,4,0,1,3,10,10
20180202-W-St_Petersburg-QF-Petra_Kvitova-Jelena_Ostapenko,2,F-DTM,3,2,0,0,2,0,3
20180202-W-St_Petersburg-QF-Petra_Kvitova-Jelena_Ostapenko,2,F-DTL,3,2,1,0,1,1,2
20180202-W-St_Petersburg-QF-Petra_Kvitova-Jelena_Ostapenko,2,F-IO,3,3,2,1,0,3,0
20180202-W-St_Petersburg-QF-Petra_Kvitova-Jelena_Ostapenko,2,B-XC,15,3,2,1,0,7,8
20180202-W-St_Petersburg-QF-Petra_Kvitova-Jelena_Ostapenko,2,B-DTM,10,0,0,0,0,5,5
20180202-W-St_Petersburg-QF-Petra_Kvitova-Jelena_Ostapenko,2,B-DTL,4,3,0,0,3,0,4
20180202-W-St_Petersburg-QF-Petra_Kvitova-Jelena_Ostapenko,2,B-IO,4,3,0,0,3,0,4
20180202-W-St_Petersburg-QF-Petra_Kvitova-Jelena_Ostapenko,2,S-XC,1,0,0,0,0,0,1
20180202-W-St_Petersburg-QF-Petra_Kvitova-Jelena_Ostapenko,2,S-DTM,2,1,0,0,1,0,2
20040820-W-Olympics-SF-Anastasia_Myskina-Justine_Henin,1,F-XC,93,15,2,4,9,55,38
20040820-W-Olympics-SF-Anastasia_Myskina-Justine_Henin,1,F-DTM,39,3,0,1,2,24,15
20040820-W-Olympics-SF-Anastasia_Myskina-Justine_Henin,1,F-DTL,30,11,2,3,6,20,10
20040820-W-Olympics-SF-Anastasia_Myskina-Justine_Henin,1,F-IO,28,6,2,1,3,14,14
20040820-W-Olympics-SF-Anastasia_Myskina-Justine_Henin,1,B-XC,90,17,2,6,9,40,50
20040820-W-Olympics-SF-Anastasia_Myskina-Justine_Henin,1,B-DTM,72,5,0,0,5,37,35
20040820-W-Olympics-SF-Anastasia_Myskina-Justine_Henin,1,B-DTL,45,12,2,4,6,24,21
20040820-W-Olympics-SF-Anastasia_Myskina-Justine_Henin,1,B-IO,22,6,3,0,3,10,12
20040820-W-Olympics-SF-Anastasia_Myskina-Justine_Henin,1,B-II,1,0,0,0,0,0,1
20040820-W-Olympics-SF-Anastasia_Myskina-Justine_Henin,1,S-XC,1,0,0,0,0,0,1
20040820-W-Olympics-SF-Anastasia_Myskina-Justine_Henin,1,S-DTM,1,0,0,0,0,1,0
20040820-W-Olympics-SF-Anastasia_Myskina-Justine_Henin,2,F-XC,109,26,4,8,14,45,64
20040820-W-Olympics-SF-Anastasia_Myskina-Justine_Henin,2,F-DTM,34,3,0,0,3,10,24
20040820-W-Olympics-SF-Anastasia_Myskina-Justine_Henin,2,F-DTL,41,9,3,3,3,20,21
20040820-W-Olympics-SF-Anastasia_Myskina-Justine_Henin,2,F-IO,45,8,2,3,3,25,20
20040820-W-Olympics-SF-Anastasia_Myskina-Justine_Henin,2,B-XC,63,14,0,4,10,30,33
20040820-W-Olympics-SF-Anastasia_Myskina-Justine_Henin,2,B-DTM,40,3,0,0,3,11,29
20040820-W-Olympics-SF-Anastasia_Myskina-Justine_Henin,2,B-DTL,19,9,6,1,2,14,5
20040820-W-Olympics-SF-Anastasia_Myskina-Justine_Henin,2,B-IO,10,2,1,1,0,6,4
20040820-W-Olympics-SF-Anastasia_Myskina-Justine_Henin,2,S-XC,20,3,0,1,2,12,8
20040820-W-Olympics-SF-Anastasia_Myskina-Justine_Henin,2,S-DTM,8,0,0,0,0,5,3
20040820-W-Olympics-SF-Anastasia_Myskina-Justine_Henin,2,S-DTL,5,1,0,0,1,0,5
20040820-W-Olympics-SF-Anastasia_Myskina-Justine_Henin,2,S-IO,2,2,0,0,2,0,2
20180117-W-Australian_Open-R64-Elina_Svitolina-Katerina_Siniakova,1,F-XC,43,7,0,1,6,23,20
20180117-W-Australian_Open-R64-Elina_Svitolina-Katerina_Siniakova,1,F-DTM,48,1,0,0,1,24,24
20180117-W-Australian_Open-R64-Elina_Svitolina-Katerina_Siniakova,1,F-DTL,4,2,0,0,2,0,4
20180117-W-Australian_Open-R64-Elina_Svitolina-Katerina_Siniakova,1,F-IO,14,8,3,1,4,8,6
20180117-W-Australian_Open-R64-Elina_Svitolina-Katerina_Siniakova,1,F-II,1,1,1,0,0,1,0
20180117-W-Australian_Open-R64-Elina_Svitolina-Katerina_Siniakova,1,B-XC,56,7,1,2,4,26,30
20180117-W-Australian_Open-R64-Elina_Svitolina-Katerina_Siniakova,1,B-DTM,56,1,0,0,1,27,29
20180117-W-Australian_Open-R64-Elina_Svitolina-Katerina_Siniakova,1,B-DTL,5,3,0,0,3,2,3
20180117-W-Australian_Open-R64-Elina_Svitolina-Katerina_Siniakova,1,B-IO,11,3,1,1,1,8,3
20180117-W-Australian_Open-R64-Elina_Svitolina-Katerina_Siniakova,1,S-XC,3,0,0,0,0,1,2
20180117-W-Australian_Open-R64-Elina_Svitolina-Katerina_Siniakova,1,S-DTM,7,0,0,0,0,4,3
20180117-W-Australian_Open-R64-Elina_Svitolina-Katerina_Siniakova,2,F-XC,44,13,3,4,6,22,22
20180117-W-Australian_Open-R64-Elina_Svitolina-Katerina_Siniakova,2,F-DTM,36,5,0,0,5,10,26
20180117-W-Australian_Open-R64-Elina_Svitolina-Katerina_Siniakova,2,F-DTL,17,7,0,0,7,5,12
20180117-W-Australian_Open-R64-Elina_Svitolina-Katerina_Siniakova,2,F-IO,18,7,3,0,4,9,9
20180117-W-Australian_Open-R64-Elina_Svitolina-Katerina_Siniakova,2,B-XC,56,20,7,2,11,26,30
20180117-W-Australian_Open-R64-Elina_Svitolina-Katerina_Siniakova,2,B-DTM,60,5,1,1,3,32,28
20180117-W-Australian_Open-R64-Elina_Svitolina-Katerina_Siniakova,2,B-DTL,25,16,4,4,8,11,14
20180117-W-Australian_Open-R64-Elina_Svitolina-Katerina_Siniakova,2,B-IO,28,7,0,5,2,15,13
20180117-W-Australian_Open-R64-Elina_Svitolina-Katerina_Siniakova,2,S-XC,1,0,0,0,0,0,1
20180117-W-Australian_Open-R64-Elina_Svitolina-Katerina_Siniakova,2,S-DTM,4,0,0,0,0,3,1
20180117-W-Australian_Open-R64-Elina_Svitolina-Katerina_Siniakova,2,S-DTL,2,0,0,0,0,0,2
20180602-W-Roland_Garros-R32-Caroline_Garcia-Irina_Camelia_Begu,1,F-XC,47,16,7,4,5,30,17
20180602-W-Roland_Garros-R32-Caroline_Garcia-Irina_Camelia_Begu,1,F-DTM,29,0,0,0,0,18,11
20180602-W-Roland_Garros-R32-Caroline_Garcia-Irina_Camelia_Begu,1,F-DTL,8,3,3,0,0,5,3
20180602-W-Roland_Garros-R32-Caroline_Garcia-Irina_Camelia_Begu,1,F-IO,8,3,1,2,0,7,1
20180602-W-Roland_Garros-R32-Caroline_Garcia-Irina_Camelia_Begu,1,F-II,1,0,0,0,0,1,0
20180602-W-Roland_Garros-R32-Caroline_Garcia-Irina_Camelia_Begu,1,B-XC,29,6,1,1,4,16,13
20180602-W-Roland_Garros-R32-Caroline_Garcia-Irina_Camelia_Begu,1,B-DTM,13,1,0,0,1,9,4
20180602-W-Roland_Garros-R32-Caroline_Garcia-Irina_Camelia_Begu,1,B-DTL,6,3,0,1,2,3,3
20180602-W-Roland_Garros-R32-Caroline_Garcia-Irina_Camelia_Begu,1,B-IO,3,0,0,0,0,3,0
20180602-W-Roland_Garros-R32-Caroline_Garcia-Irina_Camelia_Begu,1,S-XC,1,0,0,0,0,0,1
20180602-W-Roland_Garros-R32-Caroline_Garcia-Irina_Camelia_Begu,1,S-DTM,2,0,0,0,0,2,0
20180602-W-Roland_Garros-R32-Caroline_Garcia-Irina_Camelia_Begu,1,S-DTL,1,0,0,0,0,1,0
20180602-W-Roland_Garros-R32-Caroline_Garcia-Irina_Camelia_Begu,1,S-IO,2,0,0,0,0,2,0
20180602-W-Roland_Garros-R32-Caroline_Garcia-Irina_Camelia_Begu,2,F-XC,29,8,0,2,6,8,21
20180602-W-Roland_Garros-R32-Caroline_Garcia-Irina_Camelia_Begu,2,F-DTM,28,3,0,1,2,12,16
20180602-W-Roland_Garros-R32-Caroline_Garcia-Irina_Camelia_Begu,2,F-DTL,12,6,2,1,3,4,8
20180602-W-Roland_Garros-R32-Caroline_Garcia-Irina_Camelia_Begu,2,F-IO,5,1,1,0,0,4,1
20180602-W-Roland_Garros-R32-Caroline_Garcia-Irina_Camelia_Begu,2,F-II,1,0,0,0,0,1,0
20180602-W-Roland_Garros-R32-Caroline_Garcia-Irina_Camelia_Begu,2,B-XC,32,4,1,2,1,15,17
20180602-W-Roland_Garros-R32-Caroline_Garcia-Irina_Camelia_Begu,2,B-DTM,31,5,0,1,4,7,24
20180602-W-Roland_Garros-R32-Caroline_Garcia-Irina_Camelia_Begu,2,B-DTL,10,6,2,1,3,5,5
20180602-W-Roland_Garros-R32-Caroline_Garcia-Irina_Camelia_Begu,2,B-IO,5,2,1,0,1,1,4
20180602-W-Roland_Garros-R32-Caroline_Garcia-Irina_Camelia_Begu,2,S-XC,3,0,0,0,0,2,1
20180602-W-Roland_Garros-R32-Caroline_Garcia-Irina_Camelia_Begu,2,S-DTM,2,0,0,0,0,1,1
20180602-W-Roland_Garros-R32-Caroline_Garcia-Irina_Camelia_Begu,2,S-DTL,1,0,0,0,0,1,0
20180531-W-Roland_Garros-R64-Maria_Sharapova-Donna_Vekic,1,F-XC,33,11,3,5,3,22,11
20180531-W-Roland_Garros-R64-Maria_Sharapova-Donna_Vekic,1,F-DTM,15,1,0,0,1,6,9
20180531-W-Roland_Garros-R64-Maria_Sharapova-Donna_Vekic,1,F-DTL,14,6,2,3,1,9,5
20180531-W-Roland_Garros-R64-Maria_Sharapova-Donna_Vekic,1,F-IO,18,7,7,0,0,16,2
20180531-W-Roland_Garros-R64-Maria_Sharapova-Donna_Vekic,1,B-XC,35,8,2,1,5,21,14
20180531-W-Roland_Garros-R64-Maria_Sharapova-Donna_Vekic,1,B-DTM,23,4,0,0,4,9,14
20180531-W-Roland_Garros-R64-Maria_Sharapova-Donna_Vekic,1,B-DTL,9,5,1,0,4,2,7
20180531-W-Roland_Garros-R64-Maria_Sharapova-Donna_Vekic,1,B-IO,5,4,2,2,0,5,0
20180531-W-Roland_Garros-R64-Maria_Sharapova-Donna_Vekic,1,S-XC,1,0,0,0,0,0,1
20180531-W-Roland_Garros-R64-Maria_Sharapova-Donna_Vekic,1,S-DTL,2,0,0,0,0,1,1
20180531-W-Roland_Garros-R64-Maria_Sharapova-Donna_Vekic,2,F-XC,25,4,2,0,2,12,13
20180531-W-Roland_Garros-R64-Maria_Sharapova-Donna_Vekic,2,F-DTM,20,2,0,0,2,6,14
20180531-W-Roland_Garros-R64-Maria_Sharapova-Donna_Vekic,2,F-DTL,11,7,3,2,2,7,4
20180531-W-Roland_Garros-R64-Maria_Sharapova-Donna_Vekic,2,F-IO,18,6,3,1,2,11,7
20180531-W-Roland_Garros-R64-Maria_Sharapova-Donna_Vekic,2,B-XC,26,3,0,2,1,14,12
20180531-W-Roland_Garros-R64-Maria_Sharapova-Donna_Vekic,2,B-DTM,27,2,0,0,2,6,21
20180531-W-Roland_Garros-R64-Maria_Sharapova-Donna_Vekic,2,B-DTL,14,9,7,0,2,8,6
20180531-W-Roland_Garros-R64-Maria_Sharapova-Donna_Vekic,2,B-IO,7,4,2,0,2,3,4
20180531-W-Roland_Garros-R64-Maria_Sharapova-Donna_Vekic,2,S-XC,2,0,0,0,0,0,2
20180531-W-Roland_Garros-R64-Maria_Sharapova-Donna_Vekic,2,S-DTM,3,0,0,0,0,1,2
20050127-W-Australian_Open-SF-Serena_Williams-Maria_Sharapova,1,F-XC,75,24,3,4,17,39,36
20050127-W-Australian_Open-SF-Serena_Williams-Maria_Sharapova,1,F-DTM,27,0,0,0,0,13,14
20050127-W-Australian_Open-SF-Serena_Williams-Maria_Sharapova,1,F-DTL,26,6,1,1,4,9,17
20050127-W-Australian_Open-SF-Serena_Williams-Maria_Sharapova,1,F-IO,18,10,4,3,3,11,7
20050127-W-Australian_Open-SF-Serena_Williams-Maria_Sharapova,1,F-II,1,0,0,0,0,0,1
20050127-W-Australian_Open-SF-Serena_Williams-Maria_Sharapova,1,B-XC,78,12,3,1,8,40,38
20050127-W-Australian_Open-SF-Serena_Williams-Maria_Sharapova,1,B-DTM,34,4,0,0,4,17,17
20050127-W-Australian_Open-SF-Serena_Williams-Maria_Sharapova,1,B-DTL,19,9,1,0,8,6,13
20050127-W-Australian_Open-SF-Serena_Williams-Maria_Sharapova,1,B-IO,7,3,0,1,2,4,3
20050127-W-Australian_Open-SF-Serena_Williams-Maria_Sharapova,1,S-XC,1,0,0,0,0,1,0
20050127-W-Australian_Open-SF-Serena_Williams-Maria_Sharapova,2,F-XC,62,16,4,3,9,32,30
20050127-W-Australian_Open-SF-Serena_Williams-Maria_Sharapova,2,F-DTM,18,4,0,0,4,5,13
20050127-W-Australian_Open-SF-Serena_Williams-Maria_Sharapova,2,F-DTL,29,11,1,2,8,13,16
20050127-W-Australian_Open-SF-Serena_Williams-Maria_Sharapova,2,F-IO,22,7,1,5,1,13,9
20050127-W-Australian_Open-SF-Serena_Williams-Maria_Sharapova,2,F-II,2,2,0,1,1,1,1
20050127-W-Australian_Open-SF-Serena_Williams-Maria_Sharapova,2,B-XC,65,7,2,0,5,34,31
20050127-W-Australian_Open-SF-Serena_Williams-Maria_Sharapova,2,B-DTM,32,6,0,3,3,16,16
20050127-W-Australian_Open-SF-Serena_Williams-Maria_Sharapova,2,B-DTL,36,10,0,6,4,18,18
20050127-W-Australian_Open-SF-Serena_Williams-Maria_Sharapova,2,B-IO,17,8,2,1,5,9,8
20050127-W-Australian_Open-SF-Serena_Williams-Maria_Sharapova,2,B-II,1,0,0,0,0,0,1
20050127-W-Australian_Open-SF-Serena_Williams-Maria_Sharapova,2,S-DTM,2,1,0,0,1,1,1
20130322-W-Miami-R64-Eugenie_Bouchard-Maria_Sharapova,1,F-XC,25,9,1,3,5,10,15
20130322-W-Miami-R64-Eugenie_Bouchard-Maria_Sharapova,1,F-DTM,14,2,0,1,1,4,10
20130322-W-Miami-R64-Eugenie_Bouchard-Maria_Sharapova,1,F-DTL,2,1,0,0,1,0,2
20130322-W-Miami-R64-Eugenie_Bouchard-Maria_Sharapova,1,F-IO,4,1,0,0,1,0,4
20130322-W-Miami-R64-Eugenie_Bouchard-Maria_Sharapova,1,B-XC,17,1,0,0,1,6,11
20130322-W-Miami-R64-Eugenie_Bouchard-Maria_Sharapova,1,B-DTM,9,0,0,0,0,2,7
20130322-W-Miami-R64-Eugenie_Bouchard-Maria_Sharapova,1,B-DTL,4,0,0,0,0,0,4
20130322-W-Miami-R64-Eugenie_Bouchard-Maria_Sharapova,1,B-IO,3,1,1,0,0,1,2
20130322-W-Miami-R64-Eugenie_Bouchard-Maria_Sharapova,1,S-XC,1,0,0,0,0,0,1
20130322-W-Miami-R64-Eugenie_Bouchard-Maria_Sharapova,1,S-DTM,1,0,0,0,0,0,1
20130322-W-Miami-R64-Eugenie_Bouchard-Maria_Sharapova,2,F-XC,31,11,7,2,2,23,8
20130322-W-Miami-R64-Eugenie_Bouchard-Maria_Sharapova,2,F-DTM,8,1,0,1,0,4,4
20130322-W-Miami-R64-Eugenie_Bouchard-Maria_Sharapova,2,F-DTL,6,3,1,2,0,5,1
20130322-W-Miami-R64-Eugenie_Bouchard-Maria_Sharapova,2,F-IO,5,2,0,1,1,4,1
20130322-W-Miami-R64-Eugenie_Bouchard-Maria_Sharapova,2,B-XC,18,5,1,1,3,13,5
20130322-W-Miami-R64-Eugenie_Bouchard-Maria_Sharapova,2,B-DTM,11,0,0,0,0,7,4
20130322-W-Miami-R64-Eugenie_Bouchard-Maria_Sharapova,2,B-DTL,4,3,2,1,0,4,0
20130322-W-Miami-R64-Eugenie_Bouchard-Maria_Sharapova,2,B-IO,1,0,0,0,0,1,0
20180705-W-Wimbledon-R64-Yulia_Putintseva-Daria_Kasatkina,1,F-XC,12,3,1,0,2,6,6
20180705-W-Wimbledon-R64-Yulia_Putintseva-Daria_Kasatkina,1,F-DTM,5,0,0,0,0,3,2
20180705-W-Wimbledon-R64-Yulia_Putintseva-Daria_Kasatkina,1,F-DTL,13,6,1,0,4,3,10
20180705-W-Wimbledon-R64-Yulia_Putintseva-Daria_Kasatkina,1,F-IO,7,3,2,0,1,3,4
20180705-W-Wimbledon-R64-Yulia_Putintseva-Daria_Kasatkina,1,F-II,1,0,0,0,0,0,1
20180705-W-Wimbledon-R64-Yulia_Putintseva-Daria_Kasatkina,1,B-XC,19,3,1,0,2,6,13
20180705-W-Wimbledon-R64-Yulia_Putintseva-Daria_Kasatkina,1,B-DTM,12,4,0,1,3,3,9
20180705-W-Wimbledon-R64-Yulia_Putintseva-Daria_Kasatkina,1,B-DTL,7,2,2,0,0,5,2
20180705-W-Wimbledon-R64-Yulia_Putintseva-Daria_Kasatkina,1,B-IO,3,1,1,0,0,1,2
20180705-W-Wimbledon-R64-Yulia_Putintseva-Daria_Kasatkina,1,S-XC,4,0,0,0,0,1,3
20180705-W-Wimbledon-R64-Yulia_Putintseva-Daria_Kasatkina,1,S-DTM,3,0,0,0,0,1,2
20180705-W-Wimbledon-R64-Yulia_Putintseva-Daria_Kasatkina,1,S-DTL,3,0,0,0,0,1,2
20180705-W-Wimbledon-R64-Yulia_Putintseva-Daria_Kasatkina,2,F-XC,13,4,1,1,2,8,5
20180705-W-Wimbledon-R64-Yulia_Putintseva-Daria_Kasatkina,2,F-DTM,5,1,1,0,0,3,2
20180705-W-Wimbledon-R64-Yulia_Putintseva-Daria_Kasatkina,2,F-DTL,9,0,0,0,0,5,4
20180705-W-Wimbledon-R64-Yulia_Putintseva-Daria_Kasatkina,2,F-IO,10,2,2,0,0,7,3
20180705-W-Wimbledon-R64-Yulia_Putintseva-Daria_Kasatkina,2,F-II,2,0,0,0,0,2,0
20180705-W-Wimbledon-R64-Yulia_Putintseva-Daria_Kasatkina,2,B-XC,22,3,1,1,1,14,8
20180705-W-Wimbledon-R64-Yulia_Putintseva-Daria_Kasatkina,2,B-DTM,3,0,0,0,0,3,0
20180705-W-Wimbledon-R64-Yulia_Putintseva-Daria_Kasatkina,2,B-DTL,6,3,1,1,1,5,1
20180705-W-Wimbledon-R64-Yulia_Putintseva-Daria_Kasatkina,2,B-IO,4,3,1,0,1,3,1
20180705-W-Wimbledon-R64-Yulia_Putintseva-Daria_Kasatkina,2,S-XC,5,0,0,0,0,4,1
20180705-W-Wimbledon-R64-Yulia_Putintseva-Daria_Kasatkina,2,S-DTM,7,1,0,0,1,3,4
20180705-W-Wimbledon-R64-Yulia_Putintseva-Daria_Kasatkina,2,S-DTL,1,0,0,0,0,1,0
20180705-W-Wimbledon-R64-Yulia_Putintseva-Daria_Kasatkina,2,S-IO,1,0,0,0,0,0,1
20180705-W-Wimbledon-R64-Yulia_Putintseva-Daria_Kasatkina,2,S-II,1,0,0,0,0,0,1
20180702-W-Wimbledon-R64-Caroline_Wozniacki-Ekaterina_Makarova,1,F-XC,44,8,2,2,4,20,24
20180702-W-Wimbledon-R64-Caroline_Wozniacki-Ekaterina_Makarova,1,F-DTM,33,5,0,0,5,17,16
20180702-W-Wimbledon-R64-Caroline_Wozniacki-Ekaterina_Makarova,1,F-DTL,16,7,1,1,5,4,12
20180702-W-Wimbledon-R64-Caroline_Wozniacki-Ekaterina_Makarova,1,F-IO,14,5,2,1,2,5,9
20180702-W-Wimbledon-R64-Caroline_Wozniacki-Ekaterina_Makarova,1,B-XC,45,4,1,2,1,25,20
20180702-W-Wimbledon-R64-Caroline_Wozniacki-Ekaterina_Makarova,1,B-DTM,28,3,1,0,2,8,20
20180702-W-Wimbledon-R64-Caroline_Wozniacki-Ekaterina_Makarova,1,B-DTL,5,2,1,1,0,2,3
20180702-W-Wimbledon-R64-Caroline_Wozniacki-Ekaterina_Makarova,1,B-IO,10,3,1,1,1,4,6
20180702-W-Wimbledon-R64-Caroline_Wozniacki-Ekaterina_Makarova,1,S-XC,3,1,1,0,0,2,1
20180702-W-Wimbledon-R64-Caroline_Wozniacki-Ekaterina_Makarova,1,S-DTM,11,0,0,0,0,5,6
20180702-W-Wimbledon-R64-Caroline_Wozniacki-Ekaterina_Makarova,1,S-DTL,2,1,0,1,0,2,0
20180702-W-Wimbledon-R64-Caroline_Wozniacki-Ekaterina_Makarova,2,F-XC,40,13,6,3,4,28,12
20180702-W-Wimbledon-R64-Caroline_Wozniacki-Ekaterina_Makarova,2,F-DTM,18,2,0,0,2,8,10
20180702-W-Wimbledon-R64-Caroline_Wozniacki-Ekaterina_Makarova,2,F-DTL,30,12,5,0,7,16,14
20180702-W-Wimbledon-R64-Caroline_Wozniacki-Ekaterina_Makarova,2,F-IO,19,10,4,0,6,11,8
20180702-W-Wimbledon-R64-Caroline_Wozniacki-Ekaterina_Makarova,2,B-XC,46,8,4,0,4,27,19
20180702-W-Wimbledon-R64-Caroline_Wozniacki-Ekaterina_Makarova,2,B-DTM,25,3,1,0,2,13,12
20180702-W-Wimbledon-R64-Caroline_Wozniacki-Ekaterina_Makarova,2,B-DTL,18,7,3,2,2,10,8
20180702-W-Wimbledon-R64-Caroline_Wozniacki-Ekaterina_Makarova,2,B-IO,16,8,5,0,3,8,8
20180702-W-Wimbledon-R64-Caroline_Wozniacki-Ekaterina_Makarova,2,B-II,1,1,1,0,0,1,0
20180702-W-Wimbledon-R64-Caroline_Wozniacki-Ekaterina_Makarova,2,S-DTM,4,0,0,0,0,2,2
20180702-W-Wimbledon-R64-Caroline_Wozniacki-Ekaterina_Makarova,2,S-DTL,1,0,0,0,0,0,1
20180714-W-Wimbledon-F-Serena_Williams-Angelique_Kerber,1,F-XC,23,6,1,1,4,9,14
20180714-W-Wimbledon-F-Serena_Williams-Angelique_Kerber,1,F-DTM,15,1,0,0,1,6,9
20180714-W-Wimbledon-F-Serena_Williams-Angelique_Kerber,1,F-DTL,6,3,1,1,1,3,3
20180714-W-Wimbledon-F-Serena_Williams-Angelique_Kerber,1,F-IO,16,6,2,1,3,9,7
20180714-W-Wimbledon-F-Serena_Williams-Angelique_Kerber,1,F-II,1,1,1,0,0,1,0
20180714-W-Wimbledon-F-Serena_Williams-Angelique_Kerber,1,B-XC,28,9,2,0,7,7,21
20180714-W-Wimbledon-F-Serena_Williams-Angelique_Kerber,1,B-DTM,16,3,0,1,2,9,7
20180714-W-Wimbledon-F-Serena_Williams-Angelique_Kerber,1,B-DTL,13,4,2,1,1,8,5
20180714-W-Wimbledon-F-Serena_Williams-Angelique_Kerber,1,B-IO,4,1,1,0,0,3,1
20180714-W-Wimbledon-F-Serena_Williams-Angelique_Kerber,1,S-XC,1,0,0,0,0,0,1
20180714-W-Wimbledon-F-Serena_Williams-Angelique_Kerber,1,S-DTL,1,0,0,0,0,0,1
20180714-W-Wimbledon-F-Serena_Williams-Angelique_Kerber,2,F-XC,41,9,3,4,2,24,17
20180714-W-Wimbledon-F-Serena_Williams-Angelique_Kerber,2,F-DTM,13,0,0,0,0,6,7
20180714-W-Wimbledon-F-Serena_Williams-Angelique_Kerber,2,F-DTL,10,5,3,1,1,9,1
20180714-W-Wimbledon-F-Serena_Williams-Angelique_Kerber,2,F-IO,7,2,2,0,0,4,3
20180714-W-Wimbledon-F-Serena_Williams-Angelique_Kerber,2,B-XC,15,0,0,0,0,11,4
20180714-W-Wimbledon-F-Serena_Williams-Angelique_Kerber,2,B-DTM,20,2,0,1,1,10,10
20180714-W-Wimbledon-F-Serena_Williams-Angelique_Kerber,2,B-DTL,2,1,1,0,0,2,0
20180714-W-Wimbledon-F-Serena_Williams-Angelique_Kerber,2,B-IO,3,2,1,0,1,1,2
20180714-W-Wimbledon-F-Serena_Williams-Angelique_Kerber,2,S-XC,2,0,0,0,0,0,2
20180714-W-Wimbledon-F-Serena_Williams-Angelique_Kerber,2,S-DTM,7,0,0,0,0,3,4
20180722-W-ITF_Berkeley-F-Nicole_Gibbs-Sofia_Kenin,1,F-XC,29,9,1,1,7,14,15
20180722-W-ITF_Berkeley-F-Nicole_Gibbs-Sofia_Kenin,1,F-DTM,25,3,0,0,3,5,20
20180722-W-ITF_Berkeley-F-Nicole_Gibbs-Sofia_Kenin,1,F-DTL,2,0,0,0,0,0,2
20180722-W-ITF_Berkeley-F-Nicole_Gibbs-Sofia_Kenin,1,F-IO,14,5,2,1,2,9,5
20180722-W-ITF_Berkeley-F-Nicole_Gibbs-Sofia_Kenin,1,B-XC,17,5,2,1,2,10,7
20180722-W-ITF_Berkeley-F-Nicole_Gibbs-Sofia_Kenin,1,B-DTM,25,5,0,0,5,6,19
20180722-W-ITF_Berkeley-F-Nicole_Gibbs-Sofia_Kenin,1,B-DTL,4,0,0,0,0,2,2
20180722-W-ITF_Berkeley-F-Nicole_Gibbs-Sofia_Kenin,1,B-IO,7,3,0,0,3,3,4
20180722-W-ITF_Berkeley-F-Nicole_Gibbs-Sofia_Kenin,1,S-XC,5,0,0,0,0,2,3
20180722-W-ITF_Berkeley-F-Nicole_Gibbs-Sofia_Kenin,1,S-DTM,7,2,0,0,2,2,5
20180722-W-ITF_Berkeley-F-Nicole_Gibbs-Sofia_Kenin,1,S-DTL,2,0,0,0,0,0,2
20180722-W-ITF_Berkeley-F-Nicole_Gibbs-Sofia_Kenin,1,S-IO,3,0,0,0,0,2,1
20180722-W-ITF_Berkeley-F-Nicole_Gibbs-Sofia_Kenin,2,F-XC,38,11,4,2,5,24,14
20180722-W-ITF_Berkeley-F-Nicole_Gibbs-Sofia_Kenin,2,F-DTM,24,2,0,0,2,12,12
20180722-W-ITF_Berkeley-F-Nicole_Gibbs-Sofia_Kenin,2,F-DTL,3,0,0,0,0,2,1
20180722-W-ITF_Berkeley-F-Nicole_Gibbs-Sofia_Kenin,2,F-IO,5,0,0,0,0,3,2
20180722-W-ITF_Berkeley-F-Nicole_Gibbs-Sofia_Kenin,2,F-II,1,1,1,0,0,1,0
20180722-W-ITF_Berkeley-F-Nicole_Gibbs-Sofia_Kenin,2,B-XC,21,5,1,0,4,7,14
20180722-W-ITF_Berkeley-F-Nicole_Gibbs-Sofia_Kenin,2,B-DTM,29,2,0,0,2,19,10
20180722-W-ITF_Berkeley-F-Nicole_Gibbs-Sofia_Kenin,2,B-DTL,2,2,1,0,1,1,1
20180722-W-ITF_Berkeley-F-Nicole_Gibbs-Sofia_Kenin,2,B-IO,1,0,0,0,0,1,0
20180722-W-ITF_Berkeley-F-Nicole_Gibbs-Sofia_Kenin,2,B-II,1,1,0,1,0,1,0
20180722-W-ITF_Berkeley-F-Nicole_Gibbs-Sofia_Kenin,2,S-XC,5,0,0,0,0,4,1
20180730-W-Washington-R32-Andrea_Petkovic-Jamie_Loeb,1,F-XC,18,6,0,2,4,9,9
20180730-W-Washington-R32-Andrea_Petkovic-Jamie_Loeb,1,F-DTM,9,0,0,0,0,7,2
20180730-W-Washington-R32-Andrea_Petkovic-Jamie_Loeb,1,F-DTL,2,2,1,1,0,2,0
20180730-W-Washington-R32-Andrea_Petkovic-Jamie_Loeb,1,F-IO,9,4,2,1,1,6,3
20180730-W-Washington-R32-Andrea_Petkovic-Jamie_Loeb,1,F-II,1,0,0,0,0,1,0
20180730-W-Washington-R32-Andrea_Petkovic-Jamie_Loeb,1,B-XC,11,2,1,0,1,9,2
20180730-W-Washington-R32-Andrea_Petkovic-Jamie_Loeb,1,B-DTM,19,1,0,0,1,10,9
20180730-W-Washington-R32-Andrea_Petkovic-Jamie_Loeb,1,B-DTL,1,0,0,0,0,1,0
20180730-W-Washington-R32-Andrea_Petkovic-Jamie_Loeb,1,B-IO,5,1,0,0,1,3,2
20180730-W-Washington-R32-Andrea_Petkovic-Jamie_Loeb,1,S-XC,2,0,0,0,0,1,1
20180730-W-Washington-R32-Andrea_Petkovic-Jamie_Loeb,1,S-DTM,4,0,0,0,0,2,2
20180730-W-Washington-R32-Andrea_Petkovic-Jamie_Loeb,1,S-DTL,1,0,0,0,0,0,1
20180730-W-Washington-R32-Andrea_Petkovic-Jamie_Loeb,2,F-XC,16,4,0,1,3,5,11
20180730-W-Washington-R32-Andrea_Petkovic-Jamie_Loeb,2,F-DTM,9,4,0,0,4,3,6
20180730-W-Washington-R32-Andrea_Petkovic-Jamie_Loeb,2,F-DTL,4,4,2,1,1,3,1
20180730-W-Washington-R32-Andrea_Petkovic-Jamie_Loeb,2,F-IO,19,9,2,0,7,5,14
20180730-W-Washington-R32-Andrea_Petkovic-Jamie_Loeb,2,B-XC,13,6,2,2,2,7,6
20180730-W-Washington-R32-Andrea_Petkovic-Jamie_Loeb,2,B-DTM,14,3,0,0,3,7,7
20180730-W-Washington-R32-Andrea_Petkovic-Jamie_Loeb,2,B-DTL,9,4,1,0,3,3,6
20180730-W-Washington-R32-Andrea_Petkovic-Jamie_Loeb,2,B-IO,5,4,1,0,3,1,4
20180730-W-Washington-R32-Andrea_Petkovic-Jamie_Loeb,2,S-XC,2,0,0,0,0,1,1
20180730-W-Washington-R32-Andrea_Petkovic-Jamie_Loeb,2,S-DTM,1,0,0,0,0,0,1
20180530-W-Roland_Garros-R64-Katerina_Siniakova-Kateryna_Kozlova,1,F-XC,49,16,6,4,6,27,22
20180530-W-Roland_Garros-R64-Katerina_Siniakova-Kateryna_Kozlova,1,F-DTM,25,2,1,1,0,15,10
20180530-W-Roland_Garros-R64-Katerina_Siniakova-Kateryna_Kozlova,1,F-DTL,31,14,6,2,6,18,13
20180530-W-Roland_Garros-R64-Katerina_Siniakova-Kateryna_Kozlova,1,F-IO,22,3,3,0,0,14,8
20180530-W-Roland_Garros-R64-Katerina_Siniakova-Kateryna_Kozlova,1,F-II,1,1,0,0,1,0,1
20180530-W-Roland_Garros-R64-Katerina_Siniakova-Kateryna_Kozlova,1,B-XC,84,9,3,2,4,41,43
20180530-W-Roland_Garros-R64-Katerina_Siniakova-Kateryna_Kozlova,1,B-DTM,20,0,0,0,0,13,7
20180530-W-Roland_Garros-R64-Katerina_Siniakova-Kateryna_Kozlova,1,B-DTL,23,9,5,1,3,13,10
20180530-W-Roland_Garros-R64-Katerina_Siniakova-Kateryna_Kozlova,1,B-IO,19,8,4,3,1,13,6
20180530-W-Roland_Garros-R64-Katerina_Siniakova-Kateryna_Kozlova,1,S-XC,8,1,0,0,1,2,6
20180530-W-Roland_Garros-R64-Katerina_Siniakova-Kateryna_Kozlova,1,S-DTM,2,0,0,0,0,0,2
20180530-W-Roland_Garros-R64-Katerina_Siniakova-Kateryna_Kozlova,1,S-DTL,2,0,0,0,0,1,1
20180530-W-Roland_Garros-R64-Katerina_Siniakova-Kateryna_Kozlova,1,S-IO,1,1,0,0,1,0,1
20180530-W-Roland_Garros-R64-Katerina_Siniakova-Kateryna_Kozlova,2,F-XC,39,9,2,1,6,14,25
20180530-W-Roland_Garros-R64-Katerina_Siniakova-Kateryna_Kozlova,2,F-DTM,21,3,1,0,2,13,8
20180530-W-Roland_Garros-R64-Katerina_Siniakova-Kateryna_Kozlova,2,F-DTL,23,4,1,1,2,14,9
20180530-W-Roland_Garros-R64-Katerina_Siniakova-Kateryna_Kozlova,2,F-IO,16,8,1,3,4,6,10
20180530-W-Roland_Garros-R64-Katerina_Siniakova-Kateryna_Kozlova,2,F-II,2,1,1,0,0,2,0
20180530-W-Roland_Garros-R64-Katerina_Siniakova-Kateryna_Kozlova,2,B-XC,75,9,2,2,5,32,43
20180530-W-Roland_Garros-R64-Katerina_Siniakova-Kateryna_Kozlova,2,B-DTM,38,3,1,0,2,19,19
20180530-W-Roland_Garros-R64-Katerina_Siniakova-Kateryna_Kozlova,2,B-DTL,35,13,1,0,12,10,25
20180530-W-Roland_Garros-R64-Katerina_Siniakova-Kateryna_Kozlova,2,B-IO,8,1,1,0,0,4,4
20180530-W-Roland_Garros-R64-Katerina_Siniakova-Kateryna_Kozlova,2,B-II,1,0,0,0,0,1,0
20180530-W-Roland_Garros-R64-Katerina_Siniakova-Kateryna_Kozlova,2,S-XC,9,1,0,0,1,5,4
20180530-W-Roland_Garros-R64-Katerina_Siniakova-Kateryna_Kozlova,2,S-DTM,7,1,0,0,1,3,4
20180530-W-Roland_Garros-R64-Katerina_Siniakova-Kateryna_Kozlova,2,S-DTL,5,2,0,1,1,4,1
20180730-W-Washington-R32-Belinda_Bencic-Harriet_Dart,1,F-XC,48,8,2,0,6,30,18
20180730-W-Washington-R32-Belinda_Bencic-Harriet_Dart,1,F-DTM,15,2,0,1,1,8,7
20180730-W-Washington-R32-Belinda_Bencic-Harriet_Dart,1,F-DTL,7,4,2,1,1,6,1
20180730-W-Washington-R32-Belinda_Bencic-Harriet_Dart,1,F-IO,15,4,0,1,3,11,4
20180730-W-Washington-R32-Belinda_Bencic-Harriet_Dart,1,B-XC,24,7,2,2,3,16,8
20180730-W-Washington-R32-Belinda_Bencic-Harriet_Dart,1,B-DTM,21,1,0,1,0,13,8
20180730-W-Washington-R32-Belinda_Bencic-Harriet_Dart,1,B-DTL,12,6,4,0,2,7,5
20180730-W-Washington-R32-Belinda_Bencic-Harriet_Dart,1,B-IO,9,3,2,0,1,7,2
20180730-W-Washington-R32-Belinda_Bencic-Harriet_Dart,1,S-XC,1,0,0,0,0,1,0
20180730-W-Washington-R32-Belinda_Bencic-Harriet_Dart,1,S-DTM,1,0,0,0,0,0,1
20180730-W-Washington-R32-Belinda_Bencic-Harriet_Dart,2,F-XC,37,11,6,2,3,14,23
20180730-W-Washington-R32-Belinda_Bencic-Harriet_Dart,2,F-DTM,22,2,0,0,2,6,16
20180730-W-Washington-R32-Belinda_Bencic-Harriet_Dart,2,F-DTL,24,9,4,1,4,10,14
20180730-W-Washington-R32-Belinda_Bencic-Harriet_Dart,2,F-IO,9,5,3,0,2,5,4
20180730-W-Washington-R32-Belinda_Bencic-Harriet_Dart,2,B-XC,17,4,0,0,4,7,10
20180730-W-Washington-R32-Belinda_Bencic-Harriet_Dart,2,B-DTM,19,1,0,0,1,3,16
20180730-W-Washington-R32-Belinda_Bencic-Harriet_Dart,2,B-DTL,12,10,2,2,6,6,6
20180730-W-Washington-R32-Belinda_Bencic-Harriet_Dart,2,B-IO,9,1,0,0,1,5,4
20180730-W-Washington-R32-Belinda_Bencic-Harriet_Dart,2,S-XC,3,0,0,0,0,0,3
20180730-W-Washington-R32-Belinda_Bencic-Harriet_Dart,2,S-DTM,2,0,0,0,0,0,2
20180908-W-US_Open-F-Serena_Williams-Naomi_Osaka,1,F-XC,22,6,2,1,3,6,16
20180908-W-US_Open-F-Serena_Williams-Naomi_Osaka,1,F-DTM,8,1,0,0,1,3,5
20180908-W-US_Open-F-Serena_Williams-Naomi_Osaka,1,F-DTL,7,4,3,1,0,5,2
20180908-W-US_Open-F-Serena_Williams-Naomi_Osaka,1,F-IO,11,7,3,2,2,8,3
20180908-W-US_Open-F-Serena_Williams-Naomi_Osaka,1,B-XC,20,4,0,1,3,5,15
20180908-W-US_Open-F-Serena_Williams-Naomi_Osaka,1,B-DTM,18,0,0,0,0,6,12
20180908-W-US_Open-F-Serena_Williams-Naomi_Osaka,1,B-DTL,13,7,2,0,5,6,7
20180908-W-US_Open-F-Serena_Williams-Naomi_Osaka,1,B-IO,3,1,0,0,1,0,3
20180908-W-US_Open-F-Serena_Williams-Naomi_Osaka,1,S-DTM,2,0,0,0,0,0,2
20180908-W-US_Open-F-Serena_Williams-Naomi_Osaka,2,F-XC,27,5,2,1,2,19,8
20180908-W-US_Open-F-Serena_Williams-Naomi_Osaka,2,F-DTM,6,0,0,0,0,1,5
20180908-W-US_Open-F-Serena_Williams-Naomi_Osaka,2,F-DTL,11,6,3,1,2,8,3
20180908-W-US_Open-F-Serena_Williams-Naomi_Osaka,2,F-IO,11,6,2,1,3,6,5
20180908-W-US_Open-F-Serena_Williams-Naomi_Osaka,2,B-XC,32,3,0,2,1,23,9
20180908-W-US_Open-F-Serena_Williams-Naomi_Osaka,2,B-DTM,7,2,0,0,2,4,3
20180908-W-US_Open-F-Serena_Williams-Naomi_Osaka,2,B-DTL,2,2,0,1,1,1,1
20180908-W-US_Open-F-Serena_Williams-Naomi_Osaka,2,B-IO,1,0,0,0,0,0,1
20180908-W-US_Open-F-Serena_Williams-Naomi_Osaka,2,S-XC,1,0,0,0,0,0,1
20180908-W-US_Open-F-Serena_Williams-Naomi_Osaka,2,S-DTM,2,0,0,0,0,1,1
20180705-W-Wimbledon-R64-Eugenie_Bouchard-Ashleigh_Barty,1,F-XC,40,15,4,6,5,19,21
20180705-W-Wimbledon-R64-Eugenie_Bouchard-Ashleigh_Barty,1,F-DTM,16,0,0,0,0,4,12
20180705-W-Wimbledon-R64-Eugenie_Bouchard-Ashleigh_Barty,1,F-DTL,12,6,2,2,2,6,6
20180705-W-Wimbledon-R64-Eugenie_Bouchard-Ashleigh_Barty,1,F-IO,14,5,1,1,3,7,7
20180705-W-Wimbledon-R64-Eugenie_Bouchard-Ashleigh_Barty,1,B-XC,14,4,1,0,3,6,8
20180705-W-Wimbledon-R64-Eugenie_Bouchard-Ashleigh_Barty,1,B-DTM,18,1,0,0,1,5,13
20180705-W-Wimbledon-R64-Eugenie_Bouchard-Ashleigh_Barty,1,B-DTL,9,5,1,1,3,3,6
20180705-W-Wimbledon-R64-Eugenie_Bouchard-Ashleigh_Barty,1,B-IO,2,0,0,0,0,2,0
20180705-W-Wimbledon-R64-Eugenie_Bouchard-Ashleigh_Barty,1,S-XC,3,0,0,0,0,1,2
20180705-W-Wimbledon-R64-Eugenie_Bouchard-Ashleigh_Barty,1,S-DTM,3,0,0,0,0,2,1
20180705-W-Wimbledon-R64-Eugenie_Bouchard-Ashleigh_Barty,1,S-DTL,1,0,0,0,0,0,1
20180705-W-Wimbledon-R64-Eugenie_Bouchard-Ashleigh_Barty,2,F-XC,36,18,6,8,4,25,11
20180705-W-Wimbledon-R64-Eugenie_Bouchard-Ashleigh_Barty,2,F-DTM,24,2,0,0,2,14,10
20180705-W-Wimbledon-R64-Eugenie_Bouchard-Ashleigh_Barty,2,F-DTL,7,2,1,0,1,5,2
20180705-W-Wimbledon-R64-Eugenie_Bouchard-Ashleigh_Barty,2,F-IO,12,4,2,2,0,9,3
20180705-W-Wimbledon-R64-Eugenie_Bouchard-Ashleigh_Barty,2,F-II,3,3,1,0,2,1,2
20180705-W-Wimbledon-R64-Eugenie_Bouchard-Ashleigh_Barty,2,B-XC,1,1,0,0,1,0,1
20180705-W-Wimbledon-R64-Eugenie_Bouchard-Ashleigh_Barty,2,B-DTM,5,2,0,0,2,2,3
20180705-W-Wimbledon-R64-Eugenie_Bouchard-Ashleigh_Barty,2,B-DTL,2,1,0,1,0,2,0
20180705-W-Wimbledon-R64-Eugenie_Bouchard-Ashleigh_Barty,2,B-IO,1,1,0,0,1,0,1
20180705-W-Wimbledon-R64-Eugenie_Bouchard-Ashleigh_Barty,2,S-XC,13,2,0,1,1,9,4
20180705-W-Wimbledon-R64-Eugenie_Bouchard-Ashleigh_Barty,2,S-DTM,21,0,0,0,0,10,11
20180705-W-Wimbledon-R64-Eugenie_Bouchard-Ashleigh_Barty,2,S-DTL,4,2,2,0,0,3,1
20180705-W-Wimbledon-R64-Eugenie_Bouchard-Ashleigh_Barty,2,S-IO,4,2,0,0,2,0,4
20180902-W-US_Open-R16-Ashleigh_Barty-Karolina_Pliskova,1,F-XC,44,17,9,1,7,23,21
20180902-W-US_Open-R16-Ashleigh_Barty-Karolina_Pliskova,1,F-DTM,25,5,1,0,4,4,21
20180902-W-US_Open-R16-Ashleigh_Barty-Karolina_Pliskova,1,F-DTL,9,2,0,0,2,3,6
20180902-W-US_Open-R16-Ashleigh_Barty-Karolina_Pliskova,1,F-IO,17,8,5,0,3,10,7
20180902-W-US_Open-R16-Ashleigh_Barty-Karolina_Pliskova,1,F-II,5,5,5,0,0,5,0
20180902-W-US_Open-R16-Ashleigh_Barty-Karolina_Pliskova,1,B-XC,3,1,0,0,1,1,2
20180902-W-US_Open-R16-Ashleigh_Barty-Karolina_Pliskova,1,B-DTM,6,1,1,0,0,2,4
20180902-W-US_Open-R16-Ashleigh_Barty-Karolina_Pliskova,1,S-XC,33,4,0,0,4,14,19
20180902-W-US_Open-R16-Ashleigh_Barty-Karolina_Pliskova,1,S-DTM,22,3,0,0,3,8,14
20180902-W-US_Open-R16-Ashleigh_Barty-Karolina_Pliskova,1,S-DTL,7,4,0,2,2,2,5
20180902-W-US_Open-R16-Ashleigh_Barty-Karolina_Pliskova,1,S-IO,2,1,0,0,1,1,1
20180902-W-US_Open-R16-Ashleigh_Barty-Karolina_Pliskova,2,F-XC,32,2,0,1,1,21,11
20180902-W-US_Open-R16-Ashleigh_Barty-Karolina_Pliskova,2,F-DTM,17,5,1,0,4,7,10
20180902-W-US_Open-R16-Ashleigh_Barty-Karolina_Pliskova,2,F-DTL,10,3,1,1,1,7,3
20180902-W-US_Open-R16-Ashleigh_Barty-Karolina_Pliskova,2,F-IO,20,4,0,2,2,12,8
20180902-W-US_Open-R16-Ashleigh_Barty-Karolina_Pliskova,2,F-II,4,3,1,0,2,2,2
20180902-W-US_Open-R16-Ashleigh_Barty-Karolina_Pliskova,2,B-XC,27,4,1,2,1,17,10
20180902-W-US_Open-R16-Ashleigh_Barty-Karolina_Pliskova,2,B-DTM,15,2,0,0,2,5,10
20180902-W-US_Open-R16-Ashleigh_Barty-Karolina_Pliskova,2,B-DTL,10,3,0,1,2,8,2
20180902-W-US_Open-R16-Ashleigh_Barty-Karolina_Pliskova,2,B-IO,3,0,0,0,0,3,0
20180902-W-US_Open-R16-Ashleigh_Barty-Karolina_Pliskova,2,S-XC,12,2,0,0,2,5,7
20180902-W-US_Open-R16-Ashleigh_Barty-Karolina_Pliskova,2,S-DTM,7,0,0,0,0,3,4
20180902-W-US_Open-R16-Ashleigh_Barty-Karolina_Pliskova,2,S-DTL,1,0,0,0,0,1,0
20180830-W-US_Open-R64-Maria_Sharapova-Sorana_Cirstea,1,F-XC,37,11,5,3,3,21,16
20180830-W-US_Open-R64-Maria_Sharapova-Sorana_Cirstea,1,F-DTM,20,1,0,0,1,11,9
20180830-W-US_Open-R64-Maria_Sharapova-Sorana_Cirstea,1,F-DTL,5,2,1,0,1,1,4
20180830-W-US_Open-R64-Maria_Sharapova-Sorana_Cirstea,1,F-IO,17,7,3,0,4,9,8
20180830-W-US_Open-R64-Maria_Sharapova-Sorana_Cirstea,1,B-XC,32,13,2,2,9,14,18
20180830-W-US_Open-R64-Maria_Sharapova-Sorana_Cirstea,1,B-DTM,23,2,0,0,2,14,9
20180830-W-US_Open-R64-Maria_Sharapova-Sorana_Cirstea,1,B-DTL,4,4,3,0,1,3,1
20180830-W-US_Open-R64-Maria_Sharapova-Sorana_Cirstea,1,B-IO,4,1,0,1,0,2,2
20180830-W-US_Open-R64-Maria_Sharapova-Sorana_Cirstea,2,F-XC,25,3,1,0,2,15,10
20180830-W-US_Open-R64-Maria_Sharapova-Sorana_Cirstea,2,F-DTM,28,3,0,1,2,15,13
20180830-W-US_Open-R64-Maria_Sharapova-Sorana_Cirstea,2,F-DTL,12,8,1,2,5,6,6
20180830-W-US_Open-R64-Maria_Sharapova-Sorana_Cirstea,2,F-IO,15,6,0,1,5,4,11
20180830-W-US_Open-R64-Maria_Sharapova-Sorana_Cirstea,2,B-XC,24,4,1,1,2,12,12
20180830-W-US_Open-R64-Maria_Sharapova-Sorana_Cirstea,2,B-DTM,27,4,0,1,3,11,16
20180830-W-US_Open-R64-Maria_Sharapova-Sorana_Cirstea,2,B-DTL,10,6,2,2,2,5,5
20180830-W-US_Open-R64-Maria_Sharapova-Sorana_Cirstea,2,B-IO,6,2,0,1,1,3,3
20180830-W-US_Open-R64-Maria_Sharapova-Sorana_Cirstea,2,S-DTM,1,0,0,0,0,0,1
20180903-W-US_Open-R16-Madison_Keys-Dominika_Cibulkova,1,F-XC,20,8,2,5,1,14,6
20180903-W-US_Open-R16-Madison_Keys-Dominika_Cibulkova,1,F-DTM,13,3,1,1,1,6,7
20180903-W-US_Open-R16-Madison_Keys-Dominika_Cibulkova,1,F-DTL,6,5,2,0,3,2,4
20180903-W-US_Open-R16-Madison_Keys-Dominika_Cibulkova,1,F-IO,13,8,4,0,4,8,5
20180903-W-US_Open-R16-Madison_Keys-Dominika_Cibulkova,1,F-II,1,1,0,1,0,1,0
20180903-W-US_Open-R16-Madison_Keys-Dominika_Cibulkova,1,B-XC,16,5,2,2,1,13,3
20180903-W-US_Open-R16-Madison_Keys-Dominika_Cibulkova,1,B-DTM,24,2,0,1,1,15,9
20180903-W-US_Open-R16-Madison_Keys-Dominika_Cibulkova,1,B-DTL,8,7,5,0,2,6,2
20180903-W-US_Open-R16-Madison_Keys-Dominika_Cibulkova,1,B-IO,4,0,0,0,0,1,3
20180903-W-US_Open-R16-Madison_Keys-Dominika_Cibulkova,1,S-XC,2,0,0,0,0,0,2
20180903-W-US_Open-R16-Madison_Keys-Dominika_Cibulkova,1,S-DTM,2,0,0,0,0,0,2
20180903-W-US_Open-R16-Madison_Keys-Dominika_Cibulkova,2,F-XC,18,5,3,1,1,10,8
20180903-W-US_Open-R16-Madison_Keys-Dominika_Cibulkova,2,F-DTM,20,3,0,0,3,11,9
20180903-W-US_Open-R16-Madison_Keys-Dominika_Cibulkova,2,F-DTL,9,3,1,1,1,4,5
20180903-W-US_Open-R16-Madison_Keys-Dominika_Cibulkova,2,F-IO,14,7,1,2,4,6,8
20180903-W-US_Open-R16-Madison_Keys-Dominika_Cibulkova,2,F-II,1,0,0,0,0,1,0
20180903-W-US_Open-R16-Madison_Keys-Dominika_Cibulkova,2,B-XC,28,4,2,0,2,8,20
20180903-W-US_Open-R16-Madison_Keys-Dominika_Cibulkova,2,B-DTM,17,2,0,0,2,5,12
20180903-W-US_Open-R16-Madison_Keys-Dominika_Cibulkova,2,B-IO,1,1,0,0,1,0,1
20180903-W-US_Open-R16-Madison_Keys-Dominika_Cibulkova,2,S-DTM,3,0,0,0,0,0,3
19920808-W-Olympics-F-Steffi_Graf-Jennifer_Capriati,1,F-XC,80,25,3,7,15,43,37
19920808-W-Olympics-F-Steffi_Graf-Jennifer_Capriati,1,F-DTM,11,1,0,0,1,6,5
19920808-W-Olympics-F-Steffi_Graf-Jennifer_Capriati,1,F-DTL,20,3,2,1,0,14,6
19920808-W-Olympics-F-Steffi_Graf-Jennifer_Capriati,1,F-IO,48,14,6,2,6,28,20
19920808-W-Olympics-F-Steffi_Graf-Jennifer_Capriati,1,F-II,8,1,0,0,1,6,2
19920808-W-Olympics-F-Steffi_Graf-Jennifer_Capriati,1,B-XC,2,1,0,0,1,0,2
19920808-W-Olympics-F-Steffi_Graf-Jennifer_Capriati,1,B-DTL,2,2,2,0,0,2,0
19920808-W-Olympics-F-Steffi_Graf-Jennifer_Capriati,1,S-XC,149,9,0,1,8,64,85
19920808-W-Olympics-F-Steffi_Graf-Jennifer_Capriati,1,S-DTM,12,1,0,0,1,2,10
19920808-W-Olympics-F-Steffi_Graf-Jennifer_Capriati,1,S-DTL,27,4,1,0,3,13,14
19920808-W-Olympics-F-Steffi_Graf-Jennifer_Capriati,1,S-IO,3,1,0,0,1,0,3
19920808-W-Olympics-F-Steffi_Graf-Jennifer_Capriati,2,F-XC,52,14,4,2,8,22,30
19920808-W-Olympics-F-Steffi_Graf-Jennifer_Capriati,2,F-DTM,24,1,0,0,1,12,12
19920808-W-Olympics-F-Steffi_Graf-Jennifer_Capriati,2,F-DTL,34,8,1,1,6,15,19
19920808-W-Olympics-F-Steffi_Graf-Jennifer_Capriati,2,F-IO,15,3,1,2,0,11,4
19920808-W-Olympics-F-Steffi_Graf-Jennifer_Capriati,2,B-XC,141,13,3,2,8,73,68
19920808-W-Olympics-F-Steffi_Graf-Jennifer_Capriati,2,B-DTM,27,2,0,0,2,17,10
19920808-W-Olympics-F-Steffi_Graf-Jennifer_Capriati,2,B-DTL,29,10,2,2,6,12,17
19920808-W-Olympics-F-Steffi_Graf-Jennifer_Capriati,2,B-IO,6,1,1,0,0,4,2
19920808-W-Olympics-F-Steffi_Graf-Jennifer_Capriati,2,S-XC,19,3,0,2,1,9,10
19920808-W-Olympics-F-Steffi_Graf-Jennifer_Capriati,2,S-DTM,4,0,0,0,0,3,1
19920808-W-Olympics-F-Steffi_Graf-Jennifer_Capriati,2,S-DTL,6,2,0,1,1,1,5
20130505-W-Madrid-R64-Serena_Williams-Yulia_Putintseva,1,F-XC,26,5,3,0,2,16,10
20130505-W-Madrid-R64-Serena_Williams-Yulia_Putintseva,1,F-DTM,5,1,0,0,1,2,3
20130505-W-Madrid-R64-Serena_Williams-Yulia_Putintseva,1,F-DTL,11,4,3,1,0,7,4
20130505-W-Madrid-R64-Serena_Williams-Yulia_Putintseva,1,F-IO,5,0,0,0,0,5,0
20130505-W-Madrid-R64-Serena_Williams-Yulia_Putintseva,1,B-XC,46,10,1,4,5,23,23
20130505-W-Madrid-R64-Serena_Williams-Yulia_Putintseva,1,B-DTM,29,3,0,1,2,14,15
20130505-W-Madrid-R64-Serena_Williams-Yulia_Putintseva,1,B-DTL,13,7,1,2,4,5,8
20130505-W-Madrid-R64-Serena_Williams-Yulia_Putintseva,1,B-IO,7,2,1,0,1,5,2
20130505-W-Madrid-R64-Serena_Williams-Yulia_Putintseva,1,S-XC,2,0,0,0,0,0,2
20130505-W-Madrid-R64-Serena_Williams-Yulia_Putintseva,1,S-DTM,2,0,0,0,0,1,1
20130505-W-Madrid-R64-Serena_Williams-Yulia_Putintseva,1,S-DTL,2,0,0,0,0,1,1
20130505-W-Madrid-R64-Serena_Williams-Yulia_Putintseva,1,S-IO,1,0,0,0,0,1,0
20130505-W-Madrid-R64-Serena_Williams-Yulia_Putintseva,2,F-XC,27,6,3,1,2,14,13
20130505-W-Madrid-R64-Serena_Williams-Yulia_Putintseva,2,F-DTM,17,2,0,0,2,7,10
20130505-W-Madrid-R64-Serena_Williams-Yulia_Putintseva,2,F-DTL,24,2,1,1,0,11,13
20130505-W-Madrid-R64-Serena_Williams-Yulia_Putintseva,2,F-IO,17,3,1,0,2,9,8
20130505-W-Madrid-R64-Serena_Williams-Yulia_Putintseva,2,F-II,2,2,1,1,0,2,0
20130505-W-Madrid-R64-Serena_Williams-Yulia_Putintseva,2,B-XC,22,4,0,2,2,13,9
20130505-W-Madrid-R64-Serena_Williams-Yulia_Putintseva,2,B-DTM,15,1,0,0,1,4,11
20130505-W-Madrid-R64-Serena_Williams-Yulia_Putintseva,2,B-DTL,6,5,1,1,3,2,4
20130505-W-Madrid-R64-Serena_Williams-Yulia_Putintseva,2,B-IO,2,1,0,0,1,0,2
20130505-W-Madrid-R64-Serena_Williams-Yulia_Putintseva,2,S-XC,4,1,0,0,1,1,3
20130505-W-Madrid-R64-Serena_Williams-Yulia_Putintseva,2,S-DTM,3,0,0,0,0,2,1
20130505-W-Madrid-R64-Serena_Williams-Yulia_Putintseva,2,S-DTL,2,0,0,0,0,1,1
20180710-W-Wimbledon-QF-Camila_Giorgi-Serena_Williams,1,F-XC,24,11,5,5,1,13,11
20180710-W-Wimbledon-QF-Camila_Giorgi-Serena_Williams,1,F-DTM,16,4,0,0,4,10,6
20180710-W-Wimbledon-QF-Camila_Giorgi-Serena_Williams,1,F-DTL,3,1,1,0,0,1,2
20180710-W-Wimbledon-QF-Camila_Giorgi-Serena_Williams,1,F-IO,6,5,1,2,2,4,2
20180710-W-Wimbledon-QF-Camila_Giorgi-Serena_Williams,1,B-XC,19,4,0,4,0,11,8
20180710-W-Wimbledon-QF-Camila_Giorgi-Serena_Williams,1,B-DTM,27,4,0,2,2,13,14
20180710-W-Wimbledon-QF-Camila_Giorgi-Serena_Williams,1,B-DTL,4,1,0,0,1,1,3
20180710-W-Wimbledon-QF-Camila_Giorgi-Serena_Williams,1,B-IO,2,1,0,1,0,2,0
20180710-W-Wimbledon-QF-Camila_Giorgi-Serena_Williams,2,F-XC,19,8,2,2,4,10,9
20180710-W-Wimbledon-QF-Camila_Giorgi-Serena_Williams,2,F-DTM,13,1,0,0,1,8,5
20180710-W-Wimbledon-QF-Camila_Giorgi-Serena_Williams,2,F-DTL,7,4,2,1,1,6,1
20180710-W-Wimbledon-QF-Camila_Giorgi-Serena_Williams,2,F-IO,15,5,1,2,2,7,8
20180710-W-Wimbledon-QF-Camila_Giorgi-Serena_Williams,2,B-XC,13,4,1,2,1,7,6
20180710-W-Wimbledon-QF-Camila_Giorgi-Serena_Williams,2,B-DTM,16,1,0,0,1,7,9
20180710-W-Wimbledon-QF-Camila_Giorgi-Serena_Williams,2,B-DTL,8,6,3,2,1,6,2
20180710-W-Wimbledon-QF-Camila_Giorgi-Serena_Williams,2,B-IO,5,2,0,1,1,2,3
20180710-W-Wimbledon-QF-Camila_Giorgi-Serena_Williams,2,S-XC,1,1,1,0,0,1,0
20180710-W-Wimbledon-QF-Camila_Giorgi-Serena_Williams,2,S-DTM,1,0,0,0,0,0,1
19950909-W-US_Open-F-Monica_Seles-Steffi_Graf,1,F-XC,75,16,5,1,10,36,39
19950909-W-US_Open-F-Monica_Seles-Steffi_Graf,1,F-DTM,28,1,0,0,1,15,13
19950909-W-US_Open-F-Monica_Seles-Steffi_Graf,1,F-DTL,14,13,6,3,4,10,4
19950909-W-US_Open-F-Monica_Seles-Steffi_Graf,1,F-IO,11,7,3,1,3,7,4
19950909-W-US_Open-F-Monica_Seles-Steffi_Graf,1,B-XC,39,16,2,3,11,19,20
19950909-W-US_Open-F-Monica_Seles-Steffi_Graf,1,B-DTM,51,8,0,4,4,28,23
19950909-W-US_Open-F-Monica_Seles-Steffi_Graf,1,B-DTL,11,5,1,2,2,5,6
19950909-W-US_Open-F-Monica_Seles-Steffi_Graf,1,B-IO,12,6,4,1,1,9,3
19950909-W-US_Open-F-Monica_Seles-Steffi_Graf,1,S-DTL,5,0,0,0,0,1,4
19950909-W-US_Open-F-Monica_Seles-Steffi_Graf,2,F-XC,45,7,1,4,2,26,19
19950909-W-US_Open-F-Monica_Seles-Steffi_Graf,2,F-DTM,35,3,1,0,2,19,16
19950909-W-US_Open-F-Monica_Seles-Steffi_Graf,2,F-DTL,5,3,1,1,1,3,2
19950909-W-US_Open-F-Monica_Seles-Steffi_Graf,2,F-IO,29,13,3,4,6,19,10
19950909-W-US_Open-F-Monica_Seles-Steffi_Graf,2,B-XC,2,0,0,0,0,1,1
19950909-W-US_Open-F-Monica_Seles-Steffi_Graf,2,B-DTM,3,0,0,0,0,1,2
19950909-W-US_Open-F-Monica_Seles-Steffi_Graf,2,B-DTL,1,0,0,0,0,1,0
19950909-W-US_Open-F-Monica_Seles-Steffi_Graf,2,S-XC,57,7,1,5,1,28,29
19950909-W-US_Open-F-Monica_Seles-Steffi_Graf,2,S-DTM,41,5,0,0,5,12,29
19950909-W-US_Open-F-Monica_Seles-Steffi_Graf,2,S-DTL,7,1,0,0,1,3,4
19950909-W-US_Open-F-Monica_Seles-Steffi_Graf,2,S-IO,5,1,0,0,1,1,4
19900908-W-US_Open-F-Steffi_Graf-Gabriela_Sabatini,1,F-XC,69,14,4,2,8,35,34
19900908-W-US_Open-F-Steffi_Graf-Gabriela_Sabatini,1,F-DTM,23,3,0,1,2,12,11
19900908-W-US_Open-F-Steffi_Graf-Gabriela_Sabatini,1,F-DTL,6,2,0,0,2,3,3
19900908-W-US_Open-F-Steffi_Graf-Gabriela_Sabatini,1,F-IO,38,8,5,1,2,18,20
19900908-W-US_Open-F-Steffi_Graf-Gabriela_Sabatini,1,F-II,12,1,0,0,1,6,6
19900908-W-US_Open-F-Steffi_Graf-Gabriela_Sabatini,1,B-XC,11,6,2,3,1,6,5
19900908-W-US_Open-F-Steffi_Graf-Gabriela_Sabatini,1,B-DTM,4,1,0,0,1,1,3
19900908-W-US_Open-F-Steffi_Graf-Gabriela_Sabatini,1,B-DTL,3,1,0,0,1,2,1
19900908-W-US_Open-F-Steffi_Graf-Gabriela_Sabatini,1,B-IO,1,0,0,0,0,0,1
19900908-W-US_Open-F-Steffi_Graf-Gabriela_Sabatini,1,S-XC,94,13,1,2,10,40,54
19900908-W-US_Open-F-Steffi_Graf-Gabriela_Sabatini,1,S-DTM,43,1,0,0,1,14,29
19900908-W-US_Open-F-Steffi_Graf-Gabriela_Sabatini,1,S-DTL,24,2,0,2,0,10,14
19900908-W-US_Open-F-Steffi_Graf-Gabriela_Sabatini,1,S-IO,12,1,0,1,0,8,4
19900908-W-US_Open-F-Steffi_Graf-Gabriela_Sabatini,2,F-XC,35,8,5,3,0,21,14
19900908-W-US_Open-F-Steffi_Graf-Gabriela_Sabatini,2,F-DTM,54,1,0,0,1,22,32
19900908-W-US_Open-F-Steffi_Graf-Gabriela_Sabatini,2,F-DTL,47,9,2,2,5,27,20
19900908-W-US_Open-F-Steffi_Graf-Gabriela_Sabatini,2,F-IO,28,5,2,0,3,20,8
19900908-W-US_Open-F-Steffi_Graf-Gabriela_Sabatini,2,B-XC,54,5,2,1,2,33,21
19900908-W-US_Open-F-Steffi_Graf-Gabriela_Sabatini,2,B-DTM,21,0,0,0,0,15,6
19900908-W-US_Open-F-Steffi_Graf-Gabriela_Sabatini,2,B-DTL,8,3,3,0,0,6,2
19900908-W-US_Open-F-Steffi_Graf-Gabriela_Sabatini,2,B-IO,2,0,0,0,0,0,2
19900908-W-US_Open-F-Steffi_Graf-Gabriela_Sabatini,2,S-XC,50,4,0,1,3,25,25
19900908-W-US_Open-F-Steffi_Graf-Gabriela_Sabatini,2,S-DTM,15,1,0,0,1,5,10
19900908-W-US_Open-F-Steffi_Graf-Gabriela_Sabatini,2,S-DTL,6,1,0,1,0,5,1
20091003-W-Tokyo-F-Maria_Sharapova-Jelena_Jankovic,1,F-XC,19,1,1,0,0,8,11
20091003-W-Tokyo-F-Maria_Sharapova-Jelena_Jankovic,1,F-DTM,8,1,0,0,1,1,7
20091003-W-Tokyo-F-Maria_Sharapova-Jelena_Jankovic,1,F-DTL,5,3,2,0,1,2,3
20091003-W-Tokyo-F-Maria_Sharapova-Jelena_Jankovic,1,F-IO,7,2,0,0,2,2,5
20091003-W-Tokyo-F-Maria_Sharapova-Jelena_Jankovic,1,F-II,1,1,1,0,0,1,0
20091003-W-Tokyo-F-Maria_Sharapova-Jelena_Jankovic,1,B-XC,16,5,1,0,4,6,10
20091003-W-Tokyo-F-Maria_Sharapova-Jelena_Jankovic,1,B-DTM,3,0,0,0,0,1,2
20091003-W-Tokyo-F-Maria_Sharapova-Jelena_Jankovic,1,B-DTL,6,2,1,0,1,2,4
20091003-W-Tokyo-F-Maria_Sharapova-Jelena_Jankovic,1,B-IO,2,0,0,0,0,1,1
20091003-W-Tokyo-F-Maria_Sharapova-Jelena_Jankovic,1,S-DTL,1,1,0,0,1,0,1
20091003-W-Tokyo-F-Maria_Sharapova-Jelena_Jankovic,2,F-XC,10,1,0,0,1,7,3
20091003-W-Tokyo-F-Maria_Sharapova-Jelena_Jankovic,2,F-DTM,7,0,0,0,0,5,2
20091003-W-Tokyo-F-Maria_Sharapova-Jelena_Jankovic,2,F-DTL,15,6,0,1,5,8,7
20091003-W-Tokyo-F-Maria_Sharapova-Jelena_Jankovic,2,F-IO,4,2,1,0,1,1,3
20091003-W-Tokyo-F-Maria_Sharapova-Jelena_Jankovic,2,B-XC,6,2,1,0,1,4,2
20091003-W-Tokyo-F-Maria_Sharapova-Jelena_Jankovic,2,B-DTM,5,0,0,0,0,2,3
20091003-W-Tokyo-F-Maria_Sharapova-Jelena_Jankovic,2,B-DTL,10,2,1,0,1,7,3
20091003-W-Tokyo-F-Maria_Sharapova-Jelena_Jankovic,2,B-IO,6,2,0,1,1,4,2
20091003-W-Tokyo-F-Maria_Sharapova-Jelena_Jankovic,2,S-XC,1,0,0,0,0,0,1
20091003-W-Tokyo-F-Maria_Sharapova-Jelena_Jankovic,2,S-DTM,2,0,0,0,0,1,1
20091003-W-Tokyo-F-Maria_Sharapova-Jelena_Jankovic,2,S-DTL,1,0,0,0,0,0,1
19970704-W-Wimbledon-SF-Martina_Hingis-Anna_Kournikova,1,F-XC,19,5,1,1,3,10,9
19970704-W-Wimbledon-SF-Martina_Hingis-Anna_Kournikova,1,F-DTM,13,0,0,0,0,6,7
19970704-W-Wimbledon-SF-Martina_Hingis-Anna_Kournikova,1,F-DTL,13,3,3,0,0,8,5
19970704-W-Wimbledon-SF-Martina_Hingis-Anna_Kournikova,1,F-IO,13,2,1,1,0,9,4
19970704-W-Wimbledon-SF-Martina_Hingis-Anna_Kournikova,1,B-XC,22,5,3,0,2,11,11
19970704-W-Wimbledon-SF-Martina_Hingis-Anna_Kournikova,1,B-DTM,21,0,0,0,0,15,6
19970704-W-Wimbledon-SF-Martina_Hingis-Anna_Kournikova,1,B-DTL,12,5,1,1,3,2,10
19970704-W-Wimbledon-SF-Martina_Hingis-Anna_Kournikova,1,B-IO,5,1,1,0,0,5,0
19970704-W-Wimbledon-SF-Martina_Hingis-Anna_Kournikova,1,S-XC,1,1,0,0,1,0,1
19970704-W-Wimbledon-SF-Martina_Hingis-Anna_Kournikova,1,S-DTM,5,0,0,0,0,2,3
19970704-W-Wimbledon-SF-Martina_Hingis-Anna_Kournikova,1,S-DTL,1,0,0,0,0,0,1
19970704-W-Wimbledon-SF-Martina_Hingis-Anna_Kournikova,2,F-XC,27,6,2,1,3,13,14
19970704-W-Wimbledon-SF-Martina_Hingis-Anna_Kournikova,2,F-DTM,9,3,1,0,2,3,6
19970704-W-Wimbledon-SF-Martina_Hingis-Anna_Kournikova,2,F-DTL,8,5,2,1,2,3,5
19970704-W-Wimbledon-SF-Martina_Hingis-Anna_Kournikova,2,F-IO,7,5,2,2,1,5,2
19970704-W-Wimbledon-SF-Martina_Hingis-Anna_Kournikova,2,F-II,1,1,0,0,1,0,1
19970704-W-Wimbledon-SF-Martina_Hingis-Anna_Kournikova,2,B-XC,35,10,1,3,6,17,18
19970704-W-Wimbledon-SF-Martina_Hingis-Anna_Kournikova,2,B-DTM,14,2,0,0,2,4,10
19970704-W-Wimbledon-SF-Martina_Hingis-Anna_Kournikova,2,B-DTL,9,2,0,0,2,4,5
19970704-W-Wimbledon-SF-Martina_Hingis-Anna_Kournikova,2,B-IO,5,3,1,1,1,2,3
19970704-W-Wimbledon-SF-Martina_Hingis-Anna_Kournikova,2,S-XC,6,0,0,0,0,6,0
19970704-W-Wimbledon-SF-Martina_Hingis-Anna_Kournikova,2,S-DTM,4,0,0,0,0,1,3
19970704-W-Wimbledon-SF-Martina_Hingis-Anna_Kournikova,2,S-IO,1,1,0,0,1,0,1
20181102-W-Zhuhai-RR-Madison_Keys-Qiang_Wang,1,F-XC,28,9,4,1,4,12,16
20181102-W-Zhuhai-RR-Madison_Keys-Qiang_Wang,1,F-DTM,22,2,0,0,2,11,11
20181102-W-Zhuhai-RR-Madison_Keys-Qiang_Wang,1,F-DTL,11,8,6,0,2,7,4
20181102-W-Zhuhai-RR-Madison_Keys-Qiang_Wang,1,F-IO,15,6,3,0,3,5,10
20181102-W-Zhuhai-RR-Madison_Keys-Qiang_Wang,1,B-XC,33,8,3,1,4,17,16
20181102-W-Zhuhai-RR-Madison_Keys-Qiang_Wang,1,B-DTM,30,6,0,0,6,11,19
20181102-W-Zhuhai-RR-Madison_Keys-Qiang_Wang,1,B-DTL,13,9,2,1,6,7,6
20181102-W-Zhuhai-RR-Madison_Keys-Qiang_Wang,1,B-IO,12,8,2,2,4,4,8
20181102-W-Zhuhai-RR-Madison_Keys-Qiang_Wang,1,S-XC,6,1,0,0,1,1,5
20181102-W-Zhuhai-RR-Madison_Keys-Qiang_Wang,1,S-DTM,5,0,0,0,0,2,3
20181102-W-Zhuhai-RR-Madison_Keys-Qiang_Wang,1,S-DTL,1,0,0,0,0,0,1
20181102-W-Zhuhai-RR-Madison_Keys-Qiang_Wang,2,F-XC,32,10,4,2,4,13,19
20181102-W-Zhuhai-RR-Madison_Keys-Qiang_Wang,2,F-DTM,30,4,1,0,3,15,15
20181102-W-Zhuhai-RR-Madison_Keys-Qiang_Wang,2,F-DTL,7,1,1,0,0,5,2
20181102-W-Zhuhai-RR-Madison_Keys-Qiang_Wang,2,F-IO,17,4,1,0,3,9,8
20181102-W-Zhuhai-RR-Madison_Keys-Qiang_Wang,2,F-II,2,1,1,0,0,1,1
20181102-W-Zhuhai-RR-Madison_Keys-Qiang_Wang,2,B-XC,37,7,0,3,4,21,16
20181102-W-Zhuhai-RR-Madison_Keys-Qiang_Wang,2,B-DTM,29,4,0,0,4,13,16
20181102-W-Zhuhai-RR-Madison_Keys-Qiang_Wang,2,B-DTL,7,4,1,1,2,4,3
20181102-W-Zhuhai-RR-Madison_Keys-Qiang_Wang,2,B-II,1,0,0,0,0,1,0
20181102-W-Zhuhai-RR-Madison_Keys-Qiang_Wang,2,S-XC,3,1,0,1,0,2,1
20181102-W-Zhuhai-RR-Madison_Keys-Qiang_Wang,2,S-DTM,1,0,0,0,0,1,0
20120126-W-Australian_Open-SF-Petra_Kvitova-Maria_Sharapova,1,F-XC,72,17,6,1,10,35,37
20120126-W-Australian_Open-SF-Petra_Kvitova-Maria_Sharapova,1,F-DTM,26,3,0,0,3,9,17
20120126-W-Australian_Open-SF-Petra_Kvitova-Maria_Sharapova,1,F-DTL,21,11,7,0,4,11,10
20120126-W-Australian_Open-SF-Petra_Kvitova-Maria_Sharapova,1,F-IO,13,6,1,1,4,4,9
20120126-W-Australian_Open-SF-Petra_Kvitova-Maria_Sharapova,1,B-XC,30,6,1,1,4,13,17
20120126-W-Australian_Open-SF-Petra_Kvitova-Maria_Sharapova,1,B-DTM,17,3,0,0,3,2,15
20120126-W-Australian_Open-SF-Petra_Kvitova-Maria_Sharapova,1,B-DTL,8,2,0,1,1,3,5
20120126-W-Australian_Open-SF-Petra_Kvitova-Maria_Sharapova,1,B-IO,11,5,3,0,2,6,5
20120126-W-Australian_Open-SF-Petra_Kvitova-Maria_Sharapova,1,S-XC,5,1,0,1,0,4,1
20120126-W-Australian_Open-SF-Petra_Kvitova-Maria_Sharapova,1,S-DTM,4,0,0,0,0,2,2
20120126-W-Australian_Open-SF-Petra_Kvitova-Maria_Sharapova,1,S-DTL,1,0,0,0,0,0,1
20120126-W-Australian_Open-SF-Petra_Kvitova-Maria_Sharapova,2,F-XC,48,9,1,5,3,31,17
20120126-W-Australian_Open-SF-Petra_Kvitova-Maria_Sharapova,2,F-DTM,18,2,0,1,1,8,10
20120126-W-Australian_Open-SF-Petra_Kvitova-Maria_Sharapova,2,F-DTL,17,10,5,2,3,11,6
20120126-W-Australian_Open-SF-Petra_Kvitova-Maria_Sharapova,2,F-IO,24,8,4,1,3,16,8
20120126-W-Australian_Open-SF-Petra_Kvitova-Maria_Sharapova,2,F-II,1,0,0,0,0,1,0
20120126-W-Australian_Open-SF-Petra_Kvitova-Maria_Sharapova,2,B-XC,52,8,2,2,4,29,23
20120126-W-Australian_Open-SF-Petra_Kvitova-Maria_Sharapova,2,B-DTM,39,4,0,0,4,23,16
20120126-W-Australian_Open-SF-Petra_Kvitova-Maria_Sharapova,2,B-DTL,7,5,1,4,0,5,2
20120126-W-Australian_Open-SF-Petra_Kvitova-Maria_Sharapova,2,B-IO,4,1,1,0,0,3,1
20120126-W-Australian_Open-SF-Petra_Kvitova-Maria_Sharapova,2,S-XC,2,0,0,0,0,1,1
20120126-W-Australian_Open-SF-Petra_Kvitova-Maria_Sharapova,2,S-DTM,2,0,0,0,0,1,1
19910908-W-US_Open-F-Monica_Seles-Martina_Navratilova,1,F-XC,16,8,5,3,0,13,3
19910908-W-US_Open-F-Monica_Seles-Martina_Navratilova,1,F-DTM,12,0,0,0,0,7,5
19910908-W-US_Open-F-Monica_Seles-Martina_Navratilova,1,F-DTL,10,7,5,1,1,9,1
19910908-W-US_Open-F-Monica_Seles-Martina_Navratilova,1,F-IO,8,4,3,0,1,7,1
19910908-W-US_Open-F-Monica_Seles-Martina_Navratilova,1,B-XC,25,4,1,2,1,18,7
19910908-W-US_Open-F-Monica_Seles-Martina_Navratilova,1,B-DTM,11,0,0,0,0,7,4
19910908-W-US_Open-F-Monica_Seles-Martina_Navratilova,1,B-DTL,6,4,2,1,1,5,1
19910908-W-US_Open-F-Monica_Seles-Martina_Navratilova,1,B-IO,7,4,2,0,2,4,3
19910908-W-US_Open-F-Monica_Seles-Martina_Navratilova,1,S-XC,1,0,0,0,0,0,1
19910908-W-US_Open-F-Monica_Seles-Martina_Navratilova,2,F-XC,17,3,2,0,1,5,12
19910908-W-US_Open-F-Monica_Seles-Martina_Navratilova,2,F-DTM,6,1,0,0,1,3,3
19910908-W-US_Open-F-Monica_Seles-Martina_Navratilova,2,F-DTL,4,3,0,1,2,1,3
19910908-W-US_Open-F-Monica_Seles-Martina_Navratilova,2,F-IO,1,0,0,0,0,1,0
19910908-W-US_Open-F-Monica_Seles-Martina_Navratilova,2,B-XC,7,1,1,0,0,4,3
19910908-W-US_Open-F-Monica_Seles-Martina_Navratilova,2,B-DTL,2,1,0,1,0,2,0
19910908-W-US_Open-F-Monica_Seles-Martina_Navratilova,2,S-XC,12,3,0,0,3,1,11
19910908-W-US_Open-F-Monica_Seles-Martina_Navratilova,2,S-DTM,5,0,0,0,0,0,5
19910908-W-US_Open-F-Monica_Seles-Martina_Navratilova,2,S-DTL,7,1,0,0,1,1,6
19910908-W-US_Open-F-Monica_Seles-Martina_Navratilova,2,S-IO,2,0,0,0,0,0,2
19920604-W-Roland_Garros-SF-Steffi_Graf-Arantxa_Sanchez_Vicario,1,F-XC,87,19,5,6,8,51,36
19920604-W-Roland_Garros-SF-Steffi_Graf-Arantxa_Sanchez_Vicario,1,F-DTM,17,2,2,0,0,9,8
19920604-W-Roland_Garros-SF-Steffi_Graf-Arantxa_Sanchez_Vicario,1,F-DTL,13,6,1,2,3,8,5
19920604-W-Roland_Garros-SF-Steffi_Graf-Arantxa_Sanchez_Vicario,1,F-IO,54,9,3,3,3,37,17
19920604-W-Roland_Garros-SF-Steffi_Graf-Arantxa_Sanchez_Vicario,1,F-II,18,3,3,0,0,10,8
19920604-W-Roland_Garros-SF-Steffi_Graf-Arantxa_Sanchez_Vicario,1,B-XC,2,0,0,0,0,1,1
19920604-W-Roland_Garros-SF-Steffi_Graf-Arantxa_Sanchez_Vicario,1,B-DTM,1,0,0,0,0,1,0
19920604-W-Roland_Garros-SF-Steffi_Graf-Arantxa_Sanchez_Vicario,1,B-DTL,1,1,1,0,0,1,0
19920604-W-Roland_Garros-SF-Steffi_Graf-Arantxa_Sanchez_Vicario,1,S-XC,144,11,1,6,4,91,53
19920604-W-Roland_Garros-SF-Steffi_Graf-Arantxa_Sanchez_Vicario,1,S-DTM,23,4,2,0,2,13,10
19920604-W-Roland_Garros-SF-Steffi_Graf-Arantxa_Sanchez_Vicario,1,S-DTL,26,1,0,1,0,15,11
19920604-W-Roland_Garros-SF-Steffi_Graf-Arantxa_Sanchez_Vicario,1,S-IO,5,0,0,0,0,2,3
19920604-W-Roland_Garros-SF-Steffi_Graf-Arantxa_Sanchez_Vicario,2,F-XC,34,3,1,2,0,16,18
19920604-W-Roland_Garros-SF-Steffi_Graf-Arantxa_Sanchez_Vicario,2,F-DTM,43,1,0,0,1,18,25
19920604-W-Roland_Garros-SF-Steffi_Graf-Arantxa_Sanchez_Vicario,2,F-DTL,41,7,2,2,3,19,22
19920604-W-Roland_Garros-SF-Steffi_Graf-Arantxa_Sanchez_Vicario,2,F-IO,16,3,0,2,1,9,7
19920604-W-Roland_Garros-SF-Steffi_Graf-Arantxa_Sanchez_Vicario,2,F-II,6,3,1,2,0,5,1
19920604-W-Roland_Garros-SF-Steffi_Graf-Arantxa_Sanchez_Vicario,2,B-XC,137,13,0,2,11,45,92
19920604-W-Roland_Garros-SF-Steffi_Graf-Arantxa_Sanchez_Vicario,2,B-DTM,24,1,0,0,1,7,17
19920604-W-Roland_Garros-SF-Steffi_Graf-Arantxa_Sanchez_Vicario,2,B-DTL,19,8,2,3,3,9,10
19920604-W-Roland_Garros-SF-Steffi_Graf-Arantxa_Sanchez_Vicario,2,B-IO,1,0,0,0,0,0,1
19920604-W-Roland_Garros-SF-Steffi_Graf-Arantxa_Sanchez_Vicario,2,S-XC,22,2,0,2,0,11,11
19920604-W-Roland_Garros-SF-Steffi_Graf-Arantxa_Sanchez_Vicario,2,S-DTM,3,0,0,0,0,1,2
19920604-W-Roland_Garros-SF-Steffi_Graf-Arantxa_Sanchez_Vicario,2,S-DTL,17,1,0,0,1,4,13
19920604-W-Roland_Garros-SF-Steffi_Graf-Arantxa_Sanchez_Vicario,2,S-IO,2,0,0,0,0,1,1
19920604-W-Roland_Garros-SF-Steffi_Graf-Arantxa_Sanchez_Vicario,2,S-II,1,1,0,0,1,0,1
19920606-W-Roland_Garros-F-Monica_Seles-Steffi_Graf,1,F-XC,233,16,4,6,6,136,97
19920606-W-Roland_Garros-F-Monica_Seles-Steffi_Graf,1,F-DTM,54,1,0,0,1,22,32
19920606-W-Roland_Garros-F-Monica_Seles-Steffi_Graf,1,F-DTL,51,15,5,4,6,32,19
19920606-W-Roland_Garros-F-Monica_Seles-Steffi_Graf,1,F-IO,24,8,5,1,2,15,9
19920606-W-Roland_Garros-F-Monica_Seles-Steffi_Graf,1,F-II,1,0,0,0,0,1,0
19920606-W-Roland_Garros-F-Monica_Seles-Steffi_Graf,1,B-XC,106,11,5,2,4,57,49
19920606-W-Roland_Garros-F-Monica_Seles-Steffi_Graf,1,B-DTM,40,1,1,0,0,14,26
19920606-W-Roland_Garros-F-Monica_Seles-Steffi_Graf,1,B-DTL,27,10,4,1,5,15,12
19920606-W-Roland_Garros-F-Monica_Seles-Steffi_Graf,1,B-IO,5,0,0,0,0,4,1
19920606-W-Roland_Garros-F-Monica_Seles-Steffi_Graf,1,S-XC,1,0,0,0,0,0,1
19920606-W-Roland_Garros-F-Monica_Seles-Steffi_Graf,1,S-DTM,9,0,0,0,0,2,7
19920606-W-Roland_Garros-F-Monica_Seles-Steffi_Graf,1,S-DTL,5,0,0,0,0,4,1
19920606-W-Roland_Garros-F-Monica_Seles-Steffi_Graf,2,F-XC,144,38,7,9,22,75,69
19920606-W-Roland_Garros-F-Monica_Seles-Steffi_Graf,2,F-DTM,31,2,1,0,1,10,21
19920606-W-Roland_Garros-F-Monica_Seles-Steffi_Graf,2,F-DTL,44,17,7,3,7,23,21
19920606-W-Roland_Garros-F-Monica_Seles-Steffi_Graf,2,F-IO,100,23,11,5,7,49,51
19920606-W-Roland_Garros-F-Monica_Seles-Steffi_Graf,2,F-II,22,12,1,1,10,8,14
19920606-W-Roland_Garros-F-Monica_Seles-Steffi_Graf,2,B-XC,3,1,0,0,1,1,2
19920606-W-Roland_Garros-F-Monica_Seles-Steffi_Graf,2,B-DTM,1,0,0,0,0,1,0
19920606-W-Roland_Garros-F-Monica_Seles-Steffi_Graf,2,B-DTL,3,2,2,0,0,3,0
19920606-W-Roland_Garros-F-Monica_Seles-Steffi_Graf,2,S-XC,162,13,2,4,7,75,87
19920606-W-Roland_Garros-F-Monica_Seles-Steffi_Graf,2,S-DTM,44,6,0,0,6,13,31
19920606-W-Roland_Garros-F-Monica_Seles-Steffi_Graf,2,S-DTL,20,2,1,0,1,7,13
19920606-W-Roland_Garros-F-Monica_Seles-Steffi_Graf,2,S-IO,5,1,0,0,1,2,3
20160603-W-Roland_Garros-SF-Serena_Williams-Kiki_Bertens,1,F-XC,42,16,4,4,8,21,21
20160603-W-Roland_Garros-SF-Serena_Williams-Kiki_Bertens,1,F-DTM,18,2,0,0,2,6,12
20160603-W-Roland_Garros-SF-Serena_Williams-Kiki_Bertens,1,F-DTL,15,3,2,0,1,8,7
20160603-W-Roland_Garros-SF-Serena_Williams-Kiki_Bertens,1,F-IO,14,3,0,1,2,7,7
20160603-W-Roland_Garros-SF-Serena_Williams-Kiki_Bertens,1,F-II,1,1,1,0,0,1,0
20160603-W-Roland_Garros-SF-Serena_Williams-Kiki_Bertens,1,B-XC,39,10,3,2,5,18,21
20160603-W-Roland_Garros-SF-Serena_Williams-Kiki_Bertens,1,B-DTM,20,2,0,0,2,8,12
20160603-W-Roland_Garros-SF-Serena_Williams-Kiki_Bertens,1,B-DTL,17,12,6,1,5,8,9
20160603-W-Roland_Garros-SF-Serena_Williams-Kiki_Bertens,1,B-IO,10,3,1,1,1,5,5
20160603-W-Roland_Garros-SF-Serena_Williams-Kiki_Bertens,1,S-XC,3,1,1,0,0,2,1
20160603-W-Roland_Garros-SF-Serena_Williams-Kiki_Bertens,1,S-DTM,4,0,0,0,0,2,2
20160603-W-Roland_Garros-SF-Serena_Williams-Kiki_Bertens,1,S-DTL,1,0,0,0,0,1,0
20160603-W-Roland_Garros-SF-Serena_Williams-Kiki_Bertens,2,F-XC,42,9,3,3,3,24,18
20160603-W-Roland_Garros-SF-Serena_Williams-Kiki_Bertens,2,F-DTM,21,1,1,0,0,12,9
20160603-W-Roland_Garros-SF-Serena_Williams-Kiki_Bertens,2,F-DTL,13,4,2,1,1,9,4
20160603-W-Roland_Garros-SF-Serena_Williams-Kiki_Bertens,2,F-IO,14,5,1,0,4,7,7
20160603-W-Roland_Garros-SF-Serena_Williams-Kiki_Bertens,2,F-II,1,1,0,1,0,1,0
20160603-W-Roland_Garros-SF-Serena_Williams-Kiki_Bertens,2,B-XC,24,5,2,1,2,14,10
20160603-W-Roland_Garros-SF-Serena_Williams-Kiki_Bertens,2,B-DTM,27,1,0,0,1,13,14
20160603-W-Roland_Garros-SF-Serena_Williams-Kiki_Bertens,2,B-DTL,7,2,1,0,1,3,4
20160603-W-Roland_Garros-SF-Serena_Williams-Kiki_Bertens,2,B-IO,4,2,0,1,1,3,1
20160603-W-Roland_Garros-SF-Serena_Williams-Kiki_Bertens,2,S-XC,8,0,0,0,0,4,4
20160603-W-Roland_Garros-SF-Serena_Williams-Kiki_Bertens,2,S-DTM,9,0,0,0,0,4,5
20160603-W-Roland_Garros-SF-Serena_Williams-Kiki_Bertens,2,S-DTL,1,0,0,0,0,0,1
20160603-W-Roland_Garros-SF-Serena_Williams-Kiki_Bertens,2,S-IO,2,0,0,0,0,2,0
20160603-W-Roland_Garros-SF-Samantha_Stosur-Garbine_Muguruza,1,F-XC,22,6,2,3,1,13,9
20160603-W-Roland_Garros-SF-Samantha_Stosur-Garbine_Muguruza,1,F-DTM,21,1,0,0,1,7,14
20160603-W-Roland_Garros-SF-Samantha_Stosur-Garbine_Muguruza,1,F-DTL,6,4,1,1,2,4,2
20160603-W-Roland_Garros-SF-Samantha_Stosur-Garbine_Muguruza,1,F-IO,13,6,1,3,2,8,5
20160603-W-Roland_Garros-SF-Samantha_Stosur-Garbine_Muguruza,1,F-II,1,1,0,1,0,1,0
20160603-W-Roland_Garros-SF-Samantha_Stosur-Garbine_Muguruza,1,B-XC,4,0,0,0,0,2,2
20160603-W-Roland_Garros-SF-Samantha_Stosur-Garbine_Muguruza,1,B-DTM,13,2,0,0,2,3,10
20160603-W-Roland_Garros-SF-Samantha_Stosur-Garbine_Muguruza,1,B-DTL,6,2,1,0,1,2,4
20160603-W-Roland_Garros-SF-Samantha_Stosur-Garbine_Muguruza,1,S-XC,7,0,0,0,0,4,3
20160603-W-Roland_Garros-SF-Samantha_Stosur-Garbine_Muguruza,1,S-DTM,6,0,0,0,0,2,4
20160603-W-Roland_Garros-SF-Samantha_Stosur-Garbine_Muguruza,1,S-DTL,1,0,0,0,0,0,1
20160603-W-Roland_Garros-SF-Samantha_Stosur-Garbine_Muguruza,1,S-IO,1,0,0,0,0,0,1
20160603-W-Roland_Garros-SF-Samantha_Stosur-Garbine_Muguruza,2,F-XC,20,10,2,5,3,13,7
20160603-W-Roland_Garros-SF-Samantha_Stosur-Garbine_Muguruza,2,F-DTM,14,0,0,0,0,5,9
20160603-W-Roland_Garros-SF-Samantha_Stosur-Garbine_Muguruza,2,F-DTL,7,3,2,0,1,4,3
20160603-W-Roland_Garros-SF-Samantha_Stosur-Garbine_Muguruza,2,F-IO,5,2,1,1,0,4,1
20160603-W-Roland_Garros-SF-Samantha_Stosur-Garbine_Muguruza,2,B-XC,23,4,1,1,2,16,7
20160603-W-Roland_Garros-SF-Samantha_Stosur-Garbine_Muguruza,2,B-DTM,10,1,0,0,1,5,5
20160603-W-Roland_Garros-SF-Samantha_Stosur-Garbine_Muguruza,2,B-DTL,7,3,1,2,0,3,4
20160603-W-Roland_Garros-SF-Samantha_Stosur-Garbine_Muguruza,2,B-IO,12,7,2,2,3,6,6
20160603-W-Roland_Garros-SF-Samantha_Stosur-Garbine_Muguruza,2,B-II,1,0,0,0,0,1,0
20180727-W-ITF_Prague-QF-Iga_Swiatek-Mona_Barthel,1,F-XC,22,15,8,4,3,18,4
20180727-W-ITF_Prague-QF-Iga_Swiatek-Mona_Barthel,1,F-DTM,19,3,0,0,3,10,9
20180727-W-ITF_Prague-QF-Iga_Swiatek-Mona_Barthel,1,F-DTL,9,2,1,1,0,8,1
20180727-W-ITF_Prague-QF-Iga_Swiatek-Mona_Barthel,1,F-IO,14,5,2,1,2,10,4
20180727-W-ITF_Prague-QF-Iga_Swiatek-Mona_Barthel,1,F-II,1,1,1,0,0,1,0
20180727-W-ITF_Prague-QF-Iga_Swiatek-Mona_Barthel,1,B-XC,12,5,2,1,2,7,5
20180727-W-ITF_Prague-QF-Iga_Swiatek-Mona_Barthel,1,B-DTM,14,1,0,1,0,7,7
20180727-W-ITF_Prague-QF-Iga_Swiatek-Mona_Barthel,1,B-DTL,10,4,1,1,2,8,2
20180727-W-ITF_Prague-QF-Iga_Swiatek-Mona_Barthel,1,B-IO,10,5,1,2,2,7,3
20180727-W-ITF_Prague-QF-Iga_Swiatek-Mona_Barthel,1,S-XC,1,0,0,0,0,0,1
20180727-W-ITF_Prague-QF-Iga_Swiatek-Mona_Barthel,1,S-DTM,3,0,0,0,0,2,1
20180727-W-ITF_Prague-QF-Iga_Swiatek-Mona_Barthel,2,F-XC,11,4,2,0,2,4,7
20180727-W-ITF_Prague-QF-Iga_Swiatek-Mona_Barthel,2,F-DTM,10,1,0,0,1,2,8
20180727-W-ITF_Prague-QF-Iga_Swiatek-Mona_Barthel,2,F-DTL,3,0,0,0,0,0,3
20180727-W-ITF_Prague-QF-Iga_Swiatek-Mona_Barthel,2,F-IO,9,3,1,0,2,5,4
20180727-W-ITF_Prague-QF-Iga_Swiatek-Mona_Barthel,2,B-XC,17,5,2,2,1,7,10
20180727-W-ITF_Prague-QF-Iga_Swiatek-Mona_Barthel,2,B-DTM,13,2,0,0,2,6,7
20180727-W-ITF_Prague-QF-Iga_Swiatek-Mona_Barthel,2,B-DTL,11,5,2,0,3,3,8
20180727-W-ITF_Prague-QF-Iga_Swiatek-Mona_Barthel,2,B-IO,9,4,1,1,2,3,6
20180727-W-ITF_Prague-QF-Iga_Swiatek-Mona_Barthel,2,B-II,1,1,0,1,0,1,0
20180122-W-Australian_Open-R16-Su_Wei_Hsieh-Angelique_Kerber,1,F-XC,75,18,10,5,3,46,29
20180122-W-Australian_Open-R16-Su_Wei_Hsieh-Angelique_Kerber,1,F-DTM,23,2,1,0,1,6,17
20180122-W-Australian_Open-R16-Su_Wei_Hsieh-Angelique_Kerber,1,F-DTL,10,3,0,0,3,3,7
20180122-W-Australian_Open-R16-Su_Wei_Hsieh-Angelique_Kerber,1,F-IO,20,8,4,0,4,10,10
20180122-W-Australian_Open-R16-Su_Wei_Hsieh-Angelique_Kerber,1,F-II,1,0,0,0,0,1,0
20180122-W-Australian_Open-R16-Su_Wei_Hsieh-Angelique_Kerber,1,B-XC,65,15,7,4,4,36,29
20180122-W-Australian_Open-R16-Su_Wei_Hsieh-Angelique_Kerber,1,B-DTM,36,3,0,0,3,19,17
20180122-W-Australian_Open-R16-Su_Wei_Hsieh-Angelique_Kerber,1,B-DTL,27,8,3,2,3,16,11
20180122-W-Australian_Open-R16-Su_Wei_Hsieh-Angelique_Kerber,1,B-IO,21,7,3,0,4,11,10
20180122-W-Australian_Open-R16-Su_Wei_Hsieh-Angelique_Kerber,1,B-II,1,1,1,0,0,1,0
20180122-W-Australian_Open-R16-Su_Wei_Hsieh-Angelique_Kerber,1,S-XC,2,0,0,0,0,1,1
20180122-W-Australian_Open-R16-Su_Wei_Hsieh-Angelique_Kerber,1,S-DTM,6,0,0,0,0,2,4
20180122-W-Australian_Open-R16-Su_Wei_Hsieh-Angelique_Kerber,2,F-XC,63,7,2,3,2,33,30
20180122-W-Australian_Open-R16-Su_Wei_Hsieh-Angelique_Kerber,2,F-DTM,38,1,0,0,1,22,16
20180122-W-Australian_Open-R16-Su_Wei_Hsieh-Angelique_Kerber,2,F-DTL,24,7,5,1,1,12,12
20180122-W-Australian_Open-R16-Su_Wei_Hsieh-Angelique_Kerber,2,F-IO,25,11,4,4,3,18,7
20180122-W-Australian_Open-R16-Su_Wei_Hsieh-Angelique_Kerber,2,F-II,1,1,0,1,0,1,0
20180122-W-Australian_Open-R16-Su_Wei_Hsieh-Angelique_Kerber,2,B-XC,51,8,1,5,2,28,23
20180122-W-Australian_Open-R16-Su_Wei_Hsieh-Angelique_Kerber,2,B-DTM,35,2,0,2,0,16,19
20180122-W-Australian_Open-R16-Su_Wei_Hsieh-Angelique_Kerber,2,B-DTL,15,8,4,2,2,10,5
20180122-W-Australian_Open-R16-Su_Wei_Hsieh-Angelique_Kerber,2,B-IO,5,1,1,0,0,3,2
20180122-W-Australian_Open-R16-Su_Wei_Hsieh-Angelique_Kerber,2,S-XC,8,0,0,0,0,2,6
20180122-W-Australian_Open-R16-Su_Wei_Hsieh-Angelique_Kerber,2,S-DTM,17,0,0,0,0,6,11
20180122-W-Australian_Open-R16-Su_Wei_Hsieh-Angelique_Kerber,2,S-DTL,6,1,0,1,0,2,4
20180122-W-Australian_Open-R16-Su_Wei_Hsieh-Angelique_Kerber,2,S-IO,4,0,0,0,0,3,1
20181211-W-ITF_Dubai-R32-Kaja_Juvan-Tatjana_Maria,1,F-XC,26,6,0,1,5,16,10
20181211-W-ITF_Dubai-R32-Kaja_Juvan-Tatjana_Maria,1,F-DTM,33,3,0,1,2,10,23
20181211-W-ITF_Dubai-R32-Kaja_Juvan-Tatjana_Maria,1,F-DTL,11,4,2,0,2,8,3
20181211-W-ITF_Dubai-R32-Kaja_Juvan-Tatjana_Maria,1,F-IO,23,8,2,2,4,11,12
20181211-W-ITF_Dubai-R32-Kaja_Juvan-Tatjana_Maria,1,B-XC,5,4,1,0,3,2,3
20181211-W-ITF_Dubai-R32-Kaja_Juvan-Tatjana_Maria,1,B-DTM,23,0,0,0,0,14,9
20181211-W-ITF_Dubai-R32-Kaja_Juvan-Tatjana_Maria,1,B-DTL,2,0,0,0,0,1,1
20181211-W-ITF_Dubai-R32-Kaja_Juvan-Tatjana_Maria,1,B-IO,7,3,1,0,2,4,3
20181211-W-ITF_Dubai-R32-Kaja_Juvan-Tatjana_Maria,1,S-XC,1,0,0,0,0,0,1
20181211-W-ITF_Dubai-R32-Kaja_Juvan-Tatjana_Maria,1,S-DTM,7,0,0,0,0,1,6
20181211-W-ITF_Dubai-R32-Kaja_Juvan-Tatjana_Maria,1,S-DTL,2,1,0,0,1,0,2
20181211-W-ITF_Dubai-R32-Kaja_Juvan-Tatjana_Maria,1,S-IO,3,1,0,0,1,1,2
20181211-W-ITF_Dubai-R32-Kaja_Juvan-Tatjana_Maria,2,F-XC,14,3,1,0,2,6,8
20181211-W-ITF_Dubai-R32-Kaja_Juvan-Tatjana_Maria,2,F-DTM,15,4,0,2,2,9,6
20181211-W-ITF_Dubai-R32-Kaja_Juvan-Tatjana_Maria,2,F-DTL,2,1,1,0,0,2,0
20181211-W-ITF_Dubai-R32-Kaja_Juvan-Tatjana_Maria,2,F-IO,10,4,0,4,0,7,3
20181211-W-ITF_Dubai-R32-Kaja_Juvan-Tatjana_Maria,2,B-XC,1,0,0,0,0,0,1
20181211-W-ITF_Dubai-R32-Kaja_Juvan-Tatjana_Maria,2,B-DTM,6,0,0,0,0,3,3
20181211-W-ITF_Dubai-R32-Kaja_Juvan-Tatjana_Maria,2,B-DTL,2,1,1,0,0,2,0
20181211-W-ITF_Dubai-R32-Kaja_Juvan-Tatjana_Maria,2,B-IO,3,1,0,1,0,3,0
20181211-W-ITF_Dubai-R32-Kaja_Juvan-Tatjana_Maria,2,S-XC,13,3,0,2,1,9,4
20181211-W-ITF_Dubai-R32-Kaja_Juvan-Tatjana_Maria,2,S-DTM,41,4,0,1,3,16,25
20181211-W-ITF_Dubai-R32-Kaja_Juvan-Tatjana_Maria,2,S-DTL,6,2,0,1,1,1,5
20181211-W-ITF_Dubai-R32-Kaja_Juvan-Tatjana_Maria,2,S-IO,9,2,0,2,0,5,4
20181017-W-Luxembourg-R16-Eugenie_Bouchard-Carla_Suarez_Navarro,1,F-XC,18,8,5,3,0,16,2
20181017-W-Luxembourg-R16-Eugenie_Bouchard-Carla_Suarez_Navarro,1,F-DTM,9,0,0,0,0,6,3
20181017-W-Luxembourg-R16-Eugenie_Bouchard-Carla_Suarez_Navarro,1,F-DTL,7,4,2,1,1,6,1
20181017-W-Luxembourg-R16-Eugenie_Bouchard-Carla_Suarez_Navarro,1,F-IO,10,4,3,1,0,8,2
20181017-W-Luxembourg-R16-Eugenie_Bouchard-Carla_Suarez_Navarro,1,B-XC,14,6,3,1,2,9,5
20181017-W-Luxembourg-R16-Eugenie_Bouchard-Carla_Suarez_Navarro,1,B-DTM,19,1,0,1,0,13,6
20181017-W-Luxembourg-R16-Eugenie_Bouchard-Carla_Suarez_Navarro,1,B-DTL,4,2,1,0,1,2,2
20181017-W-Luxembourg-R16-Eugenie_Bouchard-Carla_Suarez_Navarro,1,B-IO,3,3,2,1,0,3,0
20181017-W-Luxembourg-R16-Eugenie_Bouchard-Carla_Suarez_Navarro,1,S-DTM,2,0,0,0,0,1,1
20181017-W-Luxembourg-R16-Eugenie_Bouchard-Carla_Suarez_Navarro,2,F-XC,13,5,3,1,1,4,9
20181017-W-Luxembourg-R16-Eugenie_Bouchard-Carla_Suarez_Navarro,2,F-DTM,16,0,0,0,0,3,13
20181017-W-Luxembourg-R16-Eugenie_Bouchard-Carla_Suarez_Navarro,2,F-DTL,4,1,1,0,0,1,3
20181017-W-Luxembourg-R16-Eugenie_Bouchard-Carla_Suarez_Navarro,2,F-IO,5,1,1,0,0,2,3
20181017-W-Luxembourg-R16-Eugenie_Bouchard-Carla_Suarez_Navarro,2,B-XC,6,3,0,1,2,2,4
20181017-W-Luxembourg-R16-Eugenie_Bouchard-Carla_Suarez_Navarro,2,B-DTM,16,4,1,0,3,7,9
20181017-W-Luxembourg-R16-Eugenie_Bouchard-Carla_Suarez_Navarro,2,B-DTL,1,0,0,0,0,1,0
20181017-W-Luxembourg-R16-Eugenie_Bouchard-Carla_Suarez_Navarro,2,B-IO,1,0,0,0,0,0,1
20181017-W-Luxembourg-R16-Eugenie_Bouchard-Carla_Suarez_Navarro,2,S-XC,4,0,0,0,0,2,2
20181017-W-Luxembourg-R16-Eugenie_Bouchard-Carla_Suarez_Navarro,2,S-DTM,9,0,0,0,0,1,8
20181017-W-Luxembourg-R16-Eugenie_Bouchard-Carla_Suarez_Navarro,2,S-DTL,2,0,0,0,0,0,2
20181017-W-Luxembourg-R16-Eugenie_Bouchard-Carla_Suarez_Navarro,2,S-IO,1,0,0,0,0,0,1
20180827-W-US_Open-R128-Venus_Williams-Svetlana_Kuznetsova,1,F-XC,33,19,9,4,6,24,9
20180827-W-US_Open-R128-Venus_Williams-Svetlana_Kuznetsova,1,F-DTM,24,1,0,1,0,11,13
20180827-W-US_Open-R128-Venus_Williams-Svetlana_Kuznetsova,1,F-DTL,7,3,1,1,1,3,4
20180827-W-US_Open-R128-Venus_Williams-Svetlana_Kuznetsova,1,F-IO,38,19,12,5,2,28,10
20180827-W-US_Open-R128-Venus_Williams-Svetlana_Kuznetsova,1,B-XC,52,12,1,5,6,24,28
20180827-W-US_Open-R128-Venus_Williams-Svetlana_Kuznetsova,1,B-DTM,44,4,0,0,4,17,27
20180827-W-US_Open-R128-Venus_Williams-Svetlana_Kuznetsova,1,B-DTL,6,3,2,1,0,5,1
20180827-W-US_Open-R128-Venus_Williams-Svetlana_Kuznetsova,1,B-IO,17,12,6,2,4,11,6
20180827-W-US_Open-R128-Venus_Williams-Svetlana_Kuznetsova,1,S-XC,4,1,0,0,1,3,1
20180827-W-US_Open-R128-Venus_Williams-Svetlana_Kuznetsova,1,S-DTM,4,0,0,0,0,1,3
20180827-W-US_Open-R128-Venus_Williams-Svetlana_Kuznetsova,1,S-DTL,1,0,0,0,0,1,0
20180827-W-US_Open-R128-Venus_Williams-Svetlana_Kuznetsova,2,F-XC,16,7,2,3,2,8,8
20180827-W-US_Open-R128-Venus_Williams-Svetlana_Kuznetsova,2,F-DTM,36,2,0,1,1,9,27
20180827-W-US_Open-R128-Venus_Williams-Svetlana_Kuznetsova,2,F-DTL,4,2,1,0,1,1,3
20180827-W-US_Open-R128-Venus_Williams-Svetlana_Kuznetsova,2,F-IO,26,14,6,2,6,13,13
20180827-W-US_Open-R128-Venus_Williams-Svetlana_Kuznetsova,2,F-II,1,1,0,1,0,1,0
20180827-W-US_Open-R128-Venus_Williams-Svetlana_Kuznetsova,2,B-XC,37,10,4,4,2,24,13
20180827-W-US_Open-R128-Venus_Williams-Svetlana_Kuznetsova,2,B-DTM,50,3,0,0,3,26,24
20180827-W-US_Open-R128-Venus_Williams-Svetlana_Kuznetsova,2,B-DTL,8,6,4,0,2,5,3
20180827-W-US_Open-R128-Venus_Williams-Svetlana_Kuznetsova,2,B-IO,6,4,3,1,0,5,1
20180827-W-US_Open-R128-Venus_Williams-Svetlana_Kuznetsova,2,S-XC,9,0,0,0,0,3,6
20180827-W-US_Open-R128-Venus_Williams-Svetlana_Kuznetsova,2,S-DTM,14,0,0,0,0,5,9
20180827-W-US_Open-R128-Venus_Williams-Svetlana_Kuznetsova,2,S-DTL,2,0,0,0,0,1,1
19960125-W-Australian_Open-SF-Chanda_Rubin-Monica_Seles,1,F-XC,43,11,8,2,1,25,18
19960125-W-Australian_Open-SF-Chanda_Rubin-Monica_Seles,1,F-DTM,23,4,0,0,4,8,15
19960125-W-Australian_Open-SF-Chanda_Rubin-Monica_Seles,1,F-DTL,13,7,3,1,3,7,6
19960125-W-Australian_Open-SF-Chanda_Rubin-Monica_Seles,1,F-IO,35,14,2,8,4,22,13
19960125-W-Australian_Open-SF-Chanda_Rubin-Monica_Seles,1,F-II,1,1,1,0,0,1,0
19960125-W-Australian_Open-SF-Chanda_Rubin-Monica_Seles,1,B-XC,34,11,2,2,7,12,22
19960125-W-Australian_Open-SF-Chanda_Rubin-Monica_Seles,1,B-DTM,21,2,0,0,2,8,13
19960125-W-Australian_Open-SF-Chanda_Rubin-Monica_Seles,1,B-DTL,19,8,1,2,5,10,9
19960125-W-Australian_Open-SF-Chanda_Rubin-Monica_Seles,1,B-IO,7,4,0,0,4,2,5
19960125-W-Australian_Open-SF-Chanda_Rubin-Monica_Seles,1,S-XC,8,2,0,1,1,4,4
19960125-W-Australian_Open-SF-Chanda_Rubin-Monica_Seles,1,S-DTM,9,0,0,0,0,3,6
19960125-W-Australian_Open-SF-Chanda_Rubin-Monica_Seles,1,S-DTL,2,1,0,0,1,1,1
19960125-W-Australian_Open-SF-Chanda_Rubin-Monica_Seles,2,F-XC,54,8,4,1,3,34,20
19960125-W-Australian_Open-SF-Chanda_Rubin-Monica_Seles,2,F-DTM,21,1,0,1,0,8,13
19960125-W-Australian_Open-SF-Chanda_Rubin-Monica_Seles,2,F-DTL,18,7,4,1,2,10,8
19960125-W-Australian_Open-SF-Chanda_Rubin-Monica_Seles,2,F-IO,14,7,4,1,2,7,7
19960125-W-Australian_Open-SF-Chanda_Rubin-Monica_Seles,2,F-II,1,0,0,0,0,0,1
19960125-W-Australian_Open-SF-Chanda_Rubin-Monica_Seles,2,B-XC,35,9,5,4,0,24,11
19960125-W-Australian_Open-SF-Chanda_Rubin-Monica_Seles,2,B-DTM,32,2,0,0,2,11,21
19960125-W-Australian_Open-SF-Chanda_Rubin-Monica_Seles,2,B-DTL,13,2,0,1,1,7,6
19960125-W-Australian_Open-SF-Chanda_Rubin-Monica_Seles,2,B-IO,9,3,2,0,1,5,4
19960125-W-Australian_Open-SF-Chanda_Rubin-Monica_Seles,2,S-DTM,1,0,0,0,0,0,1
19960125-W-Australian_Open-SF-Chanda_Rubin-Monica_Seles,2,S-DTL,1,0,0,0,0,0,1
20130512-W-Madrid-F-Maria_Sharapova-Serena_Williams,1,F-XC,17,6,1,2,3,6,11
20130512-W-Madrid-F-Maria_Sharapova-Serena_Williams,1,F-DTM,18,5,1,0,4,3,15
20130512-W-Madrid-F-Maria_Sharapova-Serena_Williams,1,F-DTL,6,6,2,1,3,3,3
20130512-W-Madrid-F-Maria_Sharapova-Serena_Williams,1,F-IO,7,4,2,0,2,5,2
20130512-W-Madrid-F-Maria_Sharapova-Serena_Williams,1,B-XC,13,4,2,0,2,6,7
20130512-W-Madrid-F-Maria_Sharapova-Serena_Williams,1,B-DTM,11,2,1,0,1,4,7
20130512-W-Madrid-F-Maria_Sharapova-Serena_Williams,1,B-DTL,3,1,0,0,1,1,2
20130512-W-Madrid-F-Maria_Sharapova-Serena_Williams,1,B-IO,3,1,0,0,1,2,1
20130512-W-Madrid-F-Maria_Sharapova-Serena_Williams,1,S-XC,1,0,0,0,0,0,1
20130512-W-Madrid-F-Maria_Sharapova-Serena_Williams,1,S-DTL,1,0,0,0,0,0,1
20130512-W-Madrid-F-Maria_Sharapova-Serena_Williams,2,F-XC,24,6,0,2,4,16,8
20130512-W-Madrid-F-Maria_Sharapova-Serena_Williams,2,F-DTM,8,2,1,0,1,6,2
20130512-W-Madrid-F-Maria_Sharapova-Serena_Williams,2,F-DTL,6,4,3,0,1,4,2
20130512-W-Madrid-F-Maria_Sharapova-Serena_Williams,2,F-IO,5,4,2,2,0,5,0
20130512-W-Madrid-F-Maria_Sharapova-Serena_Williams,2,B-XC,14,6,2,1,3,9,5
20130512-W-Madrid-F-Maria_Sharapova-Serena_Williams,2,B-DTM,14,0,0,0,0,7,7
20130512-W-Madrid-F-Maria_Sharapova-Serena_Williams,2,B-DTL,3,2,1,0,1,1,2
20130512-W-Madrid-F-Maria_Sharapova-Serena_Williams,2,B-IO,2,0,0,0,0,2,0
20130512-W-Madrid-F-Maria_Sharapova-Serena_Williams,2,S-XC,1,0,0,0,0,1,0
20130512-W-Madrid-F-Maria_Sharapova-Serena_Williams,2,S-DTM,1,0,0,0,0,0,1
20130512-W-Madrid-F-Maria_Sharapova-Serena_Williams,2,S-IO,1,1,0,1,0,1,0
20060706-W-Wimbledon-SF-Justine_Henin-Kim_Clijsters,1,F-XC,33,6,2,2,2,18,15
20060706-W-Wimbledon-SF-Justine_Henin-Kim_Clijsters,1,F-DTM,25,0,0,0,0,13,12
20060706-W-Wimbledon-SF-Justine_Henin-Kim_Clijsters,1,F-DTL,7,2,1,0,1,3,4
20060706-W-Wimbledon-SF-Justine_Henin-Kim_Clijsters,1,F-IO,17,7,3,1,3,10,7
20060706-W-Wimbledon-SF-Justine_Henin-Kim_Clijsters,1,F-II,1,0,0,0,0,1,0
20060706-W-Wimbledon-SF-Justine_Henin-Kim_Clijsters,1,B-XC,18,6,3,0,3,12,6
20060706-W-Wimbledon-SF-Justine_Henin-Kim_Clijsters,1,B-DTM,22,2,0,0,2,8,14
20060706-W-Wimbledon-SF-Justine_Henin-Kim_Clijsters,1,B-DTL,1,1,0,0,1,0,1
20060706-W-Wimbledon-SF-Justine_Henin-Kim_Clijsters,1,B-IO,7,3,0,1,2,2,5
20060706-W-Wimbledon-SF-Justine_Henin-Kim_Clijsters,1,S-XC,16,1,0,0,1,5,11
20060706-W-Wimbledon-SF-Justine_Henin-Kim_Clijsters,1,S-DTM,20,1,0,0,1,11,9
20060706-W-Wimbledon-SF-Justine_Henin-Kim_Clijsters,1,S-DTL,2,2,0,2,0,2,0
20060706-W-Wimbledon-SF-Justine_Henin-Kim_Clijsters,1,S-IO,2,1,0,0,1,0,2
20060706-W-Wimbledon-SF-Justine_Henin-Kim_Clijsters,2,F-XC,38,11,3,3,5,23,15
20060706-W-Wimbledon-SF-Justine_Henin-Kim_Clijsters,2,F-DTM,22,1,0,0,1,10,12
20060706-W-Wimbledon-SF-Justine_Henin-Kim_Clijsters,2,F-DTL,18,7,3,2,2,10,8
20060706-W-Wimbledon-SF-Justine_Henin-Kim_Clijsters,2,F-IO,22,12,5,3,4,13,9
20060706-W-Wimbledon-SF-Justine_Henin-Kim_Clijsters,2,F-II,1,1,0,1,0,1,0
20060706-W-Wimbledon-SF-Justine_Henin-Kim_Clijsters,2,B-XC,35,4,1,0,3,19,16
20060706-W-Wimbledon-SF-Justine_Henin-Kim_Clijsters,2,B-DTM,25,0,0,0,0,11,14
20060706-W-Wimbledon-SF-Justine_Henin-Kim_Clijsters,2,B-DTL,7,4,0,3,1,6,1
20060706-W-Wimbledon-SF-Justine_Henin-Kim_Clijsters,2,B-IO,5,0,0,0,0,2,3
20060706-W-Wimbledon-SF-Justine_Henin-Kim_Clijsters,2,S-XC,5,0,0,0,0,2,3
20060706-W-Wimbledon-SF-Justine_Henin-Kim_Clijsters,2,S-DTM,12,1,0,0,1,2,10
20060706-W-Wimbledon-SF-Justine_Henin-Kim_Clijsters,2,S-DTL,1,0,0,0,0,0,1
20060706-W-Wimbledon-SF-Justine_Henin-Kim_Clijsters,2,S-IO,1,0,0,0,0,1,0
20080124-W-Australian_Open-SF-Ana_Ivanovic-Daniela_Hantuchova,1,F-XC,30,5,0,1,4,11,19
20080124-W-Australian_Open-SF-Ana_Ivanovic-Daniela_Hantuchova,1,F-DTM,10,1,0,0,1,3,7
20080124-W-Australian_Open-SF-Ana_Ivanovic-Daniela_Hantuchova,1,F-DTL,15,8,2,0,6,5,10
20080124-W-Australian_Open-SF-Ana_Ivanovic-Daniela_Hantuchova,1,F-IO,21,10,6,1,3,16,5
20080124-W-Australian_Open-SF-Ana_Ivanovic-Daniela_Hantuchova,1,F-II,2,2,1,0,1,1,1
20080124-W-Australian_Open-SF-Ana_Ivanovic-Daniela_Hantuchova,1,B-XC,15,2,1,1,0,4,11
20080124-W-Australian_Open-SF-Ana_Ivanovic-Daniela_Hantuchova,1,B-DTM,32,4,0,0,4,6,26
20080124-W-Australian_Open-SF-Ana_Ivanovic-Daniela_Hantuchova,1,B-DTL,11,5,1,2,2,8,3
20080124-W-Australian_Open-SF-Ana_Ivanovic-Daniela_Hantuchova,1,B-IO,3,2,1,1,0,2,1
20080124-W-Australian_Open-SF-Ana_Ivanovic-Daniela_Hantuchova,1,S-XC,2,0,0,0,0,2,0
20080124-W-Australian_Open-SF-Ana_Ivanovic-Daniela_Hantuchova,1,S-DTM,3,0,0,0,0,2,1
20080124-W-Australian_Open-SF-Ana_Ivanovic-Daniela_Hantuchova,1,S-DTL,6,0,0,0,0,2,4
20080124-W-Australian_Open-SF-Ana_Ivanovic-Daniela_Hantuchova,2,F-XC,44,20,7,8,5,32,12
20080124-W-Australian_Open-SF-Ana_Ivanovic-Daniela_Hantuchova,2,F-DTM,9,1,0,1,0,7,2
20080124-W-Australian_Open-SF-Ana_Ivanovic-Daniela_Hantuchova,2,F-DTL,20,6,1,2,3,9,11
20080124-W-Australian_Open-SF-Ana_Ivanovic-Daniela_Hantuchova,2,F-IO,13,5,4,0,1,7,6
20080124-W-Australian_Open-SF-Ana_Ivanovic-Daniela_Hantuchova,2,F-II,2,1,0,1,0,2,0
20080124-W-Australian_Open-SF-Ana_Ivanovic-Daniela_Hantuchova,2,B-XC,33,6,1,2,3,23,10
20080124-W-Australian_Open-SF-Ana_Ivanovic-Daniela_Hantuchova,2,B-DTM,8,2,0,1,1,4,4
20080124-W-Australian_Open-SF-Ana_Ivanovic-Daniela_Hantuchova,2,B-DTL,9,3,2,1,0,7,2
20080124-W-Australian_Open-SF-Ana_Ivanovic-Daniela_Hantuchova,2,B-IO,9,4,3,0,1,6,3
20080124-W-Australian_Open-SF-Ana_Ivanovic-Daniela_Hantuchova,2,S-XC,2,1,0,1,0,2,0
20080124-W-Australian_Open-SF-Ana_Ivanovic-Daniela_Hantuchova,2,S-DTM,3,0,0,0,0,1,2
20000521-W-Rome-F-Amelie_Mauresmo-Monica_Seles,1,F-XC,37,11,4,3,4,21,16
20000521-W-Rome-F-Amelie_Mauresmo-Monica_Seles,1,F-DTM,19,0,0,0,0,9,10
20000521-W-Rome-F-Amelie_Mauresmo-Monica_Seles,1,F-DTL,20,8,3,0,5,7,13
20000521-W-Rome-F-Amelie_Mauresmo-Monica_Seles,1,F-IO,24,7,3,3,1,14,10
20000521-W-Rome-F-Amelie_Mauresmo-Monica_Seles,1,B-XC,18,3,0,1,2,9,9
20000521-W-Rome-F-Amelie_Mauresmo-Monica_Seles,1,B-DTM,19,2,0,0,2,4,15
20000521-W-Rome-F-Amelie_Mauresmo-Monica_Seles,1,B-DTL,9,5,4,1,0,7,2
20000521-W-Rome-F-Amelie_Mauresmo-Monica_Seles,1,B-IO,3,2,1,0,1,1,2
20000521-W-Rome-F-Amelie_Mauresmo-Monica_Seles,1,S-XC,10,2,1,0,1,3,7
20000521-W-Rome-F-Amelie_Mauresmo-Monica_Seles,1,S-DTM,9,2,0,0,2,3,6
20000521-W-Rome-F-Amelie_Mauresmo-Monica_Seles,1,S-DTL,2,1,0,0,1,1,1
20000521-W-Rome-F-Amelie_Mauresmo-Monica_Seles,2,F-XC,50,5,1,3,1,31,19
20000521-W-Rome-F-Amelie_Mauresmo-Monica_Seles,2,F-DTM,23,1,0,0,1,14,9
20000521-W-Rome-F-Amelie_Mauresmo-Monica_Seles,2,F-DTL,17,5,0,3,2,8,9
20000521-W-Rome-F-Amelie_Mauresmo-Monica_Seles,2,F-IO,15,5,2,2,1,10,5
20000521-W-Rome-F-Amelie_Mauresmo-Monica_Seles,2,B-XC,36,7,2,1,4,19,17
20000521-W-Rome-F-Amelie_Mauresmo-Monica_Seles,2,B-DTM,16,1,0,0,1,6,10
20000521-W-Rome-F-Amelie_Mauresmo-Monica_Seles,2,B-DTL,4,2,1,1,0,4,0
20000521-W-Rome-F-Amelie_Mauresmo-Monica_Seles,2,B-IO,2,0,0,0,0,0,2
20000521-W-Rome-F-Amelie_Mauresmo-Monica_Seles,2,S-DTL,1,0,0,0,0,0,1
20000521-W-Rome-F-Amelie_Mauresmo-Monica_Seles,2,S-IO,1,0,0,0,0,0,1
20180611-W-s_Hertogenbosch-R32-Coco_Vandeweghe-Aliaksandra_Sasnovich,1,F-XC,23,5,4,0,1,18,5
20180611-W-s_Hertogenbosch-R32-Coco_Vandeweghe-Aliaksandra_Sasnovich,1,F-DTM,18,3,1,0,2,7,11
20180611-W-s_Hertogenbosch-R32-Coco_Vandeweghe-Aliaksandra_Sasnovich,1,F-DTL,6,4,1,1,2,3,3
20180611-W-s_Hertogenbosch-R32-Coco_Vandeweghe-Aliaksandra_Sasnovich,1,F-IO,11,9,4,1,4,7,4
20180611-W-s_Hertogenbosch-R32-Coco_Vandeweghe-Aliaksandra_Sasnovich,1,F-II,3,0,0,0,0,2,1
20180611-W-s_Hertogenbosch-R32-Coco_Vandeweghe-Aliaksandra_Sasnovich,1,B-XC,24,8,2,2,4,12,12
20180611-W-s_Hertogenbosch-R32-Coco_Vandeweghe-Aliaksandra_Sasnovich,1,B-DTM,20,5,0,2,3,9,11
20180611-W-s_Hertogenbosch-R32-Coco_Vandeweghe-Aliaksandra_Sasnovich,1,B-DTL,4,4,1,2,1,3,1
20180611-W-s_Hertogenbosch-R32-Coco_Vandeweghe-Aliaksandra_Sasnovich,1,B-IO,2,2,2,0,0,2,0
20180611-W-s_Hertogenbosch-R32-Coco_Vandeweghe-Aliaksandra_Sasnovich,1,S-XC,6,1,0,0,1,1,5
20180611-W-s_Hertogenbosch-R32-Coco_Vandeweghe-Aliaksandra_Sasnovich,1,S-DTM,2,0,0,0,0,0,2
20180611-W-s_Hertogenbosch-R32-Coco_Vandeweghe-Aliaksandra_Sasnovich,1,S-DTL,3,0,0,0,0,2,1
20180611-W-s_Hertogenbosch-R32-Coco_Vandeweghe-Aliaksandra_Sasnovich,1,S-IO,1,0,0,0,0,0,1
20180611-W-s_Hertogenbosch-R32-Coco_Vandeweghe-Aliaksandra_Sasnovich,2,F-XC,24,12,3,3,6,12,12
20180611-W-s_Hertogenbosch-R32-Coco_Vandeweghe-Aliaksandra_Sasnovich,2,F-DTM,15,1,0,0,1,5,10
20180611-W-s_Hertogenbosch-R32-Coco_Vandeweghe-Aliaksandra_Sasnovich,2,F-DTL,10,5,1,0,4,3,7
20180611-W-s_Hertogenbosch-R32-Coco_Vandeweghe-Aliaksandra_Sasnovich,2,F-IO,13,5,0,2,3,7,6
20180611-W-s_Hertogenbosch-R32-Coco_Vandeweghe-Aliaksandra_Sasnovich,2,B-XC,32,8,2,1,5,17,15
20180611-W-s_Hertogenbosch-R32-Coco_Vandeweghe-Aliaksandra_Sasnovich,2,B-DTM,18,3,0,1,2,10,8
20180611-W-s_Hertogenbosch-R32-Coco_Vandeweghe-Aliaksandra_Sasnovich,2,B-DTL,7,4,2,2,0,5,2
20180611-W-s_Hertogenbosch-R32-Coco_Vandeweghe-Aliaksandra_Sasnovich,2,B-IO,10,3,0,0,3,5,5
20180611-W-s_Hertogenbosch-R32-Coco_Vandeweghe-Aliaksandra_Sasnovich,2,S-XC,3,0,0,0,0,1,2
20180611-W-s_Hertogenbosch-R32-Coco_Vandeweghe-Aliaksandra_Sasnovich,2,S-DTM,1,0,0,0,0,0,1
20181013-W-Hong_Kong-SF-Qiang_Wang-Garbine_Muguruza,1,F-XC,79,24,13,6,5,55,24
20181013-W-Hong_Kong-SF-Qiang_Wang-Garbine_Muguruza,1,F-DTM,48,5,0,1,4,28,20
20181013-W-Hong_Kong-SF-Qiang_Wang-Garbine_Muguruza,1,F-DTL,15,4,2,1,1,11,4
20181013-W-Hong_Kong-SF-Qiang_Wang-Garbine_Muguruza,1,F-IO,37,9,2,2,5,21,16
20181013-W-Hong_Kong-SF-Qiang_Wang-Garbine_Muguruza,1,F-II,3,3,2,1,0,3,0
20181013-W-Hong_Kong-SF-Qiang_Wang-Garbine_Muguruza,1,B-XC,68,10,6,3,1,47,21
20181013-W-Hong_Kong-SF-Qiang_Wang-Garbine_Muguruza,1,B-DTM,51,2,0,0,2,32,19
20181013-W-Hong_Kong-SF-Qiang_Wang-Garbine_Muguruza,1,B-DTL,19,9,5,1,3,13,6
20181013-W-Hong_Kong-SF-Qiang_Wang-Garbine_Muguruza,1,B-IO,7,2,1,1,0,6,1
20181013-W-Hong_Kong-SF-Qiang_Wang-Garbine_Muguruza,1,S-XC,2,0,0,0,0,1,1
20181013-W-Hong_Kong-SF-Qiang_Wang-Garbine_Muguruza,1,S-DTM,4,0,0,0,0,2,2
20181013-W-Hong_Kong-SF-Qiang_Wang-Garbine_Muguruza,2,F-XC,51,9,4,2,3,19,32
20181013-W-Hong_Kong-SF-Qiang_Wang-Garbine_Muguruza,2,F-DTM,35,4,0,2,2,11,24
20181013-W-Hong_Kong-SF-Qiang_Wang-Garbine_Muguruza,2,F-DTL,25,12,5,1,6,10,15
20181013-W-Hong_Kong-SF-Qiang_Wang-Garbine_Muguruza,2,F-IO,28,12,7,4,1,16,12
20181013-W-Hong_Kong-SF-Qiang_Wang-Garbine_Muguruza,2,B-XC,76,14,4,4,6,29,47
20181013-W-Hong_Kong-SF-Qiang_Wang-Garbine_Muguruza,2,B-DTM,60,1,0,0,1,18,42
20181013-W-Hong_Kong-SF-Qiang_Wang-Garbine_Muguruza,2,B-DTL,33,11,5,1,5,14,19
20181013-W-Hong_Kong-SF-Qiang_Wang-Garbine_Muguruza,2,B-IO,22,11,0,5,6,9,13
20181013-W-Hong_Kong-SF-Qiang_Wang-Garbine_Muguruza,2,S-DTM,1,0,0,0,0,0,1
20181030-W-Zhuhai-RR-Ashleigh_Barty-Aryna_Sabalenka,1,F-XC,27,8,1,4,3,14,13
20181030-W-Zhuhai-RR-Ashleigh_Barty-Aryna_Sabalenka,1,F-DTM,9,2,0,1,1,5,4
20181030-W-Zhuhai-RR-Ashleigh_Barty-Aryna_Sabalenka,1,F-DTL,2,0,0,0,0,1,1
20181030-W-Zhuhai-RR-Ashleigh_Barty-Aryna_Sabalenka,1,F-IO,18,8,2,1,5,8,10
20181030-W-Zhuhai-RR-Ashleigh_Barty-Aryna_Sabalenka,1,F-II,2,0,0,0,0,1,1
20181030-W-Zhuhai-RR-Ashleigh_Barty-Aryna_Sabalenka,1,B-XC,7,0,0,0,0,4,3
20181030-W-Zhuhai-RR-Ashleigh_Barty-Aryna_Sabalenka,1,B-DTM,12,0,0,0,0,3,9
20181030-W-Zhuhai-RR-Ashleigh_Barty-Aryna_Sabalenka,1,B-DTL,1,1,0,0,1,0,1
20181030-W-Zhuhai-RR-Ashleigh_Barty-Aryna_Sabalenka,1,S-XC,17,5,0,2,3,9,8
20181030-W-Zhuhai-RR-Ashleigh_Barty-Aryna_Sabalenka,1,S-DTM,11,0,0,0,0,3,8
20181030-W-Zhuhai-RR-Ashleigh_Barty-Aryna_Sabalenka,1,S-DTL,5,1,0,0,1,2,3
20181030-W-Zhuhai-RR-Ashleigh_Barty-Aryna_Sabalenka,2,F-XC,23,11,4,2,5,15,8
20181030-W-Zhuhai-RR-Ashleigh_Barty-Aryna_Sabalenka,2,F-DTM,5,1,0,1,0,3,2
20181030-W-Zhuhai-RR-Ashleigh_Barty-Aryna_Sabalenka,2,F-DTL,11,3,1,1,1,8,3
20181030-W-Zhuhai-RR-Ashleigh_Barty-Aryna_Sabalenka,2,F-IO,19,6,2,2,2,11,8
20181030-W-Zhuhai-RR-Ashleigh_Barty-Aryna_Sabalenka,2,F-II,1,1,0,1,0,1,0
20181030-W-Zhuhai-RR-Ashleigh_Barty-Aryna_Sabalenka,2,B-XC,32,7,0,2,5,14,18
20181030-W-Zhuhai-RR-Ashleigh_Barty-Aryna_Sabalenka,2,B-DTM,9,1,0,0,1,6,3
20181030-W-Zhuhai-RR-Ashleigh_Barty-Aryna_Sabalenka,2,B-DTL,7,2,1,1,0,4,3
20181030-W-Zhuhai-RR-Ashleigh_Barty-Aryna_Sabalenka,2,B-IO,8,4,0,2,2,3,5
20181030-W-Zhuhai-RR-Ashleigh_Barty-Aryna_Sabalenka,2,S-XC,2,0,0,0,0,2,0
20181030-W-Zhuhai-RR-Ashleigh_Barty-Aryna_Sabalenka,2,S-DTM,4,0,0,0,0,2,2
20181030-W-Zhuhai-RR-Ashleigh_Barty-Aryna_Sabalenka,2,S-DTL,3,0,0,0,0,2,1
20181030-W-Zhuhai-RR-Ashleigh_Barty-Aryna_Sabalenka,2,S-IO,1,1,0,0,1,0,1
19990111-W-Sydney-R16-Serena_Williams-Steffi_Graf,1,F-XC,66,20,5,7,8,29,37
19990111-W-Sydney-R16-Serena_Williams-Steffi_Graf,1,F-DTM,14,2,0,0,2,6,8
19990111-W-Sydney-R16-Serena_Williams-Steffi_Graf,1,F-DTL,7,5,2,2,1,6,1
19990111-W-Sydney-R16-Serena_Williams-Steffi_Graf,1,F-IO,5,2,1,0,1,2,3
19990111-W-Sydney-R16-Serena_Williams-Steffi_Graf,1,F-II,1,0,0,0,0,1,0
19990111-W-Sydney-R16-Serena_Williams-Steffi_Graf,1,B-XC,75,15,3,4,8,39,36
19990111-W-Sydney-R16-Serena_Williams-Steffi_Graf,1,B-DTM,51,5,0,0,5,20,31
19990111-W-Sydney-R16-Serena_Williams-Steffi_Graf,1,B-DTL,22,9,5,2,2,15,7
19990111-W-Sydney-R16-Serena_Williams-Steffi_Graf,1,B-IO,9,3,0,0,3,1,8
19990111-W-Sydney-R16-Serena_Williams-Steffi_Graf,1,S-XC,1,1,0,0,1,0,1
19990111-W-Sydney-R16-Serena_Williams-Steffi_Graf,1,S-DTL,2,1,1,0,0,1,1
19990111-W-Sydney-R16-Serena_Williams-Steffi_Graf,1,S-IO,1,1,0,0,1,0,1
19990111-W-Sydney-R16-Serena_Williams-Steffi_Graf,2,F-XC,73,17,4,6,7,44,29
19990111-W-Sydney-R16-Serena_Williams-Steffi_Graf,2,F-DTM,26,4,0,1,3,14,12
19990111-W-Sydney-R16-Serena_Williams-Steffi_Graf,2,F-DTL,27,7,3,2,2,16,11
19990111-W-Sydney-R16-Serena_Williams-Steffi_Graf,2,F-IO,41,17,2,7,8,21,20
19990111-W-Sydney-R16-Serena_Williams-Steffi_Graf,2,F-II,2,1,0,1,0,1,1
19990111-W-Sydney-R16-Serena_Williams-Steffi_Graf,2,B-IO,1,0,0,0,0,1,0
19990111-W-Sydney-R16-Serena_Williams-Steffi_Graf,2,S-XC,53,6,0,1,5,24,29
19990111-W-Sydney-R16-Serena_Williams-Steffi_Graf,2,S-DTM,14,1,0,0,1,8,6
19990111-W-Sydney-R16-Serena_Williams-Steffi_Graf,2,S-DTL,8,2,1,1,0,6,2
19990111-W-Sydney-R16-Serena_Williams-Steffi_Graf,2,S-IO,2,1,0,1,0,1,1
19990111-W-Sydney-R16-Serena_Williams-Steffi_Graf,2,S-II,1,0,0,0,0,1,0
20181231-W-Brisbane-R32-Samantha_Stosur-Marie_Bouzkova,1,F-XC,31,11,2,4,5,15,16
20181231-W-Brisbane-R32-Samantha_Stosur-Marie_Bouzkova,1,F-DTM,33,4,0,1,3,18,15
20181231-W-Brisbane-R32-Samantha_Stosur-Marie_Bouzkova,1,F-DTL,7,1,0,0,1,5,2
20181231-W-Brisbane-R32-Samantha_Stosur-Marie_Bouzkova,1,F-IO,25,7,5,1,1,11,14
20181231-W-Brisbane-R32-Samantha_Stosur-Marie_Bouzkova,1,B-XC,5,1,0,0,1,3,2
20181231-W-Brisbane-R32-Samantha_Stosur-Marie_Bouzkova,1,B-DTM,16,1,0,0,1,6,10
20181231-W-Brisbane-R32-Samantha_Stosur-Marie_Bouzkova,1,B-DTL,8,4,2,1,1,5,3
20181231-W-Brisbane-R32-Samantha_Stosur-Marie_Bouzkova,1,B-IO,4,0,0,0,0,3,1
20181231-W-Brisbane-R32-Samantha_Stosur-Marie_Bouzkova,1,S-XC,19,1,0,0,1,6,13
20181231-W-Brisbane-R32-Samantha_Stosur-Marie_Bouzkova,1,S-DTM,13,1,0,0,1,6,7
20181231-W-Brisbane-R32-Samantha_Stosur-Marie_Bouzkova,1,S-DTL,6,1,0,0,1,2,4
20181231-W-Brisbane-R32-Samantha_Stosur-Marie_Bouzkova,1,S-IO,2,0,0,0,0,1,1
20181231-W-Brisbane-R32-Samantha_Stosur-Marie_Bouzkova,2,F-XC,33,15,5,4,6,19,14
20181231-W-Brisbane-R32-Samantha_Stosur-Marie_Bouzkova,2,F-DTM,28,1,0,0,1,13,15
20181231-W-Brisbane-R32-Samantha_Stosur-Marie_Bouzkova,2,F-DTL,12,7,2,1,4,5,7
20181231-W-Brisbane-R32-Samantha_Stosur-Marie_Bouzkova,2,F-IO,16,7,4,1,2,10,6
20181231-W-Brisbane-R32-Samantha_Stosur-Marie_Bouzkova,2,B-XC,39,7,3,1,3,23,16
20181231-W-Brisbane-R32-Samantha_Stosur-Marie_Bouzkova,2,B-DTM,17,2,0,0,2,8,9
20181231-W-Brisbane-R32-Samantha_Stosur-Marie_Bouzkova,2,B-DTL,10,7,3,3,1,8,2
20181231-W-Brisbane-R32-Samantha_Stosur-Marie_Bouzkova,2,B-IO,11,7,4,2,1,9,2
20181231-W-Brisbane-R32-Samantha_Stosur-Marie_Bouzkova,2,B-II,1,0,0,0,0,1,0
20181231-W-Brisbane-R32-Samantha_Stosur-Marie_Bouzkova,2,S-XC,6,3,2,0,1,4,2
20181231-W-Brisbane-R32-Samantha_Stosur-Marie_Bouzkova,2,S-DTM,2,1,0,0,1,1,1
20181231-W-Brisbane-R32-Samantha_Stosur-Marie_Bouzkova,2,S-IO,1,1,0,1,0,1,0
20181231-W-Brisbane-R32-Daria_Kasatkina-Kimberly_Birrell,1,F-XC,87,12,5,1,6,43,44
20181231-W-Brisbane-R32-Daria_Kasatkina-Kimberly_Birrell,1,F-DTM,31,1,0,0,1,15,16
20181231-W-Brisbane-R32-Daria_Kasatkina-Kimberly_Birrell,1,F-DTL,26,4,1,2,1,12,14
20181231-W-Brisbane-R32-Daria_Kasatkina-Kimberly_Birrell,1,F-IO,41,12,6,1,5,25,16
20181231-W-Brisbane-R32-Daria_Kasatkina-Kimberly_Birrell,1,F-II,2,0,0,0,0,1,1
20181231-W-Brisbane-R32-Daria_Kasatkina-Kimberly_Birrell,1,B-XC,89,11,0,3,8,45,44
20181231-W-Brisbane-R32-Daria_Kasatkina-Kimberly_Birrell,1,B-DTM,81,8,0,0,8,37,44
20181231-W-Brisbane-R32-Daria_Kasatkina-Kimberly_Birrell,1,B-DTL,23,9,2,2,5,11,12
20181231-W-Brisbane-R32-Daria_Kasatkina-Kimberly_Birrell,1,B-IO,15,5,1,0,4,7,8
20181231-W-Brisbane-R32-Daria_Kasatkina-Kimberly_Birrell,1,S-XC,12,0,0,0,0,4,8
20181231-W-Brisbane-R32-Daria_Kasatkina-Kimberly_Birrell,1,S-DTM,9,0,0,0,0,5,4
20181231-W-Brisbane-R32-Daria_Kasatkina-Kimberly_Birrell,1,S-IO,3,0,0,0,0,1,2
20181231-W-Brisbane-R32-Daria_Kasatkina-Kimberly_Birrell,2,F-XC,95,20,7,4,9,57,38
20181231-W-Brisbane-R32-Daria_Kasatkina-Kimberly_Birrell,2,F-DTM,39,4,0,0,4,16,23
20181231-W-Brisbane-R32-Daria_Kasatkina-Kimberly_Birrell,2,F-DTL,46,15,3,3,9,28,18
20181231-W-Brisbane-R32-Daria_Kasatkina-Kimberly_Birrell,2,F-IO,35,9,4,2,3,23,12
20181231-W-Brisbane-R32-Daria_Kasatkina-Kimberly_Birrell,2,F-II,2,1,0,0,1,1,1
20181231-W-Brisbane-R32-Daria_Kasatkina-Kimberly_Birrell,2,B-XC,124,18,4,5,9,58,66
20181231-W-Brisbane-R32-Daria_Kasatkina-Kimberly_Birrell,2,B-DTM,48,4,0,0,4,20,28
20181231-W-Brisbane-R32-Daria_Kasatkina-Kimberly_Birrell,2,B-DTL,30,13,8,1,4,18,12
20181231-W-Brisbane-R32-Daria_Kasatkina-Kimberly_Birrell,2,B-IO,14,4,1,0,3,7,7
20181231-W-Brisbane-R32-Daria_Kasatkina-Kimberly_Birrell,2,S-DTL,1,1,1,0,0,1,0
20190103-W-Auckland-R16-Caroline_Wozniacki-Bianca_Andreescu,1,F-XC,74,14,6,4,4,35,39
20190103-W-Auckland-R16-Caroline_Wozniacki-Bianca_Andreescu,1,F-DTM,31,0,0,0,0,13,18
20190103-W-Auckland-R16-Caroline_Wozniacki-Bianca_Andreescu,1,F-DTL,24,7,2,4,1,16,8
20190103-W-Auckland-R16-Caroline_Wozniacki-Bianca_Andreescu,1,F-IO,23,4,2,1,1,14,9
20190103-W-Auckland-R16-Caroline_Wozniacki-Bianca_Andreescu,1,F-II,2,0,0,0,0,2,0
20190103-W-Auckland-R16-Caroline_Wozniacki-Bianca_Andreescu,1,B-XC,52,7,0,2,5,25,27
20190103-W-Auckland-R16-Caroline_Wozniacki-Bianca_Andreescu,1,B-DTM,25,0,0,0,0,12,13
20190103-W-Auckland-R16-Caroline_Wozniacki-Bianca_Andreescu,1,B-DTL,19,9,0,4,5,9,10
20190103-W-Auckland-R16-Caroline_Wozniacki-Bianca_Andreescu,1,B-IO,13,5,0,0,5,3,10
20190103-W-Auckland-R16-Caroline_Wozniacki-Bianca_Andreescu,1,B-II,1,0,0,0,0,1,0
20190103-W-Auckland-R16-Caroline_Wozniacki-Bianca_Andreescu,1,S-XC,2,0,0,0,0,1,1
20190103-W-Auckland-R16-Caroline_Wozniacki-Bianca_Andreescu,1,S-DTM,5,0,0,0,0,1,4
20190103-W-Auckland-R16-Caroline_Wozniacki-Bianca_Andreescu,1,S-DTL,3,0,0,0,0,0,3
20190103-W-Auckland-R16-Caroline_Wozniacki-Bianca_Andreescu,1,S-IO,1,0,0,0,0,1,0
20190103-W-Auckland-R16-Caroline_Wozniacki-Bianca_Andreescu,2,F-XC,75,11,5,3,3,45,30
20190103-W-Auckland-R16-Caroline_Wozniacki-Bianca_Andreescu,2,F-DTM,19,0,0,0,0,6,13
20190103-W-Auckland-R16-Caroline_Wozniacki-Bianca_Andreescu,2,F-DTL,25,8,3,2,3,16,9
20190103-W-Auckland-R16-Caroline_Wozniacki-Bianca_Andreescu,2,F-IO,22,8,5,1,2,16,6
20190103-W-Auckland-R16-Caroline_Wozniacki-Bianca_Andreescu,2,F-II,1,0,0,0,0,1,0
20190103-W-Auckland-R16-Caroline_Wozniacki-Bianca_Andreescu,2,B-XC,52,12,4,3,5,29,23
20190103-W-Auckland-R16-Caroline_Wozniacki-Bianca_Andreescu,2,B-DTM,27,2,0,1,1,19,8
20190103-W-Auckland-R16-Caroline_Wozniacki-Bianca_Andreescu,2,B-DTL,22,6,1,2,3,11,11
20190103-W-Auckland-R16-Caroline_Wozniacki-Bianca_Andreescu,2,B-IO,6,0,0,0,0,3,3
20190103-W-Auckland-R16-Caroline_Wozniacki-Bianca_Andreescu,2,B-II,1,0,0,0,0,0,1
20190103-W-Auckland-R16-Caroline_Wozniacki-Bianca_Andreescu,2,S-XC,11,3,0,0,3,3,8
20190103-W-Auckland-R16-Caroline_Wozniacki-Bianca_Andreescu,2,S-DTM,11,1,0,0,1,2,9
20190103-W-Auckland-R16-Caroline_Wozniacki-Bianca_Andreescu,2,S-DTL,6,0,0,0,0,2,4
20190103-W-Auckland-R16-Caroline_Wozniacki-Bianca_Andreescu,2,S-IO,3,0,0,0,0,2,1
20190103-W-Brisbane-QF-Naomi_Osaka-Anastasija_Sevastova,1,F-XC,48,15,3,7,5,29,19
20190103-W-Brisbane-QF-Naomi_Osaka-Anastasija_Sevastova,1,F-DTM,11,0,0,0,0,5,6
20190103-W-Brisbane-QF-Naomi_Osaka-Anastasija_Sevastova,1,F-DTL,7,3,0,0,3,3,4
20190103-W-Brisbane-QF-Naomi_Osaka-Anastasija_Sevastova,1,F-IO,12,6,2,1,3,8,4
20190103-W-Brisbane-QF-Naomi_Osaka-Anastasija_Sevastova,1,B-XC,52,9,3,3,3,29,23
20190103-W-Brisbane-QF-Naomi_Osaka-Anastasija_Sevastova,1,B-DTM,16,1,0,0,1,6,10
20190103-W-Brisbane-QF-Naomi_Osaka-Anastasija_Sevastova,1,B-DTL,11,9,5,1,3,7,4
20190103-W-Brisbane-QF-Naomi_Osaka-Anastasija_Sevastova,1,B-IO,6,4,3,1,0,6,0
20190103-W-Brisbane-QF-Naomi_Osaka-Anastasija_Sevastova,2,F-XC,36,8,1,1,6,17,19
20190103-W-Brisbane-QF-Naomi_Osaka-Anastasija_Sevastova,2,F-DTM,9,0,0,0,0,3,6
20190103-W-Brisbane-QF-Naomi_Osaka-Anastasija_Sevastova,2,F-DTL,7,3,1,2,0,5,2
20190103-W-Brisbane-QF-Naomi_Osaka-Anastasija_Sevastova,2,F-IO,13,3,2,1,0,10,3
20190103-W-Brisbane-QF-Naomi_Osaka-Anastasija_Sevastova,2,F-II,1,1,1,0,0,1,0
20190103-W-Brisbane-QF-Naomi_Osaka-Anastasija_Sevastova,2,B-XC,28,3,1,0,2,12,16
20190103-W-Brisbane-QF-Naomi_Osaka-Anastasija_Sevastova,2,B-DTM,22,0,0,0,0,11,11
20190103-W-Brisbane-QF-Naomi_Osaka-Anastasija_Sevastova,2,B-DTL,5,3,3,0,0,3,2
20190103-W-Brisbane-QF-Naomi_Osaka-Anastasija_Sevastova,2,B-IO,4,2,1,0,1,3,1
20190103-W-Brisbane-QF-Naomi_Osaka-Anastasija_Sevastova,2,S-XC,13,0,0,0,0,3,10
20190103-W-Brisbane-QF-Naomi_Osaka-Anastasija_Sevastova,2,S-DTM,5,0,0,0,0,1,4
20190103-W-Brisbane-QF-Naomi_Osaka-Anastasija_Sevastova,2,S-DTL,1,0,0,0,0,0,1
20190103-W-Brisbane-QF-Naomi_Osaka-Anastasija_Sevastova,2,S-IO,1,0,0,0,0,0,1
20190104-W-Brisbane-QF-Aliaksandra_Sasnovich-Donna_Vekic,1,F-XC,19,6,2,0,4,6,13
20190104-W-Brisbane-QF-Aliaksandra_Sasnovich-Donna_Vekic,1,F-DTM,9,1,0,0,1,4,5
20190104-W-Brisbane-QF-Aliaksandra_Sasnovich-Donna_Vekic,1,F-DTL,8,3,1,0,2,1,7
20190104-W-Brisbane-QF-Aliaksandra_Sasnovich-Donna_Vekic,1,F-IO,6,3,0,1,2,1,5
20190104-W-Brisbane-QF-Aliaksandra_Sasnovich-Donna_Vekic,1,B-XC,18,7,4,0,3,11,7
20190104-W-Brisbane-QF-Aliaksandra_Sasnovich-Donna_Vekic,1,B-DTM,7,1,0,0,1,1,6
20190104-W-Brisbane-QF-Aliaksandra_Sasnovich-Donna_Vekic,1,B-DTL,4,4,3,0,1,3,1
20190104-W-Brisbane-QF-Aliaksandra_Sasnovich-Donna_Vekic,1,B-IO,1,1,0,1,0,1,0
20190104-W-Brisbane-QF-Aliaksandra_Sasnovich-Donna_Vekic,1,S-XC,1,0,0,0,0,0,1
20190104-W-Brisbane-QF-Aliaksandra_Sasnovich-Donna_Vekic,1,S-DTM,4,0,0,0,0,1,3
20190104-W-Brisbane-QF-Aliaksandra_Sasnovich-Donna_Vekic,2,F-XC,18,5,4,0,1,14,4
20190104-W-Brisbane-QF-Aliaksandra_Sasnovich-Donna_Vekic,2,F-DTM,9,1,0,0,1,5,4
20190104-W-Brisbane-QF-Aliaksandra_Sasnovich-Donna_Vekic,2,F-DTL,1,0,0,0,0,0,1
20190104-W-Brisbane-QF-Aliaksandra_Sasnovich-Donna_Vekic,2,F-IO,12,5,2,3,0,9,3
20190104-W-Brisbane-QF-Aliaksandra_Sasnovich-Donna_Vekic,2,B-XC,14,2,0,1,1,8,6
20190104-W-Brisbane-QF-Aliaksandra_Sasnovich-Donna_Vekic,2,B-DTM,11,1,0,0,1,6,5
20190104-W-Brisbane-QF-Aliaksandra_Sasnovich-Donna_Vekic,2,B-DTL,5,2,1,1,0,5,0
20190104-W-Brisbane-QF-Aliaksandra_Sasnovich-Donna_Vekic,2,S-XC,1,1,1,0,0,1,0
20120729-W-Olympics-R64-Agnieszka_Radwanska-Julia_Goerges,1,F-XC,33,11,5,2,4,21,12
20120729-W-Olympics-R64-Agnieszka_Radwanska-Julia_Goerges,1,F-DTM,6,2,0,0,2,1,5
20120729-W-Olympics-R64-Agnieszka_Radwanska-Julia_Goerges,1,F-DTL,14,4,1,2,1,7,7
20120729-W-Olympics-R64-Agnieszka_Radwanska-Julia_Goerges,1,F-IO,19,7,2,1,4,9,10
20120729-W-Olympics-R64-Agnieszka_Radwanska-Julia_Goerges,1,F-II,2,2,1,0,1,1,1
20120729-W-Olympics-R64-Agnieszka_Radwanska-Julia_Goerges,1,B-XC,32,4,0,0,4,14,18
20120729-W-Olympics-R64-Agnieszka_Radwanska-Julia_Goerges,1,B-DTM,21,1,0,0,1,5,16
20120729-W-Olympics-R64-Agnieszka_Radwanska-Julia_Goerges,1,B-DTL,12,3,0,2,1,5,7
20120729-W-Olympics-R64-Agnieszka_Radwanska-Julia_Goerges,1,B-IO,7,3,2,0,1,5,2
20120729-W-Olympics-R64-Agnieszka_Radwanska-Julia_Goerges,1,S-XC,4,0,0,0,0,2,2
20120729-W-Olympics-R64-Agnieszka_Radwanska-Julia_Goerges,1,S-DTM,4,0,0,0,0,1,3
20120729-W-Olympics-R64-Agnieszka_Radwanska-Julia_Goerges,1,S-DTL,1,0,0,0,0,0,1
20120729-W-Olympics-R64-Agnieszka_Radwanska-Julia_Goerges,1,S-IO,1,0,0,0,0,1,0
20120729-W-Olympics-R64-Agnieszka_Radwanska-Julia_Goerges,2,F-XC,38,14,6,2,6,21,17
20120729-W-Olympics-R64-Agnieszka_Radwanska-Julia_Goerges,2,F-DTM,13,2,0,0,2,7,6
20120729-W-Olympics-R64-Agnieszka_Radwanska-Julia_Goerges,2,F-DTL,15,8,2,2,4,8,7
20120729-W-Olympics-R64-Agnieszka_Radwanska-Julia_Goerges,2,F-IO,26,14,6,5,3,20,6
20120729-W-Olympics-R64-Agnieszka_Radwanska-Julia_Goerges,2,F-II,1,1,1,0,0,1,0
20120729-W-Olympics-R64-Agnieszka_Radwanska-Julia_Goerges,2,B-XC,35,5,1,3,1,21,14
20120729-W-Olympics-R64-Agnieszka_Radwanska-Julia_Goerges,2,B-DTM,20,3,1,0,2,10,10
20120729-W-Olympics-R64-Agnieszka_Radwanska-Julia_Goerges,2,B-DTL,19,11,6,0,5,10,9
20120729-W-Olympics-R64-Agnieszka_Radwanska-Julia_Goerges,2,B-IO,2,1,0,0,1,1,1
20120729-W-Olympics-R64-Agnieszka_Radwanska-Julia_Goerges,2,S-XC,4,0,0,0,0,2,2
20120729-W-Olympics-R64-Agnieszka_Radwanska-Julia_Goerges,2,S-DTM,2,0,0,0,0,0,2
20120729-W-Olympics-R64-Agnieszka_Radwanska-Julia_Goerges,2,S-DTL,1,1,0,0,1,0,1
20190104-W-Auckland-QF-Venus_Williams-Bianca_Andreescu,1,F-XC,72,22,3,9,10,33,39
20190104-W-Auckland-QF-Venus_Williams-Bianca_Andreescu,1,F-DTM,37,6,0,1,5,14,23
20190104-W-Auckland-QF-Venus_Williams-Bianca_Andreescu,1,F-DTL,16,6,1,2,3,6,10
20190104-W-Auckland-QF-Venus_Williams-Bianca_Andreescu,1,F-IO,27,9,2,2,5,9,18
20190104-W-Auckland-QF-Venus_Williams-Bianca_Andreescu,1,F-II,1,0,0,0,0,0,1
20190104-W-Auckland-QF-Venus_Williams-Bianca_Andreescu,1,B-XC,52,7,1,2,4,23,29
20190104-W-Auckland-QF-Venus_Williams-Bianca_Andreescu,1,B-DTM,25,1,0,1,0,11,14
20190104-W-Auckland-QF-Venus_Williams-Bianca_Andreescu,1,B-DTL,7,1,0,1,0,3,4
20190104-W-Auckland-QF-Venus_Williams-Bianca_Andreescu,1,B-IO,7,2,0,2,0,5,2
20190104-W-Auckland-QF-Venus_Williams-Bianca_Andreescu,1,B-II,1,0,0,0,0,1,0
20190104-W-Auckland-QF-Venus_Williams-Bianca_Andreescu,1,S-XC,5,0,0,0,0,0,5
20190104-W-Auckland-QF-Venus_Williams-Bianca_Andreescu,1,S-DTM,2,0,0,0,0,0,2
20190104-W-Auckland-QF-Venus_Williams-Bianca_Andreescu,1,S-DTL,1,0,0,0,0,0,1
20190104-W-Auckland-QF-Venus_Williams-Bianca_Andreescu,1,S-IO,1,0,0,0,0,0,1
20190104-W-Auckland-QF-Venus_Williams-Bianca_Andreescu,2,F-XC,55,13,6,3,4,33,22
20190104-W-Auckland-QF-Venus_Williams-Bianca_Andreescu,2,F-DTM,28,1,0,0,1,13,15
20190104-W-Auckland-QF-Venus_Williams-Bianca_Andreescu,2,F-DTL,20,6,1,2,3,14,6
20190104-W-Auckland-QF-Venus_Williams-Bianca_Andreescu,2,F-IO,24,10,4,3,3,17,7
20190104-W-Auckland-QF-Venus_Williams-Bianca_Andreescu,2,F-II,4,1,0,0,1,3,1
20190104-W-Auckland-QF-Venus_Williams-Bianca_Andreescu,2,B-XC,37,15,7,1,7,19,18
20190104-W-Auckland-QF-Venus_Williams-Bianca_Andreescu,2,B-DTM,29,1,0,0,1,15,14
20190104-W-Auckland-QF-Venus_Williams-Bianca_Andreescu,2,B-DTL,13,6,4,0,2,9,4
20190104-W-Auckland-QF-Venus_Williams-Bianca_Andreescu,2,B-IO,10,5,1,1,3,4,6
20190104-W-Auckland-QF-Venus_Williams-Bianca_Andreescu,2,S-XC,3,0,0,0,0,1,2
20190104-W-Auckland-QF-Venus_Williams-Bianca_Andreescu,2,S-DTM,10,0,0,0,0,7,3
20190104-W-Auckland-QF-Venus_Williams-Bianca_Andreescu,2,S-DTL,10,2,1,1,0,4,6
20190104-W-Auckland-QF-Venus_Williams-Bianca_Andreescu,2,S-IO,4,1,0,1,0,2,2
20190102-W-Brisbane-R16-Karolina_Pliskova-Marie_Bouzkova,1,F-XC,33,7,5,0,2,15,18
20190102-W-Brisbane-R16-Karolina_Pliskova-Marie_Bouzkova,1,F-DTM,12,2,0,1,1,8,4
20190102-W-Brisbane-R16-Karolina_Pliskova-Marie_Bouzkova,1,F-DTL,5,3,3,0,0,4,1
20190102-W-Brisbane-R16-Karolina_Pliskova-Marie_Bouzkova,1,F-IO,15,6,3,1,2,7,8
20190102-W-Brisbane-R16-Karolina_Pliskova-Marie_Bouzkova,1,B-XC,19,3,0,0,3,10,9
20190102-W-Brisbane-R16-Karolina_Pliskova-Marie_Bouzkova,1,B-DTM,15,1,0,0,1,4,11
20190102-W-Brisbane-R16-Karolina_Pliskova-Marie_Bouzkova,1,B-DTL,8,2,1,1,0,7,1
20190102-W-Brisbane-R16-Karolina_Pliskova-Marie_Bouzkova,1,B-IO,5,1,1,0,0,4,1
20190102-W-Brisbane-R16-Karolina_Pliskova-Marie_Bouzkova,1,S-XC,3,0,0,0,0,1,2
20190102-W-Brisbane-R16-Karolina_Pliskova-Marie_Bouzkova,1,S-DTM,6,0,0,0,0,5,1
20190102-W-Brisbane-R16-Karolina_Pliskova-Marie_Bouzkova,2,F-XC,18,3,1,0,2,8,10
20190102-W-Brisbane-R16-Karolina_Pliskova-Marie_Bouzkova,2,F-DTM,16,1,0,0,1,8,8
20190102-W-Brisbane-R16-Karolina_Pliskova-Marie_Bouzkova,2,F-DTL,15,8,3,1,4,7,8
20190102-W-Brisbane-R16-Karolina_Pliskova-Marie_Bouzkova,2,F-IO,12,5,1,0,4,5,7
20190102-W-Brisbane-R16-Karolina_Pliskova-Marie_Bouzkova,2,F-II,1,0,0,0,0,0,1
20190102-W-Brisbane-R16-Karolina_Pliskova-Marie_Bouzkova,2,B-XC,22,3,2,0,1,10,12
20190102-W-Brisbane-R16-Karolina_Pliskova-Marie_Bouzkova,2,B-DTM,16,0,0,0,0,7,9
20190102-W-Brisbane-R16-Karolina_Pliskova-Marie_Bouzkova,2,B-DTL,9,6,6,0,0,6,3
20190102-W-Brisbane-R16-Karolina_Pliskova-Marie_Bouzkova,2,B-IO,7,4,2,0,2,3,4
20190102-W-Brisbane-R16-Karolina_Pliskova-Marie_Bouzkova,2,S-XC,1,0,0,0,0,1,0
20190105-W-Brisbane-SF-Karolina_Pliskova-Donna_Vekic,1,F-XC,36,8,5,0,3,19,17
20190105-W-Brisbane-SF-Karolina_Pliskova-Donna_Vekic,1,F-DTM,5,0,0,0,0,3,2
20190105-W-Brisbane-SF-Karolina_Pliskova-Donna_Vekic,1,F-DTL,18,9,7,1,1,10,8
20190105-W-Brisbane-SF-Karolina_Pliskova-Donna_Vekic,1,F-IO,11,3,2,0,1,5,6
20190105-W-Brisbane-SF-Karolina_Pliskova-Donna_Vekic,1,F-II,1,1,0,1,0,1,0
20190105-W-Brisbane-SF-Karolina_Pliskova-Donna_Vekic,1,B-XC,20,1,0,0,1,4,16
20190105-W-Brisbane-SF-Karolina_Pliskova-Donna_Vekic,1,B-DTM,17,0,0,0,0,8,9
20190105-W-Brisbane-SF-Karolina_Pliskova-Donna_Vekic,1,B-DTL,6,3,2,0,1,2,4
20190105-W-Brisbane-SF-Karolina_Pliskova-Donna_Vekic,1,B-IO,7,6,4,0,2,5,2
20190105-W-Brisbane-SF-Karolina_Pliskova-Donna_Vekic,1,S-XC,9,0,0,0,0,4,5
20190105-W-Brisbane-SF-Karolina_Pliskova-Donna_Vekic,1,S-DTM,6,0,0,0,0,4,2
20190105-W-Brisbane-SF-Karolina_Pliskova-Donna_Vekic,2,F-XC,24,5,3,0,2,14,10
20190105-W-Brisbane-SF-Karolina_Pliskova-Donna_Vekic,2,F-DTM,12,0,0,0,0,5,7
20190105-W-Brisbane-SF-Karolina_Pliskova-Donna_Vekic,2,F-DTL,21,10,6,2,2,15,6
20190105-W-Brisbane-SF-Karolina_Pliskova-Donna_Vekic,2,F-IO,22,7,4,1,2,14,8
20190105-W-Brisbane-SF-Karolina_Pliskova-Donna_Vekic,2,F-II,1,0,0,0,0,1,0
20190105-W-Brisbane-SF-Karolina_Pliskova-Donna_Vekic,2,B-XC,20,1,0,1,0,16,4
20190105-W-Brisbane-SF-Karolina_Pliskova-Donna_Vekic,2,B-DTM,16,0,0,0,0,5,11
20190105-W-Brisbane-SF-Karolina_Pliskova-Donna_Vekic,2,B-DTL,17,9,4,0,5,9,8
20190105-W-Brisbane-SF-Karolina_Pliskova-Donna_Vekic,2,B-IO,7,4,0,1,3,4,3
20190105-W-Brisbane-SF-Naomi_Osaka-Lesia_Tsurenko,1,F-XC,21,4,0,1,3,12,9
20190105-W-Brisbane-SF-Naomi_Osaka-Lesia_Tsurenko,1,F-DTM,10,4,0,0,4,3,7
20190105-W-Brisbane-SF-Naomi_Osaka-Lesia_Tsurenko,1,F-DTL,6,3,2,1,0,4,2
20190105-W-Brisbane-SF-Naomi_Osaka-Lesia_Tsurenko,1,F-IO,8,3,1,0,2,2,6
20190105-W-Brisbane-SF-Naomi_Osaka-Lesia_Tsurenko,1,B-XC,26,7,1,1,5,10,16
20190105-W-Brisbane-SF-Naomi_Osaka-Lesia_Tsurenko,1,B-DTM,7,3,0,0,3,1,6
20190105-W-Brisbane-SF-Naomi_Osaka-Lesia_Tsurenko,1,B-DTL,6,3,2,1,0,4,2
20190105-W-Brisbane-SF-Naomi_Osaka-Lesia_Tsurenko,1,B-IO,2,1,0,0,1,1,1
20190105-W-Brisbane-SF-Naomi_Osaka-Lesia_Tsurenko,1,S-DTL,1,0,0,0,0,0,1
20190105-W-Brisbane-SF-Naomi_Osaka-Lesia_Tsurenko,2,F-XC,16,5,2,0,3,5,11
20190105-W-Brisbane-SF-Naomi_Osaka-Lesia_Tsurenko,2,F-DTM,7,1,0,0,1,4,3
20190105-W-Brisbane-SF-Naomi_Osaka-Lesia_Tsurenko,2,F-DTL,9,2,0,1,1,5,4
20190105-W-Brisbane-SF-Naomi_Osaka-Lesia_Tsurenko,2,F-IO,8,3,1,1,1,5,3
20190105-W-Brisbane-SF-Naomi_Osaka-Lesia_Tsurenko,2,B-XC,9,4,2,1,1,7,2
20190105-W-Brisbane-SF-Naomi_Osaka-Lesia_Tsurenko,2,B-DTM,22,1,0,0,1,14,8
20190105-W-Brisbane-SF-Naomi_Osaka-Lesia_Tsurenko,2,B-DTL,6,2,2,0,0,5,1
20190105-W-Brisbane-SF-Naomi_Osaka-Lesia_Tsurenko,2,B-IO,2,1,1,0,0,2,0
20190105-W-Brisbane-SF-Naomi_Osaka-Lesia_Tsurenko,2,S-XC,1,0,0,0,0,0,1
20190105-W-Brisbane-SF-Naomi_Osaka-Lesia_Tsurenko,2,S-DTM,4,0,0,0,0,2,2
20190105-W-Brisbane-SF-Naomi_Osaka-Lesia_Tsurenko,2,S-DTL,1,0,0,0,0,0,1
20060908-W-US_Open-SF-Amelie_Mauresmo-Maria_Sharapova,1,F-XC,56,8,0,2,6,24,32
20060908-W-US_Open-SF-Amelie_Mauresmo-Maria_Sharapova,1,F-DTM,36,1,0,0,1,12,24
20060908-W-US_Open-SF-Amelie_Mauresmo-Maria_Sharapova,1,F-DTL,49,18,3,7,8,24,25
20060908-W-US_Open-SF-Amelie_Mauresmo-Maria_Sharapova,1,F-IO,20,4,1,0,3,10,10
20060908-W-US_Open-SF-Amelie_Mauresmo-Maria_Sharapova,1,F-II,1,0,0,0,0,0,1
20060908-W-US_Open-SF-Amelie_Mauresmo-Maria_Sharapova,1,B-XC,10,3,0,1,2,6,4
20060908-W-US_Open-SF-Amelie_Mauresmo-Maria_Sharapova,1,B-DTM,19,3,0,0,3,10,9
20060908-W-US_Open-SF-Amelie_Mauresmo-Maria_Sharapova,1,B-DTL,11,2,1,1,0,3,8
20060908-W-US_Open-SF-Amelie_Mauresmo-Maria_Sharapova,1,B-IO,4,0,0,0,0,1,3
20060908-W-US_Open-SF-Amelie_Mauresmo-Maria_Sharapova,1,S-XC,11,1,0,0,1,5,6
20060908-W-US_Open-SF-Amelie_Mauresmo-Maria_Sharapova,1,S-DTM,16,0,0,0,0,10,6
20060908-W-US_Open-SF-Amelie_Mauresmo-Maria_Sharapova,1,S-DTL,8,1,0,0,1,4,4
20060908-W-US_Open-SF-Amelie_Mauresmo-Maria_Sharapova,1,S-IO,7,0,0,0,0,3,4
20060908-W-US_Open-SF-Amelie_Mauresmo-Maria_Sharapova,2,F-XC,86,12,6,3,3,52,34
20060908-W-US_Open-SF-Amelie_Mauresmo-Maria_Sharapova,2,F-DTM,26,1,0,0,1,12,14
20060908-W-US_Open-SF-Amelie_Mauresmo-Maria_Sharapova,2,F-DTL,19,8,4,3,1,11,8
20060908-W-US_Open-SF-Amelie_Mauresmo-Maria_Sharapova,2,F-IO,26,6,2,2,2,16,10
20060908-W-US_Open-SF-Amelie_Mauresmo-Maria_Sharapova,2,F-II,3,0,0,0,0,1,2
20060908-W-US_Open-SF-Amelie_Mauresmo-Maria_Sharapova,2,B-XC,48,9,4,2,3,28,20
20060908-W-US_Open-SF-Amelie_Mauresmo-Maria_Sharapova,2,B-DTM,20,2,0,0,2,9,11
20060908-W-US_Open-SF-Amelie_Mauresmo-Maria_Sharapova,2,B-DTL,16,3,0,2,1,9,7
20060908-W-US_Open-SF-Amelie_Mauresmo-Maria_Sharapova,2,B-IO,11,2,1,0,1,6,5
20190109-W-Hobart-R16-Magda_Linette-Greet_Minnen,1,F-XC,71,18,2,7,9,42,29
20190109-W-Hobart-R16-Magda_Linette-Greet_Minnen,1,F-DTM,39,2,0,0,2,13,26
20190109-W-Hobart-R16-Magda_Linette-Greet_Minnen,1,F-DTL,16,10,4,2,4,8,8
20190109-W-Hobart-R16-Magda_Linette-Greet_Minnen,1,F-IO,18,7,3,0,4,9,9
20190109-W-Hobart-R16-Magda_Linette-Greet_Minnen,1,F-II,3,2,1,1,0,2,1
20190109-W-Hobart-R16-Magda_Linette-Greet_Minnen,1,B-XC,54,9,1,1,7,21,33
20190109-W-Hobart-R16-Magda_Linette-Greet_Minnen,1,B-DTM,37,3,0,1,2,15,22
20190109-W-Hobart-R16-Magda_Linette-Greet_Minnen,1,B-DTL,7,3,1,1,1,3,4
20190109-W-Hobart-R16-Magda_Linette-Greet_Minnen,1,B-IO,3,1,1,0,0,2,1
20190109-W-Hobart-R16-Magda_Linette-Greet_Minnen,1,S-XC,3,0,0,0,0,0,3
20190109-W-Hobart-R16-Magda_Linette-Greet_Minnen,1,S-DTM,2,0,0,0,0,1,1
20190109-W-Hobart-R16-Magda_Linette-Greet_Minnen,1,S-DTL,1,0,0,0,0,1,0
20190109-W-Hobart-R16-Magda_Linette-Greet_Minnen,1,S-IO,1,1,1,0,0,1,0
20190109-W-Hobart-R16-Magda_Linette-Greet_Minnen,2,F-XC,73,18,3,7,8,38,35
20190109-W-Hobart-R16-Magda_Linette-Greet_Minnen,2,F-DTM,33,1,1,0,0,17,16
20190109-W-Hobart-R16-Magda_Linette-Greet_Minnen,2,F-DTL,19,8,1,1,6,8,11
20190109-W-Hobart-R16-Magda_Linette-Greet_Minnen,2,F-IO,38,17,8,4,5,28,10
20190109-W-Hobart-R16-Magda_Linette-Greet_Minnen,2,F-II,6,3,3,0,0,6,0
20190109-W-Hobart-R16-Magda_Linette-Greet_Minnen,2,B-XC,28,7,2,1,4,14,14
20190109-W-Hobart-R16-Magda_Linette-Greet_Minnen,2,B-DTM,37,2,0,0,2,20,17
20190109-W-Hobart-R16-Magda_Linette-Greet_Minnen,2,B-DTL,4,2,0,1,1,3,1
20190109-W-Hobart-R16-Magda_Linette-Greet_Minnen,2,B-IO,1,0,0,0,0,0,1
20190109-W-Hobart-R16-Magda_Linette-Greet_Minnen,2,S-XC,5,1,0,0,1,2,3
20190109-W-Hobart-R16-Magda_Linette-Greet_Minnen,2,S-DTM,8,0,0,0,0,5,3
20190109-W-Hobart-R16-Magda_Linette-Greet_Minnen,2,S-DTL,2,1,0,0,1,1,1
20090604-W-Roland_Garros-SF-Dinara_Safina-Dominika_Cibulkova,1,F-XC,81,10,2,1,7,42,39
20090604-W-Roland_Garros-SF-Dinara_Safina-Dominika_Cibulkova,1,F-DTM,22,3,0,0,3,10,12
20090604-W-Roland_Garros-SF-Dinara_Safina-Dominika_Cibulkova,1,F-DTL,27,3,3,0,0,15,12
20090604-W-Roland_Garros-SF-Dinara_Safina-Dominika_Cibulkova,1,F-IO,26,5,3,0,2,15,11
20090604-W-Roland_Garros-SF-Dinara_Safina-Dominika_Cibulkova,1,F-II,1,0,0,0,0,0,1
20090604-W-Roland_Garros-SF-Dinara_Safina-Dominika_Cibulkova,1,B-XC,66,7,2,1,4,39,27
20090604-W-Roland_Garros-SF-Dinara_Safina-Dominika_Cibulkova,1,B-DTM,25,2,0,1,1,18,7
20090604-W-Roland_Garros-SF-Dinara_Safina-Dominika_Cibulkova,1,B-DTL,11,8,5,0,3,7,4
20090604-W-Roland_Garros-SF-Dinara_Safina-Dominika_Cibulkova,1,B-IO,3,1,1,0,0,2,1
20090604-W-Roland_Garros-SF-Dinara_Safina-Dominika_Cibulkova,1,B-II,1,0,0,0,0,1,0
20090604-W-Roland_Garros-SF-Dinara_Safina-Dominika_Cibulkova,1,S-XC,5,0,0,0,0,2,3
20090604-W-Roland_Garros-SF-Dinara_Safina-Dominika_Cibulkova,1,S-DTM,1,0,0,0,0,1,0
20090604-W-Roland_Garros-SF-Dinara_Safina-Dominika_Cibulkova,1,S-DTL,1,0,0,0,0,0,1
20090604-W-Roland_Garros-SF-Dinara_Safina-Dominika_Cibulkova,2,F-XC,72,10,0,2,8,32,40
20090604-W-Roland_Garros-SF-Dinara_Safina-Dominika_Cibulkova,2,F-DTM,31,2,0,0,2,14,17
20090604-W-Roland_Garros-SF-Dinara_Safina-Dominika_Cibulkova,2,F-DTL,20,10,3,2,5,9,11
20090604-W-Roland_Garros-SF-Dinara_Safina-Dominika_Cibulkova,2,F-IO,6,2,2,0,0,3,3
20090604-W-Roland_Garros-SF-Dinara_Safina-Dominika_Cibulkova,2,F-II,3,0,0,0,0,2,1
20090604-W-Roland_Garros-SF-Dinara_Safina-Dominika_Cibulkova,2,B-XC,75,15,4,3,8,35,40
20090604-W-Roland_Garros-SF-Dinara_Safina-Dominika_Cibulkova,2,B-DTM,33,4,0,0,4,10,23
20090604-W-Roland_Garros-SF-Dinara_Safina-Dominika_Cibulkova,2,B-DTL,16,3,1,0,2,6,10
20090604-W-Roland_Garros-SF-Dinara_Safina-Dominika_Cibulkova,2,B-IO,3,0,0,0,0,1,2
20090604-W-Roland_Garros-SF-Dinara_Safina-Dominika_Cibulkova,2,S-XC,7,0,0,0,0,3,4
20090604-W-Roland_Garros-SF-Dinara_Safina-Dominika_Cibulkova,2,S-DTM,5,0,0,0,0,1,4
20190110-W-Hobart-QF-Dayana_Yastremska-Belinda_Bencic,1,F-XC,37,23,11,2,10,24,13
20190110-W-Hobart-QF-Dayana_Yastremska-Belinda_Bencic,1,F-DTM,18,4,1,0,3,9,9
20190110-W-Hobart-QF-Dayana_Yastremska-Belinda_Bencic,1,F-DTL,10,6,1,1,4,5,5
20190110-W-Hobart-QF-Dayana_Yastremska-Belinda_Bencic,1,F-IO,7,2,0,0,2,4,3
20190110-W-Hobart-QF-Dayana_Yastremska-Belinda_Bencic,1,F-II,1,1,0,0,1,0,1
20190110-W-Hobart-QF-Dayana_Yastremska-Belinda_Bencic,1,B-XC,13,5,2,1,2,6,7
20190110-W-Hobart-QF-Dayana_Yastremska-Belinda_Bencic,1,B-DTM,15,3,1,0,2,8,7
20190110-W-Hobart-QF-Dayana_Yastremska-Belinda_Bencic,1,B-DTL,13,4,2,0,2,9,4
20190110-W-Hobart-QF-Dayana_Yastremska-Belinda_Bencic,1,B-IO,10,7,3,1,3,5,5
20190110-W-Hobart-QF-Dayana_Yastremska-Belinda_Bencic,2,F-XC,23,4,2,1,1,10,13
20190110-W-Hobart-QF-Dayana_Yastremska-Belinda_Bencic,2,F-DTM,10,2,0,0,2,2,8
20190110-W-Hobart-QF-Dayana_Yastremska-Belinda_Bencic,2,F-DTL,8,5,1,1,3,3,5
20190110-W-Hobart-QF-Dayana_Yastremska-Belinda_Bencic,2,F-IO,7,0,0,0,0,4,3
20190110-W-Hobart-QF-Dayana_Yastremska-Belinda_Bencic,2,B-XC,14,3,0,1,2,4,10
20190110-W-Hobart-QF-Dayana_Yastremska-Belinda_Bencic,2,B-DTM,21,1,0,0,1,10,11
20190110-W-Hobart-QF-Dayana_Yastremska-Belinda_Bencic,2,B-DTL,5,0,0,0,0,1,4
20190110-W-Hobart-QF-Dayana_Yastremska-Belinda_Bencic,2,B-IO,6,2,1,1,0,4,2
20190110-W-Hobart-QF-Dayana_Yastremska-Belinda_Bencic,2,S-DTM,1,0,0,0,0,0,1
20190108-W-Australian_Open-Q1-Iga_Swiatek-Olga_Danilovic,1,F-XC,34,12,6,3,3,24,10
20190108-W-Australian_Open-Q1-Iga_Swiatek-Olga_Danilovic,1,F-DTM,14,1,0,0,1,6,8
20190108-W-Australian_Open-Q1-Iga_Swiatek-Olga_Danilovic,1,F-DTL,14,8,3,4,1,12,2
20190108-W-Australian_Open-Q1-Iga_Swiatek-Olga_Danilovic,1,F-IO,14,9,3,4,2,9,5
20190108-W-Australian_Open-Q1-Iga_Swiatek-Olga_Danilovic,1,B-XC,27,11,2,0,9,11,16
20190108-W-Australian_Open-Q1-Iga_Swiatek-Olga_Danilovic,1,B-DTM,14,4,0,0,4,3,11
20190108-W-Australian_Open-Q1-Iga_Swiatek-Olga_Danilovic,1,B-DTL,16,10,1,0,9,6,10
20190108-W-Australian_Open-Q1-Iga_Swiatek-Olga_Danilovic,1,B-IO,3,0,0,0,0,1,2
20190108-W-Australian_Open-Q1-Iga_Swiatek-Olga_Danilovic,1,S-DTM,2,0,0,0,0,1,1
20190108-W-Australian_Open-Q1-Iga_Swiatek-Olga_Danilovic,1,S-DTL,3,0,0,0,0,0,3
20190108-W-Australian_Open-Q1-Iga_Swiatek-Olga_Danilovic,2,F-XC,42,15,2,3,10,23,19
20190108-W-Australian_Open-Q1-Iga_Swiatek-Olga_Danilovic,2,F-DTM,17,1,0,0,1,9,8
20190108-W-Australian_Open-Q1-Iga_Swiatek-Olga_Danilovic,2,F-DTL,8,5,1,0,4,1,7
20190108-W-Australian_Open-Q1-Iga_Swiatek-Olga_Danilovic,2,F-IO,3,3,3,0,0,3,0
20190108-W-Australian_Open-Q1-Iga_Swiatek-Olga_Danilovic,2,F-II,4,2,1,1,0,2,2
20190108-W-Australian_Open-Q1-Iga_Swiatek-Olga_Danilovic,2,B-XC,22,5,1,1,3,6,16
20190108-W-Australian_Open-Q1-Iga_Swiatek-Olga_Danilovic,2,B-DTM,16,2,1,0,1,7,9
20190108-W-Australian_Open-Q1-Iga_Swiatek-Olga_Danilovic,2,B-DTL,7,5,1,2,2,4,3
20190108-W-Australian_Open-Q1-Iga_Swiatek-Olga_Danilovic,2,B-IO,7,2,0,0,2,3,4
20190108-W-Australian_Open-Q1-Iga_Swiatek-Olga_Danilovic,2,S-XC,2,0,0,0,0,1,1
20190108-W-Australian_Open-Q1-Iga_Swiatek-Olga_Danilovic,2,S-DTM,2,0,0,0,0,0,2
20190108-W-Australian_Open-Q1-Iga_Swiatek-Olga_Danilovic,2,S-DTL,3,1,0,0,1,2,1
20190111-W-Hobart-SF-Alize_Cornet-Sofia_Kenin,1,F-XC,21,5,2,2,1,13,8
20190111-W-Hobart-SF-Alize_Cornet-Sofia_Kenin,1,F-DTM,10,0,0,0,0,5,5
20190111-W-Hobart-SF-Alize_Cornet-Sofia_Kenin,1,F-DTL,4,1,0,0,1,1,3
20190111-W-Hobart-SF-Alize_Cornet-Sofia_Kenin,1,F-IO,9,1,1,0,0,3,6
20190111-W-Hobart-SF-Alize_Cornet-Sofia_Kenin,1,F-II,1,0,0,0,0,1,0
20190111-W-Hobart-SF-Alize_Cornet-Sofia_Kenin,1,B-XC,20,1,0,0,1,8,12
20190111-W-Hobart-SF-Alize_Cornet-Sofia_Kenin,1,B-DTM,24,2,0,0,2,13,11
20190111-W-Hobart-SF-Alize_Cornet-Sofia_Kenin,1,B-DTL,5,4,4,0,0,4,1
20190111-W-Hobart-SF-Alize_Cornet-Sofia_Kenin,1,B-IO,3,0,0,0,0,1,2
20190111-W-Hobart-SF-Alize_Cornet-Sofia_Kenin,1,S-XC,3,1,0,0,1,1,2
20190111-W-Hobart-SF-Alize_Cornet-Sofia_Kenin,1,S-DTM,4,0,0,0,0,1,3
20190111-W-Hobart-SF-Alize_Cornet-Sofia_Kenin,1,S-DTL,2,2,0,0,2,0,2
20190111-W-Hobart-SF-Alize_Cornet-Sofia_Kenin,2,F-XC,23,10,4,1,5,13,10
20190111-W-Hobart-SF-Alize_Cornet-Sofia_Kenin,2,F-DTM,14,4,0,0,4,4,10
20190111-W-Hobart-SF-Alize_Cornet-Sofia_Kenin,2,F-DTL,4,3,1,0,2,1,3
20190111-W-Hobart-SF-Alize_Cornet-Sofia_Kenin,2,F-IO,10,4,1,1,2,7,3
20190111-W-Hobart-SF-Alize_Cornet-Sofia_Kenin,2,F-II,2,1,1,0,0,2,0
20190111-W-Hobart-SF-Alize_Cornet-Sofia_Kenin,2,B-XC,32,14,2,6,6,20,12
20190111-W-Hobart-SF-Alize_Cornet-Sofia_Kenin,2,B-DTM,28,4,0,0,4,17,11
20190111-W-Hobart-SF-Alize_Cornet-Sofia_Kenin,2,B-DTL,4,3,2,0,1,3,1
20190111-W-Hobart-SF-Alize_Cornet-Sofia_Kenin,2,B-IO,1,1,1,0,0,1,0
20190111-W-Hobart-SF-Alize_Cornet-Sofia_Kenin,2,S-XC,12,2,0,0,2,4,8
20190111-W-Hobart-SF-Alize_Cornet-Sofia_Kenin,2,S-DTM,6,0,0,0,0,3,3
20190107-W-Hobart-R32-Ana_Bogdan-Ons_Jabeur,1,F-XC,43,12,5,3,4,21,22
20190107-W-Hobart-R32-Ana_Bogdan-Ons_Jabeur,1,F-DTM,29,3,0,0,3,14,15
20190107-W-Hobart-R32-Ana_Bogdan-Ons_Jabeur,1,F-DTL,7,2,1,0,1,4,3
20190107-W-Hobart-R32-Ana_Bogdan-Ons_Jabeur,1,F-IO,6,1,0,0,1,3,3
20190107-W-Hobart-R32-Ana_Bogdan-Ons_Jabeur,1,B-XC,51,11,4,1,6,28,23
20190107-W-Hobart-R32-Ana_Bogdan-Ons_Jabeur,1,B-DTM,32,2,0,1,1,16,16
20190107-W-Hobart-R32-Ana_Bogdan-Ons_Jabeur,1,B-DTL,2,1,0,0,1,0,2
20190107-W-Hobart-R32-Ana_Bogdan-Ons_Jabeur,1,B-IO,2,2,1,0,1,1,1
20190107-W-Hobart-R32-Ana_Bogdan-Ons_Jabeur,1,S-XC,5,2,0,0,2,1,4
20190107-W-Hobart-R32-Ana_Bogdan-Ons_Jabeur,1,S-DTM,1,0,0,0,0,1,0
20190107-W-Hobart-R32-Ana_Bogdan-Ons_Jabeur,1,S-DTL,3,3,1,0,2,1,2
20190107-W-Hobart-R32-Ana_Bogdan-Ons_Jabeur,2,F-XC,46,16,3,8,5,26,20
20190107-W-Hobart-R32-Ana_Bogdan-Ons_Jabeur,2,F-DTM,11,0,0,0,0,8,3
20190107-W-Hobart-R32-Ana_Bogdan-Ons_Jabeur,2,F-DTL,16,10,3,4,3,10,6
20190107-W-Hobart-R32-Ana_Bogdan-Ons_Jabeur,2,F-IO,18,8,2,2,4,8,10
20190107-W-Hobart-R32-Ana_Bogdan-Ons_Jabeur,2,F-II,3,1,0,1,0,2,1
20190107-W-Hobart-R32-Ana_Bogdan-Ons_Jabeur,2,B-XC,30,10,1,4,5,13,17
20190107-W-Hobart-R32-Ana_Bogdan-Ons_Jabeur,2,B-DTM,17,2,0,0,2,7,10
20190107-W-Hobart-R32-Ana_Bogdan-Ons_Jabeur,2,B-DTL,8,6,0,3,3,3,5
20190107-W-Hobart-R32-Ana_Bogdan-Ons_Jabeur,2,B-IO,3,0,0,0,0,2,1
20190107-W-Hobart-R32-Ana_Bogdan-Ons_Jabeur,2,S-XC,12,1,0,0,1,7,5
20190107-W-Hobart-R32-Ana_Bogdan-Ons_Jabeur,2,S-DTM,8,2,1,0,1,3,5
20190107-W-Hobart-R32-Ana_Bogdan-Ons_Jabeur,2,S-DTL,7,1,0,0,1,2,5
20190107-W-Hobart-R32-Ana_Bogdan-Ons_Jabeur,2,S-IO,1,1,0,0,1,0,1
20190111-W-Sydney-SF-Ashleigh_Barty-Kiki_Bertens,1,F-XC,56,17,6,7,4,38,18
20190111-W-Sydney-SF-Ashleigh_Barty-Kiki_Bertens,1,F-DTM,18,0,0,0,0,8,10
20190111-W-Sydney-SF-Ashleigh_Barty-Kiki_Bertens,1,F-DTL,12,6,3,0,3,5,7
20190111-W-Sydney-SF-Ashleigh_Barty-Kiki_Bertens,1,F-IO,33,7,2,4,1,24,9
20190111-W-Sydney-SF-Ashleigh_Barty-Kiki_Bertens,1,F-II,5,1,1,0,0,4,1
20190111-W-Sydney-SF-Ashleigh_Barty-Kiki_Bertens,1,B-XC,15,1,0,0,1,6,9
20190111-W-Sydney-SF-Ashleigh_Barty-Kiki_Bertens,1,B-DTM,23,2,0,0,2,10,13
20190111-W-Sydney-SF-Ashleigh_Barty-Kiki_Bertens,1,B-DTL,3,1,0,1,0,2,1
20190111-W-Sydney-SF-Ashleigh_Barty-Kiki_Bertens,1,B-IO,1,0,0,0,0,0,1
20190111-W-Sydney-SF-Ashleigh_Barty-Kiki_Bertens,1,S-XC,40,8,0,0,8,14,26
20190111-W-Sydney-SF-Ashleigh_Barty-Kiki_Bertens,1,S-DTM,17,1,0,0,1,5,12
20190111-W-Sydney-SF-Ashleigh_Barty-Kiki_Bertens,1,S-DTL,10,2,1,0,1,6,4
20190111-W-Sydney-SF-Ashleigh_Barty-Kiki_Bertens,1,S-IO,3,1,0,0,1,2,1
20190111-W-Sydney-SF-Ashleigh_Barty-Kiki_Bertens,2,F-XC,56,15,5,4,6,27,29
20190111-W-Sydney-SF-Ashleigh_Barty-Kiki_Bertens,2,F-DTM,18,3,0,0,3,6,12
20190111-W-Sydney-SF-Ashleigh_Barty-Kiki_Bertens,2,F-DTL,17,7,1,1,5,4,13
20190111-W-Sydney-SF-Ashleigh_Barty-Kiki_Bertens,2,F-IO,46,17,8,2,7,33,13
20190111-W-Sydney-SF-Ashleigh_Barty-Kiki_Bertens,2,F-II,2,0,0,0,0,1,1
20190111-W-Sydney-SF-Ashleigh_Barty-Kiki_Bertens,2,B-XC,45,9,3,2,4,22,23
20190111-W-Sydney-SF-Ashleigh_Barty-Kiki_Bertens,2,B-DTM,26,4,0,0,4,10,16
20190111-W-Sydney-SF-Ashleigh_Barty-Kiki_Bertens,2,B-DTL,9,3,1,1,1,4,5
20190111-W-Sydney-SF-Ashleigh_Barty-Kiki_Bertens,2,B-IO,3,1,0,1,0,3,0
20190111-W-Sydney-SF-Ashleigh_Barty-Kiki_Bertens,2,S-XC,10,3,0,2,1,7,3
20190111-W-Sydney-SF-Ashleigh_Barty-Kiki_Bertens,2,S-DTM,3,0,0,0,0,0,3
20190111-W-Sydney-SF-Ashleigh_Barty-Kiki_Bertens,2,S-DTL,3,1,0,0,1,0,3
20190111-W-Sydney-SF-Petra_Kvitova-Aliaksandra_Sasnovich,1,F-XC,10,3,0,0,3,4,6
20190111-W-Sydney-SF-Petra_Kvitova-Aliaksandra_Sasnovich,1,F-DTM,9,2,1,0,1,5,4
20190111-W-Sydney-SF-Petra_Kvitova-Aliaksandra_Sasnovich,1,F-DTL,3,1,1,0,0,2,1
20190111-W-Sydney-SF-Petra_Kvitova-Aliaksandra_Sasnovich,1,F-IO,8,5,2,2,1,6,2
20190111-W-Sydney-SF-Petra_Kvitova-Aliaksandra_Sasnovich,1,B-XC,11,8,6,2,0,10,1
20190111-W-Sydney-SF-Petra_Kvitova-Aliaksandra_Sasnovich,1,B-DTM,7,1,0,0,1,4,3
20190111-W-Sydney-SF-Petra_Kvitova-Aliaksandra_Sasnovich,1,B-DTL,5,4,2,0,2,3,2
20190111-W-Sydney-SF-Petra_Kvitova-Aliaksandra_Sasnovich,1,B-IO,2,1,1,0,0,2,0
20190111-W-Sydney-SF-Petra_Kvitova-Aliaksandra_Sasnovich,1,S-DTM,1,0,0,0,0,0,1
20190111-W-Sydney-SF-Petra_Kvitova-Aliaksandra_Sasnovich,1,S-DTL,1,0,0,0,0,1,0
20190111-W-Sydney-SF-Petra_Kvitova-Aliaksandra_Sasnovich,2,F-XC,14,3,0,0,3,3,11
20190111-W-Sydney-SF-Petra_Kvitova-Aliaksandra_Sasnovich,2,F-DTM,5,0,0,0,0,4,1
20190111-W-Sydney-SF-Petra_Kvitova-Aliaksandra_Sasnovich,2,F-DTL,3,2,0,0,2,0,3
20190111-W-Sydney-SF-Petra_Kvitova-Aliaksandra_Sasnovich,2,F-IO,5,1,1,0,0,3,2
20190111-W-Sydney-SF-Petra_Kvitova-Aliaksandra_Sasnovich,2,F-II,1,0,0,0,0,0,1
20190111-W-Sydney-SF-Petra_Kvitova-Aliaksandra_Sasnovich,2,B-XC,10,5,2,1,2,6,4
20190111-W-Sydney-SF-Petra_Kvitova-Aliaksandra_Sasnovich,2,B-DTM,5,1,0,0,1,0,5
20190111-W-Sydney-SF-Petra_Kvitova-Aliaksandra_Sasnovich,2,B-DTL,2,1,0,0,1,0,2
20190111-W-Sydney-SF-Petra_Kvitova-Aliaksandra_Sasnovich,2,B-IO,4,2,2,0,0,2,2
20190111-W-Sydney-SF-Petra_Kvitova-Aliaksandra_Sasnovich,2,S-DTL,2,0,0,0,0,0,2
20190114-W-Australian_Open-R128-Beatriz_Haddad_Maia-Bernarda_Pera,1,F-XC,71,15,6,5,4,37,34
20190114-W-Australian_Open-R128-Beatriz_Haddad_Maia-Bernarda_Pera,1,F-DTM,39,6,0,1,5,21,18
20190114-W-Australian_Open-R128-Beatriz_Haddad_Maia-Bernarda_Pera,1,F-DTL,15,9,4,3,2,11,4
20190114-W-Australian_Open-R128-Beatriz_Haddad_Maia-Bernarda_Pera,1,F-IO,10,5,2,0,3,7,3
20190114-W-Australian_Open-R128-Beatriz_Haddad_Maia-Bernarda_Pera,1,F-II,1,0,0,0,0,1,0
20190114-W-Australian_Open-R128-Beatriz_Haddad_Maia-Bernarda_Pera,1,B-XC,52,13,1,3,9,24,28
20190114-W-Australian_Open-R128-Beatriz_Haddad_Maia-Bernarda_Pera,1,B-DTM,27,7,0,0,6,11,16
20190114-W-Australian_Open-R128-Beatriz_Haddad_Maia-Bernarda_Pera,1,B-IO,3,2,0,1,1,1,2
20190114-W-Australian_Open-R128-Beatriz_Haddad_Maia-Bernarda_Pera,1,S-XC,1,0,0,0,0,1,0
20190114-W-Australian_Open-R128-Beatriz_Haddad_Maia-Bernarda_Pera,1,S-DTM,4,0,0,0,0,0,4
20190114-W-Australian_Open-R128-Beatriz_Haddad_Maia-Bernarda_Pera,1,S-DTL,1,0,0,0,0,0,1
20190114-W-Australian_Open-R128-Beatriz_Haddad_Maia-Bernarda_Pera,2,F-XC,51,15,4,3,8,26,25
20190114-W-Australian_Open-R128-Beatriz_Haddad_Maia-Bernarda_Pera,2,F-DTM,42,5,1,0,4,20,22
20190114-W-Australian_Open-R128-Beatriz_Haddad_Maia-Bernarda_Pera,2,F-DTL,31,13,4,2,7,17,14
20190114-W-Australian_Open-R128-Beatriz_Haddad_Maia-Bernarda_Pera,2,F-IO,15,8,0,3,5,8,7
20190114-W-Australian_Open-R128-Beatriz_Haddad_Maia-Bernarda_Pera,2,F-II,1,0,0,0,0,0,1
20190114-W-Australian_Open-R128-Beatriz_Haddad_Maia-Bernarda_Pera,2,B-XC,33,7,1,0,6,14,19
20190114-W-Australian_Open-R128-Beatriz_Haddad_Maia-Bernarda_Pera,2,B-DTM,38,4,0,0,4,18,20
20190114-W-Australian_Open-R128-Beatriz_Haddad_Maia-Bernarda_Pera,2,B-DTL,7,2,1,0,1,3,4
20190114-W-Australian_Open-R128-Beatriz_Haddad_Maia-Bernarda_Pera,2,B-IO,4,1,1,0,0,3,1
20190114-W-Australian_Open-R128-Beatriz_Haddad_Maia-Bernarda_Pera,2,S-DTM,5,0,0,0,0,1,4
20190114-W-Australian_Open-R128-Beatriz_Haddad_Maia-Bernarda_Pera,2,S-DTL,4,0,0,0,0,2,2
20190114-W-Australian_Open-R128-Beatriz_Haddad_Maia-Bernarda_Pera,2,S-IO,2,0,0,0,0,1,1
20190115-W-Australian_Open-R128-Viktoria_Kuzmova-Kateryna_Kozlova,1,F-XC,65,15,6,4,5,33,32
20190115-W-Australian_Open-R128-Viktoria_Kuzmova-Kateryna_Kozlova,1,F-DTM,18,0,0,0,0,8,10
20190115-W-Australian_Open-R128-Viktoria_Kuzmova-Kateryna_Kozlova,1,F-DTL,19,13,4,4,5,13,6
20190115-W-Australian_Open-R128-Viktoria_Kuzmova-Kateryna_Kozlova,1,F-IO,26,13,8,2,3,19,7
20190115-W-Australian_Open-R128-Viktoria_Kuzmova-Kateryna_Kozlova,1,F-II,2,1,0,1,0,1,1
20190115-W-Australian_Open-R128-Viktoria_Kuzmova-Kateryna_Kozlova,1,B-XC,71,16,5,4,7,43,28
20190115-W-Australian_Open-R128-Viktoria_Kuzmova-Kateryna_Kozlova,1,B-DTM,35,4,0,0,4,12,23
20190115-W-Australian_Open-R128-Viktoria_Kuzmova-Kateryna_Kozlova,1,B-DTL,12,7,3,0,4,5,7
20190115-W-Australian_Open-R128-Viktoria_Kuzmova-Kateryna_Kozlova,1,B-IO,17,8,3,1,4,10,7
20190115-W-Australian_Open-R128-Viktoria_Kuzmova-Kateryna_Kozlova,1,S-XC,2,1,0,0,1,0,2
20190115-W-Australian_Open-R128-Viktoria_Kuzmova-Kateryna_Kozlova,1,S-DTM,5,0,0,0,0,0,5
20190115-W-Australian_Open-R128-Viktoria_Kuzmova-Kateryna_Kozlova,1,S-IO,2,0,0,0,0,0,2
20190115-W-Australian_Open-R128-Viktoria_Kuzmova-Kateryna_Kozlova,2,F-XC,47,11,3,5,3,26,21
20190115-W-Australian_Open-R128-Viktoria_Kuzmova-Kateryna_Kozlova,2,F-DTM,33,3,0,0,3,14,19
20190115-W-Australian_Open-R128-Viktoria_Kuzmova-Kateryna_Kozlova,2,F-DTL,20,6,2,2,2,13,7
20190115-W-Australian_Open-R128-Viktoria_Kuzmova-Kateryna_Kozlova,2,F-IO,29,5,3,1,1,21,8
20190115-W-Australian_Open-R128-Viktoria_Kuzmova-Kateryna_Kozlova,2,F-II,1,0,0,0,0,1,0
20190115-W-Australian_Open-R128-Viktoria_Kuzmova-Kateryna_Kozlova,2,B-XC,31,5,0,2,3,17,14
20190115-W-Australian_Open-R128-Viktoria_Kuzmova-Kateryna_Kozlova,2,B-DTM,36,2,0,1,1,17,19
20190115-W-Australian_Open-R128-Viktoria_Kuzmova-Kateryna_Kozlova,2,B-DTL,8,3,1,1,1,4,4
20190115-W-Australian_Open-R128-Viktoria_Kuzmova-Kateryna_Kozlova,2,B-IO,4,1,0,0,1,2,2
20190115-W-Australian_Open-R128-Viktoria_Kuzmova-Kateryna_Kozlova,2,S-XC,14,1,1,0,0,5,9
20190115-W-Australian_Open-R128-Viktoria_Kuzmova-Kateryna_Kozlova,2,S-DTM,15,1,1,0,0,4,11
20190115-W-Australian_Open-R128-Viktoria_Kuzmova-Kateryna_Kozlova,2,S-DTL,1,0,0,0,0,0,1
20190116-W-Australian_Open-R64-Marketa_Vondrousova-Petra_Martic,1,F-XC,76,18,2,3,13,34,42
20190116-W-Australian_Open-R64-Marketa_Vondrousova-Petra_Martic,1,F-DTM,24,2,0,1,1,8,16
20190116-W-Australian_Open-R64-Marketa_Vondrousova-Petra_Martic,1,F-DTL,9,5,1,0,4,2,7
20190116-W-Australian_Open-R64-Marketa_Vondrousova-Petra_Martic,1,F-IO,9,4,2,0,2,6,3
20190116-W-Australian_Open-R64-Marketa_Vondrousova-Petra_Martic,1,B-XC,59,9,4,1,4,30,29
20190116-W-Australian_Open-R64-Marketa_Vondrousova-Petra_Martic,1,B-DTM,30,5,0,0,5,11,19
20190116-W-Australian_Open-R64-Marketa_Vondrousova-Petra_Martic,1,B-DTL,5,2,1,0,1,4,1
20190116-W-Australian_Open-R64-Marketa_Vondrousova-Petra_Martic,1,B-IO,5,1,1,0,0,2,3
20190116-W-Australian_Open-R64-Marketa_Vondrousova-Petra_Martic,1,S-XC,1,0,0,0,0,0,1
20190116-W-Australian_Open-R64-Marketa_Vondrousova-Petra_Martic,1,S-DTM,7,0,0,0,0,5,2
20190116-W-Australian_Open-R64-Marketa_Vondrousova-Petra_Martic,1,S-DTL,3,0,0,0,0,2,1
20190116-W-Australian_Open-R64-Marketa_Vondrousova-Petra_Martic,1,S-IO,1,0,0,0,0,0,1
20190116-W-Australian_Open-R64-Marketa_Vondrousova-Petra_Martic,2,F-XC,50,7,1,1,5,20,30
20190116-W-Australian_Open-R64-Marketa_Vondrousova-Petra_Martic,2,F-DTM,37,1,0,0,1,23,14
20190116-W-Australian_Open-R64-Marketa_Vondrousova-Petra_Martic,2,F-DTL,20,5,3,0,2,12,8
20190116-W-Australian_Open-R64-Marketa_Vondrousova-Petra_Martic,2,F-IO,26,11,2,4,5,13,13
20190116-W-Australian_Open-R64-Marketa_Vondrousova-Petra_Martic,2,F-II,1,1,0,0,1,0,1
20190116-W-Australian_Open-R64-Marketa_Vondrousova-Petra_Martic,2,B-XC,24,4,1,0,3,12,12
20190116-W-Australian_Open-R64-Marketa_Vondrousova-Petra_Martic,2,B-DTM,26,3,1,1,1,16,10
20190116-W-Australian_Open-R64-Marketa_Vondrousova-Petra_Martic,2,B-DTL,4,1,0,1,0,2,2
20190116-W-Australian_Open-R64-Marketa_Vondrousova-Petra_Martic,2,B-IO,2,1,1,0,0,2,0
20190116-W-Australian_Open-R64-Marketa_Vondrousova-Petra_Martic,2,S-XC,6,1,0,0,1,1,5
20190116-W-Australian_Open-R64-Marketa_Vondrousova-Petra_Martic,2,S-DTM,17,0,0,0,0,10,7
20190116-W-Australian_Open-R64-Marketa_Vondrousova-Petra_Martic,2,S-DTL,9,2,0,1,1,4,5
20190116-W-Australian_Open-R64-Marketa_Vondrousova-Petra_Martic,2,S-IO,4,0,0,0,0,2,2
20190117-W-Australian_Open-R64-Camila_Giorgi-Iga_Swiatek,1,F-XC,15,4,0,2,2,11,4
20190117-W-Australian_Open-R64-Camila_Giorgi-Iga_Swiatek,1,F-DTM,10,2,0,1,1,6,4
20190117-W-Australian_Open-R64-Camila_Giorgi-Iga_Swiatek,1,F-DTL,3,3,3,0,0,3,0
20190117-W-Australian_Open-R64-Camila_Giorgi-Iga_Swiatek,1,F-IO,2,2,0,0,2,0,2
20190117-W-Australian_Open-R64-Camila_Giorgi-Iga_Swiatek,1,B-XC,13,2,0,2,0,11,2
20190117-W-Australian_Open-R64-Camila_Giorgi-Iga_Swiatek,1,B-DTM,5,1,0,0,1,2,3
20190117-W-Australian_Open-R64-Camila_Giorgi-Iga_Swiatek,1,B-DTL,2,2,1,1,0,2,0
20190117-W-Australian_Open-R64-Camila_Giorgi-Iga_Swiatek,2,F-XC,12,4,1,0,3,3,9
20190117-W-Australian_Open-R64-Camila_Giorgi-Iga_Swiatek,2,F-DTM,5,0,0,0,0,3,2
20190117-W-Australian_Open-R64-Camila_Giorgi-Iga_Swiatek,2,F-DTL,2,0,0,0,0,0,2
20190117-W-Australian_Open-R64-Camila_Giorgi-Iga_Swiatek,2,F-IO,4,3,0,1,2,2,2
20190117-W-Australian_Open-R64-Camila_Giorgi-Iga_Swiatek,2,B-XC,12,4,2,0,2,4,8
20190117-W-Australian_Open-R64-Camila_Giorgi-Iga_Swiatek,2,B-DTM,6,0,0,0,0,0,6
20190117-W-Australian_Open-R64-Camila_Giorgi-Iga_Swiatek,2,B-DTL,6,3,1,0,2,2,4
20190117-W-Australian_Open-R64-Camila_Giorgi-Iga_Swiatek,2,B-IO,5,2,0,0,2,1,4
20190117-W-Australian_Open-R64-Camila_Giorgi-Iga_Swiatek,2,S-DTM,1,0,0,0,0,1,0
20190117-W-Australian_Open-R64-Camila_Giorgi-Iga_Swiatek,2,S-DTL,2,0,0,0,0,0,2
20190117-W-Australian_Open-R64-Madison_Keys-Anastasia_Potapova,1,F-XC,30,3,1,0,2,10,20
20190117-W-Australian_Open-R64-Madison_Keys-Anastasia_Potapova,1,F-DTM,16,4,0,0,4,6,10
20190117-W-Australian_Open-R64-Madison_Keys-Anastasia_Potapova,1,F-DTL,9,8,3,0,5,3,6
20190117-W-Australian_Open-R64-Madison_Keys-Anastasia_Potapova,1,F-IO,9,4,1,2,1,6,3
20190117-W-Australian_Open-R64-Madison_Keys-Anastasia_Potapova,1,B-XC,11,6,4,0,2,6,5
20190117-W-Australian_Open-R64-Madison_Keys-Anastasia_Potapova,1,B-DTM,15,1,1,0,0,9,6
20190117-W-Australian_Open-R64-Madison_Keys-Anastasia_Potapova,1,B-DTL,11,6,3,0,3,5,6
20190117-W-Australian_Open-R64-Madison_Keys-Anastasia_Potapova,1,B-IO,4,1,0,1,0,2,2
20190117-W-Australian_Open-R64-Madison_Keys-Anastasia_Potapova,1,S-XC,2,0,0,0,0,1,1
20190117-W-Australian_Open-R64-Madison_Keys-Anastasia_Potapova,1,S-DTM,5,0,0,0,0,1,4
20190117-W-Australian_Open-R64-Madison_Keys-Anastasia_Potapova,1,S-IO,1,0,0,0,0,1,0
20190117-W-Australian_Open-R64-Madison_Keys-Anastasia_Potapova,2,F-XC,28,8,1,3,4,18,10
20190117-W-Australian_Open-R64-Madison_Keys-Anastasia_Potapova,2,F-DTM,21,1,0,0,1,5,16
20190117-W-Australian_Open-R64-Madison_Keys-Anastasia_Potapova,2,F-DTL,14,6,5,1,0,10,4
20190117-W-Australian_Open-R64-Madison_Keys-Anastasia_Potapova,2,F-IO,11,4,2,0,2,4,7
20190117-W-Australian_Open-R64-Madison_Keys-Anastasia_Potapova,2,B-XC,12,2,0,1,1,10,2
20190117-W-Australian_Open-R64-Madison_Keys-Anastasia_Potapova,2,B-DTM,14,1,0,0,1,7,7
20190117-W-Australian_Open-R64-Madison_Keys-Anastasia_Potapova,2,B-DTL,6,6,2,2,2,4,2
20190117-W-Australian_Open-R64-Madison_Keys-Anastasia_Potapova,2,B-IO,2,2,1,0,1,1,1
20181214-W-ITF_Dubai-SF-Evgeniya_Rodina-Viktoria_Kuzmova,1,F-XC,17,2,0,0,2,7,10
20181214-W-ITF_Dubai-SF-Evgeniya_Rodina-Viktoria_Kuzmova,1,F-DTM,13,2,0,0,2,3,10
20181214-W-ITF_Dubai-SF-Evgeniya_Rodina-Viktoria_Kuzmova,1,F-DTL,5,4,3,0,1,4,1
20181214-W-ITF_Dubai-SF-Evgeniya_Rodina-Viktoria_Kuzmova,1,B-XC,14,0,0,0,0,6,8
20181214-W-ITF_Dubai-SF-Evgeniya_Rodina-Viktoria_Kuzmova,1,B-DTM,18,0,0,0,0,7,11
20181214-W-ITF_Dubai-SF-Evgeniya_Rodina-Viktoria_Kuzmova,1,B-DTL,4,2,0,0,2,1,3
20181214-W-ITF_Dubai-SF-Evgeniya_Rodina-Viktoria_Kuzmova,1,B-IO,1,0,0,0,0,1,0
20181214-W-ITF_Dubai-SF-Evgeniya_Rodina-Viktoria_Kuzmova,1,S-XC,1,0,0,0,0,0,1
20181214-W-ITF_Dubai-SF-Evgeniya_Rodina-Viktoria_Kuzmova,1,S-DTM,2,0,0,0,0,1,1
20181214-W-ITF_Dubai-SF-Evgeniya_Rodina-Viktoria_Kuzmova,1,S-IO,1,0,0,0,0,0,1
20181214-W-ITF_Dubai-SF-Evgeniya_Rodina-Viktoria_Kuzmova,2,F-XC,28,11,5,1,5,15,13
20181214-W-ITF_Dubai-SF-Evgeniya_Rodina-Viktoria_Kuzmova,2,F-DTM,4,0,0,0,0,4,0
20181214-W-ITF_Dubai-SF-Evgeniya_Rodina-Viktoria_Kuzmova,2,F-DTL,8,4,1,2,1,6,2
20181214-W-ITF_Dubai-SF-Evgeniya_Rodina-Viktoria_Kuzmova,2,F-IO,11,5,2,1,2,8,3
20181214-W-ITF_Dubai-SF-Evgeniya_Rodina-Viktoria_Kuzmova,2,B-XC,12,2,1,0,1,7,5
20181214-W-ITF_Dubai-SF-Evgeniya_Rodina-Viktoria_Kuzmova,2,B-DTM,9,2,0,1,1,4,5
20181214-W-ITF_Dubai-SF-Evgeniya_Rodina-Viktoria_Kuzmova,2,B-DTL,4,3,1,1,1,2,2
20181214-W-ITF_Dubai-SF-Evgeniya_Rodina-Viktoria_Kuzmova,2,B-IO,3,3,2,0,1,2,1
20181214-W-ITF_Dubai-SF-Evgeniya_Rodina-Viktoria_Kuzmova,2,S-XC,1,0,0,0,0,0,1
20181214-W-ITF_Dubai-SF-Evgeniya_Rodina-Viktoria_Kuzmova,2,S-IO,2,1,0,0,1,1,1
20190118-W-Australian_Open-R32-Aryna_Sabalenka-Amanda_Anisimova,1,F-XC,14,4,3,0,1,5,9
20190118-W-Australian_Open-R32-Aryna_Sabalenka-Amanda_Anisimova,1,F-DTM,7,1,0,0,1,1,6
20190118-W-Australian_Open-R32-Aryna_Sabalenka-Amanda_Anisimova,1,F-DTL,12,6,1,1,4,5,7
20190118-W-Australian_Open-R32-Aryna_Sabalenka-Amanda_Anisimova,1,F-IO,7,1,0,0,1,1,6
20190118-W-Australian_Open-R32-Aryna_Sabalenka-Amanda_Anisimova,1,F-II,1,1,1,0,0,1,0
20190118-W-Australian_Open-R32-Aryna_Sabalenka-Amanda_Anisimova,1,B-XC,20,7,1,2,4,7,13
20190118-W-Australian_Open-R32-Aryna_Sabalenka-Amanda_Anisimova,1,B-DTM,6,0,0,0,0,2,4
20190118-W-Australian_Open-R32-Aryna_Sabalenka-Amanda_Anisimova,1,B-DTL,5,1,1,0,0,1,4
20190118-W-Australian_Open-R32-Aryna_Sabalenka-Amanda_Anisimova,1,B-IO,1,1,0,0,1,0,1
20190118-W-Australian_Open-R32-Aryna_Sabalenka-Amanda_Anisimova,1,S-DTM,1,0,0,0,0,0,1
20190118-W-Australian_Open-R32-Aryna_Sabalenka-Amanda_Anisimova,2,F-XC,20,9,2,4,3,14,6
20190118-W-Australian_Open-R32-Aryna_Sabalenka-Amanda_Anisimova,2,F-DTM,5,0,0,0,0,4,1
20190118-W-Australian_Open-R32-Aryna_Sabalenka-Amanda_Anisimova,2,F-DTL,5,2,2,0,0,5,0
20190118-W-Australian_Open-R32-Aryna_Sabalenka-Amanda_Anisimova,2,F-IO,6,4,1,2,1,5,1
20190118-W-Australian_Open-R32-Aryna_Sabalenka-Amanda_Anisimova,2,F-II,1,1,1,0,0,1,0
20190118-W-Australian_Open-R32-Aryna_Sabalenka-Amanda_Anisimova,2,B-XC,21,7,2,3,2,13,8
20190118-W-Australian_Open-R32-Aryna_Sabalenka-Amanda_Anisimova,2,B-DTM,13,4,0,2,2,9,4
20190118-W-Australian_Open-R32-Aryna_Sabalenka-Amanda_Anisimova,2,B-DTL,6,4,2,2,0,5,1
20190118-W-Australian_Open-R32-Aryna_Sabalenka-Amanda_Anisimova,2,B-IO,3,2,0,1,1,2,1
20190118-W-Australian_Open-R32-Aryna_Sabalenka-Amanda_Anisimova,2,S-XC,2,0,0,0,0,0,2
20190118-W-Australian_Open-R32-Aryna_Sabalenka-Amanda_Anisimova,2,S-DTM,1,0,0,0,0,0,1
20190118-W-Australian_Open-R32-Aryna_Sabalenka-Amanda_Anisimova,2,S-DTL,1,0,0,0,0,1,0
20050701-W-Wimbledon-SF-Amelie_Mauresmo-Lindsay_Davenport,1,F-XC,40,13,6,1,6,24,16
20050701-W-Wimbledon-SF-Amelie_Mauresmo-Lindsay_Davenport,1,F-DTM,16,2,0,0,2,7,9
20050701-W-Wimbledon-SF-Amelie_Mauresmo-Lindsay_Davenport,1,F-DTL,18,3,0,1,2,9,9
20050701-W-Wimbledon-SF-Amelie_Mauresmo-Lindsay_Davenport,1,F-IO,5,0,0,0,0,3,2
20050701-W-Wimbledon-SF-Amelie_Mauresmo-Lindsay_Davenport,1,B-XC,20,9,4,2,3,11,9
20050701-W-Wimbledon-SF-Amelie_Mauresmo-Lindsay_Davenport,1,B-DTM,10,1,0,1,0,3,7
20050701-W-Wimbledon-SF-Amelie_Mauresmo-Lindsay_Davenport,1,B-DTL,4,1,0,0,1,2,2
20050701-W-Wimbledon-SF-Amelie_Mauresmo-Lindsay_Davenport,1,S-XC,9,0,0,0,0,1,8
20050701-W-Wimbledon-SF-Amelie_Mauresmo-Lindsay_Davenport,1,S-DTM,19,0,0,0,0,9,10
20050701-W-Wimbledon-SF-Amelie_Mauresmo-Lindsay_Davenport,1,S-DTL,6,2,1,0,1,5,1
20050701-W-Wimbledon-SF-Amelie_Mauresmo-Lindsay_Davenport,1,S-IO,2,0,0,0,0,1,1
20050701-W-Wimbledon-SF-Amelie_Mauresmo-Lindsay_Davenport,2,F-XC,54,13,6,1,6,22,32
20050701-W-Wimbledon-SF-Amelie_Mauresmo-Lindsay_Davenport,2,F-DTM,8,0,0,0,0,4,4
20050701-W-Wimbledon-SF-Amelie_Mauresmo-Lindsay_Davenport,2,F-DTL,15,7,3,0,4,7,8
20050701-W-Wimbledon-SF-Amelie_Mauresmo-Lindsay_Davenport,2,F-IO,26,13,2,4,7,13,13
20050701-W-Wimbledon-SF-Amelie_Mauresmo-Lindsay_Davenport,2,B-XC,37,9,3,4,2,21,16
20050701-W-Wimbledon-SF-Amelie_Mauresmo-Lindsay_Davenport,2,B-DTM,7,0,0,0,0,3,4
20050701-W-Wimbledon-SF-Amelie_Mauresmo-Lindsay_Davenport,2,B-DTL,15,4,3,0,1,10,5
20050701-W-Wimbledon-SF-Amelie_Mauresmo-Lindsay_Davenport,2,B-IO,9,2,2,0,0,6,3
20050701-W-Wimbledon-SF-Amelie_Mauresmo-Lindsay_Davenport,2,S-XC,2,0,0,0,0,1,1
20050701-W-Wimbledon-SF-Amelie_Mauresmo-Lindsay_Davenport,2,S-DTM,1,0,0,0,0,0,1
20050701-W-Wimbledon-SF-Amelie_Mauresmo-Lindsay_Davenport,2,S-DTL,1,0,0,0,0,0,1
20190119-W-Australian_Open-R32-Dayana_Yastremska-Serena_Williams,1,F-XC,19,8,4,0,4,7,12
20190119-W-Australian_Open-R32-Dayana_Yastremska-Serena_Williams,1,F-DTM,13,4,0,1,3,6,7
20190119-W-Australian_Open-R32-Dayana_Yastremska-Serena_Williams,1,F-DTL,8,0,0,0,0,2,6
20190119-W-Australian_Open-R32-Dayana_Yastremska-Serena_Williams,1,F-IO,11,6,1,0,5,4,7
20190119-W-Australian_Open-R32-Dayana_Yastremska-Serena_Williams,1,B-XC,10,4,1,0,3,3,7
20190119-W-Australian_Open-R32-Dayana_Yastremska-Serena_Williams,1,B-DTM,14,0,0,0,0,4,10
20190119-W-Australian_Open-R32-Dayana_Yastremska-Serena_Williams,1,B-DTL,10,7,4,0,3,6,4
20190119-W-Australian_Open-R32-Dayana_Yastremska-Serena_Williams,1,B-IO,8,2,1,1,0,5,3
20190119-W-Australian_Open-R32-Dayana_Yastremska-Serena_Williams,1,S-DTM,1,0,0,0,0,0,1
20190119-W-Australian_Open-R32-Dayana_Yastremska-Serena_Williams,2,F-XC,16,5,2,1,2,11,5
20190119-W-Australian_Open-R32-Dayana_Yastremska-Serena_Williams,2,F-DTM,11,0,0,0,0,5,6
20190119-W-Australian_Open-R32-Dayana_Yastremska-Serena_Williams,2,F-DTL,9,2,2,0,0,8,1
20190119-W-Australian_Open-R32-Dayana_Yastremska-Serena_Williams,2,F-IO,7,2,1,1,0,6,1
20190119-W-Australian_Open-R32-Dayana_Yastremska-Serena_Williams,2,B-XC,8,1,0,0,1,3,5
20190119-W-Australian_Open-R32-Dayana_Yastremska-Serena_Williams,2,B-DTM,14,2,0,0,2,9,5
20190119-W-Australian_Open-R32-Dayana_Yastremska-Serena_Williams,2,B-DTL,8,5,0,3,2,4,4
20190119-W-Australian_Open-R32-Dayana_Yastremska-Serena_Williams,2,B-IO,7,3,1,0,2,4,3
20190119-W-Australian_Open-R32-Dayana_Yastremska-Serena_Williams,2,S-XC,1,0,0,0,0,1,0
20190119-W-Australian_Open-R32-Dayana_Yastremska-Serena_Williams,2,S-DTM,1,0,0,0,0,0,1
20190120-W-Australian_Open-R16-Danielle_Collins-Angelique_Kerber,1,F-XC,31,8,5,1,2,17,14
20190120-W-Australian_Open-R16-Danielle_Collins-Angelique_Kerber,1,F-DTM,13,1,0,0,1,7,6
20190120-W-Australian_Open-R16-Danielle_Collins-Angelique_Kerber,1,F-DTL,10,3,1,1,1,7,3
20190120-W-Australian_Open-R16-Danielle_Collins-Angelique_Kerber,1,F-IO,10,1,1,0,0,6,4
20190120-W-Australian_Open-R16-Danielle_Collins-Angelique_Kerber,1,B-XC,33,15,8,2,5,19,14
20190120-W-Australian_Open-R16-Danielle_Collins-Angelique_Kerber,1,B-DTM,8,1,0,0,1,3,5
20190120-W-Australian_Open-R16-Danielle_Collins-Angelique_Kerber,1,B-DTL,10,6,2,0,4,6,4
20190120-W-Australian_Open-R16-Danielle_Collins-Angelique_Kerber,1,B-IO,1,0,0,0,0,1,0
20190120-W-Australian_Open-R16-Danielle_Collins-Angelique_Kerber,2,F-XC,31,6,1,0,5,11,20
20190120-W-Australian_Open-R16-Danielle_Collins-Angelique_Kerber,2,F-DTM,13,0,0,0,0,6,7
20190120-W-Australian_Open-R16-Danielle_Collins-Angelique_Kerber,2,F-DTL,11,3,0,0,3,3,8
20190120-W-Australian_Open-R16-Danielle_Collins-Angelique_Kerber,2,F-IO,8,2,2,0,0,5,3
20190120-W-Australian_Open-R16-Danielle_Collins-Angelique_Kerber,2,B-XC,19,4,0,1,2,10,9
20190120-W-Australian_Open-R16-Danielle_Collins-Angelique_Kerber,2,B-DTM,14,0,0,0,0,4,10
20190120-W-Australian_Open-R16-Danielle_Collins-Angelique_Kerber,2,B-DTL,3,1,0,0,1,1,2
20190120-W-Australian_Open-R16-Danielle_Collins-Angelique_Kerber,2,B-IO,2,1,1,0,0,1,1
20190120-W-Australian_Open-R16-Danielle_Collins-Angelique_Kerber,2,S-XC,1,0,0,0,0,1,0
20190120-W-Australian_Open-R16-Danielle_Collins-Angelique_Kerber,2,S-DTM,3,0,0,0,0,1,2
20190120-W-Australian_Open-R16-Danielle_Collins-Angelique_Kerber,2,S-DTL,3,0,0,0,0,1,2
20190120-W-Australian_Open-R16-Ashleigh_Barty-Maria_Sharapova,1,F-XC,93,15,3,3,9,52,41
20190120-W-Australian_Open-R16-Ashleigh_Barty-Maria_Sharapova,1,F-DTM,23,2,0,1,1,11,12
20190120-W-Australian_Open-R16-Ashleigh_Barty-Maria_Sharapova,1,F-DTL,18,9,1,2,6,10,8
20190120-W-Australian_Open-R16-Ashleigh_Barty-Maria_Sharapova,1,F-IO,24,9,3,1,5,13,11
20190120-W-Australian_Open-R16-Ashleigh_Barty-Maria_Sharapova,1,F-II,7,2,1,0,1,2,5
20190120-W-Australian_Open-R16-Ashleigh_Barty-Maria_Sharapova,1,B-XC,12,2,0,1,1,8,4
20190120-W-Australian_Open-R16-Ashleigh_Barty-Maria_Sharapova,1,B-DTM,17,2,1,0,1,11,6
20190120-W-Australian_Open-R16-Ashleigh_Barty-Maria_Sharapova,1,B-DTL,2,2,0,1,1,1,1
20190120-W-Australian_Open-R16-Ashleigh_Barty-Maria_Sharapova,1,B-IO,3,0,0,0,0,3,0
20190120-W-Australian_Open-R16-Ashleigh_Barty-Maria_Sharapova,1,S-XC,44,7,1,1,5,25,19
20190120-W-Australian_Open-R16-Ashleigh_Barty-Maria_Sharapova,1,S-DTM,29,0,0,0,0,11,18
20190120-W-Australian_Open-R16-Ashleigh_Barty-Maria_Sharapova,1,S-DTL,18,4,1,0,3,10,8
20190120-W-Australian_Open-R16-Ashleigh_Barty-Maria_Sharapova,1,S-IO,4,0,0,0,0,2,2
20190120-W-Australian_Open-R16-Ashleigh_Barty-Maria_Sharapova,2,F-XC,88,15,4,0,11,36,52
20190120-W-Australian_Open-R16-Ashleigh_Barty-Maria_Sharapova,2,F-DTM,28,4,0,0,4,12,16
20190120-W-Australian_Open-R16-Ashleigh_Barty-Maria_Sharapova,2,F-DTL,30,6,0,4,2,15,15
20190120-W-Australian_Open-R16-Ashleigh_Barty-Maria_Sharapova,2,F-IO,27,5,2,1,2,14,13
20190120-W-Australian_Open-R16-Ashleigh_Barty-Maria_Sharapova,2,F-II,2,1,0,1,0,2,0
20190120-W-Australian_Open-R16-Ashleigh_Barty-Maria_Sharapova,2,B-XC,74,13,2,1,10,32,42
20190120-W-Australian_Open-R16-Ashleigh_Barty-Maria_Sharapova,2,B-DTM,24,0,0,0,0,10,14
20190120-W-Australian_Open-R16-Ashleigh_Barty-Maria_Sharapova,2,B-DTL,7,2,1,0,1,4,3
20190120-W-Australian_Open-R16-Ashleigh_Barty-Maria_Sharapova,2,B-IO,7,0,0,0,0,5,2
20190120-W-Australian_Open-R16-Ashleigh_Barty-Maria_Sharapova,2,S-XC,1,0,0,0,0,0,1
20190120-W-Australian_Open-R16-Ashleigh_Barty-Maria_Sharapova,2,S-DTM,1,0,0,0,0,1,0
20190120-W-Australian_Open-R16-Ashleigh_Barty-Maria_Sharapova,2,S-DTL,1,0,0,0,0,0,1
20190120-W-Australian_Open-R16-Ashleigh_Barty-Maria_Sharapova,2,S-IO,1,0,0,0,0,1,0
20190122-W-Australian_Open-QF-Petra_Kvitova-Ashleigh_Barty,1,F-XC,48,15,5,3,7,29,19
20190122-W-Australian_Open-QF-Petra_Kvitova-Ashleigh_Barty,1,F-DTM,9,2,0,0,2,2,7
20190122-W-Australian_Open-QF-Petra_Kvitova-Ashleigh_Barty,1,F-DTL,5,1,0,1,0,2,3
20190122-W-Australian_Open-QF-Petra_Kvitova-Ashleigh_Barty,1,F-IO,7,2,1,0,1,4,3
20190122-W-Australian_Open-QF-Petra_Kvitova-Ashleigh_Barty,1,B-XC,22,8,2,3,3,16,6
20190122-W-Australian_Open-QF-Petra_Kvitova-Ashleigh_Barty,1,B-DTM,16,4,0,1,3,10,6
20190122-W-Australian_Open-QF-Petra_Kvitova-Ashleigh_Barty,1,B-DTL,9,7,4,2,1,7,2
20190122-W-Australian_Open-QF-Petra_Kvitova-Ashleigh_Barty,1,B-IO,6,3,2,1,0,5,1
20190122-W-Australian_Open-QF-Petra_Kvitova-Ashleigh_Barty,1,S-XC,3,0,0,0,0,2,1
20190122-W-Australian_Open-QF-Petra_Kvitova-Ashleigh_Barty,1,S-DTM,1,0,0,0,0,1,0
20190122-W-Australian_Open-QF-Petra_Kvitova-Ashleigh_Barty,1,S-DTL,1,0,0,0,0,0,1
20190122-W-Australian_Open-QF-Petra_Kvitova-Ashleigh_Barty,2,F-XC,33,12,3,2,7,11,22
20190122-W-Australian_Open-QF-Petra_Kvitova-Ashleigh_Barty,2,F-DTM,13,0,0,0,0,3,10
20190122-W-Australian_Open-QF-Petra_Kvitova-Ashleigh_Barty,2,F-DTL,4,2,1,0,1,1,3
20190122-W-Australian_Open-QF-Petra_Kvitova-Ashleigh_Barty,2,F-IO,7,0,0,0,0,5,2
20190122-W-Australian_Open-QF-Petra_Kvitova-Ashleigh_Barty,2,B-XC,10,2,0,1,1,4,6
20190122-W-Australian_Open-QF-Petra_Kvitova-Ashleigh_Barty,2,B-DTM,11,1,0,0,1,4,7
20190122-W-Australian_Open-QF-Petra_Kvitova-Ashleigh_Barty,2,B-DTL,4,2,0,1,1,1,3
20190122-W-Australian_Open-QF-Petra_Kvitova-Ashleigh_Barty,2,S-XC,11,1,0,0,1,5,6
20190122-W-Australian_Open-QF-Petra_Kvitova-Ashleigh_Barty,2,S-DTM,7,1,0,0,1,3,4
20190122-W-Australian_Open-QF-Petra_Kvitova-Ashleigh_Barty,2,S-DTL,5,1,0,1,0,3,2
20190122-W-Australian_Open-QF-Petra_Kvitova-Ashleigh_Barty,2,S-IO,1,0,0,0,0,0,1
19860906-W-US_Open-SF-Steffi_Graf-Martina_Navratilova,1,F-XC,45,8,3,1,4,25,20
19860906-W-US_Open-SF-Steffi_Graf-Martina_Navratilova,1,F-DTM,8,0,0,0,0,4,4
19860906-W-US_Open-SF-Steffi_Graf-Martina_Navratilova,1,F-DTL,8,5,1,3,1,5,3
19860906-W-US_Open-SF-Steffi_Graf-Martina_Navratilova,1,F-IO,31,5,2,2,1,18,13
19860906-W-US_Open-SF-Steffi_Graf-Martina_Navratilova,1,F-II,5,2,1,1,0,4,1
19860906-W-US_Open-SF-Steffi_Graf-Martina_Navratilova,1,B-XC,17,9,2,6,0,10,7
19860906-W-US_Open-SF-Steffi_Graf-Martina_Navratilova,1,B-DTM,15,2,0,2,0,8,7
19860906-W-US_Open-SF-Steffi_Graf-Martina_Navratilova,1,B-DTL,8,5,2,1,2,3,5
19860906-W-US_Open-SF-Steffi_Graf-Martina_Navratilova,1,B-IO,4,3,1,2,0,4,0
19860906-W-US_Open-SF-Steffi_Graf-Martina_Navratilova,1,S-XC,33,4,0,2,2,16,17
19860906-W-US_Open-SF-Steffi_Graf-Martina_Navratilova,1,S-DTM,16,4,0,1,3,6,10
19860906-W-US_Open-SF-Steffi_Graf-Martina_Navratilova,1,S-DTL,14,6,3,2,1,11,3
19860906-W-US_Open-SF-Steffi_Graf-Martina_Navratilova,1,S-IO,3,1,0,0,1,0,3
19860906-W-US_Open-SF-Steffi_Graf-Martina_Navratilova,2,F-XC,54,10,1,3,6,27,27
19860906-W-US_Open-SF-Steffi_Graf-Martina_Navratilova,2,F-DTM,5,2,0,0,2,2,3
19860906-W-US_Open-SF-Steffi_Graf-Martina_Navratilova,2,F-DTL,11,5,0,2,3,4,7
19860906-W-US_Open-SF-Steffi_Graf-Martina_Navratilova,2,F-IO,5,1,0,1,0,3,2
19860906-W-US_Open-SF-Steffi_Graf-Martina_Navratilova,2,F-II,1,0,0,0,0,0,1
19860906-W-US_Open-SF-Steffi_Graf-Martina_Navratilova,2,B-XC,2,1,0,0,1,1,1
19860906-W-US_Open-SF-Steffi_Graf-Martina_Navratilova,2,B-DTM,6,1,0,0,1,1,5
19860906-W-US_Open-SF-Steffi_Graf-Martina_Navratilova,2,S-XC,18,4,0,2,2,8,10
19860906-W-US_Open-SF-Steffi_Graf-Martina_Navratilova,2,S-DTM,8,0,0,0,0,2,6
19860906-W-US_Open-SF-Steffi_Graf-Martina_Navratilova,2,S-DTL,12,0,0,0,0,4,8
19860906-W-US_Open-SF-Steffi_Graf-Martina_Navratilova,2,S-IO,6,4,0,3,1,3,3
20190115-W-Australian_Open-R128-Whitney_Osuigwe-Bianca_Andreescu,1,F-XC,74,18,2,5,11,35,39
20190115-W-Australian_Open-R128-Whitney_Osuigwe-Bianca_Andreescu,1,F-DTM,38,3,0,0,3,20,18
20190115-W-Australian_Open-R128-Whitney_Osuigwe-Bianca_Andreescu,1,F-DTL,11,5,1,2,2,7,4
20190115-W-Australian_Open-R128-Whitney_Osuigwe-Bianca_Andreescu,1,F-IO,30,9,2,2,5,19,11
20190115-W-Australian_Open-R128-Whitney_Osuigwe-Bianca_Andreescu,1,F-II,2,0,0,0,0,2,0
20190115-W-Australian_Open-R128-Whitney_Osuigwe-Bianca_Andreescu,1,B-XC,69,16,2,4,10,35,34
20190115-W-Australian_Open-R128-Whitney_Osuigwe-Bianca_Andreescu,1,B-DTM,48,3,0,1,2,29,19
20190115-W-Australian_Open-R128-Whitney_Osuigwe-Bianca_Andreescu,1,B-DTL,8,4,2,1,1,5,3
20190115-W-Australian_Open-R128-Whitney_Osuigwe-Bianca_Andreescu,1,B-IO,4,3,1,2,0,3,1
20190115-W-Australian_Open-R128-Whitney_Osuigwe-Bianca_Andreescu,1,S-XC,4,1,0,1,0,2,2
20190115-W-Australian_Open-R128-Whitney_Osuigwe-Bianca_Andreescu,1,S-DTM,10,1,0,0,1,5,5
20190115-W-Australian_Open-R128-Whitney_Osuigwe-Bianca_Andreescu,1,S-DTL,2,0,0,0,0,1,1
20190115-W-Australian_Open-R128-Whitney_Osuigwe-Bianca_Andreescu,2,F-XC,59,23,6,8,9,33,26
20190115-W-Australian_Open-R128-Whitney_Osuigwe-Bianca_Andreescu,2,F-DTM,46,2,0,0,2,23,23
20190115-W-Australian_Open-R128-Whitney_Osuigwe-Bianca_Andreescu,2,F-DTL,23,7,5,1,1,14,9
20190115-W-Australian_Open-R128-Whitney_Osuigwe-Bianca_Andreescu,2,F-IO,34,9,3,0,6,16,18
20190115-W-Australian_Open-R128-Whitney_Osuigwe-Bianca_Andreescu,2,F-II,3,2,2,0,0,3,0
20190115-W-Australian_Open-R128-Whitney_Osuigwe-Bianca_Andreescu,2,B-XC,39,15,3,5,7,16,23
20190115-W-Australian_Open-R128-Whitney_Osuigwe-Bianca_Andreescu,2,B-DTM,28,2,0,0,2,12,16
20190115-W-Australian_Open-R128-Whitney_Osuigwe-Bianca_Andreescu,2,B-DTL,5,1,0,1,0,4,1
20190115-W-Australian_Open-R128-Whitney_Osuigwe-Bianca_Andreescu,2,B-IO,7,2,1,1,0,4,3
20190115-W-Australian_Open-R128-Whitney_Osuigwe-Bianca_Andreescu,2,S-XC,12,1,0,0,1,3,9
20190115-W-Australian_Open-R128-Whitney_Osuigwe-Bianca_Andreescu,2,S-DTM,19,3,0,0,3,5,14
20190115-W-Australian_Open-R128-Whitney_Osuigwe-Bianca_Andreescu,2,S-DTL,6,3,0,1,2,1,5
20190115-W-Australian_Open-R128-Whitney_Osuigwe-Bianca_Andreescu,2,S-IO,2,1,0,0,1,1,1
20190123-W-Australian_Open-QF-Serena_Williams-Karolina_Pliskova,1,F-XC,64,19,9,1,9,28,36
20190123-W-Australian_Open-QF-Serena_Williams-Karolina_Pliskova,1,F-DTM,28,1,0,0,1,6,22
20190123-W-Australian_Open-QF-Serena_Williams-Karolina_Pliskova,1,F-DTL,25,14,5,4,5,14,11
20190123-W-Australian_Open-QF-Serena_Williams-Karolina_Pliskova,1,F-IO,15,11,5,2,4,8,7
20190123-W-Australian_Open-QF-Serena_Williams-Karolina_Pliskova,1,B-XC,34,11,4,2,5,17,17
20190123-W-Australian_Open-QF-Serena_Williams-Karolina_Pliskova,1,B-DTM,20,1,0,0,1,7,13
20190123-W-Australian_Open-QF-Serena_Williams-Karolina_Pliskova,1,B-DTL,19,10,6,0,4,8,11
20190123-W-Australian_Open-QF-Serena_Williams-Karolina_Pliskova,1,B-IO,9,2,0,2,0,5,4
20190123-W-Australian_Open-QF-Serena_Williams-Karolina_Pliskova,1,S-XC,5,1,0,0,1,2,3
20190123-W-Australian_Open-QF-Serena_Williams-Karolina_Pliskova,1,S-DTL,1,1,0,0,1,0,1
20190123-W-Australian_Open-QF-Serena_Williams-Karolina_Pliskova,2,F-XC,58,7,3,4,0,40,18
20190123-W-Australian_Open-QF-Serena_Williams-Karolina_Pliskova,2,F-DTM,24,2,1,0,1,14,10
20190123-W-Australian_Open-QF-Serena_Williams-Karolina_Pliskova,2,F-DTL,15,8,3,2,3,9,6
20190123-W-Australian_Open-QF-Serena_Williams-Karolina_Pliskova,2,F-IO,16,5,3,1,1,12,4
20190123-W-Australian_Open-QF-Serena_Williams-Karolina_Pliskova,2,B-XC,23,3,2,1,0,17,6
20190123-W-Australian_Open-QF-Serena_Williams-Karolina_Pliskova,2,B-DTM,25,2,0,0,2,13,12
20190123-W-Australian_Open-QF-Serena_Williams-Karolina_Pliskova,2,B-DTL,9,5,3,0,2,4,5
20190123-W-Australian_Open-QF-Serena_Williams-Karolina_Pliskova,2,B-IO,14,6,5,1,0,8,6
20190123-W-Australian_Open-QF-Serena_Williams-Karolina_Pliskova,2,S-XC,6,0,0,0,0,4,2
20190123-W-Australian_Open-QF-Serena_Williams-Karolina_Pliskova,2,S-DTM,6,0,0,0,0,4,2
20180710-W-Wimbledon-QF-Angelique_Kerber-Daria_Kasatkina,1,F-XC,126,12,4,4,4,66,60
20180710-W-Wimbledon-QF-Angelique_Kerber-Daria_Kasatkina,1,F-DTM,23,1,0,0,1,11,12
20180710-W-Wimbledon-QF-Angelique_Kerber-Daria_Kasatkina,1,F-DTL,29,10,5,2,3,13,16
20180710-W-Wimbledon-QF-Angelique_Kerber-Daria_Kasatkina,1,F-IO,29,5,1,4,0,17,12
20180710-W-Wimbledon-QF-Angelique_Kerber-Daria_Kasatkina,1,F-II,1,1,1,0,0,1,0
20180710-W-Wimbledon-QF-Angelique_Kerber-Daria_Kasatkina,1,B-XC,52,5,1,1,3,18,34
20180710-W-Wimbledon-QF-Angelique_Kerber-Daria_Kasatkina,1,B-DTM,25,2,0,0,2,6,19
20180710-W-Wimbledon-QF-Angelique_Kerber-Daria_Kasatkina,1,B-DTL,11,2,1,1,0,8,3
20180710-W-Wimbledon-QF-Angelique_Kerber-Daria_Kasatkina,1,B-IO,6,2,0,0,2,3,3
20180710-W-Wimbledon-QF-Angelique_Kerber-Daria_Kasatkina,1,S-XC,5,1,0,1,0,1,4
20180710-W-Wimbledon-QF-Angelique_Kerber-Daria_Kasatkina,1,S-DTM,6,0,0,0,0,4,2
20180710-W-Wimbledon-QF-Angelique_Kerber-Daria_Kasatkina,1,S-DTL,6,0,0,0,0,3,3
20180710-W-Wimbledon-QF-Angelique_Kerber-Daria_Kasatkina,1,S-IO,1,0,0,0,0,0,1
20180710-W-Wimbledon-QF-Angelique_Kerber-Daria_Kasatkina,2,F-XC,66,14,8,2,4,43,23
20180710-W-Wimbledon-QF-Angelique_Kerber-Daria_Kasatkina,2,F-DTM,20,1,1,0,0,8,12
20180710-W-Wimbledon-QF-Angelique_Kerber-Daria_Kasatkina,2,F-DTL,20,6,1,1,4,12,8
20180710-W-Wimbledon-QF-Angelique_Kerber-Daria_Kasatkina,2,F-IO,32,11,6,2,3,19,13
20180710-W-Wimbledon-QF-Angelique_Kerber-Daria_Kasatkina,2,F-II,7,1,1,0,0,4,3
20180710-W-Wimbledon-QF-Angelique_Kerber-Daria_Kasatkina,2,B-XC,66,7,1,1,5,34,32
20180710-W-Wimbledon-QF-Angelique_Kerber-Daria_Kasatkina,2,B-DTM,29,4,0,0,4,13,16
20180710-W-Wimbledon-QF-Angelique_Kerber-Daria_Kasatkina,2,B-DTL,14,5,3,0,2,10,4
20180710-W-Wimbledon-QF-Angelique_Kerber-Daria_Kasatkina,2,B-IO,7,2,0,0,2,3,4
20180710-W-Wimbledon-QF-Angelique_Kerber-Daria_Kasatkina,2,S-XC,19,3,0,1,2,4,15
20180710-W-Wimbledon-QF-Angelique_Kerber-Daria_Kasatkina,2,S-DTM,8,0,0,0,0,3,5
20180710-W-Wimbledon-QF-Angelique_Kerber-Daria_Kasatkina,2,S-DTL,7,1,0,0,1,1,6
20180710-W-Wimbledon-QF-Angelique_Kerber-Daria_Kasatkina,2,S-IO,5,1,0,0,1,2,3
20180623-W-Birmingham-SF-Petra_Kvitova-Mihaela_Buzarnescu,1,F-XC,27,13,6,2,5,13,14
20180623-W-Birmingham-SF-Petra_Kvitova-Mihaela_Buzarnescu,1,F-DTM,6,2,0,0,2,1,5
20180623-W-Birmingham-SF-Petra_Kvitova-Mihaela_Buzarnescu,1,F-DTL,5,5,1,1,3,2,3
20180623-W-Birmingham-SF-Petra_Kvitova-Mihaela_Buzarnescu,1,F-IO,7,6,2,1,3,3,4
20180623-W-Birmingham-SF-Petra_Kvitova-Mihaela_Buzarnescu,1,F-II,1,1,0,0,1,0,1
20180623-W-Birmingham-SF-Petra_Kvitova-Mihaela_Buzarnescu,1,B-XC,10,6,1,2,3,6,4
20180623-W-Birmingham-SF-Petra_Kvitova-Mihaela_Buzarnescu,1,B-DTM,1,0,0,0,0,0,1
20180623-W-Birmingham-SF-Petra_Kvitova-Mihaela_Buzarnescu,1,B-DTL,4,3,1,2,0,4,0
20180623-W-Birmingham-SF-Petra_Kvitova-Mihaela_Buzarnescu,1,B-IO,3,2,1,0,1,2,1
20180623-W-Birmingham-SF-Petra_Kvitova-Mihaela_Buzarnescu,1,S-DTM,1,0,0,0,0,1,0
20180623-W-Birmingham-SF-Petra_Kvitova-Mihaela_Buzarnescu,2,F-XC,14,5,2,1,2,9,5
20180623-W-Birmingham-SF-Petra_Kvitova-Mihaela_Buzarnescu,2,F-DTM,5,0,0,0,0,4,1
20180623-W-Birmingham-SF-Petra_Kvitova-Mihaela_Buzarnescu,2,F-DTL,5,3,0,1,2,2,3
20180623-W-Birmingham-SF-Petra_Kvitova-Mihaela_Buzarnescu,2,F-IO,3,2,0,0,2,1,2
20180623-W-Birmingham-SF-Petra_Kvitova-Mihaela_Buzarnescu,2,B-XC,4,0,0,0,0,0,4
20180623-W-Birmingham-SF-Petra_Kvitova-Mihaela_Buzarnescu,2,B-DTM,5,0,0,0,0,3,2
20180623-W-Birmingham-SF-Petra_Kvitova-Mihaela_Buzarnescu,2,B-DTL,3,2,0,0,2,1,2
20180623-W-Birmingham-SF-Petra_Kvitova-Mihaela_Buzarnescu,2,B-IO,2,0,0,0,0,2,0
20180623-W-Birmingham-SF-Petra_Kvitova-Mihaela_Buzarnescu,2,S-XC,1,0,0,0,0,0,1
20180623-W-Birmingham-SF-Petra_Kvitova-Mihaela_Buzarnescu,2,S-DTM,1,0,0,0,0,1,0
20190114-W-Australian_Open-R128-Astra_Sharma-Priscilla_Hon,1,F-XC,38,13,2,3,8,19,19
20190114-W-Australian_Open-R128-Astra_Sharma-Priscilla_Hon,1,F-DTM,37,4,0,1,3,21,16
20190114-W-Australian_Open-R128-Astra_Sharma-Priscilla_Hon,1,F-DTL,17,10,2,3,5,10,7
20190114-W-Australian_Open-R128-Astra_Sharma-Priscilla_Hon,1,F-IO,7,4,1,1,2,2,5
20190114-W-Australian_Open-R128-Astra_Sharma-Priscilla_Hon,1,F-II,3,1,1,0,0,2,1
20190114-W-Australian_Open-R128-Astra_Sharma-Priscilla_Hon,1,B-XC,9,1,1,0,0,5,4
20190114-W-Australian_Open-R128-Astra_Sharma-Priscilla_Hon,1,B-DTM,15,2,0,0,2,4,11
20190114-W-Australian_Open-R128-Astra_Sharma-Priscilla_Hon,1,B-DTL,7,3,1,2,0,5,2
20190114-W-Australian_Open-R128-Astra_Sharma-Priscilla_Hon,1,B-IO,2,0,0,0,0,1,1
20190114-W-Australian_Open-R128-Astra_Sharma-Priscilla_Hon,1,S-XC,3,1,0,1,0,2,1
20190114-W-Australian_Open-R128-Astra_Sharma-Priscilla_Hon,1,S-DTM,2,0,0,0,0,0,2
20190114-W-Australian_Open-R128-Astra_Sharma-Priscilla_Hon,1,S-DTL,4,0,0,0,0,2,2
20190114-W-Australian_Open-R128-Astra_Sharma-Priscilla_Hon,2,F-XC,36,13,3,1,8,18,18
20190114-W-Australian_Open-R128-Astra_Sharma-Priscilla_Hon,2,F-DTM,24,4,0,0,4,10,14
20190114-W-Australian_Open-R128-Astra_Sharma-Priscilla_Hon,2,F-DTL,8,6,4,1,1,6,2
20190114-W-Australian_Open-R128-Astra_Sharma-Priscilla_Hon,2,F-IO,14,11,6,3,2,12,2
20190114-W-Australian_Open-R128-Astra_Sharma-Priscilla_Hon,2,B-XC,32,9,3,4,2,16,16
20190114-W-Australian_Open-R128-Astra_Sharma-Priscilla_Hon,2,B-DTM,22,4,0,0,4,7,15
20190114-W-Australian_Open-R128-Astra_Sharma-Priscilla_Hon,2,B-DTL,10,6,1,0,5,3,7
20190114-W-Australian_Open-R128-Astra_Sharma-Priscilla_Hon,2,B-IO,3,3,1,0,2,1,2
20190114-W-Australian_Open-R128-Astra_Sharma-Priscilla_Hon,2,S-XC,1,0,0,0,0,0,1
20190114-W-Australian_Open-R128-Astra_Sharma-Priscilla_Hon,2,S-DTM,2,0,0,0,0,1,1
20190114-W-Australian_Open-R128-Astra_Sharma-Priscilla_Hon,2,S-DTL,1,0,0,0,0,1,0
20190130-W-St_Petersburg-R16-Vera_Zvonareva-Julia_Goerges,1,F-XC,19,2,0,1,1,12,7
20190130-W-St_Petersburg-R16-Vera_Zvonareva-Julia_Goerges,1,F-DTM,9,0,0,0,0,7,2
20190130-W-St_Petersburg-R16-Vera_Zvonareva-Julia_Goerges,1,F-DTL,18,1,0,0,1,8,10
20190130-W-St_Petersburg-R16-Vera_Zvonareva-Julia_Goerges,1,F-IO,6,2,0,2,0,5,1
20190130-W-St_Petersburg-R16-Vera_Zvonareva-Julia_Goerges,1,F-II,1,0,0,0,0,1,0
20190130-W-St_Petersburg-R16-Vera_Zvonareva-Julia_Goerges,1,B-XC,16,0,0,0,0,12,4
20190130-W-St_Petersburg-R16-Vera_Zvonareva-Julia_Goerges,1,B-DTM,29,1,0,0,1,11,18
20190130-W-St_Petersburg-R16-Vera_Zvonareva-Julia_Goerges,1,B-DTL,13,5,1,1,3,8,5
20190130-W-St_Petersburg-R16-Vera_Zvonareva-Julia_Goerges,1,B-IO,4,1,1,0,0,3,1
20190130-W-St_Petersburg-R16-Vera_Zvonareva-Julia_Goerges,1,B-II,1,0,0,0,0,1,0
20190130-W-St_Petersburg-R16-Vera_Zvonareva-Julia_Goerges,1,S-XC,1,0,0,0,0,1,0
20190130-W-St_Petersburg-R16-Vera_Zvonareva-Julia_Goerges,1,S-DTM,1,0,0,0,0,0,1
20190130-W-St_Petersburg-R16-Vera_Zvonareva-Julia_Goerges,1,S-DTL,3,0,0,0,0,0,3
20190130-W-St_Petersburg-R16-Vera_Zvonareva-Julia_Goerges,2,F-XC,33,13,2,5,6,17,16
20190130-W-St_Petersburg-R16-Vera_Zvonareva-Julia_Goerges,2,F-DTM,4,1,0,0,1,2,2
20190130-W-St_Petersburg-R16-Vera_Zvonareva-Julia_Goerges,2,F-DTL,17,10,3,3,4,10,7
20190130-W-St_Petersburg-R16-Vera_Zvonareva-Julia_Goerges,2,F-IO,29,19,7,1,11,16,13
20190130-W-St_Petersburg-R16-Vera_Zvonareva-Julia_Goerges,2,F-II,3,1,0,0,1,0,3
20190130-W-St_Petersburg-R16-Vera_Zvonareva-Julia_Goerges,2,B-XC,34,7,3,1,3,14,20
20190130-W-St_Petersburg-R16-Vera_Zvonareva-Julia_Goerges,2,B-DTM,11,1,0,0,1,5,6
20190130-W-St_Petersburg-R16-Vera_Zvonareva-Julia_Goerges,2,B-DTL,17,12,4,0,8,7,10
20190130-W-St_Petersburg-R16-Vera_Zvonareva-Julia_Goerges,2,B-IO,2,0,0,0,0,0,2
20180710-W-Wimbledon-QF-Kiki_Bertens-Julia_Goerges,1,F-XC,37,8,3,2,3,14,23
20180710-W-Wimbledon-QF-Kiki_Bertens-Julia_Goerges,1,F-DTM,10,2,0,0,2,2,8
20180710-W-Wimbledon-QF-Kiki_Bertens-Julia_Goerges,1,F-DTL,11,5,1,2,2,7,4
20180710-W-Wimbledon-QF-Kiki_Bertens-Julia_Goerges,1,F-IO,32,15,1,6,8,14,18
20180710-W-Wimbledon-QF-Kiki_Bertens-Julia_Goerges,1,B-XC,21,4,1,1,2,3,18
20180710-W-Wimbledon-QF-Kiki_Bertens-Julia_Goerges,1,B-DTM,14,3,2,0,1,6,8
20180710-W-Wimbledon-QF-Kiki_Bertens-Julia_Goerges,1,B-DTL,6,3,1,1,1,4,2
20180710-W-Wimbledon-QF-Kiki_Bertens-Julia_Goerges,1,B-IO,1,1,0,0,1,0,1
20180710-W-Wimbledon-QF-Kiki_Bertens-Julia_Goerges,1,S-XC,2,0,0,0,0,0,2
20180710-W-Wimbledon-QF-Kiki_Bertens-Julia_Goerges,1,S-DTM,3,0,0,0,0,0,3
20180710-W-Wimbledon-QF-Kiki_Bertens-Julia_Goerges,1,S-DTL,1,1,0,0,1,0,1
20180710-W-Wimbledon-QF-Kiki_Bertens-Julia_Goerges,1,S-IO,1,0,0,0,0,1,0
20180710-W-Wimbledon-QF-Kiki_Bertens-Julia_Goerges,2,F-XC,38,10,5,2,3,29,9
20180710-W-Wimbledon-QF-Kiki_Bertens-Julia_Goerges,2,F-DTM,10,3,0,1,2,7,3
20180710-W-Wimbledon-QF-Kiki_Bertens-Julia_Goerges,2,F-DTL,14,11,3,3,5,8,6
20180710-W-Wimbledon-QF-Kiki_Bertens-Julia_Goerges,2,F-IO,16,9,5,0,4,11,5
20180710-W-Wimbledon-QF-Kiki_Bertens-Julia_Goerges,2,F-II,2,2,2,0,0,2,0
20180710-W-Wimbledon-QF-Kiki_Bertens-Julia_Goerges,2,B-XC,22,7,2,5,0,17,5
20180710-W-Wimbledon-QF-Kiki_Bertens-Julia_Goerges,2,B-DTM,23,0,0,0,0,14,9
20180710-W-Wimbledon-QF-Kiki_Bertens-Julia_Goerges,2,B-DTL,11,5,3,1,1,6,5
20180710-W-Wimbledon-QF-Kiki_Bertens-Julia_Goerges,2,B-IO,3,1,1,0,0,2,1
20180710-W-Wimbledon-QF-Kiki_Bertens-Julia_Goerges,2,S-XC,3,0,0,0,0,2,1
20180710-W-Wimbledon-QF-Kiki_Bertens-Julia_Goerges,2,S-DTM,1,0,0,0,0,1,0
20180710-W-Wimbledon-QF-Kiki_Bertens-Julia_Goerges,2,S-DTL,1,0,0,0,0,0,1
20190130-W-St_Petersburg-R32-Ekaterina_Alexandrova-Katie_Boulter,1,F-XC,67,18,6,4,8,38,29
20190130-W-St_Petersburg-R32-Ekaterina_Alexandrova-Katie_Boulter,1,F-DTM,27,4,0,0,4,16,11
20190130-W-St_Petersburg-R32-Ekaterina_Alexandrova-Katie_Boulter,1,F-DTL,13,5,0,4,1,9,4
20190130-W-St_Petersburg-R32-Ekaterina_Alexandrova-Katie_Boulter,1,F-IO,12,2,0,0,2,6,6
20190130-W-St_Petersburg-R32-Ekaterina_Alexandrova-Katie_Boulter,1,B-XC,22,6,2,1,3,14,8
20190130-W-St_Petersburg-R32-Ekaterina_Alexandrova-Katie_Boulter,1,B-DTM,31,2,0,1,1,17,14
20190130-W-St_Petersburg-R32-Ekaterina_Alexandrova-Katie_Boulter,1,B-DTL,8,2,2,0,0,6,2
20190130-W-St_Petersburg-R32-Ekaterina_Alexandrova-Katie_Boulter,1,B-IO,15,6,2,0,4,7,8
20190130-W-St_Petersburg-R32-Ekaterina_Alexandrova-Katie_Boulter,1,S-XC,2,0,0,0,0,1,1
20190130-W-St_Petersburg-R32-Ekaterina_Alexandrova-Katie_Boulter,1,S-DTM,6,0,0,0,0,2,4
20190130-W-St_Petersburg-R32-Ekaterina_Alexandrova-Katie_Boulter,2,F-XC,62,17,6,4,7,29,33
20190130-W-St_Petersburg-R32-Ekaterina_Alexandrova-Katie_Boulter,2,F-DTM,36,4,0,0,4,15,21
20190130-W-St_Petersburg-R32-Ekaterina_Alexandrova-Katie_Boulter,2,F-DTL,21,6,4,1,1,11,10
20190130-W-St_Petersburg-R32-Ekaterina_Alexandrova-Katie_Boulter,2,F-IO,12,7,4,0,3,7,5
20190130-W-St_Petersburg-R32-Ekaterina_Alexandrova-Katie_Boulter,2,B-XC,11,3,1,2,0,4,7
20190130-W-St_Petersburg-R32-Ekaterina_Alexandrova-Katie_Boulter,2,B-DTM,29,2,0,1,1,16,13
20190130-W-St_Petersburg-R32-Ekaterina_Alexandrova-Katie_Boulter,2,B-DTL,6,4,1,0,3,1,5
20190130-W-St_Petersburg-R32-Ekaterina_Alexandrova-Katie_Boulter,2,B-IO,11,6,0,0,6,2,9
20190130-W-St_Petersburg-R32-Ekaterina_Alexandrova-Katie_Boulter,2,S-XC,2,0,0,0,0,2,0
20190130-W-St_Petersburg-R32-Ekaterina_Alexandrova-Katie_Boulter,2,S-DTM,5,0,0,0,0,0,5
20190130-W-St_Petersburg-R32-Ekaterina_Alexandrova-Katie_Boulter,2,S-DTL,1,0,0,0,0,0,1
20190131-W-St_Petersburg-R16-Tereza_Martincova-Ekaterina_Alexandrova,1,F-XC,43,9,0,2,7,12,31
20190131-W-St_Petersburg-R16-Tereza_Martincova-Ekaterina_Alexandrova,1,F-DTM,25,2,0,0,2,13,12
20190131-W-St_Petersburg-R16-Tereza_Martincova-Ekaterina_Alexandrova,1,F-DTL,14,4,0,3,1,9,5
20190131-W-St_Petersburg-R16-Tereza_Martincova-Ekaterina_Alexandrova,1,F-IO,12,3,0,2,1,5,7
20190131-W-St_Petersburg-R16-Tereza_Martincova-Ekaterina_Alexandrova,1,F-II,1,0,0,0,0,0,1
20190131-W-St_Petersburg-R16-Tereza_Martincova-Ekaterina_Alexandrova,1,B-XC,23,6,0,2,4,10,13
20190131-W-St_Petersburg-R16-Tereza_Martincova-Ekaterina_Alexandrova,1,B-DTM,22,1,0,1,0,10,12
20190131-W-St_Petersburg-R16-Tereza_Martincova-Ekaterina_Alexandrova,1,B-DTL,3,0,0,0,0,2,1
20190131-W-St_Petersburg-R16-Tereza_Martincova-Ekaterina_Alexandrova,1,B-IO,2,1,1,0,0,2,0
20190131-W-St_Petersburg-R16-Tereza_Martincova-Ekaterina_Alexandrova,1,S-XC,1,0,0,0,0,0,1
20190131-W-St_Petersburg-R16-Tereza_Martincova-Ekaterina_Alexandrova,1,S-DTM,2,0,0,0,0,0,2
20190131-W-St_Petersburg-R16-Tereza_Martincova-Ekaterina_Alexandrova,1,S-DTL,2,0,0,0,0,0,2
20190131-W-St_Petersburg-R16-Tereza_Martincova-Ekaterina_Alexandrova,1,S-IO,1,0,0,0,0,0,1
20190131-W-St_Petersburg-R16-Tereza_Martincova-Ekaterina_Alexandrova,2,F-XC,46,11,2,3,6,29,17
20190131-W-St_Petersburg-R16-Tereza_Martincova-Ekaterina_Alexandrova,2,F-DTM,16,4,0,0,4,5,11
20190131-W-St_Petersburg-R16-Tereza_Martincova-Ekaterina_Alexandrova,2,F-DTL,10,6,2,2,2,8,2
20190131-W-St_Petersburg-R16-Tereza_Martincova-Ekaterina_Alexandrova,2,F-IO,20,10,3,3,4,12,8
20190131-W-St_Petersburg-R16-Tereza_Martincova-Ekaterina_Alexandrova,2,B-XC,22,4,1,3,0,16,6
20190131-W-St_Petersburg-R16-Tereza_Martincova-Ekaterina_Alexandrova,2,B-DTM,28,2,0,0,2,16,12
20190131-W-St_Petersburg-R16-Tereza_Martincova-Ekaterina_Alexandrova,2,B-DTL,12,3,0,1,2,5,7
20190131-W-St_Petersburg-R16-Tereza_Martincova-Ekaterina_Alexandrova,2,B-IO,9,0,0,0,0,4,5
20190131-W-St_Petersburg-R16-Tereza_Martincova-Ekaterina_Alexandrova,2,S-XC,5,0,0,0,0,2,3
20190131-W-St_Petersburg-R16-Tereza_Martincova-Ekaterina_Alexandrova,2,S-DTM,2,0,0,0,0,2,0
20190131-W-St_Petersburg-R16-Tereza_Martincova-Ekaterina_Alexandrova,2,S-DTL,3,0,0,0,0,2,1
20190131-W-Hua_Hin-R16-Jennifer_Brady-Tamara_Zidansek,1,F-XC,70,18,4,6,8,36,34
20190131-W-Hua_Hin-R16-Jennifer_Brady-Tamara_Zidansek,1,F-DTM,58,5,0,0,5,28,30
20190131-W-Hua_Hin-R16-Jennifer_Brady-Tamara_Zidansek,1,F-DTL,24,9,4,1,4,11,13
20190131-W-Hua_Hin-R16-Jennifer_Brady-Tamara_Zidansek,1,F-IO,55,14,4,4,6,22,33
20190131-W-Hua_Hin-R16-Jennifer_Brady-Tamara_Zidansek,1,F-II,4,3,0,0,3,0,4
20190131-W-Hua_Hin-R16-Jennifer_Brady-Tamara_Zidansek,1,B-XC,66,12,2,3,7,23,43
20190131-W-Hua_Hin-R16-Jennifer_Brady-Tamara_Zidansek,1,B-DTM,38,1,0,0,1,16,22
20190131-W-Hua_Hin-R16-Jennifer_Brady-Tamara_Zidansek,1,B-DTL,9,7,4,1,2,6,3
20190131-W-Hua_Hin-R16-Jennifer_Brady-Tamara_Zidansek,1,B-IO,3,1,0,0,1,1,2
20190131-W-Hua_Hin-R16-Jennifer_Brady-Tamara_Zidansek,1,S-XC,6,0,0,0,0,3,3
20190131-W-Hua_Hin-R16-Jennifer_Brady-Tamara_Zidansek,1,S-DTM,4,0,0,0,0,2,2
20190131-W-Hua_Hin-R16-Jennifer_Brady-Tamara_Zidansek,1,S-DTL,2,0,0,0,0,0,2
20190131-W-Hua_Hin-R16-Jennifer_Brady-Tamara_Zidansek,2,F-XC,72,15,8,3,4,40,32
20190131-W-Hua_Hin-R16-Jennifer_Brady-Tamara_Zidansek,2,F-DTM,50,0,0,0,0,24,26
20190131-W-Hua_Hin-R16-Jennifer_Brady-Tamara_Zidansek,2,F-DTL,13,6,3,0,3,7,6
20190131-W-Hua_Hin-R16-Jennifer_Brady-Tamara_Zidansek,2,F-IO,59,22,7,2,13,33,26
20190131-W-Hua_Hin-R16-Jennifer_Brady-Tamara_Zidansek,2,F-II,8,5,1,1,3,5,3
20190131-W-Hua_Hin-R16-Jennifer_Brady-Tamara_Zidansek,2,B-XC,48,2,0,2,0,36,12
20190131-W-Hua_Hin-R16-Jennifer_Brady-Tamara_Zidansek,2,B-DTM,59,2,0,0,2,30,29
20190131-W-Hua_Hin-R16-Jennifer_Brady-Tamara_Zidansek,2,B-DTL,12,5,2,0,3,8,4
20190131-W-Hua_Hin-R16-Jennifer_Brady-Tamara_Zidansek,2,B-IO,3,1,0,1,0,2,1
20190131-W-Hua_Hin-R16-Jennifer_Brady-Tamara_Zidansek,2,S-XC,12,1,0,0,1,5,7
20190131-W-Hua_Hin-R16-Jennifer_Brady-Tamara_Zidansek,2,S-DTM,7,0,0,0,0,4,3
20190131-W-Hua_Hin-R16-Jennifer_Brady-Tamara_Zidansek,2,S-DTL,2,2,0,1,1,1,1
20190131-W-Hua_Hin-R16-Jennifer_Brady-Tamara_Zidansek,2,S-IO,1,0,0,0,0,0,1
20190201-W-Hua_Hin-QF-Yafan_Wang-Magda_Linette,1,F-XC,50,14,3,4,7,20,30
20190201-W-Hua_Hin-QF-Yafan_Wang-Magda_Linette,1,F-DTM,26,1,0,0,1,10,16
20190201-W-Hua_Hin-QF-Yafan_Wang-Magda_Linette,1,F-DTL,22,4,2,1,1,11,11
20190201-W-Hua_Hin-QF-Yafan_Wang-Magda_Linette,1,F-IO,18,8,3,2,3,8,10
20190201-W-Hua_Hin-QF-Yafan_Wang-Magda_Linette,1,F-II,1,0,0,0,0,0,1
20190201-W-Hua_Hin-QF-Yafan_Wang-Magda_Linette,1,B-XC,49,4,1,2,1,28,21
20190201-W-Hua_Hin-QF-Yafan_Wang-Magda_Linette,1,B-DTM,28,2,0,0,2,12,16
20190201-W-Hua_Hin-QF-Yafan_Wang-Magda_Linette,1,B-DTL,16,9,3,1,5,8,8
20190201-W-Hua_Hin-QF-Yafan_Wang-Magda_Linette,1,B-IO,2,2,0,0,2,0,2
20190201-W-Hua_Hin-QF-Yafan_Wang-Magda_Linette,1,S-XC,5,0,0,0,0,2,3
20190201-W-Hua_Hin-QF-Yafan_Wang-Magda_Linette,1,S-DTM,3,0,0,0,0,1,2
20190201-W-Hua_Hin-QF-Yafan_Wang-Magda_Linette,1,S-DTL,1,0,0,0,0,0,1
20190201-W-Hua_Hin-QF-Yafan_Wang-Magda_Linette,2,F-XC,61,15,4,6,5,39,22
20190201-W-Hua_Hin-QF-Yafan_Wang-Magda_Linette,2,F-DTM,14,2,0,0,2,6,8
20190201-W-Hua_Hin-QF-Yafan_Wang-Magda_Linette,2,F-DTL,16,7,3,2,2,13,3
20190201-W-Hua_Hin-QF-Yafan_Wang-Magda_Linette,2,F-IO,17,6,0,3,3,9,8
20190201-W-Hua_Hin-QF-Yafan_Wang-Magda_Linette,2,F-II,2,0,0,0,0,0,2
20190201-W-Hua_Hin-QF-Yafan_Wang-Magda_Linette,2,B-XC,66,9,1,4,4,34,32
20190201-W-Hua_Hin-QF-Yafan_Wang-Magda_Linette,2,B-DTM,32,1,0,0,1,16,16
20190201-W-Hua_Hin-QF-Yafan_Wang-Magda_Linette,2,B-DTL,6,2,0,1,1,3,3
20190201-W-Hua_Hin-QF-Yafan_Wang-Magda_Linette,2,S-XC,1,0,0,0,0,1,0
20190201-W-Hua_Hin-QF-Yafan_Wang-Magda_Linette,2,S-DTM,1,0,0,0,0,0,1
20190201-W-Hua_Hin-QF-Yafan_Wang-Magda_Linette,2,S-DTL,1,0,0,0,0,1,0
20090517-W-Madrid-F-Caroline_Wozniacki-Dinara_Safina,1,F-XC,45,7,3,1,3,22,23
20090517-W-Madrid-F-Caroline_Wozniacki-Dinara_Safina,1,F-DTM,24,0,0,0,0,13,11
20090517-W-Madrid-F-Caroline_Wozniacki-Dinara_Safina,1,F-DTL,25,7,3,0,4,16,9
20090517-W-Madrid-F-Caroline_Wozniacki-Dinara_Safina,1,F-IO,17,2,1,0,1,10,7
20090517-W-Madrid-F-Caroline_Wozniacki-Dinara_Safina,1,F-II,2,1,0,0,1,1,1
20090517-W-Madrid-F-Caroline_Wozniacki-Dinara_Safina,1,B-XC,59,5,0,0,5,26,33
20090517-W-Madrid-F-Caroline_Wozniacki-Dinara_Safina,1,B-DTM,36,2,0,0,2,12,24
20090517-W-Madrid-F-Caroline_Wozniacki-Dinara_Safina,1,B-DTL,19,9,1,3,5,9,10
20090517-W-Madrid-F-Caroline_Wozniacki-Dinara_Safina,1,B-IO,9,4,0,3,1,4,5
20090517-W-Madrid-F-Caroline_Wozniacki-Dinara_Safina,1,S-XC,5,0,0,0,0,4,1
20090517-W-Madrid-F-Caroline_Wozniacki-Dinara_Safina,1,S-DTM,4,0,0,0,0,1,3
20090517-W-Madrid-F-Caroline_Wozniacki-Dinara_Safina,2,F-XC,64,12,3,4,5,35,29
20090517-W-Madrid-F-Caroline_Wozniacki-Dinara_Safina,2,F-DTM,22,0,0,0,0,13,9
20090517-W-Madrid-F-Caroline_Wozniacki-Dinara_Safina,2,F-DTL,23,6,1,1,4,13,10
20090517-W-Madrid-F-Caroline_Wozniacki-Dinara_Safina,2,F-IO,23,8,3,2,3,15,8
20090517-W-Madrid-F-Caroline_Wozniacki-Dinara_Safina,2,F-II,2,1,0,0,1,0,2
20090517-W-Madrid-F-Caroline_Wozniacki-Dinara_Safina,2,B-XC,78,14,3,4,7,41,37
20090517-W-Madrid-F-Caroline_Wozniacki-Dinara_Safina,2,B-DTM,23,2,0,0,2,8,15
20090517-W-Madrid-F-Caroline_Wozniacki-Dinara_Safina,2,B-DTL,13,8,6,0,2,8,5
20090517-W-Madrid-F-Caroline_Wozniacki-Dinara_Safina,2,B-IO,5,2,0,0,2,0,5
20090517-W-Madrid-F-Caroline_Wozniacki-Dinara_Safina,2,S-XC,1,0,0,0,0,0,1
20090517-W-Madrid-F-Caroline_Wozniacki-Dinara_Safina,2,S-DTM,3,0,0,0,0,2,1
20090517-W-Madrid-F-Caroline_Wozniacki-Dinara_Safina,2,S-DTL,1,0,0,0,0,0,1
20180710-W-Wimbledon-QF-Dominika_Cibulkova-Jelena_Ostapenko,1,F-XC,15,4,0,2,2,8,7
20180710-W-Wimbledon-QF-Dominika_Cibulkova-Jelena_Ostapenko,1,F-DTM,24,1,1,0,0,13,11
20180710-W-Wimbledon-QF-Dominika_Cibulkova-Jelena_Ostapenko,1,F-DTL,6,2,0,0,2,4,2
20180710-W-Wimbledon-QF-Dominika_Cibulkova-Jelena_Ostapenko,1,F-IO,3,1,1,0,0,3,0
20180710-W-Wimbledon-QF-Dominika_Cibulkova-Jelena_Ostapenko,1,B-XC,17,4,0,1,3,11,6
20180710-W-Wimbledon-QF-Dominika_Cibulkova-Jelena_Ostapenko,1,B-DTM,11,1,0,0,1,4,7
20180710-W-Wimbledon-QF-Dominika_Cibulkova-Jelena_Ostapenko,1,B-DTL,3,2,1,0,1,1,2
20180710-W-Wimbledon-QF-Dominika_Cibulkova-Jelena_Ostapenko,1,B-IO,3,0,0,0,0,2,1
20180710-W-Wimbledon-QF-Dominika_Cibulkova-Jelena_Ostapenko,1,S-XC,2,0,0,0,0,1,1
20180710-W-Wimbledon-QF-Dominika_Cibulkova-Jelena_Ostapenko,1,S-DTM,3,0,0,0,0,2,1
20180710-W-Wimbledon-QF-Dominika_Cibulkova-Jelena_Ostapenko,2,F-XC,26,11,5,3,3,15,11
20180710-W-Wimbledon-QF-Dominika_Cibulkova-Jelena_Ostapenko,2,F-DTM,7,1,0,0,1,3,4
20180710-W-Wimbledon-QF-Dominika_Cibulkova-Jelena_Ostapenko,2,F-DTL,5,3,0,1,2,3,2
20180710-W-Wimbledon-QF-Dominika_Cibulkova-Jelena_Ostapenko,2,F-IO,12,7,2,2,3,9,3
20180710-W-Wimbledon-QF-Dominika_Cibulkova-Jelena_Ostapenko,2,B-XC,26,12,4,3,5,9,17
20180710-W-Wimbledon-QF-Dominika_Cibulkova-Jelena_Ostapenko,2,B-DTM,14,3,0,0,3,4,10
20180710-W-Wimbledon-QF-Dominika_Cibulkova-Jelena_Ostapenko,2,B-DTL,6,6,2,0,4,2,4
20180710-W-Wimbledon-QF-Dominika_Cibulkova-Jelena_Ostapenko,2,B-IO,4,3,1,0,2,2,2
20180710-W-Wimbledon-QF-Dominika_Cibulkova-Jelena_Ostapenko,2,S-XC,1,0,0,0,0,1,0
20180710-W-Wimbledon-QF-Dominika_Cibulkova-Jelena_Ostapenko,2,S-DTM,1,1,1,0,0,1,0
20190202-W-Hua_Hin-SF-Dayana_Yastremska-Magda_Linette,1,F-XC,42,16,6,4,6,27,15
20190202-W-Hua_Hin-SF-Dayana_Yastremska-Magda_Linette,1,F-DTM,17,4,0,1,3,7,10
20190202-W-Hua_Hin-SF-Dayana_Yastremska-Magda_Linette,1,F-DTL,14,5,3,0,2,7,7
20190202-W-Hua_Hin-SF-Dayana_Yastremska-Magda_Linette,1,F-IO,13,6,4,0,2,9,4
20190202-W-Hua_Hin-SF-Dayana_Yastremska-Magda_Linette,1,B-XC,15,4,0,2,2,7,8
20190202-W-Hua_Hin-SF-Dayana_Yastremska-Magda_Linette,1,B-DTM,23,4,0,1,3,11,12
20190202-W-Hua_Hin-SF-Dayana_Yastremska-Magda_Linette,1,B-DTL,13,6,3,2,1,6,7
20190202-W-Hua_Hin-SF-Dayana_Yastremska-Magda_Linette,1,B-IO,10,5,3,1,1,6,4
20190202-W-Hua_Hin-SF-Dayana_Yastremska-Magda_Linette,1,S-XC,1,0,0,0,0,0,1
20190202-W-Hua_Hin-SF-Dayana_Yastremska-Magda_Linette,1,S-DTM,2,0,0,0,0,1,1
20190202-W-Hua_Hin-SF-Dayana_Yastremska-Magda_Linette,2,F-XC,47,15,3,5,7,24,23
20190202-W-Hua_Hin-SF-Dayana_Yastremska-Magda_Linette,2,F-DTM,22,2,0,0,2,8,14
20190202-W-Hua_Hin-SF-Dayana_Yastremska-Magda_Linette,2,F-DTL,9,3,0,1,2,3,6
20190202-W-Hua_Hin-SF-Dayana_Yastremska-Magda_Linette,2,F-IO,4,2,1,0,1,1,3
20190202-W-Hua_Hin-SF-Dayana_Yastremska-Magda_Linette,2,B-XC,33,4,0,2,2,24,9
20190202-W-Hua_Hin-SF-Dayana_Yastremska-Magda_Linette,2,B-DTM,14,0,0,0,0,4,10
20190202-W-Hua_Hin-SF-Dayana_Yastremska-Magda_Linette,2,B-DTL,2,0,0,0,0,1,1
20190202-W-Hua_Hin-SF-Dayana_Yastremska-Magda_Linette,2,B-IO,4,1,0,1,0,3,1
20190202-W-Hua_Hin-SF-Dayana_Yastremska-Magda_Linette,2,S-XC,1,0,0,0,0,0,1
20190202-W-Hua_Hin-SF-Dayana_Yastremska-Magda_Linette,2,S-DTM,1,0,0,0,0,0,1
20190131-W-Hua_Hin-R16-Viktorija_Golubic-Ying_Ying_Duan,1,F-XC,23,8,0,5,3,17,6
20190131-W-Hua_Hin-R16-Viktorija_Golubic-Ying_Ying_Duan,1,F-DTM,24,3,0,0,3,14,10
20190131-W-Hua_Hin-R16-Viktorija_Golubic-Ying_Ying_Duan,1,F-DTL,11,5,1,3,1,7,4
20190131-W-Hua_Hin-R16-Viktorija_Golubic-Ying_Ying_Duan,1,F-IO,14,4,1,1,2,8,6
20190131-W-Hua_Hin-R16-Viktorija_Golubic-Ying_Ying_Duan,1,F-II,1,0,0,0,0,0,1
20190131-W-Hua_Hin-R16-Viktorija_Golubic-Ying_Ying_Duan,1,B-XC,10,5,2,3,0,6,4
20190131-W-Hua_Hin-R16-Viktorija_Golubic-Ying_Ying_Duan,1,B-DTM,17,5,1,1,3,9,8
20190131-W-Hua_Hin-R16-Viktorija_Golubic-Ying_Ying_Duan,1,B-DTL,8,4,4,0,0,7,1
20190131-W-Hua_Hin-R16-Viktorija_Golubic-Ying_Ying_Duan,1,B-IO,4,1,0,0,1,2,2
20190131-W-Hua_Hin-R16-Viktorija_Golubic-Ying_Ying_Duan,1,S-XC,14,1,0,1,0,7,7
20190131-W-Hua_Hin-R16-Viktorija_Golubic-Ying_Ying_Duan,1,S-DTM,8,0,0,0,0,6,2
20190131-W-Hua_Hin-R16-Viktorija_Golubic-Ying_Ying_Duan,1,S-DTL,4,1,0,1,0,2,2
20190131-W-Hua_Hin-R16-Viktorija_Golubic-Ying_Ying_Duan,1,S-IO,1,0,0,0,0,1,0
20190131-W-Hua_Hin-R16-Viktorija_Golubic-Ying_Ying_Duan,2,F-XC,44,20,7,5,8,19,25
20190131-W-Hua_Hin-R16-Viktorija_Golubic-Ying_Ying_Duan,2,F-DTM,14,1,0,0,1,6,8
20190131-W-Hua_Hin-R16-Viktorija_Golubic-Ying_Ying_Duan,2,F-DTL,12,5,4,1,0,6,6
20190131-W-Hua_Hin-R16-Viktorija_Golubic-Ying_Ying_Duan,2,F-IO,17,8,2,1,5,9,8
20190131-W-Hua_Hin-R16-Viktorija_Golubic-Ying_Ying_Duan,2,B-XC,34,14,4,3,7,13,21
20190131-W-Hua_Hin-R16-Viktorija_Golubic-Ying_Ying_Duan,2,B-DTM,24,2,0,0,2,9,15
20190131-W-Hua_Hin-R16-Viktorija_Golubic-Ying_Ying_Duan,2,B-DTL,13,6,4,1,1,7,6
20190131-W-Hua_Hin-R16-Viktorija_Golubic-Ying_Ying_Duan,2,B-IO,8,4,0,0,4,3,5
20190202-W-Hua_Hin-SF-Tamara_Zidansek-Ajla_Tomljanovic,1,F-XC,36,5,0,1,4,10,26
20190202-W-Hua_Hin-SF-Tamara_Zidansek-Ajla_Tomljanovic,1,F-DTM,20,4,1,0,3,8,12
20190202-W-Hua_Hin-SF-Tamara_Zidansek-Ajla_Tomljanovic,1,F-DTL,3,2,1,0,1,2,1
20190202-W-Hua_Hin-SF-Tamara_Zidansek-Ajla_Tomljanovic,1,F-IO,15,7,2,2,3,9,6
20190202-W-Hua_Hin-SF-Tamara_Zidansek-Ajla_Tomljanovic,1,F-II,4,2,0,0,2,1,3
20190202-W-Hua_Hin-SF-Tamara_Zidansek-Ajla_Tomljanovic,1,B-XC,15,2,1,0,1,7,8
20190202-W-Hua_Hin-SF-Tamara_Zidansek-Ajla_Tomljanovic,1,B-DTM,24,4,0,0,4,9,15
20190202-W-Hua_Hin-SF-Tamara_Zidansek-Ajla_Tomljanovic,1,B-DTL,8,2,1,0,1,3,5
20190202-W-Hua_Hin-SF-Tamara_Zidansek-Ajla_Tomljanovic,1,S-XC,3,0,0,0,0,2,1
20190202-W-Hua_Hin-SF-Tamara_Zidansek-Ajla_Tomljanovic,1,S-DTM,3,0,0,0,0,0,3
20190202-W-Hua_Hin-SF-Tamara_Zidansek-Ajla_Tomljanovic,1,S-DTL,1,0,0,0,0,0,1
20190202-W-Hua_Hin-SF-Tamara_Zidansek-Ajla_Tomljanovic,2,F-XC,27,8,2,5,1,22,5
20190202-W-Hua_Hin-SF-Tamara_Zidansek-Ajla_Tomljanovic,2,F-DTM,20,3,0,0,3,9,11
20190202-W-Hua_Hin-SF-Tamara_Zidansek-Ajla_Tomljanovic,2,F-DTL,20,8,1,3,4,13,7
20190202-W-Hua_Hin-SF-Tamara_Zidansek-Ajla_Tomljanovic,2,F-IO,8,0,0,0,0,2,6
20190202-W-Hua_Hin-SF-Tamara_Zidansek-Ajla_Tomljanovic,2,B-XC,23,5,1,1,3,12,11
20190202-W-Hua_Hin-SF-Tamara_Zidansek-Ajla_Tomljanovic,2,B-DTM,13,0,0,0,0,8,5
20190202-W-Hua_Hin-SF-Tamara_Zidansek-Ajla_Tomljanovic,2,B-DTL,2,1,1,0,0,2,0
20190202-W-Hua_Hin-SF-Tamara_Zidansek-Ajla_Tomljanovic,2,B-IO,4,1,1,0,0,4,0
20190202-W-Hua_Hin-SF-Tamara_Zidansek-Ajla_Tomljanovic,2,S-XC,3,1,0,0,1,1,2
20190202-W-Hua_Hin-SF-Tamara_Zidansek-Ajla_Tomljanovic,2,S-DTM,2,0,0,0,0,2,0
20190202-W-Hua_Hin-SF-Tamara_Zidansek-Ajla_Tomljanovic,2,S-DTL,2,0,0,0,0,1,1
20190202-W-Hua_Hin-SF-Tamara_Zidansek-Ajla_Tomljanovic,2,S-IO,1,0,0,0,0,0,1
20190129-W-St_Petersburg-R32-Olga_Danilovic-Veronika_Kudermetova,1,F-XC,35,11,3,3,5,11,24
20190129-W-St_Petersburg-R32-Olga_Danilovic-Veronika_Kudermetova,1,F-DTM,11,3,0,0,3,3,8
20190129-W-St_Petersburg-R32-Olga_Danilovic-Veronika_Kudermetova,1,F-DTL,10,6,2,0,4,4,6
20190129-W-St_Petersburg-R32-Olga_Danilovic-Veronika_Kudermetova,1,F-IO,4,2,1,1,0,3,1
20190129-W-St_Petersburg-R32-Olga_Danilovic-Veronika_Kudermetova,1,F-II,1,0,0,0,0,1,0
20190129-W-St_Petersburg-R32-Olga_Danilovic-Veronika_Kudermetova,1,B-XC,12,5,3,0,2,6,6
20190129-W-St_Petersburg-R32-Olga_Danilovic-Veronika_Kudermetova,1,B-DTM,3,1,0,0,1,1,2
20190129-W-St_Petersburg-R32-Olga_Danilovic-Veronika_Kudermetova,1,B-DTL,6,3,1,1,1,4,2
20190129-W-St_Petersburg-R32-Olga_Danilovic-Veronika_Kudermetova,1,B-IO,1,1,0,0,1,0,1
20190129-W-St_Petersburg-R32-Olga_Danilovic-Veronika_Kudermetova,1,S-XC,1,0,0,0,0,0,1
20190129-W-St_Petersburg-R32-Olga_Danilovic-Veronika_Kudermetova,1,S-DTL,1,1,0,0,1,0,1
20190129-W-St_Petersburg-R32-Olga_Danilovic-Veronika_Kudermetova,1,S-IO,1,1,0,0,1,0,1
20190129-W-St_Petersburg-R32-Olga_Danilovic-Veronika_Kudermetova,2,F-XC,15,3,0,2,1,8,7
20190129-W-St_Petersburg-R32-Olga_Danilovic-Veronika_Kudermetova,2,F-DTM,5,1,1,0,0,5,0
20190129-W-St_Petersburg-R32-Olga_Danilovic-Veronika_Kudermetova,2,F-DTL,10,7,2,2,3,7,3
20190129-W-St_Petersburg-R32-Olga_Danilovic-Veronika_Kudermetova,2,F-IO,9,5,2,1,2,4,5
20190129-W-St_Petersburg-R32-Olga_Danilovic-Veronika_Kudermetova,2,B-XC,14,3,0,2,1,9,5
20190129-W-St_Petersburg-R32-Olga_Danilovic-Veronika_Kudermetova,2,B-DTM,13,1,0,1,0,8,5
20190129-W-St_Petersburg-R32-Olga_Danilovic-Veronika_Kudermetova,2,B-DTL,1,1,1,0,0,1,0
20190129-W-St_Petersburg-R32-Olga_Danilovic-Veronika_Kudermetova,2,B-IO,4,2,0,2,0,4,0
20190129-W-St_Petersburg-R32-Olga_Danilovic-Veronika_Kudermetova,2,S-XC,5,1,1,0,0,5,0
20190129-W-St_Petersburg-R32-Olga_Danilovic-Veronika_Kudermetova,2,S-DTM,3,0,0,0,0,2,1
20180707-W-Wimbledon-R32-Naomi_Osaka-Angelique_Kerber,1,F-XC,37,9,7,0,2,16,21
20180707-W-Wimbledon-R32-Naomi_Osaka-Angelique_Kerber,1,F-DTM,5,2,0,1,1,1,4
20180707-W-Wimbledon-R32-Naomi_Osaka-Angelique_Kerber,1,F-DTL,10,4,1,1,2,3,7
20180707-W-Wimbledon-R32-Naomi_Osaka-Angelique_Kerber,1,F-IO,14,4,2,0,2,8,6
20180707-W-Wimbledon-R32-Naomi_Osaka-Angelique_Kerber,1,B-XC,35,10,5,2,3,17,18
20180707-W-Wimbledon-R32-Naomi_Osaka-Angelique_Kerber,1,B-DTM,15,3,0,0,3,3,12
20180707-W-Wimbledon-R32-Naomi_Osaka-Angelique_Kerber,1,B-DTL,12,5,1,0,4,3,9
20180707-W-Wimbledon-R32-Naomi_Osaka-Angelique_Kerber,1,B-IO,9,3,1,1,1,5,4
20180707-W-Wimbledon-R32-Naomi_Osaka-Angelique_Kerber,2,F-XC,5,1,1,0,0,4,1
20180707-W-Wimbledon-R32-Naomi_Osaka-Angelique_Kerber,2,F-DTM,11,0,0,0,0,3,8
20180707-W-Wimbledon-R32-Naomi_Osaka-Angelique_Kerber,2,F-IO,32,5,2,3,0,22,10
20180707-W-Wimbledon-R32-Naomi_Osaka-Angelique_Kerber,2,F-II,14,9,7,0,2,11,3
20180707-W-Wimbledon-R32-Naomi_Osaka-Angelique_Kerber,2,B-DTM,18,1,0,0,1,10,8
20180707-W-Wimbledon-R32-Naomi_Osaka-Angelique_Kerber,2,B-IO,21,6,3,1,2,16,5
20180707-W-Wimbledon-R32-Naomi_Osaka-Angelique_Kerber,2,B-II,6,4,4,0,0,5,1
20180707-W-Wimbledon-R32-Naomi_Osaka-Angelique_Kerber,2,S-DTM,5,1,0,0,1,3,2
20180707-W-Wimbledon-R32-Naomi_Osaka-Angelique_Kerber,2,S-IO,2,0,0,0,0,0,2
20180705-W-Wimbledon-R64-Naomi_Osaka-Katie_Boulter,1,F-XC,25,13,6,4,3,19,6
20180705-W-Wimbledon-R64-Naomi_Osaka-Katie_Boulter,1,F-DTM,4,0,0,0,0,1,3
20180705-W-Wimbledon-R64-Naomi_Osaka-Katie_Boulter,1,F-DTL,7,4,4,0,0,6,1
20180705-W-Wimbledon-R64-Naomi_Osaka-Katie_Boulter,1,F-IO,13,7,4,1,2,9,4
20180705-W-Wimbledon-R64-Naomi_Osaka-Katie_Boulter,1,B-XC,17,6,0,5,1,11,6
20180705-W-Wimbledon-R64-Naomi_Osaka-Katie_Boulter,1,B-DTM,13,3,0,1,2,5,8
20180705-W-Wimbledon-R64-Naomi_Osaka-Katie_Boulter,1,B-DTL,3,1,1,0,0,1,2
20180705-W-Wimbledon-R64-Naomi_Osaka-Katie_Boulter,1,B-IO,7,4,0,2,2,4,3
20180705-W-Wimbledon-R64-Naomi_Osaka-Katie_Boulter,2,F-XC,11,4,3,1,0,6,5
20180705-W-Wimbledon-R64-Naomi_Osaka-Katie_Boulter,2,F-DTM,9,1,0,1,0,4,5
20180705-W-Wimbledon-R64-Naomi_Osaka-Katie_Boulter,2,F-DTL,6,1,1,0,0,5,1
20180705-W-Wimbledon-R64-Naomi_Osaka-Katie_Boulter,2,F-IO,5,4,1,1,2,3,2
20180705-W-Wimbledon-R64-Naomi_Osaka-Katie_Boulter,2,B-XC,5,3,1,1,1,4,1
20180705-W-Wimbledon-R64-Naomi_Osaka-Katie_Boulter,2,B-DTM,15,1,0,0,1,5,10
20180705-W-Wimbledon-R64-Naomi_Osaka-Katie_Boulter,2,B-DTL,6,4,2,1,1,3,3
20180705-W-Wimbledon-R64-Naomi_Osaka-Katie_Boulter,2,B-IO,4,4,0,2,2,2,2
20180705-W-Wimbledon-R64-Naomi_Osaka-Katie_Boulter,2,S-XC,1,1,0,0,1,0,1
20180705-W-Wimbledon-R64-Naomi_Osaka-Katie_Boulter,2,S-DTM,5,0,0,0,0,2,3
20180705-W-Wimbledon-R64-Naomi_Osaka-Katie_Boulter,2,S-DTL,1,0,0,0,0,0,1
20190202-W-St_Petersburg-SF-Vera_Zvonareva-Donna_Vekic,1,F-XC,23,5,0,3,2,11,12
20190202-W-St_Petersburg-SF-Vera_Zvonareva-Donna_Vekic,1,F-DTM,22,2,0,0,2,11,11
20190202-W-St_Petersburg-SF-Vera_Zvonareva-Donna_Vekic,1,F-DTL,19,2,1,0,1,8,11
20190202-W-St_Petersburg-SF-Vera_Zvonareva-Donna_Vekic,1,F-IO,14,2,0,0,2,3,11
20190202-W-St_Petersburg-SF-Vera_Zvonareva-Donna_Vekic,1,B-XC,33,8,2,2,4,15,18
20190202-W-St_Petersburg-SF-Vera_Zvonareva-Donna_Vekic,1,B-DTM,19,2,0,1,1,8,11
20190202-W-St_Petersburg-SF-Vera_Zvonareva-Donna_Vekic,1,B-DTL,12,3,1,0,2,2,10
20190202-W-St_Petersburg-SF-Vera_Zvonareva-Donna_Vekic,1,B-IO,4,1,0,0,1,1,3
20190202-W-St_Petersburg-SF-Vera_Zvonareva-Donna_Vekic,1,S-XC,5,0,0,0,0,0,5
20190202-W-St_Petersburg-SF-Vera_Zvonareva-Donna_Vekic,1,S-DTM,1,0,0,0,0,0,1
20190202-W-St_Petersburg-SF-Vera_Zvonareva-Donna_Vekic,1,S-DTL,7,0,0,0,0,3,4
20190202-W-St_Petersburg-SF-Vera_Zvonareva-Donna_Vekic,2,F-XC,35,6,5,0,1,24,11
20190202-W-St_Petersburg-SF-Vera_Zvonareva-Donna_Vekic,2,F-DTM,12,1,0,0,1,8,4
20190202-W-St_Petersburg-SF-Vera_Zvonareva-Donna_Vekic,2,F-DTL,14,5,1,2,2,7,7
20190202-W-St_Petersburg-SF-Vera_Zvonareva-Donna_Vekic,2,F-IO,28,12,5,2,5,19,9
20190202-W-St_Petersburg-SF-Vera_Zvonareva-Donna_Vekic,2,F-II,1,0,0,0,0,0,1
20190202-W-St_Petersburg-SF-Vera_Zvonareva-Donna_Vekic,2,B-XC,35,8,2,3,3,23,12
20190202-W-St_Petersburg-SF-Vera_Zvonareva-Donna_Vekic,2,B-DTM,21,1,0,0,1,13,8
20190202-W-St_Petersburg-SF-Vera_Zvonareva-Donna_Vekic,2,B-DTL,13,2,0,2,0,9,4
20190202-W-St_Petersburg-SF-Vera_Zvonareva-Donna_Vekic,2,B-IO,7,2,0,1,1,2,5
20190202-W-St_Petersburg-SF-Vera_Zvonareva-Donna_Vekic,2,S-XC,1,0,0,0,0,1,0
20100603-W-Roland_Garros-SF-Samantha_Stosur-Jelena_Jankovic,1,F-XC,16,7,2,4,1,10,6
20100603-W-Roland_Garros-SF-Samantha_Stosur-Jelena_Jankovic,1,F-DTM,4,1,0,0,1,1,3
20100603-W-Roland_Garros-SF-Samantha_Stosur-Jelena_Jankovic,1,F-DTL,6,4,2,0,2,3,3
20100603-W-Roland_Garros-SF-Samantha_Stosur-Jelena_Jankovic,1,F-IO,19,4,2,1,1,9,10
20100603-W-Roland_Garros-SF-Samantha_Stosur-Jelena_Jankovic,1,F-II,2,2,1,0,1,1,1
20100603-W-Roland_Garros-SF-Samantha_Stosur-Jelena_Jankovic,1,B-XC,12,4,1,1,2,6,6
20100603-W-Roland_Garros-SF-Samantha_Stosur-Jelena_Jankovic,1,B-DTM,9,0,0,0,0,5,4
20100603-W-Roland_Garros-SF-Samantha_Stosur-Jelena_Jankovic,1,B-DTL,5,3,1,2,0,5,0
20100603-W-Roland_Garros-SF-Samantha_Stosur-Jelena_Jankovic,1,S-XC,6,1,0,0,1,2,4
20100603-W-Roland_Garros-SF-Samantha_Stosur-Jelena_Jankovic,1,S-DTM,3,0,0,0,0,1,2
20100603-W-Roland_Garros-SF-Samantha_Stosur-Jelena_Jankovic,1,S-DTL,3,1,0,1,0,1,2
20100603-W-Roland_Garros-SF-Samantha_Stosur-Jelena_Jankovic,1,S-IO,1,0,0,0,0,0,1
20100603-W-Roland_Garros-SF-Samantha_Stosur-Jelena_Jankovic,2,F-XC,12,5,0,2,3,6,6
20100603-W-Roland_Garros-SF-Samantha_Stosur-Jelena_Jankovic,2,F-DTM,2,0,0,0,0,2,0
20100603-W-Roland_Garros-SF-Samantha_Stosur-Jelena_Jankovic,2,F-DTL,6,3,1,0,2,3,3
20100603-W-Roland_Garros-SF-Samantha_Stosur-Jelena_Jankovic,2,F-IO,19,6,1,0,5,7,12
20100603-W-Roland_Garros-SF-Samantha_Stosur-Jelena_Jankovic,2,B-XC,23,4,0,2,2,14,9
20100603-W-Roland_Garros-SF-Samantha_Stosur-Jelena_Jankovic,2,B-DTM,9,0,0,0,0,6,3
20100603-W-Roland_Garros-SF-Samantha_Stosur-Jelena_Jankovic,2,B-DTL,8,4,2,1,1,5,3
20100603-W-Roland_Garros-SF-Samantha_Stosur-Jelena_Jankovic,2,B-IO,1,0,0,0,0,0,1
20100603-W-Roland_Garros-SF-Samantha_Stosur-Jelena_Jankovic,2,S-XC,4,0,0,0,0,0,4
20100603-W-Roland_Garros-SF-Samantha_Stosur-Jelena_Jankovic,2,S-DTM,2,0,0,0,0,2,0
20190115-W-Australian_Open-R128-Veronika_Kudermetova-Sofia_Kenin,1,F-XC,39,8,3,2,3,14,25
20190115-W-Australian_Open-R128-Veronika_Kudermetova-Sofia_Kenin,1,F-DTM,36,3,0,0,3,11,25
20190115-W-Australian_Open-R128-Veronika_Kudermetova-Sofia_Kenin,1,F-DTL,5,5,2,0,3,2,3
20190115-W-Australian_Open-R128-Veronika_Kudermetova-Sofia_Kenin,1,F-IO,19,11,1,3,7,7,12
20190115-W-Australian_Open-R128-Veronika_Kudermetova-Sofia_Kenin,1,B-XC,27,7,2,1,4,16,11
20190115-W-Australian_Open-R128-Veronika_Kudermetova-Sofia_Kenin,1,B-DTM,45,6,0,1,5,17,28
20190115-W-Australian_Open-R128-Veronika_Kudermetova-Sofia_Kenin,1,B-DTL,12,8,4,0,4,5,7
20190115-W-Australian_Open-R128-Veronika_Kudermetova-Sofia_Kenin,1,B-IO,16,7,3,0,4,5,11
20190115-W-Australian_Open-R128-Veronika_Kudermetova-Sofia_Kenin,1,S-XC,10,0,0,0,0,7,3
20190115-W-Australian_Open-R128-Veronika_Kudermetova-Sofia_Kenin,1,S-DTM,3,0,0,0,0,1,2
20190115-W-Australian_Open-R128-Veronika_Kudermetova-Sofia_Kenin,1,S-DTL,1,0,0,0,0,1,0
20190115-W-Australian_Open-R128-Veronika_Kudermetova-Sofia_Kenin,1,S-IO,1,0,0,0,0,0,1
20190115-W-Australian_Open-R128-Veronika_Kudermetova-Sofia_Kenin,2,F-XC,37,10,3,5,2,28,9
20190115-W-Australian_Open-R128-Veronika_Kudermetova-Sofia_Kenin,2,F-DTM,53,8,0,1,7,29,24
20190115-W-Australian_Open-R128-Veronika_Kudermetova-Sofia_Kenin,2,F-DTL,7,2,2,0,0,4,3
20190115-W-Australian_Open-R128-Veronika_Kudermetova-Sofia_Kenin,2,F-IO,9,2,0,0,2,4,5
20190115-W-Australian_Open-R128-Veronika_Kudermetova-Sofia_Kenin,2,B-XC,35,8,1,3,4,20,15
20190115-W-Australian_Open-R128-Veronika_Kudermetova-Sofia_Kenin,2,B-DTM,42,4,1,0,3,23,19
20190115-W-Australian_Open-R128-Veronika_Kudermetova-Sofia_Kenin,2,B-DTL,7,5,2,1,2,3,4
20190115-W-Australian_Open-R128-Veronika_Kudermetova-Sofia_Kenin,2,B-IO,7,4,2,2,0,7,0
20190115-W-Australian_Open-R128-Veronika_Kudermetova-Sofia_Kenin,2,S-XC,3,1,1,0,0,1,2
20190115-W-Australian_Open-R128-Veronika_Kudermetova-Sofia_Kenin,2,S-DTM,8,0,0,0,0,3,5
20190115-W-Australian_Open-R128-Veronika_Kudermetova-Sofia_Kenin,2,S-DTL,1,0,0,0,0,0,1
20190201-W-St_Petersburg-QF-Aryna_Sabalenka-Ekaterina_Alexandrova,1,F-XC,37,17,5,4,8,18,19
20190201-W-St_Petersburg-QF-Aryna_Sabalenka-Ekaterina_Alexandrova,1,F-DTM,21,2,0,0,2,9,12
20190201-W-St_Petersburg-QF-Aryna_Sabalenka-Ekaterina_Alexandrova,1,F-DTL,12,6,2,1,3,6,6
20190201-W-St_Petersburg-QF-Aryna_Sabalenka-Ekaterina_Alexandrova,1,F-IO,8,4,0,3,1,5,3
20190201-W-St_Petersburg-QF-Aryna_Sabalenka-Ekaterina_Alexandrova,1,B-XC,29,9,3,4,2,20,9
20190201-W-St_Petersburg-QF-Aryna_Sabalenka-Ekaterina_Alexandrova,1,B-DTM,11,2,0,0,2,3,8
20190201-W-St_Petersburg-QF-Aryna_Sabalenka-Ekaterina_Alexandrova,1,B-DTL,5,3,2,1,0,5,0
20190201-W-St_Petersburg-QF-Aryna_Sabalenka-Ekaterina_Alexandrova,1,B-IO,3,2,2,0,0,2,1
20190201-W-St_Petersburg-QF-Aryna_Sabalenka-Ekaterina_Alexandrova,1,S-XC,1,0,0,0,0,1,0
20190201-W-St_Petersburg-QF-Aryna_Sabalenka-Ekaterina_Alexandrova,1,S-DTM,1,0,0,0,0,0,1
20190201-W-St_Petersburg-QF-Aryna_Sabalenka-Ekaterina_Alexandrova,2,F-XC,24,7,1,1,5,15,9
20190201-W-St_Petersburg-QF-Aryna_Sabalenka-Ekaterina_Alexandrova,2,F-DTM,8,3,0,2,1,5,3
20190201-W-St_Petersburg-QF-Aryna_Sabalenka-Ekaterina_Alexandrova,2,F-DTL,6,4,3,0,1,4,2
20190201-W-St_Petersburg-QF-Aryna_Sabalenka-Ekaterina_Alexandrova,2,F-IO,10,4,1,0,3,3,7
20190201-W-St_Petersburg-QF-Aryna_Sabalenka-Ekaterina_Alexandrova,2,F-II,2,1,0,1,0,2,0
20190201-W-St_Petersburg-QF-Aryna_Sabalenka-Ekaterina_Alexandrova,2,B-XC,25,8,6,0,2,12,13
20190201-W-St_Petersburg-QF-Aryna_Sabalenka-Ekaterina_Alexandrova,2,B-DTM,29,3,0,0,3,12,17
20190201-W-St_Petersburg-QF-Aryna_Sabalenka-Ekaterina_Alexandrova,2,B-DTL,11,3,2,0,1,6,5
20190201-W-St_Petersburg-QF-Aryna_Sabalenka-Ekaterina_Alexandrova,2,B-IO,8,3,2,0,1,6,2
20180702-W-Wimbledon-R128-Donna_Vekic-Sloane_Stephens,1,F-XC,19,5,1,3,1,13,6
20180702-W-Wimbledon-R128-Donna_Vekic-Sloane_Stephens,1,F-DTM,30,1,0,1,0,17,13
20180702-W-Wimbledon-R128-Donna_Vekic-Sloane_Stephens,1,F-DTL,8,3,1,1,1,5,3
20180702-W-Wimbledon-R128-Donna_Vekic-Sloane_Stephens,1,F-IO,13,5,2,0,3,6,7
20180702-W-Wimbledon-R128-Donna_Vekic-Sloane_Stephens,1,F-II,2,1,0,1,0,2,0
20180702-W-Wimbledon-R128-Donna_Vekic-Sloane_Stephens,1,B-XC,28,7,2,4,1,18,10
20180702-W-Wimbledon-R128-Donna_Vekic-Sloane_Stephens,1,B-DTM,25,1,0,0,1,13,12
20180702-W-Wimbledon-R128-Donna_Vekic-Sloane_Stephens,1,B-DTL,2,2,1,0,1,1,1
20180702-W-Wimbledon-R128-Donna_Vekic-Sloane_Stephens,1,B-IO,6,4,3,1,0,6,0
20180702-W-Wimbledon-R128-Donna_Vekic-Sloane_Stephens,1,S-DTM,1,0,0,0,0,0,1
20180702-W-Wimbledon-R128-Donna_Vekic-Sloane_Stephens,2,F-XC,29,9,0,2,7,10,19
20180702-W-Wimbledon-R128-Donna_Vekic-Sloane_Stephens,2,F-DTM,24,4,0,1,3,10,14
20180702-W-Wimbledon-R128-Donna_Vekic-Sloane_Stephens,2,F-DTL,5,1,0,0,1,1,4
20180702-W-Wimbledon-R128-Donna_Vekic-Sloane_Stephens,2,F-IO,28,8,4,1,3,16,12
20180702-W-Wimbledon-R128-Donna_Vekic-Sloane_Stephens,2,B-XC,24,6,1,1,4,7,17
20180702-W-Wimbledon-R128-Donna_Vekic-Sloane_Stephens,2,B-DTM,27,3,2,0,1,18,9
20180702-W-Wimbledon-R128-Donna_Vekic-Sloane_Stephens,2,B-DTL,8,3,0,2,1,2,6
20180702-W-Wimbledon-R128-Donna_Vekic-Sloane_Stephens,2,B-IO,9,3,0,0,3,1,8
20180702-W-Wimbledon-R128-Donna_Vekic-Sloane_Stephens,2,S-DTM,1,0,0,0,0,0,1
20170211-W-Fed_Cup_World_Group_QF-RR-Aliaksandra_Sasnovich-Michaella_Krajicek,1,F-XC,32,8,2,3,3,21,11
20170211-W-Fed_Cup_World_Group_QF-RR-Aliaksandra_Sasnovich-Michaella_Krajicek,1,F-DTM,37,4,0,1,3,18,19
20170211-W-Fed_Cup_World_Group_QF-RR-Aliaksandra_Sasnovich-Michaella_Krajicek,1,F-DTL,10,6,2,2,2,7,3
20170211-W-Fed_Cup_World_Group_QF-RR-Aliaksandra_Sasnovich-Michaella_Krajicek,1,F-IO,15,9,6,0,3,9,6
20170211-W-Fed_Cup_World_Group_QF-RR-Aliaksandra_Sasnovich-Michaella_Krajicek,1,B-XC,33,10,5,3,2,24,9
20170211-W-Fed_Cup_World_Group_QF-RR-Aliaksandra_Sasnovich-Michaella_Krajicek,1,B-DTM,28,5,0,1,4,18,10
20170211-W-Fed_Cup_World_Group_QF-RR-Aliaksandra_Sasnovich-Michaella_Krajicek,1,B-DTL,3,3,1,0,2,1,2
20170211-W-Fed_Cup_World_Group_QF-RR-Aliaksandra_Sasnovich-Michaella_Krajicek,1,B-IO,8,6,3,1,2,5,3
20170211-W-Fed_Cup_World_Group_QF-RR-Aliaksandra_Sasnovich-Michaella_Krajicek,1,S-XC,3,0,0,0,0,1,2
20170211-W-Fed_Cup_World_Group_QF-RR-Aliaksandra_Sasnovich-Michaella_Krajicek,1,S-DTM,1,0,0,0,0,0,1
20170211-W-Fed_Cup_World_Group_QF-RR-Aliaksandra_Sasnovich-Michaella_Krajicek,2,F-XC,33,7,3,1,3,16,17
20170211-W-Fed_Cup_World_Group_QF-RR-Aliaksandra_Sasnovich-Michaella_Krajicek,2,F-DTM,21,5,1,0,4,9,12
20170211-W-Fed_Cup_World_Group_QF-RR-Aliaksandra_Sasnovich-Michaella_Krajicek,2,F-DTL,7,7,2,1,4,3,4
20170211-W-Fed_Cup_World_Group_QF-RR-Aliaksandra_Sasnovich-Michaella_Krajicek,2,F-IO,11,6,4,1,1,7,4
20170211-W-Fed_Cup_World_Group_QF-RR-Aliaksandra_Sasnovich-Michaella_Krajicek,2,B-XC,31,8,1,3,4,11,20
20170211-W-Fed_Cup_World_Group_QF-RR-Aliaksandra_Sasnovich-Michaella_Krajicek,2,B-DTM,35,3,0,0,3,12,23
20170211-W-Fed_Cup_World_Group_QF-RR-Aliaksandra_Sasnovich-Michaella_Krajicek,2,B-DTL,6,1,0,1,0,5,1
20170211-W-Fed_Cup_World_Group_QF-RR-Aliaksandra_Sasnovich-Michaella_Krajicek,2,B-IO,7,1,0,0,1,0,7
20170211-W-Fed_Cup_World_Group_QF-RR-Aliaksandra_Sasnovich-Michaella_Krajicek,2,S-XC,2,1,0,1,0,1,1
20170211-W-Fed_Cup_World_Group_QF-RR-Aliaksandra_Sasnovich-Michaella_Krajicek,2,S-DTM,9,3,0,0,3,2,7
20170211-W-Fed_Cup_World_Group_QF-RR-Aliaksandra_Sasnovich-Michaella_Krajicek,2,S-DTL,4,1,0,0,1,0,4
20170211-W-Fed_Cup_World_Group_QF-RR-Aliaksandra_Sasnovich-Michaella_Krajicek,2,S-IO,1,0,0,0,0,0,1
20180413-W-ITF_Osaka-QF-Rebecca_Marino-Kurumi_Nara,1,F-XC,66,16,6,3,7,38,28
20180413-W-ITF_Osaka-QF-Rebecca_Marino-Kurumi_Nara,1,F-DTM,68,12,0,0,12,32,36
20180413-W-ITF_Osaka-QF-Rebecca_Marino-Kurumi_Nara,1,F-DTL,4,3,2,0,1,3,1
20180413-W-ITF_Osaka-QF-Rebecca_Marino-Kurumi_Nara,1,F-IO,21,10,4,2,4,12,9
20180413-W-ITF_Osaka-QF-Rebecca_Marino-Kurumi_Nara,1,B-XC,16,3,1,0,2,10,6
20180413-W-ITF_Osaka-QF-Rebecca_Marino-Kurumi_Nara,1,B-DTM,50,5,0,1,4,25,25
20180413-W-ITF_Osaka-QF-Rebecca_Marino-Kurumi_Nara,1,B-DTL,6,0,0,0,0,4,2
20180413-W-ITF_Osaka-QF-Rebecca_Marino-Kurumi_Nara,1,B-IO,7,2,0,0,2,2,5
20180413-W-ITF_Osaka-QF-Rebecca_Marino-Kurumi_Nara,1,S-XC,3,2,0,0,2,1,2
20180413-W-ITF_Osaka-QF-Rebecca_Marino-Kurumi_Nara,1,S-DTM,6,0,0,0,0,2,4
20180413-W-ITF_Osaka-QF-Rebecca_Marino-Kurumi_Nara,1,S-DTL,3,1,0,0,1,1,2
20180413-W-ITF_Osaka-QF-Rebecca_Marino-Kurumi_Nara,1,S-IO,3,0,0,0,0,2,1
20180413-W-ITF_Osaka-QF-Rebecca_Marino-Kurumi_Nara,2,F-XC,50,11,3,3,5,26,24
20180413-W-ITF_Osaka-QF-Rebecca_Marino-Kurumi_Nara,2,F-DTM,70,5,0,0,5,32,38
20180413-W-ITF_Osaka-QF-Rebecca_Marino-Kurumi_Nara,2,F-DTL,8,1,0,0,1,3,5
20180413-W-ITF_Osaka-QF-Rebecca_Marino-Kurumi_Nara,2,F-IO,10,2,2,0,0,6,4
20180413-W-ITF_Osaka-QF-Rebecca_Marino-Kurumi_Nara,2,B-XC,28,4,0,1,3,11,17
20180413-W-ITF_Osaka-QF-Rebecca_Marino-Kurumi_Nara,2,B-DTM,54,5,0,0,5,22,32
20180413-W-ITF_Osaka-QF-Rebecca_Marino-Kurumi_Nara,2,B-DTL,1,1,0,0,1,0,1
20180413-W-ITF_Osaka-QF-Rebecca_Marino-Kurumi_Nara,2,B-IO,7,0,0,0,0,2,5
20180413-W-ITF_Osaka-QF-Rebecca_Marino-Kurumi_Nara,2,S-XC,1,0,0,0,0,1,0
20190210-W-Fed_Cup_World_Group_II-RR-Arantxa_Rus-Bianca_Andreescu,1,F-XC,22,3,0,1,2,9,13
20190210-W-Fed_Cup_World_Group_II-RR-Arantxa_Rus-Bianca_Andreescu,1,F-DTM,33,2,0,0,2,13,20
20190210-W-Fed_Cup_World_Group_II-RR-Arantxa_Rus-Bianca_Andreescu,1,F-DTL,1,0,0,0,0,0,1
20190210-W-Fed_Cup_World_Group_II-RR-Arantxa_Rus-Bianca_Andreescu,1,F-IO,7,3,2,0,1,3,4
20190210-W-Fed_Cup_World_Group_II-RR-Arantxa_Rus-Bianca_Andreescu,1,F-II,1,0,0,0,0,0,1
20190210-W-Fed_Cup_World_Group_II-RR-Arantxa_Rus-Bianca_Andreescu,1,B-XC,10,2,1,1,0,5,5
20190210-W-Fed_Cup_World_Group_II-RR-Arantxa_Rus-Bianca_Andreescu,1,B-DTM,40,8,0,0,8,10,30
20190210-W-Fed_Cup_World_Group_II-RR-Arantxa_Rus-Bianca_Andreescu,1,B-DTL,8,3,0,0,3,2,6
20190210-W-Fed_Cup_World_Group_II-RR-Arantxa_Rus-Bianca_Andreescu,1,B-IO,5,0,0,0,0,2,3
20190210-W-Fed_Cup_World_Group_II-RR-Arantxa_Rus-Bianca_Andreescu,1,S-XC,3,1,0,0,1,0,3
20190210-W-Fed_Cup_World_Group_II-RR-Arantxa_Rus-Bianca_Andreescu,1,S-DTM,5,0,0,0,0,0,5
20190210-W-Fed_Cup_World_Group_II-RR-Arantxa_Rus-Bianca_Andreescu,1,S-IO,1,1,0,0,1,0,1
20190210-W-Fed_Cup_World_Group_II-RR-Arantxa_Rus-Bianca_Andreescu,2,F-XC,28,11,1,5,5,20,8
20190210-W-Fed_Cup_World_Group_II-RR-Arantxa_Rus-Bianca_Andreescu,2,F-DTM,25,3,0,1,2,14,11
20190210-W-Fed_Cup_World_Group_II-RR-Arantxa_Rus-Bianca_Andreescu,2,F-DTL,3,3,2,0,1,2,1
20190210-W-Fed_Cup_World_Group_II-RR-Arantxa_Rus-Bianca_Andreescu,2,F-IO,4,2,2,0,0,2,2
20190210-W-Fed_Cup_World_Group_II-RR-Arantxa_Rus-Bianca_Andreescu,2,B-XC,13,7,0,4,3,8,5
20190210-W-Fed_Cup_World_Group_II-RR-Arantxa_Rus-Bianca_Andreescu,2,B-DTM,37,5,0,1,4,22,15
20190210-W-Fed_Cup_World_Group_II-RR-Arantxa_Rus-Bianca_Andreescu,2,B-DTL,6,1,0,0,1,3,3
20190210-W-Fed_Cup_World_Group_II-RR-Arantxa_Rus-Bianca_Andreescu,2,B-IO,6,2,1,0,1,5,1
20190210-W-Fed_Cup_World_Group_II-RR-Arantxa_Rus-Bianca_Andreescu,2,S-XC,1,1,0,0,1,0,1
20190210-W-Fed_Cup_World_Group_II-RR-Arantxa_Rus-Bianca_Andreescu,2,S-DTM,8,0,0,0,0,4,4
20190210-W-Fed_Cup_World_Group_II-RR-Arantxa_Rus-Bianca_Andreescu,2,S-DTL,1,0,0,0,0,1,0
20190210-W-Fed_Cup_World_Group_II-RR-Arantxa_Rus-Bianca_Andreescu,2,S-IO,2,0,0,0,0,2,0
20190131-W-St_Petersburg-R16-Aryna_Sabalenka-Alison_Van_Uytvanck,1,F-XC,18,5,4,0,1,10,8
20190131-W-St_Petersburg-R16-Aryna_Sabalenka-Alison_Van_Uytvanck,1,F-DTM,8,1,0,0,1,3,5
20190131-W-St_Petersburg-R16-Aryna_Sabalenka-Alison_Van_Uytvanck,1,F-DTL,7,2,1,0,1,3,4
20190131-W-St_Petersburg-R16-Aryna_Sabalenka-Alison_Van_Uytvanck,1,F-IO,8,3,0,1,2,5,3
20190131-W-St_Petersburg-R16-Aryna_Sabalenka-Alison_Van_Uytvanck,1,B-XC,29,12,2,3,6,14,15
20190131-W-St_Petersburg-R16-Aryna_Sabalenka-Alison_Van_Uytvanck,1,B-DTM,14,2,0,2,0,6,8
20190131-W-St_Petersburg-R16-Aryna_Sabalenka-Alison_Van_Uytvanck,1,B-DTL,6,3,2,1,0,4,2
20190131-W-St_Petersburg-R16-Aryna_Sabalenka-Alison_Van_Uytvanck,1,B-IO,3,3,2,0,1,2,1
20190131-W-St_Petersburg-R16-Aryna_Sabalenka-Alison_Van_Uytvanck,1,S-XC,2,0,0,0,0,0,2
20190131-W-St_Petersburg-R16-Aryna_Sabalenka-Alison_Van_Uytvanck,1,S-DTM,5,0,0,0,0,3,2
20190131-W-St_Petersburg-R16-Aryna_Sabalenka-Alison_Van_Uytvanck,1,S-DTL,1,0,0,0,0,0,1
20190131-W-St_Petersburg-R16-Aryna_Sabalenka-Alison_Van_Uytvanck,1,S-IO,1,1,0,1,0,1,0
20190131-W-St_Petersburg-R16-Aryna_Sabalenka-Alison_Van_Uytvanck,2,F-XC,11,4,1,2,1,6,5
20190131-W-St_Petersburg-R16-Aryna_Sabalenka-Alison_Van_Uytvanck,2,F-DTM,13,1,0,1,0,6,7
20190131-W-St_Petersburg-R16-Aryna_Sabalenka-Alison_Van_Uytvanck,2,F-DTL,2,0,0,0,0,2,0
20190131-W-St_Petersburg-R16-Aryna_Sabalenka-Alison_Van_Uytvanck,2,F-IO,8,5,3,1,1,6,2
20190131-W-St_Petersburg-R16-Aryna_Sabalenka-Alison_Van_Uytvanck,2,B-XC,19,4,1,1,2,9,10
20190131-W-St_Petersburg-R16-Aryna_Sabalenka-Alison_Van_Uytvanck,2,B-DTM,13,2,0,2,0,6,7
20190131-W-St_Petersburg-R16-Aryna_Sabalenka-Alison_Van_Uytvanck,2,B-DTL,6,1,0,0,1,3,3
20190131-W-St_Petersburg-R16-Aryna_Sabalenka-Alison_Van_Uytvanck,2,B-IO,2,0,0,0,0,1,1
20190131-W-St_Petersburg-R16-Aryna_Sabalenka-Alison_Van_Uytvanck,2,S-XC,5,0,0,0,0,5,0
20190131-W-St_Petersburg-R16-Aryna_Sabalenka-Alison_Van_Uytvanck,2,S-DTM,6,0,0,0,0,3,3
20120607-W-Roland_Garros-SF-Samantha_Stosur-Sara_Errani,1,F-XC,36,8,6,1,1,14,22
20120607-W-Roland_Garros-SF-Samantha_Stosur-Sara_Errani,1,F-DTM,23,3,0,1,2,8,15
20120607-W-Roland_Garros-SF-Samantha_Stosur-Sara_Errani,1,F-DTL,17,2,1,0,1,5,12
20120607-W-Roland_Garros-SF-Samantha_Stosur-Sara_Errani,1,F-IO,54,15,6,4,5,30,24
20120607-W-Roland_Garros-SF-Samantha_Stosur-Sara_Errani,1,F-II,14,9,3,0,6,3,11
20120607-W-Roland_Garros-SF-Samantha_Stosur-Sara_Errani,1,B-XC,17,6,0,0,6,6,11
20120607-W-Roland_Garros-SF-Samantha_Stosur-Sara_Errani,1,B-DTM,26,5,0,0,5,9,17
20120607-W-Roland_Garros-SF-Samantha_Stosur-Sara_Errani,1,B-DTL,21,10,3,1,6,10,11
20120607-W-Roland_Garros-SF-Samantha_Stosur-Sara_Errani,1,B-IO,3,1,1,0,0,2,1
20120607-W-Roland_Garros-SF-Samantha_Stosur-Sara_Errani,1,S-XC,16,1,0,0,1,5,11
20120607-W-Roland_Garros-SF-Samantha_Stosur-Sara_Errani,1,S-DTM,13,0,0,0,0,2,11
20120607-W-Roland_Garros-SF-Samantha_Stosur-Sara_Errani,1,S-DTL,6,2,0,1,1,1,5
20120607-W-Roland_Garros-SF-Samantha_Stosur-Sara_Errani,1,S-IO,1,0,0,0,0,1,0
20120607-W-Roland_Garros-SF-Samantha_Stosur-Sara_Errani,2,F-XC,51,16,5,8,3,39,12
20120607-W-Roland_Garros-SF-Samantha_Stosur-Sara_Errani,2,F-DTM,21,1,0,0,1,11,10
20120607-W-Roland_Garros-SF-Samantha_Stosur-Sara_Errani,2,F-DTL,18,3,2,0,1,12,6
20120607-W-Roland_Garros-SF-Samantha_Stosur-Sara_Errani,2,F-IO,38,8,5,2,1,30,8
20120607-W-Roland_Garros-SF-Samantha_Stosur-Sara_Errani,2,F-II,10,6,3,2,1,8,2
20120607-W-Roland_Garros-SF-Samantha_Stosur-Sara_Errani,2,B-XC,58,9,0,2,7,33,25
20120607-W-Roland_Garros-SF-Samantha_Stosur-Sara_Errani,2,B-DTM,18,1,0,1,0,12,6
20120607-W-Roland_Garros-SF-Samantha_Stosur-Sara_Errani,2,B-DTL,6,2,1,0,1,5,1
20120607-W-Roland_Garros-SF-Samantha_Stosur-Sara_Errani,2,B-IO,1,0,0,0,0,1,0
20120607-W-Roland_Garros-SF-Samantha_Stosur-Sara_Errani,2,S-XC,6,0,0,0,0,3,3
20120607-W-Roland_Garros-SF-Samantha_Stosur-Sara_Errani,2,S-DTM,3,0,0,0,0,0,3
20120607-W-Roland_Garros-SF-Samantha_Stosur-Sara_Errani,2,S-DTL,4,0,0,0,0,3,1
20190202-W-St_Petersburg-SF-Aryna_Sabalenka-Kiki_Bertens,1,F-XC,45,12,2,7,3,21,24
20190202-W-St_Petersburg-SF-Aryna_Sabalenka-Kiki_Bertens,1,F-DTM,6,0,0,0,0,3,3
20190202-W-St_Petersburg-SF-Aryna_Sabalenka-Kiki_Bertens,1,F-DTL,13,4,0,1,3,4,9
20190202-W-St_Petersburg-SF-Aryna_Sabalenka-Kiki_Bertens,1,F-IO,21,7,2,0,5,10,11
20190202-W-St_Petersburg-SF-Aryna_Sabalenka-Kiki_Bertens,1,F-II,2,1,1,0,0,2,0
20190202-W-St_Petersburg-SF-Aryna_Sabalenka-Kiki_Bertens,1,B-XC,35,12,1,3,8,16,19
20190202-W-St_Petersburg-SF-Aryna_Sabalenka-Kiki_Bertens,1,B-DTM,12,1,0,0,1,4,8
20190202-W-St_Petersburg-SF-Aryna_Sabalenka-Kiki_Bertens,1,B-DTL,8,5,3,2,0,7,1
20190202-W-St_Petersburg-SF-Aryna_Sabalenka-Kiki_Bertens,1,B-IO,3,2,0,0,2,1,2
20190202-W-St_Petersburg-SF-Aryna_Sabalenka-Kiki_Bertens,1,S-DTM,1,0,0,0,0,0,1
20190202-W-St_Petersburg-SF-Aryna_Sabalenka-Kiki_Bertens,1,S-DTL,1,0,0,0,0,0,1
20190202-W-St_Petersburg-SF-Aryna_Sabalenka-Kiki_Bertens,2,F-XC,25,6,2,2,2,16,9
20190202-W-St_Petersburg-SF-Aryna_Sabalenka-Kiki_Bertens,2,F-DTM,11,2,1,0,1,6,5
20190202-W-St_Petersburg-SF-Aryna_Sabalenka-Kiki_Bertens,2,F-DTL,21,11,4,2,5,11,10
20190202-W-St_Petersburg-SF-Aryna_Sabalenka-Kiki_Bertens,2,F-IO,11,8,3,2,3,8,3
20190202-W-St_Petersburg-SF-Aryna_Sabalenka-Kiki_Bertens,2,F-II,1,0,0,0,0,1,0
20190202-W-St_Petersburg-SF-Aryna_Sabalenka-Kiki_Bertens,2,B-XC,21,5,1,1,3,10,11
20190202-W-St_Petersburg-SF-Aryna_Sabalenka-Kiki_Bertens,2,B-DTM,25,3,0,0,3,13,12
20190202-W-St_Petersburg-SF-Aryna_Sabalenka-Kiki_Bertens,2,B-DTL,9,2,0,0,2,3,6
20190202-W-St_Petersburg-SF-Aryna_Sabalenka-Kiki_Bertens,2,B-IO,3,2,2,0,0,2,1
20190202-W-St_Petersburg-SF-Aryna_Sabalenka-Kiki_Bertens,2,S-XC,4,1,0,0,1,2,2
20190202-W-St_Petersburg-SF-Aryna_Sabalenka-Kiki_Bertens,2,S-DTM,4,0,0,0,0,3,1
20190202-W-St_Petersburg-SF-Aryna_Sabalenka-Kiki_Bertens,2,S-IO,1,0,0,0,0,1,0
20170401-W-ITF_Santa_Margherita_Di_Pula-F-Bianca_Andreescu-Bernarda_Pera,1,F-XC,63,17,5,3,9,33,30
20170401-W-ITF_Santa_Margherita_Di_Pula-F-Bianca_Andreescu-Bernarda_Pera,1,F-DTM,65,10,0,1,9,26,39
20170401-W-ITF_Santa_Margherita_Di_Pula-F-Bianca_Andreescu-Bernarda_Pera,1,F-DTL,10,4,1,0,3,6,4
20170401-W-ITF_Santa_Margherita_Di_Pula-F-Bianca_Andreescu-Bernarda_Pera,1,F-IO,22,8,3,1,4,10,12
20170401-W-ITF_Santa_Margherita_Di_Pula-F-Bianca_Andreescu-Bernarda_Pera,1,B-XC,44,12,4,4,4,21,23
20170401-W-ITF_Santa_Margherita_Di_Pula-F-Bianca_Andreescu-Bernarda_Pera,1,B-DTM,74,7,0,0,7,29,45
20170401-W-ITF_Santa_Margherita_Di_Pula-F-Bianca_Andreescu-Bernarda_Pera,1,B-DTL,12,1,0,0,1,5,7
20170401-W-ITF_Santa_Margherita_Di_Pula-F-Bianca_Andreescu-Bernarda_Pera,1,B-IO,12,3,0,0,3,4,8
20170401-W-ITF_Santa_Margherita_Di_Pula-F-Bianca_Andreescu-Bernarda_Pera,1,S-XC,1,0,0,0,0,0,1
20170401-W-ITF_Santa_Margherita_Di_Pula-F-Bianca_Andreescu-Bernarda_Pera,1,S-DTM,5,0,0,0,0,1,4
20170401-W-ITF_Santa_Margherita_Di_Pula-F-Bianca_Andreescu-Bernarda_Pera,1,S-DTL,3,0,0,0,0,2,1
20170401-W-ITF_Santa_Margherita_Di_Pula-F-Bianca_Andreescu-Bernarda_Pera,1,S-IO,3,0,0,0,0,0,3
20170401-W-ITF_Santa_Margherita_Di_Pula-F-Bianca_Andreescu-Bernarda_Pera,2,F-XC,92,19,4,7,8,57,35
20170401-W-ITF_Santa_Margherita_Di_Pula-F-Bianca_Andreescu-Bernarda_Pera,2,F-DTM,86,12,2,2,8,46,40
20170401-W-ITF_Santa_Margherita_Di_Pula-F-Bianca_Andreescu-Bernarda_Pera,2,F-DTL,8,4,2,1,1,3,5
20170401-W-ITF_Santa_Margherita_Di_Pula-F-Bianca_Andreescu-Bernarda_Pera,2,F-IO,23,9,3,1,5,15,8
20170401-W-ITF_Santa_Margherita_Di_Pula-F-Bianca_Andreescu-Bernarda_Pera,2,B-XC,35,6,2,1,3,20,15
20170401-W-ITF_Santa_Margherita_Di_Pula-F-Bianca_Andreescu-Bernarda_Pera,2,B-DTM,67,10,0,4,6,36,31
20170401-W-ITF_Santa_Margherita_Di_Pula-F-Bianca_Andreescu-Bernarda_Pera,2,B-DTL,7,3,1,1,1,4,3
20170401-W-ITF_Santa_Margherita_Di_Pula-F-Bianca_Andreescu-Bernarda_Pera,2,B-IO,9,5,1,0,4,5,4
20170401-W-ITF_Santa_Margherita_Di_Pula-F-Bianca_Andreescu-Bernarda_Pera,2,B-II,1,0,0,0,0,1,0
20170401-W-ITF_Santa_Margherita_Di_Pula-F-Bianca_Andreescu-Bernarda_Pera,2,S-XC,1,0,0,0,0,0,1
20170401-W-ITF_Santa_Margherita_Di_Pula-F-Bianca_Andreescu-Bernarda_Pera,2,S-DTM,10,0,0,0,0,3,7
20170401-W-ITF_Santa_Margherita_Di_Pula-F-Bianca_Andreescu-Bernarda_Pera,2,S-DTL,5,2,1,0,1,3,2
20170401-W-ITF_Santa_Margherita_Di_Pula-F-Bianca_Andreescu-Bernarda_Pera,2,S-IO,3,0,0,0,0,2,1
20190212-W-Doha-R32-Camila_Giorgi-Kiki_Bertens,1,F-XC,61,21,7,3,11,33,28
20190212-W-Doha-R32-Camila_Giorgi-Kiki_Bertens,1,F-DTM,57,8,0,2,6,39,18
20190212-W-Doha-R32-Camila_Giorgi-Kiki_Bertens,1,F-DTL,10,5,1,2,2,6,4
20190212-W-Doha-R32-Camila_Giorgi-Kiki_Bertens,1,F-IO,19,10,3,2,5,9,10
20190212-W-Doha-R32-Camila_Giorgi-Kiki_Bertens,1,B-XC,37,11,3,2,6,20,17
20190212-W-Doha-R32-Camila_Giorgi-Kiki_Bertens,1,B-DTM,33,2,1,0,1,17,16
20190212-W-Doha-R32-Camila_Giorgi-Kiki_Bertens,1,B-DTL,4,3,1,0,2,2,2
20190212-W-Doha-R32-Camila_Giorgi-Kiki_Bertens,1,B-IO,6,3,1,1,1,5,1
20190212-W-Doha-R32-Camila_Giorgi-Kiki_Bertens,1,S-XC,1,0,0,0,0,1,0
20190212-W-Doha-R32-Camila_Giorgi-Kiki_Bertens,2,F-XC,29,8,2,1,5,7,22
20190212-W-Doha-R32-Camila_Giorgi-Kiki_Bertens,2,F-DTM,50,7,0,1,6,18,32
20190212-W-Doha-R32-Camila_Giorgi-Kiki_Bertens,2,F-DTL,8,2,0,0,2,3,5
20190212-W-Doha-R32-Camila_Giorgi-Kiki_Bertens,2,F-IO,13,7,1,1,5,6,7
20190212-W-Doha-R32-Camila_Giorgi-Kiki_Bertens,2,B-XC,9,1,0,0,1,3,6
20190212-W-Doha-R32-Camila_Giorgi-Kiki_Bertens,2,B-DTM,32,3,1,0,2,7,25
20190212-W-Doha-R32-Camila_Giorgi-Kiki_Bertens,2,B-DTL,4,0,0,0,0,4,0
20190212-W-Doha-R32-Camila_Giorgi-Kiki_Bertens,2,B-IO,5,4,1,2,1,3,2
20190212-W-Doha-R32-Camila_Giorgi-Kiki_Bertens,2,S-XC,5,0,0,0,0,1,4
20190212-W-Doha-R32-Camila_Giorgi-Kiki_Bertens,2,S-DTM,26,1,0,0,1,11,15
20190201-W-St_Petersburg-QF-Anastasia_Pavlyuchenkova-Kiki_Bertens,1,F-XC,25,9,1,0,8,11,14
20190201-W-St_Petersburg-QF-Anastasia_Pavlyuchenkova-Kiki_Bertens,1,F-DTM,18,1,0,0,1,8,10
20190201-W-St_Petersburg-QF-Anastasia_Pavlyuchenkova-Kiki_Bertens,1,F-DTL,6,3,0,2,1,5,1
20190201-W-St_Petersburg-QF-Anastasia_Pavlyuchenkova-Kiki_Bertens,1,F-IO,14,6,1,2,3,9,5
20190201-W-St_Petersburg-QF-Anastasia_Pavlyuchenkova-Kiki_Bertens,1,B-XC,21,5,1,2,2,12,9
20190201-W-St_Petersburg-QF-Anastasia_Pavlyuchenkova-Kiki_Bertens,1,B-DTM,17,3,0,0,3,6,11
20190201-W-St_Petersburg-QF-Anastasia_Pavlyuchenkova-Kiki_Bertens,1,B-DTL,2,2,1,0,1,1,1
20190201-W-St_Petersburg-QF-Anastasia_Pavlyuchenkova-Kiki_Bertens,1,B-IO,4,3,0,1,2,1,3
20190201-W-St_Petersburg-QF-Anastasia_Pavlyuchenkova-Kiki_Bertens,1,S-DTM,7,0,0,0,0,3,4
20190201-W-St_Petersburg-QF-Anastasia_Pavlyuchenkova-Kiki_Bertens,2,F-XC,18,4,1,0,3,5,13
20190201-W-St_Petersburg-QF-Anastasia_Pavlyuchenkova-Kiki_Bertens,2,F-DTM,26,3,2,0,1,14,12
20190201-W-St_Petersburg-QF-Anastasia_Pavlyuchenkova-Kiki_Bertens,2,F-DTL,9,4,2,1,1,6,3
20190201-W-St_Petersburg-QF-Anastasia_Pavlyuchenkova-Kiki_Bertens,2,F-IO,17,11,6,3,2,12,5
20190201-W-St_Petersburg-QF-Anastasia_Pavlyuchenkova-Kiki_Bertens,2,F-II,1,1,0,0,1,0,1
20190201-W-St_Petersburg-QF-Anastasia_Pavlyuchenkova-Kiki_Bertens,2,B-XC,5,2,1,0,1,2,3
20190201-W-St_Petersburg-QF-Anastasia_Pavlyuchenkova-Kiki_Bertens,2,B-DTM,13,0,0,0,0,7,6
20190201-W-St_Petersburg-QF-Anastasia_Pavlyuchenkova-Kiki_Bertens,2,B-DTL,8,4,3,0,1,5,3
20190201-W-St_Petersburg-QF-Anastasia_Pavlyuchenkova-Kiki_Bertens,2,B-IO,1,1,0,0,1,0,1
20190201-W-St_Petersburg-QF-Anastasia_Pavlyuchenkova-Kiki_Bertens,2,S-XC,5,2,0,0,2,0,5
20190201-W-St_Petersburg-QF-Anastasia_Pavlyuchenkova-Kiki_Bertens,2,S-DTM,7,1,0,1,0,1,6
20190201-W-St_Petersburg-QF-Petra_Kvitova-Donna_Vekic,1,F-XC,46,18,3,1,14,23,23
20190201-W-St_Petersburg-QF-Petra_Kvitova-Donna_Vekic,1,F-DTM,21,2,0,0,2,5,16
20190201-W-St_Petersburg-QF-Petra_Kvitova-Donna_Vekic,1,F-DTL,8,6,1,0,5,2,6
20190201-W-St_Petersburg-QF-Petra_Kvitova-Donna_Vekic,1,F-IO,12,5,1,2,2,9,3
20190201-W-St_Petersburg-QF-Petra_Kvitova-Donna_Vekic,1,F-II,1,1,1,0,0,1,0
20190201-W-St_Petersburg-QF-Petra_Kvitova-Donna_Vekic,1,B-XC,25,8,3,1,4,14,11
20190201-W-St_Petersburg-QF-Petra_Kvitova-Donna_Vekic,1,B-DTM,18,1,0,0,1,9,9
20190201-W-St_Petersburg-QF-Petra_Kvitova-Donna_Vekic,1,B-DTL,2,0,0,0,0,1,1
20190201-W-St_Petersburg-QF-Petra_Kvitova-Donna_Vekic,1,B-IO,6,2,0,1,1,3,3
20190201-W-St_Petersburg-QF-Petra_Kvitova-Donna_Vekic,1,B-II,1,1,0,0,1,0,1
20190201-W-St_Petersburg-QF-Petra_Kvitova-Donna_Vekic,1,S-XC,5,1,0,0,1,4,1
20190201-W-St_Petersburg-QF-Petra_Kvitova-Donna_Vekic,1,S-DTM,4,1,0,0,1,0,4
20190201-W-St_Petersburg-QF-Petra_Kvitova-Donna_Vekic,1,S-DTL,2,0,0,0,0,0,2
20190201-W-St_Petersburg-QF-Petra_Kvitova-Donna_Vekic,1,S-IO,2,0,0,0,0,1,1
20190201-W-St_Petersburg-QF-Petra_Kvitova-Donna_Vekic,2,F-XC,27,3,2,0,1,14,13
20190201-W-St_Petersburg-QF-Petra_Kvitova-Donna_Vekic,2,F-DTM,30,3,1,1,1,15,15
20190201-W-St_Petersburg-QF-Petra_Kvitova-Donna_Vekic,2,F-DTL,11,3,1,0,2,4,7
20190201-W-St_Petersburg-QF-Petra_Kvitova-Donna_Vekic,2,F-IO,13,4,1,0,3,6,7
20190201-W-St_Petersburg-QF-Petra_Kvitova-Donna_Vekic,2,B-XC,13,0,0,0,0,8,5
20190201-W-St_Petersburg-QF-Petra_Kvitova-Donna_Vekic,2,B-DTM,27,2,1,0,1,16,11
20190201-W-St_Petersburg-QF-Petra_Kvitova-Donna_Vekic,2,B-DTL,8,4,1,0,3,2,6
20190201-W-St_Petersburg-QF-Petra_Kvitova-Donna_Vekic,2,B-IO,5,1,0,0,1,3,2
20190201-W-St_Petersburg-QF-Petra_Kvitova-Donna_Vekic,2,S-XC,1,1,0,1,0,1,0
20190201-W-St_Petersburg-QF-Petra_Kvitova-Donna_Vekic,2,S-DTM,3,0,0,0,0,1,2
20190201-W-St_Petersburg-QF-Vera_Zvonareva-Daria_Kasatkina,1,F-XC,56,9,3,4,2,34,22
20190201-W-St_Petersburg-QF-Vera_Zvonareva-Daria_Kasatkina,1,F-DTM,32,1,0,0,1,24,8
20190201-W-St_Petersburg-QF-Vera_Zvonareva-Daria_Kasatkina,1,F-DTL,18,5,1,1,3,11,7
20190201-W-St_Petersburg-QF-Vera_Zvonareva-Daria_Kasatkina,1,F-IO,27,6,2,0,4,15,12
20190201-W-St_Petersburg-QF-Vera_Zvonareva-Daria_Kasatkina,1,F-II,1,1,0,0,1,0,1
20190201-W-St_Petersburg-QF-Vera_Zvonareva-Daria_Kasatkina,1,B-XC,53,6,1,3,2,29,24
20190201-W-St_Petersburg-QF-Vera_Zvonareva-Daria_Kasatkina,1,B-DTM,31,1,0,0,1,18,13
20190201-W-St_Petersburg-QF-Vera_Zvonareva-Daria_Kasatkina,1,B-DTL,22,6,3,1,2,13,9
20190201-W-St_Petersburg-QF-Vera_Zvonareva-Daria_Kasatkina,1,B-IO,11,4,1,2,1,10,1
20190201-W-St_Petersburg-QF-Vera_Zvonareva-Daria_Kasatkina,1,S-XC,4,0,0,0,0,3,1
20190201-W-St_Petersburg-QF-Vera_Zvonareva-Daria_Kasatkina,1,S-DTM,4,0,0,0,0,2,2
20190201-W-St_Petersburg-QF-Vera_Zvonareva-Daria_Kasatkina,1,S-DTL,1,0,0,0,0,0,1
20190201-W-St_Petersburg-QF-Vera_Zvonareva-Daria_Kasatkina,2,F-XC,68,17,5,2,10,29,39
20190201-W-St_Petersburg-QF-Vera_Zvonareva-Daria_Kasatkina,2,F-DTM,40,3,1,0,2,11,29
20190201-W-St_Petersburg-QF-Vera_Zvonareva-Daria_Kasatkina,2,F-DTL,20,4,0,0,4,10,10
20190201-W-St_Petersburg-QF-Vera_Zvonareva-Daria_Kasatkina,2,F-IO,24,9,1,5,3,13,11
20190201-W-St_Petersburg-QF-Vera_Zvonareva-Daria_Kasatkina,2,F-II,1,0,0,0,0,0,1
20190201-W-St_Petersburg-QF-Vera_Zvonareva-Daria_Kasatkina,2,B-XC,50,9,1,2,6,22,28
20190201-W-St_Petersburg-QF-Vera_Zvonareva-Daria_Kasatkina,2,B-DTM,35,0,0,0,0,12,23
20190201-W-St_Petersburg-QF-Vera_Zvonareva-Daria_Kasatkina,2,B-DTL,8,3,0,2,1,3,5
20190201-W-St_Petersburg-QF-Vera_Zvonareva-Daria_Kasatkina,2,B-IO,8,3,1,1,1,3,5
20190201-W-St_Petersburg-QF-Vera_Zvonareva-Daria_Kasatkina,2,S-XC,12,4,0,1,3,5,7
20190201-W-St_Petersburg-QF-Vera_Zvonareva-Daria_Kasatkina,2,S-DTM,15,0,0,0,0,3,12
20190201-W-St_Petersburg-QF-Vera_Zvonareva-Daria_Kasatkina,2,S-DTL,2,1,0,1,0,1,1
20190213-W-Doha-R16-Su_Wei_Hsieh-Karolina_Muchova,1,F-XC,16,4,1,1,2,7,9
20190213-W-Doha-R16-Su_Wei_Hsieh-Karolina_Muchova,1,F-DTM,9,2,0,0,2,4,5
20190213-W-Doha-R16-Su_Wei_Hsieh-Karolina_Muchova,1,F-DTL,2,1,1,0,0,2,0
20190213-W-Doha-R16-Su_Wei_Hsieh-Karolina_Muchova,1,F-IO,10,5,1,1,3,6,4
20190213-W-Doha-R16-Su_Wei_Hsieh-Karolina_Muchova,1,F-II,1,0,0,0,0,1,0
20190213-W-Doha-R16-Su_Wei_Hsieh-Karolina_Muchova,1,B-XC,37,10,0,5,5,21,16
20190213-W-Doha-R16-Su_Wei_Hsieh-Karolina_Muchova,1,B-DTM,12,1,0,0,1,8,4
20190213-W-Doha-R16-Su_Wei_Hsieh-Karolina_Muchova,1,B-DTL,7,4,1,1,2,3,4
20190213-W-Doha-R16-Su_Wei_Hsieh-Karolina_Muchova,1,B-IO,4,2,0,0,2,1,3
20190213-W-Doha-R16-Su_Wei_Hsieh-Karolina_Muchova,1,S-DTM,1,0,0,0,0,0,1
20190213-W-Doha-R16-Su_Wei_Hsieh-Karolina_Muchova,1,S-DTL,1,1,1,0,0,1,0
20190213-W-Doha-R16-Su_Wei_Hsieh-Karolina_Muchova,1,S-IO,1,0,0,0,0,0,1
20190213-W-Doha-R16-Su_Wei_Hsieh-Karolina_Muchova,2,F-XC,19,9,2,1,6,6,13
20190213-W-Doha-R16-Su_Wei_Hsieh-Karolina_Muchova,2,F-DTM,8,0,0,0,0,2,6
20190213-W-Doha-R16-Su_Wei_Hsieh-Karolina_Muchova,2,F-DTL,15,7,2,4,1,10,5
20190213-W-Doha-R16-Su_Wei_Hsieh-Karolina_Muchova,2,F-IO,12,6,3,1,2,7,5
20190213-W-Doha-R16-Su_Wei_Hsieh-Karolina_Muchova,2,B-XC,12,0,0,0,0,6,6
20190213-W-Doha-R16-Su_Wei_Hsieh-Karolina_Muchova,2,B-DTM,11,1,0,1,0,6,5
20190213-W-Doha-R16-Su_Wei_Hsieh-Karolina_Muchova,2,B-DTL,10,4,2,0,2,5,5
20190213-W-Doha-R16-Su_Wei_Hsieh-Karolina_Muchova,2,B-IO,4,4,2,0,2,2,2
20190213-W-Doha-R16-Su_Wei_Hsieh-Karolina_Muchova,2,S-XC,8,1,1,0,0,5,3
20190213-W-Doha-R16-Su_Wei_Hsieh-Karolina_Muchova,2,S-DTM,8,1,0,0,1,1,7
20180624-W-ITF_Ilkley-F-Tereza_Smitkova-Dayana_Yastremska,1,F-XC,33,17,1,3,13,12,21
20180624-W-ITF_Ilkley-F-Tereza_Smitkova-Dayana_Yastremska,1,F-DTM,14,3,0,1,2,6,8
20180624-W-ITF_Ilkley-F-Tereza_Smitkova-Dayana_Yastremska,1,F-DTL,7,4,1,1,2,3,4
20180624-W-ITF_Ilkley-F-Tereza_Smitkova-Dayana_Yastremska,1,F-IO,7,3,1,0,2,1,6
20180624-W-ITF_Ilkley-F-Tereza_Smitkova-Dayana_Yastremska,1,F-II,2,2,1,1,0,2,0
20180624-W-ITF_Ilkley-F-Tereza_Smitkova-Dayana_Yastremska,1,B-XC,25,12,4,1,7,12,13
20180624-W-ITF_Ilkley-F-Tereza_Smitkova-Dayana_Yastremska,1,B-DTM,18,3,0,0,3,8,10
20180624-W-ITF_Ilkley-F-Tereza_Smitkova-Dayana_Yastremska,1,B-DTL,7,5,2,2,1,6,1
20180624-W-ITF_Ilkley-F-Tereza_Smitkova-Dayana_Yastremska,1,B-IO,9,3,0,2,1,5,4
20180624-W-ITF_Ilkley-F-Tereza_Smitkova-Dayana_Yastremska,1,S-XC,7,0,0,0,0,4,3
20180624-W-ITF_Ilkley-F-Tereza_Smitkova-Dayana_Yastremska,1,S-DTM,1,0,0,0,0,0,1
20180624-W-ITF_Ilkley-F-Tereza_Smitkova-Dayana_Yastremska,1,S-DTL,2,1,0,0,1,1,1
20180624-W-ITF_Ilkley-F-Tereza_Smitkova-Dayana_Yastremska,1,S-II,1,0,0,0,0,0,1
20180624-W-ITF_Ilkley-F-Tereza_Smitkova-Dayana_Yastremska,2,F-XC,35,15,8,1,6,19,16
20180624-W-ITF_Ilkley-F-Tereza_Smitkova-Dayana_Yastremska,2,F-DTM,6,1,0,0,1,3,3
20180624-W-ITF_Ilkley-F-Tereza_Smitkova-Dayana_Yastremska,2,F-DTL,21,8,1,4,3,11,10
20180624-W-ITF_Ilkley-F-Tereza_Smitkova-Dayana_Yastremska,2,F-IO,22,8,2,2,4,13,9
20180624-W-ITF_Ilkley-F-Tereza_Smitkova-Dayana_Yastremska,2,B-XC,20,4,1,2,1,11,9
20180624-W-ITF_Ilkley-F-Tereza_Smitkova-Dayana_Yastremska,2,B-DTM,14,1,0,0,1,9,5
20180624-W-ITF_Ilkley-F-Tereza_Smitkova-Dayana_Yastremska,2,B-DTL,19,6,1,0,5,12,7
20180624-W-ITF_Ilkley-F-Tereza_Smitkova-Dayana_Yastremska,2,B-IO,23,6,3,0,3,14,9
20180624-W-ITF_Ilkley-F-Tereza_Smitkova-Dayana_Yastremska,2,S-DTM,1,0,0,0,0,0,1
20181019-W-Moscow-SF-Daria_Kasatkina-Johanna_Konta,1,F-XC,28,9,6,3,0,17,11
20181019-W-Moscow-SF-Daria_Kasatkina-Johanna_Konta,1,F-DTM,39,2,0,1,1,20,19
20181019-W-Moscow-SF-Daria_Kasatkina-Johanna_Konta,1,F-DTL,10,3,1,0,2,4,6
20181019-W-Moscow-SF-Daria_Kasatkina-Johanna_Konta,1,F-IO,25,7,6,0,1,15,10
20181019-W-Moscow-SF-Daria_Kasatkina-Johanna_Konta,1,B-XC,15,2,0,1,1,10,5
20181019-W-Moscow-SF-Daria_Kasatkina-Johanna_Konta,1,B-DTM,48,6,2,0,4,27,21
20181019-W-Moscow-SF-Daria_Kasatkina-Johanna_Konta,1,B-DTL,4,2,1,0,1,1,3
20181019-W-Moscow-SF-Daria_Kasatkina-Johanna_Konta,1,B-IO,7,2,0,0,2,1,6
20181019-W-Moscow-SF-Daria_Kasatkina-Johanna_Konta,1,S-XC,6,0,0,0,0,2,4
20181019-W-Moscow-SF-Daria_Kasatkina-Johanna_Konta,1,S-DTM,15,1,0,0,1,9,6
20181019-W-Moscow-SF-Daria_Kasatkina-Johanna_Konta,1,S-DTL,3,1,1,0,0,1,2
20181019-W-Moscow-SF-Daria_Kasatkina-Johanna_Konta,1,S-IO,1,0,0,0,0,1,0
20181019-W-Moscow-SF-Daria_Kasatkina-Johanna_Konta,2,F-XC,37,14,5,2,7,20,17
20181019-W-Moscow-SF-Daria_Kasatkina-Johanna_Konta,2,F-DTM,25,2,0,0,2,13,12
20181019-W-Moscow-SF-Daria_Kasatkina-Johanna_Konta,2,F-DTL,9,2,1,0,1,5,4
20181019-W-Moscow-SF-Daria_Kasatkina-Johanna_Konta,2,F-IO,25,11,2,3,6,10,15
20181019-W-Moscow-SF-Daria_Kasatkina-Johanna_Konta,2,F-II,1,0,0,0,0,0,1
20181019-W-Moscow-SF-Daria_Kasatkina-Johanna_Konta,2,B-XC,33,3,1,2,0,18,15
20181019-W-Moscow-SF-Daria_Kasatkina-Johanna_Konta,2,B-DTM,58,4,1,0,3,22,36
20181019-W-Moscow-SF-Daria_Kasatkina-Johanna_Konta,2,B-DTL,2,1,0,1,0,1,1
20181019-W-Moscow-SF-Daria_Kasatkina-Johanna_Konta,2,B-IO,4,3,2,1,0,4,0
20181019-W-Moscow-SF-Daria_Kasatkina-Johanna_Konta,2,S-XC,5,1,1,0,0,4,1
20181019-W-Moscow-SF-Daria_Kasatkina-Johanna_Konta,2,S-DTM,3,0,0,0,0,2,1
20180719-W-Bucharest-R16-Claire_Liu-Petra_Martic,1,F-XC,62,18,7,6,5,33,29
20180719-W-Bucharest-R16-Claire_Liu-Petra_Martic,1,F-DTM,15,1,0,0,1,6,9
20180719-W-Bucharest-R16-Claire_Liu-Petra_Martic,1,F-DTL,51,15,2,2,11,21,30
20180719-W-Bucharest-R16-Claire_Liu-Petra_Martic,1,F-IO,34,13,2,2,9,16,18
20180719-W-Bucharest-R16-Claire_Liu-Petra_Martic,1,F-II,2,0,0,0,0,2,0
20180719-W-Bucharest-R16-Claire_Liu-Petra_Martic,1,B-XC,81,12,2,3,7,36,45
20180719-W-Bucharest-R16-Claire_Liu-Petra_Martic,1,B-DTM,18,3,0,0,3,5,13
20180719-W-Bucharest-R16-Claire_Liu-Petra_Martic,1,B-DTL,20,12,6,1,5,9,11
20180719-W-Bucharest-R16-Claire_Liu-Petra_Martic,1,B-IO,10,5,1,1,3,6,4
20180719-W-Bucharest-R16-Claire_Liu-Petra_Martic,1,S-XC,3,0,0,0,0,0,3
20180719-W-Bucharest-R16-Claire_Liu-Petra_Martic,1,S-DTM,4,0,0,0,0,1,3
20180719-W-Bucharest-R16-Claire_Liu-Petra_Martic,1,S-DTL,6,1,1,0,0,1,5
20180719-W-Bucharest-R16-Claire_Liu-Petra_Martic,2,F-XC,70,12,4,3,5,40,30
20180719-W-Bucharest-R16-Claire_Liu-Petra_Martic,2,F-DTM,24,3,0,1,2,12,12
20180719-W-Bucharest-R16-Claire_Liu-Petra_Martic,2,F-DTL,27,9,2,1,6,15,12
20180719-W-Bucharest-R16-Claire_Liu-Petra_Martic,2,F-IO,33,11,7,0,4,19,14
20180719-W-Bucharest-R16-Claire_Liu-Petra_Martic,2,F-II,12,4,2,1,1,8,4
20180719-W-Bucharest-R16-Claire_Liu-Petra_Martic,2,B-XC,43,4,1,1,2,22,21
20180719-W-Bucharest-R16-Claire_Liu-Petra_Martic,2,B-DTM,19,3,1,0,2,6,13
20180719-W-Bucharest-R16-Claire_Liu-Petra_Martic,2,B-DTL,22,6,1,1,4,13,9
20180719-W-Bucharest-R16-Claire_Liu-Petra_Martic,2,B-IO,3,0,0,0,0,0,3
20180719-W-Bucharest-R16-Claire_Liu-Petra_Martic,2,S-XC,19,1,0,0,1,13,6
20180719-W-Bucharest-R16-Claire_Liu-Petra_Martic,2,S-DTM,10,1,0,0,1,4,6
20180719-W-Bucharest-R16-Claire_Liu-Petra_Martic,2,S-DTL,12,0,0,0,0,8,4
20181018-W-Moscow-QF-Daria_Kasatkina-Anastasia_Pavlyuchenkova,1,F-XC,36,10,5,3,2,20,16
20181018-W-Moscow-QF-Daria_Kasatkina-Anastasia_Pavlyuchenkova,1,F-DTM,34,2,0,2,0,21,13
20181018-W-Moscow-QF-Daria_Kasatkina-Anastasia_Pavlyuchenkova,1,F-DTL,3,1,1,0,0,2,1
20181018-W-Moscow-QF-Daria_Kasatkina-Anastasia_Pavlyuchenkova,1,F-IO,15,2,2,0,0,11,4
20181018-W-Moscow-QF-Daria_Kasatkina-Anastasia_Pavlyuchenkova,1,F-II,1,1,1,0,0,1,0
20181018-W-Moscow-QF-Daria_Kasatkina-Anastasia_Pavlyuchenkova,1,B-XC,14,2,0,0,2,10,4
20181018-W-Moscow-QF-Daria_Kasatkina-Anastasia_Pavlyuchenkova,1,B-DTM,17,1,0,0,1,8,9
20181018-W-Moscow-QF-Daria_Kasatkina-Anastasia_Pavlyuchenkova,1,B-DTL,5,2,2,0,0,4,1
20181018-W-Moscow-QF-Daria_Kasatkina-Anastasia_Pavlyuchenkova,1,B-IO,3,2,2,0,0,3,0
20181018-W-Moscow-QF-Daria_Kasatkina-Anastasia_Pavlyuchenkova,1,B-II,1,1,0,1,0,1,0
20181018-W-Moscow-QF-Daria_Kasatkina-Anastasia_Pavlyuchenkova,1,S-XC,5,1,0,1,0,2,3
20181018-W-Moscow-QF-Daria_Kasatkina-Anastasia_Pavlyuchenkova,1,S-DTM,9,0,0,0,0,2,7
20181018-W-Moscow-QF-Daria_Kasatkina-Anastasia_Pavlyuchenkova,1,S-DTL,1,0,0,0,0,0,1
20181018-W-Moscow-QF-Daria_Kasatkina-Anastasia_Pavlyuchenkova,2,F-XC,32,15,5,5,5,16,16
20181018-W-Moscow-QF-Daria_Kasatkina-Anastasia_Pavlyuchenkova,2,F-DTM,26,1,0,0,1,10,16
20181018-W-Moscow-QF-Daria_Kasatkina-Anastasia_Pavlyuchenkova,2,F-DTL,10,5,2,2,1,8,2
20181018-W-Moscow-QF-Daria_Kasatkina-Anastasia_Pavlyuchenkova,2,F-IO,18,8,3,0,5,6,12
20181018-W-Moscow-QF-Daria_Kasatkina-Anastasia_Pavlyuchenkova,2,B-XC,28,5,3,0,2,14,14
20181018-W-Moscow-QF-Daria_Kasatkina-Anastasia_Pavlyuchenkova,2,B-DTM,30,3,0,0,3,7,23
20181018-W-Moscow-QF-Daria_Kasatkina-Anastasia_Pavlyuchenkova,2,B-DTL,6,2,0,0,2,1,5
20181018-W-Moscow-QF-Daria_Kasatkina-Anastasia_Pavlyuchenkova,2,B-IO,7,3,3,0,0,5,2
20181018-W-Moscow-QF-Daria_Kasatkina-Anastasia_Pavlyuchenkova,2,S-DTM,3,0,0,0,0,0,3
20190218-W-Budapest-R32-Fiona_Ferro-Arantxa_Rus,1,F-XC,35,13,2,4,7,13,22
20190218-W-Budapest-R32-Fiona_Ferro-Arantxa_Rus,1,F-DTM,32,4,0,0,4,12,20
20190218-W-Budapest-R32-Fiona_Ferro-Arantxa_Rus,1,F-DTL,6,5,0,2,3,2,4
20190218-W-Budapest-R32-Fiona_Ferro-Arantxa_Rus,1,F-IO,23,15,6,1,8,11,12
20190218-W-Budapest-R32-Fiona_Ferro-Arantxa_Rus,1,F-II,1,1,0,1,0,1,0
20190218-W-Budapest-R32-Fiona_Ferro-Arantxa_Rus,1,B-XC,66,5,0,0,5,28,38
20190218-W-Budapest-R32-Fiona_Ferro-Arantxa_Rus,1,B-DTM,35,2,1,0,1,19,16
20190218-W-Budapest-R32-Fiona_Ferro-Arantxa_Rus,1,B-DTL,5,4,0,1,3,1,4
20190218-W-Budapest-R32-Fiona_Ferro-Arantxa_Rus,1,B-IO,3,1,0,0,1,1,2
20190218-W-Budapest-R32-Fiona_Ferro-Arantxa_Rus,1,S-DTM,5,1,0,0,1,2,3
20190218-W-Budapest-R32-Fiona_Ferro-Arantxa_Rus,1,S-DTL,1,0,0,0,0,0,1
20190218-W-Budapest-R32-Fiona_Ferro-Arantxa_Rus,2,F-XC,80,17,5,3,9,45,35
20190218-W-Budapest-R32-Fiona_Ferro-Arantxa_Rus,2,F-DTM,49,5,0,0,5,24,25
20190218-W-Budapest-R32-Fiona_Ferro-Arantxa_Rus,2,F-DTL,7,3,1,1,1,4,3
20190218-W-Budapest-R32-Fiona_Ferro-Arantxa_Rus,2,F-IO,15,9,4,0,5,9,6
20190218-W-Budapest-R32-Fiona_Ferro-Arantxa_Rus,2,F-II,1,0,0,0,0,1,0
20190218-W-Budapest-R32-Fiona_Ferro-Arantxa_Rus,2,B-XC,19,7,2,2,3,11,8
20190218-W-Budapest-R32-Fiona_Ferro-Arantxa_Rus,2,B-DTM,28,4,0,0,4,13,15
20190218-W-Budapest-R32-Fiona_Ferro-Arantxa_Rus,2,B-DTL,9,3,1,0,2,6,3
20190218-W-Budapest-R32-Fiona_Ferro-Arantxa_Rus,2,B-IO,10,0,0,0,0,4,6
20190218-W-Budapest-R32-Fiona_Ferro-Arantxa_Rus,2,S-XC,2,0,0,0,0,2,0
20190218-W-Budapest-R32-Fiona_Ferro-Arantxa_Rus,2,S-DTM,1,0,0,0,0,0,1
20190214-W-Doha-QF-Elise_Mertens-Kiki_Bertens,1,F-XC,15,5,2,0,3,8,7
20190214-W-Doha-QF-Elise_Mertens-Kiki_Bertens,1,F-DTM,40,2,0,0,2,26,14
20190214-W-Doha-QF-Elise_Mertens-Kiki_Bertens,1,F-DTL,7,0,0,0,0,4,3
20190214-W-Doha-QF-Elise_Mertens-Kiki_Bertens,1,F-IO,22,2,0,0,2,11,11
20190214-W-Doha-QF-Elise_Mertens-Kiki_Bertens,1,B-XC,22,5,1,3,1,12,10
20190214-W-Doha-QF-Elise_Mertens-Kiki_Bertens,1,B-DTM,27,1,0,0,1,16,11
20190214-W-Doha-QF-Elise_Mertens-Kiki_Bertens,1,B-DTL,5,4,1,1,2,3,2
20190214-W-Doha-QF-Elise_Mertens-Kiki_Bertens,1,B-IO,14,6,1,1,4,5,9
20190214-W-Doha-QF-Elise_Mertens-Kiki_Bertens,1,S-XC,4,0,0,0,0,3,1
20190214-W-Doha-QF-Elise_Mertens-Kiki_Bertens,1,S-DTM,3,0,0,0,0,1,2
20190214-W-Doha-QF-Elise_Mertens-Kiki_Bertens,1,S-DTL,1,0,0,0,0,0,1
20190214-W-Doha-QF-Elise_Mertens-Kiki_Bertens,2,F-XC,29,10,3,4,3,15,14
20190214-W-Doha-QF-Elise_Mertens-Kiki_Bertens,2,F-DTM,36,8,1,0,7,15,21
20190214-W-Doha-QF-Elise_Mertens-Kiki_Bertens,2,F-DTL,2,0,0,0,0,0,2
20190214-W-Doha-QF-Elise_Mertens-Kiki_Bertens,2,F-IO,27,17,8,3,6,16,11
20190214-W-Doha-QF-Elise_Mertens-Kiki_Bertens,2,F-II,1,1,0,0,1,0,1
20190214-W-Doha-QF-Elise_Mertens-Kiki_Bertens,2,B-XC,25,12,0,1,11,7,18
20190214-W-Doha-QF-Elise_Mertens-Kiki_Bertens,2,B-DTM,36,3,0,0,3,12,24
20190214-W-Doha-QF-Elise_Mertens-Kiki_Bertens,2,B-DTL,4,3,1,1,1,3,1
20190214-W-Doha-QF-Elise_Mertens-Kiki_Bertens,2,B-IO,4,2,1,0,1,3,1
20190214-W-Doha-QF-Elise_Mertens-Kiki_Bertens,2,S-XC,3,0,0,0,0,2,1
20190214-W-Doha-QF-Elise_Mertens-Kiki_Bertens,2,S-DTM,6,0,0,0,0,3,3
20190214-W-Doha-QF-Elise_Mertens-Kiki_Bertens,2,S-DTL,1,1,0,0,1,0,1
20190217-W-Dubai-R64-Alize_Cornet-Timea_Babos,1,F-XC,32,7,1,0,6,18,14
20190217-W-Dubai-R64-Alize_Cornet-Timea_Babos,1,F-DTM,35,3,0,1,2,15,20
20190217-W-Dubai-R64-Alize_Cornet-Timea_Babos,1,F-DTL,10,4,2,0,2,6,4
20190217-W-Dubai-R64-Alize_Cornet-Timea_Babos,1,F-IO,8,2,1,0,1,4,4
20190217-W-Dubai-R64-Alize_Cornet-Timea_Babos,1,B-XC,22,3,1,0,2,14,8
20190217-W-Dubai-R64-Alize_Cornet-Timea_Babos,1,B-DTM,28,3,0,0,3,13,15
20190217-W-Dubai-R64-Alize_Cornet-Timea_Babos,1,B-DTL,7,3,1,1,1,3,4
20190217-W-Dubai-R64-Alize_Cornet-Timea_Babos,1,B-IO,5,4,2,0,2,2,3
20190217-W-Dubai-R64-Alize_Cornet-Timea_Babos,1,S-XC,4,0,0,0,0,3,1
20190217-W-Dubai-R64-Alize_Cornet-Timea_Babos,1,S-DTM,6,1,0,0,1,1,5
20190217-W-Dubai-R64-Alize_Cornet-Timea_Babos,2,F-XC,36,13,1,3,9,18,18
20190217-W-Dubai-R64-Alize_Cornet-Timea_Babos,2,F-DTM,27,6,0,0,6,13,14
20190217-W-Dubai-R64-Alize_Cornet-Timea_Babos,2,F-DTL,4,1,0,0,1,3,1
20190217-W-Dubai-R64-Alize_Cornet-Timea_Babos,2,F-IO,6,3,0,0,3,1,5
20190217-W-Dubai-R64-Alize_Cornet-Timea_Babos,2,B-XC,35,6,1,0,5,16,19
20190217-W-Dubai-R64-Alize_Cornet-Timea_Babos,2,B-DTM,35,1,0,0,1,16,19
20190217-W-Dubai-R64-Alize_Cornet-Timea_Babos,2,B-DTL,3,3,1,0,2,1,2
20190217-W-Dubai-R64-Alize_Cornet-Timea_Babos,2,B-IO,9,5,2,0,3,4,5
20190217-W-Dubai-R64-Alize_Cornet-Timea_Babos,2,S-XC,5,1,0,0,1,3,2
20190217-W-Dubai-R64-Alize_Cornet-Timea_Babos,2,S-DTM,4,0,0,0,0,1,3
20190217-W-Dubai-R64-Alize_Cornet-Timea_Babos,2,S-DTL,1,1,0,1,0,1,0
20190217-W-Dubai-R64-Alize_Cornet-Timea_Babos,2,S-IO,1,0,0,0,0,1,0
20190219-W-Dubai-R32-Naomi_Osaka-Kristina_Mladenovic,1,F-XC,24,11,3,2,6,9,15
20190219-W-Dubai-R32-Naomi_Osaka-Kristina_Mladenovic,1,F-DTM,5,1,0,0,1,3,2
20190219-W-Dubai-R32-Naomi_Osaka-Kristina_Mladenovic,1,F-DTL,4,1,1,0,0,3,1
20190219-W-Dubai-R32-Naomi_Osaka-Kristina_Mladenovic,1,F-IO,8,4,1,0,3,4,4
20190219-W-Dubai-R32-Naomi_Osaka-Kristina_Mladenovic,1,B-XC,14,5,1,0,4,8,6
20190219-W-Dubai-R32-Naomi_Osaka-Kristina_Mladenovic,1,B-DTM,5,0,0,0,0,1,4
20190219-W-Dubai-R32-Naomi_Osaka-Kristina_Mladenovic,1,B-DTL,2,2,0,0,2,0,2
20190219-W-Dubai-R32-Naomi_Osaka-Kristina_Mladenovic,1,B-IO,10,6,1,1,4,3,7
20190219-W-Dubai-R32-Naomi_Osaka-Kristina_Mladenovic,2,F-XC,14,4,1,1,2,8,6
20190219-W-Dubai-R32-Naomi_Osaka-Kristina_Mladenovic,2,F-DTM,8,0,0,0,0,7,1
20190219-W-Dubai-R32-Naomi_Osaka-Kristina_Mladenovic,2,F-DTL,4,1,1,0,0,2,2
20190219-W-Dubai-R32-Naomi_Osaka-Kristina_Mladenovic,2,F-IO,2,2,2,0,0,2,0
20190219-W-Dubai-R32-Naomi_Osaka-Kristina_Mladenovic,2,F-II,1,1,0,1,0,1,0
20190219-W-Dubai-R32-Naomi_Osaka-Kristina_Mladenovic,2,B-XC,10,5,0,1,4,3,7
20190219-W-Dubai-R32-Naomi_Osaka-Kristina_Mladenovic,2,B-DTM,8,1,0,0,1,3,5
20190219-W-Dubai-R32-Naomi_Osaka-Kristina_Mladenovic,2,B-DTL,4,3,1,0,2,2,2
20190219-W-Dubai-R32-Naomi_Osaka-Kristina_Mladenovic,2,B-IO,2,1,0,0,1,0,2
20190219-W-Dubai-R32-Naomi_Osaka-Kristina_Mladenovic,2,S-XC,2,0,0,0,0,0,2
20190219-W-Dubai-R32-Naomi_Osaka-Kristina_Mladenovic,2,S-DTM,6,0,0,0,0,2,4
20190219-W-Dubai-R32-Naomi_Osaka-Kristina_Mladenovic,2,S-DTL,1,1,0,0,1,0,1
20181017-W-Moscow-R16-Anastasia_Pavlyuchenkova-Valentini_Grammatikopoulou,1,F-XC,21,3,1,0,2,11,10
20181017-W-Moscow-R16-Anastasia_Pavlyuchenkova-Valentini_Grammatikopoulou,1,F-DTM,24,2,1,0,1,12,12
20181017-W-Moscow-R16-Anastasia_Pavlyuchenkova-Valentini_Grammatikopoulou,1,F-DTL,10,5,2,1,2,5,5
20181017-W-Moscow-R16-Anastasia_Pavlyuchenkova-Valentini_Grammatikopoulou,1,F-IO,9,5,4,1,0,9,0
20181017-W-Moscow-R16-Anastasia_Pavlyuchenkova-Valentini_Grammatikopoulou,1,B-XC,16,8,3,1,4,9,7
20181017-W-Moscow-R16-Anastasia_Pavlyuchenkova-Valentini_Grammatikopoulou,1,B-DTM,19,2,0,1,1,13,6
20181017-W-Moscow-R16-Anastasia_Pavlyuchenkova-Valentini_Grammatikopoulou,1,B-DTL,9,2,1,0,1,6,3
20181017-W-Moscow-R16-Anastasia_Pavlyuchenkova-Valentini_Grammatikopoulou,1,B-IO,4,1,0,0,1,2,2
20181017-W-Moscow-R16-Anastasia_Pavlyuchenkova-Valentini_Grammatikopoulou,1,S-DTM,2,0,0,0,0,1,1
20181017-W-Moscow-R16-Anastasia_Pavlyuchenkova-Valentini_Grammatikopoulou,1,S-DTL,1,0,0,0,0,0,1
20181017-W-Moscow-R16-Anastasia_Pavlyuchenkova-Valentini_Grammatikopoulou,2,F-XC,23,6,3,1,2,11,12
20181017-W-Moscow-R16-Anastasia_Pavlyuchenkova-Valentini_Grammatikopoulou,2,F-DTM,13,2,0,0,2,5,8
20181017-W-Moscow-R16-Anastasia_Pavlyuchenkova-Valentini_Grammatikopoulou,2,F-DTL,2,1,0,0,1,0,2
20181017-W-Moscow-R16-Anastasia_Pavlyuchenkova-Valentini_Grammatikopoulou,2,F-IO,10,7,1,0,6,3,7
20181017-W-Moscow-R16-Anastasia_Pavlyuchenkova-Valentini_Grammatikopoulou,2,B-XC,20,7,3,1,3,7,13
20181017-W-Moscow-R16-Anastasia_Pavlyuchenkova-Valentini_Grammatikopoulou,2,B-DTM,24,6,0,1,5,9,15
20181017-W-Moscow-R16-Anastasia_Pavlyuchenkova-Valentini_Grammatikopoulou,2,B-DTL,1,1,0,0,1,0,1
20181017-W-Moscow-R16-Anastasia_Pavlyuchenkova-Valentini_Grammatikopoulou,2,B-IO,2,2,1,0,1,1,1
20181017-W-Moscow-R16-Anastasia_Pavlyuchenkova-Valentini_Grammatikopoulou,2,S-XC,4,0,0,0,0,1,3
20181017-W-Moscow-R16-Anastasia_Pavlyuchenkova-Valentini_Grammatikopoulou,2,S-DTM,7,0,0,0,0,1,6
20181017-W-Moscow-R16-Anastasia_Pavlyuchenkova-Valentini_Grammatikopoulou,2,S-IO,1,0,0,0,0,0,1
20190221-W-Budapest-R16-Arantxa_Rus-Ekaterina_Alexandrova,1,F-XC,18,1,0,0,1,5,13
20190221-W-Budapest-R16-Arantxa_Rus-Ekaterina_Alexandrova,1,F-DTM,27,3,0,1,2,10,17
20190221-W-Budapest-R16-Arantxa_Rus-Ekaterina_Alexandrova,1,F-DTL,8,4,2,0,2,4,4
20190221-W-Budapest-R16-Arantxa_Rus-Ekaterina_Alexandrova,1,F-IO,17,6,2,0,4,6,11
20190221-W-Budapest-R16-Arantxa_Rus-Ekaterina_Alexandrova,1,F-II,1,0,0,0,0,0,1
20190221-W-Budapest-R16-Arantxa_Rus-Ekaterina_Alexandrova,1,B-XC,20,7,2,0,5,9,11
20190221-W-Budapest-R16-Arantxa_Rus-Ekaterina_Alexandrova,1,B-DTM,37,4,0,0,4,17,20
20190221-W-Budapest-R16-Arantxa_Rus-Ekaterina_Alexandrova,1,B-DTL,5,4,1,0,3,1,4
20190221-W-Budapest-R16-Arantxa_Rus-Ekaterina_Alexandrova,1,B-IO,6,2,0,1,1,2,4
20190221-W-Budapest-R16-Arantxa_Rus-Ekaterina_Alexandrova,1,S-XC,2,0,0,0,0,2,0
20190221-W-Budapest-R16-Arantxa_Rus-Ekaterina_Alexandrova,1,S-DTM,2,1,0,1,0,2,0
20190221-W-Budapest-R16-Arantxa_Rus-Ekaterina_Alexandrova,1,S-IO,1,0,0,0,0,0,1
20190221-W-Budapest-R16-Arantxa_Rus-Ekaterina_Alexandrova,2,F-XC,29,8,3,1,4,15,14
20190221-W-Budapest-R16-Arantxa_Rus-Ekaterina_Alexandrova,2,F-DTM,14,2,0,0,2,8,6
20190221-W-Budapest-R16-Arantxa_Rus-Ekaterina_Alexandrova,2,F-DTL,6,1,1,0,0,5,1
20190221-W-Budapest-R16-Arantxa_Rus-Ekaterina_Alexandrova,2,F-IO,17,7,3,1,3,12,5
20190221-W-Budapest-R16-Arantxa_Rus-Ekaterina_Alexandrova,2,B-XC,19,4,1,2,1,14,5
20190221-W-Budapest-R16-Arantxa_Rus-Ekaterina_Alexandrova,2,B-DTM,33,1,0,0,1,18,15
20190221-W-Budapest-R16-Arantxa_Rus-Ekaterina_Alexandrova,2,B-DTL,5,3,2,1,0,4,1
20190221-W-Budapest-R16-Arantxa_Rus-Ekaterina_Alexandrova,2,B-IO,12,3,0,1,2,5,7
20190221-W-Budapest-R16-Arantxa_Rus-Ekaterina_Alexandrova,2,S-XC,1,0,0,0,0,0,1
20190221-W-Budapest-R16-Arantxa_Rus-Ekaterina_Alexandrova,2,S-DTM,1,0,0,0,0,1,0
20190221-W-Dubai-QF-Karolina_Pliskova-Su_Wei_Hsieh,1,F-XC,63,14,5,2,6,24,39
20190221-W-Dubai-QF-Karolina_Pliskova-Su_Wei_Hsieh,1,F-DTM,15,4,0,0,4,4,11
20190221-W-Dubai-QF-Karolina_Pliskova-Su_Wei_Hsieh,1,F-DTL,17,9,3,2,4,6,11
20190221-W-Dubai-QF-Karolina_Pliskova-Su_Wei_Hsieh,1,F-IO,16,7,2,2,3,7,9
20190221-W-Dubai-QF-Karolina_Pliskova-Su_Wei_Hsieh,1,B-XC,43,4,0,1,3,14,29
20190221-W-Dubai-QF-Karolina_Pliskova-Su_Wei_Hsieh,1,B-DTM,22,4,0,0,4,7,15
20190221-W-Dubai-QF-Karolina_Pliskova-Su_Wei_Hsieh,1,B-DTL,14,7,3,0,4,5,9
20190221-W-Dubai-QF-Karolina_Pliskova-Su_Wei_Hsieh,1,B-IO,8,2,1,0,1,2,6
20190221-W-Dubai-QF-Karolina_Pliskova-Su_Wei_Hsieh,1,S-XC,15,3,0,1,2,6,9
20190221-W-Dubai-QF-Karolina_Pliskova-Su_Wei_Hsieh,1,S-DTM,8,1,0,0,1,1,7
20190221-W-Dubai-QF-Karolina_Pliskova-Su_Wei_Hsieh,1,S-DTL,2,1,0,0,1,0,2
20190221-W-Dubai-QF-Karolina_Pliskova-Su_Wei_Hsieh,2,F-XC,36,9,3,3,3,29,7
20190221-W-Dubai-QF-Karolina_Pliskova-Su_Wei_Hsieh,2,F-DTM,18,5,0,0,5,7,11
20190221-W-Dubai-QF-Karolina_Pliskova-Su_Wei_Hsieh,2,F-DTL,19,4,1,2,1,13,6
20190221-W-Dubai-QF-Karolina_Pliskova-Su_Wei_Hsieh,2,F-IO,15,7,3,2,2,10,5
20190221-W-Dubai-QF-Karolina_Pliskova-Su_Wei_Hsieh,2,F-II,1,0,0,0,0,1,0
20190221-W-Dubai-QF-Karolina_Pliskova-Su_Wei_Hsieh,2,B-XC,58,11,2,3,6,38,20
20190221-W-Dubai-QF-Karolina_Pliskova-Su_Wei_Hsieh,2,B-DTM,23,0,0,0,0,18,5
20190221-W-Dubai-QF-Karolina_Pliskova-Su_Wei_Hsieh,2,B-DTL,23,11,3,3,5,15,8
20190221-W-Dubai-QF-Karolina_Pliskova-Su_Wei_Hsieh,2,B-IO,8,4,3,0,1,4,4
20190221-W-Dubai-QF-Karolina_Pliskova-Su_Wei_Hsieh,2,S-DTM,1,0,0,0,0,0,1
20190221-W-Dubai-QF-Karolina_Pliskova-Su_Wei_Hsieh,2,S-DTL,4,0,0,0,0,1,3
20190221-W-Dubai-QF-Karolina_Pliskova-Su_Wei_Hsieh,2,S-IO,1,1,1,0,0,1,0
20190219-W-Dubai-R32-Su_Wei_Hsieh-Aliaksandra_Sasnovich,1,F-XC,23,2,0,0,2,14,9
20190219-W-Dubai-R32-Su_Wei_Hsieh-Aliaksandra_Sasnovich,1,F-DTM,10,1,1,0,0,7,3
20190219-W-Dubai-R32-Su_Wei_Hsieh-Aliaksandra_Sasnovich,1,F-DTL,3,2,2,0,0,3,0
20190219-W-Dubai-R32-Su_Wei_Hsieh-Aliaksandra_Sasnovich,1,F-IO,7,5,3,2,0,6,1
20190219-W-Dubai-R32-Su_Wei_Hsieh-Aliaksandra_Sasnovich,1,B-XC,20,6,0,1,5,11,9
20190219-W-Dubai-R32-Su_Wei_Hsieh-Aliaksandra_Sasnovich,1,B-DTM,11,0,0,0,0,7,4
20190219-W-Dubai-R32-Su_Wei_Hsieh-Aliaksandra_Sasnovich,1,B-DTL,4,3,2,1,0,3,1
20190219-W-Dubai-R32-Su_Wei_Hsieh-Aliaksandra_Sasnovich,1,B-IO,4,1,0,0,1,1,3
20190219-W-Dubai-R32-Su_Wei_Hsieh-Aliaksandra_Sasnovich,1,S-XC,3,1,0,0,1,2,1
20190219-W-Dubai-R32-Su_Wei_Hsieh-Aliaksandra_Sasnovich,1,S-DTM,1,0,0,0,0,0,1
20190219-W-Dubai-R32-Su_Wei_Hsieh-Aliaksandra_Sasnovich,2,F-XC,22,5,1,1,3,11,11
20190219-W-Dubai-R32-Su_Wei_Hsieh-Aliaksandra_Sasnovich,2,F-DTM,10,0,0,0,0,5,5
20190219-W-Dubai-R32-Su_Wei_Hsieh-Aliaksandra_Sasnovich,2,F-DTL,11,5,2,0,3,4,7
20190219-W-Dubai-R32-Su_Wei_Hsieh-Aliaksandra_Sasnovich,2,F-IO,6,4,1,1,2,3,3
20190219-W-Dubai-R32-Su_Wei_Hsieh-Aliaksandra_Sasnovich,2,F-II,1,1,1,0,0,1,0
20190219-W-Dubai-R32-Su_Wei_Hsieh-Aliaksandra_Sasnovich,2,B-XC,15,7,1,1,5,8,7
20190219-W-Dubai-R32-Su_Wei_Hsieh-Aliaksandra_Sasnovich,2,B-DTM,9,1,0,0,1,1,8
20190219-W-Dubai-R32-Su_Wei_Hsieh-Aliaksandra_Sasnovich,2,B-DTL,9,5,1,1,3,2,7
20190219-W-Dubai-R32-Su_Wei_Hsieh-Aliaksandra_Sasnovich,2,B-IO,7,4,1,0,3,2,5
20190219-W-Dubai-R32-Su_Wei_Hsieh-Aliaksandra_Sasnovich,2,S-XC,2,0,0,0,0,1,1
20190219-W-Dubai-R32-Su_Wei_Hsieh-Aliaksandra_Sasnovich,2,S-DTM,2,0,0,0,0,0,2
20190219-W-Dubai-R32-Su_Wei_Hsieh-Aliaksandra_Sasnovich,2,S-DTL,2,0,0,0,0,0,2
20190220-W-Dubai-R16-Jennifer_Brady-Petra_Kvitova,1,F-XC,26,7,2,3,2,20,6
20190220-W-Dubai-R16-Jennifer_Brady-Petra_Kvitova,1,F-DTM,24,4,0,2,2,13,11
20190220-W-Dubai-R16-Jennifer_Brady-Petra_Kvitova,1,F-DTL,19,8,2,2,4,11,8
20190220-W-Dubai-R16-Jennifer_Brady-Petra_Kvitova,1,F-IO,20,9,4,1,4,11,9
20190220-W-Dubai-R16-Jennifer_Brady-Petra_Kvitova,1,B-XC,30,7,0,3,4,16,14
20190220-W-Dubai-R16-Jennifer_Brady-Petra_Kvitova,1,B-DTM,13,2,0,0,2,4,9
20190220-W-Dubai-R16-Jennifer_Brady-Petra_Kvitova,1,B-DTL,7,4,1,2,1,3,4
20190220-W-Dubai-R16-Jennifer_Brady-Petra_Kvitova,1,B-IO,1,0,0,0,0,0,1
20190220-W-Dubai-R16-Jennifer_Brady-Petra_Kvitova,1,S-XC,3,0,0,0,0,2,1
20190220-W-Dubai-R16-Jennifer_Brady-Petra_Kvitova,1,S-DTM,3,0,0,0,0,1,2
20190220-W-Dubai-R16-Jennifer_Brady-Petra_Kvitova,1,S-DTL,1,0,0,0,0,0,1
20190220-W-Dubai-R16-Jennifer_Brady-Petra_Kvitova,2,F-XC,44,11,2,2,7,20,24
20190220-W-Dubai-R16-Jennifer_Brady-Petra_Kvitova,2,F-DTM,27,3,1,0,2,13,14
20190220-W-Dubai-R16-Jennifer_Brady-Petra_Kvitova,2,F-DTL,12,8,4,0,4,7,5
20190220-W-Dubai-R16-Jennifer_Brady-Petra_Kvitova,2,F-IO,24,13,4,4,5,14,10
20190220-W-Dubai-R16-Jennifer_Brady-Petra_Kvitova,2,F-II,2,2,1,0,1,1,1
20190220-W-Dubai-R16-Jennifer_Brady-Petra_Kvitova,2,B-XC,20,3,1,1,1,7,13
20190220-W-Dubai-R16-Jennifer_Brady-Petra_Kvitova,2,B-DTM,14,2,0,0,2,4,10
20190220-W-Dubai-R16-Jennifer_Brady-Petra_Kvitova,2,B-DTL,1,0,0,0,0,0,1
20190220-W-Dubai-R16-Jennifer_Brady-Petra_Kvitova,2,B-IO,7,3,2,0,1,6,1
20190220-W-Dubai-R16-Jennifer_Brady-Petra_Kvitova,2,S-XC,4,1,0,0,1,2,2
20190220-W-Dubai-R16-Kristina_Mladenovic-Carla_Suarez_Navarro,1,F-XC,26,12,4,4,4,15,11
20190220-W-Dubai-R16-Kristina_Mladenovic-Carla_Suarez_Navarro,1,F-DTM,27,3,0,0,3,7,20
20190220-W-Dubai-R16-Kristina_Mladenovic-Carla_Suarez_Navarro,1,F-DTL,6,5,0,2,3,2,4
20190220-W-Dubai-R16-Kristina_Mladenovic-Carla_Suarez_Navarro,1,F-IO,31,11,2,1,8,13,18
20190220-W-Dubai-R16-Kristina_Mladenovic-Carla_Suarez_Navarro,1,F-II,5,5,2,0,3,2,3
20190220-W-Dubai-R16-Kristina_Mladenovic-Carla_Suarez_Navarro,1,B-XC,33,9,2,1,6,11,22
20190220-W-Dubai-R16-Kristina_Mladenovic-Carla_Suarez_Navarro,1,B-DTM,66,5,0,1,4,24,42
20190220-W-Dubai-R16-Kristina_Mladenovic-Carla_Suarez_Navarro,1,B-DTL,10,7,3,0,4,4,6
20190220-W-Dubai-R16-Kristina_Mladenovic-Carla_Suarez_Navarro,1,B-IO,8,4,0,0,4,2,6
20190220-W-Dubai-R16-Kristina_Mladenovic-Carla_Suarez_Navarro,1,S-XC,12,2,0,0,2,3,9
20190220-W-Dubai-R16-Kristina_Mladenovic-Carla_Suarez_Navarro,1,S-DTM,10,2,0,0,2,4,6
20190220-W-Dubai-R16-Kristina_Mladenovic-Carla_Suarez_Navarro,1,S-DTL,1,0,0,0,0,1,0
20190220-W-Dubai-R16-Kristina_Mladenovic-Carla_Suarez_Navarro,1,S-IO,1,0,0,0,0,0,1
20190220-W-Dubai-R16-Kristina_Mladenovic-Carla_Suarez_Navarro,2,F-XC,37,14,7,3,4,25,12
20190220-W-Dubai-R16-Kristina_Mladenovic-Carla_Suarez_Navarro,2,F-DTM,45,3,0,0,3,27,18
20190220-W-Dubai-R16-Kristina_Mladenovic-Carla_Suarez_Navarro,2,F-DTL,6,3,1,0,2,2,4
20190220-W-Dubai-R16-Kristina_Mladenovic-Carla_Suarez_Navarro,2,F-IO,39,6,2,0,4,23,16
20190220-W-Dubai-R16-Kristina_Mladenovic-Carla_Suarez_Navarro,2,F-II,2,2,2,0,0,2,0
20190220-W-Dubai-R16-Kristina_Mladenovic-Carla_Suarez_Navarro,2,B-XC,47,7,0,0,7,24,23
20190220-W-Dubai-R16-Kristina_Mladenovic-Carla_Suarez_Navarro,2,B-DTM,31,2,1,0,1,18,13
20190220-W-Dubai-R16-Kristina_Mladenovic-Carla_Suarez_Navarro,2,B-DTL,5,4,3,0,1,4,1
20190220-W-Dubai-R16-Kristina_Mladenovic-Carla_Suarez_Navarro,2,B-IO,4,2,2,0,0,3,1
20190220-W-Dubai-R16-Kristina_Mladenovic-Carla_Suarez_Navarro,2,S-XC,10,2,0,0,2,6,4
20190220-W-Dubai-R16-Kristina_Mladenovic-Carla_Suarez_Navarro,2,S-DTM,2,0,0,0,0,2,0
20190220-W-Dubai-R16-Kristina_Mladenovic-Carla_Suarez_Navarro,2,S-DTL,1,0,0,0,0,0,1
20190219-W-Budapest-R32-Tereza_Smitkova-Ysaline_Bonaventure,1,F-XC,40,16,5,3,8,18,22
20190219-W-Budapest-R32-Tereza_Smitkova-Ysaline_Bonaventure,1,F-DTM,8,0,0,0,0,5,3
20190219-W-Budapest-R32-Tereza_Smitkova-Ysaline_Bonaventure,1,F-DTL,14,6,2,0,4,7,7
20190219-W-Budapest-R32-Tereza_Smitkova-Ysaline_Bonaventure,1,F-IO,15,9,5,2,2,12,3
20190219-W-Budapest-R32-Tereza_Smitkova-Ysaline_Bonaventure,1,B-XC,16,4,1,2,1,8,8
20190219-W-Budapest-R32-Tereza_Smitkova-Ysaline_Bonaventure,1,B-DTM,21,2,0,0,2,10,11
20190219-W-Budapest-R32-Tereza_Smitkova-Ysaline_Bonaventure,1,B-DTL,8,4,1,1,2,4,4
20190219-W-Budapest-R32-Tereza_Smitkova-Ysaline_Bonaventure,1,B-IO,10,4,3,0,1,5,5
20190219-W-Budapest-R32-Tereza_Smitkova-Ysaline_Bonaventure,1,S-XC,2,0,0,0,0,2,0
20190219-W-Budapest-R32-Tereza_Smitkova-Ysaline_Bonaventure,1,S-DTM,4,0,0,0,0,2,2
20190219-W-Budapest-R32-Tereza_Smitkova-Ysaline_Bonaventure,1,S-DTL,1,1,1,0,0,1,0
20190219-W-Budapest-R32-Tereza_Smitkova-Ysaline_Bonaventure,1,S-IO,1,0,0,0,0,1,0
20190219-W-Budapest-R32-Tereza_Smitkova-Ysaline_Bonaventure,2,F-XC,32,11,2,6,3,18,14
20190219-W-Budapest-R32-Tereza_Smitkova-Ysaline_Bonaventure,2,F-DTM,23,2,1,0,1,7,16
20190219-W-Budapest-R32-Tereza_Smitkova-Ysaline_Bonaventure,2,F-DTL,17,8,2,0,6,8,9
20190219-W-Budapest-R32-Tereza_Smitkova-Ysaline_Bonaventure,2,F-IO,26,13,3,5,5,14,12
20190219-W-Budapest-R32-Tereza_Smitkova-Ysaline_Bonaventure,2,B-XC,23,3,0,1,2,14,9
20190219-W-Budapest-R32-Tereza_Smitkova-Ysaline_Bonaventure,2,B-DTM,23,2,0,0,2,12,11
20190219-W-Budapest-R32-Tereza_Smitkova-Ysaline_Bonaventure,2,B-DTL,12,2,0,1,1,6,6
20190219-W-Budapest-R32-Tereza_Smitkova-Ysaline_Bonaventure,2,B-IO,10,6,1,3,2,6,4
20190219-W-Budapest-R32-Tereza_Smitkova-Ysaline_Bonaventure,2,S-DTM,3,0,0,0,0,2,1
20190219-W-Budapest-R32-Tereza_Smitkova-Ysaline_Bonaventure,2,S-DTL,3,0,0,0,0,1,2
20190219-W-Budapest-R32-Tereza_Smitkova-Ysaline_Bonaventure,2,S-IO,1,0,0,0,0,1,0
20190221-W-Budapest-R16-Iga_Swiatek-Alison_Van_Uytvanck,1,F-XC,32,14,4,6,4,17,15
20190221-W-Budapest-R16-Iga_Swiatek-Alison_Van_Uytvanck,1,F-DTM,10,1,0,0,1,6,4
20190221-W-Budapest-R16-Iga_Swiatek-Alison_Van_Uytvanck,1,F-DTL,11,7,1,1,5,4,7
20190221-W-Budapest-R16-Iga_Swiatek-Alison_Van_Uytvanck,1,F-IO,16,5,2,2,1,10,6
20190221-W-Budapest-R16-Iga_Swiatek-Alison_Van_Uytvanck,1,F-II,1,0,0,0,0,0,1
20190221-W-Budapest-R16-Iga_Swiatek-Alison_Van_Uytvanck,1,B-XC,37,8,1,1,6,18,19
20190221-W-Budapest-R16-Iga_Swiatek-Alison_Van_Uytvanck,1,B-DTM,16,2,0,0,2,6,10
20190221-W-Budapest-R16-Iga_Swiatek-Alison_Van_Uytvanck,1,B-DTL,14,5,1,1,3,5,9
20190221-W-Budapest-R16-Iga_Swiatek-Alison_Van_Uytvanck,1,B-IO,11,4,2,1,1,4,7
20190221-W-Budapest-R16-Iga_Swiatek-Alison_Van_Uytvanck,1,S-XC,1,1,0,0,1,0,1
20190221-W-Budapest-R16-Iga_Swiatek-Alison_Van_Uytvanck,1,S-DTM,1,0,0,0,0,0,1
20190221-W-Budapest-R16-Iga_Swiatek-Alison_Van_Uytvanck,1,S-DTL,2,1,0,0,1,1,1
20190221-W-Budapest-R16-Iga_Swiatek-Alison_Van_Uytvanck,2,F-XC,32,8,3,2,3,21,11
20190221-W-Budapest-R16-Iga_Swiatek-Alison_Van_Uytvanck,2,F-DTM,13,2,0,1,1,7,6
20190221-W-Budapest-R16-Iga_Swiatek-Alison_Van_Uytvanck,2,F-DTL,10,5,1,0,4,6,4
20190221-W-Budapest-R16-Iga_Swiatek-Alison_Van_Uytvanck,2,F-IO,11,4,0,3,1,8,3
20190221-W-Budapest-R16-Iga_Swiatek-Alison_Van_Uytvanck,2,B-XC,28,5,1,1,3,15,13
20190221-W-Budapest-R16-Iga_Swiatek-Alison_Van_Uytvanck,2,B-DTM,22,1,0,0,1,12,10
20190221-W-Budapest-R16-Iga_Swiatek-Alison_Van_Uytvanck,2,B-DTL,10,4,1,1,2,6,4
20190221-W-Budapest-R16-Iga_Swiatek-Alison_Van_Uytvanck,2,B-IO,3,2,0,1,1,2,1
20190221-W-Budapest-R16-Iga_Swiatek-Alison_Van_Uytvanck,2,S-XC,3,0,0,0,0,2,1
20190221-W-Budapest-R16-Iga_Swiatek-Alison_Van_Uytvanck,2,S-DTM,10,0,0,0,0,3,7
20190221-W-Budapest-R16-Iga_Swiatek-Alison_Van_Uytvanck,2,S-DTL,4,0,0,0,0,1,3
20190221-W-Budapest-R16-Iga_Swiatek-Alison_Van_Uytvanck,2,S-IO,2,0,0,0,0,1,1
20190220-W-Budapest-R32-Georgina_Garcia_Perez-Marketa_Vondrousova,1,F-XC,25,9,0,0,9,6,19
20190220-W-Budapest-R32-Georgina_Garcia_Perez-Marketa_Vondrousova,1,F-DTM,16,1,0,0,1,6,10
20190220-W-Budapest-R32-Georgina_Garcia_Perez-Marketa_Vondrousova,1,F-DTL,20,7,1,0,6,6,14
20190220-W-Budapest-R32-Georgina_Garcia_Perez-Marketa_Vondrousova,1,F-IO,17,7,1,4,2,11,6
20190220-W-Budapest-R32-Georgina_Garcia_Perez-Marketa_Vondrousova,1,B-XC,50,11,2,5,4,22,28
20190220-W-Budapest-R32-Georgina_Garcia_Perez-Marketa_Vondrousova,1,B-DTM,35,0,0,0,0,13,22
20190220-W-Budapest-R32-Georgina_Garcia_Perez-Marketa_Vondrousova,1,B-DTL,16,6,1,1,4,6,10
20190220-W-Budapest-R32-Georgina_Garcia_Perez-Marketa_Vondrousova,1,B-IO,8,3,1,1,1,3,5
20190220-W-Budapest-R32-Georgina_Garcia_Perez-Marketa_Vondrousova,1,S-XC,2,0,0,0,0,2,0
20190220-W-Budapest-R32-Georgina_Garcia_Perez-Marketa_Vondrousova,1,S-DTM,3,0,0,0,0,0,3
20190220-W-Budapest-R32-Georgina_Garcia_Perez-Marketa_Vondrousova,1,S-DTL,2,0,0,0,0,2,0
20190220-W-Budapest-R32-Georgina_Garcia_Perez-Marketa_Vondrousova,1,S-II,1,0,0,0,0,0,1
20190220-W-Budapest-R32-Georgina_Garcia_Perez-Marketa_Vondrousova,2,F-XC,83,11,1,4,6,45,38
20190220-W-Budapest-R32-Georgina_Garcia_Perez-Marketa_Vondrousova,2,F-DTM,20,1,0,0,1,15,5
20190220-W-Budapest-R32-Georgina_Garcia_Perez-Marketa_Vondrousova,2,F-DTL,14,6,5,0,1,10,4
20190220-W-Budapest-R32-Georgina_Garcia_Perez-Marketa_Vondrousova,2,F-IO,3,1,0,0,1,2,1
20190220-W-Budapest-R32-Georgina_Garcia_Perez-Marketa_Vondrousova,2,B-XC,33,3,0,1,2,19,14
20190220-W-Budapest-R32-Georgina_Garcia_Perez-Marketa_Vondrousova,2,B-DTM,16,0,0,0,0,12,4
20190220-W-Budapest-R32-Georgina_Garcia_Perez-Marketa_Vondrousova,2,B-IO,1,0,0,0,0,1,0
20190220-W-Budapest-R32-Georgina_Garcia_Perez-Marketa_Vondrousova,2,S-XC,1,0,0,0,0,1,0
20190220-W-Budapest-R32-Georgina_Garcia_Perez-Marketa_Vondrousova,2,S-DTM,4,0,0,0,0,3,1
20190220-W-Budapest-R32-Georgina_Garcia_Perez-Marketa_Vondrousova,2,S-DTL,1,0,0,0,0,0,1
20190108-W-Hobart-R32-Maria_Sakkari-Magda_Linette,1,F-XC,48,20,9,3,8,26,22
20190108-W-Hobart-R32-Maria_Sakkari-Magda_Linette,1,F-DTM,29,2,0,0,2,13,16
20190108-W-Hobart-R32-Maria_Sakkari-Magda_Linette,1,F-DTL,12,5,3,0,2,8,4
20190108-W-Hobart-R32-Maria_Sakkari-Magda_Linette,1,F-IO,26,9,3,1,5,16,10
20190108-W-Hobart-R32-Maria_Sakkari-Magda_Linette,1,F-II,1,0,0,0,0,1,0
20190108-W-Hobart-R32-Maria_Sakkari-Magda_Linette,1,B-XC,46,14,5,2,7,27,19
20190108-W-Hobart-R32-Maria_Sakkari-Magda_Linette,1,B-DTM,19,2,0,0,2,8,11
20190108-W-Hobart-R32-Maria_Sakkari-Magda_Linette,1,B-DTL,7,5,4,0,1,6,1
20190108-W-Hobart-R32-Maria_Sakkari-Magda_Linette,1,B-IO,5,3,0,1,1,2,3
20190108-W-Hobart-R32-Maria_Sakkari-Magda_Linette,1,S-XC,2,0,0,0,0,0,2
20190108-W-Hobart-R32-Maria_Sakkari-Magda_Linette,2,F-XC,45,12,3,2,7,21,24
20190108-W-Hobart-R32-Maria_Sakkari-Magda_Linette,2,F-DTM,27,5,0,0,5,8,19
20190108-W-Hobart-R32-Maria_Sakkari-Magda_Linette,2,F-DTL,1,1,1,0,0,1,0
20190108-W-Hobart-R32-Maria_Sakkari-Magda_Linette,2,F-IO,6,3,3,0,0,5,1
20190108-W-Hobart-R32-Maria_Sakkari-Magda_Linette,2,F-II,1,1,1,0,0,1,0
20190108-W-Hobart-R32-Maria_Sakkari-Magda_Linette,2,B-XC,48,5,0,2,3,20,28
20190108-W-Hobart-R32-Maria_Sakkari-Magda_Linette,2,B-DTM,36,3,0,0,3,18,18
20190108-W-Hobart-R32-Maria_Sakkari-Magda_Linette,2,B-DTL,14,5,1,3,1,6,8
20190108-W-Hobart-R32-Maria_Sakkari-Magda_Linette,2,B-IO,4,2,0,1,1,3,1
20190108-W-Hobart-R32-Maria_Sakkari-Magda_Linette,2,S-DTM,1,0,0,0,0,0,1
20190108-W-Hobart-R32-Maria_Sakkari-Magda_Linette,2,S-DTL,2,0,0,0,0,1,1
20190301-W-Acapulco-SF-Bianca_Andreescu-Sofia_Kenin,1,F-XC,36,16,4,2,10,15,21
20190301-W-Acapulco-SF-Bianca_Andreescu-Sofia_Kenin,1,F-DTM,32,3,0,1,2,15,17
20190301-W-Acapulco-SF-Bianca_Andreescu-Sofia_Kenin,1,F-DTL,10,4,1,2,1,7,3
20190301-W-Acapulco-SF-Bianca_Andreescu-Sofia_Kenin,1,F-IO,14,5,3,0,2,8,6
20190301-W-Acapulco-SF-Bianca_Andreescu-Sofia_Kenin,1,B-XC,17,10,2,2,6,8,9
20190301-W-Acapulco-SF-Bianca_Andreescu-Sofia_Kenin,1,B-DTM,23,4,0,2,2,9,14
20190301-W-Acapulco-SF-Bianca_Andreescu-Sofia_Kenin,1,B-DTL,5,1,0,0,1,2,3
20190301-W-Acapulco-SF-Bianca_Andreescu-Sofia_Kenin,1,S-XC,2,1,0,0,1,0,2
20190301-W-Acapulco-SF-Bianca_Andreescu-Sofia_Kenin,1,S-DTM,19,2,0,0,2,10,9
20190301-W-Acapulco-SF-Bianca_Andreescu-Sofia_Kenin,1,S-DTL,7,1,0,1,0,4,3
20190301-W-Acapulco-SF-Bianca_Andreescu-Sofia_Kenin,1,S-IO,1,0,0,0,0,0,1
20190301-W-Acapulco-SF-Bianca_Andreescu-Sofia_Kenin,2,F-XC,33,12,6,3,3,23,10
20190301-W-Acapulco-SF-Bianca_Andreescu-Sofia_Kenin,2,F-DTM,34,1,0,0,1,17,17
20190301-W-Acapulco-SF-Bianca_Andreescu-Sofia_Kenin,2,F-DTL,5,2,0,1,1,3,2
20190301-W-Acapulco-SF-Bianca_Andreescu-Sofia_Kenin,2,F-IO,16,10,5,1,4,10,6
20190301-W-Acapulco-SF-Bianca_Andreescu-Sofia_Kenin,2,B-XC,39,9,1,1,7,15,24
20190301-W-Acapulco-SF-Bianca_Andreescu-Sofia_Kenin,2,B-DTM,32,4,0,0,4,19,13
20190301-W-Acapulco-SF-Bianca_Andreescu-Sofia_Kenin,2,B-DTL,2,1,1,0,0,2,0
20190301-W-Acapulco-SF-Bianca_Andreescu-Sofia_Kenin,2,B-IO,10,6,5,1,0,8,2
20190301-W-Acapulco-SF-Bianca_Andreescu-Sofia_Kenin,2,S-XC,4,0,0,0,0,2,2
20190301-W-Acapulco-SF-Bianca_Andreescu-Sofia_Kenin,2,S-DTM,5,0,0,0,0,3,2
20190301-W-Acapulco-SF-Bianca_Andreescu-Sofia_Kenin,2,S-DTL,1,0,0,0,0,1,0
20190301-W-Acapulco-SF-Donna_Vekic-Yafan_Wang,1,F-XC,61,17,2,6,9,27,34
20190301-W-Acapulco-SF-Donna_Vekic-Yafan_Wang,1,F-DTM,41,4,0,0,4,16,25
20190301-W-Acapulco-SF-Donna_Vekic-Yafan_Wang,1,F-DTL,14,7,2,1,4,7,7
20190301-W-Acapulco-SF-Donna_Vekic-Yafan_Wang,1,F-IO,33,21,8,4,9,16,17
20190301-W-Acapulco-SF-Donna_Vekic-Yafan_Wang,1,B-XC,26,4,0,1,3,17,9
20190301-W-Acapulco-SF-Donna_Vekic-Yafan_Wang,1,B-DTM,20,0,0,0,0,6,14
20190301-W-Acapulco-SF-Donna_Vekic-Yafan_Wang,1,B-DTL,12,7,2,1,4,5,7
20190301-W-Acapulco-SF-Donna_Vekic-Yafan_Wang,1,B-IO,5,1,0,0,1,1,4
20190301-W-Acapulco-SF-Donna_Vekic-Yafan_Wang,1,S-XC,1,0,0,0,0,1,0
20190301-W-Acapulco-SF-Donna_Vekic-Yafan_Wang,2,F-XC,63,11,2,6,3,38,25
20190301-W-Acapulco-SF-Donna_Vekic-Yafan_Wang,2,F-DTM,37,2,0,0,2,20,17
20190301-W-Acapulco-SF-Donna_Vekic-Yafan_Wang,2,F-DTL,12,8,4,1,3,8,4
20190301-W-Acapulco-SF-Donna_Vekic-Yafan_Wang,2,F-IO,16,6,3,2,1,11,5
20190301-W-Acapulco-SF-Donna_Vekic-Yafan_Wang,2,F-II,3,1,0,0,1,0,3
20190301-W-Acapulco-SF-Donna_Vekic-Yafan_Wang,2,B-XC,27,2,0,0,2,12,15
20190301-W-Acapulco-SF-Donna_Vekic-Yafan_Wang,2,B-DTM,21,1,0,0,1,10,11
20190301-W-Acapulco-SF-Donna_Vekic-Yafan_Wang,2,B-DTL,7,2,0,1,1,3,4
20190301-W-Acapulco-SF-Donna_Vekic-Yafan_Wang,2,B-IO,5,1,0,1,0,3,2
20190301-W-Acapulco-SF-Donna_Vekic-Yafan_Wang,2,S-XC,3,0,0,0,0,1,2
20190301-W-Acapulco-SF-Donna_Vekic-Yafan_Wang,2,S-DTM,2,0,0,0,0,0,2
20190301-W-Acapulco-SF-Donna_Vekic-Yafan_Wang,2,S-DTL,1,0,0,0,0,1,0
20190301-W-Acapulco-SF-Donna_Vekic-Yafan_Wang,2,S-IO,2,0,0,0,0,2,0
20190223-W-Budapest-SF-Anastasia_Potapova-Marketa_Vondrousova,1,F-XC,29,7,1,1,5,9,20
20190223-W-Budapest-SF-Anastasia_Potapova-Marketa_Vondrousova,1,F-DTM,7,0,0,0,0,4,3
20190223-W-Budapest-SF-Anastasia_Potapova-Marketa_Vondrousova,1,F-DTL,13,6,2,0,4,5,8
20190223-W-Budapest-SF-Anastasia_Potapova-Marketa_Vondrousova,1,F-IO,8,1,1,0,0,4,4
20190223-W-Budapest-SF-Anastasia_Potapova-Marketa_Vondrousova,1,F-II,2,1,1,0,0,2,0
20190223-W-Budapest-SF-Anastasia_Potapova-Marketa_Vondrousova,1,B-XC,24,5,3,0,2,13,11
20190223-W-Budapest-SF-Anastasia_Potapova-Marketa_Vondrousova,1,B-DTM,8,0,0,0,0,5,3
20190223-W-Budapest-SF-Anastasia_Potapova-Marketa_Vondrousova,1,B-DTL,13,4,0,2,2,8,5
20190223-W-Budapest-SF-Anastasia_Potapova-Marketa_Vondrousova,1,B-IO,6,2,1,0,1,3,3
20190223-W-Budapest-SF-Anastasia_Potapova-Marketa_Vondrousova,1,S-XC,2,0,0,0,0,1,1
20190223-W-Budapest-SF-Anastasia_Potapova-Marketa_Vondrousova,1,S-DTM,1,0,0,0,0,0,1
20190223-W-Budapest-SF-Anastasia_Potapova-Marketa_Vondrousova,1,S-DTL,1,0,0,0,0,0,1
20190223-W-Budapest-SF-Anastasia_Potapova-Marketa_Vondrousova,1,S-IO,1,0,0,0,0,0,1
20190223-W-Budapest-SF-Anastasia_Potapova-Marketa_Vondrousova,2,F-XC,33,7,1,3,3,14,19
20190223-W-Budapest-SF-Anastasia_Potapova-Marketa_Vondrousova,2,F-DTM,12,0,0,0,0,8,4
20190223-W-Budapest-SF-Anastasia_Potapova-Marketa_Vondrousova,2,F-DTL,5,2,0,0,2,2,3
20190223-W-Budapest-SF-Anastasia_Potapova-Marketa_Vondrousova,2,B-XC,28,6,2,1,3,18,10
20190223-W-Budapest-SF-Anastasia_Potapova-Marketa_Vondrousova,2,B-DTM,8,0,0,0,0,4,4
20190223-W-Budapest-SF-Anastasia_Potapova-Marketa_Vondrousova,2,B-DTL,1,0,0,0,0,1,0
20190223-W-Budapest-SF-Anastasia_Potapova-Marketa_Vondrousova,2,B-IO,1,0,0,0,0,0,1
20190223-W-Budapest-SF-Anastasia_Potapova-Marketa_Vondrousova,2,S-DTM,8,0,0,0,0,4,4
20190223-W-Budapest-SF-Anastasia_Potapova-Marketa_Vondrousova,2,S-DTL,3,1,1,0,0,2,1
20110910-W-US_Open-SF-Samantha_Stosur-Angelique_Kerber,1,F-XC,47,10,4,3,3,26,21
20110910-W-US_Open-SF-Samantha_Stosur-Angelique_Kerber,1,F-DTM,25,1,0,1,0,7,18
20110910-W-US_Open-SF-Samantha_Stosur-Angelique_Kerber,1,F-DTL,36,14,5,3,6,17,19
20110910-W-US_Open-SF-Samantha_Stosur-Angelique_Kerber,1,F-IO,40,17,6,8,3,23,17
20110910-W-US_Open-SF-Samantha_Stosur-Angelique_Kerber,1,F-II,5,1,0,0,1,3,2
20110910-W-US_Open-SF-Samantha_Stosur-Angelique_Kerber,1,B-XC,8,1,0,0,1,3,5
20110910-W-US_Open-SF-Samantha_Stosur-Angelique_Kerber,1,B-DTM,22,0,0,0,0,11,11
20110910-W-US_Open-SF-Samantha_Stosur-Angelique_Kerber,1,B-DTL,9,5,0,1,4,3,6
20110910-W-US_Open-SF-Samantha_Stosur-Angelique_Kerber,1,B-IO,1,1,0,0,1,0,1
20110910-W-US_Open-SF-Samantha_Stosur-Angelique_Kerber,1,S-XC,12,1,0,0,1,3,9
20110910-W-US_Open-SF-Samantha_Stosur-Angelique_Kerber,1,S-DTM,17,0,0,0,0,5,12
20110910-W-US_Open-SF-Samantha_Stosur-Angelique_Kerber,1,S-DTL,7,2,1,1,0,5,2
20110910-W-US_Open-SF-Samantha_Stosur-Angelique_Kerber,1,S-IO,1,0,0,0,0,0,1
20110910-W-US_Open-SF-Samantha_Stosur-Angelique_Kerber,2,F-XC,63,8,3,5,0,46,17
20110910-W-US_Open-SF-Samantha_Stosur-Angelique_Kerber,2,F-DTM,12,1,0,0,1,1,11
20110910-W-US_Open-SF-Samantha_Stosur-Angelique_Kerber,2,F-DTL,21,14,3,6,5,15,6
20110910-W-US_Open-SF-Samantha_Stosur-Angelique_Kerber,2,F-IO,20,10,1,5,4,12,8
20110910-W-US_Open-SF-Samantha_Stosur-Angelique_Kerber,2,F-II,1,1,0,0,1,0,1
20110910-W-US_Open-SF-Samantha_Stosur-Angelique_Kerber,2,B-XC,46,3,0,2,1,29,17
20110910-W-US_Open-SF-Samantha_Stosur-Angelique_Kerber,2,B-DTM,20,0,0,0,0,12,8
20110910-W-US_Open-SF-Samantha_Stosur-Angelique_Kerber,2,B-DTL,3,2,0,0,2,1,2
20110910-W-US_Open-SF-Samantha_Stosur-Angelique_Kerber,2,B-IO,8,2,0,0,2,4,4
20110910-W-US_Open-SF-Samantha_Stosur-Angelique_Kerber,2,S-XC,1,0,0,0,0,0,1
20110910-W-US_Open-SF-Samantha_Stosur-Angelique_Kerber,2,S-DTM,5,0,0,0,0,2,3
20110910-W-US_Open-SF-Samantha_Stosur-Angelique_Kerber,2,S-IO,1,0,0,0,0,1,0
20181017-W-Moscow-R16-Alize_Cornet-Daria_Kasatkina,1,F-XC,66,13,3,4,6,41,25
20181017-W-Moscow-R16-Alize_Cornet-Daria_Kasatkina,1,F-DTM,64,3,0,0,3,30,34
20181017-W-Moscow-R16-Alize_Cornet-Daria_Kasatkina,1,F-DTL,18,4,0,0,4,8,10
20181017-W-Moscow-R16-Alize_Cornet-Daria_Kasatkina,1,F-IO,32,7,3,0,4,15,17
20181017-W-Moscow-R16-Alize_Cornet-Daria_Kasatkina,1,B-XC,81,10,3,0,7,36,45
20181017-W-Moscow-R16-Alize_Cornet-Daria_Kasatkina,1,B-DTM,68,4,0,0,4,28,40
20181017-W-Moscow-R16-Alize_Cornet-Daria_Kasatkina,1,B-DTL,9,7,2,0,5,2,7
20181017-W-Moscow-R16-Alize_Cornet-Daria_Kasatkina,1,B-IO,8,1,1,0,0,4,4
20181017-W-Moscow-R16-Alize_Cornet-Daria_Kasatkina,1,S-XC,16,1,0,0,1,5,11
20181017-W-Moscow-R16-Alize_Cornet-Daria_Kasatkina,1,S-DTM,14,1,1,0,0,4,10
20181017-W-Moscow-R16-Alize_Cornet-Daria_Kasatkina,1,S-DTL,1,0,0,0,0,1,0
20181017-W-Moscow-R16-Alize_Cornet-Daria_Kasatkina,2,F-XC,72,19,5,1,13,37,35
20181017-W-Moscow-R16-Alize_Cornet-Daria_Kasatkina,2,F-DTM,47,4,0,0,4,22,25
20181017-W-Moscow-R16-Alize_Cornet-Daria_Kasatkina,2,F-DTL,10,5,0,0,5,4,6
20181017-W-Moscow-R16-Alize_Cornet-Daria_Kasatkina,2,F-IO,43,13,3,6,4,28,15
20181017-W-Moscow-R16-Alize_Cornet-Daria_Kasatkina,2,F-II,6,3,2,1,0,5,1
20181017-W-Moscow-R16-Alize_Cornet-Daria_Kasatkina,2,B-XC,70,5,2,1,2,41,29
20181017-W-Moscow-R16-Alize_Cornet-Daria_Kasatkina,2,B-DTM,87,8,0,0,8,37,50
20181017-W-Moscow-R16-Alize_Cornet-Daria_Kasatkina,2,B-DTL,10,7,2,1,4,5,5
20181017-W-Moscow-R16-Alize_Cornet-Daria_Kasatkina,2,B-IO,19,4,0,1,3,11,8
20181017-W-Moscow-R16-Alize_Cornet-Daria_Kasatkina,2,S-XC,9,0,0,0,0,6,3
20181017-W-Moscow-R16-Alize_Cornet-Daria_Kasatkina,2,S-DTM,14,0,0,0,0,7,7
20181017-W-Moscow-R16-Alize_Cornet-Daria_Kasatkina,2,S-DTL,5,1,0,0,1,1,4
20181017-W-Moscow-R16-Alize_Cornet-Daria_Kasatkina,2,S-IO,2,0,0,0,0,0,2
20190223-W-Budapest-SF-Alison_Van_Uytvanck-Ekaterina_Alexandrova,1,F-XC,64,15,2,5,8,30,34
20190223-W-Budapest-SF-Alison_Van_Uytvanck-Ekaterina_Alexandrova,1,F-DTM,40,2,0,0,2,18,22
20190223-W-Budapest-SF-Alison_Van_Uytvanck-Ekaterina_Alexandrova,1,F-DTL,25,11,4,0,7,8,17
20190223-W-Budapest-SF-Alison_Van_Uytvanck-Ekaterina_Alexandrova,1,F-IO,10,1,0,0,1,4,6
20190223-W-Budapest-SF-Alison_Van_Uytvanck-Ekaterina_Alexandrova,1,F-II,2,2,2,0,0,2,0
20190223-W-Budapest-SF-Alison_Van_Uytvanck-Ekaterina_Alexandrova,1,B-XC,32,5,1,1,3,14,18
20190223-W-Budapest-SF-Alison_Van_Uytvanck-Ekaterina_Alexandrova,1,B-DTM,33,3,0,1,2,15,18
20190223-W-Budapest-SF-Alison_Van_Uytvanck-Ekaterina_Alexandrova,1,B-DTL,8,4,2,0,2,3,5
20190223-W-Budapest-SF-Alison_Van_Uytvanck-Ekaterina_Alexandrova,1,B-IO,3,1,0,0,1,1,2
20190223-W-Budapest-SF-Alison_Van_Uytvanck-Ekaterina_Alexandrova,1,S-XC,9,0,0,0,0,5,4
20190223-W-Budapest-SF-Alison_Van_Uytvanck-Ekaterina_Alexandrova,1,S-DTM,15,0,0,0,0,8,7
20190223-W-Budapest-SF-Alison_Van_Uytvanck-Ekaterina_Alexandrova,1,S-DTL,7,0,0,0,0,3,4
20190223-W-Budapest-SF-Alison_Van_Uytvanck-Ekaterina_Alexandrova,1,S-IO,8,1,0,1,0,5,3
20190223-W-Budapest-SF-Alison_Van_Uytvanck-Ekaterina_Alexandrova,2,F-XC,52,12,1,4,7,28,24
20190223-W-Budapest-SF-Alison_Van_Uytvanck-Ekaterina_Alexandrova,2,F-DTM,20,2,0,0,2,11,9
20190223-W-Budapest-SF-Alison_Van_Uytvanck-Ekaterina_Alexandrova,2,F-DTL,25,12,4,1,7,12,13
20190223-W-Budapest-SF-Alison_Van_Uytvanck-Ekaterina_Alexandrova,2,F-IO,18,8,4,2,2,9,9
20190223-W-Budapest-SF-Alison_Van_Uytvanck-Ekaterina_Alexandrova,2,B-XC,54,16,5,8,3,30,24
20190223-W-Budapest-SF-Alison_Van_Uytvanck-Ekaterina_Alexandrova,2,B-DTM,40,3,0,0,3,23,17
20190223-W-Budapest-SF-Alison_Van_Uytvanck-Ekaterina_Alexandrova,2,B-DTL,19,7,3,1,3,12,7
20190223-W-Budapest-SF-Alison_Van_Uytvanck-Ekaterina_Alexandrova,2,B-IO,27,9,1,4,4,18,9
20190223-W-Budapest-SF-Alison_Van_Uytvanck-Ekaterina_Alexandrova,2,S-XC,6,0,0,0,0,3,3
20190223-W-Budapest-SF-Alison_Van_Uytvanck-Ekaterina_Alexandrova,2,S-DTM,4,0,0,0,0,1,3
20190223-W-Budapest-SF-Alison_Van_Uytvanck-Ekaterina_Alexandrova,2,S-DTL,6,4,0,0,4,2,4
20190223-W-Budapest-SF-Alison_Van_Uytvanck-Ekaterina_Alexandrova,2,S-IO,4,0,0,0,0,3,1
20190114-W-Australian_Open-R128-Shuai_Peng-Eugenie_Bouchard,1,F-XC,13,4,0,1,3,5,8
20190114-W-Australian_Open-R128-Shuai_Peng-Eugenie_Bouchard,1,F-DTM,12,1,0,0,1,3,9
20190114-W-Australian_Open-R128-Shuai_Peng-Eugenie_Bouchard,1,F-DTL,8,2,1,1,0,3,5
20190114-W-Australian_Open-R128-Shuai_Peng-Eugenie_Bouchard,1,F-IO,4,2,1,1,0,2,2
20190114-W-Australian_Open-R128-Shuai_Peng-Eugenie_Bouchard,1,B-XC,10,3,0,1,2,3,7
20190114-W-Australian_Open-R128-Shuai_Peng-Eugenie_Bouchard,1,B-DTM,15,1,0,0,1,4,11
20190114-W-Australian_Open-R128-Shuai_Peng-Eugenie_Bouchard,1,B-DTL,2,0,0,0,0,0,2
20190114-W-Australian_Open-R128-Shuai_Peng-Eugenie_Bouchard,1,B-IO,4,2,1,1,0,3,1
20190114-W-Australian_Open-R128-Shuai_Peng-Eugenie_Bouchard,1,S-XC,1,0,0,0,0,0,1
20190114-W-Australian_Open-R128-Shuai_Peng-Eugenie_Bouchard,1,S-DTM,2,0,0,0,0,0,2
20190114-W-Australian_Open-R128-Shuai_Peng-Eugenie_Bouchard,2,F-XC,17,5,2,2,1,13,4
20190114-W-Australian_Open-R128-Shuai_Peng-Eugenie_Bouchard,2,F-DTM,9,2,0,0,2,4,5
20190114-W-Australian_Open-R128-Shuai_Peng-Eugenie_Bouchard,2,F-DTL,4,1,1,0,0,3,1
20190114-W-Australian_Open-R128-Shuai_Peng-Eugenie_Bouchard,2,F-IO,3,1,1,0,0,2,1
20190114-W-Australian_Open-R128-Shuai_Peng-Eugenie_Bouchard,2,F-II,1,1,1,0,0,1,0
20190114-W-Australian_Open-R128-Shuai_Peng-Eugenie_Bouchard,2,B-XC,16,7,1,4,2,12,4
20190114-W-Australian_Open-R128-Shuai_Peng-Eugenie_Bouchard,2,B-DTM,10,1,0,0,1,8,2
20190114-W-Australian_Open-R128-Shuai_Peng-Eugenie_Bouchard,2,B-DTL,3,1,1,0,0,1,2
20190114-W-Australian_Open-R128-Shuai_Peng-Eugenie_Bouchard,2,B-IO,3,1,0,0,1,2,1
20190114-W-Australian_Open-R128-Shuai_Peng-Eugenie_Bouchard,2,S-XC,1,0,0,0,0,1,0
20190114-W-Australian_Open-R128-Shuai_Peng-Eugenie_Bouchard,2,S-DTM,2,0,0,0,0,1,1
20180115-W-Australian_Open-R32-Su_Wei_Hsieh-Agnieszka_Radwanska,1,F-XC,40,13,6,3,4,29,11
20180115-W-Australian_Open-R32-Su_Wei_Hsieh-Agnieszka_Radwanska,1,F-DTM,12,1,0,0,1,9,3
20180115-W-Australian_Open-R32-Su_Wei_Hsieh-Agnieszka_Radwanska,1,F-DTL,3,1,1,0,0,1,2
20180115-W-Australian_Open-R32-Su_Wei_Hsieh-Agnieszka_Radwanska,1,F-IO,12,5,2,2,1,11,1
20180115-W-Australian_Open-R32-Su_Wei_Hsieh-Agnieszka_Radwanska,1,F-II,1,0,0,0,0,1,0
20180115-W-Australian_Open-R32-Su_Wei_Hsieh-Agnieszka_Radwanska,1,B-XC,56,17,4,4,9,37,19
20180115-W-Australian_Open-R32-Su_Wei_Hsieh-Agnieszka_Radwanska,1,B-DTM,31,1,0,0,1,17,14
20180115-W-Australian_Open-R32-Su_Wei_Hsieh-Agnieszka_Radwanska,1,B-DTL,14,8,5,2,1,11,3
20180115-W-Australian_Open-R32-Su_Wei_Hsieh-Agnieszka_Radwanska,1,B-IO,13,5,4,0,1,10,3
20180115-W-Australian_Open-R32-Su_Wei_Hsieh-Agnieszka_Radwanska,1,B-II,1,1,0,0,1,0,1
20180115-W-Australian_Open-R32-Su_Wei_Hsieh-Agnieszka_Radwanska,1,S-DTL,2,1,0,0,1,0,2
20180115-W-Australian_Open-R32-Su_Wei_Hsieh-Agnieszka_Radwanska,1,S-IO,1,0,0,0,0,1,0
20180115-W-Australian_Open-R32-Su_Wei_Hsieh-Agnieszka_Radwanska,2,F-XC,33,2,0,1,1,12,21
20180115-W-Australian_Open-R32-Su_Wei_Hsieh-Agnieszka_Radwanska,2,F-DTM,24,1,0,0,1,8,16
20180115-W-Australian_Open-R32-Su_Wei_Hsieh-Agnieszka_Radwanska,2,F-DTL,10,2,0,0,2,3,7
20180115-W-Australian_Open-R32-Su_Wei_Hsieh-Agnieszka_Radwanska,2,F-IO,11,2,2,0,0,6,5
20180115-W-Australian_Open-R32-Su_Wei_Hsieh-Agnieszka_Radwanska,2,B-XC,27,3,0,0,3,6,21
20180115-W-Australian_Open-R32-Su_Wei_Hsieh-Agnieszka_Radwanska,2,B-DTM,35,5,0,1,4,5,30
20180115-W-Australian_Open-R32-Su_Wei_Hsieh-Agnieszka_Radwanska,2,B-DTL,6,2,0,0,2,1,5
20180115-W-Australian_Open-R32-Su_Wei_Hsieh-Agnieszka_Radwanska,2,B-IO,4,0,0,0,0,2,2
20180115-W-Australian_Open-R32-Su_Wei_Hsieh-Agnieszka_Radwanska,2,S-XC,7,0,0,0,0,4,3
20180115-W-Australian_Open-R32-Su_Wei_Hsieh-Agnieszka_Radwanska,2,S-DTM,8,0,0,0,0,3,5
20180115-W-Australian_Open-R32-Su_Wei_Hsieh-Agnieszka_Radwanska,2,S-DTL,1,0,0,0,0,0,1
20180115-W-Australian_Open-R32-Su_Wei_Hsieh-Agnieszka_Radwanska,2,S-IO,1,1,1,0,0,1,0
20190228-W-Acapulco-QF-Saisai_Zheng-Bianca_Andreescu,1,F-XC,29,10,4,1,5,20,9
20190228-W-Acapulco-QF-Saisai_Zheng-Bianca_Andreescu,1,F-DTM,55,4,0,0,4,29,26
20190228-W-Acapulco-QF-Saisai_Zheng-Bianca_Andreescu,1,F-DTL,6,1,0,0,1,3,3
20190228-W-Acapulco-QF-Saisai_Zheng-Bianca_Andreescu,1,F-IO,17,7,0,3,4,9,8
20190228-W-Acapulco-QF-Saisai_Zheng-Bianca_Andreescu,1,F-II,1,0,0,0,0,1,0
20190228-W-Acapulco-QF-Saisai_Zheng-Bianca_Andreescu,1,B-XC,18,4,2,1,1,11,7
20190228-W-Acapulco-QF-Saisai_Zheng-Bianca_Andreescu,1,B-DTM,33,2,0,0,2,20,13
20190228-W-Acapulco-QF-Saisai_Zheng-Bianca_Andreescu,1,B-DTL,7,4,1,1,2,3,4
20190228-W-Acapulco-QF-Saisai_Zheng-Bianca_Andreescu,1,B-IO,6,3,1,0,2,2,4
20190228-W-Acapulco-QF-Saisai_Zheng-Bianca_Andreescu,1,S-XC,7,0,0,0,0,4,3
20190228-W-Acapulco-QF-Saisai_Zheng-Bianca_Andreescu,1,S-DTM,8,0,0,0,0,5,3
20190228-W-Acapulco-QF-Saisai_Zheng-Bianca_Andreescu,1,S-DTL,3,1,0,1,0,2,1
20190228-W-Acapulco-QF-Saisai_Zheng-Bianca_Andreescu,1,S-IO,1,0,0,0,0,0,1
20190228-W-Acapulco-QF-Saisai_Zheng-Bianca_Andreescu,2,F-XC,43,13,2,6,5,24,19
20190228-W-Acapulco-QF-Saisai_Zheng-Bianca_Andreescu,2,F-DTM,41,1,0,0,1,12,29
20190228-W-Acapulco-QF-Saisai_Zheng-Bianca_Andreescu,2,F-DTL,8,3,0,1,2,4,4
20190228-W-Acapulco-QF-Saisai_Zheng-Bianca_Andreescu,2,F-IO,27,9,3,4,2,19,8
20190228-W-Acapulco-QF-Saisai_Zheng-Bianca_Andreescu,2,F-II,3,2,2,0,0,2,1
20190228-W-Acapulco-QF-Saisai_Zheng-Bianca_Andreescu,2,B-XC,27,11,1,2,8,12,15
20190228-W-Acapulco-QF-Saisai_Zheng-Bianca_Andreescu,2,B-DTM,18,5,1,0,4,7,11
20190228-W-Acapulco-QF-Saisai_Zheng-Bianca_Andreescu,2,B-DTL,5,1,1,0,0,3,2
20190228-W-Acapulco-QF-Saisai_Zheng-Bianca_Andreescu,2,B-IO,4,1,0,0,1,1,3
20190228-W-Acapulco-QF-Saisai_Zheng-Bianca_Andreescu,2,S-XC,3,0,0,0,0,0,3
20190228-W-Acapulco-QF-Saisai_Zheng-Bianca_Andreescu,2,S-DTM,12,1,0,0,1,4,8
20190228-W-Acapulco-QF-Saisai_Zheng-Bianca_Andreescu,2,S-IO,2,1,0,0,1,0,2
20190306-W-Indian_Wells-R128-Bianca_Andreescu-Irina_Camelia_Begu,1,F-XC,61,14,5,3,6,38,23
20190306-W-Indian_Wells-R128-Bianca_Andreescu-Irina_Camelia_Begu,1,F-DTM,62,2,0,1,1,32,30
20190306-W-Indian_Wells-R128-Bianca_Andreescu-Irina_Camelia_Begu,1,F-DTL,12,3,1,1,1,9,3
20190306-W-Indian_Wells-R128-Bianca_Andreescu-Irina_Camelia_Begu,1,F-IO,23,7,2,0,5,10,13
20190306-W-Indian_Wells-R128-Bianca_Andreescu-Irina_Camelia_Begu,1,F-II,1,0,0,0,0,0,1
20190306-W-Indian_Wells-R128-Bianca_Andreescu-Irina_Camelia_Begu,1,B-XC,29,9,2,0,7,13,16
20190306-W-Indian_Wells-R128-Bianca_Andreescu-Irina_Camelia_Begu,1,B-DTM,43,6,1,1,4,23,20
20190306-W-Indian_Wells-R128-Bianca_Andreescu-Irina_Camelia_Begu,1,B-DTL,6,0,0,0,0,1,5
20190306-W-Indian_Wells-R128-Bianca_Andreescu-Irina_Camelia_Begu,1,B-IO,6,4,0,1,3,2,4
20190306-W-Indian_Wells-R128-Bianca_Andreescu-Irina_Camelia_Begu,1,S-XC,4,0,0,0,0,3,1
20190306-W-Indian_Wells-R128-Bianca_Andreescu-Irina_Camelia_Begu,1,S-DTM,14,0,0,0,0,10,4
20190306-W-Indian_Wells-R128-Bianca_Andreescu-Irina_Camelia_Begu,1,S-DTL,1,0,0,0,0,0,1
20190306-W-Indian_Wells-R128-Bianca_Andreescu-Irina_Camelia_Begu,1,S-IO,1,0,0,0,0,1,0
20190306-W-Indian_Wells-R128-Bianca_Andreescu-Irina_Camelia_Begu,2,F-XC,66,14,4,2,8,31,35
20190306-W-Indian_Wells-R128-Bianca_Andreescu-Irina_Camelia_Begu,2,F-DTM,57,7,1,0,6,19,38
20190306-W-Indian_Wells-R128-Bianca_Andreescu-Irina_Camelia_Begu,2,F-DTL,12,6,2,0,4,6,6
20190306-W-Indian_Wells-R128-Bianca_Andreescu-Irina_Camelia_Begu,2,F-IO,30,12,4,3,5,13,17
20190306-W-Indian_Wells-R128-Bianca_Andreescu-Irina_Camelia_Begu,2,B-XC,43,12,1,4,7,21,22
20190306-W-Indian_Wells-R128-Bianca_Andreescu-Irina_Camelia_Begu,2,B-DTM,46,5,0,0,5,22,24
20190306-W-Indian_Wells-R128-Bianca_Andreescu-Irina_Camelia_Begu,2,B-DTL,7,5,2,0,3,3,4
20190306-W-Indian_Wells-R128-Bianca_Andreescu-Irina_Camelia_Begu,2,B-IO,19,7,2,2,3,9,10
20190306-W-Indian_Wells-R128-Bianca_Andreescu-Irina_Camelia_Begu,2,S-XC,3,0,0,0,0,2,1
20190306-W-Indian_Wells-R128-Bianca_Andreescu-Irina_Camelia_Begu,2,S-DTM,2,0,0,0,0,2,0
20190306-W-Indian_Wells-R128-Bianca_Andreescu-Irina_Camelia_Begu,2,S-DTL,3,2,1,1,0,3,0
20190306-W-Indian_Wells-R128-Bianca_Andreescu-Irina_Camelia_Begu,2,S-IO,1,0,0,0,0,1,0
20190226-W-Acapulco-R32-Katie_Boulter-Conny_Perrin,1,F-XC,34,13,5,1,7,21,13
20190226-W-Acapulco-R32-Katie_Boulter-Conny_Perrin,1,F-DTM,4,0,0,0,0,4,0
20190226-W-Acapulco-R32-Katie_Boulter-Conny_Perrin,1,F-DTL,6,2,1,0,1,3,3
20190226-W-Acapulco-R32-Katie_Boulter-Conny_Perrin,1,F-IO,27,18,11,3,4,18,9
20190226-W-Acapulco-R32-Katie_Boulter-Conny_Perrin,1,F-II,1,1,0,1,0,1,0
20190226-W-Acapulco-R32-Katie_Boulter-Conny_Perrin,1,B-XC,24,10,3,4,3,13,11
20190226-W-Acapulco-R32-Katie_Boulter-Conny_Perrin,1,B-DTM,14,1,0,0,1,8,6
20190226-W-Acapulco-R32-Katie_Boulter-Conny_Perrin,1,B-DTL,7,3,1,1,1,3,4
20190226-W-Acapulco-R32-Katie_Boulter-Conny_Perrin,1,B-IO,2,2,1,0,1,1,1
20190226-W-Acapulco-R32-Katie_Boulter-Conny_Perrin,1,S-XC,1,0,0,0,0,0,1
20190226-W-Acapulco-R32-Katie_Boulter-Conny_Perrin,1,S-DTL,1,0,0,0,0,0,1
20190226-W-Acapulco-R32-Katie_Boulter-Conny_Perrin,1,S-IO,2,1,0,0,1,1,1
20190226-W-Acapulco-R32-Katie_Boulter-Conny_Perrin,2,F-XC,13,1,0,0,1,6,7
20190226-W-Acapulco-R32-Katie_Boulter-Conny_Perrin,2,F-DTM,19,2,0,0,2,5,14
20190226-W-Acapulco-R32-Katie_Boulter-Conny_Perrin,2,F-DTL,10,1,1,0,0,6,4
20190226-W-Acapulco-R32-Katie_Boulter-Conny_Perrin,2,F-IO,16,5,3,1,1,8,8
20190226-W-Acapulco-R32-Katie_Boulter-Conny_Perrin,2,B-XC,3,0,0,0,0,0,3
20190226-W-Acapulco-R32-Katie_Boulter-Conny_Perrin,2,B-DTM,12,4,0,0,4,4,8
20190226-W-Acapulco-R32-Katie_Boulter-Conny_Perrin,2,B-DTL,8,3,1,1,1,6,2
20190226-W-Acapulco-R32-Katie_Boulter-Conny_Perrin,2,B-IO,3,0,0,0,0,2,1
20190226-W-Acapulco-R32-Katie_Boulter-Conny_Perrin,2,S-XC,1,0,0,0,0,1,0
20190226-W-Acapulco-R32-Katie_Boulter-Conny_Perrin,2,S-DTM,12,0,0,0,0,9,3
20190226-W-Acapulco-R32-Katie_Boulter-Conny_Perrin,2,S-DTL,2,0,0,0,0,0,2
20190226-W-Acapulco-R32-Katie_Boulter-Conny_Perrin,2,S-IO,1,0,0,0,0,0,1
20190306-W-Indian_Wells-R128-Magda_Linette-Petra_Martic,1,F-XC,78,24,8,6,10,45,33
20190306-W-Indian_Wells-R128-Magda_Linette-Petra_Martic,1,F-DTM,21,2,0,0,2,11,10
20190306-W-Indian_Wells-R128-Magda_Linette-Petra_Martic,1,F-DTL,23,14,4,2,8,10,13
20190306-W-Indian_Wells-R128-Magda_Linette-Petra_Martic,1,F-IO,24,8,4,0,4,15,9
20190306-W-Indian_Wells-R128-Magda_Linette-Petra_Martic,1,F-II,1,0,0,0,0,1,0
20190306-W-Indian_Wells-R128-Magda_Linette-Petra_Martic,1,B-XC,107,17,3,2,12,53,54
20190306-W-Indian_Wells-R128-Magda_Linette-Petra_Martic,1,B-DTM,29,0,0,0,0,12,17
20190306-W-Indian_Wells-R128-Magda_Linette-Petra_Martic,1,B-DTL,15,7,1,1,5,8,7
20190306-W-Indian_Wells-R128-Magda_Linette-Petra_Martic,1,B-IO,7,3,2,0,1,6,1
20190306-W-Indian_Wells-R128-Magda_Linette-Petra_Martic,1,S-XC,2,0,0,0,0,2,0
20190306-W-Indian_Wells-R128-Magda_Linette-Petra_Martic,1,S-DTL,1,0,0,0,0,1,0
20190306-W-Indian_Wells-R128-Magda_Linette-Petra_Martic,2,F-XC,61,13,3,5,5,29,32
20190306-W-Indian_Wells-R128-Magda_Linette-Petra_Martic,2,F-DTM,31,2,0,0,2,15,16
20190306-W-Indian_Wells-R128-Magda_Linette-Petra_Martic,2,F-DTL,26,8,3,4,1,13,13
20190306-W-Indian_Wells-R128-Magda_Linette-Petra_Martic,2,F-IO,28,12,3,6,3,15,13
20190306-W-Indian_Wells-R128-Magda_Linette-Petra_Martic,2,F-II,9,3,0,2,1,5,4
20190306-W-Indian_Wells-R128-Magda_Linette-Petra_Martic,2,B-XC,64,10,1,2,7,35,29
20190306-W-Indian_Wells-R128-Magda_Linette-Petra_Martic,2,B-DTM,24,1,0,0,1,13,11
20190306-W-Indian_Wells-R128-Magda_Linette-Petra_Martic,2,B-DTL,8,4,0,1,3,3,5
20190306-W-Indian_Wells-R128-Magda_Linette-Petra_Martic,2,B-IO,5,3,0,1,2,3,2
20190306-W-Indian_Wells-R128-Magda_Linette-Petra_Martic,2,S-XC,19,2,0,0,2,6,13
20190306-W-Indian_Wells-R128-Magda_Linette-Petra_Martic,2,S-DTM,8,0,0,0,0,4,4
20190306-W-Indian_Wells-R128-Magda_Linette-Petra_Martic,2,S-DTL,6,1,0,0,1,1,5
20190306-W-Indian_Wells-R128-Magda_Linette-Petra_Martic,2,S-IO,1,0,0,0,0,0,1
20190306-W-Indian_Wells-R128-Amanda_Anisimova-Aleksandra_Krunic,1,F-XC,19,7,3,2,2,14,5
20190306-W-Indian_Wells-R128-Amanda_Anisimova-Aleksandra_Krunic,1,F-DTM,8,3,0,0,3,4,4
20190306-W-Indian_Wells-R128-Amanda_Anisimova-Aleksandra_Krunic,1,F-DTL,6,5,4,0,1,5,1
20190306-W-Indian_Wells-R128-Amanda_Anisimova-Aleksandra_Krunic,1,F-IO,7,4,3,1,0,6,1
20190306-W-Indian_Wells-R128-Amanda_Anisimova-Aleksandra_Krunic,1,F-II,1,1,1,0,0,1,0
20190306-W-Indian_Wells-R128-Amanda_Anisimova-Aleksandra_Krunic,1,B-XC,17,7,3,0,4,10,7
20190306-W-Indian_Wells-R128-Amanda_Anisimova-Aleksandra_Krunic,1,B-DTM,12,1,0,1,0,8,4
20190306-W-Indian_Wells-R128-Amanda_Anisimova-Aleksandra_Krunic,1,B-DTL,4,4,1,2,1,3,1
20190306-W-Indian_Wells-R128-Amanda_Anisimova-Aleksandra_Krunic,1,B-IO,5,0,0,0,0,4,1
20190306-W-Indian_Wells-R128-Amanda_Anisimova-Aleksandra_Krunic,1,S-DTM,3,0,0,0,0,0,3
20190306-W-Indian_Wells-R128-Amanda_Anisimova-Aleksandra_Krunic,2,F-XC,17,6,1,0,4,7,10
20190306-W-Indian_Wells-R128-Amanda_Anisimova-Aleksandra_Krunic,2,F-DTM,19,4,0,0,4,7,12
20190306-W-Indian_Wells-R128-Amanda_Anisimova-Aleksandra_Krunic,2,F-DTL,6,2,1,0,1,3,3
20190306-W-Indian_Wells-R128-Amanda_Anisimova-Aleksandra_Krunic,2,F-IO,7,2,2,0,0,5,2
20190306-W-Indian_Wells-R128-Amanda_Anisimova-Aleksandra_Krunic,2,B-XC,3,1,0,0,1,1,2
20190306-W-Indian_Wells-R128-Amanda_Anisimova-Aleksandra_Krunic,2,B-DTM,4,0,0,0,0,0,4
20190306-W-Indian_Wells-R128-Amanda_Anisimova-Aleksandra_Krunic,2,B-DTL,4,1,0,0,1,0,4
20190306-W-Indian_Wells-R128-Amanda_Anisimova-Aleksandra_Krunic,2,B-IO,2,2,1,0,1,1,1
20190306-W-Indian_Wells-R128-Amanda_Anisimova-Aleksandra_Krunic,2,S-XC,6,1,0,0,1,0,6
20190306-W-Indian_Wells-R128-Amanda_Anisimova-Aleksandra_Krunic,2,S-DTM,8,0,0,0,0,3,5
20190306-W-Indian_Wells-R128-Amanda_Anisimova-Aleksandra_Krunic,2,S-DTL,1,0,0,0,0,0,1
20190306-W-Indian_Wells-R128-Sofia_Kenin-Yafan_Wang,1,F-XC,92,39,11,8,20,40,52
20190306-W-Indian_Wells-R128-Sofia_Kenin-Yafan_Wang,1,F-DTM,51,8,0,0,8,25,26
20190306-W-Indian_Wells-R128-Sofia_Kenin-Yafan_Wang,1,F-DTL,11,8,2,3,3,8,3
20190306-W-Indian_Wells-R128-Sofia_Kenin-Yafan_Wang,1,F-IO,24,7,4,0,3,14,10
20190306-W-Indian_Wells-R128-Sofia_Kenin-Yafan_Wang,1,B-XC,61,13,2,3,8,31,30
20190306-W-Indian_Wells-R128-Sofia_Kenin-Yafan_Wang,1,B-DTM,33,3,0,0,3,9,24
20190306-W-Indian_Wells-R128-Sofia_Kenin-Yafan_Wang,1,B-DTL,8,7,3,1,3,5,3
20190306-W-Indian_Wells-R128-Sofia_Kenin-Yafan_Wang,1,B-IO,10,5,4,0,1,6,4
20190306-W-Indian_Wells-R128-Sofia_Kenin-Yafan_Wang,1,S-XC,6,2,1,0,1,2,4
20190306-W-Indian_Wells-R128-Sofia_Kenin-Yafan_Wang,1,S-DTM,5,0,0,0,0,2,3
20190306-W-Indian_Wells-R128-Sofia_Kenin-Yafan_Wang,2,F-XC,63,11,2,1,8,31,32
20190306-W-Indian_Wells-R128-Sofia_Kenin-Yafan_Wang,2,F-DTM,79,8,1,5,2,45,34
20190306-W-Indian_Wells-R128-Sofia_Kenin-Yafan_Wang,2,F-DTL,10,4,1,0,3,5,5
20190306-W-Indian_Wells-R128-Sofia_Kenin-Yafan_Wang,2,F-IO,12,6,3,3,0,7,5
20190306-W-Indian_Wells-R128-Sofia_Kenin-Yafan_Wang,2,F-II,1,1,1,0,0,1,0
20190306-W-Indian_Wells-R128-Sofia_Kenin-Yafan_Wang,2,B-XC,48,10,2,3,5,26,22
20190306-W-Indian_Wells-R128-Sofia_Kenin-Yafan_Wang,2,B-DTM,45,5,0,1,4,17,28
20190306-W-Indian_Wells-R128-Sofia_Kenin-Yafan_Wang,2,B-DTL,5,1,0,1,0,3,2
20190306-W-Indian_Wells-R128-Sofia_Kenin-Yafan_Wang,2,B-IO,3,1,0,1,0,2,1
20190306-W-Indian_Wells-R128-Sofia_Kenin-Yafan_Wang,2,S-XC,1,0,0,0,0,1,0
20190306-W-Indian_Wells-R128-Sofia_Kenin-Yafan_Wang,2,S-DTM,17,1,0,1,0,12,5
20190306-W-Indian_Wells-R128-Sofia_Kenin-Yafan_Wang,2,S-DTL,2,1,1,0,0,2,0
20190307-W-Indian_Wells-R128-Andrea_Petkovic-Venus_Williams,1,F-XC,46,13,5,4,4,25,21
20190307-W-Indian_Wells-R128-Andrea_Petkovic-Venus_Williams,1,F-DTM,45,8,0,2,6,26,19
20190307-W-Indian_Wells-R128-Andrea_Petkovic-Venus_Williams,1,F-DTL,7,4,1,0,3,3,4
20190307-W-Indian_Wells-R128-Andrea_Petkovic-Venus_Williams,1,F-IO,11,7,2,2,3,6,5
20190307-W-Indian_Wells-R128-Andrea_Petkovic-Venus_Williams,1,F-II,1,1,1,0,0,1,0
20190307-W-Indian_Wells-R128-Andrea_Petkovic-Venus_Williams,1,B-XC,36,9,2,1,6,19,17
20190307-W-Indian_Wells-R128-Andrea_Petkovic-Venus_Williams,1,B-DTM,29,3,0,1,2,15,14
20190307-W-Indian_Wells-R128-Andrea_Petkovic-Venus_Williams,1,B-DTL,2,2,2,0,0,2,0
20190307-W-Indian_Wells-R128-Andrea_Petkovic-Venus_Williams,1,B-IO,3,2,1,0,1,1,2
20190307-W-Indian_Wells-R128-Andrea_Petkovic-Venus_Williams,1,S-XC,2,1,0,0,1,1,1
20190307-W-Indian_Wells-R128-Andrea_Petkovic-Venus_Williams,1,S-DTM,3,0,0,0,0,1,2
20190307-W-Indian_Wells-R128-Andrea_Petkovic-Venus_Williams,1,S-DTL,1,0,0,0,0,0,1
20190307-W-Indian_Wells-R128-Andrea_Petkovic-Venus_Williams,1,S-IO,1,0,0,0,0,1,0
20190307-W-Indian_Wells-R128-Andrea_Petkovic-Venus_Williams,2,F-XC,47,13,5,2,6,24,23
20190307-W-Indian_Wells-R128-Andrea_Petkovic-Venus_Williams,2,F-DTM,37,4,0,2,2,16,21
20190307-W-Indian_Wells-R128-Andrea_Petkovic-Venus_Williams,2,F-DTL,8,6,3,0,3,4,4
20190307-W-Indian_Wells-R128-Andrea_Petkovic-Venus_Williams,2,F-IO,7,3,0,0,3,2,5
20190307-W-Indian_Wells-R128-Andrea_Petkovic-Venus_Williams,2,F-II,1,0,0,0,0,0,1
20190307-W-Indian_Wells-R128-Andrea_Petkovic-Venus_Williams,2,B-XC,31,9,3,1,5,15,16
20190307-W-Indian_Wells-R128-Andrea_Petkovic-Venus_Williams,2,B-DTM,34,5,0,0,5,13,21
20190307-W-Indian_Wells-R128-Andrea_Petkovic-Venus_Williams,2,B-DTL,7,4,2,0,2,3,4
20190307-W-Indian_Wells-R128-Andrea_Petkovic-Venus_Williams,2,B-IO,12,4,4,0,0,5,7
20190307-W-Indian_Wells-R128-Andrea_Petkovic-Venus_Williams,2,S-XC,2,0,0,0,0,2,0
20190307-W-Indian_Wells-R128-Andrea_Petkovic-Venus_Williams,2,S-DTM,7,0,0,0,0,3,4
20190307-W-Indian_Wells-R128-Andrea_Petkovic-Venus_Williams,2,S-DTL,1,0,0,0,0,0,1
20190307-W-Indian_Wells-R128-Andrea_Petkovic-Venus_Williams,2,S-IO,1,0,0,0,0,1,0
20190228-W-Acapulco-QF-Sofia_Kenin-Victoria_Azarenka,1,F-XC,66,22,8,8,6,49,17
20190228-W-Acapulco-QF-Sofia_Kenin-Victoria_Azarenka,1,F-DTM,29,4,1,0,3,14,15
20190228-W-Acapulco-QF-Sofia_Kenin-Victoria_Azarenka,1,F-DTL,6,3,1,1,1,3,3
20190228-W-Acapulco-QF-Sofia_Kenin-Victoria_Azarenka,1,F-IO,12,3,2,0,1,9,3
20190228-W-Acapulco-QF-Sofia_Kenin-Victoria_Azarenka,1,F-II,1,0,0,0,0,1,0
20190228-W-Acapulco-QF-Sofia_Kenin-Victoria_Azarenka,1,B-XC,63,20,8,7,5,44,19
20190228-W-Acapulco-QF-Sofia_Kenin-Victoria_Azarenka,1,B-DTM,27,7,1,0,6,12,15
20190228-W-Acapulco-QF-Sofia_Kenin-Victoria_Azarenka,1,B-DTL,9,6,5,0,1,7,2
20190228-W-Acapulco-QF-Sofia_Kenin-Victoria_Azarenka,1,B-IO,9,6,3,2,1,6,3
20190228-W-Acapulco-QF-Sofia_Kenin-Victoria_Azarenka,1,B-II,1,0,0,0,0,1,0
20190228-W-Acapulco-QF-Sofia_Kenin-Victoria_Azarenka,1,S-XC,7,0,0,0,0,6,1
20190228-W-Acapulco-QF-Sofia_Kenin-Victoria_Azarenka,1,S-DTM,5,0,0,0,0,3,2
20190228-W-Acapulco-QF-Sofia_Kenin-Victoria_Azarenka,1,S-IO,1,0,0,0,0,0,1
20190228-W-Acapulco-QF-Sofia_Kenin-Victoria_Azarenka,2,F-XC,37,8,2,2,4,12,25
20190228-W-Acapulco-QF-Sofia_Kenin-Victoria_Azarenka,2,F-DTM,33,1,0,0,1,7,26
20190228-W-Acapulco-QF-Sofia_Kenin-Victoria_Azarenka,2,F-DTL,23,4,0,2,2,12,11
20190228-W-Acapulco-QF-Sofia_Kenin-Victoria_Azarenka,2,F-IO,24,2,0,2,0,13,11
20190228-W-Acapulco-QF-Sofia_Kenin-Victoria_Azarenka,2,B-XC,26,0,0,0,0,7,19
20190228-W-Acapulco-QF-Sofia_Kenin-Victoria_Azarenka,2,B-DTM,37,8,0,1,7,15,22
20190228-W-Acapulco-QF-Sofia_Kenin-Victoria_Azarenka,2,B-DTL,22,7,1,2,4,8,14
20190228-W-Acapulco-QF-Sofia_Kenin-Victoria_Azarenka,2,B-IO,12,3,0,3,0,9,3
20190228-W-Acapulco-QF-Sofia_Kenin-Victoria_Azarenka,2,S-XC,5,1,0,0,1,0,5
20190228-W-Acapulco-QF-Sofia_Kenin-Victoria_Azarenka,2,S-DTM,6,0,0,0,0,2,4
20190228-W-Acapulco-QF-Sofia_Kenin-Victoria_Azarenka,2,S-DTL,3,0,0,0,0,0,3
20190310-W-Indian_Wells-R32-Kiki_Bertens-Johanna_Konta,1,F-XC,39,6,1,2,3,20,19
20190310-W-Indian_Wells-R32-Kiki_Bertens-Johanna_Konta,1,F-DTM,30,8,0,1,7,12,18
20190310-W-Indian_Wells-R32-Kiki_Bertens-Johanna_Konta,1,F-DTL,7,3,0,1,2,3,4
20190310-W-Indian_Wells-R32-Kiki_Bertens-Johanna_Konta,1,F-IO,18,8,5,0,3,11,7
20190310-W-Indian_Wells-R32-Kiki_Bertens-Johanna_Konta,1,F-II,1,1,1,0,0,1,0
20190310-W-Indian_Wells-R32-Kiki_Bertens-Johanna_Konta,1,B-XC,9,2,0,2,0,7,2
20190310-W-Indian_Wells-R32-Kiki_Bertens-Johanna_Konta,1,B-DTM,31,3,0,0,3,16,15
20190310-W-Indian_Wells-R32-Kiki_Bertens-Johanna_Konta,1,B-DTL,5,2,1,1,0,4,1
20190310-W-Indian_Wells-R32-Kiki_Bertens-Johanna_Konta,1,B-IO,3,1,0,0,1,0,3
20190310-W-Indian_Wells-R32-Kiki_Bertens-Johanna_Konta,1,S-XC,4,2,1,1,0,4,0
20190310-W-Indian_Wells-R32-Kiki_Bertens-Johanna_Konta,1,S-DTM,13,1,0,0,1,6,7
20190310-W-Indian_Wells-R32-Kiki_Bertens-Johanna_Konta,1,S-DTL,3,2,1,0,1,1,2
20190310-W-Indian_Wells-R32-Kiki_Bertens-Johanna_Konta,2,F-XC,60,17,4,3,10,36,24
20190310-W-Indian_Wells-R32-Kiki_Bertens-Johanna_Konta,2,F-DTM,29,7,1,0,6,11,18
20190310-W-Indian_Wells-R32-Kiki_Bertens-Johanna_Konta,2,F-DTL,5,3,0,1,2,3,2
20190310-W-Indian_Wells-R32-Kiki_Bertens-Johanna_Konta,2,F-IO,15,3,1,0,2,5,10
20190310-W-Indian_Wells-R32-Kiki_Bertens-Johanna_Konta,2,B-XC,32,14,1,4,9,12,20
20190310-W-Indian_Wells-R32-Kiki_Bertens-Johanna_Konta,2,B-DTM,23,2,0,1,1,11,12
20190310-W-Indian_Wells-R32-Kiki_Bertens-Johanna_Konta,2,B-DTL,1,0,0,0,0,1,0
20190310-W-Indian_Wells-R32-Kiki_Bertens-Johanna_Konta,2,B-IO,4,1,0,0,1,1,3
20190310-W-Indian_Wells-R32-Kiki_Bertens-Johanna_Konta,2,S-XC,4,0,0,0,0,2,2
20190310-W-Indian_Wells-R32-Kiki_Bertens-Johanna_Konta,2,S-DTM,7,1,0,1,0,2,5
20190308-W-Indian_Wells-R64-Magda_Linette-Kiki_Bertens,1,F-XC,51,9,2,2,5,23,28
20190308-W-Indian_Wells-R64-Magda_Linette-Kiki_Bertens,1,F-DTM,26,2,0,0,2,10,16
20190308-W-Indian_Wells-R64-Magda_Linette-Kiki_Bertens,1,F-DTL,8,5,1,0,4,2,6
20190308-W-Indian_Wells-R64-Magda_Linette-Kiki_Bertens,1,F-IO,20,6,0,1,5,6,14
20190308-W-Indian_Wells-R64-Magda_Linette-Kiki_Bertens,1,B-XC,41,6,0,0,6,20,21
20190308-W-Indian_Wells-R64-Magda_Linette-Kiki_Bertens,1,B-DTM,28,5,0,0,5,13,15
20190308-W-Indian_Wells-R64-Magda_Linette-Kiki_Bertens,1,B-DTL,3,1,1,0,0,2,1
20190308-W-Indian_Wells-R64-Magda_Linette-Kiki_Bertens,1,S-DTL,1,1,1,0,0,1,0
20190308-W-Indian_Wells-R64-Magda_Linette-Kiki_Bertens,2,F-XC,41,9,2,3,4,27,14
20190308-W-Indian_Wells-R64-Magda_Linette-Kiki_Bertens,2,F-DTM,29,1,0,0,1,15,14
20190308-W-Indian_Wells-R64-Magda_Linette-Kiki_Bertens,2,F-DTL,7,2,1,0,1,3,4
20190308-W-Indian_Wells-R64-Magda_Linette-Kiki_Bertens,2,F-IO,21,3,0,2,1,11,10
20190308-W-Indian_Wells-R64-Magda_Linette-Kiki_Bertens,2,F-II,1,0,0,0,0,0,1
20190308-W-Indian_Wells-R64-Magda_Linette-Kiki_Bertens,2,B-XC,15,3,0,1,2,6,9
20190308-W-Indian_Wells-R64-Magda_Linette-Kiki_Bertens,2,B-DTM,30,3,0,0,3,17,13
20190308-W-Indian_Wells-R64-Magda_Linette-Kiki_Bertens,2,B-DTL,6,3,1,1,1,3,3
20190308-W-Indian_Wells-R64-Magda_Linette-Kiki_Bertens,2,B-IO,2,1,0,0,1,0,2
20190308-W-Indian_Wells-R64-Magda_Linette-Kiki_Bertens,2,S-XC,8,1,0,0,1,4,4
20190308-W-Indian_Wells-R64-Magda_Linette-Kiki_Bertens,2,S-DTM,5,1,0,1,0,3,2
20190228-W-Acapulco-R16-Varvara_Flink-Johanna_Konta,1,F-XC,33,7,3,1,3,14,19
20190228-W-Acapulco-R16-Varvara_Flink-Johanna_Konta,1,F-DTM,30,6,0,0,6,10,20
20190228-W-Acapulco-R16-Varvara_Flink-Johanna_Konta,1,F-DTL,9,2,1,1,0,6,3
20190228-W-Acapulco-R16-Varvara_Flink-Johanna_Konta,1,F-IO,11,5,3,0,2,6,5
20190228-W-Acapulco-R16-Varvara_Flink-Johanna_Konta,1,F-II,1,1,0,1,0,1,0
20190228-W-Acapulco-R16-Varvara_Flink-Johanna_Konta,1,B-XC,28,8,2,3,3,6,22
20190228-W-Acapulco-R16-Varvara_Flink-Johanna_Konta,1,B-DTM,13,4,0,0,4,5,8
20190228-W-Acapulco-R16-Varvara_Flink-Johanna_Konta,1,B-DTL,5,5,2,0,3,2,3
20190228-W-Acapulco-R16-Varvara_Flink-Johanna_Konta,1,B-IO,1,1,0,0,1,0,1
20190228-W-Acapulco-R16-Varvara_Flink-Johanna_Konta,1,S-XC,2,0,0,0,0,0,2
20190228-W-Acapulco-R16-Varvara_Flink-Johanna_Konta,1,S-DTM,1,0,0,0,0,0,1
20190228-W-Acapulco-R16-Varvara_Flink-Johanna_Konta,2,F-XC,43,11,5,3,3,25,18
20190228-W-Acapulco-R16-Varvara_Flink-Johanna_Konta,2,F-DTM,13,3,1,0,2,10,3
20190228-W-Acapulco-R16-Varvara_Flink-Johanna_Konta,2,F-DTL,1,1,0,0,1,0,1
20190228-W-Acapulco-R16-Varvara_Flink-Johanna_Konta,2,F-IO,7,4,1,1,2,4,3
20190228-W-Acapulco-R16-Varvara_Flink-Johanna_Konta,2,B-XC,15,7,2,0,5,9,6
20190228-W-Acapulco-R16-Varvara_Flink-Johanna_Konta,2,B-DTM,25,3,1,0,2,16,9
20190228-W-Acapulco-R16-Varvara_Flink-Johanna_Konta,2,B-DTL,11,5,2,1,2,9,2
20190228-W-Acapulco-R16-Varvara_Flink-Johanna_Konta,2,B-IO,5,3,0,1,2,3,2
20190228-W-Acapulco-R16-Varvara_Flink-Johanna_Konta,2,S-XC,6,0,0,0,0,4,2
20190228-W-Acapulco-R16-Varvara_Flink-Johanna_Konta,2,S-DTM,2,0,0,0,0,1,1
20190311-W-Indian_Wells-R32-Natalia_Vikhlyantseva-Angelique_Kerber,1,F-XC,90,15,4,2,9,44,46
20190311-W-Indian_Wells-R32-Natalia_Vikhlyantseva-Angelique_Kerber,1,F-DTM,39,3,0,0,3,14,25
20190311-W-Indian_Wells-R32-Natalia_Vikhlyantseva-Angelique_Kerber,1,F-DTL,32,10,3,3,4,17,15
20190311-W-Indian_Wells-R32-Natalia_Vikhlyantseva-Angelique_Kerber,1,F-IO,11,4,1,0,3,5,6
20190311-W-Indian_Wells-R32-Natalia_Vikhlyantseva-Angelique_Kerber,1,B-XC,62,12,5,2,5,32,30
20190311-W-Indian_Wells-R32-Natalia_Vikhlyantseva-Angelique_Kerber,1,B-DTM,55,7,1,0,6,25,30
20190311-W-Indian_Wells-R32-Natalia_Vikhlyantseva-Angelique_Kerber,1,B-DTL,27,13,6,1,6,11,16
20190311-W-Indian_Wells-R32-Natalia_Vikhlyantseva-Angelique_Kerber,1,B-IO,17,5,1,1,3,7,10
20190311-W-Indian_Wells-R32-Natalia_Vikhlyantseva-Angelique_Kerber,1,B-II,1,0,0,0,0,0,1
20190311-W-Indian_Wells-R32-Natalia_Vikhlyantseva-Angelique_Kerber,1,S-XC,2,0,0,0,0,0,2
20190311-W-Indian_Wells-R32-Natalia_Vikhlyantseva-Angelique_Kerber,1,S-DTM,1,0,0,0,0,1,0
20190311-W-Indian_Wells-R32-Natalia_Vikhlyantseva-Angelique_Kerber,2,F-XC,85,11,5,4,2,48,37
20190311-W-Indian_Wells-R32-Natalia_Vikhlyantseva-Angelique_Kerber,2,F-DTM,30,0,0,0,0,18,12
20190311-W-Indian_Wells-R32-Natalia_Vikhlyantseva-Angelique_Kerber,2,F-DTL,22,10,2,3,5,8,14
20190311-W-Indian_Wells-R32-Natalia_Vikhlyantseva-Angelique_Kerber,2,F-IO,20,6,0,3,3,12,8
20190311-W-Indian_Wells-R32-Natalia_Vikhlyantseva-Angelique_Kerber,2,F-II,2,1,1,0,0,1,1
20190311-W-Indian_Wells-R32-Natalia_Vikhlyantseva-Angelique_Kerber,2,B-XC,71,4,0,2,2,38,33
20190311-W-Indian_Wells-R32-Natalia_Vikhlyantseva-Angelique_Kerber,2,B-DTM,42,4,0,1,3,26,16
20190311-W-Indian_Wells-R32-Natalia_Vikhlyantseva-Angelique_Kerber,2,B-DTL,6,1,0,0,1,3,3
20190311-W-Indian_Wells-R32-Natalia_Vikhlyantseva-Angelique_Kerber,2,B-IO,3,1,0,0,1,2,1
20190311-W-Indian_Wells-R32-Natalia_Vikhlyantseva-Angelique_Kerber,2,B-II,1,1,0,0,1,0,1
20190311-W-Indian_Wells-R32-Natalia_Vikhlyantseva-Angelique_Kerber,2,S-XC,10,0,0,0,0,5,5
20190311-W-Indian_Wells-R32-Natalia_Vikhlyantseva-Angelique_Kerber,2,S-DTM,9,2,0,1,1,4,5
20190311-W-Indian_Wells-R32-Natalia_Vikhlyantseva-Angelique_Kerber,2,S-IO,3,0,0,0,0,0,3
20190312-W-Indian_Wells-R16-Qiang_Wang-Bianca_Andreescu,1,F-XC,38,13,2,2,9,16,22
20190312-W-Indian_Wells-R16-Qiang_Wang-Bianca_Andreescu,1,F-DTM,51,2,0,0,2,33,18
20190312-W-Indian_Wells-R16-Qiang_Wang-Bianca_Andreescu,1,F-DTL,4,2,0,2,0,4,0
20190312-W-Indian_Wells-R16-Qiang_Wang-Bianca_Andreescu,1,F-IO,15,5,0,2,3,8,7
20190312-W-Indian_Wells-R16-Qiang_Wang-Bianca_Andreescu,1,B-XC,32,8,2,0,6,11,21
20190312-W-Indian_Wells-R16-Qiang_Wang-Bianca_Andreescu,1,B-DTM,29,3,1,1,1,15,14
20190312-W-Indian_Wells-R16-Qiang_Wang-Bianca_Andreescu,1,B-DTL,7,5,1,2,2,4,3
20190312-W-Indian_Wells-R16-Qiang_Wang-Bianca_Andreescu,1,B-IO,2,1,0,0,1,1,1
20190312-W-Indian_Wells-R16-Qiang_Wang-Bianca_Andreescu,1,S-XC,4,0,0,0,0,1,3
20190312-W-Indian_Wells-R16-Qiang_Wang-Bianca_Andreescu,1,S-DTM,2,0,0,0,0,0,2
20190312-W-Indian_Wells-R16-Qiang_Wang-Bianca_Andreescu,1,S-DTL,1,0,0,0,0,0,1
20190312-W-Indian_Wells-R16-Qiang_Wang-Bianca_Andreescu,2,F-XC,29,11,1,3,7,12,17
20190312-W-Indian_Wells-R16-Qiang_Wang-Bianca_Andreescu,2,F-DTM,41,7,2,1,4,18,23
20190312-W-Indian_Wells-R16-Qiang_Wang-Bianca_Andreescu,2,F-DTL,13,0,0,0,0,9,4
20190312-W-Indian_Wells-R16-Qiang_Wang-Bianca_Andreescu,2,F-IO,27,9,4,1,4,14,13
20190312-W-Indian_Wells-R16-Qiang_Wang-Bianca_Andreescu,2,B-XC,19,7,4,1,2,15,4
20190312-W-Indian_Wells-R16-Qiang_Wang-Bianca_Andreescu,2,B-DTM,27,1,0,1,0,16,11
20190312-W-Indian_Wells-R16-Qiang_Wang-Bianca_Andreescu,2,B-DTL,1,1,1,0,0,1,0
20190312-W-Indian_Wells-R16-Qiang_Wang-Bianca_Andreescu,2,B-IO,6,3,0,0,3,1,5
20190312-W-Indian_Wells-R16-Qiang_Wang-Bianca_Andreescu,2,S-XC,2,0,0,0,0,0,2
20190312-W-Indian_Wells-R16-Qiang_Wang-Bianca_Andreescu,2,S-DTM,17,1,0,1,0,7,10
20190312-W-Indian_Wells-R16-Kiki_Bertens-Garbine_Muguruza,1,F-XC,80,14,3,3,8,33,47
20190312-W-Indian_Wells-R16-Kiki_Bertens-Garbine_Muguruza,1,F-DTM,77,4,0,0,4,24,53
20190312-W-Indian_Wells-R16-Kiki_Bertens-Garbine_Muguruza,1,F-DTL,16,5,2,1,2,8,8
20190312-W-Indian_Wells-R16-Kiki_Bertens-Garbine_Muguruza,1,F-IO,34,14,5,0,9,16,18
20190312-W-Indian_Wells-R16-Kiki_Bertens-Garbine_Muguruza,1,F-II,2,0,0,0,0,0,2
20190312-W-Indian_Wells-R16-Kiki_Bertens-Garbine_Muguruza,1,B-XC,29,9,1,0,8,11,18
20190312-W-Indian_Wells-R16-Kiki_Bertens-Garbine_Muguruza,1,B-DTM,64,3,0,0,3,24,40
20190312-W-Indian_Wells-R16-Kiki_Bertens-Garbine_Muguruza,1,B-DTL,8,4,2,0,2,3,5
20190312-W-Indian_Wells-R16-Kiki_Bertens-Garbine_Muguruza,1,B-IO,9,3,2,0,1,6,3
20190312-W-Indian_Wells-R16-Kiki_Bertens-Garbine_Muguruza,1,S-XC,8,0,0,0,0,2,6
20190312-W-Indian_Wells-R16-Kiki_Bertens-Garbine_Muguruza,1,S-DTM,26,0,0,0,0,7,19
20190312-W-Indian_Wells-R16-Kiki_Bertens-Garbine_Muguruza,1,S-DTL,1,1,0,0,1,0,1
20190312-W-Indian_Wells-R16-Kiki_Bertens-Garbine_Muguruza,2,F-XC,89,9,0,1,8,53,36
20190312-W-Indian_Wells-R16-Kiki_Bertens-Garbine_Muguruza,2,F-DTM,81,7,0,1,6,45,36
20190312-W-Indian_Wells-R16-Kiki_Bertens-Garbine_Muguruza,2,F-DTL,4,2,1,1,0,3,1
20190312-W-Indian_Wells-R16-Kiki_Bertens-Garbine_Muguruza,2,F-IO,45,13,4,6,3,32,13
20190312-W-Indian_Wells-R16-Kiki_Bertens-Garbine_Muguruza,2,B-XC,59,8,1,1,6,36,23
20190312-W-Indian_Wells-R16-Kiki_Bertens-Garbine_Muguruza,2,B-DTM,64,8,0,1,7,31,33
20190312-W-Indian_Wells-R16-Kiki_Bertens-Garbine_Muguruza,2,B-DTL,8,2,0,1,1,3,5
20190312-W-Indian_Wells-R16-Kiki_Bertens-Garbine_Muguruza,2,B-IO,17,8,1,5,2,13,4
20190312-W-Indian_Wells-R16-Kiki_Bertens-Garbine_Muguruza,2,S-XC,1,0,0,0,0,1,0
20190312-W-Indian_Wells-R16-Kiki_Bertens-Garbine_Muguruza,2,S-IO,1,0,0,0,0,0,1
20190312-W-Indian_Wells-R16-Ashleigh_Barty-Elina_Svitolina,1,F-XC,129,29,8,6,15,62,67
20190312-W-Indian_Wells-R16-Ashleigh_Barty-Elina_Svitolina,1,F-DTM,50,6,2,0,4,29,21
20190312-W-Indian_Wells-R16-Ashleigh_Barty-Elina_Svitolina,1,F-DTL,24,6,1,1,4,13,11
20190312-W-Indian_Wells-R16-Ashleigh_Barty-Elina_Svitolina,1,F-IO,77,32,16,2,14,43,34
20190312-W-Indian_Wells-R16-Ashleigh_Barty-Elina_Svitolina,1,F-II,21,11,6,1,4,14,7
20190312-W-Indian_Wells-R16-Ashleigh_Barty-Elina_Svitolina,1,B-XC,17,8,3,1,4,8,9
20190312-W-Indian_Wells-R16-Ashleigh_Barty-Elina_Svitolina,1,B-DTM,48,7,0,0,7,25,23
20190312-W-Indian_Wells-R16-Ashleigh_Barty-Elina_Svitolina,1,B-DTL,13,7,1,0,6,4,9
20190312-W-Indian_Wells-R16-Ashleigh_Barty-Elina_Svitolina,1,B-IO,3,1,1,0,0,3,0
20190312-W-Indian_Wells-R16-Ashleigh_Barty-Elina_Svitolina,1,S-XC,79,10,0,3,7,37,42
20190312-W-Indian_Wells-R16-Ashleigh_Barty-Elina_Svitolina,1,S-DTM,48,2,1,0,1,29,19
20190312-W-Indian_Wells-R16-Ashleigh_Barty-Elina_Svitolina,1,S-DTL,23,8,2,0,5,13,10
20190312-W-Indian_Wells-R16-Ashleigh_Barty-Elina_Svitolina,1,S-IO,9,2,0,1,1,5,4
20190312-W-Indian_Wells-R16-Ashleigh_Barty-Elina_Svitolina,2,F-XC,116,19,5,5,9,61,55
20190312-W-Indian_Wells-R16-Ashleigh_Barty-Elina_Svitolina,2,F-DTM,91,5,0,0,5,39,52
20190312-W-Indian_Wells-R16-Ashleigh_Barty-Elina_Svitolina,2,F-DTL,25,8,1,2,5,9,16
20190312-W-Indian_Wells-R16-Ashleigh_Barty-Elina_Svitolina,2,F-IO,25,2,1,0,1,15,10
20190312-W-Indian_Wells-R16-Ashleigh_Barty-Elina_Svitolina,2,F-II,3,0,0,0,0,0,3
20190312-W-Indian_Wells-R16-Ashleigh_Barty-Elina_Svitolina,2,B-XC,157,12,1,1,10,68,89
20190312-W-Indian_Wells-R16-Ashleigh_Barty-Elina_Svitolina,2,B-DTM,42,4,0,0,4,19,23
20190312-W-Indian_Wells-R16-Ashleigh_Barty-Elina_Svitolina,2,B-DTL,7,5,2,2,1,4,3
20190312-W-Indian_Wells-R16-Ashleigh_Barty-Elina_Svitolina,2,B-IO,6,3,1,1,1,3,3
20190312-W-Indian_Wells-R16-Ashleigh_Barty-Elina_Svitolina,2,B-II,1,0,0,0,0,0,1
20190312-W-Indian_Wells-R16-Ashleigh_Barty-Elina_Svitolina,2,S-XC,14,0,0,0,0,5,9
20190312-W-Indian_Wells-R16-Ashleigh_Barty-Elina_Svitolina,2,S-DTM,9,0,0,0,0,1,8
20190312-W-Indian_Wells-R16-Ashleigh_Barty-Elina_Svitolina,2,S-DTL,3,0,0,0,0,0,3
20190312-W-Guadalajara-R32-Fanny_Stollar-Renata_Zarazua,1,F-XC,27,14,3,5,6,12,15
20190312-W-Guadalajara-R32-Fanny_Stollar-Renata_Zarazua,1,F-DTM,5,1,0,0,1,3,2
20190312-W-Guadalajara-R32-Fanny_Stollar-Renata_Zarazua,1,F-DTL,6,5,0,1,4,2,4
20190312-W-Guadalajara-R32-Fanny_Stollar-Renata_Zarazua,1,F-IO,15,6,3,1,2,10,5
20190312-W-Guadalajara-R32-Fanny_Stollar-Renata_Zarazua,1,F-II,1,0,0,0,0,1,0
20190312-W-Guadalajara-R32-Fanny_Stollar-Renata_Zarazua,1,B-XC,17,7,2,0,5,5,12
20190312-W-Guadalajara-R32-Fanny_Stollar-Renata_Zarazua,1,B-DTM,19,5,0,0,5,6,13
20190312-W-Guadalajara-R32-Fanny_Stollar-Renata_Zarazua,1,B-DTL,2,2,0,1,1,1,1
20190312-W-Guadalajara-R32-Fanny_Stollar-Renata_Zarazua,1,B-IO,6,3,0,0,3,0,6
20190312-W-Guadalajara-R32-Fanny_Stollar-Renata_Zarazua,1,S-XC,1,1,1,0,0,1,0
20190312-W-Guadalajara-R32-Fanny_Stollar-Renata_Zarazua,2,F-XC,13,2,0,2,0,11,2
20190312-W-Guadalajara-R32-Fanny_Stollar-Renata_Zarazua,2,F-DTM,15,2,0,1,1,7,8
20190312-W-Guadalajara-R32-Fanny_Stollar-Renata_Zarazua,2,F-DTL,4,3,0,1,2,1,3
20190312-W-Guadalajara-R32-Fanny_Stollar-Renata_Zarazua,2,F-IO,1,0,0,0,0,0,1
20190312-W-Guadalajara-R32-Fanny_Stollar-Renata_Zarazua,2,B-XC,8,3,1,1,1,5,3
20190312-W-Guadalajara-R32-Fanny_Stollar-Renata_Zarazua,2,B-DTM,22,2,0,1,1,14,8
20190312-W-Guadalajara-R32-Fanny_Stollar-Renata_Zarazua,2,B-DTL,2,1,0,0,1,1,1
20190312-W-Guadalajara-R32-Fanny_Stollar-Renata_Zarazua,2,B-IO,5,1,0,0,1,1,4
20190312-W-Guadalajara-R32-Fanny_Stollar-Renata_Zarazua,2,S-XC,2,0,0,0,0,1,1
20190312-W-Guadalajara-R32-Fanny_Stollar-Renata_Zarazua,2,S-DTM,1,0,0,0,0,1,0
20190312-W-Guadalajara-R32-Fanny_Stollar-Renata_Zarazua,2,S-IO,1,0,0,0,0,1,0
20190313-W-Indian_Wells-QF-Bianca_Andreescu-Garbine_Muguruza,1,F-XC,12,8,6,0,2,9,3
20190313-W-Indian_Wells-QF-Bianca_Andreescu-Garbine_Muguruza,1,F-DTM,18,1,0,0,1,12,6
20190313-W-Indian_Wells-QF-Bianca_Andreescu-Garbine_Muguruza,1,F-DTL,3,1,1,0,0,2,1
20190313-W-Indian_Wells-QF-Bianca_Andreescu-Garbine_Muguruza,1,F-IO,11,1,0,0,1,8,3
20190313-W-Indian_Wells-QF-Bianca_Andreescu-Garbine_Muguruza,1,F-II,1,1,1,0,0,1,0
20190313-W-Indian_Wells-QF-Bianca_Andreescu-Garbine_Muguruza,1,B-XC,12,5,2,1,2,7,5
20190313-W-Indian_Wells-QF-Bianca_Andreescu-Garbine_Muguruza,1,B-DTM,20,3,0,1,2,15,5
20190313-W-Indian_Wells-QF-Bianca_Andreescu-Garbine_Muguruza,1,B-DTL,4,0,0,0,0,3,1
20190313-W-Indian_Wells-QF-Bianca_Andreescu-Garbine_Muguruza,1,B-IO,1,1,1,0,0,1,0
20190313-W-Indian_Wells-QF-Bianca_Andreescu-Garbine_Muguruza,1,S-DTM,8,2,0,0,2,4,4
20190313-W-Indian_Wells-QF-Bianca_Andreescu-Garbine_Muguruza,1,S-DTL,1,1,0,0,1,0,1
20190313-W-Indian_Wells-QF-Bianca_Andreescu-Garbine_Muguruza,2,F-XC,16,5,1,0,4,4,12
20190313-W-Indian_Wells-QF-Bianca_Andreescu-Garbine_Muguruza,2,F-DTM,19,4,0,0,4,5,14
20190313-W-Indian_Wells-QF-Bianca_Andreescu-Garbine_Muguruza,2,F-DTL,2,0,0,0,0,1,1
20190313-W-Indian_Wells-QF-Bianca_Andreescu-Garbine_Muguruza,2,F-IO,14,6,0,0,6,2,12
20190313-W-Indian_Wells-QF-Bianca_Andreescu-Garbine_Muguruza,2,B-XC,23,4,0,1,3,7,16
20190313-W-Indian_Wells-QF-Bianca_Andreescu-Garbine_Muguruza,2,B-DTM,17,1,0,0,1,6,11
20190313-W-Indian_Wells-QF-Bianca_Andreescu-Garbine_Muguruza,2,B-DTL,4,3,0,0,3,1,3
20190313-W-Indian_Wells-QF-Bianca_Andreescu-Garbine_Muguruza,2,B-IO,2,0,0,0,0,1,1
20190311-W-Indian_Wells-R32-Danielle_Collins-Naomi_Osaka,1,F-XC,19,6,2,1,3,8,11
20190311-W-Indian_Wells-R32-Danielle_Collins-Naomi_Osaka,1,F-DTM,15,2,1,0,1,4,11
20190311-W-Indian_Wells-R32-Danielle_Collins-Naomi_Osaka,1,F-DTL,4,2,1,0,1,3,1
20190311-W-Indian_Wells-R32-Danielle_Collins-Naomi_Osaka,1,F-IO,2,1,1,0,0,2,0
20190311-W-Indian_Wells-R32-Danielle_Collins-Naomi_Osaka,1,B-XC,27,8,1,2,5,13,14
20190311-W-Indian_Wells-R32-Danielle_Collins-Naomi_Osaka,1,B-DTM,26,3,0,0,3,11,15
20190311-W-Indian_Wells-R32-Danielle_Collins-Naomi_Osaka,1,B-DTL,6,6,1,3,2,4,2
20190311-W-Indian_Wells-R32-Danielle_Collins-Naomi_Osaka,1,S-XC,1,0,0,0,0,0,1
20190311-W-Indian_Wells-R32-Danielle_Collins-Naomi_Osaka,1,S-DTM,2,0,0,0,0,0,2
20190311-W-Indian_Wells-R32-Danielle_Collins-Naomi_Osaka,1,S-DTL,2,0,0,0,0,0,2
20190311-W-Indian_Wells-R32-Danielle_Collins-Naomi_Osaka,2,F-XC,18,8,4,2,2,11,7
20190311-W-Indian_Wells-R32-Danielle_Collins-Naomi_Osaka,2,F-DTM,9,2,0,1,1,6,3
20190311-W-Indian_Wells-R32-Danielle_Collins-Naomi_Osaka,2,F-DTL,8,5,1,2,2,6,2
20190311-W-Indian_Wells-R32-Danielle_Collins-Naomi_Osaka,2,F-IO,14,8,3,1,4,8,6
20190311-W-Indian_Wells-R32-Danielle_Collins-Naomi_Osaka,2,F-II,1,1,1,0,0,1,0
20190311-W-Indian_Wells-R32-Danielle_Collins-Naomi_Osaka,2,B-XC,22,5,2,0,3,13,9
20190311-W-Indian_Wells-R32-Danielle_Collins-Naomi_Osaka,2,B-DTM,16,1,0,0,1,7,9
20190311-W-Indian_Wells-R32-Danielle_Collins-Naomi_Osaka,2,B-DTL,7,3,0,1,2,2,5
20190311-W-Indian_Wells-R32-Danielle_Collins-Naomi_Osaka,2,B-IO,8,4,1,1,2,5,3
20190311-W-Indian_Wells-R32-Danielle_Collins-Naomi_Osaka,2,S-DTM,1,0,0,0,0,0,1
20190314-W-Indian_Wells-QF-Karolina_Pliskova-Belinda_Bencic,1,F-XC,62,15,5,0,10,26,36
20190314-W-Indian_Wells-QF-Karolina_Pliskova-Belinda_Bencic,1,F-DTM,14,1,0,0,1,6,8
20190314-W-Indian_Wells-QF-Karolina_Pliskova-Belinda_Bencic,1,F-DTL,25,16,6,3,7,14,11
20190314-W-Indian_Wells-QF-Karolina_Pliskova-Belinda_Bencic,1,F-IO,25,15,9,2,4,15,10
20190314-W-Indian_Wells-QF-Karolina_Pliskova-Belinda_Bencic,1,F-II,1,0,0,0,0,0,1
20190314-W-Indian_Wells-QF-Karolina_Pliskova-Belinda_Bencic,1,B-XC,36,5,0,0,5,16,20
20190314-W-Indian_Wells-QF-Karolina_Pliskova-Belinda_Bencic,1,B-DTM,46,2,0,0,2,16,30
20190314-W-Indian_Wells-QF-Karolina_Pliskova-Belinda_Bencic,1,B-DTL,16,5,3,1,1,7,9
20190314-W-Indian_Wells-QF-Karolina_Pliskova-Belinda_Bencic,1,B-IO,15,2,1,0,1,9,6
20190314-W-Indian_Wells-QF-Karolina_Pliskova-Belinda_Bencic,1,S-XC,12,2,0,1,1,5,7
20190314-W-Indian_Wells-QF-Karolina_Pliskova-Belinda_Bencic,1,S-DTM,9,1,0,0,1,2,7
20190314-W-Indian_Wells-QF-Karolina_Pliskova-Belinda_Bencic,1,S-DTL,1,1,1,0,0,1,0
20190314-W-Indian_Wells-QF-Karolina_Pliskova-Belinda_Bencic,1,S-IO,1,0,0,0,0,1,0
20190314-W-Indian_Wells-QF-Karolina_Pliskova-Belinda_Bencic,2,F-XC,69,19,8,2,9,39,30
20190314-W-Indian_Wells-QF-Karolina_Pliskova-Belinda_Bencic,2,F-DTM,31,2,0,0,2,16,15
20190314-W-Indian_Wells-QF-Karolina_Pliskova-Belinda_Bencic,2,F-DTL,30,8,6,2,0,24,6
20190314-W-Indian_Wells-QF-Karolina_Pliskova-Belinda_Bencic,2,F-IO,19,4,3,1,0,16,3
20190314-W-Indian_Wells-QF-Karolina_Pliskova-Belinda_Bencic,2,B-XC,42,4,1,1,2,24,18
20190314-W-Indian_Wells-QF-Karolina_Pliskova-Belinda_Bencic,2,B-DTM,23,0,0,0,0,10,13
20190314-W-Indian_Wells-QF-Karolina_Pliskova-Belinda_Bencic,2,B-DTL,12,4,2,2,0,9,3
20190314-W-Indian_Wells-QF-Karolina_Pliskova-Belinda_Bencic,2,B-IO,20,9,3,1,5,13,7
20190314-W-Indian_Wells-QF-Karolina_Pliskova-Belinda_Bencic,2,S-XC,1,0,0,0,0,0,1
20190314-W-Indian_Wells-QF-Karolina_Pliskova-Belinda_Bencic,2,S-DTM,2,0,0,0,0,1,1
19940605-W-Roland_Garros-F-Mary_Pierce-Arantxa_Sanchez_Vicario,1,F-XC,52,15,4,4,7,29,23
19940605-W-Roland_Garros-F-Mary_Pierce-Arantxa_Sanchez_Vicario,1,F-DTM,31,3,0,1,2,17,14
19940605-W-Roland_Garros-F-Mary_Pierce-Arantxa_Sanchez_Vicario,1,F-DTL,28,3,0,0,3,16,12
19940605-W-Roland_Garros-F-Mary_Pierce-Arantxa_Sanchez_Vicario,1,F-IO,10,1,0,1,0,8,2
19940605-W-Roland_Garros-F-Mary_Pierce-Arantxa_Sanchez_Vicario,1,B-XC,49,6,4,2,0,30,19
19940605-W-Roland_Garros-F-Mary_Pierce-Arantxa_Sanchez_Vicario,1,B-DTM,26,0,0,0,0,20,6
19940605-W-Roland_Garros-F-Mary_Pierce-Arantxa_Sanchez_Vicario,1,B-DTL,4,4,2,1,1,3,1
19940605-W-Roland_Garros-F-Mary_Pierce-Arantxa_Sanchez_Vicario,1,B-IO,3,1,0,1,0,3,0
19940605-W-Roland_Garros-F-Mary_Pierce-Arantxa_Sanchez_Vicario,1,S-XC,26,1,0,1,0,16,10
19940605-W-Roland_Garros-F-Mary_Pierce-Arantxa_Sanchez_Vicario,1,S-DTM,6,1,1,0,0,2,4
19940605-W-Roland_Garros-F-Mary_Pierce-Arantxa_Sanchez_Vicario,2,F-XC,54,13,2,3,8,22,32
19940605-W-Roland_Garros-F-Mary_Pierce-Arantxa_Sanchez_Vicario,2,F-DTM,11,2,0,0,2,4,7
19940605-W-Roland_Garros-F-Mary_Pierce-Arantxa_Sanchez_Vicario,2,F-DTL,10,2,0,0,2,2,8
19940605-W-Roland_Garros-F-Mary_Pierce-Arantxa_Sanchez_Vicario,2,F-IO,20,6,1,2,3,8,12
19940605-W-Roland_Garros-F-Mary_Pierce-Arantxa_Sanchez_Vicario,2,F-II,4,2,1,1,0,3,1
19940605-W-Roland_Garros-F-Mary_Pierce-Arantxa_Sanchez_Vicario,2,B-XC,66,17,5,2,10,30,36
19940605-W-Roland_Garros-F-Mary_Pierce-Arantxa_Sanchez_Vicario,2,B-DTM,28,1,0,1,0,10,18
19940605-W-Roland_Garros-F-Mary_Pierce-Arantxa_Sanchez_Vicario,2,B-DTL,45,9,0,3,6,17,28
19940605-W-Roland_Garros-F-Mary_Pierce-Arantxa_Sanchez_Vicario,2,B-IO,17,6,2,0,4,9,8
19940605-W-Roland_Garros-F-Mary_Pierce-Arantxa_Sanchez_Vicario,2,S-XC,3,0,0,0,0,0,3
19940605-W-Roland_Garros-F-Mary_Pierce-Arantxa_Sanchez_Vicario,2,S-DTM,5,0,0,0,0,1,4
19940605-W-Roland_Garros-F-Mary_Pierce-Arantxa_Sanchez_Vicario,2,S-DTL,1,0,0,0,0,1,0
20100603-W-Roland_Garros-SF-Francesca_Schiavone-Elena_Dementieva,1,F-XC,13,3,0,2,1,7,6
20100603-W-Roland_Garros-SF-Francesca_Schiavone-Elena_Dementieva,1,F-DTM,6,0,0,0,0,5,1
20100603-W-Roland_Garros-SF-Francesca_Schiavone-Elena_Dementieva,1,F-DTL,10,3,1,0,2,4,6
20100603-W-Roland_Garros-SF-Francesca_Schiavone-Elena_Dementieva,1,F-IO,15,3,2,0,1,9,6
20100603-W-Roland_Garros-SF-Francesca_Schiavone-Elena_Dementieva,1,F-II,4,1,0,1,0,3,1
20100603-W-Roland_Garros-SF-Francesca_Schiavone-Elena_Dementieva,1,B-XC,32,5,1,1,3,22,10
20100603-W-Roland_Garros-SF-Francesca_Schiavone-Elena_Dementieva,1,B-DTM,10,1,0,0,1,4,6
20100603-W-Roland_Garros-SF-Francesca_Schiavone-Elena_Dementieva,1,B-DTL,3,2,2,0,0,2,1
20100603-W-Roland_Garros-SF-Francesca_Schiavone-Elena_Dementieva,1,S-XC,14,0,0,0,0,6,8
20100603-W-Roland_Garros-SF-Francesca_Schiavone-Elena_Dementieva,1,S-DTM,6,0,0,0,0,4,2
20100603-W-Roland_Garros-SF-Francesca_Schiavone-Elena_Dementieva,1,S-DTL,3,0,0,0,0,2,1
20100603-W-Roland_Garros-SF-Francesca_Schiavone-Elena_Dementieva,2,F-XC,19,8,2,4,2,10,9
20100603-W-Roland_Garros-SF-Francesca_Schiavone-Elena_Dementieva,2,F-DTM,4,0,0,0,0,1,3
20100603-W-Roland_Garros-SF-Francesca_Schiavone-Elena_Dementieva,2,F-DTL,9,3,1,0,2,3,6
20100603-W-Roland_Garros-SF-Francesca_Schiavone-Elena_Dementieva,2,F-IO,29,6,2,0,4,14,15
20100603-W-Roland_Garros-SF-Francesca_Schiavone-Elena_Dementieva,2,F-II,9,7,4,0,3,5,4
20100603-W-Roland_Garros-SF-Francesca_Schiavone-Elena_Dementieva,2,B-XC,35,3,0,1,2,15,20
20100603-W-Roland_Garros-SF-Francesca_Schiavone-Elena_Dementieva,2,B-DTM,7,1,0,0,1,1,6
20100603-W-Roland_Garros-SF-Francesca_Schiavone-Elena_Dementieva,2,B-DTL,4,2,0,0,2,1,3
20100603-W-Roland_Garros-SF-Francesca_Schiavone-Elena_Dementieva,2,B-IO,4,2,0,0,2,0,4
20100603-W-Roland_Garros-SF-Francesca_Schiavone-Elena_Dementieva,2,S-XC,2,0,0,0,0,1,1
20100603-W-Roland_Garros-SF-Francesca_Schiavone-Elena_Dementieva,2,S-DTM,5,0,0,0,0,3,2
20100603-W-Roland_Garros-SF-Francesca_Schiavone-Elena_Dementieva,2,S-DTL,2,0,0,0,0,0,2
20190308-W-Indian_Wells-R64-Dominika_Cibulkova-Bianca_Andreescu,1,F-XC,35,6,1,2,3,18,17
20190308-W-Indian_Wells-R64-Dominika_Cibulkova-Bianca_Andreescu,1,F-DTM,43,4,0,0,4,16,27
20190308-W-Indian_Wells-R64-Dominika_Cibulkova-Bianca_Andreescu,1,F-DTL,8,1,0,1,0,7,1
20190308-W-Indian_Wells-R64-Dominika_Cibulkova-Bianca_Andreescu,1,F-IO,23,8,2,2,4,12,11
20190308-W-Indian_Wells-R64-Dominika_Cibulkova-Bianca_Andreescu,1,B-XC,38,10,0,1,9,12,26
20190308-W-Indian_Wells-R64-Dominika_Cibulkova-Bianca_Andreescu,1,B-DTM,30,3,0,1,2,15,15
20190308-W-Indian_Wells-R64-Dominika_Cibulkova-Bianca_Andreescu,1,B-DTL,2,1,0,0,1,0,2
20190308-W-Indian_Wells-R64-Dominika_Cibulkova-Bianca_Andreescu,1,B-IO,3,3,0,0,3,0,3
20190308-W-Indian_Wells-R64-Dominika_Cibulkova-Bianca_Andreescu,1,S-XC,2,0,0,0,0,1,1
20190308-W-Indian_Wells-R64-Dominika_Cibulkova-Bianca_Andreescu,1,S-DTM,5,0,0,0,0,1,4
20190308-W-Indian_Wells-R64-Dominika_Cibulkova-Bianca_Andreescu,2,F-XC,25,8,4,1,3,13,12
20190308-W-Indian_Wells-R64-Dominika_Cibulkova-Bianca_Andreescu,2,F-DTM,48,7,0,0,7,28,20
20190308-W-Indian_Wells-R64-Dominika_Cibulkova-Bianca_Andreescu,2,F-DTL,7,2,1,0,1,4,3
20190308-W-Indian_Wells-R64-Dominika_Cibulkova-Bianca_Andreescu,2,F-IO,15,4,2,0,2,9,6
20190308-W-Indian_Wells-R64-Dominika_Cibulkova-Bianca_Andreescu,2,F-II,2,2,2,0,0,2,0
20190308-W-Indian_Wells-R64-Dominika_Cibulkova-Bianca_Andreescu,2,B-XC,25,5,0,2,3,16,9
20190308-W-Indian_Wells-R64-Dominika_Cibulkova-Bianca_Andreescu,2,B-DTM,34,2,0,0,2,15,19
20190308-W-Indian_Wells-R64-Dominika_Cibulkova-Bianca_Andreescu,2,B-DTL,5,2,0,0,2,2,3
20190308-W-Indian_Wells-R64-Dominika_Cibulkova-Bianca_Andreescu,2,B-IO,1,1,0,0,1,0,1
20190308-W-Indian_Wells-R64-Dominika_Cibulkova-Bianca_Andreescu,2,S-XC,3,1,0,0,1,1,2
20190308-W-Indian_Wells-R64-Dominika_Cibulkova-Bianca_Andreescu,2,S-DTM,9,0,0,0,0,5,4
20190308-W-Indian_Wells-R64-Dominika_Cibulkova-Bianca_Andreescu,2,S-IO,2,0,0,0,0,0,2
20190315-W-Indian_Wells-SF-Bianca_Andreescu-Elina_Svitolina,1,F-XC,54,19,4,4,11,24,30
20190315-W-Indian_Wells-SF-Bianca_Andreescu-Elina_Svitolina,1,F-DTM,73,10,1,2,7,23,50
20190315-W-Indian_Wells-SF-Bianca_Andreescu-Elina_Svitolina,1,F-DTL,16,7,2,2,3,9,7
20190315-W-Indian_Wells-SF-Bianca_Andreescu-Elina_Svitolina,1,F-IO,38,14,5,0,9,20,18
20190315-W-Indian_Wells-SF-Bianca_Andreescu-Elina_Svitolina,1,F-II,3,2,1,0,1,1,2
20190315-W-Indian_Wells-SF-Bianca_Andreescu-Elina_Svitolina,1,B-XC,38,10,5,2,3,20,18
20190315-W-Indian_Wells-SF-Bianca_Andreescu-Elina_Svitolina,1,B-DTM,47,12,1,4,7,15,32
20190315-W-Indian_Wells-SF-Bianca_Andreescu-Elina_Svitolina,1,B-DTL,8,3,0,1,2,4,4
20190315-W-Indian_Wells-SF-Bianca_Andreescu-Elina_Svitolina,1,B-IO,9,4,1,0,3,3,6
20190315-W-Indian_Wells-SF-Bianca_Andreescu-Elina_Svitolina,1,S-XC,7,1,0,0,1,1,6
20190315-W-Indian_Wells-SF-Bianca_Andreescu-Elina_Svitolina,1,S-DTM,23,3,0,0,3,11,12
20190315-W-Indian_Wells-SF-Bianca_Andreescu-Elina_Svitolina,1,S-DTL,4,1,0,1,0,2,2
20190315-W-Indian_Wells-SF-Bianca_Andreescu-Elina_Svitolina,1,S-IO,4,0,0,0,0,2,2
20190315-W-Indian_Wells-SF-Bianca_Andreescu-Elina_Svitolina,2,F-XC,63,11,3,4,4,43,20
20190315-W-Indian_Wells-SF-Bianca_Andreescu-Elina_Svitolina,2,F-DTM,63,0,0,0,0,36,27
20190315-W-Indian_Wells-SF-Bianca_Andreescu-Elina_Svitolina,2,F-DTL,9,2,0,0,2,3,6
20190315-W-Indian_Wells-SF-Bianca_Andreescu-Elina_Svitolina,2,F-IO,13,2,1,0,1,5,8
20190315-W-Indian_Wells-SF-Bianca_Andreescu-Elina_Svitolina,2,B-XC,83,10,1,1,8,46,37
20190315-W-Indian_Wells-SF-Bianca_Andreescu-Elina_Svitolina,2,B-DTM,39,3,0,1,2,23,16
20190315-W-Indian_Wells-SF-Bianca_Andreescu-Elina_Svitolina,2,B-DTL,2,1,0,0,1,1,1
20190315-W-Indian_Wells-SF-Bianca_Andreescu-Elina_Svitolina,2,B-IO,9,4,0,1,3,5,4
20190315-W-Indian_Wells-SF-Bianca_Andreescu-Elina_Svitolina,2,S-XC,3,0,0,0,0,1,2
20190315-W-Indian_Wells-SF-Bianca_Andreescu-Elina_Svitolina,2,S-DTM,9,0,0,0,0,4,5
20190315-W-Indian_Wells-SF-Bianca_Andreescu-Elina_Svitolina,2,S-DTL,2,0,0,0,0,1,1
20100502-W-Stuttgart-F-Samantha_Stosur-Justine_Henin,1,F-XC,26,8,4,2,2,14,12
20100502-W-Stuttgart-F-Samantha_Stosur-Justine_Henin,1,F-DTM,13,0,0,0,0,4,9
20100502-W-Stuttgart-F-Samantha_Stosur-Justine_Henin,1,F-DTL,8,5,2,1,2,4,4
20100502-W-Stuttgart-F-Samantha_Stosur-Justine_Henin,1,F-IO,18,7,1,3,3,8,10
20100502-W-Stuttgart-F-Samantha_Stosur-Justine_Henin,1,F-II,6,3,1,1,1,3,3
20100502-W-Stuttgart-F-Samantha_Stosur-Justine_Henin,1,B-XC,11,1,0,1,0,3,8
20100502-W-Stuttgart-F-Samantha_Stosur-Justine_Henin,1,B-DTM,6,0,0,0,0,3,3
20100502-W-Stuttgart-F-Samantha_Stosur-Justine_Henin,1,B-DTL,8,5,3,0,2,4,4
20100502-W-Stuttgart-F-Samantha_Stosur-Justine_Henin,1,B-IO,3,2,1,0,1,1,2
20100502-W-Stuttgart-F-Samantha_Stosur-Justine_Henin,1,S-XC,6,1,0,0,1,0,6
20100502-W-Stuttgart-F-Samantha_Stosur-Justine_Henin,1,S-DTM,4,0,0,0,0,1,3
20100502-W-Stuttgart-F-Samantha_Stosur-Justine_Henin,1,S-DTL,2,1,0,0,1,1,1
20100502-W-Stuttgart-F-Samantha_Stosur-Justine_Henin,1,S-IO,1,0,0,0,0,0,1
20100502-W-Stuttgart-F-Samantha_Stosur-Justine_Henin,2,F-XC,35,13,3,4,6,22,13
20100502-W-Stuttgart-F-Samantha_Stosur-Justine_Henin,2,F-DTM,10,0,0,0,0,6,4
20100502-W-Stuttgart-F-Samantha_Stosur-Justine_Henin,2,F-DTL,8,4,1,0,3,4,4
20100502-W-Stuttgart-F-Samantha_Stosur-Justine_Henin,2,F-IO,9,4,3,0,1,8,1
20100502-W-Stuttgart-F-Samantha_Stosur-Justine_Henin,2,F-II,1,0,0,0,0,0,1
20100502-W-Stuttgart-F-Samantha_Stosur-Justine_Henin,2,B-XC,22,8,3,2,3,12,10
20100502-W-Stuttgart-F-Samantha_Stosur-Justine_Henin,2,B-DTM,13,1,0,1,0,9,4
20100502-W-Stuttgart-F-Samantha_Stosur-Justine_Henin,2,B-DTL,2,2,2,0,0,2,0
20100502-W-Stuttgart-F-Samantha_Stosur-Justine_Henin,2,B-IO,2,2,0,0,2,0,2
20100502-W-Stuttgart-F-Samantha_Stosur-Justine_Henin,2,S-XC,12,1,0,0,1,9,3
20100502-W-Stuttgart-F-Samantha_Stosur-Justine_Henin,2,S-DTM,1,0,0,0,0,0,1
20100502-W-Stuttgart-F-Samantha_Stosur-Justine_Henin,2,S-DTL,1,1,1,0,0,1,0
20190310-W-Indian_Wells-R32-Qiang_Wang-Elise_Mertens,1,F-XC,118,22,5,3,14,54,64
20190310-W-Indian_Wells-R32-Qiang_Wang-Elise_Mertens,1,F-DTM,70,5,1,0,4,30,40
20190310-W-Indian_Wells-R32-Qiang_Wang-Elise_Mertens,1,F-DTL,22,8,2,4,2,12,10
20190310-W-Indian_Wells-R32-Qiang_Wang-Elise_Mertens,1,F-IO,32,4,1,1,2,20,12
20190310-W-Indian_Wells-R32-Qiang_Wang-Elise_Mertens,1,F-II,1,1,0,0,1,0,1
20190310-W-Indian_Wells-R32-Qiang_Wang-Elise_Mertens,1,B-XC,90,16,2,6,8,51,39
20190310-W-Indian_Wells-R32-Qiang_Wang-Elise_Mertens,1,B-DTM,42,5,0,0,5,14,28
20190310-W-Indian_Wells-R32-Qiang_Wang-Elise_Mertens,1,B-DTL,26,8,2,2,4,14,12
20190310-W-Indian_Wells-R32-Qiang_Wang-Elise_Mertens,1,B-IO,9,3,1,1,1,5,4
20190310-W-Indian_Wells-R32-Qiang_Wang-Elise_Mertens,1,S-XC,9,0,0,0,0,2,7
20190310-W-Indian_Wells-R32-Qiang_Wang-Elise_Mertens,1,S-DTM,4,0,0,0,0,2,2
20190310-W-Indian_Wells-R32-Qiang_Wang-Elise_Mertens,1,S-IO,2,0,0,0,0,1,1
20190310-W-Indian_Wells-R32-Qiang_Wang-Elise_Mertens,2,F-XC,93,19,4,5,10,48,45
20190310-W-Indian_Wells-R32-Qiang_Wang-Elise_Mertens,2,F-DTM,23,2,0,0,2,7,16
20190310-W-Indian_Wells-R32-Qiang_Wang-Elise_Mertens,2,F-DTL,37,15,9,1,5,23,14
20190310-W-Indian_Wells-R32-Qiang_Wang-Elise_Mertens,2,F-IO,44,19,8,4,7,27,17
20190310-W-Indian_Wells-R32-Qiang_Wang-Elise_Mertens,2,B-XC,60,13,3,2,8,29,31
20190310-W-Indian_Wells-R32-Qiang_Wang-Elise_Mertens,2,B-DTM,55,5,0,0,5,29,26
20190310-W-Indian_Wells-R32-Qiang_Wang-Elise_Mertens,2,B-DTL,43,15,6,2,7,20,23
20190310-W-Indian_Wells-R32-Qiang_Wang-Elise_Mertens,2,B-IO,26,7,3,1,3,18,8
20190310-W-Indian_Wells-R32-Qiang_Wang-Elise_Mertens,2,S-XC,14,0,0,0,0,7,7
20190310-W-Indian_Wells-R32-Qiang_Wang-Elise_Mertens,2,S-DTM,14,0,0,0,0,6,8
20190310-W-Indian_Wells-R32-Qiang_Wang-Elise_Mertens,2,S-DTL,3,0,0,0,0,2,1
20190310-W-Indian_Wells-R32-Qiang_Wang-Elise_Mertens,2,S-IO,1,1,0,0,1,0,1
20190317-W-Indian_Wells-F-Angelique_Kerber-Bianca_Andreescu,1,F-XC,60,8,0,1,7,23,37
20190317-W-Indian_Wells-F-Angelique_Kerber-Bianca_Andreescu,1,F-DTM,46,4,0,0,4,20,26
20190317-W-Indian_Wells-F-Angelique_Kerber-Bianca_Andreescu,1,F-DTL,12,9,4,3,2,7,5
20190317-W-Indian_Wells-F-Angelique_Kerber-Bianca_Andreescu,1,F-IO,23,10,4,4,2,18,5
20190317-W-Indian_Wells-F-Angelique_Kerber-Bianca_Andreescu,1,B-XC,60,12,3,5,4,26,34
20190317-W-Indian_Wells-F-Angelique_Kerber-Bianca_Andreescu,1,B-DTM,57,9,0,0,9,22,35
20190317-W-Indian_Wells-F-Angelique_Kerber-Bianca_Andreescu,1,B-DTL,5,2,1,0,1,4,1
20190317-W-Indian_Wells-F-Angelique_Kerber-Bianca_Andreescu,1,B-IO,11,1,0,0,1,5,6
20190317-W-Indian_Wells-F-Angelique_Kerber-Bianca_Andreescu,1,S-XC,4,0,0,0,0,0,4
20190317-W-Indian_Wells-F-Angelique_Kerber-Bianca_Andreescu,1,S-DTM,12,0,0,0,0,2,10
20190317-W-Indian_Wells-F-Angelique_Kerber-Bianca_Andreescu,1,S-DTL,7,1,0,1,0,3,4
20190317-W-Indian_Wells-F-Angelique_Kerber-Bianca_Andreescu,1,S-IO,4,1,0,0,1,0,4
20190317-W-Indian_Wells-F-Angelique_Kerber-Bianca_Andreescu,2,F-XC,71,17,10,1,6,46,25
20190317-W-Indian_Wells-F-Angelique_Kerber-Bianca_Andreescu,2,F-DTM,33,2,0,0,2,17,16
20190317-W-Indian_Wells-F-Angelique_Kerber-Bianca_Andreescu,2,F-DTL,19,8,6,0,2,11,8
20190317-W-Indian_Wells-F-Angelique_Kerber-Bianca_Andreescu,2,F-IO,29,13,8,2,3,18,11
20190317-W-Indian_Wells-F-Angelique_Kerber-Bianca_Andreescu,2,F-II,5,3,1,1,1,4,1
20190317-W-Indian_Wells-F-Angelique_Kerber-Bianca_Andreescu,2,B-XC,32,14,3,5,6,19,13
20190317-W-Indian_Wells-F-Angelique_Kerber-Bianca_Andreescu,2,B-DTM,35,4,0,1,3,23,12
20190317-W-Indian_Wells-F-Angelique_Kerber-Bianca_Andreescu,2,B-DTL,13,3,1,0,2,8,5
20190317-W-Indian_Wells-F-Angelique_Kerber-Bianca_Andreescu,2,B-IO,10,2,0,0,2,4,6
20190317-W-Indian_Wells-F-Angelique_Kerber-Bianca_Andreescu,2,S-XC,2,0,0,0,0,1,1
20190317-W-Indian_Wells-F-Angelique_Kerber-Bianca_Andreescu,2,S-DTM,20,4,0,0,4,13,7
20190317-W-Indian_Wells-F-Angelique_Kerber-Bianca_Andreescu,2,S-DTL,2,0,0,0,0,2,0
20190317-W-Indian_Wells-F-Angelique_Kerber-Bianca_Andreescu,2,S-IO,3,0,0,0,0,2,1
20190310-W-Indian_Wells-R32-Bianca_Andreescu-Stefanie_Voegele,1,F-XC,12,3,0,2,1,7,5
20190310-W-Indian_Wells-R32-Bianca_Andreescu-Stefanie_Voegele,1,F-DTM,14,2,0,0,2,9,5
20190310-W-Indian_Wells-R32-Bianca_Andreescu-Stefanie_Voegele,1,F-DTL,8,3,0,0,3,5,3
20190310-W-Indian_Wells-R32-Bianca_Andreescu-Stefanie_Voegele,1,F-IO,8,5,3,2,0,8,0
20190310-W-Indian_Wells-R32-Bianca_Andreescu-Stefanie_Voegele,1,F-II,1,1,0,1,0,1,0
20190310-W-Indian_Wells-R32-Bianca_Andreescu-Stefanie_Voegele,1,B-XC,12,4,0,0,4,6,6
20190310-W-Indian_Wells-R32-Bianca_Andreescu-Stefanie_Voegele,1,B-DTM,19,3,0,1,2,15,4
20190310-W-Indian_Wells-R32-Bianca_Andreescu-Stefanie_Voegele,1,B-DTL,6,4,4,0,0,6,0
20190310-W-Indian_Wells-R32-Bianca_Andreescu-Stefanie_Voegele,1,B-IO,2,1,1,0,0,2,0
20190310-W-Indian_Wells-R32-Bianca_Andreescu-Stefanie_Voegele,1,S-XC,3,0,0,0,0,2,1
20190310-W-Indian_Wells-R32-Bianca_Andreescu-Stefanie_Voegele,1,S-DTM,3,0,0,0,0,3,0
20190310-W-Indian_Wells-R32-Bianca_Andreescu-Stefanie_Voegele,1,S-DTL,2,1,0,0,1,1,1
20190310-W-Indian_Wells-R32-Bianca_Andreescu-Stefanie_Voegele,2,F-XC,12,2,1,0,1,4,8
20190310-W-Indian_Wells-R32-Bianca_Andreescu-Stefanie_Voegele,2,F-DTM,17,1,0,0,1,1,16
20190310-W-Indian_Wells-R32-Bianca_Andreescu-Stefanie_Voegele,2,F-DTL,4,2,0,0,2,0,4
20190310-W-Indian_Wells-R32-Bianca_Andreescu-Stefanie_Voegele,2,F-IO,9,3,0,0,3,3,6
20190310-W-Indian_Wells-R32-Bianca_Andreescu-Stefanie_Voegele,2,B-XC,27,4,2,0,2,6,21
20190310-W-Indian_Wells-R32-Bianca_Andreescu-Stefanie_Voegele,2,B-DTM,9,0,0,0,0,3,6
20190310-W-Indian_Wells-R32-Bianca_Andreescu-Stefanie_Voegele,2,B-DTL,1,0,0,0,0,0,1
20190310-W-Indian_Wells-R32-Bianca_Andreescu-Stefanie_Voegele,2,B-IO,7,1,0,0,1,4,3
20190310-W-Indian_Wells-R32-Bianca_Andreescu-Stefanie_Voegele,2,S-XC,3,1,0,1,0,1,2
20190310-W-Indian_Wells-R32-Bianca_Andreescu-Stefanie_Voegele,2,S-DTM,2,0,0,0,0,0,2
20190314-W-Indian_Wells-QF-Venus_Williams-Angelique_Kerber,1,F-XC,67,9,2,1,6,34,33
20190314-W-Indian_Wells-QF-Venus_Williams-Angelique_Kerber,1,F-DTM,11,2,2,0,0,4,7
20190314-W-Indian_Wells-QF-Venus_Williams-Angelique_Kerber,1,F-DTL,30,14,8,0,6,13,17
20190314-W-Indian_Wells-QF-Venus_Williams-Angelique_Kerber,1,F-IO,21,11,5,2,4,13,8
20190314-W-Indian_Wells-QF-Venus_Williams-Angelique_Kerber,1,F-II,2,1,0,1,0,1,1
20190314-W-Indian_Wells-QF-Venus_Williams-Angelique_Kerber,1,B-XC,40,6,2,0,4,16,24
20190314-W-Indian_Wells-QF-Venus_Williams-Angelique_Kerber,1,B-DTM,17,1,1,0,0,10,7
20190314-W-Indian_Wells-QF-Venus_Williams-Angelique_Kerber,1,B-DTL,22,10,4,0,6,6,16
20190314-W-Indian_Wells-QF-Venus_Williams-Angelique_Kerber,1,B-IO,15,5,4,0,1,8,7
20190314-W-Indian_Wells-QF-Venus_Williams-Angelique_Kerber,1,S-DTL,4,1,0,0,1,1,3
20190314-W-Indian_Wells-QF-Venus_Williams-Angelique_Kerber,1,S-IO,1,0,0,0,0,0,1
20190314-W-Indian_Wells-QF-Venus_Williams-Angelique_Kerber,2,F-XC,54,7,5,2,0,38,16
20190314-W-Indian_Wells-QF-Venus_Williams-Angelique_Kerber,2,F-DTM,15,2,1,1,0,8,7
20190314-W-Indian_Wells-QF-Venus_Williams-Angelique_Kerber,2,F-DTL,25,14,10,1,3,17,8
20190314-W-Indian_Wells-QF-Venus_Williams-Angelique_Kerber,2,F-IO,14,5,2,2,1,8,6
20190314-W-Indian_Wells-QF-Venus_Williams-Angelique_Kerber,2,B-XC,54,9,3,2,4,29,25
20190314-W-Indian_Wells-QF-Venus_Williams-Angelique_Kerber,2,B-DTM,33,1,0,0,1,19,14
20190314-W-Indian_Wells-QF-Venus_Williams-Angelique_Kerber,2,B-DTL,8,6,3,0,3,4,4
20190314-W-Indian_Wells-QF-Venus_Williams-Angelique_Kerber,2,B-IO,3,0,0,0,0,1,2
20190314-W-Indian_Wells-QF-Venus_Williams-Angelique_Kerber,2,B-II,1,0,0,0,0,1,0
20190314-W-Indian_Wells-QF-Venus_Williams-Angelique_Kerber,2,S-XC,6,0,0,0,0,4,2
20190314-W-Indian_Wells-QF-Venus_Williams-Angelique_Kerber,2,S-DTM,7,0,0,0,0,2,5
20190314-W-Indian_Wells-QF-Venus_Williams-Angelique_Kerber,2,S-DTL,4,0,0,0,0,3,1
20190306-W-Indian_Wells-R128-Caty_Mcnally-Bernarda_Pera,1,F-XC,41,7,0,1,6,18,23
20190306-W-Indian_Wells-R128-Caty_Mcnally-Bernarda_Pera,1,F-DTM,27,4,0,0,4,5,22
20190306-W-Indian_Wells-R128-Caty_Mcnally-Bernarda_Pera,1,F-DTL,5,3,1,1,1,4,1
20190306-W-Indian_Wells-R128-Caty_Mcnally-Bernarda_Pera,1,F-IO,16,6,0,2,4,6,10
20190306-W-Indian_Wells-R128-Caty_Mcnally-Bernarda_Pera,1,F-II,1,1,0,0,1,0,1
20190306-W-Indian_Wells-R128-Caty_Mcnally-Bernarda_Pera,1,B-XC,12,6,0,1,5,5,7
20190306-W-Indian_Wells-R128-Caty_Mcnally-Bernarda_Pera,1,B-DTM,13,2,0,1,1,5,8
20190306-W-Indian_Wells-R128-Caty_Mcnally-Bernarda_Pera,1,B-DTL,2,1,0,0,1,1,1
20190306-W-Indian_Wells-R128-Caty_Mcnally-Bernarda_Pera,1,B-IO,4,2,0,0,2,1,3
20190306-W-Indian_Wells-R128-Caty_Mcnally-Bernarda_Pera,1,S-XC,2,0,0,0,0,1,1
20190306-W-Indian_Wells-R128-Caty_Mcnally-Bernarda_Pera,1,S-DTM,4,0,0,0,0,1,3
20190306-W-Indian_Wells-R128-Caty_Mcnally-Bernarda_Pera,1,S-DTL,2,1,0,1,0,2,0
20190306-W-Indian_Wells-R128-Caty_Mcnally-Bernarda_Pera,2,F-XC,39,12,8,0,4,26,13
20190306-W-Indian_Wells-R128-Caty_Mcnally-Bernarda_Pera,2,F-DTM,8,0,0,0,0,3,5
20190306-W-Indian_Wells-R128-Caty_Mcnally-Bernarda_Pera,2,F-DTL,5,4,2,0,2,2,3
20190306-W-Indian_Wells-R128-Caty_Mcnally-Bernarda_Pera,2,F-IO,7,1,0,1,0,7,0
20190306-W-Indian_Wells-R128-Caty_Mcnally-Bernarda_Pera,2,B-XC,30,7,1,2,4,15,15
20190306-W-Indian_Wells-R128-Caty_Mcnally-Bernarda_Pera,2,B-DTM,25,1,0,0,1,15,10
20190306-W-Indian_Wells-R128-Caty_Mcnally-Bernarda_Pera,2,B-DTL,2,0,0,0,0,2,0
20190306-W-Indian_Wells-R128-Caty_Mcnally-Bernarda_Pera,2,S-XC,1,0,0,0,0,0,1
20190306-W-Indian_Wells-R128-Caty_Mcnally-Bernarda_Pera,2,S-DTM,2,0,0,0,0,2,0
20190306-W-Indian_Wells-R128-Caty_Mcnally-Bernarda_Pera,2,S-DTL,1,0,0,0,0,0,1
20190306-W-Indian_Wells-R128-Caty_Mcnally-Bernarda_Pera,2,S-IO,1,1,0,0,1,0,1
20080817-W-Olympics-F-Dinara_Safina-Elena_Dementieva,1,F-XC,65,9,2,3,3,42,23
20080817-W-Olympics-F-Dinara_Safina-Elena_Dementieva,1,F-DTM,21,5,1,0,4,6,15
20080817-W-Olympics-F-Dinara_Safina-Elena_Dementieva,1,F-DTL,21,6,2,0,4,8,13
20080817-W-Olympics-F-Dinara_Safina-Elena_Dementieva,1,F-IO,22,6,2,1,3,11,11
20080817-W-Olympics-F-Dinara_Safina-Elena_Dementieva,1,F-II,1,0,0,0,0,1,0
20080817-W-Olympics-F-Dinara_Safina-Elena_Dementieva,1,B-XC,99,11,3,1,7,60,39
20080817-W-Olympics-F-Dinara_Safina-Elena_Dementieva,1,B-DTM,48,3,0,0,3,24,24
20080817-W-Olympics-F-Dinara_Safina-Elena_Dementieva,1,B-DTL,19,9,2,2,5,7,12
20080817-W-Olympics-F-Dinara_Safina-Elena_Dementieva,1,B-IO,7,3,0,0,3,1,6
20080817-W-Olympics-F-Dinara_Safina-Elena_Dementieva,1,S-XC,7,1,0,0,1,3,4
20080817-W-Olympics-F-Dinara_Safina-Elena_Dementieva,1,S-DTM,10,0,0,0,0,5,5
20080817-W-Olympics-F-Dinara_Safina-Elena_Dementieva,1,S-DTL,1,0,0,0,0,0,1
20080817-W-Olympics-F-Dinara_Safina-Elena_Dementieva,2,F-XC,85,20,8,2,10,44,41
20080817-W-Olympics-F-Dinara_Safina-Elena_Dementieva,2,F-DTM,23,2,0,0,2,14,9
20080817-W-Olympics-F-Dinara_Safina-Elena_Dementieva,2,F-DTL,30,10,5,0,5,13,17
20080817-W-Olympics-F-Dinara_Safina-Elena_Dementieva,2,F-IO,50,11,4,2,5,20,30
20080817-W-Olympics-F-Dinara_Safina-Elena_Dementieva,2,F-II,4,1,0,0,1,0,4
20080817-W-Olympics-F-Dinara_Safina-Elena_Dementieva,2,B-XC,93,11,3,2,6,43,50
20080817-W-Olympics-F-Dinara_Safina-Elena_Dementieva,2,B-DTM,24,3,0,0,3,11,13
20080817-W-Olympics-F-Dinara_Safina-Elena_Dementieva,2,B-DTL,23,9,3,3,3,12,11
20080817-W-Olympics-F-Dinara_Safina-Elena_Dementieva,2,B-IO,8,3,1,0,2,3,5
20080817-W-Olympics-F-Dinara_Safina-Elena_Dementieva,2,S-XC,2,1,0,0,1,0,2
20080817-W-Olympics-F-Dinara_Safina-Elena_Dementieva,2,S-DTM,1,0,0,0,0,0,1
20190320-W-Miami-R128-Dominika_Cibulkova-Victoria_Azarenka,1,F-XC,62,11,2,5,4,38,24
20190320-W-Miami-R128-Dominika_Cibulkova-Victoria_Azarenka,1,F-DTM,35,2,0,0,2,22,13
20190320-W-Miami-R128-Dominika_Cibulkova-Victoria_Azarenka,1,F-DTL,21,13,7,1,5,11,10
20190320-W-Miami-R128-Dominika_Cibulkova-Victoria_Azarenka,1,F-IO,18,9,5,1,3,13,5
20190320-W-Miami-R128-Dominika_Cibulkova-Victoria_Azarenka,1,F-II,5,2,2,0,0,4,1
20190320-W-Miami-R128-Dominika_Cibulkova-Victoria_Azarenka,1,B-XC,36,8,6,1,1,22,14
20190320-W-Miami-R128-Dominika_Cibulkova-Victoria_Azarenka,1,B-DTM,37,4,0,0,4,20,17
20190320-W-Miami-R128-Dominika_Cibulkova-Victoria_Azarenka,1,B-DTL,14,6,1,0,5,5,9
20190320-W-Miami-R128-Dominika_Cibulkova-Victoria_Azarenka,1,B-IO,8,3,2,0,1,4,4
20190320-W-Miami-R128-Dominika_Cibulkova-Victoria_Azarenka,1,S-XC,1,0,0,0,0,1,0
20190320-W-Miami-R128-Dominika_Cibulkova-Victoria_Azarenka,1,S-DTM,5,0,0,0,0,1,4
20190320-W-Miami-R128-Dominika_Cibulkova-Victoria_Azarenka,1,S-DTL,2,1,1,0,0,1,1
20190320-W-Miami-R128-Dominika_Cibulkova-Victoria_Azarenka,2,F-XC,46,10,5,3,2,24,22
20190320-W-Miami-R128-Dominika_Cibulkova-Victoria_Azarenka,2,F-DTM,40,3,0,0,3,9,31
20190320-W-Miami-R128-Dominika_Cibulkova-Victoria_Azarenka,2,F-DTL,24,9,0,2,7,8,16
20190320-W-Miami-R128-Dominika_Cibulkova-Victoria_Azarenka,2,F-IO,21,8,3,0,5,12,9
20190320-W-Miami-R128-Dominika_Cibulkova-Victoria_Azarenka,2,B-XC,22,5,1,0,4,11,11
20190320-W-Miami-R128-Dominika_Cibulkova-Victoria_Azarenka,2,B-DTM,38,2,0,0,2,13,25
20190320-W-Miami-R128-Dominika_Cibulkova-Victoria_Azarenka,2,B-DTL,10,4,3,0,1,6,4
20190320-W-Miami-R128-Dominika_Cibulkova-Victoria_Azarenka,2,B-IO,12,5,1,1,3,5,7
20190320-W-Miami-R128-Dominika_Cibulkova-Victoria_Azarenka,2,S-XC,2,0,0,0,0,0,2
20190320-W-Miami-R128-Dominika_Cibulkova-Victoria_Azarenka,2,S-DTM,5,0,0,0,0,1,4
20190320-W-Miami-R128-Dominika_Cibulkova-Victoria_Azarenka,2,S-DTL,1,0,0,0,0,1,0
20190321-W-Miami-R64-Xiyu_Wang-Kiki_Bertens,1,F-XC,44,9,0,1,8,14,30
20190321-W-Miami-R64-Xiyu_Wang-Kiki_Bertens,1,F-DTM,25,3,0,1,2,13,12
20190321-W-Miami-R64-Xiyu_Wang-Kiki_Bertens,1,F-DTL,3,2,0,0,2,0,3
20190321-W-Miami-R64-Xiyu_Wang-Kiki_Bertens,1,F-IO,12,4,3,0,1,7,5
20190321-W-Miami-R64-Xiyu_Wang-Kiki_Bertens,1,B-XC,20,9,1,3,5,11,9
20190321-W-Miami-R64-Xiyu_Wang-Kiki_Bertens,1,B-DTM,11,0,0,0,0,4,7
20190321-W-Miami-R64-Xiyu_Wang-Kiki_Bertens,1,B-DTL,1,0,0,0,0,1,0
20190321-W-Miami-R64-Xiyu_Wang-Kiki_Bertens,1,B-IO,1,1,0,0,1,0,1
20190321-W-Miami-R64-Xiyu_Wang-Kiki_Bertens,1,S-DTM,2,0,0,0,0,0,2
20190321-W-Miami-R64-Xiyu_Wang-Kiki_Bertens,2,F-XC,17,4,0,1,3,7,10
20190321-W-Miami-R64-Xiyu_Wang-Kiki_Bertens,2,F-DTM,28,3,1,1,1,18,10
20190321-W-Miami-R64-Xiyu_Wang-Kiki_Bertens,2,F-DTL,8,4,1,0,3,1,7
20190321-W-Miami-R64-Xiyu_Wang-Kiki_Bertens,2,F-IO,10,3,3,0,0,8,2
20190321-W-Miami-R64-Xiyu_Wang-Kiki_Bertens,2,B-XC,9,1,1,0,0,8,1
20190321-W-Miami-R64-Xiyu_Wang-Kiki_Bertens,2,B-DTM,22,1,0,0,1,10,12
20190321-W-Miami-R64-Xiyu_Wang-Kiki_Bertens,2,B-DTL,2,2,1,0,1,1,1
20190321-W-Miami-R64-Xiyu_Wang-Kiki_Bertens,2,B-IO,2,2,1,0,1,1,1
20190321-W-Miami-R64-Xiyu_Wang-Kiki_Bertens,2,S-XC,4,1,0,0,1,3,1
20190321-W-Miami-R64-Xiyu_Wang-Kiki_Bertens,2,S-DTM,12,2,0,0,2,6,6
20190322-W-Miami-R64-Bianca_Andreescu-Sofia_Kenin,1,F-XC,13,8,4,2,2,11,2
20190322-W-Miami-R64-Bianca_Andreescu-Sofia_Kenin,1,F-DTM,24,4,1,0,3,8,16
20190322-W-Miami-R64-Bianca_Andreescu-Sofia_Kenin,1,F-DTL,2,1,1,0,0,2,0
20190322-W-Miami-R64-Bianca_Andreescu-Sofia_Kenin,1,F-IO,17,7,4,1,2,10,7
20190322-W-Miami-R64-Bianca_Andreescu-Sofia_Kenin,1,B-XC,8,3,1,1,1,4,4
20190322-W-Miami-R64-Bianca_Andreescu-Sofia_Kenin,1,B-DTM,16,4,0,1,3,7,9
20190322-W-Miami-R64-Bianca_Andreescu-Sofia_Kenin,1,B-DTL,5,2,0,0,2,1,4
20190322-W-Miami-R64-Bianca_Andreescu-Sofia_Kenin,1,B-IO,6,3,0,0,3,3,3
20190322-W-Miami-R64-Bianca_Andreescu-Sofia_Kenin,1,S-XC,3,1,0,0,1,2,1
20190322-W-Miami-R64-Bianca_Andreescu-Sofia_Kenin,1,S-DTM,13,0,0,0,0,5,8
20190322-W-Miami-R64-Bianca_Andreescu-Sofia_Kenin,1,S-DTL,4,1,0,0,1,0,4
20190322-W-Miami-R64-Bianca_Andreescu-Sofia_Kenin,1,S-IO,4,0,0,0,0,2,2
20190322-W-Miami-R64-Bianca_Andreescu-Sofia_Kenin,2,F-XC,28,7,1,2,4,15,13
20190322-W-Miami-R64-Bianca_Andreescu-Sofia_Kenin,2,F-DTM,23,4,0,0,4,8,15
20190322-W-Miami-R64-Bianca_Andreescu-Sofia_Kenin,2,F-DTL,4,2,1,0,1,3,1
20190322-W-Miami-R64-Bianca_Andreescu-Sofia_Kenin,2,F-IO,5,1,0,0,1,4,1
20190322-W-Miami-R64-Bianca_Andreescu-Sofia_Kenin,2,F-II,1,1,1,0,0,1,0
20190322-W-Miami-R64-Bianca_Andreescu-Sofia_Kenin,2,B-XC,32,9,1,1,7,18,14
20190322-W-Miami-R64-Bianca_Andreescu-Sofia_Kenin,2,B-DTM,22,1,0,0,1,12,10
20190322-W-Miami-R64-Bianca_Andreescu-Sofia_Kenin,2,B-DTL,1,0,0,0,0,0,1
20190322-W-Miami-R64-Bianca_Andreescu-Sofia_Kenin,2,B-IO,7,6,2,1,3,3,4
20190322-W-Miami-R64-Bianca_Andreescu-Sofia_Kenin,2,S-XC,4,1,0,0,1,3,1
20190322-W-Miami-R64-Bianca_Andreescu-Sofia_Kenin,2,S-DTM,3,0,0,0,0,1,2
20190323-W-Miami-R32-Bianca_Andreescu-Angelique_Kerber,1,F-XC,41,10,4,3,3,26,15
20190323-W-Miami-R32-Bianca_Andreescu-Angelique_Kerber,1,F-DTM,36,8,0,2,6,20,16
20190323-W-Miami-R32-Bianca_Andreescu-Angelique_Kerber,1,F-DTL,17,10,7,1,2,12,5
20190323-W-Miami-R32-Bianca_Andreescu-Angelique_Kerber,1,F-IO,20,13,10,0,3,16,4
20190323-W-Miami-R32-Bianca_Andreescu-Angelique_Kerber,1,B-XC,36,9,4,1,4,17,19
20190323-W-Miami-R32-Bianca_Andreescu-Angelique_Kerber,1,B-DTM,43,4,0,1,3,24,19
20190323-W-Miami-R32-Bianca_Andreescu-Angelique_Kerber,1,B-DTL,14,6,2,2,2,10,4
20190323-W-Miami-R32-Bianca_Andreescu-Angelique_Kerber,1,B-IO,7,1,0,0,1,6,1
20190323-W-Miami-R32-Bianca_Andreescu-Angelique_Kerber,1,S-XC,5,0,0,0,0,2,3
20190323-W-Miami-R32-Bianca_Andreescu-Angelique_Kerber,1,S-DTM,24,2,0,1,1,9,15
20190323-W-Miami-R32-Bianca_Andreescu-Angelique_Kerber,1,S-DTL,8,2,0,1,1,4,4
20190323-W-Miami-R32-Bianca_Andreescu-Angelique_Kerber,1,S-IO,2,0,0,0,0,1,1
20190323-W-Miami-R32-Bianca_Andreescu-Angelique_Kerber,2,F-XC,86,11,2,4,5,49,37
20190323-W-Miami-R32-Bianca_Andreescu-Angelique_Kerber,2,F-DTM,25,4,0,1,3,9,16
20190323-W-Miami-R32-Bianca_Andreescu-Angelique_Kerber,2,F-DTL,8,4,2,1,1,4,4
20190323-W-Miami-R32-Bianca_Andreescu-Angelique_Kerber,2,F-IO,22,14,6,2,6,11,11
20190323-W-Miami-R32-Bianca_Andreescu-Angelique_Kerber,2,F-II,1,0,0,0,0,1,0
20190323-W-Miami-R32-Bianca_Andreescu-Angelique_Kerber,2,B-XC,53,13,2,2,9,20,33
20190323-W-Miami-R32-Bianca_Andreescu-Angelique_Kerber,2,B-DTM,44,2,0,0,2,17,27
20190323-W-Miami-R32-Bianca_Andreescu-Angelique_Kerber,2,B-DTL,5,2,1,0,1,2,3
20190323-W-Miami-R32-Bianca_Andreescu-Angelique_Kerber,2,B-IO,10,0,0,0,0,2,8
20190323-W-Miami-R32-Bianca_Andreescu-Angelique_Kerber,2,S-XC,4,1,0,1,0,1,3
20190323-W-Miami-R32-Bianca_Andreescu-Angelique_Kerber,2,S-DTM,5,0,0,0,0,3,2
20190323-W-Miami-R32-Bianca_Andreescu-Angelique_Kerber,2,S-DTL,6,2,0,1,1,3,3
20190323-W-Miami-R32-Bianca_Andreescu-Angelique_Kerber,2,S-IO,4,0,0,0,0,3,1
20190323-W-Miami-R32-Viktoria_Kuzmova-Kiki_Bertens,1,F-XC,44,9,3,0,6,18,26
20190323-W-Miami-R32-Viktoria_Kuzmova-Kiki_Bertens,1,F-DTM,14,0,0,0,0,5,9
20190323-W-Miami-R32-Viktoria_Kuzmova-Kiki_Bertens,1,F-DTL,8,4,3,0,1,5,3
20190323-W-Miami-R32-Viktoria_Kuzmova-Kiki_Bertens,1,F-IO,19,8,2,1,5,11,8
20190323-W-Miami-R32-Viktoria_Kuzmova-Kiki_Bertens,1,B-XC,24,3,1,1,1,7,17
20190323-W-Miami-R32-Viktoria_Kuzmova-Kiki_Bertens,1,B-DTM,18,4,0,0,4,4,14
20190323-W-Miami-R32-Viktoria_Kuzmova-Kiki_Bertens,1,B-DTL,4,1,0,0,1,1,3
20190323-W-Miami-R32-Viktoria_Kuzmova-Kiki_Bertens,1,B-IO,6,1,0,0,1,4,2
20190323-W-Miami-R32-Viktoria_Kuzmova-Kiki_Bertens,1,S-XC,1,0,0,0,0,1,0
20190323-W-Miami-R32-Viktoria_Kuzmova-Kiki_Bertens,1,S-DTM,2,1,0,0,1,1,1
20190323-W-Miami-R32-Viktoria_Kuzmova-Kiki_Bertens,1,S-IO,3,0,0,0,0,1,2
20190323-W-Miami-R32-Viktoria_Kuzmova-Kiki_Bertens,2,F-XC,26,6,2,2,2,13,13
20190323-W-Miami-R32-Viktoria_Kuzmova-Kiki_Bertens,2,F-DTM,28,0,0,0,0,15,13
20190323-W-Miami-R32-Viktoria_Kuzmova-Kiki_Bertens,2,F-DTL,9,5,2,1,2,6,3
20190323-W-Miami-R32-Viktoria_Kuzmova-Kiki_Bertens,2,F-IO,12,4,1,1,2,8,4
20190323-W-Miami-R32-Viktoria_Kuzmova-Kiki_Bertens,2,F-II,1,0,0,0,0,1,0
20190323-W-Miami-R32-Viktoria_Kuzmova-Kiki_Bertens,2,B-XC,10,4,1,2,1,8,2
20190323-W-Miami-R32-Viktoria_Kuzmova-Kiki_Bertens,2,B-DTM,25,4,0,0,4,13,12
20190323-W-Miami-R32-Viktoria_Kuzmova-Kiki_Bertens,2,B-DTL,4,1,0,0,1,2,2
20190323-W-Miami-R32-Viktoria_Kuzmova-Kiki_Bertens,2,B-IO,2,0,0,0,0,0,2
20190323-W-Miami-R32-Viktoria_Kuzmova-Kiki_Bertens,2,S-XC,3,0,0,0,0,3,0
20190323-W-Miami-R32-Viktoria_Kuzmova-Kiki_Bertens,2,S-DTM,12,2,0,0,2,7,5
20190323-W-Miami-R32-Su_Wei_Hsieh-Naomi_Osaka,1,F-XC,48,15,6,5,4,29,19
20190323-W-Miami-R32-Su_Wei_Hsieh-Naomi_Osaka,1,F-DTM,21,0,0,0,0,11,10
20190323-W-Miami-R32-Su_Wei_Hsieh-Naomi_Osaka,1,F-DTL,14,5,3,0,2,9,5
20190323-W-Miami-R32-Su_Wei_Hsieh-Naomi_Osaka,1,F-IO,17,6,2,4,0,14,3
20190323-W-Miami-R32-Su_Wei_Hsieh-Naomi_Osaka,1,B-XC,57,11,0,2,9,29,28
20190323-W-Miami-R32-Su_Wei_Hsieh-Naomi_Osaka,1,B-DTM,32,5,0,0,5,13,19
20190323-W-Miami-R32-Su_Wei_Hsieh-Naomi_Osaka,1,B-DTL,9,3,0,1,2,5,4
20190323-W-Miami-R32-Su_Wei_Hsieh-Naomi_Osaka,1,B-IO,11,5,0,2,3,4,7
20190323-W-Miami-R32-Su_Wei_Hsieh-Naomi_Osaka,1,S-XC,4,1,0,0,1,1,3
20190323-W-Miami-R32-Su_Wei_Hsieh-Naomi_Osaka,1,S-DTM,4,0,0,0,0,3,1
20190323-W-Miami-R32-Su_Wei_Hsieh-Naomi_Osaka,1,S-DTL,1,0,0,0,0,1,0
20190323-W-Miami-R32-Su_Wei_Hsieh-Naomi_Osaka,1,S-IO,2,0,0,0,0,2,0
20190323-W-Miami-R32-Su_Wei_Hsieh-Naomi_Osaka,2,F-XC,62,22,8,5,9,32,30
20190323-W-Miami-R32-Su_Wei_Hsieh-Naomi_Osaka,2,F-DTM,26,4,1,2,1,11,15
20190323-W-Miami-R32-Su_Wei_Hsieh-Naomi_Osaka,2,F-DTL,10,4,0,0,4,5,5
20190323-W-Miami-R32-Su_Wei_Hsieh-Naomi_Osaka,2,F-IO,15,8,2,2,4,7,8
20190323-W-Miami-R32-Su_Wei_Hsieh-Naomi_Osaka,2,B-XC,57,8,2,2,4,27,30
20190323-W-Miami-R32-Su_Wei_Hsieh-Naomi_Osaka,2,B-DTM,34,2,0,0,2,12,22
20190323-W-Miami-R32-Su_Wei_Hsieh-Naomi_Osaka,2,B-DTL,15,8,2,3,3,8,7
20190323-W-Miami-R32-Su_Wei_Hsieh-Naomi_Osaka,2,B-IO,11,5,1,1,3,4,7
20190323-W-Miami-R32-Su_Wei_Hsieh-Naomi_Osaka,2,S-XC,1,0,0,0,0,1,0
20190323-W-Miami-R32-Su_Wei_Hsieh-Naomi_Osaka,2,S-DTM,4,0,0,0,0,0,4
20190325-W-Miami-R16-Caroline_Wozniacki-Su_Wei_Hsieh,1,F-XC,85,9,2,0,7,32,53
20190325-W-Miami-R16-Caroline_Wozniacki-Su_Wei_Hsieh,1,F-DTM,33,2,0,0,2,10,23
20190325-W-Miami-R16-Caroline_Wozniacki-Su_Wei_Hsieh,1,F-DTL,33,4,0,1,3,11,22
20190325-W-Miami-R16-Caroline_Wozniacki-Su_Wei_Hsieh,1,F-IO,10,0,0,0,0,5,5
20190325-W-Miami-R16-Caroline_Wozniacki-Su_Wei_Hsieh,1,B-XC,76,11,3,3,5,33,43
20190325-W-Miami-R16-Caroline_Wozniacki-Su_Wei_Hsieh,1,B-DTM,27,0,0,0,0,9,18
20190325-W-Miami-R16-Caroline_Wozniacki-Su_Wei_Hsieh,1,B-DTL,25,7,0,3,4,8,17
20190325-W-Miami-R16-Caroline_Wozniacki-Su_Wei_Hsieh,1,B-IO,17,7,4,0,3,7,10
20190325-W-Miami-R16-Caroline_Wozniacki-Su_Wei_Hsieh,1,S-XC,4,1,0,0,1,1,3
20190325-W-Miami-R16-Caroline_Wozniacki-Su_Wei_Hsieh,1,S-DTM,4,0,0,0,0,0,4
20190325-W-Miami-R16-Caroline_Wozniacki-Su_Wei_Hsieh,1,S-DTL,2,0,0,0,0,1,1
20190325-W-Miami-R16-Caroline_Wozniacki-Su_Wei_Hsieh,1,S-IO,1,0,0,0,0,1,0
20190325-W-Miami-R16-Caroline_Wozniacki-Su_Wei_Hsieh,2,F-XC,105,16,9,3,4,71,34
20190325-W-Miami-R16-Caroline_Wozniacki-Su_Wei_Hsieh,2,F-DTM,16,0,0,0,0,10,6
20190325-W-Miami-R16-Caroline_Wozniacki-Su_Wei_Hsieh,2,F-DTL,25,10,6,1,3,20,5
20190325-W-Miami-R16-Caroline_Wozniacki-Su_Wei_Hsieh,2,F-IO,17,12,5,2,5,8,9
20190325-W-Miami-R16-Caroline_Wozniacki-Su_Wei_Hsieh,2,B-XC,101,17,1,8,8,61,40
20190325-W-Miami-R16-Caroline_Wozniacki-Su_Wei_Hsieh,2,B-DTM,23,2,0,0,2,13,10
20190325-W-Miami-R16-Caroline_Wozniacki-Su_Wei_Hsieh,2,B-DTL,26,6,3,0,3,15,11
20190325-W-Miami-R16-Caroline_Wozniacki-Su_Wei_Hsieh,2,B-IO,9,3,1,0,2,6,3
20190325-W-Miami-R16-Caroline_Wozniacki-Su_Wei_Hsieh,2,S-XC,3,0,0,0,0,2,1
20190325-W-Miami-R16-Caroline_Wozniacki-Su_Wei_Hsieh,2,S-DTM,3,0,0,0,0,2,1
20190321-W-Miami-R128-Nao_Hibino-Karolina_Muchova,1,F-XC,30,11,1,4,6,12,18
20190321-W-Miami-R128-Nao_Hibino-Karolina_Muchova,1,F-DTM,10,2,0,0,2,4,6
20190321-W-Miami-R128-Nao_Hibino-Karolina_Muchova,1,F-DTL,7,3,0,0,3,3,4
20190321-W-Miami-R128-Nao_Hibino-Karolina_Muchova,1,F-IO,12,3,1,0,2,4,8
20190321-W-Miami-R128-Nao_Hibino-Karolina_Muchova,1,B-XC,16,5,2,2,1,7,9
20190321-W-Miami-R128-Nao_Hibino-Karolina_Muchova,1,B-DTM,14,2,0,0,2,6,8
20190321-W-Miami-R128-Nao_Hibino-Karolina_Muchova,1,B-DTL,5,2,1,0,1,2,3
20190321-W-Miami-R128-Nao_Hibino-Karolina_Muchova,1,S-XC,2,1,0,0,1,0,2
20190321-W-Miami-R128-Nao_Hibino-Karolina_Muchova,1,S-DTM,3,0,0,0,0,2,1
20190321-W-Miami-R128-Nao_Hibino-Karolina_Muchova,2,F-XC,26,10,0,2,8,11,15
20190321-W-Miami-R128-Nao_Hibino-Karolina_Muchova,2,F-DTM,11,1,0,0,1,6,5
20190321-W-Miami-R128-Nao_Hibino-Karolina_Muchova,2,F-DTL,12,6,3,0,3,7,5
20190321-W-Miami-R128-Nao_Hibino-Karolina_Muchova,2,F-IO,6,3,2,1,0,4,2
20190321-W-Miami-R128-Nao_Hibino-Karolina_Muchova,2,B-XC,8,1,0,0,1,4,4
20190321-W-Miami-R128-Nao_Hibino-Karolina_Muchova,2,B-DTM,12,2,0,0,2,5,7
20190321-W-Miami-R128-Nao_Hibino-Karolina_Muchova,2,B-DTL,4,3,1,0,2,2,2
20190321-W-Miami-R128-Nao_Hibino-Karolina_Muchova,2,B-IO,2,1,0,0,1,0,2
20190321-W-Miami-R128-Nao_Hibino-Karolina_Muchova,2,S-XC,4,0,0,0,0,3,1
20190321-W-Miami-R128-Nao_Hibino-Karolina_Muchova,2,S-DTM,6,0,0,0,0,3,3
20190321-W-Miami-R128-Nao_Hibino-Karolina_Muchova,2,S-DTL,6,0,0,0,0,3,3
20190325-W-Miami-R16-Ashleigh_Barty-Kiki_Bertens,1,F-XC,46,10,4,1,5,22,24
20190325-W-Miami-R16-Ashleigh_Barty-Kiki_Bertens,1,F-DTM,27,0,0,0,0,18,9
20190325-W-Miami-R16-Ashleigh_Barty-Kiki_Bertens,1,F-DTL,8,4,3,1,0,4,4
20190325-W-Miami-R16-Ashleigh_Barty-Kiki_Bertens,1,F-IO,23,5,2,1,2,11,12
20190325-W-Miami-R16-Ashleigh_Barty-Kiki_Bertens,1,F-II,5,4,1,1,2,3,2
20190325-W-Miami-R16-Ashleigh_Barty-Kiki_Bertens,1,B-XC,22,4,0,1,3,12,10
20190325-W-Miami-R16-Ashleigh_Barty-Kiki_Bertens,1,B-DTM,27,1,0,0,1,14,13
20190325-W-Miami-R16-Ashleigh_Barty-Kiki_Bertens,1,B-DTL,4,2,0,1,1,2,2
20190325-W-Miami-R16-Ashleigh_Barty-Kiki_Bertens,1,B-IO,1,0,0,0,0,1,0
20190325-W-Miami-R16-Ashleigh_Barty-Kiki_Bertens,1,S-XC,40,6,1,1,4,21,19
20190325-W-Miami-R16-Ashleigh_Barty-Kiki_Bertens,1,S-DTM,24,1,0,0,1,11,13
20190325-W-Miami-R16-Ashleigh_Barty-Kiki_Bertens,1,S-DTL,5,0,0,0,0,2,3
20190325-W-Miami-R16-Ashleigh_Barty-Kiki_Bertens,1,S-IO,1,0,0,0,0,0,1
20190325-W-Miami-R16-Ashleigh_Barty-Kiki_Bertens,2,F-XC,32,8,3,2,3,20,12
20190325-W-Miami-R16-Ashleigh_Barty-Kiki_Bertens,2,F-DTM,29,1,0,0,1,17,12
20190325-W-Miami-R16-Ashleigh_Barty-Kiki_Bertens,2,F-DTL,19,8,1,3,4,8,11
20190325-W-Miami-R16-Ashleigh_Barty-Kiki_Bertens,2,F-IO,59,20,4,3,13,25,34
20190325-W-Miami-R16-Ashleigh_Barty-Kiki_Bertens,2,F-II,1,0,0,0,0,1,0
20190325-W-Miami-R16-Ashleigh_Barty-Kiki_Bertens,2,B-XC,35,6,0,0,6,18,17
20190325-W-Miami-R16-Ashleigh_Barty-Kiki_Bertens,2,B-DTM,26,4,0,1,3,8,18
20190325-W-Miami-R16-Ashleigh_Barty-Kiki_Bertens,2,B-DTL,4,2,0,2,0,2,2
20190325-W-Miami-R16-Ashleigh_Barty-Kiki_Bertens,2,B-IO,4,0,0,0,0,1,3
20190325-W-Miami-R16-Ashleigh_Barty-Kiki_Bertens,2,S-XC,13,4,0,3,1,6,7
20190325-W-Miami-R16-Ashleigh_Barty-Kiki_Bertens,2,S-DTM,9,0,0,0,0,3,6
20190325-W-Miami-R16-Ashleigh_Barty-Kiki_Bertens,2,S-DTL,6,3,1,1,1,4,2
20190325-W-Miami-R16-Ashleigh_Barty-Kiki_Bertens,2,S-IO,1,0,0,0,0,1,0
20190325-W-Miami-R16-Anett_Kontaveit-Bianca_Andreescu,1,F-XC,25,4,1,1,2,13,12
20190325-W-Miami-R16-Anett_Kontaveit-Bianca_Andreescu,1,F-DTM,16,2,0,0,2,10,6
20190325-W-Miami-R16-Anett_Kontaveit-Bianca_Andreescu,1,F-DTL,7,4,1,2,1,6,1
20190325-W-Miami-R16-Anett_Kontaveit-Bianca_Andreescu,1,F-IO,5,1,1,0,0,4,1
20190325-W-Miami-R16-Anett_Kontaveit-Bianca_Andreescu,1,B-XC,20,8,5,0,3,13,7
20190325-W-Miami-R16-Anett_Kontaveit-Bianca_Andreescu,1,B-DTM,15,1,0,0,1,6,9
20190325-W-Miami-R16-Anett_Kontaveit-Bianca_Andreescu,1,B-DTL,1,0,0,0,0,1,0
20190325-W-Miami-R16-Anett_Kontaveit-Bianca_Andreescu,1,B-IO,2,1,1,0,0,2,0
20190325-W-Miami-R16-Anett_Kontaveit-Bianca_Andreescu,1,S-DTM,4,0,0,0,0,1,3
20190325-W-Miami-R16-Anett_Kontaveit-Bianca_Andreescu,2,F-XC,14,6,3,0,3,5,9
20190325-W-Miami-R16-Anett_Kontaveit-Bianca_Andreescu,2,F-DTM,21,2,0,0,2,6,15
20190325-W-Miami-R16-Anett_Kontaveit-Bianca_Andreescu,2,F-DTL,3,1,0,0,1,2,1
20190325-W-Miami-R16-Anett_Kontaveit-Bianca_Andreescu,2,F-IO,8,3,1,0,2,3,5
20190325-W-Miami-R16-Anett_Kontaveit-Bianca_Andreescu,2,B-XC,10,4,0,2,2,6,4
20190325-W-Miami-R16-Anett_Kontaveit-Bianca_Andreescu,2,B-DTM,8,1,0,0,1,2,6
20190325-W-Miami-R16-Anett_Kontaveit-Bianca_Andreescu,2,B-DTL,3,0,0,0,0,2,1
20190325-W-Miami-R16-Anett_Kontaveit-Bianca_Andreescu,2,B-IO,3,1,1,0,0,2,1
20190325-W-Miami-R16-Anett_Kontaveit-Bianca_Andreescu,2,S-DTM,7,1,0,0,1,2,5
20190325-W-Miami-R16-Anett_Kontaveit-Bianca_Andreescu,2,S-DTL,1,0,0,0,0,0,1
20190325-W-Miami-R16-Anett_Kontaveit-Bianca_Andreescu,2,S-IO,3,0,0,0,0,2,1
20190328-W-Miami-SF-Anett_Kontaveit-Ashleigh_Barty,1,F-XC,44,12,4,2,6,24,20
20190328-W-Miami-SF-Anett_Kontaveit-Ashleigh_Barty,1,F-DTM,5,2,0,0,2,2,3
20190328-W-Miami-SF-Anett_Kontaveit-Ashleigh_Barty,1,F-DTL,14,6,1,2,3,7,7
20190328-W-Miami-SF-Anett_Kontaveit-Ashleigh_Barty,1,F-IO,10,6,1,0,5,3,7
20190328-W-Miami-SF-Anett_Kontaveit-Ashleigh_Barty,1,F-II,3,2,0,0,2,1,2
20190328-W-Miami-SF-Anett_Kontaveit-Ashleigh_Barty,1,B-XC,40,11,1,2,8,22,18
20190328-W-Miami-SF-Anett_Kontaveit-Ashleigh_Barty,1,B-DTM,11,0,0,0,0,4,7
20190328-W-Miami-SF-Anett_Kontaveit-Ashleigh_Barty,1,B-DTL,6,5,1,1,3,2,4
20190328-W-Miami-SF-Anett_Kontaveit-Ashleigh_Barty,1,B-IO,1,0,0,0,0,1,0
20190328-W-Miami-SF-Anett_Kontaveit-Ashleigh_Barty,1,S-XC,4,0,0,0,0,4,0
20190328-W-Miami-SF-Anett_Kontaveit-Ashleigh_Barty,1,S-DTM,4,0,0,0,0,1,3
20190328-W-Miami-SF-Anett_Kontaveit-Ashleigh_Barty,1,S-DTL,2,0,0,0,0,1,1
20190328-W-Miami-SF-Anett_Kontaveit-Ashleigh_Barty,2,F-XC,42,12,2,1,9,18,24
20190328-W-Miami-SF-Anett_Kontaveit-Ashleigh_Barty,2,F-DTM,7,0,0,0,0,7,0
20190328-W-Miami-SF-Anett_Kontaveit-Ashleigh_Barty,2,F-DTL,12,2,1,0,1,6,6
20190328-W-Miami-SF-Anett_Kontaveit-Ashleigh_Barty,2,F-IO,10,7,3,2,2,7,3
20190328-W-Miami-SF-Anett_Kontaveit-Ashleigh_Barty,2,F-II,1,0,0,0,0,1,0
20190328-W-Miami-SF-Anett_Kontaveit-Ashleigh_Barty,2,B-XC,8,1,0,0,1,2,6
20190328-W-Miami-SF-Anett_Kontaveit-Ashleigh_Barty,2,B-DTM,11,2,0,0,2,4,7
20190328-W-Miami-SF-Anett_Kontaveit-Ashleigh_Barty,2,B-DTL,2,1,0,0,1,0,2
20190328-W-Miami-SF-Anett_Kontaveit-Ashleigh_Barty,2,B-IO,1,0,0,0,0,0,1
20190328-W-Miami-SF-Anett_Kontaveit-Ashleigh_Barty,2,S-XC,21,1,0,1,0,10,11
20190328-W-Miami-SF-Anett_Kontaveit-Ashleigh_Barty,2,S-DTM,19,1,0,1,0,9,10
20190328-W-Miami-SF-Anett_Kontaveit-Ashleigh_Barty,2,S-DTL,5,1,0,0,1,1,4
20190328-W-Miami-SF-Anett_Kontaveit-Ashleigh_Barty,2,S-IO,1,0,0,0,0,0,1
20190321-W-Miami-R128-Misaki_Doi-Xin_Yu_Wang,1,F-XC,46,10,1,1,8,24,22
20190321-W-Miami-R128-Misaki_Doi-Xin_Yu_Wang,1,F-DTM,38,4,0,0,4,15,23
20190321-W-Miami-R128-Misaki_Doi-Xin_Yu_Wang,1,F-DTL,12,8,3,1,4,6,6
20190321-W-Miami-R128-Misaki_Doi-Xin_Yu_Wang,1,F-IO,16,7,3,1,3,9,7
20190321-W-Miami-R128-Misaki_Doi-Xin_Yu_Wang,1,F-II,1,1,1,0,0,1,0
20190321-W-Miami-R128-Misaki_Doi-Xin_Yu_Wang,1,B-XC,11,2,0,1,1,5,6
20190321-W-Miami-R128-Misaki_Doi-Xin_Yu_Wang,1,B-DTM,15,0,0,0,0,6,9
20190321-W-Miami-R128-Misaki_Doi-Xin_Yu_Wang,1,B-DTL,2,0,0,0,0,2,0
20190321-W-Miami-R128-Misaki_Doi-Xin_Yu_Wang,1,B-IO,1,0,0,0,0,0,1
20190321-W-Miami-R128-Misaki_Doi-Xin_Yu_Wang,1,S-DTM,7,0,0,0,0,2,5
20190321-W-Miami-R128-Misaki_Doi-Xin_Yu_Wang,1,S-DTL,1,1,0,1,0,1,0
20190321-W-Miami-R128-Misaki_Doi-Xin_Yu_Wang,2,F-XC,23,8,5,1,2,11,12
20190321-W-Miami-R128-Misaki_Doi-Xin_Yu_Wang,2,F-DTM,26,3,0,0,3,15,11
20190321-W-Miami-R128-Misaki_Doi-Xin_Yu_Wang,2,F-DTL,15,6,3,1,2,8,7
20190321-W-Miami-R128-Misaki_Doi-Xin_Yu_Wang,2,F-IO,24,12,6,1,5,14,10
20190321-W-Miami-R128-Misaki_Doi-Xin_Yu_Wang,2,B-XC,37,11,3,1,7,18,19
20190321-W-Miami-R128-Misaki_Doi-Xin_Yu_Wang,2,B-DTM,32,6,0,0,6,13,19
20190321-W-Miami-R128-Misaki_Doi-Xin_Yu_Wang,2,B-DTL,1,1,0,0,1,0,1
20190321-W-Miami-R128-Misaki_Doi-Xin_Yu_Wang,2,B-IO,2,1,0,0,1,1,1
20190322-W-Miami-R64-Daria_Kasatkina-Cori_Gauff,1,F-XC,43,5,0,1,4,23,20
20190322-W-Miami-R64-Daria_Kasatkina-Cori_Gauff,1,F-DTM,24,2,0,1,1,12,12
20190322-W-Miami-R64-Daria_Kasatkina-Cori_Gauff,1,F-DTL,11,3,0,1,2,8,3
20190322-W-Miami-R64-Daria_Kasatkina-Cori_Gauff,1,F-IO,11,6,1,3,2,6,5
20190322-W-Miami-R64-Daria_Kasatkina-Cori_Gauff,1,B-XC,15,3,0,1,2,7,8
20190322-W-Miami-R64-Daria_Kasatkina-Cori_Gauff,1,B-DTM,18,0,0,0,0,7,11
20190322-W-Miami-R64-Daria_Kasatkina-Cori_Gauff,1,B-DTL,6,3,3,0,0,4,2
20190322-W-Miami-R64-Daria_Kasatkina-Cori_Gauff,1,B-IO,5,0,0,0,0,3,2
20190322-W-Miami-R64-Daria_Kasatkina-Cori_Gauff,1,S-XC,1,0,0,0,0,1,0
20190322-W-Miami-R64-Daria_Kasatkina-Cori_Gauff,1,S-DTM,5,0,0,0,0,1,4
20190322-W-Miami-R64-Daria_Kasatkina-Cori_Gauff,2,F-XC,39,7,4,0,3,20,19
20190322-W-Miami-R64-Daria_Kasatkina-Cori_Gauff,2,F-DTM,36,3,0,0,3,16,20
20190322-W-Miami-R64-Daria_Kasatkina-Cori_Gauff,2,F-DTL,4,1,0,1,0,3,1
20190322-W-Miami-R64-Daria_Kasatkina-Cori_Gauff,2,F-IO,8,4,1,0,3,5,3
20190322-W-Miami-R64-Daria_Kasatkina-Cori_Gauff,2,B-XC,13,3,0,1,2,6,7
20190322-W-Miami-R64-Daria_Kasatkina-Cori_Gauff,2,B-DTM,17,1,0,0,1,7,10
20190322-W-Miami-R64-Daria_Kasatkina-Cori_Gauff,2,B-DTL,7,3,1,0,2,2,5
20190322-W-Miami-R64-Daria_Kasatkina-Cori_Gauff,2,B-IO,5,4,2,0,2,3,2
20190322-W-Miami-R64-Daria_Kasatkina-Cori_Gauff,2,S-DTM,6,2,0,0,2,1,5
20190322-W-Miami-R64-Daria_Kasatkina-Cori_Gauff,2,S-DTL,2,0,0,0,0,2,0
20190322-W-Miami-R64-Daria_Kasatkina-Cori_Gauff,2,S-IO,1,0,0,0,0,0,1
20190327-W-Miami-QF-Karolina_Pliskova-Marketa_Vondrousova,1,F-XC,34,11,4,3,4,24,10
20190327-W-Miami-QF-Karolina_Pliskova-Marketa_Vondrousova,1,F-DTM,13,1,1,0,0,7,6
20190327-W-Miami-QF-Karolina_Pliskova-Marketa_Vondrousova,1,F-DTL,6,2,1,0,1,3,3
20190327-W-Miami-QF-Karolina_Pliskova-Marketa_Vondrousova,1,F-IO,28,9,1,1,7,13,15
20190327-W-Miami-QF-Karolina_Pliskova-Marketa_Vondrousova,1,B-XC,30,3,0,1,2,13,17
20190327-W-Miami-QF-Karolina_Pliskova-Marketa_Vondrousova,1,B-DTM,22,1,0,0,1,8,14
20190327-W-Miami-QF-Karolina_Pliskova-Marketa_Vondrousova,1,B-DTL,13,3,1,2,0,7,6
20190327-W-Miami-QF-Karolina_Pliskova-Marketa_Vondrousova,1,B-IO,6,2,0,1,1,3,3
20190327-W-Miami-QF-Karolina_Pliskova-Marketa_Vondrousova,1,S-XC,6,1,0,0,1,3,3
20190327-W-Miami-QF-Karolina_Pliskova-Marketa_Vondrousova,1,S-DTM,2,0,0,0,0,1,1
20190327-W-Miami-QF-Karolina_Pliskova-Marketa_Vondrousova,1,S-DTL,2,0,0,0,0,1,1
20190327-W-Miami-QF-Karolina_Pliskova-Marketa_Vondrousova,2,F-XC,57,10,2,1,7,33,24
20190327-W-Miami-QF-Karolina_Pliskova-Marketa_Vondrousova,2,F-DTM,22,4,1,0,3,9,13
20190327-W-Miami-QF-Karolina_Pliskova-Marketa_Vondrousova,2,F-DTL,10,6,2,1,3,5,5
20190327-W-Miami-QF-Karolina_Pliskova-Marketa_Vondrousova,2,F-IO,4,3,2,0,1,3,1
20190327-W-Miami-QF-Karolina_Pliskova-Marketa_Vondrousova,2,B-XC,18,4,0,1,3,6,12
20190327-W-Miami-QF-Karolina_Pliskova-Marketa_Vondrousova,2,B-DTM,32,4,0,0,4,14,18
20190327-W-Miami-QF-Karolina_Pliskova-Marketa_Vondrousova,2,B-DTL,6,1,1,0,0,1,5
20190327-W-Miami-QF-Karolina_Pliskova-Marketa_Vondrousova,2,S-DTM,3,0,0,0,0,1,2
20190327-W-Miami-QF-Karolina_Pliskova-Marketa_Vondrousova,2,S-DTL,4,0,0,0,0,2,2
20190320-W-Miami-R128-Xiyu_Wang-Monica_Puig,1,F-XC,33,8,2,1,5,25,8
20190320-W-Miami-R128-Xiyu_Wang-Monica_Puig,1,F-DTM,19,0,0,0,0,11,8
20190320-W-Miami-R128-Xiyu_Wang-Monica_Puig,1,F-DTL,5,4,2,2,0,4,1
20190320-W-Miami-R128-Xiyu_Wang-Monica_Puig,1,F-IO,6,6,3,1,2,4,2
20190320-W-Miami-R128-Xiyu_Wang-Monica_Puig,1,B-XC,23,9,5,1,3,18,5
20190320-W-Miami-R128-Xiyu_Wang-Monica_Puig,1,B-DTM,11,1,0,0,1,7,4
20190320-W-Miami-R128-Xiyu_Wang-Monica_Puig,1,S-DTM,1,0,0,0,0,0,1
20190320-W-Miami-R128-Xiyu_Wang-Monica_Puig,2,F-XC,16,10,3,2,5,8,8
20190320-W-Miami-R128-Xiyu_Wang-Monica_Puig,2,F-DTM,22,3,1,0,2,9,13
20190320-W-Miami-R128-Xiyu_Wang-Monica_Puig,2,F-DTL,9,5,2,0,3,2,7
20190320-W-Miami-R128-Xiyu_Wang-Monica_Puig,2,F-IO,4,2,0,0,2,2,2
20190320-W-Miami-R128-Xiyu_Wang-Monica_Puig,2,B-XC,29,9,2,1,6,5,24
20190320-W-Miami-R128-Xiyu_Wang-Monica_Puig,2,B-DTM,18,1,1,0,0,4,14
20190320-W-Miami-R128-Xiyu_Wang-Monica_Puig,2,B-DTL,3,2,1,0,1,1,2
20190320-W-Miami-R128-Xiyu_Wang-Monica_Puig,2,B-IO,3,2,0,1,1,2,1
20190322-W-Miami-R128-Bianca_Andreescu-Irina_Camelia_Begu,1,F-XC,54,19,6,5,8,32,22
20190322-W-Miami-R128-Bianca_Andreescu-Irina_Camelia_Begu,1,F-DTM,62,6,1,0,5,27,35
20190322-W-Miami-R128-Bianca_Andreescu-Irina_Camelia_Begu,1,F-DTL,13,4,1,2,1,8,5
20190322-W-Miami-R128-Bianca_Andreescu-Irina_Camelia_Begu,1,F-IO,31,15,5,4,6,18,13
20190322-W-Miami-R128-Bianca_Andreescu-Irina_Camelia_Begu,1,F-II,2,1,0,0,1,1,1
20190322-W-Miami-R128-Bianca_Andreescu-Irina_Camelia_Begu,1,B-XC,25,8,4,2,2,20,5
20190322-W-Miami-R128-Bianca_Andreescu-Irina_Camelia_Begu,1,B-DTM,31,3,0,0,3,16,15
20190322-W-Miami-R128-Bianca_Andreescu-Irina_Camelia_Begu,1,B-DTL,8,5,1,0,4,3,5
20190322-W-Miami-R128-Bianca_Andreescu-Irina_Camelia_Begu,1,B-IO,6,1,0,0,1,3,3
20190322-W-Miami-R128-Bianca_Andreescu-Irina_Camelia_Begu,1,S-XC,1,0,0,0,0,1,0
20190322-W-Miami-R128-Bianca_Andreescu-Irina_Camelia_Begu,1,S-DTM,15,0,0,0,0,5,10
20190322-W-Miami-R128-Bianca_Andreescu-Irina_Camelia_Begu,1,S-DTL,1,1,0,0,1,0,1
20190322-W-Miami-R128-Bianca_Andreescu-Irina_Camelia_Begu,1,S-IO,1,1,0,0,1,0,1
20190322-W-Miami-R128-Bianca_Andreescu-Irina_Camelia_Begu,2,F-XC,58,13,2,3,8,30,28
20190322-W-Miami-R128-Bianca_Andreescu-Irina_Camelia_Begu,2,F-DTM,57,4,1,0,3,32,25
20190322-W-Miami-R128-Bianca_Andreescu-Irina_Camelia_Begu,2,F-DTL,8,4,1,1,2,5,3
20190322-W-Miami-R128-Bianca_Andreescu-Irina_Camelia_Begu,2,F-IO,34,11,5,1,5,18,16
20190322-W-Miami-R128-Bianca_Andreescu-Irina_Camelia_Begu,2,B-XC,37,9,3,1,5,14,23
20190322-W-Miami-R128-Bianca_Andreescu-Irina_Camelia_Begu,2,B-DTM,45,5,0,0,5,12,33
20190322-W-Miami-R128-Bianca_Andreescu-Irina_Camelia_Begu,2,B-DTL,9,5,1,3,1,5,4
20190322-W-Miami-R128-Bianca_Andreescu-Irina_Camelia_Begu,2,B-IO,16,6,1,0,5,8,8
20190322-W-Miami-R128-Bianca_Andreescu-Irina_Camelia_Begu,2,S-XC,5,0,0,0,0,2,3
20190322-W-Miami-R128-Bianca_Andreescu-Irina_Camelia_Begu,2,S-DTM,2,0,0,0,0,1,1
20190322-W-Miami-R128-Bianca_Andreescu-Irina_Camelia_Begu,2,S-DTL,1,0,0,0,0,0,1
20190322-W-Miami-R128-Bianca_Andreescu-Irina_Camelia_Begu,2,S-IO,1,1,0,0,1,0,1
20190402-W-Charleston-R32-Martina_Trevisan-Kiki_Bertens,1,F-XC,50,7,1,0,6,20,30
20190402-W-Charleston-R32-Martina_Trevisan-Kiki_Bertens,1,F-DTM,12,0,0,0,0,4,8
20190402-W-Charleston-R32-Martina_Trevisan-Kiki_Bertens,1,F-DTL,5,3,1,1,1,4,1
20190402-W-Charleston-R32-Martina_Trevisan-Kiki_Bertens,1,F-IO,22,7,1,0,6,10,12
20190402-W-Charleston-R32-Martina_Trevisan-Kiki_Bertens,1,B-XC,20,1,0,0,1,7,13
20190402-W-Charleston-R32-Martina_Trevisan-Kiki_Bertens,1,B-DTM,28,3,0,0,3,9,19
20190402-W-Charleston-R32-Martina_Trevisan-Kiki_Bertens,1,B-DTL,7,1,0,0,1,2,5
20190402-W-Charleston-R32-Martina_Trevisan-Kiki_Bertens,1,B-IO,6,0,0,0,0,4,2
20190402-W-Charleston-R32-Martina_Trevisan-Kiki_Bertens,1,S-XC,3,0,0,0,0,1,2
20190402-W-Charleston-R32-Martina_Trevisan-Kiki_Bertens,1,S-DTM,3,1,0,0,1,0,3
20190402-W-Charleston-R32-Martina_Trevisan-Kiki_Bertens,1,S-DTL,3,1,0,1,0,2,1
20190402-W-Charleston-R32-Martina_Trevisan-Kiki_Bertens,2,F-XC,33,4,0,2,2,23,10
20190402-W-Charleston-R32-Martina_Trevisan-Kiki_Bertens,2,F-DTM,18,1,0,0,1,10,8
20190402-W-Charleston-R32-Martina_Trevisan-Kiki_Bertens,2,F-DTL,6,4,3,0,1,4,2
20190402-W-Charleston-R32-Martina_Trevisan-Kiki_Bertens,2,F-IO,9,6,1,5,0,8,1
20190402-W-Charleston-R32-Martina_Trevisan-Kiki_Bertens,2,F-II,1,0,0,0,0,1,0
20190402-W-Charleston-R32-Martina_Trevisan-Kiki_Bertens,2,B-XC,15,3,0,0,3,7,8
20190402-W-Charleston-R32-Martina_Trevisan-Kiki_Bertens,2,B-DTM,32,0,0,0,0,17,15
20190402-W-Charleston-R32-Martina_Trevisan-Kiki_Bertens,2,B-DTL,8,1,1,0,0,5,3
20190402-W-Charleston-R32-Martina_Trevisan-Kiki_Bertens,2,B-IO,6,2,0,0,2,3,3
20190402-W-Charleston-R32-Martina_Trevisan-Kiki_Bertens,2,S-XC,6,0,0,0,0,2,4
20190402-W-Charleston-R32-Martina_Trevisan-Kiki_Bertens,2,S-DTM,5,0,0,0,0,4,1
20190402-W-Charleston-R32-Martina_Trevisan-Kiki_Bertens,2,S-DTL,2,1,0,0,1,1,1
20190402-W-Charleston-R32-Martina_Trevisan-Kiki_Bertens,2,S-IO,1,0,0,0,0,1,0
20190403-W-Charleston-R32-Caroline_Wozniacki-Laura_Siegemund,1,F-XC,48,5,0,2,3,27,21
20190403-W-Charleston-R32-Caroline_Wozniacki-Laura_Siegemund,1,F-DTM,22,1,0,0,1,10,12
20190403-W-Charleston-R32-Caroline_Wozniacki-Laura_Siegemund,1,F-DTL,10,3,0,0,3,4,6
20190403-W-Charleston-R32-Caroline_Wozniacki-Laura_Siegemund,1,F-IO,13,1,1,0,0,7,6
20190403-W-Charleston-R32-Caroline_Wozniacki-Laura_Siegemund,1,F-II,3,1,0,1,0,2,1
20190403-W-Charleston-R32-Caroline_Wozniacki-Laura_Siegemund,1,B-XC,33,2,1,0,1,25,8
20190403-W-Charleston-R32-Caroline_Wozniacki-Laura_Siegemund,1,B-DTM,19,0,0,0,0,8,11
20190403-W-Charleston-R32-Caroline_Wozniacki-Laura_Siegemund,1,B-DTL,5,3,2,0,1,4,1
20190403-W-Charleston-R32-Caroline_Wozniacki-Laura_Siegemund,1,B-IO,6,5,3,2,0,6,0
20190403-W-Charleston-R32-Caroline_Wozniacki-Laura_Siegemund,1,S-XC,2,0,0,0,0,0,2
20190403-W-Charleston-R32-Caroline_Wozniacki-Laura_Siegemund,1,S-DTM,4,0,0,0,0,1,3
20190403-W-Charleston-R32-Caroline_Wozniacki-Laura_Siegemund,2,F-XC,21,7,3,0,4,13,8
20190403-W-Charleston-R32-Caroline_Wozniacki-Laura_Siegemund,2,F-DTM,13,1,1,0,0,4,9
20190403-W-Charleston-R32-Caroline_Wozniacki-Laura_Siegemund,2,F-DTL,11,7,3,0,4,6,5
20190403-W-Charleston-R32-Caroline_Wozniacki-Laura_Siegemund,2,F-IO,13,1,0,0,1,8,5
20190403-W-Charleston-R32-Caroline_Wozniacki-Laura_Siegemund,2,B-XC,25,4,1,0,3,7,18
20190403-W-Charleston-R32-Caroline_Wozniacki-Laura_Siegemund,2,B-DTM,30,4,0,1,3,8,22
20190403-W-Charleston-R32-Caroline_Wozniacki-Laura_Siegemund,2,B-DTL,12,4,0,2,2,7,5
20190403-W-Charleston-R32-Caroline_Wozniacki-Laura_Siegemund,2,B-IO,13,4,3,0,1,6,7
20190403-W-Charleston-R32-Caroline_Wozniacki-Laura_Siegemund,2,S-XC,10,1,0,0,1,4,6
20190403-W-Charleston-R32-Caroline_Wozniacki-Laura_Siegemund,2,S-DTM,7,1,0,0,1,4,3
20190226-W-Acapulco-R32-Jil_Teichmann-Bianca_Andreescu,1,F-XC,21,6,1,1,4,10,11
20190226-W-Acapulco-R32-Jil_Teichmann-Bianca_Andreescu,1,F-DTM,37,6,0,0,6,18,19
20190226-W-Acapulco-R32-Jil_Teichmann-Bianca_Andreescu,1,F-DTL,2,1,0,0,1,0,2
20190226-W-Acapulco-R32-Jil_Teichmann-Bianca_Andreescu,1,F-IO,11,5,2,0,3,5,6
20190226-W-Acapulco-R32-Jil_Teichmann-Bianca_Andreescu,1,B-XC,18,4,0,1,3,10,8
20190226-W-Acapulco-R32-Jil_Teichmann-Bianca_Andreescu,1,B-DTM,26,2,0,1,1,17,9
20190226-W-Acapulco-R32-Jil_Teichmann-Bianca_Andreescu,1,B-DTL,2,1,0,0,1,1,1
20190226-W-Acapulco-R32-Jil_Teichmann-Bianca_Andreescu,1,B-IO,2,2,1,0,1,1,1
20190226-W-Acapulco-R32-Jil_Teichmann-Bianca_Andreescu,1,S-XC,4,0,0,0,0,4,0
20190226-W-Acapulco-R32-Jil_Teichmann-Bianca_Andreescu,1,S-DTM,7,1,0,0,1,2,5
20190226-W-Acapulco-R32-Jil_Teichmann-Bianca_Andreescu,1,S-IO,1,0,0,0,0,0,1
20190226-W-Acapulco-R32-Jil_Teichmann-Bianca_Andreescu,2,F-XC,29,9,5,0,4,13,16
20190226-W-Acapulco-R32-Jil_Teichmann-Bianca_Andreescu,2,F-DTM,25,4,0,1,3,11,14
20190226-W-Acapulco-R32-Jil_Teichmann-Bianca_Andreescu,2,F-DTL,5,3,1,0,2,2,3
20190226-W-Acapulco-R32-Jil_Teichmann-Bianca_Andreescu,2,F-IO,19,10,1,5,4,9,10
20190226-W-Acapulco-R32-Jil_Teichmann-Bianca_Andreescu,2,B-XC,6,4,1,1,2,4,2
20190226-W-Acapulco-R32-Jil_Teichmann-Bianca_Andreescu,2,B-DTM,15,0,0,0,0,5,10
20190226-W-Acapulco-R32-Jil_Teichmann-Bianca_Andreescu,2,B-DTL,3,2,0,1,1,2,1
20190226-W-Acapulco-R32-Jil_Teichmann-Bianca_Andreescu,2,B-IO,1,1,0,0,1,0,1
20190226-W-Acapulco-R32-Jil_Teichmann-Bianca_Andreescu,2,S-DTM,11,2,0,1,1,5,6
20190226-W-Acapulco-R32-Jil_Teichmann-Bianca_Andreescu,2,S-IO,5,3,0,0,3,1,4
20190309-W-Indian_Wells-R64-Caroline_Wozniacki-Ekaterina_Alexandrova,1,F-XC,84,12,0,4,8,38,46
20190309-W-Indian_Wells-R64-Caroline_Wozniacki-Ekaterina_Alexandrova,1,F-DTM,33,1,0,0,1,22,11
20190309-W-Indian_Wells-R64-Caroline_Wozniacki-Ekaterina_Alexandrova,1,F-DTL,28,4,1,1,2,16,12
20190309-W-Indian_Wells-R64-Caroline_Wozniacki-Ekaterina_Alexandrova,1,F-IO,16,2,0,2,0,11,5
20190309-W-Indian_Wells-R64-Caroline_Wozniacki-Ekaterina_Alexandrova,1,B-XC,76,8,0,4,4,40,36
20190309-W-Indian_Wells-R64-Caroline_Wozniacki-Ekaterina_Alexandrova,1,B-DTM,52,3,1,0,2,26,26
20190309-W-Indian_Wells-R64-Caroline_Wozniacki-Ekaterina_Alexandrova,1,B-DTL,21,8,4,3,1,15,6
20190309-W-Indian_Wells-R64-Caroline_Wozniacki-Ekaterina_Alexandrova,1,B-IO,16,4,1,0,3,8,8
20190309-W-Indian_Wells-R64-Caroline_Wozniacki-Ekaterina_Alexandrova,1,B-II,1,1,0,1,0,1,0
20190309-W-Indian_Wells-R64-Caroline_Wozniacki-Ekaterina_Alexandrova,1,S-XC,4,0,0,0,0,2,2
20190309-W-Indian_Wells-R64-Caroline_Wozniacki-Ekaterina_Alexandrova,1,S-DTM,4,0,0,0,0,1,3
20190309-W-Indian_Wells-R64-Caroline_Wozniacki-Ekaterina_Alexandrova,1,S-DTL,6,1,0,0,1,5,1
20190309-W-Indian_Wells-R64-Caroline_Wozniacki-Ekaterina_Alexandrova,2,F-XC,91,22,8,5,9,41,50
20190309-W-Indian_Wells-R64-Caroline_Wozniacki-Ekaterina_Alexandrova,2,F-DTM,36,4,1,0,3,14,22
20190309-W-Indian_Wells-R64-Caroline_Wozniacki-Ekaterina_Alexandrova,2,F-DTL,36,16,5,3,8,18,18
20190309-W-Indian_Wells-R64-Caroline_Wozniacki-Ekaterina_Alexandrova,2,F-IO,33,11,3,3,5,15,18
20190309-W-Indian_Wells-R64-Caroline_Wozniacki-Ekaterina_Alexandrova,2,B-XC,88,14,3,2,9,39,49
20190309-W-Indian_Wells-R64-Caroline_Wozniacki-Ekaterina_Alexandrova,2,B-DTM,59,4,0,0,4,31,28
20190309-W-Indian_Wells-R64-Caroline_Wozniacki-Ekaterina_Alexandrova,2,B-DTL,25,12,5,1,6,14,11
20190309-W-Indian_Wells-R64-Caroline_Wozniacki-Ekaterina_Alexandrova,2,B-IO,13,4,2,0,2,6,7
20190309-W-Indian_Wells-R64-Caroline_Wozniacki-Ekaterina_Alexandrova,2,S-XC,5,0,0,0,0,2,3
20190309-W-Indian_Wells-R64-Caroline_Wozniacki-Ekaterina_Alexandrova,2,S-DTM,3,0,0,0,0,0,3
20190308-W-Indian_Wells-R64-Aliaksandra_Sasnovich-Kateryna_Kozlova,1,F-XC,41,15,4,3,8,20,21
20190308-W-Indian_Wells-R64-Aliaksandra_Sasnovich-Kateryna_Kozlova,1,F-DTM,23,3,0,0,3,10,13
20190308-W-Indian_Wells-R64-Aliaksandra_Sasnovich-Kateryna_Kozlova,1,F-DTL,17,6,1,4,1,9,8
20190308-W-Indian_Wells-R64-Aliaksandra_Sasnovich-Kateryna_Kozlova,1,F-IO,20,5,1,0,4,6,14
20190308-W-Indian_Wells-R64-Aliaksandra_Sasnovich-Kateryna_Kozlova,1,B-XC,44,11,3,2,6,23,21
20190308-W-Indian_Wells-R64-Aliaksandra_Sasnovich-Kateryna_Kozlova,1,B-DTM,30,8,1,1,6,13,17
20190308-W-Indian_Wells-R64-Aliaksandra_Sasnovich-Kateryna_Kozlova,1,B-DTL,9,3,0,0,3,3,6
20190308-W-Indian_Wells-R64-Aliaksandra_Sasnovich-Kateryna_Kozlova,1,B-IO,7,1,0,0,1,4,3
20190308-W-Indian_Wells-R64-Aliaksandra_Sasnovich-Kateryna_Kozlova,1,S-XC,6,1,0,0,1,2,4
20190308-W-Indian_Wells-R64-Aliaksandra_Sasnovich-Kateryna_Kozlova,1,S-DTM,7,0,0,0,0,3,4
20190308-W-Indian_Wells-R64-Aliaksandra_Sasnovich-Kateryna_Kozlova,2,F-XC,23,3,0,1,2,10,13
20190308-W-Indian_Wells-R64-Aliaksandra_Sasnovich-Kateryna_Kozlova,2,F-DTM,28,5,1,0,3,18,10
20190308-W-Indian_Wells-R64-Aliaksandra_Sasnovich-Kateryna_Kozlova,2,F-DTL,8,1,1,0,0,3,5
20190308-W-Indian_Wells-R64-Aliaksandra_Sasnovich-Kateryna_Kozlova,2,F-IO,14,8,4,0,4,8,6
20190308-W-Indian_Wells-R64-Aliaksandra_Sasnovich-Kateryna_Kozlova,2,B-XC,34,11,2,3,6,18,16
20190308-W-Indian_Wells-R64-Aliaksandra_Sasnovich-Kateryna_Kozlova,2,B-DTM,48,6,0,0,6,22,26
20190308-W-Indian_Wells-R64-Aliaksandra_Sasnovich-Kateryna_Kozlova,2,B-DTL,9,1,0,1,0,5,4
20190308-W-Indian_Wells-R64-Aliaksandra_Sasnovich-Kateryna_Kozlova,2,B-IO,7,2,0,1,1,5,2
20190308-W-Indian_Wells-R64-Aliaksandra_Sasnovich-Kateryna_Kozlova,2,S-XC,6,0,0,0,0,2,4
20190308-W-Indian_Wells-R64-Aliaksandra_Sasnovich-Kateryna_Kozlova,2,S-DTM,8,0,0,0,0,5,3
20190308-W-Indian_Wells-R64-Aliaksandra_Sasnovich-Kateryna_Kozlova,2,S-DTL,6,1,0,0,1,2,4
20190308-W-Indian_Wells-R64-Aliaksandra_Sasnovich-Kateryna_Kozlova,2,S-IO,1,0,0,0,0,1,0
20190404-W-Charleston-R16-Maria_Sakkari-Kiki_Bertens,1,F-XC,57,12,4,3,5,28,29
20190404-W-Charleston-R16-Maria_Sakkari-Kiki_Bertens,1,F-DTM,74,7,0,3,4,34,40
20190404-W-Charleston-R16-Maria_Sakkari-Kiki_Bertens,1,F-DTL,16,5,0,1,4,7,9
20190404-W-Charleston-R16-Maria_Sakkari-Kiki_Bertens,1,F-IO,55,7,0,2,5,33,22
20190404-W-Charleston-R16-Maria_Sakkari-Kiki_Bertens,1,F-II,5,2,2,0,0,4,1
20190404-W-Charleston-R16-Maria_Sakkari-Kiki_Bertens,1,B-XC,65,5,2,0,3,42,23
20190404-W-Charleston-R16-Maria_Sakkari-Kiki_Bertens,1,B-DTM,34,3,1,0,2,14,20
20190404-W-Charleston-R16-Maria_Sakkari-Kiki_Bertens,1,B-DTL,3,0,0,0,0,2,1
20190404-W-Charleston-R16-Maria_Sakkari-Kiki_Bertens,1,B-IO,4,1,0,1,0,4,0
20190404-W-Charleston-R16-Maria_Sakkari-Kiki_Bertens,1,S-XC,6,1,0,0,1,2,4
20190404-W-Charleston-R16-Maria_Sakkari-Kiki_Bertens,1,S-DTM,3,0,0,0,0,2,1
20190404-W-Charleston-R16-Maria_Sakkari-Kiki_Bertens,1,S-DTL,1,0,0,0,0,1,0
20190404-W-Charleston-R16-Maria_Sakkari-Kiki_Bertens,2,F-XC,60,16,2,5,9,34,26
20190404-W-Charleston-R16-Maria_Sakkari-Kiki_Bertens,2,F-DTM,36,1,1,0,0,18,18
20190404-W-Charleston-R16-Maria_Sakkari-Kiki_Bertens,2,F-DTL,10,6,2,0,4,3,7
20190404-W-Charleston-R16-Maria_Sakkari-Kiki_Bertens,2,F-IO,27,13,3,2,8,11,16
20190404-W-Charleston-R16-Maria_Sakkari-Kiki_Bertens,2,F-II,3,1,0,0,1,0,3
20190404-W-Charleston-R16-Maria_Sakkari-Kiki_Bertens,2,B-XC,54,4,1,1,2,25,29
20190404-W-Charleston-R16-Maria_Sakkari-Kiki_Bertens,2,B-DTM,59,5,0,0,5,19,40
20190404-W-Charleston-R16-Maria_Sakkari-Kiki_Bertens,2,B-DTL,16,5,1,1,3,8,8
20190404-W-Charleston-R16-Maria_Sakkari-Kiki_Bertens,2,B-IO,15,4,1,3,0,7,8
20190404-W-Charleston-R16-Maria_Sakkari-Kiki_Bertens,2,S-XC,15,1,0,1,0,9,6
20190404-W-Charleston-R16-Maria_Sakkari-Kiki_Bertens,2,S-DTM,9,1,0,0,1,2,7
20190404-W-Charleston-R16-Maria_Sakkari-Kiki_Bertens,2,S-DTL,2,0,0,0,0,0,2
20190404-W-Charleston-R16-Maria_Sakkari-Kiki_Bertens,2,S-IO,1,1,0,1,0,1,0
20190101-W-Auckland-R32-Timea_Babos-Bianca_Andreescu,1,F-XC,27,10,3,3,4,11,16
20190101-W-Auckland-R32-Timea_Babos-Bianca_Andreescu,1,F-DTM,19,2,0,1,1,10,9
20190101-W-Auckland-R32-Timea_Babos-Bianca_Andreescu,1,F-DTL,4,2,0,1,1,1,3
20190101-W-Auckland-R32-Timea_Babos-Bianca_Andreescu,1,F-IO,12,3,0,0,3,3,9
20190101-W-Auckland-R32-Timea_Babos-Bianca_Andreescu,1,B-XC,25,7,0,1,6,8,17
20190101-W-Auckland-R32-Timea_Babos-Bianca_Andreescu,1,B-DTM,34,5,1,1,3,14,20
20190101-W-Auckland-R32-Timea_Babos-Bianca_Andreescu,1,B-DTL,6,4,1,1,2,3,3
20190101-W-Auckland-R32-Timea_Babos-Bianca_Andreescu,1,B-IO,4,3,2,1,0,3,1
20190101-W-Auckland-R32-Timea_Babos-Bianca_Andreescu,1,S-XC,11,1,0,1,0,5,6
20190101-W-Auckland-R32-Timea_Babos-Bianca_Andreescu,1,S-DTM,4,1,0,0,1,1,3
20190101-W-Auckland-R32-Timea_Babos-Bianca_Andreescu,1,S-IO,1,0,0,0,0,1,0
20190101-W-Auckland-R32-Timea_Babos-Bianca_Andreescu,2,F-XC,31,17,6,3,8,17,14
20190101-W-Auckland-R32-Timea_Babos-Bianca_Andreescu,2,F-DTM,17,5,0,1,4,10,7
20190101-W-Auckland-R32-Timea_Babos-Bianca_Andreescu,2,F-DTL,9,5,4,0,1,8,1
20190101-W-Auckland-R32-Timea_Babos-Bianca_Andreescu,2,F-IO,15,5,2,0,3,7,8
20190101-W-Auckland-R32-Timea_Babos-Bianca_Andreescu,2,B-XC,34,7,2,3,2,24,10
20190101-W-Auckland-R32-Timea_Babos-Bianca_Andreescu,2,B-DTM,15,2,0,1,1,9,6
20190101-W-Auckland-R32-Timea_Babos-Bianca_Andreescu,2,B-DTL,4,3,0,1,2,2,2
20190101-W-Auckland-R32-Timea_Babos-Bianca_Andreescu,2,B-IO,4,1,0,0,1,2,2
20190101-W-Auckland-R32-Timea_Babos-Bianca_Andreescu,2,S-XC,2,0,0,0,0,0,2
20190101-W-Auckland-R32-Timea_Babos-Bianca_Andreescu,2,S-DTM,12,1,0,0,1,5,7
20190101-W-Auckland-R32-Timea_Babos-Bianca_Andreescu,2,S-DTL,3,1,0,1,0,2,1
20190408-W-Lugano-R32-Arantxa_Rus-Viktorija_Golubic,1,F-XC,65,14,6,3,5,39,26
20190408-W-Lugano-R32-Arantxa_Rus-Viktorija_Golubic,1,F-DTM,74,5,1,0,4,39,35
20190408-W-Lugano-R32-Arantxa_Rus-Viktorija_Golubic,1,F-DTL,13,4,2,0,2,5,8
20190408-W-Lugano-R32-Arantxa_Rus-Viktorija_Golubic,1,F-IO,34,17,9,2,6,21,13
20190408-W-Lugano-R32-Arantxa_Rus-Viktorija_Golubic,1,F-II,4,1,0,0,1,2,2
20190408-W-Lugano-R32-Arantxa_Rus-Viktorija_Golubic,1,B-XC,59,16,5,1,10,28,31
20190408-W-Lugano-R32-Arantxa_Rus-Viktorija_Golubic,1,B-DTM,103,4,0,0,4,46,57
20190408-W-Lugano-R32-Arantxa_Rus-Viktorija_Golubic,1,B-DTL,32,14,4,3,7,18,14
20190408-W-Lugano-R32-Arantxa_Rus-Viktorija_Golubic,1,B-IO,22,3,1,0,2,10,12
20190408-W-Lugano-R32-Arantxa_Rus-Viktorija_Golubic,1,B-II,1,0,0,0,0,1,0
20190408-W-Lugano-R32-Arantxa_Rus-Viktorija_Golubic,1,S-XC,6,3,0,2,1,3,3
20190408-W-Lugano-R32-Arantxa_Rus-Viktorija_Golubic,1,S-DTM,10,0,0,0,0,1,9
20190408-W-Lugano-R32-Arantxa_Rus-Viktorija_Golubic,1,S-DTL,2,0,0,0,0,1,1
20190408-W-Lugano-R32-Arantxa_Rus-Viktorija_Golubic,1,S-IO,2,1,0,0,1,0,2
20190408-W-Lugano-R32-Arantxa_Rus-Viktorija_Golubic,2,F-XC,105,8,2,2,4,58,47
20190408-W-Lugano-R32-Arantxa_Rus-Viktorija_Golubic,2,F-DTM,59,4,0,1,3,28,31
20190408-W-Lugano-R32-Arantxa_Rus-Viktorija_Golubic,2,F-DTL,7,4,2,1,1,5,2
20190408-W-Lugano-R32-Arantxa_Rus-Viktorija_Golubic,2,F-IO,35,12,3,6,3,24,11
20190408-W-Lugano-R32-Arantxa_Rus-Viktorija_Golubic,2,B-XC,40,16,4,5,7,19,21
20190408-W-Lugano-R32-Arantxa_Rus-Viktorija_Golubic,2,B-DTM,74,7,1,0,6,32,42
20190408-W-Lugano-R32-Arantxa_Rus-Viktorija_Golubic,2,B-DTL,14,4,1,1,2,6,8
20190408-W-Lugano-R32-Arantxa_Rus-Viktorija_Golubic,2,B-IO,26,7,2,2,3,16,10
20190408-W-Lugano-R32-Arantxa_Rus-Viktorija_Golubic,2,B-II,1,1,0,0,1,0,1
20190408-W-Lugano-R32-Arantxa_Rus-Viktorija_Golubic,2,S-XC,14,1,0,0,1,8,6
20190408-W-Lugano-R32-Arantxa_Rus-Viktorija_Golubic,2,S-DTM,19,0,0,0,0,8,11
20190408-W-Lugano-R32-Arantxa_Rus-Viktorija_Golubic,2,S-DTL,5,1,0,0,1,4,1
20190408-W-Lugano-R32-Arantxa_Rus-Viktorija_Golubic,2,S-IO,2,0,0,0,0,0,2
20190409-W-Lugano-R32-Carla_Suarez_Navarro-Polona_Hercog,1,F-XC,42,15,4,6,5,21,21
20190409-W-Lugano-R32-Carla_Suarez_Navarro-Polona_Hercog,1,F-DTM,41,3,0,0,3,15,26
20190409-W-Lugano-R32-Carla_Suarez_Navarro-Polona_Hercog,1,F-DTL,10,3,2,0,1,7,3
20190409-W-Lugano-R32-Carla_Suarez_Navarro-Polona_Hercog,1,F-IO,51,8,3,3,2,38,13
20190409-W-Lugano-R32-Carla_Suarez_Navarro-Polona_Hercog,1,F-II,6,3,1,2,0,6,0
20190409-W-Lugano-R32-Carla_Suarez_Navarro-Polona_Hercog,1,B-XC,81,16,1,2,13,34,47
20190409-W-Lugano-R32-Carla_Suarez_Navarro-Polona_Hercog,1,B-DTM,53,6,0,0,6,19,34
20190409-W-Lugano-R32-Carla_Suarez_Navarro-Polona_Hercog,1,B-DTL,4,2,1,0,1,2,2
20190409-W-Lugano-R32-Carla_Suarez_Navarro-Polona_Hercog,1,B-IO,5,2,1,0,1,1,4
20190409-W-Lugano-R32-Carla_Suarez_Navarro-Polona_Hercog,1,S-XC,7,0,0,0,0,5,2
20190409-W-Lugano-R32-Carla_Suarez_Navarro-Polona_Hercog,1,S-DTM,3,0,0,0,0,0,3
20190409-W-Lugano-R32-Carla_Suarez_Navarro-Polona_Hercog,2,F-XC,36,11,4,3,4,22,14
20190409-W-Lugano-R32-Carla_Suarez_Navarro-Polona_Hercog,2,F-DTM,44,1,0,0,1,26,18
20190409-W-Lugano-R32-Carla_Suarez_Navarro-Polona_Hercog,2,F-DTL,4,1,0,1,0,3,1
20190409-W-Lugano-R32-Carla_Suarez_Navarro-Polona_Hercog,2,F-IO,46,12,1,6,5,27,19
20190409-W-Lugano-R32-Carla_Suarez_Navarro-Polona_Hercog,2,F-II,7,3,0,2,1,4,3
20190409-W-Lugano-R32-Carla_Suarez_Navarro-Polona_Hercog,2,B-XC,57,12,3,1,8,26,31
20190409-W-Lugano-R32-Carla_Suarez_Navarro-Polona_Hercog,2,B-DTM,30,5,0,1,4,14,16
20190409-W-Lugano-R32-Carla_Suarez_Navarro-Polona_Hercog,2,B-DTL,5,3,2,0,1,3,2
20190409-W-Lugano-R32-Carla_Suarez_Navarro-Polona_Hercog,2,B-IO,4,2,0,0,2,2,2
20190409-W-Lugano-R32-Carla_Suarez_Navarro-Polona_Hercog,2,S-XC,21,3,0,1,2,8,13
20190409-W-Lugano-R32-Carla_Suarez_Navarro-Polona_Hercog,2,S-DTM,23,3,0,0,3,7,16
20190409-W-Lugano-R32-Carla_Suarez_Navarro-Polona_Hercog,2,S-DTL,3,2,0,0,2,0,3
20190409-W-Bogota-R32-Emiliana_Arango-Bibiane_Schoofs,1,F-XC,17,7,0,2,5,6,11
20190409-W-Bogota-R32-Emiliana_Arango-Bibiane_Schoofs,1,F-DTM,29,2,0,1,1,10,19
20190409-W-Bogota-R32-Emiliana_Arango-Bibiane_Schoofs,1,F-DTL,5,1,0,0,1,1,4
20190409-W-Bogota-R32-Emiliana_Arango-Bibiane_Schoofs,1,F-IO,32,12,0,4,8,13,19
20190409-W-Bogota-R32-Emiliana_Arango-Bibiane_Schoofs,1,F-II,5,4,0,1,3,2,3
20190409-W-Bogota-R32-Emiliana_Arango-Bibiane_Schoofs,1,B-XC,22,5,0,0,5,8,14
20190409-W-Bogota-R32-Emiliana_Arango-Bibiane_Schoofs,1,B-DTM,21,1,0,0,1,3,18
20190409-W-Bogota-R32-Emiliana_Arango-Bibiane_Schoofs,1,B-DTL,7,4,0,0,4,1,6
20190409-W-Bogota-R32-Emiliana_Arango-Bibiane_Schoofs,1,B-IO,2,1,1,0,0,1,1
20190409-W-Bogota-R32-Emiliana_Arango-Bibiane_Schoofs,1,S-XC,14,1,0,0,1,5,9
20190409-W-Bogota-R32-Emiliana_Arango-Bibiane_Schoofs,1,S-DTM,11,3,0,0,3,5,6
20190409-W-Bogota-R32-Emiliana_Arango-Bibiane_Schoofs,1,S-DTL,1,0,0,0,0,1,0
20190409-W-Bogota-R32-Emiliana_Arango-Bibiane_Schoofs,1,S-IO,1,1,0,1,0,1,0
20190409-W-Bogota-R32-Emiliana_Arango-Bibiane_Schoofs,2,F-XC,25,12,5,3,4,19,6
20190409-W-Bogota-R32-Emiliana_Arango-Bibiane_Schoofs,2,F-DTM,29,3,1,1,1,17,12
20190409-W-Bogota-R32-Emiliana_Arango-Bibiane_Schoofs,2,F-DTL,4,1,1,0,0,2,2
20190409-W-Bogota-R32-Emiliana_Arango-Bibiane_Schoofs,2,F-IO,31,16,4,3,9,20,11
20190409-W-Bogota-R32-Emiliana_Arango-Bibiane_Schoofs,2,F-II,1,0,0,0,0,1,0
20190409-W-Bogota-R32-Emiliana_Arango-Bibiane_Schoofs,2,B-XC,31,1,0,0,1,23,8
20190409-W-Bogota-R32-Emiliana_Arango-Bibiane_Schoofs,2,B-DTM,25,2,0,0,2,12,13
20190409-W-Bogota-R32-Emiliana_Arango-Bibiane_Schoofs,2,B-DTL,3,1,0,0,1,2,1
20190409-W-Bogota-R32-Emiliana_Arango-Bibiane_Schoofs,2,S-XC,17,5,0,1,4,6,11
20190409-W-Bogota-R32-Emiliana_Arango-Bibiane_Schoofs,2,S-DTM,4,0,0,0,0,0,4
20190409-W-Bogota-R32-Emiliana_Arango-Bibiane_Schoofs,2,S-DTL,4,2,0,1,1,3,1
20190410-W-Lugano-R32-Veronika_Kudermetova-Jil_Teichmann,1,F-XC,83,12,1,5,6,31,52
20190410-W-Lugano-R32-Veronika_Kudermetova-Jil_Teichmann,1,F-DTM,25,1,0,0,1,13,12
20190410-W-Lugano-R32-Veronika_Kudermetova-Jil_Teichmann,1,F-DTL,15,9,4,2,3,8,7
20190410-W-Lugano-R32-Veronika_Kudermetova-Jil_Teichmann,1,F-IO,31,20,7,3,10,14,17
20190410-W-Lugano-R32-Veronika_Kudermetova-Jil_Teichmann,1,F-II,1,0,0,0,0,0,1
20190410-W-Lugano-R32-Veronika_Kudermetova-Jil_Teichmann,1,B-XC,49,22,6,3,13,22,27
20190410-W-Lugano-R32-Veronika_Kudermetova-Jil_Teichmann,1,B-DTM,54,2,0,0,2,25,29
20190410-W-Lugano-R32-Veronika_Kudermetova-Jil_Teichmann,1,B-DTL,18,11,6,2,3,12,6
20190410-W-Lugano-R32-Veronika_Kudermetova-Jil_Teichmann,1,B-IO,32,16,5,3,8,17,15
20190410-W-Lugano-R32-Veronika_Kudermetova-Jil_Teichmann,1,S-XC,2,0,0,0,0,1,1
20190410-W-Lugano-R32-Veronika_Kudermetova-Jil_Teichmann,1,S-DTM,8,0,0,0,0,2,6
20190410-W-Lugano-R32-Veronika_Kudermetova-Jil_Teichmann,1,S-DTL,1,1,0,0,1,0,1
20190410-W-Lugano-R32-Veronika_Kudermetova-Jil_Teichmann,1,S-IO,3,1,0,0,1,2,1
20190410-W-Lugano-R32-Veronika_Kudermetova-Jil_Teichmann,2,F-XC,70,12,2,1,9,32,38
20190410-W-Lugano-R32-Veronika_Kudermetova-Jil_Teichmann,2,F-DTM,64,7,1,1,5,34,30
20190410-W-Lugano-R32-Veronika_Kudermetova-Jil_Teichmann,2,F-DTL,7,3,2,0,1,3,4
20190410-W-Lugano-R32-Veronika_Kudermetova-Jil_Teichmann,2,F-IO,12,4,3,0,1,8,4
20190410-W-Lugano-R32-Veronika_Kudermetova-Jil_Teichmann,2,B-XC,48,8,0,2,6,30,18
20190410-W-Lugano-R32-Veronika_Kudermetova-Jil_Teichmann,2,B-DTM,57,5,0,2,3,36,21
20190410-W-Lugano-R32-Veronika_Kudermetova-Jil_Teichmann,2,B-DTL,13,6,2,1,3,8,5
20190410-W-Lugano-R32-Veronika_Kudermetova-Jil_Teichmann,2,B-IO,10,2,1,0,1,5,5
20190410-W-Lugano-R32-Veronika_Kudermetova-Jil_Teichmann,2,S-XC,6,1,0,0,1,1,5
20190410-W-Lugano-R32-Veronika_Kudermetova-Jil_Teichmann,2,S-DTM,11,0,0,0,0,5,6
20190410-W-Lugano-R32-Veronika_Kudermetova-Jil_Teichmann,2,S-DTL,2,0,0,0,0,1,1
20120907-W-US_Open-SF-Serena_Williams-Sara_Errani,1,F-XC,26,11,4,1,6,17,9
20120907-W-US_Open-SF-Serena_Williams-Sara_Errani,1,F-DTM,3,0,0,0,0,3,0
20120907-W-US_Open-SF-Serena_Williams-Sara_Errani,1,F-DTL,9,2,1,1,0,6,3
20120907-W-US_Open-SF-Serena_Williams-Sara_Errani,1,F-IO,8,3,2,0,1,2,6
20120907-W-US_Open-SF-Serena_Williams-Sara_Errani,1,B-XC,44,11,5,2,4,28,16
20120907-W-US_Open-SF-Serena_Williams-Sara_Errani,1,B-DTM,7,1,0,0,1,2,5
20120907-W-US_Open-SF-Serena_Williams-Sara_Errani,1,B-DTL,18,9,6,1,2,14,4
20120907-W-US_Open-SF-Serena_Williams-Sara_Errani,1,B-IO,2,2,0,2,0,2,0
20120907-W-US_Open-SF-Serena_Williams-Sara_Errani,1,S-XC,1,0,0,0,0,0,1
20120907-W-US_Open-SF-Serena_Williams-Sara_Errani,2,F-XC,14,2,0,0,2,3,11
20120907-W-US_Open-SF-Serena_Williams-Sara_Errani,2,F-DTM,16,1,0,0,1,3,13
20120907-W-US_Open-SF-Serena_Williams-Sara_Errani,2,F-DTL,11,2,0,0,2,1,10
20120907-W-US_Open-SF-Serena_Williams-Sara_Errani,2,F-IO,14,3,3,0,0,6,8
20120907-W-US_Open-SF-Serena_Williams-Sara_Errani,2,F-II,3,2,1,1,0,3,0
20120907-W-US_Open-SF-Serena_Williams-Sara_Errani,2,B-XC,29,3,1,0,2,14,15
20120907-W-US_Open-SF-Serena_Williams-Sara_Errani,2,B-DTM,16,1,0,0,1,10,6
20120907-W-US_Open-SF-Serena_Williams-Sara_Errani,2,B-DTL,5,0,0,0,0,2,3
20120907-W-US_Open-SF-Serena_Williams-Sara_Errani,2,B-IO,1,0,0,0,0,0,1
20120907-W-US_Open-SF-Serena_Williams-Sara_Errani,2,S-XC,4,0,0,0,0,2,2
20120907-W-US_Open-SF-Serena_Williams-Sara_Errani,2,S-DTM,3,1,0,0,1,1,2
20120907-W-US_Open-SF-Serena_Williams-Sara_Errani,2,S-DTL,1,1,0,1,0,1,0
20120907-W-US_Open-SF-Serena_Williams-Sara_Errani,2,S-IO,1,1,1,0,0,1,0
20190105-W-Auckland-SF-Su_Wei_Hsieh-Bianca_Andreescu,1,F-XC,28,9,1,5,3,13,15
20190105-W-Auckland-SF-Su_Wei_Hsieh-Bianca_Andreescu,1,F-DTM,12,1,0,1,0,8,4
20190105-W-Auckland-SF-Su_Wei_Hsieh-Bianca_Andreescu,1,F-DTL,3,2,1,0,1,1,2
20190105-W-Auckland-SF-Su_Wei_Hsieh-Bianca_Andreescu,1,F-IO,4,2,1,0,1,2,2
20190105-W-Auckland-SF-Su_Wei_Hsieh-Bianca_Andreescu,1,F-II,1,1,1,0,0,1,0
20190105-W-Auckland-SF-Su_Wei_Hsieh-Bianca_Andreescu,1,B-XC,27,7,1,3,3,11,16
20190105-W-Auckland-SF-Su_Wei_Hsieh-Bianca_Andreescu,1,B-DTM,20,4,0,0,4,11,9
20190105-W-Auckland-SF-Su_Wei_Hsieh-Bianca_Andreescu,1,B-DTL,5,3,2,0,1,4,1
20190105-W-Auckland-SF-Su_Wei_Hsieh-Bianca_Andreescu,1,B-IO,6,3,1,0,2,2,4
20190105-W-Auckland-SF-Su_Wei_Hsieh-Bianca_Andreescu,1,S-XC,2,0,0,0,0,0,2
20190105-W-Auckland-SF-Su_Wei_Hsieh-Bianca_Andreescu,1,S-DTM,5,0,0,0,0,2,3
20190105-W-Auckland-SF-Su_Wei_Hsieh-Bianca_Andreescu,2,F-XC,26,6,4,0,2,15,11
20190105-W-Auckland-SF-Su_Wei_Hsieh-Bianca_Andreescu,2,F-DTM,25,4,2,0,2,11,14
20190105-W-Auckland-SF-Su_Wei_Hsieh-Bianca_Andreescu,2,F-DTL,14,5,2,2,1,12,2
20190105-W-Auckland-SF-Su_Wei_Hsieh-Bianca_Andreescu,2,F-IO,9,3,1,0,2,4,5
20190105-W-Auckland-SF-Su_Wei_Hsieh-Bianca_Andreescu,2,B-XC,13,7,3,1,3,6,7
20190105-W-Auckland-SF-Su_Wei_Hsieh-Bianca_Andreescu,2,B-DTM,12,1,0,0,1,7,5
20190105-W-Auckland-SF-Su_Wei_Hsieh-Bianca_Andreescu,2,B-DTL,6,4,2,2,0,5,1
20190105-W-Auckland-SF-Su_Wei_Hsieh-Bianca_Andreescu,2,B-IO,4,1,0,0,1,1,3
20190105-W-Auckland-SF-Su_Wei_Hsieh-Bianca_Andreescu,2,S-XC,3,0,0,0,0,2,1
20190105-W-Auckland-SF-Su_Wei_Hsieh-Bianca_Andreescu,2,S-DTM,7,1,0,0,1,3,4
20190105-W-Auckland-SF-Su_Wei_Hsieh-Bianca_Andreescu,2,S-DTL,5,0,0,0,0,4,1
20190105-W-Auckland-SF-Su_Wei_Hsieh-Bianca_Andreescu,2,S-IO,3,0,0,0,0,1,2
20190411-W-Bogota-R16-Sara_Errani-Bibiane_Schoofs,1,F-XC,24,1,0,1,0,16,8
20190411-W-Bogota-R16-Sara_Errani-Bibiane_Schoofs,1,F-DTM,26,1,0,0,1,16,10
20190411-W-Bogota-R16-Sara_Errani-Bibiane_Schoofs,1,F-DTL,6,1,1,0,0,3,3
20190411-W-Bogota-R16-Sara_Errani-Bibiane_Schoofs,1,F-IO,15,2,0,0,2,7,8
20190411-W-Bogota-R16-Sara_Errani-Bibiane_Schoofs,1,F-II,1,1,1,0,0,1,0
20190411-W-Bogota-R16-Sara_Errani-Bibiane_Schoofs,1,B-XC,26,1,0,0,1,15,11
20190411-W-Bogota-R16-Sara_Errani-Bibiane_Schoofs,1,B-DTM,36,1,0,0,1,22,14
20190411-W-Bogota-R16-Sara_Errani-Bibiane_Schoofs,1,B-DTL,2,2,2,0,0,2,0
20190411-W-Bogota-R16-Sara_Errani-Bibiane_Schoofs,1,B-IO,1,1,1,0,0,1,0
20190411-W-Bogota-R16-Sara_Errani-Bibiane_Schoofs,1,S-XC,7,0,0,0,0,4,3
20190411-W-Bogota-R16-Sara_Errani-Bibiane_Schoofs,1,S-DTM,11,1,0,0,1,6,5
20190411-W-Bogota-R16-Sara_Errani-Bibiane_Schoofs,1,S-IO,2,1,0,0,1,0,2
20190411-W-Bogota-R16-Sara_Errani-Bibiane_Schoofs,2,F-XC,40,18,2,1,15,12,28
20190411-W-Bogota-R16-Sara_Errani-Bibiane_Schoofs,2,F-DTM,26,5,0,0,5,7,19
20190411-W-Bogota-R16-Sara_Errani-Bibiane_Schoofs,2,F-DTL,3,2,0,0,2,1,2
20190411-W-Bogota-R16-Sara_Errani-Bibiane_Schoofs,2,F-IO,21,7,4,0,3,7,14
20190411-W-Bogota-R16-Sara_Errani-Bibiane_Schoofs,2,B-XC,17,0,0,0,0,8,9
20190411-W-Bogota-R16-Sara_Errani-Bibiane_Schoofs,2,B-DTM,39,5,0,0,5,15,24
20190411-W-Bogota-R16-Sara_Errani-Bibiane_Schoofs,2,B-DTL,3,1,0,0,1,1,2
20190411-W-Bogota-R16-Sara_Errani-Bibiane_Schoofs,2,B-IO,2,0,0,0,0,1,1
20190411-W-Bogota-R16-Sara_Errani-Bibiane_Schoofs,2,S-XC,14,2,0,0,2,5,9
20190411-W-Bogota-R16-Sara_Errani-Bibiane_Schoofs,2,S-DTM,18,1,0,0,1,12,6
20190411-W-Bogota-R16-Sara_Errani-Bibiane_Schoofs,2,S-DTL,2,0,0,0,0,0,2
20190411-W-Bogota-R16-Sara_Errani-Bibiane_Schoofs,2,S-IO,3,0,0,0,0,0,3
20190213-W-Doha-R16-Kiki_Bertens-Carla_Suarez_Navarro,1,F-XC,25,10,5,1,4,13,12
20190213-W-Doha-R16-Kiki_Bertens-Carla_Suarez_Navarro,1,F-DTM,17,0,0,0,0,10,7
20190213-W-Doha-R16-Kiki_Bertens-Carla_Suarez_Navarro,1,F-DTL,6,4,1,1,2,3,3
20190213-W-Doha-R16-Kiki_Bertens-Carla_Suarez_Navarro,1,F-IO,24,10,4,2,4,14,10
20190213-W-Doha-R16-Kiki_Bertens-Carla_Suarez_Navarro,1,B-XC,26,5,0,1,4,10,16
20190213-W-Doha-R16-Kiki_Bertens-Carla_Suarez_Navarro,1,B-DTM,33,5,0,1,4,18,15
20190213-W-Doha-R16-Kiki_Bertens-Carla_Suarez_Navarro,1,B-DTL,5,3,3,0,0,4,1
20190213-W-Doha-R16-Kiki_Bertens-Carla_Suarez_Navarro,1,B-IO,5,2,0,0,2,2,3
20190213-W-Doha-R16-Kiki_Bertens-Carla_Suarez_Navarro,1,S-XC,9,1,0,1,0,5,4
20190213-W-Doha-R16-Kiki_Bertens-Carla_Suarez_Navarro,1,S-DTM,4,0,0,0,0,3,1
20190213-W-Doha-R16-Kiki_Bertens-Carla_Suarez_Navarro,1,S-DTL,2,0,0,0,0,0,2
20190213-W-Doha-R16-Kiki_Bertens-Carla_Suarez_Navarro,2,F-XC,27,5,1,3,1,17,10
20190213-W-Doha-R16-Kiki_Bertens-Carla_Suarez_Navarro,2,F-DTM,37,4,0,0,4,16,21
20190213-W-Doha-R16-Kiki_Bertens-Carla_Suarez_Navarro,2,F-DTL,15,5,1,1,3,8,7
20190213-W-Doha-R16-Kiki_Bertens-Carla_Suarez_Navarro,2,F-IO,27,7,1,1,5,10,17
20190213-W-Doha-R16-Kiki_Bertens-Carla_Suarez_Navarro,2,F-II,2,1,0,0,1,0,2
20190213-W-Doha-R16-Kiki_Bertens-Carla_Suarez_Navarro,2,B-XC,21,4,0,1,3,9,12
20190213-W-Doha-R16-Kiki_Bertens-Carla_Suarez_Navarro,2,B-DTM,23,2,0,1,1,10,13
20190213-W-Doha-R16-Kiki_Bertens-Carla_Suarez_Navarro,2,B-DTL,4,2,2,0,0,3,1
20190213-W-Doha-R16-Kiki_Bertens-Carla_Suarez_Navarro,2,B-IO,1,1,0,0,1,0,1
20190213-W-Doha-R16-Kiki_Bertens-Carla_Suarez_Navarro,2,S-XC,9,1,0,1,0,7,2
20190213-W-Doha-R16-Kiki_Bertens-Carla_Suarez_Navarro,2,S-DTM,3,0,0,0,0,0,3
20190213-W-Doha-R16-Kiki_Bertens-Carla_Suarez_Navarro,2,S-DTL,1,0,0,0,0,0,1
19930430-W-Hamburg-QF-Monica_Seles-Magdalena_Maleeva,1,F-XC,44,4,1,1,2,22,22
19930430-W-Hamburg-QF-Monica_Seles-Magdalena_Maleeva,1,F-DTM,14,1,0,1,0,6,8
19930430-W-Hamburg-QF-Monica_Seles-Magdalena_Maleeva,1,F-DTL,25,11,1,6,4,15,10
19930430-W-Hamburg-QF-Monica_Seles-Magdalena_Maleeva,1,F-IO,17,4,1,1,2,12,5
19930430-W-Hamburg-QF-Monica_Seles-Magdalena_Maleeva,1,B-XC,34,4,0,4,0,18,16
19930430-W-Hamburg-QF-Monica_Seles-Magdalena_Maleeva,1,B-DTM,11,0,0,0,0,8,3
19930430-W-Hamburg-QF-Monica_Seles-Magdalena_Maleeva,1,B-DTL,6,1,0,1,0,6,0
19930430-W-Hamburg-QF-Monica_Seles-Magdalena_Maleeva,1,B-IO,5,3,1,0,2,1,4
19930430-W-Hamburg-QF-Monica_Seles-Magdalena_Maleeva,1,S-DTM,2,0,0,0,0,1,1
19930430-W-Hamburg-QF-Monica_Seles-Magdalena_Maleeva,2,F-XC,39,13,1,4,8,14,25
19930430-W-Hamburg-QF-Monica_Seles-Magdalena_Maleeva,2,F-DTM,14,2,0,1,1,6,8
19930430-W-Hamburg-QF-Monica_Seles-Magdalena_Maleeva,2,F-DTL,21,6,2,1,3,13,8
19930430-W-Hamburg-QF-Monica_Seles-Magdalena_Maleeva,2,F-IO,8,4,1,2,1,4,4
19930430-W-Hamburg-QF-Monica_Seles-Magdalena_Maleeva,2,B-XC,36,6,1,1,4,16,20
19930430-W-Hamburg-QF-Monica_Seles-Magdalena_Maleeva,2,B-DTM,15,0,0,0,0,6,9
19930430-W-Hamburg-QF-Monica_Seles-Magdalena_Maleeva,2,B-DTL,12,5,3,2,0,9,3
19930430-W-Hamburg-QF-Monica_Seles-Magdalena_Maleeva,2,B-IO,4,2,1,1,0,2,2
19930430-W-Hamburg-QF-Monica_Seles-Magdalena_Maleeva,2,S-XC,3,0,0,0,0,1,2
19930430-W-Hamburg-QF-Monica_Seles-Magdalena_Maleeva,2,S-DTM,5,0,0,0,0,2,3
20170803-W-Washington-R16-Bianca_Andreescu-Kristina_Mladenovic,1,F-XC,16,10,7,1,2,12,4
20170803-W-Washington-R16-Bianca_Andreescu-Kristina_Mladenovic,1,F-DTM,14,2,0,0,2,6,8
20170803-W-Washington-R16-Bianca_Andreescu-Kristina_Mladenovic,1,F-DTL,7,3,2,1,0,6,1
20170803-W-Washington-R16-Bianca_Andreescu-Kristina_Mladenovic,1,F-IO,7,3,2,0,1,5,2
20170803-W-Washington-R16-Bianca_Andreescu-Kristina_Mladenovic,1,B-XC,10,1,0,0,1,8,2
20170803-W-Washington-R16-Bianca_Andreescu-Kristina_Mladenovic,1,B-DTM,20,3,1,0,2,9,11
20170803-W-Washington-R16-Bianca_Andreescu-Kristina_Mladenovic,1,B-DTL,3,2,1,0,1,1,2
20170803-W-Washington-R16-Bianca_Andreescu-Kristina_Mladenovic,1,B-IO,3,0,0,0,0,1,2
20170803-W-Washington-R16-Bianca_Andreescu-Kristina_Mladenovic,1,S-XC,1,0,0,0,0,0,1
20170803-W-Washington-R16-Bianca_Andreescu-Kristina_Mladenovic,2,F-XC,19,8,5,1,2,11,8
20170803-W-Washington-R16-Bianca_Andreescu-Kristina_Mladenovic,2,F-DTM,9,3,0,1,2,5,4
20170803-W-Washington-R16-Bianca_Andreescu-Kristina_Mladenovic,2,F-IO,19,7,0,2,5,7,12
20170803-W-Washington-R16-Bianca_Andreescu-Kristina_Mladenovic,2,F-II,1,1,0,0,1,0,1
20170803-W-Washington-R16-Bianca_Andreescu-Kristina_Mladenovic,2,B-XC,10,7,0,1,6,3,7
20170803-W-Washington-R16-Bianca_Andreescu-Kristina_Mladenovic,2,B-DTM,8,2,0,0,2,4,4
20170803-W-Washington-R16-Bianca_Andreescu-Kristina_Mladenovic,2,B-DTL,1,0,0,0,0,0,1
20170803-W-Washington-R16-Bianca_Andreescu-Kristina_Mladenovic,2,B-IO,3,2,0,0,2,0,3
20170803-W-Washington-R16-Bianca_Andreescu-Kristina_Mladenovic,2,S-XC,3,0,0,0,0,0,3
20170803-W-Washington-R16-Bianca_Andreescu-Kristina_Mladenovic,2,S-DTM,4,0,0,0,0,1,3
20170803-W-Washington-R16-Bianca_Andreescu-Kristina_Mladenovic,2,S-DTL,2,2,0,1,1,1,1
20190410-W-Lugano-R16-Sorana_Cirstea-Polona_Hercog,1,F-XC,46,6,3,2,1,23,23
20190410-W-Lugano-R16-Sorana_Cirstea-Polona_Hercog,1,F-DTM,25,5,0,1,4,12,13
20190410-W-Lugano-R16-Sorana_Cirstea-Polona_Hercog,1,F-DTL,16,4,1,1,2,7,9
20190410-W-Lugano-R16-Sorana_Cirstea-Polona_Hercog,1,F-IO,17,2,1,1,0,10,7
20190410-W-Lugano-R16-Sorana_Cirstea-Polona_Hercog,1,B-XC,55,6,1,0,5,23,32
20190410-W-Lugano-R16-Sorana_Cirstea-Polona_Hercog,1,B-DTM,41,2,0,0,2,13,28
20190410-W-Lugano-R16-Sorana_Cirstea-Polona_Hercog,1,B-DTL,19,11,6,0,5,8,11
20190410-W-Lugano-R16-Sorana_Cirstea-Polona_Hercog,1,B-IO,18,9,2,1,6,7,11
20190410-W-Lugano-R16-Sorana_Cirstea-Polona_Hercog,1,S-XC,14,3,0,1,2,6,8
20190410-W-Lugano-R16-Sorana_Cirstea-Polona_Hercog,1,S-DTM,6,1,0,0,1,3,3
20190410-W-Lugano-R16-Sorana_Cirstea-Polona_Hercog,1,S-DTL,4,1,0,1,0,2,2
20190410-W-Lugano-R16-Sorana_Cirstea-Polona_Hercog,2,F-XC,73,25,5,8,12,36,37
20190410-W-Lugano-R16-Sorana_Cirstea-Polona_Hercog,2,F-DTM,28,6,1,0,5,13,15
20190410-W-Lugano-R16-Sorana_Cirstea-Polona_Hercog,2,F-DTL,11,6,4,1,1,8,3
20190410-W-Lugano-R16-Sorana_Cirstea-Polona_Hercog,2,F-IO,48,15,7,0,8,30,18
20190410-W-Lugano-R16-Sorana_Cirstea-Polona_Hercog,2,F-II,9,4,1,1,2,4,5
20190410-W-Lugano-R16-Sorana_Cirstea-Polona_Hercog,2,B-XC,21,5,1,0,4,10,11
20190410-W-Lugano-R16-Sorana_Cirstea-Polona_Hercog,2,B-DTM,23,3,0,0,3,11,12
20190410-W-Lugano-R16-Sorana_Cirstea-Polona_Hercog,2,B-DTL,5,4,0,2,2,2,3
20190410-W-Lugano-R16-Sorana_Cirstea-Polona_Hercog,2,B-IO,1,0,0,0,0,1,0
20190410-W-Lugano-R16-Sorana_Cirstea-Polona_Hercog,2,S-XC,33,3,0,0,3,17,16
20190410-W-Lugano-R16-Sorana_Cirstea-Polona_Hercog,2,S-DTM,23,3,0,0,3,13,10
20190410-W-Lugano-R16-Sorana_Cirstea-Polona_Hercog,2,S-DTL,5,2,0,0,2,1,4
20190410-W-Lugano-R16-Sorana_Cirstea-Polona_Hercog,2,S-IO,1,0,0,0,0,1,0
20190425-W-Stuttgart-R16-Kiki_Bertens-Belinda_Bencic,1,F-XC,42,11,7,2,2,22,20
20190425-W-Stuttgart-R16-Kiki_Bertens-Belinda_Bencic,1,F-DTM,12,3,1,0,2,5,7
20190425-W-Stuttgart-R16-Kiki_Bertens-Belinda_Bencic,1,F-DTL,8,2,2,0,0,5,3
20190425-W-Stuttgart-R16-Kiki_Bertens-Belinda_Bencic,1,F-IO,13,8,3,1,4,7,6
20190425-W-Stuttgart-R16-Kiki_Bertens-Belinda_Bencic,1,F-II,1,1,1,0,0,1,0
20190425-W-Stuttgart-R16-Kiki_Bertens-Belinda_Bencic,1,B-XC,33,9,2,2,5,14,19
20190425-W-Stuttgart-R16-Kiki_Bertens-Belinda_Bencic,1,B-DTM,24,2,0,0,2,12,12
20190425-W-Stuttgart-R16-Kiki_Bertens-Belinda_Bencic,1,B-DTL,1,1,1,0,0,1,0
20190425-W-Stuttgart-R16-Kiki_Bertens-Belinda_Bencic,1,B-IO,4,2,1,0,1,2,2
20190425-W-Stuttgart-R16-Kiki_Bertens-Belinda_Bencic,1,S-XC,8,2,0,0,2,0,8
20190425-W-Stuttgart-R16-Kiki_Bertens-Belinda_Bencic,1,S-DTM,4,1,0,0,1,2,2
20190425-W-Stuttgart-R16-Kiki_Bertens-Belinda_Bencic,1,S-DTL,3,1,0,1,0,1,2
20190425-W-Stuttgart-R16-Kiki_Bertens-Belinda_Bencic,2,F-XC,40,10,1,5,4,24,16
20190425-W-Stuttgart-R16-Kiki_Bertens-Belinda_Bencic,2,F-DTM,22,2,0,0,2,9,13
20190425-W-Stuttgart-R16-Kiki_Bertens-Belinda_Bencic,2,F-DTL,9,3,0,0,3,3,6
20190425-W-Stuttgart-R16-Kiki_Bertens-Belinda_Bencic,2,F-IO,11,3,1,1,1,6,5
20190425-W-Stuttgart-R16-Kiki_Bertens-Belinda_Bencic,2,B-XC,35,10,1,3,6,19,16
20190425-W-Stuttgart-R16-Kiki_Bertens-Belinda_Bencic,2,B-DTM,26,3,0,1,2,14,12
20190425-W-Stuttgart-R16-Kiki_Bertens-Belinda_Bencic,2,B-DTL,8,4,1,1,2,4,4
20190425-W-Stuttgart-R16-Kiki_Bertens-Belinda_Bencic,2,B-IO,7,6,2,0,4,3,4
20190425-W-Stuttgart-R16-Kiki_Bertens-Belinda_Bencic,2,S-XC,2,0,0,0,0,1,1
20190425-W-Stuttgart-R16-Kiki_Bertens-Belinda_Bencic,2,S-DTM,1,0,0,0,0,1,0
20190423-W-Stuttgart-R32-Anna_Lena_Friedsam-Kiki_Bertens,1,F-XC,33,7,1,1,5,15,18
20190423-W-Stuttgart-R32-Anna_Lena_Friedsam-Kiki_Bertens,1,F-DTM,42,4,0,0,4,17,25
20190423-W-Stuttgart-R32-Anna_Lena_Friedsam-Kiki_Bertens,1,F-DTL,7,5,1,2,2,4,3
20190423-W-Stuttgart-R32-Anna_Lena_Friedsam-Kiki_Bertens,1,F-IO,15,7,0,3,4,8,7
20190423-W-Stuttgart-R32-Anna_Lena_Friedsam-Kiki_Bertens,1,F-II,1,1,0,0,1,0,1
20190423-W-Stuttgart-R32-Anna_Lena_Friedsam-Kiki_Bertens,1,B-XC,54,7,2,1,4,22,32
20190423-W-Stuttgart-R32-Anna_Lena_Friedsam-Kiki_Bertens,1,B-DTM,35,2,0,1,1,15,20
20190423-W-Stuttgart-R32-Anna_Lena_Friedsam-Kiki_Bertens,1,B-DTL,1,1,1,0,0,1,0
20190423-W-Stuttgart-R32-Anna_Lena_Friedsam-Kiki_Bertens,1,B-IO,1,0,0,0,0,1,0
20190423-W-Stuttgart-R32-Anna_Lena_Friedsam-Kiki_Bertens,1,S-XC,12,0,0,0,0,8,4
20190423-W-Stuttgart-R32-Anna_Lena_Friedsam-Kiki_Bertens,1,S-DTM,2,0,0,0,0,0,2
20190423-W-Stuttgart-R32-Anna_Lena_Friedsam-Kiki_Bertens,1,S-DTL,2,1,0,0,1,0,2
20190423-W-Stuttgart-R32-Anna_Lena_Friedsam-Kiki_Bertens,2,F-XC,32,10,4,3,3,21,11
20190423-W-Stuttgart-R32-Anna_Lena_Friedsam-Kiki_Bertens,2,F-DTM,27,3,1,0,2,13,14
20190423-W-Stuttgart-R32-Anna_Lena_Friedsam-Kiki_Bertens,2,F-DTL,6,1,0,0,1,2,4
20190423-W-Stuttgart-R32-Anna_Lena_Friedsam-Kiki_Bertens,2,F-IO,18,4,4,0,0,10,8
20190423-W-Stuttgart-R32-Anna_Lena_Friedsam-Kiki_Bertens,2,F-II,4,4,1,2,1,3,1
20190423-W-Stuttgart-R32-Anna_Lena_Friedsam-Kiki_Bertens,2,B-XC,39,6,0,2,4,23,16
20190423-W-Stuttgart-R32-Anna_Lena_Friedsam-Kiki_Bertens,2,B-DTM,32,3,1,0,2,17,15
20190423-W-Stuttgart-R32-Anna_Lena_Friedsam-Kiki_Bertens,2,B-DTL,2,0,0,0,0,2,0
20190423-W-Stuttgart-R32-Anna_Lena_Friedsam-Kiki_Bertens,2,B-IO,3,3,2,1,0,3,0
20190423-W-Stuttgart-R32-Anna_Lena_Friedsam-Kiki_Bertens,2,S-XC,11,1,0,0,1,4,7
20190423-W-Stuttgart-R32-Anna_Lena_Friedsam-Kiki_Bertens,2,S-DTM,14,1,0,0,1,8,6
20190423-W-Stuttgart-R32-Anna_Lena_Friedsam-Kiki_Bertens,2,S-DTL,7,3,1,2,0,4,3
20190426-W-Stuttgart-QF-Kiki_Bertens-Angelique_Kerber,1,F-XC,36,13,2,2,9,15,21
20190426-W-Stuttgart-QF-Kiki_Bertens-Angelique_Kerber,1,F-DTM,16,1,0,0,1,10,6
20190426-W-Stuttgart-QF-Kiki_Bertens-Angelique_Kerber,1,F-DTL,10,1,1,0,0,7,3
20190426-W-Stuttgart-QF-Kiki_Bertens-Angelique_Kerber,1,F-IO,11,9,5,4,0,9,2
20190426-W-Stuttgart-QF-Kiki_Bertens-Angelique_Kerber,1,F-II,2,0,0,0,0,2,0
20190426-W-Stuttgart-QF-Kiki_Bertens-Angelique_Kerber,1,B-XC,20,5,2,0,3,13,7
20190426-W-Stuttgart-QF-Kiki_Bertens-Angelique_Kerber,1,B-DTM,22,0,0,0,0,10,12
20190426-W-Stuttgart-QF-Kiki_Bertens-Angelique_Kerber,1,B-DTL,4,3,1,0,2,2,2
20190426-W-Stuttgart-QF-Kiki_Bertens-Angelique_Kerber,1,B-IO,4,2,1,0,1,3,1
20190426-W-Stuttgart-QF-Kiki_Bertens-Angelique_Kerber,1,S-XC,7,1,0,0,1,1,6
20190426-W-Stuttgart-QF-Kiki_Bertens-Angelique_Kerber,1,S-DTM,4,2,0,0,2,0,4
20190426-W-Stuttgart-QF-Kiki_Bertens-Angelique_Kerber,1,S-DTL,1,1,0,1,0,1,0
20190426-W-Stuttgart-QF-Kiki_Bertens-Angelique_Kerber,2,F-XC,38,3,0,2,1,19,19
20190426-W-Stuttgart-QF-Kiki_Bertens-Angelique_Kerber,2,F-DTM,18,3,1,0,2,11,7
20190426-W-Stuttgart-QF-Kiki_Bertens-Angelique_Kerber,2,F-DTL,15,9,3,2,4,7,8
20190426-W-Stuttgart-QF-Kiki_Bertens-Angelique_Kerber,2,F-IO,19,8,2,3,3,9,10
20190426-W-Stuttgart-QF-Kiki_Bertens-Angelique_Kerber,2,B-XC,25,6,1,1,4,12,13
20190426-W-Stuttgart-QF-Kiki_Bertens-Angelique_Kerber,2,B-DTM,10,0,0,0,0,6,4
20190426-W-Stuttgart-QF-Kiki_Bertens-Angelique_Kerber,2,B-DTL,5,3,0,1,2,3,2
20190426-W-Stuttgart-QF-Kiki_Bertens-Angelique_Kerber,2,B-IO,6,1,1,0,0,2,4
20190426-W-Stuttgart-QF-Kiki_Bertens-Angelique_Kerber,2,S-XC,1,0,0,0,0,0,1
20190426-W-Stuttgart-QF-Kiki_Bertens-Angelique_Kerber,2,S-DTM,4,0,0,0,0,0,4
20180421-W-Fed_Cup_World_Group_II_R1-RR-Bianca_Andreescu-Lesia_Tsurenko,1,F-XC,73,18,2,4,12,26,47
20180421-W-Fed_Cup_World_Group_II_R1-RR-Bianca_Andreescu-Lesia_Tsurenko,1,F-DTM,49,10,0,0,10,10,39
20180421-W-Fed_Cup_World_Group_II_R1-RR-Bianca_Andreescu-Lesia_Tsurenko,1,F-DTL,12,6,1,1,4,3,9
20180421-W-Fed_Cup_World_Group_II_R1-RR-Bianca_Andreescu-Lesia_Tsurenko,1,F-IO,30,8,2,1,5,13,17
20180421-W-Fed_Cup_World_Group_II_R1-RR-Bianca_Andreescu-Lesia_Tsurenko,1,F-II,4,0,0,0,0,2,2
20180421-W-Fed_Cup_World_Group_II_R1-RR-Bianca_Andreescu-Lesia_Tsurenko,1,B-XC,45,8,0,2,6,21,24
20180421-W-Fed_Cup_World_Group_II_R1-RR-Bianca_Andreescu-Lesia_Tsurenko,1,B-DTM,38,4,0,0,4,13,25
20180421-W-Fed_Cup_World_Group_II_R1-RR-Bianca_Andreescu-Lesia_Tsurenko,1,B-DTL,8,2,0,0,2,4,4
20180421-W-Fed_Cup_World_Group_II_R1-RR-Bianca_Andreescu-Lesia_Tsurenko,1,B-IO,6,2,2,0,0,2,4
20180421-W-Fed_Cup_World_Group_II_R1-RR-Bianca_Andreescu-Lesia_Tsurenko,1,S-XC,5,0,0,0,0,1,4
20180421-W-Fed_Cup_World_Group_II_R1-RR-Bianca_Andreescu-Lesia_Tsurenko,1,S-DTM,3,0,0,0,0,0,3
20180421-W-Fed_Cup_World_Group_II_R1-RR-Bianca_Andreescu-Lesia_Tsurenko,1,S-IO,1,0,0,0,0,0,1
20180421-W-Fed_Cup_World_Group_II_R1-RR-Bianca_Andreescu-Lesia_Tsurenko,2,F-XC,61,15,4,6,5,43,18
20180421-W-Fed_Cup_World_Group_II_R1-RR-Bianca_Andreescu-Lesia_Tsurenko,2,F-DTM,48,3,0,1,2,33,15
20180421-W-Fed_Cup_World_Group_II_R1-RR-Bianca_Andreescu-Lesia_Tsurenko,2,F-DTL,12,3,0,1,2,8,4
20180421-W-Fed_Cup_World_Group_II_R1-RR-Bianca_Andreescu-Lesia_Tsurenko,2,F-IO,13,2,1,0,1,8,5
20180421-W-Fed_Cup_World_Group_II_R1-RR-Bianca_Andreescu-Lesia_Tsurenko,2,F-II,1,0,0,0,0,0,1
20180421-W-Fed_Cup_World_Group_II_R1-RR-Bianca_Andreescu-Lesia_Tsurenko,2,B-XC,46,8,2,1,5,27,19
20180421-W-Fed_Cup_World_Group_II_R1-RR-Bianca_Andreescu-Lesia_Tsurenko,2,B-DTM,49,3,0,0,3,31,18
20180421-W-Fed_Cup_World_Group_II_R1-RR-Bianca_Andreescu-Lesia_Tsurenko,2,B-DTL,10,3,3,0,0,7,3
20180421-W-Fed_Cup_World_Group_II_R1-RR-Bianca_Andreescu-Lesia_Tsurenko,2,B-IO,10,3,0,1,2,6,4
20180421-W-Fed_Cup_World_Group_II_R1-RR-Bianca_Andreescu-Lesia_Tsurenko,2,S-XC,6,1,0,0,1,3,3
20180421-W-Fed_Cup_World_Group_II_R1-RR-Bianca_Andreescu-Lesia_Tsurenko,2,S-DTM,7,1,1,0,0,2,5
20190209-W-Fed_Cup_World_Group_II_R1-RR-Francoise_Abanda-Arantxa_Rus,1,F-XC,138,23,2,11,10,72,66
20190209-W-Fed_Cup_World_Group_II_R1-RR-Francoise_Abanda-Arantxa_Rus,1,F-DTM,90,12,0,1,11,49,41
20190209-W-Fed_Cup_World_Group_II_R1-RR-Francoise_Abanda-Arantxa_Rus,1,F-DTL,18,10,4,1,5,8,10
20190209-W-Fed_Cup_World_Group_II_R1-RR-Francoise_Abanda-Arantxa_Rus,1,F-IO,22,16,2,5,9,11,11
20190209-W-Fed_Cup_World_Group_II_R1-RR-Francoise_Abanda-Arantxa_Rus,1,B-XC,74,9,3,2,4,44,30
20190209-W-Fed_Cup_World_Group_II_R1-RR-Francoise_Abanda-Arantxa_Rus,1,B-DTM,93,4,1,0,3,46,47
20190209-W-Fed_Cup_World_Group_II_R1-RR-Francoise_Abanda-Arantxa_Rus,1,B-DTL,15,6,1,2,3,6,9
20190209-W-Fed_Cup_World_Group_II_R1-RR-Francoise_Abanda-Arantxa_Rus,1,B-IO,10,4,1,1,2,6,4
20190209-W-Fed_Cup_World_Group_II_R1-RR-Francoise_Abanda-Arantxa_Rus,1,B-II,1,0,0,0,0,0,1
20190209-W-Fed_Cup_World_Group_II_R1-RR-Francoise_Abanda-Arantxa_Rus,1,S-XC,4,0,0,0,0,2,2
20190209-W-Fed_Cup_World_Group_II_R1-RR-Francoise_Abanda-Arantxa_Rus,1,S-DTM,4,0,0,0,0,1,3
20190209-W-Fed_Cup_World_Group_II_R1-RR-Francoise_Abanda-Arantxa_Rus,1,S-DTL,2,0,0,0,0,0,2
20190209-W-Fed_Cup_World_Group_II_R1-RR-Francoise_Abanda-Arantxa_Rus,2,F-XC,93,11,5,3,3,44,49
20190209-W-Fed_Cup_World_Group_II_R1-RR-Francoise_Abanda-Arantxa_Rus,2,F-DTM,65,3,1,0,2,29,36
20190209-W-Fed_Cup_World_Group_II_R1-RR-Francoise_Abanda-Arantxa_Rus,2,F-DTL,19,6,2,0,4,8,11
20190209-W-Fed_Cup_World_Group_II_R1-RR-Francoise_Abanda-Arantxa_Rus,2,F-IO,51,16,8,3,5,30,21
20190209-W-Fed_Cup_World_Group_II_R1-RR-Francoise_Abanda-Arantxa_Rus,2,F-II,1,0,0,0,0,1,0
20190209-W-Fed_Cup_World_Group_II_R1-RR-Francoise_Abanda-Arantxa_Rus,2,B-XC,69,10,1,2,7,33,36
20190209-W-Fed_Cup_World_Group_II_R1-RR-Francoise_Abanda-Arantxa_Rus,2,B-DTM,131,10,0,1,9,59,72
20190209-W-Fed_Cup_World_Group_II_R1-RR-Francoise_Abanda-Arantxa_Rus,2,B-DTL,16,8,1,2,5,6,10
20190209-W-Fed_Cup_World_Group_II_R1-RR-Francoise_Abanda-Arantxa_Rus,2,B-IO,8,2,0,0,2,2,6
20190209-W-Fed_Cup_World_Group_II_R1-RR-Francoise_Abanda-Arantxa_Rus,2,S-XC,4,2,1,0,1,3,1
20190209-W-Fed_Cup_World_Group_II_R1-RR-Francoise_Abanda-Arantxa_Rus,2,S-DTM,13,0,0,0,0,6,7
20190209-W-Fed_Cup_World_Group_II_R1-RR-Francoise_Abanda-Arantxa_Rus,2,S-DTL,2,1,1,0,0,1,1
20190427-W-Stuttgart-SF-Petra_Kvitova-Kiki_Bertens,1,F-XC,75,15,4,3,8,51,24
20190427-W-Stuttgart-SF-Petra_Kvitova-Kiki_Bertens,1,F-DTM,28,3,0,0,3,12,16
20190427-W-Stuttgart-SF-Petra_Kvitova-Kiki_Bertens,1,F-DTL,11,5,3,0,2,7,4
20190427-W-Stuttgart-SF-Petra_Kvitova-Kiki_Bertens,1,F-IO,15,7,3,2,2,11,4
20190427-W-Stuttgart-SF-Petra_Kvitova-Kiki_Bertens,1,F-II,1,1,1,0,0,1,0
20190427-W-Stuttgart-SF-Petra_Kvitova-Kiki_Bertens,1,B-XC,29,6,3,2,1,19,10
20190427-W-Stuttgart-SF-Petra_Kvitova-Kiki_Bertens,1,B-DTM,13,0,0,0,0,9,4
20190427-W-Stuttgart-SF-Petra_Kvitova-Kiki_Bertens,1,B-DTL,3,2,1,0,1,2,1
20190427-W-Stuttgart-SF-Petra_Kvitova-Kiki_Bertens,1,B-IO,6,2,1,0,1,5,1
20190427-W-Stuttgart-SF-Petra_Kvitova-Kiki_Bertens,1,S-XC,4,2,0,0,2,0,4
20190427-W-Stuttgart-SF-Petra_Kvitova-Kiki_Bertens,1,S-DTM,5,0,0,0,0,2,3
20190427-W-Stuttgart-SF-Petra_Kvitova-Kiki_Bertens,1,S-DTL,1,1,0,1,0,1,0
20190427-W-Stuttgart-SF-Petra_Kvitova-Kiki_Bertens,1,S-IO,3,0,0,0,0,2,1
20190427-W-Stuttgart-SF-Petra_Kvitova-Kiki_Bertens,2,F-XC,34,11,3,3,5,17,17
20190427-W-Stuttgart-SF-Petra_Kvitova-Kiki_Bertens,2,F-DTM,17,3,0,0,3,6,11
20190427-W-Stuttgart-SF-Petra_Kvitova-Kiki_Bertens,2,F-DTL,9,5,3,0,2,3,6
20190427-W-Stuttgart-SF-Petra_Kvitova-Kiki_Bertens,2,F-IO,6,6,3,0,3,3,3
20190427-W-Stuttgart-SF-Petra_Kvitova-Kiki_Bertens,2,B-XC,40,8,1,3,4,15,25
20190427-W-Stuttgart-SF-Petra_Kvitova-Kiki_Bertens,2,B-DTM,44,3,0,1,2,16,28
20190427-W-Stuttgart-SF-Petra_Kvitova-Kiki_Bertens,2,B-DTL,4,1,0,0,1,1,3
20190427-W-Stuttgart-SF-Petra_Kvitova-Kiki_Bertens,2,B-IO,5,2,0,0,2,3,2
20190427-W-Stuttgart-SF-Petra_Kvitova-Kiki_Bertens,2,S-XC,14,1,0,0,1,7,7
20190427-W-Stuttgart-SF-Petra_Kvitova-Kiki_Bertens,2,S-DTM,5,1,0,0,1,0,5
20190427-W-Stuttgart-SF-Petra_Kvitova-Kiki_Bertens,2,S-DTL,1,0,0,0,0,0,1
20190427-W-Stuttgart-SF-Petra_Kvitova-Kiki_Bertens,2,S-IO,1,1,0,0,1,0,1
20190425-W-Stuttgart-R16-Laura_Siegemund-Anastasija_Sevastova,1,F-XC,22,6,1,1,4,8,14
20190425-W-Stuttgart-R16-Laura_Siegemund-Anastasija_Sevastova,1,F-DTM,19,2,0,0,2,7,12
20190425-W-Stuttgart-R16-Laura_Siegemund-Anastasija_Sevastova,1,F-DTL,7,3,1,0,2,4,3
20190425-W-Stuttgart-R16-Laura_Siegemund-Anastasija_Sevastova,1,F-IO,8,4,0,0,4,3,5
20190425-W-Stuttgart-R16-Laura_Siegemund-Anastasija_Sevastova,1,B-XC,22,3,0,1,2,14,8
20190425-W-Stuttgart-R16-Laura_Siegemund-Anastasija_Sevastova,1,B-DTM,31,5,0,0,5,12,19
20190425-W-Stuttgart-R16-Laura_Siegemund-Anastasija_Sevastova,1,B-DTL,8,5,2,1,2,4,4
20190425-W-Stuttgart-R16-Laura_Siegemund-Anastasija_Sevastova,1,B-IO,8,6,1,2,3,5,3
20190425-W-Stuttgart-R16-Laura_Siegemund-Anastasija_Sevastova,1,S-XC,3,0,0,0,0,1,2
20190425-W-Stuttgart-R16-Laura_Siegemund-Anastasija_Sevastova,1,S-DTM,3,0,0,0,0,1,2
20190425-W-Stuttgart-R16-Laura_Siegemund-Anastasija_Sevastova,2,F-XC,27,12,2,4,6,18,9
20190425-W-Stuttgart-R16-Laura_Siegemund-Anastasija_Sevastova,2,F-DTM,20,4,0,0,4,8,12
20190425-W-Stuttgart-R16-Laura_Siegemund-Anastasija_Sevastova,2,F-DTL,8,6,3,1,2,5,3
20190425-W-Stuttgart-R16-Laura_Siegemund-Anastasija_Sevastova,2,F-IO,16,9,2,1,6,6,10
20190425-W-Stuttgart-R16-Laura_Siegemund-Anastasija_Sevastova,2,B-XC,30,10,0,2,8,16,14
20190425-W-Stuttgart-R16-Laura_Siegemund-Anastasija_Sevastova,2,B-DTM,25,4,0,0,4,11,14
20190425-W-Stuttgart-R16-Laura_Siegemund-Anastasija_Sevastova,2,B-DTL,2,1,0,0,1,0,2
20190425-W-Stuttgart-R16-Laura_Siegemund-Anastasija_Sevastova,2,B-IO,4,3,1,0,2,2,2
20190425-W-Stuttgart-R16-Laura_Siegemund-Anastasija_Sevastova,2,S-XC,1,0,0,0,0,0,1
20190425-W-Stuttgart-R16-Laura_Siegemund-Anastasija_Sevastova,2,S-DTL,2,0,0,0,0,1,1
20190501-W-Rabat-R16-Su_Wei_Hsieh-Lara_Arruabarrena,1,F-XC,57,21,9,5,7,32,25
20190501-W-Rabat-R16-Su_Wei_Hsieh-Lara_Arruabarrena,1,F-DTM,13,1,0,0,1,6,7
20190501-W-Rabat-R16-Su_Wei_Hsieh-Lara_Arruabarrena,1,F-DTL,11,5,1,1,3,5,6
20190501-W-Rabat-R16-Su_Wei_Hsieh-Lara_Arruabarrena,1,F-IO,20,11,4,4,3,13,7
20190501-W-Rabat-R16-Su_Wei_Hsieh-Lara_Arruabarrena,1,B-XC,117,16,6,4,6,63,54
20190501-W-Rabat-R16-Su_Wei_Hsieh-Lara_Arruabarrena,1,B-DTM,29,1,0,0,1,13,16
20190501-W-Rabat-R16-Su_Wei_Hsieh-Lara_Arruabarrena,1,B-DTL,29,13,4,3,6,18,11
20190501-W-Rabat-R16-Su_Wei_Hsieh-Lara_Arruabarrena,1,B-IO,17,9,6,1,2,11,6
20190501-W-Rabat-R16-Su_Wei_Hsieh-Lara_Arruabarrena,1,S-XC,9,0,0,0,0,3,6
20190501-W-Rabat-R16-Su_Wei_Hsieh-Lara_Arruabarrena,1,S-DTM,2,0,0,0,0,0,2
20190501-W-Rabat-R16-Su_Wei_Hsieh-Lara_Arruabarrena,1,S-DTL,4,0,0,0,0,2,2
20190501-W-Rabat-R16-Su_Wei_Hsieh-Lara_Arruabarrena,2,F-XC,33,7,0,6,1,20,13
20190501-W-Rabat-R16-Su_Wei_Hsieh-Lara_Arruabarrena,2,F-DTM,24,2,2,0,0,11,13
20190501-W-Rabat-R16-Su_Wei_Hsieh-Lara_Arruabarrena,2,F-DTL,27,9,1,3,5,12,15
20190501-W-Rabat-R16-Su_Wei_Hsieh-Lara_Arruabarrena,2,F-IO,32,7,4,2,1,21,11
20190501-W-Rabat-R16-Su_Wei_Hsieh-Lara_Arruabarrena,2,F-II,5,1,1,0,0,2,3
20190501-W-Rabat-R16-Su_Wei_Hsieh-Lara_Arruabarrena,2,B-XC,35,5,1,1,3,15,20
20190501-W-Rabat-R16-Su_Wei_Hsieh-Lara_Arruabarrena,2,B-DTM,35,2,0,0,2,20,15
20190501-W-Rabat-R16-Su_Wei_Hsieh-Lara_Arruabarrena,2,B-DTL,20,8,3,2,3,12,8
20190501-W-Rabat-R16-Su_Wei_Hsieh-Lara_Arruabarrena,2,B-IO,3,1,0,1,0,2,1
20190501-W-Rabat-R16-Su_Wei_Hsieh-Lara_Arruabarrena,2,S-XC,38,6,1,1,4,12,26
20190501-W-Rabat-R16-Su_Wei_Hsieh-Lara_Arruabarrena,2,S-DTM,14,0,0,0,0,5,9
20190501-W-Rabat-R16-Su_Wei_Hsieh-Lara_Arruabarrena,2,S-DTL,15,1,0,0,1,8,7
20190501-W-Rabat-R16-Su_Wei_Hsieh-Lara_Arruabarrena,2,S-IO,1,0,0,0,0,1,0
20190429-W-Rabat-R32-Yulia_Putintseva-Tamara_Zidansek,1,F-XC,53,19,2,9,8,27,26
20190429-W-Rabat-R32-Yulia_Putintseva-Tamara_Zidansek,1,F-DTM,43,3,2,0,1,18,25
20190429-W-Rabat-R32-Yulia_Putintseva-Tamara_Zidansek,1,F-DTL,28,2,0,0,2,9,19
20190429-W-Rabat-R32-Yulia_Putintseva-Tamara_Zidansek,1,F-IO,27,2,0,1,1,9,18
20190429-W-Rabat-R32-Yulia_Putintseva-Tamara_Zidansek,1,F-II,2,0,0,0,0,0,2
20190429-W-Rabat-R32-Yulia_Putintseva-Tamara_Zidansek,1,B-XC,53,10,2,3,5,29,24
20190429-W-Rabat-R32-Yulia_Putintseva-Tamara_Zidansek,1,B-DTM,38,5,0,3,2,16,22
20190429-W-Rabat-R32-Yulia_Putintseva-Tamara_Zidansek,1,B-DTL,12,6,3,0,3,6,6
20190429-W-Rabat-R32-Yulia_Putintseva-Tamara_Zidansek,1,B-IO,5,1,0,0,1,4,1
20190429-W-Rabat-R32-Yulia_Putintseva-Tamara_Zidansek,1,B-II,1,1,0,1,0,1,0
20190429-W-Rabat-R32-Yulia_Putintseva-Tamara_Zidansek,1,S-XC,18,1,1,0,0,9,9
20190429-W-Rabat-R32-Yulia_Putintseva-Tamara_Zidansek,1,S-DTM,14,0,0,0,0,7,7
20190429-W-Rabat-R32-Yulia_Putintseva-Tamara_Zidansek,1,S-DTL,7,1,0,1,0,3,4
20190429-W-Rabat-R32-Yulia_Putintseva-Tamara_Zidansek,1,S-IO,1,0,0,0,0,1,0
20190429-W-Rabat-R32-Yulia_Putintseva-Tamara_Zidansek,2,F-XC,72,16,8,3,5,43,29
20190429-W-Rabat-R32-Yulia_Putintseva-Tamara_Zidansek,2,F-DTM,29,3,0,1,2,20,9
20190429-W-Rabat-R32-Yulia_Putintseva-Tamara_Zidansek,2,F-DTL,9,6,2,1,3,6,3
20190429-W-Rabat-R32-Yulia_Putintseva-Tamara_Zidansek,2,F-IO,41,14,6,4,4,26,15
20190429-W-Rabat-R32-Yulia_Putintseva-Tamara_Zidansek,2,F-II,3,2,0,1,1,1,2
20190429-W-Rabat-R32-Yulia_Putintseva-Tamara_Zidansek,2,B-XC,67,11,4,1,6,39,28
20190429-W-Rabat-R32-Yulia_Putintseva-Tamara_Zidansek,2,B-DTM,66,4,0,0,4,33,33
20190429-W-Rabat-R32-Yulia_Putintseva-Tamara_Zidansek,2,B-DTL,14,4,2,0,2,7,7
20190429-W-Rabat-R32-Yulia_Putintseva-Tamara_Zidansek,2,B-IO,6,4,1,1,2,3,3
20190429-W-Rabat-R32-Yulia_Putintseva-Tamara_Zidansek,2,S-XC,7,1,0,0,1,1,6
20190429-W-Rabat-R32-Yulia_Putintseva-Tamara_Zidansek,2,S-DTM,9,1,0,0,1,4,5
20190429-W-Rabat-R32-Yulia_Putintseva-Tamara_Zidansek,2,S-DTL,2,0,0,0,0,1,1
20190429-W-Rabat-R32-Yulia_Putintseva-Tamara_Zidansek,2,S-IO,1,0,0,0,0,1,0
20180408-W-ITF_Kashiwa-F-Luksika_Kumkhum-Bianca_Andreescu,1,F-XC,38,16,9,4,3,27,11
20180408-W-ITF_Kashiwa-F-Luksika_Kumkhum-Bianca_Andreescu,1,F-DTM,38,2,0,2,0,23,15
20180408-W-ITF_Kashiwa-F-Luksika_Kumkhum-Bianca_Andreescu,1,F-DTL,10,7,2,0,5,4,6
20180408-W-ITF_Kashiwa-F-Luksika_Kumkhum-Bianca_Andreescu,1,F-IO,11,5,1,0,4,3,8
20180408-W-ITF_Kashiwa-F-Luksika_Kumkhum-Bianca_Andreescu,1,F-II,1,0,0,0,0,0,1
20180408-W-ITF_Kashiwa-F-Luksika_Kumkhum-Bianca_Andreescu,1,B-XC,59,9,2,3,4,28,31
20180408-W-ITF_Kashiwa-F-Luksika_Kumkhum-Bianca_Andreescu,1,B-DTM,24,3,0,1,2,15,9
20180408-W-ITF_Kashiwa-F-Luksika_Kumkhum-Bianca_Andreescu,1,B-DTL,4,3,2,0,1,3,1
20180408-W-ITF_Kashiwa-F-Luksika_Kumkhum-Bianca_Andreescu,1,B-IO,5,4,0,2,2,2,3
20180408-W-ITF_Kashiwa-F-Luksika_Kumkhum-Bianca_Andreescu,1,S-XC,5,0,0,0,0,2,3
20180408-W-ITF_Kashiwa-F-Luksika_Kumkhum-Bianca_Andreescu,1,S-DTM,1,0,0,0,0,0,1
20180408-W-ITF_Kashiwa-F-Luksika_Kumkhum-Bianca_Andreescu,2,F-XC,31,6,2,3,1,16,15
20180408-W-ITF_Kashiwa-F-Luksika_Kumkhum-Bianca_Andreescu,2,F-DTM,23,4,0,1,3,10,13
20180408-W-ITF_Kashiwa-F-Luksika_Kumkhum-Bianca_Andreescu,2,F-DTL,4,2,0,0,2,1,3
20180408-W-ITF_Kashiwa-F-Luksika_Kumkhum-Bianca_Andreescu,2,F-IO,19,6,1,1,4,7,12
20180408-W-ITF_Kashiwa-F-Luksika_Kumkhum-Bianca_Andreescu,2,F-II,5,4,3,0,1,3,2
20180408-W-ITF_Kashiwa-F-Luksika_Kumkhum-Bianca_Andreescu,2,B-XC,32,1,1,0,0,20,12
20180408-W-ITF_Kashiwa-F-Luksika_Kumkhum-Bianca_Andreescu,2,B-DTM,34,4,0,0,4,12,22
20180408-W-ITF_Kashiwa-F-Luksika_Kumkhum-Bianca_Andreescu,2,B-DTL,5,4,3,1,0,4,1
20180408-W-ITF_Kashiwa-F-Luksika_Kumkhum-Bianca_Andreescu,2,B-IO,5,3,1,1,1,4,1
20180408-W-ITF_Kashiwa-F-Luksika_Kumkhum-Bianca_Andreescu,2,S-XC,3,0,0,0,0,3,0
20180408-W-ITF_Kashiwa-F-Luksika_Kumkhum-Bianca_Andreescu,2,S-DTM,8,1,0,0,1,2,6
20180408-W-ITF_Kashiwa-F-Luksika_Kumkhum-Bianca_Andreescu,2,S-DTL,1,0,0,0,0,1,0
20180408-W-ITF_Kashiwa-F-Luksika_Kumkhum-Bianca_Andreescu,2,S-IO,1,0,0,0,0,0,1
20190504-W-Madrid-R64-Kiki_Bertens-Katerina_Siniakova,1,F-XC,37,9,2,3,4,18,19
20190504-W-Madrid-R64-Kiki_Bertens-Katerina_Siniakova,1,F-DTM,6,3,1,0,2,4,2
20190504-W-Madrid-R64-Kiki_Bertens-Katerina_Siniakova,1,F-DTL,7,6,2,1,3,3,4
20190504-W-Madrid-R64-Kiki_Bertens-Katerina_Siniakova,1,F-IO,7,5,0,0,5,2,5
20190504-W-Madrid-R64-Kiki_Bertens-Katerina_Siniakova,1,B-XC,13,1,0,0,1,5,8
20190504-W-Madrid-R64-Kiki_Bertens-Katerina_Siniakova,1,B-DTM,26,2,0,1,1,17,9
20190504-W-Madrid-R64-Kiki_Bertens-Katerina_Siniakova,1,B-DTL,4,2,1,0,1,1,3
20190504-W-Madrid-R64-Kiki_Bertens-Katerina_Siniakova,1,B-IO,1,0,0,0,0,0,1
20190504-W-Madrid-R64-Kiki_Bertens-Katerina_Siniakova,1,S-XC,2,0,0,0,0,0,2
20190504-W-Madrid-R64-Kiki_Bertens-Katerina_Siniakova,1,S-DTM,8,1,1,0,0,2,6
20190504-W-Madrid-R64-Kiki_Bertens-Katerina_Siniakova,2,F-XC,21,5,0,3,2,12,9
20190504-W-Madrid-R64-Kiki_Bertens-Katerina_Siniakova,2,F-DTM,21,4,0,0,4,8,13
20190504-W-Madrid-R64-Kiki_Bertens-Katerina_Siniakova,2,F-DTL,7,3,1,1,1,6,1
20190504-W-Madrid-R64-Kiki_Bertens-Katerina_Siniakova,2,F-IO,6,2,0,0,2,1,5
20190504-W-Madrid-R64-Kiki_Bertens-Katerina_Siniakova,2,B-XC,20,3,1,1,1,13,7
20190504-W-Madrid-R64-Kiki_Bertens-Katerina_Siniakova,2,B-DTM,18,2,1,0,1,8,10
20190504-W-Madrid-R64-Kiki_Bertens-Katerina_Siniakova,2,B-DTL,5,1,1,0,0,3,2
20190504-W-Madrid-R64-Kiki_Bertens-Katerina_Siniakova,2,B-IO,5,1,0,0,1,2,3
20190504-W-Madrid-R64-Kiki_Bertens-Katerina_Siniakova,2,S-XC,1,0,0,0,0,0,1
20190504-W-Madrid-R64-Kiki_Bertens-Katerina_Siniakova,2,S-DTM,2,1,0,0,1,1,1
20190504-W-Madrid-R64-Kiki_Bertens-Katerina_Siniakova,2,S-DTL,1,0,0,0,0,0,1
20190504-W-Madrid-R64-Kiki_Bertens-Katerina_Siniakova,2,S-IO,1,0,0,0,0,0,1
20190405-W-Madrid-R64-Naomi_Osaka-Dominika_Cibulkova,1,F-XC,48,17,7,3,7,29,19
20190405-W-Madrid-R64-Naomi_Osaka-Dominika_Cibulkova,1,F-DTM,16,2,0,0,2,7,9
20190405-W-Madrid-R64-Naomi_Osaka-Dominika_Cibulkova,1,F-DTL,9,3,2,1,0,7,2
20190405-W-Madrid-R64-Naomi_Osaka-Dominika_Cibulkova,1,F-IO,13,7,4,1,2,8,5
20190405-W-Madrid-R64-Naomi_Osaka-Dominika_Cibulkova,1,F-II,2,1,1,0,0,1,1
20190405-W-Madrid-R64-Naomi_Osaka-Dominika_Cibulkova,1,B-XC,35,5,2,2,1,16,19
20190405-W-Madrid-R64-Naomi_Osaka-Dominika_Cibulkova,1,B-DTM,23,2,0,0,2,5,18
20190405-W-Madrid-R64-Naomi_Osaka-Dominika_Cibulkova,1,B-DTL,14,8,2,1,5,6,8
20190405-W-Madrid-R64-Naomi_Osaka-Dominika_Cibulkova,1,B-IO,14,6,2,0,4,9,5
20190405-W-Madrid-R64-Naomi_Osaka-Dominika_Cibulkova,1,S-XC,2,0,0,0,0,0,2
20190405-W-Madrid-R64-Naomi_Osaka-Dominika_Cibulkova,1,S-DTM,1,0,0,0,0,1,0
20190405-W-Madrid-R64-Naomi_Osaka-Dominika_Cibulkova,2,F-XC,25,5,2,2,1,9,16
20190405-W-Madrid-R64-Naomi_Osaka-Dominika_Cibulkova,2,F-DTM,32,2,0,0,2,12,20
20190405-W-Madrid-R64-Naomi_Osaka-Dominika_Cibulkova,2,F-DTL,16,4,1,1,2,9,7
20190405-W-Madrid-R64-Naomi_Osaka-Dominika_Cibulkova,2,F-IO,16,5,3,1,1,13,3
20190405-W-Madrid-R64-Naomi_Osaka-Dominika_Cibulkova,2,F-II,2,2,2,0,0,2,0
20190405-W-Madrid-R64-Naomi_Osaka-Dominika_Cibulkova,2,B-XC,15,1,0,0,1,8,7
20190405-W-Madrid-R64-Naomi_Osaka-Dominika_Cibulkova,2,B-DTM,19,2,1,0,1,8,11
20190405-W-Madrid-R64-Naomi_Osaka-Dominika_Cibulkova,2,B-DTL,6,5,1,2,2,3,3
20190405-W-Madrid-R64-Naomi_Osaka-Dominika_Cibulkova,2,B-IO,3,1,1,0,0,2,1
20190405-W-Madrid-R64-Naomi_Osaka-Dominika_Cibulkova,2,S-XC,9,0,0,0,0,7,2
20190405-W-Madrid-R64-Naomi_Osaka-Dominika_Cibulkova,2,S-DTM,6,1,0,0,1,3,3
20190405-W-Madrid-R64-Naomi_Osaka-Dominika_Cibulkova,2,S-DTL,1,0,0,0,0,0,1
20190505-W-Madrid-R64-Maria_Sakkari-Carla_Suarez_Navarro,1,F-XC,36,13,2,5,6,16,20
20190505-W-Madrid-R64-Maria_Sakkari-Carla_Suarez_Navarro,1,F-DTM,30,2,0,0,2,13,17
20190505-W-Madrid-R64-Maria_Sakkari-Carla_Suarez_Navarro,1,F-DTL,8,2,0,0,2,4,4
20190505-W-Madrid-R64-Maria_Sakkari-Carla_Suarez_Navarro,1,F-IO,21,6,0,1,5,10,11
20190505-W-Madrid-R64-Maria_Sakkari-Carla_Suarez_Navarro,1,F-II,1,1,0,0,1,0,1
20190505-W-Madrid-R64-Maria_Sakkari-Carla_Suarez_Navarro,1,B-XC,42,8,2,3,3,16,26
20190505-W-Madrid-R64-Maria_Sakkari-Carla_Suarez_Navarro,1,B-DTM,24,3,0,0,3,8,16
20190505-W-Madrid-R64-Maria_Sakkari-Carla_Suarez_Navarro,1,B-DTL,5,2,1,0,1,2,3
20190505-W-Madrid-R64-Maria_Sakkari-Carla_Suarez_Navarro,1,B-IO,2,1,0,0,1,1,1
20190505-W-Madrid-R64-Maria_Sakkari-Carla_Suarez_Navarro,1,S-XC,2,0,0,0,0,0,2
20190505-W-Madrid-R64-Maria_Sakkari-Carla_Suarez_Navarro,1,S-DTM,1,0,0,0,0,1,0
20190505-W-Madrid-R64-Maria_Sakkari-Carla_Suarez_Navarro,1,S-DTL,2,1,1,0,0,1,1
20190505-W-Madrid-R64-Maria_Sakkari-Carla_Suarez_Navarro,2,F-XC,43,11,2,8,1,27,16
20190505-W-Madrid-R64-Maria_Sakkari-Carla_Suarez_Navarro,2,F-DTM,28,2,0,0,2,10,18
20190505-W-Madrid-R64-Maria_Sakkari-Carla_Suarez_Navarro,2,F-DTL,10,4,2,1,1,8,2
20190505-W-Madrid-R64-Maria_Sakkari-Carla_Suarez_Navarro,2,F-IO,26,8,3,0,5,11,15
20190505-W-Madrid-R64-Maria_Sakkari-Carla_Suarez_Navarro,2,F-II,5,3,1,1,1,4,1
20190505-W-Madrid-R64-Maria_Sakkari-Carla_Suarez_Navarro,2,B-XC,33,7,0,2,5,21,12
20190505-W-Madrid-R64-Maria_Sakkari-Carla_Suarez_Navarro,2,B-DTM,31,4,0,1,3,17,14
20190505-W-Madrid-R64-Maria_Sakkari-Carla_Suarez_Navarro,2,B-DTL,4,4,0,1,3,1,3
20190505-W-Madrid-R64-Maria_Sakkari-Carla_Suarez_Navarro,2,S-XC,2,0,0,0,0,1,1
20190505-W-Madrid-R64-Maria_Sakkari-Carla_Suarez_Navarro,2,S-DTM,2,1,0,0,1,0,2
20190504-W-Prague-F-Jil_Teichmann-Karolina_Muchova,1,F-XC,118,16,4,3,9,67,51
20190504-W-Prague-F-Jil_Teichmann-Karolina_Muchova,1,F-DTM,55,6,1,1,4,31,24
20190504-W-Prague-F-Jil_Teichmann-Karolina_Muchova,1,F-DTL,6,3,0,1,2,4,2
20190504-W-Prague-F-Jil_Teichmann-Karolina_Muchova,1,F-IO,15,6,3,0,3,5,10
20190504-W-Prague-F-Jil_Teichmann-Karolina_Muchova,1,F-II,1,1,0,0,1,0,1
20190504-W-Prague-F-Jil_Teichmann-Karolina_Muchova,1,B-XC,49,8,2,2,4,27,22
20190504-W-Prague-F-Jil_Teichmann-Karolina_Muchova,1,B-DTM,57,2,0,1,1,28,29
20190504-W-Prague-F-Jil_Teichmann-Karolina_Muchova,1,B-DTL,20,6,0,3,3,7,13
20190504-W-Prague-F-Jil_Teichmann-Karolina_Muchova,1,B-IO,15,2,0,0,2,3,12
20190504-W-Prague-F-Jil_Teichmann-Karolina_Muchova,1,S-XC,11,0,0,0,0,7,4
20190504-W-Prague-F-Jil_Teichmann-Karolina_Muchova,1,S-DTM,21,3,0,0,3,10,11
20190504-W-Prague-F-Jil_Teichmann-Karolina_Muchova,1,S-DTL,7,2,0,0,2,2,5
20190504-W-Prague-F-Jil_Teichmann-Karolina_Muchova,1,S-IO,2,0,0,0,0,1,1
20190504-W-Prague-F-Jil_Teichmann-Karolina_Muchova,2,F-XC,86,19,3,5,11,40,46
20190504-W-Prague-F-Jil_Teichmann-Karolina_Muchova,2,F-DTM,43,3,0,0,3,22,21
20190504-W-Prague-F-Jil_Teichmann-Karolina_Muchova,2,F-DTL,15,9,0,4,5,5,10
20190504-W-Prague-F-Jil_Teichmann-Karolina_Muchova,2,F-IO,23,8,2,0,6,9,14
20190504-W-Prague-F-Jil_Teichmann-Karolina_Muchova,2,F-II,11,6,3,0,3,4,7
20190504-W-Prague-F-Jil_Teichmann-Karolina_Muchova,2,B-XC,65,12,2,3,7,35,30
20190504-W-Prague-F-Jil_Teichmann-Karolina_Muchova,2,B-DTM,63,6,0,0,6,21,42
20190504-W-Prague-F-Jil_Teichmann-Karolina_Muchova,2,B-DTL,18,8,2,0,6,11,7
20190504-W-Prague-F-Jil_Teichmann-Karolina_Muchova,2,B-IO,10,3,0,1,2,6,4
20190504-W-Prague-F-Jil_Teichmann-Karolina_Muchova,2,S-XC,13,2,0,1,1,6,7
20190504-W-Prague-F-Jil_Teichmann-Karolina_Muchova,2,S-DTM,18,0,0,0,0,11,7
20190504-W-Prague-F-Jil_Teichmann-Karolina_Muchova,2,S-DTL,9,3,0,3,0,6,3
20190504-W-Prague-F-Jil_Teichmann-Karolina_Muchova,2,S-IO,7,0,0,0,0,2,5
20190504-W-Madrid-R64-Anett_Kontaveit-Aliaksandra_Sasnovich,1,F-XC,25,11,3,3,5,12,13
20190504-W-Madrid-R64-Anett_Kontaveit-Aliaksandra_Sasnovich,1,F-DTM,14,1,0,0,1,2,12
20190504-W-Madrid-R64-Anett_Kontaveit-Aliaksandra_Sasnovich,1,F-DTL,5,2,0,0,2,1,4
20190504-W-Madrid-R64-Anett_Kontaveit-Aliaksandra_Sasnovich,1,F-IO,4,3,2,0,1,3,1
20190504-W-Madrid-R64-Anett_Kontaveit-Aliaksandra_Sasnovich,1,B-XC,27,5,1,2,2,9,18
20190504-W-Madrid-R64-Anett_Kontaveit-Aliaksandra_Sasnovich,1,B-DTM,11,1,0,0,1,3,8
20190504-W-Madrid-R64-Anett_Kontaveit-Aliaksandra_Sasnovich,1,B-DTL,8,4,1,0,3,4,4
20190504-W-Madrid-R64-Anett_Kontaveit-Aliaksandra_Sasnovich,1,B-IO,5,3,1,1,1,3,2
20190504-W-Madrid-R64-Anett_Kontaveit-Aliaksandra_Sasnovich,1,S-XC,3,1,1,0,0,1,2
20190504-W-Madrid-R64-Anett_Kontaveit-Aliaksandra_Sasnovich,1,S-DTM,2,0,0,0,0,1,1
20190504-W-Madrid-R64-Anett_Kontaveit-Aliaksandra_Sasnovich,2,F-XC,17,5,3,0,2,11,6
20190504-W-Madrid-R64-Anett_Kontaveit-Aliaksandra_Sasnovich,2,F-DTM,15,1,1,0,0,10,5
20190504-W-Madrid-R64-Anett_Kontaveit-Aliaksandra_Sasnovich,2,F-DTL,5,2,0,2,0,4,1
20190504-W-Madrid-R64-Anett_Kontaveit-Aliaksandra_Sasnovich,2,F-IO,5,1,1,0,0,4,1
20190504-W-Madrid-R64-Anett_Kontaveit-Aliaksandra_Sasnovich,2,F-II,1,0,0,0,0,0,1
20190504-W-Madrid-R64-Anett_Kontaveit-Aliaksandra_Sasnovich,2,B-XC,21,7,4,2,1,17,4
20190504-W-Madrid-R64-Anett_Kontaveit-Aliaksandra_Sasnovich,2,B-DTM,16,0,0,0,0,10,6
20190504-W-Madrid-R64-Anett_Kontaveit-Aliaksandra_Sasnovich,2,B-DTL,8,6,4,0,2,5,3
20190504-W-Madrid-R64-Anett_Kontaveit-Aliaksandra_Sasnovich,2,B-IO,4,3,1,0,2,2,2
20190504-W-Madrid-R64-Anett_Kontaveit-Aliaksandra_Sasnovich,2,S-XC,2,0,0,0,0,2,0
20190504-W-Madrid-R64-Anett_Kontaveit-Aliaksandra_Sasnovich,2,S-DTM,2,1,0,0,1,1,1
20190509-W-Madrid-QF-Petra_Kvitova-Kiki_Bertens,1,F-XC,41,8,4,2,2,16,25
20190509-W-Madrid-QF-Petra_Kvitova-Kiki_Bertens,1,F-DTM,25,4,0,0,4,5,20
20190509-W-Madrid-QF-Petra_Kvitova-Kiki_Bertens,1,F-DTL,1,1,0,0,1,0,1
20190509-W-Madrid-QF-Petra_Kvitova-Kiki_Bertens,1,F-IO,8,4,1,2,1,5,3
20190509-W-Madrid-QF-Petra_Kvitova-Kiki_Bertens,1,F-II,1,1,1,0,0,1,0
20190509-W-Madrid-QF-Petra_Kvitova-Kiki_Bertens,1,B-XC,37,9,1,0,8,15,22
20190509-W-Madrid-QF-Petra_Kvitova-Kiki_Bertens,1,B-DTM,22,3,0,0,3,7,15
20190509-W-Madrid-QF-Petra_Kvitova-Kiki_Bertens,1,B-DTL,4,2,1,0,1,2,2
20190509-W-Madrid-QF-Petra_Kvitova-Kiki_Bertens,1,B-IO,7,4,0,1,3,3,4
20190509-W-Madrid-QF-Petra_Kvitova-Kiki_Bertens,1,S-XC,1,0,0,0,0,0,1
20190509-W-Madrid-QF-Petra_Kvitova-Kiki_Bertens,1,S-DTL,2,1,0,0,1,0,2
20190509-W-Madrid-QF-Petra_Kvitova-Kiki_Bertens,2,F-XC,34,6,2,4,0,22,12
20190509-W-Madrid-QF-Petra_Kvitova-Kiki_Bertens,2,F-DTM,24,4,1,1,2,12,12
20190509-W-Madrid-QF-Petra_Kvitova-Kiki_Bertens,2,F-DTL,3,2,1,0,1,2,1
20190509-W-Madrid-QF-Petra_Kvitova-Kiki_Bertens,2,F-IO,9,2,2,0,0,7,2
20190509-W-Madrid-QF-Petra_Kvitova-Kiki_Bertens,2,B-XC,15,3,1,2,0,12,3
20190509-W-Madrid-QF-Petra_Kvitova-Kiki_Bertens,2,B-DTM,30,7,0,1,6,16,14
20190509-W-Madrid-QF-Petra_Kvitova-Kiki_Bertens,2,B-DTL,3,0,0,0,0,1,2
20190509-W-Madrid-QF-Petra_Kvitova-Kiki_Bertens,2,B-IO,2,1,0,1,0,2,0
20190509-W-Madrid-QF-Petra_Kvitova-Kiki_Bertens,2,S-XC,5,2,0,2,0,5,0
20190509-W-Madrid-QF-Petra_Kvitova-Kiki_Bertens,2,S-DTM,5,0,0,0,0,3,2
20190506-W-Madrid-R32-Kiki_Bertens-Jelena_Ostapenko,1,F-XC,29,9,2,4,3,19,10
20190506-W-Madrid-R32-Kiki_Bertens-Jelena_Ostapenko,1,F-DTM,15,2,0,0,2,6,9
20190506-W-Madrid-R32-Kiki_Bertens-Jelena_Ostapenko,1,F-DTL,5,1,0,0,1,3,2
20190506-W-Madrid-R32-Kiki_Bertens-Jelena_Ostapenko,1,F-IO,5,2,1,1,0,4,1
20190506-W-Madrid-R32-Kiki_Bertens-Jelena_Ostapenko,1,B-XC,8,1,1,0,0,4,4
20190506-W-Madrid-R32-Kiki_Bertens-Jelena_Ostapenko,1,B-DTM,10,0,0,0,0,6,4
20190506-W-Madrid-R32-Kiki_Bertens-Jelena_Ostapenko,1,B-DTL,5,2,1,0,1,3,2
20190506-W-Madrid-R32-Kiki_Bertens-Jelena_Ostapenko,1,B-IO,1,0,0,0,0,0,1
20190506-W-Madrid-R32-Kiki_Bertens-Jelena_Ostapenko,1,S-XC,4,0,0,0,0,3,1
20190506-W-Madrid-R32-Kiki_Bertens-Jelena_Ostapenko,1,S-DTM,16,1,0,0,1,8,8
20190506-W-Madrid-R32-Kiki_Bertens-Jelena_Ostapenko,1,S-DTL,1,0,0,0,0,0,1
20190506-W-Madrid-R32-Kiki_Bertens-Jelena_Ostapenko,2,F-XC,36,10,2,5,3,14,22
20190506-W-Madrid-R32-Kiki_Bertens-Jelena_Ostapenko,2,F-DTM,6,1,0,0,1,2,4
20190506-W-Madrid-R32-Kiki_Bertens-Jelena_Ostapenko,2,F-DTL,14,8,3,2,3,7,7
20190506-W-Madrid-R32-Kiki_Bertens-Jelena_Ostapenko,2,F-IO,15,10,1,4,5,6,9
20190506-W-Madrid-R32-Kiki_Bertens-Jelena_Ostapenko,2,B-XC,24,5,1,2,2,13,11
20190506-W-Madrid-R32-Kiki_Bertens-Jelena_Ostapenko,2,B-DTM,12,2,0,0,2,4,8
20190506-W-Madrid-R32-Kiki_Bertens-Jelena_Ostapenko,2,B-DTL,5,4,1,1,2,2,3
20190506-W-Madrid-R32-Kiki_Bertens-Jelena_Ostapenko,2,B-IO,4,2,0,0,2,1,3
20190506-W-Madrid-R32-Kiki_Bertens-Jelena_Ostapenko,2,S-DTL,1,1,0,0,1,0,1
20190508-W-Madrid-R16-Anastasija_Sevastova-Kiki_Bertens,1,F-XC,35,13,4,2,7,14,21
20190508-W-Madrid-R16-Anastasija_Sevastova-Kiki_Bertens,1,F-DTM,23,0,0,0,0,8,15
20190508-W-Madrid-R16-Anastasija_Sevastova-Kiki_Bertens,1,F-DTL,9,3,2,0,1,6,3
20190508-W-Madrid-R16-Anastasija_Sevastova-Kiki_Bertens,1,F-IO,14,2,1,0,1,8,6
20190508-W-Madrid-R16-Anastasija_Sevastova-Kiki_Bertens,1,F-II,1,1,0,1,0,1,0
20190508-W-Madrid-R16-Anastasija_Sevastova-Kiki_Bertens,1,B-XC,22,3,0,1,2,9,13
20190508-W-Madrid-R16-Anastasija_Sevastova-Kiki_Bertens,1,B-DTM,13,2,0,0,2,1,12
20190508-W-Madrid-R16-Anastasija_Sevastova-Kiki_Bertens,1,B-DTL,3,2,1,0,1,2,1
20190508-W-Madrid-R16-Anastasija_Sevastova-Kiki_Bertens,1,B-IO,1,1,0,0,1,0,1
20190508-W-Madrid-R16-Anastasija_Sevastova-Kiki_Bertens,1,S-XC,1,0,0,0,0,1,0
20190508-W-Madrid-R16-Anastasija_Sevastova-Kiki_Bertens,1,S-DTM,3,1,0,0,1,0,3
20190508-W-Madrid-R16-Anastasija_Sevastova-Kiki_Bertens,1,S-DTL,1,0,0,0,0,0,1
20190508-W-Madrid-R16-Anastasija_Sevastova-Kiki_Bertens,2,F-XC,40,7,4,1,2,29,11
20190508-W-Madrid-R16-Anastasija_Sevastova-Kiki_Bertens,2,F-DTM,3,0,0,0,0,1,2
20190508-W-Madrid-R16-Anastasija_Sevastova-Kiki_Bertens,2,F-DTL,5,5,3,1,1,4,1
20190508-W-Madrid-R16-Anastasija_Sevastova-Kiki_Bertens,2,F-IO,13,8,2,3,3,9,4
20190508-W-Madrid-R16-Anastasija_Sevastova-Kiki_Bertens,2,F-II,2,1,1,0,0,1,1
20190508-W-Madrid-R16-Anastasija_Sevastova-Kiki_Bertens,2,B-XC,12,3,0,1,2,6,6
20190508-W-Madrid-R16-Anastasija_Sevastova-Kiki_Bertens,2,B-DTM,13,0,0,0,0,8,5
20190508-W-Madrid-R16-Anastasija_Sevastova-Kiki_Bertens,2,B-DTL,2,1,0,0,1,0,2
20190508-W-Madrid-R16-Anastasija_Sevastova-Kiki_Bertens,2,B-IO,3,1,0,0,1,2,1
20190508-W-Madrid-R16-Anastasija_Sevastova-Kiki_Bertens,2,S-XC,7,1,0,1,0,5,2
20190508-W-Madrid-R16-Anastasija_Sevastova-Kiki_Bertens,2,S-DTM,7,1,0,0,1,4,3
20190508-W-Madrid-R16-Anastasija_Sevastova-Kiki_Bertens,2,S-IO,1,0,0,0,0,1,0
20190510-W-Madrid-SF-Sloane_Stephens-Kiki_Bertens,1,F-XC,38,5,1,2,2,17,21
20190510-W-Madrid-SF-Sloane_Stephens-Kiki_Bertens,1,F-DTM,43,7,0,0,7,17,26
20190510-W-Madrid-SF-Sloane_Stephens-Kiki_Bertens,1,F-DTL,14,5,0,2,3,3,11
20190510-W-Madrid-SF-Sloane_Stephens-Kiki_Bertens,1,F-IO,20,7,1,5,1,12,8
20190510-W-Madrid-SF-Sloane_Stephens-Kiki_Bertens,1,B-XC,32,6,0,3,3,11,21
20190510-W-Madrid-SF-Sloane_Stephens-Kiki_Bertens,1,B-DTM,28,7,0,0,7,10,18
20190510-W-Madrid-SF-Sloane_Stephens-Kiki_Bertens,1,B-DTL,7,6,3,1,2,5,2
20190510-W-Madrid-SF-Sloane_Stephens-Kiki_Bertens,1,B-IO,5,3,1,1,1,2,3
20190510-W-Madrid-SF-Sloane_Stephens-Kiki_Bertens,1,S-XC,3,1,0,0,1,0,3
20190510-W-Madrid-SF-Sloane_Stephens-Kiki_Bertens,1,S-DTM,6,2,0,0,2,1,5
20190510-W-Madrid-SF-Sloane_Stephens-Kiki_Bertens,2,F-XC,51,13,3,6,4,35,16
20190510-W-Madrid-SF-Sloane_Stephens-Kiki_Bertens,2,F-DTM,15,1,0,1,0,7,8
20190510-W-Madrid-SF-Sloane_Stephens-Kiki_Bertens,2,F-DTL,8,5,1,1,3,4,4
20190510-W-Madrid-SF-Sloane_Stephens-Kiki_Bertens,2,F-IO,26,7,1,1,5,15,11
20190510-W-Madrid-SF-Sloane_Stephens-Kiki_Bertens,2,F-II,4,2,1,0,1,3,1
20190510-W-Madrid-SF-Sloane_Stephens-Kiki_Bertens,2,B-XC,26,4,0,2,2,18,8
20190510-W-Madrid-SF-Sloane_Stephens-Kiki_Bertens,2,B-DTM,32,6,0,0,6,16,16
20190510-W-Madrid-SF-Sloane_Stephens-Kiki_Bertens,2,B-DTL,5,4,1,0,3,2,3
20190510-W-Madrid-SF-Sloane_Stephens-Kiki_Bertens,2,B-IO,2,0,0,0,0,1,1
20190510-W-Madrid-SF-Sloane_Stephens-Kiki_Bertens,2,S-XC,5,0,0,0,0,5,0
20190510-W-Madrid-SF-Sloane_Stephens-Kiki_Bertens,2,S-DTM,6,0,0,0,0,3,3
20190510-W-Madrid-SF-Sloane_Stephens-Kiki_Bertens,2,S-DTL,1,0,0,0,0,1,0
20190513-W-Rome-R64-Aliaksandra_Sasnovich-Dominika_Cibulkova,1,F-XC,31,12,6,0,6,11,20
20190513-W-Rome-R64-Aliaksandra_Sasnovich-Dominika_Cibulkova,1,F-DTM,16,1,0,0,1,2,14
20190513-W-Rome-R64-Aliaksandra_Sasnovich-Dominika_Cibulkova,1,F-DTL,10,4,2,0,2,3,7
20190513-W-Rome-R64-Aliaksandra_Sasnovich-Dominika_Cibulkova,1,F-IO,6,2,2,0,0,4,2
20190513-W-Rome-R64-Aliaksandra_Sasnovich-Dominika_Cibulkova,1,B-XC,17,8,3,0,5,10,7
20190513-W-Rome-R64-Aliaksandra_Sasnovich-Dominika_Cibulkova,1,B-DTM,9,0,0,0,0,3,6
20190513-W-Rome-R64-Aliaksandra_Sasnovich-Dominika_Cibulkova,1,B-DTL,9,4,1,0,3,3,6
20190513-W-Rome-R64-Aliaksandra_Sasnovich-Dominika_Cibulkova,1,B-IO,2,1,1,0,0,2,0
20190513-W-Rome-R64-Aliaksandra_Sasnovich-Dominika_Cibulkova,1,S-XC,3,0,0,0,0,0,3
20190513-W-Rome-R64-Aliaksandra_Sasnovich-Dominika_Cibulkova,1,S-DTM,3,0,0,0,0,1,2
20190513-W-Rome-R64-Aliaksandra_Sasnovich-Dominika_Cibulkova,1,S-IO,1,0,0,0,0,1,0
20190513-W-Rome-R64-Aliaksandra_Sasnovich-Dominika_Cibulkova,2,F-XC,40,7,3,0,4,29,11
20190513-W-Rome-R64-Aliaksandra_Sasnovich-Dominika_Cibulkova,2,F-DTM,17,0,0,0,0,8,9
20190513-W-Rome-R64-Aliaksandra_Sasnovich-Dominika_Cibulkova,2,F-DTL,11,6,1,4,1,8,3
20190513-W-Rome-R64-Aliaksandra_Sasnovich-Dominika_Cibulkova,2,F-IO,9,5,4,0,1,7,2
20190513-W-Rome-R64-Aliaksandra_Sasnovich-Dominika_Cibulkova,2,F-II,2,1,1,0,0,2,0
20190513-W-Rome-R64-Aliaksandra_Sasnovich-Dominika_Cibulkova,2,B-XC,8,1,0,1,0,5,3
20190513-W-Rome-R64-Aliaksandra_Sasnovich-Dominika_Cibulkova,2,B-DTM,10,0,0,0,0,5,5
20190513-W-Rome-R64-Aliaksandra_Sasnovich-Dominika_Cibulkova,2,B-DTL,7,5,2,2,1,6,1
20190513-W-Rome-R64-Aliaksandra_Sasnovich-Dominika_Cibulkova,2,B-IO,3,2,0,0,2,1,2
20190513-W-Rome-R64-Aliaksandra_Sasnovich-Dominika_Cibulkova,2,S-XC,3,0,0,0,0,2,1
20190513-W-Rome-R64-Aliaksandra_Sasnovich-Dominika_Cibulkova,2,S-DTM,1,0,0,0,0,0,1
20190513-W-Rome-R64-Aliaksandra_Sasnovich-Dominika_Cibulkova,2,S-DTL,3,0,0,0,0,1,2
20190513-W-Rome-R64-Aliaksandra_Sasnovich-Dominika_Cibulkova,2,S-IO,1,1,0,1,0,1,0
20190513-W-Rome-R64-Elisabetta_Cocciaretto-Amanda_Anisimova,1,F-XC,46,16,4,3,9,18,28
20190513-W-Rome-R64-Elisabetta_Cocciaretto-Amanda_Anisimova,1,F-DTM,12,3,0,0,3,3,9
20190513-W-Rome-R64-Elisabetta_Cocciaretto-Amanda_Anisimova,1,F-DTL,4,0,0,0,0,2,2
20190513-W-Rome-R64-Elisabetta_Cocciaretto-Amanda_Anisimova,1,F-IO,5,2,2,0,0,3,2
20190513-W-Rome-R64-Elisabetta_Cocciaretto-Amanda_Anisimova,1,B-XC,23,7,0,3,4,14,9
20190513-W-Rome-R64-Elisabetta_Cocciaretto-Amanda_Anisimova,1,B-DTM,20,1,0,0,1,11,9
20190513-W-Rome-R64-Elisabetta_Cocciaretto-Amanda_Anisimova,1,B-DTL,5,2,1,0,1,1,4
20190513-W-Rome-R64-Elisabetta_Cocciaretto-Amanda_Anisimova,1,B-IO,2,0,0,0,0,0,2
20190513-W-Rome-R64-Elisabetta_Cocciaretto-Amanda_Anisimova,1,S-XC,3,0,0,0,0,1,2
20190513-W-Rome-R64-Elisabetta_Cocciaretto-Amanda_Anisimova,1,S-DTM,4,0,0,0,0,0,4
20190513-W-Rome-R64-Elisabetta_Cocciaretto-Amanda_Anisimova,2,F-XC,34,11,1,5,5,25,9
20190513-W-Rome-R64-Elisabetta_Cocciaretto-Amanda_Anisimova,2,F-DTM,11,2,0,0,2,5,6
20190513-W-Rome-R64-Elisabetta_Cocciaretto-Amanda_Anisimova,2,F-DTL,11,7,4,0,3,8,3
20190513-W-Rome-R64-Elisabetta_Cocciaretto-Amanda_Anisimova,2,F-IO,13,11,6,2,3,9,4
20190513-W-Rome-R64-Elisabetta_Cocciaretto-Amanda_Anisimova,2,F-II,1,1,0,0,1,0,1
20190513-W-Rome-R64-Elisabetta_Cocciaretto-Amanda_Anisimova,2,B-XC,27,5,0,3,2,13,14
20190513-W-Rome-R64-Elisabetta_Cocciaretto-Amanda_Anisimova,2,B-DTM,18,2,0,0,2,9,9
20190513-W-Rome-R64-Elisabetta_Cocciaretto-Amanda_Anisimova,2,B-DTL,5,4,2,0,2,2,3
20190513-W-Rome-R64-Elisabetta_Cocciaretto-Amanda_Anisimova,2,B-IO,7,0,0,0,0,4,3
20190513-W-Rome-R64-Elisabetta_Cocciaretto-Amanda_Anisimova,2,S-XC,1,0,0,0,0,0,1
20190513-W-Rome-R64-Elisabetta_Cocciaretto-Amanda_Anisimova,2,S-DTM,2,0,0,0,0,0,2
20190513-W-Rome-R64-Elisabetta_Cocciaretto-Amanda_Anisimova,2,S-IO,1,0,0,0,0,0,1
20190514-W-Rome-R32-Karolina_Pliskova-Ajla_Tomljanovic,1,F-XC,19,3,1,0,2,8,11
20190514-W-Rome-R32-Karolina_Pliskova-Ajla_Tomljanovic,1,F-DTM,13,2,0,0,2,6,7
20190514-W-Rome-R32-Karolina_Pliskova-Ajla_Tomljanovic,1,F-DTL,5,4,1,0,3,2,3
20190514-W-Rome-R32-Karolina_Pliskova-Ajla_Tomljanovic,1,F-IO,9,3,1,2,0,8,1
20190514-W-Rome-R32-Karolina_Pliskova-Ajla_Tomljanovic,1,B-XC,15,4,0,0,4,5,10
20190514-W-Rome-R32-Karolina_Pliskova-Ajla_Tomljanovic,1,B-DTM,14,0,0,0,0,5,9
20190514-W-Rome-R32-Karolina_Pliskova-Ajla_Tomljanovic,1,B-DTL,4,3,1,0,2,1,3
20190514-W-Rome-R32-Karolina_Pliskova-Ajla_Tomljanovic,1,B-IO,2,2,1,0,1,1,1
20190514-W-Rome-R32-Karolina_Pliskova-Ajla_Tomljanovic,1,S-XC,3,0,0,0,0,1,2
20190514-W-Rome-R32-Karolina_Pliskova-Ajla_Tomljanovic,1,S-DTM,2,0,0,0,0,1,1
20190514-W-Rome-R32-Karolina_Pliskova-Ajla_Tomljanovic,1,S-DTL,1,0,0,0,0,0,1
20190514-W-Rome-R32-Karolina_Pliskova-Ajla_Tomljanovic,2,F-XC,18,8,2,2,4,11,7
20190514-W-Rome-R32-Karolina_Pliskova-Ajla_Tomljanovic,2,F-DTM,14,4,0,0,4,6,8
20190514-W-Rome-R32-Karolina_Pliskova-Ajla_Tomljanovic,2,F-DTL,5,3,0,0,3,2,3
20190514-W-Rome-R32-Karolina_Pliskova-Ajla_Tomljanovic,2,F-IO,11,4,0,0,4,5,6
20190514-W-Rome-R32-Karolina_Pliskova-Ajla_Tomljanovic,2,B-XC,15,4,1,1,2,7,8
20190514-W-Rome-R32-Karolina_Pliskova-Ajla_Tomljanovic,2,B-DTM,19,4,0,0,4,5,14
20190514-W-Rome-R32-Karolina_Pliskova-Ajla_Tomljanovic,2,B-DTL,6,3,1,2,0,5,1
20190514-W-Rome-R32-Karolina_Pliskova-Ajla_Tomljanovic,2,B-IO,4,2,0,1,1,2,2
20190514-W-Rome-R32-Karolina_Pliskova-Ajla_Tomljanovic,2,S-XC,1,0,0,0,0,1,0
20190514-W-Rome-R32-Karolina_Pliskova-Ajla_Tomljanovic,2,S-DTM,1,0,0,0,0,0,1
20190514-W-Rome-R32-Karolina_Pliskova-Ajla_Tomljanovic,2,S-DTL,2,0,0,0,0,1,1
20190514-W-Rome-R32-Karolina_Pliskova-Ajla_Tomljanovic,2,S-IO,1,0,0,0,0,1,0
20190516-W-Rome-R32-Amanda_Anisimova-Kiki_Bertens,1,F-XC,66,17,4,0,13,28,38
20190516-W-Rome-R32-Amanda_Anisimova-Kiki_Bertens,1,F-DTM,38,9,1,0,8,19,19
20190516-W-Rome-R32-Amanda_Anisimova-Kiki_Bertens,1,F-DTL,17,4,1,0,3,6,11
20190516-W-Rome-R32-Amanda_Anisimova-Kiki_Bertens,1,F-IO,35,9,3,2,4,18,17
20190516-W-Rome-R32-Amanda_Anisimova-Kiki_Bertens,1,F-II,2,2,0,0,2,0,2
20190516-W-Rome-R32-Amanda_Anisimova-Kiki_Bertens,1,B-XC,29,6,3,1,2,16,13
20190516-W-Rome-R32-Amanda_Anisimova-Kiki_Bertens,1,B-DTM,26,5,0,2,3,13,13
20190516-W-Rome-R32-Amanda_Anisimova-Kiki_Bertens,1,B-DTL,12,3,3,0,0,7,5
20190516-W-Rome-R32-Amanda_Anisimova-Kiki_Bertens,1,B-IO,5,1,0,0,1,1,4
20190516-W-Rome-R32-Amanda_Anisimova-Kiki_Bertens,1,S-XC,5,0,0,0,0,3,2
20190516-W-Rome-R32-Amanda_Anisimova-Kiki_Bertens,1,S-DTM,3,0,0,0,0,2,1
20190516-W-Rome-R32-Amanda_Anisimova-Kiki_Bertens,1,S-DTL,2,1,0,0,1,0,2
20190516-W-Rome-R32-Amanda_Anisimova-Kiki_Bertens,1,S-IO,2,0,0,0,0,2,0
20190516-W-Rome-R32-Amanda_Anisimova-Kiki_Bertens,2,F-XC,53,8,0,2,6,28,25
20190516-W-Rome-R32-Amanda_Anisimova-Kiki_Bertens,2,F-DTM,35,9,1,1,7,18,17
20190516-W-Rome-R32-Amanda_Anisimova-Kiki_Bertens,2,F-DTL,20,7,3,0,4,6,14
20190516-W-Rome-R32-Amanda_Anisimova-Kiki_Bertens,2,F-IO,17,8,2,2,4,8,9
20190516-W-Rome-R32-Amanda_Anisimova-Kiki_Bertens,2,F-II,2,1,1,0,0,1,1
20190516-W-Rome-R32-Amanda_Anisimova-Kiki_Bertens,2,B-XC,10,3,0,0,3,3,7
20190516-W-Rome-R32-Amanda_Anisimova-Kiki_Bertens,2,B-DTM,23,3,0,0,3,10,13
20190516-W-Rome-R32-Amanda_Anisimova-Kiki_Bertens,2,B-DTL,4,1,0,0,1,2,2
20190516-W-Rome-R32-Amanda_Anisimova-Kiki_Bertens,2,B-IO,5,1,0,0,1,2,3
20190516-W-Rome-R32-Amanda_Anisimova-Kiki_Bertens,2,S-XC,18,3,0,0,3,6,12
20190516-W-Rome-R32-Amanda_Anisimova-Kiki_Bertens,2,S-DTM,26,1,0,1,0,14,12
20190516-W-Rome-R32-Amanda_Anisimova-Kiki_Bertens,2,S-DTL,3,2,1,0,1,1,2
20190516-W-Rome-R32-Amanda_Anisimova-Kiki_Bertens,2,S-IO,2,2,0,1,1,1,1
19811130-W-Australian_Open-F-Martina_Navratilova-Chris_Evert,1,F-XC,67,8,3,3,2,32,35
19811130-W-Australian_Open-F-Martina_Navratilova-Chris_Evert,1,F-DTM,18,2,0,1,1,4,14
19811130-W-Australian_Open-F-Martina_Navratilova-Chris_Evert,1,F-DTL,11,4,1,1,2,4,7
19811130-W-Australian_Open-F-Martina_Navratilova-Chris_Evert,1,F-IO,10,6,1,1,4,3,7
19811130-W-Australian_Open-F-Martina_Navratilova-Chris_Evert,1,B-XC,10,4,2,0,2,5,5
19811130-W-Australian_Open-F-Martina_Navratilova-Chris_Evert,1,B-DTM,8,0,0,0,0,3,5
19811130-W-Australian_Open-F-Martina_Navratilova-Chris_Evert,1,B-DTL,3,0,0,0,0,3,0
19811130-W-Australian_Open-F-Martina_Navratilova-Chris_Evert,1,B-IO,1,0,0,0,0,0,1
19811130-W-Australian_Open-F-Martina_Navratilova-Chris_Evert,1,S-XC,84,7,1,0,6,30,54
19811130-W-Australian_Open-F-Martina_Navratilova-Chris_Evert,1,S-DTM,56,2,0,1,1,26,30
19811130-W-Australian_Open-F-Martina_Navratilova-Chris_Evert,1,S-DTL,25,8,0,0,8,7,18
19811130-W-Australian_Open-F-Martina_Navratilova-Chris_Evert,1,S-IO,5,0,0,0,0,2,3
19811130-W-Australian_Open-F-Martina_Navratilova-Chris_Evert,2,F-XC,132,22,6,5,11,77,55
19811130-W-Australian_Open-F-Martina_Navratilova-Chris_Evert,2,F-DTM,32,2,0,1,1,19,13
19811130-W-Australian_Open-F-Martina_Navratilova-Chris_Evert,2,F-DTL,22,11,6,5,0,14,8
19811130-W-Australian_Open-F-Martina_Navratilova-Chris_Evert,2,F-IO,12,3,1,2,0,8,4
19811130-W-Australian_Open-F-Martina_Navratilova-Chris_Evert,2,B-XC,64,13,5,3,5,38,26
19811130-W-Australian_Open-F-Martina_Navratilova-Chris_Evert,2,B-DTM,24,2,0,1,1,11,13
19811130-W-Australian_Open-F-Martina_Navratilova-Chris_Evert,2,B-DTL,30,3,0,1,2,14,16
19811130-W-Australian_Open-F-Martina_Navratilova-Chris_Evert,2,B-IO,22,3,1,0,2,14,8
19811130-W-Australian_Open-F-Martina_Navratilova-Chris_Evert,2,S-DTM,1,0,0,0,0,0,1
19811130-W-Australian_Open-F-Martina_Navratilova-Chris_Evert,2,S-DTL,1,0,0,0,0,0,1
19811130-W-Australian_Open-F-Martina_Navratilova-Chris_Evert,2,S-IO,1,0,0,0,0,0,1
20190412-W-Bogota-QF-Astra_Sharma-Sara_Errani,1,F-XC,33,17,10,5,2,23,10
20190412-W-Bogota-QF-Astra_Sharma-Sara_Errani,1,F-DTM,23,4,0,0,4,8,15
20190412-W-Bogota-QF-Astra_Sharma-Sara_Errani,1,F-DTL,8,4,1,0,3,3,5
20190412-W-Bogota-QF-Astra_Sharma-Sara_Errani,1,F-IO,34,13,6,2,5,20,14
20190412-W-Bogota-QF-Astra_Sharma-Sara_Errani,1,F-II,5,3,0,2,1,3,2
20190412-W-Bogota-QF-Astra_Sharma-Sara_Errani,1,B-XC,10,2,0,0,2,2,8
20190412-W-Bogota-QF-Astra_Sharma-Sara_Errani,1,B-DTM,7,3,0,0,3,2,5
20190412-W-Bogota-QF-Astra_Sharma-Sara_Errani,1,B-DTL,2,1,0,0,1,0,2
20190412-W-Bogota-QF-Astra_Sharma-Sara_Errani,1,B-IO,1,1,0,0,1,0,1
20190412-W-Bogota-QF-Astra_Sharma-Sara_Errani,1,S-DTM,5,0,0,0,0,0,5
20190412-W-Bogota-QF-Astra_Sharma-Sara_Errani,1,S-DTL,1,0,0,0,0,0,1
20190412-W-Bogota-QF-Astra_Sharma-Sara_Errani,2,F-XC,12,3,0,3,0,8,4
20190412-W-Bogota-QF-Astra_Sharma-Sara_Errani,2,F-DTM,15,1,0,0,1,7,8
20190412-W-Bogota-QF-Astra_Sharma-Sara_Errani,2,F-DTL,6,1,0,1,0,5,1
20190412-W-Bogota-QF-Astra_Sharma-Sara_Errani,2,F-IO,10,2,0,1,1,7,3
20190412-W-Bogota-QF-Astra_Sharma-Sara_Errani,2,F-II,2,1,1,0,0,2,0
20190412-W-Bogota-QF-Astra_Sharma-Sara_Errani,2,B-XC,22,5,0,1,4,12,10
20190412-W-Bogota-QF-Astra_Sharma-Sara_Errani,2,B-DTM,19,0,0,0,0,9,10
20190412-W-Bogota-QF-Astra_Sharma-Sara_Errani,2,B-DTL,3,1,1,0,0,2,1
20190412-W-Bogota-QF-Astra_Sharma-Sara_Errani,2,S-XC,1,0,0,0,0,0,1
20190412-W-Bogota-QF-Astra_Sharma-Sara_Errani,2,S-DTM,3,0,0,0,0,1,2
20190412-W-Bogota-QF-Astra_Sharma-Sara_Errani,2,S-DTL,2,1,0,1,0,2,0
20190516-W-Rome-R16-Carla_Suarez_Navarro-Kiki_Bertens,1,F-XC,51,13,7,4,2,35,16
20190516-W-Rome-R16-Carla_Suarez_Navarro-Kiki_Bertens,1,F-DTM,30,1,0,1,0,21,9
20190516-W-Rome-R16-Carla_Suarez_Navarro-Kiki_Bertens,1,F-DTL,13,7,2,2,3,7,6
20190516-W-Rome-R16-Carla_Suarez_Navarro-Kiki_Bertens,1,F-IO,44,16,3,4,9,27,17
20190516-W-Rome-R16-Carla_Suarez_Navarro-Kiki_Bertens,1,F-II,3,2,1,0,1,2,1
20190516-W-Rome-R16-Carla_Suarez_Navarro-Kiki_Bertens,1,B-XC,52,11,3,2,6,29,23
20190516-W-Rome-R16-Carla_Suarez_Navarro-Kiki_Bertens,1,B-DTM,28,3,0,0,3,13,15
20190516-W-Rome-R16-Carla_Suarez_Navarro-Kiki_Bertens,1,B-DTL,4,2,0,1,1,3,1
20190516-W-Rome-R16-Carla_Suarez_Navarro-Kiki_Bertens,1,S-XC,9,1,0,1,0,6,3
20190516-W-Rome-R16-Carla_Suarez_Navarro-Kiki_Bertens,1,S-DTM,5,2,0,0,2,1,4
20190516-W-Rome-R16-Carla_Suarez_Navarro-Kiki_Bertens,1,S-DTL,2,2,0,1,1,1,1
20190516-W-Rome-R16-Carla_Suarez_Navarro-Kiki_Bertens,2,F-XC,32,4,0,1,3,12,20
20190516-W-Rome-R16-Carla_Suarez_Navarro-Kiki_Bertens,2,F-DTM,17,0,0,0,0,8,9
20190516-W-Rome-R16-Carla_Suarez_Navarro-Kiki_Bertens,2,F-DTL,12,4,1,0,3,5,7
20190516-W-Rome-R16-Carla_Suarez_Navarro-Kiki_Bertens,2,F-IO,44,19,6,5,8,23,21
20190516-W-Rome-R16-Carla_Suarez_Navarro-Kiki_Bertens,2,F-II,5,0,0,0,0,3,2
20190516-W-Rome-R16-Carla_Suarez_Navarro-Kiki_Bertens,2,B-XC,25,2,0,0,2,15,10
20190516-W-Rome-R16-Carla_Suarez_Navarro-Kiki_Bertens,2,B-DTM,40,2,0,0,2,10,30
20190516-W-Rome-R16-Carla_Suarez_Navarro-Kiki_Bertens,2,B-DTL,4,1,0,0,1,1,3
20190516-W-Rome-R16-Carla_Suarez_Navarro-Kiki_Bertens,2,S-XC,13,1,0,1,0,4,9
20190516-W-Rome-R16-Carla_Suarez_Navarro-Kiki_Bertens,2,S-DTM,9,0,0,0,0,5,4
20190516-W-Rome-R16-Carla_Suarez_Navarro-Kiki_Bertens,2,S-DTL,1,0,0,0,0,1,0
20190518-W-Rome-SF-Kiki_Bertens-Johanna_Konta,1,F-XC,50,15,4,2,9,25,25
20190518-W-Rome-SF-Kiki_Bertens-Johanna_Konta,1,F-DTM,37,2,0,0,2,18,19
20190518-W-Rome-SF-Kiki_Bertens-Johanna_Konta,1,F-DTL,17,8,4,2,2,10,7
20190518-W-Rome-SF-Kiki_Bertens-Johanna_Konta,1,F-IO,17,5,2,1,2,7,10
20190518-W-Rome-SF-Kiki_Bertens-Johanna_Konta,1,F-II,2,1,1,0,0,1,1
20190518-W-Rome-SF-Kiki_Bertens-Johanna_Konta,1,B-XC,14,3,1,1,1,5,9
20190518-W-Rome-SF-Kiki_Bertens-Johanna_Konta,1,B-DTM,43,4,0,1,3,24,19
20190518-W-Rome-SF-Kiki_Bertens-Johanna_Konta,1,B-DTL,8,3,0,2,1,4,4
20190518-W-Rome-SF-Kiki_Bertens-Johanna_Konta,1,B-IO,3,0,0,0,0,1,2
20190518-W-Rome-SF-Kiki_Bertens-Johanna_Konta,1,S-XC,13,1,1,0,0,11,2
20190518-W-Rome-SF-Kiki_Bertens-Johanna_Konta,1,S-DTM,13,1,0,0,1,4,9
20190518-W-Rome-SF-Kiki_Bertens-Johanna_Konta,1,S-DTL,4,2,0,1,1,2,2
20190518-W-Rome-SF-Kiki_Bertens-Johanna_Konta,1,S-IO,2,0,0,0,0,1,1
20190518-W-Rome-SF-Kiki_Bertens-Johanna_Konta,2,F-XC,72,20,6,4,10,39,33
20190518-W-Rome-SF-Kiki_Bertens-Johanna_Konta,2,F-DTM,23,3,0,1,2,8,15
20190518-W-Rome-SF-Kiki_Bertens-Johanna_Konta,2,F-DTL,18,8,3,0,5,9,9
20190518-W-Rome-SF-Kiki_Bertens-Johanna_Konta,2,F-IO,33,10,4,2,4,18,15
20190518-W-Rome-SF-Kiki_Bertens-Johanna_Konta,2,F-II,1,0,0,0,0,1,0
20190518-W-Rome-SF-Kiki_Bertens-Johanna_Konta,2,B-XC,57,15,3,3,9,26,31
20190518-W-Rome-SF-Kiki_Bertens-Johanna_Konta,2,B-DTM,19,2,0,1,1,11,8
20190518-W-Rome-SF-Kiki_Bertens-Johanna_Konta,2,B-DTL,6,4,3,0,1,3,3
20190518-W-Rome-SF-Kiki_Bertens-Johanna_Konta,2,B-IO,9,1,0,0,1,4,5
20190518-W-Rome-SF-Kiki_Bertens-Johanna_Konta,2,S-XC,5,1,0,0,1,2,3
20190518-W-Rome-SF-Kiki_Bertens-Johanna_Konta,2,S-DTM,8,2,0,1,1,4,4
20190518-W-Rome-SF-Kiki_Bertens-Johanna_Konta,2,S-DTL,5,0,0,0,0,1,4
20190520-W-Strasbourg-R32-Chloe_Paquet-Sofia_Kenin,1,F-XC,24,4,3,0,1,11,13
20190520-W-Strasbourg-R32-Chloe_Paquet-Sofia_Kenin,1,F-DTM,22,2,0,0,2,8,14
20190520-W-Strasbourg-R32-Chloe_Paquet-Sofia_Kenin,1,F-DTL,11,4,1,1,2,6,5
20190520-W-Strasbourg-R32-Chloe_Paquet-Sofia_Kenin,1,F-IO,15,1,1,0,0,11,4
20190520-W-Strasbourg-R32-Chloe_Paquet-Sofia_Kenin,1,F-II,1,1,1,0,0,1,0
20190520-W-Strasbourg-R32-Chloe_Paquet-Sofia_Kenin,1,B-XC,21,6,2,0,4,11,10
20190520-W-Strasbourg-R32-Chloe_Paquet-Sofia_Kenin,1,B-DTM,29,3,0,0,3,11,18
20190520-W-Strasbourg-R32-Chloe_Paquet-Sofia_Kenin,1,B-DTL,7,4,0,1,3,3,4
20190520-W-Strasbourg-R32-Chloe_Paquet-Sofia_Kenin,1,B-IO,4,1,1,0,0,2,2
20190520-W-Strasbourg-R32-Chloe_Paquet-Sofia_Kenin,1,S-XC,6,0,0,0,0,2,4
20190520-W-Strasbourg-R32-Chloe_Paquet-Sofia_Kenin,1,S-DTM,3,1,0,0,1,1,2
20190520-W-Strasbourg-R32-Chloe_Paquet-Sofia_Kenin,2,F-XC,27,7,3,0,4,16,11
20190520-W-Strasbourg-R32-Chloe_Paquet-Sofia_Kenin,2,F-DTM,15,1,0,0,1,10,5
20190520-W-Strasbourg-R32-Chloe_Paquet-Sofia_Kenin,2,F-DTL,5,2,0,1,1,2,3
20190520-W-Strasbourg-R32-Chloe_Paquet-Sofia_Kenin,2,F-IO,10,5,2,1,2,8,2
20190520-W-Strasbourg-R32-Chloe_Paquet-Sofia_Kenin,2,F-II,2,2,2,0,0,2,0
20190520-W-Strasbourg-R32-Chloe_Paquet-Sofia_Kenin,2,B-XC,47,14,1,4,9,21,26
20190520-W-Strasbourg-R32-Chloe_Paquet-Sofia_Kenin,2,B-DTM,13,4,0,0,4,6,7
20190520-W-Strasbourg-R32-Chloe_Paquet-Sofia_Kenin,2,B-DTL,10,6,4,0,2,6,4
20190520-W-Strasbourg-R32-Chloe_Paquet-Sofia_Kenin,2,B-IO,7,4,2,0,2,4,3
20190520-W-Strasbourg-R32-Chloe_Paquet-Sofia_Kenin,2,S-XC,4,0,0,0,0,2,2
20190520-W-Strasbourg-R32-Chloe_Paquet-Sofia_Kenin,2,S-DTM,4,1,0,0,1,1,3
20190520-W-Strasbourg-R32-Chloe_Paquet-Sofia_Kenin,2,S-DTL,1,0,0,0,0,0,1
20190522-W-Strasbourg-R16-Aryna_Sabalenka-Laura_Siegemund,1,F-XC,24,10,2,4,4,16,8
20190522-W-Strasbourg-R16-Aryna_Sabalenka-Laura_Siegemund,1,F-DTM,12,2,0,0,2,7,5
20190522-W-Strasbourg-R16-Aryna_Sabalenka-Laura_Siegemund,1,F-DTL,6,4,2,1,1,4,2
20190522-W-Strasbourg-R16-Aryna_Sabalenka-Laura_Siegemund,1,F-IO,7,3,2,1,0,5,2
20190522-W-Strasbourg-R16-Aryna_Sabalenka-Laura_Siegemund,1,B-XC,21,6,2,2,2,19,2
20190522-W-Strasbourg-R16-Aryna_Sabalenka-Laura_Siegemund,1,B-DTM,12,1,0,0,1,7,5
20190522-W-Strasbourg-R16-Aryna_Sabalenka-Laura_Siegemund,1,B-DTL,11,5,1,2,2,4,7
20190522-W-Strasbourg-R16-Aryna_Sabalenka-Laura_Siegemund,1,B-IO,5,2,0,0,2,2,3
20190522-W-Strasbourg-R16-Aryna_Sabalenka-Laura_Siegemund,1,S-XC,2,0,0,0,0,1,1
20190522-W-Strasbourg-R16-Aryna_Sabalenka-Laura_Siegemund,1,S-DTM,2,0,0,0,0,0,2
20190522-W-Strasbourg-R16-Aryna_Sabalenka-Laura_Siegemund,2,F-XC,16,6,3,2,1,9,7
20190522-W-Strasbourg-R16-Aryna_Sabalenka-Laura_Siegemund,2,F-DTM,8,1,0,0,1,2,6
20190522-W-Strasbourg-R16-Aryna_Sabalenka-Laura_Siegemund,2,F-DTL,9,3,0,2,1,3,6
20190522-W-Strasbourg-R16-Aryna_Sabalenka-Laura_Siegemund,2,F-IO,6,4,2,0,2,2,4
20190522-W-Strasbourg-R16-Aryna_Sabalenka-Laura_Siegemund,2,F-II,1,1,1,0,0,1,0
20190522-W-Strasbourg-R16-Aryna_Sabalenka-Laura_Siegemund,2,B-XC,15,6,0,0,6,2,13
20190522-W-Strasbourg-R16-Aryna_Sabalenka-Laura_Siegemund,2,B-DTM,19,4,1,0,3,6,13
20190522-W-Strasbourg-R16-Aryna_Sabalenka-Laura_Siegemund,2,B-DTL,5,4,1,0,3,1,4
20190522-W-Strasbourg-R16-Aryna_Sabalenka-Laura_Siegemund,2,B-IO,4,1,1,0,0,2,2
20190522-W-Strasbourg-R16-Aryna_Sabalenka-Laura_Siegemund,2,S-XC,7,2,0,0,2,2,5
20190522-W-Strasbourg-R16-Aryna_Sabalenka-Laura_Siegemund,2,S-DTM,3,0,0,0,0,0,3
20190522-W-Strasbourg-R16-Aryna_Sabalenka-Laura_Siegemund,2,S-DTL,1,0,0,0,0,0,1
20170901-W-ITF_Dunakeszi-QF-Dayana_Yastremska-Anna_Bondar,1,F-XC,26,13,4,2,7,17,9
20170901-W-ITF_Dunakeszi-QF-Dayana_Yastremska-Anna_Bondar,1,F-DTM,20,3,0,1,2,14,6
20170901-W-ITF_Dunakeszi-QF-Dayana_Yastremska-Anna_Bondar,1,F-DTL,5,1,1,0,0,5,0
20170901-W-ITF_Dunakeszi-QF-Dayana_Yastremska-Anna_Bondar,1,F-IO,9,4,2,0,2,7,2
20170901-W-ITF_Dunakeszi-QF-Dayana_Yastremska-Anna_Bondar,1,F-II,1,1,1,0,0,1,0
20170901-W-ITF_Dunakeszi-QF-Dayana_Yastremska-Anna_Bondar,1,B-XC,21,6,2,2,2,16,5
20170901-W-ITF_Dunakeszi-QF-Dayana_Yastremska-Anna_Bondar,1,B-DTM,15,2,0,0,2,9,6
20170901-W-ITF_Dunakeszi-QF-Dayana_Yastremska-Anna_Bondar,1,B-DTL,5,1,0,0,1,4,1
20170901-W-ITF_Dunakeszi-QF-Dayana_Yastremska-Anna_Bondar,1,B-IO,10,4,3,0,1,5,5
20170901-W-ITF_Dunakeszi-QF-Dayana_Yastremska-Anna_Bondar,1,S-DTM,2,1,0,0,1,0,2
20170901-W-ITF_Dunakeszi-QF-Dayana_Yastremska-Anna_Bondar,2,F-XC,17,9,1,3,5,8,9
20170901-W-ITF_Dunakeszi-QF-Dayana_Yastremska-Anna_Bondar,2,F-DTM,19,3,0,0,3,4,15
20170901-W-ITF_Dunakeszi-QF-Dayana_Yastremska-Anna_Bondar,2,F-DTL,5,2,0,0,2,2,3
20170901-W-ITF_Dunakeszi-QF-Dayana_Yastremska-Anna_Bondar,2,F-IO,12,3,0,0,3,3,9
20170901-W-ITF_Dunakeszi-QF-Dayana_Yastremska-Anna_Bondar,2,B-XC,16,6,0,2,4,7,9
20170901-W-ITF_Dunakeszi-QF-Dayana_Yastremska-Anna_Bondar,2,B-DTM,20,2,0,0,2,7,13
20170901-W-ITF_Dunakeszi-QF-Dayana_Yastremska-Anna_Bondar,2,B-DTL,5,0,0,0,0,0,5
20170901-W-ITF_Dunakeszi-QF-Dayana_Yastremska-Anna_Bondar,2,B-IO,4,0,0,0,0,2,2
20170901-W-ITF_Dunakeszi-QF-Dayana_Yastremska-Anna_Bondar,2,S-XC,3,0,0,0,0,0,3
20170901-W-ITF_Dunakeszi-QF-Dayana_Yastremska-Anna_Bondar,2,S-DTL,1,1,0,0,1,0,1
20190219-W-Dubai-R32-Viktoria_Kuzmova-Kiki_Bertens,1,F-XC,78,24,7,3,14,44,34
20190219-W-Dubai-R32-Viktoria_Kuzmova-Kiki_Bertens,1,F-DTM,22,3,0,0,3,12,10
20190219-W-Dubai-R32-Viktoria_Kuzmova-Kiki_Bertens,1,F-DTL,16,5,3,1,1,12,4
20190219-W-Dubai-R32-Viktoria_Kuzmova-Kiki_Bertens,1,F-IO,17,9,4,3,2,12,5
20190219-W-Dubai-R32-Viktoria_Kuzmova-Kiki_Bertens,1,F-II,1,0,0,0,0,1,0
20190219-W-Dubai-R32-Viktoria_Kuzmova-Kiki_Bertens,1,B-XC,43,13,1,5,7,21,22
20190219-W-Dubai-R32-Viktoria_Kuzmova-Kiki_Bertens,1,B-DTM,25,4,0,0,4,12,13
20190219-W-Dubai-R32-Viktoria_Kuzmova-Kiki_Bertens,1,B-DTL,10,4,1,1,2,6,4
20190219-W-Dubai-R32-Viktoria_Kuzmova-Kiki_Bertens,1,B-IO,13,1,1,0,0,9,4
20190219-W-Dubai-R32-Viktoria_Kuzmova-Kiki_Bertens,1,S-XC,2,0,0,0,0,0,2
20190219-W-Dubai-R32-Viktoria_Kuzmova-Kiki_Bertens,1,S-DTL,1,0,0,0,0,1,0
20190219-W-Dubai-R32-Viktoria_Kuzmova-Kiki_Bertens,2,F-XC,54,17,5,5,7,26,28
20190219-W-Dubai-R32-Viktoria_Kuzmova-Kiki_Bertens,2,F-DTM,42,10,1,1,8,10,32
20190219-W-Dubai-R32-Viktoria_Kuzmova-Kiki_Bertens,2,F-DTL,15,6,2,0,4,6,9
20190219-W-Dubai-R32-Viktoria_Kuzmova-Kiki_Bertens,2,F-IO,18,8,5,0,3,10,8
20190219-W-Dubai-R32-Viktoria_Kuzmova-Kiki_Bertens,2,B-XC,19,6,1,0,5,10,9
20190219-W-Dubai-R32-Viktoria_Kuzmova-Kiki_Bertens,2,B-DTM,24,2,0,1,1,10,14
20190219-W-Dubai-R32-Viktoria_Kuzmova-Kiki_Bertens,2,B-DTL,7,0,0,0,0,3,4
20190219-W-Dubai-R32-Viktoria_Kuzmova-Kiki_Bertens,2,B-IO,4,2,1,0,1,1,3
20190219-W-Dubai-R32-Viktoria_Kuzmova-Kiki_Bertens,2,S-XC,6,1,1,0,0,2,4
20190219-W-Dubai-R32-Viktoria_Kuzmova-Kiki_Bertens,2,S-DTM,15,0,0,0,0,4,11
20190219-W-Dubai-R32-Viktoria_Kuzmova-Kiki_Bertens,2,S-IO,2,2,0,1,1,1,1
20190522-W-Strasbourg-R32-Diana_Marcinkevica-Daria_Gavrilova,1,F-XC,30,12,4,6,2,19,11
20190522-W-Strasbourg-R32-Diana_Marcinkevica-Daria_Gavrilova,1,F-DTM,11,0,0,0,0,7,4
20190522-W-Strasbourg-R32-Diana_Marcinkevica-Daria_Gavrilova,1,F-DTL,22,12,3,1,8,10,12
20190522-W-Strasbourg-R32-Diana_Marcinkevica-Daria_Gavrilova,1,F-IO,26,8,3,2,3,15,11
20190522-W-Strasbourg-R32-Diana_Marcinkevica-Daria_Gavrilova,1,F-II,9,6,0,4,2,5,4
20190522-W-Strasbourg-R32-Diana_Marcinkevica-Daria_Gavrilova,1,B-XC,45,8,1,2,5,26,19
20190522-W-Strasbourg-R32-Diana_Marcinkevica-Daria_Gavrilova,1,B-DTM,24,1,1,0,0,14,10
20190522-W-Strasbourg-R32-Diana_Marcinkevica-Daria_Gavrilova,1,B-DTL,12,10,4,0,6,5,7
20190522-W-Strasbourg-R32-Diana_Marcinkevica-Daria_Gavrilova,1,B-IO,5,4,1,0,3,1,4
20190522-W-Strasbourg-R32-Diana_Marcinkevica-Daria_Gavrilova,1,S-XC,3,0,0,0,0,1,2
20190522-W-Strasbourg-R32-Diana_Marcinkevica-Daria_Gavrilova,1,S-DTM,4,0,0,0,0,2,2
20190522-W-Strasbourg-R32-Diana_Marcinkevica-Daria_Gavrilova,1,S-DTL,2,2,2,0,0,2,0
20190522-W-Strasbourg-R32-Diana_Marcinkevica-Daria_Gavrilova,1,S-IO,1,1,1,0,0,1,0
20190522-W-Strasbourg-R32-Diana_Marcinkevica-Daria_Gavrilova,2,F-XC,30,5,2,2,1,16,14
20190522-W-Strasbourg-R32-Diana_Marcinkevica-Daria_Gavrilova,2,F-DTM,12,0,0,0,0,8,4
20190522-W-Strasbourg-R32-Diana_Marcinkevica-Daria_Gavrilova,2,F-DTL,14,6,3,2,1,8,6
20190522-W-Strasbourg-R32-Diana_Marcinkevica-Daria_Gavrilova,2,F-IO,33,12,6,1,5,17,16
20190522-W-Strasbourg-R32-Diana_Marcinkevica-Daria_Gavrilova,2,F-II,6,4,3,0,1,4,2
20190522-W-Strasbourg-R32-Diana_Marcinkevica-Daria_Gavrilova,2,B-XC,14,2,0,1,1,7,7
20190522-W-Strasbourg-R32-Diana_Marcinkevica-Daria_Gavrilova,2,B-DTM,21,2,1,0,1,11,10
20190522-W-Strasbourg-R32-Diana_Marcinkevica-Daria_Gavrilova,2,B-DTL,7,4,1,1,2,3,4
20190522-W-Strasbourg-R32-Diana_Marcinkevica-Daria_Gavrilova,2,B-IO,5,0,0,0,0,2,3
20190522-W-Strasbourg-R32-Diana_Marcinkevica-Daria_Gavrilova,2,S-XC,27,3,0,1,2,9,18
20190522-W-Strasbourg-R32-Diana_Marcinkevica-Daria_Gavrilova,2,S-DTM,12,1,0,0,1,3,9
20190522-W-Strasbourg-R32-Diana_Marcinkevica-Daria_Gavrilova,2,S-DTL,3,0,0,0,0,2,1
20190309-W-Indian_Wells-R64-Venus_Williams-Petra_Kvitova,1,F-XC,45,12,0,8,4,24,21
20190309-W-Indian_Wells-R64-Venus_Williams-Petra_Kvitova,1,F-DTM,38,6,1,1,4,22,16
20190309-W-Indian_Wells-R64-Venus_Williams-Petra_Kvitova,1,F-DTL,7,2,2,0,0,4,3
20190309-W-Indian_Wells-R64-Venus_Williams-Petra_Kvitova,1,F-IO,16,4,1,0,3,9,7
20190309-W-Indian_Wells-R64-Venus_Williams-Petra_Kvitova,1,F-II,1,0,0,0,0,0,1
20190309-W-Indian_Wells-R64-Venus_Williams-Petra_Kvitova,1,B-XC,31,6,2,2,2,19,12
20190309-W-Indian_Wells-R64-Venus_Williams-Petra_Kvitova,1,B-DTM,44,4,1,1,2,22,22
20190309-W-Indian_Wells-R64-Venus_Williams-Petra_Kvitova,1,B-DTL,2,1,0,0,1,1,1
20190309-W-Indian_Wells-R64-Venus_Williams-Petra_Kvitova,1,B-IO,10,7,1,2,4,4,6
20190309-W-Indian_Wells-R64-Venus_Williams-Petra_Kvitova,1,S-XC,3,0,0,0,0,0,3
20190309-W-Indian_Wells-R64-Venus_Williams-Petra_Kvitova,1,S-DTM,6,0,0,0,0,4,2
20190309-W-Indian_Wells-R64-Venus_Williams-Petra_Kvitova,1,S-DTL,5,0,0,0,0,1,4
20190309-W-Indian_Wells-R64-Venus_Williams-Petra_Kvitova,1,S-IO,2,1,1,0,0,1,1
20190309-W-Indian_Wells-R64-Venus_Williams-Petra_Kvitova,2,F-XC,48,18,5,6,7,27,21
20190309-W-Indian_Wells-R64-Venus_Williams-Petra_Kvitova,2,F-DTM,46,10,0,1,9,18,28
20190309-W-Indian_Wells-R64-Venus_Williams-Petra_Kvitova,2,F-DTL,6,5,1,1,3,2,4
20190309-W-Indian_Wells-R64-Venus_Williams-Petra_Kvitova,2,F-IO,18,10,2,2,6,6,12
20190309-W-Indian_Wells-R64-Venus_Williams-Petra_Kvitova,2,F-II,1,1,0,0,1,0,1
20190309-W-Indian_Wells-R64-Venus_Williams-Petra_Kvitova,2,B-XC,31,12,5,2,5,18,13
20190309-W-Indian_Wells-R64-Venus_Williams-Petra_Kvitova,2,B-DTM,32,4,1,2,1,16,16
20190309-W-Indian_Wells-R64-Venus_Williams-Petra_Kvitova,2,B-DTL,3,2,0,1,1,1,2
20190309-W-Indian_Wells-R64-Venus_Williams-Petra_Kvitova,2,B-IO,12,7,1,2,4,7,5
20190309-W-Indian_Wells-R64-Venus_Williams-Petra_Kvitova,2,B-II,1,0,0,0,0,1,0
20190309-W-Indian_Wells-R64-Venus_Williams-Petra_Kvitova,2,S-XC,3,1,1,0,0,3,0
20190309-W-Indian_Wells-R64-Venus_Williams-Petra_Kvitova,2,S-DTM,9,1,0,0,1,4,5
20190309-W-Indian_Wells-R64-Venus_Williams-Petra_Kvitova,2,S-DTL,1,0,0,0,0,0,1
20190309-W-Indian_Wells-R64-Venus_Williams-Petra_Kvitova,2,S-IO,3,0,0,0,0,0,3
20190527-W-Roland_Garros-R128-Marie_Bouzkova-Bianca_Andreescu,1,F-XC,69,12,4,4,4,35,34
20190527-W-Roland_Garros-R128-Marie_Bouzkova-Bianca_Andreescu,1,F-DTM,53,3,0,0,3,15,38
20190527-W-Roland_Garros-R128-Marie_Bouzkova-Bianca_Andreescu,1,F-DTL,12,5,1,1,3,6,6
20190527-W-Roland_Garros-R128-Marie_Bouzkova-Bianca_Andreescu,1,F-IO,33,7,1,0,6,9,24
20190527-W-Roland_Garros-R128-Marie_Bouzkova-Bianca_Andreescu,1,F-II,2,2,0,2,0,2,0
20190527-W-Roland_Garros-R128-Marie_Bouzkova-Bianca_Andreescu,1,B-XC,75,14,2,5,7,34,41
20190527-W-Roland_Garros-R128-Marie_Bouzkova-Bianca_Andreescu,1,B-DTM,55,2,0,0,2,23,32
20190527-W-Roland_Garros-R128-Marie_Bouzkova-Bianca_Andreescu,1,B-DTL,10,6,5,0,1,8,2
20190527-W-Roland_Garros-R128-Marie_Bouzkova-Bianca_Andreescu,1,B-IO,8,3,2,0,1,4,4
20190527-W-Roland_Garros-R128-Marie_Bouzkova-Bianca_Andreescu,1,S-XC,11,2,0,1,1,3,8
20190527-W-Roland_Garros-R128-Marie_Bouzkova-Bianca_Andreescu,1,S-DTM,9,0,0,0,0,2,7
20190527-W-Roland_Garros-R128-Marie_Bouzkova-Bianca_Andreescu,1,S-DTL,2,0,0,0,0,1,1
20190527-W-Roland_Garros-R128-Marie_Bouzkova-Bianca_Andreescu,1,S-IO,1,0,0,0,0,0,1
20190527-W-Roland_Garros-R128-Marie_Bouzkova-Bianca_Andreescu,2,F-XC,62,30,9,7,14,35,27
20190527-W-Roland_Garros-R128-Marie_Bouzkova-Bianca_Andreescu,2,F-DTM,58,6,0,0,6,28,30
20190527-W-Roland_Garros-R128-Marie_Bouzkova-Bianca_Andreescu,2,F-DTL,19,4,2,0,2,10,9
20190527-W-Roland_Garros-R128-Marie_Bouzkova-Bianca_Andreescu,2,F-IO,29,14,6,3,5,22,7
20190527-W-Roland_Garros-R128-Marie_Bouzkova-Bianca_Andreescu,2,F-II,6,3,3,0,0,5,1
20190527-W-Roland_Garros-R128-Marie_Bouzkova-Bianca_Andreescu,2,B-XC,68,10,3,2,5,35,33
20190527-W-Roland_Garros-R128-Marie_Bouzkova-Bianca_Andreescu,2,B-DTM,35,3,1,0,2,18,17
20190527-W-Roland_Garros-R128-Marie_Bouzkova-Bianca_Andreescu,2,B-DTL,24,8,3,2,3,18,6
20190527-W-Roland_Garros-R128-Marie_Bouzkova-Bianca_Andreescu,2,B-IO,8,3,0,2,1,5,3
20190527-W-Roland_Garros-R128-Marie_Bouzkova-Bianca_Andreescu,2,S-XC,5,0,0,0,0,2,3
20190527-W-Roland_Garros-R128-Marie_Bouzkova-Bianca_Andreescu,2,S-DTM,13,3,0,0,3,7,6
20190527-W-Roland_Garros-R128-Marie_Bouzkova-Bianca_Andreescu,2,S-DTL,4,0,0,0,0,0,4
20190527-W-Roland_Garros-R128-Marie_Bouzkova-Bianca_Andreescu,2,S-IO,4,1,0,0,1,0,4
20190527-W-Roland_Garros-R128-Kiki_Bertens-Pauline_Parmentier,1,F-XC,48,11,3,3,5,30,18
20190527-W-Roland_Garros-R128-Kiki_Bertens-Pauline_Parmentier,1,F-DTM,23,4,0,0,4,8,15
20190527-W-Roland_Garros-R128-Kiki_Bertens-Pauline_Parmentier,1,F-DTL,10,4,0,1,3,7,3
20190527-W-Roland_Garros-R128-Kiki_Bertens-Pauline_Parmentier,1,F-IO,35,9,2,5,2,25,10
20190527-W-Roland_Garros-R128-Kiki_Bertens-Pauline_Parmentier,1,F-II,5,3,2,1,0,4,1
20190527-W-Roland_Garros-R128-Kiki_Bertens-Pauline_Parmentier,1,B-XC,28,3,0,0,3,14,14
20190527-W-Roland_Garros-R128-Kiki_Bertens-Pauline_Parmentier,1,B-DTM,20,2,0,1,1,12,8
20190527-W-Roland_Garros-R128-Kiki_Bertens-Pauline_Parmentier,1,B-DTL,11,3,1,1,1,5,6
20190527-W-Roland_Garros-R128-Kiki_Bertens-Pauline_Parmentier,1,S-XC,8,0,0,0,0,4,4
20190527-W-Roland_Garros-R128-Kiki_Bertens-Pauline_Parmentier,1,S-DTM,3,0,0,0,0,3,0
20190527-W-Roland_Garros-R128-Kiki_Bertens-Pauline_Parmentier,1,S-DTL,1,1,0,1,0,1,0
20190527-W-Roland_Garros-R128-Kiki_Bertens-Pauline_Parmentier,2,F-XC,53,8,1,2,5,23,30
20190527-W-Roland_Garros-R128-Kiki_Bertens-Pauline_Parmentier,2,F-DTM,37,1,0,1,0,18,19
20190527-W-Roland_Garros-R128-Kiki_Bertens-Pauline_Parmentier,2,F-DTL,7,1,1,0,0,3,4
20190527-W-Roland_Garros-R128-Kiki_Bertens-Pauline_Parmentier,2,F-IO,34,8,3,2,3,18,16
20190527-W-Roland_Garros-R128-Kiki_Bertens-Pauline_Parmentier,2,F-II,5,1,0,0,1,2,3
20190527-W-Roland_Garros-R128-Kiki_Bertens-Pauline_Parmentier,2,B-XC,37,4,0,1,3,15,22
20190527-W-Roland_Garros-R128-Kiki_Bertens-Pauline_Parmentier,2,B-DTM,21,1,0,0,1,9,12
20190527-W-Roland_Garros-R128-Kiki_Bertens-Pauline_Parmentier,2,S-XC,5,1,0,0,1,0,5
20190527-W-Roland_Garros-R128-Kiki_Bertens-Pauline_Parmentier,2,S-DTM,4,0,0,0,0,1,3
20190527-W-Roland_Garros-R128-Kiki_Bertens-Pauline_Parmentier,2,S-DTL,1,0,0,0,0,0,1
20190528-W-Roland_Garros-R128-Simona_Halep-Ajla_Tomljanovic,1,F-XC,50,12,3,4,5,25,25
20190528-W-Roland_Garros-R128-Simona_Halep-Ajla_Tomljanovic,1,F-DTM,41,2,0,1,1,27,14
20190528-W-Roland_Garros-R128-Simona_Halep-Ajla_Tomljanovic,1,F-DTL,14,9,2,3,4,6,8
20190528-W-Roland_Garros-R128-Simona_Halep-Ajla_Tomljanovic,1,F-IO,33,8,1,2,5,13,20
20190528-W-Roland_Garros-R128-Simona_Halep-Ajla_Tomljanovic,1,F-II,2,1,0,1,0,1,1
20190528-W-Roland_Garros-R128-Simona_Halep-Ajla_Tomljanovic,1,B-XC,49,4,0,2,2,32,17
20190528-W-Roland_Garros-R128-Simona_Halep-Ajla_Tomljanovic,1,B-DTM,50,3,0,0,3,24,26
20190528-W-Roland_Garros-R128-Simona_Halep-Ajla_Tomljanovic,1,B-DTL,11,2,1,0,1,7,4
20190528-W-Roland_Garros-R128-Simona_Halep-Ajla_Tomljanovic,1,B-IO,13,3,1,1,1,7,6
20190528-W-Roland_Garros-R128-Simona_Halep-Ajla_Tomljanovic,1,S-XC,2,0,0,0,0,2,0
20190528-W-Roland_Garros-R128-Simona_Halep-Ajla_Tomljanovic,1,S-DTL,1,0,0,0,0,0,1
20190528-W-Roland_Garros-R128-Simona_Halep-Ajla_Tomljanovic,2,F-XC,44,9,1,4,4,21,23
20190528-W-Roland_Garros-R128-Simona_Halep-Ajla_Tomljanovic,2,F-DTM,47,5,1,0,4,20,27
20190528-W-Roland_Garros-R128-Simona_Halep-Ajla_Tomljanovic,2,F-DTL,8,3,1,1,1,5,3
20190528-W-Roland_Garros-R128-Simona_Halep-Ajla_Tomljanovic,2,F-IO,19,7,1,4,2,9,10
20190528-W-Roland_Garros-R128-Simona_Halep-Ajla_Tomljanovic,2,B-XC,42,6,0,1,5,20,22
20190528-W-Roland_Garros-R128-Simona_Halep-Ajla_Tomljanovic,2,B-DTM,70,8,1,0,7,29,41
20190528-W-Roland_Garros-R128-Simona_Halep-Ajla_Tomljanovic,2,B-DTL,7,2,2,0,0,3,4
20190528-W-Roland_Garros-R128-Simona_Halep-Ajla_Tomljanovic,2,B-IO,7,2,0,1,1,4,3
20190528-W-Roland_Garros-R128-Simona_Halep-Ajla_Tomljanovic,2,S-XC,1,0,0,0,0,0,1
20190528-W-Roland_Garros-R128-Simona_Halep-Ajla_Tomljanovic,2,S-DTM,8,1,0,0,1,4,4
20190528-W-Roland_Garros-R128-Simona_Halep-Ajla_Tomljanovic,2,S-DTL,3,0,0,0,0,1,2
20190528-W-Roland_Garros-R128-Simona_Halep-Ajla_Tomljanovic,2,S-IO,1,0,0,0,0,0,1
20190530-W-Roland_Garros-R64-Ashleigh_Barty-Danielle_Collins,1,F-XC,39,10,3,3,4,24,15
20190530-W-Roland_Garros-R64-Ashleigh_Barty-Danielle_Collins,1,F-DTM,5,1,1,0,0,3,2
20190530-W-Roland_Garros-R64-Ashleigh_Barty-Danielle_Collins,1,F-DTL,7,4,1,2,1,6,1
20190530-W-Roland_Garros-R64-Ashleigh_Barty-Danielle_Collins,1,F-IO,17,7,2,1,4,7,10
20190530-W-Roland_Garros-R64-Ashleigh_Barty-Danielle_Collins,1,F-II,3,3,1,2,0,3,0
20190530-W-Roland_Garros-R64-Ashleigh_Barty-Danielle_Collins,1,B-XC,10,3,1,0,2,6,4
20190530-W-Roland_Garros-R64-Ashleigh_Barty-Danielle_Collins,1,B-DTM,12,3,0,0,3,6,6
20190530-W-Roland_Garros-R64-Ashleigh_Barty-Danielle_Collins,1,B-DTL,2,0,0,0,0,2,0
20190530-W-Roland_Garros-R64-Ashleigh_Barty-Danielle_Collins,1,B-IO,2,0,0,0,0,2,0
20190530-W-Roland_Garros-R64-Ashleigh_Barty-Danielle_Collins,1,S-XC,23,2,1,0,1,7,16
20190530-W-Roland_Garros-R64-Ashleigh_Barty-Danielle_Collins,1,S-DTM,21,5,0,1,4,7,14
20190530-W-Roland_Garros-R64-Ashleigh_Barty-Danielle_Collins,1,S-DTL,4,1,0,0,1,1,3
20190530-W-Roland_Garros-R64-Ashleigh_Barty-Danielle_Collins,1,S-IO,3,0,0,0,0,3,0
20190530-W-Roland_Garros-R64-Ashleigh_Barty-Danielle_Collins,2,F-XC,27,4,2,0,1,8,19
20190530-W-Roland_Garros-R64-Ashleigh_Barty-Danielle_Collins,2,F-DTM,12,0,0,0,0,5,7
20190530-W-Roland_Garros-R64-Ashleigh_Barty-Danielle_Collins,2,F-DTL,15,8,1,1,6,6,9
20190530-W-Roland_Garros-R64-Ashleigh_Barty-Danielle_Collins,2,F-IO,12,2,2,0,0,8,4
20190530-W-Roland_Garros-R64-Ashleigh_Barty-Danielle_Collins,2,F-II,2,0,0,0,0,1,1
20190530-W-Roland_Garros-R64-Ashleigh_Barty-Danielle_Collins,2,B-XC,43,6,2,1,3,25,18
20190530-W-Roland_Garros-R64-Ashleigh_Barty-Danielle_Collins,2,B-DTM,21,1,0,0,1,9,12
20190530-W-Roland_Garros-R64-Ashleigh_Barty-Danielle_Collins,2,B-DTL,13,7,2,2,3,6,7
20190530-W-Roland_Garros-R64-Ashleigh_Barty-Danielle_Collins,2,B-IO,5,3,1,1,1,3,2
20190530-W-Roland_Garros-R64-Ashleigh_Barty-Danielle_Collins,2,S-XC,1,0,0,0,0,0,1
20190530-W-Roland_Garros-R64-Ashleigh_Barty-Danielle_Collins,2,S-DTL,1,1,0,0,1,0,1
20190530-W-Roland_Garros-R64-Ashleigh_Barty-Danielle_Collins,2,S-IO,1,1,0,1,0,1,0
20040821-W-Olympics-F-Amelie_Mauresmo-Justine_Henin,1,F-XC,24,4,1,1,2,14,10
20040821-W-Olympics-F-Amelie_Mauresmo-Justine_Henin,1,F-DTM,7,1,0,1,0,2,5
20040821-W-Olympics-F-Amelie_Mauresmo-Justine_Henin,1,F-DTL,16,2,1,0,1,6,10
20040821-W-Olympics-F-Amelie_Mauresmo-Justine_Henin,1,F-IO,23,3,0,1,2,12,11
20040821-W-Olympics-F-Amelie_Mauresmo-Justine_Henin,1,B-XC,36,7,1,2,4,18,18
20040821-W-Olympics-F-Amelie_Mauresmo-Justine_Henin,1,B-DTM,12,3,0,1,2,4,8
20040821-W-Olympics-F-Amelie_Mauresmo-Justine_Henin,1,B-DTL,5,2,1,0,1,3,2
20040821-W-Olympics-F-Amelie_Mauresmo-Justine_Henin,1,S-XC,10,1,0,0,1,4,6
20040821-W-Olympics-F-Amelie_Mauresmo-Justine_Henin,1,S-DTM,5,0,0,0,0,3,2
20040821-W-Olympics-F-Amelie_Mauresmo-Justine_Henin,1,S-DTL,2,1,0,0,1,0,2
20040821-W-Olympics-F-Amelie_Mauresmo-Justine_Henin,2,F-XC,31,9,2,2,5,12,19
20040821-W-Olympics-F-Amelie_Mauresmo-Justine_Henin,2,F-DTM,8,0,0,0,0,3,5
20040821-W-Olympics-F-Amelie_Mauresmo-Justine_Henin,2,F-DTL,2,2,1,1,0,2,0
20040821-W-Olympics-F-Amelie_Mauresmo-Justine_Henin,2,F-IO,18,3,0,1,2,10,8
20040821-W-Olympics-F-Amelie_Mauresmo-Justine_Henin,2,F-II,2,1,0,1,0,2,0
20040821-W-Olympics-F-Amelie_Mauresmo-Justine_Henin,2,B-XC,38,7,1,3,3,23,15
20040821-W-Olympics-F-Amelie_Mauresmo-Justine_Henin,2,B-DTM,13,3,0,2,1,8,5
20040821-W-Olympics-F-Amelie_Mauresmo-Justine_Henin,2,B-DTL,16,9,2,4,3,9,7
20040821-W-Olympics-F-Amelie_Mauresmo-Justine_Henin,2,B-IO,2,0,0,0,0,2,0
20040821-W-Olympics-F-Amelie_Mauresmo-Justine_Henin,2,S-XC,8,1,0,0,1,4,4
20040821-W-Olympics-F-Amelie_Mauresmo-Justine_Henin,2,S-DTM,2,0,0,0,0,1,1
20040821-W-Olympics-F-Amelie_Mauresmo-Justine_Henin,2,S-DTL,1,0,0,0,0,1,0
20070509-W-Roland_Garros-F-Justine_Henin-Ana_Ivanovic,1,F-XC,41,10,1,6,3,23,18
20070509-W-Roland_Garros-F-Justine_Henin-Ana_Ivanovic,1,F-DTM,14,1,1,0,0,8,6
20070509-W-Roland_Garros-F-Justine_Henin-Ana_Ivanovic,1,F-DTL,21,2,1,1,0,12,9
20070509-W-Roland_Garros-F-Justine_Henin-Ana_Ivanovic,1,F-IO,13,5,1,3,1,7,6
20070509-W-Roland_Garros-F-Justine_Henin-Ana_Ivanovic,1,B-XC,8,2,1,0,1,5,3
20070509-W-Roland_Garros-F-Justine_Henin-Ana_Ivanovic,1,B-DTM,4,0,0,0,0,2,2
20070509-W-Roland_Garros-F-Justine_Henin-Ana_Ivanovic,1,B-DTL,4,3,1,2,0,3,1
20070509-W-Roland_Garros-F-Justine_Henin-Ana_Ivanovic,1,B-IO,1,1,0,0,1,0,1
20070509-W-Roland_Garros-F-Justine_Henin-Ana_Ivanovic,1,S-XC,5,0,0,0,0,2,3
20070509-W-Roland_Garros-F-Justine_Henin-Ana_Ivanovic,1,S-DTL,1,0,0,0,0,0,1
20070509-W-Roland_Garros-F-Justine_Henin-Ana_Ivanovic,2,F-XC,39,9,3,2,4,16,23
20070509-W-Roland_Garros-F-Justine_Henin-Ana_Ivanovic,2,F-DTM,10,2,1,0,1,6,4
20070509-W-Roland_Garros-F-Justine_Henin-Ana_Ivanovic,2,F-DTL,6,4,1,2,1,4,2
20070509-W-Roland_Garros-F-Justine_Henin-Ana_Ivanovic,2,F-IO,8,2,0,0,2,1,7
20070509-W-Roland_Garros-F-Justine_Henin-Ana_Ivanovic,2,F-II,5,2,1,0,1,2,3
20070509-W-Roland_Garros-F-Justine_Henin-Ana_Ivanovic,2,B-XC,17,7,1,0,6,6,11
20070509-W-Roland_Garros-F-Justine_Henin-Ana_Ivanovic,2,B-DTM,6,2,0,0,2,2,4
20070509-W-Roland_Garros-F-Justine_Henin-Ana_Ivanovic,2,B-DTL,17,4,1,1,2,7,10
20070509-W-Roland_Garros-F-Justine_Henin-Ana_Ivanovic,2,B-IO,2,0,0,0,0,2,0
20070509-W-Roland_Garros-F-Justine_Henin-Ana_Ivanovic,2,S-XC,1,0,0,0,0,1,0
20070509-W-Roland_Garros-F-Justine_Henin-Ana_Ivanovic,2,S-DTM,2,0,0,0,0,2,0
20070509-W-Roland_Garros-F-Justine_Henin-Ana_Ivanovic,2,S-DTL,1,0,0,0,0,1,0
20080126-W-Australian_Open-F-Ana_Ivanovic-Maria_Sharapova,1,F-XC,18,7,2,2,3,7,11
20080126-W-Australian_Open-F-Ana_Ivanovic-Maria_Sharapova,1,F-DTM,3,0,0,0,0,2,1
20080126-W-Australian_Open-F-Ana_Ivanovic-Maria_Sharapova,1,F-DTL,9,5,1,1,3,4,5
20080126-W-Australian_Open-F-Ana_Ivanovic-Maria_Sharapova,1,F-IO,8,6,1,1,4,2,6
20080126-W-Australian_Open-F-Ana_Ivanovic-Maria_Sharapova,1,F-II,2,1,0,0,1,0,2
20080126-W-Australian_Open-F-Ana_Ivanovic-Maria_Sharapova,1,B-XC,21,5,3,2,0,9,12
20080126-W-Australian_Open-F-Ana_Ivanovic-Maria_Sharapova,1,B-DTM,12,0,0,0,0,3,9
20080126-W-Australian_Open-F-Ana_Ivanovic-Maria_Sharapova,1,B-DTL,11,6,0,2,4,5,6
20080126-W-Australian_Open-F-Ana_Ivanovic-Maria_Sharapova,1,B-IO,6,4,1,0,3,1,5
20080126-W-Australian_Open-F-Ana_Ivanovic-Maria_Sharapova,1,S-XC,1,0,0,0,0,0,1
20080126-W-Australian_Open-F-Ana_Ivanovic-Maria_Sharapova,1,S-DTM,2,0,0,0,0,1,1
20080126-W-Australian_Open-F-Ana_Ivanovic-Maria_Sharapova,2,F-XC,24,12,3,5,4,17,7
20080126-W-Australian_Open-F-Ana_Ivanovic-Maria_Sharapova,2,F-DTM,6,0,0,0,0,4,2
20080126-W-Australian_Open-F-Ana_Ivanovic-Maria_Sharapova,2,F-DTL,9,3,2,1,0,7,2
20080126-W-Australian_Open-F-Ana_Ivanovic-Maria_Sharapova,2,F-IO,12,5,5,0,0,11,1
20080126-W-Australian_Open-F-Ana_Ivanovic-Maria_Sharapova,2,B-XC,21,4,1,2,1,17,4
20080126-W-Australian_Open-F-Ana_Ivanovic-Maria_Sharapova,2,B-DTM,10,1,0,1,0,6,4
20080126-W-Australian_Open-F-Ana_Ivanovic-Maria_Sharapova,2,B-DTL,4,1,0,1,0,4,0
20080126-W-Australian_Open-F-Ana_Ivanovic-Maria_Sharapova,2,B-IO,2,1,0,1,0,2,0
20080806-W-US_Open-F-Serena_Williams-Jelena_Jankovic,1,F-XC,99,18,4,3,11,53,46
20080806-W-US_Open-F-Serena_Williams-Jelena_Jankovic,1,F-DTM,23,0,0,0,0,14,9
20080806-W-US_Open-F-Serena_Williams-Jelena_Jankovic,1,F-DTL,42,7,1,2,4,25,17
20080806-W-US_Open-F-Serena_Williams-Jelena_Jankovic,1,F-IO,29,10,5,2,3,20,9
20080806-W-US_Open-F-Serena_Williams-Jelena_Jankovic,1,B-XC,86,16,4,3,9,39,47
20080806-W-US_Open-F-Serena_Williams-Jelena_Jankovic,1,B-DTM,16,1,0,0,1,4,12
20080806-W-US_Open-F-Serena_Williams-Jelena_Jankovic,1,B-DTL,25,9,3,3,3,16,9
20080806-W-US_Open-F-Serena_Williams-Jelena_Jankovic,1,B-IO,7,3,2,0,1,6,1
20080806-W-US_Open-F-Serena_Williams-Jelena_Jankovic,1,S-XC,6,0,0,0,0,3,3
20080806-W-US_Open-F-Serena_Williams-Jelena_Jankovic,1,S-DTM,8,1,0,0,1,4,4
20080806-W-US_Open-F-Serena_Williams-Jelena_Jankovic,2,F-XC,57,4,0,2,2,24,33
20080806-W-US_Open-F-Serena_Williams-Jelena_Jankovic,2,F-DTM,15,0,0,0,0,8,7
20080806-W-US_Open-F-Serena_Williams-Jelena_Jankovic,2,F-DTL,55,11,3,4,4,25,30
20080806-W-US_Open-F-Serena_Williams-Jelena_Jankovic,2,F-IO,18,4,1,2,1,12,6
20080806-W-US_Open-F-Serena_Williams-Jelena_Jankovic,2,F-II,1,0,0,0,0,0,1
20080806-W-US_Open-F-Serena_Williams-Jelena_Jankovic,2,B-XC,60,9,3,1,5,33,27
20080806-W-US_Open-F-Serena_Williams-Jelena_Jankovic,2,B-DTM,40,2,0,1,1,17,23
20080806-W-US_Open-F-Serena_Williams-Jelena_Jankovic,2,B-DTL,51,5,2,1,2,27,24
20080806-W-US_Open-F-Serena_Williams-Jelena_Jankovic,2,B-IO,25,3,0,1,2,11,14
20080806-W-US_Open-F-Serena_Williams-Jelena_Jankovic,2,S-XC,5,0,0,0,0,1,4
20080806-W-US_Open-F-Serena_Williams-Jelena_Jankovic,2,S-DTM,3,0,0,0,0,0,3
20080806-W-US_Open-F-Serena_Williams-Jelena_Jankovic,2,S-DTL,1,0,0,0,0,0,1
20120128-W-Australian_Open-F-Victoria_Azarenka-Maria_Sharapova,1,F-XC,41,4,2,2,0,31,10
20120128-W-Australian_Open-F-Victoria_Azarenka-Maria_Sharapova,1,F-DTM,9,1,0,0,1,5,4
20120128-W-Australian_Open-F-Victoria_Azarenka-Maria_Sharapova,1,F-DTL,27,6,2,3,1,15,12
20120128-W-Australian_Open-F-Victoria_Azarenka-Maria_Sharapova,1,F-IO,7,3,1,2,0,6,1
20120128-W-Australian_Open-F-Victoria_Azarenka-Maria_Sharapova,1,B-XC,24,6,1,4,1,19,5
20120128-W-Australian_Open-F-Victoria_Azarenka-Maria_Sharapova,1,B-DTM,28,1,0,0,1,10,18
20120128-W-Australian_Open-F-Victoria_Azarenka-Maria_Sharapova,1,B-DTL,15,6,1,2,3,9,6
20120128-W-Australian_Open-F-Victoria_Azarenka-Maria_Sharapova,1,B-IO,4,0,0,0,0,3,1
20120128-W-Australian_Open-F-Victoria_Azarenka-Maria_Sharapova,1,S-XC,4,0,0,0,0,3,1
20120128-W-Australian_Open-F-Victoria_Azarenka-Maria_Sharapova,1,S-DTM,2,0,0,0,0,2,0
20120128-W-Australian_Open-F-Victoria_Azarenka-Maria_Sharapova,1,S-DTL,1,0,0,0,0,0,1
20120128-W-Australian_Open-F-Victoria_Azarenka-Maria_Sharapova,2,F-XC,42,8,0,4,4,15,27
20120128-W-Australian_Open-F-Victoria_Azarenka-Maria_Sharapova,2,F-DTM,13,2,1,0,1,5,8
20120128-W-Australian_Open-F-Victoria_Azarenka-Maria_Sharapova,2,F-DTL,17,6,1,1,4,6,11
20120128-W-Australian_Open-F-Victoria_Azarenka-Maria_Sharapova,2,F-IO,20,7,2,2,3,10,10
20120128-W-Australian_Open-F-Victoria_Azarenka-Maria_Sharapova,2,F-II,2,0,0,0,0,1,1
20120128-W-Australian_Open-F-Victoria_Azarenka-Maria_Sharapova,2,B-XC,38,6,1,0,5,15,23
20120128-W-Australian_Open-F-Victoria_Azarenka-Maria_Sharapova,2,B-DTM,12,1,0,0,1,2,10
20120128-W-Australian_Open-F-Victoria_Azarenka-Maria_Sharapova,2,B-DTL,13,6,2,0,4,3,10
20120128-W-Australian_Open-F-Victoria_Azarenka-Maria_Sharapova,2,B-IO,9,2,1,0,1,6,3
20120128-W-Australian_Open-F-Victoria_Azarenka-Maria_Sharapova,2,S-XC,2,0,0,0,0,1,1
20120128-W-Australian_Open-F-Victoria_Azarenka-Maria_Sharapova,2,S-DTM,1,0,0,0,0,0,1
20190611-W-s_Hertogenbosch-R32-Johanna_Larsson-Kiki_Bertens,1,F-XC,14,3,0,0,3,6,8
20190611-W-s_Hertogenbosch-R32-Johanna_Larsson-Kiki_Bertens,1,F-DTM,18,4,0,0,4,4,14
20190611-W-s_Hertogenbosch-R32-Johanna_Larsson-Kiki_Bertens,1,F-DTL,9,2,0,0,2,6,3
20190611-W-s_Hertogenbosch-R32-Johanna_Larsson-Kiki_Bertens,1,F-IO,14,2,0,1,1,9,5
20190611-W-s_Hertogenbosch-R32-Johanna_Larsson-Kiki_Bertens,1,F-II,2,0,0,0,0,0,2
20190611-W-s_Hertogenbosch-R32-Johanna_Larsson-Kiki_Bertens,1,B-XC,16,2,0,0,2,5,11
20190611-W-s_Hertogenbosch-R32-Johanna_Larsson-Kiki_Bertens,1,B-DTM,5,1,1,0,0,2,3
20190611-W-s_Hertogenbosch-R32-Johanna_Larsson-Kiki_Bertens,1,B-DTL,4,2,0,1,1,1,3
20190611-W-s_Hertogenbosch-R32-Johanna_Larsson-Kiki_Bertens,1,B-IO,3,0,0,0,0,1,2
20190611-W-s_Hertogenbosch-R32-Johanna_Larsson-Kiki_Bertens,1,S-XC,10,1,0,0,1,4,6
20190611-W-s_Hertogenbosch-R32-Johanna_Larsson-Kiki_Bertens,1,S-DTM,2,0,0,0,0,0,2
20190611-W-s_Hertogenbosch-R32-Johanna_Larsson-Kiki_Bertens,1,S-DTL,3,0,0,0,0,0,3
20190611-W-s_Hertogenbosch-R32-Johanna_Larsson-Kiki_Bertens,2,F-XC,24,7,1,4,2,13,11
20190611-W-s_Hertogenbosch-R32-Johanna_Larsson-Kiki_Bertens,2,F-DTM,8,1,0,0,1,6,2
20190611-W-s_Hertogenbosch-R32-Johanna_Larsson-Kiki_Bertens,2,F-DTL,4,2,2,0,0,3,1
20190611-W-s_Hertogenbosch-R32-Johanna_Larsson-Kiki_Bertens,2,F-IO,11,3,0,1,2,8,3
20190611-W-s_Hertogenbosch-R32-Johanna_Larsson-Kiki_Bertens,2,B-XC,14,2,0,1,1,8,6
20190611-W-s_Hertogenbosch-R32-Johanna_Larsson-Kiki_Bertens,2,B-DTM,16,1,0,0,1,10,6
20190611-W-s_Hertogenbosch-R32-Johanna_Larsson-Kiki_Bertens,2,B-DTL,2,1,0,0,1,1,1
20190611-W-s_Hertogenbosch-R32-Johanna_Larsson-Kiki_Bertens,2,B-IO,1,1,0,0,1,0,1
20190611-W-s_Hertogenbosch-R32-Johanna_Larsson-Kiki_Bertens,2,S-XC,4,0,0,0,0,2,2
20190611-W-s_Hertogenbosch-R32-Johanna_Larsson-Kiki_Bertens,2,S-DTM,7,1,0,0,1,1,6
20190611-W-s_Hertogenbosch-R32-Johanna_Larsson-Kiki_Bertens,2,S-DTL,5,2,0,0,2,0,5
20190613-W-s_Hertogenbosch-R16-Kiki_Bertens-Arantxa_Rus,1,F-XC,87,15,2,2,10,52,35
20190613-W-s_Hertogenbosch-R16-Kiki_Bertens-Arantxa_Rus,1,F-DTM,33,5,0,1,4,15,18
20190613-W-s_Hertogenbosch-R16-Kiki_Bertens-Arantxa_Rus,1,F-DTL,13,8,1,2,5,5,8
20190613-W-s_Hertogenbosch-R16-Kiki_Bertens-Arantxa_Rus,1,F-IO,11,4,0,1,3,5,6
20190613-W-s_Hertogenbosch-R16-Kiki_Bertens-Arantxa_Rus,1,B-XC,10,3,0,1,2,4,6
20190613-W-s_Hertogenbosch-R16-Kiki_Bertens-Arantxa_Rus,1,B-DTM,11,2,1,0,1,5,6
20190613-W-s_Hertogenbosch-R16-Kiki_Bertens-Arantxa_Rus,1,B-DTL,3,1,0,1,0,3,0
20190613-W-s_Hertogenbosch-R16-Kiki_Bertens-Arantxa_Rus,1,B-IO,1,0,0,0,0,0,1
20190613-W-s_Hertogenbosch-R16-Kiki_Bertens-Arantxa_Rus,1,S-XC,3,0,0,0,0,0,3
20190613-W-s_Hertogenbosch-R16-Kiki_Bertens-Arantxa_Rus,1,S-DTM,4,0,0,0,0,0,4
20190613-W-s_Hertogenbosch-R16-Kiki_Bertens-Arantxa_Rus,2,F-XC,20,7,1,3,3,13,7
20190613-W-s_Hertogenbosch-R16-Kiki_Bertens-Arantxa_Rus,2,F-DTM,17,4,1,0,3,9,8
20190613-W-s_Hertogenbosch-R16-Kiki_Bertens-Arantxa_Rus,2,F-DTL,8,2,1,0,1,5,3
20190613-W-s_Hertogenbosch-R16-Kiki_Bertens-Arantxa_Rus,2,F-IO,24,5,1,2,2,14,10
20190613-W-s_Hertogenbosch-R16-Kiki_Bertens-Arantxa_Rus,2,F-II,2,0,0,0,0,1,1
20190613-W-s_Hertogenbosch-R16-Kiki_Bertens-Arantxa_Rus,2,B-XC,58,12,1,2,9,23,35
20190613-W-s_Hertogenbosch-R16-Kiki_Bertens-Arantxa_Rus,2,B-DTM,55,5,0,0,5,21,34
20190613-W-s_Hertogenbosch-R16-Kiki_Bertens-Arantxa_Rus,2,B-DTL,5,3,0,0,3,1,4
20190613-W-s_Hertogenbosch-R16-Kiki_Bertens-Arantxa_Rus,2,B-IO,5,2,0,1,1,4,1
20190613-W-s_Hertogenbosch-R16-Kiki_Bertens-Arantxa_Rus,2,S-XC,4,0,0,0,0,1,3
20190613-W-s_Hertogenbosch-R16-Kiki_Bertens-Arantxa_Rus,2,S-DTM,1,0,0,0,0,1,0
20190613-W-s_Hertogenbosch-R16-Kiki_Bertens-Arantxa_Rus,2,S-DTL,2,1,0,0,1,1,1
20190615-W-s_Hertogenbosch-SF-Elena_Rybakina-Kiki_Bertens,1,F-XC,48,13,4,3,6,30,18
20190615-W-s_Hertogenbosch-SF-Elena_Rybakina-Kiki_Bertens,1,F-DTM,16,1,0,0,1,8,8
20190615-W-s_Hertogenbosch-SF-Elena_Rybakina-Kiki_Bertens,1,F-DTL,18,9,4,0,5,10,8
20190615-W-s_Hertogenbosch-SF-Elena_Rybakina-Kiki_Bertens,1,F-IO,21,7,1,2,4,13,8
20190615-W-s_Hertogenbosch-SF-Elena_Rybakina-Kiki_Bertens,1,F-II,1,0,0,0,0,1,0
20190615-W-s_Hertogenbosch-SF-Elena_Rybakina-Kiki_Bertens,1,B-XC,36,3,0,1,2,17,19
20190615-W-s_Hertogenbosch-SF-Elena_Rybakina-Kiki_Bertens,1,B-DTM,13,3,0,0,3,4,9
20190615-W-s_Hertogenbosch-SF-Elena_Rybakina-Kiki_Bertens,1,B-DTL,2,0,0,0,0,1,1
20190615-W-s_Hertogenbosch-SF-Elena_Rybakina-Kiki_Bertens,1,B-IO,2,0,0,0,0,0,2
20190615-W-s_Hertogenbosch-SF-Elena_Rybakina-Kiki_Bertens,1,S-XC,2,1,0,0,1,0,2
20190615-W-s_Hertogenbosch-SF-Elena_Rybakina-Kiki_Bertens,2,F-XC,35,2,0,0,2,12,23
20190615-W-s_Hertogenbosch-SF-Elena_Rybakina-Kiki_Bertens,2,F-DTM,12,4,0,0,4,4,8
20190615-W-s_Hertogenbosch-SF-Elena_Rybakina-Kiki_Bertens,2,F-DTL,6,3,0,0,3,1,5
20190615-W-s_Hertogenbosch-SF-Elena_Rybakina-Kiki_Bertens,2,F-IO,9,4,2,0,2,5,4
20190615-W-s_Hertogenbosch-SF-Elena_Rybakina-Kiki_Bertens,2,B-XC,16,4,0,1,3,9,7
20190615-W-s_Hertogenbosch-SF-Elena_Rybakina-Kiki_Bertens,2,B-DTM,23,3,0,0,3,9,14
20190615-W-s_Hertogenbosch-SF-Elena_Rybakina-Kiki_Bertens,2,B-DTL,3,1,1,0,0,2,1
20190615-W-s_Hertogenbosch-SF-Elena_Rybakina-Kiki_Bertens,2,S-XC,7,0,0,0,0,2,5
20190615-W-s_Hertogenbosch-SF-Elena_Rybakina-Kiki_Bertens,2,S-DTM,17,1,0,0,1,7,10
20190615-W-s_Hertogenbosch-SF-Elena_Rybakina-Kiki_Bertens,2,S-IO,1,0,0,0,0,0,1
20190616-W-s_Hertogenbosch-F-Kiki_Bertens-Alison_Riske,1,F-XC,43,11,6,2,3,23,20
20190616-W-s_Hertogenbosch-F-Kiki_Bertens-Alison_Riske,1,F-DTM,19,4,1,1,2,10,9
20190616-W-s_Hertogenbosch-F-Kiki_Bertens-Alison_Riske,1,F-DTL,15,6,3,1,2,7,8
20190616-W-s_Hertogenbosch-F-Kiki_Bertens-Alison_Riske,1,F-IO,9,5,1,1,3,3,6
20190616-W-s_Hertogenbosch-F-Kiki_Bertens-Alison_Riske,1,B-XC,21,3,0,0,3,6,15
20190616-W-s_Hertogenbosch-F-Kiki_Bertens-Alison_Riske,1,B-DTM,26,0,0,0,0,11,15
20190616-W-s_Hertogenbosch-F-Kiki_Bertens-Alison_Riske,1,B-DTL,12,7,4,0,3,6,6
20190616-W-s_Hertogenbosch-F-Kiki_Bertens-Alison_Riske,1,B-IO,4,1,1,0,0,3,1
20190616-W-s_Hertogenbosch-F-Kiki_Bertens-Alison_Riske,1,S-XC,18,2,0,0,2,6,12
20190616-W-s_Hertogenbosch-F-Kiki_Bertens-Alison_Riske,1,S-DTM,29,0,0,0,0,10,19
20190616-W-s_Hertogenbosch-F-Kiki_Bertens-Alison_Riske,1,S-DTL,1,0,0,0,0,1,0
20190616-W-s_Hertogenbosch-F-Kiki_Bertens-Alison_Riske,1,S-IO,1,0,0,0,0,1,0
20190616-W-s_Hertogenbosch-F-Kiki_Bertens-Alison_Riske,2,F-XC,34,7,4,1,2,18,16
20190616-W-s_Hertogenbosch-F-Kiki_Bertens-Alison_Riske,2,F-DTM,24,1,0,0,1,8,16
20190616-W-s_Hertogenbosch-F-Kiki_Bertens-Alison_Riske,2,F-DTL,24,7,1,2,4,11,13
20190616-W-s_Hertogenbosch-F-Kiki_Bertens-Alison_Riske,2,F-IO,35,11,2,4,5,23,12
20190616-W-s_Hertogenbosch-F-Kiki_Bertens-Alison_Riske,2,B-XC,50,7,0,5,2,32,18
20190616-W-s_Hertogenbosch-F-Kiki_Bertens-Alison_Riske,2,B-DTM,31,3,0,1,2,21,10
20190616-W-s_Hertogenbosch-F-Kiki_Bertens-Alison_Riske,2,B-DTL,6,2,0,1,1,2,4
20190616-W-s_Hertogenbosch-F-Kiki_Bertens-Alison_Riske,2,B-IO,7,1,0,0,1,5,2
20190616-W-s_Hertogenbosch-F-Kiki_Bertens-Alison_Riske,2,S-DTM,2,0,0,0,0,0,2
20190616-W-s_Hertogenbosch-F-Kiki_Bertens-Alison_Riske,2,S-IO,1,0,0,0,0,1,0
20190610-W-s_Hertogenbosch-R32-Arantxa_Rus-Bibiane_Schoofs,1,F-XC,39,11,5,4,2,30,9
20190610-W-s_Hertogenbosch-R32-Arantxa_Rus-Bibiane_Schoofs,1,F-DTM,33,2,0,1,1,17,16
20190610-W-s_Hertogenbosch-R32-Arantxa_Rus-Bibiane_Schoofs,1,F-DTL,25,5,1,2,2,15,10
20190610-W-s_Hertogenbosch-R32-Arantxa_Rus-Bibiane_Schoofs,1,F-IO,22,5,2,1,2,12,10
20190610-W-s_Hertogenbosch-R32-Arantxa_Rus-Bibiane_Schoofs,1,F-II,1,1,1,0,0,1,0
20190610-W-s_Hertogenbosch-R32-Arantxa_Rus-Bibiane_Schoofs,1,B-XC,37,6,1,3,2,26,11
20190610-W-s_Hertogenbosch-R32-Arantxa_Rus-Bibiane_Schoofs,1,B-DTM,38,8,0,0,8,19,19
20190610-W-s_Hertogenbosch-R32-Arantxa_Rus-Bibiane_Schoofs,1,B-DTL,6,1,0,1,0,2,4
20190610-W-s_Hertogenbosch-R32-Arantxa_Rus-Bibiane_Schoofs,1,B-IO,3,2,0,2,0,3,0
20190610-W-s_Hertogenbosch-R32-Arantxa_Rus-Bibiane_Schoofs,1,S-XC,3,1,0,1,0,1,2
20190610-W-s_Hertogenbosch-R32-Arantxa_Rus-Bibiane_Schoofs,1,S-DTM,5,1,0,0,1,3,2
20190610-W-s_Hertogenbosch-R32-Arantxa_Rus-Bibiane_Schoofs,1,S-DTL,2,0,0,0,0,1,1
20190610-W-s_Hertogenbosch-R32-Arantxa_Rus-Bibiane_Schoofs,1,S-IO,1,0,0,0,0,0,1
20190610-W-s_Hertogenbosch-R32-Arantxa_Rus-Bibiane_Schoofs,2,F-XC,65,15,2,4,9,26,39
20190610-W-s_Hertogenbosch-R32-Arantxa_Rus-Bibiane_Schoofs,2,F-DTM,41,6,0,0,6,12,29
20190610-W-s_Hertogenbosch-R32-Arantxa_Rus-Bibiane_Schoofs,2,F-DTL,21,7,2,2,3,13,8
20190610-W-s_Hertogenbosch-R32-Arantxa_Rus-Bibiane_Schoofs,2,F-IO,21,7,2,4,1,13,8
20190610-W-s_Hertogenbosch-R32-Arantxa_Rus-Bibiane_Schoofs,2,B-XC,8,0,0,0,0,2,6
20190610-W-s_Hertogenbosch-R32-Arantxa_Rus-Bibiane_Schoofs,2,B-DTM,8,1,0,0,1,2,6
20190610-W-s_Hertogenbosch-R32-Arantxa_Rus-Bibiane_Schoofs,2,B-DTL,2,0,0,0,0,0,2
20190610-W-s_Hertogenbosch-R32-Arantxa_Rus-Bibiane_Schoofs,2,S-XC,23,4,0,2,2,8,15
20190610-W-s_Hertogenbosch-R32-Arantxa_Rus-Bibiane_Schoofs,2,S-DTM,11,0,0,0,0,5,6
20190610-W-s_Hertogenbosch-R32-Arantxa_Rus-Bibiane_Schoofs,2,S-DTL,3,1,1,0,0,1,2
20190610-W-s_Hertogenbosch-R32-Arantxa_Rus-Bibiane_Schoofs,2,S-IO,3,0,0,0,0,1,2
20190531-W-Roland_Garros-R32-Carla_Suarez_Navarro-Marketa_Vondrousova,1,F-XC,69,17,5,3,9,36,33
20190531-W-Roland_Garros-R32-Carla_Suarez_Navarro-Marketa_Vondrousova,1,F-DTM,21,5,0,1,4,7,14
20190531-W-Roland_Garros-R32-Carla_Suarez_Navarro-Marketa_Vondrousova,1,F-DTL,8,2,2,0,0,3,5
20190531-W-Roland_Garros-R32-Carla_Suarez_Navarro-Marketa_Vondrousova,1,F-IO,39,11,4,3,4,29,10
20190531-W-Roland_Garros-R32-Carla_Suarez_Navarro-Marketa_Vondrousova,1,F-II,9,6,2,3,1,7,2
20190531-W-Roland_Garros-R32-Carla_Suarez_Navarro-Marketa_Vondrousova,1,B-XC,67,15,3,2,10,26,41
20190531-W-Roland_Garros-R32-Carla_Suarez_Navarro-Marketa_Vondrousova,1,B-DTM,22,3,0,0,3,7,15
20190531-W-Roland_Garros-R32-Carla_Suarez_Navarro-Marketa_Vondrousova,1,B-DTL,6,3,2,0,1,4,2
20190531-W-Roland_Garros-R32-Carla_Suarez_Navarro-Marketa_Vondrousova,1,B-IO,2,0,0,0,0,1,1
20190531-W-Roland_Garros-R32-Carla_Suarez_Navarro-Marketa_Vondrousova,1,S-XC,6,0,0,0,0,1,5
20190531-W-Roland_Garros-R32-Carla_Suarez_Navarro-Marketa_Vondrousova,1,S-DTM,4,0,0,0,0,2,2
20190531-W-Roland_Garros-R32-Carla_Suarez_Navarro-Marketa_Vondrousova,1,S-DTL,1,0,0,0,0,0,1
20190531-W-Roland_Garros-R32-Carla_Suarez_Navarro-Marketa_Vondrousova,1,S-IO,2,0,0,0,0,1,1
20190531-W-Roland_Garros-R32-Carla_Suarez_Navarro-Marketa_Vondrousova,2,F-XC,85,7,4,2,1,51,34
20190531-W-Roland_Garros-R32-Carla_Suarez_Navarro-Marketa_Vondrousova,2,F-DTM,23,2,0,1,1,8,15
20190531-W-Roland_Garros-R32-Carla_Suarez_Navarro-Marketa_Vondrousova,2,F-DTL,22,12,3,1,8,13,9
20190531-W-Roland_Garros-R32-Carla_Suarez_Navarro-Marketa_Vondrousova,2,F-IO,6,2,2,0,0,4,2
20190531-W-Roland_Garros-R32-Carla_Suarez_Navarro-Marketa_Vondrousova,2,F-II,2,0,0,0,0,2,0
20190531-W-Roland_Garros-R32-Carla_Suarez_Navarro-Marketa_Vondrousova,2,B-XC,27,6,2,1,3,16,11
20190531-W-Roland_Garros-R32-Carla_Suarez_Navarro-Marketa_Vondrousova,2,B-DTM,33,1,0,0,1,18,15
20190531-W-Roland_Garros-R32-Carla_Suarez_Navarro-Marketa_Vondrousova,2,B-DTL,4,1,1,0,0,2,2
20190531-W-Roland_Garros-R32-Carla_Suarez_Navarro-Marketa_Vondrousova,2,B-IO,2,1,0,0,1,1,1
20190531-W-Roland_Garros-R32-Carla_Suarez_Navarro-Marketa_Vondrousova,2,S-DTM,12,0,0,0,0,5,7
20190531-W-Roland_Garros-R32-Carla_Suarez_Navarro-Marketa_Vondrousova,2,S-DTL,2,0,0,0,0,1,1
20190531-W-Roland_Garros-R32-Carla_Suarez_Navarro-Marketa_Vondrousova,2,S-IO,1,0,0,0,0,1,0
20190620-W-Mallorca-R16-Belinda_Bencic-Shelby_Rogers,1,F-XC,20,9,3,0,6,11,9
20190620-W-Mallorca-R16-Belinda_Bencic-Shelby_Rogers,1,F-DTM,11,1,0,0,1,5,6
20190620-W-Mallorca-R16-Belinda_Bencic-Shelby_Rogers,1,F-DTL,3,1,1,0,0,3,0
20190620-W-Mallorca-R16-Belinda_Bencic-Shelby_Rogers,1,F-IO,10,2,1,1,0,7,3
20190620-W-Mallorca-R16-Belinda_Bencic-Shelby_Rogers,1,B-XC,16,2,0,0,2,9,7
20190620-W-Mallorca-R16-Belinda_Bencic-Shelby_Rogers,1,B-DTM,16,3,0,0,3,8,8
20190620-W-Mallorca-R16-Belinda_Bencic-Shelby_Rogers,1,B-DTL,10,8,4,0,4,4,6
20190620-W-Mallorca-R16-Belinda_Bencic-Shelby_Rogers,1,B-IO,2,1,0,0,1,0,2
20190620-W-Mallorca-R16-Belinda_Bencic-Shelby_Rogers,2,F-XC,20,6,2,0,4,9,11
20190620-W-Mallorca-R16-Belinda_Bencic-Shelby_Rogers,2,F-DTM,6,1,1,0,0,2,4
20190620-W-Mallorca-R16-Belinda_Bencic-Shelby_Rogers,2,F-DTL,6,2,2,0,0,2,4
20190620-W-Mallorca-R16-Belinda_Bencic-Shelby_Rogers,2,F-IO,12,6,3,1,2,7,5
20190620-W-Mallorca-R16-Belinda_Bencic-Shelby_Rogers,2,F-II,1,1,1,0,0,1,0
20190620-W-Mallorca-R16-Belinda_Bencic-Shelby_Rogers,2,B-XC,15,6,4,0,2,7,8
20190620-W-Mallorca-R16-Belinda_Bencic-Shelby_Rogers,2,B-DTM,7,0,0,0,0,4,3
20190620-W-Mallorca-R16-Belinda_Bencic-Shelby_Rogers,2,B-DTL,13,8,2,0,6,5,8
20190620-W-Mallorca-R16-Belinda_Bencic-Shelby_Rogers,2,B-IO,6,4,1,0,3,2,4
20190620-W-Mallorca-R16-Belinda_Bencic-Shelby_Rogers,2,S-XC,4,0,0,0,0,3,1
20190620-W-Mallorca-R16-Belinda_Bencic-Shelby_Rogers,2,S-DTM,6,0,0,0,0,2,4
20190620-W-Mallorca-R16-Belinda_Bencic-Shelby_Rogers,2,S-DTL,1,0,0,0,0,0,1
20190620-W-Mallorca-R16-Belinda_Bencic-Shelby_Rogers,2,S-IO,1,1,0,0,1,0,1
20190618-W-Birmingham-R32-Petra_Martic-Ekaterina_Alexandrova,1,F-XC,41,9,2,1,6,25,16
20190618-W-Birmingham-R32-Petra_Martic-Ekaterina_Alexandrova,1,F-DTM,19,1,0,0,1,8,11
20190618-W-Birmingham-R32-Petra_Martic-Ekaterina_Alexandrova,1,F-DTL,16,5,2,1,2,9,7
20190618-W-Birmingham-R32-Petra_Martic-Ekaterina_Alexandrova,1,F-IO,9,2,1,0,1,5,4
20190618-W-Birmingham-R32-Petra_Martic-Ekaterina_Alexandrova,1,B-XC,8,2,1,0,1,5,3
20190618-W-Birmingham-R32-Petra_Martic-Ekaterina_Alexandrova,1,B-DTM,9,1,0,0,1,3,6
20190618-W-Birmingham-R32-Petra_Martic-Ekaterina_Alexandrova,1,B-IO,1,0,0,0,0,0,1
20190618-W-Birmingham-R32-Petra_Martic-Ekaterina_Alexandrova,1,S-XC,17,2,0,1,1,11,6
20190618-W-Birmingham-R32-Petra_Martic-Ekaterina_Alexandrova,1,S-DTM,18,1,0,1,0,8,10
20190618-W-Birmingham-R32-Petra_Martic-Ekaterina_Alexandrova,1,S-DTL,10,5,0,2,3,6,4
20190618-W-Birmingham-R32-Petra_Martic-Ekaterina_Alexandrova,1,S-IO,3,0,0,0,0,2,1
20190618-W-Birmingham-R32-Petra_Martic-Ekaterina_Alexandrova,2,F-XC,44,15,5,2,8,20,24
20190618-W-Birmingham-R32-Petra_Martic-Ekaterina_Alexandrova,2,F-DTM,12,1,0,0,1,4,8
20190618-W-Birmingham-R32-Petra_Martic-Ekaterina_Alexandrova,2,F-DTL,12,3,1,0,2,5,7
20190618-W-Birmingham-R32-Petra_Martic-Ekaterina_Alexandrova,2,F-IO,10,4,3,0,1,9,1
20190618-W-Birmingham-R32-Petra_Martic-Ekaterina_Alexandrova,2,F-II,1,1,1,0,0,1,0
20190618-W-Birmingham-R32-Petra_Martic-Ekaterina_Alexandrova,2,B-XC,29,6,3,0,3,14,15
20190618-W-Birmingham-R32-Petra_Martic-Ekaterina_Alexandrova,2,B-DTM,16,0,0,0,0,5,11
20190618-W-Birmingham-R32-Petra_Martic-Ekaterina_Alexandrova,2,B-DTL,9,3,1,0,2,3,6
20190618-W-Birmingham-R32-Petra_Martic-Ekaterina_Alexandrova,2,B-IO,6,1,1,0,0,4,2
20190618-W-Birmingham-R32-Petra_Martic-Ekaterina_Alexandrova,2,S-XC,6,0,0,0,0,0,6
20190618-W-Birmingham-R32-Petra_Martic-Ekaterina_Alexandrova,2,S-DTM,5,2,0,1,1,3,2
20190618-W-Birmingham-R32-Petra_Martic-Ekaterina_Alexandrova,2,S-DTL,6,2,0,1,1,3,3
20190618-W-Birmingham-R32-Petra_Martic-Ekaterina_Alexandrova,2,S-IO,2,1,0,0,1,1,1
20190619-W-Birmingham-R16-Petra_Martic-Margarita_Gasparyan,1,F-XC,39,7,2,3,2,27,12
20190619-W-Birmingham-R16-Petra_Martic-Margarita_Gasparyan,1,F-DTM,20,1,0,1,0,11,9
20190619-W-Birmingham-R16-Petra_Martic-Margarita_Gasparyan,1,F-DTL,12,2,1,1,0,10,2
20190619-W-Birmingham-R16-Petra_Martic-Margarita_Gasparyan,1,F-IO,26,7,3,2,2,17,9
20190619-W-Birmingham-R16-Petra_Martic-Margarita_Gasparyan,1,F-II,2,0,0,0,0,1,1
20190619-W-Birmingham-R16-Petra_Martic-Margarita_Gasparyan,1,B-XC,13,1,0,1,0,9,4
20190619-W-Birmingham-R16-Petra_Martic-Margarita_Gasparyan,1,B-DTM,6,0,0,0,0,5,1
20190619-W-Birmingham-R16-Petra_Martic-Margarita_Gasparyan,1,B-DTL,2,1,1,0,0,1,1
20190619-W-Birmingham-R16-Petra_Martic-Margarita_Gasparyan,1,B-IO,2,0,0,0,0,1,1
20190619-W-Birmingham-R16-Petra_Martic-Margarita_Gasparyan,1,S-XC,35,6,0,1,5,19,16
20190619-W-Birmingham-R16-Petra_Martic-Margarita_Gasparyan,1,S-DTM,14,0,0,0,0,5,9
20190619-W-Birmingham-R16-Petra_Martic-Margarita_Gasparyan,1,S-DTL,9,1,0,1,0,7,2
20190619-W-Birmingham-R16-Petra_Martic-Margarita_Gasparyan,1,S-IO,2,0,0,0,0,2,0
20190619-W-Birmingham-R16-Petra_Martic-Margarita_Gasparyan,2,F-XC,31,7,3,1,3,10,21
20190619-W-Birmingham-R16-Petra_Martic-Margarita_Gasparyan,2,F-DTM,10,0,0,0,0,3,7
20190619-W-Birmingham-R16-Petra_Martic-Margarita_Gasparyan,2,F-DTL,33,9,5,1,3,16,17
20190619-W-Birmingham-R16-Petra_Martic-Margarita_Gasparyan,2,F-IO,24,5,1,2,2,12,12
20190619-W-Birmingham-R16-Petra_Martic-Margarita_Gasparyan,2,F-II,2,1,1,0,0,1,1
20190619-W-Birmingham-R16-Petra_Martic-Margarita_Gasparyan,2,B-XC,29,4,1,1,2,12,17
20190619-W-Birmingham-R16-Petra_Martic-Margarita_Gasparyan,2,B-DTM,20,1,0,0,1,5,15
20190619-W-Birmingham-R16-Petra_Martic-Margarita_Gasparyan,2,B-DTL,16,9,4,1,4,7,9
20190619-W-Birmingham-R16-Petra_Martic-Margarita_Gasparyan,2,B-IO,6,3,2,0,1,4,2
20190619-W-Birmingham-R16-Petra_Martic-Margarita_Gasparyan,2,S-XC,10,1,0,0,1,2,8
20190619-W-Birmingham-R16-Petra_Martic-Margarita_Gasparyan,2,S-DTM,9,0,0,0,0,5,4
20190619-W-Birmingham-R16-Petra_Martic-Margarita_Gasparyan,2,S-DTL,6,1,0,0,1,2,4
20190619-W-Birmingham-R16-Petra_Martic-Margarita_Gasparyan,2,S-II,1,0,0,0,0,0,1
20190618-W-Birmingham-R32-Venus_Williams-Aliaksandra_Sasnovich,1,F-XC,22,7,2,1,4,15,7
20190618-W-Birmingham-R32-Venus_Williams-Aliaksandra_Sasnovich,1,F-DTM,11,1,0,0,1,6,5
20190618-W-Birmingham-R32-Venus_Williams-Aliaksandra_Sasnovich,1,F-DTL,3,3,3,0,0,3,0
20190618-W-Birmingham-R32-Venus_Williams-Aliaksandra_Sasnovich,1,F-IO,6,2,0,0,2,4,2
20190618-W-Birmingham-R32-Venus_Williams-Aliaksandra_Sasnovich,1,B-XC,19,3,1,2,0,13,6
20190618-W-Birmingham-R32-Venus_Williams-Aliaksandra_Sasnovich,1,B-DTM,13,0,0,0,0,7,6
20190618-W-Birmingham-R32-Venus_Williams-Aliaksandra_Sasnovich,1,B-DTL,4,2,1,0,1,3,1
20190618-W-Birmingham-R32-Venus_Williams-Aliaksandra_Sasnovich,1,B-IO,6,2,0,1,1,5,1
20190618-W-Birmingham-R32-Venus_Williams-Aliaksandra_Sasnovich,1,S-DTM,7,0,0,0,0,2,5
20190618-W-Birmingham-R32-Venus_Williams-Aliaksandra_Sasnovich,1,S-IO,3,1,0,0,1,1,2
20190618-W-Birmingham-R32-Venus_Williams-Aliaksandra_Sasnovich,2,F-XC,27,14,5,0,9,10,17
20190618-W-Birmingham-R32-Venus_Williams-Aliaksandra_Sasnovich,2,F-DTM,17,5,1,0,4,4,13
20190618-W-Birmingham-R32-Venus_Williams-Aliaksandra_Sasnovich,2,F-DTL,8,6,3,0,3,3,5
20190618-W-Birmingham-R32-Venus_Williams-Aliaksandra_Sasnovich,2,F-IO,9,3,2,0,1,6,3
20190618-W-Birmingham-R32-Venus_Williams-Aliaksandra_Sasnovich,2,B-XC,13,5,0,1,4,6,7
20190618-W-Birmingham-R32-Venus_Williams-Aliaksandra_Sasnovich,2,B-DTM,12,0,0,0,0,5,7
20190618-W-Birmingham-R32-Venus_Williams-Aliaksandra_Sasnovich,2,B-DTL,4,3,2,0,1,2,2
20190618-W-Birmingham-R32-Venus_Williams-Aliaksandra_Sasnovich,2,B-IO,2,0,0,0,0,2,0
20190618-W-Birmingham-R32-Venus_Williams-Aliaksandra_Sasnovich,2,S-XC,3,0,0,0,0,0,3
20190618-W-Birmingham-R32-Venus_Williams-Aliaksandra_Sasnovich,2,S-DTM,1,0,0,0,0,0,1
20190614-W-s_Hertogenbosch-QF-Natalia_Vikhlyantseva-Kiki_Bertens,1,F-XC,25,6,2,0,4,12,13
20190614-W-s_Hertogenbosch-QF-Natalia_Vikhlyantseva-Kiki_Bertens,1,F-DTM,17,3,0,0,3,9,8
20190614-W-s_Hertogenbosch-QF-Natalia_Vikhlyantseva-Kiki_Bertens,1,F-DTL,7,5,2,1,2,5,2
20190614-W-s_Hertogenbosch-QF-Natalia_Vikhlyantseva-Kiki_Bertens,1,F-IO,13,6,3,1,2,9,4
20190614-W-s_Hertogenbosch-QF-Natalia_Vikhlyantseva-Kiki_Bertens,1,B-XC,19,7,1,2,4,9,10
20190614-W-s_Hertogenbosch-QF-Natalia_Vikhlyantseva-Kiki_Bertens,1,B-DTM,7,1,0,0,1,4,3
20190614-W-s_Hertogenbosch-QF-Natalia_Vikhlyantseva-Kiki_Bertens,1,B-DTL,6,3,1,0,2,2,4
20190614-W-s_Hertogenbosch-QF-Natalia_Vikhlyantseva-Kiki_Bertens,1,B-IO,4,2,0,1,1,2,2
20190614-W-s_Hertogenbosch-QF-Natalia_Vikhlyantseva-Kiki_Bertens,2,F-XC,20,4,1,1,2,10,10
20190614-W-s_Hertogenbosch-QF-Natalia_Vikhlyantseva-Kiki_Bertens,2,F-DTM,21,1,0,0,1,8,13
20190614-W-s_Hertogenbosch-QF-Natalia_Vikhlyantseva-Kiki_Bertens,2,F-DTL,2,2,1,1,0,2,0
20190614-W-s_Hertogenbosch-QF-Natalia_Vikhlyantseva-Kiki_Bertens,2,F-IO,6,4,1,0,3,2,4
20190614-W-s_Hertogenbosch-QF-Natalia_Vikhlyantseva-Kiki_Bertens,2,F-II,1,0,0,0,0,0,1
20190614-W-s_Hertogenbosch-QF-Natalia_Vikhlyantseva-Kiki_Bertens,2,B-XC,4,1,1,0,0,4,0
20190614-W-s_Hertogenbosch-QF-Natalia_Vikhlyantseva-Kiki_Bertens,2,B-DTM,7,3,0,0,3,2,5
20190614-W-s_Hertogenbosch-QF-Natalia_Vikhlyantseva-Kiki_Bertens,2,B-DTL,3,1,0,1,0,2,1
20190614-W-s_Hertogenbosch-QF-Natalia_Vikhlyantseva-Kiki_Bertens,2,B-IO,1,1,0,0,1,0,1
20190614-W-s_Hertogenbosch-QF-Natalia_Vikhlyantseva-Kiki_Bertens,2,S-XC,6,0,0,0,0,2,4
20190614-W-s_Hertogenbosch-QF-Natalia_Vikhlyantseva-Kiki_Bertens,2,S-DTM,8,0,0,0,0,2,6
20190614-W-s_Hertogenbosch-QF-Natalia_Vikhlyantseva-Kiki_Bertens,2,S-DTL,1,1,0,0,1,0,1
20190625-W-Eastbourne-R32-Yulia_Putintseva-Kiki_Bertens,1,F-XC,44,10,1,4,5,26,18
20190625-W-Eastbourne-R32-Yulia_Putintseva-Kiki_Bertens,1,F-DTM,13,2,0,0,2,4,9
20190625-W-Eastbourne-R32-Yulia_Putintseva-Kiki_Bertens,1,F-DTL,15,7,0,2,5,6,9
20190625-W-Eastbourne-R32-Yulia_Putintseva-Kiki_Bertens,1,F-IO,5,2,0,1,1,1,4
20190625-W-Eastbourne-R32-Yulia_Putintseva-Kiki_Bertens,1,F-II,1,0,0,0,0,0,1
20190625-W-Eastbourne-R32-Yulia_Putintseva-Kiki_Bertens,1,B-XC,12,3,1,1,1,7,5
20190625-W-Eastbourne-R32-Yulia_Putintseva-Kiki_Bertens,1,B-DTM,15,0,0,0,0,6,9
20190625-W-Eastbourne-R32-Yulia_Putintseva-Kiki_Bertens,1,B-DTL,4,1,0,0,1,1,3
20190625-W-Eastbourne-R32-Yulia_Putintseva-Kiki_Bertens,1,B-IO,2,1,0,0,1,1,1
20190625-W-Eastbourne-R32-Yulia_Putintseva-Kiki_Bertens,1,S-XC,6,2,0,0,2,2,4
20190625-W-Eastbourne-R32-Yulia_Putintseva-Kiki_Bertens,1,S-DTM,5,2,0,0,2,2,3
20190625-W-Eastbourne-R32-Yulia_Putintseva-Kiki_Bertens,1,S-DTL,1,0,0,0,0,0,1
20190625-W-Eastbourne-R32-Yulia_Putintseva-Kiki_Bertens,1,S-IO,1,0,0,0,0,0,1
20190625-W-Eastbourne-R32-Yulia_Putintseva-Kiki_Bertens,2,F-XC,51,11,4,2,5,25,26
20190625-W-Eastbourne-R32-Yulia_Putintseva-Kiki_Bertens,2,F-DTM,7,1,0,0,1,1,6
20190625-W-Eastbourne-R32-Yulia_Putintseva-Kiki_Bertens,2,F-DTL,9,6,0,1,5,4,5
20190625-W-Eastbourne-R32-Yulia_Putintseva-Kiki_Bertens,2,F-IO,12,3,1,0,2,6,6
20190625-W-Eastbourne-R32-Yulia_Putintseva-Kiki_Bertens,2,F-II,2,0,0,0,0,2,0
20190625-W-Eastbourne-R32-Yulia_Putintseva-Kiki_Bertens,2,B-XC,8,1,0,0,1,5,3
20190625-W-Eastbourne-R32-Yulia_Putintseva-Kiki_Bertens,2,B-DTM,16,2,1,0,1,7,9
20190625-W-Eastbourne-R32-Yulia_Putintseva-Kiki_Bertens,2,B-DTL,1,0,0,0,0,1,0
20190625-W-Eastbourne-R32-Yulia_Putintseva-Kiki_Bertens,2,B-IO,2,0,0,0,0,2,0
20190625-W-Eastbourne-R32-Yulia_Putintseva-Kiki_Bertens,2,S-XC,4,1,0,0,1,1,3
20190625-W-Eastbourne-R32-Yulia_Putintseva-Kiki_Bertens,2,S-DTL,1,0,0,0,0,0,1
20190625-W-Eastbourne-R32-Yulia_Putintseva-Kiki_Bertens,2,S-IO,1,0,0,0,0,1,0
20190413-W-Lugano-SF-Fiona_Ferro-Polona_Hercog,1,F-XC,29,7,4,1,2,19,10
20190413-W-Lugano-SF-Fiona_Ferro-Polona_Hercog,1,F-DTM,30,6,1,0,5,14,16
20190413-W-Lugano-SF-Fiona_Ferro-Polona_Hercog,1,F-DTL,13,4,2,1,1,8,5
20190413-W-Lugano-SF-Fiona_Ferro-Polona_Hercog,1,F-IO,35,14,5,2,7,14,21
20190413-W-Lugano-SF-Fiona_Ferro-Polona_Hercog,1,F-II,3,3,3,0,0,3,0
20190413-W-Lugano-SF-Fiona_Ferro-Polona_Hercog,1,B-XC,55,8,0,1,7,27,28
20190413-W-Lugano-SF-Fiona_Ferro-Polona_Hercog,1,B-DTM,12,1,0,0,1,5,7
20190413-W-Lugano-SF-Fiona_Ferro-Polona_Hercog,1,B-DTL,9,7,1,0,6,2,7
20190413-W-Lugano-SF-Fiona_Ferro-Polona_Hercog,1,B-IO,2,1,1,0,0,2,0
20190413-W-Lugano-SF-Fiona_Ferro-Polona_Hercog,1,S-XC,2,0,0,0,0,0,2
20190413-W-Lugano-SF-Fiona_Ferro-Polona_Hercog,1,S-DTM,2,0,0,0,0,0,2
20190413-W-Lugano-SF-Fiona_Ferro-Polona_Hercog,2,F-XC,32,8,3,3,2,17,15
20190413-W-Lugano-SF-Fiona_Ferro-Polona_Hercog,2,F-DTM,24,0,0,0,0,13,11
20190413-W-Lugano-SF-Fiona_Ferro-Polona_Hercog,2,F-DTL,5,1,1,0,0,4,1
20190413-W-Lugano-SF-Fiona_Ferro-Polona_Hercog,2,F-IO,39,10,3,0,7,20,19
20190413-W-Lugano-SF-Fiona_Ferro-Polona_Hercog,2,F-II,11,4,2,1,1,7,4
20190413-W-Lugano-SF-Fiona_Ferro-Polona_Hercog,2,B-XC,24,5,1,0,4,10,14
20190413-W-Lugano-SF-Fiona_Ferro-Polona_Hercog,2,B-DTM,7,2,0,0,2,1,6
20190413-W-Lugano-SF-Fiona_Ferro-Polona_Hercog,2,B-DTL,5,4,3,0,1,3,2
20190413-W-Lugano-SF-Fiona_Ferro-Polona_Hercog,2,S-XC,12,1,0,0,1,8,4
20190413-W-Lugano-SF-Fiona_Ferro-Polona_Hercog,2,S-DTM,17,1,0,0,1,9,8
20190413-W-Lugano-SF-Fiona_Ferro-Polona_Hercog,2,S-DTL,3,1,0,0,1,2,1
20180523-W-Roland_Garros-Q1-Bianca_Andreescu-Vera_Lapko,1,F-XC,24,7,1,1,5,11,13
20180523-W-Roland_Garros-Q1-Bianca_Andreescu-Vera_Lapko,1,F-DTM,22,7,1,1,5,11,11
20180523-W-Roland_Garros-Q1-Bianca_Andreescu-Vera_Lapko,1,F-DTL,7,4,3,0,1,5,2
20180523-W-Roland_Garros-Q1-Bianca_Andreescu-Vera_Lapko,1,F-IO,15,5,3,0,2,9,6
20180523-W-Roland_Garros-Q1-Bianca_Andreescu-Vera_Lapko,1,F-II,2,2,2,0,0,2,0
20180523-W-Roland_Garros-Q1-Bianca_Andreescu-Vera_Lapko,1,B-XC,15,6,2,4,0,8,7
20180523-W-Roland_Garros-Q1-Bianca_Andreescu-Vera_Lapko,1,B-DTM,11,2,0,0,2,3,8
20180523-W-Roland_Garros-Q1-Bianca_Andreescu-Vera_Lapko,1,B-DTL,5,2,0,1,1,1,4
20180523-W-Roland_Garros-Q1-Bianca_Andreescu-Vera_Lapko,1,B-IO,4,2,1,0,1,3,1
20180523-W-Roland_Garros-Q1-Bianca_Andreescu-Vera_Lapko,1,S-XC,3,0,0,0,0,3,0
20180523-W-Roland_Garros-Q1-Bianca_Andreescu-Vera_Lapko,1,S-DTM,4,0,0,0,0,3,1
20180523-W-Roland_Garros-Q1-Bianca_Andreescu-Vera_Lapko,1,S-IO,1,0,0,0,0,1,0
20180523-W-Roland_Garros-Q1-Bianca_Andreescu-Vera_Lapko,2,F-XC,23,6,3,0,3,13,10
20180523-W-Roland_Garros-Q1-Bianca_Andreescu-Vera_Lapko,2,F-DTM,14,1,0,0,1,3,11
20180523-W-Roland_Garros-Q1-Bianca_Andreescu-Vera_Lapko,2,F-DTL,11,6,2,2,2,6,5
20180523-W-Roland_Garros-Q1-Bianca_Andreescu-Vera_Lapko,2,F-IO,16,6,3,0,3,8,8
20180523-W-Roland_Garros-Q1-Bianca_Andreescu-Vera_Lapko,2,F-II,1,1,0,0,1,0,1
20180523-W-Roland_Garros-Q1-Bianca_Andreescu-Vera_Lapko,2,B-XC,12,5,0,1,4,7,5
20180523-W-Roland_Garros-Q1-Bianca_Andreescu-Vera_Lapko,2,B-DTM,20,5,0,0,5,7,13
20180523-W-Roland_Garros-Q1-Bianca_Andreescu-Vera_Lapko,2,B-DTL,5,2,1,1,0,2,3
20180523-W-Roland_Garros-Q1-Bianca_Andreescu-Vera_Lapko,2,B-IO,4,2,1,0,1,2,2
20180523-W-Roland_Garros-Q1-Bianca_Andreescu-Vera_Lapko,2,S-DTM,2,0,0,0,0,2,0
20180523-W-Roland_Garros-Q1-Bianca_Andreescu-Vera_Lapko,2,S-DTL,1,0,0,0,0,0,1
20190110-W-Australian_Open-Q2-Valentini_Grammatikopoulou-Bianca_Andreescu,1,F-XC,20,6,2,1,3,14,6
20190110-W-Australian_Open-Q2-Valentini_Grammatikopoulou-Bianca_Andreescu,1,F-DTM,13,4,0,1,3,4,9
20190110-W-Australian_Open-Q2-Valentini_Grammatikopoulou-Bianca_Andreescu,1,F-DTL,4,0,0,0,0,2,2
20190110-W-Australian_Open-Q2-Valentini_Grammatikopoulou-Bianca_Andreescu,1,F-IO,18,7,3,2,2,13,5
20190110-W-Australian_Open-Q2-Valentini_Grammatikopoulou-Bianca_Andreescu,1,B-XC,36,8,2,2,4,14,22
20190110-W-Australian_Open-Q2-Valentini_Grammatikopoulou-Bianca_Andreescu,1,B-DTM,11,1,0,0,1,7,4
20190110-W-Australian_Open-Q2-Valentini_Grammatikopoulou-Bianca_Andreescu,1,B-DTL,2,2,0,0,2,0,2
20190110-W-Australian_Open-Q2-Valentini_Grammatikopoulou-Bianca_Andreescu,1,B-IO,6,3,2,1,0,5,1
20190110-W-Australian_Open-Q2-Valentini_Grammatikopoulou-Bianca_Andreescu,1,S-XC,4,0,0,0,0,0,4
20190110-W-Australian_Open-Q2-Valentini_Grammatikopoulou-Bianca_Andreescu,1,S-DTM,3,0,0,0,0,1,2
20190110-W-Australian_Open-Q2-Valentini_Grammatikopoulou-Bianca_Andreescu,1,S-DTL,1,0,0,0,0,0,1
20190110-W-Australian_Open-Q2-Valentini_Grammatikopoulou-Bianca_Andreescu,2,F-XC,16,8,4,1,3,10,6
20190110-W-Australian_Open-Q2-Valentini_Grammatikopoulou-Bianca_Andreescu,2,F-DTM,16,1,0,0,1,7,9
20190110-W-Australian_Open-Q2-Valentini_Grammatikopoulou-Bianca_Andreescu,2,F-DTL,5,2,1,0,1,4,1
20190110-W-Australian_Open-Q2-Valentini_Grammatikopoulou-Bianca_Andreescu,2,F-IO,8,3,3,0,0,7,1
20190110-W-Australian_Open-Q2-Valentini_Grammatikopoulou-Bianca_Andreescu,2,F-II,2,1,1,0,0,2,0
20190110-W-Australian_Open-Q2-Valentini_Grammatikopoulou-Bianca_Andreescu,2,B-XC,25,4,3,0,1,15,10
20190110-W-Australian_Open-Q2-Valentini_Grammatikopoulou-Bianca_Andreescu,2,B-DTM,17,2,0,0,2,7,10
20190110-W-Australian_Open-Q2-Valentini_Grammatikopoulou-Bianca_Andreescu,2,B-DTL,3,1,0,0,1,1,2
20190110-W-Australian_Open-Q2-Valentini_Grammatikopoulou-Bianca_Andreescu,2,B-IO,1,0,0,0,0,1,0
20190110-W-Australian_Open-Q2-Valentini_Grammatikopoulou-Bianca_Andreescu,2,S-XC,4,1,0,0,1,3,1
20190110-W-Australian_Open-Q2-Valentini_Grammatikopoulou-Bianca_Andreescu,2,S-DTM,9,1,0,0,1,1,8
20190110-W-Australian_Open-Q2-Valentini_Grammatikopoulou-Bianca_Andreescu,2,S-DTL,4,0,0,0,0,1,3
20190626-W-Eastbourne-R16-Anna_Lena_Friedsam-Kiki_Bertens,1,F-XC,23,7,1,0,6,8,15
20190626-W-Eastbourne-R16-Anna_Lena_Friedsam-Kiki_Bertens,1,F-DTM,27,1,0,0,1,12,15
20190626-W-Eastbourne-R16-Anna_Lena_Friedsam-Kiki_Bertens,1,F-DTL,13,6,3,0,3,6,7
20190626-W-Eastbourne-R16-Anna_Lena_Friedsam-Kiki_Bertens,1,F-IO,18,5,1,1,3,5,13
20190626-W-Eastbourne-R16-Anna_Lena_Friedsam-Kiki_Bertens,1,F-II,1,1,0,0,1,0,1
20190626-W-Eastbourne-R16-Anna_Lena_Friedsam-Kiki_Bertens,1,B-XC,23,4,1,2,1,11,12
20190626-W-Eastbourne-R16-Anna_Lena_Friedsam-Kiki_Bertens,1,B-DTM,11,2,0,0,2,2,9
20190626-W-Eastbourne-R16-Anna_Lena_Friedsam-Kiki_Bertens,1,B-DTL,5,3,2,0,1,3,2
20190626-W-Eastbourne-R16-Anna_Lena_Friedsam-Kiki_Bertens,1,B-IO,2,2,0,1,1,1,1
20190626-W-Eastbourne-R16-Anna_Lena_Friedsam-Kiki_Bertens,1,S-XC,19,3,0,0,3,10,9
20190626-W-Eastbourne-R16-Anna_Lena_Friedsam-Kiki_Bertens,1,S-DTM,6,0,0,0,0,1,5
20190626-W-Eastbourne-R16-Anna_Lena_Friedsam-Kiki_Bertens,1,S-DTL,1,1,0,0,1,0,1
20190626-W-Eastbourne-R16-Anna_Lena_Friedsam-Kiki_Bertens,2,F-XC,39,16,6,3,7,21,18
20190626-W-Eastbourne-R16-Anna_Lena_Friedsam-Kiki_Bertens,2,F-DTM,10,0,0,0,0,4,6
20190626-W-Eastbourne-R16-Anna_Lena_Friedsam-Kiki_Bertens,2,F-DTL,4,3,2,0,1,3,1
20190626-W-Eastbourne-R16-Anna_Lena_Friedsam-Kiki_Bertens,2,F-IO,12,3,1,1,1,8,4
20190626-W-Eastbourne-R16-Anna_Lena_Friedsam-Kiki_Bertens,2,F-II,2,2,0,1,1,1,1
20190626-W-Eastbourne-R16-Anna_Lena_Friedsam-Kiki_Bertens,2,B-XC,16,1,0,0,1,8,8
20190626-W-Eastbourne-R16-Anna_Lena_Friedsam-Kiki_Bertens,2,B-DTM,28,1,0,0,1,15,13
20190626-W-Eastbourne-R16-Anna_Lena_Friedsam-Kiki_Bertens,2,B-DTL,7,3,0,1,2,3,4
20190626-W-Eastbourne-R16-Anna_Lena_Friedsam-Kiki_Bertens,2,B-IO,1,0,0,0,0,1,0
20190626-W-Eastbourne-R16-Anna_Lena_Friedsam-Kiki_Bertens,2,S-XC,13,1,0,0,1,7,6
20190626-W-Eastbourne-R16-Anna_Lena_Friedsam-Kiki_Bertens,2,S-DTM,10,0,0,0,0,7,3
20190626-W-Eastbourne-R16-Anna_Lena_Friedsam-Kiki_Bertens,2,S-DTL,1,0,0,0,0,1,0
20190626-W-Eastbourne-R16-Anna_Lena_Friedsam-Kiki_Bertens,2,S-IO,2,0,0,0,0,1,1
20190628-W-Eastbourne-SF-Karolina_Pliskova-Kiki_Bertens,1,F-XC,17,6,4,2,0,14,3
20190628-W-Eastbourne-SF-Karolina_Pliskova-Kiki_Bertens,1,F-DTM,11,1,0,0,1,5,6
20190628-W-Eastbourne-SF-Karolina_Pliskova-Kiki_Bertens,1,F-DTL,6,4,3,1,0,6,0
20190628-W-Eastbourne-SF-Karolina_Pliskova-Kiki_Bertens,1,F-IO,10,6,3,2,1,9,1
20190628-W-Eastbourne-SF-Karolina_Pliskova-Kiki_Bertens,1,B-XC,3,1,0,0,1,1,2
20190628-W-Eastbourne-SF-Karolina_Pliskova-Kiki_Bertens,1,B-DTM,8,0,0,0,0,6,2
20190628-W-Eastbourne-SF-Karolina_Pliskova-Kiki_Bertens,1,B-DTL,2,1,1,0,0,2,0
20190628-W-Eastbourne-SF-Karolina_Pliskova-Kiki_Bertens,1,B-IO,4,1,0,0,1,2,2
20190628-W-Eastbourne-SF-Karolina_Pliskova-Kiki_Bertens,1,S-XC,6,2,1,0,1,3,3
20190628-W-Eastbourne-SF-Karolina_Pliskova-Kiki_Bertens,1,S-DTM,1,0,0,0,0,1,0
20190628-W-Eastbourne-SF-Karolina_Pliskova-Kiki_Bertens,2,F-XC,13,4,1,1,2,3,10
20190628-W-Eastbourne-SF-Karolina_Pliskova-Kiki_Bertens,2,F-DTM,5,0,0,0,0,2,3
20190628-W-Eastbourne-SF-Karolina_Pliskova-Kiki_Bertens,2,F-DTL,2,0,0,0,0,2,0
20190628-W-Eastbourne-SF-Karolina_Pliskova-Kiki_Bertens,2,F-IO,11,4,0,1,3,4,7
20190628-W-Eastbourne-SF-Karolina_Pliskova-Kiki_Bertens,2,F-II,1,0,0,0,0,1,0
20190628-W-Eastbourne-SF-Karolina_Pliskova-Kiki_Bertens,2,B-XC,5,1,0,1,0,2,3
20190628-W-Eastbourne-SF-Karolina_Pliskova-Kiki_Bertens,2,B-DTM,12,4,0,0,4,3,9
20190628-W-Eastbourne-SF-Karolina_Pliskova-Kiki_Bertens,2,B-DTL,1,1,0,0,1,0,1
20190628-W-Eastbourne-SF-Karolina_Pliskova-Kiki_Bertens,2,B-IO,4,2,1,0,1,2,2
20190628-W-Eastbourne-SF-Karolina_Pliskova-Kiki_Bertens,2,S-XC,2,1,0,0,1,0,2
20190628-W-Eastbourne-SF-Karolina_Pliskova-Kiki_Bertens,2,S-DTM,2,0,0,0,0,1,1
20190628-W-Eastbourne-SF-Karolina_Pliskova-Kiki_Bertens,2,S-DTL,1,0,0,0,0,0,1
20190627-W-Wimbledon-Q3-Sabine_Lisicki-Lesley_Kerkhove,1,F-XC,35,16,6,2,8,15,20
20190627-W-Wimbledon-Q3-Sabine_Lisicki-Lesley_Kerkhove,1,F-DTM,21,4,0,2,2,12,9
20190627-W-Wimbledon-Q3-Sabine_Lisicki-Lesley_Kerkhove,1,F-DTL,13,8,3,3,2,9,4
20190627-W-Wimbledon-Q3-Sabine_Lisicki-Lesley_Kerkhove,1,F-IO,21,10,5,0,5,10,11
20190627-W-Wimbledon-Q3-Sabine_Lisicki-Lesley_Kerkhove,1,B-XC,19,4,1,0,3,9,10
20190627-W-Wimbledon-Q3-Sabine_Lisicki-Lesley_Kerkhove,1,B-DTM,26,5,0,0,5,13,13
20190627-W-Wimbledon-Q3-Sabine_Lisicki-Lesley_Kerkhove,1,B-DTL,9,8,4,0,4,4,5
20190627-W-Wimbledon-Q3-Sabine_Lisicki-Lesley_Kerkhove,1,B-IO,6,5,1,2,2,3,3
20190627-W-Wimbledon-Q3-Sabine_Lisicki-Lesley_Kerkhove,1,S-XC,4,1,0,0,1,2,2
20190627-W-Wimbledon-Q3-Sabine_Lisicki-Lesley_Kerkhove,1,S-DTM,4,1,0,0,1,1,3
20190627-W-Wimbledon-Q3-Sabine_Lisicki-Lesley_Kerkhove,1,S-DTL,1,0,0,0,0,0,1
20190627-W-Wimbledon-Q3-Sabine_Lisicki-Lesley_Kerkhove,1,S-IO,1,0,0,0,0,0,1
20190627-W-Wimbledon-Q3-Sabine_Lisicki-Lesley_Kerkhove,2,F-XC,20,0,0,0,0,10,10
20190627-W-Wimbledon-Q3-Sabine_Lisicki-Lesley_Kerkhove,2,F-DTM,21,3,0,0,3,11,10
20190627-W-Wimbledon-Q3-Sabine_Lisicki-Lesley_Kerkhove,2,F-DTL,9,6,2,2,2,5,4
20190627-W-Wimbledon-Q3-Sabine_Lisicki-Lesley_Kerkhove,2,F-IO,23,5,1,1,3,14,9
20190627-W-Wimbledon-Q3-Sabine_Lisicki-Lesley_Kerkhove,2,B-XC,17,3,0,1,2,10,7
20190627-W-Wimbledon-Q3-Sabine_Lisicki-Lesley_Kerkhove,2,B-DTM,33,5,0,1,4,12,21
20190627-W-Wimbledon-Q3-Sabine_Lisicki-Lesley_Kerkhove,2,B-DTL,8,2,2,0,0,6,2
20190627-W-Wimbledon-Q3-Sabine_Lisicki-Lesley_Kerkhove,2,B-IO,12,5,2,0,3,5,7
20190627-W-Wimbledon-Q3-Sabine_Lisicki-Lesley_Kerkhove,2,S-XC,6,0,0,0,0,1,5
20190627-W-Wimbledon-Q3-Sabine_Lisicki-Lesley_Kerkhove,2,S-DTM,3,1,0,0,1,0,3
20190627-W-Wimbledon-Q3-Sabine_Lisicki-Lesley_Kerkhove,2,S-DTL,2,0,0,0,0,0,2
20190627-W-Wimbledon-Q3-Sabine_Lisicki-Lesley_Kerkhove,2,S-IO,1,0,0,0,0,1,0
20190625-W-Wimbledon-Q1-En_Shuo_Liang-Emma_Raducanu,1,F-XC,26,13,4,4,5,19,7
20190625-W-Wimbledon-Q1-En_Shuo_Liang-Emma_Raducanu,1,F-DTM,17,4,0,0,4,9,8
20190625-W-Wimbledon-Q1-En_Shuo_Liang-Emma_Raducanu,1,F-DTL,6,5,1,0,4,1,5
20190625-W-Wimbledon-Q1-En_Shuo_Liang-Emma_Raducanu,1,F-IO,15,9,6,0,3,10,5
20190625-W-Wimbledon-Q1-En_Shuo_Liang-Emma_Raducanu,1,F-II,2,2,2,0,0,2,0
20190625-W-Wimbledon-Q1-En_Shuo_Liang-Emma_Raducanu,1,B-XC,24,8,5,1,2,15,9
20190625-W-Wimbledon-Q1-En_Shuo_Liang-Emma_Raducanu,1,B-DTM,20,3,0,0,3,11,9
20190625-W-Wimbledon-Q1-En_Shuo_Liang-Emma_Raducanu,1,B-DTL,5,4,1,2,1,3,2
20190625-W-Wimbledon-Q1-En_Shuo_Liang-Emma_Raducanu,1,B-IO,2,1,0,0,1,0,2
20190625-W-Wimbledon-Q1-En_Shuo_Liang-Emma_Raducanu,1,S-XC,2,0,0,0,0,1,1
20190625-W-Wimbledon-Q1-En_Shuo_Liang-Emma_Raducanu,1,S-DTM,3,0,0,0,0,0,3
20190625-W-Wimbledon-Q1-En_Shuo_Liang-Emma_Raducanu,1,S-DTL,3,1,1,0,0,2,1
20190625-W-Wimbledon-Q1-En_Shuo_Liang-Emma_Raducanu,2,F-XC,33,14,5,2,7,16,17
20190625-W-Wimbledon-Q1-En_Shuo_Liang-Emma_Raducanu,2,F-DTM,15,3,0,0,3,2,13
20190625-W-Wimbledon-Q1-En_Shuo_Liang-Emma_Raducanu,2,F-DTL,5,3,0,1,2,1,4
20190625-W-Wimbledon-Q1-En_Shuo_Liang-Emma_Raducanu,2,F-IO,14,5,1,1,3,6,8
20190625-W-Wimbledon-Q1-En_Shuo_Liang-Emma_Raducanu,2,B-XC,24,9,2,3,4,13,11
20190625-W-Wimbledon-Q1-En_Shuo_Liang-Emma_Raducanu,2,B-DTM,20,1,0,0,1,7,13
20190625-W-Wimbledon-Q1-En_Shuo_Liang-Emma_Raducanu,2,B-DTL,7,5,3,1,1,5,2
20190625-W-Wimbledon-Q1-En_Shuo_Liang-Emma_Raducanu,2,B-IO,3,3,0,0,3,0,3
20190625-W-Wimbledon-Q1-En_Shuo_Liang-Emma_Raducanu,2,S-XC,3,0,0,0,0,0,3
20190625-W-Wimbledon-Q1-En_Shuo_Liang-Emma_Raducanu,2,S-DTM,1,0,0,0,0,0,1
20190627-W-Eastbourne-QF-Aryna_Sabalenka-Kiki_Bertens,1,F-XC,61,20,6,6,7,32,29
20190627-W-Eastbourne-QF-Aryna_Sabalenka-Kiki_Bertens,1,F-DTM,22,1,0,0,1,12,10
20190627-W-Eastbourne-QF-Aryna_Sabalenka-Kiki_Bertens,1,F-DTL,15,10,4,1,5,8,7
20190627-W-Eastbourne-QF-Aryna_Sabalenka-Kiki_Bertens,1,F-IO,20,7,3,0,4,10,10
20190627-W-Eastbourne-QF-Aryna_Sabalenka-Kiki_Bertens,1,B-XC,22,7,1,1,5,11,11
20190627-W-Eastbourne-QF-Aryna_Sabalenka-Kiki_Bertens,1,B-DTM,17,0,0,0,0,12,5
20190627-W-Eastbourne-QF-Aryna_Sabalenka-Kiki_Bertens,1,B-DTL,7,3,2,0,1,4,3
20190627-W-Eastbourne-QF-Aryna_Sabalenka-Kiki_Bertens,1,B-IO,3,3,2,0,1,2,1
20190627-W-Eastbourne-QF-Aryna_Sabalenka-Kiki_Bertens,1,S-DTM,5,0,0,0,0,1,4
20190627-W-Eastbourne-QF-Aryna_Sabalenka-Kiki_Bertens,1,S-DTL,1,0,0,0,0,0,1
20190627-W-Eastbourne-QF-Aryna_Sabalenka-Kiki_Bertens,1,S-IO,1,0,0,0,0,1,0
20190627-W-Eastbourne-QF-Aryna_Sabalenka-Kiki_Bertens,2,F-XC,40,12,4,2,6,19,21
20190627-W-Eastbourne-QF-Aryna_Sabalenka-Kiki_Bertens,2,F-DTM,29,2,0,1,1,16,13
20190627-W-Eastbourne-QF-Aryna_Sabalenka-Kiki_Bertens,2,F-DTL,8,3,2,1,0,6,2
20190627-W-Eastbourne-QF-Aryna_Sabalenka-Kiki_Bertens,2,F-IO,20,13,9,0,4,11,9
20190627-W-Eastbourne-QF-Aryna_Sabalenka-Kiki_Bertens,2,B-XC,8,2,1,0,1,5,3
20190627-W-Eastbourne-QF-Aryna_Sabalenka-Kiki_Bertens,2,B-DTM,24,2,0,0,2,7,17
20190627-W-Eastbourne-QF-Aryna_Sabalenka-Kiki_Bertens,2,B-DTL,5,3,1,0,2,1,4
20190627-W-Eastbourne-QF-Aryna_Sabalenka-Kiki_Bertens,2,B-IO,3,2,2,0,0,2,1
20190627-W-Eastbourne-QF-Aryna_Sabalenka-Kiki_Bertens,2,S-XC,8,0,0,0,0,4,4
20190627-W-Eastbourne-QF-Aryna_Sabalenka-Kiki_Bertens,2,S-DTM,8,2,1,0,1,5,3
20190627-W-Eastbourne-QF-Aryna_Sabalenka-Kiki_Bertens,2,S-DTL,2,0,0,0,0,0,2
20190627-W-Eastbourne-QF-Aryna_Sabalenka-Kiki_Bertens,2,S-IO,2,0,0,0,0,2,0
20190702-W-Wimbledon-R128-Kiki_Bertens-Mandy_Minella,1,F-XC,26,6,0,3,3,18,8
20190702-W-Wimbledon-R128-Kiki_Bertens-Mandy_Minella,1,F-DTM,17,2,0,0,2,9,8
20190702-W-Wimbledon-R128-Kiki_Bertens-Mandy_Minella,1,F-DTL,7,0,0,0,0,2,5
20190702-W-Wimbledon-R128-Kiki_Bertens-Mandy_Minella,1,F-IO,27,8,4,0,4,19,8
20190702-W-Wimbledon-R128-Kiki_Bertens-Mandy_Minella,1,F-II,1,1,0,1,0,1,0
20190702-W-Wimbledon-R128-Kiki_Bertens-Mandy_Minella,1,B-XC,7,0,0,0,0,6,1
20190702-W-Wimbledon-R128-Kiki_Bertens-Mandy_Minella,1,B-DTM,15,2,0,1,1,9,6
20190702-W-Wimbledon-R128-Kiki_Bertens-Mandy_Minella,1,B-DTL,3,2,0,1,1,1,2
20190702-W-Wimbledon-R128-Kiki_Bertens-Mandy_Minella,1,B-IO,1,0,0,0,0,0,1
20190702-W-Wimbledon-R128-Kiki_Bertens-Mandy_Minella,1,S-XC,8,0,0,0,0,5,3
20190702-W-Wimbledon-R128-Kiki_Bertens-Mandy_Minella,1,S-DTM,7,0,0,0,0,4,3
20190702-W-Wimbledon-R128-Kiki_Bertens-Mandy_Minella,1,S-DTL,3,0,0,0,0,2,1
20190702-W-Wimbledon-R128-Kiki_Bertens-Mandy_Minella,2,F-XC,36,9,2,2,5,16,20
20190702-W-Wimbledon-R128-Kiki_Bertens-Mandy_Minella,2,F-DTM,21,4,0,0,4,3,18
20190702-W-Wimbledon-R128-Kiki_Bertens-Mandy_Minella,2,F-DTL,9,3,0,1,2,6,3
20190702-W-Wimbledon-R128-Kiki_Bertens-Mandy_Minella,2,F-IO,18,5,1,3,1,10,8
20190702-W-Wimbledon-R128-Kiki_Bertens-Mandy_Minella,2,F-II,3,1,0,0,1,2,1
20190702-W-Wimbledon-R128-Kiki_Bertens-Mandy_Minella,2,B-XC,3,0,0,0,0,0,3
20190702-W-Wimbledon-R128-Kiki_Bertens-Mandy_Minella,2,B-DTM,6,0,0,0,0,1,5
20190702-W-Wimbledon-R128-Kiki_Bertens-Mandy_Minella,2,B-DTL,7,2,0,0,2,2,5
20190702-W-Wimbledon-R128-Kiki_Bertens-Mandy_Minella,2,B-IO,2,0,0,0,0,2,0
20190702-W-Wimbledon-R128-Kiki_Bertens-Mandy_Minella,2,S-XC,7,1,0,0,1,2,5
20190702-W-Wimbledon-R128-Kiki_Bertens-Mandy_Minella,2,S-DTM,13,1,0,0,1,2,11
20190702-W-Wimbledon-R128-Kiki_Bertens-Mandy_Minella,2,S-DTL,5,2,0,0,2,1,4
20190702-W-Wimbledon-R128-Kiki_Bertens-Mandy_Minella,2,S-IO,1,0,0,0,0,0,1
20190703-W-Wimbledon-R64-Cori_Gauff-Magdalena_Rybarikova,1,F-XC,34,7,2,2,3,24,10
20190703-W-Wimbledon-R64-Cori_Gauff-Magdalena_Rybarikova,1,F-DTM,34,1,1,0,0,19,15
20190703-W-Wimbledon-R64-Cori_Gauff-Magdalena_Rybarikova,1,F-DTL,3,0,0,0,0,3,0
20190703-W-Wimbledon-R64-Cori_Gauff-Magdalena_Rybarikova,1,F-IO,8,2,1,0,1,6,2
20190703-W-Wimbledon-R64-Cori_Gauff-Magdalena_Rybarikova,1,B-XC,33,10,6,2,2,26,7
20190703-W-Wimbledon-R64-Cori_Gauff-Magdalena_Rybarikova,1,B-DTM,17,1,0,0,1,11,6
20190703-W-Wimbledon-R64-Cori_Gauff-Magdalena_Rybarikova,1,B-DTL,8,4,4,0,0,6,2
20190703-W-Wimbledon-R64-Cori_Gauff-Magdalena_Rybarikova,1,B-IO,3,0,0,0,0,3,0
20190703-W-Wimbledon-R64-Cori_Gauff-Magdalena_Rybarikova,1,S-XC,1,0,0,0,0,1,0
20190703-W-Wimbledon-R64-Cori_Gauff-Magdalena_Rybarikova,1,S-DTM,2,0,0,0,0,1,1
20190703-W-Wimbledon-R64-Cori_Gauff-Magdalena_Rybarikova,1,S-DTL,3,0,0,0,0,2,1
20190703-W-Wimbledon-R64-Cori_Gauff-Magdalena_Rybarikova,2,F-XC,31,4,0,0,4,8,23
20190703-W-Wimbledon-R64-Cori_Gauff-Magdalena_Rybarikova,2,F-DTM,23,3,0,0,3,9,14
20190703-W-Wimbledon-R64-Cori_Gauff-Magdalena_Rybarikova,2,F-DTL,7,1,0,0,1,1,6
20190703-W-Wimbledon-R64-Cori_Gauff-Magdalena_Rybarikova,2,F-IO,13,5,3,0,2,5,8
20190703-W-Wimbledon-R64-Cori_Gauff-Magdalena_Rybarikova,2,F-II,1,0,0,0,0,0,1
20190703-W-Wimbledon-R64-Cori_Gauff-Magdalena_Rybarikova,2,B-XC,10,1,1,0,0,6,4
20190703-W-Wimbledon-R64-Cori_Gauff-Magdalena_Rybarikova,2,B-DTM,12,1,0,0,1,1,11
20190703-W-Wimbledon-R64-Cori_Gauff-Magdalena_Rybarikova,2,B-DTL,2,0,0,0,0,1,1
20190703-W-Wimbledon-R64-Cori_Gauff-Magdalena_Rybarikova,2,B-IO,3,1,0,0,1,1,2
20190703-W-Wimbledon-R64-Cori_Gauff-Magdalena_Rybarikova,2,S-XC,8,1,0,0,1,1,7
20190703-W-Wimbledon-R64-Cori_Gauff-Magdalena_Rybarikova,2,S-DTM,13,2,0,0,2,2,11
20190703-W-Wimbledon-R64-Cori_Gauff-Magdalena_Rybarikova,2,S-DTL,7,1,0,0,1,1,6
20190703-W-Wimbledon-R64-Cori_Gauff-Magdalena_Rybarikova,2,S-IO,4,1,0,0,1,0,4
20190702-W-Wimbledon-R128-Ivana_Jorovic-Lesley_Kerkhove,1,F-XC,45,5,3,0,2,23,22
20190702-W-Wimbledon-R128-Ivana_Jorovic-Lesley_Kerkhove,1,F-DTM,23,3,0,0,3,13,10
20190702-W-Wimbledon-R128-Ivana_Jorovic-Lesley_Kerkhove,1,F-DTL,28,12,2,2,8,14,14
20190702-W-Wimbledon-R128-Ivana_Jorovic-Lesley_Kerkhove,1,F-IO,14,8,5,2,1,11,3
20190702-W-Wimbledon-R128-Ivana_Jorovic-Lesley_Kerkhove,1,B-XC,28,11,5,2,4,18,10
20190702-W-Wimbledon-R128-Ivana_Jorovic-Lesley_Kerkhove,1,B-DTM,30,5,0,2,3,17,13
20190702-W-Wimbledon-R128-Ivana_Jorovic-Lesley_Kerkhove,1,B-DTL,11,6,1,2,3,5,6
20190702-W-Wimbledon-R128-Ivana_Jorovic-Lesley_Kerkhove,1,B-IO,12,7,5,1,1,10,2
20190702-W-Wimbledon-R128-Ivana_Jorovic-Lesley_Kerkhove,1,S-XC,1,0,0,0,0,0,1
20190702-W-Wimbledon-R128-Ivana_Jorovic-Lesley_Kerkhove,1,S-DTM,5,0,0,0,0,3,2
20190702-W-Wimbledon-R128-Ivana_Jorovic-Lesley_Kerkhove,2,F-XC,54,9,2,1,6,26,28
20190702-W-Wimbledon-R128-Ivana_Jorovic-Lesley_Kerkhove,2,F-DTM,21,2,0,0,2,6,15
20190702-W-Wimbledon-R128-Ivana_Jorovic-Lesley_Kerkhove,2,F-DTL,9,8,3,1,4,4,5
20190702-W-Wimbledon-R128-Ivana_Jorovic-Lesley_Kerkhove,2,F-IO,21,12,7,1,4,11,10
20190702-W-Wimbledon-R128-Ivana_Jorovic-Lesley_Kerkhove,2,B-XC,23,4,1,2,1,11,12
20190702-W-Wimbledon-R128-Ivana_Jorovic-Lesley_Kerkhove,2,B-DTM,30,4,0,0,4,10,20
20190702-W-Wimbledon-R128-Ivana_Jorovic-Lesley_Kerkhove,2,B-DTL,8,4,2,0,2,3,5
20190702-W-Wimbledon-R128-Ivana_Jorovic-Lesley_Kerkhove,2,B-IO,7,3,2,0,1,2,5
20190702-W-Wimbledon-R128-Ivana_Jorovic-Lesley_Kerkhove,2,S-XC,1,0,0,0,0,1,0
20190702-W-Wimbledon-R128-Ivana_Jorovic-Lesley_Kerkhove,2,S-DTM,3,0,0,0,0,0,3
20190702-W-Wimbledon-R128-Ivana_Jorovic-Lesley_Kerkhove,2,S-DTL,2,1,0,0,1,0,2
20190702-W-Wimbledon-R128-Ivana_Jorovic-Lesley_Kerkhove,2,S-IO,1,0,0,0,0,0,1
20190701-W-Wimbledon-R128-Alize_Cornet-Victoria_Azarenka,1,F-XC,41,6,2,1,3,21,20
20190701-W-Wimbledon-R128-Alize_Cornet-Victoria_Azarenka,1,F-DTM,11,2,0,0,2,6,5
20190701-W-Wimbledon-R128-Alize_Cornet-Victoria_Azarenka,1,F-DTL,9,4,2,1,1,4,5
20190701-W-Wimbledon-R128-Alize_Cornet-Victoria_Azarenka,1,F-IO,7,1,0,1,0,3,4
20190701-W-Wimbledon-R128-Alize_Cornet-Victoria_Azarenka,1,F-II,1,0,0,0,0,0,1
20190701-W-Wimbledon-R128-Alize_Cornet-Victoria_Azarenka,1,B-XC,40,6,1,3,2,24,16
20190701-W-Wimbledon-R128-Alize_Cornet-Victoria_Azarenka,1,B-DTM,26,1,0,0,0,14,12
20190701-W-Wimbledon-R128-Alize_Cornet-Victoria_Azarenka,1,B-DTL,11,6,1,3,2,7,4
20190701-W-Wimbledon-R128-Alize_Cornet-Victoria_Azarenka,1,B-IO,5,2,0,1,1,3,2
20190701-W-Wimbledon-R128-Alize_Cornet-Victoria_Azarenka,1,S-XC,6,0,0,0,0,0,6
20190701-W-Wimbledon-R128-Alize_Cornet-Victoria_Azarenka,1,S-DTM,5,0,0,0,0,0,5
20190701-W-Wimbledon-R128-Alize_Cornet-Victoria_Azarenka,1,S-DTL,2,1,1,0,0,2,0
20190701-W-Wimbledon-R128-Alize_Cornet-Victoria_Azarenka,2,F-XC,26,8,3,3,2,13,13
20190701-W-Wimbledon-R128-Alize_Cornet-Victoria_Azarenka,2,F-DTM,15,1,0,1,0,4,11
20190701-W-Wimbledon-R128-Alize_Cornet-Victoria_Azarenka,2,F-DTL,27,4,1,1,2,18,9
20190701-W-Wimbledon-R128-Alize_Cornet-Victoria_Azarenka,2,F-IO,15,5,1,2,2,8,7
20190701-W-Wimbledon-R128-Alize_Cornet-Victoria_Azarenka,2,B-XC,27,7,3,3,1,16,11
20190701-W-Wimbledon-R128-Alize_Cornet-Victoria_Azarenka,2,B-DTM,23,3,0,1,2,14,9
20190701-W-Wimbledon-R128-Alize_Cornet-Victoria_Azarenka,2,B-DTL,12,7,4,2,1,11,1
20190701-W-Wimbledon-R128-Alize_Cornet-Victoria_Azarenka,2,B-IO,14,5,1,1,3,7,7
20190701-W-Wimbledon-R128-Alize_Cornet-Victoria_Azarenka,2,S-XC,7,0,0,0,0,3,4
20190701-W-Wimbledon-R128-Alize_Cornet-Victoria_Azarenka,2,S-DTM,3,0,0,0,0,2,1
20190701-W-Wimbledon-R128-Alize_Cornet-Victoria_Azarenka,2,S-DTL,2,0,0,0,0,0,2
20190704-W-Wimbledon-R64-Taylor_Townsend-Kiki_Bertens,1,F-XC,69,16,4,4,8,35,34
20190704-W-Wimbledon-R64-Taylor_Townsend-Kiki_Bertens,1,F-DTM,14,2,0,0,1,5,9
20190704-W-Wimbledon-R64-Taylor_Townsend-Kiki_Bertens,1,F-DTL,11,7,4,2,1,9,2
20190704-W-Wimbledon-R64-Taylor_Townsend-Kiki_Bertens,1,F-IO,15,7,1,0,6,5,10
20190704-W-Wimbledon-R64-Taylor_Townsend-Kiki_Bertens,1,F-II,4,3,0,1,2,1,3
20190704-W-Wimbledon-R64-Taylor_Townsend-Kiki_Bertens,1,B-XC,27,9,1,1,7,9,18
20190704-W-Wimbledon-R64-Taylor_Townsend-Kiki_Bertens,1,B-DTM,17,1,0,0,1,8,9
20190704-W-Wimbledon-R64-Taylor_Townsend-Kiki_Bertens,1,B-DTL,2,0,0,0,0,1,1
20190704-W-Wimbledon-R64-Taylor_Townsend-Kiki_Bertens,1,B-IO,2,0,0,0,0,2,0
20190704-W-Wimbledon-R64-Taylor_Townsend-Kiki_Bertens,1,S-XC,9,3,1,0,2,2,7
20190704-W-Wimbledon-R64-Taylor_Townsend-Kiki_Bertens,1,S-DTM,11,2,0,0,2,3,8
20190704-W-Wimbledon-R64-Taylor_Townsend-Kiki_Bertens,1,S-DTL,5,0,0,0,0,1,4
20190704-W-Wimbledon-R64-Taylor_Townsend-Kiki_Bertens,2,F-XC,52,11,4,3,4,35,17
20190704-W-Wimbledon-R64-Taylor_Townsend-Kiki_Bertens,2,F-DTM,17,2,1,1,0,7,10
20190704-W-Wimbledon-R64-Taylor_Townsend-Kiki_Bertens,2,F-DTL,12,6,3,2,1,9,3
20190704-W-Wimbledon-R64-Taylor_Townsend-Kiki_Bertens,2,F-IO,23,11,8,1,2,16,7
20190704-W-Wimbledon-R64-Taylor_Townsend-Kiki_Bertens,2,B-XC,21,1,0,0,1,9,12
20190704-W-Wimbledon-R64-Taylor_Townsend-Kiki_Bertens,2,B-DTM,24,1,0,0,1,14,10
20190704-W-Wimbledon-R64-Taylor_Townsend-Kiki_Bertens,2,B-DTL,6,5,3,0,2,4,2
20190704-W-Wimbledon-R64-Taylor_Townsend-Kiki_Bertens,2,S-XC,12,1,0,0,1,5,7
20190704-W-Wimbledon-R64-Taylor_Townsend-Kiki_Bertens,2,S-DTM,6,0,0,0,0,2,4
20190704-W-Wimbledon-R64-Taylor_Townsend-Kiki_Bertens,2,S-DTL,6,1,0,1,0,5,1
20190704-W-Wimbledon-R64-Taylor_Townsend-Kiki_Bertens,2,S-IO,1,0,0,0,0,0,1
20190705-W-Wimbledon-R32-Karolina_Pliskova-Su_Wei_Hsieh,1,F-XC,36,12,4,4,4,22,14
20190705-W-Wimbledon-R32-Karolina_Pliskova-Su_Wei_Hsieh,1,F-DTM,7,0,0,0,0,1,6
20190705-W-Wimbledon-R32-Karolina_Pliskova-Su_Wei_Hsieh,1,F-DTL,10,6,1,1,4,3,7
20190705-W-Wimbledon-R32-Karolina_Pliskova-Su_Wei_Hsieh,1,F-IO,15,10,6,2,2,12,3
20190705-W-Wimbledon-R32-Karolina_Pliskova-Su_Wei_Hsieh,1,B-XC,22,5,2,2,1,11,11
20190705-W-Wimbledon-R32-Karolina_Pliskova-Su_Wei_Hsieh,1,B-DTM,13,4,0,0,4,3,10
20190705-W-Wimbledon-R32-Karolina_Pliskova-Su_Wei_Hsieh,1,B-DTL,8,2,1,0,1,4,4
20190705-W-Wimbledon-R32-Karolina_Pliskova-Su_Wei_Hsieh,1,B-IO,7,1,0,1,0,4,3
20190705-W-Wimbledon-R32-Karolina_Pliskova-Su_Wei_Hsieh,1,S-XC,10,3,1,1,1,3,7
20190705-W-Wimbledon-R32-Karolina_Pliskova-Su_Wei_Hsieh,1,S-DTM,11,0,0,0,0,2,9
20190705-W-Wimbledon-R32-Karolina_Pliskova-Su_Wei_Hsieh,2,F-XC,27,9,4,3,2,20,7
20190705-W-Wimbledon-R32-Karolina_Pliskova-Su_Wei_Hsieh,2,F-DTM,10,1,0,0,1,3,7
20190705-W-Wimbledon-R32-Karolina_Pliskova-Su_Wei_Hsieh,2,F-DTL,10,6,2,2,2,6,4
20190705-W-Wimbledon-R32-Karolina_Pliskova-Su_Wei_Hsieh,2,F-IO,10,4,0,2,2,8,2
20190705-W-Wimbledon-R32-Karolina_Pliskova-Su_Wei_Hsieh,2,B-XC,27,10,4,1,5,18,9
20190705-W-Wimbledon-R32-Karolina_Pliskova-Su_Wei_Hsieh,2,B-DTM,24,2,0,2,0,10,14
20190705-W-Wimbledon-R32-Karolina_Pliskova-Su_Wei_Hsieh,2,B-DTL,6,2,2,0,0,5,1
20190705-W-Wimbledon-R32-Karolina_Pliskova-Su_Wei_Hsieh,2,B-IO,3,2,2,0,0,2,1
20190705-W-Wimbledon-R32-Karolina_Pliskova-Su_Wei_Hsieh,2,S-XC,3,0,0,0,0,1,2
20190705-W-Wimbledon-R32-Karolina_Pliskova-Su_Wei_Hsieh,2,S-DTM,2,0,0,0,0,1,1
20190705-W-Wimbledon-R32-Karolina_Pliskova-Su_Wei_Hsieh,2,S-IO,2,0,0,0,0,2,0
20190701-W-Wimbledon-R128-Daria_Gavrilova-Elina_Svitolina,1,F-XC,41,8,3,3,2,20,21
20190701-W-Wimbledon-R128-Daria_Gavrilova-Elina_Svitolina,1,F-DTM,6,0,0,0,0,1,5
20190701-W-Wimbledon-R128-Daria_Gavrilova-Elina_Svitolina,1,F-DTL,9,5,1,0,4,2,7
20190701-W-Wimbledon-R128-Daria_Gavrilova-Elina_Svitolina,1,F-IO,8,5,3,1,1,6,2
20190701-W-Wimbledon-R128-Daria_Gavrilova-Elina_Svitolina,1,F-II,2,0,0,0,0,0,2
20190701-W-Wimbledon-R128-Daria_Gavrilova-Elina_Svitolina,1,B-XC,9,3,0,1,2,3,6
20190701-W-Wimbledon-R128-Daria_Gavrilova-Elina_Svitolina,1,B-DTM,6,0,0,0,0,1,5
20190701-W-Wimbledon-R128-Daria_Gavrilova-Elina_Svitolina,1,B-DTL,6,1,1,0,0,2,4
20190701-W-Wimbledon-R128-Daria_Gavrilova-Elina_Svitolina,1,B-IO,4,0,0,0,0,2,2
20190701-W-Wimbledon-R128-Daria_Gavrilova-Elina_Svitolina,1,S-XC,1,0,0,0,0,0,1
20190701-W-Wimbledon-R128-Daria_Gavrilova-Elina_Svitolina,1,S-DTM,8,1,0,0,1,3,5
20190701-W-Wimbledon-R128-Daria_Gavrilova-Elina_Svitolina,1,S-DTL,3,1,0,0,1,1,2
20190701-W-Wimbledon-R128-Daria_Gavrilova-Elina_Svitolina,1,S-IO,1,0,0,0,0,1,0
20190701-W-Wimbledon-R128-Daria_Gavrilova-Elina_Svitolina,2,F-XC,43,14,4,3,7,26,17
20190701-W-Wimbledon-R128-Daria_Gavrilova-Elina_Svitolina,2,F-DTM,12,0,0,0,0,5,7
20190701-W-Wimbledon-R128-Daria_Gavrilova-Elina_Svitolina,2,F-DTL,8,1,0,1,0,4,4
20190701-W-Wimbledon-R128-Daria_Gavrilova-Elina_Svitolina,2,F-IO,13,5,0,2,2,11,2
20190701-W-Wimbledon-R128-Daria_Gavrilova-Elina_Svitolina,2,F-II,2,0,0,0,0,0,2
20190701-W-Wimbledon-R128-Daria_Gavrilova-Elina_Svitolina,2,B-XC,12,2,1,0,1,8,4
20190701-W-Wimbledon-R128-Daria_Gavrilova-Elina_Svitolina,2,B-DTM,4,0,0,0,0,2,2
20190701-W-Wimbledon-R128-Daria_Gavrilova-Elina_Svitolina,2,B-DTL,4,4,3,0,1,3,1
20190701-W-Wimbledon-R128-Daria_Gavrilova-Elina_Svitolina,2,B-IO,1,0,0,0,0,1,0
20190701-W-Wimbledon-R128-Daria_Gavrilova-Elina_Svitolina,2,S-XC,2,0,0,0,0,0,2
20190701-W-Wimbledon-R128-Daria_Gavrilova-Elina_Svitolina,2,S-DTM,1,0,0,0,0,0,1
20190701-W-Wimbledon-R128-Daria_Gavrilova-Elina_Svitolina,2,S-IO,1,0,0,0,0,0,1
20190701-W-Wimbledon-R128-Iga_Swiatek-Viktorija_Golubic,1,F-XC,40,17,8,1,8,23,17
20190701-W-Wimbledon-R128-Iga_Swiatek-Viktorija_Golubic,1,F-DTM,7,1,0,0,1,3,4
20190701-W-Wimbledon-R128-Iga_Swiatek-Viktorija_Golubic,1,F-DTL,8,3,1,2,0,5,3
20190701-W-Wimbledon-R128-Iga_Swiatek-Viktorija_Golubic,1,F-IO,13,6,1,1,4,6,7
20190701-W-Wimbledon-R128-Iga_Swiatek-Viktorija_Golubic,1,F-II,2,2,0,1,1,1,1
20190701-W-Wimbledon-R128-Iga_Swiatek-Viktorija_Golubic,1,B-XC,32,10,0,4,6,9,23
20190701-W-Wimbledon-R128-Iga_Swiatek-Viktorija_Golubic,1,B-DTM,6,1,0,0,1,2,4
20190701-W-Wimbledon-R128-Iga_Swiatek-Viktorija_Golubic,1,B-DTL,5,4,2,0,2,2,3
20190701-W-Wimbledon-R128-Iga_Swiatek-Viktorija_Golubic,1,B-IO,5,1,0,0,1,1,4
20190701-W-Wimbledon-R128-Iga_Swiatek-Viktorija_Golubic,1,S-XC,3,0,0,0,0,0,3
20190701-W-Wimbledon-R128-Iga_Swiatek-Viktorija_Golubic,1,S-DTM,1,0,0,0,0,0,1
20190701-W-Wimbledon-R128-Iga_Swiatek-Viktorija_Golubic,1,S-DTL,1,0,0,0,0,0,1
20190701-W-Wimbledon-R128-Iga_Swiatek-Viktorija_Golubic,2,F-XC,21,6,0,2,4,7,14
20190701-W-Wimbledon-R128-Iga_Swiatek-Viktorija_Golubic,2,F-DTM,14,1,0,1,0,6,8
20190701-W-Wimbledon-R128-Iga_Swiatek-Viktorija_Golubic,2,F-DTL,7,3,2,1,0,6,1
20190701-W-Wimbledon-R128-Iga_Swiatek-Viktorija_Golubic,2,F-IO,2,0,0,0,0,2,0
20190701-W-Wimbledon-R128-Iga_Swiatek-Viktorija_Golubic,2,F-II,1,0,0,0,0,1,0
20190701-W-Wimbledon-R128-Iga_Swiatek-Viktorija_Golubic,2,B-XC,11,3,3,0,0,9,2
20190701-W-Wimbledon-R128-Iga_Swiatek-Viktorija_Golubic,2,B-DTM,15,1,0,1,0,10,5
20190701-W-Wimbledon-R128-Iga_Swiatek-Viktorija_Golubic,2,B-DTL,8,3,1,1,1,4,4
20190701-W-Wimbledon-R128-Iga_Swiatek-Viktorija_Golubic,2,S-XC,10,0,0,0,0,7,3
20190701-W-Wimbledon-R128-Iga_Swiatek-Viktorija_Golubic,2,S-DTM,8,0,0,0,0,4,4
20190701-W-Wimbledon-R128-Iga_Swiatek-Viktorija_Golubic,2,S-DTL,3,0,0,0,0,1,2
20190701-W-Wimbledon-R128-Karolina_Pliskova-Lin_Zhu,1,F-XC,28,9,3,3,3,15,13
20190701-W-Wimbledon-R128-Karolina_Pliskova-Lin_Zhu,1,F-DTM,11,1,0,0,1,3,8
20190701-W-Wimbledon-R128-Karolina_Pliskova-Lin_Zhu,1,F-DTL,9,3,2,0,1,5,4
20190701-W-Wimbledon-R128-Karolina_Pliskova-Lin_Zhu,1,F-IO,23,13,1,7,5,16,7
20190701-W-Wimbledon-R128-Karolina_Pliskova-Lin_Zhu,1,F-II,2,2,2,0,0,2,0
20190701-W-Wimbledon-R128-Karolina_Pliskova-Lin_Zhu,1,B-XC,15,1,1,0,0,10,5
20190701-W-Wimbledon-R128-Karolina_Pliskova-Lin_Zhu,1,B-DTM,13,3,1,1,1,7,6
20190701-W-Wimbledon-R128-Karolina_Pliskova-Lin_Zhu,1,B-DTL,5,2,1,0,1,3,2
20190701-W-Wimbledon-R128-Karolina_Pliskova-Lin_Zhu,1,B-IO,8,1,0,0,1,3,5
20190701-W-Wimbledon-R128-Karolina_Pliskova-Lin_Zhu,1,S-XC,5,1,0,1,0,4,1
20190701-W-Wimbledon-R128-Karolina_Pliskova-Lin_Zhu,1,S-DTM,3,0,0,0,0,2,1
20190701-W-Wimbledon-R128-Karolina_Pliskova-Lin_Zhu,1,S-IO,3,0,0,0,0,1,2
20190701-W-Wimbledon-R128-Karolina_Pliskova-Lin_Zhu,2,F-XC,26,8,1,5,2,14,12
20190701-W-Wimbledon-R128-Karolina_Pliskova-Lin_Zhu,2,F-DTM,19,1,0,0,1,12,7
20190701-W-Wimbledon-R128-Karolina_Pliskova-Lin_Zhu,2,F-DTL,12,8,4,2,2,8,4
20190701-W-Wimbledon-R128-Karolina_Pliskova-Lin_Zhu,2,F-IO,6,1,0,0,1,1,5
20190701-W-Wimbledon-R128-Karolina_Pliskova-Lin_Zhu,2,B-XC,21,4,1,0,3,8,13
20190701-W-Wimbledon-R128-Karolina_Pliskova-Lin_Zhu,2,B-DTM,20,4,0,3,1,7,13
20190701-W-Wimbledon-R128-Karolina_Pliskova-Lin_Zhu,2,B-DTL,6,4,2,0,2,3,3
20190701-W-Wimbledon-R128-Karolina_Pliskova-Lin_Zhu,2,B-IO,7,2,0,0,2,4,3
20190701-W-Wimbledon-R128-Karolina_Pliskova-Lin_Zhu,2,S-XC,10,2,0,0,2,3,7
20190701-W-Wimbledon-R128-Karolina_Pliskova-Lin_Zhu,2,S-DTM,5,0,0,0,0,3,2
20190701-W-Wimbledon-R128-Karolina_Pliskova-Lin_Zhu,2,S-DTL,2,2,1,1,0,2,0
20190702-W-Wimbledon-R128-Belinda_Bencic-Anastasia_Pavlyuchenkova,1,F-XC,25,9,5,2,2,14,11
20190702-W-Wimbledon-R128-Belinda_Bencic-Anastasia_Pavlyuchenkova,1,F-DTM,9,1,0,0,1,2,7
20190702-W-Wimbledon-R128-Belinda_Bencic-Anastasia_Pavlyuchenkova,1,F-DTL,12,5,3,1,1,9,3
20190702-W-Wimbledon-R128-Belinda_Bencic-Anastasia_Pavlyuchenkova,1,F-IO,7,2,2,0,0,6,1
20190702-W-Wimbledon-R128-Belinda_Bencic-Anastasia_Pavlyuchenkova,1,F-II,1,1,1,0,0,1,0
20190702-W-Wimbledon-R128-Belinda_Bencic-Anastasia_Pavlyuchenkova,1,B-XC,12,6,4,2,0,9,3
20190702-W-Wimbledon-R128-Belinda_Bencic-Anastasia_Pavlyuchenkova,1,B-DTM,6,0,0,0,0,3,3
20190702-W-Wimbledon-R128-Belinda_Bencic-Anastasia_Pavlyuchenkova,1,B-DTL,5,3,3,0,0,5,0
20190702-W-Wimbledon-R128-Belinda_Bencic-Anastasia_Pavlyuchenkova,1,B-IO,4,1,0,0,1,3,1
20190702-W-Wimbledon-R128-Belinda_Bencic-Anastasia_Pavlyuchenkova,1,S-XC,2,0,0,0,0,0,2
20190702-W-Wimbledon-R128-Belinda_Bencic-Anastasia_Pavlyuchenkova,2,F-XC,34,11,5,2,4,16,18
20190702-W-Wimbledon-R128-Belinda_Bencic-Anastasia_Pavlyuchenkova,2,F-DTM,8,1,0,0,1,2,6
20190702-W-Wimbledon-R128-Belinda_Bencic-Anastasia_Pavlyuchenkova,2,F-DTL,6,4,1,1,2,4,2
20190702-W-Wimbledon-R128-Belinda_Bencic-Anastasia_Pavlyuchenkova,2,F-IO,8,6,4,0,2,5,3
20190702-W-Wimbledon-R128-Belinda_Bencic-Anastasia_Pavlyuchenkova,2,B-XC,17,5,0,2,3,6,11
20190702-W-Wimbledon-R128-Belinda_Bencic-Anastasia_Pavlyuchenkova,2,B-DTM,7,2,0,1,1,3,4
20190702-W-Wimbledon-R128-Belinda_Bencic-Anastasia_Pavlyuchenkova,2,B-DTL,2,1,0,0,1,0,2
20190702-W-Wimbledon-R128-Belinda_Bencic-Anastasia_Pavlyuchenkova,2,B-IO,6,0,0,0,0,3,3
20190702-W-Wimbledon-R128-Serena_Williams-Giulia_Gatto_Monticone,1,F-XC,37,15,5,4,6,24,13
20190702-W-Wimbledon-R128-Serena_Williams-Giulia_Gatto_Monticone,1,F-DTM,6,0,0,0,0,3,3
20190702-W-Wimbledon-R128-Serena_Williams-Giulia_Gatto_Monticone,1,F-DTL,11,5,2,0,3,4,7
20190702-W-Wimbledon-R128-Serena_Williams-Giulia_Gatto_Monticone,1,F-IO,16,6,0,0,6,5,11
20190702-W-Wimbledon-R128-Serena_Williams-Giulia_Gatto_Monticone,1,F-II,2,1,0,0,1,1,1
20190702-W-Wimbledon-R128-Serena_Williams-Giulia_Gatto_Monticone,1,B-XC,27,6,1,3,2,14,13
20190702-W-Wimbledon-R128-Serena_Williams-Giulia_Gatto_Monticone,1,B-DTM,11,2,0,1,1,6,5
20190702-W-Wimbledon-R128-Serena_Williams-Giulia_Gatto_Monticone,1,B-DTL,10,4,0,2,2,6,4
20190702-W-Wimbledon-R128-Serena_Williams-Giulia_Gatto_Monticone,1,B-IO,3,0,0,0,0,2,1
20190702-W-Wimbledon-R128-Serena_Williams-Giulia_Gatto_Monticone,1,S-XC,1,0,0,0,0,1,0
20190702-W-Wimbledon-R128-Serena_Williams-Giulia_Gatto_Monticone,1,S-DTL,1,1,0,0,1,0,1
20190702-W-Wimbledon-R128-Serena_Williams-Giulia_Gatto_Monticone,2,F-XC,19,2,0,0,2,7,12
20190702-W-Wimbledon-R128-Serena_Williams-Giulia_Gatto_Monticone,2,F-DTM,15,2,0,0,2,7,8
20190702-W-Wimbledon-R128-Serena_Williams-Giulia_Gatto_Monticone,2,F-DTL,15,5,1,1,3,5,10
20190702-W-Wimbledon-R128-Serena_Williams-Giulia_Gatto_Monticone,2,F-IO,9,4,1,1,2,4,5
20190702-W-Wimbledon-R128-Serena_Williams-Giulia_Gatto_Monticone,2,F-II,1,1,0,0,1,0,1
20190702-W-Wimbledon-R128-Serena_Williams-Giulia_Gatto_Monticone,2,B-XC,24,4,0,2,2,16,8
20190702-W-Wimbledon-R128-Serena_Williams-Giulia_Gatto_Monticone,2,B-DTM,15,0,0,0,0,6,9
20190702-W-Wimbledon-R128-Serena_Williams-Giulia_Gatto_Monticone,2,B-DTL,9,4,3,1,0,6,3
20190702-W-Wimbledon-R128-Serena_Williams-Giulia_Gatto_Monticone,2,B-IO,5,3,1,0,2,2,3
20190702-W-Wimbledon-R128-Serena_Williams-Giulia_Gatto_Monticone,2,S-XC,1,0,0,0,0,1,0
20190702-W-Wimbledon-R128-Serena_Williams-Giulia_Gatto_Monticone,2,S-DTM,2,0,0,0,0,1,1
20190702-W-Wimbledon-R128-Serena_Williams-Giulia_Gatto_Monticone,2,S-DTL,2,1,0,0,1,0,2
20190702-W-Wimbledon-R128-Serena_Williams-Giulia_Gatto_Monticone,2,S-IO,1,0,0,0,0,0,1
20190702-W-Wimbledon-R128-Ashleigh_Barty-Saisai_Zheng,1,F-XC,30,9,3,4,2,23,7
20190702-W-Wimbledon-R128-Ashleigh_Barty-Saisai_Zheng,1,F-DTM,9,1,1,0,0,6,3
20190702-W-Wimbledon-R128-Ashleigh_Barty-Saisai_Zheng,1,F-DTL,2,1,0,0,1,1,1
20190702-W-Wimbledon-R128-Ashleigh_Barty-Saisai_Zheng,1,F-IO,36,10,3,3,4,23,13
20190702-W-Wimbledon-R128-Ashleigh_Barty-Saisai_Zheng,1,F-II,5,3,2,1,0,4,1
20190702-W-Wimbledon-R128-Ashleigh_Barty-Saisai_Zheng,1,B-XC,18,2,0,1,1,8,10
20190702-W-Wimbledon-R128-Ashleigh_Barty-Saisai_Zheng,1,B-DTM,14,0,0,0,0,4,10
20190702-W-Wimbledon-R128-Ashleigh_Barty-Saisai_Zheng,1,B-DTL,3,1,0,0,1,1,2
20190702-W-Wimbledon-R128-Ashleigh_Barty-Saisai_Zheng,1,B-IO,1,0,0,0,0,0,1
20190702-W-Wimbledon-R128-Ashleigh_Barty-Saisai_Zheng,1,S-XC,31,5,0,3,2,20,11
20190702-W-Wimbledon-R128-Ashleigh_Barty-Saisai_Zheng,1,S-DTM,6,0,0,0,0,4,2
20190702-W-Wimbledon-R128-Ashleigh_Barty-Saisai_Zheng,1,S-DTL,9,2,0,1,1,6,3
20190702-W-Wimbledon-R128-Ashleigh_Barty-Saisai_Zheng,1,S-IO,2,0,0,0,0,2,0
20190702-W-Wimbledon-R128-Ashleigh_Barty-Saisai_Zheng,2,F-XC,10,4,0,0,4,3,7
20190702-W-Wimbledon-R128-Ashleigh_Barty-Saisai_Zheng,2,F-DTM,20,3,0,0,3,5,15
20190702-W-Wimbledon-R128-Ashleigh_Barty-Saisai_Zheng,2,F-DTL,20,2,0,0,2,10,10
20190702-W-Wimbledon-R128-Ashleigh_Barty-Saisai_Zheng,2,F-IO,28,3,0,1,2,16,12
20190702-W-Wimbledon-R128-Ashleigh_Barty-Saisai_Zheng,2,F-II,1,1,0,0,1,0,1
20190702-W-Wimbledon-R128-Ashleigh_Barty-Saisai_Zheng,2,B-XC,26,3,0,2,1,11,15
20190702-W-Wimbledon-R128-Ashleigh_Barty-Saisai_Zheng,2,B-DTM,19,1,0,1,0,9,10
20190702-W-Wimbledon-R128-Ashleigh_Barty-Saisai_Zheng,2,B-DTL,6,5,2,1,2,3,3
20190702-W-Wimbledon-R128-Ashleigh_Barty-Saisai_Zheng,2,B-IO,1,0,0,0,0,0,1
20190702-W-Wimbledon-R128-Ashleigh_Barty-Saisai_Zheng,2,S-XC,26,2,0,1,1,7,19
20190702-W-Wimbledon-R128-Ashleigh_Barty-Saisai_Zheng,2,S-DTM,8,0,0,0,0,2,6
20190702-W-Wimbledon-R128-Ashleigh_Barty-Saisai_Zheng,2,S-DTL,4,2,0,0,2,0,4
20190706-W-Wimbledon-R32-Carla_Suarez_Navarro-Lauren_Davis,1,F-XC,29,8,3,2,3,16,13
20190706-W-Wimbledon-R32-Carla_Suarez_Navarro-Lauren_Davis,1,F-DTM,11,6,1,0,5,3,8
20190706-W-Wimbledon-R32-Carla_Suarez_Navarro-Lauren_Davis,1,F-DTL,1,1,1,0,0,1,0
20190706-W-Wimbledon-R32-Carla_Suarez_Navarro-Lauren_Davis,1,F-IO,13,5,2,2,1,8,5
20190706-W-Wimbledon-R32-Carla_Suarez_Navarro-Lauren_Davis,1,F-II,1,0,0,0,0,1,0
20190706-W-Wimbledon-R32-Carla_Suarez_Navarro-Lauren_Davis,1,B-XC,29,3,0,0,3,12,17
20190706-W-Wimbledon-R32-Carla_Suarez_Navarro-Lauren_Davis,1,B-DTM,17,3,0,1,2,9,8
20190706-W-Wimbledon-R32-Carla_Suarez_Navarro-Lauren_Davis,1,B-DTL,1,0,0,0,0,1,0
20190706-W-Wimbledon-R32-Carla_Suarez_Navarro-Lauren_Davis,1,B-IO,10,4,1,1,2,3,7
20190706-W-Wimbledon-R32-Carla_Suarez_Navarro-Lauren_Davis,1,S-XC,9,0,0,0,0,3,6
20190706-W-Wimbledon-R32-Carla_Suarez_Navarro-Lauren_Davis,1,S-DTM,5,0,0,0,0,4,1
20190706-W-Wimbledon-R32-Carla_Suarez_Navarro-Lauren_Davis,1,S-DTL,2,0,0,0,0,0,2
20190706-W-Wimbledon-R32-Carla_Suarez_Navarro-Lauren_Davis,2,F-XC,12,5,3,0,2,9,3
20190706-W-Wimbledon-R32-Carla_Suarez_Navarro-Lauren_Davis,2,F-DTM,20,1,0,0,1,9,11
20190706-W-Wimbledon-R32-Carla_Suarez_Navarro-Lauren_Davis,2,F-DTL,11,8,0,3,5,4,7
20190706-W-Wimbledon-R32-Carla_Suarez_Navarro-Lauren_Davis,2,F-IO,10,3,1,1,1,6,4
20190706-W-Wimbledon-R32-Carla_Suarez_Navarro-Lauren_Davis,2,B-XC,17,8,4,0,4,10,7
20190706-W-Wimbledon-R32-Carla_Suarez_Navarro-Lauren_Davis,2,B-DTM,27,6,0,1,5,14,13
20190706-W-Wimbledon-R32-Carla_Suarez_Navarro-Lauren_Davis,2,B-DTL,4,3,2,0,1,2,2
20190706-W-Wimbledon-R32-Carla_Suarez_Navarro-Lauren_Davis,2,B-IO,2,2,0,0,2,0,2
20190706-W-Wimbledon-R32-Carla_Suarez_Navarro-Lauren_Davis,2,S-XC,10,3,0,1,2,4,6
20190706-W-Wimbledon-R32-Carla_Suarez_Navarro-Lauren_Davis,2,S-DTM,12,1,1,0,0,5,7
20190706-W-Wimbledon-R32-Carla_Suarez_Navarro-Lauren_Davis,2,S-DTL,3,1,0,0,1,1,2
20190705-W-Wimbledon-R32-Cori_Gauff-Polona_Hercog,1,F-XC,45,9,1,2,6,24,21
20190705-W-Wimbledon-R32-Cori_Gauff-Polona_Hercog,1,F-DTM,55,3,0,1,2,30,25
20190705-W-Wimbledon-R32-Cori_Gauff-Polona_Hercog,1,F-DTL,17,3,1,0,2,7,10
20190705-W-Wimbledon-R32-Cori_Gauff-Polona_Hercog,1,F-IO,38,11,2,1,8,16,22
20190705-W-Wimbledon-R32-Cori_Gauff-Polona_Hercog,1,F-II,2,1,0,1,0,2,0
20190705-W-Wimbledon-R32-Cori_Gauff-Polona_Hercog,1,B-XC,85,11,1,3,7,43,42
20190705-W-Wimbledon-R32-Cori_Gauff-Polona_Hercog,1,B-DTM,34,2,0,0,2,11,23
20190705-W-Wimbledon-R32-Cori_Gauff-Polona_Hercog,1,B-DTL,9,5,3,0,2,4,5
20190705-W-Wimbledon-R32-Cori_Gauff-Polona_Hercog,1,B-IO,5,2,0,1,1,3,2
20190705-W-Wimbledon-R32-Cori_Gauff-Polona_Hercog,1,S-XC,34,3,0,1,2,16,18
20190705-W-Wimbledon-R32-Cori_Gauff-Polona_Hercog,1,S-DTM,32,2,0,1,1,20,12
20190705-W-Wimbledon-R32-Cori_Gauff-Polona_Hercog,1,S-DTL,7,1,1,0,0,6,1
20190705-W-Wimbledon-R32-Cori_Gauff-Polona_Hercog,1,S-IO,6,2,0,1,0,5,1
20190705-W-Wimbledon-R32-Cori_Gauff-Polona_Hercog,2,F-XC,96,21,7,2,12,47,49
20190705-W-Wimbledon-R32-Cori_Gauff-Polona_Hercog,2,F-DTM,34,5,0,1,4,16,18
20190705-W-Wimbledon-R32-Cori_Gauff-Polona_Hercog,2,F-DTL,9,4,1,1,2,3,6
20190705-W-Wimbledon-R32-Cori_Gauff-Polona_Hercog,2,F-IO,56,18,7,4,7,38,18
20190705-W-Wimbledon-R32-Cori_Gauff-Polona_Hercog,2,F-II,5,3,2,1,0,4,1
20190705-W-Wimbledon-R32-Cori_Gauff-Polona_Hercog,2,B-XC,4,1,1,0,0,3,1
20190705-W-Wimbledon-R32-Cori_Gauff-Polona_Hercog,2,B-DTM,8,1,0,0,1,3,5
20190705-W-Wimbledon-R32-Cori_Gauff-Polona_Hercog,2,B-DTL,3,1,0,0,1,1,2
20190705-W-Wimbledon-R32-Cori_Gauff-Polona_Hercog,2,B-IO,2,0,0,0,0,1,1
20190705-W-Wimbledon-R32-Cori_Gauff-Polona_Hercog,2,S-XC,85,5,0,1,4,40,45
20190705-W-Wimbledon-R32-Cori_Gauff-Polona_Hercog,2,S-DTM,64,2,0,0,2,26,38
20190705-W-Wimbledon-R32-Cori_Gauff-Polona_Hercog,2,S-DTL,16,2,0,1,1,6,10
20190705-W-Wimbledon-R32-Cori_Gauff-Polona_Hercog,2,S-IO,6,0,0,0,0,3,3
20190708-W-Wimbledon-R16-Carla_Suarez_Navarro-Serena_Williams,1,F-XC,22,8,4,1,3,8,14
20190708-W-Wimbledon-R16-Carla_Suarez_Navarro-Serena_Williams,1,F-DTM,18,0,0,0,0,8,10
20190708-W-Wimbledon-R16-Carla_Suarez_Navarro-Serena_Williams,1,F-DTL,9,5,0,0,5,2,7
20190708-W-Wimbledon-R16-Carla_Suarez_Navarro-Serena_Williams,1,F-IO,15,2,0,2,0,5,10
20190708-W-Wimbledon-R16-Carla_Suarez_Navarro-Serena_Williams,1,F-II,2,1,1,0,0,1,1
20190708-W-Wimbledon-R16-Carla_Suarez_Navarro-Serena_Williams,1,B-XC,7,3,0,0,3,1,6
20190708-W-Wimbledon-R16-Carla_Suarez_Navarro-Serena_Williams,1,B-DTM,20,1,0,0,1,6,14
20190708-W-Wimbledon-R16-Carla_Suarez_Navarro-Serena_Williams,1,B-DTL,1,1,1,0,0,1,0
20190708-W-Wimbledon-R16-Carla_Suarez_Navarro-Serena_Williams,1,B-IO,1,1,0,0,1,0,1
20190708-W-Wimbledon-R16-Carla_Suarez_Navarro-Serena_Williams,1,S-XC,13,1,0,1,0,5,8
20190708-W-Wimbledon-R16-Carla_Suarez_Navarro-Serena_Williams,1,S-DTM,2,1,0,0,1,1,1
20190708-W-Wimbledon-R16-Carla_Suarez_Navarro-Serena_Williams,2,F-XC,23,9,3,4,2,16,7
20190708-W-Wimbledon-R16-Carla_Suarez_Navarro-Serena_Williams,2,F-DTM,11,2,0,0,2,7,4
20190708-W-Wimbledon-R16-Carla_Suarez_Navarro-Serena_Williams,2,F-DTL,2,2,2,0,0,2,0
20190708-W-Wimbledon-R16-Carla_Suarez_Navarro-Serena_Williams,2,F-IO,6,3,2,1,0,5,1
20190708-W-Wimbledon-R16-Carla_Suarez_Navarro-Serena_Williams,2,F-II,1,1,0,1,0,1,0
20190708-W-Wimbledon-R16-Carla_Suarez_Navarro-Serena_Williams,2,B-XC,37,13,5,2,6,23,14
20190708-W-Wimbledon-R16-Carla_Suarez_Navarro-Serena_Williams,2,B-DTM,16,3,0,2,1,11,5
20190708-W-Wimbledon-R16-Carla_Suarez_Navarro-Serena_Williams,2,B-DTL,10,3,2,0,1,7,3
20190708-W-Wimbledon-R16-Carla_Suarez_Navarro-Serena_Williams,2,B-IO,6,3,2,0,1,3,3
20190708-W-Wimbledon-R16-Carla_Suarez_Navarro-Serena_Williams,2,S-XC,2,1,1,0,0,1,1
20190708-W-Wimbledon-R16-Carla_Suarez_Navarro-Serena_Williams,2,S-DTM,1,0,0,0,0,0,1
20190706-W-Wimbledon-R32-Barbora_Strycova-Kiki_Bertens,1,F-XC,59,12,1,3,8,32,27
20190706-W-Wimbledon-R32-Barbora_Strycova-Kiki_Bertens,1,F-DTM,24,1,0,1,0,12,12
20190706-W-Wimbledon-R32-Barbora_Strycova-Kiki_Bertens,1,F-DTL,14,2,1,0,1,8,6
20190706-W-Wimbledon-R32-Barbora_Strycova-Kiki_Bertens,1,F-IO,11,3,0,2,1,5,6
20190706-W-Wimbledon-R32-Barbora_Strycova-Kiki_Bertens,1,F-II,2,1,0,0,1,1,1
20190706-W-Wimbledon-R32-Barbora_Strycova-Kiki_Bertens,1,B-XC,11,1,0,1,0,8,3
20190706-W-Wimbledon-R32-Barbora_Strycova-Kiki_Bertens,1,B-DTM,11,0,0,0,0,6,5
20190706-W-Wimbledon-R32-Barbora_Strycova-Kiki_Bertens,1,B-DTL,1,1,0,1,0,1,0
20190706-W-Wimbledon-R32-Barbora_Strycova-Kiki_Bertens,1,B-IO,1,1,1,0,0,1,0
20190706-W-Wimbledon-R32-Barbora_Strycova-Kiki_Bertens,1,S-XC,13,1,1,0,0,7,6
20190706-W-Wimbledon-R32-Barbora_Strycova-Kiki_Bertens,1,S-DTM,6,0,0,0,0,5,1
20190706-W-Wimbledon-R32-Barbora_Strycova-Kiki_Bertens,1,S-DTL,1,1,1,0,0,1,0
20190706-W-Wimbledon-R32-Barbora_Strycova-Kiki_Bertens,2,F-XC,65,13,1,3,9,29,36
20190706-W-Wimbledon-R32-Barbora_Strycova-Kiki_Bertens,2,F-DTM,19,2,0,1,1,11,8
20190706-W-Wimbledon-R32-Barbora_Strycova-Kiki_Bertens,2,F-DTL,7,3,1,0,2,3,4
20190706-W-Wimbledon-R32-Barbora_Strycova-Kiki_Bertens,2,F-IO,8,3,1,1,1,2,6
20190706-W-Wimbledon-R32-Barbora_Strycova-Kiki_Bertens,2,F-II,3,0,0,0,0,1,2
20190706-W-Wimbledon-R32-Barbora_Strycova-Kiki_Bertens,2,B-XC,18,5,0,1,4,6,12
20190706-W-Wimbledon-R32-Barbora_Strycova-Kiki_Bertens,2,B-DTM,19,3,0,2,1,11,8
20190706-W-Wimbledon-R32-Barbora_Strycova-Kiki_Bertens,2,B-DTL,4,0,0,0,0,2,2
20190706-W-Wimbledon-R32-Barbora_Strycova-Kiki_Bertens,2,B-IO,10,4,1,1,2,5,5
20190706-W-Wimbledon-R32-Barbora_Strycova-Kiki_Bertens,2,S-XC,8,0,0,0,0,2,6
20190706-W-Wimbledon-R32-Barbora_Strycova-Kiki_Bertens,2,S-DTM,3,1,0,1,0,2,1
20190706-W-Wimbledon-R32-Barbora_Strycova-Kiki_Bertens,2,S-DTL,6,0,0,0,0,2,4
20190706-W-Wimbledon-R32-Barbora_Strycova-Kiki_Bertens,2,S-IO,1,0,0,0,0,1,0
20180407-W-ITF_Kashiwa-SF-Destanee_Aiava-Bianca_Andreescu,1,F-XC,13,3,0,1,2,3,10
20180407-W-ITF_Kashiwa-SF-Destanee_Aiava-Bianca_Andreescu,1,F-DTM,8,1,0,0,1,2,6
20180407-W-ITF_Kashiwa-SF-Destanee_Aiava-Bianca_Andreescu,1,F-DTL,7,4,2,0,2,3,4
20180407-W-ITF_Kashiwa-SF-Destanee_Aiava-Bianca_Andreescu,1,F-IO,12,5,0,2,3,5,7
20180407-W-ITF_Kashiwa-SF-Destanee_Aiava-Bianca_Andreescu,1,F-II,1,1,0,1,0,1,0
20180407-W-ITF_Kashiwa-SF-Destanee_Aiava-Bianca_Andreescu,1,B-XC,19,6,0,1,5,5,14
20180407-W-ITF_Kashiwa-SF-Destanee_Aiava-Bianca_Andreescu,1,B-DTM,16,2,0,0,2,9,7
20180407-W-ITF_Kashiwa-SF-Destanee_Aiava-Bianca_Andreescu,1,B-DTL,5,2,0,0,2,0,5
20180407-W-ITF_Kashiwa-SF-Destanee_Aiava-Bianca_Andreescu,1,B-IO,3,2,1,0,1,1,2
20180407-W-ITF_Kashiwa-SF-Destanee_Aiava-Bianca_Andreescu,1,S-XC,1,1,0,0,1,0,1
20180407-W-ITF_Kashiwa-SF-Destanee_Aiava-Bianca_Andreescu,1,S-DTM,1,0,0,0,0,1,0
20180407-W-ITF_Kashiwa-SF-Destanee_Aiava-Bianca_Andreescu,2,F-XC,20,9,4,1,4,14,6
20180407-W-ITF_Kashiwa-SF-Destanee_Aiava-Bianca_Andreescu,2,F-DTM,15,1,1,0,0,8,7
20180407-W-ITF_Kashiwa-SF-Destanee_Aiava-Bianca_Andreescu,2,F-DTL,7,4,2,2,0,7,0
20180407-W-ITF_Kashiwa-SF-Destanee_Aiava-Bianca_Andreescu,2,F-IO,7,1,0,1,0,4,3
20180407-W-ITF_Kashiwa-SF-Destanee_Aiava-Bianca_Andreescu,2,F-II,3,2,1,1,0,3,0
20180407-W-ITF_Kashiwa-SF-Destanee_Aiava-Bianca_Andreescu,2,B-XC,13,2,0,1,1,7,6
20180407-W-ITF_Kashiwa-SF-Destanee_Aiava-Bianca_Andreescu,2,B-DTM,15,2,0,1,1,8,7
20180407-W-ITF_Kashiwa-SF-Destanee_Aiava-Bianca_Andreescu,2,B-DTL,3,2,0,1,1,2,1
20180407-W-ITF_Kashiwa-SF-Destanee_Aiava-Bianca_Andreescu,2,B-IO,2,0,0,0,0,1,1
20180407-W-ITF_Kashiwa-SF-Destanee_Aiava-Bianca_Andreescu,2,S-XC,2,0,0,0,0,2,0
20180407-W-ITF_Kashiwa-SF-Destanee_Aiava-Bianca_Andreescu,2,S-DTM,1,0,0,0,0,1,0
20180407-W-ITF_Kashiwa-SF-Destanee_Aiava-Bianca_Andreescu,2,S-DTL,1,0,0,0,0,1,0
20190706-W-Wimbledon-R32-Sloane_Stephens-Johanna_Konta,1,F-XC,34,10,7,1,2,16,18
20190706-W-Wimbledon-R32-Sloane_Stephens-Johanna_Konta,1,F-DTM,43,6,0,0,6,22,21
20190706-W-Wimbledon-R32-Sloane_Stephens-Johanna_Konta,1,F-DTL,8,5,2,0,3,5,3
20190706-W-Wimbledon-R32-Sloane_Stephens-Johanna_Konta,1,F-IO,18,9,5,2,2,13,5
20190706-W-Wimbledon-R32-Sloane_Stephens-Johanna_Konta,1,B-XC,25,6,2,1,3,17,8
20190706-W-Wimbledon-R32-Sloane_Stephens-Johanna_Konta,1,B-DTM,39,5,0,2,3,14,25
20190706-W-Wimbledon-R32-Sloane_Stephens-Johanna_Konta,1,B-DTL,9,5,2,1,2,4,5
20190706-W-Wimbledon-R32-Sloane_Stephens-Johanna_Konta,1,B-IO,3,2,1,1,0,3,0
20190706-W-Wimbledon-R32-Sloane_Stephens-Johanna_Konta,1,S-XC,9,0,0,0,0,6,3
20190706-W-Wimbledon-R32-Sloane_Stephens-Johanna_Konta,1,S-DTM,5,1,0,0,1,1,4
20190706-W-Wimbledon-R32-Sloane_Stephens-Johanna_Konta,1,S-DTL,2,1,1,0,0,2,0
20190706-W-Wimbledon-R32-Sloane_Stephens-Johanna_Konta,1,S-IO,5,1,0,0,1,3,2
20190706-W-Wimbledon-R32-Sloane_Stephens-Johanna_Konta,2,F-XC,55,16,4,7,5,39,16
20190706-W-Wimbledon-R32-Sloane_Stephens-Johanna_Konta,2,F-DTM,24,3,0,0,3,9,15
20190706-W-Wimbledon-R32-Sloane_Stephens-Johanna_Konta,2,F-DTL,10,5,2,1,2,6,4
20190706-W-Wimbledon-R32-Sloane_Stephens-Johanna_Konta,2,F-IO,19,2,1,1,0,10,9
20190706-W-Wimbledon-R32-Sloane_Stephens-Johanna_Konta,2,B-XC,29,4,0,2,2,17,12
20190706-W-Wimbledon-R32-Sloane_Stephens-Johanna_Konta,2,B-DTM,31,2,0,1,1,12,19
20190706-W-Wimbledon-R32-Sloane_Stephens-Johanna_Konta,2,B-DTL,10,9,2,0,7,2,8
20190706-W-Wimbledon-R32-Sloane_Stephens-Johanna_Konta,2,B-IO,3,1,0,1,0,1,2
20190706-W-Wimbledon-R32-Sloane_Stephens-Johanna_Konta,2,S-XC,6,1,0,0,1,2,4
20190706-W-Wimbledon-R32-Sloane_Stephens-Johanna_Konta,2,S-DTM,11,3,0,0,3,2,9
20190706-W-Wimbledon-R32-Sloane_Stephens-Johanna_Konta,2,S-DTL,4,3,1,0,2,1,3
20190702-W-Wimbledon-R128-Tamara_Zidansek-Eugenie_Bouchard,1,F-XC,50,17,9,5,3,33,17
20190702-W-Wimbledon-R128-Tamara_Zidansek-Eugenie_Bouchard,1,F-DTM,30,3,1,1,1,19,11
20190702-W-Wimbledon-R128-Tamara_Zidansek-Eugenie_Bouchard,1,F-DTL,23,11,4,2,5,13,10
20190702-W-Wimbledon-R128-Tamara_Zidansek-Eugenie_Bouchard,1,F-IO,21,12,3,2,7,9,12
20190702-W-Wimbledon-R128-Tamara_Zidansek-Eugenie_Bouchard,1,F-II,5,3,1,0,2,3,2
20190702-W-Wimbledon-R128-Tamara_Zidansek-Eugenie_Bouchard,1,B-XC,27,4,0,1,3,12,15
20190702-W-Wimbledon-R128-Tamara_Zidansek-Eugenie_Bouchard,1,B-DTM,26,0,0,0,0,16,10
20190702-W-Wimbledon-R128-Tamara_Zidansek-Eugenie_Bouchard,1,B-DTL,13,6,3,0,3,8,5
20190702-W-Wimbledon-R128-Tamara_Zidansek-Eugenie_Bouchard,1,B-IO,1,0,0,0,0,1,0
20190702-W-Wimbledon-R128-Tamara_Zidansek-Eugenie_Bouchard,1,S-XC,14,3,0,1,2,5,9
20190702-W-Wimbledon-R128-Tamara_Zidansek-Eugenie_Bouchard,1,S-DTM,8,1,0,0,1,2,6
20190702-W-Wimbledon-R128-Tamara_Zidansek-Eugenie_Bouchard,1,S-DTL,3,1,1,0,0,3,0
20190702-W-Wimbledon-R128-Tamara_Zidansek-Eugenie_Bouchard,1,S-IO,1,0,0,0,0,0,1
20190702-W-Wimbledon-R128-Tamara_Zidansek-Eugenie_Bouchard,2,F-XC,70,22,3,4,15,25,45
20190702-W-Wimbledon-R128-Tamara_Zidansek-Eugenie_Bouchard,2,F-DTM,10,2,0,1,1,5,5
20190702-W-Wimbledon-R128-Tamara_Zidansek-Eugenie_Bouchard,2,F-DTL,13,2,0,1,1,4,9
20190702-W-Wimbledon-R128-Tamara_Zidansek-Eugenie_Bouchard,2,F-IO,23,5,0,1,4,15,8
20190702-W-Wimbledon-R128-Tamara_Zidansek-Eugenie_Bouchard,2,F-II,3,1,0,0,1,0,3
20190702-W-Wimbledon-R128-Tamara_Zidansek-Eugenie_Bouchard,2,B-XC,55,13,0,6,7,26,29
20190702-W-Wimbledon-R128-Tamara_Zidansek-Eugenie_Bouchard,2,B-DTM,24,1,0,0,1,8,16
20190702-W-Wimbledon-R128-Tamara_Zidansek-Eugenie_Bouchard,2,B-DTL,10,4,2,1,1,4,6
20190702-W-Wimbledon-R128-Tamara_Zidansek-Eugenie_Bouchard,2,B-IO,5,2,1,1,0,4,1
20190702-W-Wimbledon-R128-Tamara_Zidansek-Eugenie_Bouchard,2,S-XC,2,1,0,1,0,1,1
20190702-W-Wimbledon-R128-Tamara_Zidansek-Eugenie_Bouchard,2,S-DTL,1,0,0,0,0,1,0
20190706-W-Wimbledon-R32-Serena_Williams-Julia_Goerges,1,F-XC,19,13,7,2,4,12,7
20190706-W-Wimbledon-R32-Serena_Williams-Julia_Goerges,1,F-DTM,3,0,0,0,0,2,1
20190706-W-Wimbledon-R32-Serena_Williams-Julia_Goerges,1,F-DTL,6,1,1,0,0,4,2
20190706-W-Wimbledon-R32-Serena_Williams-Julia_Goerges,1,F-IO,8,4,2,0,2,5,3
20190706-W-Wimbledon-R32-Serena_Williams-Julia_Goerges,1,B-XC,7,4,0,2,2,3,4
20190706-W-Wimbledon-R32-Serena_Williams-Julia_Goerges,1,B-DTM,3,0,0,0,0,1,2
20190706-W-Wimbledon-R32-Serena_Williams-Julia_Goerges,1,B-DTL,4,3,0,2,1,3,1
20190706-W-Wimbledon-R32-Serena_Williams-Julia_Goerges,1,B-IO,1,0,0,0,0,0,1
20190706-W-Wimbledon-R32-Serena_Williams-Julia_Goerges,2,F-XC,11,6,2,1,3,6,5
20190706-W-Wimbledon-R32-Serena_Williams-Julia_Goerges,2,F-DTM,3,1,0,1,0,1,2
20190706-W-Wimbledon-R32-Serena_Williams-Julia_Goerges,2,F-DTL,5,4,1,2,1,4,1
20190706-W-Wimbledon-R32-Serena_Williams-Julia_Goerges,2,F-IO,8,4,2,1,1,3,5
20190706-W-Wimbledon-R32-Serena_Williams-Julia_Goerges,2,F-II,1,0,0,0,0,1,0
20190706-W-Wimbledon-R32-Serena_Williams-Julia_Goerges,2,B-XC,5,1,1,0,0,2,3
20190706-W-Wimbledon-R32-Serena_Williams-Julia_Goerges,2,B-DTM,5,2,0,0,2,2,3
20190706-W-Wimbledon-R32-Serena_Williams-Julia_Goerges,2,B-DTL,10,4,0,1,3,4,6
20190706-W-Wimbledon-R32-Serena_Williams-Julia_Goerges,2,S-XC,2,1,0,0,1,0,2
20190704-W-Wimbledon-R64-Kaja_Juvan-Serena_Williams,1,F-XC,22,11,2,5,4,13,9
20190704-W-Wimbledon-R64-Kaja_Juvan-Serena_Williams,1,F-DTM,7,0,0,0,0,4,3
20190704-W-Wimbledon-R64-Kaja_Juvan-Serena_Williams,1,F-DTL,13,4,1,1,2,6,7
20190704-W-Wimbledon-R64-Kaja_Juvan-Serena_Williams,1,F-IO,7,3,0,1,2,4,3
20190704-W-Wimbledon-R64-Kaja_Juvan-Serena_Williams,1,F-II,2,1,0,1,0,2,0
20190704-W-Wimbledon-R64-Kaja_Juvan-Serena_Williams,1,B-XC,12,4,1,1,2,5,7
20190704-W-Wimbledon-R64-Kaja_Juvan-Serena_Williams,1,B-DTM,8,2,0,1,1,4,4
20190704-W-Wimbledon-R64-Kaja_Juvan-Serena_Williams,1,B-DTL,8,3,0,1,2,4,4
20190704-W-Wimbledon-R64-Kaja_Juvan-Serena_Williams,1,B-IO,3,2,0,1,1,2,1
20190704-W-Wimbledon-R64-Kaja_Juvan-Serena_Williams,1,S-XC,3,0,0,0,0,2,1
20190704-W-Wimbledon-R64-Kaja_Juvan-Serena_Williams,1,S-DTM,1,1,0,0,1,0,1
20190704-W-Wimbledon-R64-Kaja_Juvan-Serena_Williams,1,S-DTL,4,1,1,0,0,2,2
20190704-W-Wimbledon-R64-Kaja_Juvan-Serena_Williams,1,S-IO,1,0,0,0,0,1,0
20190704-W-Wimbledon-R64-Kaja_Juvan-Serena_Williams,2,F-XC,31,11,4,3,4,16,15
20190704-W-Wimbledon-R64-Kaja_Juvan-Serena_Williams,2,F-DTM,8,1,0,0,1,2,6
20190704-W-Wimbledon-R64-Kaja_Juvan-Serena_Williams,2,F-DTL,11,7,0,4,3,6,5
20190704-W-Wimbledon-R64-Kaja_Juvan-Serena_Williams,2,F-IO,10,3,1,1,1,7,3
20190704-W-Wimbledon-R64-Kaja_Juvan-Serena_Williams,2,B-XC,16,5,1,1,3,10,6
20190704-W-Wimbledon-R64-Kaja_Juvan-Serena_Williams,2,B-DTM,8,2,0,0,2,1,7
20190704-W-Wimbledon-R64-Kaja_Juvan-Serena_Williams,2,B-DTL,11,5,2,2,1,8,3
20190704-W-Wimbledon-R64-Kaja_Juvan-Serena_Williams,2,B-IO,2,0,0,0,0,0,2
20190704-W-Wimbledon-R64-Kaja_Juvan-Serena_Williams,2,S-XC,1,0,0,0,0,0,1
20190704-W-Wimbledon-R64-Kaja_Juvan-Serena_Williams,2,S-DTM,1,0,0,0,0,0,1
20190712-W-Wimbledon_Juniors-SF-Emma_Navarro-Daria_Snigur,1,F-XC,27,6,5,1,0,16,11
20190712-W-Wimbledon_Juniors-SF-Emma_Navarro-Daria_Snigur,1,F-DTM,10,1,0,1,0,3,7
20190712-W-Wimbledon_Juniors-SF-Emma_Navarro-Daria_Snigur,1,F-DTL,9,2,0,1,1,5,4
20190712-W-Wimbledon_Juniors-SF-Emma_Navarro-Daria_Snigur,1,F-IO,9,2,1,0,1,3,6
20190712-W-Wimbledon_Juniors-SF-Emma_Navarro-Daria_Snigur,1,F-II,1,1,0,1,0,1,0
20190712-W-Wimbledon_Juniors-SF-Emma_Navarro-Daria_Snigur,1,B-XC,18,3,1,0,2,1,17
20190712-W-Wimbledon_Juniors-SF-Emma_Navarro-Daria_Snigur,1,B-DTM,13,0,0,0,0,3,10
20190712-W-Wimbledon_Juniors-SF-Emma_Navarro-Daria_Snigur,1,B-DTL,11,6,2,0,4,4,7
20190712-W-Wimbledon_Juniors-SF-Emma_Navarro-Daria_Snigur,1,S-XC,13,4,0,0,4,2,11
20190712-W-Wimbledon_Juniors-SF-Emma_Navarro-Daria_Snigur,1,S-DTM,10,0,0,0,0,2,8
20190712-W-Wimbledon_Juniors-SF-Emma_Navarro-Daria_Snigur,1,S-DTL,1,0,0,0,0,0,1
20190712-W-Wimbledon_Juniors-SF-Emma_Navarro-Daria_Snigur,2,F-XC,22,8,4,1,3,13,9
20190712-W-Wimbledon_Juniors-SF-Emma_Navarro-Daria_Snigur,2,F-DTM,6,0,0,0,0,3,3
20190712-W-Wimbledon_Juniors-SF-Emma_Navarro-Daria_Snigur,2,F-DTL,13,4,0,1,3,7,6
20190712-W-Wimbledon_Juniors-SF-Emma_Navarro-Daria_Snigur,2,F-IO,5,0,0,0,0,3,2
20190712-W-Wimbledon_Juniors-SF-Emma_Navarro-Daria_Snigur,2,B-XC,47,12,4,6,2,41,6
20190712-W-Wimbledon_Juniors-SF-Emma_Navarro-Daria_Snigur,2,B-DTM,13,1,0,0,1,7,6
20190712-W-Wimbledon_Juniors-SF-Emma_Navarro-Daria_Snigur,2,B-DTL,12,5,4,1,0,10,2
20190712-W-Wimbledon_Juniors-SF-Emma_Navarro-Daria_Snigur,2,B-IO,10,3,1,1,1,7,3
20190712-W-Wimbledon_Juniors-SF-Emma_Navarro-Daria_Snigur,2,S-DTM,1,0,0,0,0,0,1
20190703-W-Wimbledon-R64-Margarita_Gasparyan-Elina_Svitolina,1,F-XC,55,12,7,3,2,36,19
20190703-W-Wimbledon-R64-Margarita_Gasparyan-Elina_Svitolina,1,F-DTM,13,2,0,2,0,11,2
20190703-W-Wimbledon-R64-Margarita_Gasparyan-Elina_Svitolina,1,F-DTL,47,16,6,3,7,33,14
20190703-W-Wimbledon-R64-Margarita_Gasparyan-Elina_Svitolina,1,F-IO,35,6,4,1,1,25,10
20190703-W-Wimbledon-R64-Margarita_Gasparyan-Elina_Svitolina,1,F-II,2,2,1,0,1,1,1
20190703-W-Wimbledon-R64-Margarita_Gasparyan-Elina_Svitolina,1,B-XC,48,10,5,2,3,29,19
20190703-W-Wimbledon-R64-Margarita_Gasparyan-Elina_Svitolina,1,B-DTM,25,2,0,2,0,19,6
20190703-W-Wimbledon-R64-Margarita_Gasparyan-Elina_Svitolina,1,B-DTL,35,11,3,5,3,27,8
20190703-W-Wimbledon-R64-Margarita_Gasparyan-Elina_Svitolina,1,B-IO,20,3,1,0,2,11,9
20190703-W-Wimbledon-R64-Margarita_Gasparyan-Elina_Svitolina,1,S-XC,18,2,1,0,1,10,8
20190703-W-Wimbledon-R64-Margarita_Gasparyan-Elina_Svitolina,1,S-DTM,11,0,0,0,0,5,6
20190703-W-Wimbledon-R64-Margarita_Gasparyan-Elina_Svitolina,1,S-DTL,10,2,0,1,1,4,6
20190703-W-Wimbledon-R64-Margarita_Gasparyan-Elina_Svitolina,1,S-IO,1,0,0,0,0,1,0
20190703-W-Wimbledon-R64-Margarita_Gasparyan-Elina_Svitolina,2,F-XC,72,11,3,3,5,27,45
20190703-W-Wimbledon-R64-Margarita_Gasparyan-Elina_Svitolina,2,F-DTM,37,3,0,1,2,11,26
20190703-W-Wimbledon-R64-Margarita_Gasparyan-Elina_Svitolina,2,F-DTL,17,1,0,1,0,6,11
20190703-W-Wimbledon-R64-Margarita_Gasparyan-Elina_Svitolina,2,F-IO,26,4,0,4,0,11,15
20190703-W-Wimbledon-R64-Margarita_Gasparyan-Elina_Svitolina,2,B-XC,87,7,1,5,1,31,56
20190703-W-Wimbledon-R64-Margarita_Gasparyan-Elina_Svitolina,2,B-DTM,26,0,0,0,0,9,17
20190703-W-Wimbledon-R64-Margarita_Gasparyan-Elina_Svitolina,2,B-DTL,9,2,1,1,0,5,4
20190703-W-Wimbledon-R64-Margarita_Gasparyan-Elina_Svitolina,2,B-IO,4,1,0,0,1,0,4
20190703-W-Wimbledon-R64-Margarita_Gasparyan-Elina_Svitolina,2,S-XC,20,3,0,1,2,11,9
20190703-W-Wimbledon-R64-Margarita_Gasparyan-Elina_Svitolina,2,S-DTM,3,0,0,0,0,0,3
20190703-W-Wimbledon-R64-Margarita_Gasparyan-Elina_Svitolina,2,S-DTL,1,0,0,0,0,0,1
20190114-W-Australian_Open-R128-Kiki_Bertens-Alison_Riske,1,F-XC,25,8,1,2,5,11,14
20190114-W-Australian_Open-R128-Kiki_Bertens-Alison_Riske,1,F-DTM,22,5,0,1,4,10,12
20190114-W-Australian_Open-R128-Kiki_Bertens-Alison_Riske,1,F-DTL,10,2,1,0,1,5,5
20190114-W-Australian_Open-R128-Kiki_Bertens-Alison_Riske,1,F-IO,9,5,2,0,3,4,5
20190114-W-Australian_Open-R128-Kiki_Bertens-Alison_Riske,1,B-XC,7,0,0,0,0,5,2
20190114-W-Australian_Open-R128-Kiki_Bertens-Alison_Riske,1,B-DTM,19,1,0,0,1,8,11
20190114-W-Australian_Open-R128-Kiki_Bertens-Alison_Riske,1,B-DTL,3,1,0,1,0,2,1
20190114-W-Australian_Open-R128-Kiki_Bertens-Alison_Riske,1,B-IO,6,4,2,0,2,2,4
20190114-W-Australian_Open-R128-Kiki_Bertens-Alison_Riske,1,S-XC,2,0,0,0,0,1,1
20190114-W-Australian_Open-R128-Kiki_Bertens-Alison_Riske,1,S-DTM,8,0,0,0,0,3,5
20190114-W-Australian_Open-R128-Kiki_Bertens-Alison_Riske,1,S-DTL,1,0,0,0,0,0,1
20190114-W-Australian_Open-R128-Kiki_Bertens-Alison_Riske,2,F-XC,22,5,2,2,1,18,4
20190114-W-Australian_Open-R128-Kiki_Bertens-Alison_Riske,2,F-DTM,24,5,1,0,4,13,11
20190114-W-Australian_Open-R128-Kiki_Bertens-Alison_Riske,2,F-DTL,4,2,0,1,1,1,3
20190114-W-Australian_Open-R128-Kiki_Bertens-Alison_Riske,2,F-IO,14,4,1,1,2,9,5
20190114-W-Australian_Open-R128-Kiki_Bertens-Alison_Riske,2,B-XC,13,3,1,0,2,5,8
20190114-W-Australian_Open-R128-Kiki_Bertens-Alison_Riske,2,B-DTM,20,1,0,0,1,9,11
20190114-W-Australian_Open-R128-Kiki_Bertens-Alison_Riske,2,B-DTL,5,2,0,1,1,2,3
20190114-W-Australian_Open-R128-Kiki_Bertens-Alison_Riske,2,B-IO,10,4,0,1,3,3,7
20190114-W-Australian_Open-R128-Kiki_Bertens-Alison_Riske,2,S-XC,1,0,0,0,0,1,0
20190716-W-Bucharest-R32-Anna_Bondar-Patricia_Maria_Tig,1,F-XC,20,4,1,1,2,8,12
20190716-W-Bucharest-R32-Anna_Bondar-Patricia_Maria_Tig,1,F-DTM,22,4,0,1,3,9,13
20190716-W-Bucharest-R32-Anna_Bondar-Patricia_Maria_Tig,1,F-DTL,6,3,0,0,3,1,5
20190716-W-Bucharest-R32-Anna_Bondar-Patricia_Maria_Tig,1,F-IO,21,5,2,1,2,9,12
20190716-W-Bucharest-R32-Anna_Bondar-Patricia_Maria_Tig,1,F-II,2,2,2,0,0,2,0
20190716-W-Bucharest-R32-Anna_Bondar-Patricia_Maria_Tig,1,B-XC,23,4,1,1,2,6,17
20190716-W-Bucharest-R32-Anna_Bondar-Patricia_Maria_Tig,1,B-DTM,23,3,0,1,2,6,17
20190716-W-Bucharest-R32-Anna_Bondar-Patricia_Maria_Tig,1,B-DTL,2,1,0,0,1,0,2
20190716-W-Bucharest-R32-Anna_Bondar-Patricia_Maria_Tig,1,B-IO,2,0,0,0,0,0,2
20190716-W-Bucharest-R32-Anna_Bondar-Patricia_Maria_Tig,1,S-XC,1,0,0,0,0,0,1
20190716-W-Bucharest-R32-Anna_Bondar-Patricia_Maria_Tig,2,F-XC,26,8,3,4,1,19,7
20190716-W-Bucharest-R32-Anna_Bondar-Patricia_Maria_Tig,2,F-DTM,12,1,0,0,1,8,4
20190716-W-Bucharest-R32-Anna_Bondar-Patricia_Maria_Tig,2,F-DTL,4,4,2,0,2,2,2
20190716-W-Bucharest-R32-Anna_Bondar-Patricia_Maria_Tig,2,F-IO,15,10,6,2,2,11,4
20190716-W-Bucharest-R32-Anna_Bondar-Patricia_Maria_Tig,2,B-XC,21,4,2,0,2,15,6
20190716-W-Bucharest-R32-Anna_Bondar-Patricia_Maria_Tig,2,B-DTM,22,1,0,0,1,17,5
20190716-W-Bucharest-R32-Anna_Bondar-Patricia_Maria_Tig,2,B-DTL,3,1,1,0,0,2,1
20190716-W-Bucharest-R32-Anna_Bondar-Patricia_Maria_Tig,2,B-IO,3,1,1,0,0,1,2
20190716-W-Bucharest-R32-Anna_Bondar-Patricia_Maria_Tig,2,S-XC,4,0,0,0,0,2,2
20190716-W-Bucharest-R32-Anna_Bondar-Patricia_Maria_Tig,2,S-DTM,2,0,0,0,0,0,2
20190716-W-Bucharest-R32-Anna_Bondar-Patricia_Maria_Tig,2,S-DTL,1,0,0,0,0,1,0
20190706-W-Wimbledon-R32-Petra_Kvitova-Magda_Linette,1,F-XC,12,5,0,3,2,6,6
20190706-W-Wimbledon-R32-Petra_Kvitova-Magda_Linette,1,F-DTM,10,1,0,1,0,5,5
20190706-W-Wimbledon-R32-Petra_Kvitova-Magda_Linette,1,F-DTL,4,4,3,0,1,3,1
20190706-W-Wimbledon-R32-Petra_Kvitova-Magda_Linette,1,F-IO,7,6,2,1,3,3,4
20190706-W-Wimbledon-R32-Petra_Kvitova-Magda_Linette,1,F-II,3,2,1,1,0,2,1
20190706-W-Wimbledon-R32-Petra_Kvitova-Magda_Linette,1,B-XC,17,6,4,0,2,9,8
20190706-W-Wimbledon-R32-Petra_Kvitova-Magda_Linette,1,B-DTM,10,2,0,2,0,4,6
20190706-W-Wimbledon-R32-Petra_Kvitova-Magda_Linette,1,B-DTL,5,3,2,1,0,4,1
20190706-W-Wimbledon-R32-Petra_Kvitova-Magda_Linette,1,B-IO,3,1,1,0,0,3,0
20190706-W-Wimbledon-R32-Petra_Kvitova-Magda_Linette,1,S-XC,2,0,0,0,0,1,1
20190706-W-Wimbledon-R32-Petra_Kvitova-Magda_Linette,2,F-XC,24,2,1,0,1,12,12
20190706-W-Wimbledon-R32-Petra_Kvitova-Magda_Linette,2,F-DTM,8,0,0,0,0,4,4
20190706-W-Wimbledon-R32-Petra_Kvitova-Magda_Linette,2,F-DTL,4,4,3,1,0,4,0
20190706-W-Wimbledon-R32-Petra_Kvitova-Magda_Linette,2,F-IO,4,2,1,0,1,1,3
20190706-W-Wimbledon-R32-Petra_Kvitova-Magda_Linette,2,B-XC,12,4,1,2,1,7,5
20190706-W-Wimbledon-R32-Petra_Kvitova-Magda_Linette,2,B-DTM,9,0,0,0,0,5,4
20190706-W-Wimbledon-R32-Petra_Kvitova-Magda_Linette,2,B-DTL,2,2,2,0,0,2,0
20190706-W-Wimbledon-R32-Petra_Kvitova-Magda_Linette,2,B-IO,2,0,0,0,0,2,0
20190706-W-Wimbledon-R32-Petra_Kvitova-Magda_Linette,2,S-XC,1,1,0,0,1,0,1
20190706-W-Wimbledon-R32-Petra_Kvitova-Magda_Linette,2,S-IO,1,0,0,0,0,1,0
20190705-W-Wimbledon-R64-Karolina_Pliskova-Monica_Puig,1,F-XC,16,4,2,2,0,11,5
20190705-W-Wimbledon-R64-Karolina_Pliskova-Monica_Puig,1,F-DTM,7,0,0,0,0,4,3
20190705-W-Wimbledon-R64-Karolina_Pliskova-Monica_Puig,1,F-DTL,5,5,2,1,2,3,2
20190705-W-Wimbledon-R64-Karolina_Pliskova-Monica_Puig,1,F-IO,4,4,1,1,2,2,2
20190705-W-Wimbledon-R64-Karolina_Pliskova-Monica_Puig,1,F-II,1,1,1,0,0,1,0
20190705-W-Wimbledon-R64-Karolina_Pliskova-Monica_Puig,1,B-XC,8,0,0,0,0,3,5
20190705-W-Wimbledon-R64-Karolina_Pliskova-Monica_Puig,1,B-DTM,12,1,0,0,1,6,6
20190705-W-Wimbledon-R64-Karolina_Pliskova-Monica_Puig,1,B-DTL,3,2,0,2,0,2,1
20190705-W-Wimbledon-R64-Karolina_Pliskova-Monica_Puig,1,B-IO,2,0,0,0,0,0,2
20190705-W-Wimbledon-R64-Karolina_Pliskova-Monica_Puig,1,S-XC,4,0,0,0,0,1,3
20190705-W-Wimbledon-R64-Karolina_Pliskova-Monica_Puig,1,S-DTM,1,0,0,0,0,0,1
20190705-W-Wimbledon-R64-Karolina_Pliskova-Monica_Puig,2,F-XC,18,4,2,0,2,8,10
20190705-W-Wimbledon-R64-Karolina_Pliskova-Monica_Puig,2,F-DTM,10,3,0,0,3,5,5
20190705-W-Wimbledon-R64-Karolina_Pliskova-Monica_Puig,2,F-DTL,12,7,0,5,2,8,4
20190705-W-Wimbledon-R64-Karolina_Pliskova-Monica_Puig,2,F-IO,9,3,0,0,3,4,5
20190705-W-Wimbledon-R64-Karolina_Pliskova-Monica_Puig,2,F-II,1,0,0,0,0,0,1
20190705-W-Wimbledon-R64-Karolina_Pliskova-Monica_Puig,2,B-XC,10,1,1,0,0,6,4
20190705-W-Wimbledon-R64-Karolina_Pliskova-Monica_Puig,2,B-DTM,11,4,0,1,2,6,5
20190705-W-Wimbledon-R64-Karolina_Pliskova-Monica_Puig,2,B-DTL,6,3,1,1,1,3,3
20190705-W-Wimbledon-R64-Karolina_Pliskova-Monica_Puig,2,B-IO,6,5,1,2,2,4,2
20190705-W-Wimbledon-R64-Karolina_Pliskova-Monica_Puig,2,S-DTM,1,0,0,0,0,1,0
20190720-W-Bucharest-SF-Elena_Rybakina-Martina_Di_Giuseppe,1,F-XC,15,7,3,4,0,12,3
20190720-W-Bucharest-SF-Elena_Rybakina-Martina_Di_Giuseppe,1,F-DTM,9,1,0,0,1,5,4
20190720-W-Bucharest-SF-Elena_Rybakina-Martina_Di_Giuseppe,1,F-DTL,4,3,1,0,2,2,2
20190720-W-Bucharest-SF-Elena_Rybakina-Martina_Di_Giuseppe,1,F-IO,5,3,3,0,0,5,0
20190720-W-Bucharest-SF-Elena_Rybakina-Martina_Di_Giuseppe,1,B-XC,16,5,2,2,1,14,2
20190720-W-Bucharest-SF-Elena_Rybakina-Martina_Di_Giuseppe,1,B-DTM,6,0,0,0,0,2,4
20190720-W-Bucharest-SF-Elena_Rybakina-Martina_Di_Giuseppe,1,B-DTL,4,2,0,0,2,1,3
20190720-W-Bucharest-SF-Elena_Rybakina-Martina_Di_Giuseppe,1,B-IO,2,1,1,0,0,1,1
20190720-W-Bucharest-SF-Elena_Rybakina-Martina_Di_Giuseppe,1,S-DTL,1,0,0,0,0,1,0
20190720-W-Bucharest-SF-Elena_Rybakina-Martina_Di_Giuseppe,1,S-IO,1,0,0,0,0,0,1
20190720-W-Bucharest-SF-Elena_Rybakina-Martina_Di_Giuseppe,2,F-XC,12,6,4,1,1,10,2
20190720-W-Bucharest-SF-Elena_Rybakina-Martina_Di_Giuseppe,2,F-DTM,14,1,0,0,1,4,10
20190720-W-Bucharest-SF-Elena_Rybakina-Martina_Di_Giuseppe,2,F-DTL,8,6,2,0,4,2,6
20190720-W-Bucharest-SF-Elena_Rybakina-Martina_Di_Giuseppe,2,F-IO,9,5,3,0,2,5,4
20190720-W-Bucharest-SF-Elena_Rybakina-Martina_Di_Giuseppe,2,F-II,1,0,0,0,0,1,0
20190720-W-Bucharest-SF-Elena_Rybakina-Martina_Di_Giuseppe,2,B-XC,1,0,0,0,0,0,1
20190720-W-Bucharest-SF-Elena_Rybakina-Martina_Di_Giuseppe,2,B-DTM,1,0,0,0,0,0,1
20190720-W-Bucharest-SF-Elena_Rybakina-Martina_Di_Giuseppe,2,B-IO,1,0,0,0,0,0,1
20190720-W-Bucharest-SF-Elena_Rybakina-Martina_Di_Giuseppe,2,S-XC,5,0,0,0,0,2,3
20190720-W-Bucharest-SF-Elena_Rybakina-Martina_Di_Giuseppe,2,S-DTM,6,1,0,0,1,1,5
20190720-W-Bucharest-SF-Elena_Rybakina-Martina_Di_Giuseppe,2,S-DTL,1,0,0,0,0,0,1
20190720-W-Bucharest-SF-Elena_Rybakina-Martina_Di_Giuseppe,2,S-IO,1,0,0,0,0,0,1
20190715-W-Bucharest-R32-Laura_Siegemund-Anhelina_Kalinina,1,F-XC,32,9,0,2,7,13,19
20190715-W-Bucharest-R32-Laura_Siegemund-Anhelina_Kalinina,1,F-DTM,21,1,0,0,1,10,11
20190715-W-Bucharest-R32-Laura_Siegemund-Anhelina_Kalinina,1,F-DTL,23,8,3,2,3,12,11
20190715-W-Bucharest-R32-Laura_Siegemund-Anhelina_Kalinina,1,F-IO,23,9,3,4,2,18,5
20190715-W-Bucharest-R32-Laura_Siegemund-Anhelina_Kalinina,1,B-XC,47,10,3,3,4,24,23
20190715-W-Bucharest-R32-Laura_Siegemund-Anhelina_Kalinina,1,B-DTM,31,1,0,1,0,17,14
20190715-W-Bucharest-R32-Laura_Siegemund-Anhelina_Kalinina,1,B-DTL,24,17,7,5,5,16,8
20190715-W-Bucharest-R32-Laura_Siegemund-Anhelina_Kalinina,1,B-IO,9,1,0,0,1,4,5
20190715-W-Bucharest-R32-Laura_Siegemund-Anhelina_Kalinina,1,S-XC,17,2,0,0,2,7,10
20190715-W-Bucharest-R32-Laura_Siegemund-Anhelina_Kalinina,1,S-DTM,9,0,0,0,0,2,7
20190715-W-Bucharest-R32-Laura_Siegemund-Anhelina_Kalinina,1,S-DTL,1,0,0,0,0,0,1
20190715-W-Bucharest-R32-Laura_Siegemund-Anhelina_Kalinina,2,F-XC,66,15,6,4,5,40,26
20190715-W-Bucharest-R32-Laura_Siegemund-Anhelina_Kalinina,2,F-DTM,15,0,0,0,0,7,8
20190715-W-Bucharest-R32-Laura_Siegemund-Anhelina_Kalinina,2,F-DTL,7,3,0,2,1,5,2
20190715-W-Bucharest-R32-Laura_Siegemund-Anhelina_Kalinina,2,F-IO,11,0,0,0,0,6,5
20190715-W-Bucharest-R32-Laura_Siegemund-Anhelina_Kalinina,2,F-II,6,1,0,1,0,5,1
20190715-W-Bucharest-R32-Laura_Siegemund-Anhelina_Kalinina,2,B-XC,86,18,0,6,12,37,49
20190715-W-Bucharest-R32-Laura_Siegemund-Anhelina_Kalinina,2,B-DTM,33,3,0,0,3,10,23
20190715-W-Bucharest-R32-Laura_Siegemund-Anhelina_Kalinina,2,B-DTL,19,9,3,1,5,11,8
20190715-W-Bucharest-R32-Laura_Siegemund-Anhelina_Kalinina,2,B-IO,12,6,3,1,2,10,2
20190715-W-Bucharest-R32-Laura_Siegemund-Anhelina_Kalinina,2,S-XC,2,1,1,0,0,1,1
20190715-W-Bucharest-R32-Laura_Siegemund-Anhelina_Kalinina,2,S-DTM,4,2,0,1,1,2,2
20190715-W-Bucharest-R32-Laura_Siegemund-Anhelina_Kalinina,2,S-DTL,1,0,0,0,0,0,1
20190719-W-Bucharest-QF-Patricia_Maria_Tig-Kristyna_Pliskova,1,F-XC,36,7,4,0,3,20,16
20190719-W-Bucharest-QF-Patricia_Maria_Tig-Kristyna_Pliskova,1,F-DTM,14,3,1,0,2,6,8
20190719-W-Bucharest-QF-Patricia_Maria_Tig-Kristyna_Pliskova,1,F-DTL,4,3,1,0,2,1,3
20190719-W-Bucharest-QF-Patricia_Maria_Tig-Kristyna_Pliskova,1,F-IO,12,7,5,2,0,11,1
20190719-W-Bucharest-QF-Patricia_Maria_Tig-Kristyna_Pliskova,1,F-II,1,1,1,0,0,1,0
20190719-W-Bucharest-QF-Patricia_Maria_Tig-Kristyna_Pliskova,1,B-XC,18,4,3,0,1,12,6
20190719-W-Bucharest-QF-Patricia_Maria_Tig-Kristyna_Pliskova,1,B-DTM,20,5,0,0,5,10,10
20190719-W-Bucharest-QF-Patricia_Maria_Tig-Kristyna_Pliskova,1,B-DTL,4,2,2,0,0,3,1
20190719-W-Bucharest-QF-Patricia_Maria_Tig-Kristyna_Pliskova,1,B-IO,4,4,2,0,2,2,2
20190719-W-Bucharest-QF-Patricia_Maria_Tig-Kristyna_Pliskova,1,S-DTM,2,0,0,0,0,2,0
20190719-W-Bucharest-QF-Patricia_Maria_Tig-Kristyna_Pliskova,1,S-DTL,1,0,0,0,0,1,0
20190719-W-Bucharest-QF-Patricia_Maria_Tig-Kristyna_Pliskova,2,F-XC,25,10,5,2,3,9,16
20190719-W-Bucharest-QF-Patricia_Maria_Tig-Kristyna_Pliskova,2,F-DTM,10,0,0,0,0,6,4
20190719-W-Bucharest-QF-Patricia_Maria_Tig-Kristyna_Pliskova,2,F-DTL,9,8,4,2,2,7,2
20190719-W-Bucharest-QF-Patricia_Maria_Tig-Kristyna_Pliskova,2,F-IO,12,9,1,1,7,2,10
20190719-W-Bucharest-QF-Patricia_Maria_Tig-Kristyna_Pliskova,2,B-XC,19,6,3,2,1,12,7
20190719-W-Bucharest-QF-Patricia_Maria_Tig-Kristyna_Pliskova,2,B-DTM,23,5,1,0,4,12,11
20190719-W-Bucharest-QF-Patricia_Maria_Tig-Kristyna_Pliskova,2,B-DTL,6,1,0,0,1,1,5
20190719-W-Bucharest-QF-Patricia_Maria_Tig-Kristyna_Pliskova,2,B-IO,7,3,1,0,2,3,4
20190719-W-Bucharest-QF-Patricia_Maria_Tig-Kristyna_Pliskova,2,S-XC,3,1,0,0,1,1,2
20190719-W-Bucharest-QF-Patricia_Maria_Tig-Kristyna_Pliskova,2,S-DTM,3,1,0,0,1,2,1
20190719-W-Bucharest-QF-Patricia_Maria_Tig-Kristyna_Pliskova,2,S-IO,2,0,0,0,0,1,1
20190720-W-Bucharest-SF-Patricia_Maria_Tig-Laura_Siegemund,1,F-XC,31,7,2,2,3,20,11
20190720-W-Bucharest-SF-Patricia_Maria_Tig-Laura_Siegemund,1,F-DTM,12,1,0,0,1,7,5
20190720-W-Bucharest-SF-Patricia_Maria_Tig-Laura_Siegemund,1,F-DTL,4,3,1,1,1,2,2
20190720-W-Bucharest-SF-Patricia_Maria_Tig-Laura_Siegemund,1,F-IO,13,4,1,1,2,7,6
20190720-W-Bucharest-SF-Patricia_Maria_Tig-Laura_Siegemund,1,B-XC,18,3,2,0,1,12,6
20190720-W-Bucharest-SF-Patricia_Maria_Tig-Laura_Siegemund,1,B-DTM,18,0,0,0,0,14,4
20190720-W-Bucharest-SF-Patricia_Maria_Tig-Laura_Siegemund,1,B-DTL,10,4,1,2,1,6,4
20190720-W-Bucharest-SF-Patricia_Maria_Tig-Laura_Siegemund,1,B-IO,4,2,1,1,0,4,0
20190720-W-Bucharest-SF-Patricia_Maria_Tig-Laura_Siegemund,1,S-XC,2,1,0,1,0,1,1
20190720-W-Bucharest-SF-Patricia_Maria_Tig-Laura_Siegemund,1,S-DTM,6,0,0,0,0,1,5
20190720-W-Bucharest-SF-Patricia_Maria_Tig-Laura_Siegemund,1,S-DTL,3,0,0,0,0,1,2
20190720-W-Bucharest-SF-Patricia_Maria_Tig-Laura_Siegemund,1,S-IO,1,1,0,1,0,1,0
20190720-W-Bucharest-SF-Patricia_Maria_Tig-Laura_Siegemund,2,F-XC,35,12,4,1,7,14,21
20190720-W-Bucharest-SF-Patricia_Maria_Tig-Laura_Siegemund,2,F-DTM,12,1,0,0,1,4,8
20190720-W-Bucharest-SF-Patricia_Maria_Tig-Laura_Siegemund,2,F-DTL,9,3,0,1,2,5,4
20190720-W-Bucharest-SF-Patricia_Maria_Tig-Laura_Siegemund,2,F-IO,14,3,1,0,2,8,6
20190720-W-Bucharest-SF-Patricia_Maria_Tig-Laura_Siegemund,2,B-XC,14,4,0,0,4,2,12
20190720-W-Bucharest-SF-Patricia_Maria_Tig-Laura_Siegemund,2,B-DTM,10,1,0,0,1,1,9
20190720-W-Bucharest-SF-Patricia_Maria_Tig-Laura_Siegemund,2,B-DTL,8,3,2,0,1,4,4
20190720-W-Bucharest-SF-Patricia_Maria_Tig-Laura_Siegemund,2,B-IO,3,2,0,0,2,0,3
20190720-W-Bucharest-SF-Patricia_Maria_Tig-Laura_Siegemund,2,S-XC,7,4,0,1,3,2,5
20190720-W-Bucharest-SF-Patricia_Maria_Tig-Laura_Siegemund,2,S-DTM,3,1,0,0,1,2,1
20190721-W-Bucharest-F-Patricia_Maria_Tig-Elena_Rybakina,1,F-XC,21,6,1,2,3,8,13
20190721-W-Bucharest-F-Patricia_Maria_Tig-Elena_Rybakina,1,F-DTM,13,1,0,0,1,6,7
20190721-W-Bucharest-F-Patricia_Maria_Tig-Elena_Rybakina,1,F-DTL,4,4,2,0,2,2,2
20190721-W-Bucharest-F-Patricia_Maria_Tig-Elena_Rybakina,1,F-IO,6,1,1,0,0,2,4
20190721-W-Bucharest-F-Patricia_Maria_Tig-Elena_Rybakina,1,B-XC,11,6,3,0,3,7,4
20190721-W-Bucharest-F-Patricia_Maria_Tig-Elena_Rybakina,1,B-DTM,8,0,0,0,0,4,4
20190721-W-Bucharest-F-Patricia_Maria_Tig-Elena_Rybakina,1,B-IO,2,1,1,0,0,1,1
20190721-W-Bucharest-F-Patricia_Maria_Tig-Elena_Rybakina,1,S-XC,1,0,0,0,0,0,1
20190721-W-Bucharest-F-Patricia_Maria_Tig-Elena_Rybakina,1,S-DTM,5,0,0,0,0,2,3
20190721-W-Bucharest-F-Patricia_Maria_Tig-Elena_Rybakina,2,F-XC,29,12,6,3,3,22,7
20190721-W-Bucharest-F-Patricia_Maria_Tig-Elena_Rybakina,2,F-DTM,9,2,0,1,1,4,5
20190721-W-Bucharest-F-Patricia_Maria_Tig-Elena_Rybakina,2,F-DTL,7,4,3,0,1,6,1
20190721-W-Bucharest-F-Patricia_Maria_Tig-Elena_Rybakina,2,F-IO,8,3,2,0,1,5,3
20190721-W-Bucharest-F-Patricia_Maria_Tig-Elena_Rybakina,2,B-XC,12,5,2,0,3,7,5
20190721-W-Bucharest-F-Patricia_Maria_Tig-Elena_Rybakina,2,B-DTM,7,0,0,0,0,3,4
20190721-W-Bucharest-F-Patricia_Maria_Tig-Elena_Rybakina,2,B-DTL,4,4,3,0,1,3,1
20190721-W-Bucharest-F-Patricia_Maria_Tig-Elena_Rybakina,2,B-IO,7,2,0,1,1,4,3
20190721-W-Bucharest-F-Patricia_Maria_Tig-Elena_Rybakina,2,S-XC,1,0,0,0,0,0,1
20190721-W-Bucharest-F-Patricia_Maria_Tig-Elena_Rybakina,2,S-DTM,1,0,0,0,0,1,0
20190702-W-Wimbledon-R128-Sorana_Cirstea-Amanda_Anisimova,1,F-XC,27,6,1,4,1,13,14
20190702-W-Wimbledon-R128-Sorana_Cirstea-Amanda_Anisimova,1,F-DTM,14,2,0,0,2,2,12
20190702-W-Wimbledon-R128-Sorana_Cirstea-Amanda_Anisimova,1,F-DTL,14,4,2,1,1,9,5
20190702-W-Wimbledon-R128-Sorana_Cirstea-Amanda_Anisimova,1,F-IO,12,2,1,0,1,4,8
20190702-W-Wimbledon-R128-Sorana_Cirstea-Amanda_Anisimova,1,B-XC,14,4,2,1,1,6,8
20190702-W-Wimbledon-R128-Sorana_Cirstea-Amanda_Anisimova,1,B-DTM,23,5,0,2,3,9,14
20190702-W-Wimbledon-R128-Sorana_Cirstea-Amanda_Anisimova,1,B-DTL,15,9,1,5,3,6,9
20190702-W-Wimbledon-R128-Sorana_Cirstea-Amanda_Anisimova,1,B-IO,9,2,0,0,2,4,5
20190702-W-Wimbledon-R128-Sorana_Cirstea-Amanda_Anisimova,1,S-XC,1,0,0,0,0,0,1
20190702-W-Wimbledon-R128-Sorana_Cirstea-Amanda_Anisimova,1,S-DTM,1,0,0,0,0,1,0
20190702-W-Wimbledon-R128-Sorana_Cirstea-Amanda_Anisimova,1,S-DTL,1,0,0,0,0,0,1
20190702-W-Wimbledon-R128-Sorana_Cirstea-Amanda_Anisimova,2,F-XC,36,11,3,6,2,27,9
20190702-W-Wimbledon-R128-Sorana_Cirstea-Amanda_Anisimova,2,F-DTM,9,0,0,0,0,6,3
20190702-W-Wimbledon-R128-Sorana_Cirstea-Amanda_Anisimova,2,F-DTL,9,4,3,0,1,5,4
20190702-W-Wimbledon-R128-Sorana_Cirstea-Amanda_Anisimova,2,F-IO,9,2,2,0,0,6,3
20190702-W-Wimbledon-R128-Sorana_Cirstea-Amanda_Anisimova,2,F-II,3,1,1,0,0,3,0
20190702-W-Wimbledon-R128-Sorana_Cirstea-Amanda_Anisimova,2,B-XC,28,8,4,2,2,21,7
20190702-W-Wimbledon-R128-Sorana_Cirstea-Amanda_Anisimova,2,B-DTM,13,1,0,0,1,7,6
20190702-W-Wimbledon-R128-Sorana_Cirstea-Amanda_Anisimova,2,B-DTL,5,0,0,0,0,2,3
20190702-W-Wimbledon-R128-Sorana_Cirstea-Amanda_Anisimova,2,B-IO,2,1,1,0,0,1,1
20190702-W-Wimbledon-R128-Sorana_Cirstea-Amanda_Anisimova,2,S-XC,3,0,0,0,0,2,1
20190702-W-Wimbledon-R128-Sorana_Cirstea-Amanda_Anisimova,2,S-DTM,1,0,0,0,0,1,0
20190702-W-Wimbledon-R128-Sorana_Cirstea-Amanda_Anisimova,2,S-DTL,2,0,0,0,0,2,0
20190702-W-Wimbledon-R128-Sorana_Cirstea-Amanda_Anisimova,2,S-IO,1,0,0,0,0,1,0
20190704-W-Wimbledon-R64-Amanda_Anisimova-Magda_Linette,1,F-XC,46,19,5,7,7,26,20
20190704-W-Wimbledon-R64-Amanda_Anisimova-Magda_Linette,1,F-DTM,12,1,0,1,0,9,3
20190704-W-Wimbledon-R64-Amanda_Anisimova-Magda_Linette,1,F-DTL,10,7,1,3,3,5,5
20190704-W-Wimbledon-R64-Amanda_Anisimova-Magda_Linette,1,F-IO,14,7,3,1,3,6,8
20190704-W-Wimbledon-R64-Amanda_Anisimova-Magda_Linette,1,F-II,2,2,0,1,1,1,1
20190704-W-Wimbledon-R64-Amanda_Anisimova-Magda_Linette,1,B-XC,25,5,0,4,1,15,10
20190704-W-Wimbledon-R64-Amanda_Anisimova-Magda_Linette,1,B-DTM,12,3,0,3,0,8,4
20190704-W-Wimbledon-R64-Amanda_Anisimova-Magda_Linette,1,B-DTL,10,5,2,1,2,5,5
20190704-W-Wimbledon-R64-Amanda_Anisimova-Magda_Linette,1,B-IO,8,5,1,2,2,5,3
20190704-W-Wimbledon-R64-Amanda_Anisimova-Magda_Linette,1,S-XC,3,0,0,0,0,2,1
20190704-W-Wimbledon-R64-Amanda_Anisimova-Magda_Linette,1,S-DTM,1,1,0,1,0,1,0
20190704-W-Wimbledon-R64-Amanda_Anisimova-Magda_Linette,1,S-DTL,3,0,0,0,0,2,1
20190704-W-Wimbledon-R64-Amanda_Anisimova-Magda_Linette,1,S-IO,1,0,0,0,0,1,0
20190704-W-Wimbledon-R64-Amanda_Anisimova-Magda_Linette,2,F-XC,40,12,5,4,3,21,19
20190704-W-Wimbledon-R64-Amanda_Anisimova-Magda_Linette,2,F-DTM,13,0,0,0,0,4,9
20190704-W-Wimbledon-R64-Amanda_Anisimova-Magda_Linette,2,F-DTL,9,8,4,2,2,6,3
20190704-W-Wimbledon-R64-Amanda_Anisimova-Magda_Linette,2,F-IO,6,2,0,0,2,0,6
20190704-W-Wimbledon-R64-Amanda_Anisimova-Magda_Linette,2,B-XC,21,5,3,2,0,11,10
20190704-W-Wimbledon-R64-Amanda_Anisimova-Magda_Linette,2,B-DTM,23,4,0,2,2,13,10
20190704-W-Wimbledon-R64-Amanda_Anisimova-Magda_Linette,2,B-DTL,13,6,2,2,2,7,6
20190704-W-Wimbledon-R64-Amanda_Anisimova-Magda_Linette,2,B-IO,4,0,0,0,0,2,2
20190704-W-Wimbledon-R64-Amanda_Anisimova-Magda_Linette,2,S-XC,9,1,0,1,0,3,6
20190704-W-Wimbledon-R64-Amanda_Anisimova-Magda_Linette,2,S-DTM,4,0,0,0,0,2,2
20190705-W-Wimbledon-R32-Shuai_Zhang-Caroline_Wozniacki,1,F-XC,59,10,0,6,4,33,26
20190705-W-Wimbledon-R32-Shuai_Zhang-Caroline_Wozniacki,1,F-DTM,13,2,0,1,1,5,8
20190705-W-Wimbledon-R32-Shuai_Zhang-Caroline_Wozniacki,1,F-DTL,21,10,6,2,2,13,8
20190705-W-Wimbledon-R32-Shuai_Zhang-Caroline_Wozniacki,1,F-IO,11,3,3,0,0,8,3
20190705-W-Wimbledon-R32-Shuai_Zhang-Caroline_Wozniacki,1,F-II,2,0,0,0,0,2,0
20190705-W-Wimbledon-R32-Shuai_Zhang-Caroline_Wozniacki,1,B-XC,43,6,1,3,2,22,21
20190705-W-Wimbledon-R32-Shuai_Zhang-Caroline_Wozniacki,1,B-DTM,15,1,0,0,1,6,9
20190705-W-Wimbledon-R32-Shuai_Zhang-Caroline_Wozniacki,1,B-DTL,12,8,4,1,3,6,6
20190705-W-Wimbledon-R32-Shuai_Zhang-Caroline_Wozniacki,1,B-IO,4,2,1,1,0,4,0
20190705-W-Wimbledon-R32-Shuai_Zhang-Caroline_Wozniacki,1,S-XC,5,0,0,0,0,2,3
20190705-W-Wimbledon-R32-Shuai_Zhang-Caroline_Wozniacki,2,F-XC,48,7,0,4,3,22,26
20190705-W-Wimbledon-R32-Shuai_Zhang-Caroline_Wozniacki,2,F-DTM,13,0,0,0,0,6,7
20190705-W-Wimbledon-R32-Shuai_Zhang-Caroline_Wozniacki,2,F-DTL,20,7,2,1,4,8,12
20190705-W-Wimbledon-R32-Shuai_Zhang-Caroline_Wozniacki,2,F-IO,9,3,1,2,0,6,3
20190705-W-Wimbledon-R32-Shuai_Zhang-Caroline_Wozniacki,2,B-XC,41,6,1,3,2,22,19
20190705-W-Wimbledon-R32-Shuai_Zhang-Caroline_Wozniacki,2,B-DTM,22,1,0,1,0,11,11
20190705-W-Wimbledon-R32-Shuai_Zhang-Caroline_Wozniacki,2,B-DTL,9,3,0,2,1,5,4
20190705-W-Wimbledon-R32-Shuai_Zhang-Caroline_Wozniacki,2,B-IO,9,1,0,1,0,4,5
20190705-W-Wimbledon-R32-Shuai_Zhang-Caroline_Wozniacki,2,S-XC,2,0,0,0,0,0,2
20190705-W-Wimbledon-R32-Shuai_Zhang-Caroline_Wozniacki,2,S-DTM,3,0,0,0,0,1,2
20190705-W-Wimbledon-R32-Shuai_Zhang-Caroline_Wozniacki,2,S-DTL,2,1,0,1,0,2,0
20190102-W-Brisbane-R16-Donna_Vekic-Kiki_Bertens,1,F-XC,49,7,0,4,3,27,22
20190102-W-Brisbane-R16-Donna_Vekic-Kiki_Bertens,1,F-DTM,54,3,0,0,2,25,29
20190102-W-Brisbane-R16-Donna_Vekic-Kiki_Bertens,1,F-DTL,28,13,2,5,6,13,15
20190102-W-Brisbane-R16-Donna_Vekic-Kiki_Bertens,1,F-IO,49,14,4,3,7,27,22
20190102-W-Brisbane-R16-Donna_Vekic-Kiki_Bertens,1,F-II,1,1,1,0,0,1,0
20190102-W-Brisbane-R16-Donna_Vekic-Kiki_Bertens,1,B-XC,24,4,0,2,2,11,13
20190102-W-Brisbane-R16-Donna_Vekic-Kiki_Bertens,1,B-DTM,27,0,0,0,0,11,16
20190102-W-Brisbane-R16-Donna_Vekic-Kiki_Bertens,1,B-DTL,6,3,0,0,3,2,4
20190102-W-Brisbane-R16-Donna_Vekic-Kiki_Bertens,1,B-IO,4,0,0,0,0,2,2
20190102-W-Brisbane-R16-Donna_Vekic-Kiki_Bertens,1,S-XC,2,1,0,0,1,0,2
20190102-W-Brisbane-R16-Donna_Vekic-Kiki_Bertens,1,S-DTM,2,0,0,0,0,0,2
20190102-W-Brisbane-R16-Donna_Vekic-Kiki_Bertens,1,S-DTL,2,1,1,0,0,1,1
20190102-W-Brisbane-R16-Donna_Vekic-Kiki_Bertens,2,F-XC,89,23,8,2,13,52,37
20190102-W-Brisbane-R16-Donna_Vekic-Kiki_Bertens,2,F-DTM,29,3,0,0,3,10,19
20190102-W-Brisbane-R16-Donna_Vekic-Kiki_Bertens,2,F-DTL,16,10,5,0,5,10,6
20190102-W-Brisbane-R16-Donna_Vekic-Kiki_Bertens,2,F-IO,22,9,6,1,2,17,5
20190102-W-Brisbane-R16-Donna_Vekic-Kiki_Bertens,2,F-II,5,3,0,2,1,4,1
20190102-W-Brisbane-R16-Donna_Vekic-Kiki_Bertens,2,B-XC,33,6,0,0,6,13,20
20190102-W-Brisbane-R16-Donna_Vekic-Kiki_Bertens,2,B-DTM,46,8,1,2,5,23,23
20190102-W-Brisbane-R16-Donna_Vekic-Kiki_Bertens,2,B-DTL,9,6,0,3,3,5,4
20190102-W-Brisbane-R16-Donna_Vekic-Kiki_Bertens,2,B-IO,3,0,0,0,0,2,1
20190102-W-Brisbane-R16-Donna_Vekic-Kiki_Bertens,2,S-XC,9,0,0,0,0,7,2
20190102-W-Brisbane-R16-Donna_Vekic-Kiki_Bertens,2,S-DTM,9,1,0,0,1,2,7
20190726-W-Palermo-QF-Arantxa_Rus-Paula_Badosa,1,F-XC,36,8,4,1,3,18,18
20190726-W-Palermo-QF-Arantxa_Rus-Paula_Badosa,1,F-DTM,36,1,0,1,0,12,24
20190726-W-Palermo-QF-Arantxa_Rus-Paula_Badosa,1,F-DTL,8,3,0,1,2,4,4
20190726-W-Palermo-QF-Arantxa_Rus-Paula_Badosa,1,F-IO,25,7,3,1,3,10,15
20190726-W-Palermo-QF-Arantxa_Rus-Paula_Badosa,1,F-II,2,1,1,0,0,2,0
20190726-W-Palermo-QF-Arantxa_Rus-Paula_Badosa,1,B-XC,38,7,1,0,6,16,22
20190726-W-Palermo-QF-Arantxa_Rus-Paula_Badosa,1,B-DTM,37,4,0,0,4,13,24
20190726-W-Palermo-QF-Arantxa_Rus-Paula_Badosa,1,B-DTL,3,2,1,1,0,2,1
20190726-W-Palermo-QF-Arantxa_Rus-Paula_Badosa,1,B-IO,9,2,0,0,2,2,7
20190726-W-Palermo-QF-Arantxa_Rus-Paula_Badosa,1,B-II,1,0,0,0,0,0,1
20190726-W-Palermo-QF-Arantxa_Rus-Paula_Badosa,1,S-XC,3,0,0,0,0,1,2
20190726-W-Palermo-QF-Arantxa_Rus-Paula_Badosa,1,S-DTM,5,0,0,0,0,1,4
20190726-W-Palermo-QF-Arantxa_Rus-Paula_Badosa,2,F-XC,50,7,2,1,4,29,21
20190726-W-Palermo-QF-Arantxa_Rus-Paula_Badosa,2,F-DTM,40,1,0,1,0,27,13
20190726-W-Palermo-QF-Arantxa_Rus-Paula_Badosa,2,F-DTL,11,2,1,1,0,7,4
20190726-W-Palermo-QF-Arantxa_Rus-Paula_Badosa,2,F-IO,22,10,2,2,6,13,9
20190726-W-Palermo-QF-Arantxa_Rus-Paula_Badosa,2,B-XC,17,3,3,0,0,10,7
20190726-W-Palermo-QF-Arantxa_Rus-Paula_Badosa,2,B-DTM,31,1,1,0,0,18,13
20190726-W-Palermo-QF-Arantxa_Rus-Paula_Badosa,2,B-DTL,5,2,1,0,1,2,3
20190726-W-Palermo-QF-Arantxa_Rus-Paula_Badosa,2,B-IO,9,3,2,0,1,6,3
20190726-W-Palermo-QF-Arantxa_Rus-Paula_Badosa,2,S-DTM,1,0,0,0,0,1,0
20190723-W-Palermo-R32-Ekaterine_Gorgodze-Kiki_Bertens,1,F-XC,31,8,0,3,5,14,17
20190723-W-Palermo-R32-Ekaterine_Gorgodze-Kiki_Bertens,1,F-DTM,16,2,0,1,1,4,12
20190723-W-Palermo-R32-Ekaterine_Gorgodze-Kiki_Bertens,1,F-DTL,16,6,1,1,4,8,8
20190723-W-Palermo-R32-Ekaterine_Gorgodze-Kiki_Bertens,1,F-IO,16,2,0,0,2,6,10
20190723-W-Palermo-R32-Ekaterine_Gorgodze-Kiki_Bertens,1,F-II,1,0,0,0,0,0,1
20190723-W-Palermo-R32-Ekaterine_Gorgodze-Kiki_Bertens,1,B-XC,24,2,0,0,2,10,14
20190723-W-Palermo-R32-Ekaterine_Gorgodze-Kiki_Bertens,1,B-DTM,27,2,0,0,2,11,16
20190723-W-Palermo-R32-Ekaterine_Gorgodze-Kiki_Bertens,1,B-DTL,14,3,0,0,3,7,7
20190723-W-Palermo-R32-Ekaterine_Gorgodze-Kiki_Bertens,1,B-IO,6,1,0,0,1,1,5
20190723-W-Palermo-R32-Ekaterine_Gorgodze-Kiki_Bertens,1,S-XC,1,0,0,0,0,0,1
20190723-W-Palermo-R32-Ekaterine_Gorgodze-Kiki_Bertens,1,S-DTM,4,1,1,0,0,2,2
20190723-W-Palermo-R32-Ekaterine_Gorgodze-Kiki_Bertens,1,S-DTL,1,0,0,0,0,0,1
20190723-W-Palermo-R32-Ekaterine_Gorgodze-Kiki_Bertens,2,F-XC,52,7,2,3,2,31,21
20190723-W-Palermo-R32-Ekaterine_Gorgodze-Kiki_Bertens,2,F-DTM,6,0,0,0,0,3,3
20190723-W-Palermo-R32-Ekaterine_Gorgodze-Kiki_Bertens,2,F-DTL,9,2,0,2,0,6,3
20190723-W-Palermo-R32-Ekaterine_Gorgodze-Kiki_Bertens,2,F-IO,17,9,3,2,4,11,6
20190723-W-Palermo-R32-Ekaterine_Gorgodze-Kiki_Bertens,2,B-XC,10,3,1,1,1,7,3
20190723-W-Palermo-R32-Ekaterine_Gorgodze-Kiki_Bertens,2,B-DTM,15,2,1,0,1,9,6
20190723-W-Palermo-R32-Ekaterine_Gorgodze-Kiki_Bertens,2,B-DTL,7,2,0,0,2,3,4
20190723-W-Palermo-R32-Ekaterine_Gorgodze-Kiki_Bertens,2,B-IO,2,0,0,0,0,1,1
20190723-W-Palermo-R32-Ekaterine_Gorgodze-Kiki_Bertens,2,S-XC,10,0,0,0,0,6,4
20190723-W-Palermo-R32-Ekaterine_Gorgodze-Kiki_Bertens,2,S-DTM,5,0,0,0,0,2,3
20190725-W-Palermo-R16-Aleksandra_Krunic-Kiki_Bertens,1,F-XC,34,5,2,0,3,16,18
20190725-W-Palermo-R16-Aleksandra_Krunic-Kiki_Bertens,1,F-DTM,8,0,0,0,0,3,5
20190725-W-Palermo-R16-Aleksandra_Krunic-Kiki_Bertens,1,F-DTL,16,5,1,0,4,9,7
20190725-W-Palermo-R16-Aleksandra_Krunic-Kiki_Bertens,1,F-IO,17,3,2,1,0,9,8
20190725-W-Palermo-R16-Aleksandra_Krunic-Kiki_Bertens,1,F-II,8,4,0,1,3,3,5
20190725-W-Palermo-R16-Aleksandra_Krunic-Kiki_Bertens,1,B-XC,21,3,0,2,1,9,12
20190725-W-Palermo-R16-Aleksandra_Krunic-Kiki_Bertens,1,B-DTM,8,0,0,0,0,6,2
20190725-W-Palermo-R16-Aleksandra_Krunic-Kiki_Bertens,1,B-DTL,4,2,0,0,2,1,3
20190725-W-Palermo-R16-Aleksandra_Krunic-Kiki_Bertens,1,S-XC,13,1,0,1,0,9,4
20190725-W-Palermo-R16-Aleksandra_Krunic-Kiki_Bertens,1,S-DTM,5,1,0,0,1,2,3
20190725-W-Palermo-R16-Aleksandra_Krunic-Kiki_Bertens,1,S-DTL,5,0,0,0,0,4,1
20190725-W-Palermo-R16-Aleksandra_Krunic-Kiki_Bertens,2,F-XC,22,6,0,4,2,11,11
20190725-W-Palermo-R16-Aleksandra_Krunic-Kiki_Bertens,2,F-DTM,15,2,0,0,2,7,8
20190725-W-Palermo-R16-Aleksandra_Krunic-Kiki_Bertens,2,F-DTL,12,4,0,1,3,6,6
20190725-W-Palermo-R16-Aleksandra_Krunic-Kiki_Bertens,2,F-IO,14,6,2,1,3,5,9
20190725-W-Palermo-R16-Aleksandra_Krunic-Kiki_Bertens,2,F-II,3,2,0,1,1,2,1
20190725-W-Palermo-R16-Aleksandra_Krunic-Kiki_Bertens,2,B-XC,24,1,0,0,1,13,11
20190725-W-Palermo-R16-Aleksandra_Krunic-Kiki_Bertens,2,B-DTM,15,0,0,0,0,6,9
20190725-W-Palermo-R16-Aleksandra_Krunic-Kiki_Bertens,2,B-DTL,1,1,1,0,0,1,0
20190725-W-Palermo-R16-Aleksandra_Krunic-Kiki_Bertens,2,B-IO,1,0,0,0,0,1,0
20190725-W-Palermo-R16-Aleksandra_Krunic-Kiki_Bertens,2,S-XC,12,0,0,0,0,6,6
20190725-W-Palermo-R16-Aleksandra_Krunic-Kiki_Bertens,2,S-DTM,3,0,0,0,0,0,3
20190725-W-Palermo-R16-Aleksandra_Krunic-Kiki_Bertens,2,S-DTL,3,0,0,0,0,2,1
20190722-W-Palermo-R32-Arantxa_Rus-Amandine_Hesse,1,F-XC,67,12,2,4,6,41,26
20190722-W-Palermo-R32-Arantxa_Rus-Amandine_Hesse,1,F-DTM,51,1,0,1,0,35,16
20190722-W-Palermo-R32-Arantxa_Rus-Amandine_Hesse,1,F-DTL,17,5,2,1,2,9,8
20190722-W-Palermo-R32-Arantxa_Rus-Amandine_Hesse,1,F-IO,28,8,1,3,4,15,13
20190722-W-Palermo-R32-Arantxa_Rus-Amandine_Hesse,1,B-XC,43,8,3,0,5,27,16
20190722-W-Palermo-R32-Arantxa_Rus-Amandine_Hesse,1,B-DTM,32,3,0,0,3,17,15
20190722-W-Palermo-R32-Arantxa_Rus-Amandine_Hesse,1,B-DTL,12,3,1,0,2,10,2
20190722-W-Palermo-R32-Arantxa_Rus-Amandine_Hesse,1,B-IO,7,0,0,0,0,3,4
20190722-W-Palermo-R32-Arantxa_Rus-Amandine_Hesse,1,B-II,1,1,1,0,0,1,0
20190722-W-Palermo-R32-Arantxa_Rus-Amandine_Hesse,1,S-XC,2,0,0,0,0,1,1
20190722-W-Palermo-R32-Arantxa_Rus-Amandine_Hesse,2,F-XC,55,7,1,3,3,27,28
20190722-W-Palermo-R32-Arantxa_Rus-Amandine_Hesse,2,F-DTM,36,4,0,1,3,16,20
20190722-W-Palermo-R32-Arantxa_Rus-Amandine_Hesse,2,F-DTL,21,7,1,2,4,10,11
20190722-W-Palermo-R32-Arantxa_Rus-Amandine_Hesse,2,F-IO,38,11,2,2,7,13,25
20190722-W-Palermo-R32-Arantxa_Rus-Amandine_Hesse,2,F-II,4,0,0,0,0,2,2
20190722-W-Palermo-R32-Arantxa_Rus-Amandine_Hesse,2,B-XC,30,2,1,0,1,12,18
20190722-W-Palermo-R32-Arantxa_Rus-Amandine_Hesse,2,B-DTM,40,3,0,0,3,14,26
20190722-W-Palermo-R32-Arantxa_Rus-Amandine_Hesse,2,B-DTL,14,5,0,0,5,2,12
20190722-W-Palermo-R32-Arantxa_Rus-Amandine_Hesse,2,B-IO,4,1,1,0,0,1,3
20190722-W-Palermo-R32-Arantxa_Rus-Amandine_Hesse,2,S-XC,8,1,0,0,1,2,6
20190722-W-Palermo-R32-Arantxa_Rus-Amandine_Hesse,2,S-DTM,7,1,0,0,1,2,5
20190722-W-Palermo-R32-Arantxa_Rus-Amandine_Hesse,2,S-DTL,2,0,0,0,0,0,2
20190724-W-Palermo-R16-Jil_Teichmann-Gabriela_Ce,1,F-XC,71,18,6,6,6,38,33
20190724-W-Palermo-R16-Jil_Teichmann-Gabriela_Ce,1,F-DTM,32,2,1,0,1,17,15
20190724-W-Palermo-R16-Jil_Teichmann-Gabriela_Ce,1,F-DTL,12,4,2,0,2,6,6
20190724-W-Palermo-R16-Jil_Teichmann-Gabriela_Ce,1,F-IO,57,16,7,1,8,33,24
20190724-W-Palermo-R16-Jil_Teichmann-Gabriela_Ce,1,F-II,4,1,0,0,1,2,2
20190724-W-Palermo-R16-Jil_Teichmann-Gabriela_Ce,1,B-XC,53,8,7,0,1,29,24
20190724-W-Palermo-R16-Jil_Teichmann-Gabriela_Ce,1,B-DTM,26,1,0,0,1,17,9
20190724-W-Palermo-R16-Jil_Teichmann-Gabriela_Ce,1,B-DTL,7,3,1,0,2,2,5
20190724-W-Palermo-R16-Jil_Teichmann-Gabriela_Ce,1,B-IO,1,1,1,0,0,1,0
20190724-W-Palermo-R16-Jil_Teichmann-Gabriela_Ce,1,S-XC,1,0,0,0,0,0,1
20190724-W-Palermo-R16-Jil_Teichmann-Gabriela_Ce,1,S-DTM,2,0,0,0,0,0,2
20190724-W-Palermo-R16-Jil_Teichmann-Gabriela_Ce,1,S-DTL,3,0,0,0,0,1,2
20190724-W-Palermo-R16-Jil_Teichmann-Gabriela_Ce,1,S-IO,1,1,0,0,1,0,1
20190724-W-Palermo-R16-Jil_Teichmann-Gabriela_Ce,2,F-XC,45,10,5,2,3,25,20
20190724-W-Palermo-R16-Jil_Teichmann-Gabriela_Ce,2,F-DTM,36,2,0,0,2,9,27
20190724-W-Palermo-R16-Jil_Teichmann-Gabriela_Ce,2,F-DTL,13,2,0,0,2,7,6
20190724-W-Palermo-R16-Jil_Teichmann-Gabriela_Ce,2,F-IO,38,2,1,0,1,24,14
20190724-W-Palermo-R16-Jil_Teichmann-Gabriela_Ce,2,F-II,4,0,0,0,0,3,1
20190724-W-Palermo-R16-Jil_Teichmann-Gabriela_Ce,2,B-XC,32,6,1,1,4,12,20
20190724-W-Palermo-R16-Jil_Teichmann-Gabriela_Ce,2,B-DTM,34,3,0,0,3,15,19
20190724-W-Palermo-R16-Jil_Teichmann-Gabriela_Ce,2,B-DTL,6,0,0,0,0,3,3
20190724-W-Palermo-R16-Jil_Teichmann-Gabriela_Ce,2,B-IO,1,0,0,0,0,0,1
20190724-W-Palermo-R16-Jil_Teichmann-Gabriela_Ce,2,S-XC,3,0,0,0,0,3,0
20190724-W-Palermo-R16-Jil_Teichmann-Gabriela_Ce,2,S-DTM,15,0,0,0,0,7,8
20190724-W-Palermo-R16-Jil_Teichmann-Gabriela_Ce,2,S-DTL,1,0,0,0,0,0,1
20190723-W-Palermo-R32-Daria_Gavrilova-Jil_Teichmann,1,F-XC,56,11,5,1,5,36,20
20190723-W-Palermo-R32-Daria_Gavrilova-Jil_Teichmann,1,F-DTM,18,2,0,1,1,10,8
20190723-W-Palermo-R32-Daria_Gavrilova-Jil_Teichmann,1,F-DTL,20,9,4,1,4,14,6
20190723-W-Palermo-R32-Daria_Gavrilova-Jil_Teichmann,1,F-IO,42,15,5,3,7,20,22
20190723-W-Palermo-R32-Daria_Gavrilova-Jil_Teichmann,1,F-II,9,0,0,0,0,2,7
20190723-W-Palermo-R32-Daria_Gavrilova-Jil_Teichmann,1,B-XC,6,1,0,0,1,4,2
20190723-W-Palermo-R32-Daria_Gavrilova-Jil_Teichmann,1,B-DTM,20,1,0,0,1,5,15
20190723-W-Palermo-R32-Daria_Gavrilova-Jil_Teichmann,1,B-DTL,25,8,2,0,6,15,10
20190723-W-Palermo-R32-Daria_Gavrilova-Jil_Teichmann,1,B-IO,5,1,0,0,1,0,5
20190723-W-Palermo-R32-Daria_Gavrilova-Jil_Teichmann,1,S-DTM,5,0,0,0,0,3,2
20190723-W-Palermo-R32-Daria_Gavrilova-Jil_Teichmann,1,S-DTL,1,0,0,0,0,1,0
20190723-W-Palermo-R32-Daria_Gavrilova-Jil_Teichmann,2,F-XC,72,17,6,4,7,40,32
20190723-W-Palermo-R32-Daria_Gavrilova-Jil_Teichmann,2,F-DTM,19,1,0,0,1,7,12
20190723-W-Palermo-R32-Daria_Gavrilova-Jil_Teichmann,2,F-DTL,4,1,0,1,0,4,0
20190723-W-Palermo-R32-Daria_Gavrilova-Jil_Teichmann,2,F-IO,18,10,5,3,2,12,6
20190723-W-Palermo-R32-Daria_Gavrilova-Jil_Teichmann,2,F-II,2,0,0,0,0,1,1
20190723-W-Palermo-R32-Daria_Gavrilova-Jil_Teichmann,2,B-XC,33,5,2,0,3,15,18
20190723-W-Palermo-R32-Daria_Gavrilova-Jil_Teichmann,2,B-DTM,35,1,0,0,1,16,19
20190723-W-Palermo-R32-Daria_Gavrilova-Jil_Teichmann,2,B-DTL,22,8,2,1,5,10,12
20190723-W-Palermo-R32-Daria_Gavrilova-Jil_Teichmann,2,B-IO,6,0,0,0,0,4,2
20190723-W-Palermo-R32-Daria_Gavrilova-Jil_Teichmann,2,S-XC,1,0,0,0,0,0,1
20190723-W-Palermo-R32-Daria_Gavrilova-Jil_Teichmann,2,S-DTM,4,0,0,0,0,2,2
20190723-W-Palermo-R32-Daria_Gavrilova-Jil_Teichmann,2,S-DTL,3,2,0,0,2,0,3
20190723-W-Palermo-R32-Daria_Gavrilova-Jil_Teichmann,2,S-IO,3,1,1,0,0,2,1
20190725-W-Palermo-R16-Arantxa_Rus-Viktoria_Kuzmova,1,F-XC,27,5,3,0,2,13,14
20190725-W-Palermo-R16-Arantxa_Rus-Viktoria_Kuzmova,1,F-DTM,32,2,0,1,1,12,20
20190725-W-Palermo-R16-Arantxa_Rus-Viktoria_Kuzmova,1,F-DTL,10,3,1,1,1,6,4
20190725-W-Palermo-R16-Arantxa_Rus-Viktoria_Kuzmova,1,F-IO,21,8,5,0,3,13,8
20190725-W-Palermo-R16-Arantxa_Rus-Viktoria_Kuzmova,1,B-XC,23,1,0,0,1,12,11
20190725-W-Palermo-R16-Arantxa_Rus-Viktoria_Kuzmova,1,B-DTM,37,1,0,0,1,19,18
20190725-W-Palermo-R16-Arantxa_Rus-Viktoria_Kuzmova,1,B-DTL,2,1,0,1,0,1,1
20190725-W-Palermo-R16-Arantxa_Rus-Viktoria_Kuzmova,1,B-IO,2,1,0,0,1,1,1
20190725-W-Palermo-R16-Arantxa_Rus-Viktoria_Kuzmova,1,S-XC,5,2,0,1,1,3,2
20190725-W-Palermo-R16-Arantxa_Rus-Viktoria_Kuzmova,1,S-DTM,6,0,0,0,0,1,5
20190725-W-Palermo-R16-Arantxa_Rus-Viktoria_Kuzmova,1,S-DTL,1,0,0,0,0,0,1
20190725-W-Palermo-R16-Arantxa_Rus-Viktoria_Kuzmova,2,F-XC,54,13,4,3,6,31,23
20190725-W-Palermo-R16-Arantxa_Rus-Viktoria_Kuzmova,2,F-DTM,19,2,0,0,2,8,11
20190725-W-Palermo-R16-Arantxa_Rus-Viktoria_Kuzmova,2,F-DTL,14,10,3,0,7,5,9
20190725-W-Palermo-R16-Arantxa_Rus-Viktoria_Kuzmova,2,F-IO,28,7,3,1,3,17,11
20190725-W-Palermo-R16-Arantxa_Rus-Viktoria_Kuzmova,2,B-XC,30,7,2,2,3,19,11
20190725-W-Palermo-R16-Arantxa_Rus-Viktoria_Kuzmova,2,B-DTM,25,2,0,0,2,9,16
20190725-W-Palermo-R16-Arantxa_Rus-Viktoria_Kuzmova,2,B-DTL,1,1,0,0,1,0,1
20190725-W-Palermo-R16-Arantxa_Rus-Viktoria_Kuzmova,2,B-IO,16,4,3,0,1,9,7
20190725-W-Palermo-R16-Arantxa_Rus-Viktoria_Kuzmova,2,S-DTM,2,0,0,0,0,0,2
20190725-W-Palermo-R16-Arantxa_Rus-Viktoria_Kuzmova,2,S-IO,1,1,0,0,1,0,1
20190727-W-Palermo-SF-Kiki_Bertens-Paula_Badosa,1,F-XC,68,14,5,3,6,43,25
20190727-W-Palermo-SF-Kiki_Bertens-Paula_Badosa,1,F-DTM,11,1,0,0,1,8,3
20190727-W-Palermo-SF-Kiki_Bertens-Paula_Badosa,1,F-DTL,9,4,1,2,1,7,2
20190727-W-Palermo-SF-Kiki_Bertens-Paula_Badosa,1,F-IO,30,12,1,4,7,19,11
20190727-W-Palermo-SF-Kiki_Bertens-Paula_Badosa,1,F-II,2,1,0,0,1,1,1
20190727-W-Palermo-SF-Kiki_Bertens-Paula_Badosa,1,B-XC,45,3,0,0,3,19,26
20190727-W-Palermo-SF-Kiki_Bertens-Paula_Badosa,1,B-DTM,26,2,0,1,1,14,12
20190727-W-Palermo-SF-Kiki_Bertens-Paula_Badosa,1,B-DTL,4,1,0,0,1,2,2
20190727-W-Palermo-SF-Kiki_Bertens-Paula_Badosa,1,S-XC,7,1,0,0,1,5,2
20190727-W-Palermo-SF-Kiki_Bertens-Paula_Badosa,1,S-DTM,5,0,0,0,0,4,1
20190727-W-Palermo-SF-Kiki_Bertens-Paula_Badosa,1,S-DTL,1,0,0,0,0,1,0
20190727-W-Palermo-SF-Kiki_Bertens-Paula_Badosa,2,F-XC,47,13,2,4,7,16,31
20190727-W-Palermo-SF-Kiki_Bertens-Paula_Badosa,2,F-DTM,41,4,0,1,3,15,26
20190727-W-Palermo-SF-Kiki_Bertens-Paula_Badosa,2,F-DTL,17,3,2,1,0,6,11
20190727-W-Palermo-SF-Kiki_Bertens-Paula_Badosa,2,F-IO,25,6,2,1,3,14,11
20190727-W-Palermo-SF-Kiki_Bertens-Paula_Badosa,2,F-II,2,1,1,0,0,2,0
20190727-W-Palermo-SF-Kiki_Bertens-Paula_Badosa,2,B-XC,39,3,0,0,3,18,21
20190727-W-Palermo-SF-Kiki_Bertens-Paula_Badosa,2,B-DTM,20,0,0,0,0,7,13
20190727-W-Palermo-SF-Kiki_Bertens-Paula_Badosa,2,B-DTL,8,3,0,2,1,3,5
20190727-W-Palermo-SF-Kiki_Bertens-Paula_Badosa,2,B-IO,2,1,0,0,1,0,2
20190727-W-Palermo-SF-Kiki_Bertens-Paula_Badosa,2,S-XC,1,0,0,0,0,0,1
20190727-W-Palermo-SF-Kiki_Bertens-Paula_Badosa,2,S-DTM,4,0,0,0,0,0,4
20190727-W-Palermo-SF-Kiki_Bertens-Paula_Badosa,2,S-DTL,1,0,0,0,0,0,1
20190728-W-Palermo-F-Jil_Teichmann-Kiki_Bertens,1,F-XC,93,11,2,2,7,64,29
20190728-W-Palermo-F-Jil_Teichmann-Kiki_Bertens,1,F-DTM,35,1,0,0,1,16,19
20190728-W-Palermo-F-Jil_Teichmann-Kiki_Bertens,1,F-DTL,8,5,2,1,2,6,2
20190728-W-Palermo-F-Jil_Teichmann-Kiki_Bertens,1,F-IO,20,7,4,0,3,14,6
20190728-W-Palermo-F-Jil_Teichmann-Kiki_Bertens,1,F-II,2,1,1,0,0,2,0
20190728-W-Palermo-F-Jil_Teichmann-Kiki_Bertens,1,B-XC,43,6,1,3,2,26,17
20190728-W-Palermo-F-Jil_Teichmann-Kiki_Bertens,1,B-DTM,43,3,0,0,3,20,23
20190728-W-Palermo-F-Jil_Teichmann-Kiki_Bertens,1,B-DTL,26,7,0,1,6,15,11
20190728-W-Palermo-F-Jil_Teichmann-Kiki_Bertens,1,B-IO,7,1,0,0,1,5,2
20190728-W-Palermo-F-Jil_Teichmann-Kiki_Bertens,1,S-DTM,3,0,0,0,0,1,2
20190728-W-Palermo-F-Jil_Teichmann-Kiki_Bertens,1,S-DTL,7,2,0,2,0,3,4
20190728-W-Palermo-F-Jil_Teichmann-Kiki_Bertens,2,F-XC,80,14,2,3,9,38,42
20190728-W-Palermo-F-Jil_Teichmann-Kiki_Bertens,2,F-DTM,36,4,0,0,4,11,25
20190728-W-Palermo-F-Jil_Teichmann-Kiki_Bertens,2,F-DTL,10,5,2,2,1,5,5
20190728-W-Palermo-F-Jil_Teichmann-Kiki_Bertens,2,F-IO,40,12,4,4,4,21,19
20190728-W-Palermo-F-Jil_Teichmann-Kiki_Bertens,2,F-II,5,2,1,0,1,2,3
20190728-W-Palermo-F-Jil_Teichmann-Kiki_Bertens,2,B-XC,55,8,3,1,4,19,36
20190728-W-Palermo-F-Jil_Teichmann-Kiki_Bertens,2,B-DTM,33,3,0,0,3,11,22
20190728-W-Palermo-F-Jil_Teichmann-Kiki_Bertens,2,B-DTL,17,6,2,0,4,5,12
20190728-W-Palermo-F-Jil_Teichmann-Kiki_Bertens,2,B-IO,5,2,0,1,1,3,2
20190728-W-Palermo-F-Jil_Teichmann-Kiki_Bertens,2,S-XC,4,1,0,0,1,1,3
20190728-W-Palermo-F-Jil_Teichmann-Kiki_Bertens,2,S-DTM,4,0,0,0,0,1,3
20190728-W-Palermo-F-Jil_Teichmann-Kiki_Bertens,2,S-DTL,3,0,0,0,0,0,3
20190726-W-Palermo-QF-Jasmine_Paolini-Kiki_Bertens,1,F-XC,46,9,0,3,6,21,25
20190726-W-Palermo-QF-Jasmine_Paolini-Kiki_Bertens,1,F-DTM,27,3,0,0,3,12,15
20190726-W-Palermo-QF-Jasmine_Paolini-Kiki_Bertens,1,F-DTL,13,4,0,1,3,7,6
20190726-W-Palermo-QF-Jasmine_Paolini-Kiki_Bertens,1,F-IO,36,12,3,3,6,19,17
20190726-W-Palermo-QF-Jasmine_Paolini-Kiki_Bertens,1,F-II,3,2,0,2,0,3,0
20190726-W-Palermo-QF-Jasmine_Paolini-Kiki_Bertens,1,B-XC,66,10,2,3,5,47,19
20190726-W-Palermo-QF-Jasmine_Paolini-Kiki_Bertens,1,B-DTM,17,2,0,0,2,7,10
20190726-W-Palermo-QF-Jasmine_Paolini-Kiki_Bertens,1,B-DTL,8,4,2,1,1,5,3
20190726-W-Palermo-QF-Jasmine_Paolini-Kiki_Bertens,1,S-XC,3,0,0,0,0,2,1
20190726-W-Palermo-QF-Jasmine_Paolini-Kiki_Bertens,1,S-DTM,4,0,0,0,0,0,4
20190726-W-Palermo-QF-Jasmine_Paolini-Kiki_Bertens,1,S-DTL,3,0,0,0,0,1,2
20190726-W-Palermo-QF-Jasmine_Paolini-Kiki_Bertens,2,F-XC,48,10,4,2,4,28,20
20190726-W-Palermo-QF-Jasmine_Paolini-Kiki_Bertens,2,F-DTM,20,3,0,0,3,11,9
20190726-W-Palermo-QF-Jasmine_Paolini-Kiki_Bertens,2,F-DTL,13,6,2,1,3,7,6
20190726-W-Palermo-QF-Jasmine_Paolini-Kiki_Bertens,2,F-IO,26,7,3,2,2,15,11
20190726-W-Palermo-QF-Jasmine_Paolini-Kiki_Bertens,2,F-II,4,4,1,0,3,1,3
20190726-W-Palermo-QF-Jasmine_Paolini-Kiki_Bertens,2,B-XC,36,5,0,1,4,9,27
20190726-W-Palermo-QF-Jasmine_Paolini-Kiki_Bertens,2,B-DTM,19,1,0,0,1,7,12
20190726-W-Palermo-QF-Jasmine_Paolini-Kiki_Bertens,2,B-DTL,8,1,0,0,1,3,5
20190726-W-Palermo-QF-Jasmine_Paolini-Kiki_Bertens,2,B-IO,2,1,0,1,0,1,1
20190726-W-Palermo-QF-Jasmine_Paolini-Kiki_Bertens,2,S-XC,17,2,0,0,2,5,12
20190726-W-Palermo-QF-Jasmine_Paolini-Kiki_Bertens,2,S-DTM,10,1,0,1,0,5,5
20190726-W-Palermo-QF-Jasmine_Paolini-Kiki_Bertens,2,S-DTL,1,1,0,0,1,0,1
20190702-W-Wimbledon-R128-Andrea_Petkovic-Monica_Niculescu,1,F-XC,52,14,3,2,9,15,37
20190702-W-Wimbledon-R128-Andrea_Petkovic-Monica_Niculescu,1,F-DTM,20,1,0,0,1,12,8
20190702-W-Wimbledon-R128-Andrea_Petkovic-Monica_Niculescu,1,F-DTL,10,4,0,2,2,5,5
20190702-W-Wimbledon-R128-Andrea_Petkovic-Monica_Niculescu,1,F-IO,18,6,2,3,1,12,6
20190702-W-Wimbledon-R128-Andrea_Petkovic-Monica_Niculescu,1,F-II,2,2,1,1,0,2,0
20190702-W-Wimbledon-R128-Andrea_Petkovic-Monica_Niculescu,1,B-XC,46,9,2,5,2,22,24
20190702-W-Wimbledon-R128-Andrea_Petkovic-Monica_Niculescu,1,B-DTM,38,5,0,0,5,16,22
20190702-W-Wimbledon-R128-Andrea_Petkovic-Monica_Niculescu,1,B-DTL,7,3,2,0,1,3,4
20190702-W-Wimbledon-R128-Andrea_Petkovic-Monica_Niculescu,1,B-IO,4,2,1,0,1,3,1
20190702-W-Wimbledon-R128-Andrea_Petkovic-Monica_Niculescu,1,S-XC,5,0,0,0,0,0,5
20190702-W-Wimbledon-R128-Andrea_Petkovic-Monica_Niculescu,1,S-DTM,2,0,0,0,0,1,1
20190702-W-Wimbledon-R128-Andrea_Petkovic-Monica_Niculescu,1,S-DTL,4,1,0,1,0,3,1
20190702-W-Wimbledon-R128-Andrea_Petkovic-Monica_Niculescu,1,S-IO,4,2,0,1,1,1,3
20190702-W-Wimbledon-R128-Andrea_Petkovic-Monica_Niculescu,2,F-XC,1,1,1,0,0,1,0
20190702-W-Wimbledon-R128-Andrea_Petkovic-Monica_Niculescu,2,F-DTM,5,1,0,1,0,2,3
20190702-W-Wimbledon-R128-Andrea_Petkovic-Monica_Niculescu,2,F-DTL,6,1,0,1,0,4,2
20190702-W-Wimbledon-R128-Andrea_Petkovic-Monica_Niculescu,2,F-IO,2,2,0,2,0,2,0
20190702-W-Wimbledon-R128-Andrea_Petkovic-Monica_Niculescu,2,B-XC,35,6,0,2,4,22,13
20190702-W-Wimbledon-R128-Andrea_Petkovic-Monica_Niculescu,2,B-DTM,27,2,0,1,1,17,10
20190702-W-Wimbledon-R128-Andrea_Petkovic-Monica_Niculescu,2,B-DTL,7,6,3,0,3,4,3
20190702-W-Wimbledon-R128-Andrea_Petkovic-Monica_Niculescu,2,B-IO,13,4,2,1,1,9,4
20190702-W-Wimbledon-R128-Andrea_Petkovic-Monica_Niculescu,2,S-XC,4,0,0,0,0,0,4
20190702-W-Wimbledon-R128-Andrea_Petkovic-Monica_Niculescu,2,S-DTM,4,1,0,1,0,2,2
20190702-W-Wimbledon-R128-Andrea_Petkovic-Monica_Niculescu,2,S-DTL,1,1,0,1,0,1,0
20190701-W-Wimbledon-R128-Madison_Brengle-Marketa_Vondrousova,1,F-XC,18,2,1,0,1,8,10
20190701-W-Wimbledon-R128-Madison_Brengle-Marketa_Vondrousova,1,F-DTM,18,2,0,1,1,5,13
20190701-W-Wimbledon-R128-Madison_Brengle-Marketa_Vondrousova,1,F-DTL,6,1,0,0,1,3,3
20190701-W-Wimbledon-R128-Madison_Brengle-Marketa_Vondrousova,1,F-IO,10,2,0,1,1,6,4
20190701-W-Wimbledon-R128-Madison_Brengle-Marketa_Vondrousova,1,B-XC,53,10,3,3,4,31,22
20190701-W-Wimbledon-R128-Madison_Brengle-Marketa_Vondrousova,1,B-DTM,33,6,1,1,4,19,14
20190701-W-Wimbledon-R128-Madison_Brengle-Marketa_Vondrousova,1,B-DTL,13,9,0,4,5,7,6
20190701-W-Wimbledon-R128-Madison_Brengle-Marketa_Vondrousova,1,B-IO,12,2,1,0,1,8,4
20190701-W-Wimbledon-R128-Madison_Brengle-Marketa_Vondrousova,1,S-XC,2,0,0,0,0,2,0
20190701-W-Wimbledon-R128-Madison_Brengle-Marketa_Vondrousova,1,S-DTM,5,0,0,0,0,1,4
20190701-W-Wimbledon-R128-Madison_Brengle-Marketa_Vondrousova,1,S-DTL,4,0,0,0,0,3,1
20190701-W-Wimbledon-R128-Madison_Brengle-Marketa_Vondrousova,1,S-IO,1,0,0,0,0,0,1
20190701-W-Wimbledon-R128-Madison_Brengle-Marketa_Vondrousova,2,F-XC,64,13,3,2,8,28,36
20190701-W-Wimbledon-R128-Madison_Brengle-Marketa_Vondrousova,2,F-DTM,30,2,0,0,2,15,15
20190701-W-Wimbledon-R128-Madison_Brengle-Marketa_Vondrousova,2,F-DTL,11,6,1,1,4,5,6
20190701-W-Wimbledon-R128-Madison_Brengle-Marketa_Vondrousova,2,F-IO,8,4,2,1,1,5,3
20190701-W-Wimbledon-R128-Madison_Brengle-Marketa_Vondrousova,2,B-XC,13,1,0,0,1,7,6
20190701-W-Wimbledon-R128-Madison_Brengle-Marketa_Vondrousova,2,B-DTM,17,3,1,0,2,7,10
20190701-W-Wimbledon-R128-Madison_Brengle-Marketa_Vondrousova,2,B-DTL,8,3,1,0,2,3,5
20190701-W-Wimbledon-R128-Madison_Brengle-Marketa_Vondrousova,2,B-IO,9,5,1,0,4,4,5
20190701-W-Wimbledon-R128-Madison_Brengle-Marketa_Vondrousova,2,S-XC,1,0,0,0,0,1,0
20190701-W-Wimbledon-R128-Madison_Brengle-Marketa_Vondrousova,2,S-DTM,10,3,0,0,3,1,9
20190701-W-Wimbledon-R128-Madison_Brengle-Marketa_Vondrousova,2,S-DTL,1,0,0,0,0,1,0
20190701-W-Wimbledon-R128-Madison_Brengle-Marketa_Vondrousova,2,S-IO,3,0,0,0,0,1,2
20190702-W-Wimbledon-R128-Sloane_Stephens-Timea_Bacsinszky,1,F-XC,54,18,7,5,6,35,19
20190702-W-Wimbledon-R128-Sloane_Stephens-Timea_Bacsinszky,1,F-DTM,17,1,0,0,1,12,5
20190702-W-Wimbledon-R128-Sloane_Stephens-Timea_Bacsinszky,1,F-DTL,4,1,0,1,0,1,3
20190702-W-Wimbledon-R128-Sloane_Stephens-Timea_Bacsinszky,1,F-IO,12,1,0,0,1,6,6
20190702-W-Wimbledon-R128-Sloane_Stephens-Timea_Bacsinszky,1,F-II,1,1,1,0,0,1,0
20190702-W-Wimbledon-R128-Sloane_Stephens-Timea_Bacsinszky,1,B-XC,41,8,4,1,3,28,13
20190702-W-Wimbledon-R128-Sloane_Stephens-Timea_Bacsinszky,1,B-DTM,25,2,1,1,0,20,5
20190702-W-Wimbledon-R128-Sloane_Stephens-Timea_Bacsinszky,1,B-DTL,15,3,1,0,2,9,6
20190702-W-Wimbledon-R128-Sloane_Stephens-Timea_Bacsinszky,1,B-IO,9,0,0,0,0,6,3
20190702-W-Wimbledon-R128-Sloane_Stephens-Timea_Bacsinszky,1,S-XC,4,0,0,0,0,2,2
20190702-W-Wimbledon-R128-Sloane_Stephens-Timea_Bacsinszky,1,S-DTM,4,2,0,0,2,1,3
20190702-W-Wimbledon-R128-Sloane_Stephens-Timea_Bacsinszky,1,S-DTL,1,0,0,0,0,1,0
20190702-W-Wimbledon-R128-Sloane_Stephens-Timea_Bacsinszky,2,F-XC,18,4,0,0,4,5,13
20190702-W-Wimbledon-R128-Sloane_Stephens-Timea_Bacsinszky,2,F-DTM,20,1,0,0,1,6,14
20190702-W-Wimbledon-R128-Sloane_Stephens-Timea_Bacsinszky,2,F-DTL,10,0,0,0,0,5,5
20190702-W-Wimbledon-R128-Sloane_Stephens-Timea_Bacsinszky,2,F-IO,10,0,0,0,0,4,6
20190702-W-Wimbledon-R128-Sloane_Stephens-Timea_Bacsinszky,2,B-XC,39,5,1,2,2,14,25
20190702-W-Wimbledon-R128-Sloane_Stephens-Timea_Bacsinszky,2,B-DTM,25,2,0,2,0,12,13
20190702-W-Wimbledon-R128-Sloane_Stephens-Timea_Bacsinszky,2,B-DTL,7,1,0,0,1,2,5
20190702-W-Wimbledon-R128-Sloane_Stephens-Timea_Bacsinszky,2,B-IO,7,1,0,0,1,1,6
20190702-W-Wimbledon-R128-Sloane_Stephens-Timea_Bacsinszky,2,S-XC,6,1,0,1,0,4,2
20190702-W-Wimbledon-R128-Sloane_Stephens-Timea_Bacsinszky,2,S-DTM,7,1,0,1,0,2,5
20190702-W-Wimbledon-R128-Sloane_Stephens-Timea_Bacsinszky,2,S-DTL,1,0,0,0,0,0,1
20190702-W-Wimbledon-R128-Sloane_Stephens-Timea_Bacsinszky,2,S-IO,1,0,0,0,0,1,0
20190806-W-Toronto-R64-Bianca_Andreescu-Eugenie_Bouchard,1,F-XC,34,11,4,4,3,21,13
20190806-W-Toronto-R64-Bianca_Andreescu-Eugenie_Bouchard,1,F-DTM,25,4,0,1,3,14,11
20190806-W-Toronto-R64-Bianca_Andreescu-Eugenie_Bouchard,1,F-DTL,12,4,2,0,2,6,6
20190806-W-Toronto-R64-Bianca_Andreescu-Eugenie_Bouchard,1,F-IO,15,8,6,1,1,12,3
20190806-W-Toronto-R64-Bianca_Andreescu-Eugenie_Bouchard,1,F-II,1,1,1,0,0,1,0
20190806-W-Toronto-R64-Bianca_Andreescu-Eugenie_Bouchard,1,B-XC,13,4,0,2,2,10,3
20190806-W-Toronto-R64-Bianca_Andreescu-Eugenie_Bouchard,1,B-DTM,7,1,0,1,0,3,4
20190806-W-Toronto-R64-Bianca_Andreescu-Eugenie_Bouchard,1,B-DTL,10,7,3,1,3,6,4
20190806-W-Toronto-R64-Bianca_Andreescu-Eugenie_Bouchard,1,B-IO,5,3,1,0,2,2,3
20190806-W-Toronto-R64-Bianca_Andreescu-Eugenie_Bouchard,1,S-XC,3,2,0,0,2,0,3
20190806-W-Toronto-R64-Bianca_Andreescu-Eugenie_Bouchard,1,S-DTM,7,3,0,0,3,3,4
20190806-W-Toronto-R64-Bianca_Andreescu-Eugenie_Bouchard,1,S-DTL,1,0,0,0,0,1,0
20190806-W-Toronto-R64-Bianca_Andreescu-Eugenie_Bouchard,2,F-XC,39,7,3,1,3,17,22
20190806-W-Toronto-R64-Bianca_Andreescu-Eugenie_Bouchard,2,F-DTM,21,3,0,0,3,7,14
20190806-W-Toronto-R64-Bianca_Andreescu-Eugenie_Bouchard,2,F-DTL,2,0,0,0,0,1,1
20190806-W-Toronto-R64-Bianca_Andreescu-Eugenie_Bouchard,2,F-IO,12,7,1,1,5,4,8
20190806-W-Toronto-R64-Bianca_Andreescu-Eugenie_Bouchard,2,B-XC,30,5,1,1,3,14,16
20190806-W-Toronto-R64-Bianca_Andreescu-Eugenie_Bouchard,2,B-DTM,24,1,0,0,1,7,17
20190806-W-Toronto-R64-Bianca_Andreescu-Eugenie_Bouchard,2,B-DTL,6,2,1,0,1,2,4
20190806-W-Toronto-R64-Bianca_Andreescu-Eugenie_Bouchard,2,B-IO,4,2,0,1,1,1,3
20190806-W-Toronto-R64-Bianca_Andreescu-Eugenie_Bouchard,2,S-XC,1,0,0,0,0,0,1
20190806-W-Toronto-R64-Bianca_Andreescu-Eugenie_Bouchard,2,S-DTM,2,1,0,0,1,1,1
20190807-W-Toronto-R32-Bianca_Andreescu-Daria_Kasatkina,1,F-XC,60,23,10,2,11,33,27
20190807-W-Toronto-R32-Bianca_Andreescu-Daria_Kasatkina,1,F-DTM,47,5,0,0,5,20,27
20190807-W-Toronto-R32-Bianca_Andreescu-Daria_Kasatkina,1,F-DTL,17,5,3,0,2,9,8
20190807-W-Toronto-R32-Bianca_Andreescu-Daria_Kasatkina,1,F-IO,40,13,5,0,8,17,23
20190807-W-Toronto-R32-Bianca_Andreescu-Daria_Kasatkina,1,F-II,6,3,1,0,2,2,4
20190807-W-Toronto-R32-Bianca_Andreescu-Daria_Kasatkina,1,B-XC,50,6,3,1,2,25,25
20190807-W-Toronto-R32-Bianca_Andreescu-Daria_Kasatkina,1,B-DTM,43,2,0,0,2,17,26
20190807-W-Toronto-R32-Bianca_Andreescu-Daria_Kasatkina,1,B-DTL,16,4,3,0,1,10,6
20190807-W-Toronto-R32-Bianca_Andreescu-Daria_Kasatkina,1,B-IO,10,3,1,1,1,3,7
20190807-W-Toronto-R32-Bianca_Andreescu-Daria_Kasatkina,1,S-XC,4,1,0,0,1,2,2
20190807-W-Toronto-R32-Bianca_Andreescu-Daria_Kasatkina,1,S-DTM,7,2,0,0,2,2,5
20190807-W-Toronto-R32-Bianca_Andreescu-Daria_Kasatkina,1,S-DTL,3,1,0,0,1,1,2
20190807-W-Toronto-R32-Bianca_Andreescu-Daria_Kasatkina,1,S-IO,2,0,0,0,0,1,1
20190807-W-Toronto-R32-Bianca_Andreescu-Daria_Kasatkina,2,F-XC,63,17,5,3,9,35,28
20190807-W-Toronto-R32-Bianca_Andreescu-Daria_Kasatkina,2,F-DTM,57,0,0,0,0,31,26
20190807-W-Toronto-R32-Bianca_Andreescu-Daria_Kasatkina,2,F-DTL,16,5,3,1,1,8,8
20190807-W-Toronto-R32-Bianca_Andreescu-Daria_Kasatkina,2,F-IO,68,14,5,3,6,39,29
20190807-W-Toronto-R32-Bianca_Andreescu-Daria_Kasatkina,2,F-II,2,1,0,0,1,0,2
20190807-W-Toronto-R32-Bianca_Andreescu-Daria_Kasatkina,2,B-XC,40,3,1,0,2,22,18
20190807-W-Toronto-R32-Bianca_Andreescu-Daria_Kasatkina,2,B-DTM,40,6,0,0,6,16,24
20190807-W-Toronto-R32-Bianca_Andreescu-Daria_Kasatkina,2,B-DTL,7,5,3,0,2,4,3
20190807-W-Toronto-R32-Bianca_Andreescu-Daria_Kasatkina,2,B-IO,5,2,1,0,1,4,1
20190807-W-Toronto-R32-Bianca_Andreescu-Daria_Kasatkina,2,S-XC,13,1,0,0,1,6,7
20190807-W-Toronto-R32-Bianca_Andreescu-Daria_Kasatkina,2,S-DTM,19,0,0,0,0,9,10
20190807-W-Toronto-R32-Bianca_Andreescu-Daria_Kasatkina,2,S-DTL,4,0,0,0,0,0,4
20190807-W-Toronto-R32-Bianca_Andreescu-Daria_Kasatkina,2,S-IO,1,0,0,0,0,1,0
20190806-W-Toronto-R32-Francesca_Di_Lorenzo-Kiki_Bertens,1,F-XC,27,4,0,0,4,10,17
20190806-W-Toronto-R32-Francesca_Di_Lorenzo-Kiki_Bertens,1,F-DTM,25,2,0,0,2,13,12
20190806-W-Toronto-R32-Francesca_Di_Lorenzo-Kiki_Bertens,1,F-DTL,7,5,3,0,2,3,4
20190806-W-Toronto-R32-Francesca_Di_Lorenzo-Kiki_Bertens,1,F-IO,8,3,1,0,2,3,5
20190806-W-Toronto-R32-Francesca_Di_Lorenzo-Kiki_Bertens,1,F-II,3,0,0,0,0,0,3
20190806-W-Toronto-R32-Francesca_Di_Lorenzo-Kiki_Bertens,1,B-XC,47,8,0,1,7,11,36
20190806-W-Toronto-R32-Francesca_Di_Lorenzo-Kiki_Bertens,1,B-DTM,33,4,0,0,4,13,20
20190806-W-Toronto-R32-Francesca_Di_Lorenzo-Kiki_Bertens,1,B-DTL,5,0,0,0,0,2,3
20190806-W-Toronto-R32-Francesca_Di_Lorenzo-Kiki_Bertens,1,B-IO,2,1,0,0,1,0,2
20190806-W-Toronto-R32-Francesca_Di_Lorenzo-Kiki_Bertens,1,S-XC,1,0,0,0,0,0,1
20190806-W-Toronto-R32-Francesca_Di_Lorenzo-Kiki_Bertens,1,S-DTM,1,0,0,0,0,0,1
20190806-W-Toronto-R32-Francesca_Di_Lorenzo-Kiki_Bertens,2,F-XC,62,6,2,0,4,44,18
20190806-W-Toronto-R32-Francesca_Di_Lorenzo-Kiki_Bertens,2,F-DTM,22,2,0,0,2,12,10
20190806-W-Toronto-R32-Francesca_Di_Lorenzo-Kiki_Bertens,2,F-DTL,7,3,3,0,0,6,1
20190806-W-Toronto-R32-Francesca_Di_Lorenzo-Kiki_Bertens,2,F-IO,16,11,8,2,1,12,4
20190806-W-Toronto-R32-Francesca_Di_Lorenzo-Kiki_Bertens,2,F-II,1,0,0,0,0,0,1
20190806-W-Toronto-R32-Francesca_Di_Lorenzo-Kiki_Bertens,2,B-XC,20,6,1,3,2,16,4
20190806-W-Toronto-R32-Francesca_Di_Lorenzo-Kiki_Bertens,2,B-DTM,18,1,0,0,1,7,11
20190806-W-Toronto-R32-Francesca_Di_Lorenzo-Kiki_Bertens,2,B-DTL,5,2,1,0,1,3,2
20190806-W-Toronto-R32-Francesca_Di_Lorenzo-Kiki_Bertens,2,B-IO,4,1,0,0,1,1,3
20190806-W-Toronto-R32-Francesca_Di_Lorenzo-Kiki_Bertens,2,S-DTM,2,0,0,0,0,1,1
20190806-W-Toronto-R32-Francesca_Di_Lorenzo-Kiki_Bertens,2,S-DTL,2,0,0,0,0,2,0
20190808-W-Toronto-R16-Bianca_Andreescu-Kiki_Bertens,1,F-XC,44,16,4,6,6,27,17
20190808-W-Toronto-R16-Bianca_Andreescu-Kiki_Bertens,1,F-DTM,38,3,0,0,3,18,20
20190808-W-Toronto-R16-Bianca_Andreescu-Kiki_Bertens,1,F-DTL,13,3,0,2,1,12,1
20190808-W-Toronto-R16-Bianca_Andreescu-Kiki_Bertens,1,F-IO,30,8,2,1,5,15,15
20190808-W-Toronto-R16-Bianca_Andreescu-Kiki_Bertens,1,F-II,5,4,1,0,3,1,4
20190808-W-Toronto-R16-Bianca_Andreescu-Kiki_Bertens,1,B-XC,31,6,4,1,1,20,11
20190808-W-Toronto-R16-Bianca_Andreescu-Kiki_Bertens,1,B-DTM,22,1,1,0,0,18,4
20190808-W-Toronto-R16-Bianca_Andreescu-Kiki_Bertens,1,B-DTL,6,3,0,0,3,3,3
20190808-W-Toronto-R16-Bianca_Andreescu-Kiki_Bertens,1,B-IO,6,3,2,0,1,4,2
20190808-W-Toronto-R16-Bianca_Andreescu-Kiki_Bertens,1,S-XC,4,1,0,0,1,2,2
20190808-W-Toronto-R16-Bianca_Andreescu-Kiki_Bertens,1,S-DTM,5,1,0,0,1,2,3
20190808-W-Toronto-R16-Bianca_Andreescu-Kiki_Bertens,1,S-IO,5,1,0,0,1,2,3
20190808-W-Toronto-R16-Bianca_Andreescu-Kiki_Bertens,2,F-XC,47,9,3,0,6,21,26
20190808-W-Toronto-R16-Bianca_Andreescu-Kiki_Bertens,2,F-DTM,43,7,1,0,6,13,30
20190808-W-Toronto-R16-Bianca_Andreescu-Kiki_Bertens,2,F-DTL,7,3,0,0,3,2,5
20190808-W-Toronto-R16-Bianca_Andreescu-Kiki_Bertens,2,F-IO,29,9,2,0,7,12,17
20190808-W-Toronto-R16-Bianca_Andreescu-Kiki_Bertens,2,F-II,2,2,0,1,1,1,1
20190808-W-Toronto-R16-Bianca_Andreescu-Kiki_Bertens,2,B-XC,25,8,2,0,6,10,15
20190808-W-Toronto-R16-Bianca_Andreescu-Kiki_Bertens,2,B-DTM,40,9,1,0,8,15,25
20190808-W-Toronto-R16-Bianca_Andreescu-Kiki_Bertens,2,B-DTL,9,4,0,1,3,4,5
20190808-W-Toronto-R16-Bianca_Andreescu-Kiki_Bertens,2,B-IO,2,2,0,0,2,0,2
20190808-W-Toronto-R16-Bianca_Andreescu-Kiki_Bertens,2,S-XC,1,0,0,0,0,1,0
20190808-W-Toronto-R16-Bianca_Andreescu-Kiki_Bertens,2,S-DTM,10,1,0,0,1,1,9
20190810-W-Toronto-SF-Bianca_Andreescu-Sofia_Kenin,1,F-XC,43,15,6,1,8,23,20
20190810-W-Toronto-SF-Bianca_Andreescu-Sofia_Kenin,1,F-DTM,43,5,0,0,5,21,22
20190810-W-Toronto-SF-Bianca_Andreescu-Sofia_Kenin,1,F-DTL,17,5,3,0,2,10,7
20190810-W-Toronto-SF-Bianca_Andreescu-Sofia_Kenin,1,F-IO,17,7,2,2,3,10,7
20190810-W-Toronto-SF-Bianca_Andreescu-Sofia_Kenin,1,B-XC,22,4,1,0,3,12,10
20190810-W-Toronto-SF-Bianca_Andreescu-Sofia_Kenin,1,B-DTM,30,6,1,0,5,13,17
20190810-W-Toronto-SF-Bianca_Andreescu-Sofia_Kenin,1,B-DTL,6,2,1,0,1,5,1
20190810-W-Toronto-SF-Bianca_Andreescu-Sofia_Kenin,1,B-IO,8,2,2,0,0,4,4
20190810-W-Toronto-SF-Bianca_Andreescu-Sofia_Kenin,1,S-XC,2,2,1,0,1,1,1
20190810-W-Toronto-SF-Bianca_Andreescu-Sofia_Kenin,1,S-DTM,14,0,0,0,0,6,8
20190810-W-Toronto-SF-Bianca_Andreescu-Sofia_Kenin,1,S-DTL,1,0,0,0,0,0,1
20190810-W-Toronto-SF-Bianca_Andreescu-Sofia_Kenin,1,S-IO,5,2,0,0,2,0,5
20190810-W-Toronto-SF-Bianca_Andreescu-Sofia_Kenin,2,F-XC,53,10,6,1,3,27,26
20190810-W-Toronto-SF-Bianca_Andreescu-Sofia_Kenin,2,F-DTM,49,8,0,1,7,24,25
20190810-W-Toronto-SF-Bianca_Andreescu-Sofia_Kenin,2,F-DTL,6,4,1,0,3,2,4
20190810-W-Toronto-SF-Bianca_Andreescu-Sofia_Kenin,2,F-IO,6,4,2,0,2,4,2
20190810-W-Toronto-SF-Bianca_Andreescu-Sofia_Kenin,2,B-XC,44,18,4,3,11,19,25
20190810-W-Toronto-SF-Bianca_Andreescu-Sofia_Kenin,2,B-DTM,42,3,0,0,3,26,16
20190810-W-Toronto-SF-Bianca_Andreescu-Sofia_Kenin,2,B-DTL,2,0,0,0,0,0,2
20190810-W-Toronto-SF-Bianca_Andreescu-Sofia_Kenin,2,B-IO,8,4,2,0,2,3,5
20190810-W-Toronto-SF-Bianca_Andreescu-Sofia_Kenin,2,S-XC,5,2,1,0,1,3,2
20190810-W-Toronto-SF-Bianca_Andreescu-Sofia_Kenin,2,S-DTM,11,0,0,0,0,6,5
20190810-W-Toronto-SF-Bianca_Andreescu-Sofia_Kenin,2,S-DTL,1,1,0,1,0,1,0
20190810-W-Toronto-SF-Bianca_Andreescu-Sofia_Kenin,2,S-IO,1,0,0,0,0,0,1
20190809-W-Toronto-QF-Karolina_Pliskova-Bianca_Andreescu,1,F-XC,36,14,3,3,8,19,17
20190809-W-Toronto-QF-Karolina_Pliskova-Bianca_Andreescu,1,F-DTM,21,4,0,0,4,11,10
20190809-W-Toronto-QF-Karolina_Pliskova-Bianca_Andreescu,1,F-DTL,4,3,0,1,2,2,2
20190809-W-Toronto-QF-Karolina_Pliskova-Bianca_Andreescu,1,F-IO,22,7,3,2,2,14,8
20190809-W-Toronto-QF-Karolina_Pliskova-Bianca_Andreescu,1,F-II,1,0,0,0,0,0,1
20190809-W-Toronto-QF-Karolina_Pliskova-Bianca_Andreescu,1,B-XC,30,7,1,0,6,14,16
20190809-W-Toronto-QF-Karolina_Pliskova-Bianca_Andreescu,1,B-DTM,20,0,0,0,0,14,6
20190809-W-Toronto-QF-Karolina_Pliskova-Bianca_Andreescu,1,B-DTL,3,2,1,0,1,2,1
20190809-W-Toronto-QF-Karolina_Pliskova-Bianca_Andreescu,1,B-IO,9,4,1,0,3,4,5
20190809-W-Toronto-QF-Karolina_Pliskova-Bianca_Andreescu,1,S-XC,3,0,0,0,0,1,2
20190809-W-Toronto-QF-Karolina_Pliskova-Bianca_Andreescu,1,S-DTM,6,1,1,0,0,3,3
20190809-W-Toronto-QF-Karolina_Pliskova-Bianca_Andreescu,2,F-XC,14,5,3,2,0,12,2
20190809-W-Toronto-QF-Karolina_Pliskova-Bianca_Andreescu,2,F-DTM,27,3,0,0,3,11,16
20190809-W-Toronto-QF-Karolina_Pliskova-Bianca_Andreescu,2,F-DTL,7,2,1,0,1,4,3
20190809-W-Toronto-QF-Karolina_Pliskova-Bianca_Andreescu,2,F-IO,13,6,4,1,1,10,3
20190809-W-Toronto-QF-Karolina_Pliskova-Bianca_Andreescu,2,B-XC,19,6,3,1,2,11,8
20190809-W-Toronto-QF-Karolina_Pliskova-Bianca_Andreescu,2,B-DTM,28,4,0,0,4,7,21
20190809-W-Toronto-QF-Karolina_Pliskova-Bianca_Andreescu,2,B-DTL,7,4,3,1,0,5,2
20190809-W-Toronto-QF-Karolina_Pliskova-Bianca_Andreescu,2,B-IO,7,4,0,0,4,2,5
20190809-W-Toronto-QF-Karolina_Pliskova-Bianca_Andreescu,2,S-XC,4,0,0,0,0,1,3
20190809-W-Toronto-QF-Karolina_Pliskova-Bianca_Andreescu,2,S-DTM,16,4,0,0,4,4,12
20190809-W-Toronto-QF-Karolina_Pliskova-Bianca_Andreescu,2,S-IO,3,1,0,0,1,0,3
20190811-W-Toronto-F-Serena_Williams-Bianca_Andreescu,1,F-XC,3,1,0,1,0,1,2
20190811-W-Toronto-F-Serena_Williams-Bianca_Andreescu,1,F-DTM,4,3,0,0,3,0,4
20190811-W-Toronto-F-Serena_Williams-Bianca_Andreescu,1,F-IO,3,1,1,0,0,2,1
20190811-W-Toronto-F-Serena_Williams-Bianca_Andreescu,1,B-XC,7,2,0,0,2,2,5
20190811-W-Toronto-F-Serena_Williams-Bianca_Andreescu,1,B-DTM,4,1,0,0,1,2,2
20190811-W-Toronto-F-Serena_Williams-Bianca_Andreescu,1,B-IO,2,1,1,0,0,2,0
20190811-W-Toronto-F-Serena_Williams-Bianca_Andreescu,2,F-XC,3,1,1,0,0,3,0
20190811-W-Toronto-F-Serena_Williams-Bianca_Andreescu,2,F-DTM,2,0,0,0,0,1,1
20190811-W-Toronto-F-Serena_Williams-Bianca_Andreescu,2,F-IO,1,0,0,0,0,1,0
20190811-W-Toronto-F-Serena_Williams-Bianca_Andreescu,2,B-XC,3,1,0,0,1,2,1
20190811-W-Toronto-F-Serena_Williams-Bianca_Andreescu,2,B-DTM,5,3,0,0,3,1,4
20190811-W-Toronto-F-Serena_Williams-Bianca_Andreescu,2,S-DTM,3,1,0,0,1,1,2
20190805-W-Toronto-R64-Su_Wei_Hsieh-Sofia_Kenin,1,F-XC,30,14,4,4,6,12,18
20190805-W-Toronto-R64-Su_Wei_Hsieh-Sofia_Kenin,1,F-DTM,15,2,1,0,1,7,8
20190805-W-Toronto-R64-Su_Wei_Hsieh-Sofia_Kenin,1,F-DTL,7,4,1,0,3,1,6
20190805-W-Toronto-R64-Su_Wei_Hsieh-Sofia_Kenin,1,F-IO,5,1,0,1,0,3,2
20190805-W-Toronto-R64-Su_Wei_Hsieh-Sofia_Kenin,1,B-XC,24,7,3,0,4,9,15
20190805-W-Toronto-R64-Su_Wei_Hsieh-Sofia_Kenin,1,B-DTM,17,1,0,0,1,7,10
20190805-W-Toronto-R64-Su_Wei_Hsieh-Sofia_Kenin,1,B-DTL,2,1,1,0,0,1,1
20190805-W-Toronto-R64-Su_Wei_Hsieh-Sofia_Kenin,1,B-IO,2,0,0,0,0,0,2
20190805-W-Toronto-R64-Su_Wei_Hsieh-Sofia_Kenin,1,S-DTM,4,0,0,0,0,1,3
20190805-W-Toronto-R64-Su_Wei_Hsieh-Sofia_Kenin,1,S-DTL,1,0,0,0,0,0,1
20190805-W-Toronto-R64-Su_Wei_Hsieh-Sofia_Kenin,1,S-IO,1,0,0,0,0,0,1
20190805-W-Toronto-R64-Su_Wei_Hsieh-Sofia_Kenin,2,F-XC,29,7,2,2,3,20,9
20190805-W-Toronto-R64-Su_Wei_Hsieh-Sofia_Kenin,2,F-DTM,14,2,0,0,2,10,4
20190805-W-Toronto-R64-Su_Wei_Hsieh-Sofia_Kenin,2,F-DTL,7,4,2,0,2,4,3
20190805-W-Toronto-R64-Su_Wei_Hsieh-Sofia_Kenin,2,F-IO,5,1,1,0,0,3,2
20190805-W-Toronto-R64-Su_Wei_Hsieh-Sofia_Kenin,2,F-II,1,1,1,0,0,1,0
20190805-W-Toronto-R64-Su_Wei_Hsieh-Sofia_Kenin,2,B-XC,18,5,0,2,3,10,8
20190805-W-Toronto-R64-Su_Wei_Hsieh-Sofia_Kenin,2,B-DTM,15,1,0,0,1,10,5
20190805-W-Toronto-R64-Su_Wei_Hsieh-Sofia_Kenin,2,B-DTL,8,4,2,0,2,4,4
20190805-W-Toronto-R64-Su_Wei_Hsieh-Sofia_Kenin,2,B-IO,8,4,2,0,2,3,5
20190805-W-Toronto-R64-Su_Wei_Hsieh-Sofia_Kenin,2,S-XC,3,0,0,0,0,3,0
20190805-W-Toronto-R64-Su_Wei_Hsieh-Sofia_Kenin,2,S-DTM,6,1,0,1,0,2,4
20190813-W-Cincinnati-R64-Venus_Williams-Kiki_Bertens,1,F-XC,43,8,1,3,4,23,20
20190813-W-Cincinnati-R64-Venus_Williams-Kiki_Bertens,1,F-DTM,28,2,0,0,2,7,21
20190813-W-Cincinnati-R64-Venus_Williams-Kiki_Bertens,1,F-DTL,18,4,3,0,1,11,7
20190813-W-Cincinnati-R64-Venus_Williams-Kiki_Bertens,1,F-IO,47,10,4,4,2,34,13
20190813-W-Cincinnati-R64-Venus_Williams-Kiki_Bertens,1,F-II,1,1,0,1,0,1,0
20190813-W-Cincinnati-R64-Venus_Williams-Kiki_Bertens,1,B-XC,64,13,2,0,11,36,28
20190813-W-Cincinnati-R64-Venus_Williams-Kiki_Bertens,1,B-DTM,22,2,0,0,2,13,9
20190813-W-Cincinnati-R64-Venus_Williams-Kiki_Bertens,1,B-DTL,4,2,0,1,1,2,2
20190813-W-Cincinnati-R64-Venus_Williams-Kiki_Bertens,1,B-IO,4,2,1,0,1,3,1
20190813-W-Cincinnati-R64-Venus_Williams-Kiki_Bertens,1,S-XC,7,0,0,0,0,3,4
20190813-W-Cincinnati-R64-Venus_Williams-Kiki_Bertens,1,S-DTM,1,0,0,0,0,1,0
20190813-W-Cincinnati-R64-Venus_Williams-Kiki_Bertens,1,S-DTL,1,0,0,0,0,1,0
20190813-W-Cincinnati-R64-Venus_Williams-Kiki_Bertens,2,F-XC,44,11,3,3,5,24,20
20190813-W-Cincinnati-R64-Venus_Williams-Kiki_Bertens,2,F-DTM,28,3,1,0,2,12,16
20190813-W-Cincinnati-R64-Venus_Williams-Kiki_Bertens,2,F-DTL,5,1,0,0,1,2,3
20190813-W-Cincinnati-R64-Venus_Williams-Kiki_Bertens,2,F-IO,19,9,4,1,4,8,11
20190813-W-Cincinnati-R64-Venus_Williams-Kiki_Bertens,2,B-XC,60,14,3,1,10,24,36
20190813-W-Cincinnati-R64-Venus_Williams-Kiki_Bertens,2,B-DTM,40,3,0,0,3,13,27
20190813-W-Cincinnati-R64-Venus_Williams-Kiki_Bertens,2,B-DTL,15,6,2,0,4,5,10
20190813-W-Cincinnati-R64-Venus_Williams-Kiki_Bertens,2,B-IO,3,1,1,0,0,1,2
20190813-W-Cincinnati-R64-Venus_Williams-Kiki_Bertens,2,S-XC,12,0,0,0,0,6,6
20190813-W-Cincinnati-R64-Venus_Williams-Kiki_Bertens,2,S-DTM,10,0,0,0,0,3,7
20190813-W-Cincinnati-R64-Venus_Williams-Kiki_Bertens,2,S-DTL,2,0,0,0,0,0,2
20190813-W-Cincinnati-R64-Venus_Williams-Kiki_Bertens,2,S-IO,1,1,1,0,0,1,0
20190731-W-Washington-R16-Lauren_Davis-Sofia_Kenin,1,F-XC,32,12,7,1,4,22,10
20190731-W-Washington-R16-Lauren_Davis-Sofia_Kenin,1,F-DTM,42,5,0,0,5,18,24
20190731-W-Washington-R16-Lauren_Davis-Sofia_Kenin,1,F-DTL,23,5,2,2,1,15,8
20190731-W-Washington-R16-Lauren_Davis-Sofia_Kenin,1,F-IO,16,7,3,0,4,9,7
20190731-W-Washington-R16-Lauren_Davis-Sofia_Kenin,1,B-XC,16,7,2,1,4,8,8
20190731-W-Washington-R16-Lauren_Davis-Sofia_Kenin,1,B-DTM,29,3,0,0,3,15,14
20190731-W-Washington-R16-Lauren_Davis-Sofia_Kenin,1,B-DTL,7,3,1,0,2,3,4
20190731-W-Washington-R16-Lauren_Davis-Sofia_Kenin,1,B-IO,9,4,2,1,1,6,3
20190731-W-Washington-R16-Lauren_Davis-Sofia_Kenin,1,S-XC,3,0,0,0,0,2,1
20190731-W-Washington-R16-Lauren_Davis-Sofia_Kenin,1,S-DTM,16,1,0,0,1,11,5
20190731-W-Washington-R16-Lauren_Davis-Sofia_Kenin,1,S-DTL,3,0,0,0,0,1,2
20190731-W-Washington-R16-Lauren_Davis-Sofia_Kenin,1,S-IO,3,0,0,0,0,2,1
20190731-W-Washington-R16-Lauren_Davis-Sofia_Kenin,2,F-XC,82,28,12,3,13,33,49
20190731-W-Washington-R16-Lauren_Davis-Sofia_Kenin,2,F-DTM,27,3,0,0,3,9,18
20190731-W-Washington-R16-Lauren_Davis-Sofia_Kenin,2,F-DTL,8,5,2,2,1,4,4
20190731-W-Washington-R16-Lauren_Davis-Sofia_Kenin,2,F-IO,13,5,1,2,2,8,5
20190731-W-Washington-R16-Lauren_Davis-Sofia_Kenin,2,B-XC,35,10,2,2,6,13,22
20190731-W-Washington-R16-Lauren_Davis-Sofia_Kenin,2,B-DTM,29,6,0,1,5,10,19
20190731-W-Washington-R16-Lauren_Davis-Sofia_Kenin,2,B-DTL,4,2,0,2,0,2,2
20190731-W-Washington-R16-Lauren_Davis-Sofia_Kenin,2,B-IO,15,3,0,0,3,8,7
20190731-W-Washington-R16-Lauren_Davis-Sofia_Kenin,2,S-XC,2,0,0,0,0,1,1
20190731-W-Washington-R16-Lauren_Davis-Sofia_Kenin,2,S-DTM,2,0,0,0,0,2,0
20190731-W-Washington-R16-Lauren_Davis-Sofia_Kenin,2,S-IO,2,0,0,0,0,1,1
20190817-W-Cincinnati-SF-Madison_Keys-Sofia_Kenin,1,F-XC,17,7,4,0,3,11,6
20190817-W-Cincinnati-SF-Madison_Keys-Sofia_Kenin,1,F-DTM,17,6,0,1,5,6,11
20190817-W-Cincinnati-SF-Madison_Keys-Sofia_Kenin,1,F-DTL,5,5,1,0,4,1,4
20190817-W-Cincinnati-SF-Madison_Keys-Sofia_Kenin,1,F-IO,8,2,1,0,1,4,4
20190817-W-Cincinnati-SF-Madison_Keys-Sofia_Kenin,1,B-XC,8,4,2,1,1,5,3
20190817-W-Cincinnati-SF-Madison_Keys-Sofia_Kenin,1,B-DTM,19,3,0,0,3,7,12
20190817-W-Cincinnati-SF-Madison_Keys-Sofia_Kenin,1,B-DTL,11,6,4,1,1,8,3
20190817-W-Cincinnati-SF-Madison_Keys-Sofia_Kenin,1,B-IO,5,2,2,0,0,5,0
20190817-W-Cincinnati-SF-Madison_Keys-Sofia_Kenin,1,S-XC,5,2,1,0,1,1,4
20190817-W-Cincinnati-SF-Madison_Keys-Sofia_Kenin,1,S-DTM,3,0,0,0,0,2,1
20190817-W-Cincinnati-SF-Madison_Keys-Sofia_Kenin,2,F-XC,30,9,3,0,6,16,14
20190817-W-Cincinnati-SF-Madison_Keys-Sofia_Kenin,2,F-DTM,16,4,0,0,4,7,9
20190817-W-Cincinnati-SF-Madison_Keys-Sofia_Kenin,2,F-DTL,5,1,1,0,0,3,2
20190817-W-Cincinnati-SF-Madison_Keys-Sofia_Kenin,2,F-IO,3,2,1,0,1,1,2
20190817-W-Cincinnati-SF-Madison_Keys-Sofia_Kenin,2,F-II,1,1,0,0,1,0,1
20190817-W-Cincinnati-SF-Madison_Keys-Sofia_Kenin,2,B-XC,21,2,2,0,0,10,11
20190817-W-Cincinnati-SF-Madison_Keys-Sofia_Kenin,2,B-DTM,8,1,1,0,0,5,3
20190817-W-Cincinnati-SF-Madison_Keys-Sofia_Kenin,2,B-DTL,2,2,0,2,0,2,0
20190817-W-Cincinnati-SF-Madison_Keys-Sofia_Kenin,2,B-IO,5,3,1,0,2,1,4
20190817-W-Cincinnati-SF-Madison_Keys-Sofia_Kenin,2,S-XC,3,0,0,0,0,2,1
20190817-W-Cincinnati-SF-Madison_Keys-Sofia_Kenin,2,S-DTM,2,0,0,0,0,1,1
20190107-W-Sydney-R32-Kiki_Bertens-Bernarda_Pera,1,F-XC,39,7,2,3,2,20,19
20190107-W-Sydney-R32-Kiki_Bertens-Bernarda_Pera,1,F-DTM,33,6,0,1,5,11,22
20190107-W-Sydney-R32-Kiki_Bertens-Bernarda_Pera,1,F-DTL,9,3,2,0,1,5,4
20190107-W-Sydney-R32-Kiki_Bertens-Bernarda_Pera,1,F-IO,12,5,3,1,1,9,3
20190107-W-Sydney-R32-Kiki_Bertens-Bernarda_Pera,1,B-XC,18,2,0,1,1,13,5
20190107-W-Sydney-R32-Kiki_Bertens-Bernarda_Pera,1,B-DTM,29,5,0,1,4,12,17
20190107-W-Sydney-R32-Kiki_Bertens-Bernarda_Pera,1,B-DTL,10,2,0,2,0,6,4
20190107-W-Sydney-R32-Kiki_Bertens-Bernarda_Pera,1,B-IO,3,0,0,0,0,0,3
20190107-W-Sydney-R32-Kiki_Bertens-Bernarda_Pera,1,S-XC,8,0,0,0,0,3,5
20190107-W-Sydney-R32-Kiki_Bertens-Bernarda_Pera,1,S-DTM,6,0,0,0,0,2,4
20190107-W-Sydney-R32-Kiki_Bertens-Bernarda_Pera,1,S-DTL,1,0,0,0,0,1,0
20190107-W-Sydney-R32-Kiki_Bertens-Bernarda_Pera,2,F-XC,49,18,7,4,7,28,21
20190107-W-Sydney-R32-Kiki_Bertens-Bernarda_Pera,2,F-DTM,33,3,0,0,3,11,22
20190107-W-Sydney-R32-Kiki_Bertens-Bernarda_Pera,2,F-DTL,12,6,4,0,2,6,6
20190107-W-Sydney-R32-Kiki_Bertens-Bernarda_Pera,2,F-IO,19,11,6,1,4,10,9
20190107-W-Sydney-R32-Kiki_Bertens-Bernarda_Pera,2,F-II,1,0,0,0,0,1,0
20190107-W-Sydney-R32-Kiki_Bertens-Bernarda_Pera,2,B-XC,42,8,5,3,0,32,10
20190107-W-Sydney-R32-Kiki_Bertens-Bernarda_Pera,2,B-DTM,21,4,0,0,4,10,11
20190107-W-Sydney-R32-Kiki_Bertens-Bernarda_Pera,2,B-DTL,7,2,0,0,2,2,5
20190107-W-Sydney-R32-Kiki_Bertens-Bernarda_Pera,2,B-IO,7,4,1,1,2,3,4
20190107-W-Sydney-R32-Kiki_Bertens-Bernarda_Pera,2,S-DTM,2,0,0,0,0,1,1
20190107-W-Sydney-R32-Kiki_Bertens-Bernarda_Pera,2,S-DTL,3,0,0,0,0,1,2
20190107-W-Sydney-R32-Kiki_Bertens-Bernarda_Pera,2,S-IO,2,0,0,0,0,2,0
20170120-W-Australian_Open-R32-Ashleigh_Barty-Mona_Barthel,1,F-XC,52,16,5,5,6,30,22
20170120-W-Australian_Open-R32-Ashleigh_Barty-Mona_Barthel,1,F-DTM,11,2,0,0,2,5,6
20170120-W-Australian_Open-R32-Ashleigh_Barty-Mona_Barthel,1,F-DTL,5,3,1,1,1,4,1
20170120-W-Australian_Open-R32-Ashleigh_Barty-Mona_Barthel,1,F-IO,17,9,4,2,3,8,9
20170120-W-Australian_Open-R32-Ashleigh_Barty-Mona_Barthel,1,F-II,6,6,1,3,2,4,2
20170120-W-Australian_Open-R32-Ashleigh_Barty-Mona_Barthel,1,B-XC,23,6,1,4,1,15,8
20170120-W-Australian_Open-R32-Ashleigh_Barty-Mona_Barthel,1,B-DTM,23,7,1,1,5,8,15
20170120-W-Australian_Open-R32-Ashleigh_Barty-Mona_Barthel,1,B-DTL,7,5,1,1,3,2,5
20170120-W-Australian_Open-R32-Ashleigh_Barty-Mona_Barthel,1,B-IO,3,0,0,0,0,1,2
20170120-W-Australian_Open-R32-Ashleigh_Barty-Mona_Barthel,1,S-XC,12,2,0,0,2,3,9
20170120-W-Australian_Open-R32-Ashleigh_Barty-Mona_Barthel,1,S-DTM,8,1,0,0,1,2,6
20170120-W-Australian_Open-R32-Ashleigh_Barty-Mona_Barthel,1,S-DTL,4,1,0,0,1,2,2
20170120-W-Australian_Open-R32-Ashleigh_Barty-Mona_Barthel,1,S-IO,1,1,0,0,1,0,1
20170120-W-Australian_Open-R32-Ashleigh_Barty-Mona_Barthel,2,F-XC,24,9,5,1,3,14,10
20170120-W-Australian_Open-R32-Ashleigh_Barty-Mona_Barthel,2,F-DTM,21,0,0,0,0,14,7
20170120-W-Australian_Open-R32-Ashleigh_Barty-Mona_Barthel,2,F-DTL,20,9,1,3,5,11,9
20170120-W-Australian_Open-R32-Ashleigh_Barty-Mona_Barthel,2,F-IO,10,2,1,1,0,6,4
20170120-W-Australian_Open-R32-Ashleigh_Barty-Mona_Barthel,2,B-XC,30,4,2,2,0,20,10
20170120-W-Australian_Open-R32-Ashleigh_Barty-Mona_Barthel,2,B-DTM,25,1,0,0,1,10,15
20170120-W-Australian_Open-R32-Ashleigh_Barty-Mona_Barthel,2,B-DTL,13,5,4,1,0,10,3
20170120-W-Australian_Open-R32-Ashleigh_Barty-Mona_Barthel,2,B-IO,9,4,0,4,0,7,2
20170120-W-Australian_Open-R32-Ashleigh_Barty-Mona_Barthel,2,S-XC,3,0,0,0,0,1,2
20170120-W-Australian_Open-R32-Ashleigh_Barty-Mona_Barthel,2,S-DTM,2,0,0,0,0,0,2
20170120-W-Australian_Open-R32-Ashleigh_Barty-Mona_Barthel,2,S-DTL,3,0,0,0,0,1,2
20190101-W-Auckland-R32-Venus_Williams-Victoria_Azarenka,1,F-XC,48,9,2,5,2,26,22
20190101-W-Auckland-R32-Venus_Williams-Victoria_Azarenka,1,F-DTM,12,1,0,0,1,8,4
20190101-W-Auckland-R32-Venus_Williams-Victoria_Azarenka,1,F-DTL,10,3,0,2,1,5,5
20190101-W-Auckland-R32-Venus_Williams-Victoria_Azarenka,1,F-IO,14,6,4,1,1,10,4
20190101-W-Auckland-R32-Venus_Williams-Victoria_Azarenka,1,F-II,1,1,0,1,0,1,0
20190101-W-Auckland-R32-Venus_Williams-Victoria_Azarenka,1,B-XC,52,11,1,1,9,14,38
20190101-W-Auckland-R32-Venus_Williams-Victoria_Azarenka,1,B-DTM,20,0,0,0,0,9,11
20190101-W-Auckland-R32-Venus_Williams-Victoria_Azarenka,1,B-DTL,15,5,1,2,2,8,7
20190101-W-Auckland-R32-Venus_Williams-Victoria_Azarenka,1,B-IO,3,1,0,0,1,2,1
20190101-W-Auckland-R32-Venus_Williams-Victoria_Azarenka,1,S-XC,2,0,0,0,0,2,0
20190101-W-Auckland-R32-Venus_Williams-Victoria_Azarenka,1,S-DTM,2,0,0,0,0,0,2
20190101-W-Auckland-R32-Venus_Williams-Victoria_Azarenka,1,S-DTL,6,1,0,0,1,0,6
20190101-W-Auckland-R32-Venus_Williams-Victoria_Azarenka,2,F-XC,50,18,6,2,10,20,30
20190101-W-Auckland-R32-Venus_Williams-Victoria_Azarenka,2,F-DTM,18,1,0,0,1,8,10
20190101-W-Auckland-R32-Venus_Williams-Victoria_Azarenka,2,F-DTL,34,13,6,0,7,18,16
20190101-W-Auckland-R32-Venus_Williams-Victoria_Azarenka,2,F-IO,14,10,2,1,7,6,8
20190101-W-Auckland-R32-Venus_Williams-Victoria_Azarenka,2,B-XC,36,8,2,4,2,29,7
20190101-W-Auckland-R32-Venus_Williams-Victoria_Azarenka,2,B-DTM,10,1,0,0,1,5,5
20190101-W-Auckland-R32-Venus_Williams-Victoria_Azarenka,2,B-DTL,16,9,2,5,2,10,6
20190101-W-Auckland-R32-Venus_Williams-Victoria_Azarenka,2,B-IO,8,3,3,0,0,5,3
20190101-W-Auckland-R32-Venus_Williams-Victoria_Azarenka,2,S-XC,4,0,0,0,0,1,3
20190101-W-Auckland-R32-Venus_Williams-Victoria_Azarenka,2,S-DTM,5,0,0,0,0,2,3
20190101-W-Auckland-R32-Venus_Williams-Victoria_Azarenka,2,S-DTL,1,0,0,0,0,0,1
20190801-W-Washington-R16-Christina_Mchale-Caty_Mcnally,1,F-XC,27,9,2,4,3,12,15
20190801-W-Washington-R16-Christina_Mchale-Caty_Mcnally,1,F-DTM,29,1,0,0,1,18,11
20190801-W-Washington-R16-Christina_Mchale-Caty_Mcnally,1,F-DTL,12,5,1,0,4,2,10
20190801-W-Washington-R16-Christina_Mchale-Caty_Mcnally,1,F-IO,20,8,3,1,4,13,7
20190801-W-Washington-R16-Christina_Mchale-Caty_Mcnally,1,F-II,1,0,0,0,0,1,0
20190801-W-Washington-R16-Christina_Mchale-Caty_Mcnally,1,B-XC,19,4,0,0,4,7,12
20190801-W-Washington-R16-Christina_Mchale-Caty_Mcnally,1,B-DTM,23,3,0,1,2,9,14
20190801-W-Washington-R16-Christina_Mchale-Caty_Mcnally,1,B-DTL,9,7,4,0,3,4,5
20190801-W-Washington-R16-Christina_Mchale-Caty_Mcnally,1,B-IO,14,6,1,2,3,6,8
20190801-W-Washington-R16-Christina_Mchale-Caty_Mcnally,1,S-XC,2,0,0,0,0,1,1
20190801-W-Washington-R16-Christina_Mchale-Caty_Mcnally,1,S-DTM,4,0,0,0,0,2,2
20190801-W-Washington-R16-Christina_Mchale-Caty_Mcnally,1,S-DTL,2,0,0,0,0,1,1
20190801-W-Washington-R16-Christina_Mchale-Caty_Mcnally,1,S-IO,1,0,0,0,0,0,1
20190801-W-Washington-R16-Christina_Mchale-Caty_Mcnally,2,F-XC,27,6,2,2,2,19,8
20190801-W-Washington-R16-Christina_Mchale-Caty_Mcnally,2,F-DTM,35,6,0,1,5,10,25
20190801-W-Washington-R16-Christina_Mchale-Caty_Mcnally,2,F-DTL,4,2,1,1,0,2,2
20190801-W-Washington-R16-Christina_Mchale-Caty_Mcnally,2,F-IO,23,9,0,1,8,9,14
20190801-W-Washington-R16-Christina_Mchale-Caty_Mcnally,2,B-XC,17,5,1,1,3,8,9
20190801-W-Washington-R16-Christina_Mchale-Caty_Mcnally,2,B-DTM,15,3,0,1,2,7,8
20190801-W-Washington-R16-Christina_Mchale-Caty_Mcnally,2,B-DTL,9,4,0,1,3,3,6
20190801-W-Washington-R16-Christina_Mchale-Caty_Mcnally,2,B-IO,2,0,0,0,0,1,1
20190801-W-Washington-R16-Christina_Mchale-Caty_Mcnally,2,S-XC,6,2,0,1,1,4,2
20190801-W-Washington-R16-Christina_Mchale-Caty_Mcnally,2,S-DTM,8,0,0,0,0,3,5
20190801-W-Washington-R16-Christina_Mchale-Caty_Mcnally,2,S-DTL,3,1,1,0,0,3,0
20190801-W-Washington-R16-Christina_Mchale-Caty_Mcnally,2,S-IO,1,0,0,0,0,0,1
20190827-W-US_Open-R128-Katie_Volynets-Bianca_Andreescu,1,F-XC,59,9,3,1,5,26,33
20190827-W-US_Open-R128-Katie_Volynets-Bianca_Andreescu,1,F-DTM,45,3,0,0,3,25,20
20190827-W-US_Open-R128-Katie_Volynets-Bianca_Andreescu,1,F-DTL,7,2,0,0,2,3,4
20190827-W-US_Open-R128-Katie_Volynets-Bianca_Andreescu,1,F-IO,12,0,0,0,0,6,6
20190827-W-US_Open-R128-Katie_Volynets-Bianca_Andreescu,1,F-II,1,0,0,0,0,1,0
20190827-W-US_Open-R128-Katie_Volynets-Bianca_Andreescu,1,B-XC,23,2,1,0,1,14,9
20190827-W-US_Open-R128-Katie_Volynets-Bianca_Andreescu,1,B-DTM,32,0,0,0,0,12,20
20190827-W-US_Open-R128-Katie_Volynets-Bianca_Andreescu,1,B-DTL,11,4,0,1,3,7,4
20190827-W-US_Open-R128-Katie_Volynets-Bianca_Andreescu,1,B-IO,1,0,0,0,0,0,1
20190827-W-US_Open-R128-Katie_Volynets-Bianca_Andreescu,1,S-XC,2,0,0,0,0,0,2
20190827-W-US_Open-R128-Katie_Volynets-Bianca_Andreescu,1,S-DTM,5,2,0,0,2,0,5
20190827-W-US_Open-R128-Katie_Volynets-Bianca_Andreescu,1,S-DTL,2,0,0,0,0,1,1
20190827-W-US_Open-R128-Katie_Volynets-Bianca_Andreescu,2,F-XC,58,20,8,4,8,35,23
20190827-W-US_Open-R128-Katie_Volynets-Bianca_Andreescu,2,F-DTM,25,1,0,0,1,10,15
20190827-W-US_Open-R128-Katie_Volynets-Bianca_Andreescu,2,F-DTL,21,6,1,0,5,8,13
20190827-W-US_Open-R128-Katie_Volynets-Bianca_Andreescu,2,F-IO,24,7,1,2,4,12,12
20190827-W-US_Open-R128-Katie_Volynets-Bianca_Andreescu,2,F-II,1,1,0,0,1,0,1
20190827-W-US_Open-R128-Katie_Volynets-Bianca_Andreescu,2,B-XC,27,8,4,2,2,18,9
20190827-W-US_Open-R128-Katie_Volynets-Bianca_Andreescu,2,B-DTM,17,0,0,0,0,8,9
20190827-W-US_Open-R128-Katie_Volynets-Bianca_Andreescu,2,B-DTL,7,3,0,0,3,3,4
20190827-W-US_Open-R128-Katie_Volynets-Bianca_Andreescu,2,B-IO,2,1,1,0,0,1,1
20190827-W-US_Open-R128-Katie_Volynets-Bianca_Andreescu,2,S-XC,3,0,0,0,0,2,1
20190827-W-US_Open-R128-Katie_Volynets-Bianca_Andreescu,2,S-DTM,8,1,0,0,1,2,6
20190827-W-US_Open-R128-Katie_Volynets-Bianca_Andreescu,2,S-DTL,3,1,0,1,0,1,2
20190827-W-US_Open-R128-Katie_Volynets-Bianca_Andreescu,2,S-IO,1,0,0,0,0,1,0
20190827-W-US_Open-R128-Paula_Badosa-Kiki_Bertens,1,F-XC,26,4,0,1,3,8,18
20190827-W-US_Open-R128-Paula_Badosa-Kiki_Bertens,1,F-DTM,30,3,0,0,3,8,22
20190827-W-US_Open-R128-Paula_Badosa-Kiki_Bertens,1,F-DTL,8,3,2,0,1,5,3
20190827-W-US_Open-R128-Paula_Badosa-Kiki_Bertens,1,F-IO,26,6,1,1,4,11,15
20190827-W-US_Open-R128-Paula_Badosa-Kiki_Bertens,1,F-II,3,1,0,1,0,2,1
20190827-W-US_Open-R128-Paula_Badosa-Kiki_Bertens,1,B-XC,26,6,0,2,4,7,19
20190827-W-US_Open-R128-Paula_Badosa-Kiki_Bertens,1,B-DTM,23,0,0,0,0,7,16
20190827-W-US_Open-R128-Paula_Badosa-Kiki_Bertens,1,B-DTL,11,4,2,1,1,5,6
20190827-W-US_Open-R128-Paula_Badosa-Kiki_Bertens,1,B-IO,8,4,1,2,1,4,4
20190827-W-US_Open-R128-Paula_Badosa-Kiki_Bertens,1,S-XC,2,0,0,0,0,2,0
20190827-W-US_Open-R128-Paula_Badosa-Kiki_Bertens,1,S-DTM,2,0,0,0,0,1,1
20190827-W-US_Open-R128-Paula_Badosa-Kiki_Bertens,2,F-XC,36,9,7,1,1,30,6
20190827-W-US_Open-R128-Paula_Badosa-Kiki_Bertens,2,F-DTM,18,2,1,0,1,11,7
20190827-W-US_Open-R128-Paula_Badosa-Kiki_Bertens,2,F-DTL,5,1,0,1,0,5,0
20190827-W-US_Open-R128-Paula_Badosa-Kiki_Bertens,2,F-IO,11,4,1,2,1,8,3
20190827-W-US_Open-R128-Paula_Badosa-Kiki_Bertens,2,F-II,2,2,0,2,0,2,0
20190827-W-US_Open-R128-Paula_Badosa-Kiki_Bertens,2,B-XC,34,7,1,1,5,19,15
20190827-W-US_Open-R128-Paula_Badosa-Kiki_Bertens,2,B-DTM,31,1,0,0,1,22,9
20190827-W-US_Open-R128-Paula_Badosa-Kiki_Bertens,2,B-DTL,2,2,1,1,0,2,0
20190827-W-US_Open-R128-Paula_Badosa-Kiki_Bertens,2,B-IO,3,2,2,0,0,3,0
20190827-W-US_Open-R128-Paula_Badosa-Kiki_Bertens,2,S-XC,7,1,0,0,1,2,5
20190827-W-US_Open-R128-Paula_Badosa-Kiki_Bertens,2,S-DTM,5,1,0,0,1,3,2
20190827-W-US_Open-R128-Donna_Vekic-Richel_Hogenkamp,1,F-XC,31,10,5,0,5,15,16
20190827-W-US_Open-R128-Donna_Vekic-Richel_Hogenkamp,1,F-DTM,28,4,1,0,3,12,16
20190827-W-US_Open-R128-Donna_Vekic-Richel_Hogenkamp,1,F-DTL,8,2,1,0,1,3,5
20190827-W-US_Open-R128-Donna_Vekic-Richel_Hogenkamp,1,F-IO,38,20,6,7,7,19,19
20190827-W-US_Open-R128-Donna_Vekic-Richel_Hogenkamp,1,F-II,1,0,0,0,0,0,1
20190827-W-US_Open-R128-Donna_Vekic-Richel_Hogenkamp,1,B-XC,32,2,2,0,0,10,22
20190827-W-US_Open-R128-Donna_Vekic-Richel_Hogenkamp,1,B-DTM,33,4,0,0,4,14,19
20190827-W-US_Open-R128-Donna_Vekic-Richel_Hogenkamp,1,B-DTL,13,6,3,1,2,8,5
20190827-W-US_Open-R128-Donna_Vekic-Richel_Hogenkamp,1,B-IO,5,3,0,2,1,2,3
20190827-W-US_Open-R128-Donna_Vekic-Richel_Hogenkamp,1,S-DTM,2,0,0,0,0,1,1
20190827-W-US_Open-R128-Donna_Vekic-Richel_Hogenkamp,1,S-DTL,2,0,0,0,0,0,2
20190827-W-US_Open-R128-Donna_Vekic-Richel_Hogenkamp,1,S-IO,1,0,0,0,0,0,1
20190827-W-US_Open-R128-Donna_Vekic-Richel_Hogenkamp,2,F-XC,28,6,1,1,4,13,15
20190827-W-US_Open-R128-Donna_Vekic-Richel_Hogenkamp,2,F-DTM,26,2,0,0,2,16,10
20190827-W-US_Open-R128-Donna_Vekic-Richel_Hogenkamp,2,F-DTL,19,5,1,2,2,8,11
20190827-W-US_Open-R128-Donna_Vekic-Richel_Hogenkamp,2,F-IO,27,11,3,0,8,15,12
20190827-W-US_Open-R128-Donna_Vekic-Richel_Hogenkamp,2,F-II,1,1,1,0,0,1,0
20190827-W-US_Open-R128-Donna_Vekic-Richel_Hogenkamp,2,B-XC,11,1,0,0,1,7,4
20190827-W-US_Open-R128-Donna_Vekic-Richel_Hogenkamp,2,B-DTM,13,0,0,0,0,11,2
20190827-W-US_Open-R128-Donna_Vekic-Richel_Hogenkamp,2,B-DTL,11,7,3,0,4,6,5
20190827-W-US_Open-R128-Donna_Vekic-Richel_Hogenkamp,2,B-IO,8,5,2,1,2,3,5
20190827-W-US_Open-R128-Donna_Vekic-Richel_Hogenkamp,2,S-XC,18,1,0,0,1,9,9
20190827-W-US_Open-R128-Donna_Vekic-Richel_Hogenkamp,2,S-DTM,26,0,0,0,0,17,9
20190827-W-US_Open-R128-Donna_Vekic-Richel_Hogenkamp,2,S-DTL,8,3,0,2,1,4,4
20190827-W-US_Open-R128-Donna_Vekic-Richel_Hogenkamp,2,S-IO,4,0,0,0,0,1,3
20190826-W-US_Open-R128-Angelique_Kerber-Kristina_Mladenovic,1,F-XC,70,4,1,1,2,26,44
20190826-W-US_Open-R128-Angelique_Kerber-Kristina_Mladenovic,1,F-DTM,16,0,0,0,0,10,6
20190826-W-US_Open-R128-Angelique_Kerber-Kristina_Mladenovic,1,F-DTL,20,13,9,2,2,14,6
20190826-W-US_Open-R128-Angelique_Kerber-Kristina_Mladenovic,1,F-IO,31,11,8,2,1,17,14
20190826-W-US_Open-R128-Angelique_Kerber-Kristina_Mladenovic,1,F-II,6,2,1,1,0,5,1
20190826-W-US_Open-R128-Angelique_Kerber-Kristina_Mladenovic,1,B-XC,75,11,4,0,7,29,46
20190826-W-US_Open-R128-Angelique_Kerber-Kristina_Mladenovic,1,B-DTM,37,1,0,0,1,13,24
20190826-W-US_Open-R128-Angelique_Kerber-Kristina_Mladenovic,1,B-DTL,27,10,5,1,4,13,14
20190826-W-US_Open-R128-Angelique_Kerber-Kristina_Mladenovic,1,B-IO,12,2,0,0,2,7,5
20190826-W-US_Open-R128-Angelique_Kerber-Kristina_Mladenovic,1,S-XC,4,1,1,0,0,2,2
20190826-W-US_Open-R128-Angelique_Kerber-Kristina_Mladenovic,1,S-DTM,9,0,0,0,0,4,5
20190826-W-US_Open-R128-Angelique_Kerber-Kristina_Mladenovic,1,S-DTL,13,1,0,1,0,4,9
20190826-W-US_Open-R128-Angelique_Kerber-Kristina_Mladenovic,1,S-IO,2,0,0,0,0,1,1
20190826-W-US_Open-R128-Angelique_Kerber-Kristina_Mladenovic,2,F-XC,90,19,10,4,5,62,28
20190826-W-US_Open-R128-Angelique_Kerber-Kristina_Mladenovic,2,F-DTM,19,1,0,0,1,12,7
20190826-W-US_Open-R128-Angelique_Kerber-Kristina_Mladenovic,2,F-DTL,22,13,6,1,6,13,9
20190826-W-US_Open-R128-Angelique_Kerber-Kristina_Mladenovic,2,F-IO,46,16,7,5,4,30,16
20190826-W-US_Open-R128-Angelique_Kerber-Kristina_Mladenovic,2,F-II,7,5,3,1,1,6,1
20190826-W-US_Open-R128-Angelique_Kerber-Kristina_Mladenovic,2,B-XC,43,14,3,2,9,18,25
20190826-W-US_Open-R128-Angelique_Kerber-Kristina_Mladenovic,2,B-DTM,30,1,0,1,0,15,15
20190826-W-US_Open-R128-Angelique_Kerber-Kristina_Mladenovic,2,B-DTL,31,4,2,1,1,17,14
20190826-W-US_Open-R128-Angelique_Kerber-Kristina_Mladenovic,2,B-IO,15,3,0,0,3,8,7
20190826-W-US_Open-R128-Angelique_Kerber-Kristina_Mladenovic,2,B-II,1,0,0,0,0,1,0
20190826-W-US_Open-R128-Angelique_Kerber-Kristina_Mladenovic,2,S-XC,9,2,0,2,0,6,3
20190826-W-US_Open-R128-Angelique_Kerber-Kristina_Mladenovic,2,S-DTM,1,0,0,0,0,1,0
20190826-W-US_Open-R128-Angelique_Kerber-Kristina_Mladenovic,2,S-DTL,10,1,0,1,0,7,3
20190826-W-US_Open-R128-Angelique_Kerber-Kristina_Mladenovic,2,S-IO,5,0,0,0,0,3,2
20190826-W-US_Open-R128-Serena_Williams-Maria_Sharapova,1,F-XC,25,6,1,3,2,21,4
20190826-W-US_Open-R128-Serena_Williams-Maria_Sharapova,1,F-DTM,5,2,0,2,0,5,0
20190826-W-US_Open-R128-Serena_Williams-Maria_Sharapova,1,F-DTL,5,5,1,2,2,3,2
20190826-W-US_Open-R128-Serena_Williams-Maria_Sharapova,1,F-IO,8,4,2,2,0,8,0
20190826-W-US_Open-R128-Serena_Williams-Maria_Sharapova,1,B-XC,17,5,0,2,3,12,5
20190826-W-US_Open-R128-Serena_Williams-Maria_Sharapova,1,B-DTM,7,1,0,0,1,2,5
20190826-W-US_Open-R128-Serena_Williams-Maria_Sharapova,1,B-DTL,3,2,1,0,1,1,2
20190826-W-US_Open-R128-Serena_Williams-Maria_Sharapova,1,B-IO,3,0,0,0,0,2,1
20190826-W-US_Open-R128-Serena_Williams-Maria_Sharapova,2,F-XC,17,4,0,0,4,4,13
20190826-W-US_Open-R128-Serena_Williams-Maria_Sharapova,2,F-DTM,12,2,0,1,1,1,11
20190826-W-US_Open-R128-Serena_Williams-Maria_Sharapova,2,F-DTL,7,5,1,1,3,3,4
20190826-W-US_Open-R128-Serena_Williams-Maria_Sharapova,2,F-IO,4,1,0,1,0,2,2
20190826-W-US_Open-R128-Serena_Williams-Maria_Sharapova,2,B-XC,8,1,0,0,1,4,4
20190826-W-US_Open-R128-Serena_Williams-Maria_Sharapova,2,B-DTM,15,1,0,0,1,3,12
20190826-W-US_Open-R128-Serena_Williams-Maria_Sharapova,2,B-DTL,5,3,0,0,3,0,5
20190826-W-US_Open-R128-Serena_Williams-Maria_Sharapova,2,B-IO,2,1,0,0,1,0,2
20190829-W-US_Open-R64-Kirsten_Flipkens-Bianca_Andreescu,1,F-XC,18,7,4,0,3,7,11
20190829-W-US_Open-R64-Kirsten_Flipkens-Bianca_Andreescu,1,F-DTM,15,4,1,0,3,3,12
20190829-W-US_Open-R64-Kirsten_Flipkens-Bianca_Andreescu,1,F-DTL,4,2,1,0,1,1,3
20190829-W-US_Open-R64-Kirsten_Flipkens-Bianca_Andreescu,1,F-IO,17,4,2,1,1,14,3
20190829-W-US_Open-R64-Kirsten_Flipkens-Bianca_Andreescu,1,B-XC,7,0,0,0,0,4,3
20190829-W-US_Open-R64-Kirsten_Flipkens-Bianca_Andreescu,1,B-DTM,4,0,0,0,0,3,1
20190829-W-US_Open-R64-Kirsten_Flipkens-Bianca_Andreescu,1,S-XC,18,6,1,2,3,11,7
20190829-W-US_Open-R64-Kirsten_Flipkens-Bianca_Andreescu,1,S-DTM,19,5,1,0,4,7,12
20190829-W-US_Open-R64-Kirsten_Flipkens-Bianca_Andreescu,1,S-DTL,2,1,0,1,0,1,1
20190829-W-US_Open-R64-Kirsten_Flipkens-Bianca_Andreescu,2,F-XC,14,8,1,3,4,8,6
20190829-W-US_Open-R64-Kirsten_Flipkens-Bianca_Andreescu,2,F-DTM,19,0,0,0,0,12,7
20190829-W-US_Open-R64-Kirsten_Flipkens-Bianca_Andreescu,2,F-DTL,5,2,2,0,0,5,0
20190829-W-US_Open-R64-Kirsten_Flipkens-Bianca_Andreescu,2,F-IO,13,7,3,3,1,9,4
20190829-W-US_Open-R64-Kirsten_Flipkens-Bianca_Andreescu,2,F-II,2,2,1,1,0,2,0
20190829-W-US_Open-R64-Kirsten_Flipkens-Bianca_Andreescu,2,B-XC,19,5,2,0,3,8,11
20190829-W-US_Open-R64-Kirsten_Flipkens-Bianca_Andreescu,2,B-DTM,18,1,0,0,1,8,10
20190829-W-US_Open-R64-Kirsten_Flipkens-Bianca_Andreescu,2,B-DTL,6,4,0,0,4,2,4
20190829-W-US_Open-R64-Kirsten_Flipkens-Bianca_Andreescu,2,B-IO,1,1,0,0,1,0,1
20190829-W-US_Open-R64-Kirsten_Flipkens-Bianca_Andreescu,2,S-XC,7,1,0,0,1,4,3
20190829-W-US_Open-R64-Kirsten_Flipkens-Bianca_Andreescu,2,S-DTM,3,0,0,0,0,0,3
20190829-W-US_Open-R64-Kirsten_Flipkens-Bianca_Andreescu,2,S-DTL,4,1,0,0,1,1,3
20190829-W-US_Open-R64-Anastasia_Pavlyuchenkova-Kiki_Bertens,1,F-XC,29,12,5,2,5,13,16
20190829-W-US_Open-R64-Anastasia_Pavlyuchenkova-Kiki_Bertens,1,F-DTM,21,3,1,0,2,11,10
20190829-W-US_Open-R64-Anastasia_Pavlyuchenkova-Kiki_Bertens,1,F-DTL,10,3,2,1,0,9,1
20190829-W-US_Open-R64-Anastasia_Pavlyuchenkova-Kiki_Bertens,1,F-IO,24,9,5,1,3,12,12
20190829-W-US_Open-R64-Anastasia_Pavlyuchenkova-Kiki_Bertens,1,F-II,1,1,0,0,1,0,1
20190829-W-US_Open-R64-Anastasia_Pavlyuchenkova-Kiki_Bertens,1,B-XC,17,3,0,0,3,10,7
20190829-W-US_Open-R64-Anastasia_Pavlyuchenkova-Kiki_Bertens,1,B-DTM,14,0,0,0,0,8,6
20190829-W-US_Open-R64-Anastasia_Pavlyuchenkova-Kiki_Bertens,1,B-DTL,5,3,0,0,3,0,5
20190829-W-US_Open-R64-Anastasia_Pavlyuchenkova-Kiki_Bertens,1,B-IO,3,1,1,0,0,2,1
20190829-W-US_Open-R64-Anastasia_Pavlyuchenkova-Kiki_Bertens,2,F-XC,18,5,3,1,1,14,4
20190829-W-US_Open-R64-Anastasia_Pavlyuchenkova-Kiki_Bertens,2,F-DTM,22,2,1,0,1,13,9
20190829-W-US_Open-R64-Anastasia_Pavlyuchenkova-Kiki_Bertens,2,F-DTL,9,5,4,0,1,7,2
20190829-W-US_Open-R64-Anastasia_Pavlyuchenkova-Kiki_Bertens,2,F-IO,11,5,3,1,1,9,2
20190829-W-US_Open-R64-Anastasia_Pavlyuchenkova-Kiki_Bertens,2,B-XC,18,5,3,0,2,5,13
20190829-W-US_Open-R64-Anastasia_Pavlyuchenkova-Kiki_Bertens,2,B-DTM,16,2,0,0,2,6,10
20190829-W-US_Open-R64-Anastasia_Pavlyuchenkova-Kiki_Bertens,2,B-DTL,5,2,0,1,1,2,3
20190829-W-US_Open-R64-Anastasia_Pavlyuchenkova-Kiki_Bertens,2,B-IO,3,1,0,0,1,1,2
20190829-W-US_Open-R64-Anastasia_Pavlyuchenkova-Kiki_Bertens,2,S-XC,4,0,0,0,0,1,3
20190829-W-US_Open-R64-Anastasia_Pavlyuchenkova-Kiki_Bertens,2,S-DTM,11,2,0,1,1,4,7
20190829-W-US_Open-R64-Anastasia_Pavlyuchenkova-Kiki_Bertens,2,S-DTL,1,0,0,0,0,0,1
20190829-W-US_Open-R64-Iga_Swiatek-Anastasija_Sevastova,1,F-XC,58,13,4,1,8,26,32
20190829-W-US_Open-R64-Iga_Swiatek-Anastasija_Sevastova,1,F-DTM,17,2,0,1,1,9,8
20190829-W-US_Open-R64-Iga_Swiatek-Anastasija_Sevastova,1,F-DTL,9,4,3,0,1,7,2
20190829-W-US_Open-R64-Iga_Swiatek-Anastasija_Sevastova,1,F-IO,14,6,1,1,4,7,7
20190829-W-US_Open-R64-Iga_Swiatek-Anastasija_Sevastova,1,F-II,2,0,0,0,0,2,0
20190829-W-US_Open-R64-Iga_Swiatek-Anastasija_Sevastova,1,B-XC,38,13,1,2,10,12,26
20190829-W-US_Open-R64-Iga_Swiatek-Anastasija_Sevastova,1,B-DTM,26,4,0,0,4,16,10
20190829-W-US_Open-R64-Iga_Swiatek-Anastasija_Sevastova,1,B-DTL,18,7,3,1,3,10,8
20190829-W-US_Open-R64-Iga_Swiatek-Anastasija_Sevastova,1,B-IO,7,4,1,1,2,2,5
20190829-W-US_Open-R64-Iga_Swiatek-Anastasija_Sevastova,1,S-XC,1,0,0,0,0,1,0
20190829-W-US_Open-R64-Iga_Swiatek-Anastasija_Sevastova,1,S-DTL,1,0,0,0,0,0,1
20190829-W-US_Open-R64-Iga_Swiatek-Anastasija_Sevastova,2,F-XC,46,15,5,1,9,21,25
20190829-W-US_Open-R64-Iga_Swiatek-Anastasija_Sevastova,2,F-DTM,26,0,0,0,0,18,8
20190829-W-US_Open-R64-Iga_Swiatek-Anastasija_Sevastova,2,F-DTL,8,4,1,1,2,2,6
20190829-W-US_Open-R64-Iga_Swiatek-Anastasija_Sevastova,2,F-IO,10,4,2,0,2,4,6
20190829-W-US_Open-R64-Iga_Swiatek-Anastasija_Sevastova,2,B-XC,35,7,2,3,2,21,14
20190829-W-US_Open-R64-Iga_Swiatek-Anastasija_Sevastova,2,B-DTM,24,3,0,0,3,9,15
20190829-W-US_Open-R64-Iga_Swiatek-Anastasija_Sevastova,2,B-DTL,6,5,2,1,2,3,3
20190829-W-US_Open-R64-Iga_Swiatek-Anastasija_Sevastova,2,B-IO,2,2,1,1,0,2,0
20190829-W-US_Open-R64-Iga_Swiatek-Anastasija_Sevastova,2,S-XC,7,1,0,1,0,4,3
20190829-W-US_Open-R64-Iga_Swiatek-Anastasija_Sevastova,2,S-DTM,4,0,0,0,0,3,1
20190423-W-Stuttgart-R32-Andrea_Petkovic-Sara_Sorribes_Tormo,1,F-XC,91,24,9,5,10,51,40
20190423-W-Stuttgart-R32-Andrea_Petkovic-Sara_Sorribes_Tormo,1,F-DTM,40,3,0,2,1,22,18
20190423-W-Stuttgart-R32-Andrea_Petkovic-Sara_Sorribes_Tormo,1,F-DTL,20,12,5,3,4,12,8
20190423-W-Stuttgart-R32-Andrea_Petkovic-Sara_Sorribes_Tormo,1,F-IO,34,10,5,2,3,24,10
20190423-W-Stuttgart-R32-Andrea_Petkovic-Sara_Sorribes_Tormo,1,F-II,1,0,0,0,0,1,0
20190423-W-Stuttgart-R32-Andrea_Petkovic-Sara_Sorribes_Tormo,1,B-XC,49,10,3,2,5,26,23
20190423-W-Stuttgart-R32-Andrea_Petkovic-Sara_Sorribes_Tormo,1,B-DTM,33,2,0,1,1,17,16
20190423-W-Stuttgart-R32-Andrea_Petkovic-Sara_Sorribes_Tormo,1,B-DTL,6,2,2,0,0,5,1
20190423-W-Stuttgart-R32-Andrea_Petkovic-Sara_Sorribes_Tormo,1,B-IO,8,2,0,0,2,4,4
20190423-W-Stuttgart-R32-Andrea_Petkovic-Sara_Sorribes_Tormo,1,S-XC,6,0,0,0,0,4,2
20190423-W-Stuttgart-R32-Andrea_Petkovic-Sara_Sorribes_Tormo,1,S-DTM,3,1,0,0,1,1,2
20190423-W-Stuttgart-R32-Andrea_Petkovic-Sara_Sorribes_Tormo,1,S-DTL,1,0,0,0,0,1,0
20190423-W-Stuttgart-R32-Andrea_Petkovic-Sara_Sorribes_Tormo,1,S-IO,1,0,0,0,0,1,0
20190423-W-Stuttgart-R32-Andrea_Petkovic-Sara_Sorribes_Tormo,2,F-XC,70,11,2,5,4,38,32
20190423-W-Stuttgart-R32-Andrea_Petkovic-Sara_Sorribes_Tormo,2,F-DTM,63,3,0,2,1,27,36
20190423-W-Stuttgart-R32-Andrea_Petkovic-Sara_Sorribes_Tormo,2,F-DTL,25,4,1,2,1,13,12
20190423-W-Stuttgart-R32-Andrea_Petkovic-Sara_Sorribes_Tormo,2,F-IO,18,3,2,1,0,12,6
20190423-W-Stuttgart-R32-Andrea_Petkovic-Sara_Sorribes_Tormo,2,B-XC,7,1,1,0,0,3,4
20190423-W-Stuttgart-R32-Andrea_Petkovic-Sara_Sorribes_Tormo,2,B-DTM,16,2,0,1,1,5,11
20190423-W-Stuttgart-R32-Andrea_Petkovic-Sara_Sorribes_Tormo,2,B-DTL,14,6,5,0,1,8,6
20190423-W-Stuttgart-R32-Andrea_Petkovic-Sara_Sorribes_Tormo,2,B-IO,2,2,0,1,1,1,1
20190423-W-Stuttgart-R32-Andrea_Petkovic-Sara_Sorribes_Tormo,2,S-XC,21,2,0,0,2,6,15
20190423-W-Stuttgart-R32-Andrea_Petkovic-Sara_Sorribes_Tormo,2,S-DTM,36,0,0,0,0,17,19
20190423-W-Stuttgart-R32-Andrea_Petkovic-Sara_Sorribes_Tormo,2,S-DTL,10,3,0,0,3,3,7
20190423-W-Stuttgart-R32-Andrea_Petkovic-Sara_Sorribes_Tormo,2,S-IO,1,0,0,0,0,0,1
20190830-W-US_Open-R32-Madison_Keys-Sofia_Kenin,1,F-XC,26,9,6,0,3,14,12
20190830-W-US_Open-R32-Madison_Keys-Sofia_Kenin,1,F-DTM,22,6,0,1,5,8,14
20190830-W-US_Open-R32-Madison_Keys-Sofia_Kenin,1,F-DTL,5,4,2,1,1,4,1
20190830-W-US_Open-R32-Madison_Keys-Sofia_Kenin,1,F-IO,9,3,0,1,2,4,5
20190830-W-US_Open-R32-Madison_Keys-Sofia_Kenin,1,B-XC,5,2,0,1,1,3,2
20190830-W-US_Open-R32-Madison_Keys-Sofia_Kenin,1,B-DTM,13,4,0,1,3,3,10
20190830-W-US_Open-R32-Madison_Keys-Sofia_Kenin,1,B-DTL,5,4,1,0,3,2,3
20190830-W-US_Open-R32-Madison_Keys-Sofia_Kenin,1,B-IO,9,3,1,0,2,5,4
20190830-W-US_Open-R32-Madison_Keys-Sofia_Kenin,1,S-XC,4,0,0,0,0,2,2
20190830-W-US_Open-R32-Madison_Keys-Sofia_Kenin,1,S-DTM,2,0,0,0,0,1,1
20190830-W-US_Open-R32-Madison_Keys-Sofia_Kenin,1,S-DTL,1,0,0,0,0,0,1
20190830-W-US_Open-R32-Madison_Keys-Sofia_Kenin,1,S-IO,1,1,1,0,0,1,0
20190830-W-US_Open-R32-Madison_Keys-Sofia_Kenin,2,F-XC,21,6,1,4,1,13,8
20190830-W-US_Open-R32-Madison_Keys-Sofia_Kenin,2,F-DTM,25,2,0,0,2,14,11
20190830-W-US_Open-R32-Madison_Keys-Sofia_Kenin,2,F-DTL,5,4,2,0,2,3,2
20190830-W-US_Open-R32-Madison_Keys-Sofia_Kenin,2,F-IO,5,3,1,1,1,4,1
20190830-W-US_Open-R32-Madison_Keys-Sofia_Kenin,2,B-XC,16,5,1,1,3,9,7
20190830-W-US_Open-R32-Madison_Keys-Sofia_Kenin,2,B-DTM,19,3,0,1,2,14,5
20190830-W-US_Open-R32-Madison_Keys-Sofia_Kenin,2,B-DTL,1,1,0,0,1,0,1
20190830-W-US_Open-R32-Madison_Keys-Sofia_Kenin,2,B-IO,1,0,0,0,0,0,1
20190830-W-US_Open-R32-Madison_Keys-Sofia_Kenin,2,S-XC,4,0,0,0,0,2,2
20190830-W-US_Open-R32-Madison_Keys-Sofia_Kenin,2,S-DTL,1,0,0,0,0,0,1
20190826-W-US_Open-R128-Priscilla_Hon-Margarita_Gasparyan,1,F-XC,38,11,2,3,6,13,25
20190826-W-US_Open-R128-Priscilla_Hon-Margarita_Gasparyan,1,F-DTM,9,2,0,0,2,1,8
20190826-W-US_Open-R128-Priscilla_Hon-Margarita_Gasparyan,1,F-DTL,12,7,1,2,4,4,8
20190826-W-US_Open-R128-Priscilla_Hon-Margarita_Gasparyan,1,F-IO,14,5,1,2,2,10,4
20190826-W-US_Open-R128-Priscilla_Hon-Margarita_Gasparyan,1,B-XC,41,12,3,2,7,19,22
20190826-W-US_Open-R128-Priscilla_Hon-Margarita_Gasparyan,1,B-DTM,29,2,0,1,1,15,14
20190826-W-US_Open-R128-Priscilla_Hon-Margarita_Gasparyan,1,B-DTL,5,4,1,1,2,3,2
20190826-W-US_Open-R128-Priscilla_Hon-Margarita_Gasparyan,1,B-IO,12,3,0,0,3,2,10
20190826-W-US_Open-R128-Priscilla_Hon-Margarita_Gasparyan,1,S-XC,9,1,0,0,1,3,6
20190826-W-US_Open-R128-Priscilla_Hon-Margarita_Gasparyan,1,S-DTM,4,0,0,0,0,2,2
20190826-W-US_Open-R128-Priscilla_Hon-Margarita_Gasparyan,1,S-DTL,2,1,0,1,0,1,1
20190826-W-US_Open-R128-Priscilla_Hon-Margarita_Gasparyan,1,S-IO,1,1,0,1,0,1,0
20190826-W-US_Open-R128-Priscilla_Hon-Margarita_Gasparyan,2,F-XC,33,7,2,2,3,26,7
20190826-W-US_Open-R128-Priscilla_Hon-Margarita_Gasparyan,2,F-DTM,14,2,0,1,1,7,7
20190826-W-US_Open-R128-Priscilla_Hon-Margarita_Gasparyan,2,F-DTL,14,4,0,2,2,9,5
20190826-W-US_Open-R128-Priscilla_Hon-Margarita_Gasparyan,2,F-IO,24,4,1,0,3,15,9
20190826-W-US_Open-R128-Priscilla_Hon-Margarita_Gasparyan,2,F-II,1,0,0,0,0,0,1
20190826-W-US_Open-R128-Priscilla_Hon-Margarita_Gasparyan,2,B-XC,25,5,0,3,2,14,11
20190826-W-US_Open-R128-Priscilla_Hon-Margarita_Gasparyan,2,B-DTM,27,3,0,3,0,11,16
20190826-W-US_Open-R128-Priscilla_Hon-Margarita_Gasparyan,2,B-DTL,6,1,0,1,0,3,3
20190826-W-US_Open-R128-Priscilla_Hon-Margarita_Gasparyan,2,B-IO,9,2,0,0,2,5,4
20190826-W-US_Open-R128-Priscilla_Hon-Margarita_Gasparyan,2,S-XC,7,1,1,0,0,3,4
20190826-W-US_Open-R128-Priscilla_Hon-Margarita_Gasparyan,2,S-DTM,5,1,0,0,1,3,2
20190826-W-US_Open-R128-Priscilla_Hon-Margarita_Gasparyan,2,S-DTL,2,0,0,0,0,0,2
20190826-W-US_Open-R128-Priscilla_Hon-Margarita_Gasparyan,2,S-IO,1,0,0,0,0,0,1
20190826-W-US_Open-R128-Whitney_Osuigwe-Elina_Svitolina,1,F-XC,61,13,3,0,10,22,39
20190826-W-US_Open-R128-Whitney_Osuigwe-Elina_Svitolina,1,F-DTM,22,2,1,0,1,12,10
20190826-W-US_Open-R128-Whitney_Osuigwe-Elina_Svitolina,1,F-DTL,12,4,3,0,1,8,4
20190826-W-US_Open-R128-Whitney_Osuigwe-Elina_Svitolina,1,F-IO,17,4,0,1,3,4,13
20190826-W-US_Open-R128-Whitney_Osuigwe-Elina_Svitolina,1,F-II,1,1,1,0,0,1,0
20190826-W-US_Open-R128-Whitney_Osuigwe-Elina_Svitolina,1,B-XC,51,7,4,1,2,23,28
20190826-W-US_Open-R128-Whitney_Osuigwe-Elina_Svitolina,1,B-DTM,37,6,1,0,5,11,26
20190826-W-US_Open-R128-Whitney_Osuigwe-Elina_Svitolina,1,B-DTL,14,4,1,1,2,6,8
20190826-W-US_Open-R128-Whitney_Osuigwe-Elina_Svitolina,1,B-IO,5,2,0,0,2,1,4
20190826-W-US_Open-R128-Whitney_Osuigwe-Elina_Svitolina,1,S-XC,2,0,0,0,0,1,1
20190826-W-US_Open-R128-Whitney_Osuigwe-Elina_Svitolina,1,S-DTM,3,0,0,0,0,0,3
20190826-W-US_Open-R128-Whitney_Osuigwe-Elina_Svitolina,1,S-DTL,1,0,0,0,0,0,1
20190826-W-US_Open-R128-Whitney_Osuigwe-Elina_Svitolina,2,F-XC,36,5,1,0,4,18,18
20190826-W-US_Open-R128-Whitney_Osuigwe-Elina_Svitolina,2,F-DTM,39,1,0,0,1,23,16
20190826-W-US_Open-R128-Whitney_Osuigwe-Elina_Svitolina,2,F-DTL,13,3,2,0,1,9,4
20190826-W-US_Open-R128-Whitney_Osuigwe-Elina_Svitolina,2,F-IO,17,5,1,2,2,12,5
20190826-W-US_Open-R128-Whitney_Osuigwe-Elina_Svitolina,2,F-II,2,0,0,0,0,2,0
20190826-W-US_Open-R128-Whitney_Osuigwe-Elina_Svitolina,2,B-XC,63,8,1,1,6,40,23
20190826-W-US_Open-R128-Whitney_Osuigwe-Elina_Svitolina,2,B-DTM,17,0,0,0,0,10,7
20190826-W-US_Open-R128-Whitney_Osuigwe-Elina_Svitolina,2,B-DTL,12,4,1,1,2,8,4
20190826-W-US_Open-R128-Whitney_Osuigwe-Elina_Svitolina,2,B-IO,7,0,0,0,0,4,3
20190826-W-US_Open-R128-Whitney_Osuigwe-Elina_Svitolina,2,S-XC,3,1,0,0,1,0,3
20190826-W-US_Open-R128-Whitney_Osuigwe-Elina_Svitolina,2,S-DTM,2,0,0,0,0,1,1
20190826-W-US_Open-R128-Whitney_Osuigwe-Elina_Svitolina,2,S-IO,1,0,0,0,0,1,0
20190829-W-US_Open-R64-Taylor_Townsend-Simona_Halep,1,F-XC,34,7,1,2,4,10,24
20190829-W-US_Open-R64-Taylor_Townsend-Simona_Halep,1,F-DTM,6,0,0,0,0,2,4
20190829-W-US_Open-R64-Taylor_Townsend-Simona_Halep,1,F-DTL,6,5,0,0,5,0,6
20190829-W-US_Open-R64-Taylor_Townsend-Simona_Halep,1,F-IO,11,4,2,0,2,7,4
20190829-W-US_Open-R64-Taylor_Townsend-Simona_Halep,1,F-II,1,0,0,0,0,1,0
20190829-W-US_Open-R64-Taylor_Townsend-Simona_Halep,1,B-XC,22,8,3,3,2,12,10
20190829-W-US_Open-R64-Taylor_Townsend-Simona_Halep,1,B-DTM,18,4,0,0,4,5,13
20190829-W-US_Open-R64-Taylor_Townsend-Simona_Halep,1,B-DTL,12,6,2,0,4,6,6
20190829-W-US_Open-R64-Taylor_Townsend-Simona_Halep,1,B-IO,3,1,0,0,1,1,2
20190829-W-US_Open-R64-Taylor_Townsend-Simona_Halep,1,B-II,2,2,1,1,0,2,0
20190829-W-US_Open-R64-Taylor_Townsend-Simona_Halep,1,S-XC,2,0,0,0,0,2,0
20190829-W-US_Open-R64-Taylor_Townsend-Simona_Halep,1,S-DTM,3,1,0,1,0,3,0
20190829-W-US_Open-R64-Taylor_Townsend-Simona_Halep,1,S-DTL,2,0,0,0,0,0,2
20190829-W-US_Open-R64-Taylor_Townsend-Simona_Halep,2,F-XC,40,10,4,5,1,21,19
20190829-W-US_Open-R64-Taylor_Townsend-Simona_Halep,2,F-DTM,18,2,0,1,1,9,9
20190829-W-US_Open-R64-Taylor_Townsend-Simona_Halep,2,F-DTL,15,7,2,1,4,8,7
20190829-W-US_Open-R64-Taylor_Townsend-Simona_Halep,2,F-IO,11,4,3,0,1,8,3
20190829-W-US_Open-R64-Taylor_Townsend-Simona_Halep,2,F-II,5,3,2,0,1,2,3
20190829-W-US_Open-R64-Taylor_Townsend-Simona_Halep,2,B-XC,33,11,6,5,0,25,8
20190829-W-US_Open-R64-Taylor_Townsend-Simona_Halep,2,B-DTM,27,2,0,1,1,17,10
20190829-W-US_Open-R64-Taylor_Townsend-Simona_Halep,2,B-DTL,19,10,4,3,3,10,9
20190829-W-US_Open-R64-Taylor_Townsend-Simona_Halep,2,B-IO,8,0,0,0,0,6,2
20190829-W-US_Open-R64-Taylor_Townsend-Simona_Halep,2,S-XC,1,0,0,0,0,0,1
20190829-W-US_Open-R64-Taylor_Townsend-Simona_Halep,2,S-IO,1,0,0,0,0,0,1
20190831-W-US_Open-R32-Caroline_Wozniacki-Bianca_Andreescu,1,F-XC,33,10,3,1,6,14,19
20190831-W-US_Open-R32-Caroline_Wozniacki-Bianca_Andreescu,1,F-DTM,22,1,0,0,1,11,11
20190831-W-US_Open-R32-Caroline_Wozniacki-Bianca_Andreescu,1,F-DTL,18,3,1,0,2,7,11
20190831-W-US_Open-R32-Caroline_Wozniacki-Bianca_Andreescu,1,F-IO,11,3,0,1,2,6,5
20190831-W-US_Open-R32-Caroline_Wozniacki-Bianca_Andreescu,1,F-II,1,0,0,0,0,1,0
20190831-W-US_Open-R32-Caroline_Wozniacki-Bianca_Andreescu,1,B-XC,44,5,2,1,2,24,20
20190831-W-US_Open-R32-Caroline_Wozniacki-Bianca_Andreescu,1,B-DTM,28,1,0,0,1,10,18
20190831-W-US_Open-R32-Caroline_Wozniacki-Bianca_Andreescu,1,B-DTL,8,4,2,1,1,3,5
20190831-W-US_Open-R32-Caroline_Wozniacki-Bianca_Andreescu,1,B-IO,5,1,0,0,1,0,5
20190831-W-US_Open-R32-Caroline_Wozniacki-Bianca_Andreescu,1,S-XC,2,0,0,0,0,1,1
20190831-W-US_Open-R32-Caroline_Wozniacki-Bianca_Andreescu,1,S-DTM,4,0,0,0,0,0,4
20190831-W-US_Open-R32-Caroline_Wozniacki-Bianca_Andreescu,2,F-XC,36,12,5,1,6,21,15
20190831-W-US_Open-R32-Caroline_Wozniacki-Bianca_Andreescu,2,F-DTM,22,2,0,1,1,12,10
20190831-W-US_Open-R32-Caroline_Wozniacki-Bianca_Andreescu,2,F-DTL,8,2,1,0,1,5,3
20190831-W-US_Open-R32-Caroline_Wozniacki-Bianca_Andreescu,2,F-IO,20,9,2,3,4,11,9
20190831-W-US_Open-R32-Caroline_Wozniacki-Bianca_Andreescu,2,F-II,2,2,0,1,1,1,1
20190831-W-US_Open-R32-Caroline_Wozniacki-Bianca_Andreescu,2,B-XC,40,10,1,3,6,18,22
20190831-W-US_Open-R32-Caroline_Wozniacki-Bianca_Andreescu,2,B-DTM,25,4,0,2,2,17,8
20190831-W-US_Open-R32-Caroline_Wozniacki-Bianca_Andreescu,2,B-DTL,12,7,2,1,4,5,7
20190831-W-US_Open-R32-Caroline_Wozniacki-Bianca_Andreescu,2,B-IO,6,0,0,0,0,3,3
20190831-W-US_Open-R32-Caroline_Wozniacki-Bianca_Andreescu,2,S-XC,3,1,0,0,1,2,1
20190831-W-US_Open-R32-Caroline_Wozniacki-Bianca_Andreescu,2,S-DTM,10,1,0,0,1,4,6
20190831-W-US_Open-R32-Julia_Goerges-Kiki_Bertens,1,F-XC,13,5,3,1,1,10,3
20190831-W-US_Open-R32-Julia_Goerges-Kiki_Bertens,1,F-DTM,10,0,0,0,0,3,7
20190831-W-US_Open-R32-Julia_Goerges-Kiki_Bertens,1,F-DTL,9,6,1,0,5,2,7
20190831-W-US_Open-R32-Julia_Goerges-Kiki_Bertens,1,F-IO,18,10,4,3,3,12,6
20190831-W-US_Open-R32-Julia_Goerges-Kiki_Bertens,1,B-XC,14,4,0,1,3,9,5
20190831-W-US_Open-R32-Julia_Goerges-Kiki_Bertens,1,B-DTM,19,1,0,1,0,11,8
20190831-W-US_Open-R32-Julia_Goerges-Kiki_Bertens,1,B-DTL,8,5,1,2,2,5,3
20190831-W-US_Open-R32-Julia_Goerges-Kiki_Bertens,1,B-IO,1,1,0,0,1,0,1
20190831-W-US_Open-R32-Julia_Goerges-Kiki_Bertens,1,S-DTM,1,0,0,0,0,0,1
20190831-W-US_Open-R32-Julia_Goerges-Kiki_Bertens,2,F-XC,12,6,1,1,4,6,6
20190831-W-US_Open-R32-Julia_Goerges-Kiki_Bertens,2,F-DTM,5,0,0,0,0,1,4
20190831-W-US_Open-R32-Julia_Goerges-Kiki_Bertens,2,F-DTL,3,1,0,1,0,1,2
20190831-W-US_Open-R32-Julia_Goerges-Kiki_Bertens,2,F-IO,12,1,0,0,1,6,6
20190831-W-US_Open-R32-Julia_Goerges-Kiki_Bertens,2,B-XC,23,8,1,0,7,9,14
20190831-W-US_Open-R32-Julia_Goerges-Kiki_Bertens,2,B-DTM,14,4,0,0,4,2,12
20190831-W-US_Open-R32-Julia_Goerges-Kiki_Bertens,2,B-DTL,1,1,0,0,1,0,1
20190831-W-US_Open-R32-Julia_Goerges-Kiki_Bertens,2,B-IO,3,0,0,0,0,3,0
20190831-W-US_Open-R32-Julia_Goerges-Kiki_Bertens,2,S-XC,2,0,0,0,0,1,1
20190831-W-US_Open-R32-Julia_Goerges-Kiki_Bertens,2,S-DTM,3,0,0,0,0,1,2
20190831-W-US_Open-R32-Naomi_Osaka-Cori_Gauff,1,F-XC,21,4,0,0,4,13,8
20190831-W-US_Open-R32-Naomi_Osaka-Cori_Gauff,1,F-DTM,14,3,0,0,3,6,8
20190831-W-US_Open-R32-Naomi_Osaka-Cori_Gauff,1,F-DTL,7,3,2,0,1,3,4
20190831-W-US_Open-R32-Naomi_Osaka-Cori_Gauff,1,F-IO,4,2,2,0,0,4,0
20190831-W-US_Open-R32-Naomi_Osaka-Cori_Gauff,1,B-XC,30,11,6,2,3,19,11
20190831-W-US_Open-R32-Naomi_Osaka-Cori_Gauff,1,B-DTM,17,1,0,0,1,6,11
20190831-W-US_Open-R32-Naomi_Osaka-Cori_Gauff,1,B-DTL,4,3,1,0,2,2,2
20190831-W-US_Open-R32-Naomi_Osaka-Cori_Gauff,1,B-IO,9,2,1,0,1,5,4
20190831-W-US_Open-R32-Naomi_Osaka-Cori_Gauff,1,S-DTM,1,0,0,0,0,0,1
20190831-W-US_Open-R32-Naomi_Osaka-Cori_Gauff,1,S-DTL,1,0,0,0,0,0,1
20190831-W-US_Open-R32-Naomi_Osaka-Cori_Gauff,2,F-XC,11,4,1,1,2,4,7
20190831-W-US_Open-R32-Naomi_Osaka-Cori_Gauff,2,F-DTM,17,0,0,0,0,6,11
20190831-W-US_Open-R32-Naomi_Osaka-Cori_Gauff,2,F-DTL,9,5,0,1,4,4,5
20190831-W-US_Open-R32-Naomi_Osaka-Cori_Gauff,2,F-IO,7,4,1,0,3,3,4
20190831-W-US_Open-R32-Naomi_Osaka-Cori_Gauff,2,F-II,1,1,1,0,0,1,0
20190831-W-US_Open-R32-Naomi_Osaka-Cori_Gauff,2,B-XC,17,4,1,0,3,7,10
20190831-W-US_Open-R32-Naomi_Osaka-Cori_Gauff,2,B-DTM,21,1,0,0,1,11,10
20190831-W-US_Open-R32-Naomi_Osaka-Cori_Gauff,2,B-DTL,7,4,1,2,1,4,3
20190831-W-US_Open-R32-Naomi_Osaka-Cori_Gauff,2,B-IO,4,2,0,1,1,2,2
20190831-W-US_Open-R32-Naomi_Osaka-Cori_Gauff,2,S-XC,3,1,0,0,1,1,2
20190831-W-US_Open-R32-Naomi_Osaka-Cori_Gauff,2,S-DTM,5,0,0,0,0,1,4
20190829-W-US_Open-R64-Laura_Siegemund-Sofia_Kenin,1,F-XC,44,14,3,1,10,19,25
20190829-W-US_Open-R64-Laura_Siegemund-Sofia_Kenin,1,F-DTM,23,2,0,0,2,12,11
20190829-W-US_Open-R64-Laura_Siegemund-Sofia_Kenin,1,F-DTL,14,6,2,0,4,6,8
20190829-W-US_Open-R64-Laura_Siegemund-Sofia_Kenin,1,F-IO,10,4,1,0,3,6,4
20190829-W-US_Open-R64-Laura_Siegemund-Sofia_Kenin,1,B-XC,18,7,0,3,4,8,10
20190829-W-US_Open-R64-Laura_Siegemund-Sofia_Kenin,1,B-DTM,27,5,0,0,5,9,18
20190829-W-US_Open-R64-Laura_Siegemund-Sofia_Kenin,1,B-DTL,7,4,1,1,2,4,3
20190829-W-US_Open-R64-Laura_Siegemund-Sofia_Kenin,1,B-IO,4,1,0,0,1,2,2
20190829-W-US_Open-R64-Laura_Siegemund-Sofia_Kenin,1,S-XC,5,1,0,1,0,3,2
20190829-W-US_Open-R64-Laura_Siegemund-Sofia_Kenin,1,S-DTM,6,0,0,0,0,2,4
20190829-W-US_Open-R64-Laura_Siegemund-Sofia_Kenin,2,F-XC,56,11,2,4,5,33,23
20190829-W-US_Open-R64-Laura_Siegemund-Sofia_Kenin,2,F-DTM,13,1,0,0,1,5,8
20190829-W-US_Open-R64-Laura_Siegemund-Sofia_Kenin,2,F-DTL,8,3,1,0,2,5,3
20190829-W-US_Open-R64-Laura_Siegemund-Sofia_Kenin,2,F-IO,5,1,0,0,1,3,2
20190829-W-US_Open-R64-Laura_Siegemund-Sofia_Kenin,2,B-XC,26,5,2,1,2,12,14
20190829-W-US_Open-R64-Laura_Siegemund-Sofia_Kenin,2,B-DTM,26,4,1,1,2,12,14
20190829-W-US_Open-R64-Laura_Siegemund-Sofia_Kenin,2,B-DTL,6,2,1,1,0,4,2
20190829-W-US_Open-R64-Laura_Siegemund-Sofia_Kenin,2,B-IO,2,1,1,0,0,2,0
20190829-W-US_Open-R64-Laura_Siegemund-Sofia_Kenin,2,S-XC,3,0,0,0,0,2,1
20190829-W-US_Open-R64-Laura_Siegemund-Sofia_Kenin,2,S-DTM,3,0,0,0,0,1,2
20190831-W-US_Open-R32-Kristie_Ahn-Jelena_Ostapenko,1,F-XC,40,7,2,1,4,19,21
20190831-W-US_Open-R32-Kristie_Ahn-Jelena_Ostapenko,1,F-DTM,17,1,0,1,0,8,9
20190831-W-US_Open-R32-Kristie_Ahn-Jelena_Ostapenko,1,F-DTL,4,0,0,0,0,3,1
20190831-W-US_Open-R32-Kristie_Ahn-Jelena_Ostapenko,1,F-IO,16,7,2,1,4,9,7
20190831-W-US_Open-R32-Kristie_Ahn-Jelena_Ostapenko,1,F-II,2,1,0,0,1,0,2
20190831-W-US_Open-R32-Kristie_Ahn-Jelena_Ostapenko,1,B-XC,14,3,0,1,2,6,8
20190831-W-US_Open-R32-Kristie_Ahn-Jelena_Ostapenko,1,B-DTM,20,1,0,1,0,14,6
20190831-W-US_Open-R32-Kristie_Ahn-Jelena_Ostapenko,1,B-DTL,2,0,0,0,0,1,1
20190831-W-US_Open-R32-Kristie_Ahn-Jelena_Ostapenko,1,B-IO,2,1,0,0,1,1,1
20190831-W-US_Open-R32-Kristie_Ahn-Jelena_Ostapenko,1,S-XC,2,1,0,0,1,1,1
20190831-W-US_Open-R32-Kristie_Ahn-Jelena_Ostapenko,1,S-DTM,1,0,0,0,0,0,1
20190831-W-US_Open-R32-Kristie_Ahn-Jelena_Ostapenko,1,S-DTL,1,1,1,0,0,1,0
20190831-W-US_Open-R32-Kristie_Ahn-Jelena_Ostapenko,2,F-XC,54,22,6,7,9,29,25
20190831-W-US_Open-R32-Kristie_Ahn-Jelena_Ostapenko,2,F-DTM,10,2,0,0,2,4,6
20190831-W-US_Open-R32-Kristie_Ahn-Jelena_Ostapenko,2,F-DTL,17,10,1,2,7,9,8
20190831-W-US_Open-R32-Kristie_Ahn-Jelena_Ostapenko,2,F-IO,5,3,2,0,1,3,2
20190831-W-US_Open-R32-Kristie_Ahn-Jelena_Ostapenko,2,B-XC,17,3,0,2,1,9,8
20190831-W-US_Open-R32-Kristie_Ahn-Jelena_Ostapenko,2,B-DTM,19,4,0,0,4,6,13
20190831-W-US_Open-R32-Kristie_Ahn-Jelena_Ostapenko,2,B-DTL,9,6,5,0,1,6,3
20190831-W-US_Open-R32-Kristie_Ahn-Jelena_Ostapenko,2,B-IO,3,2,0,0,2,1,2
20190831-W-US_Open-R32-Sorana_Cirstea-Taylor_Townsend,1,F-XC,20,3,0,0,3,5,15
20190831-W-US_Open-R32-Sorana_Cirstea-Taylor_Townsend,1,F-DTM,8,1,0,0,1,4,4
20190831-W-US_Open-R32-Sorana_Cirstea-Taylor_Townsend,1,F-DTL,10,5,3,0,2,6,4
20190831-W-US_Open-R32-Sorana_Cirstea-Taylor_Townsend,1,F-IO,10,3,0,0,3,2,8
20190831-W-US_Open-R32-Sorana_Cirstea-Taylor_Townsend,1,F-II,1,1,0,1,0,1,0
20190831-W-US_Open-R32-Sorana_Cirstea-Taylor_Townsend,1,B-XC,7,3,1,2,0,5,2
20190831-W-US_Open-R32-Sorana_Cirstea-Taylor_Townsend,1,B-DTM,9,0,0,0,0,5,4
20190831-W-US_Open-R32-Sorana_Cirstea-Taylor_Townsend,1,B-DTL,8,3,1,2,0,5,3
20190831-W-US_Open-R32-Sorana_Cirstea-Taylor_Townsend,1,B-IO,5,3,2,1,0,3,2
20190831-W-US_Open-R32-Sorana_Cirstea-Taylor_Townsend,1,B-II,1,0,0,0,0,0,1
20190831-W-US_Open-R32-Sorana_Cirstea-Taylor_Townsend,1,S-DTL,2,1,0,1,0,1,1
20190831-W-US_Open-R32-Sorana_Cirstea-Taylor_Townsend,2,F-XC,14,4,1,1,2,5,9
20190831-W-US_Open-R32-Sorana_Cirstea-Taylor_Townsend,2,F-DTM,5,1,0,1,0,4,1
20190831-W-US_Open-R32-Sorana_Cirstea-Taylor_Townsend,2,F-DTL,1,1,0,1,0,1,0
20190831-W-US_Open-R32-Sorana_Cirstea-Taylor_Townsend,2,F-IO,7,1,0,0,1,2,5
20190831-W-US_Open-R32-Sorana_Cirstea-Taylor_Townsend,2,F-II,1,1,0,1,0,1,0
20190831-W-US_Open-R32-Sorana_Cirstea-Taylor_Townsend,2,B-XC,11,5,5,0,0,9,2
20190831-W-US_Open-R32-Sorana_Cirstea-Taylor_Townsend,2,B-DTM,3,1,0,0,1,0,3
20190831-W-US_Open-R32-Sorana_Cirstea-Taylor_Townsend,2,B-DTL,1,1,1,0,0,1,0
20190831-W-US_Open-R32-Sorana_Cirstea-Taylor_Townsend,2,B-IO,1,0,0,0,0,1,0
20190831-W-US_Open-R32-Sorana_Cirstea-Taylor_Townsend,2,B-II,1,0,0,0,0,0,1
20190831-W-US_Open-R32-Sorana_Cirstea-Taylor_Townsend,2,S-XC,2,0,0,0,0,1,1
20190831-W-US_Open-R32-Sorana_Cirstea-Taylor_Townsend,2,S-DTM,2,0,0,0,0,2,0
20190831-W-US_Open-R32-Sorana_Cirstea-Taylor_Townsend,2,S-DTL,2,1,0,1,0,2,0
20190801-W-ITF_Lexington-R16-Katie_Swan-Yuxuan_Zhang,1,F-XC,16,6,4,1,1,14,2
20190801-W-ITF_Lexington-R16-Katie_Swan-Yuxuan_Zhang,1,F-DTM,5,0,0,0,0,3,2
20190801-W-ITF_Lexington-R16-Katie_Swan-Yuxuan_Zhang,1,F-DTL,3,3,2,1,0,3,0
20190801-W-ITF_Lexington-R16-Katie_Swan-Yuxuan_Zhang,1,F-IO,7,4,1,2,1,5,2
20190801-W-ITF_Lexington-R16-Katie_Swan-Yuxuan_Zhang,1,F-II,2,0,0,0,0,1,1
20190801-W-ITF_Lexington-R16-Katie_Swan-Yuxuan_Zhang,1,B-XC,14,5,1,2,2,9,5
20190801-W-ITF_Lexington-R16-Katie_Swan-Yuxuan_Zhang,1,B-DTM,11,1,0,0,1,8,3
20190801-W-ITF_Lexington-R16-Katie_Swan-Yuxuan_Zhang,1,B-DTL,2,2,1,1,0,2,0
20190801-W-ITF_Lexington-R16-Katie_Swan-Yuxuan_Zhang,1,B-IO,1,1,1,0,0,1,0
20190801-W-ITF_Lexington-R16-Katie_Swan-Yuxuan_Zhang,1,S-XC,2,1,0,0,1,1,1
20190801-W-ITF_Lexington-R16-Katie_Swan-Yuxuan_Zhang,1,S-DTM,2,0,0,0,0,2,0
20190801-W-ITF_Lexington-R16-Katie_Swan-Yuxuan_Zhang,1,S-IO,1,0,0,0,0,1,0
20190801-W-ITF_Lexington-R16-Katie_Swan-Yuxuan_Zhang,2,F-XC,6,1,0,0,1,0,6
20190801-W-ITF_Lexington-R16-Katie_Swan-Yuxuan_Zhang,2,F-DTM,9,0,0,0,0,4,5
20190801-W-ITF_Lexington-R16-Katie_Swan-Yuxuan_Zhang,2,F-DTL,11,3,0,0,3,3,8
20190801-W-ITF_Lexington-R16-Katie_Swan-Yuxuan_Zhang,2,F-IO,6,3,0,0,3,2,4
20190801-W-ITF_Lexington-R16-Katie_Swan-Yuxuan_Zhang,2,B-XC,19,5,0,0,5,3,16
20190801-W-ITF_Lexington-R16-Katie_Swan-Yuxuan_Zhang,2,B-DTM,9,2,0,1,1,3,6
20190801-W-ITF_Lexington-R16-Katie_Swan-Yuxuan_Zhang,2,B-DTL,6,3,1,1,1,2,4
20190801-W-ITF_Lexington-R16-Katie_Swan-Yuxuan_Zhang,2,B-IO,5,1,0,0,1,1,4
20190902-W-US_Open-R16-Bianca_Andreescu-Taylor_Townsend,1,F-XC,37,11,2,5,4,19,18
20190902-W-US_Open-R16-Bianca_Andreescu-Taylor_Townsend,1,F-DTM,8,2,0,1,1,4,4
20190902-W-US_Open-R16-Bianca_Andreescu-Taylor_Townsend,1,F-DTL,9,5,3,0,2,5,4
20190902-W-US_Open-R16-Bianca_Andreescu-Taylor_Townsend,1,F-IO,13,5,1,2,2,8,5
20190902-W-US_Open-R16-Bianca_Andreescu-Taylor_Townsend,1,F-II,2,0,0,0,0,2,0
20190902-W-US_Open-R16-Bianca_Andreescu-Taylor_Townsend,1,B-XC,24,9,4,3,2,15,9
20190902-W-US_Open-R16-Bianca_Andreescu-Taylor_Townsend,1,B-DTM,9,2,1,0,1,5,4
20190902-W-US_Open-R16-Bianca_Andreescu-Taylor_Townsend,1,B-DTL,9,2,1,1,0,8,1
20190902-W-US_Open-R16-Bianca_Andreescu-Taylor_Townsend,1,B-IO,4,1,1,0,0,2,2
20190902-W-US_Open-R16-Bianca_Andreescu-Taylor_Townsend,1,S-DTM,2,0,0,0,0,1,1
20190902-W-US_Open-R16-Bianca_Andreescu-Taylor_Townsend,1,S-IO,1,0,0,0,0,1,0
20190902-W-US_Open-R16-Bianca_Andreescu-Taylor_Townsend,2,F-XC,25,8,1,2,5,10,15
20190902-W-US_Open-R16-Bianca_Andreescu-Taylor_Townsend,2,F-DTM,6,0,0,0,0,3,3
20190902-W-US_Open-R16-Bianca_Andreescu-Taylor_Townsend,2,F-DTL,8,7,3,1,3,5,3
20190902-W-US_Open-R16-Bianca_Andreescu-Taylor_Townsend,2,F-IO,9,4,1,1,2,5,4
20190902-W-US_Open-R16-Bianca_Andreescu-Taylor_Townsend,2,F-II,1,1,0,0,1,0,1
20190902-W-US_Open-R16-Bianca_Andreescu-Taylor_Townsend,2,B-XC,16,5,1,2,2,10,6
20190902-W-US_Open-R16-Bianca_Andreescu-Taylor_Townsend,2,B-DTM,20,2,0,1,1,10,10
20190902-W-US_Open-R16-Bianca_Andreescu-Taylor_Townsend,2,B-DTL,7,3,0,0,3,2,5
20190902-W-US_Open-R16-Bianca_Andreescu-Taylor_Townsend,2,B-IO,2,0,0,0,0,0,2
20190902-W-US_Open-R16-Bianca_Andreescu-Taylor_Townsend,2,S-XC,1,0,0,0,0,1,0
20190902-W-US_Open-R16-Bianca_Andreescu-Taylor_Townsend,2,S-DTM,6,0,0,0,0,2,4
20190902-W-US_Open-R16-Bianca_Andreescu-Taylor_Townsend,2,S-DTL,7,1,0,1,0,3,4
20190903-W-US_Open-QF-Serena_Williams-Qiang_Wang,1,F-XC,16,9,2,3,4,7,9
20190903-W-US_Open-QF-Serena_Williams-Qiang_Wang,1,F-DTM,5,1,0,1,0,3,2
20190903-W-US_Open-QF-Serena_Williams-Qiang_Wang,1,F-DTL,5,4,3,0,1,4,1
20190903-W-US_Open-QF-Serena_Williams-Qiang_Wang,1,F-IO,4,3,3,0,0,4,0
20190903-W-US_Open-QF-Serena_Williams-Qiang_Wang,1,B-XC,25,10,5,4,1,18,7
20190903-W-US_Open-QF-Serena_Williams-Qiang_Wang,1,B-DTM,7,1,0,0,1,2,5
20190903-W-US_Open-QF-Serena_Williams-Qiang_Wang,1,B-DTL,6,1,1,0,0,5,1
20190903-W-US_Open-QF-Serena_Williams-Qiang_Wang,1,B-IO,5,1,0,1,0,3,2
20190903-W-US_Open-QF-Serena_Williams-Qiang_Wang,2,F-XC,9,1,0,0,1,6,3
20190903-W-US_Open-QF-Serena_Williams-Qiang_Wang,2,F-DTM,16,1,0,0,1,3,13
20190903-W-US_Open-QF-Serena_Williams-Qiang_Wang,2,F-DTL,5,2,0,2,0,3,2
20190903-W-US_Open-QF-Serena_Williams-Qiang_Wang,2,F-IO,4,2,0,0,2,2,2
20190903-W-US_Open-QF-Serena_Williams-Qiang_Wang,2,B-XC,11,1,0,0,1,4,7
20190903-W-US_Open-QF-Serena_Williams-Qiang_Wang,2,B-DTM,12,3,0,0,3,6,6
20190903-W-US_Open-QF-Serena_Williams-Qiang_Wang,2,B-DTL,2,1,0,1,0,1,1
20190903-W-US_Open-QF-Serena_Williams-Qiang_Wang,2,S-XC,1,0,0,0,0,0,1
20190903-W-US_Open-QF-Serena_Williams-Qiang_Wang,2,S-DTL,1,0,0,0,0,0,1
20190110-W-Sydney-QF-Yulia_Putintseva-Kiki_Bertens,1,F-XC,19,5,1,1,3,9,10
20190110-W-Sydney-QF-Yulia_Putintseva-Kiki_Bertens,1,F-DTM,20,1,0,0,1,6,14
20190110-W-Sydney-QF-Yulia_Putintseva-Kiki_Bertens,1,F-DTL,8,1,0,0,1,3,5
20190110-W-Sydney-QF-Yulia_Putintseva-Kiki_Bertens,1,F-IO,21,7,1,2,4,8,13
20190110-W-Sydney-QF-Yulia_Putintseva-Kiki_Bertens,1,F-II,1,1,0,1,0,1,0
20190110-W-Sydney-QF-Yulia_Putintseva-Kiki_Bertens,1,B-XC,16,1,0,0,1,9,7
20190110-W-Sydney-QF-Yulia_Putintseva-Kiki_Bertens,1,B-DTM,14,3,0,0,3,2,12
20190110-W-Sydney-QF-Yulia_Putintseva-Kiki_Bertens,1,B-DTL,3,0,0,0,0,1,2
20190110-W-Sydney-QF-Yulia_Putintseva-Kiki_Bertens,1,S-XC,6,0,0,0,0,4,2
20190110-W-Sydney-QF-Yulia_Putintseva-Kiki_Bertens,1,S-DTM,3,0,0,0,0,1,2
20190110-W-Sydney-QF-Yulia_Putintseva-Kiki_Bertens,2,F-XC,19,5,3,1,1,14,5
20190110-W-Sydney-QF-Yulia_Putintseva-Kiki_Bertens,2,F-DTM,15,2,0,1,1,10,5
20190110-W-Sydney-QF-Yulia_Putintseva-Kiki_Bertens,2,F-DTL,6,3,2,0,1,2,4
20190110-W-Sydney-QF-Yulia_Putintseva-Kiki_Bertens,2,F-IO,10,5,3,0,2,7,3
20190110-W-Sydney-QF-Yulia_Putintseva-Kiki_Bertens,2,F-II,2,1,0,0,1,0,2
20190110-W-Sydney-QF-Yulia_Putintseva-Kiki_Bertens,2,B-XC,16,4,0,1,3,9,7
20190110-W-Sydney-QF-Yulia_Putintseva-Kiki_Bertens,2,B-DTM,22,2,0,0,2,15,7
20190110-W-Sydney-QF-Yulia_Putintseva-Kiki_Bertens,2,B-DTL,6,4,0,1,3,2,4
20190110-W-Sydney-QF-Yulia_Putintseva-Kiki_Bertens,2,B-IO,6,2,1,1,0,5,1
20190110-W-Sydney-QF-Yulia_Putintseva-Kiki_Bertens,2,S-XC,4,1,0,0,1,1,3
20190110-W-Sydney-QF-Yulia_Putintseva-Kiki_Bertens,2,S-DTM,5,0,0,0,0,2,3
20190110-W-Sydney-QF-Yulia_Putintseva-Kiki_Bertens,2,S-DTL,2,2,0,1,1,1,1
20190905-W-US_Open-SF-Belinda_Bencic-Bianca_Andreescu,1,F-XC,51,9,1,5,3,28,23
20190905-W-US_Open-SF-Belinda_Bencic-Bianca_Andreescu,1,F-DTM,34,4,1,0,3,14,20
20190905-W-US_Open-SF-Belinda_Bencic-Bianca_Andreescu,1,F-DTL,11,4,2,1,1,7,4
20190905-W-US_Open-SF-Belinda_Bencic-Bianca_Andreescu,1,F-IO,25,3,0,0,3,12,13
20190905-W-US_Open-SF-Belinda_Bencic-Bianca_Andreescu,1,B-XC,34,9,1,4,4,19,15
20190905-W-US_Open-SF-Belinda_Bencic-Bianca_Andreescu,1,B-DTM,32,2,0,1,1,15,17
20190905-W-US_Open-SF-Belinda_Bencic-Bianca_Andreescu,1,B-DTL,10,4,2,2,0,7,3
20190905-W-US_Open-SF-Belinda_Bencic-Bianca_Andreescu,1,B-IO,17,10,2,4,4,9,8
20190905-W-US_Open-SF-Belinda_Bencic-Bianca_Andreescu,1,S-IO,1,1,0,0,1,0,1
20190905-W-US_Open-SF-Belinda_Bencic-Bianca_Andreescu,2,F-XC,47,16,9,3,4,25,22
20190905-W-US_Open-SF-Belinda_Bencic-Bianca_Andreescu,2,F-DTM,44,5,1,0,4,23,21
20190905-W-US_Open-SF-Belinda_Bencic-Bianca_Andreescu,2,F-DTL,12,8,3,1,4,6,6
20190905-W-US_Open-SF-Belinda_Bencic-Bianca_Andreescu,2,F-IO,18,9,5,1,3,10,8
20190905-W-US_Open-SF-Belinda_Bencic-Bianca_Andreescu,2,B-XC,19,1,0,1,0,10,9
20190905-W-US_Open-SF-Belinda_Bencic-Bianca_Andreescu,2,B-DTM,44,8,1,3,4,17,27
20190905-W-US_Open-SF-Belinda_Bencic-Bianca_Andreescu,2,B-DTL,12,7,3,3,1,9,3
20190905-W-US_Open-SF-Belinda_Bencic-Bianca_Andreescu,2,B-IO,10,5,2,0,3,5,5
20190905-W-US_Open-SF-Belinda_Bencic-Bianca_Andreescu,2,S-XC,8,2,0,0,2,3,5
20190905-W-US_Open-SF-Belinda_Bencic-Bianca_Andreescu,2,S-DTM,7,0,0,0,0,4,3
20190905-W-US_Open-SF-Belinda_Bencic-Bianca_Andreescu,2,S-IO,1,0,0,0,0,1,0
20190904-W-US_Open-QF-Elise_Mertens-Bianca_Andreescu,1,F-XC,22,5,1,2,2,13,9
20190904-W-US_Open-QF-Elise_Mertens-Bianca_Andreescu,1,F-DTM,32,2,0,0,2,12,20
20190904-W-US_Open-QF-Elise_Mertens-Bianca_Andreescu,1,F-DTL,6,0,0,0,0,2,4
20190904-W-US_Open-QF-Elise_Mertens-Bianca_Andreescu,1,F-IO,28,7,3,1,3,13,15
20190904-W-US_Open-QF-Elise_Mertens-Bianca_Andreescu,1,B-XC,24,1,0,0,1,13,11
20190904-W-US_Open-QF-Elise_Mertens-Bianca_Andreescu,1,B-DTM,28,4,0,1,3,13,15
20190904-W-US_Open-QF-Elise_Mertens-Bianca_Andreescu,1,B-DTL,9,5,2,1,2,5,4
20190904-W-US_Open-QF-Elise_Mertens-Bianca_Andreescu,1,B-IO,7,5,2,1,2,4,3
20190904-W-US_Open-QF-Elise_Mertens-Bianca_Andreescu,1,S-XC,7,0,0,0,0,1,6
20190904-W-US_Open-QF-Elise_Mertens-Bianca_Andreescu,1,S-DTM,7,2,0,1,1,4,3
20190904-W-US_Open-QF-Elise_Mertens-Bianca_Andreescu,1,S-DTL,3,0,0,0,0,1,2
20190904-W-US_Open-QF-Elise_Mertens-Bianca_Andreescu,2,F-XC,30,16,8,5,3,21,9
20190904-W-US_Open-QF-Elise_Mertens-Bianca_Andreescu,2,F-DTM,25,5,0,0,5,9,16
20190904-W-US_Open-QF-Elise_Mertens-Bianca_Andreescu,2,F-DTL,7,2,2,0,0,3,4
20190904-W-US_Open-QF-Elise_Mertens-Bianca_Andreescu,2,F-IO,13,7,3,2,2,9,4
20190904-W-US_Open-QF-Elise_Mertens-Bianca_Andreescu,2,B-XC,33,8,0,3,5,15,18
20190904-W-US_Open-QF-Elise_Mertens-Bianca_Andreescu,2,B-DTM,39,5,0,1,4,23,16
20190904-W-US_Open-QF-Elise_Mertens-Bianca_Andreescu,2,B-DTL,10,6,4,2,0,9,1
20190904-W-US_Open-QF-Elise_Mertens-Bianca_Andreescu,2,B-IO,3,1,1,0,0,3,0
20190904-W-US_Open-QF-Elise_Mertens-Bianca_Andreescu,2,S-XC,4,1,0,0,1,2,2
20190904-W-US_Open-QF-Elise_Mertens-Bianca_Andreescu,2,S-DTM,12,1,0,0,1,9,3
20190904-W-US_Open-QF-Elise_Mertens-Bianca_Andreescu,2,S-DTL,1,0,0,0,0,0,1
20190904-W-US_Open-QF-Elise_Mertens-Bianca_Andreescu,2,S-IO,4,2,0,0,2,0,4
20190907-W-US_Open-F-Serena_Williams-Bianca_Andreescu,1,F-XC,28,13,3,1,9,9,19
20190907-W-US_Open-F-Serena_Williams-Bianca_Andreescu,1,F-DTM,17,1,0,1,0,11,6
20190907-W-US_Open-F-Serena_Williams-Bianca_Andreescu,1,F-DTL,7,4,1,1,2,4,3
20190907-W-US_Open-F-Serena_Williams-Bianca_Andreescu,1,F-IO,8,4,4,0,0,8,0
20190907-W-US_Open-F-Serena_Williams-Bianca_Andreescu,1,F-II,1,0,0,0,0,1,0
20190907-W-US_Open-F-Serena_Williams-Bianca_Andreescu,1,B-XC,35,11,0,3,8,15,20
20190907-W-US_Open-F-Serena_Williams-Bianca_Andreescu,1,B-DTM,19,2,0,0,2,4,15
20190907-W-US_Open-F-Serena_Williams-Bianca_Andreescu,1,B-DTL,5,2,2,0,0,4,1
20190907-W-US_Open-F-Serena_Williams-Bianca_Andreescu,1,B-IO,5,2,1,1,0,3,2
20190907-W-US_Open-F-Serena_Williams-Bianca_Andreescu,1,S-XC,1,0,0,0,0,0,1
20190907-W-US_Open-F-Serena_Williams-Bianca_Andreescu,1,S-DTL,1,0,0,0,0,1,0
20190907-W-US_Open-F-Serena_Williams-Bianca_Andreescu,2,F-XC,22,10,7,1,2,14,8
20190907-W-US_Open-F-Serena_Williams-Bianca_Andreescu,2,F-DTM,18,2,0,1,1,11,7
20190907-W-US_Open-F-Serena_Williams-Bianca_Andreescu,2,F-DTL,9,1,1,0,0,5,4
20190907-W-US_Open-F-Serena_Williams-Bianca_Andreescu,2,F-IO,12,4,0,2,2,6,6
20190907-W-US_Open-F-Serena_Williams-Bianca_Andreescu,2,F-II,1,1,0,0,1,0,1
20190907-W-US_Open-F-Serena_Williams-Bianca_Andreescu,2,B-XC,16,3,1,0,2,8,8
20190907-W-US_Open-F-Serena_Williams-Bianca_Andreescu,2,B-DTM,25,6,0,0,5,11,14
20190907-W-US_Open-F-Serena_Williams-Bianca_Andreescu,2,B-DTL,3,0,0,0,0,1,2
20190907-W-US_Open-F-Serena_Williams-Bianca_Andreescu,2,B-IO,1,0,0,0,0,1,0
20190907-W-US_Open-F-Serena_Williams-Bianca_Andreescu,2,S-XC,1,0,0,0,0,0,1
20190907-W-US_Open-F-Serena_Williams-Bianca_Andreescu,2,S-DTM,6,1,0,0,1,2,4
20190831-W-US_Open-R32-Donna_Vekic-Yulia_Putintseva,1,F-XC,28,10,5,3,2,19,9
20190831-W-US_Open-R32-Donna_Vekic-Yulia_Putintseva,1,F-DTM,16,0,0,0,0,9,7
20190831-W-US_Open-R32-Donna_Vekic-Yulia_Putintseva,1,F-DTL,7,4,2,0,2,2,5
20190831-W-US_Open-R32-Donna_Vekic-Yulia_Putintseva,1,F-IO,27,8,3,2,3,15,12
20190831-W-US_Open-R32-Donna_Vekic-Yulia_Putintseva,1,F-II,4,2,1,0,1,2,2
20190831-W-US_Open-R32-Donna_Vekic-Yulia_Putintseva,1,B-XC,23,5,0,1,4,7,16
20190831-W-US_Open-R32-Donna_Vekic-Yulia_Putintseva,1,B-DTM,26,1,0,0,1,16,10
20190831-W-US_Open-R32-Donna_Vekic-Yulia_Putintseva,1,B-DTL,10,4,2,0,2,5,5
20190831-W-US_Open-R32-Donna_Vekic-Yulia_Putintseva,1,B-IO,2,1,0,0,1,0,2
20190831-W-US_Open-R32-Donna_Vekic-Yulia_Putintseva,1,S-DTL,1,1,0,0,1,0,1
20190831-W-US_Open-R32-Donna_Vekic-Yulia_Putintseva,1,S-IO,1,0,0,0,0,1,0
20190831-W-US_Open-R32-Donna_Vekic-Yulia_Putintseva,2,F-XC,27,8,4,2,2,12,15
20190831-W-US_Open-R32-Donna_Vekic-Yulia_Putintseva,2,F-DTM,15,0,0,0,0,4,11
20190831-W-US_Open-R32-Donna_Vekic-Yulia_Putintseva,2,F-DTL,11,1,0,0,1,8,3
20190831-W-US_Open-R32-Donna_Vekic-Yulia_Putintseva,2,F-IO,12,1,0,0,1,4,8
20190831-W-US_Open-R32-Donna_Vekic-Yulia_Putintseva,2,B-XC,20,1,0,1,0,12,8
20190831-W-US_Open-R32-Donna_Vekic-Yulia_Putintseva,2,B-DTM,16,2,0,0,2,8,8
20190831-W-US_Open-R32-Donna_Vekic-Yulia_Putintseva,2,B-DTL,5,2,0,0,1,2,3
20190831-W-US_Open-R32-Donna_Vekic-Yulia_Putintseva,2,B-IO,7,2,0,0,2,5,2
20190831-W-US_Open-R32-Donna_Vekic-Yulia_Putintseva,2,S-XC,12,1,0,0,1,10,2
20190831-W-US_Open-R32-Donna_Vekic-Yulia_Putintseva,2,S-DTM,12,0,0,0,0,3,9
20190831-W-US_Open-R32-Donna_Vekic-Yulia_Putintseva,2,S-IO,2,2,1,0,1,1,1
20120428-W-Fes-F-Laura_Pous_Tio-Kiki_Bertens,1,F-XC,58,9,1,2,6,16,42
20120428-W-Fes-F-Laura_Pous_Tio-Kiki_Bertens,1,F-DTM,64,3,0,0,3,19,45
20120428-W-Fes-F-Laura_Pous_Tio-Kiki_Bertens,1,F-DTL,22,7,1,3,3,10,12
20120428-W-Fes-F-Laura_Pous_Tio-Kiki_Bertens,1,F-IO,35,8,0,1,7,12,23
20120428-W-Fes-F-Laura_Pous_Tio-Kiki_Bertens,1,B-XC,43,6,0,1,5,16,27
20120428-W-Fes-F-Laura_Pous_Tio-Kiki_Bertens,1,B-DTM,47,3,0,1,2,20,27
20120428-W-Fes-F-Laura_Pous_Tio-Kiki_Bertens,1,B-DTL,7,2,0,0,2,2,5
20120428-W-Fes-F-Laura_Pous_Tio-Kiki_Bertens,1,S-DTM,2,0,0,0,0,2,0
20120428-W-Fes-F-Laura_Pous_Tio-Kiki_Bertens,2,F-XC,82,18,4,5,9,53,29
20120428-W-Fes-F-Laura_Pous_Tio-Kiki_Bertens,2,F-DTM,37,2,0,0,2,29,8
20120428-W-Fes-F-Laura_Pous_Tio-Kiki_Bertens,2,F-DTL,9,3,2,0,1,3,6
20120428-W-Fes-F-Laura_Pous_Tio-Kiki_Bertens,2,F-IO,31,7,2,1,4,13,18
20120428-W-Fes-F-Laura_Pous_Tio-Kiki_Bertens,2,F-II,5,2,0,0,2,1,4
20120428-W-Fes-F-Laura_Pous_Tio-Kiki_Bertens,2,B-XC,45,5,0,0,5,28,17
20120428-W-Fes-F-Laura_Pous_Tio-Kiki_Bertens,2,B-DTM,55,2,0,0,2,38,17
20120428-W-Fes-F-Laura_Pous_Tio-Kiki_Bertens,2,B-DTL,8,2,2,0,0,5,3
20120428-W-Fes-F-Laura_Pous_Tio-Kiki_Bertens,2,B-IO,4,2,1,0,1,3,1
20120428-W-Fes-F-Laura_Pous_Tio-Kiki_Bertens,2,S-XC,6,0,0,0,0,4,2
20120428-W-Fes-F-Laura_Pous_Tio-Kiki_Bertens,2,S-DTM,11,2,0,0,2,7,4
20120428-W-Fes-F-Laura_Pous_Tio-Kiki_Bertens,2,S-DTL,1,0,0,0,0,0,1
20190131-W-St_Petersburg-R16-Kiki_Bertens-Ysaline_Bonaventure,1,F-XC,35,6,1,2,3,17,18
20190131-W-St_Petersburg-R16-Kiki_Bertens-Ysaline_Bonaventure,1,F-DTM,10,2,0,0,2,2,8
20190131-W-St_Petersburg-R16-Kiki_Bertens-Ysaline_Bonaventure,1,F-DTL,12,6,4,1,1,7,5
20190131-W-St_Petersburg-R16-Kiki_Bertens-Ysaline_Bonaventure,1,F-IO,12,7,4,2,1,8,4
20190131-W-St_Petersburg-R16-Kiki_Bertens-Ysaline_Bonaventure,1,B-XC,10,1,1,0,0,6,4
20190131-W-St_Petersburg-R16-Kiki_Bertens-Ysaline_Bonaventure,1,B-DTM,15,3,0,1,2,6,9
20190131-W-St_Petersburg-R16-Kiki_Bertens-Ysaline_Bonaventure,1,B-IO,4,2,0,1,1,2,2
20190131-W-St_Petersburg-R16-Kiki_Bertens-Ysaline_Bonaventure,1,S-XC,3,0,0,0,0,0,3
20190131-W-St_Petersburg-R16-Kiki_Bertens-Ysaline_Bonaventure,1,S-DTM,6,0,0,0,0,3,3
20190131-W-St_Petersburg-R16-Kiki_Bertens-Ysaline_Bonaventure,2,F-XC,26,6,1,3,2,15,11
20190131-W-St_Petersburg-R16-Kiki_Bertens-Ysaline_Bonaventure,2,F-DTM,14,0,0,0,0,9,5
20190131-W-St_Petersburg-R16-Kiki_Bertens-Ysaline_Bonaventure,2,F-DTL,7,3,1,1,1,4,3
20190131-W-St_Petersburg-R16-Kiki_Bertens-Ysaline_Bonaventure,2,F-IO,14,4,1,0,3,7,7
20190131-W-St_Petersburg-R16-Kiki_Bertens-Ysaline_Bonaventure,2,B-XC,17,2,0,0,2,8,9
20190131-W-St_Petersburg-R16-Kiki_Bertens-Ysaline_Bonaventure,2,B-DTM,19,1,0,0,1,10,9
20190131-W-St_Petersburg-R16-Kiki_Bertens-Ysaline_Bonaventure,2,B-DTL,8,3,0,2,1,5,3
20190131-W-St_Petersburg-R16-Kiki_Bertens-Ysaline_Bonaventure,2,B-IO,4,1,0,0,1,1,3
20190131-W-St_Petersburg-R16-Kiki_Bertens-Ysaline_Bonaventure,2,S-DTM,1,0,0,0,0,0,1
20190131-W-St_Petersburg-R16-Kiki_Bertens-Ysaline_Bonaventure,2,S-DTL,1,0,0,0,0,0,1
20190913-W-Zhengzhou-R16-Kiki_Bertens-Ajla_Tomljanovic,1,F-XC,46,11,4,2,5,23,23
20190913-W-Zhengzhou-R16-Kiki_Bertens-Ajla_Tomljanovic,1,F-DTM,20,2,1,0,1,7,13
20190913-W-Zhengzhou-R16-Kiki_Bertens-Ajla_Tomljanovic,1,F-DTL,5,3,1,1,1,3,2
20190913-W-Zhengzhou-R16-Kiki_Bertens-Ajla_Tomljanovic,1,F-IO,12,5,3,1,1,6,6
20190913-W-Zhengzhou-R16-Kiki_Bertens-Ajla_Tomljanovic,1,F-II,1,0,0,0,0,1,0
20190913-W-Zhengzhou-R16-Kiki_Bertens-Ajla_Tomljanovic,1,B-XC,29,7,0,1,6,13,16
20190913-W-Zhengzhou-R16-Kiki_Bertens-Ajla_Tomljanovic,1,B-DTM,42,5,0,0,5,17,25
20190913-W-Zhengzhou-R16-Kiki_Bertens-Ajla_Tomljanovic,1,B-DTL,3,2,1,1,0,3,0
20190913-W-Zhengzhou-R16-Kiki_Bertens-Ajla_Tomljanovic,1,B-IO,7,2,0,1,1,3,4
20190913-W-Zhengzhou-R16-Kiki_Bertens-Ajla_Tomljanovic,1,S-XC,6,1,0,0,1,3,3
20190913-W-Zhengzhou-R16-Kiki_Bertens-Ajla_Tomljanovic,1,S-DTM,5,0,0,0,0,2,3
20190913-W-Zhengzhou-R16-Kiki_Bertens-Ajla_Tomljanovic,1,S-DTL,1,1,0,0,1,0,1
20190913-W-Zhengzhou-R16-Kiki_Bertens-Ajla_Tomljanovic,2,F-XC,37,10,2,4,4,21,16
20190913-W-Zhengzhou-R16-Kiki_Bertens-Ajla_Tomljanovic,2,F-DTM,27,3,1,0,2,10,17
20190913-W-Zhengzhou-R16-Kiki_Bertens-Ajla_Tomljanovic,2,F-DTL,14,3,2,0,1,9,5
20190913-W-Zhengzhou-R16-Kiki_Bertens-Ajla_Tomljanovic,2,F-IO,23,6,3,1,2,16,7
20190913-W-Zhengzhou-R16-Kiki_Bertens-Ajla_Tomljanovic,2,B-XC,34,7,3,2,2,19,15
20190913-W-Zhengzhou-R16-Kiki_Bertens-Ajla_Tomljanovic,2,B-DTM,38,4,0,1,3,22,16
20190913-W-Zhengzhou-R16-Kiki_Bertens-Ajla_Tomljanovic,2,B-DTL,4,2,1,1,0,3,1
20190913-W-Zhengzhou-R16-Kiki_Bertens-Ajla_Tomljanovic,2,B-IO,10,4,1,2,1,9,1
20190913-W-Zhengzhou-R16-Kiki_Bertens-Ajla_Tomljanovic,2,S-XC,3,0,0,0,0,2,1
20190913-W-Zhengzhou-R16-Kiki_Bertens-Ajla_Tomljanovic,2,S-DTM,3,0,0,0,0,1,2
20190913-W-Zhengzhou-R16-Kiki_Bertens-Ajla_Tomljanovic,2,S-DTL,1,0,0,0,0,1,0
20190913-W-Zhengzhou-R16-Kiki_Bertens-Ajla_Tomljanovic,2,S-IO,2,0,0,0,0,1,1
20190910-W-Zhengzhou-R32-Bibiane_Schoofs-Saisai_Zheng,1,F-XC,72,15,3,2,10,27,45
20190910-W-Zhengzhou-R32-Bibiane_Schoofs-Saisai_Zheng,1,F-DTM,36,1,0,1,0,16,20
20190910-W-Zhengzhou-R32-Bibiane_Schoofs-Saisai_Zheng,1,F-DTL,17,6,3,1,2,8,9
20190910-W-Zhengzhou-R32-Bibiane_Schoofs-Saisai_Zheng,1,F-IO,46,13,1,4,8,19,27
20190910-W-Zhengzhou-R32-Bibiane_Schoofs-Saisai_Zheng,1,F-II,3,0,0,0,0,1,2
20190910-W-Zhengzhou-R32-Bibiane_Schoofs-Saisai_Zheng,1,B-XC,40,6,0,2,4,18,22
20190910-W-Zhengzhou-R32-Bibiane_Schoofs-Saisai_Zheng,1,B-DTM,31,6,0,2,4,10,21
20190910-W-Zhengzhou-R32-Bibiane_Schoofs-Saisai_Zheng,1,B-DTL,5,2,1,1,0,2,3
20190910-W-Zhengzhou-R32-Bibiane_Schoofs-Saisai_Zheng,1,B-IO,1,1,0,0,1,0,1
20190910-W-Zhengzhou-R32-Bibiane_Schoofs-Saisai_Zheng,1,S-XC,23,2,0,0,2,6,17
20190910-W-Zhengzhou-R32-Bibiane_Schoofs-Saisai_Zheng,1,S-DTM,8,0,0,0,0,3,5
20190910-W-Zhengzhou-R32-Bibiane_Schoofs-Saisai_Zheng,1,S-DTL,3,0,0,0,0,1,2
20190910-W-Zhengzhou-R32-Bibiane_Schoofs-Saisai_Zheng,1,S-IO,2,1,0,0,1,0,2
20190910-W-Zhengzhou-R32-Bibiane_Schoofs-Saisai_Zheng,2,F-XC,38,9,1,3,5,24,14
20190910-W-Zhengzhou-R32-Bibiane_Schoofs-Saisai_Zheng,2,F-DTM,57,1,0,0,1,37,20
20190910-W-Zhengzhou-R32-Bibiane_Schoofs-Saisai_Zheng,2,F-DTL,14,4,2,0,2,10,4
20190910-W-Zhengzhou-R32-Bibiane_Schoofs-Saisai_Zheng,2,F-IO,33,6,2,0,4,21,12
20190910-W-Zhengzhou-R32-Bibiane_Schoofs-Saisai_Zheng,2,F-II,3,2,0,1,1,2,1
20190910-W-Zhengzhou-R32-Bibiane_Schoofs-Saisai_Zheng,2,B-XC,38,6,1,2,3,21,17
20190910-W-Zhengzhou-R32-Bibiane_Schoofs-Saisai_Zheng,2,B-DTM,40,5,0,3,2,28,12
20190910-W-Zhengzhou-R32-Bibiane_Schoofs-Saisai_Zheng,2,B-DTL,9,2,2,0,0,5,4
20190910-W-Zhengzhou-R32-Bibiane_Schoofs-Saisai_Zheng,2,B-IO,6,3,0,1,2,4,2
20190910-W-Zhengzhou-R32-Bibiane_Schoofs-Saisai_Zheng,2,S-XC,6,2,0,1,1,3,3
20190910-W-Zhengzhou-R32-Bibiane_Schoofs-Saisai_Zheng,2,S-DTM,12,1,0,1,0,6,6
20190910-W-Zhengzhou-R32-Bibiane_Schoofs-Saisai_Zheng,2,S-DTL,7,1,0,0,1,4,3
20190910-W-Zhengzhou-R32-Bibiane_Schoofs-Saisai_Zheng,2,S-IO,3,1,0,0,1,1,2
20190911-W-Zhengzhou-R16-Karolina_Pliskova-Polona_Hercog,1,F-XC,38,9,5,0,4,23,15
20190911-W-Zhengzhou-R16-Karolina_Pliskova-Polona_Hercog,1,F-DTM,37,5,0,0,5,15,22
20190911-W-Zhengzhou-R16-Karolina_Pliskova-Polona_Hercog,1,F-DTL,5,0,0,0,0,5,0
20190911-W-Zhengzhou-R16-Karolina_Pliskova-Polona_Hercog,1,F-IO,35,12,5,2,5,23,12
20190911-W-Zhengzhou-R16-Karolina_Pliskova-Polona_Hercog,1,F-II,1,1,1,0,0,1,0
20190911-W-Zhengzhou-R16-Karolina_Pliskova-Polona_Hercog,1,B-XC,30,4,1,0,3,15,15
20190911-W-Zhengzhou-R16-Karolina_Pliskova-Polona_Hercog,1,B-DTM,38,3,0,0,3,18,20
20190911-W-Zhengzhou-R16-Karolina_Pliskova-Polona_Hercog,1,B-DTL,11,6,2,0,4,5,6
20190911-W-Zhengzhou-R16-Karolina_Pliskova-Polona_Hercog,1,B-IO,5,3,2,0,1,3,2
20190911-W-Zhengzhou-R16-Karolina_Pliskova-Polona_Hercog,1,S-XC,5,0,0,0,0,3,2
20190911-W-Zhengzhou-R16-Karolina_Pliskova-Polona_Hercog,1,S-DTM,9,1,0,0,1,8,1
20190911-W-Zhengzhou-R16-Karolina_Pliskova-Polona_Hercog,1,S-DTL,2,1,0,0,1,0,2
20190911-W-Zhengzhou-R16-Karolina_Pliskova-Polona_Hercog,2,F-XC,26,14,5,1,8,12,14
20190911-W-Zhengzhou-R16-Karolina_Pliskova-Polona_Hercog,2,F-DTM,40,5,0,1,4,17,23
20190911-W-Zhengzhou-R16-Karolina_Pliskova-Polona_Hercog,2,F-DTL,14,5,2,0,3,7,7
20190911-W-Zhengzhou-R16-Karolina_Pliskova-Polona_Hercog,2,F-IO,36,10,2,2,6,21,15
20190911-W-Zhengzhou-R16-Karolina_Pliskova-Polona_Hercog,2,F-II,2,0,0,0,0,1,1
20190911-W-Zhengzhou-R16-Karolina_Pliskova-Polona_Hercog,2,B-XC,14,2,0,0,2,6,8
20190911-W-Zhengzhou-R16-Karolina_Pliskova-Polona_Hercog,2,B-DTM,19,2,0,0,2,8,11
20190911-W-Zhengzhou-R16-Karolina_Pliskova-Polona_Hercog,2,B-DTL,3,1,1,0,0,2,1
20190911-W-Zhengzhou-R16-Karolina_Pliskova-Polona_Hercog,2,B-IO,2,0,0,0,0,0,2
20190911-W-Zhengzhou-R16-Karolina_Pliskova-Polona_Hercog,2,S-XC,24,1,0,0,1,6,18
20190911-W-Zhengzhou-R16-Karolina_Pliskova-Polona_Hercog,2,S-DTM,30,2,0,0,2,12,18
20190911-W-Zhengzhou-R16-Karolina_Pliskova-Polona_Hercog,2,S-DTL,6,2,0,0,2,2,4
20190911-W-Zhengzhou-R16-Karolina_Pliskova-Polona_Hercog,2,S-IO,1,0,0,0,0,0,1
20190918-W-Guangzhou-R16-Marie_Bouzkova-Elina_Svitolina,1,F-XC,18,6,2,1,3,10,8
20190918-W-Guangzhou-R16-Marie_Bouzkova-Elina_Svitolina,1,F-DTM,23,5,0,0,5,10,13
20190918-W-Guangzhou-R16-Marie_Bouzkova-Elina_Svitolina,1,F-DTL,6,2,1,0,1,4,2
20190918-W-Guangzhou-R16-Marie_Bouzkova-Elina_Svitolina,1,F-IO,6,4,3,0,1,4,2
20190918-W-Guangzhou-R16-Marie_Bouzkova-Elina_Svitolina,1,B-XC,14,1,1,0,0,7,7
20190918-W-Guangzhou-R16-Marie_Bouzkova-Elina_Svitolina,1,B-DTM,33,1,0,0,1,12,21
20190918-W-Guangzhou-R16-Marie_Bouzkova-Elina_Svitolina,1,B-DTL,7,4,1,0,3,3,4
20190918-W-Guangzhou-R16-Marie_Bouzkova-Elina_Svitolina,1,B-IO,4,2,0,0,2,1,3
20190918-W-Guangzhou-R16-Marie_Bouzkova-Elina_Svitolina,1,S-XC,1,0,0,0,0,0,1
20190918-W-Guangzhou-R16-Marie_Bouzkova-Elina_Svitolina,1,S-DTM,7,1,0,0,1,3,4
20190918-W-Guangzhou-R16-Marie_Bouzkova-Elina_Svitolina,1,S-IO,1,0,0,0,0,0,1
20190918-W-Guangzhou-R16-Marie_Bouzkova-Elina_Svitolina,2,F-XC,42,18,5,3,9,22,20
20190918-W-Guangzhou-R16-Marie_Bouzkova-Elina_Svitolina,2,F-DTM,24,2,0,2,0,15,9
20190918-W-Guangzhou-R16-Marie_Bouzkova-Elina_Svitolina,2,F-DTL,6,2,0,0,2,2,4
20190918-W-Guangzhou-R16-Marie_Bouzkova-Elina_Svitolina,2,F-IO,19,8,2,1,5,9,10
20190918-W-Guangzhou-R16-Marie_Bouzkova-Elina_Svitolina,2,B-XC,18,3,1,0,2,11,7
20190918-W-Guangzhou-R16-Marie_Bouzkova-Elina_Svitolina,2,B-DTM,13,2,0,0,2,9,4
20190918-W-Guangzhou-R16-Marie_Bouzkova-Elina_Svitolina,2,B-DTL,4,4,2,0,2,2,2
20190918-W-Guangzhou-R16-Marie_Bouzkova-Elina_Svitolina,2,B-IO,3,2,0,0,2,1,2
20190918-W-Guangzhou-R16-Marie_Bouzkova-Elina_Svitolina,2,S-XC,4,0,0,0,0,0,4
20190918-W-Guangzhou-R16-Marie_Bouzkova-Elina_Svitolina,2,S-DTM,3,0,0,0,0,3,0
20190918-W-Guangzhou-R16-Marie_Bouzkova-Elina_Svitolina,2,S-DTL,1,0,0,0,0,0,1
20190918-W-Guangzhou-R32-Laura_Siegemund-Sofia_Kenin,1,F-XC,27,10,4,1,5,11,16
20190918-W-Guangzhou-R32-Laura_Siegemund-Sofia_Kenin,1,F-DTM,28,5,0,0,5,11,17
20190918-W-Guangzhou-R32-Laura_Siegemund-Sofia_Kenin,1,F-DTL,4,2,0,0,2,1,3
20190918-W-Guangzhou-R32-Laura_Siegemund-Sofia_Kenin,1,F-IO,11,7,2,2,3,6,5
20190918-W-Guangzhou-R32-Laura_Siegemund-Sofia_Kenin,1,B-XC,8,5,1,2,2,4,4
20190918-W-Guangzhou-R32-Laura_Siegemund-Sofia_Kenin,1,B-DTM,16,3,0,0,3,5,11
20190918-W-Guangzhou-R32-Laura_Siegemund-Sofia_Kenin,1,B-DTL,1,1,0,0,1,0,1
20190918-W-Guangzhou-R32-Laura_Siegemund-Sofia_Kenin,1,B-IO,6,3,3,0,0,4,2
20190918-W-Guangzhou-R32-Laura_Siegemund-Sofia_Kenin,1,S-DTM,3,0,0,0,0,1,2
20190918-W-Guangzhou-R32-Laura_Siegemund-Sofia_Kenin,1,S-DTL,1,0,0,0,0,0,1
20190918-W-Guangzhou-R32-Laura_Siegemund-Sofia_Kenin,2,F-XC,28,11,1,5,5,19,9
20190918-W-Guangzhou-R32-Laura_Siegemund-Sofia_Kenin,2,F-DTM,25,3,0,0,3,12,13
20190918-W-Guangzhou-R32-Laura_Siegemund-Sofia_Kenin,2,F-DTL,3,2,1,1,0,2,1
20190918-W-Guangzhou-R32-Laura_Siegemund-Sofia_Kenin,2,F-IO,4,1,0,0,1,3,1
20190918-W-Guangzhou-R32-Laura_Siegemund-Sofia_Kenin,2,B-XC,11,3,0,1,2,5,6
20190918-W-Guangzhou-R32-Laura_Siegemund-Sofia_Kenin,2,B-DTM,16,3,0,0,3,6,10
20190918-W-Guangzhou-R32-Laura_Siegemund-Sofia_Kenin,2,B-DTL,3,3,0,2,1,2,1
20190918-W-Guangzhou-R32-Laura_Siegemund-Sofia_Kenin,2,B-IO,2,1,0,1,0,2,0
20190918-W-Guangzhou-R32-Laura_Siegemund-Sofia_Kenin,2,S-XC,2,0,0,0,0,2,0
20190918-W-Guangzhou-R32-Laura_Siegemund-Sofia_Kenin,2,S-DTM,6,0,0,0,0,2,4
20190917-W-Guangzhou-R32-Andrea_Petkovic-Lesley_Kerkhove,1,F-XC,42,19,5,2,12,21,21
20190917-W-Guangzhou-R32-Andrea_Petkovic-Lesley_Kerkhove,1,F-DTM,30,3,1,1,1,19,11
20190917-W-Guangzhou-R32-Andrea_Petkovic-Lesley_Kerkhove,1,F-DTL,6,4,3,0,1,5,1
20190917-W-Guangzhou-R32-Andrea_Petkovic-Lesley_Kerkhove,1,F-IO,12,5,0,0,5,2,10
20190917-W-Guangzhou-R32-Andrea_Petkovic-Lesley_Kerkhove,1,B-XC,47,13,1,2,10,26,21
20190917-W-Guangzhou-R32-Andrea_Petkovic-Lesley_Kerkhove,1,B-DTM,51,5,0,1,4,23,28
20190917-W-Guangzhou-R32-Andrea_Petkovic-Lesley_Kerkhove,1,B-DTL,9,5,1,2,2,4,5
20190917-W-Guangzhou-R32-Andrea_Petkovic-Lesley_Kerkhove,1,B-IO,1,1,0,0,1,0,1
20190917-W-Guangzhou-R32-Andrea_Petkovic-Lesley_Kerkhove,1,S-XC,4,0,0,0,0,1,3
20190917-W-Guangzhou-R32-Andrea_Petkovic-Lesley_Kerkhove,1,S-DTM,5,0,0,0,0,1,4
20190917-W-Guangzhou-R32-Andrea_Petkovic-Lesley_Kerkhove,2,F-XC,50,22,11,2,9,28,22
20190917-W-Guangzhou-R32-Andrea_Petkovic-Lesley_Kerkhove,2,F-DTM,38,7,0,0,7,13,25
20190917-W-Guangzhou-R32-Andrea_Petkovic-Lesley_Kerkhove,2,F-DTL,9,6,4,0,2,7,2
20190917-W-Guangzhou-R32-Andrea_Petkovic-Lesley_Kerkhove,2,F-IO,37,15,7,2,6,19,18
20190917-W-Guangzhou-R32-Andrea_Petkovic-Lesley_Kerkhove,2,B-XC,42,10,2,0,8,16,26
20190917-W-Guangzhou-R32-Andrea_Petkovic-Lesley_Kerkhove,2,B-DTM,27,3,0,0,3,11,16
20190917-W-Guangzhou-R32-Andrea_Petkovic-Lesley_Kerkhove,2,B-DTL,10,4,1,1,2,4,6
20190917-W-Guangzhou-R32-Andrea_Petkovic-Lesley_Kerkhove,2,B-IO,7,2,0,0,2,3,4
20190917-W-Guangzhou-R32-Andrea_Petkovic-Lesley_Kerkhove,2,S-XC,2,0,0,0,0,1,1
20190917-W-Guangzhou-R32-Andrea_Petkovic-Lesley_Kerkhove,2,S-DTM,1,0,0,0,0,0,1
20190919-W-Osaka-R16-Anastasia_Pavlyuchenkova-Kiki_Bertens,1,F-XC,42,8,1,4,3,35,7
20190919-W-Osaka-R16-Anastasia_Pavlyuchenkova-Kiki_Bertens,1,F-DTM,20,4,0,0,4,11,9
20190919-W-Osaka-R16-Anastasia_Pavlyuchenkova-Kiki_Bertens,1,F-DTL,17,6,3,2,1,11,6
20190919-W-Osaka-R16-Anastasia_Pavlyuchenkova-Kiki_Bertens,1,F-IO,17,3,1,1,1,14,3
20190919-W-Osaka-R16-Anastasia_Pavlyuchenkova-Kiki_Bertens,1,B-XC,22,6,1,1,4,12,10
20190919-W-Osaka-R16-Anastasia_Pavlyuchenkova-Kiki_Bertens,1,B-DTM,17,1,0,1,0,11,6
20190919-W-Osaka-R16-Anastasia_Pavlyuchenkova-Kiki_Bertens,1,B-DTL,7,2,1,0,1,4,3
20190919-W-Osaka-R16-Anastasia_Pavlyuchenkova-Kiki_Bertens,1,B-IO,2,1,0,1,0,1,1
20190919-W-Osaka-R16-Anastasia_Pavlyuchenkova-Kiki_Bertens,1,S-DTM,2,0,0,0,0,1,1
20190919-W-Osaka-R16-Anastasia_Pavlyuchenkova-Kiki_Bertens,1,S-DTL,1,0,0,0,0,1,0
20190919-W-Osaka-R16-Anastasia_Pavlyuchenkova-Kiki_Bertens,2,F-XC,42,8,0,2,6,15,27
20190919-W-Osaka-R16-Anastasia_Pavlyuchenkova-Kiki_Bertens,2,F-DTM,22,4,0,1,3,7,15
20190919-W-Osaka-R16-Anastasia_Pavlyuchenkova-Kiki_Bertens,2,F-DTL,9,7,5,1,1,7,2
20190919-W-Osaka-R16-Anastasia_Pavlyuchenkova-Kiki_Bertens,2,F-IO,14,9,5,1,3,9,5
20190919-W-Osaka-R16-Anastasia_Pavlyuchenkova-Kiki_Bertens,2,F-II,2,0,0,0,0,1,1
20190919-W-Osaka-R16-Anastasia_Pavlyuchenkova-Kiki_Bertens,2,B-XC,22,5,0,0,5,7,15
20190919-W-Osaka-R16-Anastasia_Pavlyuchenkova-Kiki_Bertens,2,B-DTM,21,3,0,0,3,4,17
20190919-W-Osaka-R16-Anastasia_Pavlyuchenkova-Kiki_Bertens,2,B-DTL,1,0,0,0,0,0,1
20190919-W-Osaka-R16-Anastasia_Pavlyuchenkova-Kiki_Bertens,2,B-IO,2,1,0,0,1,0,2
20190919-W-Osaka-R16-Anastasia_Pavlyuchenkova-Kiki_Bertens,2,S-XC,7,0,0,0,0,1,6
20190919-W-Osaka-R16-Anastasia_Pavlyuchenkova-Kiki_Bertens,2,S-DTM,6,0,0,0,0,2,4
20190919-W-Osaka-R16-Anastasia_Pavlyuchenkova-Kiki_Bertens,2,S-DTL,1,0,0,0,0,1,0
20190919-W-Osaka-R16-Anastasia_Pavlyuchenkova-Kiki_Bertens,2,S-IO,1,1,0,0,1,0,1
20190919-W-Seoul-R16-Patricia_Maria_Tig-Paula_Badosa,1,F-XC,43,16,4,2,10,19,24
20190919-W-Seoul-R16-Patricia_Maria_Tig-Paula_Badosa,1,F-DTM,23,4,0,1,3,8,15
20190919-W-Seoul-R16-Patricia_Maria_Tig-Paula_Badosa,1,F-DTL,4,1,0,0,1,3,1
20190919-W-Seoul-R16-Patricia_Maria_Tig-Paula_Badosa,1,F-IO,19,8,4,1,3,12,7
20190919-W-Seoul-R16-Patricia_Maria_Tig-Paula_Badosa,1,F-II,1,0,0,0,0,1,0
20190919-W-Seoul-R16-Patricia_Maria_Tig-Paula_Badosa,1,B-XC,28,8,2,1,5,12,16
20190919-W-Seoul-R16-Patricia_Maria_Tig-Paula_Badosa,1,B-DTM,18,2,0,0,2,10,8
20190919-W-Seoul-R16-Patricia_Maria_Tig-Paula_Badosa,1,B-DTL,1,0,0,0,0,1,0
20190919-W-Seoul-R16-Patricia_Maria_Tig-Paula_Badosa,1,B-IO,3,2,0,1,1,2,1
20190919-W-Seoul-R16-Patricia_Maria_Tig-Paula_Badosa,1,S-XC,3,0,0,0,0,0,3
20190919-W-Seoul-R16-Patricia_Maria_Tig-Paula_Badosa,1,S-DTM,7,0,0,0,0,4,3
20190919-W-Seoul-R16-Patricia_Maria_Tig-Paula_Badosa,2,F-XC,22,4,1,2,1,13,9
20190919-W-Seoul-R16-Patricia_Maria_Tig-Paula_Badosa,2,F-DTM,31,3,0,0,3,11,20
20190919-W-Seoul-R16-Patricia_Maria_Tig-Paula_Badosa,2,F-DTL,7,3,1,1,1,4,3
20190919-W-Seoul-R16-Patricia_Maria_Tig-Paula_Badosa,2,F-IO,12,3,3,0,0,9,3
20190919-W-Seoul-R16-Patricia_Maria_Tig-Paula_Badosa,2,B-XC,21,5,1,1,3,12,9
20190919-W-Seoul-R16-Patricia_Maria_Tig-Paula_Badosa,2,B-DTM,32,3,0,0,3,18,14
20190919-W-Seoul-R16-Patricia_Maria_Tig-Paula_Badosa,2,B-DTL,7,3,1,2,0,4,3
20190919-W-Seoul-R16-Patricia_Maria_Tig-Paula_Badosa,2,B-IO,5,1,1,0,0,4,1
20190919-W-Seoul-R16-Patricia_Maria_Tig-Paula_Badosa,2,S-XC,2,1,0,0,1,0,2
20190919-W-Seoul-R16-Patricia_Maria_Tig-Paula_Badosa,2,S-DTM,6,0,0,0,0,1,5
20170527-W-Nurnberg-F-Kiki_Bertens-Barbora_Krejcikova,1,F-XC,13,5,0,3,2,9,4
20170527-W-Nurnberg-F-Kiki_Bertens-Barbora_Krejcikova,1,F-DTM,9,1,0,0,1,5,4
20170527-W-Nurnberg-F-Kiki_Bertens-Barbora_Krejcikova,1,F-DTL,5,2,2,0,0,5,0
20170527-W-Nurnberg-F-Kiki_Bertens-Barbora_Krejcikova,1,F-IO,10,3,2,1,0,8,2
20170527-W-Nurnberg-F-Kiki_Bertens-Barbora_Krejcikova,1,B-XC,15,3,0,0,3,8,7
20170527-W-Nurnberg-F-Kiki_Bertens-Barbora_Krejcikova,1,B-DTM,6,2,0,1,1,4,2
20170527-W-Nurnberg-F-Kiki_Bertens-Barbora_Krejcikova,1,B-DTL,2,0,0,0,0,2,0
20170527-W-Nurnberg-F-Kiki_Bertens-Barbora_Krejcikova,1,S-XC,6,0,0,0,0,4,2
20170527-W-Nurnberg-F-Kiki_Bertens-Barbora_Krejcikova,1,S-DTM,3,0,0,0,0,2,1
20170527-W-Nurnberg-F-Kiki_Bertens-Barbora_Krejcikova,2,F-XC,18,6,0,2,4,6,12
20170527-W-Nurnberg-F-Kiki_Bertens-Barbora_Krejcikova,2,F-DTM,4,1,0,0,1,0,4
20170527-W-Nurnberg-F-Kiki_Bertens-Barbora_Krejcikova,2,F-DTL,1,1,1,0,0,1,0
20170527-W-Nurnberg-F-Kiki_Bertens-Barbora_Krejcikova,2,F-IO,14,7,2,0,5,4,10
20170527-W-Nurnberg-F-Kiki_Bertens-Barbora_Krejcikova,2,F-II,2,2,1,0,1,1,1
20170527-W-Nurnberg-F-Kiki_Bertens-Barbora_Krejcikova,2,B-XC,12,2,0,0,2,7,5
20170527-W-Nurnberg-F-Kiki_Bertens-Barbora_Krejcikova,2,B-DTM,5,0,0,0,0,1,4
20170527-W-Nurnberg-F-Kiki_Bertens-Barbora_Krejcikova,2,S-XC,9,0,0,0,0,0,9
20170527-W-Nurnberg-F-Kiki_Bertens-Barbora_Krejcikova,2,S-DTM,5,0,0,0,0,2,3
20170527-W-Nurnberg-F-Kiki_Bertens-Barbora_Krejcikova,2,S-DTL,1,1,0,0,1,0,1
20190921-W-Seoul-SF-Karolina_Muchova-Yafan_Wang,1,F-XC,35,10,4,2,4,18,17
20190921-W-Seoul-SF-Karolina_Muchova-Yafan_Wang,1,F-DTM,32,2,0,1,1,17,15
20190921-W-Seoul-SF-Karolina_Muchova-Yafan_Wang,1,F-DTL,21,9,3,1,5,10,11
20190921-W-Seoul-SF-Karolina_Muchova-Yafan_Wang,1,F-IO,18,5,3,1,1,12,6
20190921-W-Seoul-SF-Karolina_Muchova-Yafan_Wang,1,F-II,3,1,0,0,1,2,1
20190921-W-Seoul-SF-Karolina_Muchova-Yafan_Wang,1,B-XC,29,6,2,2,2,20,9
20190921-W-Seoul-SF-Karolina_Muchova-Yafan_Wang,1,B-DTM,30,1,0,0,1,17,13
20190921-W-Seoul-SF-Karolina_Muchova-Yafan_Wang,1,B-DTL,8,7,5,0,2,6,2
20190921-W-Seoul-SF-Karolina_Muchova-Yafan_Wang,1,B-IO,4,3,1,2,0,4,0
20190921-W-Seoul-SF-Karolina_Muchova-Yafan_Wang,1,S-XC,9,0,0,0,0,0,9
20190921-W-Seoul-SF-Karolina_Muchova-Yafan_Wang,1,S-DTM,12,1,0,0,1,6,6
20190921-W-Seoul-SF-Karolina_Muchova-Yafan_Wang,1,S-DTL,1,0,0,0,0,1,0
20190921-W-Seoul-SF-Karolina_Muchova-Yafan_Wang,1,S-IO,2,0,0,0,0,2,0
20190921-W-Seoul-SF-Karolina_Muchova-Yafan_Wang,2,F-XC,61,12,4,6,2,29,32
20190921-W-Seoul-SF-Karolina_Muchova-Yafan_Wang,2,F-DTM,29,2,0,0,2,13,16
20190921-W-Seoul-SF-Karolina_Muchova-Yafan_Wang,2,F-DTL,10,6,3,2,1,6,4
20190921-W-Seoul-SF-Karolina_Muchova-Yafan_Wang,2,F-IO,19,6,3,2,1,13,6
20190921-W-Seoul-SF-Karolina_Muchova-Yafan_Wang,2,F-II,4,1,0,1,0,4,0
20190921-W-Seoul-SF-Karolina_Muchova-Yafan_Wang,2,B-XC,41,4,0,2,2,21,20
20190921-W-Seoul-SF-Karolina_Muchova-Yafan_Wang,2,B-DTM,33,5,1,1,3,11,22
20190921-W-Seoul-SF-Karolina_Muchova-Yafan_Wang,2,B-DTL,7,3,1,0,2,3,4
20190921-W-Seoul-SF-Karolina_Muchova-Yafan_Wang,2,B-IO,2,1,1,0,0,2,0
20190921-W-Seoul-SF-Karolina_Muchova-Yafan_Wang,2,S-XC,1,0,0,0,0,0,1
20190921-W-Seoul-SF-Karolina_Muchova-Yafan_Wang,2,S-DTM,8,0,0,0,0,4,4
20190921-W-Seoul-SF-Karolina_Muchova-Yafan_Wang,2,S-DTL,6,0,0,0,0,4,2
20190829-W-US_Open-R64-Su_Wei_Hsieh-Karolina_Muchova,1,F-XC,28,7,1,2,4,11,17
20190829-W-US_Open-R64-Su_Wei_Hsieh-Karolina_Muchova,1,F-DTM,19,0,0,0,0,8,11
20190829-W-US_Open-R64-Su_Wei_Hsieh-Karolina_Muchova,1,F-DTL,8,2,0,2,0,5,3
20190829-W-US_Open-R64-Su_Wei_Hsieh-Karolina_Muchova,1,F-IO,12,5,0,0,5,5,7
20190829-W-US_Open-R64-Su_Wei_Hsieh-Karolina_Muchova,1,B-XC,41,10,0,3,7,21,20
20190829-W-US_Open-R64-Su_Wei_Hsieh-Karolina_Muchova,1,B-DTM,24,2,0,0,2,11,13
20190829-W-US_Open-R64-Su_Wei_Hsieh-Karolina_Muchova,1,B-DTL,8,6,1,2,3,3,5
20190829-W-US_Open-R64-Su_Wei_Hsieh-Karolina_Muchova,1,B-IO,7,3,2,0,1,4,3
20190829-W-US_Open-R64-Su_Wei_Hsieh-Karolina_Muchova,1,S-XC,5,0,0,0,0,2,3
20190829-W-US_Open-R64-Su_Wei_Hsieh-Karolina_Muchova,1,S-DTM,7,0,0,0,0,0,7
20190829-W-US_Open-R64-Su_Wei_Hsieh-Karolina_Muchova,1,S-DTL,2,1,0,0,1,1,1
20190829-W-US_Open-R64-Su_Wei_Hsieh-Karolina_Muchova,2,F-XC,24,9,3,0,6,13,11
20190829-W-US_Open-R64-Su_Wei_Hsieh-Karolina_Muchova,2,F-DTM,28,4,0,0,4,14,14
20190829-W-US_Open-R64-Su_Wei_Hsieh-Karolina_Muchova,2,F-DTL,13,6,3,1,2,9,4
20190829-W-US_Open-R64-Su_Wei_Hsieh-Karolina_Muchova,2,F-IO,17,8,3,1,4,6,11
20190829-W-US_Open-R64-Su_Wei_Hsieh-Karolina_Muchova,2,F-II,2,0,0,0,0,1,1
20190829-W-US_Open-R64-Su_Wei_Hsieh-Karolina_Muchova,2,B-XC,22,5,0,2,3,9,13
20190829-W-US_Open-R64-Su_Wei_Hsieh-Karolina_Muchova,2,B-DTM,15,6,0,0,6,3,12
20190829-W-US_Open-R64-Su_Wei_Hsieh-Karolina_Muchova,2,B-DTL,9,5,2,1,2,5,4
20190829-W-US_Open-R64-Su_Wei_Hsieh-Karolina_Muchova,2,B-IO,5,4,2,0,2,3,2
20190829-W-US_Open-R64-Su_Wei_Hsieh-Karolina_Muchova,2,S-XC,16,4,0,1,3,7,9
20190829-W-US_Open-R64-Su_Wei_Hsieh-Karolina_Muchova,2,S-DTM,19,2,0,1,1,7,12
20190829-W-US_Open-R64-Su_Wei_Hsieh-Karolina_Muchova,2,S-DTL,3,1,0,1,0,1,2
20190829-W-US_Open-R64-Su_Wei_Hsieh-Karolina_Muchova,2,S-IO,1,1,0,0,1,0,1
20190922-W-Seoul-F-Magda_Linette-Karolina_Muchova,1,F-XC,23,8,4,2,2,10,13
20190922-W-Seoul-F-Magda_Linette-Karolina_Muchova,1,F-DTM,9,0,0,0,0,6,3
20190922-W-Seoul-F-Magda_Linette-Karolina_Muchova,1,F-DTL,5,2,0,0,2,0,5
20190922-W-Seoul-F-Magda_Linette-Karolina_Muchova,1,F-IO,7,1,1,0,0,4,3
20190922-W-Seoul-F-Magda_Linette-Karolina_Muchova,1,B-XC,40,7,0,0,7,17,23
20190922-W-Seoul-F-Magda_Linette-Karolina_Muchova,1,B-DTM,25,1,0,0,1,7,18
20190922-W-Seoul-F-Magda_Linette-Karolina_Muchova,1,B-DTL,6,2,0,0,2,1,5
20190922-W-Seoul-F-Magda_Linette-Karolina_Muchova,1,B-IO,3,0,0,0,0,1,2
20190922-W-Seoul-F-Magda_Linette-Karolina_Muchova,1,S-XC,3,1,0,0,1,1,2
20190922-W-Seoul-F-Magda_Linette-Karolina_Muchova,2,F-XC,18,7,2,1,4,11,7
20190922-W-Seoul-F-Magda_Linette-Karolina_Muchova,2,F-DTM,19,1,0,0,1,13,6
20190922-W-Seoul-F-Magda_Linette-Karolina_Muchova,2,F-DTL,7,4,2,2,0,7,0
20190922-W-Seoul-F-Magda_Linette-Karolina_Muchova,2,F-IO,11,4,2,1,1,10,1
20190922-W-Seoul-F-Magda_Linette-Karolina_Muchova,2,B-XC,14,0,0,0,0,9,5
20190922-W-Seoul-F-Magda_Linette-Karolina_Muchova,2,B-DTM,14,3,0,1,2,3,11
20190922-W-Seoul-F-Magda_Linette-Karolina_Muchova,2,B-DTL,5,3,2,1,0,5,0
20190922-W-Seoul-F-Magda_Linette-Karolina_Muchova,2,B-IO,3,1,1,0,0,3,0
20190922-W-Seoul-F-Magda_Linette-Karolina_Muchova,2,S-XC,9,3,0,1,2,4,5
20190922-W-Seoul-F-Magda_Linette-Karolina_Muchova,2,S-DTM,8,1,0,1,0,4,4
20190922-W-Seoul-F-Magda_Linette-Karolina_Muchova,2,S-DTL,4,0,0,0,0,1,3
20190924-W-Wuhan-R32-Bernarda_Pera-Kiki_Bertens,1,F-XC,68,14,4,3,7,35,33
20190924-W-Wuhan-R32-Bernarda_Pera-Kiki_Bertens,1,F-DTM,43,8,0,0,8,11,32
20190924-W-Wuhan-R32-Bernarda_Pera-Kiki_Bertens,1,F-DTL,8,4,0,1,3,3,5
20190924-W-Wuhan-R32-Bernarda_Pera-Kiki_Bertens,1,F-IO,13,2,0,0,2,5,8
20190924-W-Wuhan-R32-Bernarda_Pera-Kiki_Bertens,1,F-II,2,0,0,0,0,2,0
20190924-W-Wuhan-R32-Bernarda_Pera-Kiki_Bertens,1,B-XC,49,13,1,5,7,23,26
20190924-W-Wuhan-R32-Bernarda_Pera-Kiki_Bertens,1,B-DTM,40,6,1,1,4,20,20
20190924-W-Wuhan-R32-Bernarda_Pera-Kiki_Bertens,1,B-DTL,9,4,2,0,2,4,5
20190924-W-Wuhan-R32-Bernarda_Pera-Kiki_Bertens,1,B-IO,8,2,2,0,0,4,4
20190924-W-Wuhan-R32-Bernarda_Pera-Kiki_Bertens,1,S-DTM,5,0,0,0,0,1,4
20190924-W-Wuhan-R32-Bernarda_Pera-Kiki_Bertens,1,S-DTL,5,1,0,0,1,2,3
20190924-W-Wuhan-R32-Bernarda_Pera-Kiki_Bertens,1,S-IO,1,0,0,0,0,0,1
20190924-W-Wuhan-R32-Bernarda_Pera-Kiki_Bertens,2,F-XC,47,9,1,3,5,25,22
20190924-W-Wuhan-R32-Bernarda_Pera-Kiki_Bertens,2,F-DTM,34,5,1,0,4,16,18
20190924-W-Wuhan-R32-Bernarda_Pera-Kiki_Bertens,2,F-DTL,4,3,0,1,2,2,2
20190924-W-Wuhan-R32-Bernarda_Pera-Kiki_Bertens,2,F-IO,8,3,1,1,1,5,3
20190924-W-Wuhan-R32-Bernarda_Pera-Kiki_Bertens,2,F-II,1,1,0,0,1,0,1
20190924-W-Wuhan-R32-Bernarda_Pera-Kiki_Bertens,2,B-XC,10,5,1,1,3,3,7
20190924-W-Wuhan-R32-Bernarda_Pera-Kiki_Bertens,2,B-DTM,31,4,0,2,2,20,11
20190924-W-Wuhan-R32-Bernarda_Pera-Kiki_Bertens,2,B-DTL,7,4,2,1,1,4,3
20190924-W-Wuhan-R32-Bernarda_Pera-Kiki_Bertens,2,B-IO,5,2,1,0,1,3,2
20190924-W-Wuhan-R32-Bernarda_Pera-Kiki_Bertens,2,S-XC,18,2,0,0,2,11,7
20190924-W-Wuhan-R32-Bernarda_Pera-Kiki_Bertens,2,S-DTM,32,1,0,0,1,21,11
20190924-W-Wuhan-R32-Bernarda_Pera-Kiki_Bertens,2,S-DTL,1,0,0,0,0,0,1
20190924-W-Wuhan-R32-Bernarda_Pera-Kiki_Bertens,2,S-IO,1,0,0,0,0,0,1
20190805-W-Toronto-R64-Anett_Kontaveit-Maria_Sharapova,1,F-XC,48,19,3,8,8,27,21
20190805-W-Toronto-R64-Anett_Kontaveit-Maria_Sharapova,1,F-DTM,30,3,0,1,2,18,12
20190805-W-Toronto-R64-Anett_Kontaveit-Maria_Sharapova,1,F-DTL,12,5,1,1,3,7,5
20190805-W-Toronto-R64-Anett_Kontaveit-Maria_Sharapova,1,F-IO,12,10,5,1,4,6,6
20190805-W-Toronto-R64-Anett_Kontaveit-Maria_Sharapova,1,B-XC,38,14,5,3,6,23,15
20190805-W-Toronto-R64-Anett_Kontaveit-Maria_Sharapova,1,B-DTM,36,2,0,0,2,18,18
20190805-W-Toronto-R64-Anett_Kontaveit-Maria_Sharapova,1,B-DTL,4,3,2,1,0,4,0
20190805-W-Toronto-R64-Anett_Kontaveit-Maria_Sharapova,1,B-IO,5,3,2,0,1,2,3
20190805-W-Toronto-R64-Anett_Kontaveit-Maria_Sharapova,1,S-XC,2,0,0,0,0,1,1
20190805-W-Toronto-R64-Anett_Kontaveit-Maria_Sharapova,1,S-DTM,2,0,0,0,0,2,0
20190805-W-Toronto-R64-Anett_Kontaveit-Maria_Sharapova,2,F-XC,34,10,2,2,6,14,20
20190805-W-Toronto-R64-Anett_Kontaveit-Maria_Sharapova,2,F-DTM,38,5,0,0,5,17,21
20190805-W-Toronto-R64-Anett_Kontaveit-Maria_Sharapova,2,F-DTL,10,6,1,1,4,5,5
20190805-W-Toronto-R64-Anett_Kontaveit-Maria_Sharapova,2,F-IO,19,6,4,1,1,12,7
20190805-W-Toronto-R64-Anett_Kontaveit-Maria_Sharapova,2,B-XC,28,8,2,2,4,13,15
20190805-W-Toronto-R64-Anett_Kontaveit-Maria_Sharapova,2,B-DTM,40,5,0,0,5,14,26
20190805-W-Toronto-R64-Anett_Kontaveit-Maria_Sharapova,2,B-DTL,8,3,3,0,0,5,3
20190805-W-Toronto-R64-Anett_Kontaveit-Maria_Sharapova,2,B-IO,7,4,2,1,1,3,4
20190805-W-Toronto-R64-Anett_Kontaveit-Maria_Sharapova,2,S-XC,1,1,0,1,0,1,0
20190805-W-Toronto-R64-Anett_Kontaveit-Maria_Sharapova,2,S-DTM,1,0,0,0,0,0,1
20190805-W-Toronto-R64-Anett_Kontaveit-Maria_Sharapova,2,S-IO,2,1,0,0,1,1,1
20190928-W-Wuhan-F-Aryna_Sabalenka-Alison_Riske,1,F-XC,31,11,2,2,7,10,21
20190928-W-Wuhan-F-Aryna_Sabalenka-Alison_Riske,1,F-DTM,21,1,0,0,1,6,15
20190928-W-Wuhan-F-Aryna_Sabalenka-Alison_Riske,1,F-DTL,2,1,1,0,0,2,0
20190928-W-Wuhan-F-Aryna_Sabalenka-Alison_Riske,1,F-IO,17,7,1,2,4,9,8
20190928-W-Wuhan-F-Aryna_Sabalenka-Alison_Riske,1,B-XC,31,9,5,1,3,21,10
20190928-W-Wuhan-F-Aryna_Sabalenka-Alison_Riske,1,B-DTM,25,5,0,0,5,13,12
20190928-W-Wuhan-F-Aryna_Sabalenka-Alison_Riske,1,B-DTL,13,7,3,1,3,7,6
20190928-W-Wuhan-F-Aryna_Sabalenka-Alison_Riske,1,B-IO,5,4,1,2,1,3,2
20190928-W-Wuhan-F-Aryna_Sabalenka-Alison_Riske,1,S-DTM,4,0,0,0,0,2,2
20190928-W-Wuhan-F-Aryna_Sabalenka-Alison_Riske,1,S-DTL,1,0,0,0,0,0,1
20190928-W-Wuhan-F-Aryna_Sabalenka-Alison_Riske,2,F-XC,24,3,0,3,0,16,8
20190928-W-Wuhan-F-Aryna_Sabalenka-Alison_Riske,2,F-DTM,17,1,0,0,1,14,3
20190928-W-Wuhan-F-Aryna_Sabalenka-Alison_Riske,2,F-DTL,10,2,1,0,1,6,4
20190928-W-Wuhan-F-Aryna_Sabalenka-Alison_Riske,2,F-IO,20,5,3,2,0,13,7
20190928-W-Wuhan-F-Aryna_Sabalenka-Alison_Riske,2,B-XC,26,5,0,1,4,6,20
20190928-W-Wuhan-F-Aryna_Sabalenka-Alison_Riske,2,B-DTM,22,5,0,1,4,8,14
20190928-W-Wuhan-F-Aryna_Sabalenka-Alison_Riske,2,B-DTL,7,5,3,1,1,5,2
20190928-W-Wuhan-F-Aryna_Sabalenka-Alison_Riske,2,B-IO,9,5,2,0,3,4,5
20190928-W-Wuhan-F-Aryna_Sabalenka-Alison_Riske,2,S-XC,2,0,0,0,0,0,2
20190928-W-Wuhan-F-Aryna_Sabalenka-Alison_Riske,2,S-DTM,4,0,0,0,0,1,3
20190930-W-Beijing-R64-Bianca_Andreescu-Aliaksandra_Sasnovich,1,F-XC,35,16,2,5,9,18,17
20190930-W-Beijing-R64-Bianca_Andreescu-Aliaksandra_Sasnovich,1,F-DTM,29,2,1,0,1,18,11
20190930-W-Beijing-R64-Bianca_Andreescu-Aliaksandra_Sasnovich,1,F-DTL,9,5,1,1,3,5,4
20190930-W-Beijing-R64-Bianca_Andreescu-Aliaksandra_Sasnovich,1,F-IO,15,4,2,2,0,13,2
20190930-W-Beijing-R64-Bianca_Andreescu-Aliaksandra_Sasnovich,1,F-II,1,1,0,1,0,1,0
20190930-W-Beijing-R64-Bianca_Andreescu-Aliaksandra_Sasnovich,1,B-XC,19,4,0,1,3,11,8
20190930-W-Beijing-R64-Bianca_Andreescu-Aliaksandra_Sasnovich,1,B-DTM,25,2,0,0,2,13,12
20190930-W-Beijing-R64-Bianca_Andreescu-Aliaksandra_Sasnovich,1,B-DTL,6,1,1,0,0,5,1
20190930-W-Beijing-R64-Bianca_Andreescu-Aliaksandra_Sasnovich,1,B-IO,4,2,0,0,2,1,3
20190930-W-Beijing-R64-Bianca_Andreescu-Aliaksandra_Sasnovich,1,S-XC,9,1,0,0,1,7,2
20190930-W-Beijing-R64-Bianca_Andreescu-Aliaksandra_Sasnovich,1,S-DTM,11,1,0,0,1,5,6
20190930-W-Beijing-R64-Bianca_Andreescu-Aliaksandra_Sasnovich,1,S-IO,2,2,0,0,2,0,2
20190930-W-Beijing-R64-Bianca_Andreescu-Aliaksandra_Sasnovich,2,F-XC,34,15,6,1,8,18,16
20190930-W-Beijing-R64-Bianca_Andreescu-Aliaksandra_Sasnovich,2,F-DTM,26,3,0,0,3,9,17
20190930-W-Beijing-R64-Bianca_Andreescu-Aliaksandra_Sasnovich,2,F-DTL,6,4,2,1,1,3,3
20190930-W-Beijing-R64-Bianca_Andreescu-Aliaksandra_Sasnovich,2,F-IO,18,5,1,1,3,7,11
20190930-W-Beijing-R64-Bianca_Andreescu-Aliaksandra_Sasnovich,2,B-XC,35,11,2,1,8,11,24
20190930-W-Beijing-R64-Bianca_Andreescu-Aliaksandra_Sasnovich,2,B-DTM,21,0,0,0,0,7,14
20190930-W-Beijing-R64-Bianca_Andreescu-Aliaksandra_Sasnovich,2,B-DTL,7,4,2,0,2,5,2
20190930-W-Beijing-R64-Bianca_Andreescu-Aliaksandra_Sasnovich,2,B-IO,8,4,0,0,4,3,5
20190930-W-Beijing-R64-Bianca_Andreescu-Aliaksandra_Sasnovich,2,S-XC,6,1,0,0,1,1,5
20190930-W-Beijing-R64-Bianca_Andreescu-Aliaksandra_Sasnovich,2,S-IO,2,1,0,0,1,1,1
20191002-W-Beijing-R16-Kiki_Bertens-Polona_Hercog,1,F-XC,59,7,1,2,4,32,27
20191002-W-Beijing-R16-Kiki_Bertens-Polona_Hercog,1,F-DTM,29,1,0,0,1,13,16
20191002-W-Beijing-R16-Kiki_Bertens-Polona_Hercog,1,F-DTL,17,5,1,0,4,8,9
20191002-W-Beijing-R16-Kiki_Bertens-Polona_Hercog,1,F-IO,39,11,2,4,5,19,20
20191002-W-Beijing-R16-Kiki_Bertens-Polona_Hercog,1,F-II,1,0,0,0,0,1,0
20191002-W-Beijing-R16-Kiki_Bertens-Polona_Hercog,1,B-XC,36,1,0,0,1,18,18
20191002-W-Beijing-R16-Kiki_Bertens-Polona_Hercog,1,B-DTM,25,1,0,0,1,3,22
20191002-W-Beijing-R16-Kiki_Bertens-Polona_Hercog,1,B-DTL,4,1,0,0,1,1,3
20191002-W-Beijing-R16-Kiki_Bertens-Polona_Hercog,1,B-IO,1,0,0,0,0,1,0
20191002-W-Beijing-R16-Kiki_Bertens-Polona_Hercog,1,S-XC,18,1,0,0,1,5,13
20191002-W-Beijing-R16-Kiki_Bertens-Polona_Hercog,1,S-DTM,19,1,0,0,1,10,9
20191002-W-Beijing-R16-Kiki_Bertens-Polona_Hercog,1,S-DTL,3,1,0,1,0,1,2
20191002-W-Beijing-R16-Kiki_Bertens-Polona_Hercog,2,F-XC,91,25,2,8,15,42,49
20191002-W-Beijing-R16-Kiki_Bertens-Polona_Hercog,2,F-DTM,31,4,0,0,4,14,17
20191002-W-Beijing-R16-Kiki_Bertens-Polona_Hercog,2,F-DTL,8,3,2,0,1,4,4
20191002-W-Beijing-R16-Kiki_Bertens-Polona_Hercog,2,F-IO,48,15,3,4,8,33,15
20191002-W-Beijing-R16-Kiki_Bertens-Polona_Hercog,2,F-II,6,3,2,0,1,3,3
20191002-W-Beijing-R16-Kiki_Bertens-Polona_Hercog,2,B-XC,7,3,2,0,1,5,2
20191002-W-Beijing-R16-Kiki_Bertens-Polona_Hercog,2,B-DTM,6,1,0,1,0,5,1
20191002-W-Beijing-R16-Kiki_Bertens-Polona_Hercog,2,S-XC,54,5,0,1,4,31,23
20191002-W-Beijing-R16-Kiki_Bertens-Polona_Hercog,2,S-DTM,22,1,0,0,1,10,12
20191002-W-Beijing-R16-Kiki_Bertens-Polona_Hercog,2,S-DTL,3,0,0,0,0,1,2
20191002-W-Beijing-R16-Kiki_Bertens-Polona_Hercog,2,S-IO,1,0,0,0,0,0,1
20190930-W-Beijing-R32-Dayana_Yastremska-Kiki_Bertens,1,F-XC,61,16,4,2,10,27,34
20190930-W-Beijing-R32-Dayana_Yastremska-Kiki_Bertens,1,F-DTM,35,5,0,0,5,14,21
20190930-W-Beijing-R32-Dayana_Yastremska-Kiki_Bertens,1,F-DTL,9,7,3,0,4,4,5
20190930-W-Beijing-R32-Dayana_Yastremska-Kiki_Bertens,1,F-IO,26,11,1,0,10,8,18
20190930-W-Beijing-R32-Dayana_Yastremska-Kiki_Bertens,1,B-XC,22,4,0,2,2,11,11
20190930-W-Beijing-R32-Dayana_Yastremska-Kiki_Bertens,1,B-DTM,23,2,0,0,2,7,16
20190930-W-Beijing-R32-Dayana_Yastremska-Kiki_Bertens,1,B-DTL,7,3,0,0,3,4,3
20190930-W-Beijing-R32-Dayana_Yastremska-Kiki_Bertens,1,B-IO,9,4,1,1,2,5,4
20190930-W-Beijing-R32-Dayana_Yastremska-Kiki_Bertens,1,S-DTM,1,0,0,0,0,0,1
20190930-W-Beijing-R32-Dayana_Yastremska-Kiki_Bertens,1,S-DTL,1,0,0,0,0,0,1
20190930-W-Beijing-R32-Dayana_Yastremska-Kiki_Bertens,2,F-XC,29,2,1,1,0,18,11
20190930-W-Beijing-R32-Dayana_Yastremska-Kiki_Bertens,2,F-DTM,39,4,0,0,4,21,18
20190930-W-Beijing-R32-Dayana_Yastremska-Kiki_Bertens,2,F-DTL,4,2,1,0,1,2,2
20190930-W-Beijing-R32-Dayana_Yastremska-Kiki_Bertens,2,F-IO,8,2,0,1,1,3,5
20190930-W-Beijing-R32-Dayana_Yastremska-Kiki_Bertens,2,B-XC,16,4,0,1,3,10,6
20190930-W-Beijing-R32-Dayana_Yastremska-Kiki_Bertens,2,B-DTM,21,3,0,0,3,11,10
20190930-W-Beijing-R32-Dayana_Yastremska-Kiki_Bertens,2,B-DTL,5,1,0,0,1,1,4
20190930-W-Beijing-R32-Dayana_Yastremska-Kiki_Bertens,2,B-IO,2,0,0,0,0,1,1
20190930-W-Beijing-R32-Dayana_Yastremska-Kiki_Bertens,2,S-XC,7,1,0,0,1,3,4
20190930-W-Beijing-R32-Dayana_Yastremska-Kiki_Bertens,2,S-DTM,14,2,0,0,2,8,6
20190928-W-Beijing-R64-Donna_Vekic-Kiki_Bertens,1,F-XC,43,10,4,2,4,30,13
20190928-W-Beijing-R64-Donna_Vekic-Kiki_Bertens,1,F-DTM,41,4,0,0,4,25,16
20190928-W-Beijing-R64-Donna_Vekic-Kiki_Bertens,1,F-DTL,15,5,0,2,3,9,6
20190928-W-Beijing-R64-Donna_Vekic-Kiki_Bertens,1,F-IO,45,16,4,6,6,33,12
20190928-W-Beijing-R64-Donna_Vekic-Kiki_Bertens,1,F-II,2,1,0,1,0,2,0
20190928-W-Beijing-R64-Donna_Vekic-Kiki_Bertens,1,B-XC,37,5,1,0,4,16,21
20190928-W-Beijing-R64-Donna_Vekic-Kiki_Bertens,1,B-DTM,28,5,0,2,3,17,11
20190928-W-Beijing-R64-Donna_Vekic-Kiki_Bertens,1,B-DTL,7,6,1,2,3,4,3
20190928-W-Beijing-R64-Donna_Vekic-Kiki_Bertens,1,B-IO,3,2,1,0,1,1,2
20190928-W-Beijing-R64-Donna_Vekic-Kiki_Bertens,1,S-DTM,3,0,0,0,0,1,2
20190928-W-Beijing-R64-Donna_Vekic-Kiki_Bertens,1,S-DTL,3,3,1,0,2,1,2
20190928-W-Beijing-R64-Donna_Vekic-Kiki_Bertens,1,S-IO,1,0,0,0,0,0,1
20190928-W-Beijing-R64-Donna_Vekic-Kiki_Bertens,2,F-XC,49,11,4,0,7,20,29
20190928-W-Beijing-R64-Donna_Vekic-Kiki_Bertens,2,F-DTM,27,2,1,0,1,8,19
20190928-W-Beijing-R64-Donna_Vekic-Kiki_Bertens,2,F-DTL,4,1,1,0,0,1,3
20190928-W-Beijing-R64-Donna_Vekic-Kiki_Bertens,2,F-IO,18,8,3,2,3,8,10
20190928-W-Beijing-R64-Donna_Vekic-Kiki_Bertens,2,F-II,1,0,0,0,0,0,1
20190928-W-Beijing-R64-Donna_Vekic-Kiki_Bertens,2,B-XC,30,3,1,1,1,17,13
20190928-W-Beijing-R64-Donna_Vekic-Kiki_Bertens,2,B-DTM,37,6,0,0,6,6,31
20190928-W-Beijing-R64-Donna_Vekic-Kiki_Bertens,2,B-DTL,8,3,1,1,1,3,5
20190928-W-Beijing-R64-Donna_Vekic-Kiki_Bertens,2,B-IO,7,3,0,2,1,6,1
20190928-W-Beijing-R64-Donna_Vekic-Kiki_Bertens,2,S-XC,17,0,0,0,0,6,11
20190928-W-Beijing-R64-Donna_Vekic-Kiki_Bertens,2,S-DTM,11,2,0,1,1,5,6
20190928-W-Beijing-R64-Donna_Vekic-Kiki_Bertens,2,S-DTL,3,0,0,0,0,0,3
20190924-W-Tashkent-R32-Nigina_Abduraimova-Monica_Niculescu,1,F-XC,23,8,0,4,4,12,11
20190924-W-Tashkent-R32-Nigina_Abduraimova-Monica_Niculescu,1,F-DTM,10,0,0,0,0,2,8
20190924-W-Tashkent-R32-Nigina_Abduraimova-Monica_Niculescu,1,F-DTL,7,1,0,1,0,4,3
20190924-W-Tashkent-R32-Nigina_Abduraimova-Monica_Niculescu,1,F-IO,11,2,0,0,2,4,7
20190924-W-Tashkent-R32-Nigina_Abduraimova-Monica_Niculescu,1,B-XC,15,4,1,0,3,7,8
20190924-W-Tashkent-R32-Nigina_Abduraimova-Monica_Niculescu,1,B-DTM,19,2,0,0,2,5,14
20190924-W-Tashkent-R32-Nigina_Abduraimova-Monica_Niculescu,1,B-DTL,8,5,1,0,4,3,5
20190924-W-Tashkent-R32-Nigina_Abduraimova-Monica_Niculescu,1,B-IO,13,5,0,0,5,3,10
20190924-W-Tashkent-R32-Nigina_Abduraimova-Monica_Niculescu,1,S-XC,10,0,0,0,0,5,5
20190924-W-Tashkent-R32-Nigina_Abduraimova-Monica_Niculescu,1,S-DTM,7,2,0,1,1,2,5
20190924-W-Tashkent-R32-Nigina_Abduraimova-Monica_Niculescu,1,S-DTL,2,1,0,1,0,1,1
20190924-W-Tashkent-R32-Nigina_Abduraimova-Monica_Niculescu,1,S-IO,4,0,0,0,0,1,3
20190924-W-Tashkent-R32-Nigina_Abduraimova-Monica_Niculescu,2,F-XC,1,0,0,0,0,0,1
20190924-W-Tashkent-R32-Nigina_Abduraimova-Monica_Niculescu,2,F-DTM,1,0,0,0,0,0,1
20190924-W-Tashkent-R32-Nigina_Abduraimova-Monica_Niculescu,2,F-DTL,1,0,0,0,0,1,0
20190924-W-Tashkent-R32-Nigina_Abduraimova-Monica_Niculescu,2,F-IO,1,0,0,0,0,1,0
20190924-W-Tashkent-R32-Nigina_Abduraimova-Monica_Niculescu,2,B-XC,23,3,0,2,1,14,9
20190924-W-Tashkent-R32-Nigina_Abduraimova-Monica_Niculescu,2,B-DTM,33,4,0,3,1,22,11
20190924-W-Tashkent-R32-Nigina_Abduraimova-Monica_Niculescu,2,B-DTL,7,7,6,1,0,7,0
20190924-W-Tashkent-R32-Nigina_Abduraimova-Monica_Niculescu,2,B-IO,5,1,1,0,0,4,1
20190924-W-Tashkent-R32-Nigina_Abduraimova-Monica_Niculescu,2,S-DTM,4,0,0,0,0,2,2
20190924-W-Tashkent-R32-Nigina_Abduraimova-Monica_Niculescu,2,S-DTL,2,1,0,1,0,2,0
20190924-W-Tashkent-R32-Nigina_Abduraimova-Monica_Niculescu,2,S-IO,2,0,0,0,0,2,0
20190929-W-Beijing-R64-Anastasija_Sevastova-Elina_Svitolina,1,F-XC,52,8,3,0,5,22,30
20190929-W-Beijing-R64-Anastasija_Sevastova-Elina_Svitolina,1,F-DTM,15,2,0,0,2,7,8
20190929-W-Beijing-R64-Anastasija_Sevastova-Elina_Svitolina,1,F-DTL,10,6,2,0,4,5,5
20190929-W-Beijing-R64-Anastasija_Sevastova-Elina_Svitolina,1,F-IO,27,7,4,1,2,13,14
20190929-W-Beijing-R64-Anastasija_Sevastova-Elina_Svitolina,1,F-II,1,1,1,0,0,1,0
20190929-W-Beijing-R64-Anastasija_Sevastova-Elina_Svitolina,1,B-XC,56,13,3,3,7,27,29
20190929-W-Beijing-R64-Anastasija_Sevastova-Elina_Svitolina,1,B-DTM,31,5,0,0,5,11,20
20190929-W-Beijing-R64-Anastasija_Sevastova-Elina_Svitolina,1,B-DTL,15,9,4,1,4,8,7
20190929-W-Beijing-R64-Anastasija_Sevastova-Elina_Svitolina,1,B-IO,14,7,2,2,3,6,8
20190929-W-Beijing-R64-Anastasija_Sevastova-Elina_Svitolina,1,S-XC,16,0,0,0,0,7,9
20190929-W-Beijing-R64-Anastasija_Sevastova-Elina_Svitolina,1,S-DTM,18,2,0,1,1,4,14
20190929-W-Beijing-R64-Anastasija_Sevastova-Elina_Svitolina,1,S-DTL,1,1,0,1,0,1,0
20190929-W-Beijing-R64-Anastasija_Sevastova-Elina_Svitolina,1,S-IO,2,1,0,0,1,1,1
20190929-W-Beijing-R64-Anastasija_Sevastova-Elina_Svitolina,2,F-XC,47,11,6,3,2,32,15
20190929-W-Beijing-R64-Anastasija_Sevastova-Elina_Svitolina,2,F-DTM,28,1,0,0,1,12,16
20190929-W-Beijing-R64-Anastasija_Sevastova-Elina_Svitolina,2,F-DTL,14,7,1,2,4,8,6
20190929-W-Beijing-R64-Anastasija_Sevastova-Elina_Svitolina,2,F-IO,22,6,2,2,3,14,8
20190929-W-Beijing-R64-Anastasija_Sevastova-Elina_Svitolina,2,B-XC,77,11,2,3,6,38,39
20190929-W-Beijing-R64-Anastasija_Sevastova-Elina_Svitolina,2,B-DTM,42,2,0,1,1,28,14
20190929-W-Beijing-R64-Anastasija_Sevastova-Elina_Svitolina,2,B-DTL,5,4,3,0,1,4,1
20190929-W-Beijing-R64-Anastasija_Sevastova-Elina_Svitolina,2,B-IO,7,3,0,1,2,3,4
20190929-W-Beijing-R64-Anastasija_Sevastova-Elina_Svitolina,2,S-XC,5,0,0,0,0,0,5
20190929-W-Beijing-R64-Anastasija_Sevastova-Elina_Svitolina,2,S-DTM,11,0,0,0,0,7,4
20190929-W-Beijing-R64-Anastasija_Sevastova-Elina_Svitolina,2,S-IO,2,0,0,0,0,1,1
20190526-W-Roland_Garros-R128-Venus_Williams-Elina_Svitolina,1,F-XC,32,8,0,3,5,7,25
20190526-W-Roland_Garros-R128-Venus_Williams-Elina_Svitolina,1,F-DTM,13,2,0,0,2,1,12
20190526-W-Roland_Garros-R128-Venus_Williams-Elina_Svitolina,1,F-DTL,8,1,0,0,1,2,6
20190526-W-Roland_Garros-R128-Venus_Williams-Elina_Svitolina,1,F-IO,14,5,2,1,2,3,11
20190526-W-Roland_Garros-R128-Venus_Williams-Elina_Svitolina,1,B-XC,31,10,1,1,8,4,27
20190526-W-Roland_Garros-R128-Venus_Williams-Elina_Svitolina,1,B-DTM,15,3,0,0,3,3,12
20190526-W-Roland_Garros-R128-Venus_Williams-Elina_Svitolina,1,B-DTL,7,1,1,0,0,4,3
20190526-W-Roland_Garros-R128-Venus_Williams-Elina_Svitolina,1,B-IO,9,5,1,1,3,3,6
20190526-W-Roland_Garros-R128-Venus_Williams-Elina_Svitolina,1,B-II,1,1,1,0,0,1,0
20190526-W-Roland_Garros-R128-Venus_Williams-Elina_Svitolina,1,S-XC,1,0,0,0,0,0,1
20190526-W-Roland_Garros-R128-Venus_Williams-Elina_Svitolina,1,S-DTM,7,2,0,0,2,3,4
20190526-W-Roland_Garros-R128-Venus_Williams-Elina_Svitolina,2,F-XC,30,9,2,2,5,21,9
20190526-W-Roland_Garros-R128-Venus_Williams-Elina_Svitolina,2,F-DTM,20,1,0,1,0,18,2
20190526-W-Roland_Garros-R128-Venus_Williams-Elina_Svitolina,2,F-DTL,10,8,5,1,2,7,3
20190526-W-Roland_Garros-R128-Venus_Williams-Elina_Svitolina,2,F-IO,11,1,0,1,0,9,2
20190526-W-Roland_Garros-R128-Venus_Williams-Elina_Svitolina,2,B-XC,26,6,5,0,1,19,7
20190526-W-Roland_Garros-R128-Venus_Williams-Elina_Svitolina,2,B-DTM,25,5,0,2,3,17,8
20190526-W-Roland_Garros-R128-Venus_Williams-Elina_Svitolina,2,B-DTL,3,1,1,0,0,3,0
20190526-W-Roland_Garros-R128-Venus_Williams-Elina_Svitolina,2,B-IO,5,2,0,1,1,1,4
20190526-W-Roland_Garros-R128-Venus_Williams-Elina_Svitolina,2,S-XC,6,1,1,0,0,5,1
20190526-W-Roland_Garros-R128-Venus_Williams-Elina_Svitolina,2,S-DTM,2,0,0,0,0,2,0
20191005-W-Beijing-SF-Caroline_Wozniacki-Naomi_Osaka,1,F-XC,13,0,0,0,0,5,8
20191005-W-Beijing-SF-Caroline_Wozniacki-Naomi_Osaka,1,F-DTM,20,1,0,0,1,7,13
20191005-W-Beijing-SF-Caroline_Wozniacki-Naomi_Osaka,1,F-DTL,21,4,0,0,4,9,12
20191005-W-Beijing-SF-Caroline_Wozniacki-Naomi_Osaka,1,F-IO,6,1,0,0,1,3,3
20191005-W-Beijing-SF-Caroline_Wozniacki-Naomi_Osaka,1,B-XC,38,9,3,2,4,16,22
20191005-W-Beijing-SF-Caroline_Wozniacki-Naomi_Osaka,1,B-DTM,25,1,0,1,0,8,17
20191005-W-Beijing-SF-Caroline_Wozniacki-Naomi_Osaka,1,B-DTL,9,5,2,1,2,6,3
20191005-W-Beijing-SF-Caroline_Wozniacki-Naomi_Osaka,1,B-IO,5,0,0,0,0,3,2
20191005-W-Beijing-SF-Caroline_Wozniacki-Naomi_Osaka,1,S-XC,2,0,0,0,0,1,1
20191005-W-Beijing-SF-Caroline_Wozniacki-Naomi_Osaka,1,S-DTM,4,0,0,0,0,2,2
20191005-W-Beijing-SF-Caroline_Wozniacki-Naomi_Osaka,2,F-XC,34,11,3,4,4,20,14
20191005-W-Beijing-SF-Caroline_Wozniacki-Naomi_Osaka,2,F-DTM,9,2,0,0,2,4,5
20191005-W-Beijing-SF-Caroline_Wozniacki-Naomi_Osaka,2,F-DTL,6,2,1,1,0,5,1
20191005-W-Beijing-SF-Caroline_Wozniacki-Naomi_Osaka,2,F-IO,18,10,4,1,5,11,7
20191005-W-Beijing-SF-Caroline_Wozniacki-Naomi_Osaka,2,F-II,1,0,0,0,0,1,0
20191005-W-Beijing-SF-Caroline_Wozniacki-Naomi_Osaka,2,B-XC,53,14,2,4,8,31,22
20191005-W-Beijing-SF-Caroline_Wozniacki-Naomi_Osaka,2,B-DTM,17,1,0,1,0,10,7
20191005-W-Beijing-SF-Caroline_Wozniacki-Naomi_Osaka,2,B-DTL,15,8,3,1,4,7,8
20191005-W-Beijing-SF-Caroline_Wozniacki-Naomi_Osaka,2,B-IO,10,4,4,0,0,8,2
20191005-W-Beijing-SF-Caroline_Wozniacki-Naomi_Osaka,2,S-XC,1,0,0,0,0,1,0
20190929-W-Beijing-R64-Bernarda_Pera-Ekaterina_Alexandrova,1,F-XC,40,15,4,2,9,19,21
20190929-W-Beijing-R64-Bernarda_Pera-Ekaterina_Alexandrova,1,F-DTM,16,5,0,1,4,3,13
20190929-W-Beijing-R64-Bernarda_Pera-Ekaterina_Alexandrova,1,F-DTL,7,5,1,0,4,2,5
20190929-W-Beijing-R64-Bernarda_Pera-Ekaterina_Alexandrova,1,F-IO,6,4,2,0,2,3,3
20190929-W-Beijing-R64-Bernarda_Pera-Ekaterina_Alexandrova,1,B-XC,27,10,4,1,5,9,18
20190929-W-Beijing-R64-Bernarda_Pera-Ekaterina_Alexandrova,1,B-DTM,29,4,0,1,3,12,17
20190929-W-Beijing-R64-Bernarda_Pera-Ekaterina_Alexandrova,1,B-DTL,9,6,1,0,5,2,7
20190929-W-Beijing-R64-Bernarda_Pera-Ekaterina_Alexandrova,1,B-IO,6,3,0,1,2,4,2
20190929-W-Beijing-R64-Bernarda_Pera-Ekaterina_Alexandrova,1,S-XC,1,0,0,0,0,1,0
20190929-W-Beijing-R64-Bernarda_Pera-Ekaterina_Alexandrova,1,S-DTM,6,0,0,0,0,4,2
20190929-W-Beijing-R64-Bernarda_Pera-Ekaterina_Alexandrova,1,S-DTL,1,0,0,0,0,1,0
20190929-W-Beijing-R64-Bernarda_Pera-Ekaterina_Alexandrova,2,F-XC,33,7,3,2,2,25,8
20190929-W-Beijing-R64-Bernarda_Pera-Ekaterina_Alexandrova,2,F-DTM,13,1,0,0,1,7,6
20190929-W-Beijing-R64-Bernarda_Pera-Ekaterina_Alexandrova,2,F-DTL,13,7,5,0,2,9,4
20190929-W-Beijing-R64-Bernarda_Pera-Ekaterina_Alexandrova,2,F-IO,11,4,2,1,1,5,6
20190929-W-Beijing-R64-Bernarda_Pera-Ekaterina_Alexandrova,2,B-XC,18,2,0,1,1,12,6
20190929-W-Beijing-R64-Bernarda_Pera-Ekaterina_Alexandrova,2,B-DTM,24,6,0,0,5,10,14
20190929-W-Beijing-R64-Bernarda_Pera-Ekaterina_Alexandrova,2,B-DTL,8,4,2,0,2,5,3
20190929-W-Beijing-R64-Bernarda_Pera-Ekaterina_Alexandrova,2,B-IO,8,2,1,0,1,5,3
20190929-W-Beijing-R64-Bernarda_Pera-Ekaterina_Alexandrova,2,S-XC,2,0,0,0,0,0,2
20190929-W-Beijing-R64-Bernarda_Pera-Ekaterina_Alexandrova,2,S-DTM,1,0,0,0,0,0,1
20190929-W-Beijing-R64-Bernarda_Pera-Ekaterina_Alexandrova,2,S-IO,1,0,0,0,0,0,1
20191003-W-Beijing-R16-Daria_Kasatkina-Ekaterina_Alexandrova,1,F-XC,41,6,0,3,3,27,14
20191003-W-Beijing-R16-Daria_Kasatkina-Ekaterina_Alexandrova,1,F-DTM,38,0,0,0,0,19,19
20191003-W-Beijing-R16-Daria_Kasatkina-Ekaterina_Alexandrova,1,F-DTL,23,4,1,2,1,13,10
20191003-W-Beijing-R16-Daria_Kasatkina-Ekaterina_Alexandrova,1,F-IO,33,0,0,0,0,21,12
20191003-W-Beijing-R16-Daria_Kasatkina-Ekaterina_Alexandrova,1,B-XC,21,2,0,1,1,7,14
20191003-W-Beijing-R16-Daria_Kasatkina-Ekaterina_Alexandrova,1,B-DTM,37,0,0,0,0,21,16
20191003-W-Beijing-R16-Daria_Kasatkina-Ekaterina_Alexandrova,1,B-DTL,8,4,2,1,1,5,3
20191003-W-Beijing-R16-Daria_Kasatkina-Ekaterina_Alexandrova,1,B-IO,3,2,1,1,0,3,0
20191003-W-Beijing-R16-Daria_Kasatkina-Ekaterina_Alexandrova,1,S-XC,11,0,0,0,0,8,3
20191003-W-Beijing-R16-Daria_Kasatkina-Ekaterina_Alexandrova,1,S-DTM,19,0,0,0,0,13,6
20191003-W-Beijing-R16-Daria_Kasatkina-Ekaterina_Alexandrova,1,S-IO,2,0,0,0,0,1,1
20191003-W-Beijing-R16-Daria_Kasatkina-Ekaterina_Alexandrova,2,F-XC,61,19,4,3,12,26,35
20191003-W-Beijing-R16-Daria_Kasatkina-Ekaterina_Alexandrova,2,F-DTM,15,1,0,1,0,8,7
20191003-W-Beijing-R16-Daria_Kasatkina-Ekaterina_Alexandrova,2,F-DTL,18,7,1,0,6,6,12
20191003-W-Beijing-R16-Daria_Kasatkina-Ekaterina_Alexandrova,2,F-IO,36,12,2,3,7,15,21
20191003-W-Beijing-R16-Daria_Kasatkina-Ekaterina_Alexandrova,2,F-II,2,1,0,0,1,1,1
20191003-W-Beijing-R16-Daria_Kasatkina-Ekaterina_Alexandrova,2,B-XC,55,12,4,3,5,26,29
20191003-W-Beijing-R16-Daria_Kasatkina-Ekaterina_Alexandrova,2,B-DTM,45,2,0,1,1,16,29
20191003-W-Beijing-R16-Daria_Kasatkina-Ekaterina_Alexandrova,2,B-DTL,20,6,3,1,2,11,9
20191003-W-Beijing-R16-Daria_Kasatkina-Ekaterina_Alexandrova,2,B-IO,11,3,1,0,2,2,9
20191003-W-Beijing-R16-Daria_Kasatkina-Ekaterina_Alexandrova,2,S-XC,1,0,0,0,0,0,1
20191003-W-Beijing-R16-Daria_Kasatkina-Ekaterina_Alexandrova,2,S-DTM,2,0,0,0,0,2,0
20191003-W-Beijing-R16-Daria_Kasatkina-Ekaterina_Alexandrova,2,S-IO,1,1,0,0,1,0,1
20191003-W-Beijing-R16-Jennifer_Brady-Bianca_Andreescu,1,F-XC,26,10,2,2,6,9,17
20191003-W-Beijing-R16-Jennifer_Brady-Bianca_Andreescu,1,F-DTM,18,5,0,0,5,7,11
20191003-W-Beijing-R16-Jennifer_Brady-Bianca_Andreescu,1,F-DTL,2,1,1,0,0,1,1
20191003-W-Beijing-R16-Jennifer_Brady-Bianca_Andreescu,1,F-IO,11,5,2,1,2,5,6
20191003-W-Beijing-R16-Jennifer_Brady-Bianca_Andreescu,1,F-II,1,1,0,0,1,0,1
20191003-W-Beijing-R16-Jennifer_Brady-Bianca_Andreescu,1,B-XC,11,0,0,0,0,6,5
20191003-W-Beijing-R16-Jennifer_Brady-Bianca_Andreescu,1,B-DTM,13,0,0,0,0,2,11
20191003-W-Beijing-R16-Jennifer_Brady-Bianca_Andreescu,1,B-DTL,2,2,0,0,2,0,2
20191003-W-Beijing-R16-Jennifer_Brady-Bianca_Andreescu,1,S-XC,1,0,0,0,0,0,1
20191003-W-Beijing-R16-Jennifer_Brady-Bianca_Andreescu,2,F-XC,20,6,3,1,2,12,8
20191003-W-Beijing-R16-Jennifer_Brady-Bianca_Andreescu,2,F-DTM,10,3,0,1,2,4,6
20191003-W-Beijing-R16-Jennifer_Brady-Bianca_Andreescu,2,F-DTL,5,3,1,0,2,3,2
20191003-W-Beijing-R16-Jennifer_Brady-Bianca_Andreescu,2,F-IO,8,3,2,1,0,6,2
20191003-W-Beijing-R16-Jennifer_Brady-Bianca_Andreescu,2,B-XC,11,4,1,2,1,8,3
20191003-W-Beijing-R16-Jennifer_Brady-Bianca_Andreescu,2,B-DTM,18,0,0,0,0,13,5
20191003-W-Beijing-R16-Jennifer_Brady-Bianca_Andreescu,2,B-DTL,5,2,1,0,1,4,1
20191003-W-Beijing-R16-Jennifer_Brady-Bianca_Andreescu,2,B-IO,5,3,0,1,2,2,3
20191003-W-Beijing-R16-Jennifer_Brady-Bianca_Andreescu,2,S-XC,1,1,0,1,0,1,0
20191003-W-Beijing-R16-Jennifer_Brady-Bianca_Andreescu,2,S-DTM,6,1,0,0,1,3,3
20191003-W-Beijing-R16-Jennifer_Brady-Bianca_Andreescu,2,S-DTL,2,1,0,0,1,1,1
20191005-W-Beijing-SF-Ashleigh_Barty-Kiki_Bertens,1,F-XC,82,18,6,3,9,39,43
20191005-W-Beijing-SF-Ashleigh_Barty-Kiki_Bertens,1,F-DTM,33,1,0,0,1,14,19
20191005-W-Beijing-SF-Ashleigh_Barty-Kiki_Bertens,1,F-DTL,17,9,4,2,3,11,6
20191005-W-Beijing-SF-Ashleigh_Barty-Kiki_Bertens,1,F-IO,57,18,6,6,6,27,30
20191005-W-Beijing-SF-Ashleigh_Barty-Kiki_Bertens,1,F-II,8,5,2,2,1,6,2
20191005-W-Beijing-SF-Ashleigh_Barty-Kiki_Bertens,1,B-XC,17,2,0,0,2,10,7
20191005-W-Beijing-SF-Ashleigh_Barty-Kiki_Bertens,1,B-DTM,27,5,0,2,3,15,12
20191005-W-Beijing-SF-Ashleigh_Barty-Kiki_Bertens,1,B-DTL,2,0,0,0,0,1,1
20191005-W-Beijing-SF-Ashleigh_Barty-Kiki_Bertens,1,S-XC,51,6,0,1,5,22,29
20191005-W-Beijing-SF-Ashleigh_Barty-Kiki_Bertens,1,S-DTM,25,1,0,0,1,7,18
20191005-W-Beijing-SF-Ashleigh_Barty-Kiki_Bertens,1,S-DTL,9,4,0,3,1,6,3
20191005-W-Beijing-SF-Ashleigh_Barty-Kiki_Bertens,1,S-IO,1,0,0,0,0,1,0
20191005-W-Beijing-SF-Ashleigh_Barty-Kiki_Bertens,2,F-XC,77,12,2,3,7,39,38
20191005-W-Beijing-SF-Ashleigh_Barty-Kiki_Bertens,2,F-DTM,22,3,2,1,0,17,5
20191005-W-Beijing-SF-Ashleigh_Barty-Kiki_Bertens,2,F-DTL,18,6,4,0,2,10,8
20191005-W-Beijing-SF-Ashleigh_Barty-Kiki_Bertens,2,F-IO,53,9,4,0,5,32,21
20191005-W-Beijing-SF-Ashleigh_Barty-Kiki_Bertens,2,F-II,5,1,0,1,0,3,2
20191005-W-Beijing-SF-Ashleigh_Barty-Kiki_Bertens,2,B-XC,38,2,0,0,2,22,16
20191005-W-Beijing-SF-Ashleigh_Barty-Kiki_Bertens,2,B-DTM,35,2,0,0,2,18,17
20191005-W-Beijing-SF-Ashleigh_Barty-Kiki_Bertens,2,B-DTL,4,3,0,1,2,1,3
20191005-W-Beijing-SF-Ashleigh_Barty-Kiki_Bertens,2,S-XC,33,5,0,1,4,13,20
20191005-W-Beijing-SF-Ashleigh_Barty-Kiki_Bertens,2,S-DTM,18,0,0,0,0,7,11
20191005-W-Beijing-SF-Ashleigh_Barty-Kiki_Bertens,2,S-DTL,8,1,0,1,0,6,2
20191005-W-Beijing-SF-Ashleigh_Barty-Kiki_Bertens,2,S-IO,1,0,0,0,0,0,1
20191004-W-Beijing-QF-Kiki_Bertens-Elina_Svitolina,1,F-XC,63,9,3,2,4,40,23
20191004-W-Beijing-QF-Kiki_Bertens-Elina_Svitolina,1,F-DTM,31,4,2,0,2,14,17
20191004-W-Beijing-QF-Kiki_Bertens-Elina_Svitolina,1,F-DTL,7,3,1,2,0,6,1
20191004-W-Beijing-QF-Kiki_Bertens-Elina_Svitolina,1,F-IO,21,11,4,2,5,12,9
20191004-W-Beijing-QF-Kiki_Bertens-Elina_Svitolina,1,F-II,2,2,2,0,0,2,0
20191004-W-Beijing-QF-Kiki_Bertens-Elina_Svitolina,1,B-XC,25,4,0,2,2,17,8
20191004-W-Beijing-QF-Kiki_Bertens-Elina_Svitolina,1,B-DTM,22,0,0,0,0,14,8
20191004-W-Beijing-QF-Kiki_Bertens-Elina_Svitolina,1,B-DTL,8,3,1,1,1,4,4
20191004-W-Beijing-QF-Kiki_Bertens-Elina_Svitolina,1,B-IO,7,2,2,0,0,5,2
20191004-W-Beijing-QF-Kiki_Bertens-Elina_Svitolina,1,S-XC,31,5,1,1,3,19,12
20191004-W-Beijing-QF-Kiki_Bertens-Elina_Svitolina,1,S-DTM,21,2,0,1,1,15,6
20191004-W-Beijing-QF-Kiki_Bertens-Elina_Svitolina,1,S-DTL,2,1,1,0,0,2,0
20191004-W-Beijing-QF-Kiki_Bertens-Elina_Svitolina,1,S-IO,2,0,0,0,0,1,1
20191004-W-Beijing-QF-Kiki_Bertens-Elina_Svitolina,2,F-XC,60,4,1,0,2,27,33
20191004-W-Beijing-QF-Kiki_Bertens-Elina_Svitolina,2,F-DTM,40,4,0,0,4,13,27
20191004-W-Beijing-QF-Kiki_Bertens-Elina_Svitolina,2,F-DTL,16,7,0,4,3,10,6
20191004-W-Beijing-QF-Kiki_Bertens-Elina_Svitolina,2,F-IO,26,4,0,1,3,9,17
20191004-W-Beijing-QF-Kiki_Bertens-Elina_Svitolina,2,F-II,1,1,0,0,1,0,1
20191004-W-Beijing-QF-Kiki_Bertens-Elina_Svitolina,2,B-XC,45,6,0,2,4,16,29
20191004-W-Beijing-QF-Kiki_Bertens-Elina_Svitolina,2,B-DTM,30,3,1,1,1,15,15
20191004-W-Beijing-QF-Kiki_Bertens-Elina_Svitolina,2,B-DTL,9,2,2,0,0,6,3
20191004-W-Beijing-QF-Kiki_Bertens-Elina_Svitolina,2,B-IO,3,0,0,0,0,1,2
20191004-W-Beijing-QF-Kiki_Bertens-Elina_Svitolina,2,S-XC,8,1,0,0,1,1,7
20191004-W-Beijing-QF-Kiki_Bertens-Elina_Svitolina,2,S-DTM,11,0,0,0,0,1,10
20191004-W-Beijing-QF-Naomi_Osaka-Bianca_Andreescu,1,F-XC,56,16,2,3,11,32,24
20191004-W-Beijing-QF-Naomi_Osaka-Bianca_Andreescu,1,F-DTM,34,4,0,1,3,11,23
20191004-W-Beijing-QF-Naomi_Osaka-Bianca_Andreescu,1,F-DTL,7,3,1,1,1,4,3
20191004-W-Beijing-QF-Naomi_Osaka-Bianca_Andreescu,1,F-IO,12,5,2,1,2,9,3
20191004-W-Beijing-QF-Naomi_Osaka-Bianca_Andreescu,1,F-II,1,1,1,0,0,1,0
20191004-W-Beijing-QF-Naomi_Osaka-Bianca_Andreescu,1,B-XC,60,8,2,2,4,30,30
20191004-W-Beijing-QF-Naomi_Osaka-Bianca_Andreescu,1,B-DTM,37,2,0,0,2,18,19
20191004-W-Beijing-QF-Naomi_Osaka-Bianca_Andreescu,1,B-DTL,10,7,3,2,2,6,4
20191004-W-Beijing-QF-Naomi_Osaka-Bianca_Andreescu,1,B-IO,13,5,2,1,2,6,7
20191004-W-Beijing-QF-Naomi_Osaka-Bianca_Andreescu,1,S-XC,2,0,0,0,0,0,2
20191004-W-Beijing-QF-Naomi_Osaka-Bianca_Andreescu,1,S-DTM,3,0,0,0,0,2,1
20191004-W-Beijing-QF-Naomi_Osaka-Bianca_Andreescu,2,F-XC,51,13,2,3,8,23,28
20191004-W-Beijing-QF-Naomi_Osaka-Bianca_Andreescu,2,F-DTM,24,2,0,0,2,7,17
20191004-W-Beijing-QF-Naomi_Osaka-Bianca_Andreescu,2,F-DTL,13,6,0,1,5,6,7
20191004-W-Beijing-QF-Naomi_Osaka-Bianca_Andreescu,2,F-IO,24,8,2,4,2,15,9
20191004-W-Beijing-QF-Naomi_Osaka-Bianca_Andreescu,2,F-II,1,0,0,0,0,1,0
20191004-W-Beijing-QF-Naomi_Osaka-Bianca_Andreescu,2,B-XC,42,10,5,1,4,23,19
20191004-W-Beijing-QF-Naomi_Osaka-Bianca_Andreescu,2,B-DTM,28,2,0,0,2,13,15
20191004-W-Beijing-QF-Naomi_Osaka-Bianca_Andreescu,2,B-DTL,17,7,5,0,2,12,5
20191004-W-Beijing-QF-Naomi_Osaka-Bianca_Andreescu,2,B-IO,5,0,0,0,0,2,3
20191004-W-Beijing-QF-Naomi_Osaka-Bianca_Andreescu,2,S-XC,4,0,0,0,0,2,2
20191004-W-Beijing-QF-Naomi_Osaka-Bianca_Andreescu,2,S-DTM,16,3,0,0,3,4,12
20191004-W-Beijing-QF-Naomi_Osaka-Bianca_Andreescu,2,S-DTL,2,1,0,0,1,1,1
20191004-W-Beijing-QF-Naomi_Osaka-Bianca_Andreescu,2,S-IO,1,1,0,0,1,0,1
20191002-W-Beijing-R16-Belinda_Bencic-Petra_Kvitova,1,F-XC,17,3,0,1,2,6,11
20191002-W-Beijing-R16-Belinda_Bencic-Petra_Kvitova,1,F-DTM,8,0,0,0,0,5,3
20191002-W-Beijing-R16-Belinda_Bencic-Petra_Kvitova,1,F-DTL,6,1,0,1,0,3,3
20191002-W-Beijing-R16-Belinda_Bencic-Petra_Kvitova,1,F-IO,10,2,1,1,0,7,3
20191002-W-Beijing-R16-Belinda_Bencic-Petra_Kvitova,1,B-XC,15,4,1,0,3,7,8
20191002-W-Beijing-R16-Belinda_Bencic-Petra_Kvitova,1,B-DTM,12,2,0,1,1,7,5
20191002-W-Beijing-R16-Belinda_Bencic-Petra_Kvitova,1,B-DTL,3,2,1,0,1,2,1
20191002-W-Beijing-R16-Belinda_Bencic-Petra_Kvitova,1,B-IO,5,2,2,0,0,4,1
20191002-W-Beijing-R16-Belinda_Bencic-Petra_Kvitova,1,S-XC,1,0,0,0,0,0,1
20191002-W-Beijing-R16-Belinda_Bencic-Petra_Kvitova,1,S-DTM,1,0,0,0,0,0,1
20191002-W-Beijing-R16-Belinda_Bencic-Petra_Kvitova,2,F-XC,19,10,4,2,4,11,8
20191002-W-Beijing-R16-Belinda_Bencic-Petra_Kvitova,2,F-DTM,10,0,0,0,0,4,6
20191002-W-Beijing-R16-Belinda_Bencic-Petra_Kvitova,2,F-DTL,8,6,3,1,2,4,4
20191002-W-Beijing-R16-Belinda_Bencic-Petra_Kvitova,2,F-IO,11,7,5,0,2,6,5
20191002-W-Beijing-R16-Belinda_Bencic-Petra_Kvitova,2,F-II,1,1,1,0,0,1,0
20191002-W-Beijing-R16-Belinda_Bencic-Petra_Kvitova,2,B-XC,10,6,1,2,3,6,4
20191002-W-Beijing-R16-Belinda_Bencic-Petra_Kvitova,2,B-DTM,11,3,0,0,3,1,10
20191002-W-Beijing-R16-Belinda_Bencic-Petra_Kvitova,2,B-DTL,3,2,2,0,0,3,0
20191002-W-Beijing-R16-Belinda_Bencic-Petra_Kvitova,2,B-IO,6,0,0,0,0,4,2
20191002-W-Beijing-R16-Belinda_Bencic-Petra_Kvitova,2,S-XC,2,0,0,0,0,1,1
20191002-W-Beijing-R16-Belinda_Bencic-Petra_Kvitova,2,S-DTM,2,0,0,0,0,1,1
20191002-W-Beijing-R16-Belinda_Bencic-Petra_Kvitova,2,S-DTL,1,0,0,0,0,1,0
20191002-W-Beijing-R16-Belinda_Bencic-Petra_Kvitova,2,S-IO,1,1,0,1,0,1,0
20191002-W-Beijing-R16-Elina_Svitolina-Sofia_Kenin,1,F-XC,67,19,7,1,11,28,39
20191002-W-Beijing-R16-Elina_Svitolina-Sofia_Kenin,1,F-DTM,54,3,0,0,3,24,30
20191002-W-Beijing-R16-Elina_Svitolina-Sofia_Kenin,1,F-DTL,19,7,2,1,4,7,12
20191002-W-Beijing-R16-Elina_Svitolina-Sofia_Kenin,1,F-IO,25,8,5,0,3,15,10
20191002-W-Beijing-R16-Elina_Svitolina-Sofia_Kenin,1,B-XC,68,3,2,0,1,34,34
20191002-W-Beijing-R16-Elina_Svitolina-Sofia_Kenin,1,B-DTM,68,3,0,0,3,31,37
20191002-W-Beijing-R16-Elina_Svitolina-Sofia_Kenin,1,B-DTL,11,8,4,1,3,6,5
20191002-W-Beijing-R16-Elina_Svitolina-Sofia_Kenin,1,B-IO,12,5,4,0,1,8,4
20191002-W-Beijing-R16-Elina_Svitolina-Sofia_Kenin,1,S-XC,9,0,0,0,0,3,6
20191002-W-Beijing-R16-Elina_Svitolina-Sofia_Kenin,1,S-DTM,12,2,0,0,2,2,10
20191002-W-Beijing-R16-Elina_Svitolina-Sofia_Kenin,1,S-DTL,1,0,0,0,0,1,0
20191002-W-Beijing-R16-Elina_Svitolina-Sofia_Kenin,1,S-IO,1,0,0,0,0,0,1
20191002-W-Beijing-R16-Elina_Svitolina-Sofia_Kenin,2,F-XC,79,14,7,3,4,52,27
20191002-W-Beijing-R16-Elina_Svitolina-Sofia_Kenin,2,F-DTM,35,2,0,0,2,20,15
20191002-W-Beijing-R16-Elina_Svitolina-Sofia_Kenin,2,F-DTL,12,5,1,1,3,8,4
20191002-W-Beijing-R16-Elina_Svitolina-Sofia_Kenin,2,F-IO,17,10,7,0,3,13,4
20191002-W-Beijing-R16-Elina_Svitolina-Sofia_Kenin,2,B-XC,105,18,5,3,10,59,46
20191002-W-Beijing-R16-Elina_Svitolina-Sofia_Kenin,2,B-DTM,43,5,0,0,5,14,29
20191002-W-Beijing-R16-Elina_Svitolina-Sofia_Kenin,2,B-DTL,17,9,3,3,3,12,5
20191002-W-Beijing-R16-Elina_Svitolina-Sofia_Kenin,2,B-IO,20,16,7,2,7,11,9
20191002-W-Beijing-R16-Elina_Svitolina-Sofia_Kenin,2,S-XC,7,1,0,1,0,5,2
20191002-W-Beijing-R16-Elina_Svitolina-Sofia_Kenin,2,S-DTM,12,0,0,0,0,6,6
20191002-W-Beijing-R16-Elina_Svitolina-Sofia_Kenin,2,S-DTL,2,0,0,0,0,0,2
20190812-W-Cincinnati-R64-Caty_Mcnally-Elise_Mertens,1,F-XC,18,8,3,1,4,8,10
20190812-W-Cincinnati-R64-Caty_Mcnally-Elise_Mertens,1,F-DTM,33,3,0,1,2,16,17
20190812-W-Cincinnati-R64-Caty_Mcnally-Elise_Mertens,1,F-DTL,5,3,0,1,2,2,3
20190812-W-Cincinnati-R64-Caty_Mcnally-Elise_Mertens,1,F-IO,14,5,3,1,1,9,5
20190812-W-Cincinnati-R64-Caty_Mcnally-Elise_Mertens,1,F-II,1,0,0,0,0,0,1
20190812-W-Cincinnati-R64-Caty_Mcnally-Elise_Mertens,1,B-XC,16,1,0,0,1,7,9
20190812-W-Cincinnati-R64-Caty_Mcnally-Elise_Mertens,1,B-DTM,25,2,0,1,1,12,13
20190812-W-Cincinnati-R64-Caty_Mcnally-Elise_Mertens,1,B-DTL,3,2,0,0,2,1,2
20190812-W-Cincinnati-R64-Caty_Mcnally-Elise_Mertens,1,B-IO,4,0,0,0,0,2,2
20190812-W-Cincinnati-R64-Caty_Mcnally-Elise_Mertens,1,S-XC,14,2,1,0,1,3,11
20190812-W-Cincinnati-R64-Caty_Mcnally-Elise_Mertens,1,S-DTM,14,4,0,0,4,5,9
20190812-W-Cincinnati-R64-Caty_Mcnally-Elise_Mertens,1,S-DTL,1,0,0,0,0,1,0
20190812-W-Cincinnati-R64-Caty_Mcnally-Elise_Mertens,2,F-XC,18,4,0,1,3,9,9
20190812-W-Cincinnati-R64-Caty_Mcnally-Elise_Mertens,2,F-DTM,12,1,0,0,1,6,6
20190812-W-Cincinnati-R64-Caty_Mcnally-Elise_Mertens,2,F-DTL,11,6,2,0,4,6,5
20190812-W-Cincinnati-R64-Caty_Mcnally-Elise_Mertens,2,F-IO,22,11,3,4,4,13,9
20190812-W-Cincinnati-R64-Caty_Mcnally-Elise_Mertens,2,B-XC,27,3,1,0,2,15,12
20190812-W-Cincinnati-R64-Caty_Mcnally-Elise_Mertens,2,B-DTM,27,1,0,0,1,17,10
20190812-W-Cincinnati-R64-Caty_Mcnally-Elise_Mertens,2,B-DTL,13,6,3,1,2,7,6
20190812-W-Cincinnati-R64-Caty_Mcnally-Elise_Mertens,2,B-IO,8,2,1,0,1,3,5
20190812-W-Cincinnati-R64-Caty_Mcnally-Elise_Mertens,2,S-DTM,1,0,0,0,0,0,1
20190812-W-Cincinnati-R64-Caty_Mcnally-Elise_Mertens,2,S-DTL,3,1,1,0,0,2,1
20190812-W-Cincinnati-R64-Caty_Mcnally-Elise_Mertens,2,S-IO,3,1,1,0,0,3,0
20191008-W-Tianjin-R32-Ajla_Tomljanovic-Veronika_Kudermetova,1,F-XC,18,5,3,1,1,8,10
20191008-W-Tianjin-R32-Ajla_Tomljanovic-Veronika_Kudermetova,1,F-DTM,19,0,0,0,0,8,11
20191008-W-Tianjin-R32-Ajla_Tomljanovic-Veronika_Kudermetova,1,F-DTL,6,2,1,0,1,1,5
20191008-W-Tianjin-R32-Ajla_Tomljanovic-Veronika_Kudermetova,1,F-IO,9,6,2,1,3,3,6
20191008-W-Tianjin-R32-Ajla_Tomljanovic-Veronika_Kudermetova,1,B-XC,19,2,1,0,1,10,9
20191008-W-Tianjin-R32-Ajla_Tomljanovic-Veronika_Kudermetova,1,B-DTM,26,4,0,0,4,11,15
20191008-W-Tianjin-R32-Ajla_Tomljanovic-Veronika_Kudermetova,1,B-DTL,5,2,2,0,0,3,2
20191008-W-Tianjin-R32-Ajla_Tomljanovic-Veronika_Kudermetova,1,B-IO,4,2,0,0,2,2,2
20191008-W-Tianjin-R32-Ajla_Tomljanovic-Veronika_Kudermetova,1,S-XC,3,1,0,0,1,1,2
20191008-W-Tianjin-R32-Ajla_Tomljanovic-Veronika_Kudermetova,1,S-DTM,9,1,0,0,1,4,5
20191008-W-Tianjin-R32-Ajla_Tomljanovic-Veronika_Kudermetova,1,S-DTL,3,0,0,0,0,2,1
20191008-W-Tianjin-R32-Ajla_Tomljanovic-Veronika_Kudermetova,1,S-IO,1,0,0,0,0,1,0
20191008-W-Tianjin-R32-Ajla_Tomljanovic-Veronika_Kudermetova,2,F-XC,24,9,3,3,3,13,11
20191008-W-Tianjin-R32-Ajla_Tomljanovic-Veronika_Kudermetova,2,F-DTM,12,2,0,0,2,10,2
20191008-W-Tianjin-R32-Ajla_Tomljanovic-Veronika_Kudermetova,2,F-DTL,14,8,2,4,2,9,5
20191008-W-Tianjin-R32-Ajla_Tomljanovic-Veronika_Kudermetova,2,F-IO,13,2,1,1,0,6,7
20191008-W-Tianjin-R32-Ajla_Tomljanovic-Veronika_Kudermetova,2,B-XC,27,6,2,3,1,18,9
20191008-W-Tianjin-R32-Ajla_Tomljanovic-Veronika_Kudermetova,2,B-DTM,23,3,1,0,2,11,12
20191008-W-Tianjin-R32-Ajla_Tomljanovic-Veronika_Kudermetova,2,B-DTL,4,2,0,0,2,2,2
20191008-W-Tianjin-R32-Ajla_Tomljanovic-Veronika_Kudermetova,2,B-IO,9,4,1,1,2,4,5
20191008-W-Tianjin-R32-Ajla_Tomljanovic-Veronika_Kudermetova,2,B-II,1,0,0,0,0,0,1
20191008-W-Tianjin-R32-Ajla_Tomljanovic-Veronika_Kudermetova,2,S-XC,3,1,0,1,0,2,1
20191008-W-Tianjin-R32-Ajla_Tomljanovic-Veronika_Kudermetova,2,S-DTM,5,0,0,0,0,4,1
20191008-W-Tianjin-R32-Ajla_Tomljanovic-Veronika_Kudermetova,2,S-DTL,1,0,0,0,0,0,1
20191008-W-Tianjin-R32-Ajla_Tomljanovic-Veronika_Kudermetova,2,S-IO,1,0,0,0,0,0,1
20191009-W-Linz-R32-Misaki_Doi-Kiki_Bertens,1,F-XC,88,12,1,2,9,38,50
20191009-W-Linz-R32-Misaki_Doi-Kiki_Bertens,1,F-DTM,26,1,0,0,1,13,13
20191009-W-Linz-R32-Misaki_Doi-Kiki_Bertens,1,F-DTL,8,4,2,0,2,3,5
20191009-W-Linz-R32-Misaki_Doi-Kiki_Bertens,1,F-IO,33,9,1,5,3,21,12
20191009-W-Linz-R32-Misaki_Doi-Kiki_Bertens,1,F-II,11,5,2,1,2,6,5
20191009-W-Linz-R32-Misaki_Doi-Kiki_Bertens,1,B-XC,39,8,0,1,7,12,27
20191009-W-Linz-R32-Misaki_Doi-Kiki_Bertens,1,B-DTM,38,6,0,1,5,12,26
20191009-W-Linz-R32-Misaki_Doi-Kiki_Bertens,1,B-DTL,5,3,0,0,3,1,4
20191009-W-Linz-R32-Misaki_Doi-Kiki_Bertens,1,B-IO,1,1,0,1,0,1,0
20191009-W-Linz-R32-Misaki_Doi-Kiki_Bertens,1,S-XC,2,1,0,0,1,0,2
20191009-W-Linz-R32-Misaki_Doi-Kiki_Bertens,1,S-DTM,8,0,0,0,0,6,2
20191009-W-Linz-R32-Misaki_Doi-Kiki_Bertens,1,S-DTL,3,0,0,0,0,0,3
20191009-W-Linz-R32-Misaki_Doi-Kiki_Bertens,1,S-IO,2,2,0,0,2,0,2
20191009-W-Linz-R32-Misaki_Doi-Kiki_Bertens,2,F-XC,64,6,2,2,2,44,20
20191009-W-Linz-R32-Misaki_Doi-Kiki_Bertens,2,F-DTM,27,3,0,0,3,13,14
20191009-W-Linz-R32-Misaki_Doi-Kiki_Bertens,2,F-DTL,6,2,1,0,1,3,3
20191009-W-Linz-R32-Misaki_Doi-Kiki_Bertens,2,F-IO,14,6,3,2,1,12,2
20191009-W-Linz-R32-Misaki_Doi-Kiki_Bertens,2,B-XC,28,4,0,2,2,19,9
20191009-W-Linz-R32-Misaki_Doi-Kiki_Bertens,2,B-DTM,34,4,0,0,4,16,18
20191009-W-Linz-R32-Misaki_Doi-Kiki_Bertens,2,B-DTL,9,2,1,0,1,4,5
20191009-W-Linz-R32-Misaki_Doi-Kiki_Bertens,2,B-IO,1,1,0,0,1,0,1
20191009-W-Linz-R32-Misaki_Doi-Kiki_Bertens,2,S-XC,20,1,0,0,1,8,12
20191009-W-Linz-R32-Misaki_Doi-Kiki_Bertens,2,S-DTM,19,1,0,0,1,11,8
20191009-W-Linz-R32-Misaki_Doi-Kiki_Bertens,2,S-DTL,3,0,0,0,0,2,1
20191011-W-Tianjin-QF-Dayana_Yastremska-Veronika_Kudermetova,1,F-XC,21,9,1,0,8,6,15
20191011-W-Tianjin-QF-Dayana_Yastremska-Veronika_Kudermetova,1,F-DTM,14,1,0,0,1,2,12
20191011-W-Tianjin-QF-Dayana_Yastremska-Veronika_Kudermetova,1,F-DTL,5,1,0,0,1,0,5
20191011-W-Tianjin-QF-Dayana_Yastremska-Veronika_Kudermetova,1,F-IO,16,5,2,1,2,5,11
20191011-W-Tianjin-QF-Dayana_Yastremska-Veronika_Kudermetova,1,F-II,1,0,0,0,0,0,1
20191011-W-Tianjin-QF-Dayana_Yastremska-Veronika_Kudermetova,1,B-XC,17,6,2,0,4,5,12
20191011-W-Tianjin-QF-Dayana_Yastremska-Veronika_Kudermetova,1,B-DTM,10,2,0,0,2,3,7
20191011-W-Tianjin-QF-Dayana_Yastremska-Veronika_Kudermetova,1,B-DTL,7,4,2,1,1,4,3
20191011-W-Tianjin-QF-Dayana_Yastremska-Veronika_Kudermetova,1,B-IO,5,2,0,0,2,0,5
20191011-W-Tianjin-QF-Dayana_Yastremska-Veronika_Kudermetova,2,F-XC,17,7,2,1,3,11,6
20191011-W-Tianjin-QF-Dayana_Yastremska-Veronika_Kudermetova,2,F-DTM,17,3,1,0,2,13,4
20191011-W-Tianjin-QF-Dayana_Yastremska-Veronika_Kudermetova,2,F-DTL,3,0,0,0,0,2,1
20191011-W-Tianjin-QF-Dayana_Yastremska-Veronika_Kudermetova,2,F-IO,3,1,0,0,1,1,2
20191011-W-Tianjin-QF-Dayana_Yastremska-Veronika_Kudermetova,2,F-II,1,0,0,0,0,1,0
20191011-W-Tianjin-QF-Dayana_Yastremska-Veronika_Kudermetova,2,B-XC,19,7,0,4,3,12,7
20191011-W-Tianjin-QF-Dayana_Yastremska-Veronika_Kudermetova,2,B-DTM,22,3,2,1,0,18,4
20191011-W-Tianjin-QF-Dayana_Yastremska-Veronika_Kudermetova,2,B-DTL,4,2,1,0,1,3,1
20191011-W-Tianjin-QF-Dayana_Yastremska-Veronika_Kudermetova,2,B-IO,6,1,1,0,0,5,1
20191011-W-Tianjin-QF-Dayana_Yastremska-Veronika_Kudermetova,2,S-XC,4,1,0,0,1,1,3
20191011-W-Tianjin-QF-Dayana_Yastremska-Veronika_Kudermetova,2,S-DTM,2,0,0,0,0,2,0
20191010-W-Linz-R16-Kiki_Bertens-Alison_Van_Uytvanck,1,F-XC,51,15,5,2,8,35,16
20191010-W-Linz-R16-Kiki_Bertens-Alison_Van_Uytvanck,1,F-DTM,14,0,0,0,0,7,7
20191010-W-Linz-R16-Kiki_Bertens-Alison_Van_Uytvanck,1,F-DTL,5,3,0,2,1,3,2
20191010-W-Linz-R16-Kiki_Bertens-Alison_Van_Uytvanck,1,F-IO,33,9,5,2,2,21,12
20191010-W-Linz-R16-Kiki_Bertens-Alison_Van_Uytvanck,1,F-II,1,0,0,0,0,1,0
20191010-W-Linz-R16-Kiki_Bertens-Alison_Van_Uytvanck,1,B-XC,27,7,4,1,2,12,15
20191010-W-Linz-R16-Kiki_Bertens-Alison_Van_Uytvanck,1,B-DTM,36,4,0,0,4,19,17
20191010-W-Linz-R16-Kiki_Bertens-Alison_Van_Uytvanck,1,B-DTL,3,3,2,0,1,2,1
20191010-W-Linz-R16-Kiki_Bertens-Alison_Van_Uytvanck,1,B-IO,2,2,0,0,2,0,2
20191010-W-Linz-R16-Kiki_Bertens-Alison_Van_Uytvanck,1,S-XC,7,1,0,0,1,3,4
20191010-W-Linz-R16-Kiki_Bertens-Alison_Van_Uytvanck,1,S-DTM,21,1,0,0,1,10,11
20191010-W-Linz-R16-Kiki_Bertens-Alison_Van_Uytvanck,1,S-DTL,3,0,0,0,0,1,2
20191010-W-Linz-R16-Kiki_Bertens-Alison_Van_Uytvanck,1,S-IO,2,1,0,1,0,2,0
20191010-W-Linz-R16-Kiki_Bertens-Alison_Van_Uytvanck,2,F-XC,36,4,2,0,2,11,25
20191010-W-Linz-R16-Kiki_Bertens-Alison_Van_Uytvanck,2,F-DTM,27,2,0,0,2,10,17
20191010-W-Linz-R16-Kiki_Bertens-Alison_Van_Uytvanck,2,F-DTL,11,5,1,1,3,6,5
20191010-W-Linz-R16-Kiki_Bertens-Alison_Van_Uytvanck,2,F-IO,17,3,1,1,1,7,10
20191010-W-Linz-R16-Kiki_Bertens-Alison_Van_Uytvanck,2,B-XC,25,5,1,0,4,13,12
20191010-W-Linz-R16-Kiki_Bertens-Alison_Van_Uytvanck,2,B-DTM,36,1,0,0,1,19,17
20191010-W-Linz-R16-Kiki_Bertens-Alison_Van_Uytvanck,2,B-DTL,5,3,1,0,2,1,4
20191010-W-Linz-R16-Kiki_Bertens-Alison_Van_Uytvanck,2,B-IO,3,0,0,0,0,2,1
20191010-W-Linz-R16-Kiki_Bertens-Alison_Van_Uytvanck,2,S-XC,8,0,0,0,0,3,5
20191010-W-Linz-R16-Kiki_Bertens-Alison_Van_Uytvanck,2,S-DTM,8,0,0,0,0,4,4
20191010-W-Linz-R16-Kiki_Bertens-Alison_Van_Uytvanck,2,S-DTL,4,1,0,1,0,2,2
20191010-W-Linz-R16-Kiki_Bertens-Alison_Van_Uytvanck,2,S-IO,2,0,0,0,0,1,1
20191011-W-Linz-QF-Cori_Gauff-Kiki_Bertens,1,F-XC,43,12,3,3,6,30,13
20191011-W-Linz-QF-Cori_Gauff-Kiki_Bertens,1,F-DTM,52,6,1,3,2,34,18
20191011-W-Linz-QF-Cori_Gauff-Kiki_Bertens,1,F-DTL,12,4,2,1,1,6,6
20191011-W-Linz-QF-Cori_Gauff-Kiki_Bertens,1,F-IO,12,1,1,0,0,7,5
20191011-W-Linz-QF-Cori_Gauff-Kiki_Bertens,1,B-XC,62,8,2,1,5,35,27
20191011-W-Linz-QF-Cori_Gauff-Kiki_Bertens,1,B-DTM,28,1,0,0,1,15,13
20191011-W-Linz-QF-Cori_Gauff-Kiki_Bertens,1,B-DTL,5,1,0,1,0,4,1
20191011-W-Linz-QF-Cori_Gauff-Kiki_Bertens,1,B-IO,6,2,0,0,2,4,2
20191011-W-Linz-QF-Cori_Gauff-Kiki_Bertens,1,S-XC,5,1,0,0,1,2,3
20191011-W-Linz-QF-Cori_Gauff-Kiki_Bertens,1,S-DTM,9,1,0,0,1,3,6
20191011-W-Linz-QF-Cori_Gauff-Kiki_Bertens,1,S-DTL,2,1,0,0,1,0,2
20191011-W-Linz-QF-Cori_Gauff-Kiki_Bertens,1,S-IO,1,0,0,0,0,1,0
20191011-W-Linz-QF-Cori_Gauff-Kiki_Bertens,2,F-XC,53,8,2,1,5,21,32
20191011-W-Linz-QF-Cori_Gauff-Kiki_Bertens,2,F-DTM,17,2,0,0,2,5,12
20191011-W-Linz-QF-Cori_Gauff-Kiki_Bertens,2,F-DTL,4,2,0,0,2,1,3
20191011-W-Linz-QF-Cori_Gauff-Kiki_Bertens,2,F-IO,25,7,1,2,4,13,12
20191011-W-Linz-QF-Cori_Gauff-Kiki_Bertens,2,B-XC,40,5,0,0,4,17,23
20191011-W-Linz-QF-Cori_Gauff-Kiki_Bertens,2,B-DTM,47,2,0,0,2,17,30
20191011-W-Linz-QF-Cori_Gauff-Kiki_Bertens,2,B-DTL,11,1,0,0,1,4,7
20191011-W-Linz-QF-Cori_Gauff-Kiki_Bertens,2,B-IO,6,2,1,0,1,2,4
20191011-W-Linz-QF-Cori_Gauff-Kiki_Bertens,2,S-XC,11,2,1,1,0,8,3
20191011-W-Linz-QF-Cori_Gauff-Kiki_Bertens,2,S-DTM,12,2,0,2,0,6,6
20191011-W-Linz-QF-Cori_Gauff-Kiki_Bertens,2,S-DTL,3,0,0,0,0,1,2
20191011-W-Linz-QF-Cori_Gauff-Kiki_Bertens,2,S-IO,1,0,0,0,0,1,0
20190930-W-Beijing-R32-Elina_Svitolina-Yafan_Wang,1,F-XC,64,14,3,3,8,30,34
20190930-W-Beijing-R32-Elina_Svitolina-Yafan_Wang,1,F-DTM,60,7,0,0,7,24,36
20190930-W-Beijing-R32-Elina_Svitolina-Yafan_Wang,1,F-DTL,8,3,0,2,1,5,3
20190930-W-Beijing-R32-Elina_Svitolina-Yafan_Wang,1,F-IO,34,9,4,2,3,20,14
20190930-W-Beijing-R32-Elina_Svitolina-Yafan_Wang,1,F-II,1,0,0,0,0,0,1
20190930-W-Beijing-R32-Elina_Svitolina-Yafan_Wang,1,B-XC,71,12,5,1,6,35,36
20190930-W-Beijing-R32-Elina_Svitolina-Yafan_Wang,1,B-DTM,46,1,0,0,1,17,29
20190930-W-Beijing-R32-Elina_Svitolina-Yafan_Wang,1,B-DTL,6,2,1,0,1,3,3
20190930-W-Beijing-R32-Elina_Svitolina-Yafan_Wang,1,B-IO,14,6,5,0,1,11,3
20190930-W-Beijing-R32-Elina_Svitolina-Yafan_Wang,1,S-XC,6,1,1,0,0,2,4
20190930-W-Beijing-R32-Elina_Svitolina-Yafan_Wang,1,S-DTM,3,1,1,0,0,2,1
20190930-W-Beijing-R32-Elina_Svitolina-Yafan_Wang,2,F-XC,70,15,4,3,8,40,30
20190930-W-Beijing-R32-Elina_Svitolina-Yafan_Wang,2,F-DTM,63,3,0,1,2,30,33
20190930-W-Beijing-R32-Elina_Svitolina-Yafan_Wang,2,F-DTL,21,8,6,0,2,12,9
20190930-W-Beijing-R32-Elina_Svitolina-Yafan_Wang,2,F-IO,47,18,4,5,9,30,17
20190930-W-Beijing-R32-Elina_Svitolina-Yafan_Wang,2,F-II,7,5,4,0,1,6,1
20190930-W-Beijing-R32-Elina_Svitolina-Yafan_Wang,2,B-XC,55,8,0,0,8,28,27
20190930-W-Beijing-R32-Elina_Svitolina-Yafan_Wang,2,B-DTM,43,5,0,0,5,19,24
20190930-W-Beijing-R32-Elina_Svitolina-Yafan_Wang,2,B-DTL,14,5,4,0,1,10,4
20190930-W-Beijing-R32-Elina_Svitolina-Yafan_Wang,2,B-IO,3,1,0,0,1,2,1
20190930-W-Beijing-R32-Elina_Svitolina-Yafan_Wang,2,S-XC,5,1,0,0,1,2,3
20190930-W-Beijing-R32-Elina_Svitolina-Yafan_Wang,2,S-DTM,9,1,0,0,1,2,7
20190930-W-Beijing-R32-Elina_Svitolina-Yafan_Wang,2,S-DTL,1,0,0,0,0,1,0
20190930-W-Beijing-R32-Elina_Svitolina-Yafan_Wang,2,S-IO,2,1,0,0,1,0,2
20191010-W-Tianjin-R16-Shuai_Peng-Dayana_Yastremska,1,F-XC,11,4,0,3,1,8,3
20191010-W-Tianjin-R16-Shuai_Peng-Dayana_Yastremska,1,F-DTM,20,4,0,0,4,11,9
20191010-W-Tianjin-R16-Shuai_Peng-Dayana_Yastremska,1,F-DTL,2,1,0,0,1,0,2
20191010-W-Tianjin-R16-Shuai_Peng-Dayana_Yastremska,1,F-IO,8,0,0,0,0,2,6
20191010-W-Tianjin-R16-Shuai_Peng-Dayana_Yastremska,1,B-XC,16,4,1,2,1,7,9
20191010-W-Tianjin-R16-Shuai_Peng-Dayana_Yastremska,1,B-DTM,19,1,0,0,1,4,15
20191010-W-Tianjin-R16-Shuai_Peng-Dayana_Yastremska,1,B-DTL,8,5,2,0,3,4,4
20191010-W-Tianjin-R16-Shuai_Peng-Dayana_Yastremska,1,B-IO,2,0,0,0,0,0,2
20191010-W-Tianjin-R16-Shuai_Peng-Dayana_Yastremska,1,S-DTM,2,0,0,0,0,0,2
20191010-W-Tianjin-R16-Shuai_Peng-Dayana_Yastremska,1,S-DTL,1,0,0,0,0,1,0
20191010-W-Tianjin-R16-Shuai_Peng-Dayana_Yastremska,2,F-XC,28,13,5,1,7,12,16
20191010-W-Tianjin-R16-Shuai_Peng-Dayana_Yastremska,2,F-DTM,12,0,0,0,0,7,5
20191010-W-Tianjin-R16-Shuai_Peng-Dayana_Yastremska,2,F-DTL,7,4,3,0,1,5,2
20191010-W-Tianjin-R16-Shuai_Peng-Dayana_Yastremska,2,F-IO,12,7,3,0,4,8,4
20191010-W-Tianjin-R16-Shuai_Peng-Dayana_Yastremska,2,B-XC,21,7,3,1,3,14,7
20191010-W-Tianjin-R16-Shuai_Peng-Dayana_Yastremska,2,B-DTM,16,3,0,1,2,10,6
20191010-W-Tianjin-R16-Shuai_Peng-Dayana_Yastremska,2,B-DTL,7,5,4,0,1,6,1
20191010-W-Tianjin-R16-Shuai_Peng-Dayana_Yastremska,2,B-IO,7,7,3,1,3,4,3
20191010-W-Tianjin-R16-Shuai_Peng-Dayana_Yastremska,2,S-DTM,1,0,0,0,0,1,0
20190808-W-Toronto-R16-Dayana_Yastremska-Sofia_Kenin,1,F-XC,15,9,3,2,4,9,6
20190808-W-Toronto-R16-Dayana_Yastremska-Sofia_Kenin,1,F-DTM,10,1,0,0,1,7,3
20190808-W-Toronto-R16-Dayana_Yastremska-Sofia_Kenin,1,F-DTL,1,1,0,0,1,0,1
20190808-W-Toronto-R16-Dayana_Yastremska-Sofia_Kenin,1,F-IO,6,2,0,0,2,4,2
20190808-W-Toronto-R16-Dayana_Yastremska-Sofia_Kenin,1,B-XC,4,0,0,0,0,3,1
20190808-W-Toronto-R16-Dayana_Yastremska-Sofia_Kenin,1,B-DTM,8,0,0,0,0,6,2
20190808-W-Toronto-R16-Dayana_Yastremska-Sofia_Kenin,1,B-DTL,5,3,1,1,1,2,3
20190808-W-Toronto-R16-Dayana_Yastremska-Sofia_Kenin,1,B-IO,9,5,2,0,3,5,4
20190808-W-Toronto-R16-Dayana_Yastremska-Sofia_Kenin,1,S-DTM,1,0,0,0,0,0,1
20190808-W-Toronto-R16-Dayana_Yastremska-Sofia_Kenin,2,F-XC,15,10,1,6,3,10,5
20190808-W-Toronto-R16-Dayana_Yastremska-Sofia_Kenin,2,F-DTM,11,2,0,1,1,5,6
20190808-W-Toronto-R16-Dayana_Yastremska-Sofia_Kenin,2,F-DTL,1,0,0,0,0,1,0
20190808-W-Toronto-R16-Dayana_Yastremska-Sofia_Kenin,2,F-IO,1,1,0,1,0,1,0
20190808-W-Toronto-R16-Dayana_Yastremska-Sofia_Kenin,2,B-XC,9,3,0,1,2,3,6
20190808-W-Toronto-R16-Dayana_Yastremska-Sofia_Kenin,2,B-DTM,11,1,0,1,0,3,8
20190808-W-Toronto-R16-Dayana_Yastremska-Sofia_Kenin,2,B-IO,3,2,2,0,0,3,0
20190808-W-Toronto-R16-Dayana_Yastremska-Sofia_Kenin,2,S-DTM,3,0,0,0,0,1,2
20190926-W-Wuhan-QF-Dayana_Yastremska-Petra_Kvitova,1,F-XC,14,3,0,2,1,10,4
20190926-W-Wuhan-QF-Dayana_Yastremska-Petra_Kvitova,1,F-DTM,15,0,0,0,0,7,8
20190926-W-Wuhan-QF-Dayana_Yastremska-Petra_Kvitova,1,F-DTL,6,5,1,1,3,3,3
20190926-W-Wuhan-QF-Dayana_Yastremska-Petra_Kvitova,1,F-IO,8,0,0,0,0,3,5
20190926-W-Wuhan-QF-Dayana_Yastremska-Petra_Kvitova,1,B-XC,12,3,1,0,2,4,8
20190926-W-Wuhan-QF-Dayana_Yastremska-Petra_Kvitova,1,B-DTM,21,2,0,0,2,7,14
20190926-W-Wuhan-QF-Dayana_Yastremska-Petra_Kvitova,1,B-DTL,8,3,0,0,3,5,3
20190926-W-Wuhan-QF-Dayana_Yastremska-Petra_Kvitova,1,B-IO,7,2,0,1,1,4,3
20190926-W-Wuhan-QF-Dayana_Yastremska-Petra_Kvitova,1,S-XC,1,0,0,0,0,0,1
20190926-W-Wuhan-QF-Dayana_Yastremska-Petra_Kvitova,1,S-DTM,1,0,0,0,0,0,1
20190926-W-Wuhan-QF-Dayana_Yastremska-Petra_Kvitova,1,S-IO,1,0,0,0,0,1,0
20190926-W-Wuhan-QF-Dayana_Yastremska-Petra_Kvitova,2,F-XC,19,4,1,0,3,11,8
20190926-W-Wuhan-QF-Dayana_Yastremska-Petra_Kvitova,2,F-DTM,9,0,0,0,0,5,4
20190926-W-Wuhan-QF-Dayana_Yastremska-Petra_Kvitova,2,F-DTL,3,2,2,0,0,3,0
20190926-W-Wuhan-QF-Dayana_Yastremska-Petra_Kvitova,2,F-IO,7,4,0,1,3,2,5
20190926-W-Wuhan-QF-Dayana_Yastremska-Petra_Kvitova,2,F-II,1,0,0,0,0,1,0
20190926-W-Wuhan-QF-Dayana_Yastremska-Petra_Kvitova,2,B-XC,21,8,4,1,3,10,11
20190926-W-Wuhan-QF-Dayana_Yastremska-Petra_Kvitova,2,B-DTM,21,2,0,0,2,11,10
20190926-W-Wuhan-QF-Dayana_Yastremska-Petra_Kvitova,2,B-DTL,5,1,0,0,1,1,4
20190926-W-Wuhan-QF-Dayana_Yastremska-Petra_Kvitova,2,B-IO,5,0,0,0,0,4,1
20190926-W-Wuhan-QF-Dayana_Yastremska-Petra_Kvitova,2,S-XC,1,0,0,0,0,0,1
20190926-W-Wuhan-QF-Dayana_Yastremska-Petra_Kvitova,2,S-DTM,1,1,0,0,1,0,1
20190926-W-Wuhan-QF-Dayana_Yastremska-Petra_Kvitova,2,S-DTL,2,1,1,0,0,1,1
20191012-W-Tianjin-SF-Heather_Watson-Veronika_Kudermetova,1,F-XC,23,6,2,2,2,20,3
20191012-W-Tianjin-SF-Heather_Watson-Veronika_Kudermetova,1,F-DTM,9,0,0,0,0,7,2
20191012-W-Tianjin-SF-Heather_Watson-Veronika_Kudermetova,1,F-DTL,3,2,0,2,0,3,0
20191012-W-Tianjin-SF-Heather_Watson-Veronika_Kudermetova,1,F-IO,5,3,2,0,1,2,3
20191012-W-Tianjin-SF-Heather_Watson-Veronika_Kudermetova,1,F-II,1,0,0,0,0,1,0
20191012-W-Tianjin-SF-Heather_Watson-Veronika_Kudermetova,1,B-XC,32,10,5,4,1,22,10
20191012-W-Tianjin-SF-Heather_Watson-Veronika_Kudermetova,1,B-DTM,33,2,0,0,2,22,11
20191012-W-Tianjin-SF-Heather_Watson-Veronika_Kudermetova,1,B-DTL,7,3,2,0,1,5,2
20191012-W-Tianjin-SF-Heather_Watson-Veronika_Kudermetova,1,B-IO,2,1,0,0,1,1,1
20191012-W-Tianjin-SF-Heather_Watson-Veronika_Kudermetova,1,S-XC,2,0,0,0,0,1,1
20191012-W-Tianjin-SF-Heather_Watson-Veronika_Kudermetova,1,S-DTL,1,0,0,0,0,1,0
20191012-W-Tianjin-SF-Heather_Watson-Veronika_Kudermetova,1,S-IO,1,0,0,0,0,0,1
20191012-W-Tianjin-SF-Heather_Watson-Veronika_Kudermetova,1,S-II,1,0,0,0,0,0,1
20191012-W-Tianjin-SF-Heather_Watson-Veronika_Kudermetova,2,F-XC,19,8,3,0,5,3,16
20191012-W-Tianjin-SF-Heather_Watson-Veronika_Kudermetova,2,F-DTM,20,0,0,0,0,5,15
20191012-W-Tianjin-SF-Heather_Watson-Veronika_Kudermetova,2,F-DTL,11,4,0,0,4,2,9
20191012-W-Tianjin-SF-Heather_Watson-Veronika_Kudermetova,2,F-IO,19,6,3,1,2,10,9
20191012-W-Tianjin-SF-Heather_Watson-Veronika_Kudermetova,2,B-XC,19,2,0,0,2,11,8
20191012-W-Tianjin-SF-Heather_Watson-Veronika_Kudermetova,2,B-DTM,20,4,0,0,4,6,14
20191012-W-Tianjin-SF-Heather_Watson-Veronika_Kudermetova,2,B-DTL,4,2,1,0,1,3,1
20191012-W-Tianjin-SF-Heather_Watson-Veronika_Kudermetova,2,B-IO,6,3,0,2,1,2,4
20191012-W-Tianjin-SF-Heather_Watson-Veronika_Kudermetova,2,S-XC,7,1,0,0,1,1,6
20191012-W-Tianjin-SF-Heather_Watson-Veronika_Kudermetova,2,S-DTM,2,0,0,0,0,1,1
20191012-W-Tianjin-SF-Heather_Watson-Veronika_Kudermetova,2,S-DTL,1,0,0,0,0,1,0
19841207-W-Australian_Open-SF-Martina_Navratilova-Helena_Sukova,1,F-XC,15,6,3,0,3,7,8
19841207-W-Australian_Open-SF-Martina_Navratilova-Helena_Sukova,1,F-DTM,1,0,0,0,0,0,1
19841207-W-Australian_Open-SF-Martina_Navratilova-Helena_Sukova,1,F-DTL,6,6,3,1,2,4,2
19841207-W-Australian_Open-SF-Martina_Navratilova-Helena_Sukova,1,F-IO,4,3,1,0,2,2,2
19841207-W-Australian_Open-SF-Martina_Navratilova-Helena_Sukova,1,B-XC,3,1,0,0,1,0,3
19841207-W-Australian_Open-SF-Martina_Navratilova-Helena_Sukova,1,B-DTM,1,0,0,0,0,0,1
19841207-W-Australian_Open-SF-Martina_Navratilova-Helena_Sukova,1,B-DTL,2,1,0,0,1,0,2
19841207-W-Australian_Open-SF-Martina_Navratilova-Helena_Sukova,1,S-XC,2,1,0,1,0,1,1
19841207-W-Australian_Open-SF-Martina_Navratilova-Helena_Sukova,1,S-DTM,2,2,1,1,0,2,0
19841207-W-Australian_Open-SF-Martina_Navratilova-Helena_Sukova,1,S-DTL,7,2,1,1,0,3,4
19841207-W-Australian_Open-SF-Martina_Navratilova-Helena_Sukova,1,S-IO,1,0,0,0,0,1,0
19841207-W-Australian_Open-SF-Martina_Navratilova-Helena_Sukova,2,F-XC,6,4,1,1,2,3,3
19841207-W-Australian_Open-SF-Martina_Navratilova-Helena_Sukova,2,F-DTM,6,0,0,0,0,2,4
19841207-W-Australian_Open-SF-Martina_Navratilova-Helena_Sukova,2,F-DTL,6,4,2,0,2,3,3
19841207-W-Australian_Open-SF-Martina_Navratilova-Helena_Sukova,2,F-IO,3,1,0,1,0,3,0
19841207-W-Australian_Open-SF-Martina_Navratilova-Helena_Sukova,2,F-II,1,1,0,0,1,0,1
19841207-W-Australian_Open-SF-Martina_Navratilova-Helena_Sukova,2,B-XC,10,6,2,0,4,3,7
19841207-W-Australian_Open-SF-Martina_Navratilova-Helena_Sukova,2,B-DTM,5,0,0,0,0,2,3
19841207-W-Australian_Open-SF-Martina_Navratilova-Helena_Sukova,2,B-DTL,7,5,3,0,2,4,3
19841207-W-Australian_Open-SF-Martina_Navratilova-Helena_Sukova,2,B-IO,1,1,0,0,1,0,1
19841207-W-Australian_Open-SF-Martina_Navratilova-Helena_Sukova,2,S-XC,10,3,0,2,1,3,7
19841207-W-Australian_Open-SF-Martina_Navratilova-Helena_Sukova,2,S-DTM,5,1,0,0,1,2,3
19841207-W-Australian_Open-SF-Martina_Navratilova-Helena_Sukova,2,S-DTL,4,1,1,0,0,3,1
19841207-W-Australian_Open-SF-Martina_Navratilova-Helena_Sukova,2,S-IO,2,1,0,0,1,0,2
20190926-W-Wuhan-QF-Elina_Svitolina-Alison_Riske,1,F-XC,41,9,1,2,6,20,21
20190926-W-Wuhan-QF-Elina_Svitolina-Alison_Riske,1,F-DTM,42,3,0,0,3,18,24
20190926-W-Wuhan-QF-Elina_Svitolina-Alison_Riske,1,F-DTL,9,2,0,0,2,2,7
20190926-W-Wuhan-QF-Elina_Svitolina-Alison_Riske,1,F-IO,23,5,2,0,3,14,9
20190926-W-Wuhan-QF-Elina_Svitolina-Alison_Riske,1,F-II,2,2,0,0,2,0,2
20190926-W-Wuhan-QF-Elina_Svitolina-Alison_Riske,1,B-XC,35,6,1,1,4,19,16
20190926-W-Wuhan-QF-Elina_Svitolina-Alison_Riske,1,B-DTM,37,3,0,0,3,18,19
20190926-W-Wuhan-QF-Elina_Svitolina-Alison_Riske,1,B-DTL,6,1,1,0,0,4,2
20190926-W-Wuhan-QF-Elina_Svitolina-Alison_Riske,1,B-IO,6,1,0,0,1,4,2
20190926-W-Wuhan-QF-Elina_Svitolina-Alison_Riske,1,S-XC,7,1,0,0,1,3,4
20190926-W-Wuhan-QF-Elina_Svitolina-Alison_Riske,1,S-DTM,5,0,0,0,0,1,4
20190926-W-Wuhan-QF-Elina_Svitolina-Alison_Riske,2,F-XC,27,5,1,2,2,20,7
20190926-W-Wuhan-QF-Elina_Svitolina-Alison_Riske,2,F-DTM,30,2,0,0,2,14,16
20190926-W-Wuhan-QF-Elina_Svitolina-Alison_Riske,2,F-DTL,18,5,2,1,2,6,12
20190926-W-Wuhan-QF-Elina_Svitolina-Alison_Riske,2,F-IO,25,11,3,4,4,18,7
20190926-W-Wuhan-QF-Elina_Svitolina-Alison_Riske,2,B-XC,29,0,0,0,0,10,19
20190926-W-Wuhan-QF-Elina_Svitolina-Alison_Riske,2,B-DTM,43,4,0,0,4,15,28
20190926-W-Wuhan-QF-Elina_Svitolina-Alison_Riske,2,B-DTL,21,9,6,0,3,12,9
20190926-W-Wuhan-QF-Elina_Svitolina-Alison_Riske,2,B-IO,21,9,5,0,4,13,8
20190926-W-Wuhan-QF-Elina_Svitolina-Alison_Riske,2,S-XC,3,0,0,0,0,1,2
20190926-W-Wuhan-QF-Elina_Svitolina-Alison_Riske,2,S-DTM,6,0,0,0,0,3,3
20191015-W-Moscow-R32-Ons_Jabeur-Veronika_Kudermetova,1,F-XC,23,8,2,1,5,12,11
20191015-W-Moscow-R32-Ons_Jabeur-Veronika_Kudermetova,1,F-DTM,7,0,0,0,0,1,6
20191015-W-Moscow-R32-Ons_Jabeur-Veronika_Kudermetova,1,F-DTL,10,3,2,1,0,9,1
20191015-W-Moscow-R32-Ons_Jabeur-Veronika_Kudermetova,1,F-IO,13,6,1,2,3,5,8
20191015-W-Moscow-R32-Ons_Jabeur-Veronika_Kudermetova,1,F-II,3,2,0,1,1,1,2
20191015-W-Moscow-R32-Ons_Jabeur-Veronika_Kudermetova,1,B-XC,15,1,0,0,1,9,6
20191015-W-Moscow-R32-Ons_Jabeur-Veronika_Kudermetova,1,B-DTM,10,1,0,0,1,7,3
20191015-W-Moscow-R32-Ons_Jabeur-Veronika_Kudermetova,1,S-XC,10,4,0,2,2,6,4
20191015-W-Moscow-R32-Ons_Jabeur-Veronika_Kudermetova,1,S-DTM,7,1,0,0,1,2,5
20191015-W-Moscow-R32-Ons_Jabeur-Veronika_Kudermetova,1,S-DTL,3,1,0,0,1,1,2
20191015-W-Moscow-R32-Ons_Jabeur-Veronika_Kudermetova,2,F-XC,18,8,2,5,1,10,8
20191015-W-Moscow-R32-Ons_Jabeur-Veronika_Kudermetova,2,F-DTM,7,1,0,0,1,2,5
20191015-W-Moscow-R32-Ons_Jabeur-Veronika_Kudermetova,2,F-DTL,8,5,2,3,0,6,2
20191015-W-Moscow-R32-Ons_Jabeur-Veronika_Kudermetova,2,F-IO,7,2,1,1,0,5,2
20191015-W-Moscow-R32-Ons_Jabeur-Veronika_Kudermetova,2,B-XC,28,7,0,4,3,16,12
20191015-W-Moscow-R32-Ons_Jabeur-Veronika_Kudermetova,2,B-DTM,16,1,0,0,1,8,8
20191015-W-Moscow-R32-Ons_Jabeur-Veronika_Kudermetova,2,B-DTL,2,2,0,1,1,1,1
20191015-W-Moscow-R32-Ons_Jabeur-Veronika_Kudermetova,2,B-IO,1,1,0,0,1,0,1
20191015-W-Moscow-R32-Ons_Jabeur-Veronika_Kudermetova,2,S-XC,9,1,0,0,1,4,5
20191015-W-Moscow-R32-Ons_Jabeur-Veronika_Kudermetova,2,S-DTM,5,1,0,0,1,1,4
20191017-W-Moscow-R16-Elina_Svitolina-Veronika_Kudermetova,1,F-XC,59,4,0,1,3,25,34
20191017-W-Moscow-R16-Elina_Svitolina-Veronika_Kudermetova,1,F-DTM,34,0,0,0,0,16,18
20191017-W-Moscow-R16-Elina_Svitolina-Veronika_Kudermetova,1,F-DTL,8,3,1,1,1,3,5
20191017-W-Moscow-R16-Elina_Svitolina-Veronika_Kudermetova,1,F-IO,18,5,4,0,1,15,3
20191017-W-Moscow-R16-Elina_Svitolina-Veronika_Kudermetova,1,B-XC,39,4,1,0,3,20,19
20191017-W-Moscow-R16-Elina_Svitolina-Veronika_Kudermetova,1,B-DTM,26,1,0,0,1,7,19
20191017-W-Moscow-R16-Elina_Svitolina-Veronika_Kudermetova,1,B-DTL,5,3,1,0,2,1,4
20191017-W-Moscow-R16-Elina_Svitolina-Veronika_Kudermetova,1,B-IO,2,0,0,0,0,2,0
20191017-W-Moscow-R16-Elina_Svitolina-Veronika_Kudermetova,1,S-XC,7,1,0,0,1,2,5
20191017-W-Moscow-R16-Elina_Svitolina-Veronika_Kudermetova,1,S-DTM,3,0,0,0,0,0,3
20191017-W-Moscow-R16-Elina_Svitolina-Veronika_Kudermetova,2,F-XC,79,20,7,5,8,44,35
20191017-W-Moscow-R16-Elina_Svitolina-Veronika_Kudermetova,2,F-DTM,10,2,1,0,1,6,4
20191017-W-Moscow-R16-Elina_Svitolina-Veronika_Kudermetova,2,F-DTL,10,5,1,0,4,4,6
20191017-W-Moscow-R16-Elina_Svitolina-Veronika_Kudermetova,2,F-IO,12,4,1,1,2,7,5
20191017-W-Moscow-R16-Elina_Svitolina-Veronika_Kudermetova,2,F-II,1,1,0,1,0,1,0
20191017-W-Moscow-R16-Elina_Svitolina-Veronika_Kudermetova,2,B-XC,39,7,3,0,4,22,17
20191017-W-Moscow-R16-Elina_Svitolina-Veronika_Kudermetova,2,B-DTM,29,3,0,0,3,15,14
20191017-W-Moscow-R16-Elina_Svitolina-Veronika_Kudermetova,2,B-DTL,12,6,5,1,0,9,3
20191017-W-Moscow-R16-Elina_Svitolina-Veronika_Kudermetova,2,B-IO,18,7,1,3,3,12,6
20191017-W-Moscow-R16-Elina_Svitolina-Veronika_Kudermetova,2,S-XC,15,3,0,0,3,7,8
20191017-W-Moscow-R16-Elina_Svitolina-Veronika_Kudermetova,2,S-DTM,3,0,0,0,0,0,3
20191017-W-Moscow-R16-Elina_Svitolina-Veronika_Kudermetova,2,S-IO,1,0,0,0,0,0,1
20191018-W-Moscow-QF-Veronika_Kudermetova-Anastasia_Pavlyuchenkova,1,F-XC,45,16,6,3,7,24,21
20191018-W-Moscow-QF-Veronika_Kudermetova-Anastasia_Pavlyuchenkova,1,F-DTM,20,3,0,0,3,9,11
20191018-W-Moscow-QF-Veronika_Kudermetova-Anastasia_Pavlyuchenkova,1,F-DTL,21,10,5,3,2,15,6
20191018-W-Moscow-QF-Veronika_Kudermetova-Anastasia_Pavlyuchenkova,1,F-IO,15,7,2,2,3,8,7
20191018-W-Moscow-QF-Veronika_Kudermetova-Anastasia_Pavlyuchenkova,1,F-II,1,0,0,0,0,0,1
20191018-W-Moscow-QF-Veronika_Kudermetova-Anastasia_Pavlyuchenkova,1,B-XC,32,7,1,1,5,11,21
20191018-W-Moscow-QF-Veronika_Kudermetova-Anastasia_Pavlyuchenkova,1,B-DTM,19,3,0,0,3,6,13
20191018-W-Moscow-QF-Veronika_Kudermetova-Anastasia_Pavlyuchenkova,1,B-DTL,18,10,6,2,2,14,4
20191018-W-Moscow-QF-Veronika_Kudermetova-Anastasia_Pavlyuchenkova,1,B-IO,9,5,3,0,2,4,5
20191018-W-Moscow-QF-Veronika_Kudermetova-Anastasia_Pavlyuchenkova,1,S-XC,3,1,0,1,0,2,1
20191018-W-Moscow-QF-Veronika_Kudermetova-Anastasia_Pavlyuchenkova,1,S-DTM,4,0,0,0,0,1,3
20191018-W-Moscow-QF-Veronika_Kudermetova-Anastasia_Pavlyuchenkova,2,F-XC,45,9,1,6,2,26,19
20191018-W-Moscow-QF-Veronika_Kudermetova-Anastasia_Pavlyuchenkova,2,F-DTM,21,1,0,0,1,8,13
20191018-W-Moscow-QF-Veronika_Kudermetova-Anastasia_Pavlyuchenkova,2,F-DTL,17,5,2,2,1,10,7
20191018-W-Moscow-QF-Veronika_Kudermetova-Anastasia_Pavlyuchenkova,2,F-IO,10,1,1,0,0,6,4
20191018-W-Moscow-QF-Veronika_Kudermetova-Anastasia_Pavlyuchenkova,2,B-XC,23,5,1,2,2,12,11
20191018-W-Moscow-QF-Veronika_Kudermetova-Anastasia_Pavlyuchenkova,2,B-DTM,26,3,0,2,1,13,13
20191018-W-Moscow-QF-Veronika_Kudermetova-Anastasia_Pavlyuchenkova,2,B-DTL,15,4,1,2,1,10,5
20191018-W-Moscow-QF-Veronika_Kudermetova-Anastasia_Pavlyuchenkova,2,B-IO,4,1,1,0,0,1,3
20191018-W-Moscow-QF-Veronika_Kudermetova-Anastasia_Pavlyuchenkova,2,S-XC,1,0,0,0,0,0,1
20191018-W-Moscow-QF-Veronika_Kudermetova-Anastasia_Pavlyuchenkova,2,S-DTM,1,0,0,0,0,0,1
20191018-W-Moscow-QF-Kirsten_Flipkens-Belinda_Bencic,1,F-XC,39,12,4,3,5,19,20
20191018-W-Moscow-QF-Kirsten_Flipkens-Belinda_Bencic,1,F-DTM,9,0,0,0,0,4,5
20191018-W-Moscow-QF-Kirsten_Flipkens-Belinda_Bencic,1,F-DTL,10,8,3,1,4,5,5
20191018-W-Moscow-QF-Kirsten_Flipkens-Belinda_Bencic,1,F-IO,12,2,0,2,0,5,7
20191018-W-Moscow-QF-Kirsten_Flipkens-Belinda_Bencic,1,B-XC,3,1,0,0,1,1,2
20191018-W-Moscow-QF-Kirsten_Flipkens-Belinda_Bencic,1,B-DTM,1,0,0,0,0,0,1
20191018-W-Moscow-QF-Kirsten_Flipkens-Belinda_Bencic,1,B-DTL,1,0,0,0,0,0,1
20191018-W-Moscow-QF-Kirsten_Flipkens-Belinda_Bencic,1,S-XC,26,0,0,0,0,10,16
20191018-W-Moscow-QF-Kirsten_Flipkens-Belinda_Bencic,1,S-DTM,34,2,0,0,2,20,14
20191018-W-Moscow-QF-Kirsten_Flipkens-Belinda_Bencic,1,S-DTL,5,0,0,0,0,4,1
20191018-W-Moscow-QF-Kirsten_Flipkens-Belinda_Bencic,1,S-IO,2,1,0,0,1,0,2
20191018-W-Moscow-QF-Kirsten_Flipkens-Belinda_Bencic,2,F-XC,37,9,1,6,2,21,16
20191018-W-Moscow-QF-Kirsten_Flipkens-Belinda_Bencic,2,F-DTM,13,2,0,2,0,7,6
20191018-W-Moscow-QF-Kirsten_Flipkens-Belinda_Bencic,2,F-DTL,6,1,0,0,1,4,2
20191018-W-Moscow-QF-Kirsten_Flipkens-Belinda_Bencic,2,F-IO,24,5,1,1,3,11,13
20191018-W-Moscow-QF-Kirsten_Flipkens-Belinda_Bencic,2,B-XC,31,3,1,2,0,18,13
20191018-W-Moscow-QF-Kirsten_Flipkens-Belinda_Bencic,2,B-DTM,18,2,1,0,1,12,6
20191018-W-Moscow-QF-Kirsten_Flipkens-Belinda_Bencic,2,B-DTL,16,11,3,7,1,12,4
20191018-W-Moscow-QF-Kirsten_Flipkens-Belinda_Bencic,2,B-IO,9,2,0,0,2,3,6
20191018-W-Moscow-QF-Kirsten_Flipkens-Belinda_Bencic,2,S-DTM,2,0,0,0,0,1,1
20191002-W-Beijing-R32-Bianca_Andreescu-Elise_Mertens,1,F-XC,37,15,3,6,6,22,15
20191002-W-Beijing-R32-Bianca_Andreescu-Elise_Mertens,1,F-DTM,27,2,0,0,2,13,14
20191002-W-Beijing-R32-Bianca_Andreescu-Elise_Mertens,1,F-DTL,9,3,1,1,1,4,5
20191002-W-Beijing-R32-Bianca_Andreescu-Elise_Mertens,1,F-IO,21,7,4,0,3,12,9
20191002-W-Beijing-R32-Bianca_Andreescu-Elise_Mertens,1,B-XC,33,7,0,2,5,21,12
20191002-W-Beijing-R32-Bianca_Andreescu-Elise_Mertens,1,B-DTM,33,3,0,1,2,17,16
20191002-W-Beijing-R32-Bianca_Andreescu-Elise_Mertens,1,B-DTL,13,6,3,1,2,8,5
20191002-W-Beijing-R32-Bianca_Andreescu-Elise_Mertens,1,B-IO,9,4,0,0,4,3,6
20191002-W-Beijing-R32-Bianca_Andreescu-Elise_Mertens,1,S-XC,8,1,0,0,1,4,4
20191002-W-Beijing-R32-Bianca_Andreescu-Elise_Mertens,1,S-DTM,10,1,0,0,1,6,4
20191002-W-Beijing-R32-Bianca_Andreescu-Elise_Mertens,1,S-DTL,2,0,0,0,0,1,1
20191002-W-Beijing-R32-Bianca_Andreescu-Elise_Mertens,1,S-IO,1,1,0,1,0,1,0
20191002-W-Beijing-R32-Bianca_Andreescu-Elise_Mertens,2,F-XC,26,11,3,0,8,10,16
20191002-W-Beijing-R32-Bianca_Andreescu-Elise_Mertens,2,F-DTM,23,1,0,0,1,10,13
20191002-W-Beijing-R32-Bianca_Andreescu-Elise_Mertens,2,F-DTL,9,5,1,2,2,5,4
20191002-W-Beijing-R32-Bianca_Andreescu-Elise_Mertens,2,F-IO,19,6,1,1,4,8,11
20191002-W-Beijing-R32-Bianca_Andreescu-Elise_Mertens,2,B-XC,44,10,2,2,6,22,22
20191002-W-Beijing-R32-Bianca_Andreescu-Elise_Mertens,2,B-DTM,33,3,0,0,3,14,19
20191002-W-Beijing-R32-Bianca_Andreescu-Elise_Mertens,2,B-DTL,11,4,3,0,1,7,4
20191002-W-Beijing-R32-Bianca_Andreescu-Elise_Mertens,2,B-IO,8,4,2,0,2,4,4
20191002-W-Beijing-R32-Bianca_Andreescu-Elise_Mertens,2,S-XC,5,0,0,0,0,1,4
20191002-W-Beijing-R32-Bianca_Andreescu-Elise_Mertens,2,S-DTM,4,0,0,0,0,2,2
20191002-W-Beijing-R32-Bianca_Andreescu-Elise_Mertens,2,S-DTL,1,0,0,0,0,0,1
20191002-W-Beijing-R32-Bianca_Andreescu-Elise_Mertens,2,S-IO,2,0,0,0,0,1,1
20191017-W-Moscow-R16-Kiki_Bertens-Kaia_Kanepi,1,F-XC,75,10,4,2,4,50,25
20191017-W-Moscow-R16-Kiki_Bertens-Kaia_Kanepi,1,F-DTM,39,4,2,0,2,27,12
20191017-W-Moscow-R16-Kiki_Bertens-Kaia_Kanepi,1,F-DTL,17,7,4,2,1,11,6
20191017-W-Moscow-R16-Kiki_Bertens-Kaia_Kanepi,1,F-IO,18,11,7,0,4,11,7
20191017-W-Moscow-R16-Kiki_Bertens-Kaia_Kanepi,1,B-XC,39,7,1,0,6,24,15
20191017-W-Moscow-R16-Kiki_Bertens-Kaia_Kanepi,1,B-DTM,36,4,0,0,4,23,13
20191017-W-Moscow-R16-Kiki_Bertens-Kaia_Kanepi,1,B-DTL,8,3,1,1,1,3,5
20191017-W-Moscow-R16-Kiki_Bertens-Kaia_Kanepi,1,B-IO,1,0,0,0,0,0,1
20191017-W-Moscow-R16-Kiki_Bertens-Kaia_Kanepi,1,S-XC,22,2,1,0,1,14,8
20191017-W-Moscow-R16-Kiki_Bertens-Kaia_Kanepi,1,S-DTM,11,0,0,0,0,6,5
20191017-W-Moscow-R16-Kiki_Bertens-Kaia_Kanepi,1,S-DTL,5,0,0,0,0,1,4
20191017-W-Moscow-R16-Kiki_Bertens-Kaia_Kanepi,1,S-IO,2,1,0,1,0,1,1
20191017-W-Moscow-R16-Kiki_Bertens-Kaia_Kanepi,2,F-XC,62,15,3,3,9,23,39
20191017-W-Moscow-R16-Kiki_Bertens-Kaia_Kanepi,2,F-DTM,46,4,0,1,3,11,35
20191017-W-Moscow-R16-Kiki_Bertens-Kaia_Kanepi,2,F-DTL,23,13,4,4,5,13,10
20191017-W-Moscow-R16-Kiki_Bertens-Kaia_Kanepi,2,F-IO,35,13,5,1,7,15,20
20191017-W-Moscow-R16-Kiki_Bertens-Kaia_Kanepi,2,B-XC,44,7,1,0,6,19,25
20191017-W-Moscow-R16-Kiki_Bertens-Kaia_Kanepi,2,B-DTM,27,1,0,0,1,11,16
20191017-W-Moscow-R16-Kiki_Bertens-Kaia_Kanepi,2,B-DTL,13,4,2,1,1,6,7
20191017-W-Moscow-R16-Kiki_Bertens-Kaia_Kanepi,2,B-IO,15,1,0,0,1,4,11
20191017-W-Moscow-R16-Kiki_Bertens-Kaia_Kanepi,2,S-XC,6,0,0,0,0,3,3
20191017-W-Moscow-R16-Kiki_Bertens-Kaia_Kanepi,2,S-DTM,6,1,0,1,0,1,5
20191017-W-Moscow-R16-Kiki_Bertens-Kaia_Kanepi,2,S-DTL,6,2,1,0,1,2,4
20191017-W-Moscow-R16-Kiki_Bertens-Kaia_Kanepi,2,S-IO,2,0,0,0,0,0,2
20191018-W-Moscow-QF-Kiki_Bertens-Kristina_Mladenovic,1,F-XC,60,8,3,1,4,37,23
20191018-W-Moscow-QF-Kiki_Bertens-Kristina_Mladenovic,1,F-DTM,17,2,0,2,0,6,11
20191018-W-Moscow-QF-Kiki_Bertens-Kristina_Mladenovic,1,F-DTL,17,9,4,1,4,9,8
20191018-W-Moscow-QF-Kiki_Bertens-Kristina_Mladenovic,1,F-IO,32,7,3,0,4,16,16
20191018-W-Moscow-QF-Kiki_Bertens-Kristina_Mladenovic,1,F-II,1,0,0,0,0,0,1
20191018-W-Moscow-QF-Kiki_Bertens-Kristina_Mladenovic,1,B-XC,61,13,2,1,10,26,35
20191018-W-Moscow-QF-Kiki_Bertens-Kristina_Mladenovic,1,B-DTM,30,4,0,2,2,16,14
20191018-W-Moscow-QF-Kiki_Bertens-Kristina_Mladenovic,1,B-DTL,4,2,1,1,0,4,0
20191018-W-Moscow-QF-Kiki_Bertens-Kristina_Mladenovic,1,B-IO,1,0,0,0,0,0,1
20191018-W-Moscow-QF-Kiki_Bertens-Kristina_Mladenovic,1,S-XC,21,3,0,0,3,11,10
20191018-W-Moscow-QF-Kiki_Bertens-Kristina_Mladenovic,1,S-DTM,11,0,0,0,0,2,9
20191018-W-Moscow-QF-Kiki_Bertens-Kristina_Mladenovic,1,S-DTL,4,3,1,1,1,3,1
20191018-W-Moscow-QF-Kiki_Bertens-Kristina_Mladenovic,2,F-XC,42,9,2,2,4,19,23
20191018-W-Moscow-QF-Kiki_Bertens-Kristina_Mladenovic,2,F-DTM,25,3,0,0,3,12,13
20191018-W-Moscow-QF-Kiki_Bertens-Kristina_Mladenovic,2,F-DTL,20,9,0,4,5,10,10
20191018-W-Moscow-QF-Kiki_Bertens-Kristina_Mladenovic,2,F-IO,33,6,1,3,2,19,14
20191018-W-Moscow-QF-Kiki_Bertens-Kristina_Mladenovic,2,F-II,5,2,2,0,0,3,2
20191018-W-Moscow-QF-Kiki_Bertens-Kristina_Mladenovic,2,B-XC,42,6,1,3,2,23,19
20191018-W-Moscow-QF-Kiki_Bertens-Kristina_Mladenovic,2,B-DTM,26,1,1,0,0,11,15
20191018-W-Moscow-QF-Kiki_Bertens-Kristina_Mladenovic,2,B-DTL,8,1,1,0,0,5,3
20191018-W-Moscow-QF-Kiki_Bertens-Kristina_Mladenovic,2,B-IO,5,4,1,0,3,2,3
20191018-W-Moscow-QF-Kiki_Bertens-Kristina_Mladenovic,2,S-XC,19,0,0,0,0,7,12
20191018-W-Moscow-QF-Kiki_Bertens-Kristina_Mladenovic,2,S-DTM,10,0,0,0,0,5,5
20191018-W-Moscow-QF-Kiki_Bertens-Kristina_Mladenovic,2,S-DTL,8,2,0,0,2,4,4
20191018-W-Moscow-QF-Kiki_Bertens-Kristina_Mladenovic,2,S-IO,1,0,0,0,0,0,1
20191015-W-Moscow-R32-Jana_Cepelova-Ekaterina_Alexandrova,1,F-XC,24,4,1,1,2,10,14
20191015-W-Moscow-R32-Jana_Cepelova-Ekaterina_Alexandrova,1,F-DTM,9,2,0,1,1,3,6
20191015-W-Moscow-R32-Jana_Cepelova-Ekaterina_Alexandrova,1,F-DTL,4,3,1,0,2,1,3
20191015-W-Moscow-R32-Jana_Cepelova-Ekaterina_Alexandrova,1,F-IO,3,2,1,0,1,1,2
20191015-W-Moscow-R32-Jana_Cepelova-Ekaterina_Alexandrova,1,F-II,1,1,0,0,1,0,1
20191015-W-Moscow-R32-Jana_Cepelova-Ekaterina_Alexandrova,1,B-XC,23,6,0,1,5,10,13
20191015-W-Moscow-R32-Jana_Cepelova-Ekaterina_Alexandrova,1,B-DTM,13,2,0,0,2,5,8
20191015-W-Moscow-R32-Jana_Cepelova-Ekaterina_Alexandrova,1,B-DTL,4,3,0,0,3,0,4
20191015-W-Moscow-R32-Jana_Cepelova-Ekaterina_Alexandrova,1,B-IO,4,0,0,0,0,2,2
20191015-W-Moscow-R32-Jana_Cepelova-Ekaterina_Alexandrova,1,S-XC,4,0,0,0,0,0,4
20191015-W-Moscow-R32-Jana_Cepelova-Ekaterina_Alexandrova,1,S-DTM,1,0,0,0,0,0,1
20191015-W-Moscow-R32-Jana_Cepelova-Ekaterina_Alexandrova,2,F-XC,24,12,2,2,8,14,10
20191015-W-Moscow-R32-Jana_Cepelova-Ekaterina_Alexandrova,2,F-DTM,13,0,0,0,0,6,7
20191015-W-Moscow-R32-Jana_Cepelova-Ekaterina_Alexandrova,2,F-DTL,11,5,3,0,2,6,5
20191015-W-Moscow-R32-Jana_Cepelova-Ekaterina_Alexandrova,2,F-IO,8,3,1,1,1,4,4
20191015-W-Moscow-R32-Jana_Cepelova-Ekaterina_Alexandrova,2,B-XC,25,10,3,1,6,16,9
20191015-W-Moscow-R32-Jana_Cepelova-Ekaterina_Alexandrova,2,B-DTM,13,2,0,0,2,6,7
20191015-W-Moscow-R32-Jana_Cepelova-Ekaterina_Alexandrova,2,B-DTL,8,1,1,0,0,5,3
20191015-W-Moscow-R32-Jana_Cepelova-Ekaterina_Alexandrova,2,B-IO,1,0,0,0,0,1,0
20191016-W-Moscow-R16-Ekaterina_Alexandrova-Anna_Kalinskaya,1,F-XC,15,3,1,0,2,8,7
20191016-W-Moscow-R16-Ekaterina_Alexandrova-Anna_Kalinskaya,1,F-DTM,5,0,0,0,0,4,1
20191016-W-Moscow-R16-Ekaterina_Alexandrova-Anna_Kalinskaya,1,F-DTL,6,1,1,0,0,6,0
20191016-W-Moscow-R16-Ekaterina_Alexandrova-Anna_Kalinskaya,1,F-IO,16,4,1,3,0,12,4
20191016-W-Moscow-R16-Ekaterina_Alexandrova-Anna_Kalinskaya,1,F-II,1,1,1,0,0,1,0
20191016-W-Moscow-R16-Ekaterina_Alexandrova-Anna_Kalinskaya,1,B-XC,23,8,2,2,4,14,9
20191016-W-Moscow-R16-Ekaterina_Alexandrova-Anna_Kalinskaya,1,B-DTM,13,0,0,0,0,12,1
20191016-W-Moscow-R16-Ekaterina_Alexandrova-Anna_Kalinskaya,1,B-DTL,10,5,3,1,1,6,4
20191016-W-Moscow-R16-Ekaterina_Alexandrova-Anna_Kalinskaya,1,B-IO,3,0,0,0,0,2,1
20191016-W-Moscow-R16-Ekaterina_Alexandrova-Anna_Kalinskaya,1,S-XC,1,0,0,0,0,1,0
20191016-W-Moscow-R16-Ekaterina_Alexandrova-Anna_Kalinskaya,2,F-XC,15,3,1,1,1,3,12
20191016-W-Moscow-R16-Ekaterina_Alexandrova-Anna_Kalinskaya,2,F-DTM,11,1,0,1,0,6,5
20191016-W-Moscow-R16-Ekaterina_Alexandrova-Anna_Kalinskaya,2,F-DTL,7,3,1,0,2,3,4
20191016-W-Moscow-R16-Ekaterina_Alexandrova-Anna_Kalinskaya,2,F-IO,7,3,0,1,2,1,6
20191016-W-Moscow-R16-Ekaterina_Alexandrova-Anna_Kalinskaya,2,B-XC,23,4,0,0,4,7,16
20191016-W-Moscow-R16-Ekaterina_Alexandrova-Anna_Kalinskaya,2,B-DTM,16,3,0,1,2,3,13
20191016-W-Moscow-R16-Ekaterina_Alexandrova-Anna_Kalinskaya,2,B-DTL,3,3,0,0,3,0,3
20191016-W-Moscow-R16-Ekaterina_Alexandrova-Anna_Kalinskaya,2,B-IO,2,1,1,0,0,1,1
20191016-W-Moscow-R16-Ekaterina_Alexandrova-Anna_Kalinskaya,2,S-DTM,4,0,0,0,0,1,3
20191016-W-Moscow-R16-Ekaterina_Alexandrova-Anna_Kalinskaya,2,S-DTL,1,1,0,0,1,0,1
20191018-W-Moscow-QF-Karolina_Muchova-Ekaterina_Alexandrova,1,F-XC,20,9,2,0,7,9,11
20191018-W-Moscow-QF-Karolina_Muchova-Ekaterina_Alexandrova,1,F-DTM,14,1,0,0,1,9,5
20191018-W-Moscow-QF-Karolina_Muchova-Ekaterina_Alexandrova,1,F-DTL,14,6,1,1,4,8,6
20191018-W-Moscow-QF-Karolina_Muchova-Ekaterina_Alexandrova,1,F-IO,10,3,2,1,0,6,4
20191018-W-Moscow-QF-Karolina_Muchova-Ekaterina_Alexandrova,1,F-II,1,1,1,0,0,1,0
20191018-W-Moscow-QF-Karolina_Muchova-Ekaterina_Alexandrova,1,B-XC,15,2,0,2,0,12,3
20191018-W-Moscow-QF-Karolina_Muchova-Ekaterina_Alexandrova,1,B-DTM,13,0,0,0,0,8,5
20191018-W-Moscow-QF-Karolina_Muchova-Ekaterina_Alexandrova,1,B-DTL,9,4,3,0,1,7,2
20191018-W-Moscow-QF-Karolina_Muchova-Ekaterina_Alexandrova,1,B-IO,2,0,0,0,0,2,0
20191018-W-Moscow-QF-Karolina_Muchova-Ekaterina_Alexandrova,1,S-XC,16,0,0,0,0,13,3
20191018-W-Moscow-QF-Karolina_Muchova-Ekaterina_Alexandrova,1,S-DTM,12,0,0,0,0,7,5
20191018-W-Moscow-QF-Karolina_Muchova-Ekaterina_Alexandrova,1,S-DTL,1,0,0,0,0,1,0
20191018-W-Moscow-QF-Karolina_Muchova-Ekaterina_Alexandrova,2,F-XC,28,11,2,3,6,12,16
20191018-W-Moscow-QF-Karolina_Muchova-Ekaterina_Alexandrova,2,F-DTM,9,0,0,0,0,2,7
20191018-W-Moscow-QF-Karolina_Muchova-Ekaterina_Alexandrova,2,F-DTL,10,4,1,1,2,3,7
20191018-W-Moscow-QF-Karolina_Muchova-Ekaterina_Alexandrova,2,F-IO,11,1,1,0,0,4,7
20191018-W-Moscow-QF-Karolina_Muchova-Ekaterina_Alexandrova,2,F-II,1,0,0,0,0,0,1
20191018-W-Moscow-QF-Karolina_Muchova-Ekaterina_Alexandrova,2,B-XC,38,9,2,2,5,10,28
20191018-W-Moscow-QF-Karolina_Muchova-Ekaterina_Alexandrova,2,B-DTM,13,2,0,0,2,3,10
20191018-W-Moscow-QF-Karolina_Muchova-Ekaterina_Alexandrova,2,B-DTL,7,3,0,0,3,1,6
20191018-W-Moscow-QF-Karolina_Muchova-Ekaterina_Alexandrova,2,B-IO,6,2,1,0,1,3,3
20191018-W-Moscow-QF-Karolina_Muchova-Ekaterina_Alexandrova,2,S-XC,4,0,0,0,0,1,3
20191018-W-Moscow-QF-Karolina_Muchova-Ekaterina_Alexandrova,2,S-DTL,2,0,0,0,0,2,0
20191015-W-Moscow-R32-Katerina_Siniakova-Polona_Hercog,1,F-XC,35,4,0,2,2,18,17
20191015-W-Moscow-R32-Katerina_Siniakova-Polona_Hercog,1,F-DTM,13,0,0,0,0,4,9
20191015-W-Moscow-R32-Katerina_Siniakova-Polona_Hercog,1,F-DTL,10,7,1,1,5,4,6
20191015-W-Moscow-R32-Katerina_Siniakova-Polona_Hercog,1,F-IO,10,5,1,0,4,4,6
20191015-W-Moscow-R32-Katerina_Siniakova-Polona_Hercog,1,B-XC,12,1,0,1,0,8,4
20191015-W-Moscow-R32-Katerina_Siniakova-Polona_Hercog,1,B-DTM,9,1,0,0,1,3,6
20191015-W-Moscow-R32-Katerina_Siniakova-Polona_Hercog,1,B-DTL,4,3,1,2,0,4,0
20191015-W-Moscow-R32-Katerina_Siniakova-Polona_Hercog,1,B-IO,4,2,0,0,2,1,3
20191015-W-Moscow-R32-Katerina_Siniakova-Polona_Hercog,1,S-XC,2,0,0,0,0,2,0
20191015-W-Moscow-R32-Katerina_Siniakova-Polona_Hercog,1,S-DTM,1,0,0,0,0,0,1
20191015-W-Moscow-R32-Katerina_Siniakova-Polona_Hercog,1,S-DTL,3,1,0,0,1,1,2
20191015-W-Moscow-R32-Katerina_Siniakova-Polona_Hercog,1,S-IO,1,0,0,0,0,1,0
20191015-W-Moscow-R32-Katerina_Siniakova-Polona_Hercog,2,F-XC,42,13,3,1,9,21,21
20191015-W-Moscow-R32-Katerina_Siniakova-Polona_Hercog,2,F-DTM,20,4,2,0,2,12,8
20191015-W-Moscow-R32-Katerina_Siniakova-Polona_Hercog,2,F-DTL,9,3,1,0,2,4,5
20191015-W-Moscow-R32-Katerina_Siniakova-Polona_Hercog,2,F-IO,15,4,1,1,2,9,6
20191015-W-Moscow-R32-Katerina_Siniakova-Polona_Hercog,2,F-II,3,2,0,2,0,3,0
20191015-W-Moscow-R32-Katerina_Siniakova-Polona_Hercog,2,B-XC,1,1,1,0,0,1,0
20191015-W-Moscow-R32-Katerina_Siniakova-Polona_Hercog,2,B-DTM,3,0,0,0,0,1,2
20191015-W-Moscow-R32-Katerina_Siniakova-Polona_Hercog,2,B-DTL,2,2,0,1,1,1,1
20191015-W-Moscow-R32-Katerina_Siniakova-Polona_Hercog,2,B-IO,1,0,0,0,0,0,1
20191015-W-Moscow-R32-Katerina_Siniakova-Polona_Hercog,2,S-XC,4,0,0,0,0,0,4
20191015-W-Moscow-R32-Katerina_Siniakova-Polona_Hercog,2,S-DTM,8,1,0,0,1,3,5
20191015-W-Moscow-R32-Katerina_Siniakova-Polona_Hercog,2,S-DTL,12,2,0,1,1,5,7
20191015-W-Moscow-R32-Katerina_Siniakova-Polona_Hercog,2,S-IO,1,0,0,0,0,1,0
20190808-W-Toronto-R16-Belinda_Bencic-Elina_Svitolina,1,F-XC,26,8,3,2,3,12,14
20190808-W-Toronto-R16-Belinda_Bencic-Elina_Svitolina,1,F-DTM,24,3,0,0,3,9,15
20190808-W-Toronto-R16-Belinda_Bencic-Elina_Svitolina,1,F-DTL,3,1,1,0,0,2,1
20190808-W-Toronto-R16-Belinda_Bencic-Elina_Svitolina,1,F-IO,33,14,3,2,9,15,18
20190808-W-Toronto-R16-Belinda_Bencic-Elina_Svitolina,1,B-XC,23,2,1,0,1,12,11
20190808-W-Toronto-R16-Belinda_Bencic-Elina_Svitolina,1,B-DTM,31,6,0,3,3,14,17
20190808-W-Toronto-R16-Belinda_Bencic-Elina_Svitolina,1,B-DTL,10,6,1,2,3,4,6
20190808-W-Toronto-R16-Belinda_Bencic-Elina_Svitolina,1,B-IO,15,8,2,1,5,8,7
20190808-W-Toronto-R16-Belinda_Bencic-Elina_Svitolina,2,F-XC,15,7,4,1,2,8,7
20190808-W-Toronto-R16-Belinda_Bencic-Elina_Svitolina,2,F-DTM,37,5,1,0,4,25,12
20190808-W-Toronto-R16-Belinda_Bencic-Elina_Svitolina,2,F-DTL,2,2,1,0,1,1,1
20190808-W-Toronto-R16-Belinda_Bencic-Elina_Svitolina,2,F-IO,13,3,1,0,2,4,9
20190808-W-Toronto-R16-Belinda_Bencic-Elina_Svitolina,2,B-XC,31,2,1,0,1,17,14
20190808-W-Toronto-R16-Belinda_Bencic-Elina_Svitolina,2,B-DTM,31,2,0,1,1,14,17
20190808-W-Toronto-R16-Belinda_Bencic-Elina_Svitolina,2,B-DTL,2,1,1,0,0,1,1
20190808-W-Toronto-R16-Belinda_Bencic-Elina_Svitolina,2,B-IO,4,2,1,1,0,2,2
20190808-W-Toronto-R16-Belinda_Bencic-Elina_Svitolina,2,S-XC,3,0,0,0,0,2,1
20190808-W-Toronto-R16-Belinda_Bencic-Elina_Svitolina,2,S-DTM,2,0,0,0,0,0,2
20190924-W-Wuhan-R32-Karolina_Pliskova-Amanda_Anisimova,1,F-XC,21,7,3,1,3,12,9
20190924-W-Wuhan-R32-Karolina_Pliskova-Amanda_Anisimova,1,F-DTM,19,0,0,0,0,8,11
20190924-W-Wuhan-R32-Karolina_Pliskova-Amanda_Anisimova,1,F-DTL,5,3,1,0,2,3,2
20190924-W-Wuhan-R32-Karolina_Pliskova-Amanda_Anisimova,1,F-IO,18,11,6,0,5,12,6
20190924-W-Wuhan-R32-Karolina_Pliskova-Amanda_Anisimova,1,F-II,1,1,1,0,0,1,0
20190924-W-Wuhan-R32-Karolina_Pliskova-Amanda_Anisimova,1,B-XC,15,1,1,0,0,8,7
20190924-W-Wuhan-R32-Karolina_Pliskova-Amanda_Anisimova,1,B-DTM,16,2,0,0,2,7,9
20190924-W-Wuhan-R32-Karolina_Pliskova-Amanda_Anisimova,1,B-DTL,10,4,0,1,3,4,6
20190924-W-Wuhan-R32-Karolina_Pliskova-Amanda_Anisimova,1,B-IO,8,6,5,0,1,6,2
20190924-W-Wuhan-R32-Karolina_Pliskova-Amanda_Anisimova,1,S-XC,1,0,0,0,0,0,1
20190924-W-Wuhan-R32-Karolina_Pliskova-Amanda_Anisimova,1,S-DTM,1,0,0,0,0,1,0
20190924-W-Wuhan-R32-Karolina_Pliskova-Amanda_Anisimova,2,F-XC,28,9,5,0,4,15,13
20190924-W-Wuhan-R32-Karolina_Pliskova-Amanda_Anisimova,2,F-DTM,20,3,0,0,3,9,11
20190924-W-Wuhan-R32-Karolina_Pliskova-Amanda_Anisimova,2,F-DTL,3,1,1,0,0,2,1
20190924-W-Wuhan-R32-Karolina_Pliskova-Amanda_Anisimova,2,F-IO,13,4,1,0,3,5,8
20190924-W-Wuhan-R32-Karolina_Pliskova-Amanda_Anisimova,2,B-XC,19,3,1,0,2,8,11
20190924-W-Wuhan-R32-Karolina_Pliskova-Amanda_Anisimova,2,B-DTM,17,1,0,0,1,3,14
20190924-W-Wuhan-R32-Karolina_Pliskova-Amanda_Anisimova,2,B-DTL,3,2,2,0,0,3,0
20190924-W-Wuhan-R32-Karolina_Pliskova-Amanda_Anisimova,2,B-IO,7,3,1,0,2,4,3
20190924-W-Wuhan-R32-Karolina_Pliskova-Amanda_Anisimova,2,S-DTM,4,0,0,0,0,0,4
19890126-W-Australian_Open-QF-Martina_Navratilova-Helena_Sukova,1,F-XC,10,4,2,0,2,5,5
19890126-W-Australian_Open-QF-Martina_Navratilova-Helena_Sukova,1,F-DTM,5,2,1,0,1,2,3
19890126-W-Australian_Open-QF-Martina_Navratilova-Helena_Sukova,1,F-DTL,3,2,2,0,0,3,0
19890126-W-Australian_Open-QF-Martina_Navratilova-Helena_Sukova,1,F-IO,2,2,1,0,1,1,1
19890126-W-Australian_Open-QF-Martina_Navratilova-Helena_Sukova,1,F-II,2,2,0,0,2,0,2
19890126-W-Australian_Open-QF-Martina_Navratilova-Helena_Sukova,1,B-XC,8,5,1,2,2,4,4
19890126-W-Australian_Open-QF-Martina_Navratilova-Helena_Sukova,1,B-DTM,3,1,0,1,0,2,1
19890126-W-Australian_Open-QF-Martina_Navratilova-Helena_Sukova,1,B-DTL,7,5,2,1,2,4,3
19890126-W-Australian_Open-QF-Martina_Navratilova-Helena_Sukova,1,S-XC,6,0,0,0,0,2,4
19890126-W-Australian_Open-QF-Martina_Navratilova-Helena_Sukova,1,S-DTM,1,0,0,0,0,1,0
19890126-W-Australian_Open-QF-Martina_Navratilova-Helena_Sukova,1,S-DTL,1,0,0,0,0,0,1
19890126-W-Australian_Open-QF-Martina_Navratilova-Helena_Sukova,1,S-IO,1,1,1,0,0,1,0
19890126-W-Australian_Open-QF-Martina_Navratilova-Helena_Sukova,2,F-XC,5,3,1,1,1,2,3
19890126-W-Australian_Open-QF-Martina_Navratilova-Helena_Sukova,2,F-DTM,3,0,0,0,0,0,3
19890126-W-Australian_Open-QF-Martina_Navratilova-Helena_Sukova,2,F-DTL,6,2,2,0,0,3,3
19890126-W-Australian_Open-QF-Martina_Navratilova-Helena_Sukova,2,F-IO,3,1,1,0,0,2,1
19890126-W-Australian_Open-QF-Martina_Navratilova-Helena_Sukova,2,F-II,1,0,0,0,0,0,1
19890126-W-Australian_Open-QF-Martina_Navratilova-Helena_Sukova,2,B-XC,5,4,3,1,0,5,0
19890126-W-Australian_Open-QF-Martina_Navratilova-Helena_Sukova,2,B-DTM,2,0,0,0,0,1,1
19890126-W-Australian_Open-QF-Martina_Navratilova-Helena_Sukova,2,B-DTL,3,3,1,0,2,1,2
19890126-W-Australian_Open-QF-Martina_Navratilova-Helena_Sukova,2,B-IO,1,1,1,0,0,1,0
19890126-W-Australian_Open-QF-Martina_Navratilova-Helena_Sukova,2,B-II,1,1,0,1,0,1,0
19890126-W-Australian_Open-QF-Martina_Navratilova-Helena_Sukova,2,S-XC,5,3,2,0,1,3,2
19890126-W-Australian_Open-QF-Martina_Navratilova-Helena_Sukova,2,S-DTM,1,0,0,0,0,0,1
19890126-W-Australian_Open-QF-Martina_Navratilova-Helena_Sukova,2,S-DTL,7,4,2,0,2,3,4
19890126-W-Australian_Open-QF-Martina_Navratilova-Helena_Sukova,2,S-IO,1,0,0,0,0,0,1
20190818-W-New_York-Q3-Jil_Teichmann-Laura_Siegemund,1,F-XC,34,9,1,0,8,8,26
20190818-W-New_York-Q3-Jil_Teichmann-Laura_Siegemund,1,F-DTM,47,7,1,0,6,22,25
20190818-W-New_York-Q3-Jil_Teichmann-Laura_Siegemund,1,F-DTL,16,5,1,2,2,8,8
20190818-W-New_York-Q3-Jil_Teichmann-Laura_Siegemund,1,F-IO,31,10,5,2,3,16,15
20190818-W-New_York-Q3-Jil_Teichmann-Laura_Siegemund,1,F-II,1,0,0,0,0,0,1
20190818-W-New_York-Q3-Jil_Teichmann-Laura_Siegemund,1,B-XC,31,5,0,1,4,15,16
20190818-W-New_York-Q3-Jil_Teichmann-Laura_Siegemund,1,B-DTM,28,4,0,0,4,11,17
20190818-W-New_York-Q3-Jil_Teichmann-Laura_Siegemund,1,B-DTL,6,6,1,1,4,2,4
20190818-W-New_York-Q3-Jil_Teichmann-Laura_Siegemund,1,B-IO,5,3,1,1,1,3,2
20190818-W-New_York-Q3-Jil_Teichmann-Laura_Siegemund,1,S-XC,6,1,1,0,0,5,1
20190818-W-New_York-Q3-Jil_Teichmann-Laura_Siegemund,1,S-DTM,11,1,0,0,1,2,9
20190818-W-New_York-Q3-Jil_Teichmann-Laura_Siegemund,1,S-DTL,1,0,0,0,0,1,0
20190818-W-New_York-Q3-Jil_Teichmann-Laura_Siegemund,1,S-IO,1,0,0,0,0,1,0
20190818-W-New_York-Q3-Jil_Teichmann-Laura_Siegemund,2,F-XC,66,15,3,3,9,33,33
20190818-W-New_York-Q3-Jil_Teichmann-Laura_Siegemund,2,F-DTM,33,0,0,0,0,18,15
20190818-W-New_York-Q3-Jil_Teichmann-Laura_Siegemund,2,F-DTL,26,14,3,2,9,12,14
20190818-W-New_York-Q3-Jil_Teichmann-Laura_Siegemund,2,F-IO,31,16,3,5,8,17,14
20190818-W-New_York-Q3-Jil_Teichmann-Laura_Siegemund,2,B-XC,37,15,6,1,8,19,18
20190818-W-New_York-Q3-Jil_Teichmann-Laura_Siegemund,2,B-DTM,19,3,0,1,2,8,11
20190818-W-New_York-Q3-Jil_Teichmann-Laura_Siegemund,2,B-DTL,10,7,6,0,1,8,2
20190818-W-New_York-Q3-Jil_Teichmann-Laura_Siegemund,2,B-IO,8,6,5,0,1,6,2
20190818-W-New_York-Q3-Jil_Teichmann-Laura_Siegemund,2,S-XC,4,0,0,0,0,3,1
20190818-W-New_York-Q3-Jil_Teichmann-Laura_Siegemund,2,S-DTM,2,0,0,0,0,1,1
20191022-W-Zhuhai-RR-Kiki_Bertens-Donna_Vekic,1,F-XC,35,3,1,2,0,16,19
20191022-W-Zhuhai-RR-Kiki_Bertens-Donna_Vekic,1,F-DTM,18,1,1,0,0,7,11
20191022-W-Zhuhai-RR-Kiki_Bertens-Donna_Vekic,1,F-DTL,8,3,1,1,1,5,3
20191022-W-Zhuhai-RR-Kiki_Bertens-Donna_Vekic,1,F-IO,16,7,2,2,3,7,9
20191022-W-Zhuhai-RR-Kiki_Bertens-Donna_Vekic,1,F-II,1,0,0,0,0,0,1
20191022-W-Zhuhai-RR-Kiki_Bertens-Donna_Vekic,1,B-XC,14,0,0,0,0,3,11
20191022-W-Zhuhai-RR-Kiki_Bertens-Donna_Vekic,1,B-DTM,38,2,0,0,2,17,21
20191022-W-Zhuhai-RR-Kiki_Bertens-Donna_Vekic,1,B-DTL,12,5,0,3,2,5,7
20191022-W-Zhuhai-RR-Kiki_Bertens-Donna_Vekic,1,B-IO,4,3,1,1,1,2,2
20191022-W-Zhuhai-RR-Kiki_Bertens-Donna_Vekic,1,S-XC,18,2,0,0,2,6,12
20191022-W-Zhuhai-RR-Kiki_Bertens-Donna_Vekic,1,S-DTM,20,2,0,0,2,8,12
20191022-W-Zhuhai-RR-Kiki_Bertens-Donna_Vekic,1,S-DTL,4,2,1,1,0,4,0
20191022-W-Zhuhai-RR-Kiki_Bertens-Donna_Vekic,2,F-XC,46,11,3,0,8,25,21
20191022-W-Zhuhai-RR-Kiki_Bertens-Donna_Vekic,2,F-DTM,28,1,0,0,1,16,12
20191022-W-Zhuhai-RR-Kiki_Bertens-Donna_Vekic,2,F-DTL,12,6,1,2,3,7,5
20191022-W-Zhuhai-RR-Kiki_Bertens-Donna_Vekic,2,F-IO,55,23,6,6,11,30,25
20191022-W-Zhuhai-RR-Kiki_Bertens-Donna_Vekic,2,B-XC,38,3,0,0,3,24,14
20191022-W-Zhuhai-RR-Kiki_Bertens-Donna_Vekic,2,B-DTM,17,1,0,0,1,10,7
20191022-W-Zhuhai-RR-Kiki_Bertens-Donna_Vekic,2,B-DTL,3,0,0,0,0,1,2
20191022-W-Zhuhai-RR-Kiki_Bertens-Donna_Vekic,2,B-IO,3,1,1,0,0,3,0
20191024-W-Zhuhai-RR-Karolina_Muchova-Alison_Riske,1,F-XC,29,11,2,4,5,18,11
20191024-W-Zhuhai-RR-Karolina_Muchova-Alison_Riske,1,F-DTM,21,1,0,0,1,14,7
20191024-W-Zhuhai-RR-Karolina_Muchova-Alison_Riske,1,F-DTL,12,2,1,0,1,6,6
20191024-W-Zhuhai-RR-Karolina_Muchova-Alison_Riske,1,F-IO,15,5,2,1,2,10,5
20191024-W-Zhuhai-RR-Karolina_Muchova-Alison_Riske,1,B-XC,22,6,0,4,2,12,10
20191024-W-Zhuhai-RR-Karolina_Muchova-Alison_Riske,1,B-DTM,25,4,0,1,3,11,14
20191024-W-Zhuhai-RR-Karolina_Muchova-Alison_Riske,1,B-DTL,5,4,1,0,3,2,3
20191024-W-Zhuhai-RR-Karolina_Muchova-Alison_Riske,1,B-IO,9,3,0,0,3,2,7
20191024-W-Zhuhai-RR-Karolina_Muchova-Alison_Riske,1,S-XC,22,1,0,0,1,8,14
20191024-W-Zhuhai-RR-Karolina_Muchova-Alison_Riske,1,S-DTM,24,3,0,2,1,14,10
20191024-W-Zhuhai-RR-Karolina_Muchova-Alison_Riske,1,S-DTL,6,0,0,0,0,2,4
20191024-W-Zhuhai-RR-Karolina_Muchova-Alison_Riske,1,S-IO,4,1,0,1,0,4,0
20191024-W-Zhuhai-RR-Karolina_Muchova-Alison_Riske,2,F-XC,31,7,1,2,4,12,19
20191024-W-Zhuhai-RR-Karolina_Muchova-Alison_Riske,2,F-DTM,20,1,0,0,1,5,15
20191024-W-Zhuhai-RR-Karolina_Muchova-Alison_Riske,2,F-DTL,12,3,1,0,2,6,6
20191024-W-Zhuhai-RR-Karolina_Muchova-Alison_Riske,2,F-IO,20,1,0,0,1,11,9
20191024-W-Zhuhai-RR-Karolina_Muchova-Alison_Riske,2,B-XC,47,10,3,2,5,27,20
20191024-W-Zhuhai-RR-Karolina_Muchova-Alison_Riske,2,B-DTM,37,3,0,0,3,16,21
20191024-W-Zhuhai-RR-Karolina_Muchova-Alison_Riske,2,B-DTL,16,10,2,5,3,9,7
20191024-W-Zhuhai-RR-Karolina_Muchova-Alison_Riske,2,B-IO,14,7,1,2,4,5,9
20191024-W-Zhuhai-RR-Karolina_Muchova-Alison_Riske,2,S-XC,4,1,1,0,0,2,2
20191024-W-Zhuhai-RR-Karolina_Muchova-Alison_Riske,2,S-DTM,2,0,0,0,0,0,2
20191024-W-Zhuhai-RR-Karolina_Muchova-Alison_Riske,2,S-DTL,2,0,0,0,0,1,1
20191024-W-Zhuhai-RR-Karolina_Muchova-Alison_Riske,2,S-IO,1,0,0,0,0,0,1
20190928-W-Beijing-R64-Jelena_Ostapenko-Karolina_Pliskova,1,F-XC,42,21,12,4,5,30,12
20190928-W-Beijing-R64-Jelena_Ostapenko-Karolina_Pliskova,1,F-DTM,13,3,0,2,1,4,9
20190928-W-Beijing-R64-Jelena_Ostapenko-Karolina_Pliskova,1,F-DTL,15,10,6,1,3,11,4
20190928-W-Beijing-R64-Jelena_Ostapenko-Karolina_Pliskova,1,F-IO,11,5,2,0,3,8,3
20190928-W-Beijing-R64-Jelena_Ostapenko-Karolina_Pliskova,1,B-XC,29,13,7,1,5,16,13
20190928-W-Beijing-R64-Jelena_Ostapenko-Karolina_Pliskova,1,B-DTM,18,2,0,0,2,12,6
20190928-W-Beijing-R64-Jelena_Ostapenko-Karolina_Pliskova,1,B-DTL,11,6,5,0,1,8,3
20190928-W-Beijing-R64-Jelena_Ostapenko-Karolina_Pliskova,1,B-IO,2,1,0,0,1,1,1
20190928-W-Beijing-R64-Jelena_Ostapenko-Karolina_Pliskova,1,S-XC,2,0,0,0,0,1,1
20190928-W-Beijing-R64-Jelena_Ostapenko-Karolina_Pliskova,1,S-DTM,4,0,0,0,0,0,4
20190928-W-Beijing-R64-Jelena_Ostapenko-Karolina_Pliskova,1,S-DTL,1,0,0,0,0,0,1
20190928-W-Beijing-R64-Jelena_Ostapenko-Karolina_Pliskova,2,F-XC,29,9,4,1,4,13,16
20190928-W-Beijing-R64-Jelena_Ostapenko-Karolina_Pliskova,2,F-DTM,15,0,0,0,0,6,9
20190928-W-Beijing-R64-Jelena_Ostapenko-Karolina_Pliskova,2,F-DTL,8,4,3,1,0,4,4
20190928-W-Beijing-R64-Jelena_Ostapenko-Karolina_Pliskova,2,F-IO,15,4,1,1,2,8,7
20190928-W-Beijing-R64-Jelena_Ostapenko-Karolina_Pliskova,2,B-XC,18,6,0,0,6,3,15
20190928-W-Beijing-R64-Jelena_Ostapenko-Karolina_Pliskova,2,B-DTM,26,2,0,1,1,9,17
20190928-W-Beijing-R64-Jelena_Ostapenko-Karolina_Pliskova,2,B-DTL,11,6,0,2,4,5,6
20190928-W-Beijing-R64-Jelena_Ostapenko-Karolina_Pliskova,2,B-IO,5,1,1,0,0,3,2
20190928-W-Beijing-R64-Jelena_Ostapenko-Karolina_Pliskova,2,S-XC,3,0,0,0,0,1,2
20190928-W-Beijing-R64-Jelena_Ostapenko-Karolina_Pliskova,2,S-DTM,2,0,0,0,0,1,1
20190928-W-Beijing-R64-Jelena_Ostapenko-Karolina_Pliskova,2,S-IO,1,0,0,0,0,0,1
20190815-W-Cincinnati-R16-Sofia_Kenin-Elina_Svitolina,1,F-XC,73,16,7,3,6,51,22
20190815-W-Cincinnati-R16-Sofia_Kenin-Elina_Svitolina,1,F-DTM,52,7,0,0,7,26,26
20190815-W-Cincinnati-R16-Sofia_Kenin-Elina_Svitolina,1,F-DTL,7,5,4,0,1,6,1
20190815-W-Cincinnati-R16-Sofia_Kenin-Elina_Svitolina,1,F-IO,11,6,6,0,0,9,2
20190815-W-Cincinnati-R16-Sofia_Kenin-Elina_Svitolina,1,B-XC,42,9,6,1,2,35,7
20190815-W-Cincinnati-R16-Sofia_Kenin-Elina_Svitolina,1,B-DTM,44,5,0,3,2,28,16
20190815-W-Cincinnati-R16-Sofia_Kenin-Elina_Svitolina,1,B-DTL,6,3,2,0,1,4,2
20190815-W-Cincinnati-R16-Sofia_Kenin-Elina_Svitolina,1,B-IO,6,3,1,0,2,3,3
20190815-W-Cincinnati-R16-Sofia_Kenin-Elina_Svitolina,1,S-XC,13,4,0,0,4,6,7
20190815-W-Cincinnati-R16-Sofia_Kenin-Elina_Svitolina,1,S-DTM,18,1,0,0,1,6,12
20190815-W-Cincinnati-R16-Sofia_Kenin-Elina_Svitolina,1,S-DTL,3,0,0,0,0,2,1
20190815-W-Cincinnati-R16-Sofia_Kenin-Elina_Svitolina,1,S-IO,4,0,0,0,0,3,1
20190815-W-Cincinnati-R16-Sofia_Kenin-Elina_Svitolina,2,F-XC,58,11,3,2,6,23,35
20190815-W-Cincinnati-R16-Sofia_Kenin-Elina_Svitolina,2,F-DTM,69,3,0,0,3,31,38
20190815-W-Cincinnati-R16-Sofia_Kenin-Elina_Svitolina,2,F-DTL,9,5,2,0,3,3,6
20190815-W-Cincinnati-R16-Sofia_Kenin-Elina_Svitolina,2,F-IO,16,5,3,0,2,10,6
20190815-W-Cincinnati-R16-Sofia_Kenin-Elina_Svitolina,2,B-XC,38,6,0,1,5,7,31
20190815-W-Cincinnati-R16-Sofia_Kenin-Elina_Svitolina,2,B-DTM,45,2,1,0,1,12,33
20190815-W-Cincinnati-R16-Sofia_Kenin-Elina_Svitolina,2,B-DTL,2,1,0,1,0,1,1
20190815-W-Cincinnati-R16-Sofia_Kenin-Elina_Svitolina,2,B-IO,6,2,1,0,1,2,4
20190815-W-Cincinnati-R16-Sofia_Kenin-Elina_Svitolina,2,S-XC,11,0,0,0,0,5,6
20190815-W-Cincinnati-R16-Sofia_Kenin-Elina_Svitolina,2,S-DTM,8,1,0,0,1,5,3
20190925-W-Wuhan-R16-Ashleigh_Barty-Sofia_Kenin,1,F-XC,43,13,4,1,8,21,22
20190925-W-Wuhan-R16-Ashleigh_Barty-Sofia_Kenin,1,F-DTM,16,1,0,0,1,9,7
20190925-W-Wuhan-R16-Ashleigh_Barty-Sofia_Kenin,1,F-DTL,10,4,2,0,2,4,6
20190925-W-Wuhan-R16-Ashleigh_Barty-Sofia_Kenin,1,F-IO,24,11,4,1,6,14,10
20190925-W-Wuhan-R16-Ashleigh_Barty-Sofia_Kenin,1,F-II,3,1,1,0,0,2,1
20190925-W-Wuhan-R16-Ashleigh_Barty-Sofia_Kenin,1,B-XC,6,2,0,1,1,4,2
20190925-W-Wuhan-R16-Ashleigh_Barty-Sofia_Kenin,1,B-DTM,6,1,0,0,1,2,4
20190925-W-Wuhan-R16-Ashleigh_Barty-Sofia_Kenin,1,B-DTL,2,2,1,0,1,1,1
20190925-W-Wuhan-R16-Ashleigh_Barty-Sofia_Kenin,1,B-IO,1,1,0,0,1,0,1
20190925-W-Wuhan-R16-Ashleigh_Barty-Sofia_Kenin,1,S-XC,27,3,0,0,3,14,13
20190925-W-Wuhan-R16-Ashleigh_Barty-Sofia_Kenin,1,S-DTM,21,1,0,0,1,12,9
20190925-W-Wuhan-R16-Ashleigh_Barty-Sofia_Kenin,1,S-DTL,12,2,0,0,2,6,6
20190925-W-Wuhan-R16-Ashleigh_Barty-Sofia_Kenin,2,F-XC,38,8,2,2,4,24,14
20190925-W-Wuhan-R16-Ashleigh_Barty-Sofia_Kenin,2,F-DTM,17,2,0,0,2,6,11
20190925-W-Wuhan-R16-Ashleigh_Barty-Sofia_Kenin,2,F-DTL,13,7,2,1,4,6,7
20190925-W-Wuhan-R16-Ashleigh_Barty-Sofia_Kenin,2,F-IO,9,3,0,0,3,2,7
20190925-W-Wuhan-R16-Ashleigh_Barty-Sofia_Kenin,2,F-II,1,0,0,0,0,0,1
20190925-W-Wuhan-R16-Ashleigh_Barty-Sofia_Kenin,2,B-XC,49,7,1,2,4,19,30
20190925-W-Wuhan-R16-Ashleigh_Barty-Sofia_Kenin,2,B-DTM,9,0,0,0,0,4,5
20190925-W-Wuhan-R16-Ashleigh_Barty-Sofia_Kenin,2,B-DTL,6,3,2,0,1,4,2
20190925-W-Wuhan-R16-Ashleigh_Barty-Sofia_Kenin,2,B-IO,7,4,0,3,1,3,4
20190925-W-Wuhan-R16-Ashleigh_Barty-Sofia_Kenin,2,S-XC,6,2,0,0,2,2,4
20190925-W-Wuhan-R16-Ashleigh_Barty-Sofia_Kenin,2,S-DTM,4,0,0,0,0,2,2
20190925-W-Wuhan-R16-Ashleigh_Barty-Sofia_Kenin,2,S-DTL,1,0,0,0,0,0,1
20190925-W-Wuhan-R16-Ashleigh_Barty-Sofia_Kenin,2,S-IO,2,0,0,0,0,2,0
20190926-W-Wuhan-QF-Ashleigh_Barty-Petra_Martic,1,F-XC,73,28,11,3,14,41,32
20190926-W-Wuhan-QF-Ashleigh_Barty-Petra_Martic,1,F-DTM,28,3,0,0,3,9,19
20190926-W-Wuhan-QF-Ashleigh_Barty-Petra_Martic,1,F-DTL,16,9,2,3,4,7,9
20190926-W-Wuhan-QF-Ashleigh_Barty-Petra_Martic,1,F-IO,22,4,0,0,4,11,11
20190926-W-Wuhan-QF-Ashleigh_Barty-Petra_Martic,1,F-II,5,3,1,1,1,3,2
20190926-W-Wuhan-QF-Ashleigh_Barty-Petra_Martic,1,B-XC,16,5,2,0,3,6,10
20190926-W-Wuhan-QF-Ashleigh_Barty-Petra_Martic,1,B-DTM,32,5,0,0,5,11,21
20190926-W-Wuhan-QF-Ashleigh_Barty-Petra_Martic,1,B-DTL,5,2,1,1,0,5,0
20190926-W-Wuhan-QF-Ashleigh_Barty-Petra_Martic,1,B-IO,5,1,1,0,0,4,1
20190926-W-Wuhan-QF-Ashleigh_Barty-Petra_Martic,1,S-XC,56,3,0,0,3,21,35
20190926-W-Wuhan-QF-Ashleigh_Barty-Petra_Martic,1,S-DTM,27,0,0,0,0,9,18
20190926-W-Wuhan-QF-Ashleigh_Barty-Petra_Martic,1,S-DTL,6,2,0,0,2,2,4
20190926-W-Wuhan-QF-Ashleigh_Barty-Petra_Martic,1,S-IO,6,2,0,0,2,3,3
20190926-W-Wuhan-QF-Ashleigh_Barty-Petra_Martic,2,F-XC,67,17,6,3,7,34,33
20190926-W-Wuhan-QF-Ashleigh_Barty-Petra_Martic,2,F-DTM,41,3,0,0,3,19,22
20190926-W-Wuhan-QF-Ashleigh_Barty-Petra_Martic,2,F-DTL,24,5,1,0,4,9,15
20190926-W-Wuhan-QF-Ashleigh_Barty-Petra_Martic,2,F-IO,48,10,1,0,9,27,21
20190926-W-Wuhan-QF-Ashleigh_Barty-Petra_Martic,2,F-II,7,4,0,1,3,3,4
20190926-W-Wuhan-QF-Ashleigh_Barty-Petra_Martic,2,B-XC,42,6,1,1,4,22,20
20190926-W-Wuhan-QF-Ashleigh_Barty-Petra_Martic,2,B-DTM,16,2,0,0,2,9,7
20190926-W-Wuhan-QF-Ashleigh_Barty-Petra_Martic,2,B-DTL,6,2,0,0,2,4,2
20190926-W-Wuhan-QF-Ashleigh_Barty-Petra_Martic,2,B-IO,1,1,0,0,1,0,1
20190926-W-Wuhan-QF-Ashleigh_Barty-Petra_Martic,2,S-XC,21,1,0,1,0,15,6
20190926-W-Wuhan-QF-Ashleigh_Barty-Petra_Martic,2,S-DTM,15,0,0,0,0,10,5
20190926-W-Wuhan-QF-Ashleigh_Barty-Petra_Martic,2,S-DTL,11,2,0,1,1,6,5
20190926-W-Wuhan-QF-Ashleigh_Barty-Petra_Martic,2,S-IO,2,0,0,0,0,1,1
20190925-W-Wuhan-R16-Svetlana_Kuznetsova-Elina_Svitolina,1,F-XC,26,5,3,0,2,15,11
20190925-W-Wuhan-R16-Svetlana_Kuznetsova-Elina_Svitolina,1,F-DTM,17,2,0,0,2,6,11
20190925-W-Wuhan-R16-Svetlana_Kuznetsova-Elina_Svitolina,1,F-DTL,12,5,3,0,2,6,6
20190925-W-Wuhan-R16-Svetlana_Kuznetsova-Elina_Svitolina,1,F-IO,19,9,1,0,8,4,15
20190925-W-Wuhan-R16-Svetlana_Kuznetsova-Elina_Svitolina,1,B-XC,33,7,1,0,6,14,19
20190925-W-Wuhan-R16-Svetlana_Kuznetsova-Elina_Svitolina,1,B-DTM,26,3,0,0,3,13,13
20190925-W-Wuhan-R16-Svetlana_Kuznetsova-Elina_Svitolina,1,B-DTL,9,5,0,0,5,1,8
20190925-W-Wuhan-R16-Svetlana_Kuznetsova-Elina_Svitolina,1,B-IO,11,4,2,1,1,4,7
20190925-W-Wuhan-R16-Svetlana_Kuznetsova-Elina_Svitolina,1,S-XC,4,2,2,0,0,3,1
20190925-W-Wuhan-R16-Svetlana_Kuznetsova-Elina_Svitolina,1,S-DTM,5,1,0,0,1,1,4
20190925-W-Wuhan-R16-Svetlana_Kuznetsova-Elina_Svitolina,1,S-DTL,3,0,0,0,0,2,1
20190925-W-Wuhan-R16-Svetlana_Kuznetsova-Elina_Svitolina,1,S-IO,1,0,0,0,0,1,0
20190925-W-Wuhan-R16-Svetlana_Kuznetsova-Elina_Svitolina,2,F-XC,24,3,0,1,2,15,9
20190925-W-Wuhan-R16-Svetlana_Kuznetsova-Elina_Svitolina,2,F-DTM,28,4,0,0,4,13,15
20190925-W-Wuhan-R16-Svetlana_Kuznetsova-Elina_Svitolina,2,F-DTL,12,6,4,0,2,8,4
20190925-W-Wuhan-R16-Svetlana_Kuznetsova-Elina_Svitolina,2,F-IO,11,5,3,2,0,9,2
20190925-W-Wuhan-R16-Svetlana_Kuznetsova-Elina_Svitolina,2,F-II,2,0,0,0,0,2,0
20190925-W-Wuhan-R16-Svetlana_Kuznetsova-Elina_Svitolina,2,B-XC,30,3,0,2,1,21,9
20190925-W-Wuhan-R16-Svetlana_Kuznetsova-Elina_Svitolina,2,B-DTM,25,1,0,0,1,12,13
20190925-W-Wuhan-R16-Svetlana_Kuznetsova-Elina_Svitolina,2,B-DTL,7,2,1,1,0,4,3
20190925-W-Wuhan-R16-Svetlana_Kuznetsova-Elina_Svitolina,2,B-IO,6,3,2,0,1,4,2
20190925-W-Wuhan-R16-Svetlana_Kuznetsova-Elina_Svitolina,2,S-XC,1,0,0,0,0,0,1
20190925-W-Wuhan-R16-Svetlana_Kuznetsova-Elina_Svitolina,2,S-DTM,7,0,0,0,0,3,4
20191024-W-Zhuhai-RR-Dayana_Yastremska-Kiki_Bertens,1,F-XC,59,18,2,4,12,24,35
20191024-W-Zhuhai-RR-Dayana_Yastremska-Kiki_Bertens,1,F-DTM,21,4,0,0,4,9,12
20191024-W-Zhuhai-RR-Dayana_Yastremska-Kiki_Bertens,1,F-DTL,13,8,2,2,4,6,7
20191024-W-Zhuhai-RR-Dayana_Yastremska-Kiki_Bertens,1,F-IO,25,7,2,1,4,12,13
20191024-W-Zhuhai-RR-Dayana_Yastremska-Kiki_Bertens,1,B-XC,19,5,3,0,2,10,9
20191024-W-Zhuhai-RR-Dayana_Yastremska-Kiki_Bertens,1,B-DTM,12,1,0,0,1,9,3
20191024-W-Zhuhai-RR-Dayana_Yastremska-Kiki_Bertens,1,B-DTL,11,2,0,0,2,4,7
20191024-W-Zhuhai-RR-Dayana_Yastremska-Kiki_Bertens,1,B-IO,1,0,0,0,0,0,1
20191024-W-Zhuhai-RR-Dayana_Yastremska-Kiki_Bertens,1,S-XC,1,0,0,0,0,1,0
20191024-W-Zhuhai-RR-Dayana_Yastremska-Kiki_Bertens,1,S-DTM,2,1,0,0,1,0,2
20191024-W-Zhuhai-RR-Dayana_Yastremska-Kiki_Bertens,1,S-DTL,2,0,0,0,0,2,0
20191024-W-Zhuhai-RR-Dayana_Yastremska-Kiki_Bertens,1,S-IO,3,0,0,0,0,1,2
20191024-W-Zhuhai-RR-Dayana_Yastremska-Kiki_Bertens,2,F-XC,41,1,0,0,1,29,12
20191024-W-Zhuhai-RR-Dayana_Yastremska-Kiki_Bertens,2,F-DTM,21,0,0,0,0,10,11
20191024-W-Zhuhai-RR-Dayana_Yastremska-Kiki_Bertens,2,F-DTL,9,2,0,1,1,3,6
20191024-W-Zhuhai-RR-Dayana_Yastremska-Kiki_Bertens,2,F-IO,6,2,0,0,2,3,3
20191024-W-Zhuhai-RR-Dayana_Yastremska-Kiki_Bertens,2,F-II,1,0,0,0,0,1,0
20191024-W-Zhuhai-RR-Dayana_Yastremska-Kiki_Bertens,2,B-XC,10,0,0,0,0,4,6
20191024-W-Zhuhai-RR-Dayana_Yastremska-Kiki_Bertens,2,B-DTM,19,1,0,0,1,7,12
20191024-W-Zhuhai-RR-Dayana_Yastremska-Kiki_Bertens,2,B-DTL,4,2,0,0,2,0,4
20191024-W-Zhuhai-RR-Dayana_Yastremska-Kiki_Bertens,2,B-IO,2,0,0,0,0,0,2
20191024-W-Zhuhai-RR-Dayana_Yastremska-Kiki_Bertens,2,S-XC,6,2,0,0,2,3,3
20191024-W-Zhuhai-RR-Dayana_Yastremska-Kiki_Bertens,2,S-DTM,18,0,0,0,0,11,7
20191024-W-Zhuhai-RR-Dayana_Yastremska-Kiki_Bertens,2,S-DTL,6,0,0,0,0,3,3
20191024-W-Zhuhai-RR-Dayana_Yastremska-Kiki_Bertens,2,S-IO,1,0,0,0,0,0,1
20191028-W-Shenzhen_Finals-RR-Elina_Svitolina-Karolina_Pliskova,1,F-XC,25,8,2,3,3,13,12
20191028-W-Shenzhen_Finals-RR-Elina_Svitolina-Karolina_Pliskova,1,F-DTM,33,0,0,0,0,13,20
20191028-W-Shenzhen_Finals-RR-Elina_Svitolina-Karolina_Pliskova,1,F-DTL,12,5,2,1,2,8,4
20191028-W-Shenzhen_Finals-RR-Elina_Svitolina-Karolina_Pliskova,1,F-IO,15,3,2,1,0,8,7
20191028-W-Shenzhen_Finals-RR-Elina_Svitolina-Karolina_Pliskova,1,F-II,1,0,0,0,0,1,0
20191028-W-Shenzhen_Finals-RR-Elina_Svitolina-Karolina_Pliskova,1,B-XC,50,14,3,3,8,24,26
20191028-W-Shenzhen_Finals-RR-Elina_Svitolina-Karolina_Pliskova,1,B-DTM,28,1,0,1,0,9,19
20191028-W-Shenzhen_Finals-RR-Elina_Svitolina-Karolina_Pliskova,1,B-DTL,8,3,2,0,1,5,3
20191028-W-Shenzhen_Finals-RR-Elina_Svitolina-Karolina_Pliskova,1,B-IO,5,3,0,0,3,1,4
20191028-W-Shenzhen_Finals-RR-Elina_Svitolina-Karolina_Pliskova,1,S-XC,4,1,1,0,0,3,1
20191028-W-Shenzhen_Finals-RR-Elina_Svitolina-Karolina_Pliskova,1,S-DTM,4,0,0,0,0,2,2
20191028-W-Shenzhen_Finals-RR-Elina_Svitolina-Karolina_Pliskova,1,S-DTL,1,1,1,0,0,1,0
20191028-W-Shenzhen_Finals-RR-Elina_Svitolina-Karolina_Pliskova,2,F-XC,46,15,7,3,5,28,18
20191028-W-Shenzhen_Finals-RR-Elina_Svitolina-Karolina_Pliskova,2,F-DTM,10,0,0,0,0,6,4
20191028-W-Shenzhen_Finals-RR-Elina_Svitolina-Karolina_Pliskova,2,F-DTL,5,5,4,0,1,4,1
20191028-W-Shenzhen_Finals-RR-Elina_Svitolina-Karolina_Pliskova,2,F-IO,20,10,3,2,5,9,11
20191028-W-Shenzhen_Finals-RR-Elina_Svitolina-Karolina_Pliskova,2,F-II,1,0,0,0,0,1,0
20191028-W-Shenzhen_Finals-RR-Elina_Svitolina-Karolina_Pliskova,2,B-XC,56,16,4,2,10,28,28
20191028-W-Shenzhen_Finals-RR-Elina_Svitolina-Karolina_Pliskova,2,B-DTM,25,0,0,0,0,17,8
20191028-W-Shenzhen_Finals-RR-Elina_Svitolina-Karolina_Pliskova,2,B-DTL,15,10,5,0,5,8,7
20191028-W-Shenzhen_Finals-RR-Elina_Svitolina-Karolina_Pliskova,2,B-IO,11,5,1,1,3,6,5
20191028-W-Shenzhen_Finals-RR-Elina_Svitolina-Karolina_Pliskova,2,S-XC,8,0,0,0,0,3,5
20191028-W-Shenzhen_Finals-RR-Elina_Svitolina-Karolina_Pliskova,2,S-DTM,2,0,0,0,0,1,1
20191028-W-Shenzhen_Finals-RR-Elina_Svitolina-Karolina_Pliskova,2,S-DTL,1,0,0,0,0,0,1
20191028-W-Shenzhen_Finals-RR-Elina_Svitolina-Karolina_Pliskova,2,S-IO,1,1,0,1,0,1,0
20191029-W-Shenzhen_Finals-RR-Petra_Kvitova-Belinda_Bencic,1,F-XC,36,16,7,2,7,24,12
20191029-W-Shenzhen_Finals-RR-Petra_Kvitova-Belinda_Bencic,1,F-DTM,18,0,0,0,0,7,11
20191029-W-Shenzhen_Finals-RR-Petra_Kvitova-Belinda_Bencic,1,F-DTL,9,6,4,0,2,5,4
20191029-W-Shenzhen_Finals-RR-Petra_Kvitova-Belinda_Bencic,1,F-IO,13,8,2,1,5,6,7
20191029-W-Shenzhen_Finals-RR-Petra_Kvitova-Belinda_Bencic,1,B-XC,12,4,1,0,3,6,6
20191029-W-Shenzhen_Finals-RR-Petra_Kvitova-Belinda_Bencic,1,B-DTM,16,2,0,0,2,6,10
20191029-W-Shenzhen_Finals-RR-Petra_Kvitova-Belinda_Bencic,1,B-DTL,6,4,2,1,1,5,1
20191029-W-Shenzhen_Finals-RR-Petra_Kvitova-Belinda_Bencic,1,B-IO,4,1,1,0,0,2,2
20191029-W-Shenzhen_Finals-RR-Petra_Kvitova-Belinda_Bencic,1,S-DTM,6,1,0,0,1,3,3
20191029-W-Shenzhen_Finals-RR-Petra_Kvitova-Belinda_Bencic,1,S-DTL,4,1,0,0,1,1,3
20191029-W-Shenzhen_Finals-RR-Petra_Kvitova-Belinda_Bencic,1,S-IO,1,0,0,0,0,0,1
20191029-W-Shenzhen_Finals-RR-Petra_Kvitova-Belinda_Bencic,2,F-XC,19,4,2,0,2,9,10
20191029-W-Shenzhen_Finals-RR-Petra_Kvitova-Belinda_Bencic,2,F-DTM,18,0,0,0,0,9,9
20191029-W-Shenzhen_Finals-RR-Petra_Kvitova-Belinda_Bencic,2,F-DTL,4,4,2,0,1,3,1
20191029-W-Shenzhen_Finals-RR-Petra_Kvitova-Belinda_Bencic,2,F-IO,13,4,1,2,1,5,8
20191029-W-Shenzhen_Finals-RR-Petra_Kvitova-Belinda_Bencic,2,B-XC,27,9,2,1,6,12,15
20191029-W-Shenzhen_Finals-RR-Petra_Kvitova-Belinda_Bencic,2,B-DTM,27,6,0,0,6,10,17
20191029-W-Shenzhen_Finals-RR-Petra_Kvitova-Belinda_Bencic,2,B-DTL,5,3,1,0,2,2,3
20191029-W-Shenzhen_Finals-RR-Petra_Kvitova-Belinda_Bencic,2,B-IO,12,4,1,0,3,6,6
20191029-W-Shenzhen_Finals-RR-Petra_Kvitova-Belinda_Bencic,2,S-XC,1,0,0,0,0,0,1
20191029-W-Shenzhen_Finals-RR-Petra_Kvitova-Belinda_Bencic,2,S-DTM,1,0,0,0,0,1,0
20191030-W-Shenzhen_Finals-RR-Elina_Svitolina-Simona_Halep,1,F-XC,56,8,1,0,7,32,24
20191030-W-Shenzhen_Finals-RR-Elina_Svitolina-Simona_Halep,1,F-DTM,44,3,0,0,3,22,22
20191030-W-Shenzhen_Finals-RR-Elina_Svitolina-Simona_Halep,1,F-DTL,23,3,3,0,0,13,10
20191030-W-Shenzhen_Finals-RR-Elina_Svitolina-Simona_Halep,1,F-IO,23,5,1,1,3,12,11
20191030-W-Shenzhen_Finals-RR-Elina_Svitolina-Simona_Halep,1,F-II,1,0,0,0,0,0,1
20191030-W-Shenzhen_Finals-RR-Elina_Svitolina-Simona_Halep,1,B-XC,68,4,2,0,2,35,33
20191030-W-Shenzhen_Finals-RR-Elina_Svitolina-Simona_Halep,1,B-DTM,43,0,0,0,0,18,25
20191030-W-Shenzhen_Finals-RR-Elina_Svitolina-Simona_Halep,1,B-DTL,14,3,2,1,0,10,4
20191030-W-Shenzhen_Finals-RR-Elina_Svitolina-Simona_Halep,1,B-IO,8,3,0,1,2,5,3
20191030-W-Shenzhen_Finals-RR-Elina_Svitolina-Simona_Halep,1,S-XC,6,1,0,1,0,3,3
20191030-W-Shenzhen_Finals-RR-Elina_Svitolina-Simona_Halep,1,S-DTM,7,0,0,0,0,3,4
20191030-W-Shenzhen_Finals-RR-Elina_Svitolina-Simona_Halep,1,S-IO,1,0,0,0,0,0,1
20191030-W-Shenzhen_Finals-RR-Elina_Svitolina-Simona_Halep,2,F-XC,59,11,2,3,6,23,36
20191030-W-Shenzhen_Finals-RR-Elina_Svitolina-Simona_Halep,2,F-DTM,24,2,0,0,2,9,15
20191030-W-Shenzhen_Finals-RR-Elina_Svitolina-Simona_Halep,2,F-DTL,27,12,3,2,7,11,16
20191030-W-Shenzhen_Finals-RR-Elina_Svitolina-Simona_Halep,2,F-IO,39,9,4,2,3,22,17
20191030-W-Shenzhen_Finals-RR-Elina_Svitolina-Simona_Halep,2,B-XC,59,8,3,0,5,30,29
20191030-W-Shenzhen_Finals-RR-Elina_Svitolina-Simona_Halep,2,B-DTM,56,2,0,0,2,30,26
20191030-W-Shenzhen_Finals-RR-Elina_Svitolina-Simona_Halep,2,B-DTL,39,12,2,3,7,20,19
20191030-W-Shenzhen_Finals-RR-Elina_Svitolina-Simona_Halep,2,B-IO,8,1,0,1,0,3,5
20191030-W-Shenzhen_Finals-RR-Elina_Svitolina-Simona_Halep,2,S-DTM,2,0,0,0,0,1,1
20191030-W-Shenzhen_Finals-RR-Elina_Svitolina-Simona_Halep,2,S-DTL,2,0,0,0,0,2,0
20191101-W-Shenzhen_Finals-RR-Elina_Svitolina-Sofia_Kenin,1,F-XC,60,7,2,2,3,26,34
20191101-W-Shenzhen_Finals-RR-Elina_Svitolina-Sofia_Kenin,1,F-DTM,25,3,0,0,3,11,14
20191101-W-Shenzhen_Finals-RR-Elina_Svitolina-Sofia_Kenin,1,F-DTL,14,1,1,0,0,6,8
20191101-W-Shenzhen_Finals-RR-Elina_Svitolina-Sofia_Kenin,1,F-IO,19,3,2,0,1,6,13
20191101-W-Shenzhen_Finals-RR-Elina_Svitolina-Sofia_Kenin,1,B-XC,52,6,2,1,3,21,31
20191101-W-Shenzhen_Finals-RR-Elina_Svitolina-Sofia_Kenin,1,B-DTM,30,1,0,0,1,9,21
20191101-W-Shenzhen_Finals-RR-Elina_Svitolina-Sofia_Kenin,1,B-DTL,8,4,1,1,2,4,4
20191101-W-Shenzhen_Finals-RR-Elina_Svitolina-Sofia_Kenin,1,B-IO,9,2,0,1,1,5,4
20191101-W-Shenzhen_Finals-RR-Elina_Svitolina-Sofia_Kenin,1,S-XC,9,2,0,0,2,5,4
20191101-W-Shenzhen_Finals-RR-Elina_Svitolina-Sofia_Kenin,1,S-DTM,12,1,0,0,1,3,9
20191101-W-Shenzhen_Finals-RR-Elina_Svitolina-Sofia_Kenin,1,S-IO,1,1,0,0,1,0,1
20191101-W-Shenzhen_Finals-RR-Elina_Svitolina-Sofia_Kenin,2,F-XC,51,16,5,1,10,32,19
20191101-W-Shenzhen_Finals-RR-Elina_Svitolina-Sofia_Kenin,2,F-DTM,33,3,0,0,3,16,17
20191101-W-Shenzhen_Finals-RR-Elina_Svitolina-Sofia_Kenin,2,F-DTL,16,8,5,0,3,12,4
20191101-W-Shenzhen_Finals-RR-Elina_Svitolina-Sofia_Kenin,2,F-IO,11,3,1,0,2,7,4
20191101-W-Shenzhen_Finals-RR-Elina_Svitolina-Sofia_Kenin,2,B-XC,57,12,2,2,8,32,25
20191101-W-Shenzhen_Finals-RR-Elina_Svitolina-Sofia_Kenin,2,B-DTM,30,2,0,1,1,20,10
20191101-W-Shenzhen_Finals-RR-Elina_Svitolina-Sofia_Kenin,2,B-DTL,22,10,6,0,4,11,11
20191101-W-Shenzhen_Finals-RR-Elina_Svitolina-Sofia_Kenin,2,B-IO,14,6,3,1,2,7,7
20191101-W-Shenzhen_Finals-RR-Elina_Svitolina-Sofia_Kenin,2,S-XC,9,1,0,0,1,5,4
20191101-W-Shenzhen_Finals-RR-Elina_Svitolina-Sofia_Kenin,2,S-DTM,13,0,0,0,0,7,6
20191101-W-Shenzhen_Finals-RR-Elina_Svitolina-Sofia_Kenin,2,S-DTL,2,1,0,0,1,1,1
20191101-W-Shenzhen_Finals-RR-Elina_Svitolina-Sofia_Kenin,2,S-IO,2,1,0,1,0,1,1
20191025-W-ITF_Szekesfehervar-QF-Kaja_Juvan-Katarina_Zavatska,1,F-XC,35,6,1,0,5,13,22
20191025-W-ITF_Szekesfehervar-QF-Kaja_Juvan-Katarina_Zavatska,1,F-DTM,18,1,0,0,1,4,14
20191025-W-ITF_Szekesfehervar-QF-Kaja_Juvan-Katarina_Zavatska,1,F-DTL,13,7,3,1,3,7,6
20191025-W-ITF_Szekesfehervar-QF-Kaja_Juvan-Katarina_Zavatska,1,F-IO,11,6,1,0,5,2,9
20191025-W-ITF_Szekesfehervar-QF-Kaja_Juvan-Katarina_Zavatska,1,F-II,1,0,0,0,0,0,1
20191025-W-ITF_Szekesfehervar-QF-Kaja_Juvan-Katarina_Zavatska,1,B-XC,35,3,0,0,3,8,27
20191025-W-ITF_Szekesfehervar-QF-Kaja_Juvan-Katarina_Zavatska,1,B-DTM,43,5,0,0,5,13,30
20191025-W-ITF_Szekesfehervar-QF-Kaja_Juvan-Katarina_Zavatska,1,B-DTL,22,3,0,0,3,7,15
20191025-W-ITF_Szekesfehervar-QF-Kaja_Juvan-Katarina_Zavatska,1,B-IO,7,3,1,0,2,2,5
20191025-W-ITF_Szekesfehervar-QF-Kaja_Juvan-Katarina_Zavatska,1,S-DTM,2,0,0,0,0,2,0
20191025-W-ITF_Szekesfehervar-QF-Kaja_Juvan-Katarina_Zavatska,1,S-IO,1,1,1,0,0,1,0
20191025-W-ITF_Szekesfehervar-QF-Kaja_Juvan-Katarina_Zavatska,2,F-XC,41,6,1,1,4,29,12
20191025-W-ITF_Szekesfehervar-QF-Kaja_Juvan-Katarina_Zavatska,2,F-DTM,18,3,0,0,3,9,9
20191025-W-ITF_Szekesfehervar-QF-Kaja_Juvan-Katarina_Zavatska,2,F-DTL,22,5,0,1,4,15,7
20191025-W-ITF_Szekesfehervar-QF-Kaja_Juvan-Katarina_Zavatska,2,F-IO,24,4,1,1,2,18,6
20191025-W-ITF_Szekesfehervar-QF-Kaja_Juvan-Katarina_Zavatska,2,B-XC,50,11,6,2,3,38,12
20191025-W-ITF_Szekesfehervar-QF-Kaja_Juvan-Katarina_Zavatska,2,B-DTM,24,1,0,0,1,17,7
20191025-W-ITF_Szekesfehervar-QF-Kaja_Juvan-Katarina_Zavatska,2,B-DTL,8,1,1,0,0,4,4
20191025-W-ITF_Szekesfehervar-QF-Kaja_Juvan-Katarina_Zavatska,2,B-IO,11,5,1,2,2,5,6
20191025-W-ITF_Szekesfehervar-QF-Kaja_Juvan-Katarina_Zavatska,2,S-DTM,2,0,0,0,0,1,1
20190928-W-Beijing-R64-Sofia_Kenin-Garbine_Muguruza,1,F-XC,50,15,4,1,10,22,28
20190928-W-Beijing-R64-Sofia_Kenin-Garbine_Muguruza,1,F-DTM,37,0,0,0,0,16,21
20190928-W-Beijing-R64-Sofia_Kenin-Garbine_Muguruza,1,F-DTL,3,1,1,0,0,2,1
20190928-W-Beijing-R64-Sofia_Kenin-Garbine_Muguruza,1,F-IO,4,3,1,1,1,3,1
20190928-W-Beijing-R64-Sofia_Kenin-Garbine_Muguruza,1,B-XC,31,2,0,1,1,13,18
20190928-W-Beijing-R64-Sofia_Kenin-Garbine_Muguruza,1,B-DTM,17,2,0,0,2,7,10
20190928-W-Beijing-R64-Sofia_Kenin-Garbine_Muguruza,1,B-DTL,7,2,0,1,1,3,4
20190928-W-Beijing-R64-Sofia_Kenin-Garbine_Muguruza,1,B-IO,9,4,1,0,3,5,4
20190928-W-Beijing-R64-Sofia_Kenin-Garbine_Muguruza,1,S-XC,3,0,0,0,0,2,1
20190928-W-Beijing-R64-Sofia_Kenin-Garbine_Muguruza,1,S-DTM,6,0,0,0,0,3,3
20190928-W-Beijing-R64-Sofia_Kenin-Garbine_Muguruza,2,F-XC,33,12,3,3,6,18,15
20190928-W-Beijing-R64-Sofia_Kenin-Garbine_Muguruza,2,F-DTM,41,8,0,1,7,20,21
20190928-W-Beijing-R64-Sofia_Kenin-Garbine_Muguruza,2,F-DTL,10,6,2,0,4,5,5
20190928-W-Beijing-R64-Sofia_Kenin-Garbine_Muguruza,2,F-IO,18,6,4,0,2,11,7
20190928-W-Beijing-R64-Sofia_Kenin-Garbine_Muguruza,2,B-XC,25,5,2,1,2,14,11
20190928-W-Beijing-R64-Sofia_Kenin-Garbine_Muguruza,2,B-DTM,24,1,0,0,1,10,14
20190928-W-Beijing-R64-Sofia_Kenin-Garbine_Muguruza,2,B-DTL,11,4,1,0,3,5,6
20190928-W-Beijing-R64-Sofia_Kenin-Garbine_Muguruza,2,B-IO,20,7,3,0,4,7,13
20190928-W-Beijing-R64-Sofia_Kenin-Garbine_Muguruza,2,S-DTL,1,1,0,0,1,0,1
20190928-W-Beijing-R64-Sofia_Kenin-Garbine_Muguruza,2,S-IO,1,0,0,0,0,1,0
20190813-W-Cincinnati-R64-Madison_Keys-Garbine_Muguruza,1,F-XC,48,24,10,0,14,20,28
20190813-W-Cincinnati-R64-Madison_Keys-Garbine_Muguruza,1,F-DTM,47,8,0,1,7,19,28
20190813-W-Cincinnati-R64-Madison_Keys-Garbine_Muguruza,1,F-DTL,4,2,1,0,1,3,1
20190813-W-Cincinnati-R64-Madison_Keys-Garbine_Muguruza,1,F-IO,21,16,7,1,8,11,10
20190813-W-Cincinnati-R64-Madison_Keys-Garbine_Muguruza,1,F-II,2,1,1,0,0,2,0
20190813-W-Cincinnati-R64-Madison_Keys-Garbine_Muguruza,1,B-XC,19,9,3,1,5,7,12
20190813-W-Cincinnati-R64-Madison_Keys-Garbine_Muguruza,1,B-DTM,24,4,0,0,4,10,14
20190813-W-Cincinnati-R64-Madison_Keys-Garbine_Muguruza,1,B-DTL,16,12,7,1,4,9,7
20190813-W-Cincinnati-R64-Madison_Keys-Garbine_Muguruza,1,B-IO,8,4,3,0,1,6,2
20190813-W-Cincinnati-R64-Madison_Keys-Garbine_Muguruza,1,S-XC,3,0,0,0,0,1,2
20190813-W-Cincinnati-R64-Madison_Keys-Garbine_Muguruza,1,S-DTM,5,1,0,0,1,0,5
20190813-W-Cincinnati-R64-Madison_Keys-Garbine_Muguruza,2,F-XC,14,2,1,0,1,7,7
20190813-W-Cincinnati-R64-Madison_Keys-Garbine_Muguruza,2,F-DTM,53,6,0,0,6,28,25
20190813-W-Cincinnati-R64-Madison_Keys-Garbine_Muguruza,2,F-DTL,14,2,1,1,0,8,6
20190813-W-Cincinnati-R64-Madison_Keys-Garbine_Muguruza,2,F-IO,22,3,0,0,3,14,8
20190813-W-Cincinnati-R64-Madison_Keys-Garbine_Muguruza,2,B-XC,16,4,1,1,2,11,5
20190813-W-Cincinnati-R64-Madison_Keys-Garbine_Muguruza,2,B-DTM,32,3,0,1,2,18,14
20190813-W-Cincinnati-R64-Madison_Keys-Garbine_Muguruza,2,B-DTL,1,0,0,0,0,1,0
20190813-W-Cincinnati-R64-Madison_Keys-Garbine_Muguruza,2,B-IO,18,7,3,3,1,12,6
20190813-W-Cincinnati-R64-Madison_Keys-Garbine_Muguruza,2,S-DTM,1,0,0,0,0,0,1
20190813-W-Cincinnati-R64-Madison_Keys-Garbine_Muguruza,2,S-IO,1,0,0,0,0,1,0
20190220-W-Dubai-R16-Sofia_Kenin-Viktoria_Kuzmova,1,F-XC,53,28,7,6,15,25,28
20190220-W-Dubai-R16-Sofia_Kenin-Viktoria_Kuzmova,1,F-DTM,39,2,0,0,2,17,22
20190220-W-Dubai-R16-Sofia_Kenin-Viktoria_Kuzmova,1,F-DTL,9,5,2,0,2,5,4
20190220-W-Dubai-R16-Sofia_Kenin-Viktoria_Kuzmova,1,F-IO,3,1,0,0,1,2,1
20190220-W-Dubai-R16-Sofia_Kenin-Viktoria_Kuzmova,1,F-II,1,1,0,0,1,0,1
20190220-W-Dubai-R16-Sofia_Kenin-Viktoria_Kuzmova,1,B-XC,26,8,1,3,4,11,15
20190220-W-Dubai-R16-Sofia_Kenin-Viktoria_Kuzmova,1,B-DTM,34,6,0,0,6,7,27
20190220-W-Dubai-R16-Sofia_Kenin-Viktoria_Kuzmova,1,B-DTL,2,2,1,1,0,2,0
20190220-W-Dubai-R16-Sofia_Kenin-Viktoria_Kuzmova,1,B-IO,5,3,1,0,2,2,3
20190220-W-Dubai-R16-Sofia_Kenin-Viktoria_Kuzmova,1,S-XC,3,0,0,0,0,2,1
20190220-W-Dubai-R16-Sofia_Kenin-Viktoria_Kuzmova,1,S-DTM,9,0,0,0,0,3,6
20190220-W-Dubai-R16-Sofia_Kenin-Viktoria_Kuzmova,1,S-DTL,1,1,0,1,0,1,0
20190220-W-Dubai-R16-Sofia_Kenin-Viktoria_Kuzmova,2,F-XC,40,13,3,3,7,21,19
20190220-W-Dubai-R16-Sofia_Kenin-Viktoria_Kuzmova,2,F-DTM,37,3,0,0,3,19,18
20190220-W-Dubai-R16-Sofia_Kenin-Viktoria_Kuzmova,2,F-DTL,10,6,2,2,2,6,4
20190220-W-Dubai-R16-Sofia_Kenin-Viktoria_Kuzmova,2,F-IO,15,8,6,1,1,12,3
20190220-W-Dubai-R16-Sofia_Kenin-Viktoria_Kuzmova,2,B-XC,24,5,2,2,1,17,7
20190220-W-Dubai-R16-Sofia_Kenin-Viktoria_Kuzmova,2,B-DTM,23,5,0,0,5,13,10
20190220-W-Dubai-R16-Sofia_Kenin-Viktoria_Kuzmova,2,B-DTL,10,5,3,0,2,4,6
20190220-W-Dubai-R16-Sofia_Kenin-Viktoria_Kuzmova,2,B-IO,9,5,2,1,2,5,4
20190220-W-Dubai-R16-Sofia_Kenin-Viktoria_Kuzmova,2,S-XC,3,0,0,0,0,0,3
20190220-W-Dubai-R16-Sofia_Kenin-Viktoria_Kuzmova,2,S-DTM,6,1,0,0,1,4,2
20190220-W-Dubai-R16-Sofia_Kenin-Viktoria_Kuzmova,2,S-IO,4,0,0,0,0,1,3
20191003-W-Beijing-R16-Naomi_Osaka-Alison_Riske,1,F-XC,36,12,2,2,8,16,20
20191003-W-Beijing-R16-Naomi_Osaka-Alison_Riske,1,F-DTM,22,3,0,0,3,10,12
20191003-W-Beijing-R16-Naomi_Osaka-Alison_Riske,1,F-DTL,5,2,1,0,1,3,2
20191003-W-Beijing-R16-Naomi_Osaka-Alison_Riske,1,F-IO,12,5,2,2,1,8,4
20191003-W-Beijing-R16-Naomi_Osaka-Alison_Riske,1,B-XC,38,11,4,3,4,23,15
20191003-W-Beijing-R16-Naomi_Osaka-Alison_Riske,1,B-DTM,22,5,0,0,5,8,14
20191003-W-Beijing-R16-Naomi_Osaka-Alison_Riske,1,B-DTL,6,1,1,0,0,4,2
20191003-W-Beijing-R16-Naomi_Osaka-Alison_Riske,1,B-IO,4,2,1,0,1,2,2
20191003-W-Beijing-R16-Naomi_Osaka-Alison_Riske,1,S-DTM,1,0,0,0,0,0,1
20191003-W-Beijing-R16-Naomi_Osaka-Alison_Riske,2,F-XC,25,3,0,1,2,14,11
20191003-W-Beijing-R16-Naomi_Osaka-Alison_Riske,2,F-DTM,19,1,0,0,1,10,9
20191003-W-Beijing-R16-Naomi_Osaka-Alison_Riske,2,F-DTL,9,1,0,0,1,2,7
20191003-W-Beijing-R16-Naomi_Osaka-Alison_Riske,2,F-IO,12,7,3,1,3,8,4
20191003-W-Beijing-R16-Naomi_Osaka-Alison_Riske,2,B-XC,18,1,0,0,1,8,10
20191003-W-Beijing-R16-Naomi_Osaka-Alison_Riske,2,B-DTM,31,3,0,0,3,12,19
20191003-W-Beijing-R16-Naomi_Osaka-Alison_Riske,2,B-DTL,11,5,1,1,3,4,7
20191003-W-Beijing-R16-Naomi_Osaka-Alison_Riske,2,B-IO,8,3,1,0,2,5,3
20191003-W-Beijing-R16-Naomi_Osaka-Alison_Riske,2,S-XC,3,0,0,0,0,1,2
20191109-W-Fed_Cup_World_Group_F-RR-Ashleigh_Barty-Caroline_Garcia,1,F-XC,26,11,5,1,5,15,11
20191109-W-Fed_Cup_World_Group_F-RR-Ashleigh_Barty-Caroline_Garcia,1,F-DTM,6,1,0,0,1,2,4
20191109-W-Fed_Cup_World_Group_F-RR-Ashleigh_Barty-Caroline_Garcia,1,F-DTL,6,4,3,1,0,6,0
20191109-W-Fed_Cup_World_Group_F-RR-Ashleigh_Barty-Caroline_Garcia,1,F-IO,7,1,1,0,0,6,1
20191109-W-Fed_Cup_World_Group_F-RR-Ashleigh_Barty-Caroline_Garcia,1,F-II,1,0,0,0,0,1,0
20191109-W-Fed_Cup_World_Group_F-RR-Ashleigh_Barty-Caroline_Garcia,1,B-XC,7,2,1,1,0,6,1
20191109-W-Fed_Cup_World_Group_F-RR-Ashleigh_Barty-Caroline_Garcia,1,B-DTM,9,2,0,0,2,4,5
20191109-W-Fed_Cup_World_Group_F-RR-Ashleigh_Barty-Caroline_Garcia,1,B-DTL,5,2,2,0,0,4,1
20191109-W-Fed_Cup_World_Group_F-RR-Ashleigh_Barty-Caroline_Garcia,1,B-IO,1,0,0,0,0,0,1
20191109-W-Fed_Cup_World_Group_F-RR-Ashleigh_Barty-Caroline_Garcia,1,S-XC,11,1,1,0,0,6,5
20191109-W-Fed_Cup_World_Group_F-RR-Ashleigh_Barty-Caroline_Garcia,1,S-DTM,7,0,0,0,0,3,4
20191109-W-Fed_Cup_World_Group_F-RR-Ashleigh_Barty-Caroline_Garcia,1,S-DTL,3,1,0,0,1,2,1
20191109-W-Fed_Cup_World_Group_F-RR-Ashleigh_Barty-Caroline_Garcia,1,S-IO,2,0,0,0,0,1,1
20191109-W-Fed_Cup_World_Group_F-RR-Ashleigh_Barty-Caroline_Garcia,2,F-XC,33,12,1,5,6,15,18
20191109-W-Fed_Cup_World_Group_F-RR-Ashleigh_Barty-Caroline_Garcia,2,F-DTM,12,3,0,0,3,4,8
20191109-W-Fed_Cup_World_Group_F-RR-Ashleigh_Barty-Caroline_Garcia,2,F-DTL,11,6,0,2,4,3,8
20191109-W-Fed_Cup_World_Group_F-RR-Ashleigh_Barty-Caroline_Garcia,2,F-IO,16,5,0,3,2,7,9
20191109-W-Fed_Cup_World_Group_F-RR-Ashleigh_Barty-Caroline_Garcia,2,F-II,1,0,0,0,0,0,1
20191109-W-Fed_Cup_World_Group_F-RR-Ashleigh_Barty-Caroline_Garcia,2,B-XC,20,1,1,0,0,9,11
20191109-W-Fed_Cup_World_Group_F-RR-Ashleigh_Barty-Caroline_Garcia,2,B-DTM,6,1,0,0,1,3,3
20191109-W-Fed_Cup_World_Group_F-RR-Ashleigh_Barty-Caroline_Garcia,2,B-DTL,1,0,0,0,0,0,1
20191109-W-Fed_Cup_World_Group_F-RR-Ashleigh_Barty-Caroline_Garcia,2,B-IO,1,1,0,0,1,0,1
20191109-W-Fed_Cup_World_Group_F-RR-Ashleigh_Barty-Caroline_Garcia,2,S-XC,1,0,0,0,0,0,1
20191109-W-Fed_Cup_World_Group_F-RR-Ashleigh_Barty-Caroline_Garcia,2,S-DTM,1,0,0,0,0,1,0
20191109-W-Fed_Cup_World_Group_F-RR-Ashleigh_Barty-Caroline_Garcia,2,S-IO,1,1,0,0,1,0,1
20190509-W-Madrid-QF-Sloane_Stephens-Petra_Martic,1,F-XC,21,8,4,3,1,15,6
20190509-W-Madrid-QF-Sloane_Stephens-Petra_Martic,1,F-DTM,25,2,0,0,2,13,12
20190509-W-Madrid-QF-Sloane_Stephens-Petra_Martic,1,F-DTL,9,2,1,0,1,6,3
20190509-W-Madrid-QF-Sloane_Stephens-Petra_Martic,1,F-IO,25,12,6,2,4,16,9
20190509-W-Madrid-QF-Sloane_Stephens-Petra_Martic,1,B-XC,40,9,3,0,6,19,21
20190509-W-Madrid-QF-Sloane_Stephens-Petra_Martic,1,B-DTM,30,5,0,0,5,13,17
20190509-W-Madrid-QF-Sloane_Stephens-Petra_Martic,1,B-DTL,8,5,2,0,3,4,4
20190509-W-Madrid-QF-Sloane_Stephens-Petra_Martic,1,B-IO,6,5,3,0,2,4,2
20190509-W-Madrid-QF-Sloane_Stephens-Petra_Martic,1,S-XC,5,0,0,0,0,2,3
20190509-W-Madrid-QF-Sloane_Stephens-Petra_Martic,1,S-IO,1,0,0,0,0,0,1
20190509-W-Madrid-QF-Sloane_Stephens-Petra_Martic,2,F-XC,21,3,0,2,1,11,10
20190509-W-Madrid-QF-Sloane_Stephens-Petra_Martic,2,F-DTM,25,1,0,0,1,13,12
20190509-W-Madrid-QF-Sloane_Stephens-Petra_Martic,2,F-DTL,4,1,0,1,0,2,2
20190509-W-Madrid-QF-Sloane_Stephens-Petra_Martic,2,F-IO,21,4,0,1,3,9,12
20190509-W-Madrid-QF-Sloane_Stephens-Petra_Martic,2,F-II,4,3,0,1,2,2,2
20190509-W-Madrid-QF-Sloane_Stephens-Petra_Martic,2,B-XC,40,8,0,0,8,20,20
20190509-W-Madrid-QF-Sloane_Stephens-Petra_Martic,2,B-DTM,26,3,0,0,3,6,20
20190509-W-Madrid-QF-Sloane_Stephens-Petra_Martic,2,B-DTL,8,1,0,1,0,4,4
20190509-W-Madrid-QF-Sloane_Stephens-Petra_Martic,2,B-IO,1,0,0,0,0,1,0
20190509-W-Madrid-QF-Sloane_Stephens-Petra_Martic,2,S-DTM,4,0,0,0,0,3,1
20190509-W-Madrid-QF-Sloane_Stephens-Petra_Martic,2,S-DTL,4,3,0,1,2,1,3
20190326-W-Miami-QF-Ashleigh_Barty-Petra_Kvitova,1,F-XC,48,10,2,0,8,28,20
20190326-W-Miami-QF-Ashleigh_Barty-Petra_Kvitova,1,F-DTM,27,3,1,0,2,17,10
20190326-W-Miami-QF-Ashleigh_Barty-Petra_Kvitova,1,F-DTL,7,4,1,2,1,5,2
20190326-W-Miami-QF-Ashleigh_Barty-Petra_Kvitova,1,F-IO,18,6,3,1,2,11,7
20190326-W-Miami-QF-Ashleigh_Barty-Petra_Kvitova,1,F-II,1,1,0,1,0,1,0
20190326-W-Miami-QF-Ashleigh_Barty-Petra_Kvitova,1,B-XC,14,3,1,0,2,6,8
20190326-W-Miami-QF-Ashleigh_Barty-Petra_Kvitova,1,B-DTM,36,4,0,0,4,16,20
20190326-W-Miami-QF-Ashleigh_Barty-Petra_Kvitova,1,B-DTL,5,1,0,0,1,2,3
20190326-W-Miami-QF-Ashleigh_Barty-Petra_Kvitova,1,B-IO,3,0,0,0,0,2,1
20190326-W-Miami-QF-Ashleigh_Barty-Petra_Kvitova,1,S-XC,28,3,0,1,2,12,16
20190326-W-Miami-QF-Ashleigh_Barty-Petra_Kvitova,1,S-DTM,33,2,0,1,1,14,19
20190326-W-Miami-QF-Ashleigh_Barty-Petra_Kvitova,1,S-DTL,10,3,2,0,1,6,4
20190326-W-Miami-QF-Ashleigh_Barty-Petra_Kvitova,1,S-IO,7,0,0,0,0,4,3
20190326-W-Miami-QF-Ashleigh_Barty-Petra_Kvitova,2,F-XC,89,18,3,3,12,44,45
20190326-W-Miami-QF-Ashleigh_Barty-Petra_Kvitova,2,F-DTM,30,5,1,0,4,14,16
20190326-W-Miami-QF-Ashleigh_Barty-Petra_Kvitova,2,F-DTL,13,8,5,1,2,8,5
20190326-W-Miami-QF-Ashleigh_Barty-Petra_Kvitova,2,F-IO,21,10,3,0,7,11,10
20190326-W-Miami-QF-Ashleigh_Barty-Petra_Kvitova,2,F-II,1,1,0,0,1,0,1
20190326-W-Miami-QF-Ashleigh_Barty-Petra_Kvitova,2,B-XC,43,18,4,4,10,16,27
20190326-W-Miami-QF-Ashleigh_Barty-Petra_Kvitova,2,B-DTM,28,2,0,0,2,14,14
20190326-W-Miami-QF-Ashleigh_Barty-Petra_Kvitova,2,B-DTL,14,6,4,0,2,8,6
20190326-W-Miami-QF-Ashleigh_Barty-Petra_Kvitova,2,B-IO,17,6,0,2,4,7,10
20190326-W-Miami-QF-Ashleigh_Barty-Petra_Kvitova,2,S-XC,4,0,0,0,0,1,3
20190326-W-Miami-QF-Ashleigh_Barty-Petra_Kvitova,2,S-DTM,5,1,0,0,1,2,3
20190326-W-Miami-QF-Ashleigh_Barty-Petra_Kvitova,2,S-DTL,5,2,0,1,1,4,1
20190326-W-Miami-QF-Ashleigh_Barty-Petra_Kvitova,2,S-IO,1,0,0,0,0,1,0
20190322-W-Miami-R64-Jelena_Ostapenko-Marketa_Vondrousova,1,F-XC,30,6,2,0,4,15,15
20190322-W-Miami-R64-Jelena_Ostapenko-Marketa_Vondrousova,1,F-DTM,10,1,0,0,1,4,6
20190322-W-Miami-R64-Jelena_Ostapenko-Marketa_Vondrousova,1,F-DTL,9,5,3,0,2,3,6
20190322-W-Miami-R64-Jelena_Ostapenko-Marketa_Vondrousova,1,F-IO,11,7,2,0,5,2,9
20190322-W-Miami-R64-Jelena_Ostapenko-Marketa_Vondrousova,1,B-XC,22,10,3,0,7,5,17
20190322-W-Miami-R64-Jelena_Ostapenko-Marketa_Vondrousova,1,B-DTM,17,0,0,0,0,8,9
20190322-W-Miami-R64-Jelena_Ostapenko-Marketa_Vondrousova,1,B-DTL,8,4,2,0,2,5,3
20190322-W-Miami-R64-Jelena_Ostapenko-Marketa_Vondrousova,1,B-IO,11,3,0,0,3,0,11
20190322-W-Miami-R64-Jelena_Ostapenko-Marketa_Vondrousova,1,S-XC,5,1,0,0,1,1,4
20190322-W-Miami-R64-Jelena_Ostapenko-Marketa_Vondrousova,1,S-DTM,1,0,0,0,0,0,1
20190322-W-Miami-R64-Jelena_Ostapenko-Marketa_Vondrousova,1,S-DTL,2,0,0,0,0,2,0
20190322-W-Miami-R64-Jelena_Ostapenko-Marketa_Vondrousova,1,S-IO,8,2,0,0,2,2,6
20190322-W-Miami-R64-Jelena_Ostapenko-Marketa_Vondrousova,2,F-XC,17,5,2,2,1,13,4
20190322-W-Miami-R64-Jelena_Ostapenko-Marketa_Vondrousova,2,F-DTM,21,2,2,0,0,18,3
20190322-W-Miami-R64-Jelena_Ostapenko-Marketa_Vondrousova,2,F-DTL,6,4,3,0,1,4,2
20190322-W-Miami-R64-Jelena_Ostapenko-Marketa_Vondrousova,2,F-IO,2,1,0,0,1,1,1
20190322-W-Miami-R64-Jelena_Ostapenko-Marketa_Vondrousova,2,B-XC,14,1,0,0,1,9,5
20190322-W-Miami-R64-Jelena_Ostapenko-Marketa_Vondrousova,2,B-DTM,33,5,0,0,5,21,12
20190322-W-Miami-R64-Jelena_Ostapenko-Marketa_Vondrousova,2,B-DTL,4,2,0,0,2,0,4
20190322-W-Miami-R64-Jelena_Ostapenko-Marketa_Vondrousova,2,B-IO,1,0,0,0,0,1,0
20190322-W-Miami-R64-Jelena_Ostapenko-Marketa_Vondrousova,2,S-XC,1,0,0,0,0,1,0
20190322-W-Miami-R64-Jelena_Ostapenko-Marketa_Vondrousova,2,S-DTM,14,0,0,0,0,7,7
20190322-W-Miami-R64-Jelena_Ostapenko-Marketa_Vondrousova,2,S-DTL,6,0,0,0,0,3,3
20190322-W-Miami-R64-Jelena_Ostapenko-Marketa_Vondrousova,2,S-IO,1,0,0,0,0,1,0
20190816-W-Cincinnati-QF-Ashleigh_Barty-Maria_Sakkari,1,F-XC,35,8,2,5,1,20,15
20190816-W-Cincinnati-QF-Ashleigh_Barty-Maria_Sakkari,1,F-DTM,25,4,0,1,3,12,13
20190816-W-Cincinnati-QF-Ashleigh_Barty-Maria_Sakkari,1,F-DTL,5,3,1,0,2,2,3
20190816-W-Cincinnati-QF-Ashleigh_Barty-Maria_Sakkari,1,F-IO,22,8,4,2,2,14,8
20190816-W-Cincinnati-QF-Ashleigh_Barty-Maria_Sakkari,1,F-II,4,2,1,1,0,4,0
20190816-W-Cincinnati-QF-Ashleigh_Barty-Maria_Sakkari,1,B-XC,13,0,0,0,0,6,7
20190816-W-Cincinnati-QF-Ashleigh_Barty-Maria_Sakkari,1,B-DTM,26,1,0,1,0,12,14
20190816-W-Cincinnati-QF-Ashleigh_Barty-Maria_Sakkari,1,B-DTL,3,1,1,0,0,3,0
20190816-W-Cincinnati-QF-Ashleigh_Barty-Maria_Sakkari,1,B-IO,2,0,0,0,0,2,0
20190816-W-Cincinnati-QF-Ashleigh_Barty-Maria_Sakkari,1,S-XC,27,4,1,0,3,14,13
20190816-W-Cincinnati-QF-Ashleigh_Barty-Maria_Sakkari,1,S-DTM,27,4,0,2,2,14,13
20190816-W-Cincinnati-QF-Ashleigh_Barty-Maria_Sakkari,1,S-DTL,7,3,1,1,1,4,3
20190816-W-Cincinnati-QF-Ashleigh_Barty-Maria_Sakkari,1,S-IO,2,1,0,0,1,0,2
20190816-W-Cincinnati-QF-Ashleigh_Barty-Maria_Sakkari,2,F-XC,34,10,5,0,5,20,14
20190816-W-Cincinnati-QF-Ashleigh_Barty-Maria_Sakkari,2,F-DTM,17,0,0,0,0,8,9
20190816-W-Cincinnati-QF-Ashleigh_Barty-Maria_Sakkari,2,F-DTL,22,4,1,0,3,8,14
20190816-W-Cincinnati-QF-Ashleigh_Barty-Maria_Sakkari,2,F-IO,40,8,1,1,6,17,23
20190816-W-Cincinnati-QF-Ashleigh_Barty-Maria_Sakkari,2,F-II,6,2,0,0,2,1,5
20190816-W-Cincinnati-QF-Ashleigh_Barty-Maria_Sakkari,2,B-XC,43,7,2,1,4,22,21
20190816-W-Cincinnati-QF-Ashleigh_Barty-Maria_Sakkari,2,B-DTM,17,2,0,0,2,5,12
20190816-W-Cincinnati-QF-Ashleigh_Barty-Maria_Sakkari,2,B-DTL,5,2,2,0,0,5,0
20190816-W-Cincinnati-QF-Ashleigh_Barty-Maria_Sakkari,2,B-IO,3,1,0,0,1,0,3
20190816-W-Cincinnati-QF-Ashleigh_Barty-Maria_Sakkari,2,S-XC,5,0,0,0,0,4,1
20190816-W-Cincinnati-QF-Ashleigh_Barty-Maria_Sakkari,2,S-DTM,7,2,0,0,2,4,3
20190816-W-Cincinnati-QF-Ashleigh_Barty-Maria_Sakkari,2,S-DTL,3,0,0,0,0,1,2
20190816-W-Cincinnati-QF-Ashleigh_Barty-Maria_Sakkari,2,S-IO,4,1,0,1,0,2,2
20190814-W-Cincinnati-R32-Anett_Kontaveit-Iga_Swiatek,1,F-XC,34,14,1,2,11,12,22
20190814-W-Cincinnati-R32-Anett_Kontaveit-Iga_Swiatek,1,F-DTM,15,2,0,0,2,6,9
20190814-W-Cincinnati-R32-Anett_Kontaveit-Iga_Swiatek,1,F-DTL,9,6,2,1,3,3,6
20190814-W-Cincinnati-R32-Anett_Kontaveit-Iga_Swiatek,1,F-IO,3,3,1,0,2,1,2
20190814-W-Cincinnati-R32-Anett_Kontaveit-Iga_Swiatek,1,B-XC,26,6,1,2,3,14,12
20190814-W-Cincinnati-R32-Anett_Kontaveit-Iga_Swiatek,1,B-DTM,12,1,0,0,1,6,6
20190814-W-Cincinnati-R32-Anett_Kontaveit-Iga_Swiatek,1,B-DTL,7,4,2,1,1,5,2
20190814-W-Cincinnati-R32-Anett_Kontaveit-Iga_Swiatek,1,B-IO,3,0,0,0,0,2,1
20190814-W-Cincinnati-R32-Anett_Kontaveit-Iga_Swiatek,1,S-DTM,2,0,0,0,0,0,2
20190814-W-Cincinnati-R32-Anett_Kontaveit-Iga_Swiatek,1,S-DTL,4,2,0,0,2,1,3
20190814-W-Cincinnati-R32-Anett_Kontaveit-Iga_Swiatek,1,S-IO,1,0,0,0,0,1,0
20190814-W-Cincinnati-R32-Anett_Kontaveit-Iga_Swiatek,2,F-XC,32,8,2,2,4,21,11
20190814-W-Cincinnati-R32-Anett_Kontaveit-Iga_Swiatek,2,F-DTM,17,3,0,0,3,9,8
20190814-W-Cincinnati-R32-Anett_Kontaveit-Iga_Swiatek,2,F-DTL,10,3,0,0,3,2,8
20190814-W-Cincinnati-R32-Anett_Kontaveit-Iga_Swiatek,2,F-IO,12,6,1,0,5,6,6
20190814-W-Cincinnati-R32-Anett_Kontaveit-Iga_Swiatek,2,B-XC,23,10,3,1,6,11,12
20190814-W-Cincinnati-R32-Anett_Kontaveit-Iga_Swiatek,2,B-DTM,11,4,0,0,4,5,6
20190814-W-Cincinnati-R32-Anett_Kontaveit-Iga_Swiatek,2,B-DTL,4,2,1,0,1,3,1
20190814-W-Cincinnati-R32-Anett_Kontaveit-Iga_Swiatek,2,B-IO,3,0,0,0,0,2,1
20190814-W-Cincinnati-R32-Anett_Kontaveit-Iga_Swiatek,2,S-XC,2,0,0,0,0,0,2
20190814-W-Cincinnati-R32-Anett_Kontaveit-Iga_Swiatek,2,S-DTM,1,0,0,0,0,0,1
20190308-W-Indian_Wells-R64-Sofia_Kenin-Elina_Svitolina,1,F-XC,74,21,6,7,8,44,30
20190308-W-Indian_Wells-R64-Sofia_Kenin-Elina_Svitolina,1,F-DTM,47,3,0,0,3,24,23
20190308-W-Indian_Wells-R64-Sofia_Kenin-Elina_Svitolina,1,F-DTL,9,6,3,0,3,4,5
20190308-W-Indian_Wells-R64-Sofia_Kenin-Elina_Svitolina,1,F-IO,16,4,2,0,2,9,7
20190308-W-Indian_Wells-R64-Sofia_Kenin-Elina_Svitolina,1,B-XC,80,21,5,4,12,42,38
20190308-W-Indian_Wells-R64-Sofia_Kenin-Elina_Svitolina,1,B-DTM,62,7,0,2,5,32,30
20190308-W-Indian_Wells-R64-Sofia_Kenin-Elina_Svitolina,1,B-DTL,9,4,3,0,1,5,4
20190308-W-Indian_Wells-R64-Sofia_Kenin-Elina_Svitolina,1,B-IO,18,5,2,1,2,14,4
20190308-W-Indian_Wells-R64-Sofia_Kenin-Elina_Svitolina,1,S-XC,8,0,0,0,0,4,4
20190308-W-Indian_Wells-R64-Sofia_Kenin-Elina_Svitolina,1,S-DTM,16,0,0,0,0,7,9
20190308-W-Indian_Wells-R64-Sofia_Kenin-Elina_Svitolina,1,S-DTL,1,0,0,0,0,1,0
20190308-W-Indian_Wells-R64-Sofia_Kenin-Elina_Svitolina,1,S-IO,2,0,0,0,0,1,1
20190308-W-Indian_Wells-R64-Sofia_Kenin-Elina_Svitolina,2,F-XC,66,18,5,2,11,29,37
20190308-W-Indian_Wells-R64-Sofia_Kenin-Elina_Svitolina,2,F-DTM,60,4,0,0,4,27,33
20190308-W-Indian_Wells-R64-Sofia_Kenin-Elina_Svitolina,2,F-DTL,11,6,3,1,2,6,5
20190308-W-Indian_Wells-R64-Sofia_Kenin-Elina_Svitolina,2,F-IO,21,6,1,2,3,10,11
20190308-W-Indian_Wells-R64-Sofia_Kenin-Elina_Svitolina,2,F-II,1,1,1,0,0,1,0
20190308-W-Indian_Wells-R64-Sofia_Kenin-Elina_Svitolina,2,B-XC,78,13,5,2,6,45,33
20190308-W-Indian_Wells-R64-Sofia_Kenin-Elina_Svitolina,2,B-DTM,51,3,0,0,3,22,29
20190308-W-Indian_Wells-R64-Sofia_Kenin-Elina_Svitolina,2,B-DTL,7,3,0,0,3,2,5
20190308-W-Indian_Wells-R64-Sofia_Kenin-Elina_Svitolina,2,B-IO,15,7,1,2,4,5,10
20190308-W-Indian_Wells-R64-Sofia_Kenin-Elina_Svitolina,2,S-XC,3,0,0,0,0,2,1
20190308-W-Indian_Wells-R64-Sofia_Kenin-Elina_Svitolina,2,S-DTM,13,0,0,0,0,7,6
20190308-W-Indian_Wells-R64-Sofia_Kenin-Elina_Svitolina,2,S-DTL,3,0,0,0,0,2,1
20190308-W-Indian_Wells-R64-Sofia_Kenin-Elina_Svitolina,2,S-IO,1,0,0,0,0,1,0
20190324-W-Miami-R32-Elise_Mertens-Marketa_Vondrousova,1,F-XC,50,9,2,0,7,26,24
20190324-W-Miami-R32-Elise_Mertens-Marketa_Vondrousova,1,F-DTM,25,5,0,0,5,12,13
20190324-W-Miami-R32-Elise_Mertens-Marketa_Vondrousova,1,F-DTL,10,6,2,1,3,4,6
20190324-W-Miami-R32-Elise_Mertens-Marketa_Vondrousova,1,F-IO,23,11,4,0,7,11,12
20190324-W-Miami-R32-Elise_Mertens-Marketa_Vondrousova,1,B-XC,34,12,3,3,6,18,16
20190324-W-Miami-R32-Elise_Mertens-Marketa_Vondrousova,1,B-DTM,33,6,1,1,4,10,23
20190324-W-Miami-R32-Elise_Mertens-Marketa_Vondrousova,1,B-DTL,15,7,2,1,4,7,8
20190324-W-Miami-R32-Elise_Mertens-Marketa_Vondrousova,1,B-IO,9,3,1,1,1,5,4
20190324-W-Miami-R32-Elise_Mertens-Marketa_Vondrousova,1,S-XC,2,0,0,0,0,1,1
20190324-W-Miami-R32-Elise_Mertens-Marketa_Vondrousova,1,S-DTM,4,1,0,0,1,3,1
20190324-W-Miami-R32-Elise_Mertens-Marketa_Vondrousova,1,S-DTL,1,0,0,0,0,1,0
20190324-W-Miami-R32-Elise_Mertens-Marketa_Vondrousova,2,F-XC,50,8,1,1,6,26,24
20190324-W-Miami-R32-Elise_Mertens-Marketa_Vondrousova,2,F-DTM,32,4,0,0,4,13,19
20190324-W-Miami-R32-Elise_Mertens-Marketa_Vondrousova,2,F-DTL,6,2,2,0,0,4,2
20190324-W-Miami-R32-Elise_Mertens-Marketa_Vondrousova,2,F-IO,5,4,2,0,2,2,3
20190324-W-Miami-R32-Elise_Mertens-Marketa_Vondrousova,2,B-XC,33,10,1,1,8,18,15
20190324-W-Miami-R32-Elise_Mertens-Marketa_Vondrousova,2,B-DTM,51,2,0,0,2,23,28
20190324-W-Miami-R32-Elise_Mertens-Marketa_Vondrousova,2,B-DTL,9,3,1,0,2,4,5
20190324-W-Miami-R32-Elise_Mertens-Marketa_Vondrousova,2,B-IO,2,1,0,1,0,2,0
20190324-W-Miami-R32-Elise_Mertens-Marketa_Vondrousova,2,S-DTM,4,0,0,0,0,2,2
20191031-W-Shenzhen_Finals-RR-Belinda_Bencic-Kiki_Bertens,1,F-XC,24,4,0,1,3,11,13
20191031-W-Shenzhen_Finals-RR-Belinda_Bencic-Kiki_Bertens,1,F-DTM,13,2,0,0,2,7,6
20191031-W-Shenzhen_Finals-RR-Belinda_Bencic-Kiki_Bertens,1,F-DTL,8,5,2,1,2,4,4
20191031-W-Shenzhen_Finals-RR-Belinda_Bencic-Kiki_Bertens,1,F-IO,20,3,1,1,1,14,6
20191031-W-Shenzhen_Finals-RR-Belinda_Bencic-Kiki_Bertens,1,B-XC,28,5,0,3,2,19,9
20191031-W-Shenzhen_Finals-RR-Belinda_Bencic-Kiki_Bertens,1,B-DTM,11,1,0,0,1,8,3
20191031-W-Shenzhen_Finals-RR-Belinda_Bencic-Kiki_Bertens,1,B-DTL,6,4,2,2,0,4,2
20191031-W-Shenzhen_Finals-RR-Belinda_Bencic-Kiki_Bertens,1,B-IO,6,4,1,1,2,3,3
20191031-W-Shenzhen_Finals-RR-Belinda_Bencic-Kiki_Bertens,2,F-XC,26,3,0,2,1,15,11
20191031-W-Shenzhen_Finals-RR-Belinda_Bencic-Kiki_Bertens,2,F-DTM,11,2,0,0,2,3,8
20191031-W-Shenzhen_Finals-RR-Belinda_Bencic-Kiki_Bertens,2,F-DTL,5,4,1,0,3,1,4
20191031-W-Shenzhen_Finals-RR-Belinda_Bencic-Kiki_Bertens,2,F-IO,5,2,2,0,0,2,3
20191031-W-Shenzhen_Finals-RR-Belinda_Bencic-Kiki_Bertens,2,B-XC,19,2,0,0,2,10,9
20191031-W-Shenzhen_Finals-RR-Belinda_Bencic-Kiki_Bertens,2,B-DTM,25,2,0,0,2,8,17
20191031-W-Shenzhen_Finals-RR-Belinda_Bencic-Kiki_Bertens,2,B-DTL,1,1,0,0,1,0,1
20191031-W-Shenzhen_Finals-RR-Belinda_Bencic-Kiki_Bertens,2,S-XC,3,0,0,0,0,1,2
20191031-W-Shenzhen_Finals-RR-Belinda_Bencic-Kiki_Bertens,2,S-DTM,17,1,0,0,1,4,13
20191029-W-Shenzhen_Finals-RR-Ashleigh_Barty-Kiki_Bertens,1,F-XC,70,12,2,4,6,31,39
20191029-W-Shenzhen_Finals-RR-Ashleigh_Barty-Kiki_Bertens,1,F-DTM,32,5,1,1,3,18,14
20191029-W-Shenzhen_Finals-RR-Ashleigh_Barty-Kiki_Bertens,1,F-DTL,17,5,2,2,1,10,7
20191029-W-Shenzhen_Finals-RR-Ashleigh_Barty-Kiki_Bertens,1,F-IO,34,10,0,1,9,13,21
20191029-W-Shenzhen_Finals-RR-Ashleigh_Barty-Kiki_Bertens,1,F-II,6,1,0,1,0,4,2
20191029-W-Shenzhen_Finals-RR-Ashleigh_Barty-Kiki_Bertens,1,B-XC,29,6,3,0,3,15,14
20191029-W-Shenzhen_Finals-RR-Ashleigh_Barty-Kiki_Bertens,1,B-DTM,40,6,0,1,5,18,22
20191029-W-Shenzhen_Finals-RR-Ashleigh_Barty-Kiki_Bertens,1,B-DTL,8,2,1,0,1,4,4
20191029-W-Shenzhen_Finals-RR-Ashleigh_Barty-Kiki_Bertens,1,B-IO,1,0,0,0,0,1,0
20191029-W-Shenzhen_Finals-RR-Ashleigh_Barty-Kiki_Bertens,1,S-XC,37,5,0,0,5,21,16
20191029-W-Shenzhen_Finals-RR-Ashleigh_Barty-Kiki_Bertens,1,S-DTM,12,1,0,1,0,8,4
20191029-W-Shenzhen_Finals-RR-Ashleigh_Barty-Kiki_Bertens,1,S-DTL,9,2,0,0,2,4,5
20191029-W-Shenzhen_Finals-RR-Ashleigh_Barty-Kiki_Bertens,1,S-IO,1,0,0,0,0,1,0
20191029-W-Shenzhen_Finals-RR-Ashleigh_Barty-Kiki_Bertens,2,F-XC,65,13,2,0,11,30,35
20191029-W-Shenzhen_Finals-RR-Ashleigh_Barty-Kiki_Bertens,2,F-DTM,24,1,0,0,1,8,16
20191029-W-Shenzhen_Finals-RR-Ashleigh_Barty-Kiki_Bertens,2,F-DTL,22,5,2,1,2,14,8
20191029-W-Shenzhen_Finals-RR-Ashleigh_Barty-Kiki_Bertens,2,F-IO,62,16,4,6,6,33,29
20191029-W-Shenzhen_Finals-RR-Ashleigh_Barty-Kiki_Bertens,2,F-II,2,2,0,0,2,0,2
20191029-W-Shenzhen_Finals-RR-Ashleigh_Barty-Kiki_Bertens,2,B-XC,41,7,1,1,5,19,22
20191029-W-Shenzhen_Finals-RR-Ashleigh_Barty-Kiki_Bertens,2,B-DTM,27,2,0,0,2,12,15
20191029-W-Shenzhen_Finals-RR-Ashleigh_Barty-Kiki_Bertens,2,B-DTL,3,2,0,0,2,0,3
20191029-W-Shenzhen_Finals-RR-Ashleigh_Barty-Kiki_Bertens,2,B-IO,2,1,0,0,1,1,1
20191029-W-Shenzhen_Finals-RR-Ashleigh_Barty-Kiki_Bertens,2,S-XC,20,1,0,1,0,7,13
20191029-W-Shenzhen_Finals-RR-Ashleigh_Barty-Kiki_Bertens,2,S-DTM,13,1,0,0,1,8,5
20191029-W-Shenzhen_Finals-RR-Ashleigh_Barty-Kiki_Bertens,2,S-DTL,3,1,0,0,1,1,2
20191026-W-Zhuhai-SF-Kiki_Bertens-Saisai_Zheng,1,F-XC,64,8,2,1,5,36,28
20191026-W-Zhuhai-SF-Kiki_Bertens-Saisai_Zheng,1,F-DTM,24,3,0,0,3,6,18
20191026-W-Zhuhai-SF-Kiki_Bertens-Saisai_Zheng,1,F-DTL,6,3,1,1,1,4,2
20191026-W-Zhuhai-SF-Kiki_Bertens-Saisai_Zheng,1,F-IO,24,4,2,1,1,14,10
20191026-W-Zhuhai-SF-Kiki_Bertens-Saisai_Zheng,1,B-XC,43,9,1,3,5,15,28
20191026-W-Zhuhai-SF-Kiki_Bertens-Saisai_Zheng,1,B-DTM,54,3,0,0,3,18,36
20191026-W-Zhuhai-SF-Kiki_Bertens-Saisai_Zheng,1,B-DTL,9,2,0,0,2,4,5
20191026-W-Zhuhai-SF-Kiki_Bertens-Saisai_Zheng,1,B-IO,7,3,1,0,2,3,4
20191026-W-Zhuhai-SF-Kiki_Bertens-Saisai_Zheng,1,S-XC,17,2,0,0,2,6,11
20191026-W-Zhuhai-SF-Kiki_Bertens-Saisai_Zheng,1,S-DTM,17,2,0,0,2,6,11
20191026-W-Zhuhai-SF-Kiki_Bertens-Saisai_Zheng,1,S-DTL,3,0,0,0,0,1,2
20191026-W-Zhuhai-SF-Kiki_Bertens-Saisai_Zheng,1,S-IO,2,0,0,0,0,0,2
20191026-W-Zhuhai-SF-Kiki_Bertens-Saisai_Zheng,2,F-XC,53,5,0,4,1,29,24
20191026-W-Zhuhai-SF-Kiki_Bertens-Saisai_Zheng,2,F-DTM,40,3,0,1,2,20,20
20191026-W-Zhuhai-SF-Kiki_Bertens-Saisai_Zheng,2,F-DTL,21,8,2,0,6,10,11
20191026-W-Zhuhai-SF-Kiki_Bertens-Saisai_Zheng,2,F-IO,38,11,1,3,6,22,16
20191026-W-Zhuhai-SF-Kiki_Bertens-Saisai_Zheng,2,B-XC,57,5,0,1,4,32,25
20191026-W-Zhuhai-SF-Kiki_Bertens-Saisai_Zheng,2,B-DTM,28,1,0,0,1,13,15
20191026-W-Zhuhai-SF-Kiki_Bertens-Saisai_Zheng,2,B-DTL,7,3,2,0,1,4,3
20191026-W-Zhuhai-SF-Kiki_Bertens-Saisai_Zheng,2,B-IO,1,1,0,0,1,0,1
20191026-W-Zhuhai-SF-Kiki_Bertens-Saisai_Zheng,2,S-XC,22,3,0,0,3,12,10
20191026-W-Zhuhai-SF-Kiki_Bertens-Saisai_Zheng,2,S-DTM,6,0,0,0,0,5,1
20191026-W-Zhuhai-SF-Kiki_Bertens-Saisai_Zheng,2,S-DTL,4,1,0,1,0,3,1
20191030-W-Shenzhen_Finals-RR-Karolina_Pliskova-Bianca_Andreescu,1,F-XC,14,4,2,1,1,10,4
20191030-W-Shenzhen_Finals-RR-Karolina_Pliskova-Bianca_Andreescu,1,F-DTM,13,0,0,0,0,6,7
20191030-W-Shenzhen_Finals-RR-Karolina_Pliskova-Bianca_Andreescu,1,F-DTL,2,1,1,0,0,2,0
20191030-W-Shenzhen_Finals-RR-Karolina_Pliskova-Bianca_Andreescu,1,F-IO,12,4,3,0,1,10,2
20191030-W-Shenzhen_Finals-RR-Karolina_Pliskova-Bianca_Andreescu,1,B-XC,13,4,2,0,2,10,3
20191030-W-Shenzhen_Finals-RR-Karolina_Pliskova-Bianca_Andreescu,1,B-DTM,14,1,0,0,1,9,5
20191030-W-Shenzhen_Finals-RR-Karolina_Pliskova-Bianca_Andreescu,1,B-DTL,1,1,1,0,0,1,0
20191030-W-Shenzhen_Finals-RR-Karolina_Pliskova-Bianca_Andreescu,1,S-XC,2,0,0,0,0,1,1
20191030-W-Shenzhen_Finals-RR-Karolina_Pliskova-Bianca_Andreescu,2,F-XC,11,2,1,0,1,5,6
20191030-W-Shenzhen_Finals-RR-Karolina_Pliskova-Bianca_Andreescu,2,F-DTM,14,0,0,0,0,4,10
20191030-W-Shenzhen_Finals-RR-Karolina_Pliskova-Bianca_Andreescu,2,F-DTL,2,1,0,0,1,1,1
20191030-W-Shenzhen_Finals-RR-Karolina_Pliskova-Bianca_Andreescu,2,F-IO,8,4,3,0,1,5,3
20191030-W-Shenzhen_Finals-RR-Karolina_Pliskova-Bianca_Andreescu,2,B-XC,12,1,0,1,0,2,10
20191030-W-Shenzhen_Finals-RR-Karolina_Pliskova-Bianca_Andreescu,2,B-DTM,12,3,0,2,1,3,9
20191030-W-Shenzhen_Finals-RR-Karolina_Pliskova-Bianca_Andreescu,2,B-DTL,3,3,1,1,1,2,1
20191030-W-Shenzhen_Finals-RR-Karolina_Pliskova-Bianca_Andreescu,2,B-IO,3,2,1,0,1,2,1
20191030-W-Shenzhen_Finals-RR-Karolina_Pliskova-Bianca_Andreescu,2,S-XC,2,1,0,0,1,0,2
20191030-W-Shenzhen_Finals-RR-Karolina_Pliskova-Bianca_Andreescu,2,S-DTM,6,2,0,0,2,2,4
20191030-W-Shenzhen_Finals-RR-Karolina_Pliskova-Bianca_Andreescu,2,S-DTL,1,1,0,0,1,0,1
20191030-W-Shenzhen_Finals-RR-Karolina_Pliskova-Bianca_Andreescu,2,S-IO,1,0,0,0,0,0,1
20190509-W-Madrid-QF-Naomi_Osaka-Belinda_Bencic,1,F-XC,46,16,7,2,7,23,23
20190509-W-Madrid-QF-Naomi_Osaka-Belinda_Bencic,1,F-DTM,12,3,1,0,2,8,4
20190509-W-Madrid-QF-Naomi_Osaka-Belinda_Bencic,1,F-DTL,8,5,1,0,4,3,5
20190509-W-Madrid-QF-Naomi_Osaka-Belinda_Bencic,1,F-IO,18,6,5,0,1,9,9
20190509-W-Madrid-QF-Naomi_Osaka-Belinda_Bencic,1,F-II,2,1,1,0,0,2,0
20190509-W-Madrid-QF-Naomi_Osaka-Belinda_Bencic,1,B-XC,65,19,4,3,12,28,37
20190509-W-Madrid-QF-Naomi_Osaka-Belinda_Bencic,1,B-DTM,18,2,1,0,1,9,9
20190509-W-Madrid-QF-Naomi_Osaka-Belinda_Bencic,1,B-DTL,10,8,5,0,3,5,5
20190509-W-Madrid-QF-Naomi_Osaka-Belinda_Bencic,1,B-IO,9,6,3,0,3,5,4
20190509-W-Madrid-QF-Naomi_Osaka-Belinda_Bencic,1,S-DTM,2,0,0,0,0,1,1
20190509-W-Madrid-QF-Naomi_Osaka-Belinda_Bencic,2,F-XC,35,11,3,2,6,18,17
20190509-W-Madrid-QF-Naomi_Osaka-Belinda_Bencic,2,F-DTM,18,0,0,0,0,7,11
20190509-W-Madrid-QF-Naomi_Osaka-Belinda_Bencic,2,F-DTL,9,5,2,1,2,5,4
20190509-W-Madrid-QF-Naomi_Osaka-Belinda_Bencic,2,F-IO,13,5,1,2,2,8,5
20190509-W-Madrid-QF-Naomi_Osaka-Belinda_Bencic,2,B-XC,43,4,0,0,4,23,20
20190509-W-Madrid-QF-Naomi_Osaka-Belinda_Bencic,2,B-DTM,31,4,0,2,2,16,15
20190509-W-Madrid-QF-Naomi_Osaka-Belinda_Bencic,2,B-DTL,13,7,5,0,2,9,4
20190509-W-Madrid-QF-Naomi_Osaka-Belinda_Bencic,2,B-IO,5,4,3,1,0,5,0
20190509-W-Madrid-QF-Naomi_Osaka-Belinda_Bencic,2,S-XC,1,0,0,0,0,0,1
20190509-W-Madrid-QF-Naomi_Osaka-Belinda_Bencic,2,S-DTM,1,0,0,0,0,1,0
20190509-W-Madrid-QF-Naomi_Osaka-Belinda_Bencic,2,S-DTL,1,0,0,0,0,0,1
20190517-W-Rome-QF-Marketa_Vondrousova-Johanna_Konta,1,F-XC,27,4,1,0,3,10,17
20190517-W-Rome-QF-Marketa_Vondrousova-Johanna_Konta,1,F-DTM,30,1,0,0,1,15,15
20190517-W-Rome-QF-Marketa_Vondrousova-Johanna_Konta,1,F-DTL,10,7,5,1,1,6,4
20190517-W-Rome-QF-Marketa_Vondrousova-Johanna_Konta,1,F-IO,3,2,1,1,0,2,1
20190517-W-Rome-QF-Marketa_Vondrousova-Johanna_Konta,1,B-XC,9,5,2,1,2,5,4
20190517-W-Rome-QF-Marketa_Vondrousova-Johanna_Konta,1,B-DTM,29,2,0,0,2,14,15
20190517-W-Rome-QF-Marketa_Vondrousova-Johanna_Konta,1,B-DTL,7,4,1,2,1,3,4
20190517-W-Rome-QF-Marketa_Vondrousova-Johanna_Konta,1,B-IO,2,0,0,0,0,2,0
20190517-W-Rome-QF-Marketa_Vondrousova-Johanna_Konta,1,S-DTM,5,0,0,0,0,2,3
20190517-W-Rome-QF-Marketa_Vondrousova-Johanna_Konta,1,S-DTL,3,0,0,0,0,0,3
20190517-W-Rome-QF-Marketa_Vondrousova-Johanna_Konta,1,S-IO,2,0,0,0,0,1,1
20190517-W-Rome-QF-Marketa_Vondrousova-Johanna_Konta,2,F-XC,30,11,5,2,4,18,12
20190517-W-Rome-QF-Marketa_Vondrousova-Johanna_Konta,2,F-DTM,11,0,0,0,0,4,7
20190517-W-Rome-QF-Marketa_Vondrousova-Johanna_Konta,2,F-DTL,3,2,2,0,0,2,1
20190517-W-Rome-QF-Marketa_Vondrousova-Johanna_Konta,2,F-IO,18,8,2,3,3,13,5
20190517-W-Rome-QF-Marketa_Vondrousova-Johanna_Konta,2,F-II,1,0,0,0,0,0,1
20190517-W-Rome-QF-Marketa_Vondrousova-Johanna_Konta,2,B-XC,38,17,9,2,6,24,14
20190517-W-Rome-QF-Marketa_Vondrousova-Johanna_Konta,2,B-DTM,20,4,0,1,3,9,11
20190517-W-Rome-QF-Marketa_Vondrousova-Johanna_Konta,2,B-DTL,8,6,4,1,1,6,2
20190517-W-Rome-QF-Marketa_Vondrousova-Johanna_Konta,2,B-IO,7,5,1,1,3,4,3
20190517-W-Rome-QF-Marketa_Vondrousova-Johanna_Konta,2,S-XC,2,0,0,0,0,0,2
20190517-W-Rome-QF-Marketa_Vondrousova-Johanna_Konta,2,S-DTM,5,0,0,0,0,2,3
20190517-W-Rome-QF-Marketa_Vondrousova-Johanna_Konta,2,S-DTL,1,0,0,0,0,1,0
20190517-W-Rome-QF-Marketa_Vondrousova-Johanna_Konta,2,S-IO,2,1,0,0,1,1,1
20190809-W-Toronto-QF-Serena_Williams-Naomi_Osaka,1,F-XC,19,8,3,1,4,11,8
20190809-W-Toronto-QF-Serena_Williams-Naomi_Osaka,1,F-DTM,14,2,1,0,1,8,6
20190809-W-Toronto-QF-Serena_Williams-Naomi_Osaka,1,F-DTL,1,1,0,1,0,1,0
20190809-W-Toronto-QF-Serena_Williams-Naomi_Osaka,1,F-IO,10,7,2,1,4,6,4
20190809-W-Toronto-QF-Serena_Williams-Naomi_Osaka,1,B-XC,25,6,0,0,6,14,11
20190809-W-Toronto-QF-Serena_Williams-Naomi_Osaka,1,B-DTM,19,2,0,0,2,10,9
20190809-W-Toronto-QF-Serena_Williams-Naomi_Osaka,1,B-DTL,6,3,2,0,1,5,1
20190809-W-Toronto-QF-Serena_Williams-Naomi_Osaka,1,B-IO,10,5,4,0,1,8,2
20190809-W-Toronto-QF-Serena_Williams-Naomi_Osaka,1,S-XC,1,0,0,0,0,1,0
20190809-W-Toronto-QF-Serena_Williams-Naomi_Osaka,2,F-XC,15,5,2,1,2,7,8
20190809-W-Toronto-QF-Serena_Williams-Naomi_Osaka,2,F-DTM,19,7,0,0,7,4,15
20190809-W-Toronto-QF-Serena_Williams-Naomi_Osaka,2,F-DTL,4,0,0,0,0,1,3
20190809-W-Toronto-QF-Serena_Williams-Naomi_Osaka,2,F-IO,4,1,1,0,0,1,3
20190809-W-Toronto-QF-Serena_Williams-Naomi_Osaka,2,B-XC,21,5,0,2,3,6,15
20190809-W-Toronto-QF-Serena_Williams-Naomi_Osaka,2,B-DTM,20,2,0,1,1,8,12
20190809-W-Toronto-QF-Serena_Williams-Naomi_Osaka,2,B-DTL,2,2,0,0,2,0,2
20190809-W-Toronto-QF-Serena_Williams-Naomi_Osaka,2,B-IO,7,3,1,0,2,4,3
20190809-W-Toronto-QF-Serena_Williams-Naomi_Osaka,2,S-XC,1,0,0,0,0,1,0
20190809-W-Toronto-QF-Serena_Williams-Naomi_Osaka,2,S-DTM,3,0,0,0,0,2,1
20190401-W-Charleston-R64-Anna_Lena_Friedsam-Tamara_Zidansek,1,F-XC,46,15,2,4,9,21,25
20190401-W-Charleston-R64-Anna_Lena_Friedsam-Tamara_Zidansek,1,F-DTM,26,6,0,0,6,12,14
20190401-W-Charleston-R64-Anna_Lena_Friedsam-Tamara_Zidansek,1,F-DTL,10,3,1,0,2,5,5
20190401-W-Charleston-R64-Anna_Lena_Friedsam-Tamara_Zidansek,1,F-IO,7,6,1,1,4,2,5
20190401-W-Charleston-R64-Anna_Lena_Friedsam-Tamara_Zidansek,1,B-XC,37,7,2,2,3,21,16
20190401-W-Charleston-R64-Anna_Lena_Friedsam-Tamara_Zidansek,1,B-DTM,12,3,0,0,3,1,11
20190401-W-Charleston-R64-Anna_Lena_Friedsam-Tamara_Zidansek,1,B-DTL,6,2,2,0,0,4,2
20190401-W-Charleston-R64-Anna_Lena_Friedsam-Tamara_Zidansek,1,B-IO,4,1,0,0,1,1,3
20190401-W-Charleston-R64-Anna_Lena_Friedsam-Tamara_Zidansek,1,S-XC,8,1,0,0,1,4,4
20190401-W-Charleston-R64-Anna_Lena_Friedsam-Tamara_Zidansek,1,S-DTM,5,0,0,0,0,2,3
20190401-W-Charleston-R64-Anna_Lena_Friedsam-Tamara_Zidansek,1,S-DTL,1,0,0,0,0,1,0
20190401-W-Charleston-R64-Anna_Lena_Friedsam-Tamara_Zidansek,2,F-XC,48,11,4,4,3,28,20
20190401-W-Charleston-R64-Anna_Lena_Friedsam-Tamara_Zidansek,2,F-DTM,17,2,0,0,2,6,11
20190401-W-Charleston-R64-Anna_Lena_Friedsam-Tamara_Zidansek,2,F-DTL,11,4,1,1,2,7,4
20190401-W-Charleston-R64-Anna_Lena_Friedsam-Tamara_Zidansek,2,F-IO,28,16,5,5,6,18,10
20190401-W-Charleston-R64-Anna_Lena_Friedsam-Tamara_Zidansek,2,F-II,4,1,1,0,0,3,1
20190401-W-Charleston-R64-Anna_Lena_Friedsam-Tamara_Zidansek,2,B-XC,20,3,0,1,2,9,11
20190401-W-Charleston-R64-Anna_Lena_Friedsam-Tamara_Zidansek,2,B-DTM,23,3,0,0,3,6,17
20190401-W-Charleston-R64-Anna_Lena_Friedsam-Tamara_Zidansek,2,B-DTL,8,4,2,0,2,5,3
20190401-W-Charleston-R64-Anna_Lena_Friedsam-Tamara_Zidansek,2,B-IO,2,0,0,0,0,2,0
20190401-W-Charleston-R64-Anna_Lena_Friedsam-Tamara_Zidansek,2,S-XC,4,2,0,0,2,0,4
20190401-W-Charleston-R64-Anna_Lena_Friedsam-Tamara_Zidansek,2,S-DTM,5,2,0,0,2,2,3
20190401-W-Charleston-R64-Anna_Lena_Friedsam-Tamara_Zidansek,2,S-DTL,3,1,0,0,1,1,2
19950115-W-Sydney-F-Lindsay_Davenport-Gabriela_Sabatini,1,F-XC,54,15,3,2,10,24,30
19950115-W-Sydney-F-Lindsay_Davenport-Gabriela_Sabatini,1,F-DTM,17,2,0,0,2,8,9
19950115-W-Sydney-F-Lindsay_Davenport-Gabriela_Sabatini,1,F-DTL,7,3,1,0,2,3,4
19950115-W-Sydney-F-Lindsay_Davenport-Gabriela_Sabatini,1,F-IO,12,6,2,0,4,5,7
19950115-W-Sydney-F-Lindsay_Davenport-Gabriela_Sabatini,1,B-XC,49,11,2,5,4,29,20
19950115-W-Sydney-F-Lindsay_Davenport-Gabriela_Sabatini,1,B-DTM,16,2,0,0,2,6,10
19950115-W-Sydney-F-Lindsay_Davenport-Gabriela_Sabatini,1,B-DTL,13,5,1,3,1,10,3
19950115-W-Sydney-F-Lindsay_Davenport-Gabriela_Sabatini,1,B-IO,9,2,1,0,1,7,2
19950115-W-Sydney-F-Lindsay_Davenport-Gabriela_Sabatini,1,S-XC,2,0,0,0,0,0,2
19950115-W-Sydney-F-Lindsay_Davenport-Gabriela_Sabatini,1,S-DTM,1,0,0,0,0,0,1
19950115-W-Sydney-F-Lindsay_Davenport-Gabriela_Sabatini,1,S-DTL,3,0,0,0,0,1,2
19950115-W-Sydney-F-Lindsay_Davenport-Gabriela_Sabatini,1,S-IO,1,0,0,0,0,0,1
19950115-W-Sydney-F-Lindsay_Davenport-Gabriela_Sabatini,2,F-XC,39,7,4,1,2,21,18
19950115-W-Sydney-F-Lindsay_Davenport-Gabriela_Sabatini,2,F-DTM,23,3,1,0,2,11,12
19950115-W-Sydney-F-Lindsay_Davenport-Gabriela_Sabatini,2,F-DTL,24,6,2,1,3,11,13
19950115-W-Sydney-F-Lindsay_Davenport-Gabriela_Sabatini,2,F-IO,12,4,0,2,2,9,3
19950115-W-Sydney-F-Lindsay_Davenport-Gabriela_Sabatini,2,B-XC,3,0,0,0,0,3,0
19950115-W-Sydney-F-Lindsay_Davenport-Gabriela_Sabatini,2,B-DTM,3,0,0,0,0,2,1
19950115-W-Sydney-F-Lindsay_Davenport-Gabriela_Sabatini,2,B-DTL,2,2,1,0,1,1,1
19950115-W-Sydney-F-Lindsay_Davenport-Gabriela_Sabatini,2,B-IO,5,2,0,0,2,2,3
19950115-W-Sydney-F-Lindsay_Davenport-Gabriela_Sabatini,2,S-XC,22,1,0,0,1,8,14
19950115-W-Sydney-F-Lindsay_Davenport-Gabriela_Sabatini,2,S-DTM,17,1,0,1,0,6,11
19950115-W-Sydney-F-Lindsay_Davenport-Gabriela_Sabatini,2,S-DTL,11,2,0,1,1,6,5
19950115-W-Sydney-F-Lindsay_Davenport-Gabriela_Sabatini,2,S-IO,4,0,0,0,0,3,1
20170915-W-ITF_Biarritz-QF-Jil_Teichmann-Polona_Hercog,1,F-XC,117,19,0,6,13,58,59
20170915-W-ITF_Biarritz-QF-Jil_Teichmann-Polona_Hercog,1,F-DTM,34,0,0,0,0,21,13
20170915-W-ITF_Biarritz-QF-Jil_Teichmann-Polona_Hercog,1,F-DTL,5,4,1,2,1,4,1
20170915-W-ITF_Biarritz-QF-Jil_Teichmann-Polona_Hercog,1,F-IO,16,7,3,2,2,11,5
20170915-W-ITF_Biarritz-QF-Jil_Teichmann-Polona_Hercog,1,F-II,8,2,0,1,1,5,3
20170915-W-ITF_Biarritz-QF-Jil_Teichmann-Polona_Hercog,1,B-XC,70,8,0,4,4,30,40
20170915-W-ITF_Biarritz-QF-Jil_Teichmann-Polona_Hercog,1,B-DTM,53,3,0,0,3,21,32
20170915-W-ITF_Biarritz-QF-Jil_Teichmann-Polona_Hercog,1,B-DTL,26,5,0,2,3,18,8
20170915-W-ITF_Biarritz-QF-Jil_Teichmann-Polona_Hercog,1,B-IO,7,1,0,0,1,3,4
20170915-W-ITF_Biarritz-QF-Jil_Teichmann-Polona_Hercog,1,S-XC,5,0,0,0,0,2,3
20170915-W-ITF_Biarritz-QF-Jil_Teichmann-Polona_Hercog,1,S-DTM,8,1,0,0,1,1,7
20170915-W-ITF_Biarritz-QF-Jil_Teichmann-Polona_Hercog,1,S-DTL,8,2,1,0,1,3,5
20170915-W-ITF_Biarritz-QF-Jil_Teichmann-Polona_Hercog,1,S-IO,5,0,0,0,0,2,3
20170915-W-ITF_Biarritz-QF-Jil_Teichmann-Polona_Hercog,2,F-XC,107,15,3,1,11,58,49
20170915-W-ITF_Biarritz-QF-Jil_Teichmann-Polona_Hercog,2,F-DTM,55,5,0,0,5,20,35
20170915-W-ITF_Biarritz-QF-Jil_Teichmann-Polona_Hercog,2,F-DTL,15,8,2,3,3,6,9
20170915-W-ITF_Biarritz-QF-Jil_Teichmann-Polona_Hercog,2,F-IO,61,15,3,4,8,26,35
20170915-W-ITF_Biarritz-QF-Jil_Teichmann-Polona_Hercog,2,F-II,18,3,1,0,2,12,6
20170915-W-ITF_Biarritz-QF-Jil_Teichmann-Polona_Hercog,2,B-XC,21,5,3,0,2,11,10
20170915-W-ITF_Biarritz-QF-Jil_Teichmann-Polona_Hercog,2,B-DTM,20,2,0,0,2,9,11
20170915-W-ITF_Biarritz-QF-Jil_Teichmann-Polona_Hercog,2,B-DTL,5,0,0,0,0,3,2
20170915-W-ITF_Biarritz-QF-Jil_Teichmann-Polona_Hercog,2,B-IO,3,2,1,1,0,3,0
20170915-W-ITF_Biarritz-QF-Jil_Teichmann-Polona_Hercog,2,S-XC,11,2,0,0,2,5,6
20170915-W-ITF_Biarritz-QF-Jil_Teichmann-Polona_Hercog,2,S-DTM,24,2,0,1,1,13,11
20170915-W-ITF_Biarritz-QF-Jil_Teichmann-Polona_Hercog,2,S-DTL,11,1,0,1,0,7,4
20170915-W-ITF_Biarritz-QF-Jil_Teichmann-Polona_Hercog,2,S-IO,1,0,0,0,0,0,1
20040411-W-Amelia_Island-F-Amelie_Mauresmo-Lindsay_Davenport,1,F-XC,24,7,2,3,2,11,13
20040411-W-Amelia_Island-F-Amelie_Mauresmo-Lindsay_Davenport,1,F-DTM,5,1,0,0,1,1,4
20040411-W-Amelia_Island-F-Amelie_Mauresmo-Lindsay_Davenport,1,F-DTL,15,2,1,0,1,5,10
20040411-W-Amelia_Island-F-Amelie_Mauresmo-Lindsay_Davenport,1,F-IO,9,2,0,2,0,5,4
20040411-W-Amelia_Island-F-Amelie_Mauresmo-Lindsay_Davenport,1,B-XC,16,5,2,2,1,8,8
20040411-W-Amelia_Island-F-Amelie_Mauresmo-Lindsay_Davenport,1,B-DTM,10,2,0,0,2,3,7
20040411-W-Amelia_Island-F-Amelie_Mauresmo-Lindsay_Davenport,1,B-DTL,11,8,3,1,4,4,7
20040411-W-Amelia_Island-F-Amelie_Mauresmo-Lindsay_Davenport,1,B-IO,4,1,1,0,0,4,0
20040411-W-Amelia_Island-F-Amelie_Mauresmo-Lindsay_Davenport,1,S-XC,15,0,0,0,0,6,9
20040411-W-Amelia_Island-F-Amelie_Mauresmo-Lindsay_Davenport,1,S-DTM,9,1,0,0,1,4,5
20040411-W-Amelia_Island-F-Amelie_Mauresmo-Lindsay_Davenport,1,S-DTL,4,0,0,0,0,0,4
20040411-W-Amelia_Island-F-Amelie_Mauresmo-Lindsay_Davenport,2,F-XC,35,13,6,4,3,23,12
20040411-W-Amelia_Island-F-Amelie_Mauresmo-Lindsay_Davenport,2,F-DTM,7,1,0,1,0,5,2
20040411-W-Amelia_Island-F-Amelie_Mauresmo-Lindsay_Davenport,2,F-DTL,5,2,1,0,1,2,3
20040411-W-Amelia_Island-F-Amelie_Mauresmo-Lindsay_Davenport,2,F-IO,11,3,1,0,2,5,6
20040411-W-Amelia_Island-F-Amelie_Mauresmo-Lindsay_Davenport,2,B-XC,48,12,3,4,5,33,15
20040411-W-Amelia_Island-F-Amelie_Mauresmo-Lindsay_Davenport,2,B-DTM,5,0,0,0,0,2,3
20040411-W-Amelia_Island-F-Amelie_Mauresmo-Lindsay_Davenport,2,B-DTL,13,6,2,1,3,6,7
20040411-W-Amelia_Island-F-Amelie_Mauresmo-Lindsay_Davenport,2,B-IO,4,3,0,0,3,1,3
20040411-W-Amelia_Island-F-Amelie_Mauresmo-Lindsay_Davenport,2,S-XC,3,0,0,0,0,2,1
19980702-W-Wimbledon-SF-Martina_Hingis-Jana_Novotna,1,F-XC,32,9,3,1,5,17,15
19980702-W-Wimbledon-SF-Martina_Hingis-Jana_Novotna,1,F-DTM,13,0,0,0,0,7,6
19980702-W-Wimbledon-SF-Martina_Hingis-Jana_Novotna,1,F-DTL,26,4,2,1,1,15,11
19980702-W-Wimbledon-SF-Martina_Hingis-Jana_Novotna,1,F-IO,7,0,0,0,0,4,3
19980702-W-Wimbledon-SF-Martina_Hingis-Jana_Novotna,1,B-XC,67,9,3,2,4,32,35
19980702-W-Wimbledon-SF-Martina_Hingis-Jana_Novotna,1,B-DTM,15,1,0,0,1,7,8
19980702-W-Wimbledon-SF-Martina_Hingis-Jana_Novotna,1,B-DTL,16,4,2,0,2,5,11
19980702-W-Wimbledon-SF-Martina_Hingis-Jana_Novotna,1,B-IO,10,5,1,2,2,6,4
19980702-W-Wimbledon-SF-Martina_Hingis-Jana_Novotna,1,S-XC,3,1,1,0,0,3,0
19980702-W-Wimbledon-SF-Martina_Hingis-Jana_Novotna,1,S-DTM,2,0,0,0,0,0,2
19980702-W-Wimbledon-SF-Martina_Hingis-Jana_Novotna,1,S-DTL,3,1,0,1,0,1,2
19980702-W-Wimbledon-SF-Martina_Hingis-Jana_Novotna,1,S-IO,1,1,0,0,1,0,1
19980702-W-Wimbledon-SF-Martina_Hingis-Jana_Novotna,2,F-XC,32,5,0,2,3,14,18
19980702-W-Wimbledon-SF-Martina_Hingis-Jana_Novotna,2,F-DTM,9,0,0,0,0,4,5
19980702-W-Wimbledon-SF-Martina_Hingis-Jana_Novotna,2,F-DTL,12,5,3,1,1,8,4
19980702-W-Wimbledon-SF-Martina_Hingis-Jana_Novotna,2,F-IO,10,4,0,4,0,9,1
19980702-W-Wimbledon-SF-Martina_Hingis-Jana_Novotna,2,B-XC,1,1,1,0,0,1,0
19980702-W-Wimbledon-SF-Martina_Hingis-Jana_Novotna,2,B-DTL,2,1,1,0,0,2,0
19980702-W-Wimbledon-SF-Martina_Hingis-Jana_Novotna,2,S-XC,70,10,0,4,6,34,36
19980702-W-Wimbledon-SF-Martina_Hingis-Jana_Novotna,2,S-DTM,14,2,0,0,2,9,5
19980702-W-Wimbledon-SF-Martina_Hingis-Jana_Novotna,2,S-DTL,26,2,0,0,2,10,16
19980702-W-Wimbledon-SF-Martina_Hingis-Jana_Novotna,2,S-IO,11,1,0,0,1,6,5
20051113-W-WTA_Championships-F-Amelie_Mauresmo-Mary_Pierce,1,F-XC,100,17,8,1,8,63,37
20051113-W-WTA_Championships-F-Amelie_Mauresmo-Mary_Pierce,1,F-DTM,55,2,0,0,2,27,28
20051113-W-WTA_Championships-F-Amelie_Mauresmo-Mary_Pierce,1,F-DTL,39,4,0,1,3,21,18
20051113-W-WTA_Championships-F-Amelie_Mauresmo-Mary_Pierce,1,F-IO,24,8,2,4,2,14,10
20051113-W-WTA_Championships-F-Amelie_Mauresmo-Mary_Pierce,1,F-II,1,0,0,0,0,1,0
20051113-W-WTA_Championships-F-Amelie_Mauresmo-Mary_Pierce,1,B-XC,26,6,3,1,2,17,9
20051113-W-WTA_Championships-F-Amelie_Mauresmo-Mary_Pierce,1,B-DTM,20,0,0,0,0,11,9
20051113-W-WTA_Championships-F-Amelie_Mauresmo-Mary_Pierce,1,B-DTL,4,2,1,0,1,1,3
20051113-W-WTA_Championships-F-Amelie_Mauresmo-Mary_Pierce,1,B-IO,4,2,0,1,1,2,2
20051113-W-WTA_Championships-F-Amelie_Mauresmo-Mary_Pierce,1,S-XC,34,2,1,0,1,18,16
20051113-W-WTA_Championships-F-Amelie_Mauresmo-Mary_Pierce,1,S-DTM,19,1,0,0,1,11,8
20051113-W-WTA_Championships-F-Amelie_Mauresmo-Mary_Pierce,1,S-DTL,4,3,2,1,0,3,1
20051113-W-WTA_Championships-F-Amelie_Mauresmo-Mary_Pierce,1,S-IO,1,0,0,0,0,1,0
20051113-W-WTA_Championships-F-Amelie_Mauresmo-Mary_Pierce,2,F-XC,92,23,9,3,11,36,56
20051113-W-WTA_Championships-F-Amelie_Mauresmo-Mary_Pierce,2,F-DTM,24,1,0,0,1,12,12
20051113-W-WTA_Championships-F-Amelie_Mauresmo-Mary_Pierce,2,F-DTL,39,12,3,2,7,14,25
20051113-W-WTA_Championships-F-Amelie_Mauresmo-Mary_Pierce,2,F-IO,27,15,5,3,7,16,11
20051113-W-WTA_Championships-F-Amelie_Mauresmo-Mary_Pierce,2,F-II,4,0,0,0,0,1,3
20051113-W-WTA_Championships-F-Amelie_Mauresmo-Mary_Pierce,2,B-XC,63,25,10,5,10,35,28
20051113-W-WTA_Championships-F-Amelie_Mauresmo-Mary_Pierce,2,B-DTM,26,1,0,0,1,8,18
20051113-W-WTA_Championships-F-Amelie_Mauresmo-Mary_Pierce,2,B-DTL,43,13,3,6,4,19,24
20051113-W-WTA_Championships-F-Amelie_Mauresmo-Mary_Pierce,2,B-IO,18,5,2,2,1,10,8
20051113-W-WTA_Championships-F-Amelie_Mauresmo-Mary_Pierce,2,S-XC,2,0,0,0,0,0,2
20051113-W-WTA_Championships-F-Amelie_Mauresmo-Mary_Pierce,2,S-DTM,2,0,0,0,0,0,2
20051113-W-WTA_Championships-F-Amelie_Mauresmo-Mary_Pierce,2,S-DTL,1,1,0,0,1,0,1
20130603-W-ITF_Nottingham-R32-An_Sophie_Mestach-Johanna_Konta,1,F-XC,25,13,4,3,6,11,14
20130603-W-ITF_Nottingham-R32-An_Sophie_Mestach-Johanna_Konta,1,F-DTM,11,2,0,0,2,5,6
20130603-W-ITF_Nottingham-R32-An_Sophie_Mestach-Johanna_Konta,1,F-DTL,11,5,4,1,0,6,5
20130603-W-ITF_Nottingham-R32-An_Sophie_Mestach-Johanna_Konta,1,F-IO,16,8,1,3,4,8,8
20130603-W-ITF_Nottingham-R32-An_Sophie_Mestach-Johanna_Konta,1,F-II,1,0,0,0,0,0,1
20130603-W-ITF_Nottingham-R32-An_Sophie_Mestach-Johanna_Konta,1,B-XC,10,2,0,0,2,2,8
20130603-W-ITF_Nottingham-R32-An_Sophie_Mestach-Johanna_Konta,1,B-DTM,6,0,0,0,0,2,4
20130603-W-ITF_Nottingham-R32-An_Sophie_Mestach-Johanna_Konta,1,B-DTL,6,1,0,0,1,1,5
20130603-W-ITF_Nottingham-R32-An_Sophie_Mestach-Johanna_Konta,1,B-IO,2,2,0,1,1,1,1
20130603-W-ITF_Nottingham-R32-An_Sophie_Mestach-Johanna_Konta,1,S-XC,10,2,0,0,2,3,7
20130603-W-ITF_Nottingham-R32-An_Sophie_Mestach-Johanna_Konta,1,S-DTM,5,1,0,0,1,4,1
20130603-W-ITF_Nottingham-R32-An_Sophie_Mestach-Johanna_Konta,1,S-IO,1,0,0,0,0,0,1
20130603-W-ITF_Nottingham-R32-An_Sophie_Mestach-Johanna_Konta,2,F-XC,22,7,2,1,4,13,9
20130603-W-ITF_Nottingham-R32-An_Sophie_Mestach-Johanna_Konta,2,F-DTM,9,1,0,0,1,6,3
20130603-W-ITF_Nottingham-R32-An_Sophie_Mestach-Johanna_Konta,2,F-DTL,6,3,0,1,2,3,3
20130603-W-ITF_Nottingham-R32-An_Sophie_Mestach-Johanna_Konta,2,F-IO,12,2,1,0,1,5,7
20130603-W-ITF_Nottingham-R32-An_Sophie_Mestach-Johanna_Konta,2,F-II,2,2,1,1,0,2,0
20130603-W-ITF_Nottingham-R32-An_Sophie_Mestach-Johanna_Konta,2,B-XC,22,5,1,0,4,12,10
20130603-W-ITF_Nottingham-R32-An_Sophie_Mestach-Johanna_Konta,2,B-DTM,13,1,1,0,0,9,4
20130603-W-ITF_Nottingham-R32-An_Sophie_Mestach-Johanna_Konta,2,B-DTL,8,4,2,1,1,5,3
20130603-W-ITF_Nottingham-R32-An_Sophie_Mestach-Johanna_Konta,2,B-IO,5,1,1,0,0,2,3
20130603-W-ITF_Nottingham-R32-An_Sophie_Mestach-Johanna_Konta,2,S-DTL,1,1,0,0,1,0,1
20130603-W-ITF_Nottingham-R32-An_Sophie_Mestach-Johanna_Konta,2,S-IO,1,0,0,0,0,1,0
20140707-W-ITF_Sacramento-R32-Nicole_Gibbs-Alexandra_Stevenson,1,F-XC,18,5,4,1,0,15,3
20140707-W-ITF_Sacramento-R32-Nicole_Gibbs-Alexandra_Stevenson,1,F-DTM,7,1,0,0,1,6,1
20140707-W-ITF_Sacramento-R32-Nicole_Gibbs-Alexandra_Stevenson,1,F-DTL,4,1,0,1,0,4,0
20140707-W-ITF_Sacramento-R32-Nicole_Gibbs-Alexandra_Stevenson,1,F-IO,17,7,3,1,3,12,5
20140707-W-ITF_Sacramento-R32-Nicole_Gibbs-Alexandra_Stevenson,1,F-II,3,1,0,1,0,3,0
20140707-W-ITF_Sacramento-R32-Nicole_Gibbs-Alexandra_Stevenson,1,B-XC,25,6,1,0,5,13,12
20140707-W-ITF_Sacramento-R32-Nicole_Gibbs-Alexandra_Stevenson,1,B-DTM,14,2,0,0,2,9,5
20140707-W-ITF_Sacramento-R32-Nicole_Gibbs-Alexandra_Stevenson,1,B-DTL,8,4,1,1,2,5,3
20140707-W-ITF_Sacramento-R32-Nicole_Gibbs-Alexandra_Stevenson,1,B-IO,4,3,0,2,1,3,1
20140707-W-ITF_Sacramento-R32-Nicole_Gibbs-Alexandra_Stevenson,1,S-XC,6,0,0,0,0,5,1
20140707-W-ITF_Sacramento-R32-Nicole_Gibbs-Alexandra_Stevenson,1,S-DTM,7,0,0,0,0,6,1
20140707-W-ITF_Sacramento-R32-Nicole_Gibbs-Alexandra_Stevenson,1,S-DTL,2,2,0,1,1,1,1
20140707-W-ITF_Sacramento-R32-Nicole_Gibbs-Alexandra_Stevenson,2,F-XC,13,4,0,2,2,4,9
20140707-W-ITF_Sacramento-R32-Nicole_Gibbs-Alexandra_Stevenson,2,F-DTM,14,1,0,0,1,2,12
20140707-W-ITF_Sacramento-R32-Nicole_Gibbs-Alexandra_Stevenson,2,F-DTL,8,1,0,0,1,3,5
20140707-W-ITF_Sacramento-R32-Nicole_Gibbs-Alexandra_Stevenson,2,F-IO,22,8,3,0,5,6,16
20140707-W-ITF_Sacramento-R32-Nicole_Gibbs-Alexandra_Stevenson,2,F-II,1,1,1,0,0,1,0
20140707-W-ITF_Sacramento-R32-Nicole_Gibbs-Alexandra_Stevenson,2,B-XC,21,7,0,1,6,4,17
20140707-W-ITF_Sacramento-R32-Nicole_Gibbs-Alexandra_Stevenson,2,B-DTM,8,1,0,0,1,3,5
20140707-W-ITF_Sacramento-R32-Nicole_Gibbs-Alexandra_Stevenson,2,B-DTL,1,1,0,0,1,0,1
20140707-W-ITF_Sacramento-R32-Nicole_Gibbs-Alexandra_Stevenson,2,B-IO,1,1,1,0,0,1,0
20140707-W-ITF_Sacramento-R32-Nicole_Gibbs-Alexandra_Stevenson,2,S-XC,14,2,0,0,2,2,12
20140707-W-ITF_Sacramento-R32-Nicole_Gibbs-Alexandra_Stevenson,2,S-DTM,4,2,0,0,2,1,3
20040801-W-San_Diego-F-Lindsay_Davenport-Anastasia_Myskina,1,F-XC,27,9,2,3,4,17,10
20040801-W-San_Diego-F-Lindsay_Davenport-Anastasia_Myskina,1,F-DTM,5,0,0,0,0,1,4
20040801-W-San_Diego-F-Lindsay_Davenport-Anastasia_Myskina,1,F-DTL,4,1,0,0,1,3,1
20040801-W-San_Diego-F-Lindsay_Davenport-Anastasia_Myskina,1,F-IO,7,4,2,2,0,7,0
20040801-W-San_Diego-F-Lindsay_Davenport-Anastasia_Myskina,1,B-XC,29,5,1,2,2,22,7
20040801-W-San_Diego-F-Lindsay_Davenport-Anastasia_Myskina,1,B-DTM,10,1,0,0,1,4,6
20040801-W-San_Diego-F-Lindsay_Davenport-Anastasia_Myskina,1,B-DTL,3,2,1,0,1,2,1
20040801-W-San_Diego-F-Lindsay_Davenport-Anastasia_Myskina,1,B-IO,5,1,0,0,1,4,1
20040801-W-San_Diego-F-Lindsay_Davenport-Anastasia_Myskina,1,S-XC,1,0,0,0,0,1,0
20040801-W-San_Diego-F-Lindsay_Davenport-Anastasia_Myskina,2,F-XC,21,6,2,0,4,9,12
20040801-W-San_Diego-F-Lindsay_Davenport-Anastasia_Myskina,2,F-DTM,9,0,0,0,0,2,7
20040801-W-San_Diego-F-Lindsay_Davenport-Anastasia_Myskina,2,F-DTL,6,2,0,0,2,2,4
20040801-W-San_Diego-F-Lindsay_Davenport-Anastasia_Myskina,2,F-IO,4,1,0,1,0,3,1
20040801-W-San_Diego-F-Lindsay_Davenport-Anastasia_Myskina,2,B-XC,22,8,0,1,7,5,17
20040801-W-San_Diego-F-Lindsay_Davenport-Anastasia_Myskina,2,B-DTM,14,3,0,0,3,3,11
20040801-W-San_Diego-F-Lindsay_Davenport-Anastasia_Myskina,2,B-DTL,6,5,2,1,2,3,3
20040801-W-San_Diego-F-Lindsay_Davenport-Anastasia_Myskina,2,B-IO,3,1,1,0,0,1,2
20040801-W-San_Diego-F-Lindsay_Davenport-Anastasia_Myskina,2,S-DTM,3,0,0,0,0,0,3
20021107-W-WTA_Tour_Championships-R16-Jelena_Dokic-Anastasia_Myskina,1,F-XC,39,7,1,1,5,20,19
20021107-W-WTA_Tour_Championships-R16-Jelena_Dokic-Anastasia_Myskina,1,F-DTM,6,1,0,0,1,3,3
20021107-W-WTA_Tour_Championships-R16-Jelena_Dokic-Anastasia_Myskina,1,F-DTL,7,2,0,1,1,1,6
20021107-W-WTA_Tour_Championships-R16-Jelena_Dokic-Anastasia_Myskina,1,F-IO,4,1,0,0,1,3,1
20021107-W-WTA_Tour_Championships-R16-Jelena_Dokic-Anastasia_Myskina,1,F-II,1,1,0,1,0,1,0
20021107-W-WTA_Tour_Championships-R16-Jelena_Dokic-Anastasia_Myskina,1,B-XC,45,17,3,5,9,29,16
20021107-W-WTA_Tour_Championships-R16-Jelena_Dokic-Anastasia_Myskina,1,B-DTM,16,1,0,1,0,10,6
20021107-W-WTA_Tour_Championships-R16-Jelena_Dokic-Anastasia_Myskina,1,B-DTL,6,2,0,0,2,3,3
20021107-W-WTA_Tour_Championships-R16-Jelena_Dokic-Anastasia_Myskina,1,B-IO,7,5,1,0,4,2,5
20021107-W-WTA_Tour_Championships-R16-Jelena_Dokic-Anastasia_Myskina,1,S-XC,1,0,0,0,0,1,0
20021107-W-WTA_Tour_Championships-R16-Jelena_Dokic-Anastasia_Myskina,1,S-DTM,1,0,0,0,0,0,1
20021107-W-WTA_Tour_Championships-R16-Jelena_Dokic-Anastasia_Myskina,2,F-XC,17,5,1,2,2,11,6
20021107-W-WTA_Tour_Championships-R16-Jelena_Dokic-Anastasia_Myskina,2,F-DTM,13,1,0,0,1,4,9
20021107-W-WTA_Tour_Championships-R16-Jelena_Dokic-Anastasia_Myskina,2,F-DTL,17,3,1,0,2,9,8
20021107-W-WTA_Tour_Championships-R16-Jelena_Dokic-Anastasia_Myskina,2,F-IO,8,4,1,1,2,3,5
20021107-W-WTA_Tour_Championships-R16-Jelena_Dokic-Anastasia_Myskina,2,F-II,1,1,0,0,1,0,1
20021107-W-WTA_Tour_Championships-R16-Jelena_Dokic-Anastasia_Myskina,2,B-XC,27,2,1,0,1,11,16
20021107-W-WTA_Tour_Championships-R16-Jelena_Dokic-Anastasia_Myskina,2,B-DTM,19,2,0,0,2,8,11
20021107-W-WTA_Tour_Championships-R16-Jelena_Dokic-Anastasia_Myskina,2,B-DTL,7,5,0,1,4,3,4
20021107-W-WTA_Tour_Championships-R16-Jelena_Dokic-Anastasia_Myskina,2,B-IO,5,3,0,2,1,3,2
20021107-W-WTA_Tour_Championships-R16-Jelena_Dokic-Anastasia_Myskina,2,S-DTM,1,0,0,0,0,0,1
20050515-W-Rome-F-Amelie_Mauresmo-Patty_Schnyder,1,F-XC,104,14,5,0,9,54,50
20050515-W-Rome-F-Amelie_Mauresmo-Patty_Schnyder,1,F-DTM,11,0,0,0,0,5,6
20050515-W-Rome-F-Amelie_Mauresmo-Patty_Schnyder,1,F-DTL,11,5,1,1,3,5,6
20050515-W-Rome-F-Amelie_Mauresmo-Patty_Schnyder,1,F-IO,11,2,0,0,2,4,7
20050515-W-Rome-F-Amelie_Mauresmo-Patty_Schnyder,1,F-II,2,1,1,0,0,1,1
20050515-W-Rome-F-Amelie_Mauresmo-Patty_Schnyder,1,B-XC,85,12,2,1,9,48,37
20050515-W-Rome-F-Amelie_Mauresmo-Patty_Schnyder,1,B-DTM,41,1,0,0,1,24,17
20050515-W-Rome-F-Amelie_Mauresmo-Patty_Schnyder,1,B-DTL,43,7,3,2,2,26,17
20050515-W-Rome-F-Amelie_Mauresmo-Patty_Schnyder,1,B-IO,11,2,0,0,2,4,7
20050515-W-Rome-F-Amelie_Mauresmo-Patty_Schnyder,1,B-II,1,0,0,0,0,1,0
20050515-W-Rome-F-Amelie_Mauresmo-Patty_Schnyder,1,S-XC,13,3,1,0,2,5,8
20050515-W-Rome-F-Amelie_Mauresmo-Patty_Schnyder,1,S-DTM,2,0,0,0,0,1,1
20050515-W-Rome-F-Amelie_Mauresmo-Patty_Schnyder,1,S-DTL,11,1,1,0,0,7,4
20050515-W-Rome-F-Amelie_Mauresmo-Patty_Schnyder,2,F-XC,108,9,1,5,3,53,55
20050515-W-Rome-F-Amelie_Mauresmo-Patty_Schnyder,2,F-DTM,16,0,0,0,0,7,9
20050515-W-Rome-F-Amelie_Mauresmo-Patty_Schnyder,2,F-DTL,18,7,1,3,3,10,8
20050515-W-Rome-F-Amelie_Mauresmo-Patty_Schnyder,2,F-IO,14,3,2,0,1,11,3
20050515-W-Rome-F-Amelie_Mauresmo-Patty_Schnyder,2,F-II,5,2,1,1,0,3,2
20050515-W-Rome-F-Amelie_Mauresmo-Patty_Schnyder,2,B-XC,67,15,2,3,10,30,37
20050515-W-Rome-F-Amelie_Mauresmo-Patty_Schnyder,2,B-DTM,47,4,0,0,4,19,28
20050515-W-Rome-F-Amelie_Mauresmo-Patty_Schnyder,2,B-DTL,48,12,2,1,9,22,26
20050515-W-Rome-F-Amelie_Mauresmo-Patty_Schnyder,2,B-IO,9,1,0,0,1,5,4
20050515-W-Rome-F-Amelie_Mauresmo-Patty_Schnyder,2,S-XC,2,1,1,0,0,2,0
20050515-W-Rome-F-Amelie_Mauresmo-Patty_Schnyder,2,S-DTM,2,0,0,0,0,0,2
20050515-W-Rome-F-Amelie_Mauresmo-Patty_Schnyder,2,S-DTL,10,2,1,0,1,4,6
20050515-W-Rome-F-Amelie_Mauresmo-Patty_Schnyder,2,S-IO,1,0,0,0,0,0,1
20020604-W-Roland_Garros-QF-Jelena_Dokic-Jennifer_Capriati,1,F-XC,55,16,4,5,7,31,24
20020604-W-Roland_Garros-QF-Jelena_Dokic-Jennifer_Capriati,1,F-DTM,14,1,0,0,1,6,8
20020604-W-Roland_Garros-QF-Jelena_Dokic-Jennifer_Capriati,1,F-DTL,33,15,6,3,6,19,14
20020604-W-Roland_Garros-QF-Jelena_Dokic-Jennifer_Capriati,1,F-IO,21,8,4,1,3,13,8
20020604-W-Roland_Garros-QF-Jelena_Dokic-Jennifer_Capriati,1,F-II,2,0,0,0,0,0,2
20020604-W-Roland_Garros-QF-Jelena_Dokic-Jennifer_Capriati,1,B-XC,61,12,1,3,8,23,38
20020604-W-Roland_Garros-QF-Jelena_Dokic-Jennifer_Capriati,1,B-DTM,11,0,0,0,0,6,5
20020604-W-Roland_Garros-QF-Jelena_Dokic-Jennifer_Capriati,1,B-DTL,8,5,3,0,2,4,4
20020604-W-Roland_Garros-QF-Jelena_Dokic-Jennifer_Capriati,1,B-IO,4,3,0,1,2,1,3
20020604-W-Roland_Garros-QF-Jelena_Dokic-Jennifer_Capriati,1,S-IO,2,0,0,0,0,1,1
20020604-W-Roland_Garros-QF-Jelena_Dokic-Jennifer_Capriati,2,F-XC,36,4,0,2,2,20,16
20020604-W-Roland_Garros-QF-Jelena_Dokic-Jennifer_Capriati,2,F-DTM,17,3,0,0,3,7,10
20020604-W-Roland_Garros-QF-Jelena_Dokic-Jennifer_Capriati,2,F-DTL,18,6,2,0,4,9,9
20020604-W-Roland_Garros-QF-Jelena_Dokic-Jennifer_Capriati,2,F-IO,6,0,0,0,0,2,4
20020604-W-Roland_Garros-QF-Jelena_Dokic-Jennifer_Capriati,2,F-II,3,1,1,0,0,2,1
20020604-W-Roland_Garros-QF-Jelena_Dokic-Jennifer_Capriati,2,B-XC,38,7,1,2,4,24,14
20020604-W-Roland_Garros-QF-Jelena_Dokic-Jennifer_Capriati,2,B-DTM,31,3,0,0,3,12,19
20020604-W-Roland_Garros-QF-Jelena_Dokic-Jennifer_Capriati,2,B-DTL,22,8,4,0,4,9,13
20020604-W-Roland_Garros-QF-Jelena_Dokic-Jennifer_Capriati,2,B-IO,8,2,0,0,2,5,3
20020604-W-Roland_Garros-QF-Jelena_Dokic-Jennifer_Capriati,2,S-XC,4,0,0,0,0,2,2
20020604-W-Roland_Garros-QF-Jelena_Dokic-Jennifer_Capriati,2,S-DTM,6,0,0,0,0,3,3
20020604-W-Roland_Garros-QF-Jelena_Dokic-Jennifer_Capriati,2,S-DTL,3,0,0,0,0,1,2
19990128-W-Australian_Open-SF-Amelie_Mauresmo-Lindsay_Davenport,1,F-XC,53,15,7,3,5,28,25
19990128-W-Australian_Open-SF-Amelie_Mauresmo-Lindsay_Davenport,1,F-DTM,21,0,0,0,0,8,13
19990128-W-Australian_Open-SF-Amelie_Mauresmo-Lindsay_Davenport,1,F-DTL,32,16,4,5,7,15,17
19990128-W-Australian_Open-SF-Amelie_Mauresmo-Lindsay_Davenport,1,F-IO,20,8,4,0,4,8,12
19990128-W-Australian_Open-SF-Amelie_Mauresmo-Lindsay_Davenport,1,F-II,5,4,3,0,1,4,1
19990128-W-Australian_Open-SF-Amelie_Mauresmo-Lindsay_Davenport,1,B-XC,20,6,2,1,3,10,10
19990128-W-Australian_Open-SF-Amelie_Mauresmo-Lindsay_Davenport,1,B-DTM,16,2,0,0,2,6,10
19990128-W-Australian_Open-SF-Amelie_Mauresmo-Lindsay_Davenport,1,B-DTL,12,9,6,0,3,9,3
19990128-W-Australian_Open-SF-Amelie_Mauresmo-Lindsay_Davenport,1,B-IO,5,2,1,0,1,1,4
19990128-W-Australian_Open-SF-Amelie_Mauresmo-Lindsay_Davenport,1,S-XC,12,1,1,0,0,6,6
19990128-W-Australian_Open-SF-Amelie_Mauresmo-Lindsay_Davenport,1,S-DTM,13,1,0,0,1,7,6
19990128-W-Australian_Open-SF-Amelie_Mauresmo-Lindsay_Davenport,1,S-DTL,9,1,0,1,0,7,2
19990128-W-Australian_Open-SF-Amelie_Mauresmo-Lindsay_Davenport,1,S-IO,1,0,0,0,0,1,0
19990128-W-Australian_Open-SF-Amelie_Mauresmo-Lindsay_Davenport,2,F-XC,62,14,3,2,9,27,35
19990128-W-Australian_Open-SF-Amelie_Mauresmo-Lindsay_Davenport,2,F-DTM,10,1,0,0,1,5,5
19990128-W-Australian_Open-SF-Amelie_Mauresmo-Lindsay_Davenport,2,F-DTL,15,9,5,2,2,10,5
19990128-W-Australian_Open-SF-Amelie_Mauresmo-Lindsay_Davenport,2,F-IO,11,1,0,0,1,3,8
19990128-W-Australian_Open-SF-Amelie_Mauresmo-Lindsay_Davenport,2,B-XC,62,14,5,5,4,30,32
19990128-W-Australian_Open-SF-Amelie_Mauresmo-Lindsay_Davenport,2,B-DTM,18,1,0,0,1,13,5
19990128-W-Australian_Open-SF-Amelie_Mauresmo-Lindsay_Davenport,2,B-DTL,16,6,3,1,2,12,4
19990128-W-Australian_Open-SF-Amelie_Mauresmo-Lindsay_Davenport,2,B-IO,17,7,5,1,1,12,5
19990128-W-Australian_Open-SF-Amelie_Mauresmo-Lindsay_Davenport,2,S-DTM,1,0,0,0,0,0,1
20040808-W-Montreal-F-Amelie_Mauresmo-Elena_Likhovtseva,1,F-XC,29,5,3,2,0,23,6
20040808-W-Montreal-F-Amelie_Mauresmo-Elena_Likhovtseva,1,F-DTM,13,1,1,0,0,9,4
20040808-W-Montreal-F-Amelie_Mauresmo-Elena_Likhovtseva,1,F-DTL,10,4,2,1,1,6,4
20040808-W-Montreal-F-Amelie_Mauresmo-Elena_Likhovtseva,1,F-IO,11,2,1,0,1,7,4
20040808-W-Montreal-F-Amelie_Mauresmo-Elena_Likhovtseva,1,F-II,3,2,1,0,1,2,1
20040808-W-Montreal-F-Amelie_Mauresmo-Elena_Likhovtseva,1,B-XC,23,6,4,1,1,12,11
20040808-W-Montreal-F-Amelie_Mauresmo-Elena_Likhovtseva,1,B-DTM,19,3,0,1,2,11,8
20040808-W-Montreal-F-Amelie_Mauresmo-Elena_Likhovtseva,1,B-DTL,5,3,2,0,1,4,1
20040808-W-Montreal-F-Amelie_Mauresmo-Elena_Likhovtseva,1,B-IO,2,1,1,0,0,2,0
20040808-W-Montreal-F-Amelie_Mauresmo-Elena_Likhovtseva,1,S-XC,15,0,0,0,0,7,8
20040808-W-Montreal-F-Amelie_Mauresmo-Elena_Likhovtseva,1,S-DTM,3,0,0,0,0,1,2
20040808-W-Montreal-F-Amelie_Mauresmo-Elena_Likhovtseva,1,S-DTL,2,0,0,0,0,1,1
20040808-W-Montreal-F-Amelie_Mauresmo-Elena_Likhovtseva,2,F-XC,18,4,0,1,3,6,12
20040808-W-Montreal-F-Amelie_Mauresmo-Elena_Likhovtseva,2,F-DTM,14,1,0,0,1,3,11
20040808-W-Montreal-F-Amelie_Mauresmo-Elena_Likhovtseva,2,F-DTL,11,2,0,0,2,3,8
20040808-W-Montreal-F-Amelie_Mauresmo-Elena_Likhovtseva,2,F-IO,24,5,3,0,2,10,14
20040808-W-Montreal-F-Amelie_Mauresmo-Elena_Likhovtseva,2,F-II,3,1,0,1,0,2,1
20040808-W-Montreal-F-Amelie_Mauresmo-Elena_Likhovtseva,2,B-XC,30,6,2,1,3,18,12
20040808-W-Montreal-F-Amelie_Mauresmo-Elena_Likhovtseva,2,B-DTM,15,3,0,0,3,3,12
20040808-W-Montreal-F-Amelie_Mauresmo-Elena_Likhovtseva,2,B-DTL,16,4,2,0,2,7,9
20040808-W-Montreal-F-Amelie_Mauresmo-Elena_Likhovtseva,2,B-IO,6,2,1,0,1,2,4
20040808-W-Montreal-F-Amelie_Mauresmo-Elena_Likhovtseva,2,S-XC,2,0,0,0,0,0,2
20190910-W-Hiroshima-R32-Risa_Ozaki-Su_Wei_Hsieh,1,F-XC,41,6,1,0,5,10,31
20190910-W-Hiroshima-R32-Risa_Ozaki-Su_Wei_Hsieh,1,F-DTM,24,2,1,0,1,10,14
20190910-W-Hiroshima-R32-Risa_Ozaki-Su_Wei_Hsieh,1,F-DTL,19,9,2,2,5,9,10
20190910-W-Hiroshima-R32-Risa_Ozaki-Su_Wei_Hsieh,1,F-IO,19,3,1,0,2,7,12
20190910-W-Hiroshima-R32-Risa_Ozaki-Su_Wei_Hsieh,1,F-II,3,1,1,0,0,1,2
20190910-W-Hiroshima-R32-Risa_Ozaki-Su_Wei_Hsieh,1,B-XC,39,4,1,0,3,21,18
20190910-W-Hiroshima-R32-Risa_Ozaki-Su_Wei_Hsieh,1,B-DTM,31,2,0,0,2,14,17
20190910-W-Hiroshima-R32-Risa_Ozaki-Su_Wei_Hsieh,1,B-DTL,12,5,3,0,2,5,7
20190910-W-Hiroshima-R32-Risa_Ozaki-Su_Wei_Hsieh,1,B-IO,3,2,0,2,0,2,1
20190910-W-Hiroshima-R32-Risa_Ozaki-Su_Wei_Hsieh,1,S-XC,14,1,0,0,0,8,6
20190910-W-Hiroshima-R32-Risa_Ozaki-Su_Wei_Hsieh,1,S-DTM,5,0,0,0,0,1,4
20190910-W-Hiroshima-R32-Risa_Ozaki-Su_Wei_Hsieh,1,S-DTL,4,1,1,0,0,2,2
20190910-W-Hiroshima-R32-Risa_Ozaki-Su_Wei_Hsieh,1,S-IO,2,0,0,0,0,1,1
20190910-W-Hiroshima-R32-Risa_Ozaki-Su_Wei_Hsieh,2,F-XC,42,13,4,4,5,27,15
20190910-W-Hiroshima-R32-Risa_Ozaki-Su_Wei_Hsieh,2,F-DTM,12,2,2,0,0,8,4
20190910-W-Hiroshima-R32-Risa_Ozaki-Su_Wei_Hsieh,2,F-DTL,14,11,7,1,3,10,4
20190910-W-Hiroshima-R32-Risa_Ozaki-Su_Wei_Hsieh,2,F-IO,16,5,3,0,2,9,7
20190910-W-Hiroshima-R32-Risa_Ozaki-Su_Wei_Hsieh,2,F-II,3,2,2,0,0,3,0
20190910-W-Hiroshima-R32-Risa_Ozaki-Su_Wei_Hsieh,2,B-XC,70,12,2,0,10,32,38
20190910-W-Hiroshima-R32-Risa_Ozaki-Su_Wei_Hsieh,2,B-DTM,22,3,0,0,3,13,9
20190910-W-Hiroshima-R32-Risa_Ozaki-Su_Wei_Hsieh,2,B-DTL,15,9,2,4,3,9,6
20190910-W-Hiroshima-R32-Risa_Ozaki-Su_Wei_Hsieh,2,B-IO,8,3,0,0,3,4,4
20190910-W-Hiroshima-R32-Risa_Ozaki-Su_Wei_Hsieh,2,S-XC,4,1,0,0,1,2,2
20190910-W-Hiroshima-R32-Risa_Ozaki-Su_Wei_Hsieh,2,S-DTM,3,1,0,0,1,0,3
20190910-W-Hiroshima-R32-Risa_Ozaki-Su_Wei_Hsieh,2,S-DTL,2,1,1,0,0,2,0
20190414-W-ITF_Istanbul-F-Vitalia_Diatchenko-Ankita_Raina,1,F-XC,12,7,5,1,1,9,3
20190414-W-ITF_Istanbul-F-Vitalia_Diatchenko-Ankita_Raina,1,F-DTM,9,1,0,0,1,5,4
20190414-W-ITF_Istanbul-F-Vitalia_Diatchenko-Ankita_Raina,1,F-DTL,6,3,0,1,2,2,4
20190414-W-ITF_Istanbul-F-Vitalia_Diatchenko-Ankita_Raina,1,F-IO,9,5,4,1,0,9,0
20190414-W-ITF_Istanbul-F-Vitalia_Diatchenko-Ankita_Raina,1,B-XC,17,2,1,0,1,10,7
20190414-W-ITF_Istanbul-F-Vitalia_Diatchenko-Ankita_Raina,1,B-DTM,17,0,0,0,0,12,5
20190414-W-ITF_Istanbul-F-Vitalia_Diatchenko-Ankita_Raina,1,B-DTL,8,8,4,2,2,6,2
20190414-W-ITF_Istanbul-F-Vitalia_Diatchenko-Ankita_Raina,1,B-IO,13,8,4,1,3,9,4
20190414-W-ITF_Istanbul-F-Vitalia_Diatchenko-Ankita_Raina,1,B-II,1,0,0,0,0,1,0
20190414-W-ITF_Istanbul-F-Vitalia_Diatchenko-Ankita_Raina,2,F-XC,13,6,1,0,5,6,7
20190414-W-ITF_Istanbul-F-Vitalia_Diatchenko-Ankita_Raina,2,F-DTM,11,2,0,0,2,2,9
20190414-W-ITF_Istanbul-F-Vitalia_Diatchenko-Ankita_Raina,2,F-DTL,3,1,0,1,0,2,1
20190414-W-ITF_Istanbul-F-Vitalia_Diatchenko-Ankita_Raina,2,F-IO,6,2,0,0,2,0,6
20190414-W-ITF_Istanbul-F-Vitalia_Diatchenko-Ankita_Raina,2,B-XC,24,6,1,1,4,9,15
20190414-W-ITF_Istanbul-F-Vitalia_Diatchenko-Ankita_Raina,2,B-DTM,22,4,0,0,4,6,16
20190414-W-ITF_Istanbul-F-Vitalia_Diatchenko-Ankita_Raina,2,B-DTL,5,3,0,1,2,3,2
20190414-W-ITF_Istanbul-F-Vitalia_Diatchenko-Ankita_Raina,2,B-IO,3,2,2,0,0,2,1
19950126-W-Australian_Open-SF-Mary_Pierce-Conchita_Martinez,1,F-XC,25,12,3,5,4,15,10
19950126-W-Australian_Open-SF-Mary_Pierce-Conchita_Martinez,1,F-DTM,20,1,0,0,1,9,11
19950126-W-Australian_Open-SF-Mary_Pierce-Conchita_Martinez,1,F-DTL,11,2,0,1,1,6,5
19950126-W-Australian_Open-SF-Mary_Pierce-Conchita_Martinez,1,F-IO,10,3,2,1,0,7,3
19950126-W-Australian_Open-SF-Mary_Pierce-Conchita_Martinez,1,F-II,1,0,0,0,0,1,0
19950126-W-Australian_Open-SF-Mary_Pierce-Conchita_Martinez,1,B-XC,38,7,2,2,3,26,12
19950126-W-Australian_Open-SF-Mary_Pierce-Conchita_Martinez,1,B-DTM,12,0,0,0,0,4,8
19950126-W-Australian_Open-SF-Mary_Pierce-Conchita_Martinez,1,B-DTL,19,11,5,1,5,9,10
19950126-W-Australian_Open-SF-Mary_Pierce-Conchita_Martinez,1,B-IO,10,5,1,0,4,4,6
19950126-W-Australian_Open-SF-Mary_Pierce-Conchita_Martinez,2,F-XC,22,7,1,2,4,13,9
19950126-W-Australian_Open-SF-Mary_Pierce-Conchita_Martinez,2,F-DTM,16,0,0,0,0,8,8
19950126-W-Australian_Open-SF-Mary_Pierce-Conchita_Martinez,2,F-DTL,12,4,2,1,1,7,5
19950126-W-Australian_Open-SF-Mary_Pierce-Conchita_Martinez,2,F-IO,14,4,2,0,2,9,5
19950126-W-Australian_Open-SF-Mary_Pierce-Conchita_Martinez,2,F-II,2,0,0,0,0,1,1
19950126-W-Australian_Open-SF-Mary_Pierce-Conchita_Martinez,2,B-XC,19,2,1,0,1,5,14
19950126-W-Australian_Open-SF-Mary_Pierce-Conchita_Martinez,2,B-DTM,12,0,0,0,0,7,5
19950126-W-Australian_Open-SF-Mary_Pierce-Conchita_Martinez,2,S-XC,13,2,0,0,2,3,10
19950126-W-Australian_Open-SF-Mary_Pierce-Conchita_Martinez,2,S-DTM,10,1,0,0,1,3,7
19950126-W-Australian_Open-SF-Mary_Pierce-Conchita_Martinez,2,S-DTL,6,1,0,0,1,1,5
19950126-W-Australian_Open-SF-Mary_Pierce-Conchita_Martinez,2,S-IO,4,0,0,0,0,2,2
19860905-W-US_Open-F-Martina_Navratilova-Helena_Sukova,1,F-XC,4,1,0,1,0,4,0
19860905-W-US_Open-F-Martina_Navratilova-Helena_Sukova,1,F-DTM,2,0,0,0,0,0,2
19860905-W-US_Open-F-Martina_Navratilova-Helena_Sukova,1,F-DTL,3,1,1,0,0,1,2
19860905-W-US_Open-F-Martina_Navratilova-Helena_Sukova,1,F-II,1,1,1,0,0,1,0
19860905-W-US_Open-F-Martina_Navratilova-Helena_Sukova,1,B-XC,3,1,1,0,0,3,0
19860905-W-US_Open-F-Martina_Navratilova-Helena_Sukova,1,B-DTM,3,0,0,0,0,1,2
19860905-W-US_Open-F-Martina_Navratilova-Helena_Sukova,1,B-DTL,2,1,0,0,1,1,1
19860905-W-US_Open-F-Martina_Navratilova-Helena_Sukova,1,S-XC,1,0,0,0,0,0,1
19860905-W-US_Open-F-Martina_Navratilova-Helena_Sukova,1,S-DTM,1,1,0,0,1,0,1
19860905-W-US_Open-F-Martina_Navratilova-Helena_Sukova,1,S-DTL,1,1,1,0,0,1,0
19860905-W-US_Open-F-Martina_Navratilova-Helena_Sukova,2,F-XC,8,3,1,0,2,5,3
19860905-W-US_Open-F-Martina_Navratilova-Helena_Sukova,2,F-DTM,5,1,0,0,1,2,3
19860905-W-US_Open-F-Martina_Navratilova-Helena_Sukova,2,F-DTL,4,2,1,0,1,2,2
19860905-W-US_Open-F-Martina_Navratilova-Helena_Sukova,2,F-IO,1,1,0,0,1,0,1
19860905-W-US_Open-F-Martina_Navratilova-Helena_Sukova,2,B-XC,4,3,1,0,2,1,3
19860905-W-US_Open-F-Martina_Navratilova-Helena_Sukova,2,B-DTM,4,3,1,0,2,1,3
19860905-W-US_Open-F-Martina_Navratilova-Helena_Sukova,2,B-DTL,4,4,2,1,1,3,1
19860905-W-US_Open-F-Martina_Navratilova-Helena_Sukova,2,B-IO,3,0,0,0,0,0,3
19860905-W-US_Open-F-Martina_Navratilova-Helena_Sukova,2,S-XC,1,0,0,0,0,0,1
19860905-W-US_Open-F-Martina_Navratilova-Helena_Sukova,2,S-DTM,1,0,0,0,0,0,1
19860905-W-US_Open-F-Martina_Navratilova-Helena_Sukova,2,S-DTL,1,0,0,0,0,0,1
19980912-W-US_Open-F-Martina_Hingis-Lindsay_Davenport,1,F-XC,19,2,1,0,1,8,11
19980912-W-US_Open-F-Martina_Hingis-Lindsay_Davenport,1,F-DTM,30,0,0,0,0,11,19
19980912-W-US_Open-F-Martina_Hingis-Lindsay_Davenport,1,F-DTL,24,2,1,1,0,14,10
19980912-W-US_Open-F-Martina_Hingis-Lindsay_Davenport,1,F-IO,19,4,2,0,2,9,10
19980912-W-US_Open-F-Martina_Hingis-Lindsay_Davenport,1,B-XC,36,8,2,0,6,10,26
19980912-W-US_Open-F-Martina_Hingis-Lindsay_Davenport,1,B-DTM,47,2,0,0,2,12,35
19980912-W-US_Open-F-Martina_Hingis-Lindsay_Davenport,1,B-DTL,15,4,2,0,2,7,8
19980912-W-US_Open-F-Martina_Hingis-Lindsay_Davenport,1,B-IO,11,5,4,1,0,7,4
19980912-W-US_Open-F-Martina_Hingis-Lindsay_Davenport,1,S-XC,4,0,0,0,0,0,4
19980912-W-US_Open-F-Martina_Hingis-Lindsay_Davenport,1,S-DTM,4,0,0,0,0,0,4
19980912-W-US_Open-F-Martina_Hingis-Lindsay_Davenport,2,F-XC,50,11,4,4,3,32,18
19980912-W-US_Open-F-Martina_Hingis-Lindsay_Davenport,2,F-DTM,20,2,0,0,2,9,11
19980912-W-US_Open-F-Martina_Hingis-Lindsay_Davenport,2,F-DTL,7,3,1,1,1,5,2
19980912-W-US_Open-F-Martina_Hingis-Lindsay_Davenport,2,F-IO,12,5,3,2,0,12,0
19980912-W-US_Open-F-Martina_Hingis-Lindsay_Davenport,2,F-II,1,0,0,0,0,1,0
19980912-W-US_Open-F-Martina_Hingis-Lindsay_Davenport,2,B-XC,68,16,2,7,7,44,24
19980912-W-US_Open-F-Martina_Hingis-Lindsay_Davenport,2,B-DTM,38,4,0,0,4,22,16
19980912-W-US_Open-F-Martina_Hingis-Lindsay_Davenport,2,B-DTL,14,7,2,4,1,10,4
19980912-W-US_Open-F-Martina_Hingis-Lindsay_Davenport,2,B-IO,12,4,3,0,1,8,4
19980912-W-US_Open-F-Martina_Hingis-Lindsay_Davenport,2,S-XC,2,0,0,0,0,1,1
19980912-W-US_Open-F-Martina_Hingis-Lindsay_Davenport,2,S-DTM,3,0,0,0,0,3,0
19980912-W-US_Open-F-Martina_Hingis-Lindsay_Davenport,2,S-DTL,1,0,0,0,0,0,1
20190114-W-Australian_Open-R128-Maria_Sharapova-Harriet_Dart,1,F-XC,35,11,3,5,3,21,14
20190114-W-Australian_Open-R128-Maria_Sharapova-Harriet_Dart,1,F-DTM,14,0,0,0,0,5,9
20190114-W-Australian_Open-R128-Maria_Sharapova-Harriet_Dart,1,F-DTL,8,5,2,1,2,4,4
20190114-W-Australian_Open-R128-Maria_Sharapova-Harriet_Dart,1,F-IO,1,1,1,0,0,1,0
20190114-W-Australian_Open-R128-Maria_Sharapova-Harriet_Dart,1,B-XC,30,9,3,5,1,23,7
20190114-W-Australian_Open-R128-Maria_Sharapova-Harriet_Dart,1,B-DTM,11,4,0,3,1,9,2
20190114-W-Australian_Open-R128-Maria_Sharapova-Harriet_Dart,1,B-DTL,4,3,3,0,0,4,0
20190114-W-Australian_Open-R128-Maria_Sharapova-Harriet_Dart,1,B-IO,1,0,0,0,0,0,1
20190114-W-Australian_Open-R128-Maria_Sharapova-Harriet_Dart,1,S-XC,1,0,0,0,0,1,0
20190114-W-Australian_Open-R128-Maria_Sharapova-Harriet_Dart,1,S-DTL,2,0,0,0,0,2,0
20190114-W-Australian_Open-R128-Maria_Sharapova-Harriet_Dart,1,S-IO,1,0,0,0,0,0,1
20190114-W-Australian_Open-R128-Maria_Sharapova-Harriet_Dart,2,F-XC,25,4,1,2,1,14,11
20190114-W-Australian_Open-R128-Maria_Sharapova-Harriet_Dart,2,F-DTM,14,2,0,0,2,6,8
20190114-W-Australian_Open-R128-Maria_Sharapova-Harriet_Dart,2,F-DTL,10,3,2,1,0,4,6
20190114-W-Australian_Open-R128-Maria_Sharapova-Harriet_Dart,2,F-IO,5,0,0,0,0,0,5
20190114-W-Australian_Open-R128-Maria_Sharapova-Harriet_Dart,2,B-XC,6,0,0,0,0,0,6
20190114-W-Australian_Open-R128-Maria_Sharapova-Harriet_Dart,2,B-DTM,17,2,0,2,0,11,6
20190114-W-Australian_Open-R128-Maria_Sharapova-Harriet_Dart,2,B-DTL,8,4,3,1,0,6,2
20190114-W-Australian_Open-R128-Maria_Sharapova-Harriet_Dart,2,B-IO,5,0,0,0,0,3,2
20190114-W-Australian_Open-R128-Maria_Sharapova-Harriet_Dart,2,S-XC,6,0,0,0,0,0,6
20190114-W-Australian_Open-R128-Maria_Sharapova-Harriet_Dart,2,S-DTM,1,0,0,0,0,0,1
20190911-W-Hiroshima-R16-Priscilla_Hon-Su_Wei_Hsieh,1,F-XC,27,7,0,3,4,8,19
20190911-W-Hiroshima-R16-Priscilla_Hon-Su_Wei_Hsieh,1,F-DTM,22,8,2,1,5,7,15
20190911-W-Hiroshima-R16-Priscilla_Hon-Su_Wei_Hsieh,1,F-DTL,11,8,2,0,6,3,8
20190911-W-Hiroshima-R16-Priscilla_Hon-Su_Wei_Hsieh,1,F-IO,17,8,3,1,4,8,9
20190911-W-Hiroshima-R16-Priscilla_Hon-Su_Wei_Hsieh,1,B-XC,30,9,4,0,5,9,21
20190911-W-Hiroshima-R16-Priscilla_Hon-Su_Wei_Hsieh,1,B-DTM,21,5,0,0,5,4,17
20190911-W-Hiroshima-R16-Priscilla_Hon-Su_Wei_Hsieh,1,B-DTL,10,5,4,0,1,7,3
20190911-W-Hiroshima-R16-Priscilla_Hon-Su_Wei_Hsieh,1,B-IO,6,3,2,0,1,3,3
20190911-W-Hiroshima-R16-Priscilla_Hon-Su_Wei_Hsieh,1,S-XC,10,2,0,0,2,3,7
20190911-W-Hiroshima-R16-Priscilla_Hon-Su_Wei_Hsieh,1,S-DTM,13,1,0,0,1,3,10
20190911-W-Hiroshima-R16-Priscilla_Hon-Su_Wei_Hsieh,1,S-DTL,10,1,0,1,0,3,7
20190911-W-Hiroshima-R16-Priscilla_Hon-Su_Wei_Hsieh,1,S-IO,3,0,0,0,0,2,1
20190911-W-Hiroshima-R16-Priscilla_Hon-Su_Wei_Hsieh,2,F-XC,23,4,2,0,2,18,5
20190911-W-Hiroshima-R16-Priscilla_Hon-Su_Wei_Hsieh,2,F-DTM,9,1,0,0,1,5,4
20190911-W-Hiroshima-R16-Priscilla_Hon-Su_Wei_Hsieh,2,F-DTL,2,0,0,0,0,1,1
20190911-W-Hiroshima-R16-Priscilla_Hon-Su_Wei_Hsieh,2,F-IO,5,1,1,0,0,4,1
20190911-W-Hiroshima-R16-Priscilla_Hon-Su_Wei_Hsieh,2,B-XC,31,7,5,1,1,26,5
20190911-W-Hiroshima-R16-Priscilla_Hon-Su_Wei_Hsieh,2,B-DTM,17,3,0,1,2,12,5
20190911-W-Hiroshima-R16-Priscilla_Hon-Su_Wei_Hsieh,2,B-DTL,6,4,0,1,3,2,4
20190911-W-Hiroshima-R16-Priscilla_Hon-Su_Wei_Hsieh,2,B-IO,1,0,0,0,0,1,0
20190911-W-Hiroshima-R16-Priscilla_Hon-Su_Wei_Hsieh,2,S-XC,11,2,0,0,2,3,8
20190911-W-Hiroshima-R16-Priscilla_Hon-Su_Wei_Hsieh,2,S-DTM,9,0,0,0,0,6,3
20190911-W-Hiroshima-R16-Priscilla_Hon-Su_Wei_Hsieh,2,S-DTL,1,0,0,0,0,0,1
20191001-W-Beijing-R32-Angelique_Kerber-Polona_Hercog,1,F-XC,28,6,0,1,5,8,20
20191001-W-Beijing-R32-Angelique_Kerber-Polona_Hercog,1,F-DTM,5,0,0,0,0,3,2
20191001-W-Beijing-R32-Angelique_Kerber-Polona_Hercog,1,F-DTL,5,4,0,2,2,2,3
20191001-W-Beijing-R32-Angelique_Kerber-Polona_Hercog,1,F-IO,14,7,3,3,1,10,4
20191001-W-Beijing-R32-Angelique_Kerber-Polona_Hercog,1,F-II,2,1,0,0,1,0,2
20191001-W-Beijing-R32-Angelique_Kerber-Polona_Hercog,1,B-XC,37,10,3,1,6,14,23
20191001-W-Beijing-R32-Angelique_Kerber-Polona_Hercog,1,B-DTM,31,4,0,0,4,10,21
20191001-W-Beijing-R32-Angelique_Kerber-Polona_Hercog,1,B-DTL,14,5,0,0,5,3,11
20191001-W-Beijing-R32-Angelique_Kerber-Polona_Hercog,1,B-IO,7,2,1,0,1,2,5
20191001-W-Beijing-R32-Angelique_Kerber-Polona_Hercog,1,S-XC,5,0,0,0,0,0,5
20191001-W-Beijing-R32-Angelique_Kerber-Polona_Hercog,1,S-DTM,4,1,0,0,1,2,2
20191001-W-Beijing-R32-Angelique_Kerber-Polona_Hercog,1,S-DTL,7,0,0,0,0,0,7
20191001-W-Beijing-R32-Angelique_Kerber-Polona_Hercog,1,S-IO,6,3,0,0,3,0,6
20191001-W-Beijing-R32-Angelique_Kerber-Polona_Hercog,2,F-XC,42,4,0,1,3,28,14
20191001-W-Beijing-R32-Angelique_Kerber-Polona_Hercog,2,F-DTM,28,5,1,0,4,14,14
20191001-W-Beijing-R32-Angelique_Kerber-Polona_Hercog,2,F-DTL,2,1,0,1,0,2,0
20191001-W-Beijing-R32-Angelique_Kerber-Polona_Hercog,2,F-IO,9,4,3,0,1,7,2
20191001-W-Beijing-R32-Angelique_Kerber-Polona_Hercog,2,F-II,3,1,1,0,0,3,0
20191001-W-Beijing-R32-Angelique_Kerber-Polona_Hercog,2,B-XC,7,4,2,1,1,6,1
20191001-W-Beijing-R32-Angelique_Kerber-Polona_Hercog,2,B-DTM,1,0,0,0,0,1,0
20191001-W-Beijing-R32-Angelique_Kerber-Polona_Hercog,2,B-DTL,3,0,0,0,0,3,0
20191001-W-Beijing-R32-Angelique_Kerber-Polona_Hercog,2,S-XC,9,1,1,0,0,7,2
20191001-W-Beijing-R32-Angelique_Kerber-Polona_Hercog,2,S-DTM,22,2,0,1,1,14,8
20191001-W-Beijing-R32-Angelique_Kerber-Polona_Hercog,2,S-DTL,18,2,0,0,2,13,5
20191001-W-Beijing-R32-Angelique_Kerber-Polona_Hercog,2,S-IO,3,1,0,0,1,1,2
20190829-W-US_Open-R64-Francesca_Di_Lorenzo-Julia_Goerges,1,F-XC,14,4,0,1,3,6,8
20190829-W-US_Open-R64-Francesca_Di_Lorenzo-Julia_Goerges,1,F-DTM,22,2,0,0,2,8,14
20190829-W-US_Open-R64-Francesca_Di_Lorenzo-Julia_Goerges,1,F-DTL,1,1,0,1,0,1,0
20190829-W-US_Open-R64-Francesca_Di_Lorenzo-Julia_Goerges,1,F-IO,1,1,0,0,1,0,1
20190829-W-US_Open-R64-Francesca_Di_Lorenzo-Julia_Goerges,1,B-XC,21,3,1,0,2,10,11
20190829-W-US_Open-R64-Francesca_Di_Lorenzo-Julia_Goerges,1,B-DTM,24,4,0,1,3,11,13
20190829-W-US_Open-R64-Francesca_Di_Lorenzo-Julia_Goerges,1,B-DTL,7,2,1,0,1,4,3
20190829-W-US_Open-R64-Francesca_Di_Lorenzo-Julia_Goerges,1,B-IO,3,1,0,0,1,1,2
20190829-W-US_Open-R64-Francesca_Di_Lorenzo-Julia_Goerges,1,S-DTM,4,1,0,0,1,0,4
20190829-W-US_Open-R64-Francesca_Di_Lorenzo-Julia_Goerges,1,S-DTL,2,0,0,0,0,1,1
20190829-W-US_Open-R64-Francesca_Di_Lorenzo-Julia_Goerges,2,F-XC,35,10,3,4,3,19,16
20190829-W-US_Open-R64-Francesca_Di_Lorenzo-Julia_Goerges,2,F-DTM,12,2,0,1,1,8,4
20190829-W-US_Open-R64-Francesca_Di_Lorenzo-Julia_Goerges,2,F-DTL,8,7,4,0,3,4,4
20190829-W-US_Open-R64-Francesca_Di_Lorenzo-Julia_Goerges,2,F-IO,16,9,4,0,5,9,7
20190829-W-US_Open-R64-Francesca_Di_Lorenzo-Julia_Goerges,2,F-II,2,1,1,0,0,2,0
20190829-W-US_Open-R64-Francesca_Di_Lorenzo-Julia_Goerges,2,B-XC,6,1,0,0,1,3,3
20190829-W-US_Open-R64-Francesca_Di_Lorenzo-Julia_Goerges,2,B-DTM,18,3,0,0,3,10,8
20190829-W-US_Open-R64-Francesca_Di_Lorenzo-Julia_Goerges,2,B-DTL,5,4,1,1,2,2,3
20190829-W-US_Open-R64-Francesca_Di_Lorenzo-Julia_Goerges,2,B-IO,3,1,0,0,1,2,1
20190829-W-US_Open-R64-Francesca_Di_Lorenzo-Julia_Goerges,2,S-DTM,1,0,0,0,0,0,1
20161126-W-ITF_Valencia-SF-Jasmine_Paolini-Cristina_Bucsa,1,F-XC,92,31,8,8,15,51,41
20161126-W-ITF_Valencia-SF-Jasmine_Paolini-Cristina_Bucsa,1,F-DTM,20,1,0,0,1,8,12
20161126-W-ITF_Valencia-SF-Jasmine_Paolini-Cristina_Bucsa,1,F-DTL,14,4,2,1,1,6,8
20161126-W-ITF_Valencia-SF-Jasmine_Paolini-Cristina_Bucsa,1,F-IO,12,1,1,0,0,5,7
20161126-W-ITF_Valencia-SF-Jasmine_Paolini-Cristina_Bucsa,1,F-II,1,0,0,0,0,1,0
20161126-W-ITF_Valencia-SF-Jasmine_Paolini-Cristina_Bucsa,1,B-XC,57,15,3,5,7,29,28
20161126-W-ITF_Valencia-SF-Jasmine_Paolini-Cristina_Bucsa,1,B-DTM,29,1,0,0,1,18,11
20161126-W-ITF_Valencia-SF-Jasmine_Paolini-Cristina_Bucsa,1,B-DTL,19,8,6,0,2,7,12
20161126-W-ITF_Valencia-SF-Jasmine_Paolini-Cristina_Bucsa,1,B-IO,2,0,0,0,0,1,1
20161126-W-ITF_Valencia-SF-Jasmine_Paolini-Cristina_Bucsa,1,S-XC,1,1,1,0,0,1,0
20161126-W-ITF_Valencia-SF-Jasmine_Paolini-Cristina_Bucsa,1,S-DTM,5,0,0,0,0,4,1
20161126-W-ITF_Valencia-SF-Jasmine_Paolini-Cristina_Bucsa,2,F-XC,43,11,4,1,6,23,20
20161126-W-ITF_Valencia-SF-Jasmine_Paolini-Cristina_Bucsa,2,F-DTM,15,1,0,0,1,7,8
20161126-W-ITF_Valencia-SF-Jasmine_Paolini-Cristina_Bucsa,2,F-DTL,35,17,3,2,12,15,20
20161126-W-ITF_Valencia-SF-Jasmine_Paolini-Cristina_Bucsa,2,F-IO,30,8,2,4,2,18,12
20161126-W-ITF_Valencia-SF-Jasmine_Paolini-Cristina_Bucsa,2,B-XC,40,8,4,1,3,22,18
20161126-W-ITF_Valencia-SF-Jasmine_Paolini-Cristina_Bucsa,2,B-DTM,30,1,0,0,1,15,15
20161126-W-ITF_Valencia-SF-Jasmine_Paolini-Cristina_Bucsa,2,B-DTL,25,8,5,1,2,11,14
20161126-W-ITF_Valencia-SF-Jasmine_Paolini-Cristina_Bucsa,2,B-IO,11,4,1,2,1,5,6
20161126-W-ITF_Valencia-SF-Jasmine_Paolini-Cristina_Bucsa,2,S-XC,1,0,0,0,0,1,0
20161126-W-ITF_Valencia-SF-Jasmine_Paolini-Cristina_Bucsa,2,S-DTM,3,0,0,0,0,0,3
20080816-W-Olympics-SF-Na_Li-Dinara_Safina,1,F-XC,66,22,5,7,10,34,32
20080816-W-Olympics-SF-Na_Li-Dinara_Safina,1,F-DTM,27,4,0,0,4,8,19
20080816-W-Olympics-SF-Na_Li-Dinara_Safina,1,F-DTL,13,7,1,0,6,3,10
20080816-W-Olympics-SF-Na_Li-Dinara_Safina,1,F-IO,17,5,2,1,2,12,5
20080816-W-Olympics-SF-Na_Li-Dinara_Safina,1,B-XC,44,16,7,1,8,23,21
20080816-W-Olympics-SF-Na_Li-Dinara_Safina,1,B-DTM,30,5,0,0,5,6,24
20080816-W-Olympics-SF-Na_Li-Dinara_Safina,1,B-DTL,16,9,4,1,4,12,4
20080816-W-Olympics-SF-Na_Li-Dinara_Safina,1,B-IO,7,2,0,0,2,2,5
20080816-W-Olympics-SF-Na_Li-Dinara_Safina,1,S-XC,1,1,0,0,1,0,1
20080816-W-Olympics-SF-Na_Li-Dinara_Safina,1,S-DTL,1,0,0,0,0,0,1
20080816-W-Olympics-SF-Na_Li-Dinara_Safina,2,F-XC,39,6,0,1,5,24,15
20080816-W-Olympics-SF-Na_Li-Dinara_Safina,2,F-DTM,32,3,2,0,1,15,17
20080816-W-Olympics-SF-Na_Li-Dinara_Safina,2,F-DTL,10,3,1,1,1,6,4
20080816-W-Olympics-SF-Na_Li-Dinara_Safina,2,F-IO,16,6,1,2,3,11,5
20080816-W-Olympics-SF-Na_Li-Dinara_Safina,2,B-XC,33,6,0,3,3,16,17
20080816-W-Olympics-SF-Na_Li-Dinara_Safina,2,B-DTM,26,1,0,0,1,12,14
20080816-W-Olympics-SF-Na_Li-Dinara_Safina,2,B-DTL,4,1,0,1,0,3,1
20080816-W-Olympics-SF-Na_Li-Dinara_Safina,2,B-IO,5,1,0,1,0,4,1
20080816-W-Olympics-SF-Na_Li-Dinara_Safina,2,S-XC,2,0,0,0,0,0,2
20080816-W-Olympics-SF-Na_Li-Dinara_Safina,2,S-DTM,3,0,0,0,0,0,3
20080816-W-Olympics-SF-Na_Li-Dinara_Safina,2,S-DTL,3,0,0,0,0,1,2
20080816-W-Olympics-SF-Na_Li-Dinara_Safina,2,S-IO,3,1,0,0,1,2,1
20120623-W-s_Hertogenbosch-F-Nadia_Petrova-Urszula_Radwanska,1,F-XC,29,6,2,1,3,19,10
20120623-W-s_Hertogenbosch-F-Nadia_Petrova-Urszula_Radwanska,1,F-DTM,7,3,1,0,2,5,2
20120623-W-s_Hertogenbosch-F-Nadia_Petrova-Urszula_Radwanska,1,F-DTL,10,5,3,1,1,8,2
20120623-W-s_Hertogenbosch-F-Nadia_Petrova-Urszula_Radwanska,1,F-IO,12,3,0,1,2,3,9
20120623-W-s_Hertogenbosch-F-Nadia_Petrova-Urszula_Radwanska,1,F-II,1,0,0,0,0,0,1
20120623-W-s_Hertogenbosch-F-Nadia_Petrova-Urszula_Radwanska,1,B-XC,22,7,3,1,3,15,7
20120623-W-s_Hertogenbosch-F-Nadia_Petrova-Urszula_Radwanska,1,B-DTM,11,1,0,0,1,6,5
20120623-W-s_Hertogenbosch-F-Nadia_Petrova-Urszula_Radwanska,1,B-DTL,10,6,4,0,2,6,4
20120623-W-s_Hertogenbosch-F-Nadia_Petrova-Urszula_Radwanska,1,B-IO,9,4,1,1,2,5,4
20120623-W-s_Hertogenbosch-F-Nadia_Petrova-Urszula_Radwanska,1,S-XC,8,1,0,1,0,4,4
20120623-W-s_Hertogenbosch-F-Nadia_Petrova-Urszula_Radwanska,1,S-DTM,4,0,0,0,0,3,1
20120623-W-s_Hertogenbosch-F-Nadia_Petrova-Urszula_Radwanska,1,S-IO,1,1,0,0,1,0,1
20120623-W-s_Hertogenbosch-F-Nadia_Petrova-Urszula_Radwanska,2,F-XC,27,7,1,0,6,9,18
20120623-W-s_Hertogenbosch-F-Nadia_Petrova-Urszula_Radwanska,2,F-DTM,8,0,0,0,0,4,4
20120623-W-s_Hertogenbosch-F-Nadia_Petrova-Urszula_Radwanska,2,F-DTL,9,2,1,0,1,4,5
20120623-W-s_Hertogenbosch-F-Nadia_Petrova-Urszula_Radwanska,2,F-IO,11,3,0,1,2,3,8
20120623-W-s_Hertogenbosch-F-Nadia_Petrova-Urszula_Radwanska,2,B-XC,28,4,1,1,2,12,16
20120623-W-s_Hertogenbosch-F-Nadia_Petrova-Urszula_Radwanska,2,B-DTM,12,1,0,1,0,7,5
20120623-W-s_Hertogenbosch-F-Nadia_Petrova-Urszula_Radwanska,2,B-DTL,8,4,1,0,3,4,4
20120623-W-s_Hertogenbosch-F-Nadia_Petrova-Urszula_Radwanska,2,B-IO,5,1,0,1,0,2,3
20120623-W-s_Hertogenbosch-F-Nadia_Petrova-Urszula_Radwanska,2,S-XC,4,2,0,0,2,1,3
20120623-W-s_Hertogenbosch-F-Nadia_Petrova-Urszula_Radwanska,2,S-DTM,9,1,0,0,1,3,6
20120623-W-s_Hertogenbosch-F-Nadia_Petrova-Urszula_Radwanska,2,S-DTL,1,1,1,0,0,1,0
20041115-W-Tour_Championships-SF-Maria_Sharapova-Anastasia_Myskina,1,F-XC,67,15,5,3,7,40,27
20041115-W-Tour_Championships-SF-Maria_Sharapova-Anastasia_Myskina,1,F-DTM,24,4,0,0,4,8,16
20041115-W-Tour_Championships-SF-Maria_Sharapova-Anastasia_Myskina,1,F-DTL,24,12,2,3,7,10,14
20041115-W-Tour_Championships-SF-Maria_Sharapova-Anastasia_Myskina,1,F-IO,17,12,4,3,5,11,6
20041115-W-Tour_Championships-SF-Maria_Sharapova-Anastasia_Myskina,1,B-XC,30,10,3,3,4,18,12
20041115-W-Tour_Championships-SF-Maria_Sharapova-Anastasia_Myskina,1,B-DTM,24,2,0,0,2,11,13
20041115-W-Tour_Championships-SF-Maria_Sharapova-Anastasia_Myskina,1,B-DTL,10,1,1,0,0,5,5
20041115-W-Tour_Championships-SF-Maria_Sharapova-Anastasia_Myskina,1,B-IO,17,7,0,1,6,7,10
20041115-W-Tour_Championships-SF-Maria_Sharapova-Anastasia_Myskina,2,F-XC,73,13,4,3,6,40,33
20041115-W-Tour_Championships-SF-Maria_Sharapova-Anastasia_Myskina,2,F-DTM,26,2,1,0,1,8,18
20041115-W-Tour_Championships-SF-Maria_Sharapova-Anastasia_Myskina,2,F-DTL,14,7,1,1,5,5,9
20041115-W-Tour_Championships-SF-Maria_Sharapova-Anastasia_Myskina,2,F-IO,6,4,2,1,1,4,2
20041115-W-Tour_Championships-SF-Maria_Sharapova-Anastasia_Myskina,2,B-XC,23,7,1,3,3,14,9
20041115-W-Tour_Championships-SF-Maria_Sharapova-Anastasia_Myskina,2,B-DTM,35,5,1,0,4,13,22
20041115-W-Tour_Championships-SF-Maria_Sharapova-Anastasia_Myskina,2,B-DTL,11,7,3,0,4,6,5
20041115-W-Tour_Championships-SF-Maria_Sharapova-Anastasia_Myskina,2,B-IO,2,0,0,0,0,2,0
20041115-W-Tour_Championships-SF-Maria_Sharapova-Anastasia_Myskina,2,S-DTM,5,0,0,0,0,2,3
19880929-W-Olympics-SF-Manuela_Maleeva_Fragniere-Gabriela_Sabatini,1,F-XC,54,5,0,0,5,18,36
19880929-W-Olympics-SF-Manuela_Maleeva_Fragniere-Gabriela_Sabatini,1,F-DTM,29,2,0,0,2,11,18
19880929-W-Olympics-SF-Manuela_Maleeva_Fragniere-Gabriela_Sabatini,1,F-DTL,20,6,2,0,4,7,13
19880929-W-Olympics-SF-Manuela_Maleeva_Fragniere-Gabriela_Sabatini,1,F-IO,14,4,0,1,3,6,8
19880929-W-Olympics-SF-Manuela_Maleeva_Fragniere-Gabriela_Sabatini,1,B-XC,84,5,0,1,4,30,54
19880929-W-Olympics-SF-Manuela_Maleeva_Fragniere-Gabriela_Sabatini,1,B-DTM,44,3,0,1,2,14,30
19880929-W-Olympics-SF-Manuela_Maleeva_Fragniere-Gabriela_Sabatini,1,B-DTL,18,4,0,1,3,7,11
19880929-W-Olympics-SF-Manuela_Maleeva_Fragniere-Gabriela_Sabatini,1,B-IO,6,1,0,0,1,2,4
19880929-W-Olympics-SF-Manuela_Maleeva_Fragniere-Gabriela_Sabatini,1,S-XC,3,0,0,0,0,0,3
19880929-W-Olympics-SF-Manuela_Maleeva_Fragniere-Gabriela_Sabatini,1,S-DTM,4,0,0,0,0,1,3
19880929-W-Olympics-SF-Manuela_Maleeva_Fragniere-Gabriela_Sabatini,1,S-DTL,2,2,0,0,2,0,2
19880929-W-Olympics-SF-Manuela_Maleeva_Fragniere-Gabriela_Sabatini,2,F-XC,46,9,0,5,4,33,13
19880929-W-Olympics-SF-Manuela_Maleeva_Fragniere-Gabriela_Sabatini,2,F-DTM,25,0,0,0,0,15,10
19880929-W-Olympics-SF-Manuela_Maleeva_Fragniere-Gabriela_Sabatini,2,F-DTL,37,6,0,1,5,20,17
19880929-W-Olympics-SF-Manuela_Maleeva_Fragniere-Gabriela_Sabatini,2,F-IO,31,6,2,2,2,19,12
19880929-W-Olympics-SF-Manuela_Maleeva_Fragniere-Gabriela_Sabatini,2,F-II,1,0,0,0,0,1,0
19880929-W-Olympics-SF-Manuela_Maleeva_Fragniere-Gabriela_Sabatini,2,B-XC,42,4,2,1,1,31,11
19880929-W-Olympics-SF-Manuela_Maleeva_Fragniere-Gabriela_Sabatini,2,B-DTM,28,2,0,0,2,17,11
19880929-W-Olympics-SF-Manuela_Maleeva_Fragniere-Gabriela_Sabatini,2,B-DTL,22,2,0,1,1,11,11
19880929-W-Olympics-SF-Manuela_Maleeva_Fragniere-Gabriela_Sabatini,2,B-IO,2,1,0,0,1,1,1
19880929-W-Olympics-SF-Manuela_Maleeva_Fragniere-Gabriela_Sabatini,2,S-XC,15,0,0,0,0,10,5
19880929-W-Olympics-SF-Manuela_Maleeva_Fragniere-Gabriela_Sabatini,2,S-DTM,5,0,0,0,0,3,2
19880929-W-Olympics-SF-Manuela_Maleeva_Fragniere-Gabriela_Sabatini,2,S-DTL,5,0,0,0,0,5,0
19880929-W-Olympics-SF-Manuela_Maleeva_Fragniere-Gabriela_Sabatini,2,S-IO,1,0,0,0,0,1,0
20070408-W-Amelia_Island-F-Nadia_Petrova-Tatiana_Golovin,1,F-XC,51,11,2,0,9,21,30
20070408-W-Amelia_Island-F-Nadia_Petrova-Tatiana_Golovin,1,F-DTM,8,0,0,0,0,3,5
20070408-W-Amelia_Island-F-Nadia_Petrova-Tatiana_Golovin,1,F-DTL,42,15,3,3,9,17,25
20070408-W-Amelia_Island-F-Nadia_Petrova-Tatiana_Golovin,1,F-IO,27,4,1,3,0,12,15
20070408-W-Amelia_Island-F-Nadia_Petrova-Tatiana_Golovin,1,F-II,1,0,0,0,0,1,0
20070408-W-Amelia_Island-F-Nadia_Petrova-Tatiana_Golovin,1,B-XC,41,6,3,0,2,16,25
20070408-W-Amelia_Island-F-Nadia_Petrova-Tatiana_Golovin,1,B-DTM,13,1,0,0,1,4,9
20070408-W-Amelia_Island-F-Nadia_Petrova-Tatiana_Golovin,1,B-DTL,8,4,1,0,3,2,6
20070408-W-Amelia_Island-F-Nadia_Petrova-Tatiana_Golovin,1,B-IO,6,2,1,0,1,3,3
20070408-W-Amelia_Island-F-Nadia_Petrova-Tatiana_Golovin,1,S-XC,15,3,0,1,2,6,9
20070408-W-Amelia_Island-F-Nadia_Petrova-Tatiana_Golovin,1,S-DTM,11,0,0,0,0,2,9
20070408-W-Amelia_Island-F-Nadia_Petrova-Tatiana_Golovin,1,S-DTL,4,1,0,0,1,1,3
20070408-W-Amelia_Island-F-Nadia_Petrova-Tatiana_Golovin,1,S-IO,1,0,0,0,0,0,1
20070408-W-Amelia_Island-F-Nadia_Petrova-Tatiana_Golovin,2,F-XC,38,3,1,2,0,28,10
20070408-W-Amelia_Island-F-Nadia_Petrova-Tatiana_Golovin,2,F-DTM,19,0,0,0,0,10,9
20070408-W-Amelia_Island-F-Nadia_Petrova-Tatiana_Golovin,2,F-DTL,23,7,2,1,4,13,10
20070408-W-Amelia_Island-F-Nadia_Petrova-Tatiana_Golovin,2,F-IO,19,5,2,2,1,13,6
20070408-W-Amelia_Island-F-Nadia_Petrova-Tatiana_Golovin,2,F-II,3,0,0,0,0,0,3
20070408-W-Amelia_Island-F-Nadia_Petrova-Tatiana_Golovin,2,B-XC,33,4,4,0,0,21,12
20070408-W-Amelia_Island-F-Nadia_Petrova-Tatiana_Golovin,2,B-DTM,45,1,0,0,1,29,16
20070408-W-Amelia_Island-F-Nadia_Petrova-Tatiana_Golovin,2,B-DTL,29,3,1,1,1,17,12
20070408-W-Amelia_Island-F-Nadia_Petrova-Tatiana_Golovin,2,B-IO,5,0,0,0,0,3,2
20070408-W-Amelia_Island-F-Nadia_Petrova-Tatiana_Golovin,2,S-XC,2,0,0,0,0,1,1
20070408-W-Amelia_Island-F-Nadia_Petrova-Tatiana_Golovin,2,S-DTM,2,0,0,0,0,1,1
20191214-W-ITF_Dubai-F-Ana_Bogdan-Daria_Snigur,1,F-XC,46,8,2,3,3,27,19
20191214-W-ITF_Dubai-F-Ana_Bogdan-Daria_Snigur,1,F-DTM,32,0,0,0,0,21,11
20191214-W-ITF_Dubai-F-Ana_Bogdan-Daria_Snigur,1,F-DTL,9,3,0,0,3,4,5
20191214-W-ITF_Dubai-F-Ana_Bogdan-Daria_Snigur,1,F-IO,10,2,1,0,1,5,5
20191214-W-ITF_Dubai-F-Ana_Bogdan-Daria_Snigur,1,B-XC,23,7,4,2,1,17,6
20191214-W-ITF_Dubai-F-Ana_Bogdan-Daria_Snigur,1,B-DTM,15,2,0,0,2,10,5
20191214-W-ITF_Dubai-F-Ana_Bogdan-Daria_Snigur,1,B-DTL,2,0,0,0,0,1,1
20191214-W-ITF_Dubai-F-Ana_Bogdan-Daria_Snigur,1,B-IO,4,3,2,0,1,2,2
20191214-W-ITF_Dubai-F-Ana_Bogdan-Daria_Snigur,1,S-DTM,4,0,0,0,0,2,2
20191214-W-ITF_Dubai-F-Ana_Bogdan-Daria_Snigur,1,S-DTL,1,0,0,0,0,0,1
20191214-W-ITF_Dubai-F-Ana_Bogdan-Daria_Snigur,2,F-XC,48,6,2,0,4,23,25
20191214-W-ITF_Dubai-F-Ana_Bogdan-Daria_Snigur,2,F-DTM,22,4,0,0,4,8,14
20191214-W-ITF_Dubai-F-Ana_Bogdan-Daria_Snigur,2,F-DTL,12,7,2,3,2,7,5
20191214-W-ITF_Dubai-F-Ana_Bogdan-Daria_Snigur,2,F-IO,4,1,0,0,1,1,3
20191214-W-ITF_Dubai-F-Ana_Bogdan-Daria_Snigur,2,B-XC,18,7,3,3,1,9,9
20191214-W-ITF_Dubai-F-Ana_Bogdan-Daria_Snigur,2,B-DTM,30,0,0,0,0,10,20
20191214-W-ITF_Dubai-F-Ana_Bogdan-Daria_Snigur,2,B-DTL,13,3,1,1,1,5,8
20191214-W-ITF_Dubai-F-Ana_Bogdan-Daria_Snigur,2,B-IO,11,5,0,1,4,1,10
20191214-W-ITF_Dubai-F-Ana_Bogdan-Daria_Snigur,2,S-DTL,1,0,0,0,0,0,1
20190209-W-Fed_Cup_World_Group_II-RR-Bianca_Andreescu-Richel_Hogenkamp,1,F-XC,34,5,2,2,1,20,14
20190209-W-Fed_Cup_World_Group_II-RR-Bianca_Andreescu-Richel_Hogenkamp,1,F-DTM,7,1,0,0,1,4,3
20190209-W-Fed_Cup_World_Group_II-RR-Bianca_Andreescu-Richel_Hogenkamp,1,F-DTL,10,6,5,0,1,8,2
20190209-W-Fed_Cup_World_Group_II-RR-Bianca_Andreescu-Richel_Hogenkamp,1,F-IO,15,4,0,0,4,6,9
20190209-W-Fed_Cup_World_Group_II-RR-Bianca_Andreescu-Richel_Hogenkamp,1,F-II,1,1,1,0,0,1,0
20190209-W-Fed_Cup_World_Group_II-RR-Bianca_Andreescu-Richel_Hogenkamp,1,B-XC,33,9,2,2,5,18,15
20190209-W-Fed_Cup_World_Group_II-RR-Bianca_Andreescu-Richel_Hogenkamp,1,B-DTM,7,1,0,0,1,2,5
20190209-W-Fed_Cup_World_Group_II-RR-Bianca_Andreescu-Richel_Hogenkamp,1,B-DTL,5,2,2,0,0,4,1
20190209-W-Fed_Cup_World_Group_II-RR-Bianca_Andreescu-Richel_Hogenkamp,1,B-IO,2,2,1,1,0,2,0
20190209-W-Fed_Cup_World_Group_II-RR-Bianca_Andreescu-Richel_Hogenkamp,1,S-XC,7,3,1,1,1,4,3
20190209-W-Fed_Cup_World_Group_II-RR-Bianca_Andreescu-Richel_Hogenkamp,1,S-DTM,1,0,0,0,0,1,0
20190209-W-Fed_Cup_World_Group_II-RR-Bianca_Andreescu-Richel_Hogenkamp,1,S-DTL,1,0,0,0,0,1,0
20190209-W-Fed_Cup_World_Group_II-RR-Bianca_Andreescu-Richel_Hogenkamp,1,S-IO,2,1,0,0,1,1,1
20190209-W-Fed_Cup_World_Group_II-RR-Bianca_Andreescu-Richel_Hogenkamp,2,F-XC,20,3,1,0,2,7,13
20190209-W-Fed_Cup_World_Group_II-RR-Bianca_Andreescu-Richel_Hogenkamp,2,F-DTM,17,2,0,0,2,7,10
20190209-W-Fed_Cup_World_Group_II-RR-Bianca_Andreescu-Richel_Hogenkamp,2,F-DTL,5,1,0,1,0,3,2
20190209-W-Fed_Cup_World_Group_II-RR-Bianca_Andreescu-Richel_Hogenkamp,2,F-IO,9,0,0,0,0,6,3
20190209-W-Fed_Cup_World_Group_II-RR-Bianca_Andreescu-Richel_Hogenkamp,2,F-II,4,2,0,0,2,2,2
20190209-W-Fed_Cup_World_Group_II-RR-Bianca_Andreescu-Richel_Hogenkamp,2,B-XC,23,2,1,0,1,10,13
20190209-W-Fed_Cup_World_Group_II-RR-Bianca_Andreescu-Richel_Hogenkamp,2,B-DTM,8,2,0,0,2,2,6
20190209-W-Fed_Cup_World_Group_II-RR-Bianca_Andreescu-Richel_Hogenkamp,2,B-DTL,7,4,2,0,2,4,3
20190209-W-Fed_Cup_World_Group_II-RR-Bianca_Andreescu-Richel_Hogenkamp,2,B-IO,3,0,0,0,0,1,2
20190209-W-Fed_Cup_World_Group_II-RR-Bianca_Andreescu-Richel_Hogenkamp,2,S-XC,5,0,0,0,0,0,5
20190209-W-Fed_Cup_World_Group_II-RR-Bianca_Andreescu-Richel_Hogenkamp,2,S-DTM,4,0,0,0,0,2,2
20190209-W-Fed_Cup_World_Group_II-RR-Bianca_Andreescu-Richel_Hogenkamp,2,S-DTL,3,2,0,1,1,1,2
20170731-W-Washington-R32-Bianca_Andreescu-Camila_Giorgi,1,F-XC,14,11,3,3,5,8,6
20170731-W-Washington-R32-Bianca_Andreescu-Camila_Giorgi,1,F-DTM,39,4,0,0,4,18,21
20170731-W-Washington-R32-Bianca_Andreescu-Camila_Giorgi,1,F-DTL,5,2,2,0,0,3,2
20170731-W-Washington-R32-Bianca_Andreescu-Camila_Giorgi,1,F-IO,8,2,1,1,0,4,4
20170731-W-Washington-R32-Bianca_Andreescu-Camila_Giorgi,1,B-XC,19,5,2,0,3,11,8
20170731-W-Washington-R32-Bianca_Andreescu-Camila_Giorgi,1,B-DTM,30,5,0,0,5,16,14
20170731-W-Washington-R32-Bianca_Andreescu-Camila_Giorgi,1,B-DTL,1,1,0,0,1,0,1
20170731-W-Washington-R32-Bianca_Andreescu-Camila_Giorgi,1,B-IO,5,3,1,0,2,2,3
20170731-W-Washington-R32-Bianca_Andreescu-Camila_Giorgi,1,S-DTM,2,0,0,0,0,0,2
20170731-W-Washington-R32-Bianca_Andreescu-Camila_Giorgi,2,F-XC,31,15,3,5,7,20,11
20170731-W-Washington-R32-Bianca_Andreescu-Camila_Giorgi,2,F-DTM,34,7,0,0,7,14,20
20170731-W-Washington-R32-Bianca_Andreescu-Camila_Giorgi,2,F-DTL,2,0,0,0,0,2,0
20170731-W-Washington-R32-Bianca_Andreescu-Camila_Giorgi,2,F-IO,9,5,3,1,1,5,4
20170731-W-Washington-R32-Bianca_Andreescu-Camila_Giorgi,2,B-XC,27,12,4,1,7,16,11
20170731-W-Washington-R32-Bianca_Andreescu-Camila_Giorgi,2,B-DTM,29,10,0,0,10,8,21
20170731-W-Washington-R32-Bianca_Andreescu-Camila_Giorgi,2,B-DTL,2,1,0,0,1,0,2
20170731-W-Washington-R32-Bianca_Andreescu-Camila_Giorgi,2,B-IO,2,0,0,0,0,0,2
20170731-W-Washington-R32-Bianca_Andreescu-Camila_Giorgi,2,S-DTM,1,0,0,0,0,0,1
20170731-W-Washington-R32-Bianca_Andreescu-Camila_Giorgi,2,S-DTL,1,0,0,0,0,1,0
20191025-W-Zhuhai-RR-Karolina_Muchova-Sofia_Kenin,1,F-XC,37,9,3,2,4,23,14
20191025-W-Zhuhai-RR-Karolina_Muchova-Sofia_Kenin,1,F-DTM,25,2,0,1,1,13,12
20191025-W-Zhuhai-RR-Karolina_Muchova-Sofia_Kenin,1,F-DTL,19,7,2,1,4,6,13
20191025-W-Zhuhai-RR-Karolina_Muchova-Sofia_Kenin,1,F-IO,18,8,4,0,4,9,9
20191025-W-Zhuhai-RR-Karolina_Muchova-Sofia_Kenin,1,F-II,2,1,1,0,0,2,0
20191025-W-Zhuhai-RR-Karolina_Muchova-Sofia_Kenin,1,B-XC,17,3,1,1,1,12,5
20191025-W-Zhuhai-RR-Karolina_Muchova-Sofia_Kenin,1,B-DTM,27,1,0,0,1,17,10
20191025-W-Zhuhai-RR-Karolina_Muchova-Sofia_Kenin,1,B-DTL,9,7,3,1,3,5,4
20191025-W-Zhuhai-RR-Karolina_Muchova-Sofia_Kenin,1,B-IO,12,4,1,1,2,8,4
20191025-W-Zhuhai-RR-Karolina_Muchova-Sofia_Kenin,1,S-XC,17,2,0,0,2,7,10
20191025-W-Zhuhai-RR-Karolina_Muchova-Sofia_Kenin,1,S-DTM,24,2,0,1,1,11,13
20191025-W-Zhuhai-RR-Karolina_Muchova-Sofia_Kenin,1,S-DTL,6,2,0,0,2,2,4
20191025-W-Zhuhai-RR-Karolina_Muchova-Sofia_Kenin,1,S-IO,3,1,0,0,1,2,1
20191025-W-Zhuhai-RR-Karolina_Muchova-Sofia_Kenin,2,F-XC,58,19,6,1,12,28,30
20191025-W-Zhuhai-RR-Karolina_Muchova-Sofia_Kenin,2,F-DTM,29,1,0,0,1,11,18
20191025-W-Zhuhai-RR-Karolina_Muchova-Sofia_Kenin,2,F-DTL,7,4,2,1,1,3,4
20191025-W-Zhuhai-RR-Karolina_Muchova-Sofia_Kenin,2,F-IO,10,0,0,0,0,4,6
20191025-W-Zhuhai-RR-Karolina_Muchova-Sofia_Kenin,2,B-XC,54,10,3,2,5,28,26
20191025-W-Zhuhai-RR-Karolina_Muchova-Sofia_Kenin,2,B-DTM,35,2,0,0,2,15,20
20191025-W-Zhuhai-RR-Karolina_Muchova-Sofia_Kenin,2,B-DTL,5,2,0,1,1,3,2
20191025-W-Zhuhai-RR-Karolina_Muchova-Sofia_Kenin,2,B-IO,6,1,0,0,1,4,2
20191025-W-Zhuhai-RR-Karolina_Muchova-Sofia_Kenin,2,S-XC,10,0,0,0,0,4,6
20191025-W-Zhuhai-RR-Karolina_Muchova-Sofia_Kenin,2,S-DTM,9,0,0,0,0,5,4
20191025-W-Zhuhai-RR-Karolina_Muchova-Sofia_Kenin,2,S-IO,2,0,0,0,0,0,2
20011031-W-WTA_Tour_Championships-R16-Jelena_Dokic-Meghann_Shaughnessy,1,F-XC,41,18,7,5,6,28,13
20011031-W-WTA_Tour_Championships-R16-Jelena_Dokic-Meghann_Shaughnessy,1,F-DTM,12,0,0,0,0,7,5
20011031-W-WTA_Tour_Championships-R16-Jelena_Dokic-Meghann_Shaughnessy,1,F-DTL,10,4,1,0,3,5,5
20011031-W-WTA_Tour_Championships-R16-Jelena_Dokic-Meghann_Shaughnessy,1,F-IO,8,2,0,1,1,4,4
20011031-W-WTA_Tour_Championships-R16-Jelena_Dokic-Meghann_Shaughnessy,1,F-II,2,1,1,0,0,2,0
20011031-W-WTA_Tour_Championships-R16-Jelena_Dokic-Meghann_Shaughnessy,1,B-XC,37,7,3,3,1,24,13
20011031-W-WTA_Tour_Championships-R16-Jelena_Dokic-Meghann_Shaughnessy,1,B-DTM,11,2,0,0,2,5,6
20011031-W-WTA_Tour_Championships-R16-Jelena_Dokic-Meghann_Shaughnessy,1,B-DTL,5,3,2,0,1,3,2
20011031-W-WTA_Tour_Championships-R16-Jelena_Dokic-Meghann_Shaughnessy,1,B-IO,1,0,0,0,0,1,0
20011031-W-WTA_Tour_Championships-R16-Jelena_Dokic-Meghann_Shaughnessy,1,S-XC,1,0,0,0,0,1,0
20011031-W-WTA_Tour_Championships-R16-Jelena_Dokic-Meghann_Shaughnessy,2,F-XC,24,8,2,2,4,11,13
20011031-W-WTA_Tour_Championships-R16-Jelena_Dokic-Meghann_Shaughnessy,2,F-DTM,22,0,0,0,0,8,14
20011031-W-WTA_Tour_Championships-R16-Jelena_Dokic-Meghann_Shaughnessy,2,F-DTL,10,7,1,1,5,4,6
20011031-W-WTA_Tour_Championships-R16-Jelena_Dokic-Meghann_Shaughnessy,2,F-IO,11,2,1,0,1,4,7
20011031-W-WTA_Tour_Championships-R16-Jelena_Dokic-Meghann_Shaughnessy,2,F-II,7,3,3,0,0,3,4
20011031-W-WTA_Tour_Championships-R16-Jelena_Dokic-Meghann_Shaughnessy,2,B-XC,21,2,0,1,1,5,16
20011031-W-WTA_Tour_Championships-R16-Jelena_Dokic-Meghann_Shaughnessy,2,B-DTM,17,3,1,0,2,8,9
20011031-W-WTA_Tour_Championships-R16-Jelena_Dokic-Meghann_Shaughnessy,2,B-DTL,8,8,4,0,4,4,4
20011031-W-WTA_Tour_Championships-R16-Jelena_Dokic-Meghann_Shaughnessy,2,B-IO,5,2,1,0,1,3,2
20011031-W-WTA_Tour_Championships-R16-Jelena_Dokic-Meghann_Shaughnessy,2,S-XC,4,1,0,1,0,3,1
20011031-W-WTA_Tour_Championships-R16-Jelena_Dokic-Meghann_Shaughnessy,2,S-DTM,4,0,0,0,0,1,3
20011031-W-WTA_Tour_Championships-R16-Jelena_Dokic-Meghann_Shaughnessy,2,S-DTL,1,0,0,0,0,1,0
20090630-W-Wimbledon-QF-Dinara_Safina-Sabine_Lisicki,1,F-XC,37,10,4,2,4,21,16
20090630-W-Wimbledon-QF-Dinara_Safina-Sabine_Lisicki,1,F-DTM,19,4,0,0,4,10,9
20090630-W-Wimbledon-QF-Dinara_Safina-Sabine_Lisicki,1,F-DTL,13,5,1,1,3,8,5
20090630-W-Wimbledon-QF-Dinara_Safina-Sabine_Lisicki,1,F-IO,16,7,2,3,2,10,6
20090630-W-Wimbledon-QF-Dinara_Safina-Sabine_Lisicki,1,B-XC,54,14,7,3,4,32,22
20090630-W-Wimbledon-QF-Dinara_Safina-Sabine_Lisicki,1,B-DTM,25,3,0,1,2,11,14
20090630-W-Wimbledon-QF-Dinara_Safina-Sabine_Lisicki,1,B-DTL,6,5,1,3,1,5,1
20090630-W-Wimbledon-QF-Dinara_Safina-Sabine_Lisicki,1,B-IO,8,4,1,0,3,4,4
20090630-W-Wimbledon-QF-Dinara_Safina-Sabine_Lisicki,1,S-XC,3,1,1,0,0,1,2
20090630-W-Wimbledon-QF-Dinara_Safina-Sabine_Lisicki,1,S-DTM,1,0,0,0,0,0,1
20090630-W-Wimbledon-QF-Dinara_Safina-Sabine_Lisicki,1,S-DTL,2,0,0,0,0,1,1
20090630-W-Wimbledon-QF-Dinara_Safina-Sabine_Lisicki,2,F-XC,38,12,3,1,7,19,19
20090630-W-Wimbledon-QF-Dinara_Safina-Sabine_Lisicki,2,F-DTM,16,4,0,0,4,4,12
20090630-W-Wimbledon-QF-Dinara_Safina-Sabine_Lisicki,2,F-DTL,10,8,3,1,4,5,5
20090630-W-Wimbledon-QF-Dinara_Safina-Sabine_Lisicki,2,F-IO,16,9,2,2,5,10,6
20090630-W-Wimbledon-QF-Dinara_Safina-Sabine_Lisicki,2,B-XC,48,8,2,1,5,19,29
20090630-W-Wimbledon-QF-Dinara_Safina-Sabine_Lisicki,2,B-DTM,24,2,0,0,2,14,10
20090630-W-Wimbledon-QF-Dinara_Safina-Sabine_Lisicki,2,B-DTL,11,5,1,2,2,5,6
20090630-W-Wimbledon-QF-Dinara_Safina-Sabine_Lisicki,2,B-IO,9,2,0,0,2,2,7
20090630-W-Wimbledon-QF-Dinara_Safina-Sabine_Lisicki,2,S-XC,1,0,0,0,0,0,1
20090630-W-Wimbledon-QF-Dinara_Safina-Sabine_Lisicki,2,S-DTM,5,0,0,0,0,2,3
20200107-W-Brisbane-R32-Dayana_Yastremska-Kiki_Bertens,1,F-XC,83,20,1,6,13,45,38
20200107-W-Brisbane-R32-Dayana_Yastremska-Kiki_Bertens,1,F-DTM,30,5,0,0,5,12,18
20200107-W-Brisbane-R32-Dayana_Yastremska-Kiki_Bertens,1,F-DTL,6,4,3,0,1,4,2
20200107-W-Brisbane-R32-Dayana_Yastremska-Kiki_Bertens,1,F-IO,15,7,2,0,5,7,8
20200107-W-Brisbane-R32-Dayana_Yastremska-Kiki_Bertens,1,B-XC,38,11,3,3,5,23,15
20200107-W-Brisbane-R32-Dayana_Yastremska-Kiki_Bertens,1,B-DTM,26,3,0,0,3,16,10
20200107-W-Brisbane-R32-Dayana_Yastremska-Kiki_Bertens,1,B-DTL,3,2,0,1,1,2,1
20200107-W-Brisbane-R32-Dayana_Yastremska-Kiki_Bertens,1,B-IO,10,3,1,1,1,6,4
20200107-W-Brisbane-R32-Dayana_Yastremska-Kiki_Bertens,1,S-XC,1,0,0,0,0,1,0
20200107-W-Brisbane-R32-Dayana_Yastremska-Kiki_Bertens,1,S-DTM,1,0,0,0,0,0,1
20200107-W-Brisbane-R32-Dayana_Yastremska-Kiki_Bertens,1,S-DTL,1,0,0,0,0,1,0
20200107-W-Brisbane-R32-Dayana_Yastremska-Kiki_Bertens,1,S-IO,1,0,0,0,0,0,1
20200107-W-Brisbane-R32-Dayana_Yastremska-Kiki_Bertens,2,F-XC,48,10,1,0,9,25,23
20200107-W-Brisbane-R32-Dayana_Yastremska-Kiki_Bertens,2,F-DTM,43,3,0,0,3,19,24
20200107-W-Brisbane-R32-Dayana_Yastremska-Kiki_Bertens,2,F-DTL,11,4,1,0,3,2,9
20200107-W-Brisbane-R32-Dayana_Yastremska-Kiki_Bertens,2,F-IO,11,5,2,0,3,4,7
20200107-W-Brisbane-R32-Dayana_Yastremska-Kiki_Bertens,2,F-II,2,1,0,1,0,1,1
20200107-W-Brisbane-R32-Dayana_Yastremska-Kiki_Bertens,2,B-XC,12,0,0,0,0,6,6
20200107-W-Brisbane-R32-Dayana_Yastremska-Kiki_Bertens,2,B-DTM,20,1,0,0,1,7,13
20200107-W-Brisbane-R32-Dayana_Yastremska-Kiki_Bertens,2,B-DTL,5,3,1,1,1,3,2
20200107-W-Brisbane-R32-Dayana_Yastremska-Kiki_Bertens,2,B-IO,4,0,0,0,0,2,2
20200107-W-Brisbane-R32-Dayana_Yastremska-Kiki_Bertens,2,S-XC,3,0,0,0,0,0,3
20200107-W-Brisbane-R32-Dayana_Yastremska-Kiki_Bertens,2,S-DTM,15,1,0,0,1,5,10
20200109-W-Brisbane-R16-Anett_Kontaveit-Kiki_Bertens,1,F-XC,62,10,2,4,4,34,28
20200109-W-Brisbane-R16-Anett_Kontaveit-Kiki_Bertens,1,F-DTM,24,7,0,0,7,10,14
20200109-W-Brisbane-R16-Anett_Kontaveit-Kiki_Bertens,1,F-DTL,16,9,4,0,5,9,7
20200109-W-Brisbane-R16-Anett_Kontaveit-Kiki_Bertens,1,F-IO,27,12,5,3,4,17,10
20200109-W-Brisbane-R16-Anett_Kontaveit-Kiki_Bertens,1,F-II,1,0,0,0,0,1,0
20200109-W-Brisbane-R16-Anett_Kontaveit-Kiki_Bertens,1,B-XC,42,9,3,1,5,23,19
20200109-W-Brisbane-R16-Anett_Kontaveit-Kiki_Bertens,1,B-DTM,15,2,0,1,1,4,11
20200109-W-Brisbane-R16-Anett_Kontaveit-Kiki_Bertens,1,B-DTL,11,8,5,0,3,6,5
20200109-W-Brisbane-R16-Anett_Kontaveit-Kiki_Bertens,1,B-IO,4,2,1,1,0,4,0
20200109-W-Brisbane-R16-Anett_Kontaveit-Kiki_Bertens,1,S-DTM,1,0,0,0,0,0,1
20200109-W-Brisbane-R16-Anett_Kontaveit-Kiki_Bertens,1,S-DTL,2,0,0,0,0,1,1
20200109-W-Brisbane-R16-Anett_Kontaveit-Kiki_Bertens,2,F-XC,55,14,3,2,9,23,32
20200109-W-Brisbane-R16-Anett_Kontaveit-Kiki_Bertens,2,F-DTM,18,2,1,1,0,12,6
20200109-W-Brisbane-R16-Anett_Kontaveit-Kiki_Bertens,2,F-DTL,9,5,4,0,1,5,4
20200109-W-Brisbane-R16-Anett_Kontaveit-Kiki_Bertens,2,F-IO,14,8,2,3,3,9,5
20200109-W-Brisbane-R16-Anett_Kontaveit-Kiki_Bertens,2,F-II,3,2,2,0,0,3,0
20200109-W-Brisbane-R16-Anett_Kontaveit-Kiki_Bertens,2,B-XC,24,2,0,1,1,13,11
20200109-W-Brisbane-R16-Anett_Kontaveit-Kiki_Bertens,2,B-DTM,15,1,0,0,1,7,8
20200109-W-Brisbane-R16-Anett_Kontaveit-Kiki_Bertens,2,B-DTL,3,2,0,1,1,2,1
20200109-W-Brisbane-R16-Anett_Kontaveit-Kiki_Bertens,2,S-XC,11,1,0,0,1,3,8
20200109-W-Brisbane-R16-Anett_Kontaveit-Kiki_Bertens,2,S-DTM,13,2,0,0,2,6,7
20200109-W-Brisbane-R16-Anett_Kontaveit-Kiki_Bertens,2,S-DTL,1,0,0,0,0,0,1
20200110-W-Brisbane-QF-Naomi_Osaka-Kiki_Bertens,1,F-XC,62,14,2,5,7,37,25
20200110-W-Brisbane-QF-Naomi_Osaka-Kiki_Bertens,1,F-DTM,25,1,0,0,1,16,9
20200110-W-Brisbane-QF-Naomi_Osaka-Kiki_Bertens,1,F-DTL,5,3,0,0,3,1,4
20200110-W-Brisbane-QF-Naomi_Osaka-Kiki_Bertens,1,F-IO,21,10,7,3,0,15,6
20200110-W-Brisbane-QF-Naomi_Osaka-Kiki_Bertens,1,F-II,2,1,0,1,0,2,0
20200110-W-Brisbane-QF-Naomi_Osaka-Kiki_Bertens,1,B-XC,43,9,4,2,3,31,12
20200110-W-Brisbane-QF-Naomi_Osaka-Kiki_Bertens,1,B-DTM,22,2,0,0,2,9,13
20200110-W-Brisbane-QF-Naomi_Osaka-Kiki_Bertens,1,B-DTL,8,5,1,1,3,2,6
20200110-W-Brisbane-QF-Naomi_Osaka-Kiki_Bertens,1,B-IO,15,8,3,2,3,11,4
20200110-W-Brisbane-QF-Naomi_Osaka-Kiki_Bertens,1,S-XC,1,0,0,0,0,0,1
20200110-W-Brisbane-QF-Naomi_Osaka-Kiki_Bertens,2,F-XC,40,8,1,5,2,17,23
20200110-W-Brisbane-QF-Naomi_Osaka-Kiki_Bertens,2,F-DTM,27,5,1,0,4,10,17
20200110-W-Brisbane-QF-Naomi_Osaka-Kiki_Bertens,2,F-DTL,17,11,2,4,5,8,9
20200110-W-Brisbane-QF-Naomi_Osaka-Kiki_Bertens,2,F-IO,19,9,6,1,2,14,5
20200110-W-Brisbane-QF-Naomi_Osaka-Kiki_Bertens,2,F-II,1,1,1,0,0,1,0
20200110-W-Brisbane-QF-Naomi_Osaka-Kiki_Bertens,2,B-XC,20,3,0,0,3,7,13
20200110-W-Brisbane-QF-Naomi_Osaka-Kiki_Bertens,2,B-DTM,27,3,0,0,3,9,18
20200110-W-Brisbane-QF-Naomi_Osaka-Kiki_Bertens,2,B-DTL,1,0,0,0,0,1,0
20200110-W-Brisbane-QF-Naomi_Osaka-Kiki_Bertens,2,B-IO,3,0,0,0,0,1,2
20200110-W-Brisbane-QF-Naomi_Osaka-Kiki_Bertens,2,S-XC,8,1,0,0,1,2,6
20200110-W-Brisbane-QF-Naomi_Osaka-Kiki_Bertens,2,S-DTM,17,0,0,0,0,5,12
20200110-W-Brisbane-QF-Naomi_Osaka-Kiki_Bertens,2,S-DTL,4,1,0,0,1,3,1
20200109-W-Shenzhen-QF-Elena_Rybakina-Elise_Mertens,1,F-XC,64,17,6,5,6,37,27
20200109-W-Shenzhen-QF-Elena_Rybakina-Elise_Mertens,1,F-DTM,15,1,0,1,0,8,7
20200109-W-Shenzhen-QF-Elena_Rybakina-Elise_Mertens,1,F-DTL,17,9,7,0,2,11,6
20200109-W-Shenzhen-QF-Elena_Rybakina-Elise_Mertens,1,F-IO,10,5,2,0,3,5,5
20200109-W-Shenzhen-QF-Elena_Rybakina-Elise_Mertens,1,B-XC,33,9,6,2,1,20,13
20200109-W-Shenzhen-QF-Elena_Rybakina-Elise_Mertens,1,B-DTM,25,1,0,1,0,16,9
20200109-W-Shenzhen-QF-Elena_Rybakina-Elise_Mertens,1,B-DTL,18,11,6,3,2,13,5
20200109-W-Shenzhen-QF-Elena_Rybakina-Elise_Mertens,1,B-IO,13,4,3,0,1,8,5
20200109-W-Shenzhen-QF-Elena_Rybakina-Elise_Mertens,1,S-XC,2,1,1,0,0,2,0
20200109-W-Shenzhen-QF-Elena_Rybakina-Elise_Mertens,1,S-DTM,4,1,0,0,1,2,2
20200109-W-Shenzhen-QF-Elena_Rybakina-Elise_Mertens,1,S-IO,1,0,0,0,0,0,1
20200109-W-Shenzhen-QF-Elena_Rybakina-Elise_Mertens,2,F-XC,41,11,3,3,5,18,23
20200109-W-Shenzhen-QF-Elena_Rybakina-Elise_Mertens,2,F-DTM,28,3,0,0,3,10,18
20200109-W-Shenzhen-QF-Elena_Rybakina-Elise_Mertens,2,F-DTL,18,6,3,0,3,8,10
20200109-W-Shenzhen-QF-Elena_Rybakina-Elise_Mertens,2,F-IO,16,4,1,0,3,7,9
20200109-W-Shenzhen-QF-Elena_Rybakina-Elise_Mertens,2,B-XC,22,8,0,2,6,9,13
20200109-W-Shenzhen-QF-Elena_Rybakina-Elise_Mertens,2,B-DTM,16,1,0,0,1,6,10
20200109-W-Shenzhen-QF-Elena_Rybakina-Elise_Mertens,2,B-DTL,9,5,3,2,0,7,2
20200109-W-Shenzhen-QF-Elena_Rybakina-Elise_Mertens,2,B-IO,4,1,1,0,0,1,3
20200109-W-Shenzhen-QF-Elena_Rybakina-Elise_Mertens,2,S-XC,5,1,0,0,1,2,3
20200109-W-Shenzhen-QF-Elena_Rybakina-Elise_Mertens,2,S-DTM,6,0,0,0,0,2,4
20200109-W-Shenzhen-QF-Elena_Rybakina-Elise_Mertens,2,S-DTL,1,0,0,0,0,0,1
20190111-W-Australian_Open-Q3-Tereza_Smitkova-Bianca_Andreescu,1,F-XC,12,8,3,1,4,6,6
20190111-W-Australian_Open-Q3-Tereza_Smitkova-Bianca_Andreescu,1,F-DTM,8,0,0,0,0,5,3
20190111-W-Australian_Open-Q3-Tereza_Smitkova-Bianca_Andreescu,1,F-DTL,1,1,1,0,0,1,0
20190111-W-Australian_Open-Q3-Tereza_Smitkova-Bianca_Andreescu,1,F-IO,10,7,0,2,5,2,8
20190111-W-Australian_Open-Q3-Tereza_Smitkova-Bianca_Andreescu,1,B-XC,8,1,0,1,0,1,7
20190111-W-Australian_Open-Q3-Tereza_Smitkova-Bianca_Andreescu,1,B-DTM,12,5,0,0,5,1,11
20190111-W-Australian_Open-Q3-Tereza_Smitkova-Bianca_Andreescu,1,B-DTL,1,0,0,0,0,1,0
20190111-W-Australian_Open-Q3-Tereza_Smitkova-Bianca_Andreescu,1,B-IO,6,4,1,0,3,2,4
20190111-W-Australian_Open-Q3-Tereza_Smitkova-Bianca_Andreescu,1,S-XC,1,0,0,0,0,0,1
20190111-W-Australian_Open-Q3-Tereza_Smitkova-Bianca_Andreescu,2,F-XC,9,4,1,1,2,2,7
20190111-W-Australian_Open-Q3-Tereza_Smitkova-Bianca_Andreescu,2,F-DTM,8,1,0,0,1,5,3
20190111-W-Australian_Open-Q3-Tereza_Smitkova-Bianca_Andreescu,2,F-DTL,3,3,2,0,1,2,1
20190111-W-Australian_Open-Q3-Tereza_Smitkova-Bianca_Andreescu,2,F-IO,6,3,1,0,2,3,3
20190111-W-Australian_Open-Q3-Tereza_Smitkova-Bianca_Andreescu,2,B-XC,7,3,0,3,0,6,1
20190111-W-Australian_Open-Q3-Tereza_Smitkova-Bianca_Andreescu,2,B-DTM,7,0,0,0,0,6,1
20190111-W-Australian_Open-Q3-Tereza_Smitkova-Bianca_Andreescu,2,B-DTL,1,1,0,1,0,1,0
20190111-W-Australian_Open-Q3-Tereza_Smitkova-Bianca_Andreescu,2,B-IO,3,2,1,0,1,1,2
20190111-W-Australian_Open-Q3-Tereza_Smitkova-Bianca_Andreescu,2,S-DTM,5,0,0,0,0,5,0
20190111-W-Australian_Open-Q3-Tereza_Smitkova-Bianca_Andreescu,2,S-DTL,1,0,0,0,0,1,0
20200112-W-Auckland-F-Serena_Williams-Jessica_Pegula,1,F-XC,34,16,4,3,9,16,18
20200112-W-Auckland-F-Serena_Williams-Jessica_Pegula,1,F-DTM,35,3,1,0,2,20,15
20200112-W-Auckland-F-Serena_Williams-Jessica_Pegula,1,F-DTL,6,3,2,0,1,4,2
20200112-W-Auckland-F-Serena_Williams-Jessica_Pegula,1,F-IO,16,9,6,1,2,11,5
20200112-W-Auckland-F-Serena_Williams-Jessica_Pegula,1,F-II,1,1,1,0,0,1,0
20200112-W-Auckland-F-Serena_Williams-Jessica_Pegula,1,B-XC,27,9,2,2,5,13,14
20200112-W-Auckland-F-Serena_Williams-Jessica_Pegula,1,B-DTM,28,3,0,0,3,17,11
20200112-W-Auckland-F-Serena_Williams-Jessica_Pegula,1,B-DTL,9,5,2,2,1,7,2
20200112-W-Auckland-F-Serena_Williams-Jessica_Pegula,1,B-IO,11,2,1,1,0,9,2
20200112-W-Auckland-F-Serena_Williams-Jessica_Pegula,1,S-XC,1,0,0,0,0,1,0
20200112-W-Auckland-F-Serena_Williams-Jessica_Pegula,1,S-DTM,1,0,0,0,0,0,1
20200112-W-Auckland-F-Serena_Williams-Jessica_Pegula,1,S-DTL,1,0,0,0,0,1,0
20200112-W-Auckland-F-Serena_Williams-Jessica_Pegula,2,F-XC,39,11,3,1,7,14,25
20200112-W-Auckland-F-Serena_Williams-Jessica_Pegula,2,F-DTM,36,3,0,1,1,17,19
20200112-W-Auckland-F-Serena_Williams-Jessica_Pegula,2,F-DTL,3,1,0,0,1,1,2
20200112-W-Auckland-F-Serena_Williams-Jessica_Pegula,2,F-IO,8,3,3,0,0,5,3
20200112-W-Auckland-F-Serena_Williams-Jessica_Pegula,2,F-II,1,1,0,0,1,0,1
20200112-W-Auckland-F-Serena_Williams-Jessica_Pegula,2,B-XC,28,8,2,3,3,12,16
20200112-W-Auckland-F-Serena_Williams-Jessica_Pegula,2,B-DTM,26,2,0,0,2,12,14
20200112-W-Auckland-F-Serena_Williams-Jessica_Pegula,2,B-DTL,4,1,1,0,0,4,0
20200112-W-Auckland-F-Serena_Williams-Jessica_Pegula,2,B-IO,3,0,0,0,0,2,1
20200112-W-Auckland-F-Serena_Williams-Jessica_Pegula,2,S-XC,6,0,0,0,0,1,5
20200112-W-Auckland-F-Serena_Williams-Jessica_Pegula,2,S-DTM,6,0,0,0,0,1,5
20200110-W-Shenzhen-SF-Elena_Rybakina-Kristyna_Pliskova,1,F-XC,16,8,2,2,4,9,7
20200110-W-Shenzhen-SF-Elena_Rybakina-Kristyna_Pliskova,1,F-DTM,10,2,1,1,0,8,2
20200110-W-Shenzhen-SF-Elena_Rybakina-Kristyna_Pliskova,1,F-DTL,4,2,1,0,1,2,2
20200110-W-Shenzhen-SF-Elena_Rybakina-Kristyna_Pliskova,1,F-IO,2,2,2,0,0,2,0
20200110-W-Shenzhen-SF-Elena_Rybakina-Kristyna_Pliskova,1,B-XC,13,5,2,3,0,12,1
20200110-W-Shenzhen-SF-Elena_Rybakina-Kristyna_Pliskova,1,B-DTM,7,0,0,0,0,5,2
20200110-W-Shenzhen-SF-Elena_Rybakina-Kristyna_Pliskova,1,B-DTL,6,4,2,1,1,4,2
20200110-W-Shenzhen-SF-Elena_Rybakina-Kristyna_Pliskova,1,B-IO,3,1,0,0,1,2,1
20200110-W-Shenzhen-SF-Elena_Rybakina-Kristyna_Pliskova,1,S-IO,1,0,0,0,0,1,0
20200110-W-Shenzhen-SF-Elena_Rybakina-Kristyna_Pliskova,2,F-XC,12,5,3,2,0,9,3
20200110-W-Shenzhen-SF-Elena_Rybakina-Kristyna_Pliskova,2,F-DTM,5,0,0,0,0,1,4
20200110-W-Shenzhen-SF-Elena_Rybakina-Kristyna_Pliskova,2,F-DTL,4,3,0,0,3,0,4
20200110-W-Shenzhen-SF-Elena_Rybakina-Kristyna_Pliskova,2,F-IO,10,6,3,0,3,5,5
20200110-W-Shenzhen-SF-Elena_Rybakina-Kristyna_Pliskova,2,B-XC,11,6,2,1,3,6,5
20200110-W-Shenzhen-SF-Elena_Rybakina-Kristyna_Pliskova,2,B-DTM,7,1,0,0,1,2,5
20200110-W-Shenzhen-SF-Elena_Rybakina-Kristyna_Pliskova,2,B-DTL,2,1,0,0,1,0,2
20200110-W-Shenzhen-SF-Elena_Rybakina-Kristyna_Pliskova,2,B-IO,6,4,3,0,1,3,3
20200110-W-Shenzhen-SF-Elena_Rybakina-Kristyna_Pliskova,2,S-XC,1,0,0,0,0,0,1
20200110-W-Shenzhen-SF-Elena_Rybakina-Kristyna_Pliskova,2,S-DTM,2,0,0,0,0,0,2
20200110-W-Shenzhen-SF-Elena_Rybakina-Kristyna_Pliskova,2,S-DTL,1,0,0,0,0,0,1
20200111-W-Auckland-SF-Amanda_Anisimova-Serena_Williams,1,F-XC,14,5,4,0,1,7,7
20200111-W-Auckland-SF-Amanda_Anisimova-Serena_Williams,1,F-DTM,7,1,0,0,1,2,5
20200111-W-Auckland-SF-Amanda_Anisimova-Serena_Williams,1,F-DTL,2,1,1,0,0,2,0
20200111-W-Auckland-SF-Amanda_Anisimova-Serena_Williams,1,F-IO,4,3,2,1,0,4,0
20200111-W-Auckland-SF-Amanda_Anisimova-Serena_Williams,1,B-XC,17,2,1,0,1,6,11
20200111-W-Auckland-SF-Amanda_Anisimova-Serena_Williams,1,B-DTM,4,1,0,0,1,0,4
20200111-W-Auckland-SF-Amanda_Anisimova-Serena_Williams,1,B-DTL,2,1,0,1,0,2,0
20200111-W-Auckland-SF-Amanda_Anisimova-Serena_Williams,1,B-IO,1,1,0,0,1,0,1
20200111-W-Auckland-SF-Amanda_Anisimova-Serena_Williams,1,S-XC,2,1,0,0,1,0,2
20200111-W-Auckland-SF-Amanda_Anisimova-Serena_Williams,1,S-DTM,1,0,0,0,0,0,1
20200111-W-Auckland-SF-Amanda_Anisimova-Serena_Williams,1,S-DTL,1,1,0,0,1,0,1
20200111-W-Auckland-SF-Amanda_Anisimova-Serena_Williams,2,F-XC,8,5,3,1,1,6,2
20200111-W-Auckland-SF-Amanda_Anisimova-Serena_Williams,2,F-DTM,6,1,0,1,0,3,3
20200111-W-Auckland-SF-Amanda_Anisimova-Serena_Williams,2,F-DTL,5,3,0,1,2,3,2
20200111-W-Auckland-SF-Amanda_Anisimova-Serena_Williams,2,F-IO,4,1,1,0,0,4,0
20200111-W-Auckland-SF-Amanda_Anisimova-Serena_Williams,2,B-XC,9,1,1,0,0,6,3
20200111-W-Auckland-SF-Amanda_Anisimova-Serena_Williams,2,B-DTM,11,1,0,1,0,6,5
20200111-W-Auckland-SF-Amanda_Anisimova-Serena_Williams,2,B-DTL,3,2,2,0,0,2,1
20200111-W-Auckland-SF-Amanda_Anisimova-Serena_Williams,2,B-IO,3,1,1,0,0,1,2
20200111-W-Auckland-SF-Amanda_Anisimova-Serena_Williams,2,S-XC,4,1,0,1,0,4,0
20200111-W-Auckland-SF-Amanda_Anisimova-Serena_Williams,2,S-DTM,2,0,0,0,0,0,2
20200106-W-Auckland-R32-Valentina_Ivanov-Jil_Teichmann,1,F-XC,23,6,3,1,2,15,8
20200106-W-Auckland-R32-Valentina_Ivanov-Jil_Teichmann,1,F-DTM,52,2,0,0,2,14,38
20200106-W-Auckland-R32-Valentina_Ivanov-Jil_Teichmann,1,F-DTL,12,3,0,1,2,8,4
20200106-W-Auckland-R32-Valentina_Ivanov-Jil_Teichmann,1,F-IO,42,12,6,0,6,24,18
20200106-W-Auckland-R32-Valentina_Ivanov-Jil_Teichmann,1,F-II,4,1,0,0,1,2,2
20200106-W-Auckland-R32-Valentina_Ivanov-Jil_Teichmann,1,B-XC,36,3,1,0,2,10,26
20200106-W-Auckland-R32-Valentina_Ivanov-Jil_Teichmann,1,B-DTM,52,4,0,0,4,11,41
20200106-W-Auckland-R32-Valentina_Ivanov-Jil_Teichmann,1,B-DTL,14,5,0,2,3,5,9
20200106-W-Auckland-R32-Valentina_Ivanov-Jil_Teichmann,1,B-IO,1,0,0,0,0,0,1
20200106-W-Auckland-R32-Valentina_Ivanov-Jil_Teichmann,1,S-XC,1,0,0,0,0,1,0
20200106-W-Auckland-R32-Valentina_Ivanov-Jil_Teichmann,1,S-DTM,9,0,0,0,0,2,7
20200106-W-Auckland-R32-Valentina_Ivanov-Jil_Teichmann,1,S-IO,2,0,0,0,0,0,2
20200106-W-Auckland-R32-Valentina_Ivanov-Jil_Teichmann,2,F-XC,111,20,7,3,10,79,32
20200106-W-Auckland-R32-Valentina_Ivanov-Jil_Teichmann,2,F-DTM,55,7,0,1,6,26,29
20200106-W-Auckland-R32-Valentina_Ivanov-Jil_Teichmann,2,F-DTL,9,6,3,0,3,5,4
20200106-W-Auckland-R32-Valentina_Ivanov-Jil_Teichmann,2,F-IO,22,11,7,0,4,17,5
20200106-W-Auckland-R32-Valentina_Ivanov-Jil_Teichmann,2,B-XC,25,7,3,4,0,18,7
20200106-W-Auckland-R32-Valentina_Ivanov-Jil_Teichmann,2,B-DTM,17,3,0,0,3,9,8
20200106-W-Auckland-R32-Valentina_Ivanov-Jil_Teichmann,2,B-DTL,1,0,0,0,0,1,0
20200106-W-Auckland-R32-Valentina_Ivanov-Jil_Teichmann,2,B-IO,1,0,0,0,0,1,0
20200106-W-Auckland-R32-Valentina_Ivanov-Jil_Teichmann,2,S-DTM,4,0,0,0,0,1,3
20200106-W-Auckland-R32-Valentina_Ivanov-Jil_Teichmann,2,S-DTL,4,0,0,0,0,1,3
20130131-W-Paris-R16-Dominika_Cibulkova-Kiki_Bertens,1,F-XC,53,9,1,4,4,30,23
20130131-W-Paris-R16-Dominika_Cibulkova-Kiki_Bertens,1,F-DTM,33,0,0,0,0,22,11
20130131-W-Paris-R16-Dominika_Cibulkova-Kiki_Bertens,1,F-DTL,16,5,1,1,3,9,7
20130131-W-Paris-R16-Dominika_Cibulkova-Kiki_Bertens,1,F-IO,51,15,4,0,11,30,21
20130131-W-Paris-R16-Dominika_Cibulkova-Kiki_Bertens,1,F-II,2,1,0,0,1,1,1
20130131-W-Paris-R16-Dominika_Cibulkova-Kiki_Bertens,1,B-XC,54,7,0,3,4,31,23
20130131-W-Paris-R16-Dominika_Cibulkova-Kiki_Bertens,1,B-DTM,17,1,0,0,1,5,12
20130131-W-Paris-R16-Dominika_Cibulkova-Kiki_Bertens,1,B-DTL,7,2,1,0,1,3,4
20130131-W-Paris-R16-Dominika_Cibulkova-Kiki_Bertens,1,B-IO,3,0,0,0,0,2,1
20130131-W-Paris-R16-Dominika_Cibulkova-Kiki_Bertens,1,S-XC,9,1,0,0,1,1,8
20130131-W-Paris-R16-Dominika_Cibulkova-Kiki_Bertens,1,S-DTM,1,0,0,0,0,0,1
20130131-W-Paris-R16-Dominika_Cibulkova-Kiki_Bertens,1,S-DTL,1,1,0,0,1,0,1
20130131-W-Paris-R16-Dominika_Cibulkova-Kiki_Bertens,2,F-XC,48,7,2,2,3,26,22
20130131-W-Paris-R16-Dominika_Cibulkova-Kiki_Bertens,2,F-DTM,19,2,0,0,2,5,14
20130131-W-Paris-R16-Dominika_Cibulkova-Kiki_Bertens,2,F-DTL,7,4,1,0,3,3,4
20130131-W-Paris-R16-Dominika_Cibulkova-Kiki_Bertens,2,F-IO,12,5,2,2,1,10,2
20130131-W-Paris-R16-Dominika_Cibulkova-Kiki_Bertens,2,F-II,2,1,1,0,0,2,0
20130131-W-Paris-R16-Dominika_Cibulkova-Kiki_Bertens,2,B-XC,33,7,1,2,4,13,20
20130131-W-Paris-R16-Dominika_Cibulkova-Kiki_Bertens,2,B-DTM,51,7,0,1,6,24,27
20130131-W-Paris-R16-Dominika_Cibulkova-Kiki_Bertens,2,B-DTL,10,6,2,1,3,5,5
20130131-W-Paris-R16-Dominika_Cibulkova-Kiki_Bertens,2,B-IO,3,1,0,1,0,2,1
20130131-W-Paris-R16-Dominika_Cibulkova-Kiki_Bertens,2,S-XC,23,1,0,0,1,11,12
20130131-W-Paris-R16-Dominika_Cibulkova-Kiki_Bertens,2,S-DTM,21,2,0,0,2,4,17
20130131-W-Paris-R16-Dominika_Cibulkova-Kiki_Bertens,2,S-DTL,4,1,0,1,0,1,3
20130131-W-Paris-R16-Dominika_Cibulkova-Kiki_Bertens,2,S-IO,2,0,0,0,0,0,2
20200111-W-Auckland-SF-Caroline_Wozniacki-Jessica_Pegula,1,F-XC,45,4,1,1,2,22,23
20200111-W-Auckland-SF-Caroline_Wozniacki-Jessica_Pegula,1,F-DTM,28,0,0,0,0,11,17
20200111-W-Auckland-SF-Caroline_Wozniacki-Jessica_Pegula,1,F-DTL,15,5,0,1,4,4,11
20200111-W-Auckland-SF-Caroline_Wozniacki-Jessica_Pegula,1,F-IO,13,4,0,1,3,9,4
20200111-W-Auckland-SF-Caroline_Wozniacki-Jessica_Pegula,1,B-XC,47,11,2,5,4,24,23
20200111-W-Auckland-SF-Caroline_Wozniacki-Jessica_Pegula,1,B-DTM,39,4,1,0,3,18,21
20200111-W-Auckland-SF-Caroline_Wozniacki-Jessica_Pegula,1,B-DTL,3,1,1,0,0,3,0
20200111-W-Auckland-SF-Caroline_Wozniacki-Jessica_Pegula,1,B-IO,11,3,1,0,2,6,5
20200111-W-Auckland-SF-Caroline_Wozniacki-Jessica_Pegula,1,S-XC,4,0,0,0,0,2,2
20200111-W-Auckland-SF-Caroline_Wozniacki-Jessica_Pegula,1,S-DTM,4,0,0,0,0,2,2
20200111-W-Auckland-SF-Caroline_Wozniacki-Jessica_Pegula,1,S-DTL,1,0,0,0,0,1,0
20200111-W-Auckland-SF-Caroline_Wozniacki-Jessica_Pegula,1,S-IO,2,1,0,0,1,1,1
20200111-W-Auckland-SF-Caroline_Wozniacki-Jessica_Pegula,2,F-XC,59,22,9,4,9,32,27
20200111-W-Auckland-SF-Caroline_Wozniacki-Jessica_Pegula,2,F-DTM,30,1,0,0,1,13,17
20200111-W-Auckland-SF-Caroline_Wozniacki-Jessica_Pegula,2,F-DTL,8,2,0,1,1,4,4
20200111-W-Auckland-SF-Caroline_Wozniacki-Jessica_Pegula,2,F-IO,21,8,3,3,2,15,6
20200111-W-Auckland-SF-Caroline_Wozniacki-Jessica_Pegula,2,F-II,1,1,0,1,0,1,0
20200111-W-Auckland-SF-Caroline_Wozniacki-Jessica_Pegula,2,B-XC,42,14,4,5,5,20,22
20200111-W-Auckland-SF-Caroline_Wozniacki-Jessica_Pegula,2,B-DTM,37,2,0,0,2,22,15
20200111-W-Auckland-SF-Caroline_Wozniacki-Jessica_Pegula,2,B-DTL,9,5,3,2,0,7,2
20200111-W-Auckland-SF-Caroline_Wozniacki-Jessica_Pegula,2,B-IO,9,6,3,0,3,5,4
20200111-W-Auckland-SF-Caroline_Wozniacki-Jessica_Pegula,2,S-XC,3,0,0,0,0,0,3
20200111-W-Auckland-SF-Caroline_Wozniacki-Jessica_Pegula,2,S-DTM,11,0,0,0,0,3,8
20200111-W-Auckland-SF-Caroline_Wozniacki-Jessica_Pegula,2,S-DTL,1,0,0,0,0,1,0
20200111-W-Auckland-SF-Caroline_Wozniacki-Jessica_Pegula,2,S-IO,2,1,0,0,1,0,2
20200111-W-Brisbane-SF-Naomi_Osaka-Karolina_Pliskova,1,F-XC,31,12,4,3,5,18,13
20200111-W-Brisbane-SF-Naomi_Osaka-Karolina_Pliskova,1,F-DTM,13,1,0,0,1,8,5
20200111-W-Brisbane-SF-Naomi_Osaka-Karolina_Pliskova,1,F-DTL,16,10,4,1,5,7,9
20200111-W-Brisbane-SF-Naomi_Osaka-Karolina_Pliskova,1,F-IO,22,12,5,1,6,12,10
20200111-W-Brisbane-SF-Naomi_Osaka-Karolina_Pliskova,1,F-II,1,1,1,0,0,1,0
20200111-W-Brisbane-SF-Naomi_Osaka-Karolina_Pliskova,1,B-XC,52,10,3,2,5,30,22
20200111-W-Brisbane-SF-Naomi_Osaka-Karolina_Pliskova,1,B-DTM,20,3,0,0,3,6,14
20200111-W-Brisbane-SF-Naomi_Osaka-Karolina_Pliskova,1,B-DTL,17,12,7,1,4,12,5
20200111-W-Brisbane-SF-Naomi_Osaka-Karolina_Pliskova,1,B-IO,12,5,2,1,2,4,8
20200111-W-Brisbane-SF-Naomi_Osaka-Karolina_Pliskova,1,S-XC,2,0,0,0,0,0,2
20200111-W-Brisbane-SF-Naomi_Osaka-Karolina_Pliskova,1,S-DTM,1,0,0,0,0,0,1
20200111-W-Brisbane-SF-Naomi_Osaka-Karolina_Pliskova,2,F-XC,27,12,3,3,6,13,14
20200111-W-Brisbane-SF-Naomi_Osaka-Karolina_Pliskova,2,F-DTM,8,1,1,0,0,3,5
20200111-W-Brisbane-SF-Naomi_Osaka-Karolina_Pliskova,2,F-DTL,11,6,3,1,2,8,3
20200111-W-Brisbane-SF-Naomi_Osaka-Karolina_Pliskova,2,F-IO,10,3,3,0,0,6,4
20200111-W-Brisbane-SF-Naomi_Osaka-Karolina_Pliskova,2,B-XC,41,6,2,2,2,18,23
20200111-W-Brisbane-SF-Naomi_Osaka-Karolina_Pliskova,2,B-DTM,34,6,1,1,4,16,18
20200111-W-Brisbane-SF-Naomi_Osaka-Karolina_Pliskova,2,B-DTL,17,8,6,1,1,11,6
20200111-W-Brisbane-SF-Naomi_Osaka-Karolina_Pliskova,2,B-IO,6,1,1,0,0,3,3
20200111-W-Brisbane-SF-Naomi_Osaka-Karolina_Pliskova,2,S-XC,9,0,0,0,0,2,7
20200111-W-Brisbane-SF-Naomi_Osaka-Karolina_Pliskova,2,S-DTM,6,0,0,0,0,3,3
20130627-W-Wimbledon-R64-Agnieszka_Radwanska-Mathilde_Johansson,1,F-XC,30,6,2,2,2,19,11
20130627-W-Wimbledon-R64-Agnieszka_Radwanska-Mathilde_Johansson,1,F-DTM,22,1,0,1,0,14,8
20130627-W-Wimbledon-R64-Agnieszka_Radwanska-Mathilde_Johansson,1,F-DTL,9,3,3,0,0,7,2
20130627-W-Wimbledon-R64-Agnieszka_Radwanska-Mathilde_Johansson,1,F-IO,13,4,0,3,1,11,2
20130627-W-Wimbledon-R64-Agnieszka_Radwanska-Mathilde_Johansson,1,B-XC,30,2,0,1,1,19,11
20130627-W-Wimbledon-R64-Agnieszka_Radwanska-Mathilde_Johansson,1,B-DTM,26,0,0,0,0,13,13
20130627-W-Wimbledon-R64-Agnieszka_Radwanska-Mathilde_Johansson,1,B-DTL,10,4,1,3,0,9,1
20130627-W-Wimbledon-R64-Agnieszka_Radwanska-Mathilde_Johansson,1,B-IO,7,1,0,0,1,4,3
20130627-W-Wimbledon-R64-Agnieszka_Radwanska-Mathilde_Johansson,1,S-XC,4,0,0,0,0,2,2
20130627-W-Wimbledon-R64-Agnieszka_Radwanska-Mathilde_Johansson,1,S-DTM,7,1,0,1,0,5,2
20130627-W-Wimbledon-R64-Agnieszka_Radwanska-Mathilde_Johansson,1,S-DTL,2,2,0,2,0,2,0
20130627-W-Wimbledon-R64-Agnieszka_Radwanska-Mathilde_Johansson,1,S-IO,3,1,0,0,1,0,3
20130627-W-Wimbledon-R64-Agnieszka_Radwanska-Mathilde_Johansson,2,F-XC,35,12,8,1,3,19,16
20130627-W-Wimbledon-R64-Agnieszka_Radwanska-Mathilde_Johansson,2,F-DTM,11,3,0,0,3,4,7
20130627-W-Wimbledon-R64-Agnieszka_Radwanska-Mathilde_Johansson,2,F-DTL,22,10,4,1,5,12,10
20130627-W-Wimbledon-R64-Agnieszka_Radwanska-Mathilde_Johansson,2,F-IO,24,6,2,2,2,11,13
20130627-W-Wimbledon-R64-Agnieszka_Radwanska-Mathilde_Johansson,2,B-XC,42,7,0,2,5,11,31
20130627-W-Wimbledon-R64-Agnieszka_Radwanska-Mathilde_Johansson,2,B-DTM,25,4,0,2,2,9,16
20130627-W-Wimbledon-R64-Agnieszka_Radwanska-Mathilde_Johansson,2,B-DTL,17,9,5,2,2,11,6
20130627-W-Wimbledon-R64-Agnieszka_Radwanska-Mathilde_Johansson,2,B-IO,13,4,0,1,3,5,8
20130627-W-Wimbledon-R64-Agnieszka_Radwanska-Mathilde_Johansson,2,S-XC,1,0,0,0,0,0,1
20200120-W-Australian_Open-R128-Marie_Bouzkova-Naomi_Osaka,1,F-XC,14,3,0,0,3,7,7
20200120-W-Australian_Open-R128-Marie_Bouzkova-Naomi_Osaka,1,F-DTM,15,4,0,0,4,5,10
20200120-W-Australian_Open-R128-Marie_Bouzkova-Naomi_Osaka,1,F-DTL,5,3,2,0,1,3,2
20200120-W-Australian_Open-R128-Marie_Bouzkova-Naomi_Osaka,1,F-IO,2,0,0,0,0,1,1
20200120-W-Australian_Open-R128-Marie_Bouzkova-Naomi_Osaka,1,B-XC,23,1,0,0,1,8,15
20200120-W-Australian_Open-R128-Marie_Bouzkova-Naomi_Osaka,1,B-DTM,28,1,0,0,1,13,15
20200120-W-Australian_Open-R128-Marie_Bouzkova-Naomi_Osaka,1,B-DTL,7,2,1,1,0,2,5
20200120-W-Australian_Open-R128-Marie_Bouzkova-Naomi_Osaka,1,B-IO,2,0,0,0,0,1,1
20200120-W-Australian_Open-R128-Marie_Bouzkova-Naomi_Osaka,1,S-DTM,2,0,0,0,0,2,0
20200120-W-Australian_Open-R128-Marie_Bouzkova-Naomi_Osaka,1,S-DTL,1,0,0,0,0,0,1
20200120-W-Australian_Open-R128-Marie_Bouzkova-Naomi_Osaka,2,F-XC,25,9,4,1,4,16,9
20200120-W-Australian_Open-R128-Marie_Bouzkova-Naomi_Osaka,2,F-DTM,7,0,0,0,0,2,5
20200120-W-Australian_Open-R128-Marie_Bouzkova-Naomi_Osaka,2,F-DTL,4,2,1,0,1,2,2
20200120-W-Australian_Open-R128-Marie_Bouzkova-Naomi_Osaka,2,F-IO,15,6,2,0,4,8,7
20200120-W-Australian_Open-R128-Marie_Bouzkova-Naomi_Osaka,2,B-XC,25,4,1,2,1,16,9
20200120-W-Australian_Open-R128-Marie_Bouzkova-Naomi_Osaka,2,B-DTM,21,7,1,0,6,10,11
20200120-W-Australian_Open-R128-Marie_Bouzkova-Naomi_Osaka,2,B-DTL,9,7,4,0,3,6,3
20200120-W-Australian_Open-R128-Marie_Bouzkova-Naomi_Osaka,2,B-IO,6,5,1,1,3,3,3
20200120-W-Australian_Open-R128-Marie_Bouzkova-Naomi_Osaka,2,S-DTM,1,0,0,0,0,0,1
20200117-W-Australian_Open-Q2-Leylah_Annie_Fernandez-Mayo_Hibi,1,F-XC,84,8,2,1,5,49,35
20200117-W-Australian_Open-Q2-Leylah_Annie_Fernandez-Mayo_Hibi,1,F-DTM,27,0,0,0,0,8,19
20200117-W-Australian_Open-Q2-Leylah_Annie_Fernandez-Mayo_Hibi,1,F-DTL,12,6,3,0,3,5,7
20200117-W-Australian_Open-Q2-Leylah_Annie_Fernandez-Mayo_Hibi,1,F-IO,16,10,4,2,4,9,7
20200117-W-Australian_Open-Q2-Leylah_Annie_Fernandez-Mayo_Hibi,1,F-II,2,0,0,0,0,1,1
20200117-W-Australian_Open-Q2-Leylah_Annie_Fernandez-Mayo_Hibi,1,B-XC,63,13,5,3,5,38,25
20200117-W-Australian_Open-Q2-Leylah_Annie_Fernandez-Mayo_Hibi,1,B-DTM,38,2,0,0,2,21,17
20200117-W-Australian_Open-Q2-Leylah_Annie_Fernandez-Mayo_Hibi,1,B-DTL,11,6,2,0,4,4,7
20200117-W-Australian_Open-Q2-Leylah_Annie_Fernandez-Mayo_Hibi,1,B-IO,13,4,2,0,2,8,5
20200117-W-Australian_Open-Q2-Leylah_Annie_Fernandez-Mayo_Hibi,1,S-XC,5,0,0,0,0,0,5
20200117-W-Australian_Open-Q2-Leylah_Annie_Fernandez-Mayo_Hibi,1,S-DTM,7,0,0,0,0,2,5
20200117-W-Australian_Open-Q2-Leylah_Annie_Fernandez-Mayo_Hibi,1,S-DTL,4,0,0,0,0,2,2
20200117-W-Australian_Open-Q2-Leylah_Annie_Fernandez-Mayo_Hibi,1,S-IO,2,1,0,0,1,0,2
20200117-W-Australian_Open-Q2-Leylah_Annie_Fernandez-Mayo_Hibi,2,F-XC,50,6,3,0,3,30,20
20200117-W-Australian_Open-Q2-Leylah_Annie_Fernandez-Mayo_Hibi,2,F-DTM,33,0,0,0,0,8,25
20200117-W-Australian_Open-Q2-Leylah_Annie_Fernandez-Mayo_Hibi,2,F-DTL,18,7,2,3,2,9,9
20200117-W-Australian_Open-Q2-Leylah_Annie_Fernandez-Mayo_Hibi,2,F-IO,33,9,2,2,5,18,15
20200117-W-Australian_Open-Q2-Leylah_Annie_Fernandez-Mayo_Hibi,2,F-II,1,0,0,0,0,0,1
20200117-W-Australian_Open-Q2-Leylah_Annie_Fernandez-Mayo_Hibi,2,B-XC,4,2,1,1,0,3,1
20200117-W-Australian_Open-Q2-Leylah_Annie_Fernandez-Mayo_Hibi,2,B-DTM,13,1,0,0,1,7,6
20200117-W-Australian_Open-Q2-Leylah_Annie_Fernandez-Mayo_Hibi,2,B-DTL,8,1,0,1,0,4,4
20200117-W-Australian_Open-Q2-Leylah_Annie_Fernandez-Mayo_Hibi,2,B-IO,4,1,0,1,0,3,1
20200117-W-Australian_Open-Q2-Leylah_Annie_Fernandez-Mayo_Hibi,2,S-XC,16,3,0,0,3,6,10
20200117-W-Australian_Open-Q2-Leylah_Annie_Fernandez-Mayo_Hibi,2,S-DTM,59,4,0,0,4,27,32
20200117-W-Australian_Open-Q2-Leylah_Annie_Fernandez-Mayo_Hibi,2,S-DTL,21,1,0,0,1,6,15
20200117-W-Australian_Open-Q2-Leylah_Annie_Fernandez-Mayo_Hibi,2,S-IO,5,1,0,0,1,0,5
20200114-W-Australian_Open-Q1-Rebecca_Sramkova-Maddison_Inglis,1,F-XC,77,20,5,7,8,37,40
20200114-W-Australian_Open-Q1-Rebecca_Sramkova-Maddison_Inglis,1,F-DTM,28,4,1,1,2,16,12
20200114-W-Australian_Open-Q1-Rebecca_Sramkova-Maddison_Inglis,1,F-DTL,21,13,6,0,7,8,13
20200114-W-Australian_Open-Q1-Rebecca_Sramkova-Maddison_Inglis,1,F-IO,28,12,4,3,5,14,14
20200114-W-Australian_Open-Q1-Rebecca_Sramkova-Maddison_Inglis,1,F-II,3,1,1,0,0,2,1
20200114-W-Australian_Open-Q1-Rebecca_Sramkova-Maddison_Inglis,1,B-XC,75,17,2,2,13,37,38
20200114-W-Australian_Open-Q1-Rebecca_Sramkova-Maddison_Inglis,1,B-DTM,48,5,0,0,5,24,24
20200114-W-Australian_Open-Q1-Rebecca_Sramkova-Maddison_Inglis,1,B-DTL,30,11,4,3,4,14,16
20200114-W-Australian_Open-Q1-Rebecca_Sramkova-Maddison_Inglis,1,B-IO,10,3,0,0,3,2,8
20200114-W-Australian_Open-Q1-Rebecca_Sramkova-Maddison_Inglis,1,S-XC,1,0,0,0,0,0,1
20200114-W-Australian_Open-Q1-Rebecca_Sramkova-Maddison_Inglis,1,S-DTM,3,1,0,0,1,1,2
20200114-W-Australian_Open-Q1-Rebecca_Sramkova-Maddison_Inglis,1,S-IO,1,0,0,0,0,0,1
20200114-W-Australian_Open-Q1-Rebecca_Sramkova-Maddison_Inglis,2,F-XC,48,11,2,5,4,31,17
20200114-W-Australian_Open-Q1-Rebecca_Sramkova-Maddison_Inglis,2,F-DTM,34,1,0,0,1,21,13
20200114-W-Australian_Open-Q1-Rebecca_Sramkova-Maddison_Inglis,2,F-DTL,22,6,2,1,3,12,10
20200114-W-Australian_Open-Q1-Rebecca_Sramkova-Maddison_Inglis,2,F-IO,29,7,3,3,1,17,12
20200114-W-Australian_Open-Q1-Rebecca_Sramkova-Maddison_Inglis,2,F-II,1,1,1,0,0,1,0
20200114-W-Australian_Open-Q1-Rebecca_Sramkova-Maddison_Inglis,2,B-XC,59,5,0,1,4,30,29
20200114-W-Australian_Open-Q1-Rebecca_Sramkova-Maddison_Inglis,2,B-DTM,48,6,0,0,6,19,29
20200114-W-Australian_Open-Q1-Rebecca_Sramkova-Maddison_Inglis,2,B-DTL,14,9,0,1,8,3,11
20200114-W-Australian_Open-Q1-Rebecca_Sramkova-Maddison_Inglis,2,B-IO,6,1,0,0,1,3,3
20200114-W-Australian_Open-Q1-Rebecca_Sramkova-Maddison_Inglis,2,S-XC,6,0,0,0,0,5,1
20200114-W-Australian_Open-Q1-Rebecca_Sramkova-Maddison_Inglis,2,S-DTM,5,0,0,0,0,3,2
20200115-W-Australian_Open-Q1-Lesley_Kerkhove-Eva_Guerrero_Alvarez,1,F-XC,31,8,3,2,3,18,13
20200115-W-Australian_Open-Q1-Lesley_Kerkhove-Eva_Guerrero_Alvarez,1,F-DTM,31,3,0,0,3,18,13
20200115-W-Australian_Open-Q1-Lesley_Kerkhove-Eva_Guerrero_Alvarez,1,F-DTL,6,4,3,0,1,3,3
20200115-W-Australian_Open-Q1-Lesley_Kerkhove-Eva_Guerrero_Alvarez,1,F-IO,21,8,4,1,3,18,3
20200115-W-Australian_Open-Q1-Lesley_Kerkhove-Eva_Guerrero_Alvarez,1,B-XC,19,5,2,1,2,13,6
20200115-W-Australian_Open-Q1-Lesley_Kerkhove-Eva_Guerrero_Alvarez,1,B-DTM,35,4,1,0,3,17,18
20200115-W-Australian_Open-Q1-Lesley_Kerkhove-Eva_Guerrero_Alvarez,1,B-DTL,8,6,2,1,3,5,3
20200115-W-Australian_Open-Q1-Lesley_Kerkhove-Eva_Guerrero_Alvarez,1,B-IO,3,0,0,0,0,3,0
20200115-W-Australian_Open-Q1-Lesley_Kerkhove-Eva_Guerrero_Alvarez,1,S-XC,2,1,0,0,1,1,1
20200115-W-Australian_Open-Q1-Lesley_Kerkhove-Eva_Guerrero_Alvarez,1,S-DTM,2,0,0,0,0,2,0
20200115-W-Australian_Open-Q1-Lesley_Kerkhove-Eva_Guerrero_Alvarez,1,S-DTL,1,0,0,0,0,0,1
20200115-W-Australian_Open-Q1-Lesley_Kerkhove-Eva_Guerrero_Alvarez,2,F-XC,18,2,0,0,2,9,9
20200115-W-Australian_Open-Q1-Lesley_Kerkhove-Eva_Guerrero_Alvarez,2,F-DTM,37,4,0,0,4,9,28
20200115-W-Australian_Open-Q1-Lesley_Kerkhove-Eva_Guerrero_Alvarez,2,F-DTL,6,4,2,1,1,4,2
20200115-W-Australian_Open-Q1-Lesley_Kerkhove-Eva_Guerrero_Alvarez,2,F-IO,14,2,1,0,1,8,6
20200115-W-Australian_Open-Q1-Lesley_Kerkhove-Eva_Guerrero_Alvarez,2,B-XC,34,8,1,1,6,13,21
20200115-W-Australian_Open-Q1-Lesley_Kerkhove-Eva_Guerrero_Alvarez,2,B-DTM,26,1,0,0,1,8,18
20200115-W-Australian_Open-Q1-Lesley_Kerkhove-Eva_Guerrero_Alvarez,2,B-DTL,1,1,0,0,1,0,1
20200115-W-Australian_Open-Q1-Lesley_Kerkhove-Eva_Guerrero_Alvarez,2,B-IO,9,4,0,1,3,4,5
20200115-W-Australian_Open-Q1-Lesley_Kerkhove-Eva_Guerrero_Alvarez,2,S-XC,4,0,0,0,0,0,4
20200115-W-Australian_Open-Q1-Lesley_Kerkhove-Eva_Guerrero_Alvarez,2,S-DTM,4,0,0,0,0,0,4
20200115-W-Australian_Open-Q1-Lesley_Kerkhove-Eva_Guerrero_Alvarez,2,S-IO,1,0,0,0,0,0,1
20200120-W-Australian_Open-R128-Caroline_Wozniacki-Kristie_Ahn,1,F-XC,37,6,1,3,2,19,18
20200120-W-Australian_Open-R128-Caroline_Wozniacki-Kristie_Ahn,1,F-DTM,31,1,0,1,0,17,14
20200120-W-Australian_Open-R128-Caroline_Wozniacki-Kristie_Ahn,1,F-DTL,22,2,1,1,0,13,9
20200120-W-Australian_Open-R128-Caroline_Wozniacki-Kristie_Ahn,1,F-IO,16,5,2,2,1,11,5
20200120-W-Australian_Open-R128-Caroline_Wozniacki-Kristie_Ahn,1,B-XC,48,3,0,1,2,24,24
20200120-W-Australian_Open-R128-Caroline_Wozniacki-Kristie_Ahn,1,B-DTM,27,0,0,0,0,13,14
20200120-W-Australian_Open-R128-Caroline_Wozniacki-Kristie_Ahn,1,B-DTL,10,5,1,1,3,6,4
20200120-W-Australian_Open-R128-Caroline_Wozniacki-Kristie_Ahn,1,B-IO,12,4,1,2,1,8,4
20200120-W-Australian_Open-R128-Caroline_Wozniacki-Kristie_Ahn,1,S-XC,2,0,0,0,0,1,1
20200120-W-Australian_Open-R128-Caroline_Wozniacki-Kristie_Ahn,1,S-DTM,2,0,0,0,0,1,1
20200120-W-Australian_Open-R128-Caroline_Wozniacki-Kristie_Ahn,1,S-DTL,2,0,0,0,0,0,2
20200120-W-Australian_Open-R128-Caroline_Wozniacki-Kristie_Ahn,1,S-IO,1,0,0,0,0,1,0
20200120-W-Australian_Open-R128-Caroline_Wozniacki-Kristie_Ahn,2,F-XC,47,12,4,1,7,26,21
20200120-W-Australian_Open-R128-Caroline_Wozniacki-Kristie_Ahn,2,F-DTM,38,4,0,0,4,10,28
20200120-W-Australian_Open-R128-Caroline_Wozniacki-Kristie_Ahn,2,F-DTL,10,4,2,0,2,7,3
20200120-W-Australian_Open-R128-Caroline_Wozniacki-Kristie_Ahn,2,F-IO,36,17,9,3,5,24,12
20200120-W-Australian_Open-R128-Caroline_Wozniacki-Kristie_Ahn,2,F-II,7,1,0,0,1,3,4
20200120-W-Australian_Open-R128-Caroline_Wozniacki-Kristie_Ahn,2,B-XC,27,5,2,1,2,16,11
20200120-W-Australian_Open-R128-Caroline_Wozniacki-Kristie_Ahn,2,B-DTM,32,2,0,0,2,9,23
20200120-W-Australian_Open-R128-Caroline_Wozniacki-Kristie_Ahn,2,B-DTL,11,2,0,1,1,5,6
20200120-W-Australian_Open-R128-Caroline_Wozniacki-Kristie_Ahn,2,B-IO,2,0,0,0,0,2,0
20200120-W-Australian_Open-R128-Caroline_Wozniacki-Kristie_Ahn,2,S-XC,7,3,0,1,2,4,3
20200120-W-Australian_Open-R128-Caroline_Wozniacki-Kristie_Ahn,2,S-DTM,9,0,0,0,0,3,6
20200120-W-Australian_Open-R128-Caroline_Wozniacki-Kristie_Ahn,2,S-DTL,8,2,0,0,2,3,5
20200121-W-Australian_Open-R128-Kiki_Bertens-Irina_Camelia_Begu,1,F-XC,50,6,2,0,4,27,23
20200121-W-Australian_Open-R128-Kiki_Bertens-Irina_Camelia_Begu,1,F-DTM,27,1,0,0,1,21,6
20200121-W-Australian_Open-R128-Kiki_Bertens-Irina_Camelia_Begu,1,F-DTL,10,5,3,0,2,4,6
20200121-W-Australian_Open-R128-Kiki_Bertens-Irina_Camelia_Begu,1,F-IO,11,4,2,0,2,5,6
20200121-W-Australian_Open-R128-Kiki_Bertens-Irina_Camelia_Begu,1,B-XC,16,1,0,0,1,8,8
20200121-W-Australian_Open-R128-Kiki_Bertens-Irina_Camelia_Begu,1,B-DTM,47,2,0,0,2,26,21
20200121-W-Australian_Open-R128-Kiki_Bertens-Irina_Camelia_Begu,1,B-DTL,2,0,0,0,0,1,1
20200121-W-Australian_Open-R128-Kiki_Bertens-Irina_Camelia_Begu,1,B-IO,3,1,0,0,1,1,2
20200121-W-Australian_Open-R128-Kiki_Bertens-Irina_Camelia_Begu,1,S-XC,9,0,0,0,0,4,5
20200121-W-Australian_Open-R128-Kiki_Bertens-Irina_Camelia_Begu,1,S-DTM,18,3,0,2,1,9,9
20200121-W-Australian_Open-R128-Kiki_Bertens-Irina_Camelia_Begu,1,S-DTL,4,0,0,0,0,1,3
20200121-W-Australian_Open-R128-Kiki_Bertens-Irina_Camelia_Begu,2,F-XC,53,6,1,2,3,24,29
20200121-W-Australian_Open-R128-Kiki_Bertens-Irina_Camelia_Begu,2,F-DTM,25,2,0,0,2,7,18
20200121-W-Australian_Open-R128-Kiki_Bertens-Irina_Camelia_Begu,2,F-DTL,19,5,0,1,4,8,11
20200121-W-Australian_Open-R128-Kiki_Bertens-Irina_Camelia_Begu,2,F-IO,33,6,1,1,4,15,18
20200121-W-Australian_Open-R128-Kiki_Bertens-Irina_Camelia_Begu,2,F-II,1,0,0,0,0,0,1
20200121-W-Australian_Open-R128-Kiki_Bertens-Irina_Camelia_Begu,2,B-XC,35,3,1,1,1,18,17
20200121-W-Australian_Open-R128-Kiki_Bertens-Irina_Camelia_Begu,2,B-DTM,18,1,0,0,1,9,9
20200121-W-Australian_Open-R128-Kiki_Bertens-Irina_Camelia_Begu,2,B-DTL,4,3,1,0,2,1,3
20200121-W-Australian_Open-R128-Kiki_Bertens-Irina_Camelia_Begu,2,B-IO,3,2,1,1,0,2,1
20200121-W-Australian_Open-R128-Kiki_Bertens-Irina_Camelia_Begu,2,S-XC,2,1,0,0,1,0,2
20200121-W-Australian_Open-R128-Kiki_Bertens-Irina_Camelia_Begu,2,S-DTM,2,1,0,0,1,1,1
20200121-W-Australian_Open-R128-Kiki_Bertens-Irina_Camelia_Begu,2,S-IO,3,1,1,0,0,3,0
20200121-W-Australian_Open-R128-Kirsten_Flipkens-Karolina_Muchova,1,F-XC,48,13,5,3,5,21,27
20200121-W-Australian_Open-R128-Kirsten_Flipkens-Karolina_Muchova,1,F-DTM,17,3,0,0,3,8,9
20200121-W-Australian_Open-R128-Kirsten_Flipkens-Karolina_Muchova,1,F-DTL,15,6,3,1,2,10,5
20200121-W-Australian_Open-R128-Kirsten_Flipkens-Karolina_Muchova,1,F-IO,32,7,0,2,5,10,22
20200121-W-Australian_Open-R128-Kirsten_Flipkens-Karolina_Muchova,1,B-XC,12,4,1,2,1,9,3
20200121-W-Australian_Open-R128-Kirsten_Flipkens-Karolina_Muchova,1,B-DTM,9,0,0,0,0,1,8
20200121-W-Australian_Open-R128-Kirsten_Flipkens-Karolina_Muchova,1,B-DTL,4,2,0,2,0,3,1
20200121-W-Australian_Open-R128-Kirsten_Flipkens-Karolina_Muchova,1,B-IO,1,1,0,0,1,0,1
20200121-W-Australian_Open-R128-Kirsten_Flipkens-Karolina_Muchova,1,S-XC,28,0,0,0,0,13,15
20200121-W-Australian_Open-R128-Kirsten_Flipkens-Karolina_Muchova,1,S-DTM,25,2,0,1,1,14,11
20200121-W-Australian_Open-R128-Kirsten_Flipkens-Karolina_Muchova,1,S-DTL,5,0,0,0,0,3,2
20200121-W-Australian_Open-R128-Kirsten_Flipkens-Karolina_Muchova,2,F-XC,30,8,4,1,3,17,13
20200121-W-Australian_Open-R128-Kirsten_Flipkens-Karolina_Muchova,2,F-DTM,18,7,1,5,1,16,2
20200121-W-Australian_Open-R128-Kirsten_Flipkens-Karolina_Muchova,2,F-DTL,17,8,2,1,5,9,8
20200121-W-Australian_Open-R128-Kirsten_Flipkens-Karolina_Muchova,2,F-IO,27,4,2,0,2,10,17
20200121-W-Australian_Open-R128-Kirsten_Flipkens-Karolina_Muchova,2,F-II,4,3,1,1,1,3,1
20200121-W-Australian_Open-R128-Kirsten_Flipkens-Karolina_Muchova,2,B-XC,32,7,1,3,3,15,17
20200121-W-Australian_Open-R128-Kirsten_Flipkens-Karolina_Muchova,2,B-DTM,22,2,0,0,2,13,9
20200121-W-Australian_Open-R128-Kirsten_Flipkens-Karolina_Muchova,2,B-DTL,14,7,1,2,4,7,7
20200121-W-Australian_Open-R128-Kirsten_Flipkens-Karolina_Muchova,2,B-IO,4,3,0,1,2,2,2
20200121-W-Australian_Open-R128-Kirsten_Flipkens-Karolina_Muchova,2,S-XC,15,2,1,1,0,10,5
20200121-W-Australian_Open-R128-Kirsten_Flipkens-Karolina_Muchova,2,S-DTM,9,1,0,0,1,2,7
20200121-W-Australian_Open-R128-Kirsten_Flipkens-Karolina_Muchova,2,S-DTL,4,0,0,0,0,2,2
20200121-W-Australian_Open-R128-Kirsten_Flipkens-Karolina_Muchova,2,S-IO,5,0,0,0,0,4,1
20200122-W-Australian_Open-R64-Arantxa_Rus-Madison_Keys,1,F-XC,31,4,0,0,4,18,13
20200122-W-Australian_Open-R64-Arantxa_Rus-Madison_Keys,1,F-DTM,37,5,0,1,4,12,25
20200122-W-Australian_Open-R64-Arantxa_Rus-Madison_Keys,1,F-DTL,7,4,3,0,1,4,3
20200122-W-Australian_Open-R64-Arantxa_Rus-Madison_Keys,1,F-IO,19,7,3,3,1,15,4
20200122-W-Australian_Open-R64-Arantxa_Rus-Madison_Keys,1,B-XC,9,1,0,0,1,3,6
20200122-W-Australian_Open-R64-Arantxa_Rus-Madison_Keys,1,B-DTM,41,3,0,0,3,11,30
20200122-W-Australian_Open-R64-Arantxa_Rus-Madison_Keys,1,B-DTL,8,1,0,0,1,3,5
20200122-W-Australian_Open-R64-Arantxa_Rus-Madison_Keys,1,B-IO,12,4,0,0,4,6,6
20200122-W-Australian_Open-R64-Arantxa_Rus-Madison_Keys,1,S-XC,2,0,0,0,0,0,2
20200122-W-Australian_Open-R64-Arantxa_Rus-Madison_Keys,1,S-DTM,2,0,0,0,0,0,2
20200122-W-Australian_Open-R64-Arantxa_Rus-Madison_Keys,1,S-DTL,1,1,0,1,0,1,0
20200122-W-Australian_Open-R64-Arantxa_Rus-Madison_Keys,1,S-IO,1,0,0,0,0,0,1
20200122-W-Australian_Open-R64-Arantxa_Rus-Madison_Keys,2,F-XC,36,15,3,5,7,23,13
20200122-W-Australian_Open-R64-Arantxa_Rus-Madison_Keys,2,F-DTM,35,3,0,1,2,23,12
20200122-W-Australian_Open-R64-Arantxa_Rus-Madison_Keys,2,F-DTL,5,5,1,1,3,2,3
20200122-W-Australian_Open-R64-Arantxa_Rus-Madison_Keys,2,F-IO,25,9,4,2,3,16,9
20200122-W-Australian_Open-R64-Arantxa_Rus-Madison_Keys,2,F-II,1,1,0,0,1,0,1
20200122-W-Australian_Open-R64-Arantxa_Rus-Madison_Keys,2,B-XC,30,5,1,1,3,13,17
20200122-W-Australian_Open-R64-Arantxa_Rus-Madison_Keys,2,B-DTM,22,5,0,1,4,11,11
20200122-W-Australian_Open-R64-Arantxa_Rus-Madison_Keys,2,B-DTL,8,5,2,1,2,5,3
20200122-W-Australian_Open-R64-Arantxa_Rus-Madison_Keys,2,B-IO,10,3,2,0,1,8,2
20200122-W-Australian_Open-R64-Arantxa_Rus-Madison_Keys,2,S-XC,1,0,0,0,0,0,1
20200122-W-Australian_Open-R64-Arantxa_Rus-Madison_Keys,2,S-DTM,3,0,0,0,0,2,1
20200121-W-Australian_Open-R128-Magda_Linette-Arantxa_Rus,1,F-XC,148,18,3,1,14,72,76
20200121-W-Australian_Open-R128-Magda_Linette-Arantxa_Rus,1,F-DTM,35,0,0,0,0,15,20
20200121-W-Australian_Open-R128-Magda_Linette-Arantxa_Rus,1,F-DTL,36,18,6,4,8,18,18
20200121-W-Australian_Open-R128-Magda_Linette-Arantxa_Rus,1,F-IO,17,4,0,0,4,8,9
20200121-W-Australian_Open-R128-Magda_Linette-Arantxa_Rus,1,B-XC,63,13,2,2,9,39,24
20200121-W-Australian_Open-R128-Magda_Linette-Arantxa_Rus,1,B-DTM,56,3,0,0,3,35,21
20200121-W-Australian_Open-R128-Magda_Linette-Arantxa_Rus,1,B-DTL,13,7,1,2,4,6,7
20200121-W-Australian_Open-R128-Magda_Linette-Arantxa_Rus,1,B-IO,15,8,4,1,3,8,7
20200121-W-Australian_Open-R128-Magda_Linette-Arantxa_Rus,1,S-IO,1,1,0,0,1,0,1
20200121-W-Australian_Open-R128-Magda_Linette-Arantxa_Rus,2,F-XC,59,8,3,0,5,21,38
20200121-W-Australian_Open-R128-Magda_Linette-Arantxa_Rus,2,F-DTM,79,6,0,1,5,33,46
20200121-W-Australian_Open-R128-Magda_Linette-Arantxa_Rus,2,F-DTL,11,5,2,1,2,8,3
20200121-W-Australian_Open-R128-Magda_Linette-Arantxa_Rus,2,F-IO,29,5,2,0,3,13,16
20200121-W-Australian_Open-R128-Magda_Linette-Arantxa_Rus,2,F-II,1,0,0,0,0,0,1
20200121-W-Australian_Open-R128-Magda_Linette-Arantxa_Rus,2,B-XC,81,13,1,0,12,41,40
20200121-W-Australian_Open-R128-Magda_Linette-Arantxa_Rus,2,B-DTM,91,3,0,0,3,46,45
20200121-W-Australian_Open-R128-Magda_Linette-Arantxa_Rus,2,B-DTL,14,5,3,1,1,11,3
20200121-W-Australian_Open-R128-Magda_Linette-Arantxa_Rus,2,B-IO,7,5,2,0,3,2,5
20200121-W-Australian_Open-R128-Magda_Linette-Arantxa_Rus,2,S-XC,2,0,0,0,0,0,2
20200121-W-Australian_Open-R128-Magda_Linette-Arantxa_Rus,2,S-DTM,7,1,0,1,0,1,6
20200121-W-Australian_Open-R128-Magda_Linette-Arantxa_Rus,2,S-DTL,1,1,0,1,0,1,0
20200122-W-Australian_Open-R64-Caroline_Wozniacki-Dayana_Yastremska,1,F-XC,26,5,2,1,2,12,14
20200122-W-Australian_Open-R64-Caroline_Wozniacki-Dayana_Yastremska,1,F-DTM,50,4,0,0,4,21,29
20200122-W-Australian_Open-R64-Caroline_Wozniacki-Dayana_Yastremska,1,F-DTL,19,3,1,0,2,9,10
20200122-W-Australian_Open-R64-Caroline_Wozniacki-Dayana_Yastremska,1,F-IO,13,1,0,0,1,9,4
20200122-W-Australian_Open-R64-Caroline_Wozniacki-Dayana_Yastremska,1,B-XC,36,4,0,3,1,17,19
20200122-W-Australian_Open-R64-Caroline_Wozniacki-Dayana_Yastremska,1,B-DTM,46,2,0,0,2,27,19
20200122-W-Australian_Open-R64-Caroline_Wozniacki-Dayana_Yastremska,1,B-DTL,8,4,3,1,0,5,3
20200122-W-Australian_Open-R64-Caroline_Wozniacki-Dayana_Yastremska,1,B-IO,7,1,0,1,0,5,2
20200122-W-Australian_Open-R64-Caroline_Wozniacki-Dayana_Yastremska,1,S-XC,2,1,0,0,1,1,1
20200122-W-Australian_Open-R64-Caroline_Wozniacki-Dayana_Yastremska,1,S-DTM,7,0,0,0,0,0,7
20200122-W-Australian_Open-R64-Caroline_Wozniacki-Dayana_Yastremska,1,S-DTL,1,0,0,0,0,0,1
20200122-W-Australian_Open-R64-Caroline_Wozniacki-Dayana_Yastremska,2,F-XC,59,21,8,4,9,35,24
20200122-W-Australian_Open-R64-Caroline_Wozniacki-Dayana_Yastremska,2,F-DTM,28,2,1,0,1,12,16
20200122-W-Australian_Open-R64-Caroline_Wozniacki-Dayana_Yastremska,2,F-DTL,12,8,2,1,5,5,7
20200122-W-Australian_Open-R64-Caroline_Wozniacki-Dayana_Yastremska,2,F-IO,25,9,4,1,4,12,13
20200122-W-Australian_Open-R64-Caroline_Wozniacki-Dayana_Yastremska,2,F-II,1,1,1,0,0,1,0
20200122-W-Australian_Open-R64-Caroline_Wozniacki-Dayana_Yastremska,2,B-XC,44,12,2,4,6,20,24
20200122-W-Australian_Open-R64-Caroline_Wozniacki-Dayana_Yastremska,2,B-DTM,41,1,0,0,1,20,21
20200122-W-Australian_Open-R64-Caroline_Wozniacki-Dayana_Yastremska,2,B-DTL,10,7,4,0,3,4,6
20200122-W-Australian_Open-R64-Caroline_Wozniacki-Dayana_Yastremska,2,B-IO,24,9,2,2,5,13,11
20200122-W-Australian_Open-R64-Caroline_Wozniacki-Dayana_Yastremska,2,S-XC,2,0,0,0,0,1,1
20200122-W-Australian_Open-R64-Caroline_Wozniacki-Dayana_Yastremska,2,S-DTM,2,0,0,0,0,0,2
20200122-W-Australian_Open-R64-Caroline_Wozniacki-Dayana_Yastremska,2,S-DTL,1,1,0,0,1,0,1
20200123-W-Australian_Open-R64-Arina_Rodionova-Kiki_Bertens,1,F-XC,64,6,1,1,4,31,33
20200123-W-Australian_Open-R64-Arina_Rodionova-Kiki_Bertens,1,F-DTM,46,4,0,0,4,25,21
20200123-W-Australian_Open-R64-Arina_Rodionova-Kiki_Bertens,1,F-DTL,17,7,1,2,4,8,9
20200123-W-Australian_Open-R64-Arina_Rodionova-Kiki_Bertens,1,F-IO,22,5,0,0,5,10,12
20200123-W-Australian_Open-R64-Arina_Rodionova-Kiki_Bertens,1,F-II,1,0,0,0,0,1,0
20200123-W-Australian_Open-R64-Arina_Rodionova-Kiki_Bertens,1,B-XC,15,3,0,1,2,9,6
20200123-W-Australian_Open-R64-Arina_Rodionova-Kiki_Bertens,1,B-DTM,20,0,0,0,0,13,7
20200123-W-Australian_Open-R64-Arina_Rodionova-Kiki_Bertens,1,B-DTL,8,0,0,0,0,5,3
20200123-W-Australian_Open-R64-Arina_Rodionova-Kiki_Bertens,1,B-IO,7,1,0,0,1,2,5
20200123-W-Australian_Open-R64-Arina_Rodionova-Kiki_Bertens,1,S-XC,11,1,0,0,1,3,8
20200123-W-Australian_Open-R64-Arina_Rodionova-Kiki_Bertens,1,S-DTM,23,0,0,0,0,11,12
20200123-W-Australian_Open-R64-Arina_Rodionova-Kiki_Bertens,1,S-DTL,3,1,1,0,0,2,1
20200123-W-Australian_Open-R64-Arina_Rodionova-Kiki_Bertens,1,S-IO,3,0,0,0,0,0,3
20200123-W-Australian_Open-R64-Arina_Rodionova-Kiki_Bertens,2,F-XC,89,8,2,1,5,39,50
20200123-W-Australian_Open-R64-Arina_Rodionova-Kiki_Bertens,2,F-DTM,29,4,0,1,3,16,13
20200123-W-Australian_Open-R64-Arina_Rodionova-Kiki_Bertens,2,F-DTL,17,7,2,1,4,8,9
20200123-W-Australian_Open-R64-Arina_Rodionova-Kiki_Bertens,2,F-IO,33,13,5,6,2,22,11
20200123-W-Australian_Open-R64-Arina_Rodionova-Kiki_Bertens,2,F-II,4,2,2,0,0,3,1
20200123-W-Australian_Open-R64-Arina_Rodionova-Kiki_Bertens,2,B-XC,11,2,0,0,2,2,9
20200123-W-Australian_Open-R64-Arina_Rodionova-Kiki_Bertens,2,B-DTM,15,1,0,0,1,8,7
20200123-W-Australian_Open-R64-Arina_Rodionova-Kiki_Bertens,2,B-DTL,6,2,1,1,0,5,1
20200123-W-Australian_Open-R64-Arina_Rodionova-Kiki_Bertens,2,B-IO,1,1,0,0,1,0,1
20200123-W-Australian_Open-R64-Arina_Rodionova-Kiki_Bertens,2,S-XC,14,2,0,0,2,4,10
20200123-W-Australian_Open-R64-Arina_Rodionova-Kiki_Bertens,2,S-DTM,18,2,0,0,2,7,11
20200123-W-Australian_Open-R64-Arina_Rodionova-Kiki_Bertens,2,S-DTL,6,3,1,2,0,5,1
20200116-W-Hobart-QF-Lizette_Cabrera-Elena_Rybakina,1,F-XC,49,16,5,2,9,22,27
20200116-W-Hobart-QF-Lizette_Cabrera-Elena_Rybakina,1,F-DTM,40,5,0,0,5,18,22
20200116-W-Hobart-QF-Lizette_Cabrera-Elena_Rybakina,1,F-DTL,11,7,4,1,2,5,6
20200116-W-Hobart-QF-Lizette_Cabrera-Elena_Rybakina,1,F-IO,17,5,3,1,1,9,8
20200116-W-Hobart-QF-Lizette_Cabrera-Elena_Rybakina,1,B-XC,50,14,5,3,6,27,23
20200116-W-Hobart-QF-Lizette_Cabrera-Elena_Rybakina,1,B-DTM,52,5,0,3,2,28,24
20200116-W-Hobart-QF-Lizette_Cabrera-Elena_Rybakina,1,B-DTL,21,7,4,0,3,12,9
20200116-W-Hobart-QF-Lizette_Cabrera-Elena_Rybakina,1,B-IO,15,5,4,1,0,10,5
20200116-W-Hobart-QF-Lizette_Cabrera-Elena_Rybakina,1,S-XC,1,0,0,0,0,0,1
20200116-W-Hobart-QF-Lizette_Cabrera-Elena_Rybakina,1,S-DTM,13,0,0,0,0,5,8
20200116-W-Hobart-QF-Lizette_Cabrera-Elena_Rybakina,2,F-XC,62,29,12,5,12,37,25
20200116-W-Hobart-QF-Lizette_Cabrera-Elena_Rybakina,2,F-DTM,43,7,0,1,6,18,25
20200116-W-Hobart-QF-Lizette_Cabrera-Elena_Rybakina,2,F-DTL,23,11,4,4,3,12,11
20200116-W-Hobart-QF-Lizette_Cabrera-Elena_Rybakina,2,F-IO,27,11,3,3,5,15,12
20200116-W-Hobart-QF-Lizette_Cabrera-Elena_Rybakina,2,B-XC,50,8,4,0,4,29,21
20200116-W-Hobart-QF-Lizette_Cabrera-Elena_Rybakina,2,B-DTM,36,2,0,0,2,16,20
20200116-W-Hobart-QF-Lizette_Cabrera-Elena_Rybakina,2,B-DTL,11,7,4,1,2,7,4
20200116-W-Hobart-QF-Lizette_Cabrera-Elena_Rybakina,2,B-IO,10,4,3,0,1,6,4
20200116-W-Hobart-QF-Lizette_Cabrera-Elena_Rybakina,2,S-XC,5,0,0,0,0,1,4
20200116-W-Hobart-QF-Lizette_Cabrera-Elena_Rybakina,2,S-DTM,5,0,0,0,0,1,4
20200116-W-Hobart-QF-Lizette_Cabrera-Elena_Rybakina,2,S-DTL,3,0,0,0,0,2,1
20200116-W-Hobart-QF-Lizette_Cabrera-Elena_Rybakina,2,S-IO,2,2,1,0,1,1,1
20170119-W-Australian_Open-R64-Agnieszka_Radwanska-Mirjana_Lucic,1,F-XC,11,2,1,1,0,5,6
20170119-W-Australian_Open-R64-Agnieszka_Radwanska-Mirjana_Lucic,1,F-DTM,13,1,0,0,1,6,7
20170119-W-Australian_Open-R64-Agnieszka_Radwanska-Mirjana_Lucic,1,F-DTL,4,2,1,1,0,2,2
20170119-W-Australian_Open-R64-Agnieszka_Radwanska-Mirjana_Lucic,1,F-IO,7,0,0,0,0,6,1
20170119-W-Australian_Open-R64-Agnieszka_Radwanska-Mirjana_Lucic,1,B-XC,9,0,0,0,0,5,4
20170119-W-Australian_Open-R64-Agnieszka_Radwanska-Mirjana_Lucic,1,B-DTM,17,0,0,0,0,6,11
20170119-W-Australian_Open-R64-Agnieszka_Radwanska-Mirjana_Lucic,1,B-DTL,2,1,1,0,0,1,1
20170119-W-Australian_Open-R64-Agnieszka_Radwanska-Mirjana_Lucic,1,B-IO,2,0,0,0,0,2,0
20170119-W-Australian_Open-R64-Agnieszka_Radwanska-Mirjana_Lucic,1,S-XC,5,1,0,1,0,4,1
20170119-W-Australian_Open-R64-Agnieszka_Radwanska-Mirjana_Lucic,1,S-DTM,4,0,0,0,0,1,3
20170119-W-Australian_Open-R64-Agnieszka_Radwanska-Mirjana_Lucic,1,S-IO,1,0,0,0,0,1,0
20170119-W-Australian_Open-R64-Agnieszka_Radwanska-Mirjana_Lucic,2,F-XC,33,14,7,3,4,20,13
20170119-W-Australian_Open-R64-Agnieszka_Radwanska-Mirjana_Lucic,2,F-DTM,4,1,1,0,0,3,1
20170119-W-Australian_Open-R64-Agnieszka_Radwanska-Mirjana_Lucic,2,F-DTL,3,1,0,0,1,2,1
20170119-W-Australian_Open-R64-Agnieszka_Radwanska-Mirjana_Lucic,2,F-IO,18,12,8,2,2,11,7
20170119-W-Australian_Open-R64-Agnieszka_Radwanska-Mirjana_Lucic,2,F-II,1,1,1,0,0,1,0
20170119-W-Australian_Open-R64-Agnieszka_Radwanska-Mirjana_Lucic,2,B-XC,23,8,4,1,3,11,12
20170119-W-Australian_Open-R64-Agnieszka_Radwanska-Mirjana_Lucic,2,B-DTM,7,1,0,0,1,1,6
20170119-W-Australian_Open-R64-Agnieszka_Radwanska-Mirjana_Lucic,2,B-DTL,4,4,2,0,2,2,2
20170119-W-Australian_Open-R64-Agnieszka_Radwanska-Mirjana_Lucic,2,B-IO,5,3,1,0,2,2,3
20170119-W-Australian_Open-R64-Agnieszka_Radwanska-Mirjana_Lucic,2,S-XC,1,0,0,0,0,0,1
20170119-W-Australian_Open-R64-Agnieszka_Radwanska-Mirjana_Lucic,2,S-DTM,4,0,0,0,0,1,3
20170119-W-Australian_Open-R64-Agnieszka_Radwanska-Mirjana_Lucic,2,S-DTL,2,1,0,0,1,0,2
20170119-W-Australian_Open-R64-Agnieszka_Radwanska-Mirjana_Lucic,2,S-IO,1,0,0,0,0,1,0
20200125-W-Australian_Open-R32-Zarina_Diyas-Kiki_Bertens,1,F-XC,60,10,3,4,3,30,30
20200125-W-Australian_Open-R32-Zarina_Diyas-Kiki_Bertens,1,F-DTM,48,1,0,0,1,19,29
20200125-W-Australian_Open-R32-Zarina_Diyas-Kiki_Bertens,1,F-DTL,29,8,3,2,3,16,13
20200125-W-Australian_Open-R32-Zarina_Diyas-Kiki_Bertens,1,F-IO,41,10,0,3,7,14,27
20200125-W-Australian_Open-R32-Zarina_Diyas-Kiki_Bertens,1,F-II,1,0,0,0,0,0,1
20200125-W-Australian_Open-R32-Zarina_Diyas-Kiki_Bertens,1,B-XC,35,2,0,1,1,15,20
20200125-W-Australian_Open-R32-Zarina_Diyas-Kiki_Bertens,1,B-DTM,34,3,0,0,3,14,20
20200125-W-Australian_Open-R32-Zarina_Diyas-Kiki_Bertens,1,B-DTL,10,3,0,1,2,3,7
20200125-W-Australian_Open-R32-Zarina_Diyas-Kiki_Bertens,1,B-IO,7,1,1,0,0,5,2
20200125-W-Australian_Open-R32-Zarina_Diyas-Kiki_Bertens,1,S-XC,6,0,0,0,0,1,5
20200125-W-Australian_Open-R32-Zarina_Diyas-Kiki_Bertens,1,S-DTM,7,1,0,0,1,0,7
20200125-W-Australian_Open-R32-Zarina_Diyas-Kiki_Bertens,1,S-IO,1,0,0,0,0,0,1
20200125-W-Australian_Open-R32-Zarina_Diyas-Kiki_Bertens,2,F-XC,68,7,3,2,2,38,30
20200125-W-Australian_Open-R32-Zarina_Diyas-Kiki_Bertens,2,F-DTM,29,2,0,0,2,18,11
20200125-W-Australian_Open-R32-Zarina_Diyas-Kiki_Bertens,2,F-DTL,12,4,2,1,1,7,5
20200125-W-Australian_Open-R32-Zarina_Diyas-Kiki_Bertens,2,F-IO,24,10,7,0,3,21,3
20200125-W-Australian_Open-R32-Zarina_Diyas-Kiki_Bertens,2,F-II,2,2,1,1,0,2,0
20200125-W-Australian_Open-R32-Zarina_Diyas-Kiki_Bertens,2,B-XC,19,5,2,1,2,12,7
20200125-W-Australian_Open-R32-Zarina_Diyas-Kiki_Bertens,2,B-DTM,39,3,1,0,2,22,17
20200125-W-Australian_Open-R32-Zarina_Diyas-Kiki_Bertens,2,B-DTL,7,5,1,2,2,3,4
20200125-W-Australian_Open-R32-Zarina_Diyas-Kiki_Bertens,2,B-IO,4,3,0,1,2,1,3
20200125-W-Australian_Open-R32-Zarina_Diyas-Kiki_Bertens,2,S-XC,15,0,0,0,0,9,6
20200125-W-Australian_Open-R32-Zarina_Diyas-Kiki_Bertens,2,S-DTM,35,1,0,0,1,20,15
20200125-W-Australian_Open-R32-Zarina_Diyas-Kiki_Bertens,2,S-DTL,11,1,1,0,0,5,6
20200125-W-Australian_Open-R32-Zarina_Diyas-Kiki_Bertens,2,S-IO,3,1,0,0,1,1,2
20200127-W-Australian_Open-R16-Garbine_Muguruza-Kiki_Bertens,1,F-XC,43,9,4,2,3,26,17
20200127-W-Australian_Open-R16-Garbine_Muguruza-Kiki_Bertens,1,F-DTM,25,3,0,0,3,12,13
20200127-W-Australian_Open-R16-Garbine_Muguruza-Kiki_Bertens,1,F-DTL,10,5,2,2,1,6,4
20200127-W-Australian_Open-R16-Garbine_Muguruza-Kiki_Bertens,1,F-IO,17,7,1,5,1,11,6
20200127-W-Australian_Open-R16-Garbine_Muguruza-Kiki_Bertens,1,B-XC,24,5,1,1,3,11,13
20200127-W-Australian_Open-R16-Garbine_Muguruza-Kiki_Bertens,1,B-DTM,20,1,0,1,0,8,12
20200127-W-Australian_Open-R16-Garbine_Muguruza-Kiki_Bertens,1,B-DTL,4,3,1,1,1,2,2
20200127-W-Australian_Open-R16-Garbine_Muguruza-Kiki_Bertens,1,B-IO,3,0,0,0,0,1,2
20200127-W-Australian_Open-R16-Garbine_Muguruza-Kiki_Bertens,2,F-XC,42,7,1,1,5,23,19
20200127-W-Australian_Open-R16-Garbine_Muguruza-Kiki_Bertens,2,F-DTM,24,1,0,0,1,5,19
20200127-W-Australian_Open-R16-Garbine_Muguruza-Kiki_Bertens,2,F-DTL,11,4,1,1,2,5,6
20200127-W-Australian_Open-R16-Garbine_Muguruza-Kiki_Bertens,2,F-IO,15,7,4,1,2,9,6
20200127-W-Australian_Open-R16-Garbine_Muguruza-Kiki_Bertens,2,B-XC,13,1,0,1,0,7,6
20200127-W-Australian_Open-R16-Garbine_Muguruza-Kiki_Bertens,2,B-DTM,23,1,0,0,1,14,9
20200127-W-Australian_Open-R16-Garbine_Muguruza-Kiki_Bertens,2,B-DTL,7,1,0,0,1,3,4
20200127-W-Australian_Open-R16-Garbine_Muguruza-Kiki_Bertens,2,S-DTM,5,0,0,0,0,3,2
20200127-W-Australian_Open-R16-Garbine_Muguruza-Kiki_Bertens,2,S-DTL,1,0,0,0,0,0,1
20200125-W-Australian_Open-R32-Iga_Swiatek-Donna_Vekic,1,F-XC,31,15,6,5,4,23,8
20200125-W-Australian_Open-R32-Iga_Swiatek-Donna_Vekic,1,F-DTM,17,1,0,1,0,11,6
20200125-W-Australian_Open-R32-Iga_Swiatek-Donna_Vekic,1,F-DTL,10,2,1,0,1,5,5
20200125-W-Australian_Open-R32-Iga_Swiatek-Donna_Vekic,1,F-IO,28,10,1,1,8,11,17
20200125-W-Australian_Open-R32-Iga_Swiatek-Donna_Vekic,1,F-II,1,0,0,0,0,1,0
20200125-W-Australian_Open-R32-Iga_Swiatek-Donna_Vekic,1,B-XC,19,3,2,1,0,11,8
20200125-W-Australian_Open-R32-Iga_Swiatek-Donna_Vekic,1,B-DTM,24,0,0,0,0,14,10
20200125-W-Australian_Open-R32-Iga_Swiatek-Donna_Vekic,1,B-DTL,7,6,3,1,2,5,2
20200125-W-Australian_Open-R32-Iga_Swiatek-Donna_Vekic,1,B-IO,5,3,2,1,0,5,0
20200125-W-Australian_Open-R32-Iga_Swiatek-Donna_Vekic,1,S-IO,1,1,0,0,1,0,1
20200125-W-Australian_Open-R32-Iga_Swiatek-Donna_Vekic,2,F-XC,18,3,1,1,1,6,12
20200125-W-Australian_Open-R32-Iga_Swiatek-Donna_Vekic,2,F-DTM,21,2,1,0,1,7,14
20200125-W-Australian_Open-R32-Iga_Swiatek-Donna_Vekic,2,F-DTL,6,6,2,0,4,2,4
20200125-W-Australian_Open-R32-Iga_Swiatek-Donna_Vekic,2,F-IO,14,9,2,3,4,6,8
20200125-W-Australian_Open-R32-Iga_Swiatek-Donna_Vekic,2,F-II,2,1,1,0,0,2,0
20200125-W-Australian_Open-R32-Iga_Swiatek-Donna_Vekic,2,B-XC,17,7,0,2,5,10,7
20200125-W-Australian_Open-R32-Iga_Swiatek-Donna_Vekic,2,B-DTM,40,7,0,0,7,20,20
20200125-W-Australian_Open-R32-Iga_Swiatek-Donna_Vekic,2,B-DTL,9,2,1,1,0,3,6
20200125-W-Australian_Open-R32-Iga_Swiatek-Donna_Vekic,2,B-IO,10,2,0,1,1,4,6
20200125-W-Australian_Open-R32-Iga_Swiatek-Donna_Vekic,2,S-DTM,1,0,0,0,0,0,1
20200124-W-Australian_Open-R32-Cori_Gauff-Naomi_Osaka,1,F-XC,8,3,1,0,2,3,5
20200124-W-Australian_Open-R32-Cori_Gauff-Naomi_Osaka,1,F-DTM,15,1,0,0,1,9,6
20200124-W-Australian_Open-R32-Cori_Gauff-Naomi_Osaka,1,F-DTL,3,2,0,0,2,0,3
20200124-W-Australian_Open-R32-Cori_Gauff-Naomi_Osaka,1,F-IO,3,0,0,0,0,2,1
20200124-W-Australian_Open-R32-Cori_Gauff-Naomi_Osaka,1,B-XC,23,6,0,2,4,13,10
20200124-W-Australian_Open-R32-Cori_Gauff-Naomi_Osaka,1,B-DTM,26,0,0,0,0,16,10
20200124-W-Australian_Open-R32-Cori_Gauff-Naomi_Osaka,1,B-DTL,2,2,1,0,1,1,1
20200124-W-Australian_Open-R32-Cori_Gauff-Naomi_Osaka,1,B-IO,2,1,1,0,0,2,0
20200124-W-Australian_Open-R32-Cori_Gauff-Naomi_Osaka,1,S-XC,3,0,0,0,0,2,1
20200124-W-Australian_Open-R32-Cori_Gauff-Naomi_Osaka,1,S-DTM,8,2,0,0,2,1,7
20200124-W-Australian_Open-R32-Cori_Gauff-Naomi_Osaka,1,S-DTL,3,1,0,0,1,0,3
20200124-W-Australian_Open-R32-Cori_Gauff-Naomi_Osaka,2,F-XC,22,8,3,0,5,11,11
20200124-W-Australian_Open-R32-Cori_Gauff-Naomi_Osaka,2,F-DTM,11,3,0,0,3,4,7
20200124-W-Australian_Open-R32-Cori_Gauff-Naomi_Osaka,2,F-DTL,1,1,1,0,0,1,0
20200124-W-Australian_Open-R32-Cori_Gauff-Naomi_Osaka,2,F-IO,15,9,4,2,3,9,6
20200124-W-Australian_Open-R32-Cori_Gauff-Naomi_Osaka,2,B-XC,38,8,1,0,7,19,19
20200124-W-Australian_Open-R32-Cori_Gauff-Naomi_Osaka,2,B-DTM,13,4,0,2,2,6,7
20200124-W-Australian_Open-R32-Cori_Gauff-Naomi_Osaka,2,B-DTL,6,5,0,0,5,0,6
20200124-W-Australian_Open-R32-Cori_Gauff-Naomi_Osaka,2,B-IO,4,3,0,1,2,2,2
20200124-W-Australian_Open-R32-Cori_Gauff-Naomi_Osaka,2,S-XC,2,0,0,0,0,0,2
20200124-W-Australian_Open-R32-Cori_Gauff-Naomi_Osaka,2,S-DTL,1,0,0,0,0,1,0
20200121-W-Australian_Open-R128-Donna_Vekic-Maria_Sharapova,1,F-XC,23,7,0,1,6,11,12
20200121-W-Australian_Open-R128-Donna_Vekic-Maria_Sharapova,1,F-DTM,23,4,1,1,2,10,13
20200121-W-Australian_Open-R128-Donna_Vekic-Maria_Sharapova,1,F-DTL,3,3,3,0,0,3,0
20200121-W-Australian_Open-R128-Donna_Vekic-Maria_Sharapova,1,F-IO,9,8,6,1,1,8,1
20200121-W-Australian_Open-R128-Donna_Vekic-Maria_Sharapova,1,B-XC,9,4,1,0,3,3,6
20200121-W-Australian_Open-R128-Donna_Vekic-Maria_Sharapova,1,B-DTM,22,2,1,0,1,12,10
20200121-W-Australian_Open-R128-Donna_Vekic-Maria_Sharapova,1,B-DTL,4,0,0,0,0,3,1
20200121-W-Australian_Open-R128-Donna_Vekic-Maria_Sharapova,1,B-IO,1,1,0,0,1,0,1
20200121-W-Australian_Open-R128-Donna_Vekic-Maria_Sharapova,1,S-XC,1,0,0,0,0,1,0
20200121-W-Australian_Open-R128-Donna_Vekic-Maria_Sharapova,1,S-DTL,2,0,0,0,0,0,2
20200121-W-Australian_Open-R128-Donna_Vekic-Maria_Sharapova,2,F-XC,29,10,4,3,3,17,12
20200121-W-Australian_Open-R128-Donna_Vekic-Maria_Sharapova,2,F-DTM,18,3,1,0,2,7,11
20200121-W-Australian_Open-R128-Donna_Vekic-Maria_Sharapova,2,F-DTL,13,6,1,2,3,5,8
20200121-W-Australian_Open-R128-Donna_Vekic-Maria_Sharapova,2,F-IO,8,3,2,0,1,4,4
20200121-W-Australian_Open-R128-Donna_Vekic-Maria_Sharapova,2,B-XC,12,1,0,0,1,7,5
20200121-W-Australian_Open-R128-Donna_Vekic-Maria_Sharapova,2,B-DTM,7,1,0,0,1,3,4
20200121-W-Australian_Open-R128-Donna_Vekic-Maria_Sharapova,2,B-DTL,3,3,1,0,2,1,2
20200121-W-Australian_Open-R128-Donna_Vekic-Maria_Sharapova,2,B-IO,8,2,0,0,2,6,2
20200121-W-Australian_Open-R128-Donna_Vekic-Maria_Sharapova,2,S-IO,1,0,0,0,0,1,0
20200121-W-Australian_Open-R128-Rebecca_Peterson-Polona_Hercog,1,F-XC,37,11,2,4,5,18,19
20200121-W-Australian_Open-R128-Rebecca_Peterson-Polona_Hercog,1,F-DTM,24,2,0,0,2,12,12
20200121-W-Australian_Open-R128-Rebecca_Peterson-Polona_Hercog,1,F-DTL,8,2,0,0,2,3,5
20200121-W-Australian_Open-R128-Rebecca_Peterson-Polona_Hercog,1,F-IO,31,8,2,1,5,14,17
20200121-W-Australian_Open-R128-Rebecca_Peterson-Polona_Hercog,1,F-II,4,2,1,0,1,1,3
20200121-W-Australian_Open-R128-Rebecca_Peterson-Polona_Hercog,1,B-XC,14,4,1,0,3,6,8
20200121-W-Australian_Open-R128-Rebecca_Peterson-Polona_Hercog,1,B-DTM,19,3,0,0,3,9,10
20200121-W-Australian_Open-R128-Rebecca_Peterson-Polona_Hercog,1,B-DTL,8,6,2,1,3,4,4
20200121-W-Australian_Open-R128-Rebecca_Peterson-Polona_Hercog,1,B-IO,2,0,0,0,0,1,1
20200121-W-Australian_Open-R128-Rebecca_Peterson-Polona_Hercog,1,S-XC,6,0,0,0,0,3,3
20200121-W-Australian_Open-R128-Rebecca_Peterson-Polona_Hercog,1,S-DTM,3,0,0,0,0,1,2
20200121-W-Australian_Open-R128-Rebecca_Peterson-Polona_Hercog,1,S-DTL,1,1,0,0,1,0,1
20200121-W-Australian_Open-R128-Rebecca_Peterson-Polona_Hercog,2,F-XC,37,15,0,6,9,17,20
20200121-W-Australian_Open-R128-Rebecca_Peterson-Polona_Hercog,2,F-DTM,30,4,0,0,4,15,15
20200121-W-Australian_Open-R128-Rebecca_Peterson-Polona_Hercog,2,F-DTL,2,1,0,0,1,0,2
20200121-W-Australian_Open-R128-Rebecca_Peterson-Polona_Hercog,2,F-IO,32,12,6,2,4,17,15
20200121-W-Australian_Open-R128-Rebecca_Peterson-Polona_Hercog,2,F-II,3,3,1,0,2,1,2
20200121-W-Australian_Open-R128-Rebecca_Peterson-Polona_Hercog,2,B-XC,24,9,3,3,3,16,8
20200121-W-Australian_Open-R128-Rebecca_Peterson-Polona_Hercog,2,B-DTM,14,2,0,0,2,5,9
20200121-W-Australian_Open-R128-Rebecca_Peterson-Polona_Hercog,2,B-DTL,1,0,0,0,0,1,0
20200121-W-Australian_Open-R128-Rebecca_Peterson-Polona_Hercog,2,B-IO,1,1,0,0,1,0,1
20200121-W-Australian_Open-R128-Rebecca_Peterson-Polona_Hercog,2,S-XC,10,0,0,0,0,5,5
20200121-W-Australian_Open-R128-Rebecca_Peterson-Polona_Hercog,2,S-DTM,5,0,0,0,0,4,1
20200121-W-Australian_Open-R128-Rebecca_Peterson-Polona_Hercog,2,S-IO,1,1,0,0,1,0,1
20200124-W-Australian_Open-R32-Caroline_Wozniacki-Ons_Jabeur,1,F-XC,30,2,0,2,0,18,12
20200124-W-Australian_Open-R32-Caroline_Wozniacki-Ons_Jabeur,1,F-DTM,38,3,0,1,2,15,23
20200124-W-Australian_Open-R32-Caroline_Wozniacki-Ons_Jabeur,1,F-DTL,9,2,0,0,2,5,4
20200124-W-Australian_Open-R32-Caroline_Wozniacki-Ons_Jabeur,1,F-IO,8,2,0,0,2,3,5
20200124-W-Australian_Open-R32-Caroline_Wozniacki-Ons_Jabeur,1,B-XC,55,7,2,2,2,32,23
20200124-W-Australian_Open-R32-Caroline_Wozniacki-Ons_Jabeur,1,B-DTM,25,1,0,1,0,13,12
20200124-W-Australian_Open-R32-Caroline_Wozniacki-Ons_Jabeur,1,B-DTL,4,3,1,1,1,2,2
20200124-W-Australian_Open-R32-Caroline_Wozniacki-Ons_Jabeur,1,B-IO,17,8,3,3,2,10,7
20200124-W-Australian_Open-R32-Caroline_Wozniacki-Ons_Jabeur,1,S-XC,3,0,0,0,0,0,3
20200124-W-Australian_Open-R32-Caroline_Wozniacki-Ons_Jabeur,1,S-DTM,5,0,0,0,0,4,1
20200124-W-Australian_Open-R32-Caroline_Wozniacki-Ons_Jabeur,1,S-DTL,3,0,0,0,0,0,3
20200124-W-Australian_Open-R32-Caroline_Wozniacki-Ons_Jabeur,2,F-XC,38,14,7,2,5,23,15
20200124-W-Australian_Open-R32-Caroline_Wozniacki-Ons_Jabeur,2,F-DTM,33,7,1,1,5,16,17
20200124-W-Australian_Open-R32-Caroline_Wozniacki-Ons_Jabeur,2,F-DTL,20,13,6,2,5,11,9
20200124-W-Australian_Open-R32-Caroline_Wozniacki-Ons_Jabeur,2,F-IO,35,18,8,2,8,20,15
20200124-W-Australian_Open-R32-Caroline_Wozniacki-Ons_Jabeur,2,F-II,1,1,0,1,0,1,0
20200124-W-Australian_Open-R32-Caroline_Wozniacki-Ons_Jabeur,2,B-XC,24,6,2,0,3,13,11
20200124-W-Australian_Open-R32-Caroline_Wozniacki-Ons_Jabeur,2,B-DTM,18,2,0,0,2,8,10
20200124-W-Australian_Open-R32-Caroline_Wozniacki-Ons_Jabeur,2,B-DTL,27,13,2,2,9,13,14
20200124-W-Australian_Open-R32-Caroline_Wozniacki-Ons_Jabeur,2,B-IO,9,3,0,1,2,5,4
20200124-W-Australian_Open-R32-Caroline_Wozniacki-Ons_Jabeur,2,S-XC,4,1,1,0,0,3,1
20200124-W-Australian_Open-R32-Caroline_Wozniacki-Ons_Jabeur,2,S-DTM,15,1,0,0,1,6,9
20200124-W-Australian_Open-R32-Caroline_Wozniacki-Ons_Jabeur,2,S-DTL,8,3,0,0,3,1,7
20200124-W-Australian_Open-R32-Caroline_Wozniacki-Ons_Jabeur,2,S-IO,2,0,0,0,0,1,1
20200128-W-Australian_Open-QF-Ons_Jabeur-Sofia_Kenin,1,F-XC,31,12,5,1,6,14,17
20200128-W-Australian_Open-QF-Ons_Jabeur-Sofia_Kenin,1,F-DTM,7,2,1,0,1,1,6
20200128-W-Australian_Open-QF-Ons_Jabeur-Sofia_Kenin,1,F-DTL,13,8,0,1,7,4,9
20200128-W-Australian_Open-QF-Ons_Jabeur-Sofia_Kenin,1,F-IO,28,16,6,3,7,14,14
20200128-W-Australian_Open-QF-Ons_Jabeur-Sofia_Kenin,1,F-II,4,2,2,0,0,4,0
20200128-W-Australian_Open-QF-Ons_Jabeur-Sofia_Kenin,1,B-XC,11,3,0,0,3,3,8
20200128-W-Australian_Open-QF-Ons_Jabeur-Sofia_Kenin,1,B-DTM,15,1,0,0,1,5,10
20200128-W-Australian_Open-QF-Ons_Jabeur-Sofia_Kenin,1,B-DTL,9,5,2,1,2,5,4
20200128-W-Australian_Open-QF-Ons_Jabeur-Sofia_Kenin,1,B-IO,3,1,0,0,1,0,3
20200128-W-Australian_Open-QF-Ons_Jabeur-Sofia_Kenin,1,S-XC,14,3,1,0,2,3,11
20200128-W-Australian_Open-QF-Ons_Jabeur-Sofia_Kenin,1,S-DTM,19,3,1,0,2,8,11
20200128-W-Australian_Open-QF-Ons_Jabeur-Sofia_Kenin,1,S-DTL,9,0,0,0,0,3,6
20200128-W-Australian_Open-QF-Ons_Jabeur-Sofia_Kenin,1,S-IO,1,0,0,0,0,1,0
20200128-W-Australian_Open-QF-Ons_Jabeur-Sofia_Kenin,2,F-XC,40,8,3,3,2,23,17
20200128-W-Australian_Open-QF-Ons_Jabeur-Sofia_Kenin,2,F-DTM,18,0,0,0,0,10,8
20200128-W-Australian_Open-QF-Ons_Jabeur-Sofia_Kenin,2,F-DTL,8,4,3,0,1,3,5
20200128-W-Australian_Open-QF-Ons_Jabeur-Sofia_Kenin,2,F-IO,11,1,0,1,0,7,4
20200128-W-Australian_Open-QF-Ons_Jabeur-Sofia_Kenin,2,F-II,1,1,0,0,1,0,1
20200128-W-Australian_Open-QF-Ons_Jabeur-Sofia_Kenin,2,B-XC,41,6,2,1,3,27,14
20200128-W-Australian_Open-QF-Ons_Jabeur-Sofia_Kenin,2,B-DTM,21,2,0,1,1,17,4
20200128-W-Australian_Open-QF-Ons_Jabeur-Sofia_Kenin,2,B-DTL,2,0,0,0,0,2,0
20200128-W-Australian_Open-QF-Ons_Jabeur-Sofia_Kenin,2,B-IO,7,4,2,1,1,6,1
20200128-W-Australian_Open-QF-Ons_Jabeur-Sofia_Kenin,2,S-XC,9,0,0,0,0,5,4
20200128-W-Australian_Open-QF-Ons_Jabeur-Sofia_Kenin,2,S-DTM,7,1,0,1,0,4,3
20200128-W-Australian_Open-QF-Ons_Jabeur-Sofia_Kenin,2,S-DTL,2,1,0,1,0,1,1
20200123-W-Australian_Open-R64-Lauren_Davis-Elina_Svitolina,1,F-XC,27,10,3,2,5,13,14
20200123-W-Australian_Open-R64-Lauren_Davis-Elina_Svitolina,1,F-DTM,38,4,0,0,4,11,27
20200123-W-Australian_Open-R64-Lauren_Davis-Elina_Svitolina,1,F-DTL,11,3,2,0,1,6,5
20200123-W-Australian_Open-R64-Lauren_Davis-Elina_Svitolina,1,F-IO,19,6,2,1,3,7,12
20200123-W-Australian_Open-R64-Lauren_Davis-Elina_Svitolina,1,B-XC,55,15,7,3,5,27,28
20200123-W-Australian_Open-R64-Lauren_Davis-Elina_Svitolina,1,B-DTM,38,4,0,1,3,17,21
20200123-W-Australian_Open-R64-Lauren_Davis-Elina_Svitolina,1,B-DTL,11,7,3,2,2,6,5
20200123-W-Australian_Open-R64-Lauren_Davis-Elina_Svitolina,1,B-IO,15,6,5,0,1,9,6
20200123-W-Australian_Open-R64-Lauren_Davis-Elina_Svitolina,1,S-XC,11,0,0,0,0,4,7
20200123-W-Australian_Open-R64-Lauren_Davis-Elina_Svitolina,1,S-DTM,15,0,0,0,0,6,9
20200123-W-Australian_Open-R64-Lauren_Davis-Elina_Svitolina,1,S-DTL,2,1,0,0,1,0,2
20200123-W-Australian_Open-R64-Lauren_Davis-Elina_Svitolina,1,S-IO,1,0,0,0,0,0,1
20200123-W-Australian_Open-R64-Lauren_Davis-Elina_Svitolina,2,F-XC,29,5,3,2,0,20,9
20200123-W-Australian_Open-R64-Lauren_Davis-Elina_Svitolina,2,F-DTM,35,2,0,0,2,22,13
20200123-W-Australian_Open-R64-Lauren_Davis-Elina_Svitolina,2,F-DTL,6,4,2,1,1,3,3
20200123-W-Australian_Open-R64-Lauren_Davis-Elina_Svitolina,2,F-IO,27,7,1,1,5,17,10
20200123-W-Australian_Open-R64-Lauren_Davis-Elina_Svitolina,2,F-II,1,1,0,1,0,1,0
20200123-W-Australian_Open-R64-Lauren_Davis-Elina_Svitolina,2,B-XC,61,13,6,3,4,36,25
20200123-W-Australian_Open-R64-Lauren_Davis-Elina_Svitolina,2,B-DTM,39,0,0,0,0,17,22
20200123-W-Australian_Open-R64-Lauren_Davis-Elina_Svitolina,2,B-DTL,8,5,2,1,2,5,3
20200123-W-Australian_Open-R64-Lauren_Davis-Elina_Svitolina,2,B-IO,6,3,2,0,1,5,1
20200123-W-Australian_Open-R64-Lauren_Davis-Elina_Svitolina,2,S-XC,6,1,0,1,0,3,3
20200123-W-Australian_Open-R64-Lauren_Davis-Elina_Svitolina,2,S-DTM,4,0,0,0,0,1,3
20200123-W-Australian_Open-R64-Lauren_Davis-Elina_Svitolina,2,S-DTL,2,1,0,1,0,2,0
20200123-W-Australian_Open-R64-Lauren_Davis-Elina_Svitolina,2,S-IO,1,0,0,0,0,0,1
20200130-W-Australian_Open-SF-Ashleigh_Barty-Sofia_Kenin,1,F-XC,40,17,9,4,4,28,12
20200130-W-Australian_Open-SF-Ashleigh_Barty-Sofia_Kenin,1,F-DTM,24,2,0,1,1,8,16
20200130-W-Australian_Open-SF-Ashleigh_Barty-Sofia_Kenin,1,F-DTL,8,6,3,2,1,6,2
20200130-W-Australian_Open-SF-Ashleigh_Barty-Sofia_Kenin,1,F-IO,16,5,3,0,2,10,6
20200130-W-Australian_Open-SF-Ashleigh_Barty-Sofia_Kenin,1,F-II,3,3,0,1,2,1,2
20200130-W-Australian_Open-SF-Ashleigh_Barty-Sofia_Kenin,1,B-XC,4,1,0,0,1,0,4
20200130-W-Australian_Open-SF-Ashleigh_Barty-Sofia_Kenin,1,B-DTM,10,3,0,0,3,2,8
20200130-W-Australian_Open-SF-Ashleigh_Barty-Sofia_Kenin,1,B-DTL,3,2,0,0,2,0,3
20200130-W-Australian_Open-SF-Ashleigh_Barty-Sofia_Kenin,1,B-IO,3,1,1,0,0,2,1
20200130-W-Australian_Open-SF-Ashleigh_Barty-Sofia_Kenin,1,S-XC,30,6,0,1,5,8,22
20200130-W-Australian_Open-SF-Ashleigh_Barty-Sofia_Kenin,1,S-DTM,35,2,0,0,2,18,17
20200130-W-Australian_Open-SF-Ashleigh_Barty-Sofia_Kenin,1,S-DTL,15,4,3,0,1,7,8
20200130-W-Australian_Open-SF-Ashleigh_Barty-Sofia_Kenin,2,F-XC,27,9,1,5,3,12,15
20200130-W-Australian_Open-SF-Ashleigh_Barty-Sofia_Kenin,2,F-DTM,25,1,0,0,1,12,13
20200130-W-Australian_Open-SF-Ashleigh_Barty-Sofia_Kenin,2,F-DTL,13,4,1,0,3,6,7
20200130-W-Australian_Open-SF-Ashleigh_Barty-Sofia_Kenin,2,F-IO,14,4,1,1,2,8,6
20200130-W-Australian_Open-SF-Ashleigh_Barty-Sofia_Kenin,2,B-XC,56,13,2,8,3,38,18
20200130-W-Australian_Open-SF-Ashleigh_Barty-Sofia_Kenin,2,B-DTM,17,2,1,0,1,10,7
20200130-W-Australian_Open-SF-Ashleigh_Barty-Sofia_Kenin,2,B-DTL,7,4,0,1,3,1,6
20200130-W-Australian_Open-SF-Ashleigh_Barty-Sofia_Kenin,2,B-IO,5,0,0,0,0,3,2
20200130-W-Australian_Open-SF-Ashleigh_Barty-Sofia_Kenin,2,S-XC,9,2,0,1,1,8,1
20200130-W-Australian_Open-SF-Ashleigh_Barty-Sofia_Kenin,2,S-DTM,4,0,0,0,0,2,2
20200130-W-Australian_Open-SF-Ashleigh_Barty-Sofia_Kenin,2,S-IO,1,0,0,0,0,0,1
20200201-W-Australian_Open-F-Sofia_Kenin-Garbine_Muguruza,1,F-XC,69,14,4,4,6,42,27
20200201-W-Australian_Open-F-Sofia_Kenin-Garbine_Muguruza,1,F-DTM,42,4,0,0,4,25,17
20200201-W-Australian_Open-F-Sofia_Kenin-Garbine_Muguruza,1,F-DTL,16,3,1,2,0,11,5
20200201-W-Australian_Open-F-Sofia_Kenin-Garbine_Muguruza,1,F-IO,18,7,4,1,2,12,6
20200201-W-Australian_Open-F-Sofia_Kenin-Garbine_Muguruza,1,F-II,1,0,0,0,0,0,1
20200201-W-Australian_Open-F-Sofia_Kenin-Garbine_Muguruza,1,B-XC,56,7,3,1,3,29,27
20200201-W-Australian_Open-F-Sofia_Kenin-Garbine_Muguruza,1,B-DTM,38,1,0,0,1,23,15
20200201-W-Australian_Open-F-Sofia_Kenin-Garbine_Muguruza,1,B-DTL,7,4,4,0,0,7,0
20200201-W-Australian_Open-F-Sofia_Kenin-Garbine_Muguruza,1,B-IO,13,6,4,1,1,9,4
20200201-W-Australian_Open-F-Sofia_Kenin-Garbine_Muguruza,1,S-XC,7,0,0,0,0,4,3
20200201-W-Australian_Open-F-Sofia_Kenin-Garbine_Muguruza,1,S-DTM,15,1,0,0,1,8,7
20200201-W-Australian_Open-F-Sofia_Kenin-Garbine_Muguruza,1,S-DTL,2,0,0,0,0,1,1
20200201-W-Australian_Open-F-Sofia_Kenin-Garbine_Muguruza,1,S-IO,1,0,0,0,0,1,0
20200201-W-Australian_Open-F-Sofia_Kenin-Garbine_Muguruza,2,F-XC,70,17,4,3,10,27,43
20200201-W-Australian_Open-F-Sofia_Kenin-Garbine_Muguruza,2,F-DTM,31,3,1,0,2,14,17
20200201-W-Australian_Open-F-Sofia_Kenin-Garbine_Muguruza,2,F-DTL,21,3,0,2,1,10,11
20200201-W-Australian_Open-F-Sofia_Kenin-Garbine_Muguruza,2,F-IO,22,7,3,0,4,13,9
20200201-W-Australian_Open-F-Sofia_Kenin-Garbine_Muguruza,2,F-II,1,0,0,0,0,0,1
20200201-W-Australian_Open-F-Sofia_Kenin-Garbine_Muguruza,2,B-XC,50,9,1,4,4,21,29
20200201-W-Australian_Open-F-Sofia_Kenin-Garbine_Muguruza,2,B-DTM,52,3,0,0,3,19,33
20200201-W-Australian_Open-F-Sofia_Kenin-Garbine_Muguruza,2,B-DTL,18,7,2,1,4,8,10
20200201-W-Australian_Open-F-Sofia_Kenin-Garbine_Muguruza,2,B-IO,14,7,0,2,5,6,8
20200201-W-Australian_Open-F-Sofia_Kenin-Garbine_Muguruza,2,S-DTM,2,0,0,0,0,2,0
20200123-W-Australian_Open-R64-Karolina_Muchova-Catherine_Cartan_Bellis,1,F-XC,24,5,1,0,4,10,14
20200123-W-Australian_Open-R64-Karolina_Muchova-Catherine_Cartan_Bellis,1,F-DTM,32,5,1,1,3,14,18
20200123-W-Australian_Open-R64-Karolina_Muchova-Catherine_Cartan_Bellis,1,F-DTL,8,5,1,2,2,5,3
20200123-W-Australian_Open-R64-Karolina_Muchova-Catherine_Cartan_Bellis,1,F-IO,22,8,4,0,4,14,8
20200123-W-Australian_Open-R64-Karolina_Muchova-Catherine_Cartan_Bellis,1,F-II,1,1,0,0,1,0,1
20200123-W-Australian_Open-R64-Karolina_Muchova-Catherine_Cartan_Bellis,1,B-XC,12,2,0,0,2,6,6
20200123-W-Australian_Open-R64-Karolina_Muchova-Catherine_Cartan_Bellis,1,B-DTM,23,1,0,0,1,8,15
20200123-W-Australian_Open-R64-Karolina_Muchova-Catherine_Cartan_Bellis,1,B-DTL,5,2,2,0,0,5,0
20200123-W-Australian_Open-R64-Karolina_Muchova-Catherine_Cartan_Bellis,1,B-IO,10,6,0,4,2,6,4
20200123-W-Australian_Open-R64-Karolina_Muchova-Catherine_Cartan_Bellis,1,S-XC,6,1,0,0,1,1,5
20200123-W-Australian_Open-R64-Karolina_Muchova-Catherine_Cartan_Bellis,1,S-DTM,10,3,0,0,3,2,8
20200123-W-Australian_Open-R64-Karolina_Muchova-Catherine_Cartan_Bellis,1,S-DTL,1,0,0,0,0,1,0
20200123-W-Australian_Open-R64-Karolina_Muchova-Catherine_Cartan_Bellis,1,S-IO,2,0,0,0,0,1,1
20200123-W-Australian_Open-R64-Karolina_Muchova-Catherine_Cartan_Bellis,2,F-XC,37,8,2,5,1,23,14
20200123-W-Australian_Open-R64-Karolina_Muchova-Catherine_Cartan_Bellis,2,F-DTM,33,3,0,0,3,18,15
20200123-W-Australian_Open-R64-Karolina_Muchova-Catherine_Cartan_Bellis,2,F-DTL,8,2,0,0,2,4,4
20200123-W-Australian_Open-R64-Karolina_Muchova-Catherine_Cartan_Bellis,2,F-IO,15,8,3,1,4,7,8
20200123-W-Australian_Open-R64-Karolina_Muchova-Catherine_Cartan_Bellis,2,B-XC,21,4,1,3,0,13,8
20200123-W-Australian_Open-R64-Karolina_Muchova-Catherine_Cartan_Bellis,2,B-DTM,37,4,0,1,1,19,18
20200123-W-Australian_Open-R64-Karolina_Muchova-Catherine_Cartan_Bellis,2,B-DTL,5,4,1,1,2,2,3
20200123-W-Australian_Open-R64-Karolina_Muchova-Catherine_Cartan_Bellis,2,B-IO,5,2,0,1,1,2,3
20200123-W-Australian_Open-R64-Karolina_Muchova-Catherine_Cartan_Bellis,2,S-XC,3,0,0,0,0,1,2
20200123-W-Australian_Open-R64-Karolina_Muchova-Catherine_Cartan_Bellis,2,S-DTM,3,0,0,0,0,1,2
20200121-W-Australian_Open-R128-Svetlana_Kuznetsova-Marketa_Vondrousova,1,F-XC,49,8,3,1,4,34,15
20200121-W-Australian_Open-R128-Svetlana_Kuznetsova-Marketa_Vondrousova,1,F-DTM,45,2,0,0,2,29,16
20200121-W-Australian_Open-R128-Svetlana_Kuznetsova-Marketa_Vondrousova,1,F-DTL,16,4,1,2,1,11,5
20200121-W-Australian_Open-R128-Svetlana_Kuznetsova-Marketa_Vondrousova,1,F-IO,57,16,7,2,7,32,25
20200121-W-Australian_Open-R128-Svetlana_Kuznetsova-Marketa_Vondrousova,1,F-II,6,2,1,0,1,4,2
20200121-W-Australian_Open-R128-Svetlana_Kuznetsova-Marketa_Vondrousova,1,B-XC,44,5,2,0,3,25,19
20200121-W-Australian_Open-R128-Svetlana_Kuznetsova-Marketa_Vondrousova,1,B-DTM,51,5,0,0,5,25,26
20200121-W-Australian_Open-R128-Svetlana_Kuznetsova-Marketa_Vondrousova,1,B-DTL,10,5,4,0,1,7,3
20200121-W-Australian_Open-R128-Svetlana_Kuznetsova-Marketa_Vondrousova,1,B-IO,4,1,0,0,1,1,3
20200121-W-Australian_Open-R128-Svetlana_Kuznetsova-Marketa_Vondrousova,1,S-XC,10,2,0,0,2,5,5
20200121-W-Australian_Open-R128-Svetlana_Kuznetsova-Marketa_Vondrousova,1,S-DTM,10,0,0,0,0,6,4
20200121-W-Australian_Open-R128-Svetlana_Kuznetsova-Marketa_Vondrousova,1,S-DTL,3,1,1,0,0,3,0
20200121-W-Australian_Open-R128-Svetlana_Kuznetsova-Marketa_Vondrousova,2,F-XC,119,12,1,4,7,49,70
20200121-W-Australian_Open-R128-Svetlana_Kuznetsova-Marketa_Vondrousova,2,F-DTM,58,4,0,0,4,28,30
20200121-W-Australian_Open-R128-Svetlana_Kuznetsova-Marketa_Vondrousova,2,F-DTL,16,9,4,0,5,7,9
20200121-W-Australian_Open-R128-Svetlana_Kuznetsova-Marketa_Vondrousova,2,F-IO,7,4,1,0,3,2,5
20200121-W-Australian_Open-R128-Svetlana_Kuznetsova-Marketa_Vondrousova,2,B-XC,36,7,2,1,4,10,26
20200121-W-Australian_Open-R128-Svetlana_Kuznetsova-Marketa_Vondrousova,2,B-DTM,46,3,1,0,2,20,26
20200121-W-Australian_Open-R128-Svetlana_Kuznetsova-Marketa_Vondrousova,2,B-DTL,5,3,2,0,1,2,3
20200121-W-Australian_Open-R128-Svetlana_Kuznetsova-Marketa_Vondrousova,2,B-IO,3,2,0,0,2,0,3
20200121-W-Australian_Open-R128-Svetlana_Kuznetsova-Marketa_Vondrousova,2,S-XC,2,0,0,0,0,0,2
20200121-W-Australian_Open-R128-Svetlana_Kuznetsova-Marketa_Vondrousova,2,S-DTM,6,0,0,0,0,1,5
20200121-W-Australian_Open-R128-Svetlana_Kuznetsova-Marketa_Vondrousova,2,S-DTL,2,0,0,0,0,1,1
20200121-W-Australian_Open-R128-Kateryna_Bondarenko-Arina_Rodionova,1,F-XC,78,22,8,1,13,31,47
20200121-W-Australian_Open-R128-Kateryna_Bondarenko-Arina_Rodionova,1,F-DTM,31,3,0,0,3,10,21
20200121-W-Australian_Open-R128-Kateryna_Bondarenko-Arina_Rodionova,1,F-DTL,19,9,3,0,6,7,12
20200121-W-Australian_Open-R128-Kateryna_Bondarenko-Arina_Rodionova,1,F-IO,31,10,2,0,8,12,19
20200121-W-Australian_Open-R128-Kateryna_Bondarenko-Arina_Rodionova,1,B-XC,59,17,3,1,13,25,34
20200121-W-Australian_Open-R128-Kateryna_Bondarenko-Arina_Rodionova,1,B-DTM,17,2,0,0,2,3,14
20200121-W-Australian_Open-R128-Kateryna_Bondarenko-Arina_Rodionova,1,B-DTL,18,12,6,3,3,12,6
20200121-W-Australian_Open-R128-Kateryna_Bondarenko-Arina_Rodionova,1,B-IO,17,9,3,3,3,10,7
20200121-W-Australian_Open-R128-Kateryna_Bondarenko-Arina_Rodionova,1,S-XC,1,0,0,0,0,0,1
20200121-W-Australian_Open-R128-Kateryna_Bondarenko-Arina_Rodionova,1,S-DTM,2,0,0,0,0,0,2
20200121-W-Australian_Open-R128-Kateryna_Bondarenko-Arina_Rodionova,1,S-DTL,1,0,0,0,0,0,1
20200121-W-Australian_Open-R128-Kateryna_Bondarenko-Arina_Rodionova,2,F-XC,44,9,4,1,4,31,13
20200121-W-Australian_Open-R128-Kateryna_Bondarenko-Arina_Rodionova,2,F-DTM,45,1,0,1,0,28,17
20200121-W-Australian_Open-R128-Kateryna_Bondarenko-Arina_Rodionova,2,F-DTL,6,2,0,1,1,3,3
20200121-W-Australian_Open-R128-Kateryna_Bondarenko-Arina_Rodionova,2,F-IO,13,3,1,0,2,5,8
20200121-W-Australian_Open-R128-Kateryna_Bondarenko-Arina_Rodionova,2,B-XC,17,1,0,0,1,9,8
20200121-W-Australian_Open-R128-Kateryna_Bondarenko-Arina_Rodionova,2,B-DTM,44,3,0,1,2,27,17
20200121-W-Australian_Open-R128-Kateryna_Bondarenko-Arina_Rodionova,2,B-DTL,9,2,0,0,2,5,4
20200121-W-Australian_Open-R128-Kateryna_Bondarenko-Arina_Rodionova,2,B-IO,14,4,2,0,2,7,7
20200121-W-Australian_Open-R128-Kateryna_Bondarenko-Arina_Rodionova,2,S-XC,11,0,0,0,0,8,3
20200121-W-Australian_Open-R128-Kateryna_Bondarenko-Arina_Rodionova,2,S-DTM,21,0,0,0,0,11,10
20200121-W-Australian_Open-R128-Kateryna_Bondarenko-Arina_Rodionova,2,S-DTL,1,0,0,0,0,1,0
20200123-W-Australian_Open-R64-Iga_Swiatek-Carla_Suarez_Navarro,1,F-XC,33,9,4,3,2,17,16
20200123-W-Australian_Open-R64-Iga_Swiatek-Carla_Suarez_Navarro,1,F-DTM,19,3,0,0,3,5,14
20200123-W-Australian_Open-R64-Iga_Swiatek-Carla_Suarez_Navarro,1,F-DTL,14,5,1,1,3,9,5
20200123-W-Australian_Open-R64-Iga_Swiatek-Carla_Suarez_Navarro,1,F-IO,15,7,3,2,2,10,5
20200123-W-Australian_Open-R64-Iga_Swiatek-Carla_Suarez_Navarro,1,F-II,1,1,1,0,0,1,0
20200123-W-Australian_Open-R64-Iga_Swiatek-Carla_Suarez_Navarro,1,B-XC,44,13,1,3,9,24,20
20200123-W-Australian_Open-R64-Iga_Swiatek-Carla_Suarez_Navarro,1,B-DTM,17,0,0,0,0,7,10
20200123-W-Australian_Open-R64-Iga_Swiatek-Carla_Suarez_Navarro,1,B-DTL,14,12,8,0,4,9,5
20200123-W-Australian_Open-R64-Iga_Swiatek-Carla_Suarez_Navarro,1,B-IO,6,4,1,1,2,4,2
20200123-W-Australian_Open-R64-Iga_Swiatek-Carla_Suarez_Navarro,1,S-XC,1,0,0,0,0,0,1
20200123-W-Australian_Open-R64-Iga_Swiatek-Carla_Suarez_Navarro,1,S-DTM,1,1,0,0,1,0,1
20200123-W-Australian_Open-R64-Iga_Swiatek-Carla_Suarez_Navarro,1,S-DTL,2,1,1,0,0,2,0
20200123-W-Australian_Open-R64-Iga_Swiatek-Carla_Suarez_Navarro,1,S-IO,1,1,1,0,0,1,0
20200123-W-Australian_Open-R64-Iga_Swiatek-Carla_Suarez_Navarro,2,F-XC,37,12,3,2,7,18,19
20200123-W-Australian_Open-R64-Iga_Swiatek-Carla_Suarez_Navarro,2,F-DTM,29,3,0,1,2,17,12
20200123-W-Australian_Open-R64-Iga_Swiatek-Carla_Suarez_Navarro,2,F-DTL,10,5,1,3,1,8,2
20200123-W-Australian_Open-R64-Iga_Swiatek-Carla_Suarez_Navarro,2,F-IO,10,3,0,0,3,3,7
20200123-W-Australian_Open-R64-Iga_Swiatek-Carla_Suarez_Navarro,2,B-XC,28,2,1,0,1,14,14
20200123-W-Australian_Open-R64-Iga_Swiatek-Carla_Suarez_Navarro,2,B-DTM,23,0,0,0,0,8,15
20200123-W-Australian_Open-R64-Iga_Swiatek-Carla_Suarez_Navarro,2,B-DTL,4,2,1,0,1,1,3
20200123-W-Australian_Open-R64-Iga_Swiatek-Carla_Suarez_Navarro,2,S-XC,11,0,0,0,0,5,6
20200123-W-Australian_Open-R64-Iga_Swiatek-Carla_Suarez_Navarro,2,S-DTM,8,0,0,0,0,3,5
20200123-W-Australian_Open-R64-Iga_Swiatek-Carla_Suarez_Navarro,2,S-DTL,2,1,0,1,0,1,1
20200201-W-Australian_Open_Juniors-F-Victoria_Jimenez_Kasintseva-Weronika_Baszak,1,F-XC,75,5,1,0,4,50,25
20200201-W-Australian_Open_Juniors-F-Victoria_Jimenez_Kasintseva-Weronika_Baszak,1,F-DTM,49,1,0,0,1,23,26
20200201-W-Australian_Open_Juniors-F-Victoria_Jimenez_Kasintseva-Weronika_Baszak,1,F-DTL,7,6,0,2,4,2,5
20200201-W-Australian_Open_Juniors-F-Victoria_Jimenez_Kasintseva-Weronika_Baszak,1,F-IO,14,9,6,3,0,11,3
20200201-W-Australian_Open_Juniors-F-Victoria_Jimenez_Kasintseva-Weronika_Baszak,1,F-II,1,0,0,0,0,0,1
20200201-W-Australian_Open_Juniors-F-Victoria_Jimenez_Kasintseva-Weronika_Baszak,1,B-XC,29,5,1,0,4,15,14
20200201-W-Australian_Open_Juniors-F-Victoria_Jimenez_Kasintseva-Weronika_Baszak,1,B-DTM,57,5,0,0,5,39,18
20200201-W-Australian_Open_Juniors-F-Victoria_Jimenez_Kasintseva-Weronika_Baszak,1,B-DTL,16,9,3,4,2,11,5
20200201-W-Australian_Open_Juniors-F-Victoria_Jimenez_Kasintseva-Weronika_Baszak,1,B-IO,11,2,1,1,0,9,2
20200201-W-Australian_Open_Juniors-F-Victoria_Jimenez_Kasintseva-Weronika_Baszak,1,S-XC,1,0,0,0,0,0,1
20200201-W-Australian_Open_Juniors-F-Victoria_Jimenez_Kasintseva-Weronika_Baszak,2,F-XC,92,26,8,7,11,42,50
20200201-W-Australian_Open_Juniors-F-Victoria_Jimenez_Kasintseva-Weronika_Baszak,2,F-DTM,30,2,0,0,2,10,20
20200201-W-Australian_Open_Juniors-F-Victoria_Jimenez_Kasintseva-Weronika_Baszak,2,F-DTL,6,4,1,0,3,2,4
20200201-W-Australian_Open_Juniors-F-Victoria_Jimenez_Kasintseva-Weronika_Baszak,2,F-IO,29,14,4,2,8,15,14
20200201-W-Australian_Open_Juniors-F-Victoria_Jimenez_Kasintseva-Weronika_Baszak,2,F-II,3,1,0,1,0,2,1
20200201-W-Australian_Open_Juniors-F-Victoria_Jimenez_Kasintseva-Weronika_Baszak,2,B-XC,58,10,0,1,9,18,40
20200201-W-Australian_Open_Juniors-F-Victoria_Jimenez_Kasintseva-Weronika_Baszak,2,B-DTM,41,4,0,1,3,11,30
20200201-W-Australian_Open_Juniors-F-Victoria_Jimenez_Kasintseva-Weronika_Baszak,2,B-DTL,10,4,0,0,4,2,8
20200201-W-Australian_Open_Juniors-F-Victoria_Jimenez_Kasintseva-Weronika_Baszak,2,B-IO,4,0,0,0,0,2,2
20200201-W-Australian_Open_Juniors-F-Victoria_Jimenez_Kasintseva-Weronika_Baszak,2,S-XC,2,1,1,0,0,2,0
20200201-W-Australian_Open_Juniors-F-Victoria_Jimenez_Kasintseva-Weronika_Baszak,2,S-DTM,8,1,0,0,1,0,8
20200201-W-Australian_Open_Juniors-F-Victoria_Jimenez_Kasintseva-Weronika_Baszak,2,S-DTL,1,0,0,0,0,0,1
20200120-W-Australian_Open-R128-Ashleigh_Barty-Lesia_Tsurenko,1,F-XC,60,17,6,3,8,31,29
20200120-W-Australian_Open-R128-Ashleigh_Barty-Lesia_Tsurenko,1,F-DTM,18,1,0,0,1,8,10
20200120-W-Australian_Open-R128-Ashleigh_Barty-Lesia_Tsurenko,1,F-DTL,9,4,1,1,2,2,7
20200120-W-Australian_Open-R128-Ashleigh_Barty-Lesia_Tsurenko,1,F-IO,20,3,1,0,2,12,8
20200120-W-Australian_Open-R128-Ashleigh_Barty-Lesia_Tsurenko,1,F-II,4,3,0,2,1,3,1
20200120-W-Australian_Open-R128-Ashleigh_Barty-Lesia_Tsurenko,1,B-XC,15,6,2,1,3,6,9
20200120-W-Australian_Open-R128-Ashleigh_Barty-Lesia_Tsurenko,1,B-DTM,19,4,0,0,4,6,13
20200120-W-Australian_Open-R128-Ashleigh_Barty-Lesia_Tsurenko,1,B-DTL,10,1,0,1,0,5,5
20200120-W-Australian_Open-R128-Ashleigh_Barty-Lesia_Tsurenko,1,B-IO,4,1,0,0,1,2,2
20200120-W-Australian_Open-R128-Ashleigh_Barty-Lesia_Tsurenko,1,S-XC,23,6,1,1,4,12,11
20200120-W-Australian_Open-R128-Ashleigh_Barty-Lesia_Tsurenko,1,S-DTM,29,2,0,1,1,17,12
20200120-W-Australian_Open-R128-Ashleigh_Barty-Lesia_Tsurenko,1,S-DTL,10,2,0,1,1,5,5
20200120-W-Australian_Open-R128-Ashleigh_Barty-Lesia_Tsurenko,1,S-IO,4,0,0,0,0,3,1
20200120-W-Australian_Open-R128-Ashleigh_Barty-Lesia_Tsurenko,2,F-XC,49,8,3,2,3,25,24
20200120-W-Australian_Open-R128-Ashleigh_Barty-Lesia_Tsurenko,2,F-DTM,24,3,0,0,3,10,14
20200120-W-Australian_Open-R128-Ashleigh_Barty-Lesia_Tsurenko,2,F-DTL,29,6,1,0,5,12,17
20200120-W-Australian_Open-R128-Ashleigh_Barty-Lesia_Tsurenko,2,F-IO,23,3,0,0,3,13,10
20200120-W-Australian_Open-R128-Ashleigh_Barty-Lesia_Tsurenko,2,F-II,1,1,0,1,0,1,0
20200120-W-Australian_Open-R128-Ashleigh_Barty-Lesia_Tsurenko,2,B-XC,41,2,0,1,1,21,20
20200120-W-Australian_Open-R128-Ashleigh_Barty-Lesia_Tsurenko,2,B-DTM,14,3,0,2,1,7,7
20200120-W-Australian_Open-R128-Ashleigh_Barty-Lesia_Tsurenko,2,B-DTL,6,2,0,0,2,2,4
20200120-W-Australian_Open-R128-Ashleigh_Barty-Lesia_Tsurenko,2,B-IO,6,0,0,0,0,4,2
20200120-W-Australian_Open-R128-Ashleigh_Barty-Lesia_Tsurenko,2,S-XC,10,0,0,0,0,6,4
20200120-W-Australian_Open-R128-Ashleigh_Barty-Lesia_Tsurenko,2,S-DTM,6,0,0,0,0,2,4
20200120-W-Australian_Open-R128-Ashleigh_Barty-Lesia_Tsurenko,2,S-DTL,1,0,0,0,0,1,0
20200120-W-Australian_Open-R128-Ashleigh_Barty-Lesia_Tsurenko,2,S-IO,2,0,0,0,0,1,1
20200121-W-Australian_Open-R128-Alize_Cornet-Monica_Niculescu,1,F-XC,82,10,7,1,2,44,38
20200121-W-Australian_Open-R128-Alize_Cornet-Monica_Niculescu,1,F-DTM,36,3,0,1,2,22,14
20200121-W-Australian_Open-R128-Alize_Cornet-Monica_Niculescu,1,F-DTL,17,5,5,0,0,11,6
20200121-W-Australian_Open-R128-Alize_Cornet-Monica_Niculescu,1,F-IO,28,6,2,0,4,12,16
20200121-W-Australian_Open-R128-Alize_Cornet-Monica_Niculescu,1,F-II,3,0,0,0,0,2,1
20200121-W-Australian_Open-R128-Alize_Cornet-Monica_Niculescu,1,B-XC,63,9,4,2,3,31,32
20200121-W-Australian_Open-R128-Alize_Cornet-Monica_Niculescu,1,B-DTM,47,3,0,2,1,28,19
20200121-W-Australian_Open-R128-Alize_Cornet-Monica_Niculescu,1,B-DTL,13,6,4,0,2,9,4
20200121-W-Australian_Open-R128-Alize_Cornet-Monica_Niculescu,1,B-IO,12,3,2,1,0,9,3
20200121-W-Australian_Open-R128-Alize_Cornet-Monica_Niculescu,1,S-XC,4,0,0,0,0,2,2
20200121-W-Australian_Open-R128-Alize_Cornet-Monica_Niculescu,1,S-DTM,3,0,0,0,0,2,1
20200121-W-Australian_Open-R128-Alize_Cornet-Monica_Niculescu,1,S-DTL,4,1,0,1,0,2,2
20200121-W-Australian_Open-R128-Alize_Cornet-Monica_Niculescu,2,F-XC,3,2,2,0,0,2,1
20200121-W-Australian_Open-R128-Alize_Cornet-Monica_Niculescu,2,F-DTM,2,0,0,0,0,2,0
20200121-W-Australian_Open-R128-Alize_Cornet-Monica_Niculescu,2,F-DTL,1,0,0,0,0,0,1
20200121-W-Australian_Open-R128-Alize_Cornet-Monica_Niculescu,2,B-XC,44,10,2,3,5,22,22
20200121-W-Australian_Open-R128-Alize_Cornet-Monica_Niculescu,2,B-DTM,71,5,0,2,3,35,36
20200121-W-Australian_Open-R128-Alize_Cornet-Monica_Niculescu,2,B-DTL,13,6,3,1,2,7,6
20200121-W-Australian_Open-R128-Alize_Cornet-Monica_Niculescu,2,B-IO,7,3,0,0,3,1,6
20200121-W-Australian_Open-R128-Alize_Cornet-Monica_Niculescu,2,S-XC,2,0,0,0,0,0,2
20200121-W-Australian_Open-R128-Alize_Cornet-Monica_Niculescu,2,S-DTM,3,0,0,0,0,2,1
20200121-W-Australian_Open-R128-Alize_Cornet-Monica_Niculescu,2,S-IO,1,0,0,0,0,0,1
20130201-W-Paris-QF-Kiki_Bertens-Lucie_Safarova,1,F-XC,27,6,2,2,2,19,8
20130201-W-Paris-QF-Kiki_Bertens-Lucie_Safarova,1,F-DTM,12,0,0,0,0,8,4
20130201-W-Paris-QF-Kiki_Bertens-Lucie_Safarova,1,F-DTL,9,5,2,2,1,8,1
20130201-W-Paris-QF-Kiki_Bertens-Lucie_Safarova,1,F-IO,4,4,1,1,2,2,2
20130201-W-Paris-QF-Kiki_Bertens-Lucie_Safarova,1,B-XC,20,4,2,1,1,12,8
20130201-W-Paris-QF-Kiki_Bertens-Lucie_Safarova,1,B-DTM,38,1,0,0,1,23,15
20130201-W-Paris-QF-Kiki_Bertens-Lucie_Safarova,1,B-DTL,3,2,1,1,0,2,1
20130201-W-Paris-QF-Kiki_Bertens-Lucie_Safarova,1,B-IO,4,2,1,0,1,2,2
20130201-W-Paris-QF-Kiki_Bertens-Lucie_Safarova,1,S-XC,9,2,0,0,2,4,5
20130201-W-Paris-QF-Kiki_Bertens-Lucie_Safarova,1,S-DTM,13,1,0,0,1,5,8
20130201-W-Paris-QF-Kiki_Bertens-Lucie_Safarova,2,F-XC,49,6,0,0,6,18,31
20130201-W-Paris-QF-Kiki_Bertens-Lucie_Safarova,2,F-DTM,23,2,0,0,2,8,15
20130201-W-Paris-QF-Kiki_Bertens-Lucie_Safarova,2,F-DTL,7,4,0,2,2,2,5
20130201-W-Paris-QF-Kiki_Bertens-Lucie_Safarova,2,F-IO,13,7,3,0,4,6,7
20130201-W-Paris-QF-Kiki_Bertens-Lucie_Safarova,2,B-XC,15,4,1,0,3,4,11
20130201-W-Paris-QF-Kiki_Bertens-Lucie_Safarova,2,B-DTM,16,1,0,0,1,6,10
20130201-W-Paris-QF-Kiki_Bertens-Lucie_Safarova,2,B-DTL,5,2,1,0,1,2,3
20130201-W-Paris-QF-Kiki_Bertens-Lucie_Safarova,2,B-IO,8,4,1,0,3,5,3
20130201-W-Paris-QF-Kiki_Bertens-Lucie_Safarova,2,S-XC,1,0,0,0,0,0,1
20130201-W-Paris-QF-Kiki_Bertens-Lucie_Safarova,2,S-DTM,2,0,0,0,0,0,2
20130201-W-Paris-QF-Kiki_Bertens-Lucie_Safarova,2,S-DTL,1,1,0,0,1,0,1
20200121-W-Australian_Open-R128-Anna_Blinkova-Jasmine_Paolini,1,F-XC,59,16,9,0,7,36,23
20200121-W-Australian_Open-R128-Anna_Blinkova-Jasmine_Paolini,1,F-DTM,24,3,0,0,3,11,13
20200121-W-Australian_Open-R128-Anna_Blinkova-Jasmine_Paolini,1,F-DTL,9,5,2,0,3,5,4
20200121-W-Australian_Open-R128-Anna_Blinkova-Jasmine_Paolini,1,F-IO,30,3,2,1,0,19,11
20200121-W-Australian_Open-R128-Anna_Blinkova-Jasmine_Paolini,1,F-II,2,1,1,0,0,1,1
20200121-W-Australian_Open-R128-Anna_Blinkova-Jasmine_Paolini,1,B-XC,58,9,3,3,3,32,26
20200121-W-Australian_Open-R128-Anna_Blinkova-Jasmine_Paolini,1,B-DTM,40,4,0,0,4,21,19
20200121-W-Australian_Open-R128-Anna_Blinkova-Jasmine_Paolini,1,B-DTL,6,3,3,0,0,3,3
20200121-W-Australian_Open-R128-Anna_Blinkova-Jasmine_Paolini,1,B-IO,11,6,4,0,2,6,5
20200121-W-Australian_Open-R128-Anna_Blinkova-Jasmine_Paolini,1,S-DTM,3,1,0,0,1,1,2
20200121-W-Australian_Open-R128-Anna_Blinkova-Jasmine_Paolini,1,S-DTL,1,0,0,0,0,1,0
20200121-W-Australian_Open-R128-Anna_Blinkova-Jasmine_Paolini,1,S-IO,1,0,0,0,0,1,0
20200121-W-Australian_Open-R128-Anna_Blinkova-Jasmine_Paolini,2,F-XC,39,6,2,2,2,17,22
20200121-W-Australian_Open-R128-Anna_Blinkova-Jasmine_Paolini,2,F-DTM,36,5,1,0,4,16,20
20200121-W-Australian_Open-R128-Anna_Blinkova-Jasmine_Paolini,2,F-DTL,10,5,2,0,3,4,6
20200121-W-Australian_Open-R128-Anna_Blinkova-Jasmine_Paolini,2,F-IO,18,5,1,0,4,10,8
20200121-W-Australian_Open-R128-Anna_Blinkova-Jasmine_Paolini,2,F-II,1,1,1,0,0,1,0
20200121-W-Australian_Open-R128-Anna_Blinkova-Jasmine_Paolini,2,B-XC,53,19,6,5,8,32,21
20200121-W-Australian_Open-R128-Anna_Blinkova-Jasmine_Paolini,2,B-DTM,61,5,0,0,5,19,42
20200121-W-Australian_Open-R128-Anna_Blinkova-Jasmine_Paolini,2,B-DTL,14,3,1,1,1,8,6
20200121-W-Australian_Open-R128-Anna_Blinkova-Jasmine_Paolini,2,B-IO,6,4,1,0,3,1,5
20200121-W-Australian_Open-R128-Anna_Blinkova-Jasmine_Paolini,2,S-XC,2,0,0,0,0,1,1
20200121-W-Australian_Open-R128-Anna_Blinkova-Jasmine_Paolini,2,S-DTM,3,0,0,0,0,0,3
20200208-W-Fed_Cup_Qualifiers-RR-Aryna_Sabalenka-Kiki_Bertens,1,F-XC,32,11,3,4,4,11,21
20200208-W-Fed_Cup_Qualifiers-RR-Aryna_Sabalenka-Kiki_Bertens,1,F-DTM,9,2,0,0,2,3,6
20200208-W-Fed_Cup_Qualifiers-RR-Aryna_Sabalenka-Kiki_Bertens,1,F-DTL,8,5,1,0,4,3,5
20200208-W-Fed_Cup_Qualifiers-RR-Aryna_Sabalenka-Kiki_Bertens,1,F-IO,19,6,1,2,3,9,10
20200208-W-Fed_Cup_Qualifiers-RR-Aryna_Sabalenka-Kiki_Bertens,1,B-XC,17,4,1,0,3,6,11
20200208-W-Fed_Cup_Qualifiers-RR-Aryna_Sabalenka-Kiki_Bertens,1,B-DTM,2,0,0,0,0,1,1
20200208-W-Fed_Cup_Qualifiers-RR-Aryna_Sabalenka-Kiki_Bertens,1,B-DTL,2,1,1,0,0,1,1
20200208-W-Fed_Cup_Qualifiers-RR-Aryna_Sabalenka-Kiki_Bertens,1,B-IO,4,1,0,0,1,3,1
20200208-W-Fed_Cup_Qualifiers-RR-Aryna_Sabalenka-Kiki_Bertens,1,S-XC,1,0,0,0,0,0,1
20200208-W-Fed_Cup_Qualifiers-RR-Aryna_Sabalenka-Kiki_Bertens,1,S-DTL,1,0,0,0,0,0,1
20200208-W-Fed_Cup_Qualifiers-RR-Aryna_Sabalenka-Kiki_Bertens,2,F-XC,17,4,2,1,1,15,2
20200208-W-Fed_Cup_Qualifiers-RR-Aryna_Sabalenka-Kiki_Bertens,2,F-DTM,16,1,0,0,1,11,5
20200208-W-Fed_Cup_Qualifiers-RR-Aryna_Sabalenka-Kiki_Bertens,2,F-DTL,7,3,2,1,0,5,2
20200208-W-Fed_Cup_Qualifiers-RR-Aryna_Sabalenka-Kiki_Bertens,2,F-IO,8,6,3,1,2,4,4
20200208-W-Fed_Cup_Qualifiers-RR-Aryna_Sabalenka-Kiki_Bertens,2,B-XC,4,0,0,0,0,4,0
20200208-W-Fed_Cup_Qualifiers-RR-Aryna_Sabalenka-Kiki_Bertens,2,B-DTM,21,6,0,1,5,9,12
20200208-W-Fed_Cup_Qualifiers-RR-Aryna_Sabalenka-Kiki_Bertens,2,B-DTL,2,0,0,0,0,2,0
20200208-W-Fed_Cup_Qualifiers-RR-Aryna_Sabalenka-Kiki_Bertens,2,B-IO,3,2,0,2,0,2,1
20200208-W-Fed_Cup_Qualifiers-RR-Aryna_Sabalenka-Kiki_Bertens,2,S-XC,1,0,0,0,0,1,0
20200208-W-Fed_Cup_Qualifiers-RR-Aryna_Sabalenka-Kiki_Bertens,2,S-DTM,7,2,0,0,2,2,5
20200208-W-Fed_Cup_Qualifiers-RR-Aryna_Sabalenka-Kiki_Bertens,2,S-DTL,1,1,1,0,0,1,0
20200207-W-Fed_Cup_Qualifiers-RR-Aliaksandra_Sasnovich-Kiki_Bertens,1,F-XC,52,13,4,1,8,25,27
20200207-W-Fed_Cup_Qualifiers-RR-Aliaksandra_Sasnovich-Kiki_Bertens,1,F-DTM,23,2,0,0,2,12,11
20200207-W-Fed_Cup_Qualifiers-RR-Aliaksandra_Sasnovich-Kiki_Bertens,1,F-DTL,13,4,1,2,1,7,6
20200207-W-Fed_Cup_Qualifiers-RR-Aliaksandra_Sasnovich-Kiki_Bertens,1,F-IO,20,7,5,1,1,11,9
20200207-W-Fed_Cup_Qualifiers-RR-Aliaksandra_Sasnovich-Kiki_Bertens,1,B-XC,42,9,0,1,8,18,24
20200207-W-Fed_Cup_Qualifiers-RR-Aliaksandra_Sasnovich-Kiki_Bertens,1,B-DTM,17,0,0,0,0,8,9
20200207-W-Fed_Cup_Qualifiers-RR-Aliaksandra_Sasnovich-Kiki_Bertens,1,B-DTL,4,3,0,0,3,0,4
20200207-W-Fed_Cup_Qualifiers-RR-Aliaksandra_Sasnovich-Kiki_Bertens,1,B-IO,8,4,3,0,1,3,5
20200207-W-Fed_Cup_Qualifiers-RR-Aliaksandra_Sasnovich-Kiki_Bertens,1,S-XC,3,0,0,0,0,1,2
20200207-W-Fed_Cup_Qualifiers-RR-Aliaksandra_Sasnovich-Kiki_Bertens,1,S-DTM,1,0,0,0,0,0,1
20200207-W-Fed_Cup_Qualifiers-RR-Aliaksandra_Sasnovich-Kiki_Bertens,1,S-DTL,1,0,0,0,0,1,0
20200207-W-Fed_Cup_Qualifiers-RR-Aliaksandra_Sasnovich-Kiki_Bertens,2,F-XC,41,12,1,3,8,23,18
20200207-W-Fed_Cup_Qualifiers-RR-Aliaksandra_Sasnovich-Kiki_Bertens,2,F-DTM,19,2,0,0,2,7,12
20200207-W-Fed_Cup_Qualifiers-RR-Aliaksandra_Sasnovich-Kiki_Bertens,2,F-DTL,12,7,2,2,3,8,4
20200207-W-Fed_Cup_Qualifiers-RR-Aliaksandra_Sasnovich-Kiki_Bertens,2,F-IO,9,4,2,2,0,7,2
20200207-W-Fed_Cup_Qualifiers-RR-Aliaksandra_Sasnovich-Kiki_Bertens,2,F-II,2,2,1,0,1,1,1
20200207-W-Fed_Cup_Qualifiers-RR-Aliaksandra_Sasnovich-Kiki_Bertens,2,B-XC,19,4,0,2,2,13,6
20200207-W-Fed_Cup_Qualifiers-RR-Aliaksandra_Sasnovich-Kiki_Bertens,2,B-DTM,34,1,0,0,1,15,19
20200207-W-Fed_Cup_Qualifiers-RR-Aliaksandra_Sasnovich-Kiki_Bertens,2,B-DTL,9,2,1,0,1,5,4
20200207-W-Fed_Cup_Qualifiers-RR-Aliaksandra_Sasnovich-Kiki_Bertens,2,B-IO,1,1,0,0,1,0,1
20200207-W-Fed_Cup_Qualifiers-RR-Aliaksandra_Sasnovich-Kiki_Bertens,2,S-XC,2,2,1,0,1,1,1
20200207-W-Fed_Cup_Qualifiers-RR-Aliaksandra_Sasnovich-Kiki_Bertens,2,S-DTM,13,1,0,0,1,4,9
20200207-W-Fed_Cup_Qualifiers-RR-Aliaksandra_Sasnovich-Kiki_Bertens,2,S-DTL,7,0,0,0,0,3,4
20200208-W-Fed_Cup_Qualifiers-RR-Aliaksandra_Sasnovich-Arantxa_Rus,1,F-XC,78,21,3,6,12,38,40
20200208-W-Fed_Cup_Qualifiers-RR-Aliaksandra_Sasnovich-Arantxa_Rus,1,F-DTM,35,5,0,1,4,14,21
20200208-W-Fed_Cup_Qualifiers-RR-Aliaksandra_Sasnovich-Arantxa_Rus,1,F-DTL,18,9,1,4,4,9,9
20200208-W-Fed_Cup_Qualifiers-RR-Aliaksandra_Sasnovich-Arantxa_Rus,1,F-IO,22,8,2,1,5,12,10
20200208-W-Fed_Cup_Qualifiers-RR-Aliaksandra_Sasnovich-Arantxa_Rus,1,B-XC,29,10,2,1,7,16,13
20200208-W-Fed_Cup_Qualifiers-RR-Aliaksandra_Sasnovich-Arantxa_Rus,1,B-DTM,36,4,0,1,3,21,15
20200208-W-Fed_Cup_Qualifiers-RR-Aliaksandra_Sasnovich-Arantxa_Rus,1,B-DTL,11,3,1,1,1,6,5
20200208-W-Fed_Cup_Qualifiers-RR-Aliaksandra_Sasnovich-Arantxa_Rus,1,B-IO,18,4,2,1,1,10,8
20200208-W-Fed_Cup_Qualifiers-RR-Aliaksandra_Sasnovich-Arantxa_Rus,1,S-DTM,1,0,0,0,0,0,1
20200208-W-Fed_Cup_Qualifiers-RR-Aliaksandra_Sasnovich-Arantxa_Rus,2,F-XC,36,5,3,1,1,18,18
20200208-W-Fed_Cup_Qualifiers-RR-Aliaksandra_Sasnovich-Arantxa_Rus,2,F-DTM,39,4,0,0,4,15,24
20200208-W-Fed_Cup_Qualifiers-RR-Aliaksandra_Sasnovich-Arantxa_Rus,2,F-DTL,8,5,1,0,4,2,6
20200208-W-Fed_Cup_Qualifiers-RR-Aliaksandra_Sasnovich-Arantxa_Rus,2,F-IO,35,10,4,1,5,21,14
20200208-W-Fed_Cup_Qualifiers-RR-Aliaksandra_Sasnovich-Arantxa_Rus,2,B-XC,40,2,0,1,1,23,17
20200208-W-Fed_Cup_Qualifiers-RR-Aliaksandra_Sasnovich-Arantxa_Rus,2,B-DTM,67,8,0,1,7,34,33
20200208-W-Fed_Cup_Qualifiers-RR-Aliaksandra_Sasnovich-Arantxa_Rus,2,B-DTL,10,4,0,0,4,2,8
20200208-W-Fed_Cup_Qualifiers-RR-Aliaksandra_Sasnovich-Arantxa_Rus,2,B-IO,3,0,0,0,0,0,3
20200208-W-Fed_Cup_Qualifiers-RR-Aliaksandra_Sasnovich-Arantxa_Rus,2,S-XC,2,0,0,0,0,1,1
20200208-W-Fed_Cup_Qualifiers-RR-Aliaksandra_Sasnovich-Arantxa_Rus,2,S-DTM,10,1,0,0,1,2,8
20190816-W-Cincinnati-QF-Madison_Keys-Venus_Williams,1,F-XC,22,7,5,0,2,15,7
20190816-W-Cincinnati-QF-Madison_Keys-Venus_Williams,1,F-DTM,27,2,0,0,2,15,12
20190816-W-Cincinnati-QF-Madison_Keys-Venus_Williams,1,F-DTL,6,4,2,0,2,3,3
20190816-W-Cincinnati-QF-Madison_Keys-Venus_Williams,1,F-IO,13,10,5,0,5,6,7
20190816-W-Cincinnati-QF-Madison_Keys-Venus_Williams,1,B-XC,17,6,4,1,1,12,5
20190816-W-Cincinnati-QF-Madison_Keys-Venus_Williams,1,B-DTM,13,3,0,0,3,8,5
20190816-W-Cincinnati-QF-Madison_Keys-Venus_Williams,1,B-DTL,6,6,1,2,3,3,3
20190816-W-Cincinnati-QF-Madison_Keys-Venus_Williams,1,B-IO,9,6,3,1,2,7,2
20190816-W-Cincinnati-QF-Madison_Keys-Venus_Williams,1,S-XC,1,0,0,0,0,1,0
20190816-W-Cincinnati-QF-Madison_Keys-Venus_Williams,2,F-XC,26,6,1,2,3,13,13
20190816-W-Cincinnati-QF-Madison_Keys-Venus_Williams,2,F-DTM,23,5,0,0,5,3,20
20190816-W-Cincinnati-QF-Madison_Keys-Venus_Williams,2,F-DTL,7,2,0,1,1,3,4
20190816-W-Cincinnati-QF-Madison_Keys-Venus_Williams,2,F-IO,15,6,0,2,4,5,10
20190816-W-Cincinnati-QF-Madison_Keys-Venus_Williams,2,B-XC,12,3,0,1,2,4,8
20190816-W-Cincinnati-QF-Madison_Keys-Venus_Williams,2,B-DTM,14,3,0,1,2,6,8
20190816-W-Cincinnati-QF-Madison_Keys-Venus_Williams,2,B-DTL,2,1,0,0,1,0,2
20190816-W-Cincinnati-QF-Madison_Keys-Venus_Williams,2,B-IO,2,1,0,1,0,2,0
20190816-W-Cincinnati-QF-Madison_Keys-Venus_Williams,2,S-DTM,1,0,0,0,0,1,0
20190517-W-Rome-QF-Maria_Sakkari-Kristina_Mladenovic,1,F-XC,38,19,10,6,3,24,14
20190517-W-Rome-QF-Maria_Sakkari-Kristina_Mladenovic,1,F-DTM,32,0,0,0,0,17,15
20190517-W-Rome-QF-Maria_Sakkari-Kristina_Mladenovic,1,F-DTL,19,6,3,1,2,12,7
20190517-W-Rome-QF-Maria_Sakkari-Kristina_Mladenovic,1,F-IO,49,5,3,0,2,35,14
20190517-W-Rome-QF-Maria_Sakkari-Kristina_Mladenovic,1,F-II,3,1,0,0,1,2,1
20190517-W-Rome-QF-Maria_Sakkari-Kristina_Mladenovic,1,B-XC,37,8,1,3,4,19,18
20190517-W-Rome-QF-Maria_Sakkari-Kristina_Mladenovic,1,B-DTM,29,3,0,0,3,14,15
20190517-W-Rome-QF-Maria_Sakkari-Kristina_Mladenovic,1,B-DTL,9,8,7,0,1,8,1
20190517-W-Rome-QF-Maria_Sakkari-Kristina_Mladenovic,1,B-IO,5,3,3,0,0,4,1
20190517-W-Rome-QF-Maria_Sakkari-Kristina_Mladenovic,1,S-XC,3,0,0,0,0,1,2
20190517-W-Rome-QF-Maria_Sakkari-Kristina_Mladenovic,1,S-DTM,4,1,0,0,1,0,4
20190517-W-Rome-QF-Maria_Sakkari-Kristina_Mladenovic,1,S-DTL,2,2,2,0,0,2,0
20190517-W-Rome-QF-Maria_Sakkari-Kristina_Mladenovic,2,F-XC,34,16,5,6,5,20,14
20190517-W-Rome-QF-Maria_Sakkari-Kristina_Mladenovic,2,F-DTM,31,3,0,0,3,12,19
20190517-W-Rome-QF-Maria_Sakkari-Kristina_Mladenovic,2,F-DTL,4,1,1,0,0,2,2
20190517-W-Rome-QF-Maria_Sakkari-Kristina_Mladenovic,2,F-IO,27,8,2,3,3,15,12
20190517-W-Rome-QF-Maria_Sakkari-Kristina_Mladenovic,2,F-II,3,2,1,1,0,3,0
20190517-W-Rome-QF-Maria_Sakkari-Kristina_Mladenovic,2,B-XC,34,3,2,0,1,12,22
20190517-W-Rome-QF-Maria_Sakkari-Kristina_Mladenovic,2,B-DTM,49,3,0,0,3,18,31
20190517-W-Rome-QF-Maria_Sakkari-Kristina_Mladenovic,2,B-DTL,15,6,1,0,5,7,8
20190517-W-Rome-QF-Maria_Sakkari-Kristina_Mladenovic,2,B-IO,9,3,1,0,2,3,6
20190517-W-Rome-QF-Maria_Sakkari-Kristina_Mladenovic,2,S-XC,7,1,0,0,1,2,5
20190517-W-Rome-QF-Maria_Sakkari-Kristina_Mladenovic,2,S-DTM,8,0,0,0,0,4,4
20190517-W-Rome-QF-Maria_Sakkari-Kristina_Mladenovic,2,S-DTL,1,0,0,0,0,0,1
20190517-W-Rome-QF-Maria_Sakkari-Kristina_Mladenovic,2,S-IO,2,1,0,1,0,1,1
20190925-W-Wuhan-R16-Sloane_Stephens-Petra_Kvitova,1,F-XC,12,2,0,1,1,9,3
20190925-W-Wuhan-R16-Sloane_Stephens-Petra_Kvitova,1,F-DTM,23,4,0,2,2,18,5
20190925-W-Wuhan-R16-Sloane_Stephens-Petra_Kvitova,1,F-DTL,2,2,0,1,1,1,1
20190925-W-Wuhan-R16-Sloane_Stephens-Petra_Kvitova,1,F-IO,10,7,2,0,5,5,5
20190925-W-Wuhan-R16-Sloane_Stephens-Petra_Kvitova,1,B-XC,9,3,1,1,1,7,2
20190925-W-Wuhan-R16-Sloane_Stephens-Petra_Kvitova,1,B-DTM,22,3,0,1,2,11,11
20190925-W-Wuhan-R16-Sloane_Stephens-Petra_Kvitova,1,B-DTL,6,1,1,0,0,3,3
20190925-W-Wuhan-R16-Sloane_Stephens-Petra_Kvitova,1,B-IO,4,2,0,0,2,1,3
20190925-W-Wuhan-R16-Sloane_Stephens-Petra_Kvitova,1,B-II,1,0,0,0,0,1,0
20190925-W-Wuhan-R16-Sloane_Stephens-Petra_Kvitova,1,S-XC,2,0,0,0,0,2,0
20190925-W-Wuhan-R16-Sloane_Stephens-Petra_Kvitova,1,S-DTM,2,0,0,0,0,1,1
20190925-W-Wuhan-R16-Sloane_Stephens-Petra_Kvitova,2,F-XC,26,13,2,1,10,7,19
20190925-W-Wuhan-R16-Sloane_Stephens-Petra_Kvitova,2,F-DTM,18,3,1,1,1,8,10
20190925-W-Wuhan-R16-Sloane_Stephens-Petra_Kvitova,2,F-DTL,2,0,0,0,0,0,2
20190925-W-Wuhan-R16-Sloane_Stephens-Petra_Kvitova,2,F-IO,16,10,2,2,6,8,8
20190925-W-Wuhan-R16-Sloane_Stephens-Petra_Kvitova,2,B-XC,9,3,0,1,2,3,6
20190925-W-Wuhan-R16-Sloane_Stephens-Petra_Kvitova,2,B-DTM,16,2,0,1,1,7,9
20190925-W-Wuhan-R16-Sloane_Stephens-Petra_Kvitova,2,B-DTL,1,1,0,1,0,1,0
20190925-W-Wuhan-R16-Sloane_Stephens-Petra_Kvitova,2,B-IO,3,2,0,0,2,1,2
20190925-W-Wuhan-R16-Sloane_Stephens-Petra_Kvitova,2,S-DTM,4,0,0,0,0,1,3
20190925-W-Wuhan-R16-Sloane_Stephens-Petra_Kvitova,2,S-IO,2,1,0,1,0,1,1
20200120-W-Australian_Open-R128-Jil_Teichmann-Ekaterina_Alexandrova,1,F-XC,39,11,3,1,7,18,21
20200120-W-Australian_Open-R128-Jil_Teichmann-Ekaterina_Alexandrova,1,F-DTM,52,2,0,0,2,21,31
20200120-W-Australian_Open-R128-Jil_Teichmann-Ekaterina_Alexandrova,1,F-DTL,20,11,3,2,6,8,12
20200120-W-Australian_Open-R128-Jil_Teichmann-Ekaterina_Alexandrova,1,F-IO,6,3,2,1,0,5,1
20200120-W-Australian_Open-R128-Jil_Teichmann-Ekaterina_Alexandrova,1,B-XC,22,4,1,1,2,8,14
20200120-W-Australian_Open-R128-Jil_Teichmann-Ekaterina_Alexandrova,1,B-DTM,41,4,0,0,4,11,30
20200120-W-Australian_Open-R128-Jil_Teichmann-Ekaterina_Alexandrova,1,B-DTL,4,3,1,0,2,1,3
20200120-W-Australian_Open-R128-Jil_Teichmann-Ekaterina_Alexandrova,1,B-IO,5,0,0,0,0,3,2
20200120-W-Australian_Open-R128-Jil_Teichmann-Ekaterina_Alexandrova,1,S-XC,20,4,0,1,3,9,11
20200120-W-Australian_Open-R128-Jil_Teichmann-Ekaterina_Alexandrova,1,S-DTM,17,1,0,0,1,5,12
20200120-W-Australian_Open-R128-Jil_Teichmann-Ekaterina_Alexandrova,1,S-DTL,4,1,0,0,1,1,3
20200120-W-Australian_Open-R128-Jil_Teichmann-Ekaterina_Alexandrova,1,S-IO,3,0,0,0,0,2,1
20200120-W-Australian_Open-R128-Jil_Teichmann-Ekaterina_Alexandrova,2,F-XC,64,25,9,6,10,41,23
20200120-W-Australian_Open-R128-Jil_Teichmann-Ekaterina_Alexandrova,2,F-DTM,23,3,0,0,3,10,13
20200120-W-Australian_Open-R128-Jil_Teichmann-Ekaterina_Alexandrova,2,F-DTL,22,10,3,2,5,13,9
20200120-W-Australian_Open-R128-Jil_Teichmann-Ekaterina_Alexandrova,2,F-IO,42,10,3,3,4,26,16
20200120-W-Australian_Open-R128-Jil_Teichmann-Ekaterina_Alexandrova,2,B-XC,38,8,1,3,4,18,20
20200120-W-Australian_Open-R128-Jil_Teichmann-Ekaterina_Alexandrova,2,B-DTM,29,3,0,0,3,15,14
20200120-W-Australian_Open-R128-Jil_Teichmann-Ekaterina_Alexandrova,2,B-DTL,11,4,2,0,2,7,4
20200120-W-Australian_Open-R128-Jil_Teichmann-Ekaterina_Alexandrova,2,B-IO,12,3,3,0,0,9,3
20200120-W-Australian_Open-R128-Jil_Teichmann-Ekaterina_Alexandrova,2,S-XC,2,0,0,0,0,2,0
20200120-W-Australian_Open-R128-Jil_Teichmann-Ekaterina_Alexandrova,2,S-DTM,1,0,0,0,0,0,1
20200120-W-Australian_Open-R128-Jil_Teichmann-Ekaterina_Alexandrova,2,S-DTL,1,1,1,0,0,1,0
20200210-W-Hua_Hin-R32-Storm_Sanders-Ulrikke_Eikeri,1,F-XC,33,8,2,2,4,19,14
20200210-W-Hua_Hin-R32-Storm_Sanders-Ulrikke_Eikeri,1,F-DTM,18,2,0,1,1,6,12
20200210-W-Hua_Hin-R32-Storm_Sanders-Ulrikke_Eikeri,1,F-DTL,15,14,5,2,7,7,8
20200210-W-Hua_Hin-R32-Storm_Sanders-Ulrikke_Eikeri,1,F-IO,10,6,3,2,1,7,3
20200210-W-Hua_Hin-R32-Storm_Sanders-Ulrikke_Eikeri,1,F-II,1,1,1,0,0,1,0
20200210-W-Hua_Hin-R32-Storm_Sanders-Ulrikke_Eikeri,1,B-XC,30,8,3,1,4,14,16
20200210-W-Hua_Hin-R32-Storm_Sanders-Ulrikke_Eikeri,1,B-DTM,21,0,0,0,0,10,11
20200210-W-Hua_Hin-R32-Storm_Sanders-Ulrikke_Eikeri,1,B-DTL,7,3,1,1,1,5,2
20200210-W-Hua_Hin-R32-Storm_Sanders-Ulrikke_Eikeri,1,B-IO,4,3,1,0,2,1,3
20200210-W-Hua_Hin-R32-Storm_Sanders-Ulrikke_Eikeri,1,S-XC,1,1,0,0,1,0,1
20200210-W-Hua_Hin-R32-Storm_Sanders-Ulrikke_Eikeri,1,S-DTM,1,0,0,0,0,0,1
20200210-W-Hua_Hin-R32-Storm_Sanders-Ulrikke_Eikeri,2,F-XC,21,4,1,0,3,7,14
20200210-W-Hua_Hin-R32-Storm_Sanders-Ulrikke_Eikeri,2,F-DTM,27,1,0,0,1,17,10
20200210-W-Hua_Hin-R32-Storm_Sanders-Ulrikke_Eikeri,2,F-DTL,6,5,3,1,1,5,1
20200210-W-Hua_Hin-R32-Storm_Sanders-Ulrikke_Eikeri,2,F-IO,12,2,1,0,1,5,7
20200210-W-Hua_Hin-R32-Storm_Sanders-Ulrikke_Eikeri,2,F-II,1,0,0,0,0,0,1
20200210-W-Hua_Hin-R32-Storm_Sanders-Ulrikke_Eikeri,2,B-XC,14,2,0,1,1,5,9
20200210-W-Hua_Hin-R32-Storm_Sanders-Ulrikke_Eikeri,2,B-DTM,27,2,2,0,0,15,12
20200210-W-Hua_Hin-R32-Storm_Sanders-Ulrikke_Eikeri,2,B-DTL,9,3,2,0,1,4,5
20200210-W-Hua_Hin-R32-Storm_Sanders-Ulrikke_Eikeri,2,B-IO,8,1,0,1,0,7,1
20200210-W-Hua_Hin-R32-Storm_Sanders-Ulrikke_Eikeri,2,S-DTL,1,0,0,0,0,0,1
20200215-W-St_Petersburg-SF-Ekaterina_Alexandrova-Kiki_Bertens,1,F-XC,33,13,1,2,10,14,19
20200215-W-St_Petersburg-SF-Ekaterina_Alexandrova-Kiki_Bertens,1,F-DTM,22,0,0,0,0,10,12
20200215-W-St_Petersburg-SF-Ekaterina_Alexandrova-Kiki_Bertens,1,F-DTL,20,4,2,0,2,12,8
20200215-W-St_Petersburg-SF-Ekaterina_Alexandrova-Kiki_Bertens,1,F-IO,36,11,2,6,3,25,11
20200215-W-St_Petersburg-SF-Ekaterina_Alexandrova-Kiki_Bertens,1,F-II,3,0,0,0,0,1,2
20200215-W-St_Petersburg-SF-Ekaterina_Alexandrova-Kiki_Bertens,1,B-XC,36,5,1,1,3,14,22
20200215-W-St_Petersburg-SF-Ekaterina_Alexandrova-Kiki_Bertens,1,B-DTM,23,5,0,0,5,9,14
20200215-W-St_Petersburg-SF-Ekaterina_Alexandrova-Kiki_Bertens,1,B-DTL,11,5,2,1,2,4,7
20200215-W-St_Petersburg-SF-Ekaterina_Alexandrova-Kiki_Bertens,1,B-IO,7,3,0,1,2,3,4
20200215-W-St_Petersburg-SF-Ekaterina_Alexandrova-Kiki_Bertens,1,S-XC,6,0,0,0,0,4,2
20200215-W-St_Petersburg-SF-Ekaterina_Alexandrova-Kiki_Bertens,1,S-DTM,1,1,0,0,1,0,1
20200215-W-St_Petersburg-SF-Ekaterina_Alexandrova-Kiki_Bertens,2,F-XC,39,11,2,3,6,22,17
20200215-W-St_Petersburg-SF-Ekaterina_Alexandrova-Kiki_Bertens,2,F-DTM,17,2,1,0,1,10,7
20200215-W-St_Petersburg-SF-Ekaterina_Alexandrova-Kiki_Bertens,2,F-DTL,5,3,0,1,2,3,2
20200215-W-St_Petersburg-SF-Ekaterina_Alexandrova-Kiki_Bertens,2,F-IO,14,8,3,2,3,8,6
20200215-W-St_Petersburg-SF-Ekaterina_Alexandrova-Kiki_Bertens,2,F-II,2,1,1,0,0,1,1
20200215-W-St_Petersburg-SF-Ekaterina_Alexandrova-Kiki_Bertens,2,B-XC,34,6,0,2,4,18,16
20200215-W-St_Petersburg-SF-Ekaterina_Alexandrova-Kiki_Bertens,2,B-DTM,23,2,0,0,2,5,18
20200215-W-St_Petersburg-SF-Ekaterina_Alexandrova-Kiki_Bertens,2,B-DTL,7,4,1,2,1,5,2
20200215-W-St_Petersburg-SF-Ekaterina_Alexandrova-Kiki_Bertens,2,S-XC,13,1,0,0,1,8,5
20200215-W-St_Petersburg-SF-Ekaterina_Alexandrova-Kiki_Bertens,2,S-DTM,17,2,0,0,2,5,12
20200215-W-St_Petersburg-SF-Ekaterina_Alexandrova-Kiki_Bertens,2,S-DTL,4,2,0,0,2,2,2
20200214-W-St_Petersburg-QF-Anastasia_Potapova-Kiki_Bertens,1,F-XC,90,5,2,1,2,40,50
20200214-W-St_Petersburg-QF-Anastasia_Potapova-Kiki_Bertens,1,F-DTM,40,2,0,0,2,15,25
20200214-W-St_Petersburg-QF-Anastasia_Potapova-Kiki_Bertens,1,F-DTL,28,12,4,0,8,12,16
20200214-W-St_Petersburg-QF-Anastasia_Potapova-Kiki_Bertens,1,F-IO,21,6,1,2,3,10,11
20200214-W-St_Petersburg-QF-Anastasia_Potapova-Kiki_Bertens,1,F-II,1,0,0,0,0,0,1
20200214-W-St_Petersburg-QF-Anastasia_Potapova-Kiki_Bertens,1,B-XC,41,2,0,0,2,16,25
20200214-W-St_Petersburg-QF-Anastasia_Potapova-Kiki_Bertens,1,B-DTM,48,2,0,1,1,26,22
20200214-W-St_Petersburg-QF-Anastasia_Potapova-Kiki_Bertens,1,B-DTL,12,6,1,1,4,3,9
20200214-W-St_Petersburg-QF-Anastasia_Potapova-Kiki_Bertens,1,B-IO,10,4,2,2,0,5,5
20200214-W-St_Petersburg-QF-Anastasia_Potapova-Kiki_Bertens,1,S-DTM,2,0,0,0,0,0,2
20200214-W-St_Petersburg-QF-Anastasia_Potapova-Kiki_Bertens,1,S-IO,4,2,0,1,1,2,2
20200214-W-St_Petersburg-QF-Anastasia_Potapova-Kiki_Bertens,2,F-XC,102,15,2,5,8,58,44
20200214-W-St_Petersburg-QF-Anastasia_Potapova-Kiki_Bertens,2,F-DTM,32,3,0,2,1,19,13
20200214-W-St_Petersburg-QF-Anastasia_Potapova-Kiki_Bertens,2,F-DTL,22,8,2,0,6,14,8
20200214-W-St_Petersburg-QF-Anastasia_Potapova-Kiki_Bertens,2,F-IO,31,15,3,1,11,12,19
20200214-W-St_Petersburg-QF-Anastasia_Potapova-Kiki_Bertens,2,F-II,2,1,1,0,0,1,1
20200214-W-St_Petersburg-QF-Anastasia_Potapova-Kiki_Bertens,2,B-XC,38,5,0,1,4,21,17
20200214-W-St_Petersburg-QF-Anastasia_Potapova-Kiki_Bertens,2,B-DTM,27,1,0,0,1,11,16
20200214-W-St_Petersburg-QF-Anastasia_Potapova-Kiki_Bertens,2,B-DTL,8,4,1,0,3,5,3
20200214-W-St_Petersburg-QF-Anastasia_Potapova-Kiki_Bertens,2,B-IO,8,4,2,1,1,5,3
20200214-W-St_Petersburg-QF-Anastasia_Potapova-Kiki_Bertens,2,S-XC,12,2,0,0,2,7,5
20200214-W-St_Petersburg-QF-Anastasia_Potapova-Kiki_Bertens,2,S-DTM,26,1,1,0,0,17,9
20200214-W-St_Petersburg-QF-Anastasia_Potapova-Kiki_Bertens,2,S-DTL,4,0,0,0,0,2,2
20200216-W-St_Petersburg-F-Elena_Rybakina-Kiki_Bertens,1,F-XC,50,8,1,2,5,27,23
20200216-W-St_Petersburg-F-Elena_Rybakina-Kiki_Bertens,1,F-DTM,18,3,0,0,3,6,12
20200216-W-St_Petersburg-F-Elena_Rybakina-Kiki_Bertens,1,F-DTL,12,5,0,0,5,3,9
20200216-W-St_Petersburg-F-Elena_Rybakina-Kiki_Bertens,1,F-IO,18,4,1,1,2,11,7
20200216-W-St_Petersburg-F-Elena_Rybakina-Kiki_Bertens,1,B-XC,30,6,0,2,4,12,18
20200216-W-St_Petersburg-F-Elena_Rybakina-Kiki_Bertens,1,B-DTM,10,0,0,0,0,4,6
20200216-W-St_Petersburg-F-Elena_Rybakina-Kiki_Bertens,1,B-DTL,4,3,1,1,1,2,2
20200216-W-St_Petersburg-F-Elena_Rybakina-Kiki_Bertens,1,S-DTM,4,0,0,0,0,1,3
20200216-W-St_Petersburg-F-Elena_Rybakina-Kiki_Bertens,1,S-DTL,1,0,0,0,0,0,1
20200216-W-St_Petersburg-F-Elena_Rybakina-Kiki_Bertens,2,F-XC,36,5,0,1,4,19,17
20200216-W-St_Petersburg-F-Elena_Rybakina-Kiki_Bertens,2,F-DTM,23,2,0,0,2,11,12
20200216-W-St_Petersburg-F-Elena_Rybakina-Kiki_Bertens,2,F-DTL,7,2,1,0,1,4,3
20200216-W-St_Petersburg-F-Elena_Rybakina-Kiki_Bertens,2,F-IO,19,11,7,1,3,15,4
20200216-W-St_Petersburg-F-Elena_Rybakina-Kiki_Bertens,2,F-II,2,2,1,0,1,1,1
20200216-W-St_Petersburg-F-Elena_Rybakina-Kiki_Bertens,2,B-XC,17,2,0,0,2,10,7
20200216-W-St_Petersburg-F-Elena_Rybakina-Kiki_Bertens,2,B-DTM,14,3,0,2,1,8,6
20200216-W-St_Petersburg-F-Elena_Rybakina-Kiki_Bertens,2,B-DTL,4,3,2,0,1,2,2
20200216-W-St_Petersburg-F-Elena_Rybakina-Kiki_Bertens,2,S-XC,4,0,0,0,0,1,3
20200216-W-St_Petersburg-F-Elena_Rybakina-Kiki_Bertens,2,S-DTM,11,0,0,0,0,6,5
20200216-W-St_Petersburg-F-Elena_Rybakina-Kiki_Bertens,2,S-DTL,1,1,0,0,1,0,1
20200216-W-Hua_Hin-F-Magda_Linette-Leonie_Kung,1,F-XC,44,12,5,2,5,26,18
20200216-W-Hua_Hin-F-Magda_Linette-Leonie_Kung,1,F-DTM,16,2,0,0,1,5,11
20200216-W-Hua_Hin-F-Magda_Linette-Leonie_Kung,1,F-DTL,3,2,0,0,2,0,3
20200216-W-Hua_Hin-F-Magda_Linette-Leonie_Kung,1,F-IO,2,0,0,0,0,1,1
20200216-W-Hua_Hin-F-Magda_Linette-Leonie_Kung,1,B-XC,23,7,2,3,2,15,8
20200216-W-Hua_Hin-F-Magda_Linette-Leonie_Kung,1,B-DTM,14,3,0,0,3,5,9
20200216-W-Hua_Hin-F-Magda_Linette-Leonie_Kung,1,B-DTL,3,1,0,0,1,0,3
20200216-W-Hua_Hin-F-Magda_Linette-Leonie_Kung,1,B-IO,8,4,1,0,3,2,6
20200216-W-Hua_Hin-F-Magda_Linette-Leonie_Kung,1,S-XC,1,0,0,0,0,0,1
20200216-W-Hua_Hin-F-Magda_Linette-Leonie_Kung,1,S-DTM,1,0,0,0,0,1,0
20200216-W-Hua_Hin-F-Magda_Linette-Leonie_Kung,1,S-DTL,2,0,0,0,0,2,0
20200216-W-Hua_Hin-F-Magda_Linette-Leonie_Kung,1,S-IO,3,0,0,0,0,3,0
20200216-W-Hua_Hin-F-Magda_Linette-Leonie_Kung,2,F-XC,22,2,1,0,1,14,8
20200216-W-Hua_Hin-F-Magda_Linette-Leonie_Kung,2,F-DTM,30,4,0,0,4,14,16
20200216-W-Hua_Hin-F-Magda_Linette-Leonie_Kung,2,F-DTL,15,4,0,1,3,5,10
20200216-W-Hua_Hin-F-Magda_Linette-Leonie_Kung,2,F-IO,9,3,1,1,1,7,2
20200216-W-Hua_Hin-F-Magda_Linette-Leonie_Kung,2,B-XC,11,3,0,0,3,4,7
20200216-W-Hua_Hin-F-Magda_Linette-Leonie_Kung,2,B-DTM,18,2,0,0,1,9,9
20200216-W-Hua_Hin-F-Magda_Linette-Leonie_Kung,2,B-DTL,1,1,0,1,0,1,0
20200216-W-Hua_Hin-F-Magda_Linette-Leonie_Kung,2,B-IO,1,1,1,0,0,1,0
20200216-W-Hua_Hin-F-Magda_Linette-Leonie_Kung,2,S-DTM,2,0,0,0,0,0,2
20200211-W-St_Petersburg-R32-Daria_Kasatkina-Ekaterina_Alexandrova,1,F-XC,69,12,2,6,4,40,29
20200211-W-St_Petersburg-R32-Daria_Kasatkina-Ekaterina_Alexandrova,1,F-DTM,42,2,0,0,2,26,16
20200211-W-St_Petersburg-R32-Daria_Kasatkina-Ekaterina_Alexandrova,1,F-DTL,15,3,0,1,2,9,6
20200211-W-St_Petersburg-R32-Daria_Kasatkina-Ekaterina_Alexandrova,1,F-IO,14,1,0,0,1,7,7
20200211-W-St_Petersburg-R32-Daria_Kasatkina-Ekaterina_Alexandrova,1,F-II,1,1,0,0,1,0,1
20200211-W-St_Petersburg-R32-Daria_Kasatkina-Ekaterina_Alexandrova,1,B-XC,22,3,0,1,2,14,8
20200211-W-St_Petersburg-R32-Daria_Kasatkina-Ekaterina_Alexandrova,1,B-DTM,29,3,1,0,2,19,10
20200211-W-St_Petersburg-R32-Daria_Kasatkina-Ekaterina_Alexandrova,1,B-DTL,7,0,0,0,0,4,3
20200211-W-St_Petersburg-R32-Daria_Kasatkina-Ekaterina_Alexandrova,1,B-IO,2,0,0,0,0,1,1
20200211-W-St_Petersburg-R32-Daria_Kasatkina-Ekaterina_Alexandrova,1,S-XC,11,1,0,0,1,6,5
20200211-W-St_Petersburg-R32-Daria_Kasatkina-Ekaterina_Alexandrova,1,S-DTM,16,1,0,0,1,10,6
20200211-W-St_Petersburg-R32-Daria_Kasatkina-Ekaterina_Alexandrova,1,S-DTL,3,1,0,0,1,2,1
20200211-W-St_Petersburg-R32-Daria_Kasatkina-Ekaterina_Alexandrova,1,S-IO,3,0,0,0,0,0,3
20200211-W-St_Petersburg-R32-Daria_Kasatkina-Ekaterina_Alexandrova,2,F-XC,83,26,5,9,12,39,44
20200211-W-St_Petersburg-R32-Daria_Kasatkina-Ekaterina_Alexandrova,2,F-DTM,19,3,0,0,3,9,10
20200211-W-St_Petersburg-R32-Daria_Kasatkina-Ekaterina_Alexandrova,2,F-DTL,29,17,8,4,5,16,13
20200211-W-St_Petersburg-R32-Daria_Kasatkina-Ekaterina_Alexandrova,2,F-IO,35,11,3,0,8,13,22
20200211-W-St_Petersburg-R32-Daria_Kasatkina-Ekaterina_Alexandrova,2,F-II,2,1,1,0,0,1,1
20200211-W-St_Petersburg-R32-Daria_Kasatkina-Ekaterina_Alexandrova,2,B-XC,37,7,3,0,4,11,26
20200211-W-St_Petersburg-R32-Daria_Kasatkina-Ekaterina_Alexandrova,2,B-DTM,34,4,0,0,4,14,20
20200211-W-St_Petersburg-R32-Daria_Kasatkina-Ekaterina_Alexandrova,2,B-DTL,15,5,1,0,4,4,11
20200211-W-St_Petersburg-R32-Daria_Kasatkina-Ekaterina_Alexandrova,2,B-IO,10,2,0,0,2,1,9
20200211-W-St_Petersburg-R32-Daria_Kasatkina-Ekaterina_Alexandrova,2,S-XC,2,0,0,0,0,1,1
20200211-W-St_Petersburg-R32-Daria_Kasatkina-Ekaterina_Alexandrova,2,S-DTM,1,0,0,0,0,1,0
20200211-W-St_Petersburg-R32-Daria_Kasatkina-Ekaterina_Alexandrova,2,S-DTL,1,0,0,0,0,1,0
20200211-W-St_Petersburg-R32-Veronika_Kudermetova-Yulia_Putintseva,1,F-XC,46,15,8,2,5,25,21
20200211-W-St_Petersburg-R32-Veronika_Kudermetova-Yulia_Putintseva,1,F-DTM,24,0,0,0,0,6,18
20200211-W-St_Petersburg-R32-Veronika_Kudermetova-Yulia_Putintseva,1,F-DTL,17,10,1,3,6,7,10
20200211-W-St_Petersburg-R32-Veronika_Kudermetova-Yulia_Putintseva,1,F-IO,17,5,2,1,2,11,6
20200211-W-St_Petersburg-R32-Veronika_Kudermetova-Yulia_Putintseva,1,B-XC,90,12,2,2,8,38,52
20200211-W-St_Petersburg-R32-Veronika_Kudermetova-Yulia_Putintseva,1,B-DTM,57,6,0,0,6,24,33
20200211-W-St_Petersburg-R32-Veronika_Kudermetova-Yulia_Putintseva,1,B-DTL,17,13,6,2,5,8,9
20200211-W-St_Petersburg-R32-Veronika_Kudermetova-Yulia_Putintseva,1,B-IO,13,6,2,0,4,4,9
20200211-W-St_Petersburg-R32-Veronika_Kudermetova-Yulia_Putintseva,1,S-XC,12,4,0,1,3,3,9
20200211-W-St_Petersburg-R32-Veronika_Kudermetova-Yulia_Putintseva,1,S-DTM,6,0,0,0,0,4,2
20200211-W-St_Petersburg-R32-Veronika_Kudermetova-Yulia_Putintseva,1,S-DTL,2,0,0,0,0,2,0
20200211-W-St_Petersburg-R32-Veronika_Kudermetova-Yulia_Putintseva,2,F-XC,46,9,4,3,2,29,17
20200211-W-St_Petersburg-R32-Veronika_Kudermetova-Yulia_Putintseva,2,F-DTM,37,2,1,0,1,21,16
20200211-W-St_Petersburg-R32-Veronika_Kudermetova-Yulia_Putintseva,2,F-DTL,20,5,2,1,2,15,5
20200211-W-St_Petersburg-R32-Veronika_Kudermetova-Yulia_Putintseva,2,F-IO,31,4,0,2,2,17,14
20200211-W-St_Petersburg-R32-Veronika_Kudermetova-Yulia_Putintseva,2,F-II,6,3,1,1,1,5,1
20200211-W-St_Petersburg-R32-Veronika_Kudermetova-Yulia_Putintseva,2,B-XC,57,4,2,0,2,31,26
20200211-W-St_Petersburg-R32-Veronika_Kudermetova-Yulia_Putintseva,2,B-DTM,30,1,0,0,1,17,13
20200211-W-St_Petersburg-R32-Veronika_Kudermetova-Yulia_Putintseva,2,B-DTL,9,6,5,1,0,7,2
20200211-W-St_Petersburg-R32-Veronika_Kudermetova-Yulia_Putintseva,2,B-IO,2,0,0,0,0,1,1
20200211-W-St_Petersburg-R32-Veronika_Kudermetova-Yulia_Putintseva,2,S-XC,19,1,0,0,1,10,9
20200211-W-St_Petersburg-R32-Veronika_Kudermetova-Yulia_Putintseva,2,S-DTM,18,1,0,0,1,7,11
20200211-W-St_Petersburg-R32-Veronika_Kudermetova-Yulia_Putintseva,2,S-DTL,1,0,0,0,0,1,0
20200207-W-Fed_Cup_Qualifiers-RR-Naomi_Osaka-Sara_Sorribes_Tormo,1,F-XC,50,6,0,2,4,19,31
20200207-W-Fed_Cup_Qualifiers-RR-Naomi_Osaka-Sara_Sorribes_Tormo,1,F-DTM,9,1,0,0,1,1,8
20200207-W-Fed_Cup_Qualifiers-RR-Naomi_Osaka-Sara_Sorribes_Tormo,1,F-DTL,3,1,0,0,1,1,2
20200207-W-Fed_Cup_Qualifiers-RR-Naomi_Osaka-Sara_Sorribes_Tormo,1,F-IO,18,8,3,1,4,5,13
20200207-W-Fed_Cup_Qualifiers-RR-Naomi_Osaka-Sara_Sorribes_Tormo,1,F-II,4,2,0,0,2,1,3
20200207-W-Fed_Cup_Qualifiers-RR-Naomi_Osaka-Sara_Sorribes_Tormo,1,B-XC,64,20,4,1,15,18,46
20200207-W-Fed_Cup_Qualifiers-RR-Naomi_Osaka-Sara_Sorribes_Tormo,1,B-DTM,26,2,0,0,2,8,18
20200207-W-Fed_Cup_Qualifiers-RR-Naomi_Osaka-Sara_Sorribes_Tormo,1,B-DTL,12,8,1,0,7,2,10
20200207-W-Fed_Cup_Qualifiers-RR-Naomi_Osaka-Sara_Sorribes_Tormo,1,B-IO,12,8,3,2,3,5,7
20200207-W-Fed_Cup_Qualifiers-RR-Naomi_Osaka-Sara_Sorribes_Tormo,2,F-XC,10,0,0,0,0,6,4
20200207-W-Fed_Cup_Qualifiers-RR-Naomi_Osaka-Sara_Sorribes_Tormo,2,F-DTM,34,2,1,1,0,23,11
20200207-W-Fed_Cup_Qualifiers-RR-Naomi_Osaka-Sara_Sorribes_Tormo,2,F-DTL,18,2,0,1,1,12,6
20200207-W-Fed_Cup_Qualifiers-RR-Naomi_Osaka-Sara_Sorribes_Tormo,2,F-IO,14,0,0,0,0,10,4
20200207-W-Fed_Cup_Qualifiers-RR-Naomi_Osaka-Sara_Sorribes_Tormo,2,B-DTM,10,1,0,1,0,8,2
20200207-W-Fed_Cup_Qualifiers-RR-Naomi_Osaka-Sara_Sorribes_Tormo,2,B-DTL,1,0,0,0,0,0,1
20200207-W-Fed_Cup_Qualifiers-RR-Naomi_Osaka-Sara_Sorribes_Tormo,2,B-IO,1,0,0,0,0,1,0
20200207-W-Fed_Cup_Qualifiers-RR-Naomi_Osaka-Sara_Sorribes_Tormo,2,S-XC,33,0,0,0,0,28,5
20200207-W-Fed_Cup_Qualifiers-RR-Naomi_Osaka-Sara_Sorribes_Tormo,2,S-DTM,36,1,0,0,1,24,12
20200207-W-Fed_Cup_Qualifiers-RR-Naomi_Osaka-Sara_Sorribes_Tormo,2,S-DTL,2,0,0,0,0,2,0
20200207-W-Fed_Cup_Qualifiers-RR-Naomi_Osaka-Sara_Sorribes_Tormo,2,S-IO,4,0,0,0,0,3,1
20200218-W-Dubai-R32-Su_Wei_Hsieh-Petra_Martic,1,F-XC,39,12,1,4,7,17,22
20200218-W-Dubai-R32-Su_Wei_Hsieh-Petra_Martic,1,F-DTM,10,0,0,0,0,7,3
20200218-W-Dubai-R32-Su_Wei_Hsieh-Petra_Martic,1,F-DTL,4,2,0,0,2,1,3
20200218-W-Dubai-R32-Su_Wei_Hsieh-Petra_Martic,1,F-IO,16,3,0,0,3,9,7
20200218-W-Dubai-R32-Su_Wei_Hsieh-Petra_Martic,1,B-XC,63,13,1,3,9,23,40
20200218-W-Dubai-R32-Su_Wei_Hsieh-Petra_Martic,1,B-DTM,29,0,0,0,0,14,15
20200218-W-Dubai-R32-Su_Wei_Hsieh-Petra_Martic,1,B-DTL,15,8,2,1,5,8,7
20200218-W-Dubai-R32-Su_Wei_Hsieh-Petra_Martic,1,B-IO,5,1,1,0,0,3,2
20200218-W-Dubai-R32-Su_Wei_Hsieh-Petra_Martic,1,S-XC,2,0,0,0,0,0,2
20200218-W-Dubai-R32-Su_Wei_Hsieh-Petra_Martic,1,S-DTM,3,1,0,1,0,1,2
20200218-W-Dubai-R32-Su_Wei_Hsieh-Petra_Martic,1,S-DTL,4,0,0,0,0,2,2
20200218-W-Dubai-R32-Su_Wei_Hsieh-Petra_Martic,1,S-IO,1,1,0,0,1,0,1
20200218-W-Dubai-R32-Su_Wei_Hsieh-Petra_Martic,2,F-XC,24,4,0,2,2,12,12
20200218-W-Dubai-R32-Su_Wei_Hsieh-Petra_Martic,2,F-DTM,27,5,0,0,4,10,17
20200218-W-Dubai-R32-Su_Wei_Hsieh-Petra_Martic,2,F-DTL,16,2,1,0,1,12,4
20200218-W-Dubai-R32-Su_Wei_Hsieh-Petra_Martic,2,F-IO,29,8,1,2,5,14,15
20200218-W-Dubai-R32-Su_Wei_Hsieh-Petra_Martic,2,F-II,3,2,0,2,0,3,0
20200218-W-Dubai-R32-Su_Wei_Hsieh-Petra_Martic,2,B-XC,28,4,0,1,3,15,13
20200218-W-Dubai-R32-Su_Wei_Hsieh-Petra_Martic,2,B-DTM,13,0,0,0,0,6,7
20200218-W-Dubai-R32-Su_Wei_Hsieh-Petra_Martic,2,B-DTL,6,3,1,0,2,4,2
20200218-W-Dubai-R32-Su_Wei_Hsieh-Petra_Martic,2,S-XC,27,2,0,0,2,14,13
20200218-W-Dubai-R32-Su_Wei_Hsieh-Petra_Martic,2,S-DTM,18,2,0,1,1,9,9
20200218-W-Dubai-R32-Su_Wei_Hsieh-Petra_Martic,2,S-DTL,5,1,1,0,0,3,2
20200210-W-Hua_Hin-R32-Chloe_Paquet-Peangtarn_Plipuech,1,F-XC,98,25,9,8,8,56,42
20200210-W-Hua_Hin-R32-Chloe_Paquet-Peangtarn_Plipuech,1,F-DTM,55,2,0,0,2,28,27
20200210-W-Hua_Hin-R32-Chloe_Paquet-Peangtarn_Plipuech,1,F-DTL,49,16,5,2,9,27,22
20200210-W-Hua_Hin-R32-Chloe_Paquet-Peangtarn_Plipuech,1,F-IO,76,13,6,1,6,48,28
20200210-W-Hua_Hin-R32-Chloe_Paquet-Peangtarn_Plipuech,1,F-II,10,4,2,1,1,8,2
20200210-W-Hua_Hin-R32-Chloe_Paquet-Peangtarn_Plipuech,1,B-XC,116,13,3,2,8,68,48
20200210-W-Hua_Hin-R32-Chloe_Paquet-Peangtarn_Plipuech,1,B-DTM,36,4,0,0,4,14,22
20200210-W-Hua_Hin-R32-Chloe_Paquet-Peangtarn_Plipuech,1,B-DTL,25,19,8,4,7,15,10
20200210-W-Hua_Hin-R32-Chloe_Paquet-Peangtarn_Plipuech,1,B-IO,4,1,1,0,0,2,2
20200210-W-Hua_Hin-R32-Chloe_Paquet-Peangtarn_Plipuech,1,S-XC,2,0,0,0,0,0,2
20200210-W-Hua_Hin-R32-Chloe_Paquet-Peangtarn_Plipuech,1,S-DTM,3,0,0,0,0,1,2
20200210-W-Hua_Hin-R32-Chloe_Paquet-Peangtarn_Plipuech,1,S-DTL,1,1,1,0,0,1,0
20200210-W-Hua_Hin-R32-Chloe_Paquet-Peangtarn_Plipuech,2,F-XC,91,7,3,0,4,45,46
20200210-W-Hua_Hin-R32-Chloe_Paquet-Peangtarn_Plipuech,2,F-DTM,71,4,0,3,1,32,39
20200210-W-Hua_Hin-R32-Chloe_Paquet-Peangtarn_Plipuech,2,F-DTL,10,3,1,0,2,5,5
20200210-W-Hua_Hin-R32-Chloe_Paquet-Peangtarn_Plipuech,2,F-IO,45,2,1,1,0,23,22
20200210-W-Hua_Hin-R32-Chloe_Paquet-Peangtarn_Plipuech,2,F-II,6,4,1,0,3,2,4
20200210-W-Hua_Hin-R32-Chloe_Paquet-Peangtarn_Plipuech,2,B-XC,46,8,1,0,7,19,27
20200210-W-Hua_Hin-R32-Chloe_Paquet-Peangtarn_Plipuech,2,B-DTM,32,4,0,1,3,8,24
20200210-W-Hua_Hin-R32-Chloe_Paquet-Peangtarn_Plipuech,2,B-IO,2,0,0,0,0,0,2
20200210-W-Hua_Hin-R32-Chloe_Paquet-Peangtarn_Plipuech,2,S-XC,50,2,0,0,2,18,32
20200210-W-Hua_Hin-R32-Chloe_Paquet-Peangtarn_Plipuech,2,S-DTM,51,2,0,0,2,17,34
20200210-W-Hua_Hin-R32-Chloe_Paquet-Peangtarn_Plipuech,2,S-DTL,9,1,0,0,1,4,5
20200210-W-Hua_Hin-R32-Chloe_Paquet-Peangtarn_Plipuech,2,S-IO,1,1,0,1,0,1,0
20200213-W-Hua_Hin-R16-Patricia_Maria_Tig-Xiaodi_You,1,F-XC,27,6,2,3,1,19,8
20200213-W-Hua_Hin-R16-Patricia_Maria_Tig-Xiaodi_You,1,F-DTM,11,0,0,0,0,8,3
20200213-W-Hua_Hin-R16-Patricia_Maria_Tig-Xiaodi_You,1,F-DTL,5,2,0,1,1,2,3
20200213-W-Hua_Hin-R16-Patricia_Maria_Tig-Xiaodi_You,1,F-IO,10,6,3,2,1,8,2
20200213-W-Hua_Hin-R16-Patricia_Maria_Tig-Xiaodi_You,1,B-XC,38,4,0,2,2,20,18
20200213-W-Hua_Hin-R16-Patricia_Maria_Tig-Xiaodi_You,1,B-DTM,18,2,0,1,1,8,10
20200213-W-Hua_Hin-R16-Patricia_Maria_Tig-Xiaodi_You,1,B-DTL,3,3,1,0,2,1,2
20200213-W-Hua_Hin-R16-Patricia_Maria_Tig-Xiaodi_You,1,B-IO,1,0,0,0,0,0,1
20200213-W-Hua_Hin-R16-Patricia_Maria_Tig-Xiaodi_You,1,S-XC,7,1,1,0,0,6,1
20200213-W-Hua_Hin-R16-Patricia_Maria_Tig-Xiaodi_You,1,S-DTM,10,1,0,0,1,6,4
20200213-W-Hua_Hin-R16-Patricia_Maria_Tig-Xiaodi_You,1,S-DTL,1,1,1,0,0,1,0
20200213-W-Hua_Hin-R16-Patricia_Maria_Tig-Xiaodi_You,1,S-IO,1,1,0,0,1,0,1
20200213-W-Hua_Hin-R16-Patricia_Maria_Tig-Xiaodi_You,2,F-XC,15,2,1,1,0,5,10
20200213-W-Hua_Hin-R16-Patricia_Maria_Tig-Xiaodi_You,2,F-DTM,14,0,0,0,0,8,6
20200213-W-Hua_Hin-R16-Patricia_Maria_Tig-Xiaodi_You,2,F-DTL,9,1,0,0,1,3,6
20200213-W-Hua_Hin-R16-Patricia_Maria_Tig-Xiaodi_You,2,F-IO,15,4,1,1,2,10,5
20200213-W-Hua_Hin-R16-Patricia_Maria_Tig-Xiaodi_You,2,F-II,2,1,0,0,1,0,2
20200213-W-Hua_Hin-R16-Patricia_Maria_Tig-Xiaodi_You,2,B-XC,26,4,0,1,3,12,14
20200213-W-Hua_Hin-R16-Patricia_Maria_Tig-Xiaodi_You,2,B-DTM,28,3,0,1,2,7,21
20200213-W-Hua_Hin-R16-Patricia_Maria_Tig-Xiaodi_You,2,B-DTL,5,0,0,0,0,3,2
20200213-W-Hua_Hin-R16-Patricia_Maria_Tig-Xiaodi_You,2,B-IO,3,1,0,0,1,1,2
20200213-W-Hua_Hin-R16-Patricia_Maria_Tig-Xiaodi_You,2,S-XC,4,1,0,0,1,0,4
20200213-W-Hua_Hin-R16-Patricia_Maria_Tig-Xiaodi_You,2,S-DTM,7,1,0,1,0,3,4
20200213-W-Hua_Hin-R16-Patricia_Maria_Tig-Xiaodi_You,2,S-DTL,2,0,0,0,0,1,1
20200213-W-Hua_Hin-R16-Patricia_Maria_Tig-Xiaodi_You,2,S-IO,1,0,0,0,0,0,1
20200217-W-Dubai-R32-Kim_Clijsters-Garbine_Muguruza,1,F-XC,56,20,6,5,9,34,22
20200217-W-Dubai-R32-Kim_Clijsters-Garbine_Muguruza,1,F-DTM,17,2,0,2,0,6,11
20200217-W-Dubai-R32-Kim_Clijsters-Garbine_Muguruza,1,F-DTL,4,3,0,1,2,2,2
20200217-W-Dubai-R32-Kim_Clijsters-Garbine_Muguruza,1,F-IO,17,7,2,2,3,10,7
20200217-W-Dubai-R32-Kim_Clijsters-Garbine_Muguruza,1,F-II,1,1,1,0,0,1,0
20200217-W-Dubai-R32-Kim_Clijsters-Garbine_Muguruza,1,B-XC,28,8,2,6,0,16,12
20200217-W-Dubai-R32-Kim_Clijsters-Garbine_Muguruza,1,B-DTM,12,0,0,0,0,5,7
20200217-W-Dubai-R32-Kim_Clijsters-Garbine_Muguruza,1,B-DTL,3,3,0,1,2,1,2
20200217-W-Dubai-R32-Kim_Clijsters-Garbine_Muguruza,1,B-IO,1,1,0,1,0,1,0
20200217-W-Dubai-R32-Kim_Clijsters-Garbine_Muguruza,1,S-XC,5,0,0,0,0,3,2
20200217-W-Dubai-R32-Kim_Clijsters-Garbine_Muguruza,1,S-DTM,2,0,0,0,0,0,2
20200217-W-Dubai-R32-Kim_Clijsters-Garbine_Muguruza,1,S-DTL,1,0,0,0,0,1,0
20200217-W-Dubai-R32-Kim_Clijsters-Garbine_Muguruza,1,S-IO,1,0,0,0,0,0,1
20200217-W-Dubai-R32-Kim_Clijsters-Garbine_Muguruza,2,F-XC,35,7,4,0,3,15,20
20200217-W-Dubai-R32-Kim_Clijsters-Garbine_Muguruza,2,F-DTM,14,1,0,0,1,7,7
20200217-W-Dubai-R32-Kim_Clijsters-Garbine_Muguruza,2,F-DTL,8,2,1,1,0,4,4
20200217-W-Dubai-R32-Kim_Clijsters-Garbine_Muguruza,2,F-IO,8,6,3,2,1,6,2
20200217-W-Dubai-R32-Kim_Clijsters-Garbine_Muguruza,2,B-XC,25,11,1,6,4,16,9
20200217-W-Dubai-R32-Kim_Clijsters-Garbine_Muguruza,2,B-DTM,25,5,0,1,4,9,16
20200217-W-Dubai-R32-Kim_Clijsters-Garbine_Muguruza,2,B-DTL,8,2,0,1,1,6,2
20200217-W-Dubai-R32-Kim_Clijsters-Garbine_Muguruza,2,B-IO,6,4,1,0,3,3,3
20200217-W-Dubai-R32-Kim_Clijsters-Garbine_Muguruza,2,S-DTM,1,0,0,0,0,0,1
20200217-W-Dubai-R32-Kim_Clijsters-Garbine_Muguruza,2,S-DTL,1,0,0,0,0,1,0
20200217-W-Dubai-R32-Kim_Clijsters-Garbine_Muguruza,2,S-IO,1,0,0,0,0,1,0
20200217-W-Dubai-R32-Marketa_Vondrousova-Anastasija_Sevastova,1,F-XC,70,3,1,1,1,49,21
20200217-W-Dubai-R32-Marketa_Vondrousova-Anastasija_Sevastova,1,F-DTM,33,1,0,0,1,18,15
20200217-W-Dubai-R32-Marketa_Vondrousova-Anastasija_Sevastova,1,F-DTL,16,8,5,1,2,11,5
20200217-W-Dubai-R32-Marketa_Vondrousova-Anastasija_Sevastova,1,F-IO,6,5,2,0,3,3,3
20200217-W-Dubai-R32-Marketa_Vondrousova-Anastasija_Sevastova,1,B-XC,15,3,0,1,2,6,9
20200217-W-Dubai-R32-Marketa_Vondrousova-Anastasija_Sevastova,1,B-DTM,15,1,0,0,1,9,6
20200217-W-Dubai-R32-Marketa_Vondrousova-Anastasija_Sevastova,1,B-DTL,1,1,0,0,1,0,1
20200217-W-Dubai-R32-Marketa_Vondrousova-Anastasija_Sevastova,1,B-IO,1,0,0,0,0,0,1
20200217-W-Dubai-R32-Marketa_Vondrousova-Anastasija_Sevastova,1,S-XC,1,0,0,0,0,1,0
20200217-W-Dubai-R32-Marketa_Vondrousova-Anastasija_Sevastova,1,S-DTM,4,1,1,0,0,3,1
20200217-W-Dubai-R32-Marketa_Vondrousova-Anastasija_Sevastova,1,S-DTL,3,1,0,1,0,2,1
20200217-W-Dubai-R32-Marketa_Vondrousova-Anastasija_Sevastova,2,F-XC,23,7,3,0,4,11,12
20200217-W-Dubai-R32-Marketa_Vondrousova-Anastasija_Sevastova,2,F-DTM,15,2,0,0,2,5,10
20200217-W-Dubai-R32-Marketa_Vondrousova-Anastasija_Sevastova,2,F-DTL,7,4,0,1,3,3,4
20200217-W-Dubai-R32-Marketa_Vondrousova-Anastasija_Sevastova,2,F-IO,21,7,3,1,3,9,12
20200217-W-Dubai-R32-Marketa_Vondrousova-Anastasija_Sevastova,2,F-II,2,1,1,0,0,1,1
20200217-W-Dubai-R32-Marketa_Vondrousova-Anastasija_Sevastova,2,B-XC,52,7,2,0,5,20,32
20200217-W-Dubai-R32-Marketa_Vondrousova-Anastasija_Sevastova,2,B-DTM,30,3,0,1,2,9,21
20200217-W-Dubai-R32-Marketa_Vondrousova-Anastasija_Sevastova,2,B-DTL,6,3,0,1,2,3,3
20200217-W-Dubai-R32-Marketa_Vondrousova-Anastasija_Sevastova,2,B-IO,2,0,0,0,0,2,0
20200217-W-Dubai-R32-Marketa_Vondrousova-Anastasija_Sevastova,2,S-XC,2,0,0,0,0,0,2
20200217-W-Dubai-R32-Marketa_Vondrousova-Anastasija_Sevastova,2,S-DTM,5,1,0,1,0,2,3
20200217-W-Dubai-R32-Marketa_Vondrousova-Anastasija_Sevastova,2,S-DTL,1,0,0,0,0,0,1
20200217-W-Dubai-R32-Marketa_Vondrousova-Anastasija_Sevastova,2,S-IO,1,0,0,0,0,1,0
20200207-W-Fed_Cup_Qualifiers-RR-Leylah_Annie_Fernandez-Jil_Teichmann,1,F-XC,44,9,2,4,3,17,27
20200207-W-Fed_Cup_Qualifiers-RR-Leylah_Annie_Fernandez-Jil_Teichmann,1,F-DTM,29,2,0,0,2,12,17
20200207-W-Fed_Cup_Qualifiers-RR-Leylah_Annie_Fernandez-Jil_Teichmann,1,F-DTL,9,1,1,0,0,5,4
20200207-W-Fed_Cup_Qualifiers-RR-Leylah_Annie_Fernandez-Jil_Teichmann,1,F-IO,18,9,3,2,4,10,8
20200207-W-Fed_Cup_Qualifiers-RR-Leylah_Annie_Fernandez-Jil_Teichmann,1,F-II,3,0,0,0,0,3,0
20200207-W-Fed_Cup_Qualifiers-RR-Leylah_Annie_Fernandez-Jil_Teichmann,1,B-XC,30,7,1,2,4,8,22
20200207-W-Fed_Cup_Qualifiers-RR-Leylah_Annie_Fernandez-Jil_Teichmann,1,B-DTM,20,0,0,0,0,13,7
20200207-W-Fed_Cup_Qualifiers-RR-Leylah_Annie_Fernandez-Jil_Teichmann,1,B-DTL,8,5,2,2,1,6,2
20200207-W-Fed_Cup_Qualifiers-RR-Leylah_Annie_Fernandez-Jil_Teichmann,1,B-IO,4,2,2,0,0,4,0
20200207-W-Fed_Cup_Qualifiers-RR-Leylah_Annie_Fernandez-Jil_Teichmann,1,S-XC,3,1,0,1,0,1,2
20200207-W-Fed_Cup_Qualifiers-RR-Leylah_Annie_Fernandez-Jil_Teichmann,1,S-DTM,1,0,0,0,0,0,1
20200207-W-Fed_Cup_Qualifiers-RR-Leylah_Annie_Fernandez-Jil_Teichmann,1,S-DTL,1,1,0,0,1,0,1
20200207-W-Fed_Cup_Qualifiers-RR-Leylah_Annie_Fernandez-Jil_Teichmann,1,S-IO,1,0,0,0,0,0,1
20200207-W-Fed_Cup_Qualifiers-RR-Leylah_Annie_Fernandez-Jil_Teichmann,2,F-XC,37,13,5,3,5,23,14
20200207-W-Fed_Cup_Qualifiers-RR-Leylah_Annie_Fernandez-Jil_Teichmann,2,F-DTM,38,3,0,0,3,19,19
20200207-W-Fed_Cup_Qualifiers-RR-Leylah_Annie_Fernandez-Jil_Teichmann,2,F-DTL,5,2,2,0,0,4,1
20200207-W-Fed_Cup_Qualifiers-RR-Leylah_Annie_Fernandez-Jil_Teichmann,2,F-IO,13,3,2,0,1,8,5
20200207-W-Fed_Cup_Qualifiers-RR-Leylah_Annie_Fernandez-Jil_Teichmann,2,F-II,1,0,0,0,0,1,0
20200207-W-Fed_Cup_Qualifiers-RR-Leylah_Annie_Fernandez-Jil_Teichmann,2,B-XC,29,4,1,3,0,16,13
20200207-W-Fed_Cup_Qualifiers-RR-Leylah_Annie_Fernandez-Jil_Teichmann,2,B-DTM,22,2,0,0,2,13,9
20200207-W-Fed_Cup_Qualifiers-RR-Leylah_Annie_Fernandez-Jil_Teichmann,2,B-DTL,7,5,1,4,0,6,1
20200207-W-Fed_Cup_Qualifiers-RR-Leylah_Annie_Fernandez-Jil_Teichmann,2,B-IO,1,0,0,0,0,0,1
20200207-W-Fed_Cup_Qualifiers-RR-Leylah_Annie_Fernandez-Jil_Teichmann,2,S-XC,13,1,0,0,1,7,6
20200207-W-Fed_Cup_Qualifiers-RR-Leylah_Annie_Fernandez-Jil_Teichmann,2,S-DTM,6,0,0,0,0,2,4
20200207-W-Fed_Cup_Qualifiers-RR-Leylah_Annie_Fernandez-Jil_Teichmann,2,S-DTL,1,0,0,0,0,0,1
20200217-W-Dubai-R32-Amanda_Anisimova-Barbora_Strycova,1,F-XC,66,17,3,10,4,37,29
20200217-W-Dubai-R32-Amanda_Anisimova-Barbora_Strycova,1,F-DTM,17,3,1,1,1,6,11
20200217-W-Dubai-R32-Amanda_Anisimova-Barbora_Strycova,1,F-DTL,15,6,3,0,3,8,7
20200217-W-Dubai-R32-Amanda_Anisimova-Barbora_Strycova,1,F-IO,29,18,7,3,8,16,13
20200217-W-Dubai-R32-Amanda_Anisimova-Barbora_Strycova,1,F-II,1,0,0,0,0,1,0
20200217-W-Dubai-R32-Amanda_Anisimova-Barbora_Strycova,1,B-XC,68,20,7,4,9,37,31
20200217-W-Dubai-R32-Amanda_Anisimova-Barbora_Strycova,1,B-DTM,23,5,0,0,4,11,12
20200217-W-Dubai-R32-Amanda_Anisimova-Barbora_Strycova,1,B-DTL,27,14,6,2,6,17,10
20200217-W-Dubai-R32-Amanda_Anisimova-Barbora_Strycova,1,B-IO,7,3,1,0,2,2,5
20200217-W-Dubai-R32-Amanda_Anisimova-Barbora_Strycova,1,S-XC,3,1,0,0,1,1,2
20200217-W-Dubai-R32-Amanda_Anisimova-Barbora_Strycova,1,S-DTL,3,0,0,0,0,1,2
20200217-W-Dubai-R32-Amanda_Anisimova-Barbora_Strycova,2,F-XC,47,4,1,0,3,22,25
20200217-W-Dubai-R32-Amanda_Anisimova-Barbora_Strycova,2,F-DTM,30,4,0,0,4,15,15
20200217-W-Dubai-R32-Amanda_Anisimova-Barbora_Strycova,2,F-DTL,12,4,2,1,1,6,6
20200217-W-Dubai-R32-Amanda_Anisimova-Barbora_Strycova,2,F-IO,14,4,1,0,3,5,9
20200217-W-Dubai-R32-Amanda_Anisimova-Barbora_Strycova,2,F-II,2,0,0,0,0,0,2
20200217-W-Dubai-R32-Amanda_Anisimova-Barbora_Strycova,2,B-XC,40,5,1,1,3,20,20
20200217-W-Dubai-R32-Amanda_Anisimova-Barbora_Strycova,2,B-DTM,24,4,1,0,3,12,12
20200217-W-Dubai-R32-Amanda_Anisimova-Barbora_Strycova,2,B-DTL,8,2,1,1,0,4,4
20200217-W-Dubai-R32-Amanda_Anisimova-Barbora_Strycova,2,S-XC,14,0,0,0,0,4,10
20200217-W-Dubai-R32-Amanda_Anisimova-Barbora_Strycova,2,S-DTM,6,0,0,0,0,3,3
20200217-W-Dubai-R32-Amanda_Anisimova-Barbora_Strycova,2,S-DTL,1,0,0,0,0,1,0
20200217-W-Dubai-R32-Amanda_Anisimova-Barbora_Strycova,2,S-II,1,0,0,0,0,0,1
20200218-W-Dubai-R32-Dayana_Yastremska-Veronika_Kudermetova,1,F-XC,34,14,2,4,8,15,19
20200218-W-Dubai-R32-Dayana_Yastremska-Veronika_Kudermetova,1,F-DTM,21,2,0,0,2,12,9
20200218-W-Dubai-R32-Dayana_Yastremska-Veronika_Kudermetova,1,F-DTL,9,2,1,0,1,4,5
20200218-W-Dubai-R32-Dayana_Yastremska-Veronika_Kudermetova,1,F-IO,20,9,3,0,6,10,10
20200218-W-Dubai-R32-Dayana_Yastremska-Veronika_Kudermetova,1,F-II,1,1,1,0,0,1,0
20200218-W-Dubai-R32-Dayana_Yastremska-Veronika_Kudermetova,1,B-XC,27,6,1,0,5,13,14
20200218-W-Dubai-R32-Dayana_Yastremska-Veronika_Kudermetova,1,B-DTM,32,3,1,1,1,13,19
20200218-W-Dubai-R32-Dayana_Yastremska-Veronika_Kudermetova,1,B-DTL,11,7,5,0,2,8,3
20200218-W-Dubai-R32-Dayana_Yastremska-Veronika_Kudermetova,1,B-IO,15,7,3,2,2,9,6
20200218-W-Dubai-R32-Dayana_Yastremska-Veronika_Kudermetova,1,S-XC,1,0,0,0,0,0,1
20200218-W-Dubai-R32-Dayana_Yastremska-Veronika_Kudermetova,2,F-XC,40,20,2,8,10,20,20
20200218-W-Dubai-R32-Dayana_Yastremska-Veronika_Kudermetova,2,F-DTM,23,3,0,0,3,12,11
20200218-W-Dubai-R32-Dayana_Yastremska-Veronika_Kudermetova,2,F-DTL,7,6,2,1,3,4,3
20200218-W-Dubai-R32-Dayana_Yastremska-Veronika_Kudermetova,2,F-IO,14,5,0,2,3,8,6
20200218-W-Dubai-R32-Dayana_Yastremska-Veronika_Kudermetova,2,B-XC,29,8,3,1,4,13,16
20200218-W-Dubai-R32-Dayana_Yastremska-Veronika_Kudermetova,2,B-DTM,33,1,0,0,1,16,17
20200218-W-Dubai-R32-Dayana_Yastremska-Veronika_Kudermetova,2,B-DTL,7,4,1,3,0,4,3
20200218-W-Dubai-R32-Dayana_Yastremska-Veronika_Kudermetova,2,B-IO,3,1,0,0,1,1,2
20200218-W-Dubai-R32-Dayana_Yastremska-Veronika_Kudermetova,2,S-XC,5,0,0,0,0,3,2
20200218-W-Dubai-R32-Dayana_Yastremska-Veronika_Kudermetova,2,S-DTM,7,1,0,0,1,4,3
20200218-W-Dubai-R32-Dayana_Yastremska-Veronika_Kudermetova,2,S-DTL,2,0,0,0,0,0,2
20200218-W-Dubai-R32-Elena_Rybakina-Sofia_Kenin,1,F-XC,54,20,5,2,12,24,30
20200218-W-Dubai-R32-Elena_Rybakina-Sofia_Kenin,1,F-DTM,20,1,0,0,1,9,11
20200218-W-Dubai-R32-Elena_Rybakina-Sofia_Kenin,1,F-DTL,7,4,2,0,2,2,5
20200218-W-Dubai-R32-Elena_Rybakina-Sofia_Kenin,1,F-IO,3,1,1,0,0,2,1
20200218-W-Dubai-R32-Elena_Rybakina-Sofia_Kenin,1,F-II,1,1,1,0,0,1,0
20200218-W-Dubai-R32-Elena_Rybakina-Sofia_Kenin,1,B-XC,24,10,5,2,3,12,12
20200218-W-Dubai-R32-Elena_Rybakina-Sofia_Kenin,1,B-DTM,14,5,1,1,3,7,7
20200218-W-Dubai-R32-Elena_Rybakina-Sofia_Kenin,1,B-DTL,10,4,0,0,4,4,6
20200218-W-Dubai-R32-Elena_Rybakina-Sofia_Kenin,1,B-IO,5,3,0,1,2,3,2
20200218-W-Dubai-R32-Elena_Rybakina-Sofia_Kenin,1,S-DTM,5,0,0,0,0,3,2
20200218-W-Dubai-R32-Elena_Rybakina-Sofia_Kenin,1,S-DTL,1,0,0,0,0,0,1
20200218-W-Dubai-R32-Elena_Rybakina-Sofia_Kenin,2,F-XC,50,14,4,1,9,25,25
20200218-W-Dubai-R32-Elena_Rybakina-Sofia_Kenin,2,F-DTM,21,3,0,0,3,10,11
20200218-W-Dubai-R32-Elena_Rybakina-Sofia_Kenin,2,F-DTL,15,10,4,1,5,8,7
20200218-W-Dubai-R32-Elena_Rybakina-Sofia_Kenin,2,F-IO,11,8,4,1,3,7,4
20200218-W-Dubai-R32-Elena_Rybakina-Sofia_Kenin,2,B-XC,24,9,3,2,4,12,12
20200218-W-Dubai-R32-Elena_Rybakina-Sofia_Kenin,2,B-DTM,9,0,0,0,0,5,4
20200218-W-Dubai-R32-Elena_Rybakina-Sofia_Kenin,2,B-DTL,4,3,1,1,1,3,1
20200218-W-Dubai-R32-Elena_Rybakina-Sofia_Kenin,2,B-IO,5,2,1,1,0,5,0
20200218-W-Dubai-R32-Elena_Rybakina-Sofia_Kenin,2,S-XC,1,0,0,0,0,1,0
20200218-W-Dubai-R32-Elena_Rybakina-Sofia_Kenin,2,S-DTM,2,0,0,0,0,2,0
20200218-W-Dubai-R32-Elena_Rybakina-Sofia_Kenin,2,S-IO,1,0,0,0,0,0,1
20200224-W-Acapulco-R32-Arantxa_Rus-Nao_Hibino,1,F-XC,68,13,2,3,8,25,43
20200224-W-Acapulco-R32-Arantxa_Rus-Nao_Hibino,1,F-DTM,59,3,0,0,3,25,34
20200224-W-Acapulco-R32-Arantxa_Rus-Nao_Hibino,1,F-DTL,8,5,1,1,3,3,5
20200224-W-Acapulco-R32-Arantxa_Rus-Nao_Hibino,1,F-IO,27,13,6,0,7,16,11
20200224-W-Acapulco-R32-Arantxa_Rus-Nao_Hibino,1,F-II,2,1,1,0,0,1,1
20200224-W-Acapulco-R32-Arantxa_Rus-Nao_Hibino,1,B-XC,34,11,3,0,8,12,22
20200224-W-Acapulco-R32-Arantxa_Rus-Nao_Hibino,1,B-DTM,37,3,0,0,3,18,19
20200224-W-Acapulco-R32-Arantxa_Rus-Nao_Hibino,1,B-DTL,6,2,1,0,1,2,4
20200224-W-Acapulco-R32-Arantxa_Rus-Nao_Hibino,1,B-IO,8,1,0,0,1,1,7
20200224-W-Acapulco-R32-Arantxa_Rus-Nao_Hibino,1,S-DTM,2,0,0,0,0,0,2
20200224-W-Acapulco-R32-Arantxa_Rus-Nao_Hibino,1,S-DTL,1,0,0,0,0,0,1
20200224-W-Acapulco-R32-Arantxa_Rus-Nao_Hibino,1,S-IO,1,1,0,1,0,1,0
20200224-W-Acapulco-R32-Arantxa_Rus-Nao_Hibino,2,F-XC,40,5,1,0,4,24,16
20200224-W-Acapulco-R32-Arantxa_Rus-Nao_Hibino,2,F-DTM,53,2,0,0,2,27,26
20200224-W-Acapulco-R32-Arantxa_Rus-Nao_Hibino,2,F-DTL,9,3,1,2,0,7,2
20200224-W-Acapulco-R32-Arantxa_Rus-Nao_Hibino,2,F-IO,16,6,2,0,4,11,5
20200224-W-Acapulco-R32-Arantxa_Rus-Nao_Hibino,2,F-II,1,0,0,0,0,1,0
20200224-W-Acapulco-R32-Arantxa_Rus-Nao_Hibino,2,B-XC,43,9,2,2,5,20,23
20200224-W-Acapulco-R32-Arantxa_Rus-Nao_Hibino,2,B-DTM,39,3,0,0,3,27,12
20200224-W-Acapulco-R32-Arantxa_Rus-Nao_Hibino,2,B-DTL,6,3,3,0,0,6,0
20200224-W-Acapulco-R32-Arantxa_Rus-Nao_Hibino,2,B-IO,5,1,1,0,0,3,2
20200224-W-Acapulco-R32-Arantxa_Rus-Nao_Hibino,2,S-XC,5,1,0,0,1,3,2
20200224-W-Acapulco-R32-Arantxa_Rus-Nao_Hibino,2,S-DTM,4,0,0,0,0,2,2
20200224-W-Acapulco-R32-Arantxa_Rus-Nao_Hibino,2,S-DTL,1,0,0,0,0,0,1
20200224-W-Doha-R32-Karolina_Muchova-Kiki_Bertens,1,F-XC,30,8,0,0,8,11,19
20200224-W-Doha-R32-Karolina_Muchova-Kiki_Bertens,1,F-DTM,30,2,0,0,2,6,24
20200224-W-Doha-R32-Karolina_Muchova-Kiki_Bertens,1,F-DTL,10,6,0,1,5,5,5
20200224-W-Doha-R32-Karolina_Muchova-Kiki_Bertens,1,F-IO,19,5,2,1,2,11,8
20200224-W-Doha-R32-Karolina_Muchova-Kiki_Bertens,1,B-XC,8,3,0,2,1,4,4
20200224-W-Doha-R32-Karolina_Muchova-Kiki_Bertens,1,B-DTM,11,3,0,0,3,3,8
20200224-W-Doha-R32-Karolina_Muchova-Kiki_Bertens,1,B-DTL,3,2,1,1,0,3,0
20200224-W-Doha-R32-Karolina_Muchova-Kiki_Bertens,1,B-IO,2,0,0,0,0,1,1
20200224-W-Doha-R32-Karolina_Muchova-Kiki_Bertens,1,S-XC,10,1,0,0,1,3,7
20200224-W-Doha-R32-Karolina_Muchova-Kiki_Bertens,1,S-DTM,6,0,0,0,0,4,2
20200224-W-Doha-R32-Karolina_Muchova-Kiki_Bertens,1,S-DTL,2,1,0,0,1,0,2
20200224-W-Doha-R32-Karolina_Muchova-Kiki_Bertens,1,S-IO,1,1,0,1,0,1,0
20200224-W-Doha-R32-Karolina_Muchova-Kiki_Bertens,2,F-XC,39,6,2,1,3,23,16
20200224-W-Doha-R32-Karolina_Muchova-Kiki_Bertens,2,F-DTM,23,2,0,1,1,13,10
20200224-W-Doha-R32-Karolina_Muchova-Kiki_Bertens,2,F-DTL,8,2,0,0,2,0,8
20200224-W-Doha-R32-Karolina_Muchova-Kiki_Bertens,2,F-IO,21,6,2,2,2,15,6
20200224-W-Doha-R32-Karolina_Muchova-Kiki_Bertens,2,F-II,1,0,0,0,0,1,0
20200224-W-Doha-R32-Karolina_Muchova-Kiki_Bertens,2,B-XC,10,3,0,1,2,4,6
20200224-W-Doha-R32-Karolina_Muchova-Kiki_Bertens,2,B-DTM,17,1,0,0,1,12,5
20200224-W-Doha-R32-Karolina_Muchova-Kiki_Bertens,2,B-DTL,1,1,0,0,1,0,1
20200224-W-Doha-R32-Karolina_Muchova-Kiki_Bertens,2,B-IO,3,0,0,0,0,3,0
20200224-W-Doha-R32-Karolina_Muchova-Kiki_Bertens,2,S-XC,5,1,0,1,0,2,3
20200224-W-Doha-R32-Karolina_Muchova-Kiki_Bertens,2,S-DTM,7,0,0,0,0,3,4
20200224-W-Doha-R64-Shuai_Zhang-Carla_Suarez_Navarro,1,F-XC,22,7,2,1,4,7,15
20200224-W-Doha-R64-Shuai_Zhang-Carla_Suarez_Navarro,1,F-DTM,27,4,0,0,4,10,17
20200224-W-Doha-R64-Shuai_Zhang-Carla_Suarez_Navarro,1,F-DTL,13,7,2,2,3,7,6
20200224-W-Doha-R64-Shuai_Zhang-Carla_Suarez_Navarro,1,F-IO,13,5,3,0,2,6,7
20200224-W-Doha-R64-Shuai_Zhang-Carla_Suarez_Navarro,1,F-II,1,0,0,0,0,0,1
20200224-W-Doha-R64-Shuai_Zhang-Carla_Suarez_Navarro,1,B-XC,27,5,2,1,2,15,12
20200224-W-Doha-R64-Shuai_Zhang-Carla_Suarez_Navarro,1,B-DTM,26,4,0,0,4,12,14
20200224-W-Doha-R64-Shuai_Zhang-Carla_Suarez_Navarro,1,B-DTL,8,4,2,0,2,4,4
20200224-W-Doha-R64-Shuai_Zhang-Carla_Suarez_Navarro,1,B-IO,8,4,4,0,0,5,3
20200224-W-Doha-R64-Shuai_Zhang-Carla_Suarez_Navarro,1,S-XC,4,0,0,0,0,1,3
20200224-W-Doha-R64-Shuai_Zhang-Carla_Suarez_Navarro,1,S-DTM,3,1,0,0,1,0,3
20200224-W-Doha-R64-Shuai_Zhang-Carla_Suarez_Navarro,2,F-XC,37,11,5,1,4,22,15
20200224-W-Doha-R64-Shuai_Zhang-Carla_Suarez_Navarro,2,F-DTM,25,2,0,1,1,13,12
20200224-W-Doha-R64-Shuai_Zhang-Carla_Suarez_Navarro,2,F-DTL,5,3,2,1,0,5,0
20200224-W-Doha-R64-Shuai_Zhang-Carla_Suarez_Navarro,2,F-IO,22,9,5,1,3,13,9
20200224-W-Doha-R64-Shuai_Zhang-Carla_Suarez_Navarro,2,F-II,1,0,0,0,0,0,1
20200224-W-Doha-R64-Shuai_Zhang-Carla_Suarez_Navarro,2,B-XC,25,6,1,1,4,13,12
20200224-W-Doha-R64-Shuai_Zhang-Carla_Suarez_Navarro,2,B-DTM,22,3,0,0,3,8,14
20200224-W-Doha-R64-Shuai_Zhang-Carla_Suarez_Navarro,2,B-DTL,6,3,3,0,0,5,1
20200224-W-Doha-R64-Shuai_Zhang-Carla_Suarez_Navarro,2,B-IO,4,2,2,0,0,2,2
20200224-W-Doha-R64-Shuai_Zhang-Carla_Suarez_Navarro,2,S-XC,4,0,0,0,0,2,2
20200224-W-Doha-R64-Shuai_Zhang-Carla_Suarez_Navarro,2,S-DTM,6,0,0,0,0,3,3
20200224-W-Doha-R64-Su_Wei_Hsieh-Vera_Zvonareva,1,F-XC,35,8,3,2,3,16,19
20200224-W-Doha-R64-Su_Wei_Hsieh-Vera_Zvonareva,1,F-DTM,17,2,0,0,2,8,9
20200224-W-Doha-R64-Su_Wei_Hsieh-Vera_Zvonareva,1,F-DTL,6,3,1,1,1,2,4
20200224-W-Doha-R64-Su_Wei_Hsieh-Vera_Zvonareva,1,F-IO,6,5,1,2,2,3,3
20200224-W-Doha-R64-Su_Wei_Hsieh-Vera_Zvonareva,1,B-XC,56,15,5,3,7,30,26
20200224-W-Doha-R64-Su_Wei_Hsieh-Vera_Zvonareva,1,B-DTM,39,2,0,0,2,14,25
20200224-W-Doha-R64-Su_Wei_Hsieh-Vera_Zvonareva,1,B-DTL,14,7,1,2,4,5,9
20200224-W-Doha-R64-Su_Wei_Hsieh-Vera_Zvonareva,1,B-IO,12,10,6,0,4,6,6
20200224-W-Doha-R64-Su_Wei_Hsieh-Vera_Zvonareva,1,S-XC,3,0,0,0,0,2,1
20200224-W-Doha-R64-Su_Wei_Hsieh-Vera_Zvonareva,1,S-DTM,1,0,0,0,0,1,0
20200224-W-Doha-R64-Su_Wei_Hsieh-Vera_Zvonareva,1,S-DTL,2,0,0,0,0,1,1
20200224-W-Doha-R64-Su_Wei_Hsieh-Vera_Zvonareva,2,F-XC,30,4,1,2,1,19,11
20200224-W-Doha-R64-Su_Wei_Hsieh-Vera_Zvonareva,2,F-DTM,26,0,0,0,0,11,15
20200224-W-Doha-R64-Su_Wei_Hsieh-Vera_Zvonareva,2,F-DTL,17,6,2,1,3,14,3
20200224-W-Doha-R64-Su_Wei_Hsieh-Vera_Zvonareva,2,F-IO,15,2,1,0,1,11,4
20200224-W-Doha-R64-Su_Wei_Hsieh-Vera_Zvonareva,2,B-XC,38,5,1,1,3,21,17
20200224-W-Doha-R64-Su_Wei_Hsieh-Vera_Zvonareva,2,B-DTM,38,3,0,0,3,19,19
20200224-W-Doha-R64-Su_Wei_Hsieh-Vera_Zvonareva,2,B-DTL,8,5,2,2,1,7,1
20200224-W-Doha-R64-Su_Wei_Hsieh-Vera_Zvonareva,2,B-IO,5,1,0,0,1,1,4
20200224-W-Doha-R64-Su_Wei_Hsieh-Vera_Zvonareva,2,S-XC,4,1,0,0,1,1,3
20200224-W-Doha-R64-Su_Wei_Hsieh-Vera_Zvonareva,2,S-DTM,5,1,0,0,1,0,5
20200224-W-Doha-R64-Su_Wei_Hsieh-Vera_Zvonareva,2,S-DTL,3,0,0,0,0,2,1
20200224-W-Doha-R64-Su_Wei_Hsieh-Vera_Zvonareva,2,S-IO,1,0,0,0,0,1,0
20200224-W-Doha-R64-Elena_Rybakina-Sorana_Cirstea,1,F-XC,36,15,4,7,4,22,14
20200224-W-Doha-R64-Elena_Rybakina-Sorana_Cirstea,1,F-DTM,12,2,0,1,1,6,6
20200224-W-Doha-R64-Elena_Rybakina-Sorana_Cirstea,1,F-DTL,6,1,1,0,0,4,2
20200224-W-Doha-R64-Elena_Rybakina-Sorana_Cirstea,1,F-IO,9,5,3,1,1,6,3
20200224-W-Doha-R64-Elena_Rybakina-Sorana_Cirstea,1,B-XC,14,3,0,1,2,7,7
20200224-W-Doha-R64-Elena_Rybakina-Sorana_Cirstea,1,B-DTM,20,2,0,1,1,7,13
20200224-W-Doha-R64-Elena_Rybakina-Sorana_Cirstea,1,B-DTL,8,7,3,3,1,7,1
20200224-W-Doha-R64-Elena_Rybakina-Sorana_Cirstea,1,B-IO,6,2,1,0,1,3,3
20200224-W-Doha-R64-Elena_Rybakina-Sorana_Cirstea,1,S-XC,2,1,0,1,0,2,0
20200224-W-Doha-R64-Elena_Rybakina-Sorana_Cirstea,1,S-DTM,4,0,0,0,0,2,2
20200224-W-Doha-R64-Elena_Rybakina-Sorana_Cirstea,1,S-DTL,1,1,0,1,0,1,0
20200224-W-Doha-R64-Elena_Rybakina-Sorana_Cirstea,2,F-XC,20,7,1,3,2,10,10
20200224-W-Doha-R64-Elena_Rybakina-Sorana_Cirstea,2,F-DTM,16,1,0,0,1,7,9
20200224-W-Doha-R64-Elena_Rybakina-Sorana_Cirstea,2,F-DTL,13,9,7,1,1,9,4
20200224-W-Doha-R64-Elena_Rybakina-Sorana_Cirstea,2,F-IO,12,6,3,2,1,8,4
20200224-W-Doha-R64-Elena_Rybakina-Sorana_Cirstea,2,B-XC,16,3,2,1,0,7,9
20200224-W-Doha-R64-Elena_Rybakina-Sorana_Cirstea,2,B-DTM,17,0,0,0,0,7,10
20200224-W-Doha-R64-Elena_Rybakina-Sorana_Cirstea,2,B-DTL,9,7,4,2,1,8,1
20200224-W-Doha-R64-Elena_Rybakina-Sorana_Cirstea,2,B-IO,16,12,5,3,4,11,5
20200224-W-Doha-R64-Elena_Rybakina-Sorana_Cirstea,2,S-XC,1,0,0,0,0,0,1
20200224-W-Doha-R64-Elena_Rybakina-Sorana_Cirstea,2,S-DTM,2,0,0,0,0,0,2
20200224-W-Doha-R64-Elena_Rybakina-Sorana_Cirstea,2,S-DTL,1,0,0,0,0,0,1
20200226-W-Doha-R16-Saisai_Zheng-Kiki_Bertens,1,F-XC,50,9,1,3,5,31,19
20200226-W-Doha-R16-Saisai_Zheng-Kiki_Bertens,1,F-DTM,81,4,0,1,3,41,40
20200226-W-Doha-R16-Saisai_Zheng-Kiki_Bertens,1,F-DTL,29,5,2,0,3,16,13
20200226-W-Doha-R16-Saisai_Zheng-Kiki_Bertens,1,F-IO,36,6,0,2,4,16,20
20200226-W-Doha-R16-Saisai_Zheng-Kiki_Bertens,1,B-XC,60,6,1,1,4,29,31
20200226-W-Doha-R16-Saisai_Zheng-Kiki_Bertens,1,B-DTM,48,3,1,0,2,28,20
20200226-W-Doha-R16-Saisai_Zheng-Kiki_Bertens,1,B-DTL,9,3,2,1,0,7,2
20200226-W-Doha-R16-Saisai_Zheng-Kiki_Bertens,1,B-IO,1,1,0,0,1,0,1
20200226-W-Doha-R16-Saisai_Zheng-Kiki_Bertens,1,S-XC,36,1,0,0,1,13,23
20200226-W-Doha-R16-Saisai_Zheng-Kiki_Bertens,1,S-DTM,15,1,0,0,1,6,9
20200226-W-Doha-R16-Saisai_Zheng-Kiki_Bertens,1,S-DTL,1,0,0,0,0,1,0
20200226-W-Doha-R16-Saisai_Zheng-Kiki_Bertens,2,F-XC,101,11,4,2,5,43,58
20200226-W-Doha-R16-Saisai_Zheng-Kiki_Bertens,2,F-DTM,34,2,0,1,1,19,15
20200226-W-Doha-R16-Saisai_Zheng-Kiki_Bertens,2,F-DTL,11,5,2,2,1,5,6
20200226-W-Doha-R16-Saisai_Zheng-Kiki_Bertens,2,F-IO,30,13,1,5,7,11,19
20200226-W-Doha-R16-Saisai_Zheng-Kiki_Bertens,2,F-II,2,0,0,0,0,1,1
20200226-W-Doha-R16-Saisai_Zheng-Kiki_Bertens,2,B-XC,64,3,0,1,2,34,30
20200226-W-Doha-R16-Saisai_Zheng-Kiki_Bertens,2,B-DTM,64,4,0,0,4,27,37
20200226-W-Doha-R16-Saisai_Zheng-Kiki_Bertens,2,B-DTL,14,5,0,2,3,6,8
20200226-W-Doha-R16-Saisai_Zheng-Kiki_Bertens,2,B-IO,10,3,1,0,2,7,3
20200226-W-Doha-R16-Saisai_Zheng-Kiki_Bertens,2,S-XC,32,6,2,1,3,19,13
20200226-W-Doha-R16-Saisai_Zheng-Kiki_Bertens,2,S-DTM,22,4,0,0,4,10,12
20200226-W-Doha-R16-Saisai_Zheng-Kiki_Bertens,2,S-DTL,11,3,0,1,2,6,5
20200226-W-Doha-R16-Saisai_Zheng-Kiki_Bertens,2,S-IO,1,0,0,0,0,1,0
20200223-W-Doha-R64-Yaroslava_Shvedova-Laura_Siegemund,1,F-XC,26,13,0,2,11,6,20
20200223-W-Doha-R64-Yaroslava_Shvedova-Laura_Siegemund,1,F-DTM,15,3,0,0,3,3,12
20200223-W-Doha-R64-Yaroslava_Shvedova-Laura_Siegemund,1,F-DTL,8,3,1,0,2,2,6
20200223-W-Doha-R64-Yaroslava_Shvedova-Laura_Siegemund,1,F-IO,7,3,2,0,1,4,3
20200223-W-Doha-R64-Yaroslava_Shvedova-Laura_Siegemund,1,B-XC,7,2,1,0,1,2,5
20200223-W-Doha-R64-Yaroslava_Shvedova-Laura_Siegemund,1,B-DTM,17,3,0,2,1,8,9
20200223-W-Doha-R64-Yaroslava_Shvedova-Laura_Siegemund,1,B-DTL,5,2,0,0,2,0,5
20200223-W-Doha-R64-Yaroslava_Shvedova-Laura_Siegemund,1,B-IO,4,3,1,1,1,3,1
20200223-W-Doha-R64-Yaroslava_Shvedova-Laura_Siegemund,1,S-DTL,4,1,1,0,0,1,3
20200223-W-Doha-R64-Yaroslava_Shvedova-Laura_Siegemund,2,F-XC,20,3,1,0,2,15,5
20200223-W-Doha-R64-Yaroslava_Shvedova-Laura_Siegemund,2,F-DTM,16,1,0,0,1,9,7
20200223-W-Doha-R64-Yaroslava_Shvedova-Laura_Siegemund,2,F-DTL,8,7,5,0,2,5,3
20200223-W-Doha-R64-Yaroslava_Shvedova-Laura_Siegemund,2,F-IO,3,1,1,0,0,3,0
20200223-W-Doha-R64-Yaroslava_Shvedova-Laura_Siegemund,2,B-XC,15,3,0,1,2,9,6
20200223-W-Doha-R64-Yaroslava_Shvedova-Laura_Siegemund,2,B-DTM,11,0,0,0,0,6,5
20200223-W-Doha-R64-Yaroslava_Shvedova-Laura_Siegemund,2,B-DTL,6,2,1,0,1,4,2
20200223-W-Doha-R64-Yaroslava_Shvedova-Laura_Siegemund,2,B-IO,6,2,0,0,2,4,2
20200223-W-Doha-R64-Yaroslava_Shvedova-Laura_Siegemund,2,S-XC,2,0,0,0,0,1,1
20200223-W-Doha-R64-Yaroslava_Shvedova-Laura_Siegemund,2,S-DTM,1,0,0,0,0,1,0
20190419-W-ITF_Dothan-QF-Elena_Gabriela_Ruse-Usue_Maitane_Arconada,1,F-XC,34,8,3,1,4,20,14
20190419-W-ITF_Dothan-QF-Elena_Gabriela_Ruse-Usue_Maitane_Arconada,1,F-DTM,11,1,0,0,1,6,5
20190419-W-ITF_Dothan-QF-Elena_Gabriela_Ruse-Usue_Maitane_Arconada,1,F-DTL,8,5,3,1,1,6,2
20190419-W-ITF_Dothan-QF-Elena_Gabriela_Ruse-Usue_Maitane_Arconada,1,F-IO,15,4,1,0,3,9,6
20190419-W-ITF_Dothan-QF-Elena_Gabriela_Ruse-Usue_Maitane_Arconada,1,B-XC,46,7,0,3,4,28,18
20190419-W-ITF_Dothan-QF-Elena_Gabriela_Ruse-Usue_Maitane_Arconada,1,B-DTM,24,5,0,3,2,14,10
20190419-W-ITF_Dothan-QF-Elena_Gabriela_Ruse-Usue_Maitane_Arconada,1,B-DTL,10,6,3,2,1,8,2
20190419-W-ITF_Dothan-QF-Elena_Gabriela_Ruse-Usue_Maitane_Arconada,1,B-IO,10,5,1,4,0,6,4
20190419-W-ITF_Dothan-QF-Elena_Gabriela_Ruse-Usue_Maitane_Arconada,1,S-XC,3,0,0,0,0,3,0
20190419-W-ITF_Dothan-QF-Elena_Gabriela_Ruse-Usue_Maitane_Arconada,1,S-DTM,2,0,0,0,0,1,1
20190419-W-ITF_Dothan-QF-Elena_Gabriela_Ruse-Usue_Maitane_Arconada,2,F-XC,24,2,1,0,1,10,14
20190419-W-ITF_Dothan-QF-Elena_Gabriela_Ruse-Usue_Maitane_Arconada,2,F-DTM,19,3,0,2,1,10,9
20190419-W-ITF_Dothan-QF-Elena_Gabriela_Ruse-Usue_Maitane_Arconada,2,F-DTL,9,1,0,0,1,4,5
20190419-W-ITF_Dothan-QF-Elena_Gabriela_Ruse-Usue_Maitane_Arconada,2,F-IO,7,2,0,0,2,2,5
20190419-W-ITF_Dothan-QF-Elena_Gabriela_Ruse-Usue_Maitane_Arconada,2,F-II,1,1,0,1,0,1,0
20190419-W-ITF_Dothan-QF-Elena_Gabriela_Ruse-Usue_Maitane_Arconada,2,B-XC,42,8,0,2,6,12,30
20190419-W-ITF_Dothan-QF-Elena_Gabriela_Ruse-Usue_Maitane_Arconada,2,B-DTM,36,4,0,2,2,13,23
20190419-W-ITF_Dothan-QF-Elena_Gabriela_Ruse-Usue_Maitane_Arconada,2,B-DTL,6,2,1,1,0,3,3
20190419-W-ITF_Dothan-QF-Elena_Gabriela_Ruse-Usue_Maitane_Arconada,2,B-IO,3,1,0,0,1,0,3
20190419-W-ITF_Dothan-QF-Elena_Gabriela_Ruse-Usue_Maitane_Arconada,2,S-DTM,2,0,0,0,0,0,2
20190419-W-ITF_Dothan-QF-Elena_Gabriela_Ruse-Usue_Maitane_Arconada,2,S-DTL,1,1,0,0,1,0,1
20181211-W-ITF_Dubai-R32-Natalia_Vikhlyantseva-Kristina_Mladenovic,1,F-XC,30,14,3,3,8,11,19
20181211-W-ITF_Dubai-R32-Natalia_Vikhlyantseva-Kristina_Mladenovic,1,F-DTM,26,2,0,0,2,9,17
20181211-W-ITF_Dubai-R32-Natalia_Vikhlyantseva-Kristina_Mladenovic,1,F-DTL,6,4,1,0,3,1,5
20181211-W-ITF_Dubai-R32-Natalia_Vikhlyantseva-Kristina_Mladenovic,1,F-IO,9,4,1,1,2,7,2
20181211-W-ITF_Dubai-R32-Natalia_Vikhlyantseva-Kristina_Mladenovic,1,B-XC,16,5,1,2,2,5,11
20181211-W-ITF_Dubai-R32-Natalia_Vikhlyantseva-Kristina_Mladenovic,1,B-DTM,17,4,0,2,2,7,10
20181211-W-ITF_Dubai-R32-Natalia_Vikhlyantseva-Kristina_Mladenovic,1,B-DTL,6,5,3,0,2,3,3
20181211-W-ITF_Dubai-R32-Natalia_Vikhlyantseva-Kristina_Mladenovic,1,B-IO,4,1,0,0,1,3,1
20181211-W-ITF_Dubai-R32-Natalia_Vikhlyantseva-Kristina_Mladenovic,1,S-XC,1,0,0,0,0,0,1
20181211-W-ITF_Dubai-R32-Natalia_Vikhlyantseva-Kristina_Mladenovic,2,F-XC,19,8,0,6,2,13,6
20181211-W-ITF_Dubai-R32-Natalia_Vikhlyantseva-Kristina_Mladenovic,2,F-DTM,17,3,0,2,1,10,7
20181211-W-ITF_Dubai-R32-Natalia_Vikhlyantseva-Kristina_Mladenovic,2,F-DTL,6,2,0,1,1,3,3
20181211-W-ITF_Dubai-R32-Natalia_Vikhlyantseva-Kristina_Mladenovic,2,F-IO,9,3,0,1,2,4,5
20181211-W-ITF_Dubai-R32-Natalia_Vikhlyantseva-Kristina_Mladenovic,2,B-XC,9,3,0,2,1,5,4
20181211-W-ITF_Dubai-R32-Natalia_Vikhlyantseva-Kristina_Mladenovic,2,B-DTM,12,1,0,0,1,8,4
20181211-W-ITF_Dubai-R32-Natalia_Vikhlyantseva-Kristina_Mladenovic,2,B-DTL,5,1,0,1,0,3,2
20181211-W-ITF_Dubai-R32-Natalia_Vikhlyantseva-Kristina_Mladenovic,2,B-IO,2,0,0,0,0,1,1
20181211-W-ITF_Dubai-R32-Natalia_Vikhlyantseva-Kristina_Mladenovic,2,S-XC,1,0,0,0,0,1,0
20181211-W-ITF_Dubai-R32-Natalia_Vikhlyantseva-Kristina_Mladenovic,2,S-DTM,7,0,0,0,0,1,6
20181211-W-ITF_Dubai-R32-Natalia_Vikhlyantseva-Kristina_Mladenovic,2,S-DTL,2,0,0,0,0,2,0
20181211-W-ITF_Dubai-R32-Natalia_Vikhlyantseva-Kristina_Mladenovic,2,S-IO,6,1,0,1,0,4,2
20200225-W-Acapulco-R32-Sara_Sorribes_Tormo-Sara_Errani,1,F-XC,103,12,2,5,5,57,46
20200225-W-Acapulco-R32-Sara_Sorribes_Tormo-Sara_Errani,1,F-DTM,95,5,0,0,5,41,54
20200225-W-Acapulco-R32-Sara_Sorribes_Tormo-Sara_Errani,1,F-DTL,17,10,4,0,6,7,10
20200225-W-Acapulco-R32-Sara_Sorribes_Tormo-Sara_Errani,1,F-IO,31,4,2,2,0,20,11
20200225-W-Acapulco-R32-Sara_Sorribes_Tormo-Sara_Errani,1,F-II,8,2,0,0,2,4,4
20200225-W-Acapulco-R32-Sara_Sorribes_Tormo-Sara_Errani,1,B-XC,38,6,3,1,2,10,28
20200225-W-Acapulco-R32-Sara_Sorribes_Tormo-Sara_Errani,1,B-DTM,60,4,0,1,3,24,36
20200225-W-Acapulco-R32-Sara_Sorribes_Tormo-Sara_Errani,1,B-DTL,14,4,0,0,4,4,10
20200225-W-Acapulco-R32-Sara_Sorribes_Tormo-Sara_Errani,1,B-IO,5,4,2,0,2,2,3
20200225-W-Acapulco-R32-Sara_Sorribes_Tormo-Sara_Errani,1,S-XC,32,5,0,1,4,13,19
20200225-W-Acapulco-R32-Sara_Sorribes_Tormo-Sara_Errani,1,S-DTM,66,4,0,0,4,25,41
20200225-W-Acapulco-R32-Sara_Sorribes_Tormo-Sara_Errani,1,S-DTL,17,3,0,0,3,8,9
20200225-W-Acapulco-R32-Sara_Sorribes_Tormo-Sara_Errani,1,S-IO,3,0,0,0,0,1,2
20200225-W-Acapulco-R32-Sara_Sorribes_Tormo-Sara_Errani,2,F-XC,140,17,4,3,10,72,68
20200225-W-Acapulco-R32-Sara_Sorribes_Tormo-Sara_Errani,2,F-DTM,46,1,0,0,1,22,24
20200225-W-Acapulco-R32-Sara_Sorribes_Tormo-Sara_Errani,2,F-DTL,25,5,1,1,3,15,10
20200225-W-Acapulco-R32-Sara_Sorribes_Tormo-Sara_Errani,2,F-IO,90,8,2,2,4,51,39
20200225-W-Acapulco-R32-Sara_Sorribes_Tormo-Sara_Errani,2,F-II,1,0,0,0,0,0,1
20200225-W-Acapulco-R32-Sara_Sorribes_Tormo-Sara_Errani,2,B-XC,86,6,1,0,5,49,37
20200225-W-Acapulco-R32-Sara_Sorribes_Tormo-Sara_Errani,2,B-DTM,61,3,0,1,2,36,25
20200225-W-Acapulco-R32-Sara_Sorribes_Tormo-Sara_Errani,2,B-DTL,5,2,0,1,1,3,2
20200225-W-Acapulco-R32-Sara_Sorribes_Tormo-Sara_Errani,2,B-IO,7,1,1,0,0,4,3
20200225-W-Acapulco-R32-Sara_Sorribes_Tormo-Sara_Errani,2,S-XC,10,0,0,0,0,9,1
20200225-W-Acapulco-R32-Sara_Sorribes_Tormo-Sara_Errani,2,S-DTM,6,0,0,0,0,3,3
20200225-W-Acapulco-R32-Sara_Sorribes_Tormo-Sara_Errani,2,S-DTL,3,2,1,0,1,1,2
20200225-W-Acapulco-R32-Sara_Sorribes_Tormo-Sara_Errani,2,S-IO,2,0,0,0,0,0,2
20200303-W-Monterrey-R32-Arantxa_Rus-Varvara_Flink,1,F-XC,12,3,0,1,2,5,7
20200303-W-Monterrey-R32-Arantxa_Rus-Varvara_Flink,1,F-DTM,23,0,0,0,0,12,11
20200303-W-Monterrey-R32-Arantxa_Rus-Varvara_Flink,1,F-DTL,4,2,1,0,1,1,3
20200303-W-Monterrey-R32-Arantxa_Rus-Varvara_Flink,1,F-IO,5,2,0,1,1,3,2
20200303-W-Monterrey-R32-Arantxa_Rus-Varvara_Flink,1,B-XC,10,2,1,0,1,6,4
20200303-W-Monterrey-R32-Arantxa_Rus-Varvara_Flink,1,B-DTM,19,4,2,0,2,8,11
20200303-W-Monterrey-R32-Arantxa_Rus-Varvara_Flink,1,B-DTL,4,0,0,0,0,2,2
20200303-W-Monterrey-R32-Arantxa_Rus-Varvara_Flink,2,F-XC,20,2,0,0,2,7,13
20200303-W-Monterrey-R32-Arantxa_Rus-Varvara_Flink,2,F-DTM,12,0,0,0,0,7,5
20200303-W-Monterrey-R32-Arantxa_Rus-Varvara_Flink,2,F-DTL,5,3,0,1,2,2,3
20200303-W-Monterrey-R32-Arantxa_Rus-Varvara_Flink,2,F-IO,4,1,1,0,0,3,1
20200303-W-Monterrey-R32-Arantxa_Rus-Varvara_Flink,2,B-XC,17,3,1,1,1,12,5
20200303-W-Monterrey-R32-Arantxa_Rus-Varvara_Flink,2,B-DTM,7,1,0,0,1,3,4
20200303-W-Monterrey-R32-Arantxa_Rus-Varvara_Flink,2,B-DTL,3,3,0,2,1,2,1
20200303-W-Monterrey-R32-Arantxa_Rus-Varvara_Flink,2,B-IO,6,1,0,0,1,4,2
20200303-W-Monterrey-R32-Arantxa_Rus-Varvara_Flink,2,S-XC,1,0,0,0,0,0,1
20171024-W-Singapore-RR-Karolina_Pliskova-Garbine_Muguruza,1,F-XC,24,7,2,3,2,16,8
20171024-W-Singapore-RR-Karolina_Pliskova-Garbine_Muguruza,1,F-DTM,7,1,0,0,1,6,1
20171024-W-Singapore-RR-Karolina_Pliskova-Garbine_Muguruza,1,F-DTL,4,4,3,0,1,3,1
20171024-W-Singapore-RR-Karolina_Pliskova-Garbine_Muguruza,1,F-IO,7,3,1,0,2,2,5
20171024-W-Singapore-RR-Karolina_Pliskova-Garbine_Muguruza,1,B-XC,16,3,1,2,0,14,2
20171024-W-Singapore-RR-Karolina_Pliskova-Garbine_Muguruza,1,B-DTM,16,0,0,0,0,13,3
20171024-W-Singapore-RR-Karolina_Pliskova-Garbine_Muguruza,1,B-DTL,6,2,1,0,1,5,1
20171024-W-Singapore-RR-Karolina_Pliskova-Garbine_Muguruza,1,B-IO,3,1,1,0,0,2,1
20171024-W-Singapore-RR-Karolina_Pliskova-Garbine_Muguruza,1,S-XC,1,0,0,0,0,1,0
20171024-W-Singapore-RR-Karolina_Pliskova-Garbine_Muguruza,1,S-DTM,1,0,0,0,0,1,0
20171024-W-Singapore-RR-Karolina_Pliskova-Garbine_Muguruza,2,F-XC,19,5,0,4,1,7,12
20171024-W-Singapore-RR-Karolina_Pliskova-Garbine_Muguruza,2,F-DTM,9,3,0,0,3,1,8
20171024-W-Singapore-RR-Karolina_Pliskova-Garbine_Muguruza,2,F-DTL,11,5,0,1,4,2,9
20171024-W-Singapore-RR-Karolina_Pliskova-Garbine_Muguruza,2,F-IO,8,7,1,1,5,2,6
20171024-W-Singapore-RR-Karolina_Pliskova-Garbine_Muguruza,2,B-XC,16,2,0,1,1,5,11
20171024-W-Singapore-RR-Karolina_Pliskova-Garbine_Muguruza,2,B-DTM,12,2,0,0,2,1,11
20171024-W-Singapore-RR-Karolina_Pliskova-Garbine_Muguruza,2,B-DTL,9,6,3,0,3,3,6
20171024-W-Singapore-RR-Karolina_Pliskova-Garbine_Muguruza,2,B-IO,1,1,1,0,0,1,0
20171024-W-Singapore-RR-Karolina_Pliskova-Garbine_Muguruza,2,S-DTM,1,0,0,0,0,0,1
20200305-W-Monterrey-R16-Arantxa_Rus-Lauren_Davis,1,F-XC,48,11,6,4,1,32,16
20200305-W-Monterrey-R16-Arantxa_Rus-Lauren_Davis,1,F-DTM,69,3,0,1,2,35,34
20200305-W-Monterrey-R16-Arantxa_Rus-Lauren_Davis,1,F-DTL,12,4,3,0,1,7,5
20200305-W-Monterrey-R16-Arantxa_Rus-Lauren_Davis,1,F-IO,43,15,7,0,8,20,23
20200305-W-Monterrey-R16-Arantxa_Rus-Lauren_Davis,1,B-XC,37,4,0,1,3,20,17
20200305-W-Monterrey-R16-Arantxa_Rus-Lauren_Davis,1,B-DTM,57,2,0,0,2,22,35
20200305-W-Monterrey-R16-Arantxa_Rus-Lauren_Davis,1,B-DTL,11,6,2,0,4,5,6
20200305-W-Monterrey-R16-Arantxa_Rus-Lauren_Davis,1,B-IO,5,2,0,0,2,1,4
20200305-W-Monterrey-R16-Arantxa_Rus-Lauren_Davis,1,S-XC,1,0,0,0,0,1,0
20200305-W-Monterrey-R16-Arantxa_Rus-Lauren_Davis,1,S-DTM,7,0,0,0,0,6,1
20200305-W-Monterrey-R16-Arantxa_Rus-Lauren_Davis,2,F-XC,62,14,4,5,5,37,25
20200305-W-Monterrey-R16-Arantxa_Rus-Lauren_Davis,2,F-DTM,58,6,0,1,5,29,29
20200305-W-Monterrey-R16-Arantxa_Rus-Lauren_Davis,2,F-DTL,21,9,1,1,7,6,15
20200305-W-Monterrey-R16-Arantxa_Rus-Lauren_Davis,2,F-IO,33,8,2,2,4,17,16
20200305-W-Monterrey-R16-Arantxa_Rus-Lauren_Davis,2,B-XC,35,10,3,2,5,17,18
20200305-W-Monterrey-R16-Arantxa_Rus-Lauren_Davis,2,B-DTM,46,3,0,0,3,23,23
20200305-W-Monterrey-R16-Arantxa_Rus-Lauren_Davis,2,B-DTL,5,2,0,0,2,1,4
20200305-W-Monterrey-R16-Arantxa_Rus-Lauren_Davis,2,B-IO,19,5,0,1,4,8,11
20200305-W-Monterrey-R16-Arantxa_Rus-Lauren_Davis,2,S-DTM,8,0,0,0,0,1,7
20200305-W-Monterrey-R16-Arantxa_Rus-Lauren_Davis,2,S-IO,1,0,0,0,0,1,0
20200306-W-Monterrey-QF-Rebecca_Peterson-Arantxa_Rus,1,F-XC,44,4,0,1,3,26,18
20200306-W-Monterrey-QF-Rebecca_Peterson-Arantxa_Rus,1,F-DTM,42,8,0,0,8,15,27
20200306-W-Monterrey-QF-Rebecca_Peterson-Arantxa_Rus,1,F-DTL,11,8,3,1,4,6,5
20200306-W-Monterrey-QF-Rebecca_Peterson-Arantxa_Rus,1,F-IO,21,8,3,2,3,10,11
20200306-W-Monterrey-QF-Rebecca_Peterson-Arantxa_Rus,1,F-II,2,1,1,0,0,2,0
20200306-W-Monterrey-QF-Rebecca_Peterson-Arantxa_Rus,1,B-XC,10,2,0,0,2,6,4
20200306-W-Monterrey-QF-Rebecca_Peterson-Arantxa_Rus,1,B-DTM,14,0,0,0,0,8,6
20200306-W-Monterrey-QF-Rebecca_Peterson-Arantxa_Rus,1,B-DTL,6,3,1,0,2,3,3
20200306-W-Monterrey-QF-Rebecca_Peterson-Arantxa_Rus,1,B-IO,3,1,0,0,1,0,3
20200306-W-Monterrey-QF-Rebecca_Peterson-Arantxa_Rus,1,S-XC,1,0,0,0,0,1,0
20200306-W-Monterrey-QF-Rebecca_Peterson-Arantxa_Rus,1,S-DTM,1,0,0,0,0,0,1
20200306-W-Monterrey-QF-Rebecca_Peterson-Arantxa_Rus,2,F-XC,13,6,4,1,1,8,5
20200306-W-Monterrey-QF-Rebecca_Peterson-Arantxa_Rus,2,F-DTM,43,5,1,1,3,23,20
20200306-W-Monterrey-QF-Rebecca_Peterson-Arantxa_Rus,2,F-DTL,4,3,3,0,0,3,1
20200306-W-Monterrey-QF-Rebecca_Peterson-Arantxa_Rus,2,F-IO,15,3,2,0,1,8,7
20200306-W-Monterrey-QF-Rebecca_Peterson-Arantxa_Rus,2,B-XC,26,6,1,0,5,8,18
20200306-W-Monterrey-QF-Rebecca_Peterson-Arantxa_Rus,2,B-DTM,40,1,0,0,1,22,18
20200306-W-Monterrey-QF-Rebecca_Peterson-Arantxa_Rus,2,B-DTL,6,3,1,0,2,1,5
20200306-W-Monterrey-QF-Rebecca_Peterson-Arantxa_Rus,2,B-IO,6,2,1,0,1,2,4
20200308-W-Monterrey-F-Elina_Svitolina-Marie_Bouzkova,1,F-XC,57,10,5,2,3,35,22
20200308-W-Monterrey-F-Elina_Svitolina-Marie_Bouzkova,1,F-DTM,102,4,0,0,4,61,41
20200308-W-Monterrey-F-Elina_Svitolina-Marie_Bouzkova,1,F-DTL,19,6,1,1,4,7,12
20200308-W-Monterrey-F-Elina_Svitolina-Marie_Bouzkova,1,F-IO,40,6,4,0,2,18,22
20200308-W-Monterrey-F-Elina_Svitolina-Marie_Bouzkova,1,F-II,1,1,1,0,0,1,0
20200308-W-Monterrey-F-Elina_Svitolina-Marie_Bouzkova,1,B-XC,81,9,3,1,5,47,34
20200308-W-Monterrey-F-Elina_Svitolina-Marie_Bouzkova,1,B-DTM,83,6,0,0,5,48,35
20200308-W-Monterrey-F-Elina_Svitolina-Marie_Bouzkova,1,B-DTL,12,5,2,1,2,7,5
20200308-W-Monterrey-F-Elina_Svitolina-Marie_Bouzkova,1,B-IO,24,13,4,3,6,11,13
20200308-W-Monterrey-F-Elina_Svitolina-Marie_Bouzkova,1,S-XC,10,1,1,0,0,6,4
20200308-W-Monterrey-F-Elina_Svitolina-Marie_Bouzkova,1,S-DTM,6,0,0,0,0,2,4
20200308-W-Monterrey-F-Elina_Svitolina-Marie_Bouzkova,1,S-DTL,1,0,0,0,0,1,0
20200308-W-Monterrey-F-Elina_Svitolina-Marie_Bouzkova,2,F-XC,96,17,5,2,10,47,49
20200308-W-Monterrey-F-Elina_Svitolina-Marie_Bouzkova,2,F-DTM,59,7,0,0,7,25,34
20200308-W-Monterrey-F-Elina_Svitolina-Marie_Bouzkova,2,F-DTL,13,7,2,0,5,4,9
20200308-W-Monterrey-F-Elina_Svitolina-Marie_Bouzkova,2,F-IO,47,25,11,5,9,27,20
20200308-W-Monterrey-F-Elina_Svitolina-Marie_Bouzkova,2,F-II,2,2,2,0,0,2,0
20200308-W-Monterrey-F-Elina_Svitolina-Marie_Bouzkova,2,B-XC,91,18,5,4,9,38,53
20200308-W-Monterrey-F-Elina_Svitolina-Marie_Bouzkova,2,B-DTM,87,4,0,0,4,40,47
20200308-W-Monterrey-F-Elina_Svitolina-Marie_Bouzkova,2,B-DTL,19,7,3,3,1,12,7
20200308-W-Monterrey-F-Elina_Svitolina-Marie_Bouzkova,2,B-IO,13,3,0,0,3,4,9
20200308-W-Monterrey-F-Elina_Svitolina-Marie_Bouzkova,2,S-XC,10,3,1,0,2,3,7
20200308-W-Monterrey-F-Elina_Svitolina-Marie_Bouzkova,2,S-DTM,14,0,0,0,0,9,5
20200308-W-Monterrey-F-Elina_Svitolina-Marie_Bouzkova,2,S-DTL,5,2,0,0,2,2,3
20200308-W-Monterrey-F-Elina_Svitolina-Marie_Bouzkova,2,S-IO,3,0,0,0,0,2,1
20200307-W-Monterrey-SF-Elina_Svitolina-Arantxa_Rus,1,F-XC,22,5,2,1,2,14,8
20200307-W-Monterrey-SF-Elina_Svitolina-Arantxa_Rus,1,F-DTM,32,2,0,0,2,22,10
20200307-W-Monterrey-SF-Elina_Svitolina-Arantxa_Rus,1,F-DTL,6,3,2,0,1,4,2
20200307-W-Monterrey-SF-Elina_Svitolina-Arantxa_Rus,1,F-IO,9,1,0,1,0,8,1
20200307-W-Monterrey-SF-Elina_Svitolina-Arantxa_Rus,1,B-XC,12,6,2,2,2,10,2
20200307-W-Monterrey-SF-Elina_Svitolina-Arantxa_Rus,1,B-DTM,16,1,0,0,1,13,3
20200307-W-Monterrey-SF-Elina_Svitolina-Arantxa_Rus,1,B-DTL,5,4,2,2,0,4,1
20200307-W-Monterrey-SF-Elina_Svitolina-Arantxa_Rus,1,B-IO,5,2,0,1,1,4,1
20200307-W-Monterrey-SF-Elina_Svitolina-Arantxa_Rus,1,S-XC,1,0,0,0,0,1,0
20200307-W-Monterrey-SF-Elina_Svitolina-Arantxa_Rus,2,F-XC,8,2,1,0,1,1,7
20200307-W-Monterrey-SF-Elina_Svitolina-Arantxa_Rus,2,F-DTM,26,0,0,0,0,7,19
20200307-W-Monterrey-SF-Elina_Svitolina-Arantxa_Rus,2,F-DTL,6,2,1,0,1,1,5
20200307-W-Monterrey-SF-Elina_Svitolina-Arantxa_Rus,2,F-IO,25,12,3,1,8,10,15
20200307-W-Monterrey-SF-Elina_Svitolina-Arantxa_Rus,2,F-II,1,1,1,0,0,1,0
20200307-W-Monterrey-SF-Elina_Svitolina-Arantxa_Rus,2,B-XC,9,2,0,0,2,2,7
20200307-W-Monterrey-SF-Elina_Svitolina-Arantxa_Rus,2,B-DTM,38,4,0,0,4,7,31
20200307-W-Monterrey-SF-Elina_Svitolina-Arantxa_Rus,2,B-DTL,2,1,0,0,1,1,1
20200307-W-Monterrey-SF-Elina_Svitolina-Arantxa_Rus,2,B-IO,4,1,0,0,1,0,4
20200307-W-Monterrey-SF-Elina_Svitolina-Arantxa_Rus,2,S-XC,2,1,0,1,0,1,1
20200307-W-Monterrey-SF-Elina_Svitolina-Arantxa_Rus,2,S-IO,1,0,0,0,0,0,1
20090119-W-Australian_Open-R128-Ana_Ivanovic-Julia_Goerges,1,F-XC,36,8,0,3,5,14,22
20090119-W-Australian_Open-R128-Ana_Ivanovic-Julia_Goerges,1,F-DTM,16,0,0,0,0,9,7
20090119-W-Australian_Open-R128-Ana_Ivanovic-Julia_Goerges,1,F-DTL,10,3,0,2,1,6,4
20090119-W-Australian_Open-R128-Ana_Ivanovic-Julia_Goerges,1,F-IO,21,6,2,1,3,12,9
20090119-W-Australian_Open-R128-Ana_Ivanovic-Julia_Goerges,1,F-II,5,3,1,2,0,4,1
20090119-W-Australian_Open-R128-Ana_Ivanovic-Julia_Goerges,1,B-XC,23,3,0,3,0,15,8
20090119-W-Australian_Open-R128-Ana_Ivanovic-Julia_Goerges,1,B-DTM,10,1,0,1,0,6,4
20090119-W-Australian_Open-R128-Ana_Ivanovic-Julia_Goerges,1,B-DTL,9,3,0,1,2,3,6
20090119-W-Australian_Open-R128-Ana_Ivanovic-Julia_Goerges,1,B-IO,2,0,0,0,0,1,1
20090119-W-Australian_Open-R128-Ana_Ivanovic-Julia_Goerges,1,S-XC,6,2,1,1,0,3,3
20090119-W-Australian_Open-R128-Ana_Ivanovic-Julia_Goerges,1,S-DTM,2,0,0,0,0,1,1
20090119-W-Australian_Open-R128-Ana_Ivanovic-Julia_Goerges,1,S-DTL,1,0,0,0,0,0,1
20090119-W-Australian_Open-R128-Ana_Ivanovic-Julia_Goerges,2,F-XC,43,20,4,9,7,30,13
20090119-W-Australian_Open-R128-Ana_Ivanovic-Julia_Goerges,2,F-DTM,11,6,0,2,4,5,6
20090119-W-Australian_Open-R128-Ana_Ivanovic-Julia_Goerges,2,F-DTL,13,6,4,2,0,9,4
20090119-W-Australian_Open-R128-Ana_Ivanovic-Julia_Goerges,2,F-IO,16,9,5,0,4,8,8
20090119-W-Australian_Open-R128-Ana_Ivanovic-Julia_Goerges,2,F-II,5,2,0,0,2,1,4
20090119-W-Australian_Open-R128-Ana_Ivanovic-Julia_Goerges,2,B-XC,35,6,2,1,2,19,16
20090119-W-Australian_Open-R128-Ana_Ivanovic-Julia_Goerges,2,B-DTM,18,1,0,0,1,9,9
20090119-W-Australian_Open-R128-Ana_Ivanovic-Julia_Goerges,2,B-DTL,18,5,2,0,3,7,11
20090119-W-Australian_Open-R128-Ana_Ivanovic-Julia_Goerges,2,B-IO,2,0,0,0,0,1,1
20090119-W-Australian_Open-R128-Ana_Ivanovic-Julia_Goerges,2,S-XC,1,0,0,0,0,0,1
20090119-W-Australian_Open-R128-Ana_Ivanovic-Julia_Goerges,2,S-DTM,1,0,0,0,0,0,1
20200304-W-Monterrey-R32-Kim_Clijsters-Johanna_Konta,1,F-XC,33,16,2,4,10,12,21
20200304-W-Monterrey-R32-Kim_Clijsters-Johanna_Konta,1,F-DTM,12,3,0,2,1,3,9
20200304-W-Monterrey-R32-Kim_Clijsters-Johanna_Konta,1,F-DTL,3,0,0,0,0,0,3
20200304-W-Monterrey-R32-Kim_Clijsters-Johanna_Konta,1,F-IO,14,10,3,5,2,11,3
20200304-W-Monterrey-R32-Kim_Clijsters-Johanna_Konta,1,B-XC,18,6,1,2,3,10,8
20200304-W-Monterrey-R32-Kim_Clijsters-Johanna_Konta,1,B-DTM,9,1,0,0,1,2,7
20200304-W-Monterrey-R32-Kim_Clijsters-Johanna_Konta,1,B-DTL,2,1,0,1,0,1,1
20200304-W-Monterrey-R32-Kim_Clijsters-Johanna_Konta,1,B-IO,2,1,0,0,1,0,2
20200304-W-Monterrey-R32-Kim_Clijsters-Johanna_Konta,1,S-XC,1,0,0,0,0,0,1
20200304-W-Monterrey-R32-Kim_Clijsters-Johanna_Konta,2,F-XC,27,13,8,2,3,20,7
20200304-W-Monterrey-R32-Kim_Clijsters-Johanna_Konta,2,F-DTM,11,2,0,2,0,8,3
20200304-W-Monterrey-R32-Kim_Clijsters-Johanna_Konta,2,F-DTL,4,2,2,0,0,3,1
20200304-W-Monterrey-R32-Kim_Clijsters-Johanna_Konta,2,F-IO,4,2,1,1,0,4,0
20200304-W-Monterrey-R32-Kim_Clijsters-Johanna_Konta,2,F-II,1,1,0,0,1,0,1
20200304-W-Monterrey-R32-Kim_Clijsters-Johanna_Konta,2,B-XC,11,5,3,0,2,8,3
20200304-W-Monterrey-R32-Kim_Clijsters-Johanna_Konta,2,B-DTM,11,1,0,1,0,7,4
20200304-W-Monterrey-R32-Kim_Clijsters-Johanna_Konta,2,B-DTL,3,3,1,0,2,1,2
20200304-W-Monterrey-R32-Kim_Clijsters-Johanna_Konta,2,B-IO,1,0,0,0,0,0,1
20200304-W-Monterrey-R32-Kim_Clijsters-Johanna_Konta,2,S-XC,2,0,0,0,0,2,0
20200304-W-Monterrey-R32-Kim_Clijsters-Johanna_Konta,2,S-DTM,4,0,0,0,0,2,2
20200304-W-Monterrey-R32-Kim_Clijsters-Johanna_Konta,2,S-DTL,3,1,0,1,0,3,0
20181029-W-Zhuhai-RR-Daria_Kasatkina-Qiang_Wang,1,F-XC,91,16,0,12,4,49,42
20181029-W-Zhuhai-RR-Daria_Kasatkina-Qiang_Wang,1,F-DTM,18,0,0,0,0,5,13
20181029-W-Zhuhai-RR-Daria_Kasatkina-Qiang_Wang,1,F-DTL,26,3,1,1,1,16,10
20181029-W-Zhuhai-RR-Daria_Kasatkina-Qiang_Wang,1,F-IO,28,8,0,3,5,13,15
20181029-W-Zhuhai-RR-Daria_Kasatkina-Qiang_Wang,1,F-II,5,2,1,1,0,2,3
20181029-W-Zhuhai-RR-Daria_Kasatkina-Qiang_Wang,1,B-XC,83,7,0,2,5,49,34
20181029-W-Zhuhai-RR-Daria_Kasatkina-Qiang_Wang,1,B-DTM,33,4,0,0,4,19,14
20181029-W-Zhuhai-RR-Daria_Kasatkina-Qiang_Wang,1,B-DTL,23,6,2,2,2,16,7
20181029-W-Zhuhai-RR-Daria_Kasatkina-Qiang_Wang,1,B-IO,11,2,0,0,2,1,10
20181029-W-Zhuhai-RR-Daria_Kasatkina-Qiang_Wang,1,S-XC,18,0,0,0,0,7,11
20181029-W-Zhuhai-RR-Daria_Kasatkina-Qiang_Wang,1,S-DTM,13,0,0,0,0,7,6
20181029-W-Zhuhai-RR-Daria_Kasatkina-Qiang_Wang,1,S-DTL,8,0,0,0,0,6,2
20181029-W-Zhuhai-RR-Daria_Kasatkina-Qiang_Wang,1,S-IO,3,0,0,0,0,1,2
20181029-W-Zhuhai-RR-Daria_Kasatkina-Qiang_Wang,2,F-XC,101,20,3,4,13,41,60
20181029-W-Zhuhai-RR-Daria_Kasatkina-Qiang_Wang,2,F-DTM,25,0,0,0,0,16,9
20181029-W-Zhuhai-RR-Daria_Kasatkina-Qiang_Wang,2,F-DTL,36,11,5,0,6,19,17
20181029-W-Zhuhai-RR-Daria_Kasatkina-Qiang_Wang,2,F-IO,34,3,2,0,1,12,22
20181029-W-Zhuhai-RR-Daria_Kasatkina-Qiang_Wang,2,F-II,3,1,0,0,1,1,2
20181029-W-Zhuhai-RR-Daria_Kasatkina-Qiang_Wang,2,B-XC,106,10,1,1,8,40,66
20181029-W-Zhuhai-RR-Daria_Kasatkina-Qiang_Wang,2,B-DTM,33,4,0,0,4,13,20
20181029-W-Zhuhai-RR-Daria_Kasatkina-Qiang_Wang,2,B-DTL,30,10,1,5,4,18,12
20181029-W-Zhuhai-RR-Daria_Kasatkina-Qiang_Wang,2,B-IO,9,3,2,1,0,8,1
20181029-W-Zhuhai-RR-Daria_Kasatkina-Qiang_Wang,2,S-XC,2,1,0,1,0,1,1
20181029-W-Zhuhai-RR-Daria_Kasatkina-Qiang_Wang,2,S-DTM,1,0,0,0,0,1,0
20200226-W-Doha-R16-Dayana_Yastremska-Garbine_Muguruza,1,F-XC,28,10,3,5,2,23,5
20200226-W-Doha-R16-Dayana_Yastremska-Garbine_Muguruza,1,F-DTM,13,2,0,1,1,6,7
20200226-W-Doha-R16-Dayana_Yastremska-Garbine_Muguruza,1,F-DTL,9,5,3,1,1,6,3
20200226-W-Doha-R16-Dayana_Yastremska-Garbine_Muguruza,1,F-IO,14,8,3,2,3,5,9
20200226-W-Doha-R16-Dayana_Yastremska-Garbine_Muguruza,1,B-XC,21,7,1,2,4,11,10
20200226-W-Doha-R16-Dayana_Yastremska-Garbine_Muguruza,1,B-DTM,21,2,0,0,2,13,8
20200226-W-Doha-R16-Dayana_Yastremska-Garbine_Muguruza,1,B-DTL,8,2,0,1,1,5,3
20200226-W-Doha-R16-Dayana_Yastremska-Garbine_Muguruza,1,B-IO,10,1,0,0,1,5,5
20200226-W-Doha-R16-Dayana_Yastremska-Garbine_Muguruza,2,F-XC,29,8,1,1,6,9,20
20200226-W-Doha-R16-Dayana_Yastremska-Garbine_Muguruza,2,F-DTM,9,1,0,1,0,3,6
20200226-W-Doha-R16-Dayana_Yastremska-Garbine_Muguruza,2,F-DTL,9,4,0,2,2,4,5
20200226-W-Doha-R16-Dayana_Yastremska-Garbine_Muguruza,2,F-IO,11,1,0,0,1,4,7
20200226-W-Doha-R16-Dayana_Yastremska-Garbine_Muguruza,2,B-XC,21,3,0,1,2,10,11
20200226-W-Doha-R16-Dayana_Yastremska-Garbine_Muguruza,2,B-DTM,22,4,0,4,0,15,7
20200226-W-Doha-R16-Dayana_Yastremska-Garbine_Muguruza,2,B-DTL,2,2,0,2,0,2,0
20200226-W-Doha-R16-Dayana_Yastremska-Garbine_Muguruza,2,B-IO,7,2,0,1,1,1,6
20200303-W-Monterrey-R32-Tamara_Zidansek-Victoria_Azarenka,1,F-XC,31,9,2,5,2,18,13
20200303-W-Monterrey-R32-Tamara_Zidansek-Victoria_Azarenka,1,F-DTM,11,3,0,1,2,3,8
20200303-W-Monterrey-R32-Tamara_Zidansek-Victoria_Azarenka,1,F-DTL,3,1,0,0,1,1,2
20200303-W-Monterrey-R32-Tamara_Zidansek-Victoria_Azarenka,1,F-IO,23,12,3,6,3,15,8
20200303-W-Monterrey-R32-Tamara_Zidansek-Victoria_Azarenka,1,F-II,2,2,1,1,0,2,0
20200303-W-Monterrey-R32-Tamara_Zidansek-Victoria_Azarenka,1,B-XC,9,0,0,0,0,7,2
20200303-W-Monterrey-R32-Tamara_Zidansek-Victoria_Azarenka,1,B-DTM,8,0,0,0,0,4,4
20200303-W-Monterrey-R32-Tamara_Zidansek-Victoria_Azarenka,1,B-DTL,5,2,1,1,0,3,2
20200303-W-Monterrey-R32-Tamara_Zidansek-Victoria_Azarenka,1,B-IO,1,1,0,0,1,0,1
20200303-W-Monterrey-R32-Tamara_Zidansek-Victoria_Azarenka,1,S-XC,3,0,0,0,0,2,1
20200303-W-Monterrey-R32-Tamara_Zidansek-Victoria_Azarenka,1,S-DTM,3,1,0,0,1,1,2
20200303-W-Monterrey-R32-Tamara_Zidansek-Victoria_Azarenka,1,S-DTL,3,0,0,0,0,2,1
20200303-W-Monterrey-R32-Tamara_Zidansek-Victoria_Azarenka,2,F-XC,21,6,1,1,4,12,9
20200303-W-Monterrey-R32-Tamara_Zidansek-Victoria_Azarenka,2,F-DTM,15,2,0,1,1,7,8
20200303-W-Monterrey-R32-Tamara_Zidansek-Victoria_Azarenka,2,F-DTL,12,6,0,2,4,4,8
20200303-W-Monterrey-R32-Tamara_Zidansek-Victoria_Azarenka,2,F-IO,13,3,1,0,2,5,8
20200303-W-Monterrey-R32-Tamara_Zidansek-Victoria_Azarenka,2,B-XC,12,5,2,1,2,5,7
20200303-W-Monterrey-R32-Tamara_Zidansek-Victoria_Azarenka,2,B-DTM,10,0,0,0,0,5,5
20200303-W-Monterrey-R32-Tamara_Zidansek-Victoria_Azarenka,2,B-DTL,9,5,4,0,1,6,3
20200303-W-Monterrey-R32-Tamara_Zidansek-Victoria_Azarenka,2,B-IO,2,2,0,2,0,2,0
20200303-W-Monterrey-R32-Tamara_Zidansek-Victoria_Azarenka,2,S-XC,3,0,0,0,0,0,3
20200303-W-Monterrey-R32-Tamara_Zidansek-Victoria_Azarenka,2,S-DTM,3,0,0,0,0,1,2
20200303-W-Monterrey-R32-Tamara_Zidansek-Victoria_Azarenka,2,S-DTL,1,0,0,0,0,1,0
20200213-W-St_Petersburg-R16-Veronika_Kudermetova-Kiki_Bertens,1,F-XC,24,9,3,2,4,7,17
20200213-W-St_Petersburg-R16-Veronika_Kudermetova-Kiki_Bertens,1,F-DTM,13,0,0,0,0,6,7
20200213-W-St_Petersburg-R16-Veronika_Kudermetova-Kiki_Bertens,1,F-DTL,15,3,1,0,2,2,13
20200213-W-St_Petersburg-R16-Veronika_Kudermetova-Kiki_Bertens,1,F-IO,12,2,0,1,1,8,4
20200213-W-St_Petersburg-R16-Veronika_Kudermetova-Kiki_Bertens,1,B-XC,24,2,0,1,1,11,13
20200213-W-St_Petersburg-R16-Veronika_Kudermetova-Kiki_Bertens,1,B-DTM,7,1,0,1,0,3,4
20200213-W-St_Petersburg-R16-Veronika_Kudermetova-Kiki_Bertens,1,B-DTL,4,1,0,0,1,1,3
20200213-W-St_Petersburg-R16-Veronika_Kudermetova-Kiki_Bertens,1,S-XC,1,0,0,0,0,1,0
20200213-W-St_Petersburg-R16-Veronika_Kudermetova-Kiki_Bertens,1,S-DTM,1,0,0,0,0,0,1
20200213-W-St_Petersburg-R16-Veronika_Kudermetova-Kiki_Bertens,2,F-XC,26,6,2,2,2,20,6
20200213-W-St_Petersburg-R16-Veronika_Kudermetova-Kiki_Bertens,2,F-DTM,9,2,0,1,1,5,4
20200213-W-St_Petersburg-R16-Veronika_Kudermetova-Kiki_Bertens,2,F-DTL,1,0,0,0,0,1,0
20200213-W-St_Petersburg-R16-Veronika_Kudermetova-Kiki_Bertens,2,F-IO,3,1,1,0,0,2,1
20200213-W-St_Petersburg-R16-Veronika_Kudermetova-Kiki_Bertens,2,F-II,1,1,0,1,0,1,0
20200213-W-St_Petersburg-R16-Veronika_Kudermetova-Kiki_Bertens,2,B-XC,19,7,0,4,3,8,11
20200213-W-St_Petersburg-R16-Veronika_Kudermetova-Kiki_Bertens,2,B-DTM,11,0,0,0,0,4,7
20200213-W-St_Petersburg-R16-Veronika_Kudermetova-Kiki_Bertens,2,B-DTL,2,2,1,1,0,2,0
20200213-W-St_Petersburg-R16-Veronika_Kudermetova-Kiki_Bertens,2,B-IO,1,0,0,0,0,0,1
20200213-W-St_Petersburg-R16-Veronika_Kudermetova-Kiki_Bertens,2,S-XC,6,0,0,0,0,5,1
20200213-W-St_Petersburg-R16-Veronika_Kudermetova-Kiki_Bertens,2,S-DTM,7,1,0,1,0,4,3
20200213-W-St_Petersburg-R16-Veronika_Kudermetova-Kiki_Bertens,2,S-DTL,5,0,0,0,0,4,1
20200225-W-Doha-R32-Petra_Kvitova-Carla_Suarez_Navarro,1,F-XC,28,13,7,3,3,16,12
20200225-W-Doha-R32-Petra_Kvitova-Carla_Suarez_Navarro,1,F-DTM,17,5,1,0,4,8,9
20200225-W-Doha-R32-Petra_Kvitova-Carla_Suarez_Navarro,1,F-DTL,3,3,2,0,1,2,1
20200225-W-Doha-R32-Petra_Kvitova-Carla_Suarez_Navarro,1,F-IO,14,8,3,0,5,6,8
20200225-W-Doha-R32-Petra_Kvitova-Carla_Suarez_Navarro,1,B-XC,14,8,2,2,4,10,4
20200225-W-Doha-R32-Petra_Kvitova-Carla_Suarez_Navarro,1,B-DTM,10,1,0,1,0,4,6
20200225-W-Doha-R32-Petra_Kvitova-Carla_Suarez_Navarro,1,B-DTL,2,2,1,0,1,1,1
20200225-W-Doha-R32-Petra_Kvitova-Carla_Suarez_Navarro,1,B-IO,5,3,2,0,1,3,2
20200225-W-Doha-R32-Petra_Kvitova-Carla_Suarez_Navarro,1,S-XC,1,0,0,0,0,0,1
20200225-W-Doha-R32-Petra_Kvitova-Carla_Suarez_Navarro,1,S-DTM,2,0,0,0,0,2,0
20200225-W-Doha-R32-Petra_Kvitova-Carla_Suarez_Navarro,1,S-IO,1,0,0,0,0,1,0
20200225-W-Doha-R32-Petra_Kvitova-Carla_Suarez_Navarro,2,F-XC,13,4,0,0,4,4,9
20200225-W-Doha-R32-Petra_Kvitova-Carla_Suarez_Navarro,2,F-DTM,28,4,0,1,3,9,19
20200225-W-Doha-R32-Petra_Kvitova-Carla_Suarez_Navarro,2,F-DTL,5,5,3,1,1,4,1
20200225-W-Doha-R32-Petra_Kvitova-Carla_Suarez_Navarro,2,F-IO,8,3,1,1,1,5,3
20200225-W-Doha-R32-Petra_Kvitova-Carla_Suarez_Navarro,2,B-XC,14,3,1,0,2,10,4
20200225-W-Doha-R32-Petra_Kvitova-Carla_Suarez_Navarro,2,B-DTM,19,4,1,0,3,9,10
20200225-W-Doha-R32-Petra_Kvitova-Carla_Suarez_Navarro,2,B-DTL,3,3,1,0,2,1,2
20200225-W-Doha-R32-Petra_Kvitova-Carla_Suarez_Navarro,2,S-DTM,2,0,0,0,0,1,1
20200225-W-Doha-R32-Petra_Kvitova-Carla_Suarez_Navarro,2,S-DTL,1,0,0,0,0,1,0
20140108-W-Hobart-R16-Yanina_Wickmayer-Garbine_Muguruza,1,F-XC,4,0,0,0,0,0,4
20140108-W-Hobart-R16-Yanina_Wickmayer-Garbine_Muguruza,1,F-DTM,2,0,0,0,0,0,2
20140108-W-Hobart-R16-Yanina_Wickmayer-Garbine_Muguruza,1,F-DTL,4,2,0,0,2,0,4
20140108-W-Hobart-R16-Yanina_Wickmayer-Garbine_Muguruza,1,F-IO,2,0,0,0,0,1,1
20140108-W-Hobart-R16-Yanina_Wickmayer-Garbine_Muguruza,1,B-XC,6,3,0,2,1,5,1
20140108-W-Hobart-R16-Yanina_Wickmayer-Garbine_Muguruza,1,B-DTM,1,1,0,1,0,1,0
20140108-W-Hobart-R16-Yanina_Wickmayer-Garbine_Muguruza,1,B-DTL,2,2,1,1,0,2,0
20140108-W-Hobart-R16-Yanina_Wickmayer-Garbine_Muguruza,1,B-IO,1,1,0,0,1,0,1
20140108-W-Hobart-R16-Yanina_Wickmayer-Garbine_Muguruza,2,F-XC,5,0,0,0,0,5,0
20140108-W-Hobart-R16-Yanina_Wickmayer-Garbine_Muguruza,2,F-DTM,2,0,0,0,0,1,1
20140108-W-Hobart-R16-Yanina_Wickmayer-Garbine_Muguruza,2,B-XC,7,2,1,1,0,4,3
20140108-W-Hobart-R16-Yanina_Wickmayer-Garbine_Muguruza,2,B-DTM,2,0,0,0,0,1,1
20140108-W-Hobart-R16-Yanina_Wickmayer-Garbine_Muguruza,2,B-IO,3,2,1,1,0,3,0
20180210-W-Fed_Cup_World_Group_II-RR-Sorana_Cirstea-Carol_Zhao,1,F-XC,15,4,3,0,1,12,3
20180210-W-Fed_Cup_World_Group_II-RR-Sorana_Cirstea-Carol_Zhao,1,F-DTM,6,1,1,0,0,3,3
20180210-W-Fed_Cup_World_Group_II-RR-Sorana_Cirstea-Carol_Zhao,1,F-DTL,9,4,2,2,0,7,2
20180210-W-Fed_Cup_World_Group_II-RR-Sorana_Cirstea-Carol_Zhao,1,F-IO,8,4,1,2,1,6,2
20180210-W-Fed_Cup_World_Group_II-RR-Sorana_Cirstea-Carol_Zhao,1,B-XC,14,4,2,1,1,11,3
20180210-W-Fed_Cup_World_Group_II-RR-Sorana_Cirstea-Carol_Zhao,1,B-DTM,16,3,1,2,0,14,2
20180210-W-Fed_Cup_World_Group_II-RR-Sorana_Cirstea-Carol_Zhao,1,B-DTL,10,5,0,1,4,4,6
20180210-W-Fed_Cup_World_Group_II-RR-Sorana_Cirstea-Carol_Zhao,1,B-IO,9,3,1,1,1,5,4
20180210-W-Fed_Cup_World_Group_II-RR-Sorana_Cirstea-Carol_Zhao,1,S-XC,1,0,0,0,0,1,0
20180210-W-Fed_Cup_World_Group_II-RR-Sorana_Cirstea-Carol_Zhao,2,F-XC,18,3,1,0,2,5,13
20180210-W-Fed_Cup_World_Group_II-RR-Sorana_Cirstea-Carol_Zhao,2,F-DTM,12,2,0,1,1,2,10
20180210-W-Fed_Cup_World_Group_II-RR-Sorana_Cirstea-Carol_Zhao,2,F-DTL,4,1,1,0,0,1,3
20180210-W-Fed_Cup_World_Group_II-RR-Sorana_Cirstea-Carol_Zhao,2,F-IO,18,7,1,0,6,6,12
20180210-W-Fed_Cup_World_Group_II-RR-Sorana_Cirstea-Carol_Zhao,2,B-XC,12,2,0,0,2,2,10
20180210-W-Fed_Cup_World_Group_II-RR-Sorana_Cirstea-Carol_Zhao,2,B-DTM,9,0,0,0,0,3,6
20180210-W-Fed_Cup_World_Group_II-RR-Sorana_Cirstea-Carol_Zhao,2,B-DTL,4,1,0,0,1,2,2
20180210-W-Fed_Cup_World_Group_II-RR-Sorana_Cirstea-Carol_Zhao,2,B-IO,2,1,0,1,0,2,0
20180210-W-Fed_Cup_World_Group_II-RR-Sorana_Cirstea-Carol_Zhao,2,S-XC,3,1,0,0,1,0,3
20180210-W-Fed_Cup_World_Group_II-RR-Sorana_Cirstea-Carol_Zhao,2,S-DTM,4,0,0,0,0,0,4
20180210-W-Fed_Cup_World_Group_II-RR-Sorana_Cirstea-Carol_Zhao,2,S-DTL,1,0,0,0,0,0,1
20190115-W-Australian_Open-R128-Samantha_Stosur-Dayana_Yastremska,1,F-XC,14,5,2,2,1,6,8
20190115-W-Australian_Open-R128-Samantha_Stosur-Dayana_Yastremska,1,F-DTM,22,2,1,0,1,8,14
20190115-W-Australian_Open-R128-Samantha_Stosur-Dayana_Yastremska,1,F-DTL,8,5,1,2,2,4,4
20190115-W-Australian_Open-R128-Samantha_Stosur-Dayana_Yastremska,1,F-IO,14,2,1,1,0,7,7
20190115-W-Australian_Open-R128-Samantha_Stosur-Dayana_Yastremska,1,B-XC,4,1,0,0,1,2,2
20190115-W-Australian_Open-R128-Samantha_Stosur-Dayana_Yastremska,1,B-DTM,4,0,0,0,0,3,1
20190115-W-Australian_Open-R128-Samantha_Stosur-Dayana_Yastremska,1,B-DTL,5,3,1,1,1,4,1
20190115-W-Australian_Open-R128-Samantha_Stosur-Dayana_Yastremska,1,B-IO,1,1,0,1,0,1,0
20190115-W-Australian_Open-R128-Samantha_Stosur-Dayana_Yastremska,1,S-XC,1,0,0,0,0,0,1
20190115-W-Australian_Open-R128-Samantha_Stosur-Dayana_Yastremska,1,S-DTM,3,0,0,0,0,1,2
20190115-W-Australian_Open-R128-Samantha_Stosur-Dayana_Yastremska,1,S-DTL,1,0,0,0,0,1,0
20190115-W-Australian_Open-R128-Samantha_Stosur-Dayana_Yastremska,2,F-XC,20,15,5,7,3,16,4
20190115-W-Australian_Open-R128-Samantha_Stosur-Dayana_Yastremska,2,F-DTM,9,2,0,1,1,5,4
20190115-W-Australian_Open-R128-Samantha_Stosur-Dayana_Yastremska,2,F-DTL,4,4,3,1,0,4,0
20190115-W-Australian_Open-R128-Samantha_Stosur-Dayana_Yastremska,2,F-IO,10,5,2,2,1,6,4
20190115-W-Australian_Open-R128-Samantha_Stosur-Dayana_Yastremska,2,B-XC,14,8,2,4,2,10,4
20190115-W-Australian_Open-R128-Samantha_Stosur-Dayana_Yastremska,2,B-DTM,24,6,0,2,4,8,16
20190115-W-Australian_Open-R128-Samantha_Stosur-Dayana_Yastremska,2,B-DTL,6,4,1,2,1,4,2
20190115-W-Australian_Open-R128-Samantha_Stosur-Dayana_Yastremska,2,B-IO,5,1,0,0,1,2,3
20200121-W-Australian_Open-R128-Misaki_Doi-Harriet_Dart,1,F-XC,85,27,8,8,11,44,41
20200121-W-Australian_Open-R128-Misaki_Doi-Harriet_Dart,1,F-DTM,38,1,0,0,1,15,23
20200121-W-Australian_Open-R128-Misaki_Doi-Harriet_Dart,1,F-DTL,8,4,2,0,2,4,4
20200121-W-Australian_Open-R128-Misaki_Doi-Harriet_Dart,1,F-IO,49,17,5,5,7,26,23
20200121-W-Australian_Open-R128-Misaki_Doi-Harriet_Dart,1,F-II,9,3,2,0,1,3,6
20200121-W-Australian_Open-R128-Misaki_Doi-Harriet_Dart,1,B-XC,98,20,1,6,13,42,56
20200121-W-Australian_Open-R128-Misaki_Doi-Harriet_Dart,1,B-DTM,59,9,0,0,9,29,30
20200121-W-Australian_Open-R128-Misaki_Doi-Harriet_Dart,1,B-DTL,15,9,6,0,3,10,5
20200121-W-Australian_Open-R128-Misaki_Doi-Harriet_Dart,1,S-DTM,3,1,0,0,1,0,3
20200121-W-Australian_Open-R128-Misaki_Doi-Harriet_Dart,2,F-XC,104,15,5,3,7,57,47
20200121-W-Australian_Open-R128-Misaki_Doi-Harriet_Dart,2,F-DTM,53,4,0,0,4,22,31
20200121-W-Australian_Open-R128-Misaki_Doi-Harriet_Dart,2,F-DTL,28,9,1,5,3,20,8
20200121-W-Australian_Open-R128-Misaki_Doi-Harriet_Dart,2,F-IO,24,13,7,3,3,16,8
20200121-W-Australian_Open-R128-Misaki_Doi-Harriet_Dart,2,F-II,4,3,1,1,1,3,1
20200121-W-Australian_Open-R128-Misaki_Doi-Harriet_Dart,2,B-XC,33,7,4,1,2,21,12
20200121-W-Australian_Open-R128-Misaki_Doi-Harriet_Dart,2,B-DTM,37,6,0,0,6,16,21
20200121-W-Australian_Open-R128-Misaki_Doi-Harriet_Dart,2,B-DTL,25,10,5,3,2,13,12
20200121-W-Australian_Open-R128-Misaki_Doi-Harriet_Dart,2,B-IO,15,5,1,1,3,10,5
20200121-W-Australian_Open-R128-Misaki_Doi-Harriet_Dart,2,S-XC,1,0,0,0,0,0,1
20200121-W-Australian_Open-R128-Misaki_Doi-Harriet_Dart,2,S-DTM,9,1,0,0,1,4,5
20200121-W-Australian_Open-R128-Misaki_Doi-Harriet_Dart,2,S-DTL,3,0,0,0,0,1,2
20200121-W-Australian_Open-R128-Misaki_Doi-Harriet_Dart,2,S-IO,1,1,0,0,1,0,1
20191019-W-Moscow-R32-Dayana_Yastremska-Daria_Kasatkina,1,F-XC,40,16,7,6,3,25,15
20191019-W-Moscow-R32-Dayana_Yastremska-Daria_Kasatkina,1,F-DTM,17,4,1,1,2,10,7
20191019-W-Moscow-R32-Dayana_Yastremska-Daria_Kasatkina,1,F-DTL,9,5,1,2,2,5,4
20191019-W-Moscow-R32-Dayana_Yastremska-Daria_Kasatkina,1,F-IO,21,5,1,1,3,13,8
20191019-W-Moscow-R32-Dayana_Yastremska-Daria_Kasatkina,1,B-XC,33,9,1,3,5,23,10
20191019-W-Moscow-R32-Dayana_Yastremska-Daria_Kasatkina,1,B-DTM,30,3,0,2,1,17,13
20191019-W-Moscow-R32-Dayana_Yastremska-Daria_Kasatkina,1,B-DTL,14,1,1,0,0,10,4
20191019-W-Moscow-R32-Dayana_Yastremska-Daria_Kasatkina,1,B-IO,12,5,4,1,0,7,5
20191019-W-Moscow-R32-Dayana_Yastremska-Daria_Kasatkina,1,S-DTM,2,0,0,0,0,1,1
20191019-W-Moscow-R32-Dayana_Yastremska-Daria_Kasatkina,1,S-DTL,1,1,1,0,0,1,0
20191019-W-Moscow-R32-Dayana_Yastremska-Daria_Kasatkina,2,F-XC,39,8,0,7,1,19,20
20191019-W-Moscow-R32-Dayana_Yastremska-Daria_Kasatkina,2,F-DTM,22,2,0,1,1,11,11
20191019-W-Moscow-R32-Dayana_Yastremska-Daria_Kasatkina,2,F-DTL,13,4,1,2,1,4,9
20191019-W-Moscow-R32-Dayana_Yastremska-Daria_Kasatkina,2,F-IO,18,5,1,2,2,10,8
20191019-W-Moscow-R32-Dayana_Yastremska-Daria_Kasatkina,2,B-XC,19,2,0,1,1,7,12
20191019-W-Moscow-R32-Dayana_Yastremska-Daria_Kasatkina,2,B-DTM,15,1,0,1,0,5,10
20191019-W-Moscow-R32-Dayana_Yastremska-Daria_Kasatkina,2,B-DTL,4,2,1,0,1,1,3
20191019-W-Moscow-R32-Dayana_Yastremska-Daria_Kasatkina,2,B-IO,1,0,0,0,0,0,1
20191019-W-Moscow-R32-Dayana_Yastremska-Daria_Kasatkina,2,S-XC,13,1,0,0,1,1,12
20191019-W-Moscow-R32-Dayana_Yastremska-Daria_Kasatkina,2,S-DTM,13,1,0,1,0,5,8
20191019-W-Moscow-R32-Dayana_Yastremska-Daria_Kasatkina,2,S-DTL,2,0,0,0,0,1,1
20190807-W-Toronto-R32-Dayana_Yastremska-Victoria_Azarenka,1,F-XC,27,15,9,1,5,19,8
20190807-W-Toronto-R32-Dayana_Yastremska-Victoria_Azarenka,1,F-DTM,7,2,0,1,1,6,1
20190807-W-Toronto-R32-Dayana_Yastremska-Victoria_Azarenka,1,F-DTL,9,2,1,0,1,3,6
20190807-W-Toronto-R32-Dayana_Yastremska-Victoria_Azarenka,1,F-IO,9,5,3,0,2,7,2
20190807-W-Toronto-R32-Dayana_Yastremska-Victoria_Azarenka,1,F-II,2,2,2,0,0,2,0
20190807-W-Toronto-R32-Dayana_Yastremska-Victoria_Azarenka,1,B-XC,22,11,9,2,0,21,1
20190807-W-Toronto-R32-Dayana_Yastremska-Victoria_Azarenka,1,B-DTM,17,3,0,0,3,8,9
20190807-W-Toronto-R32-Dayana_Yastremska-Victoria_Azarenka,1,B-DTL,14,8,5,1,2,11,3
20190807-W-Toronto-R32-Dayana_Yastremska-Victoria_Azarenka,1,B-IO,5,2,1,0,1,3,2
20190807-W-Toronto-R32-Dayana_Yastremska-Victoria_Azarenka,1,S-DTM,1,0,0,0,0,0,1
20190807-W-Toronto-R32-Dayana_Yastremska-Victoria_Azarenka,1,S-DTL,1,0,0,0,0,0,1
20190807-W-Toronto-R32-Dayana_Yastremska-Victoria_Azarenka,2,F-XC,22,3,1,2,0,11,11
20190807-W-Toronto-R32-Dayana_Yastremska-Victoria_Azarenka,2,F-DTM,16,1,0,1,0,2,14
20190807-W-Toronto-R32-Dayana_Yastremska-Victoria_Azarenka,2,F-DTL,10,3,1,2,0,5,5
20190807-W-Toronto-R32-Dayana_Yastremska-Victoria_Azarenka,2,F-IO,9,2,2,0,0,7,2
20190807-W-Toronto-R32-Dayana_Yastremska-Victoria_Azarenka,2,B-XC,17,2,0,0,2,4,13
20190807-W-Toronto-R32-Dayana_Yastremska-Victoria_Azarenka,2,B-DTM,9,0,0,0,0,4,5
20190807-W-Toronto-R32-Dayana_Yastremska-Victoria_Azarenka,2,B-DTL,4,0,0,0,0,1,3
20190807-W-Toronto-R32-Dayana_Yastremska-Victoria_Azarenka,2,B-IO,5,2,1,0,1,3,2
20190807-W-Toronto-R32-Dayana_Yastremska-Victoria_Azarenka,2,S-XC,4,0,0,0,0,1,3
20190807-W-Toronto-R32-Dayana_Yastremska-Victoria_Azarenka,2,S-DTM,4,0,0,0,0,1,3
20200219-W-Dubai-R16-Karolina_Pliskova-Kristina_Mladenovic,1,F-XC,18,8,3,2,3,9,9
20200219-W-Dubai-R16-Karolina_Pliskova-Kristina_Mladenovic,1,F-DTM,17,1,0,1,0,13,4
20200219-W-Dubai-R16-Karolina_Pliskova-Kristina_Mladenovic,1,F-DTL,3,2,2,0,0,3,0
20200219-W-Dubai-R16-Karolina_Pliskova-Kristina_Mladenovic,1,F-IO,13,5,1,2,2,8,5
20200219-W-Dubai-R16-Karolina_Pliskova-Kristina_Mladenovic,1,B-XC,7,0,0,0,0,5,2
20200219-W-Dubai-R16-Karolina_Pliskova-Kristina_Mladenovic,1,B-DTM,9,1,0,0,1,6,3
20200219-W-Dubai-R16-Karolina_Pliskova-Kristina_Mladenovic,1,B-DTL,2,1,1,0,0,1,1
20200219-W-Dubai-R16-Karolina_Pliskova-Kristina_Mladenovic,1,B-IO,1,1,1,0,0,1,0
20200219-W-Dubai-R16-Karolina_Pliskova-Kristina_Mladenovic,1,S-XC,2,1,0,1,0,1,1
20200219-W-Dubai-R16-Karolina_Pliskova-Kristina_Mladenovic,1,S-DTM,1,0,0,0,0,0,1
20200219-W-Dubai-R16-Karolina_Pliskova-Kristina_Mladenovic,2,F-XC,16,4,2,0,2,8,8
20200219-W-Dubai-R16-Karolina_Pliskova-Kristina_Mladenovic,2,F-DTM,7,1,1,0,0,3,4
20200219-W-Dubai-R16-Karolina_Pliskova-Kristina_Mladenovic,2,F-DTL,4,3,1,0,2,2,2
20200219-W-Dubai-R16-Karolina_Pliskova-Kristina_Mladenovic,2,F-IO,6,2,1,0,1,1,5
20200219-W-Dubai-R16-Karolina_Pliskova-Kristina_Mladenovic,2,F-II,1,0,0,0,0,1,0
20200219-W-Dubai-R16-Karolina_Pliskova-Kristina_Mladenovic,2,B-XC,11,5,1,1,3,6,5
20200219-W-Dubai-R16-Karolina_Pliskova-Kristina_Mladenovic,2,B-DTM,10,0,0,0,0,2,8
20200219-W-Dubai-R16-Karolina_Pliskova-Kristina_Mladenovic,2,B-DTL,6,2,0,1,1,2,4
20200219-W-Dubai-R16-Karolina_Pliskova-Kristina_Mladenovic,2,B-IO,5,1,1,0,0,1,4
20200219-W-Dubai-R16-Karolina_Pliskova-Kristina_Mladenovic,2,S-XC,1,0,0,0,0,1,0
20200219-W-Dubai-R16-Karolina_Pliskova-Kristina_Mladenovic,2,S-DTM,4,0,0,0,0,0,4
20200219-W-Dubai-R16-Karolina_Pliskova-Kristina_Mladenovic,2,S-DTL,3,0,0,0,0,2,1
19890319-W-Boca_Raton-F-Steffi_Graf-Chris_Evert,1,F-XC,59,17,5,5,7,30,29
19890319-W-Boca_Raton-F-Steffi_Graf-Chris_Evert,1,F-DTM,22,2,0,0,2,9,13
19890319-W-Boca_Raton-F-Steffi_Graf-Chris_Evert,1,F-DTL,7,3,2,0,1,3,4
19890319-W-Boca_Raton-F-Steffi_Graf-Chris_Evert,1,F-IO,29,9,4,2,3,19,10
19890319-W-Boca_Raton-F-Steffi_Graf-Chris_Evert,1,F-II,6,4,2,1,1,3,3
19890319-W-Boca_Raton-F-Steffi_Graf-Chris_Evert,1,B-XC,6,1,1,0,0,3,3
19890319-W-Boca_Raton-F-Steffi_Graf-Chris_Evert,1,B-DTM,8,0,0,0,0,4,4
19890319-W-Boca_Raton-F-Steffi_Graf-Chris_Evert,1,S-XC,81,12,0,4,8,44,37
19890319-W-Boca_Raton-F-Steffi_Graf-Chris_Evert,1,S-DTM,42,2,0,0,2,15,27
19890319-W-Boca_Raton-F-Steffi_Graf-Chris_Evert,1,S-DTL,45,7,0,1,6,20,25
19890319-W-Boca_Raton-F-Steffi_Graf-Chris_Evert,1,S-IO,24,3,1,0,2,11,13
19890319-W-Boca_Raton-F-Steffi_Graf-Chris_Evert,2,F-XC,37,13,2,4,7,21,16
19890319-W-Boca_Raton-F-Steffi_Graf-Chris_Evert,2,F-DTM,48,1,0,0,1,24,24
19890319-W-Boca_Raton-F-Steffi_Graf-Chris_Evert,2,F-DTL,34,5,4,0,1,19,15
19890319-W-Boca_Raton-F-Steffi_Graf-Chris_Evert,2,F-IO,23,3,0,2,1,15,8
19890319-W-Boca_Raton-F-Steffi_Graf-Chris_Evert,2,B-XC,100,17,0,3,14,48,52
19890319-W-Boca_Raton-F-Steffi_Graf-Chris_Evert,2,B-DTM,39,0,0,0,0,14,25
19890319-W-Boca_Raton-F-Steffi_Graf-Chris_Evert,2,B-DTL,9,5,2,2,1,7,2
19890319-W-Boca_Raton-F-Steffi_Graf-Chris_Evert,2,B-IO,8,3,1,0,2,4,4
19890319-W-Boca_Raton-F-Steffi_Graf-Chris_Evert,2,S-XC,7,0,0,0,0,2,5
19890319-W-Boca_Raton-F-Steffi_Graf-Chris_Evert,2,S-DTM,4,0,0,0,0,2,2
19890319-W-Boca_Raton-F-Steffi_Graf-Chris_Evert,2,S-DTL,1,0,0,0,0,1,0
20090207-W-Fed_Cup_WG_R1-RR-Flavia_Pennetta-Amelie_Mauresmo,1,F-XC,105,11,2,2,7,45,60
20090207-W-Fed_Cup_WG_R1-RR-Flavia_Pennetta-Amelie_Mauresmo,1,F-DTM,16,2,0,0,2,5,11
20090207-W-Fed_Cup_WG_R1-RR-Flavia_Pennetta-Amelie_Mauresmo,1,F-DTL,31,11,5,3,3,15,16
20090207-W-Fed_Cup_WG_R1-RR-Flavia_Pennetta-Amelie_Mauresmo,1,F-IO,19,3,0,1,2,8,11
20090207-W-Fed_Cup_WG_R1-RR-Flavia_Pennetta-Amelie_Mauresmo,1,F-II,11,4,2,1,1,6,5
20090207-W-Fed_Cup_WG_R1-RR-Flavia_Pennetta-Amelie_Mauresmo,1,B-XC,181,21,3,6,12,79,102
20090207-W-Fed_Cup_WG_R1-RR-Flavia_Pennetta-Amelie_Mauresmo,1,B-DTM,38,5,0,1,4,14,24
20090207-W-Fed_Cup_WG_R1-RR-Flavia_Pennetta-Amelie_Mauresmo,1,B-DTL,58,23,5,7,11,27,31
20090207-W-Fed_Cup_WG_R1-RR-Flavia_Pennetta-Amelie_Mauresmo,1,B-IO,3,2,2,0,0,3,0
20090207-W-Fed_Cup_WG_R1-RR-Flavia_Pennetta-Amelie_Mauresmo,1,S-XC,2,1,0,1,0,1,1
20090207-W-Fed_Cup_WG_R1-RR-Flavia_Pennetta-Amelie_Mauresmo,1,S-DTM,2,0,0,0,0,1,1
20090207-W-Fed_Cup_WG_R1-RR-Flavia_Pennetta-Amelie_Mauresmo,1,S-DTL,6,0,0,0,0,2,4
20090207-W-Fed_Cup_WG_R1-RR-Flavia_Pennetta-Amelie_Mauresmo,2,F-XC,83,17,4,7,6,49,34
20090207-W-Fed_Cup_WG_R1-RR-Flavia_Pennetta-Amelie_Mauresmo,2,F-DTM,16,0,0,0,0,8,8
20090207-W-Fed_Cup_WG_R1-RR-Flavia_Pennetta-Amelie_Mauresmo,2,F-DTL,77,12,1,4,7,42,35
20090207-W-Fed_Cup_WG_R1-RR-Flavia_Pennetta-Amelie_Mauresmo,2,F-IO,45,6,1,2,3,25,20
20090207-W-Fed_Cup_WG_R1-RR-Flavia_Pennetta-Amelie_Mauresmo,2,B-XC,86,16,3,8,5,52,34
20090207-W-Fed_Cup_WG_R1-RR-Flavia_Pennetta-Amelie_Mauresmo,2,B-DTM,18,3,0,0,3,5,13
20090207-W-Fed_Cup_WG_R1-RR-Flavia_Pennetta-Amelie_Mauresmo,2,B-DTL,12,5,2,0,3,6,6
20090207-W-Fed_Cup_WG_R1-RR-Flavia_Pennetta-Amelie_Mauresmo,2,B-IO,3,1,0,0,1,1,2
20090207-W-Fed_Cup_WG_R1-RR-Flavia_Pennetta-Amelie_Mauresmo,2,S-XC,60,0,0,0,0,39,21
20090207-W-Fed_Cup_WG_R1-RR-Flavia_Pennetta-Amelie_Mauresmo,2,S-DTM,26,0,0,0,0,14,12
20090207-W-Fed_Cup_WG_R1-RR-Flavia_Pennetta-Amelie_Mauresmo,2,S-DTL,13,1,0,0,1,8,5
20090207-W-Fed_Cup_WG_R1-RR-Flavia_Pennetta-Amelie_Mauresmo,2,S-IO,4,0,0,0,0,2,2
20170622-W-Mallorca-R16-Kirsten_Flipkens-Roberta_Vinci,1,F-XC,43,20,9,4,7,24,19
20170622-W-Mallorca-R16-Kirsten_Flipkens-Roberta_Vinci,1,F-DTM,7,1,0,0,1,4,3
20170622-W-Mallorca-R16-Kirsten_Flipkens-Roberta_Vinci,1,F-DTL,7,2,1,0,1,2,5
20170622-W-Mallorca-R16-Kirsten_Flipkens-Roberta_Vinci,1,F-IO,20,10,4,4,2,12,8
20170622-W-Mallorca-R16-Kirsten_Flipkens-Roberta_Vinci,1,F-II,4,2,0,1,1,2,2
20170622-W-Mallorca-R16-Kirsten_Flipkens-Roberta_Vinci,1,B-XC,5,0,0,0,0,2,3
20170622-W-Mallorca-R16-Kirsten_Flipkens-Roberta_Vinci,1,B-DTM,1,0,0,0,0,0,1
20170622-W-Mallorca-R16-Kirsten_Flipkens-Roberta_Vinci,1,B-DTL,1,0,0,0,0,0,1
20170622-W-Mallorca-R16-Kirsten_Flipkens-Roberta_Vinci,1,S-XC,83,7,0,2,5,35,48
20170622-W-Mallorca-R16-Kirsten_Flipkens-Roberta_Vinci,1,S-DTM,27,1,0,1,0,16,11
20170622-W-Mallorca-R16-Kirsten_Flipkens-Roberta_Vinci,1,S-DTL,18,4,2,0,2,7,11
20170622-W-Mallorca-R16-Kirsten_Flipkens-Roberta_Vinci,1,S-IO,2,0,0,0,0,0,2
20170622-W-Mallorca-R16-Kirsten_Flipkens-Roberta_Vinci,2,F-XC,33,8,3,2,3,20,13
20170622-W-Mallorca-R16-Kirsten_Flipkens-Roberta_Vinci,2,F-DTM,10,2,0,1,1,3,7
20170622-W-Mallorca-R16-Kirsten_Flipkens-Roberta_Vinci,2,F-DTL,16,4,2,1,1,10,6
20170622-W-Mallorca-R16-Kirsten_Flipkens-Roberta_Vinci,2,F-IO,32,10,2,4,4,22,10
20170622-W-Mallorca-R16-Kirsten_Flipkens-Roberta_Vinci,2,F-II,5,1,0,0,1,3,2
20170622-W-Mallorca-R16-Kirsten_Flipkens-Roberta_Vinci,2,B-XC,1,1,0,0,1,0,1
20170622-W-Mallorca-R16-Kirsten_Flipkens-Roberta_Vinci,2,B-DTL,1,1,1,0,0,1,0
20170622-W-Mallorca-R16-Kirsten_Flipkens-Roberta_Vinci,2,S-XC,93,2,0,0,2,48,45
20170622-W-Mallorca-R16-Kirsten_Flipkens-Roberta_Vinci,2,S-DTM,10,3,0,1,2,5,5
20170622-W-Mallorca-R16-Kirsten_Flipkens-Roberta_Vinci,2,S-DTL,14,5,1,1,3,6,8
20130701-W-Wimbledon-R16-Sabine_Lisicki-Serena_Williams,1,F-XC,40,17,6,3,8,22,18
20130701-W-Wimbledon-R16-Sabine_Lisicki-Serena_Williams,1,F-DTM,27,6,2,0,4,13,14
20130701-W-Wimbledon-R16-Sabine_Lisicki-Serena_Williams,1,F-DTL,12,4,2,1,1,7,5
20130701-W-Wimbledon-R16-Sabine_Lisicki-Serena_Williams,1,F-IO,23,11,5,1,5,13,10
20130701-W-Wimbledon-R16-Sabine_Lisicki-Serena_Williams,1,B-XC,23,6,1,3,2,15,8
20130701-W-Wimbledon-R16-Sabine_Lisicki-Serena_Williams,1,B-DTM,23,4,0,0,4,9,14
20130701-W-Wimbledon-R16-Sabine_Lisicki-Serena_Williams,1,B-DTL,11,6,2,1,3,6,5
20130701-W-Wimbledon-R16-Sabine_Lisicki-Serena_Williams,1,B-IO,3,2,1,0,1,2,1
20130701-W-Wimbledon-R16-Sabine_Lisicki-Serena_Williams,1,B-II,1,0,0,0,0,0,1
20130701-W-Wimbledon-R16-Sabine_Lisicki-Serena_Williams,1,S-DTM,3,1,0,0,1,1,2
20130701-W-Wimbledon-R16-Sabine_Lisicki-Serena_Williams,1,S-DTL,1,0,0,0,0,0,1
20130701-W-Wimbledon-R16-Sabine_Lisicki-Serena_Williams,2,F-XC,31,5,1,2,2,13,18
20130701-W-Wimbledon-R16-Sabine_Lisicki-Serena_Williams,2,F-DTM,21,3,0,1,2,10,11
20130701-W-Wimbledon-R16-Sabine_Lisicki-Serena_Williams,2,F-DTL,10,4,1,1,2,5,5
20130701-W-Wimbledon-R16-Sabine_Lisicki-Serena_Williams,2,F-IO,13,5,1,2,2,7,6
20130701-W-Wimbledon-R16-Sabine_Lisicki-Serena_Williams,2,F-II,1,0,0,0,0,1,0
20130701-W-Wimbledon-R16-Sabine_Lisicki-Serena_Williams,2,B-XC,26,5,1,1,3,14,12
20130701-W-Wimbledon-R16-Sabine_Lisicki-Serena_Williams,2,B-DTM,32,2,0,0,2,10,22
20130701-W-Wimbledon-R16-Sabine_Lisicki-Serena_Williams,2,B-DTL,21,7,1,0,6,10,11
20130701-W-Wimbledon-R16-Sabine_Lisicki-Serena_Williams,2,B-IO,9,4,0,1,3,2,7
20091028-W-WTA_Championships-RR-Venus_Williams-Serena_Williams,1,F-XC,49,17,5,1,11,23,26
20091028-W-WTA_Championships-RR-Venus_Williams-Serena_Williams,1,F-DTM,30,6,1,1,4,16,14
20091028-W-WTA_Championships-RR-Venus_Williams-Serena_Williams,1,F-DTL,24,10,5,0,5,14,10
20091028-W-WTA_Championships-RR-Venus_Williams-Serena_Williams,1,F-IO,28,15,9,4,2,23,5
20091028-W-WTA_Championships-RR-Venus_Williams-Serena_Williams,1,F-II,1,1,1,0,0,1,0
20091028-W-WTA_Championships-RR-Venus_Williams-Serena_Williams,1,B-XC,40,8,2,0,6,20,20
20091028-W-WTA_Championships-RR-Venus_Williams-Serena_Williams,1,B-DTM,24,3,0,0,3,12,12
20091028-W-WTA_Championships-RR-Venus_Williams-Serena_Williams,1,B-DTL,15,7,2,0,5,7,8
20091028-W-WTA_Championships-RR-Venus_Williams-Serena_Williams,1,B-IO,5,1,1,0,0,3,2
20091028-W-WTA_Championships-RR-Venus_Williams-Serena_Williams,1,S-XC,2,0,0,0,0,0,2
20091028-W-WTA_Championships-RR-Venus_Williams-Serena_Williams,1,S-DTM,7,1,0,1,0,3,4
20091028-W-WTA_Championships-RR-Venus_Williams-Serena_Williams,2,F-XC,49,17,4,1,11,20,29
20091028-W-WTA_Championships-RR-Venus_Williams-Serena_Williams,2,F-DTM,23,2,0,1,1,9,14
20091028-W-WTA_Championships-RR-Venus_Williams-Serena_Williams,2,F-DTL,15,9,4,1,4,9,6
20091028-W-WTA_Championships-RR-Venus_Williams-Serena_Williams,2,F-IO,17,6,1,1,4,9,8
20091028-W-WTA_Championships-RR-Venus_Williams-Serena_Williams,2,B-XC,45,9,0,1,8,18,27
20091028-W-WTA_Championships-RR-Venus_Williams-Serena_Williams,2,B-DTM,36,2,0,0,2,13,23
20091028-W-WTA_Championships-RR-Venus_Williams-Serena_Williams,2,B-DTL,22,4,2,0,2,11,11
20091028-W-WTA_Championships-RR-Venus_Williams-Serena_Williams,2,B-IO,10,3,1,1,1,7,3
20091028-W-WTA_Championships-RR-Venus_Williams-Serena_Williams,2,S-XC,2,1,0,0,1,0,2
20091028-W-WTA_Championships-RR-Venus_Williams-Serena_Williams,2,S-DTM,1,0,0,0,0,0,1
20000928-W-Olympics-F-Elena_Dementieva-Venus_Williams,1,F-XC,15,0,0,0,0,8,7
20000928-W-Olympics-F-Elena_Dementieva-Venus_Williams,1,F-DTM,8,2,0,0,2,2,6
20000928-W-Olympics-F-Elena_Dementieva-Venus_Williams,1,F-DTL,3,1,0,1,0,2,1
20000928-W-Olympics-F-Elena_Dementieva-Venus_Williams,1,F-IO,13,7,2,2,3,9,4
20000928-W-Olympics-F-Elena_Dementieva-Venus_Williams,1,F-II,1,1,1,0,0,1,0
20000928-W-Olympics-F-Elena_Dementieva-Venus_Williams,1,B-XC,27,6,1,0,5,10,17
20000928-W-Olympics-F-Elena_Dementieva-Venus_Williams,1,B-DTM,27,2,0,0,2,9,18
20000928-W-Olympics-F-Elena_Dementieva-Venus_Williams,1,B-DTL,15,4,0,3,1,8,7
20000928-W-Olympics-F-Elena_Dementieva-Venus_Williams,1,B-IO,7,4,0,0,4,1,6
20000928-W-Olympics-F-Elena_Dementieva-Venus_Williams,2,F-XC,15,9,2,3,4,7,8
20000928-W-Olympics-F-Elena_Dementieva-Venus_Williams,2,F-DTM,11,2,0,0,2,6,5
20000928-W-Olympics-F-Elena_Dementieva-Venus_Williams,2,F-DTL,16,7,4,0,3,10,6
20000928-W-Olympics-F-Elena_Dementieva-Venus_Williams,2,F-IO,11,3,0,0,3,5,6
20000928-W-Olympics-F-Elena_Dementieva-Venus_Williams,2,B-XC,30,12,1,6,5,16,14
20000928-W-Olympics-F-Elena_Dementieva-Venus_Williams,2,B-DTM,7,0,0,0,0,3,4
20000928-W-Olympics-F-Elena_Dementieva-Venus_Williams,2,B-DTL,13,8,3,1,4,6,7
20000928-W-Olympics-F-Elena_Dementieva-Venus_Williams,2,B-IO,5,2,0,1,1,4,1
20000928-W-Olympics-F-Elena_Dementieva-Venus_Williams,2,B-II,1,0,0,0,0,1,0
20000928-W-Olympics-F-Elena_Dementieva-Venus_Williams,2,S-XC,1,0,0,0,0,0,1
20000928-W-Olympics-F-Elena_Dementieva-Venus_Williams,2,S-DTM,1,0,0,0,0,0,1
20100109-W-Brisbane-F-Kim_Clijsters-Justine_Henin,1,F-XC,77,23,5,7,11,46,31
20100109-W-Brisbane-F-Kim_Clijsters-Justine_Henin,1,F-DTM,14,0,0,0,0,8,6
20100109-W-Brisbane-F-Kim_Clijsters-Justine_Henin,1,F-DTL,21,9,3,3,3,13,8
20100109-W-Brisbane-F-Kim_Clijsters-Justine_Henin,1,F-IO,25,7,3,0,4,12,13
20100109-W-Brisbane-F-Kim_Clijsters-Justine_Henin,1,F-II,2,1,0,0,1,1,1
20100109-W-Brisbane-F-Kim_Clijsters-Justine_Henin,1,B-XC,104,13,2,3,8,53,51
20100109-W-Brisbane-F-Kim_Clijsters-Justine_Henin,1,B-DTM,9,1,0,0,1,6,3
20100109-W-Brisbane-F-Kim_Clijsters-Justine_Henin,1,B-DTL,25,11,4,1,6,12,13
20100109-W-Brisbane-F-Kim_Clijsters-Justine_Henin,1,B-IO,5,1,1,0,0,2,3
20100109-W-Brisbane-F-Kim_Clijsters-Justine_Henin,1,S-XC,16,0,0,0,0,10,6
20100109-W-Brisbane-F-Kim_Clijsters-Justine_Henin,1,S-DTM,2,0,0,0,0,0,2
20100109-W-Brisbane-F-Kim_Clijsters-Justine_Henin,1,S-DTL,4,1,0,1,0,2,2
20100109-W-Brisbane-F-Kim_Clijsters-Justine_Henin,1,S-IO,1,0,0,0,0,1,0
20100109-W-Brisbane-F-Kim_Clijsters-Justine_Henin,2,F-XC,64,13,4,4,5,28,36
20100109-W-Brisbane-F-Kim_Clijsters-Justine_Henin,2,F-DTM,20,1,0,0,1,12,8
20100109-W-Brisbane-F-Kim_Clijsters-Justine_Henin,2,F-DTL,31,7,2,1,4,12,19
20100109-W-Brisbane-F-Kim_Clijsters-Justine_Henin,2,F-IO,17,8,2,2,4,9,8
20100109-W-Brisbane-F-Kim_Clijsters-Justine_Henin,2,F-II,1,0,0,0,0,0,1
20100109-W-Brisbane-F-Kim_Clijsters-Justine_Henin,2,B-XC,71,15,1,4,10,34,37
20100109-W-Brisbane-F-Kim_Clijsters-Justine_Henin,2,B-DTM,26,1,0,0,1,7,19
20100109-W-Brisbane-F-Kim_Clijsters-Justine_Henin,2,B-DTL,18,9,5,0,4,9,9
20100109-W-Brisbane-F-Kim_Clijsters-Justine_Henin,2,B-IO,4,2,1,0,1,1,3
20100109-W-Brisbane-F-Kim_Clijsters-Justine_Henin,2,S-XC,35,1,0,0,1,19,16
20100109-W-Brisbane-F-Kim_Clijsters-Justine_Henin,2,S-DTM,15,0,0,0,0,6,9
20100109-W-Brisbane-F-Kim_Clijsters-Justine_Henin,2,S-DTL,5,1,0,0,1,2,3
20100109-W-Brisbane-F-Kim_Clijsters-Justine_Henin,2,S-IO,1,0,0,0,0,1,0
20080903-W-US_Open-QF-Serena_Williams-Venus_Williams,1,F-XC,58,8,2,1,5,30,28
20080903-W-US_Open-QF-Serena_Williams-Venus_Williams,1,F-DTM,23,1,0,0,1,12,11
20080903-W-US_Open-QF-Serena_Williams-Venus_Williams,1,F-DTL,21,7,1,3,3,10,11
20080903-W-US_Open-QF-Serena_Williams-Venus_Williams,1,F-IO,28,5,3,1,1,18,10
20080903-W-US_Open-QF-Serena_Williams-Venus_Williams,1,F-II,1,0,0,0,0,0,1
20080903-W-US_Open-QF-Serena_Williams-Venus_Williams,1,B-XC,49,4,0,1,3,25,24
20080903-W-US_Open-QF-Serena_Williams-Venus_Williams,1,B-DTM,27,1,0,0,1,12,15
20080903-W-US_Open-QF-Serena_Williams-Venus_Williams,1,B-DTL,22,12,3,2,7,12,10
20080903-W-US_Open-QF-Serena_Williams-Venus_Williams,1,B-IO,10,3,1,0,2,3,7
20080903-W-US_Open-QF-Serena_Williams-Venus_Williams,1,B-II,1,0,0,0,0,1,0
20080903-W-US_Open-QF-Serena_Williams-Venus_Williams,1,S-XC,2,1,0,1,0,1,1
20080903-W-US_Open-QF-Serena_Williams-Venus_Williams,1,S-DTM,1,1,0,0,1,0,1
20080903-W-US_Open-QF-Serena_Williams-Venus_Williams,2,F-XC,61,15,4,0,11,28,33
20080903-W-US_Open-QF-Serena_Williams-Venus_Williams,2,F-DTM,22,1,0,1,0,8,14
20080903-W-US_Open-QF-Serena_Williams-Venus_Williams,2,F-DTL,31,15,6,3,6,20,11
20080903-W-US_Open-QF-Serena_Williams-Venus_Williams,2,F-IO,20,11,5,4,2,15,5
20080903-W-US_Open-QF-Serena_Williams-Venus_Williams,2,B-XC,55,8,1,3,4,26,29
20080903-W-US_Open-QF-Serena_Williams-Venus_Williams,2,B-DTM,26,7,1,0,6,8,18
20080903-W-US_Open-QF-Serena_Williams-Venus_Williams,2,B-DTL,23,7,1,2,4,12,11
20080903-W-US_Open-QF-Serena_Williams-Venus_Williams,2,B-IO,7,3,0,1,2,1,6
20080903-W-US_Open-QF-Serena_Williams-Venus_Williams,2,S-DTM,7,0,0,0,0,3,4
20070623-W-Eastbourne-F-Amelie_Mauresmo-Justine_Henin,1,F-XC,19,6,2,1,3,7,12
20070623-W-Eastbourne-F-Amelie_Mauresmo-Justine_Henin,1,F-DTM,6,2,0,0,2,1,5
20070623-W-Eastbourne-F-Amelie_Mauresmo-Justine_Henin,1,F-DTL,10,1,1,0,0,7,3
20070623-W-Eastbourne-F-Amelie_Mauresmo-Justine_Henin,1,F-IO,20,5,1,1,3,13,7
20070623-W-Eastbourne-F-Amelie_Mauresmo-Justine_Henin,1,F-II,1,1,0,0,1,0,1
20070623-W-Eastbourne-F-Amelie_Mauresmo-Justine_Henin,1,B-XC,9,2,1,0,1,3,6
20070623-W-Eastbourne-F-Amelie_Mauresmo-Justine_Henin,1,B-DTM,13,0,0,0,0,2,11
20070623-W-Eastbourne-F-Amelie_Mauresmo-Justine_Henin,1,B-DTL,8,4,1,1,2,5,3
20070623-W-Eastbourne-F-Amelie_Mauresmo-Justine_Henin,1,B-IO,3,1,0,1,0,2,1
20070623-W-Eastbourne-F-Amelie_Mauresmo-Justine_Henin,1,S-XC,7,2,0,1,1,4,3
20070623-W-Eastbourne-F-Amelie_Mauresmo-Justine_Henin,1,S-DTM,2,0,0,0,0,2,0
20070623-W-Eastbourne-F-Amelie_Mauresmo-Justine_Henin,1,S-DTL,2,0,0,0,0,0,2
20070623-W-Eastbourne-F-Amelie_Mauresmo-Justine_Henin,2,F-XC,32,17,8,4,5,22,10
20070623-W-Eastbourne-F-Amelie_Mauresmo-Justine_Henin,2,F-DTM,17,0,0,0,0,7,10
20070623-W-Eastbourne-F-Amelie_Mauresmo-Justine_Henin,2,F-DTL,15,11,6,1,4,9,6
20070623-W-Eastbourne-F-Amelie_Mauresmo-Justine_Henin,2,F-IO,15,6,2,3,1,10,5
20070623-W-Eastbourne-F-Amelie_Mauresmo-Justine_Henin,2,F-II,4,2,2,0,0,3,1
20070623-W-Eastbourne-F-Amelie_Mauresmo-Justine_Henin,2,B-XC,20,6,2,1,3,8,12
20070623-W-Eastbourne-F-Amelie_Mauresmo-Justine_Henin,2,B-DTM,8,0,0,0,0,4,4
20070623-W-Eastbourne-F-Amelie_Mauresmo-Justine_Henin,2,B-DTL,7,3,0,0,3,2,5
20070623-W-Eastbourne-F-Amelie_Mauresmo-Justine_Henin,2,B-IO,4,1,1,0,0,3,1
20070623-W-Eastbourne-F-Amelie_Mauresmo-Justine_Henin,2,S-XC,5,0,0,0,0,2,3
20070623-W-Eastbourne-F-Amelie_Mauresmo-Justine_Henin,2,S-DTM,5,1,0,0,1,0,5
20000816-W-Montreal-R32-Justine_Henin-Lindsay_Davenport,1,F-XC,34,15,4,8,3,22,12
20000816-W-Montreal-R32-Justine_Henin-Lindsay_Davenport,1,F-DTM,26,1,0,0,1,11,15
20000816-W-Montreal-R32-Justine_Henin-Lindsay_Davenport,1,F-DTL,18,6,1,1,4,10,8
20000816-W-Montreal-R32-Justine_Henin-Lindsay_Davenport,1,F-IO,14,3,0,1,2,10,4
20000816-W-Montreal-R32-Justine_Henin-Lindsay_Davenport,1,B-XC,32,10,4,2,4,17,15
20000816-W-Montreal-R32-Justine_Henin-Lindsay_Davenport,1,B-DTM,24,1,0,0,1,6,18
20000816-W-Montreal-R32-Justine_Henin-Lindsay_Davenport,1,B-DTL,9,8,2,1,5,3,6
20000816-W-Montreal-R32-Justine_Henin-Lindsay_Davenport,1,B-IO,4,3,1,1,1,2,2
20000816-W-Montreal-R32-Justine_Henin-Lindsay_Davenport,1,S-XC,30,2,0,1,1,12,18
20000816-W-Montreal-R32-Justine_Henin-Lindsay_Davenport,1,S-DTM,17,1,0,0,1,7,10
20000816-W-Montreal-R32-Justine_Henin-Lindsay_Davenport,1,S-DTL,6,3,1,1,1,2,4
20000816-W-Montreal-R32-Justine_Henin-Lindsay_Davenport,2,F-XC,48,17,3,7,7,28,20
20000816-W-Montreal-R32-Justine_Henin-Lindsay_Davenport,2,F-DTM,17,2,0,0,2,6,11
20000816-W-Montreal-R32-Justine_Henin-Lindsay_Davenport,2,F-DTL,10,6,3,1,2,7,3
20000816-W-Montreal-R32-Justine_Henin-Lindsay_Davenport,2,F-IO,21,5,1,2,2,15,6
20000816-W-Montreal-R32-Justine_Henin-Lindsay_Davenport,2,F-II,2,1,0,1,0,2,0
20000816-W-Montreal-R32-Justine_Henin-Lindsay_Davenport,2,B-XC,64,7,0,4,3,39,25
20000816-W-Montreal-R32-Justine_Henin-Lindsay_Davenport,2,B-DTM,20,2,0,0,2,9,11
20000816-W-Montreal-R32-Justine_Henin-Lindsay_Davenport,2,B-DTL,13,4,0,2,2,3,10
20000816-W-Montreal-R32-Justine_Henin-Lindsay_Davenport,2,B-IO,10,5,2,2,1,7,3
20000816-W-Montreal-R32-Justine_Henin-Lindsay_Davenport,2,S-XC,7,1,0,1,0,1,6
20000816-W-Montreal-R32-Justine_Henin-Lindsay_Davenport,2,S-DTL,2,0,0,0,0,0,2
20150506-W-Madrid-R16-Serena_Williams-Victoria_Azarenka,1,F-XC,44,19,7,4,8,25,19
20150506-W-Madrid-R16-Serena_Williams-Victoria_Azarenka,1,F-DTM,8,2,0,0,2,4,4
20150506-W-Madrid-R16-Serena_Williams-Victoria_Azarenka,1,F-DTL,17,8,2,3,3,11,6
20150506-W-Madrid-R16-Serena_Williams-Victoria_Azarenka,1,F-IO,8,6,2,0,4,4,4
20150506-W-Madrid-R16-Serena_Williams-Victoria_Azarenka,1,B-XC,44,12,3,1,8,16,28
20150506-W-Madrid-R16-Serena_Williams-Victoria_Azarenka,1,B-DTM,19,5,0,0,5,6,13
20150506-W-Madrid-R16-Serena_Williams-Victoria_Azarenka,1,B-DTL,26,12,7,1,4,14,12
20150506-W-Madrid-R16-Serena_Williams-Victoria_Azarenka,1,B-IO,5,1,0,1,0,3,2
20150506-W-Madrid-R16-Serena_Williams-Victoria_Azarenka,2,F-XC,29,6,1,4,1,13,16
20150506-W-Madrid-R16-Serena_Williams-Victoria_Azarenka,2,F-DTM,4,0,0,0,0,2,2
20150506-W-Madrid-R16-Serena_Williams-Victoria_Azarenka,2,F-DTL,21,4,1,2,1,13,8
20150506-W-Madrid-R16-Serena_Williams-Victoria_Azarenka,2,F-IO,21,8,3,3,2,16,5
20150506-W-Madrid-R16-Serena_Williams-Victoria_Azarenka,2,F-II,1,1,0,0,1,0,1
20150506-W-Madrid-R16-Serena_Williams-Victoria_Azarenka,2,B-XC,38,9,0,4,5,24,14
20150506-W-Madrid-R16-Serena_Williams-Victoria_Azarenka,2,B-DTM,15,2,0,0,2,6,9
20150506-W-Madrid-R16-Serena_Williams-Victoria_Azarenka,2,B-DTL,11,5,0,3,2,5,6
20150506-W-Madrid-R16-Serena_Williams-Victoria_Azarenka,2,B-IO,8,5,2,0,3,4,4
20150506-W-Madrid-R16-Serena_Williams-Victoria_Azarenka,2,B-II,1,0,0,0,0,0,1
20150506-W-Madrid-R16-Serena_Williams-Victoria_Azarenka,2,S-XC,2,0,0,0,0,1,1
20150506-W-Madrid-R16-Serena_Williams-Victoria_Azarenka,2,S-DTM,4,0,0,0,0,2,2
19911124-W-Virginia_Slims_Championships-F-Martina_Navratilova-Monica_Seles,1,F-XC,28,6,0,2,4,11,17
19911124-W-Virginia_Slims_Championships-F-Martina_Navratilova-Monica_Seles,1,F-DTM,6,1,0,0,1,2,4
19911124-W-Virginia_Slims_Championships-F-Martina_Navratilova-Monica_Seles,1,F-DTL,6,1,0,1,0,3,3
19911124-W-Virginia_Slims_Championships-F-Martina_Navratilova-Monica_Seles,1,F-IO,6,1,0,1,0,3,3
19911124-W-Virginia_Slims_Championships-F-Martina_Navratilova-Monica_Seles,1,B-XC,9,2,0,0,2,1,8
19911124-W-Virginia_Slims_Championships-F-Martina_Navratilova-Monica_Seles,1,B-DTM,9,1,0,0,1,3,6
19911124-W-Virginia_Slims_Championships-F-Martina_Navratilova-Monica_Seles,1,B-DTL,5,1,0,0,1,2,3
19911124-W-Virginia_Slims_Championships-F-Martina_Navratilova-Monica_Seles,1,S-XC,25,2,0,1,1,9,16
19911124-W-Virginia_Slims_Championships-F-Martina_Navratilova-Monica_Seles,1,S-DTM,23,1,0,0,1,10,13
19911124-W-Virginia_Slims_Championships-F-Martina_Navratilova-Monica_Seles,1,S-DTL,16,3,0,1,2,8,8
19911124-W-Virginia_Slims_Championships-F-Martina_Navratilova-Monica_Seles,1,S-IO,7,2,0,1,1,4,3
19911124-W-Virginia_Slims_Championships-F-Martina_Navratilova-Monica_Seles,2,F-XC,46,19,9,3,7,25,21
19911124-W-Virginia_Slims_Championships-F-Martina_Navratilova-Monica_Seles,2,F-DTM,13,0,0,0,0,9,4
19911124-W-Virginia_Slims_Championships-F-Martina_Navratilova-Monica_Seles,2,F-DTL,30,11,4,3,4,14,16
19911124-W-Virginia_Slims_Championships-F-Martina_Navratilova-Monica_Seles,2,F-IO,19,2,0,1,1,13,6
19911124-W-Virginia_Slims_Championships-F-Martina_Navratilova-Monica_Seles,2,B-XC,75,17,6,8,3,51,24
19911124-W-Virginia_Slims_Championships-F-Martina_Navratilova-Monica_Seles,2,B-DTM,13,3,0,1,2,4,9
19911124-W-Virginia_Slims_Championships-F-Martina_Navratilova-Monica_Seles,2,B-DTL,10,6,4,2,0,7,3
19911124-W-Virginia_Slims_Championships-F-Martina_Navratilova-Monica_Seles,2,B-IO,6,3,2,0,1,3,3
19911124-W-Virginia_Slims_Championships-F-Martina_Navratilova-Monica_Seles,2,S-XC,2,0,0,0,0,0,2
19911124-W-Virginia_Slims_Championships-F-Martina_Navratilova-Monica_Seles,2,S-DTM,4,0,0,0,0,2,2
20191001-W-Beijing-R32-Yulia_Putintseva-Ashleigh_Barty,1,F-XC,36,11,5,2,4,19,17
20191001-W-Beijing-R32-Yulia_Putintseva-Ashleigh_Barty,1,F-DTM,28,2,0,0,2,13,15
20191001-W-Beijing-R32-Yulia_Putintseva-Ashleigh_Barty,1,F-DTL,9,2,0,0,2,4,5
20191001-W-Beijing-R32-Yulia_Putintseva-Ashleigh_Barty,1,F-IO,23,2,0,0,2,9,14
20191001-W-Beijing-R32-Yulia_Putintseva-Ashleigh_Barty,1,F-II,3,1,0,1,0,3,0
20191001-W-Beijing-R32-Yulia_Putintseva-Ashleigh_Barty,1,B-XC,29,4,0,2,2,16,13
20191001-W-Beijing-R32-Yulia_Putintseva-Ashleigh_Barty,1,B-DTM,20,3,0,0,3,10,10
20191001-W-Beijing-R32-Yulia_Putintseva-Ashleigh_Barty,1,B-DTL,6,1,0,0,1,0,6
20191001-W-Beijing-R32-Yulia_Putintseva-Ashleigh_Barty,1,B-IO,3,0,0,0,0,2,1
20191001-W-Beijing-R32-Yulia_Putintseva-Ashleigh_Barty,1,S-XC,13,1,0,1,0,5,8
20191001-W-Beijing-R32-Yulia_Putintseva-Ashleigh_Barty,1,S-DTM,11,0,0,0,0,4,7
20191001-W-Beijing-R32-Yulia_Putintseva-Ashleigh_Barty,1,S-DTL,3,2,0,0,2,0,3
20191001-W-Beijing-R32-Yulia_Putintseva-Ashleigh_Barty,1,S-IO,4,1,0,1,0,4,0
20191001-W-Beijing-R32-Yulia_Putintseva-Ashleigh_Barty,2,F-XC,40,14,5,2,7,19,21
20191001-W-Beijing-R32-Yulia_Putintseva-Ashleigh_Barty,2,F-DTM,28,6,1,1,4,13,15
20191001-W-Beijing-R32-Yulia_Putintseva-Ashleigh_Barty,2,F-DTL,6,2,0,0,2,3,3
20191001-W-Beijing-R32-Yulia_Putintseva-Ashleigh_Barty,2,F-IO,29,7,5,1,1,19,10
20191001-W-Beijing-R32-Yulia_Putintseva-Ashleigh_Barty,2,F-II,2,2,1,0,1,1,1
20191001-W-Beijing-R32-Yulia_Putintseva-Ashleigh_Barty,2,B-XC,22,2,0,0,2,12,10
20191001-W-Beijing-R32-Yulia_Putintseva-Ashleigh_Barty,2,B-DTM,16,2,0,1,1,8,8
20191001-W-Beijing-R32-Yulia_Putintseva-Ashleigh_Barty,2,B-DTL,2,2,0,1,1,1,1
20191001-W-Beijing-R32-Yulia_Putintseva-Ashleigh_Barty,2,B-IO,2,1,0,0,1,1,1
20191001-W-Beijing-R32-Yulia_Putintseva-Ashleigh_Barty,2,S-XC,25,3,0,1,2,17,8
20191001-W-Beijing-R32-Yulia_Putintseva-Ashleigh_Barty,2,S-DTM,11,2,0,0,2,1,10
20191001-W-Beijing-R32-Yulia_Putintseva-Ashleigh_Barty,2,S-DTL,1,1,1,0,0,1,0
20191001-W-Beijing-R32-Yulia_Putintseva-Ashleigh_Barty,2,S-IO,2,1,0,1,0,2,0
20191002-W-Beijing-R16-Ashleigh_Barty-Saisai_Zheng,1,F-XC,52,21,5,7,9,30,22
20191002-W-Beijing-R16-Ashleigh_Barty-Saisai_Zheng,1,F-DTM,18,1,1,0,0,12,6
20191002-W-Beijing-R16-Ashleigh_Barty-Saisai_Zheng,1,F-DTL,10,8,6,0,2,6,4
20191002-W-Beijing-R16-Ashleigh_Barty-Saisai_Zheng,1,F-IO,42,13,5,3,5,24,18
20191002-W-Beijing-R16-Ashleigh_Barty-Saisai_Zheng,1,F-II,5,2,1,0,1,3,2
20191002-W-Beijing-R16-Ashleigh_Barty-Saisai_Zheng,1,B-XC,17,3,1,1,1,10,7
20191002-W-Beijing-R16-Ashleigh_Barty-Saisai_Zheng,1,B-DTM,48,6,0,0,6,17,31
20191002-W-Beijing-R16-Ashleigh_Barty-Saisai_Zheng,1,B-DTL,10,3,0,0,3,2,8
20191002-W-Beijing-R16-Ashleigh_Barty-Saisai_Zheng,1,B-IO,1,0,0,0,0,1,0
20191002-W-Beijing-R16-Ashleigh_Barty-Saisai_Zheng,1,S-XC,27,4,1,0,3,14,13
20191002-W-Beijing-R16-Ashleigh_Barty-Saisai_Zheng,1,S-DTM,19,2,0,0,2,9,10
20191002-W-Beijing-R16-Ashleigh_Barty-Saisai_Zheng,1,S-DTL,8,2,0,1,1,4,4
20191002-W-Beijing-R16-Ashleigh_Barty-Saisai_Zheng,1,S-IO,4,1,0,0,1,0,4
20191002-W-Beijing-R16-Ashleigh_Barty-Saisai_Zheng,2,F-XC,23,10,3,4,3,14,9
20191002-W-Beijing-R16-Ashleigh_Barty-Saisai_Zheng,2,F-DTM,36,4,0,0,4,13,23
20191002-W-Beijing-R16-Ashleigh_Barty-Saisai_Zheng,2,F-DTL,32,4,0,0,4,17,15
20191002-W-Beijing-R16-Ashleigh_Barty-Saisai_Zheng,2,F-IO,48,8,0,3,5,27,21
20191002-W-Beijing-R16-Ashleigh_Barty-Saisai_Zheng,2,B-XC,41,3,0,0,3,24,17
20191002-W-Beijing-R16-Ashleigh_Barty-Saisai_Zheng,2,B-DTM,27,1,0,1,0,18,9
20191002-W-Beijing-R16-Ashleigh_Barty-Saisai_Zheng,2,B-DTL,8,3,1,0,2,2,6
20191002-W-Beijing-R16-Ashleigh_Barty-Saisai_Zheng,2,B-IO,8,2,0,2,0,5,3
20191002-W-Beijing-R16-Ashleigh_Barty-Saisai_Zheng,2,S-XC,9,0,0,0,0,3,6
20191002-W-Beijing-R16-Ashleigh_Barty-Saisai_Zheng,2,S-DTM,12,1,0,0,1,5,7
20191002-W-Beijing-R16-Ashleigh_Barty-Saisai_Zheng,2,S-DTL,8,3,1,1,1,3,5
20200106-W-Brisbane-R32-Danielle_Collins-Elina_Svitolina,1,F-XC,20,7,3,3,1,16,4
20200106-W-Brisbane-R32-Danielle_Collins-Elina_Svitolina,1,F-DTM,5,0,0,0,0,4,1
20200106-W-Brisbane-R32-Danielle_Collins-Elina_Svitolina,1,F-DTL,4,3,2,0,1,3,1
20200106-W-Brisbane-R32-Danielle_Collins-Elina_Svitolina,1,F-IO,6,5,3,0,2,4,2
20200106-W-Brisbane-R32-Danielle_Collins-Elina_Svitolina,1,B-XC,18,13,4,5,4,12,6
20200106-W-Brisbane-R32-Danielle_Collins-Elina_Svitolina,1,B-DTM,18,3,0,2,1,7,11
20200106-W-Brisbane-R32-Danielle_Collins-Elina_Svitolina,1,B-DTL,2,2,2,0,0,2,0
20200106-W-Brisbane-R32-Danielle_Collins-Elina_Svitolina,1,B-IO,3,1,0,0,1,1,2
20200106-W-Brisbane-R32-Danielle_Collins-Elina_Svitolina,2,F-XC,13,5,1,1,3,4,9
20200106-W-Brisbane-R32-Danielle_Collins-Elina_Svitolina,2,F-DTM,11,2,0,0,2,3,8
20200106-W-Brisbane-R32-Danielle_Collins-Elina_Svitolina,2,F-DTL,5,2,0,1,1,2,3
20200106-W-Brisbane-R32-Danielle_Collins-Elina_Svitolina,2,F-IO,5,2,0,1,1,2,3
20200106-W-Brisbane-R32-Danielle_Collins-Elina_Svitolina,2,B-XC,13,2,0,0,2,6,7
20200106-W-Brisbane-R32-Danielle_Collins-Elina_Svitolina,2,B-DTM,11,1,0,0,1,5,6
20200106-W-Brisbane-R32-Danielle_Collins-Elina_Svitolina,2,B-IO,3,1,0,1,0,1,2
20200106-W-Brisbane-R32-Danielle_Collins-Elina_Svitolina,2,S-XC,1,0,0,0,0,0,1
20200106-W-Brisbane-R32-Danielle_Collins-Elina_Svitolina,2,S-DTM,1,0,0,0,0,0,1
20150223-W-Doha-R32-Flavia_Pennetta-Svetlana_Kuznetsova,1,F-XC,65,15,4,7,4,42,23
20150223-W-Doha-R32-Flavia_Pennetta-Svetlana_Kuznetsova,1,F-DTM,27,3,0,1,2,13,14
20150223-W-Doha-R32-Flavia_Pennetta-Svetlana_Kuznetsova,1,F-DTL,18,7,4,1,2,11,7
20150223-W-Doha-R32-Flavia_Pennetta-Svetlana_Kuznetsova,1,F-IO,7,2,1,0,1,4,3
20150223-W-Doha-R32-Flavia_Pennetta-Svetlana_Kuznetsova,1,B-XC,59,15,6,4,5,31,28
20150223-W-Doha-R32-Flavia_Pennetta-Svetlana_Kuznetsova,1,B-DTM,29,1,0,1,0,14,15
20150223-W-Doha-R32-Flavia_Pennetta-Svetlana_Kuznetsova,1,B-DTL,15,11,6,2,3,8,7
20150223-W-Doha-R32-Flavia_Pennetta-Svetlana_Kuznetsova,1,B-IO,3,2,0,0,2,1,2
20150223-W-Doha-R32-Flavia_Pennetta-Svetlana_Kuznetsova,1,S-XC,2,0,0,0,0,0,2
20150223-W-Doha-R32-Flavia_Pennetta-Svetlana_Kuznetsova,1,S-DTM,7,0,0,0,0,1,6
20150223-W-Doha-R32-Flavia_Pennetta-Svetlana_Kuznetsova,1,S-DTL,4,2,0,2,0,2,2
20150223-W-Doha-R32-Flavia_Pennetta-Svetlana_Kuznetsova,2,F-XC,64,15,6,7,2,35,29
20150223-W-Doha-R32-Flavia_Pennetta-Svetlana_Kuznetsova,2,F-DTM,27,3,0,1,2,10,17
20150223-W-Doha-R32-Flavia_Pennetta-Svetlana_Kuznetsova,2,F-DTL,21,7,5,1,1,12,9
20150223-W-Doha-R32-Flavia_Pennetta-Svetlana_Kuznetsova,2,F-IO,13,5,3,0,2,10,3
20150223-W-Doha-R32-Flavia_Pennetta-Svetlana_Kuznetsova,2,F-II,1,1,1,0,0,1,0
20150223-W-Doha-R32-Flavia_Pennetta-Svetlana_Kuznetsova,2,B-XC,51,9,0,3,6,26,25
20150223-W-Doha-R32-Flavia_Pennetta-Svetlana_Kuznetsova,2,B-DTM,29,2,0,0,2,14,15
20150223-W-Doha-R32-Flavia_Pennetta-Svetlana_Kuznetsova,2,B-DTL,6,3,1,0,2,3,3
20150223-W-Doha-R32-Flavia_Pennetta-Svetlana_Kuznetsova,2,B-IO,8,2,1,0,1,4,4
20150223-W-Doha-R32-Flavia_Pennetta-Svetlana_Kuznetsova,2,S-XC,5,1,0,0,1,0,5
20150223-W-Doha-R32-Flavia_Pennetta-Svetlana_Kuznetsova,2,S-DTL,1,0,0,0,0,1,0
20200124-W-Australian_Open-R32-Ashleigh_Barty-Elena_Rybakina,1,F-XC,63,11,3,3,5,36,27
20200124-W-Australian_Open-R32-Ashleigh_Barty-Elena_Rybakina,1,F-DTM,27,4,1,0,3,10,17
20200124-W-Australian_Open-R32-Ashleigh_Barty-Elena_Rybakina,1,F-DTL,5,2,2,0,0,3,2
20200124-W-Australian_Open-R32-Ashleigh_Barty-Elena_Rybakina,1,F-IO,22,8,4,3,1,14,8
20200124-W-Australian_Open-R32-Ashleigh_Barty-Elena_Rybakina,1,F-II,5,3,2,0,1,4,1
20200124-W-Australian_Open-R32-Ashleigh_Barty-Elena_Rybakina,1,B-XC,14,2,1,0,1,6,8
20200124-W-Australian_Open-R32-Ashleigh_Barty-Elena_Rybakina,1,B-DTM,10,1,0,0,1,5,5
20200124-W-Australian_Open-R32-Ashleigh_Barty-Elena_Rybakina,1,B-DTL,1,1,0,1,0,1,0
20200124-W-Australian_Open-R32-Ashleigh_Barty-Elena_Rybakina,1,S-XC,15,0,0,0,0,6,9
20200124-W-Australian_Open-R32-Ashleigh_Barty-Elena_Rybakina,1,S-DTM,17,1,0,0,1,9,8
20200124-W-Australian_Open-R32-Ashleigh_Barty-Elena_Rybakina,1,S-DTL,5,1,1,0,0,3,2
20200124-W-Australian_Open-R32-Ashleigh_Barty-Elena_Rybakina,1,S-IO,2,0,0,0,0,2,0
20200124-W-Australian_Open-R32-Ashleigh_Barty-Elena_Rybakina,2,F-XC,52,8,5,1,2,28,24
20200124-W-Australian_Open-R32-Ashleigh_Barty-Elena_Rybakina,2,F-DTM,21,3,0,0,3,6,15
20200124-W-Australian_Open-R32-Ashleigh_Barty-Elena_Rybakina,2,F-DTL,11,3,1,0,2,4,7
20200124-W-Australian_Open-R32-Ashleigh_Barty-Elena_Rybakina,2,F-IO,8,1,0,0,1,3,5
20200124-W-Australian_Open-R32-Ashleigh_Barty-Elena_Rybakina,2,B-XC,24,4,1,1,2,14,10
20200124-W-Australian_Open-R32-Ashleigh_Barty-Elena_Rybakina,2,B-DTM,32,2,0,0,2,15,17
20200124-W-Australian_Open-R32-Ashleigh_Barty-Elena_Rybakina,2,B-DTL,10,7,4,1,2,7,3
20200124-W-Australian_Open-R32-Ashleigh_Barty-Elena_Rybakina,2,B-IO,10,7,2,3,2,6,4
20200124-W-Australian_Open-R32-Ashleigh_Barty-Elena_Rybakina,2,S-XC,6,0,0,0,0,3,3
20200124-W-Australian_Open-R32-Ashleigh_Barty-Elena_Rybakina,2,S-DTM,10,2,0,0,2,2,8
20200124-W-Australian_Open-R32-Ashleigh_Barty-Elena_Rybakina,2,S-DTL,1,0,0,0,0,1,0
20200124-W-Australian_Open-R32-Ashleigh_Barty-Elena_Rybakina,2,S-IO,2,2,0,0,2,0,2
20200125-W-Australian_Open-R32-Garbine_Muguruza-Elina_Svitolina,1,F-XC,39,7,6,1,0,24,15
20200125-W-Australian_Open-R32-Garbine_Muguruza-Elina_Svitolina,1,F-DTM,13,1,0,0,1,8,5
20200125-W-Australian_Open-R32-Garbine_Muguruza-Elina_Svitolina,1,F-DTL,10,2,1,0,1,7,3
20200125-W-Australian_Open-R32-Garbine_Muguruza-Elina_Svitolina,1,F-IO,12,3,2,1,0,9,3
20200125-W-Australian_Open-R32-Garbine_Muguruza-Elina_Svitolina,1,B-XC,30,5,2,3,0,23,7
20200125-W-Australian_Open-R32-Garbine_Muguruza-Elina_Svitolina,1,B-DTM,34,2,0,1,1,18,16
20200125-W-Australian_Open-R32-Garbine_Muguruza-Elina_Svitolina,1,B-DTL,11,6,2,2,2,9,2
20200125-W-Australian_Open-R32-Garbine_Muguruza-Elina_Svitolina,1,B-IO,22,9,3,2,4,12,10
20200125-W-Australian_Open-R32-Garbine_Muguruza-Elina_Svitolina,1,S-XC,2,1,0,1,0,1,1
20200125-W-Australian_Open-R32-Garbine_Muguruza-Elina_Svitolina,2,F-XC,34,10,4,2,3,17,17
20200125-W-Australian_Open-R32-Garbine_Muguruza-Elina_Svitolina,2,F-DTM,34,0,0,0,0,11,23
20200125-W-Australian_Open-R32-Garbine_Muguruza-Elina_Svitolina,2,F-DTL,12,3,2,0,1,6,6
20200125-W-Australian_Open-R32-Garbine_Muguruza-Elina_Svitolina,2,F-IO,11,0,0,0,0,5,6
20200125-W-Australian_Open-R32-Garbine_Muguruza-Elina_Svitolina,2,B-XC,33,3,1,1,1,11,22
20200125-W-Australian_Open-R32-Garbine_Muguruza-Elina_Svitolina,2,B-DTM,29,3,0,0,3,9,20
20200125-W-Australian_Open-R32-Garbine_Muguruza-Elina_Svitolina,2,B-DTL,5,1,1,0,0,3,2
20200125-W-Australian_Open-R32-Garbine_Muguruza-Elina_Svitolina,2,B-IO,6,2,2,0,0,2,4
20200125-W-Australian_Open-R32-Garbine_Muguruza-Elina_Svitolina,2,S-XC,1,0,0,0,0,0,1
20200125-W-Australian_Open-R32-Garbine_Muguruza-Elina_Svitolina,2,S-DTL,1,0,0,0,0,0,1
20200227-W-Doha-QF-Ashleigh_Barty-Garbine_Muguruza,1,F-XC,67,20,8,6,6,45,22
20200227-W-Doha-QF-Ashleigh_Barty-Garbine_Muguruza,1,F-DTM,30,4,0,0,4,15,15
20200227-W-Doha-QF-Ashleigh_Barty-Garbine_Muguruza,1,F-DTL,18,6,2,0,4,6,12
20200227-W-Doha-QF-Ashleigh_Barty-Garbine_Muguruza,1,F-IO,24,12,6,6,0,18,6
20200227-W-Doha-QF-Ashleigh_Barty-Garbine_Muguruza,1,F-II,1,0,0,0,0,0,1
20200227-W-Doha-QF-Ashleigh_Barty-Garbine_Muguruza,1,B-XC,15,5,1,1,3,8,7
20200227-W-Doha-QF-Ashleigh_Barty-Garbine_Muguruza,1,B-DTM,24,2,0,0,2,12,12
20200227-W-Doha-QF-Ashleigh_Barty-Garbine_Muguruza,1,B-DTL,5,1,0,0,1,2,3
20200227-W-Doha-QF-Ashleigh_Barty-Garbine_Muguruza,1,B-IO,6,3,0,1,2,2,4
20200227-W-Doha-QF-Ashleigh_Barty-Garbine_Muguruza,1,S-XC,21,2,0,0,2,11,10
20200227-W-Doha-QF-Ashleigh_Barty-Garbine_Muguruza,1,S-DTM,37,5,0,1,4,18,19
20200227-W-Doha-QF-Ashleigh_Barty-Garbine_Muguruza,1,S-DTL,12,1,0,0,1,8,4
20200227-W-Doha-QF-Ashleigh_Barty-Garbine_Muguruza,1,S-IO,5,0,0,0,0,2,3
20200227-W-Doha-QF-Ashleigh_Barty-Garbine_Muguruza,2,F-XC,53,14,3,4,7,27,26
20200227-W-Doha-QF-Ashleigh_Barty-Garbine_Muguruza,2,F-DTM,31,6,0,0,6,7,24
20200227-W-Doha-QF-Ashleigh_Barty-Garbine_Muguruza,2,F-DTL,27,9,2,2,5,11,16
20200227-W-Doha-QF-Ashleigh_Barty-Garbine_Muguruza,2,F-IO,32,7,3,2,2,15,17
20200227-W-Doha-QF-Ashleigh_Barty-Garbine_Muguruza,2,B-XC,46,11,2,3,6,23,23
20200227-W-Doha-QF-Ashleigh_Barty-Garbine_Muguruza,2,B-DTM,29,3,0,0,3,15,14
20200227-W-Doha-QF-Ashleigh_Barty-Garbine_Muguruza,2,B-DTL,10,5,1,2,2,6,4
20200227-W-Doha-QF-Ashleigh_Barty-Garbine_Muguruza,2,B-IO,18,7,3,2,2,10,8
20200227-W-Doha-QF-Ashleigh_Barty-Garbine_Muguruza,2,S-XC,4,0,0,0,0,2,2
20200227-W-Doha-QF-Ashleigh_Barty-Garbine_Muguruza,2,S-DTM,8,2,0,0,2,1,7
20200227-W-Doha-QF-Ashleigh_Barty-Garbine_Muguruza,2,S-DTL,3,0,0,0,0,1,2
20200227-W-Doha-QF-Belinda_Bencic-Svetlana_Kuznetsova,1,F-XC,38,10,3,4,2,19,19
20200227-W-Doha-QF-Belinda_Bencic-Svetlana_Kuznetsova,1,F-DTM,36,1,0,0,1,17,19
20200227-W-Doha-QF-Belinda_Bencic-Svetlana_Kuznetsova,1,F-DTL,7,2,1,1,0,3,4
20200227-W-Doha-QF-Belinda_Bencic-Svetlana_Kuznetsova,1,F-IO,17,7,5,1,1,13,4
20200227-W-Doha-QF-Belinda_Bencic-Svetlana_Kuznetsova,1,B-XC,22,3,0,2,1,15,7
20200227-W-Doha-QF-Belinda_Bencic-Svetlana_Kuznetsova,1,B-DTM,49,2,0,0,2,19,30
20200227-W-Doha-QF-Belinda_Bencic-Svetlana_Kuznetsova,1,B-DTL,5,1,0,1,0,3,2
20200227-W-Doha-QF-Belinda_Bencic-Svetlana_Kuznetsova,1,B-IO,13,4,1,1,2,6,7
20200227-W-Doha-QF-Belinda_Bencic-Svetlana_Kuznetsova,1,S-DTM,1,0,0,0,0,0,1
20200227-W-Doha-QF-Belinda_Bencic-Svetlana_Kuznetsova,1,S-DTL,1,0,0,0,0,0,1
20200227-W-Doha-QF-Belinda_Bencic-Svetlana_Kuznetsova,2,F-XC,36,9,7,2,0,26,10
20200227-W-Doha-QF-Belinda_Bencic-Svetlana_Kuznetsova,2,F-DTM,31,2,0,0,2,10,21
20200227-W-Doha-QF-Belinda_Bencic-Svetlana_Kuznetsova,2,F-DTL,17,10,8,1,1,14,3
20200227-W-Doha-QF-Belinda_Bencic-Svetlana_Kuznetsova,2,F-IO,29,9,6,0,3,18,11
20200227-W-Doha-QF-Belinda_Bencic-Svetlana_Kuznetsova,2,B-XC,18,2,1,0,1,11,7
20200227-W-Doha-QF-Belinda_Bencic-Svetlana_Kuznetsova,2,B-DTM,34,3,0,0,3,17,17
20200227-W-Doha-QF-Belinda_Bencic-Svetlana_Kuznetsova,2,B-DTL,5,4,3,0,1,4,1
20200227-W-Doha-QF-Belinda_Bencic-Svetlana_Kuznetsova,2,B-IO,3,1,1,0,0,2,1
20200227-W-Doha-QF-Belinda_Bencic-Svetlana_Kuznetsova,2,S-XC,4,1,0,0,1,0,4
20200227-W-Doha-QF-Belinda_Bencic-Svetlana_Kuznetsova,2,S-DTM,10,1,0,0,1,2,8
20200227-W-Doha-QF-Belinda_Bencic-Svetlana_Kuznetsova,2,S-IO,3,0,0,0,0,3,0
20200207-W-Doha-QF-Ons_Jabeur-Petra_Kvitova,1,F-XC,24,10,3,1,6,13,11
20200207-W-Doha-QF-Ons_Jabeur-Petra_Kvitova,1,F-DTM,27,2,0,1,1,13,14
20200207-W-Doha-QF-Ons_Jabeur-Petra_Kvitova,1,F-DTL,11,7,3,1,3,7,4
20200207-W-Doha-QF-Ons_Jabeur-Petra_Kvitova,1,F-IO,15,7,3,2,2,9,6
20200207-W-Doha-QF-Ons_Jabeur-Petra_Kvitova,1,B-XC,11,5,1,1,3,5,6
20200207-W-Doha-QF-Ons_Jabeur-Petra_Kvitova,1,B-DTM,19,1,0,0,1,7,12
20200207-W-Doha-QF-Ons_Jabeur-Petra_Kvitova,1,B-DTL,5,1,0,0,1,3,2
20200207-W-Doha-QF-Ons_Jabeur-Petra_Kvitova,1,B-IO,4,2,0,0,1,3,1
20200207-W-Doha-QF-Ons_Jabeur-Petra_Kvitova,1,S-XC,3,1,1,0,0,1,2
20200207-W-Doha-QF-Ons_Jabeur-Petra_Kvitova,1,S-DTM,12,2,0,0,2,4,8
20200207-W-Doha-QF-Ons_Jabeur-Petra_Kvitova,1,S-DTL,7,2,1,1,0,4,3
20200207-W-Doha-QF-Ons_Jabeur-Petra_Kvitova,1,S-IO,5,0,0,0,0,4,1
20200207-W-Doha-QF-Ons_Jabeur-Petra_Kvitova,2,F-XC,31,7,3,2,2,18,13
20200207-W-Doha-QF-Ons_Jabeur-Petra_Kvitova,2,F-DTM,21,4,1,1,2,9,12
20200207-W-Doha-QF-Ons_Jabeur-Petra_Kvitova,2,F-DTL,4,2,0,0,2,2,2
20200207-W-Doha-QF-Ons_Jabeur-Petra_Kvitova,2,F-IO,16,10,4,1,5,10,6
20200207-W-Doha-QF-Ons_Jabeur-Petra_Kvitova,2,B-XC,33,8,2,3,3,14,19
20200207-W-Doha-QF-Ons_Jabeur-Petra_Kvitova,2,B-DTM,25,5,0,0,5,9,16
20200207-W-Doha-QF-Ons_Jabeur-Petra_Kvitova,2,B-DTL,5,3,1,0,2,2,3
20200207-W-Doha-QF-Ons_Jabeur-Petra_Kvitova,2,B-IO,7,4,1,2,1,6,1
20200207-W-Doha-QF-Ons_Jabeur-Petra_Kvitova,2,S-XC,1,0,0,0,0,0,1
20200207-W-Doha-QF-Ons_Jabeur-Petra_Kvitova,2,S-DTM,8,1,0,0,1,4,4
20200207-W-Doha-QF-Ons_Jabeur-Petra_Kvitova,2,S-DTL,1,0,0,0,0,0,1
20200207-W-Doha-QF-Ons_Jabeur-Petra_Kvitova,2,S-IO,2,0,0,0,0,1,1
20150528-W-Roland_Garros-R64-Svetlana_Kuznetsova-Francesca_Schiavone,1,F-XC,96,24,4,7,13,49,47
20150528-W-Roland_Garros-R64-Svetlana_Kuznetsova-Francesca_Schiavone,1,F-DTM,29,0,0,0,0,14,15
20150528-W-Roland_Garros-R64-Svetlana_Kuznetsova-Francesca_Schiavone,1,F-DTL,54,18,8,3,7,30,24
20150528-W-Roland_Garros-R64-Svetlana_Kuznetsova-Francesca_Schiavone,1,F-IO,78,16,9,4,3,42,36
20150528-W-Roland_Garros-R64-Svetlana_Kuznetsova-Francesca_Schiavone,1,F-II,15,4,2,2,0,8,7
20150528-W-Roland_Garros-R64-Svetlana_Kuznetsova-Francesca_Schiavone,1,B-XC,108,19,8,8,3,59,49
20150528-W-Roland_Garros-R64-Svetlana_Kuznetsova-Francesca_Schiavone,1,B-DTM,25,2,0,0,2,10,15
20150528-W-Roland_Garros-R64-Svetlana_Kuznetsova-Francesca_Schiavone,1,B-DTL,24,9,4,3,2,15,9
20150528-W-Roland_Garros-R64-Svetlana_Kuznetsova-Francesca_Schiavone,1,B-IO,5,1,0,0,1,2,3
20150528-W-Roland_Garros-R64-Svetlana_Kuznetsova-Francesca_Schiavone,1,S-XC,15,0,0,0,0,7,8
20150528-W-Roland_Garros-R64-Svetlana_Kuznetsova-Francesca_Schiavone,1,S-DTM,2,0,0,0,0,1,1
20150528-W-Roland_Garros-R64-Svetlana_Kuznetsova-Francesca_Schiavone,1,S-DTL,3,0,0,0,0,0,3
20150528-W-Roland_Garros-R64-Svetlana_Kuznetsova-Francesca_Schiavone,2,F-XC,83,20,7,9,4,45,38
20150528-W-Roland_Garros-R64-Svetlana_Kuznetsova-Francesca_Schiavone,2,F-DTM,31,3,0,0,3,14,17
20150528-W-Roland_Garros-R64-Svetlana_Kuznetsova-Francesca_Schiavone,2,F-DTL,39,13,4,7,2,21,18
20150528-W-Roland_Garros-R64-Svetlana_Kuznetsova-Francesca_Schiavone,2,F-IO,52,13,4,5,4,30,22
20150528-W-Roland_Garros-R64-Svetlana_Kuznetsova-Francesca_Schiavone,2,F-II,10,2,0,1,1,3,7
20150528-W-Roland_Garros-R64-Svetlana_Kuznetsova-Francesca_Schiavone,2,B-XC,59,10,0,4,6,25,34
20150528-W-Roland_Garros-R64-Svetlana_Kuznetsova-Francesca_Schiavone,2,B-DTM,48,1,0,1,0,29,19
20150528-W-Roland_Garros-R64-Svetlana_Kuznetsova-Francesca_Schiavone,2,B-DTL,47,19,5,6,8,29,18
20150528-W-Roland_Garros-R64-Svetlana_Kuznetsova-Francesca_Schiavone,2,B-IO,9,1,1,0,0,5,4
20150528-W-Roland_Garros-R64-Svetlana_Kuznetsova-Francesca_Schiavone,2,S-XC,37,3,1,2,0,12,25
20150528-W-Roland_Garros-R64-Svetlana_Kuznetsova-Francesca_Schiavone,2,S-DTM,22,1,0,1,0,13,9
20150528-W-Roland_Garros-R64-Svetlana_Kuznetsova-Francesca_Schiavone,2,S-DTL,16,3,1,1,1,8,8
19900819-W-Manhattan_Beach-F-Monica_Seles-Martina_Navratilova,1,F-XC,61,10,2,2,6,21,40
19900819-W-Manhattan_Beach-F-Monica_Seles-Martina_Navratilova,1,F-DTM,9,1,0,0,1,3,6
19900819-W-Manhattan_Beach-F-Monica_Seles-Martina_Navratilova,1,F-DTL,24,16,10,2,4,14,10
19900819-W-Manhattan_Beach-F-Monica_Seles-Martina_Navratilova,1,F-IO,2,1,1,0,0,1,1
19900819-W-Manhattan_Beach-F-Monica_Seles-Martina_Navratilova,1,B-XC,38,12,5,3,4,21,17
19900819-W-Manhattan_Beach-F-Monica_Seles-Martina_Navratilova,1,B-DTM,14,2,0,0,2,4,10
19900819-W-Manhattan_Beach-F-Monica_Seles-Martina_Navratilova,1,B-DTL,13,3,2,1,0,8,5
19900819-W-Manhattan_Beach-F-Monica_Seles-Martina_Navratilova,1,B-IO,9,3,1,1,1,3,6
19900819-W-Manhattan_Beach-F-Monica_Seles-Martina_Navratilova,1,B-II,3,2,2,0,0,3,0
19900819-W-Manhattan_Beach-F-Monica_Seles-Martina_Navratilova,1,S-DTL,4,0,0,0,0,0,4
19900819-W-Manhattan_Beach-F-Monica_Seles-Martina_Navratilova,1,S-II,1,0,0,0,0,0,1
19900819-W-Manhattan_Beach-F-Monica_Seles-Martina_Navratilova,2,F-XC,63,15,1,8,6,38,25
19900819-W-Manhattan_Beach-F-Monica_Seles-Martina_Navratilova,2,F-DTM,5,0,0,0,0,3,2
19900819-W-Manhattan_Beach-F-Monica_Seles-Martina_Navratilova,2,F-DTL,16,5,1,3,1,12,4
19900819-W-Manhattan_Beach-F-Monica_Seles-Martina_Navratilova,2,F-IO,5,2,0,1,1,1,4
19900819-W-Manhattan_Beach-F-Monica_Seles-Martina_Navratilova,2,F-II,2,0,0,0,0,0,2
19900819-W-Manhattan_Beach-F-Monica_Seles-Martina_Navratilova,2,S-XC,16,5,0,1,4,8,8
19900819-W-Manhattan_Beach-F-Monica_Seles-Martina_Navratilova,2,S-DTM,2,0,0,0,0,0,2
19900819-W-Manhattan_Beach-F-Monica_Seles-Martina_Navratilova,2,S-DTL,7,1,0,0,1,3,4
19900819-W-Manhattan_Beach-F-Monica_Seles-Martina_Navratilova,2,S-IO,2,0,0,0,0,2,0
20010505-W-Hamburg-SF-Venus_Williams-Jelena_Dokic,1,F-XC,26,6,0,4,2,20,6
20010505-W-Hamburg-SF-Venus_Williams-Jelena_Dokic,1,F-DTM,3,0,0,0,0,2,1
20010505-W-Hamburg-SF-Venus_Williams-Jelena_Dokic,1,F-DTL,21,5,2,1,2,13,8
20010505-W-Hamburg-SF-Venus_Williams-Jelena_Dokic,1,F-IO,7,1,1,0,0,6,1
20010505-W-Hamburg-SF-Venus_Williams-Jelena_Dokic,1,B-XC,38,10,3,5,2,26,12
20010505-W-Hamburg-SF-Venus_Williams-Jelena_Dokic,1,B-DTM,2,0,0,0,0,1,1
20010505-W-Hamburg-SF-Venus_Williams-Jelena_Dokic,1,B-DTL,15,9,3,2,4,11,4
20010505-W-Hamburg-SF-Venus_Williams-Jelena_Dokic,1,B-II,1,1,0,0,1,0,1
20010505-W-Hamburg-SF-Venus_Williams-Jelena_Dokic,2,F-XC,27,4,0,1,3,5,22
20010505-W-Hamburg-SF-Venus_Williams-Jelena_Dokic,2,F-DTM,2,0,0,0,0,1,1
20010505-W-Hamburg-SF-Venus_Williams-Jelena_Dokic,2,F-DTL,10,4,1,0,3,1,9
20010505-W-Hamburg-SF-Venus_Williams-Jelena_Dokic,2,F-IO,1,0,0,0,0,1,0
20010505-W-Hamburg-SF-Venus_Williams-Jelena_Dokic,2,B-XC,47,7,1,0,6,13,34
20010505-W-Hamburg-SF-Venus_Williams-Jelena_Dokic,2,B-DTM,5,0,0,0,0,0,5
20010505-W-Hamburg-SF-Venus_Williams-Jelena_Dokic,2,B-DTL,15,4,2,1,1,9,6
20010505-W-Hamburg-SF-Venus_Williams-Jelena_Dokic,2,B-IO,3,0,0,0,0,1,2
20010505-W-Hamburg-SF-Venus_Williams-Jelena_Dokic,2,S-XC,1,0,0,0,0,1,0
20010505-W-Hamburg-SF-Venus_Williams-Jelena_Dokic,2,S-DTM,2,0,0,0,0,1,1
20010505-W-Hamburg-SF-Venus_Williams-Jelena_Dokic,2,S-DTL,1,0,0,0,0,0,1
20020217-W-Antwerp-F-Venus_Williams-Justine_Henin,1,F-XC,40,7,3,1,3,19,21
20020217-W-Antwerp-F-Venus_Williams-Justine_Henin,1,F-DTM,18,0,0,0,0,9,9
20020217-W-Antwerp-F-Venus_Williams-Justine_Henin,1,F-DTL,35,15,5,3,7,16,19
20020217-W-Antwerp-F-Venus_Williams-Justine_Henin,1,F-IO,6,3,2,0,1,3,3
20020217-W-Antwerp-F-Venus_Williams-Justine_Henin,1,F-II,1,0,0,0,0,0,1
20020217-W-Antwerp-F-Venus_Williams-Justine_Henin,1,B-XC,37,8,1,2,5,19,18
20020217-W-Antwerp-F-Venus_Williams-Justine_Henin,1,B-DTM,13,1,0,0,1,5,8
20020217-W-Antwerp-F-Venus_Williams-Justine_Henin,1,B-DTL,41,16,8,0,8,22,19
20020217-W-Antwerp-F-Venus_Williams-Justine_Henin,1,B-IO,7,2,0,0,2,0,7
20020217-W-Antwerp-F-Venus_Williams-Justine_Henin,1,S-XC,1,0,0,0,0,1,0
20020217-W-Antwerp-F-Venus_Williams-Justine_Henin,1,S-DTM,2,0,0,0,0,0,2
20020217-W-Antwerp-F-Venus_Williams-Justine_Henin,1,S-DTL,2,0,0,0,0,1,1
20020217-W-Antwerp-F-Venus_Williams-Justine_Henin,1,S-IO,1,0,0,0,0,1,0
20020217-W-Antwerp-F-Venus_Williams-Justine_Henin,2,F-XC,69,14,3,4,7,37,32
20020217-W-Antwerp-F-Venus_Williams-Justine_Henin,2,F-DTM,17,2,0,0,2,8,9
20020217-W-Antwerp-F-Venus_Williams-Justine_Henin,2,F-DTL,17,7,2,3,2,11,6
20020217-W-Antwerp-F-Venus_Williams-Justine_Henin,2,F-IO,14,5,2,0,3,6,8
20020217-W-Antwerp-F-Venus_Williams-Justine_Henin,2,F-II,5,2,0,1,1,3,2
20020217-W-Antwerp-F-Venus_Williams-Justine_Henin,2,B-XC,34,11,1,5,5,16,18
20020217-W-Antwerp-F-Venus_Williams-Justine_Henin,2,B-DTM,9,1,0,0,1,4,5
20020217-W-Antwerp-F-Venus_Williams-Justine_Henin,2,B-DTL,3,0,0,0,0,3,0
20020217-W-Antwerp-F-Venus_Williams-Justine_Henin,2,B-IO,1,1,0,0,1,0,1
20020217-W-Antwerp-F-Venus_Williams-Justine_Henin,2,S-XC,14,4,0,2,2,6,8
20020217-W-Antwerp-F-Venus_Williams-Justine_Henin,2,S-DTM,4,0,0,0,0,3,1
20020217-W-Antwerp-F-Venus_Williams-Justine_Henin,2,S-DTL,3,1,0,1,0,1,2
20020217-W-Antwerp-F-Venus_Williams-Justine_Henin,2,S-IO,3,1,0,0,1,1,2
20190405-W-Charleston-QF-Madison_Keys-Sloane_Stephens,1,F-XC,70,22,7,10,5,37,33
20190405-W-Charleston-QF-Madison_Keys-Sloane_Stephens,1,F-DTM,12,1,0,0,1,5,7
20190405-W-Charleston-QF-Madison_Keys-Sloane_Stephens,1,F-DTL,25,7,3,2,2,11,14
20190405-W-Charleston-QF-Madison_Keys-Sloane_Stephens,1,F-IO,35,12,4,3,5,19,16
20190405-W-Charleston-QF-Madison_Keys-Sloane_Stephens,1,F-II,8,3,0,2,1,3,5
20190405-W-Charleston-QF-Madison_Keys-Sloane_Stephens,1,B-XC,43,11,1,2,8,19,24
20190405-W-Charleston-QF-Madison_Keys-Sloane_Stephens,1,B-DTM,13,3,0,0,3,3,10
20190405-W-Charleston-QF-Madison_Keys-Sloane_Stephens,1,B-DTL,16,9,3,2,4,7,9
20190405-W-Charleston-QF-Madison_Keys-Sloane_Stephens,1,B-IO,3,0,0,0,0,1,2
20190405-W-Charleston-QF-Madison_Keys-Sloane_Stephens,1,S-XC,8,0,0,0,0,2,6
20190405-W-Charleston-QF-Madison_Keys-Sloane_Stephens,1,S-DTM,5,0,0,0,0,0,5
20190405-W-Charleston-QF-Madison_Keys-Sloane_Stephens,1,S-DTL,2,1,0,0,1,0,2
20190405-W-Charleston-QF-Madison_Keys-Sloane_Stephens,1,S-IO,1,1,0,0,1,0,1
20190405-W-Charleston-QF-Madison_Keys-Sloane_Stephens,2,F-XC,46,7,1,4,2,31,15
20190405-W-Charleston-QF-Madison_Keys-Sloane_Stephens,2,F-DTM,24,2,0,1,1,10,14
20190405-W-Charleston-QF-Madison_Keys-Sloane_Stephens,2,F-DTL,27,5,2,2,1,20,7
20190405-W-Charleston-QF-Madison_Keys-Sloane_Stephens,2,F-IO,18,7,3,2,2,14,4
20190405-W-Charleston-QF-Madison_Keys-Sloane_Stephens,2,F-II,2,1,0,1,0,1,1
20190405-W-Charleston-QF-Madison_Keys-Sloane_Stephens,2,B-XC,43,7,1,3,3,21,22
20190405-W-Charleston-QF-Madison_Keys-Sloane_Stephens,2,B-DTM,24,1,0,0,1,13,11
20190405-W-Charleston-QF-Madison_Keys-Sloane_Stephens,2,B-DTL,29,15,7,3,5,19,10
20190405-W-Charleston-QF-Madison_Keys-Sloane_Stephens,2,B-IO,4,1,0,1,0,3,1
20190405-W-Charleston-QF-Madison_Keys-Sloane_Stephens,2,S-XC,7,0,0,0,0,4,3
20190405-W-Charleston-QF-Madison_Keys-Sloane_Stephens,2,S-DTM,5,0,0,0,0,2,3
20190405-W-Charleston-QF-Madison_Keys-Sloane_Stephens,2,S-DTL,7,1,0,0,1,2,5
20190405-W-Charleston-QF-Madison_Keys-Sloane_Stephens,2,S-IO,1,0,0,0,0,1,0
20190420-W-Fed_Cup_World_Group_SF-RR-Ashleigh_Barty-Victoria_Azarenka,1,F-XC,58,14,1,5,8,27,31
20190420-W-Fed_Cup_World_Group_SF-RR-Ashleigh_Barty-Victoria_Azarenka,1,F-DTM,5,1,0,0,1,2,3
20190420-W-Fed_Cup_World_Group_SF-RR-Ashleigh_Barty-Victoria_Azarenka,1,F-DTL,13,6,1,3,2,8,5
20190420-W-Fed_Cup_World_Group_SF-RR-Ashleigh_Barty-Victoria_Azarenka,1,F-IO,8,5,4,1,0,6,2
20190420-W-Fed_Cup_World_Group_SF-RR-Ashleigh_Barty-Victoria_Azarenka,1,F-II,6,2,1,1,0,6,0
20190420-W-Fed_Cup_World_Group_SF-RR-Ashleigh_Barty-Victoria_Azarenka,1,B-XC,29,5,1,0,4,13,16
20190420-W-Fed_Cup_World_Group_SF-RR-Ashleigh_Barty-Victoria_Azarenka,1,B-DTM,13,0,0,0,0,5,8
20190420-W-Fed_Cup_World_Group_SF-RR-Ashleigh_Barty-Victoria_Azarenka,1,B-DTL,12,3,0,2,1,8,4
20190420-W-Fed_Cup_World_Group_SF-RR-Ashleigh_Barty-Victoria_Azarenka,1,S-XC,46,5,0,1,4,13,33
20190420-W-Fed_Cup_World_Group_SF-RR-Ashleigh_Barty-Victoria_Azarenka,1,S-DTM,5,1,0,0,1,1,4
20190420-W-Fed_Cup_World_Group_SF-RR-Ashleigh_Barty-Victoria_Azarenka,1,S-DTL,17,4,3,0,1,8,9
20190420-W-Fed_Cup_World_Group_SF-RR-Ashleigh_Barty-Victoria_Azarenka,1,S-IO,1,0,0,0,0,1,0
20190420-W-Fed_Cup_World_Group_SF-RR-Ashleigh_Barty-Victoria_Azarenka,2,F-XC,38,6,0,3,3,15,23
20190420-W-Fed_Cup_World_Group_SF-RR-Ashleigh_Barty-Victoria_Azarenka,2,F-DTM,7,0,0,0,0,4,3
20190420-W-Fed_Cup_World_Group_SF-RR-Ashleigh_Barty-Victoria_Azarenka,2,F-DTL,56,10,1,3,6,28,28
20190420-W-Fed_Cup_World_Group_SF-RR-Ashleigh_Barty-Victoria_Azarenka,2,F-IO,14,0,0,0,0,7,7
20190420-W-Fed_Cup_World_Group_SF-RR-Ashleigh_Barty-Victoria_Azarenka,2,F-II,2,1,0,0,1,0,2
20190420-W-Fed_Cup_World_Group_SF-RR-Ashleigh_Barty-Victoria_Azarenka,2,B-XC,52,6,1,2,3,35,17
20190420-W-Fed_Cup_World_Group_SF-RR-Ashleigh_Barty-Victoria_Azarenka,2,B-DTM,4,0,0,0,0,2,2
20190420-W-Fed_Cup_World_Group_SF-RR-Ashleigh_Barty-Victoria_Azarenka,2,B-DTL,20,8,1,3,4,12,8
20190420-W-Fed_Cup_World_Group_SF-RR-Ashleigh_Barty-Victoria_Azarenka,2,B-IO,9,2,1,1,0,7,2
20190420-W-Fed_Cup_World_Group_SF-RR-Ashleigh_Barty-Victoria_Azarenka,2,S-XC,8,0,0,0,0,3,5
20190420-W-Fed_Cup_World_Group_SF-RR-Ashleigh_Barty-Victoria_Azarenka,2,S-DTL,2,0,0,0,0,1,1
19960706-W-Wimbledon-F-Steffi_Graf-Arantxa_Sanchez_Vicario,1,F-XC,29,12,2,3,7,17,12
19960706-W-Wimbledon-F-Steffi_Graf-Arantxa_Sanchez_Vicario,1,F-DTM,23,2,0,0,2,13,10
19960706-W-Wimbledon-F-Steffi_Graf-Arantxa_Sanchez_Vicario,1,F-DTL,3,0,0,0,0,1,2
19960706-W-Wimbledon-F-Steffi_Graf-Arantxa_Sanchez_Vicario,1,F-IO,45,16,8,5,3,27,18
19960706-W-Wimbledon-F-Steffi_Graf-Arantxa_Sanchez_Vicario,1,F-II,6,2,1,0,1,4,2
19960706-W-Wimbledon-F-Steffi_Graf-Arantxa_Sanchez_Vicario,1,B-XC,3,3,1,0,2,1,2
19960706-W-Wimbledon-F-Steffi_Graf-Arantxa_Sanchez_Vicario,1,B-DTM,1,0,0,0,0,1,0
19960706-W-Wimbledon-F-Steffi_Graf-Arantxa_Sanchez_Vicario,1,B-DTL,1,1,0,0,1,0,1
19960706-W-Wimbledon-F-Steffi_Graf-Arantxa_Sanchez_Vicario,1,S-XC,36,4,1,2,1,22,14
19960706-W-Wimbledon-F-Steffi_Graf-Arantxa_Sanchez_Vicario,1,S-DTM,13,1,0,0,1,5,8
19960706-W-Wimbledon-F-Steffi_Graf-Arantxa_Sanchez_Vicario,1,S-DTL,10,3,1,1,1,5,5
19960706-W-Wimbledon-F-Steffi_Graf-Arantxa_Sanchez_Vicario,1,S-IO,2,1,0,0,1,0,2
19960706-W-Wimbledon-F-Steffi_Graf-Arantxa_Sanchez_Vicario,2,F-XC,12,5,4,0,1,6,6
19960706-W-Wimbledon-F-Steffi_Graf-Arantxa_Sanchez_Vicario,2,F-DTM,27,5,1,0,4,10,17
19960706-W-Wimbledon-F-Steffi_Graf-Arantxa_Sanchez_Vicario,2,F-DTL,7,2,0,0,2,1,6
19960706-W-Wimbledon-F-Steffi_Graf-Arantxa_Sanchez_Vicario,2,F-IO,7,0,0,0,0,4,3
19960706-W-Wimbledon-F-Steffi_Graf-Arantxa_Sanchez_Vicario,2,B-XC,37,7,1,1,5,20,17
19960706-W-Wimbledon-F-Steffi_Graf-Arantxa_Sanchez_Vicario,2,B-DTM,17,5,1,0,4,5,12
19960706-W-Wimbledon-F-Steffi_Graf-Arantxa_Sanchez_Vicario,2,B-DTL,7,6,1,2,3,3,4
19960706-W-Wimbledon-F-Steffi_Graf-Arantxa_Sanchez_Vicario,2,B-IO,1,0,0,0,0,0,1
19960706-W-Wimbledon-F-Steffi_Graf-Arantxa_Sanchez_Vicario,2,S-XC,22,2,0,2,0,9,13
19960706-W-Wimbledon-F-Steffi_Graf-Arantxa_Sanchez_Vicario,2,S-DTM,8,0,0,0,0,5,3
19960706-W-Wimbledon-F-Steffi_Graf-Arantxa_Sanchez_Vicario,2,S-DTL,4,0,0,0,0,2,2
19960706-W-Wimbledon-F-Steffi_Graf-Arantxa_Sanchez_Vicario,2,S-IO,2,0,0,0,0,1,1
20120122-W-Australian_Open-R16-Kim_Clijsters-Na_Li,1,F-XC,88,21,3,4,14,41,47
20120122-W-Australian_Open-R16-Kim_Clijsters-Na_Li,1,F-DTM,10,0,0,0,0,4,6
20120122-W-Australian_Open-R16-Kim_Clijsters-Na_Li,1,F-DTL,22,9,5,1,3,14,8
20120122-W-Australian_Open-R16-Kim_Clijsters-Na_Li,1,F-IO,10,3,1,0,2,6,4
20120122-W-Australian_Open-R16-Kim_Clijsters-Na_Li,1,F-II,4,1,0,0,1,1,3
20120122-W-Australian_Open-R16-Kim_Clijsters-Na_Li,1,B-XC,49,10,0,4,6,25,24
20120122-W-Australian_Open-R16-Kim_Clijsters-Na_Li,1,B-DTM,14,1,0,0,1,6,8
20120122-W-Australian_Open-R16-Kim_Clijsters-Na_Li,1,B-DTL,12,3,1,1,1,8,4
20120122-W-Australian_Open-R16-Kim_Clijsters-Na_Li,1,B-IO,3,1,1,0,0,2,1
20120122-W-Australian_Open-R16-Kim_Clijsters-Na_Li,1,S-XC,9,0,0,0,0,4,5
20120122-W-Australian_Open-R16-Kim_Clijsters-Na_Li,1,S-DTM,3,0,0,0,0,2,1
20120122-W-Australian_Open-R16-Kim_Clijsters-Na_Li,2,F-XC,71,13,3,2,8,35,36
20120122-W-Australian_Open-R16-Kim_Clijsters-Na_Li,2,F-DTM,20,2,0,1,1,11,9
20120122-W-Australian_Open-R16-Kim_Clijsters-Na_Li,2,F-DTL,30,10,4,2,4,16,14
20120122-W-Australian_Open-R16-Kim_Clijsters-Na_Li,2,F-IO,12,5,4,0,1,8,4
20120122-W-Australian_Open-R16-Kim_Clijsters-Na_Li,2,F-II,2,1,0,0,1,1,1
20120122-W-Australian_Open-R16-Kim_Clijsters-Na_Li,2,B-XC,42,14,5,2,7,19,23
20120122-W-Australian_Open-R16-Kim_Clijsters-Na_Li,2,B-DTM,20,5,0,2,3,11,9
20120122-W-Australian_Open-R16-Kim_Clijsters-Na_Li,2,B-DTL,34,12,6,1,5,15,19
20120122-W-Australian_Open-R16-Kim_Clijsters-Na_Li,2,B-IO,9,1,0,0,1,2,7
20120122-W-Australian_Open-R16-Kim_Clijsters-Na_Li,2,S-DTM,1,0,0,0,0,0,1
19930703-W-Wimbledon-F-Steffi_Graf-Jana_Novotna,1,F-XC,33,8,1,1,6,14,19
19930703-W-Wimbledon-F-Steffi_Graf-Jana_Novotna,1,F-DTM,19,1,0,0,1,10,9
19930703-W-Wimbledon-F-Steffi_Graf-Jana_Novotna,1,F-DTL,8,3,1,1,1,5,3
19930703-W-Wimbledon-F-Steffi_Graf-Jana_Novotna,1,F-IO,14,2,0,0,2,6,8
19930703-W-Wimbledon-F-Steffi_Graf-Jana_Novotna,1,F-II,3,2,0,1,1,1,2
19930703-W-Wimbledon-F-Steffi_Graf-Jana_Novotna,1,B-XC,8,7,4,0,3,4,4
19930703-W-Wimbledon-F-Steffi_Graf-Jana_Novotna,1,B-DTM,4,0,0,0,0,1,3
19930703-W-Wimbledon-F-Steffi_Graf-Jana_Novotna,1,B-DTL,4,4,2,1,1,3,1
19930703-W-Wimbledon-F-Steffi_Graf-Jana_Novotna,1,S-XC,17,3,0,2,1,8,9
19930703-W-Wimbledon-F-Steffi_Graf-Jana_Novotna,1,S-DTM,19,2,0,0,2,11,8
19930703-W-Wimbledon-F-Steffi_Graf-Jana_Novotna,1,S-DTL,8,2,0,0,2,2,6
19930703-W-Wimbledon-F-Steffi_Graf-Jana_Novotna,1,S-IO,2,1,0,0,1,1,1
19930703-W-Wimbledon-F-Steffi_Graf-Jana_Novotna,2,F-XC,14,4,1,1,2,5,9
19930703-W-Wimbledon-F-Steffi_Graf-Jana_Novotna,2,F-DTM,17,3,1,0,2,6,11
19930703-W-Wimbledon-F-Steffi_Graf-Jana_Novotna,2,F-DTL,10,4,1,0,3,5,5
19930703-W-Wimbledon-F-Steffi_Graf-Jana_Novotna,2,F-IO,3,1,1,0,0,3,0
19930703-W-Wimbledon-F-Steffi_Graf-Jana_Novotna,2,B-XC,1,1,0,0,1,0,1
19930703-W-Wimbledon-F-Steffi_Graf-Jana_Novotna,2,B-DTM,1,0,0,0,0,0,1
19930703-W-Wimbledon-F-Steffi_Graf-Jana_Novotna,2,B-IO,1,1,0,0,1,0,1
19930703-W-Wimbledon-F-Steffi_Graf-Jana_Novotna,2,S-XC,25,2,1,1,0,12,13
19930703-W-Wimbledon-F-Steffi_Graf-Jana_Novotna,2,S-DTM,19,2,0,0,2,7,12
19930703-W-Wimbledon-F-Steffi_Graf-Jana_Novotna,2,S-DTL,8,1,0,1,0,5,3
19930703-W-Wimbledon-F-Steffi_Graf-Jana_Novotna,2,S-IO,4,2,0,1,1,3,1
19930703-W-Wimbledon-F-Steffi_Graf-Jana_Novotna,2,S-II,1,0,0,0,0,1,0
20010908-W-US_Open-F-Serena_Williams-Venus_Williams,1,F-XC,25,7,3,0,4,10,15
20010908-W-US_Open-F-Serena_Williams-Venus_Williams,1,F-DTM,16,1,0,0,1,4,12
20010908-W-US_Open-F-Serena_Williams-Venus_Williams,1,F-DTL,4,3,1,0,2,2,2
20010908-W-US_Open-F-Serena_Williams-Venus_Williams,1,F-IO,19,7,2,2,3,11,8
20010908-W-US_Open-F-Serena_Williams-Venus_Williams,1,F-II,1,1,0,0,1,0,1
20010908-W-US_Open-F-Serena_Williams-Venus_Williams,1,B-XC,36,9,0,0,9,12,24
20010908-W-US_Open-F-Serena_Williams-Venus_Williams,1,B-DTM,39,5,0,1,4,10,29
20010908-W-US_Open-F-Serena_Williams-Venus_Williams,1,B-DTL,6,3,0,1,2,4,2
20010908-W-US_Open-F-Serena_Williams-Venus_Williams,1,B-IO,7,2,1,1,0,6,1
20010908-W-US_Open-F-Serena_Williams-Venus_Williams,1,S-XC,1,0,0,0,0,0,1
20010908-W-US_Open-F-Serena_Williams-Venus_Williams,1,S-DTM,1,0,0,0,0,0,1
20010908-W-US_Open-F-Serena_Williams-Venus_Williams,2,F-XC,13,4,2,1,1,8,5
20010908-W-US_Open-F-Serena_Williams-Venus_Williams,2,F-DTM,34,1,0,1,0,19,15
20010908-W-US_Open-F-Serena_Williams-Venus_Williams,2,F-DTL,8,2,0,0,2,3,5
20010908-W-US_Open-F-Serena_Williams-Venus_Williams,2,F-IO,14,5,2,1,2,9,5
20010908-W-US_Open-F-Serena_Williams-Venus_Williams,2,B-XC,27,3,0,2,1,17,10
20010908-W-US_Open-F-Serena_Williams-Venus_Williams,2,B-DTM,34,3,0,1,2,21,13
20010908-W-US_Open-F-Serena_Williams-Venus_Williams,2,B-DTL,8,3,0,0,3,2,6
20010908-W-US_Open-F-Serena_Williams-Venus_Williams,2,B-IO,10,4,1,1,2,6,4
20010908-W-US_Open-F-Serena_Williams-Venus_Williams,2,S-DTM,2,0,0,0,0,1,1
20010908-W-US_Open-F-Serena_Williams-Venus_Williams,2,S-DTL,1,0,0,0,0,0,1
19990909-W-US_Open-SF-Serena_Williams-Lindsay_Davenport,1,F-XC,32,15,4,0,11,17,15
19990909-W-US_Open-SF-Serena_Williams-Lindsay_Davenport,1,F-DTM,32,3,0,0,3,16,16
19990909-W-US_Open-SF-Serena_Williams-Lindsay_Davenport,1,F-DTL,4,3,3,0,0,4,0
19990909-W-US_Open-SF-Serena_Williams-Lindsay_Davenport,1,F-IO,8,5,0,3,2,5,3
19990909-W-US_Open-SF-Serena_Williams-Lindsay_Davenport,1,B-XC,25,6,0,3,3,14,11
19990909-W-US_Open-SF-Serena_Williams-Lindsay_Davenport,1,B-DTM,31,4,0,0,4,13,18
19990909-W-US_Open-SF-Serena_Williams-Lindsay_Davenport,1,B-DTL,4,1,1,0,0,4,0
19990909-W-US_Open-SF-Serena_Williams-Lindsay_Davenport,1,B-IO,13,7,5,1,1,10,3
19990909-W-US_Open-SF-Serena_Williams-Lindsay_Davenport,1,S-DTM,2,0,0,0,0,1,1
19990909-W-US_Open-SF-Serena_Williams-Lindsay_Davenport,1,S-DTL,1,0,0,0,0,0,1
19990909-W-US_Open-SF-Serena_Williams-Lindsay_Davenport,2,F-XC,33,13,4,1,8,10,23
19990909-W-US_Open-SF-Serena_Williams-Lindsay_Davenport,2,F-DTM,26,2,0,0,2,10,16
19990909-W-US_Open-SF-Serena_Williams-Lindsay_Davenport,2,F-DTL,10,6,0,2,4,2,8
19990909-W-US_Open-SF-Serena_Williams-Lindsay_Davenport,2,F-IO,19,9,4,0,5,11,8
19990909-W-US_Open-SF-Serena_Williams-Lindsay_Davenport,2,B-XC,20,5,2,3,0,14,6
19990909-W-US_Open-SF-Serena_Williams-Lindsay_Davenport,2,B-DTM,22,1,0,0,1,10,12
19990909-W-US_Open-SF-Serena_Williams-Lindsay_Davenport,2,B-DTL,9,4,1,2,1,4,5
19990909-W-US_Open-SF-Serena_Williams-Lindsay_Davenport,2,B-IO,7,3,1,0,2,4,3
19990909-W-US_Open-SF-Serena_Williams-Lindsay_Davenport,2,S-XC,1,0,0,0,0,1,0
19990909-W-US_Open-SF-Serena_Williams-Lindsay_Davenport,2,S-DTM,2,0,0,0,0,0,2
19990909-W-US_Open-SF-Serena_Williams-Lindsay_Davenport,2,S-DTL,2,0,0,0,0,0,2
19990909-W-US_Open-SF-Serena_Williams-Lindsay_Davenport,2,S-IO,1,1,0,0,1,0,1
20200125-W-Australian_Open-R32-Camila_Giorgi-Angelique_Kerber,1,F-XC,67,23,7,4,12,30,37
20200125-W-Australian_Open-R32-Camila_Giorgi-Angelique_Kerber,1,F-DTM,40,8,1,0,7,25,15
20200125-W-Australian_Open-R32-Camila_Giorgi-Angelique_Kerber,1,F-DTL,11,7,4,1,2,7,4
20200125-W-Australian_Open-R32-Camila_Giorgi-Angelique_Kerber,1,F-IO,16,8,6,0,2,11,5
20200125-W-Australian_Open-R32-Camila_Giorgi-Angelique_Kerber,1,B-XC,59,18,5,1,12,33,26
20200125-W-Australian_Open-R32-Camila_Giorgi-Angelique_Kerber,1,B-DTM,54,6,1,2,3,24,30
20200125-W-Australian_Open-R32-Camila_Giorgi-Angelique_Kerber,1,B-DTL,16,8,4,0,4,10,6
20200125-W-Australian_Open-R32-Camila_Giorgi-Angelique_Kerber,1,B-IO,10,3,1,1,1,6,4
20200125-W-Australian_Open-R32-Camila_Giorgi-Angelique_Kerber,1,S-XC,2,0,0,0,0,0,2
20200125-W-Australian_Open-R32-Camila_Giorgi-Angelique_Kerber,1,S-DTM,1,0,0,0,0,1,0
20200125-W-Australian_Open-R32-Camila_Giorgi-Angelique_Kerber,1,S-DTL,1,0,0,0,0,1,0
20200125-W-Australian_Open-R32-Camila_Giorgi-Angelique_Kerber,1,S-IO,1,1,1,0,0,1,0
20200125-W-Australian_Open-R32-Camila_Giorgi-Angelique_Kerber,2,F-XC,56,5,1,2,2,25,31
20200125-W-Australian_Open-R32-Camila_Giorgi-Angelique_Kerber,2,F-DTM,34,1,0,1,0,20,14
20200125-W-Australian_Open-R32-Camila_Giorgi-Angelique_Kerber,2,F-DTL,10,5,4,0,1,6,4
20200125-W-Australian_Open-R32-Camila_Giorgi-Angelique_Kerber,2,F-IO,20,8,1,2,5,12,8
20200125-W-Australian_Open-R32-Camila_Giorgi-Angelique_Kerber,2,B-XC,39,5,0,2,3,19,20
20200125-W-Australian_Open-R32-Camila_Giorgi-Angelique_Kerber,2,B-DTM,46,0,0,0,0,22,24
20200125-W-Australian_Open-R32-Camila_Giorgi-Angelique_Kerber,2,B-DTL,10,4,1,1,2,6,4
20200125-W-Australian_Open-R32-Camila_Giorgi-Angelique_Kerber,2,B-IO,9,1,0,0,1,1,8
20200125-W-Australian_Open-R32-Camila_Giorgi-Angelique_Kerber,2,S-XC,6,0,0,0,0,2,4
20200125-W-Australian_Open-R32-Camila_Giorgi-Angelique_Kerber,2,S-DTM,6,0,0,0,0,3,3
20200125-W-Australian_Open-R32-Camila_Giorgi-Angelique_Kerber,2,S-DTL,3,0,0,0,0,1,2
20200124-W-Australian_Open-R32-Madison_Keys-Maria_Sakkari,1,F-XC,15,5,1,0,4,7,8
20200124-W-Australian_Open-R32-Madison_Keys-Maria_Sakkari,1,F-DTM,25,2,0,0,2,7,18
20200124-W-Australian_Open-R32-Madison_Keys-Maria_Sakkari,1,F-DTL,3,2,0,1,1,2,1
20200124-W-Australian_Open-R32-Madison_Keys-Maria_Sakkari,1,F-IO,16,9,2,0,7,6,10
20200124-W-Australian_Open-R32-Madison_Keys-Maria_Sakkari,1,F-II,1,1,0,0,1,0,1
20200124-W-Australian_Open-R32-Madison_Keys-Maria_Sakkari,1,B-XC,22,8,2,2,4,8,14
20200124-W-Australian_Open-R32-Madison_Keys-Maria_Sakkari,1,B-DTM,27,5,0,0,5,10,17
20200124-W-Australian_Open-R32-Madison_Keys-Maria_Sakkari,1,B-DTL,4,4,1,0,3,1,3
20200124-W-Australian_Open-R32-Madison_Keys-Maria_Sakkari,1,B-IO,7,4,0,0,4,3,4
20200124-W-Australian_Open-R32-Madison_Keys-Maria_Sakkari,1,S-XC,2,0,0,0,0,1,1
20200124-W-Australian_Open-R32-Madison_Keys-Maria_Sakkari,1,S-DTM,2,0,0,0,0,1,1
20200124-W-Australian_Open-R32-Madison_Keys-Maria_Sakkari,2,F-XC,12,6,1,2,3,5,7
20200124-W-Australian_Open-R32-Madison_Keys-Maria_Sakkari,2,F-DTM,30,5,0,1,4,19,11
20200124-W-Australian_Open-R32-Madison_Keys-Maria_Sakkari,2,F-DTL,6,4,0,0,4,2,4
20200124-W-Australian_Open-R32-Madison_Keys-Maria_Sakkari,2,F-IO,19,8,1,0,7,10,9
20200124-W-Australian_Open-R32-Madison_Keys-Maria_Sakkari,2,F-II,2,2,1,1,0,2,0
20200124-W-Australian_Open-R32-Madison_Keys-Maria_Sakkari,2,B-XC,18,1,0,0,1,10,8
20200124-W-Australian_Open-R32-Madison_Keys-Maria_Sakkari,2,B-DTM,21,1,0,0,1,14,7
20200124-W-Australian_Open-R32-Madison_Keys-Maria_Sakkari,2,B-DTL,2,2,1,1,0,2,0
20200124-W-Australian_Open-R32-Madison_Keys-Maria_Sakkari,2,B-IO,1,0,0,0,0,1,0
20200124-W-Australian_Open-R32-Madison_Keys-Maria_Sakkari,2,S-DTM,1,0,0,0,0,0,1
20090603-W-Roland_Garros-QF-Serena_Williams-Svetlana_Kuznetsova,1,F-XC,81,27,9,5,13,40,41
20090603-W-Roland_Garros-QF-Serena_Williams-Svetlana_Kuznetsova,1,F-DTM,7,0,0,0,0,4,3
20090603-W-Roland_Garros-QF-Serena_Williams-Svetlana_Kuznetsova,1,F-DTL,24,10,5,3,2,16,8
20090603-W-Roland_Garros-QF-Serena_Williams-Svetlana_Kuznetsova,1,F-IO,8,2,1,0,1,5,3
20090603-W-Roland_Garros-QF-Serena_Williams-Svetlana_Kuznetsova,1,F-II,3,2,1,0,1,2,1
20090603-W-Roland_Garros-QF-Serena_Williams-Svetlana_Kuznetsova,1,B-XC,75,9,3,3,3,41,34
20090603-W-Roland_Garros-QF-Serena_Williams-Svetlana_Kuznetsova,1,B-DTM,12,0,0,0,0,7,5
20090603-W-Roland_Garros-QF-Serena_Williams-Svetlana_Kuznetsova,1,B-DTL,26,9,6,0,3,15,11
20090603-W-Roland_Garros-QF-Serena_Williams-Svetlana_Kuznetsova,1,B-IO,11,2,0,1,1,6,5
20090603-W-Roland_Garros-QF-Serena_Williams-Svetlana_Kuznetsova,1,S-XC,2,2,0,2,0,2,0
20090603-W-Roland_Garros-QF-Serena_Williams-Svetlana_Kuznetsova,1,S-DTM,1,0,0,0,0,0,1
20090603-W-Roland_Garros-QF-Serena_Williams-Svetlana_Kuznetsova,2,F-XC,46,7,3,2,2,23,23
20090603-W-Roland_Garros-QF-Serena_Williams-Svetlana_Kuznetsova,2,F-DTM,8,2,0,0,2,4,4
20090603-W-Roland_Garros-QF-Serena_Williams-Svetlana_Kuznetsova,2,F-DTL,45,17,6,5,6,19,26
20090603-W-Roland_Garros-QF-Serena_Williams-Svetlana_Kuznetsova,2,F-IO,28,10,1,4,5,15,13
20090603-W-Roland_Garros-QF-Serena_Williams-Svetlana_Kuznetsova,2,F-II,13,7,1,4,2,8,5
20090603-W-Roland_Garros-QF-Serena_Williams-Svetlana_Kuznetsova,2,B-XC,35,7,2,2,3,15,20
20090603-W-Roland_Garros-QF-Serena_Williams-Svetlana_Kuznetsova,2,B-DTM,16,2,1,1,0,5,11
20090603-W-Roland_Garros-QF-Serena_Williams-Svetlana_Kuznetsova,2,B-DTL,22,13,2,6,5,13,9
20090603-W-Roland_Garros-QF-Serena_Williams-Svetlana_Kuznetsova,2,B-IO,2,0,0,0,0,1,1
20090603-W-Roland_Garros-QF-Serena_Williams-Svetlana_Kuznetsova,2,S-XC,6,0,0,0,0,4,2
20090603-W-Roland_Garros-QF-Serena_Williams-Svetlana_Kuznetsova,2,S-DTM,6,0,0,0,0,3,3
20090603-W-Roland_Garros-QF-Serena_Williams-Svetlana_Kuznetsova,2,S-DTL,5,0,0,0,0,1,4
20130702-W-Wimbledon-QF-Kaia_Kanepi-Sabine_Lisicki,1,F-XC,15,4,0,3,1,10,5
20130702-W-Wimbledon-QF-Kaia_Kanepi-Sabine_Lisicki,1,F-DTM,5,0,0,0,0,2,3
20130702-W-Wimbledon-QF-Kaia_Kanepi-Sabine_Lisicki,1,F-DTL,17,6,3,0,3,11,6
20130702-W-Wimbledon-QF-Kaia_Kanepi-Sabine_Lisicki,1,F-IO,14,8,1,2,5,6,8
20130702-W-Wimbledon-QF-Kaia_Kanepi-Sabine_Lisicki,1,F-II,2,1,0,0,1,0,2
20130702-W-Wimbledon-QF-Kaia_Kanepi-Sabine_Lisicki,1,B-XC,23,5,2,1,2,11,12
20130702-W-Wimbledon-QF-Kaia_Kanepi-Sabine_Lisicki,1,B-DTM,8,2,0,0,2,0,8
20130702-W-Wimbledon-QF-Kaia_Kanepi-Sabine_Lisicki,1,B-DTL,16,5,0,1,4,6,10
20130702-W-Wimbledon-QF-Kaia_Kanepi-Sabine_Lisicki,1,B-IO,2,0,0,0,0,1,1
20130702-W-Wimbledon-QF-Kaia_Kanepi-Sabine_Lisicki,1,S-XC,3,0,0,0,0,0,3
20130702-W-Wimbledon-QF-Kaia_Kanepi-Sabine_Lisicki,1,S-DTM,1,0,0,0,0,0,1
20130702-W-Wimbledon-QF-Kaia_Kanepi-Sabine_Lisicki,1,S-DTL,2,0,0,0,0,1,1
20130702-W-Wimbledon-QF-Kaia_Kanepi-Sabine_Lisicki,2,F-XC,12,3,0,2,1,6,6
20130702-W-Wimbledon-QF-Kaia_Kanepi-Sabine_Lisicki,2,F-DTM,8,0,0,0,0,5,3
20130702-W-Wimbledon-QF-Kaia_Kanepi-Sabine_Lisicki,2,F-DTL,7,4,1,1,2,4,3
20130702-W-Wimbledon-QF-Kaia_Kanepi-Sabine_Lisicki,2,F-IO,12,6,4,1,1,9,3
20130702-W-Wimbledon-QF-Kaia_Kanepi-Sabine_Lisicki,2,F-II,1,0,0,0,0,0,1
20130702-W-Wimbledon-QF-Kaia_Kanepi-Sabine_Lisicki,2,B-XC,20,2,0,0,2,11,9
20130702-W-Wimbledon-QF-Kaia_Kanepi-Sabine_Lisicki,2,B-DTM,10,1,0,0,1,4,6
20130702-W-Wimbledon-QF-Kaia_Kanepi-Sabine_Lisicki,2,B-DTL,12,5,2,0,3,4,8
20130702-W-Wimbledon-QF-Kaia_Kanepi-Sabine_Lisicki,2,B-IO,2,2,1,0,1,1,1
20130702-W-Wimbledon-QF-Kaia_Kanepi-Sabine_Lisicki,2,S-XC,1,0,0,0,0,0,1
20130702-W-Wimbledon-QF-Kaia_Kanepi-Sabine_Lisicki,2,S-DTM,1,0,0,0,0,0,1
20190611-W-s_Hertogenbosch-R32-Alison_Riske-Karolina_Muchova,1,F-XC,38,8,3,4,1,24,14
20190611-W-s_Hertogenbosch-R32-Alison_Riske-Karolina_Muchova,1,F-DTM,12,1,0,0,1,3,9
20190611-W-s_Hertogenbosch-R32-Alison_Riske-Karolina_Muchova,1,F-DTL,24,9,4,1,4,12,12
20190611-W-s_Hertogenbosch-R32-Alison_Riske-Karolina_Muchova,1,F-IO,21,3,0,1,2,16,5
20190611-W-s_Hertogenbosch-R32-Alison_Riske-Karolina_Muchova,1,F-II,2,1,1,0,0,2,0
20190611-W-s_Hertogenbosch-R32-Alison_Riske-Karolina_Muchova,1,B-XC,26,5,3,1,1,17,9
20190611-W-s_Hertogenbosch-R32-Alison_Riske-Karolina_Muchova,1,B-DTM,12,2,0,2,0,3,9
20190611-W-s_Hertogenbosch-R32-Alison_Riske-Karolina_Muchova,1,B-DTL,16,8,1,3,4,11,5
20190611-W-s_Hertogenbosch-R32-Alison_Riske-Karolina_Muchova,1,B-IO,6,1,0,1,0,6,0
20190611-W-s_Hertogenbosch-R32-Alison_Riske-Karolina_Muchova,1,S-DTL,1,0,0,0,0,0,1
20190611-W-s_Hertogenbosch-R32-Alison_Riske-Karolina_Muchova,2,F-XC,31,15,3,4,8,16,15
20190611-W-s_Hertogenbosch-R32-Alison_Riske-Karolina_Muchova,2,F-DTM,8,0,0,0,0,3,5
20190611-W-s_Hertogenbosch-R32-Alison_Riske-Karolina_Muchova,2,F-DTL,26,13,3,1,9,8,18
20190611-W-s_Hertogenbosch-R32-Alison_Riske-Karolina_Muchova,2,F-IO,12,5,3,1,1,10,2
20190611-W-s_Hertogenbosch-R32-Alison_Riske-Karolina_Muchova,2,F-II,5,2,2,0,0,4,1
20190611-W-s_Hertogenbosch-R32-Alison_Riske-Karolina_Muchova,2,B-XC,18,5,2,2,1,9,9
20190611-W-s_Hertogenbosch-R32-Alison_Riske-Karolina_Muchova,2,B-DTM,15,0,0,0,0,6,9
20190611-W-s_Hertogenbosch-R32-Alison_Riske-Karolina_Muchova,2,B-DTL,17,6,3,0,3,5,12
20190611-W-s_Hertogenbosch-R32-Alison_Riske-Karolina_Muchova,2,S-XC,7,0,0,0,0,2,5
20190611-W-s_Hertogenbosch-R32-Alison_Riske-Karolina_Muchova,2,S-DTM,2,0,0,0,0,2,0
20190611-W-s_Hertogenbosch-R32-Alison_Riske-Karolina_Muchova,2,S-DTL,17,3,0,0,3,5,12
20000704-W-Wimbledon-QF-Venus_Williams-Martina_Hingis,1,F-XC,95,18,8,3,7,55,40
20000704-W-Wimbledon-QF-Venus_Williams-Martina_Hingis,1,F-DTM,7,1,0,0,1,1,6
20000704-W-Wimbledon-QF-Venus_Williams-Martina_Hingis,1,F-DTL,61,10,2,2,6,31,30
20000704-W-Wimbledon-QF-Venus_Williams-Martina_Hingis,1,F-IO,8,1,0,0,1,3,5
20000704-W-Wimbledon-QF-Venus_Williams-Martina_Hingis,1,F-II,3,0,0,0,0,1,2
20000704-W-Wimbledon-QF-Venus_Williams-Martina_Hingis,1,B-XC,85,15,3,5,7,45,40
20000704-W-Wimbledon-QF-Venus_Williams-Martina_Hingis,1,B-DTM,17,0,0,0,0,9,8
20000704-W-Wimbledon-QF-Venus_Williams-Martina_Hingis,1,B-DTL,52,21,6,4,11,27,25
20000704-W-Wimbledon-QF-Venus_Williams-Martina_Hingis,1,B-IO,15,4,0,1,3,8,7
20000704-W-Wimbledon-QF-Venus_Williams-Martina_Hingis,1,B-II,1,0,0,0,0,0,1
20000704-W-Wimbledon-QF-Venus_Williams-Martina_Hingis,1,S-XC,2,0,0,0,0,2,0
20000704-W-Wimbledon-QF-Venus_Williams-Martina_Hingis,1,S-DTM,1,0,0,0,0,1,0
20000704-W-Wimbledon-QF-Venus_Williams-Martina_Hingis,1,S-DTL,2,0,0,0,0,1,1
20000704-W-Wimbledon-QF-Venus_Williams-Martina_Hingis,2,F-XC,101,11,2,3,6,48,53
20000704-W-Wimbledon-QF-Venus_Williams-Martina_Hingis,2,F-DTM,14,1,0,0,1,10,4
20000704-W-Wimbledon-QF-Venus_Williams-Martina_Hingis,2,F-DTL,45,7,1,3,3,16,29
20000704-W-Wimbledon-QF-Venus_Williams-Martina_Hingis,2,F-IO,12,0,0,0,0,4,8
20000704-W-Wimbledon-QF-Venus_Williams-Martina_Hingis,2,F-II,1,1,1,0,0,1,0
20000704-W-Wimbledon-QF-Venus_Williams-Martina_Hingis,2,B-XC,82,7,1,1,5,42,40
20000704-W-Wimbledon-QF-Venus_Williams-Martina_Hingis,2,B-DTM,23,1,0,0,1,8,15
20000704-W-Wimbledon-QF-Venus_Williams-Martina_Hingis,2,B-DTL,36,6,3,2,1,15,21
20000704-W-Wimbledon-QF-Venus_Williams-Martina_Hingis,2,B-IO,11,2,0,1,1,6,5
20000704-W-Wimbledon-QF-Venus_Williams-Martina_Hingis,2,S-XC,8,0,0,0,0,6,2
20000704-W-Wimbledon-QF-Venus_Williams-Martina_Hingis,2,S-DTM,5,0,0,0,0,2,3
20031120-W-Fed_Cup_World_Group_SF-RR-Anastasia_Myskina-Amelie_Mauresmo,1,F-XC,91,11,3,2,6,48,43
20031120-W-Fed_Cup_World_Group_SF-RR-Anastasia_Myskina-Amelie_Mauresmo,1,F-DTM,9,1,0,1,0,2,7
20031120-W-Fed_Cup_World_Group_SF-RR-Anastasia_Myskina-Amelie_Mauresmo,1,F-DTL,19,8,3,1,4,8,11
20031120-W-Fed_Cup_World_Group_SF-RR-Anastasia_Myskina-Amelie_Mauresmo,1,F-IO,12,1,0,1,0,8,4
20031120-W-Fed_Cup_World_Group_SF-RR-Anastasia_Myskina-Amelie_Mauresmo,1,F-II,1,0,0,0,0,1,0
20031120-W-Fed_Cup_World_Group_SF-RR-Anastasia_Myskina-Amelie_Mauresmo,1,B-XC,162,28,3,12,13,72,90
20031120-W-Fed_Cup_World_Group_SF-RR-Anastasia_Myskina-Amelie_Mauresmo,1,B-DTM,23,4,0,2,2,8,15
20031120-W-Fed_Cup_World_Group_SF-RR-Anastasia_Myskina-Amelie_Mauresmo,1,B-DTL,34,14,6,2,6,16,18
20031120-W-Fed_Cup_World_Group_SF-RR-Anastasia_Myskina-Amelie_Mauresmo,1,B-IO,6,3,0,0,3,2,4
20031120-W-Fed_Cup_World_Group_SF-RR-Anastasia_Myskina-Amelie_Mauresmo,1,B-II,6,1,0,1,0,5,1
20031120-W-Fed_Cup_World_Group_SF-RR-Anastasia_Myskina-Amelie_Mauresmo,1,S-XC,1,0,0,0,0,0,1
20031120-W-Fed_Cup_World_Group_SF-RR-Anastasia_Myskina-Amelie_Mauresmo,1,S-DTM,1,0,0,0,0,1,0
20031120-W-Fed_Cup_World_Group_SF-RR-Anastasia_Myskina-Amelie_Mauresmo,2,F-XC,80,13,2,5,6,40,40
20031120-W-Fed_Cup_World_Group_SF-RR-Anastasia_Myskina-Amelie_Mauresmo,2,F-DTM,11,0,0,0,0,3,8
20031120-W-Fed_Cup_World_Group_SF-RR-Anastasia_Myskina-Amelie_Mauresmo,2,F-DTL,66,11,2,4,5,37,29
20031120-W-Fed_Cup_World_Group_SF-RR-Anastasia_Myskina-Amelie_Mauresmo,2,F-IO,33,7,1,2,4,20,13
20031120-W-Fed_Cup_World_Group_SF-RR-Anastasia_Myskina-Amelie_Mauresmo,2,F-II,3,1,0,0,1,2,1
20031120-W-Fed_Cup_World_Group_SF-RR-Anastasia_Myskina-Amelie_Mauresmo,2,B-XC,90,12,2,4,6,42,48
20031120-W-Fed_Cup_World_Group_SF-RR-Anastasia_Myskina-Amelie_Mauresmo,2,B-DTM,16,3,0,2,1,7,9
20031120-W-Fed_Cup_World_Group_SF-RR-Anastasia_Myskina-Amelie_Mauresmo,2,B-DTL,27,10,1,5,4,20,7
20031120-W-Fed_Cup_World_Group_SF-RR-Anastasia_Myskina-Amelie_Mauresmo,2,B-IO,2,1,0,0,1,1,1
20031120-W-Fed_Cup_World_Group_SF-RR-Anastasia_Myskina-Amelie_Mauresmo,2,S-XC,24,1,1,0,0,17,7
20031120-W-Fed_Cup_World_Group_SF-RR-Anastasia_Myskina-Amelie_Mauresmo,2,S-DTM,5,0,0,0,0,2,3
20031120-W-Fed_Cup_World_Group_SF-RR-Anastasia_Myskina-Amelie_Mauresmo,2,S-DTL,7,2,0,0,2,4,3
20150601-W-Roland_Garros-R16-Serena_Williams-Sloane_Stephens,1,F-XC,57,19,4,8,7,35,22
20150601-W-Roland_Garros-R16-Serena_Williams-Sloane_Stephens,1,F-DTM,12,0,0,0,0,5,7
20150601-W-Roland_Garros-R16-Serena_Williams-Sloane_Stephens,1,F-DTL,31,6,2,3,1,16,15
20150601-W-Roland_Garros-R16-Serena_Williams-Sloane_Stephens,1,F-IO,15,3,1,2,0,10,5
20150601-W-Roland_Garros-R16-Serena_Williams-Sloane_Stephens,1,F-II,2,1,0,1,0,1,1
20150601-W-Roland_Garros-R16-Serena_Williams-Sloane_Stephens,1,B-XC,57,15,2,6,7,31,26
20150601-W-Roland_Garros-R16-Serena_Williams-Sloane_Stephens,1,B-DTM,13,3,0,0,3,1,12
20150601-W-Roland_Garros-R16-Serena_Williams-Sloane_Stephens,1,B-DTL,22,8,1,2,5,11,11
20150601-W-Roland_Garros-R16-Serena_Williams-Sloane_Stephens,1,B-IO,1,1,0,0,1,0,1
20150601-W-Roland_Garros-R16-Serena_Williams-Sloane_Stephens,1,S-DTM,1,0,0,0,0,0,1
20150601-W-Roland_Garros-R16-Serena_Williams-Sloane_Stephens,1,S-DTL,2,0,0,0,0,1,1
20150601-W-Roland_Garros-R16-Serena_Williams-Sloane_Stephens,1,S-IO,1,0,0,0,0,0,1
20150601-W-Roland_Garros-R16-Serena_Williams-Sloane_Stephens,2,F-XC,55,13,6,5,2,33,22
20150601-W-Roland_Garros-R16-Serena_Williams-Sloane_Stephens,2,F-DTM,9,0,0,0,0,4,5
20150601-W-Roland_Garros-R16-Serena_Williams-Sloane_Stephens,2,F-DTL,18,9,1,4,4,8,10
20150601-W-Roland_Garros-R16-Serena_Williams-Sloane_Stephens,2,F-IO,12,5,3,2,0,8,4
20150601-W-Roland_Garros-R16-Serena_Williams-Sloane_Stephens,2,F-II,4,2,1,1,0,2,2
20150601-W-Roland_Garros-R16-Serena_Williams-Sloane_Stephens,2,B-XC,40,7,3,1,2,23,17
20150601-W-Roland_Garros-R16-Serena_Williams-Sloane_Stephens,2,B-DTM,17,0,0,0,0,7,10
20150601-W-Roland_Garros-R16-Serena_Williams-Sloane_Stephens,2,B-DTL,34,10,5,4,1,18,16
20150601-W-Roland_Garros-R16-Serena_Williams-Sloane_Stephens,2,B-IO,4,1,0,0,1,0,4
20150601-W-Roland_Garros-R16-Serena_Williams-Sloane_Stephens,2,S-XC,5,0,0,0,0,2,3
20150601-W-Roland_Garros-R16-Serena_Williams-Sloane_Stephens,2,S-DTM,3,0,0,0,0,1,2
20200125-W-Australian_Open-R32-Anastasia_Pavlyuchenkova-Karolina_Pliskova,1,F-XC,42,17,7,4,6,25,17
20200125-W-Australian_Open-R32-Anastasia_Pavlyuchenkova-Karolina_Pliskova,1,F-DTM,40,4,0,0,4,26,14
20200125-W-Australian_Open-R32-Anastasia_Pavlyuchenkova-Karolina_Pliskova,1,F-DTL,19,8,7,0,1,14,5
20200125-W-Australian_Open-R32-Anastasia_Pavlyuchenkova-Karolina_Pliskova,1,F-IO,29,17,11,3,3,22,7
20200125-W-Australian_Open-R32-Anastasia_Pavlyuchenkova-Karolina_Pliskova,1,F-II,1,1,0,0,1,0,1
20200125-W-Australian_Open-R32-Anastasia_Pavlyuchenkova-Karolina_Pliskova,1,B-XC,22,4,2,0,2,12,10
20200125-W-Australian_Open-R32-Anastasia_Pavlyuchenkova-Karolina_Pliskova,1,B-DTM,40,9,1,3,5,22,18
20200125-W-Australian_Open-R32-Anastasia_Pavlyuchenkova-Karolina_Pliskova,1,B-DTL,14,10,8,0,2,10,4
20200125-W-Australian_Open-R32-Anastasia_Pavlyuchenkova-Karolina_Pliskova,1,B-IO,9,6,1,0,5,2,7
20200125-W-Australian_Open-R32-Anastasia_Pavlyuchenkova-Karolina_Pliskova,2,F-XC,31,11,5,1,5,13,18
20200125-W-Australian_Open-R32-Anastasia_Pavlyuchenkova-Karolina_Pliskova,2,F-DTM,49,7,0,1,6,18,31
20200125-W-Australian_Open-R32-Anastasia_Pavlyuchenkova-Karolina_Pliskova,2,F-DTL,14,10,6,0,4,9,5
20200125-W-Australian_Open-R32-Anastasia_Pavlyuchenkova-Karolina_Pliskova,2,F-IO,23,10,2,3,5,11,12
20200125-W-Australian_Open-R32-Anastasia_Pavlyuchenkova-Karolina_Pliskova,2,B-XC,40,9,2,5,2,18,22
20200125-W-Australian_Open-R32-Anastasia_Pavlyuchenkova-Karolina_Pliskova,2,B-DTM,36,4,0,1,3,13,23
20200125-W-Australian_Open-R32-Anastasia_Pavlyuchenkova-Karolina_Pliskova,2,B-DTL,8,4,1,1,2,4,4
20200125-W-Australian_Open-R32-Anastasia_Pavlyuchenkova-Karolina_Pliskova,2,B-IO,7,2,0,2,0,5,2
20200125-W-Australian_Open-R32-Anastasia_Pavlyuchenkova-Karolina_Pliskova,2,S-XC,3,0,0,0,0,2,1
20200125-W-Australian_Open-R32-Anastasia_Pavlyuchenkova-Karolina_Pliskova,2,S-DTM,1,0,0,0,0,0,1
20200125-W-Australian_Open-R32-Anastasia_Pavlyuchenkova-Karolina_Pliskova,2,S-DTL,1,0,0,0,0,0,1
19890806-W-San_Diego-F-Zina_Garrison-Steffi_Graf,1,F-XC,17,6,4,1,1,14,3
19890806-W-San_Diego-F-Zina_Garrison-Steffi_Graf,1,F-DTM,13,1,0,1,0,6,7
19890806-W-San_Diego-F-Zina_Garrison-Steffi_Graf,1,F-DTL,25,4,0,2,2,13,12
19890806-W-San_Diego-F-Zina_Garrison-Steffi_Graf,1,F-IO,6,0,0,0,0,2,4
19890806-W-San_Diego-F-Zina_Garrison-Steffi_Graf,1,B-XC,3,2,1,0,1,2,1
19890806-W-San_Diego-F-Zina_Garrison-Steffi_Graf,1,B-DTM,1,0,0,0,0,0,1
19890806-W-San_Diego-F-Zina_Garrison-Steffi_Graf,1,B-DTL,2,1,1,0,0,2,0
19890806-W-San_Diego-F-Zina_Garrison-Steffi_Graf,1,S-XC,57,6,1,3,2,31,26
19890806-W-San_Diego-F-Zina_Garrison-Steffi_Graf,1,S-DTM,2,0,0,0,0,1,1
19890806-W-San_Diego-F-Zina_Garrison-Steffi_Graf,1,S-DTL,1,0,0,0,0,0,1
19890806-W-San_Diego-F-Zina_Garrison-Steffi_Graf,2,F-XC,29,11,3,6,2,14,15
19890806-W-San_Diego-F-Zina_Garrison-Steffi_Graf,2,F-DTM,6,0,0,0,0,4,2
19890806-W-San_Diego-F-Zina_Garrison-Steffi_Graf,2,F-DTL,4,2,2,0,0,2,2
19890806-W-San_Diego-F-Zina_Garrison-Steffi_Graf,2,F-IO,31,10,6,0,4,17,14
19890806-W-San_Diego-F-Zina_Garrison-Steffi_Graf,2,F-II,26,11,2,4,5,9,17
19890806-W-San_Diego-F-Zina_Garrison-Steffi_Graf,2,B-XC,6,1,0,0,1,2,4
19890806-W-San_Diego-F-Zina_Garrison-Steffi_Graf,2,B-DTM,7,1,0,1,0,6,1
19890806-W-San_Diego-F-Zina_Garrison-Steffi_Graf,2,B-DTL,15,11,5,4,2,11,4
19890806-W-San_Diego-F-Zina_Garrison-Steffi_Graf,2,S-XC,39,4,0,3,1,16,23
19890806-W-San_Diego-F-Zina_Garrison-Steffi_Graf,2,S-DTM,8,1,0,1,0,3,5
19890806-W-San_Diego-F-Zina_Garrison-Steffi_Graf,2,S-DTL,33,5,2,3,0,19,14
20180404-W-Charleston-R32-Kristyna_Pliskova-Petra_Kvitova,1,F-XC,33,7,1,3,3,21,12
20180404-W-Charleston-R32-Kristyna_Pliskova-Petra_Kvitova,1,F-DTM,9,0,0,0,0,7,2
20180404-W-Charleston-R32-Kristyna_Pliskova-Petra_Kvitova,1,F-DTL,14,4,3,0,1,7,7
20180404-W-Charleston-R32-Kristyna_Pliskova-Petra_Kvitova,1,F-IO,10,4,2,2,0,7,3
20180404-W-Charleston-R32-Kristyna_Pliskova-Petra_Kvitova,1,B-XC,17,5,1,1,3,8,9
20180404-W-Charleston-R32-Kristyna_Pliskova-Petra_Kvitova,1,B-DTM,14,0,0,0,0,6,8
20180404-W-Charleston-R32-Kristyna_Pliskova-Petra_Kvitova,1,B-DTL,17,7,3,1,3,10,7
20180404-W-Charleston-R32-Kristyna_Pliskova-Petra_Kvitova,1,B-IO,9,3,0,1,2,5,4
20180404-W-Charleston-R32-Kristyna_Pliskova-Petra_Kvitova,1,S-XC,1,1,1,0,0,1,0
20180404-W-Charleston-R32-Kristyna_Pliskova-Petra_Kvitova,1,S-DTM,1,0,0,0,0,0,1
20180404-W-Charleston-R32-Kristyna_Pliskova-Petra_Kvitova,1,S-DTL,3,0,0,0,0,1,2
20180404-W-Charleston-R32-Kristyna_Pliskova-Petra_Kvitova,2,F-XC,71,30,8,8,14,31,40
20180404-W-Charleston-R32-Kristyna_Pliskova-Petra_Kvitova,2,F-DTM,5,1,0,0,1,1,4
20180404-W-Charleston-R32-Kristyna_Pliskova-Petra_Kvitova,2,F-DTL,14,8,4,1,3,8,6
20180404-W-Charleston-R32-Kristyna_Pliskova-Petra_Kvitova,2,F-IO,15,6,2,2,2,8,7
20180404-W-Charleston-R32-Kristyna_Pliskova-Petra_Kvitova,2,F-II,1,0,0,0,0,1,0
20180404-W-Charleston-R32-Kristyna_Pliskova-Petra_Kvitova,2,B-XC,23,5,1,1,3,11,12
20180404-W-Charleston-R32-Kristyna_Pliskova-Petra_Kvitova,2,B-DTM,9,2,1,0,1,1,8
20180404-W-Charleston-R32-Kristyna_Pliskova-Petra_Kvitova,2,B-DTL,6,3,2,1,0,4,2
20180404-W-Charleston-R32-Kristyna_Pliskova-Petra_Kvitova,2,B-IO,2,0,0,0,0,1,1
20180404-W-Charleston-R32-Kristyna_Pliskova-Petra_Kvitova,2,S-XC,2,0,0,0,0,2,0
20180404-W-Charleston-R32-Kristyna_Pliskova-Petra_Kvitova,2,S-DTL,3,2,0,1,1,2,1
20180404-W-Charleston-R32-Kristyna_Pliskova-Petra_Kvitova,2,S-IO,1,0,0,0,0,0,1
20060602-W-Roland_Garros-R32-Aravane_Rezai-Nicole_Vaidisova,1,F-XC,38,11,4,1,6,16,22
20060602-W-Roland_Garros-R32-Aravane_Rezai-Nicole_Vaidisova,1,F-DTM,11,1,0,0,1,5,6
20060602-W-Roland_Garros-R32-Aravane_Rezai-Nicole_Vaidisova,1,F-DTL,42,13,4,3,6,26,16
20060602-W-Roland_Garros-R32-Aravane_Rezai-Nicole_Vaidisova,1,F-IO,20,2,1,1,0,16,4
20060602-W-Roland_Garros-R32-Aravane_Rezai-Nicole_Vaidisova,1,F-II,1,0,0,0,0,0,1
20060602-W-Roland_Garros-R32-Aravane_Rezai-Nicole_Vaidisova,1,B-XC,39,10,2,2,6,18,21
20060602-W-Roland_Garros-R32-Aravane_Rezai-Nicole_Vaidisova,1,B-DTM,12,0,0,0,0,6,6
20060602-W-Roland_Garros-R32-Aravane_Rezai-Nicole_Vaidisova,1,B-DTL,18,11,5,0,6,7,11
20060602-W-Roland_Garros-R32-Aravane_Rezai-Nicole_Vaidisova,1,B-IO,4,2,0,0,2,2,2
20060602-W-Roland_Garros-R32-Aravane_Rezai-Nicole_Vaidisova,1,S-XC,3,0,0,0,0,0,3
20060602-W-Roland_Garros-R32-Aravane_Rezai-Nicole_Vaidisova,1,S-DTM,1,0,0,0,0,0,1
20060602-W-Roland_Garros-R32-Aravane_Rezai-Nicole_Vaidisova,1,S-DTL,1,0,0,0,0,0,1
20060602-W-Roland_Garros-R32-Aravane_Rezai-Nicole_Vaidisova,2,F-XC,45,14,5,5,4,27,18
20060602-W-Roland_Garros-R32-Aravane_Rezai-Nicole_Vaidisova,2,F-DTM,7,0,0,0,0,4,3
20060602-W-Roland_Garros-R32-Aravane_Rezai-Nicole_Vaidisova,2,F-DTL,19,6,3,1,2,13,6
20060602-W-Roland_Garros-R32-Aravane_Rezai-Nicole_Vaidisova,2,F-IO,16,8,4,3,1,9,7
20060602-W-Roland_Garros-R32-Aravane_Rezai-Nicole_Vaidisova,2,F-II,12,5,4,1,0,7,5
20060602-W-Roland_Garros-R32-Aravane_Rezai-Nicole_Vaidisova,2,B-XC,29,2,1,0,1,13,16
20060602-W-Roland_Garros-R32-Aravane_Rezai-Nicole_Vaidisova,2,B-DTM,23,3,0,0,3,10,13
20060602-W-Roland_Garros-R32-Aravane_Rezai-Nicole_Vaidisova,2,B-DTL,16,4,0,0,4,5,11
20060602-W-Roland_Garros-R32-Aravane_Rezai-Nicole_Vaidisova,2,S-XC,2,1,0,0,1,0,2
20060602-W-Roland_Garros-R32-Aravane_Rezai-Nicole_Vaidisova,2,S-DTM,5,0,0,0,0,0,5
20060602-W-Roland_Garros-R32-Aravane_Rezai-Nicole_Vaidisova,2,S-DTL,2,0,0,0,0,0,2
20000906-W-US_Open-QF-Serena_Williams-Lindsay_Davenport,1,F-XC,27,13,4,2,7,11,16
20000906-W-US_Open-QF-Serena_Williams-Lindsay_Davenport,1,F-DTM,4,0,0,0,0,1,3
20000906-W-US_Open-QF-Serena_Williams-Lindsay_Davenport,1,F-DTL,8,1,1,0,0,4,4
20000906-W-US_Open-QF-Serena_Williams-Lindsay_Davenport,1,F-IO,13,6,1,3,2,6,7
20000906-W-US_Open-QF-Serena_Williams-Lindsay_Davenport,1,B-XC,36,5,2,1,2,13,23
20000906-W-US_Open-QF-Serena_Williams-Lindsay_Davenport,1,B-DTM,19,3,0,0,3,8,11
20000906-W-US_Open-QF-Serena_Williams-Lindsay_Davenport,1,B-DTL,35,11,7,1,3,17,18
20000906-W-US_Open-QF-Serena_Williams-Lindsay_Davenport,1,B-IO,15,5,0,2,3,8,7
20000906-W-US_Open-QF-Serena_Williams-Lindsay_Davenport,2,F-XC,32,10,0,5,5,17,15
20000906-W-US_Open-QF-Serena_Williams-Lindsay_Davenport,2,F-DTM,9,0,0,0,0,6,3
20000906-W-US_Open-QF-Serena_Williams-Lindsay_Davenport,2,F-DTL,27,6,1,3,2,16,11
20000906-W-US_Open-QF-Serena_Williams-Lindsay_Davenport,2,F-IO,14,3,0,1,2,8,6
20000906-W-US_Open-QF-Serena_Williams-Lindsay_Davenport,2,B-XC,43,7,0,4,3,25,18
20000906-W-US_Open-QF-Serena_Williams-Lindsay_Davenport,2,B-DTM,10,0,0,0,0,6,4
20000906-W-US_Open-QF-Serena_Williams-Lindsay_Davenport,2,B-DTL,8,3,2,1,0,7,1
20000906-W-US_Open-QF-Serena_Williams-Lindsay_Davenport,2,B-IO,2,1,1,0,0,2,0
20000906-W-US_Open-QF-Serena_Williams-Lindsay_Davenport,2,B-II,1,0,0,0,0,0,1
20000906-W-US_Open-QF-Serena_Williams-Lindsay_Davenport,2,S-XC,4,0,0,0,0,2,2
20000906-W-US_Open-QF-Serena_Williams-Lindsay_Davenport,2,S-DTM,1,0,0,0,0,1,0
20180313-W-Indian_Wells-R16-Naomi_Osaka-Maria_Sakkari,1,F-XC,43,15,8,3,4,30,13
20180313-W-Indian_Wells-R16-Naomi_Osaka-Maria_Sakkari,1,F-DTM,16,2,0,1,1,7,9
20180313-W-Indian_Wells-R16-Naomi_Osaka-Maria_Sakkari,1,F-DTL,29,9,1,3,5,12,17
20180313-W-Indian_Wells-R16-Naomi_Osaka-Maria_Sakkari,1,F-IO,11,3,1,0,2,7,4
20180313-W-Indian_Wells-R16-Naomi_Osaka-Maria_Sakkari,1,F-II,1,0,0,0,0,0,1
20180313-W-Indian_Wells-R16-Naomi_Osaka-Maria_Sakkari,1,B-XC,61,6,0,1,5,27,34
20180313-W-Indian_Wells-R16-Naomi_Osaka-Maria_Sakkari,1,B-DTM,10,2,0,1,1,5,5
20180313-W-Indian_Wells-R16-Naomi_Osaka-Maria_Sakkari,1,B-DTL,30,14,3,4,7,14,16
20180313-W-Indian_Wells-R16-Naomi_Osaka-Maria_Sakkari,1,B-IO,7,1,0,1,0,3,4
20180313-W-Indian_Wells-R16-Naomi_Osaka-Maria_Sakkari,2,F-XC,47,8,3,3,2,27,20
20180313-W-Indian_Wells-R16-Naomi_Osaka-Maria_Sakkari,2,F-DTM,13,0,0,0,0,7,6
20180313-W-Indian_Wells-R16-Naomi_Osaka-Maria_Sakkari,2,F-DTL,19,3,2,0,1,7,12
20180313-W-Indian_Wells-R16-Naomi_Osaka-Maria_Sakkari,2,F-IO,12,1,0,0,1,7,5
20180313-W-Indian_Wells-R16-Naomi_Osaka-Maria_Sakkari,2,F-II,8,2,0,1,1,3,5
20180313-W-Indian_Wells-R16-Naomi_Osaka-Maria_Sakkari,2,B-XC,64,11,1,3,7,39,25
20180313-W-Indian_Wells-R16-Naomi_Osaka-Maria_Sakkari,2,B-DTM,14,1,0,0,1,3,11
20180313-W-Indian_Wells-R16-Naomi_Osaka-Maria_Sakkari,2,B-DTL,23,14,1,5,8,10,13
20180313-W-Indian_Wells-R16-Naomi_Osaka-Maria_Sakkari,2,B-IO,3,1,0,0,1,1,2
20180313-W-Indian_Wells-R16-Naomi_Osaka-Maria_Sakkari,2,S-XC,2,0,0,0,0,2,0
20180313-W-Indian_Wells-R16-Naomi_Osaka-Maria_Sakkari,2,S-DTL,1,0,0,0,0,0,1
20180325-W-Miami-R32-Venus_Williams-Kiki_Bertens,1,F-XC,85,16,3,5,8,40,45
20180325-W-Miami-R32-Venus_Williams-Kiki_Bertens,1,F-DTM,18,0,0,0,0,9,9
20180325-W-Miami-R32-Venus_Williams-Kiki_Bertens,1,F-DTL,45,13,2,5,6,25,20
20180325-W-Miami-R32-Venus_Williams-Kiki_Bertens,1,F-IO,37,11,2,3,6,24,13
20180325-W-Miami-R32-Venus_Williams-Kiki_Bertens,1,F-II,2,0,0,0,0,1,1
20180325-W-Miami-R32-Venus_Williams-Kiki_Bertens,1,B-XC,58,11,2,5,4,32,26
20180325-W-Miami-R32-Venus_Williams-Kiki_Bertens,1,B-DTM,7,0,0,0,0,2,5
20180325-W-Miami-R32-Venus_Williams-Kiki_Bertens,1,B-DTL,22,11,3,3,5,12,10
20180325-W-Miami-R32-Venus_Williams-Kiki_Bertens,1,B-IO,5,2,1,1,0,3,2
20180325-W-Miami-R32-Venus_Williams-Kiki_Bertens,1,S-XC,3,1,0,0,1,0,3
20180325-W-Miami-R32-Venus_Williams-Kiki_Bertens,1,S-DTM,2,0,0,0,0,1,1
20180325-W-Miami-R32-Venus_Williams-Kiki_Bertens,1,S-DTL,4,0,0,0,0,2,2
20180325-W-Miami-R32-Venus_Williams-Kiki_Bertens,2,F-XC,92,21,10,2,9,52,40
20180325-W-Miami-R32-Venus_Williams-Kiki_Bertens,2,F-DTM,20,3,1,0,2,9,11
20180325-W-Miami-R32-Venus_Williams-Kiki_Bertens,2,F-DTL,29,17,8,4,5,17,12
20180325-W-Miami-R32-Venus_Williams-Kiki_Bertens,2,F-IO,12,8,2,1,5,4,8
20180325-W-Miami-R32-Venus_Williams-Kiki_Bertens,2,F-II,4,0,0,0,0,1,3
20180325-W-Miami-R32-Venus_Williams-Kiki_Bertens,2,B-XC,54,10,4,0,6,22,32
20180325-W-Miami-R32-Venus_Williams-Kiki_Bertens,2,B-DTM,28,3,1,0,2,10,18
20180325-W-Miami-R32-Venus_Williams-Kiki_Bertens,2,B-DTL,23,11,3,3,5,11,12
20180325-W-Miami-R32-Venus_Williams-Kiki_Bertens,2,B-IO,2,1,1,0,0,1,1
20180325-W-Miami-R32-Venus_Williams-Kiki_Bertens,2,S-XC,20,4,0,2,2,10,10
20180325-W-Miami-R32-Venus_Williams-Kiki_Bertens,2,S-DTM,7,0,0,0,0,0,7
20180325-W-Miami-R32-Venus_Williams-Kiki_Bertens,2,S-DTL,2,0,0,0,0,1,1
20180325-W-Miami-R32-Venus_Williams-Kiki_Bertens,2,S-IO,1,0,0,0,0,0,1
20180904-W-US_Open-QF-Serena_Williams-Karolina_Pliskova,1,F-XC,31,9,4,2,3,21,10
20180904-W-US_Open-QF-Serena_Williams-Karolina_Pliskova,1,F-DTM,5,1,0,0,1,4,1
20180904-W-US_Open-QF-Serena_Williams-Karolina_Pliskova,1,F-DTL,18,11,5,0,6,10,8
20180904-W-US_Open-QF-Serena_Williams-Karolina_Pliskova,1,F-IO,6,2,2,0,0,4,2
20180904-W-US_Open-QF-Serena_Williams-Karolina_Pliskova,1,F-II,1,0,0,0,0,1,0
20180904-W-US_Open-QF-Serena_Williams-Karolina_Pliskova,1,B-XC,34,7,1,2,4,20,14
20180904-W-US_Open-QF-Serena_Williams-Karolina_Pliskova,1,B-DTM,7,0,0,0,0,4,3
20180904-W-US_Open-QF-Serena_Williams-Karolina_Pliskova,1,B-DTL,10,5,0,1,4,4,6
20180904-W-US_Open-QF-Serena_Williams-Karolina_Pliskova,1,B-IO,1,0,0,0,0,1,0
20180904-W-US_Open-QF-Serena_Williams-Karolina_Pliskova,1,S-XC,1,0,0,0,0,1,0
20180904-W-US_Open-QF-Serena_Williams-Karolina_Pliskova,1,S-DTM,1,0,0,0,0,1,0
20180904-W-US_Open-QF-Serena_Williams-Karolina_Pliskova,1,S-DTL,1,0,0,0,0,0,1
20180904-W-US_Open-QF-Serena_Williams-Karolina_Pliskova,2,F-XC,27,4,1,0,3,9,18
20180904-W-US_Open-QF-Serena_Williams-Karolina_Pliskova,2,F-DTM,5,2,0,0,2,1,4
20180904-W-US_Open-QF-Serena_Williams-Karolina_Pliskova,2,F-DTL,9,3,0,1,2,4,5
20180904-W-US_Open-QF-Serena_Williams-Karolina_Pliskova,2,F-IO,9,0,0,0,0,1,8
20180904-W-US_Open-QF-Serena_Williams-Karolina_Pliskova,2,F-II,3,1,0,0,1,0,3
20180904-W-US_Open-QF-Serena_Williams-Karolina_Pliskova,2,B-XC,23,5,1,1,3,9,14
20180904-W-US_Open-QF-Serena_Williams-Karolina_Pliskova,2,B-DTM,8,0,0,0,0,2,6
20180904-W-US_Open-QF-Serena_Williams-Karolina_Pliskova,2,B-DTL,14,6,1,1,4,5,9
20180904-W-US_Open-QF-Serena_Williams-Karolina_Pliskova,2,B-IO,1,0,0,0,0,0,1
20180904-W-US_Open-QF-Serena_Williams-Karolina_Pliskova,2,S-XC,3,0,0,0,0,2,1
20180904-W-US_Open-QF-Serena_Williams-Karolina_Pliskova,2,S-DTM,1,0,0,0,0,0,1
20180904-W-US_Open-QF-Serena_Williams-Karolina_Pliskova,2,S-DTL,3,0,0,0,0,1,2
20000610-W-Roland_Garros-F-Conchita_Martinez-Mary_Pierce,1,F-XC,54,9,5,3,1,29,25
20000610-W-Roland_Garros-F-Conchita_Martinez-Mary_Pierce,1,F-DTM,35,2,0,1,1,14,21
20000610-W-Roland_Garros-F-Conchita_Martinez-Mary_Pierce,1,F-DTL,28,8,2,1,5,11,17
20000610-W-Roland_Garros-F-Conchita_Martinez-Mary_Pierce,1,F-IO,14,4,1,0,3,3,11
20000610-W-Roland_Garros-F-Conchita_Martinez-Mary_Pierce,1,F-II,7,1,1,0,0,6,1
20000610-W-Roland_Garros-F-Conchita_Martinez-Mary_Pierce,1,B-XC,33,7,1,1,5,16,17
20000610-W-Roland_Garros-F-Conchita_Martinez-Mary_Pierce,1,B-DTM,26,1,0,0,1,10,16
20000610-W-Roland_Garros-F-Conchita_Martinez-Mary_Pierce,1,B-DTL,5,3,2,0,1,2,3
20000610-W-Roland_Garros-F-Conchita_Martinez-Mary_Pierce,1,B-IO,3,2,1,0,1,1,2
20000610-W-Roland_Garros-F-Conchita_Martinez-Mary_Pierce,1,S-XC,16,0,0,0,0,6,10
20000610-W-Roland_Garros-F-Conchita_Martinez-Mary_Pierce,1,S-DTM,28,2,0,2,0,12,16
20000610-W-Roland_Garros-F-Conchita_Martinez-Mary_Pierce,1,S-DTL,18,3,0,0,3,3,15
20000610-W-Roland_Garros-F-Conchita_Martinez-Mary_Pierce,1,S-IO,1,0,0,0,0,0,1
20000610-W-Roland_Garros-F-Conchita_Martinez-Mary_Pierce,2,F-XC,60,14,5,4,5,37,23
20000610-W-Roland_Garros-F-Conchita_Martinez-Mary_Pierce,2,F-DTM,25,2,0,0,2,14,11
20000610-W-Roland_Garros-F-Conchita_Martinez-Mary_Pierce,2,F-DTL,26,5,2,0,3,14,12
20000610-W-Roland_Garros-F-Conchita_Martinez-Mary_Pierce,2,F-IO,15,4,2,0,2,11,4
20000610-W-Roland_Garros-F-Conchita_Martinez-Mary_Pierce,2,B-XC,72,14,2,3,9,42,30
20000610-W-Roland_Garros-F-Conchita_Martinez-Mary_Pierce,2,B-DTM,25,3,0,0,3,10,15
20000610-W-Roland_Garros-F-Conchita_Martinez-Mary_Pierce,2,B-DTL,22,12,8,4,0,18,4
20000610-W-Roland_Garros-F-Conchita_Martinez-Mary_Pierce,2,B-IO,14,3,1,1,1,6,8
20000610-W-Roland_Garros-F-Conchita_Martinez-Mary_Pierce,2,S-DTM,1,0,0,0,0,0,1
20000610-W-Roland_Garros-F-Conchita_Martinez-Mary_Pierce,2,S-DTL,1,0,0,0,0,1,0
19960503-W-Hamburg-QF-Martina_Hingis-Mary_Pierce,1,F-XC,57,7,4,0,3,24,33
19960503-W-Hamburg-QF-Martina_Hingis-Mary_Pierce,1,F-DTM,12,2,0,1,1,8,4
19960503-W-Hamburg-QF-Martina_Hingis-Mary_Pierce,1,F-DTL,47,6,1,1,4,27,20
19960503-W-Hamburg-QF-Martina_Hingis-Mary_Pierce,1,F-IO,17,2,1,0,1,6,11
19960503-W-Hamburg-QF-Martina_Hingis-Mary_Pierce,1,B-XC,45,8,2,4,2,28,17
19960503-W-Hamburg-QF-Martina_Hingis-Mary_Pierce,1,B-DTM,10,0,0,0,0,7,3
19960503-W-Hamburg-QF-Martina_Hingis-Mary_Pierce,1,B-DTL,31,12,4,3,5,20,11
19960503-W-Hamburg-QF-Martina_Hingis-Mary_Pierce,1,B-IO,1,0,0,0,0,0,1
19960503-W-Hamburg-QF-Martina_Hingis-Mary_Pierce,1,B-II,1,0,0,0,0,1,0
19960503-W-Hamburg-QF-Martina_Hingis-Mary_Pierce,1,S-XC,4,0,0,0,0,0,4
19960503-W-Hamburg-QF-Martina_Hingis-Mary_Pierce,1,S-DTM,4,0,0,0,0,2,2
19960503-W-Hamburg-QF-Martina_Hingis-Mary_Pierce,1,S-DTL,2,0,0,0,0,0,2
19960503-W-Hamburg-QF-Martina_Hingis-Mary_Pierce,2,F-XC,43,12,4,3,5,24,19
19960503-W-Hamburg-QF-Martina_Hingis-Mary_Pierce,2,F-DTM,10,0,0,0,0,5,5
19960503-W-Hamburg-QF-Martina_Hingis-Mary_Pierce,2,F-DTL,33,8,4,1,3,17,16
19960503-W-Hamburg-QF-Martina_Hingis-Mary_Pierce,2,F-IO,8,4,2,0,2,3,5
19960503-W-Hamburg-QF-Martina_Hingis-Mary_Pierce,2,F-II,2,1,0,0,1,1,1
19960503-W-Hamburg-QF-Martina_Hingis-Mary_Pierce,2,B-XC,55,8,1,5,2,22,33
19960503-W-Hamburg-QF-Martina_Hingis-Mary_Pierce,2,B-DTM,4,0,0,0,0,3,1
19960503-W-Hamburg-QF-Martina_Hingis-Mary_Pierce,2,B-DTL,57,19,7,6,6,30,27
19960503-W-Hamburg-QF-Martina_Hingis-Mary_Pierce,2,B-IO,8,2,0,0,2,3,5
19960503-W-Hamburg-QF-Martina_Hingis-Mary_Pierce,2,S-XC,3,0,0,0,0,1,2
19960503-W-Hamburg-QF-Martina_Hingis-Mary_Pierce,2,S-DTM,1,0,0,0,0,0,1
19960503-W-Hamburg-QF-Martina_Hingis-Mary_Pierce,2,S-DTL,1,0,0,0,0,1,0
19990605-W-Roland_Garros-F-Steffi_Graf-Martina_Hingis,1,F-XC,63,20,3,12,5,45,18
19990605-W-Roland_Garros-F-Steffi_Graf-Martina_Hingis,1,F-DTM,26,0,0,0,0,13,13
19990605-W-Roland_Garros-F-Steffi_Graf-Martina_Hingis,1,F-DTL,15,4,2,2,0,12,3
19990605-W-Roland_Garros-F-Steffi_Graf-Martina_Hingis,1,F-IO,42,12,5,5,2,24,18
19990605-W-Roland_Garros-F-Steffi_Graf-Martina_Hingis,1,F-II,15,4,1,1,2,7,8
19990605-W-Roland_Garros-F-Steffi_Graf-Martina_Hingis,1,B-XC,6,2,1,0,1,3,3
19990605-W-Roland_Garros-F-Steffi_Graf-Martina_Hingis,1,B-DTM,4,1,0,0,1,2,2
19990605-W-Roland_Garros-F-Steffi_Graf-Martina_Hingis,1,B-DTL,5,5,2,0,3,2,3
19990605-W-Roland_Garros-F-Steffi_Graf-Martina_Hingis,1,S-XC,105,7,2,1,4,54,51
19990605-W-Roland_Garros-F-Steffi_Graf-Martina_Hingis,1,S-DTM,62,8,0,2,6,33,29
19990605-W-Roland_Garros-F-Steffi_Graf-Martina_Hingis,1,S-DTL,47,6,0,2,4,30,17
19990605-W-Roland_Garros-F-Steffi_Graf-Martina_Hingis,1,S-IO,4,0,0,0,0,2,2
19990605-W-Roland_Garros-F-Steffi_Graf-Martina_Hingis,2,F-XC,55,15,6,3,6,19,36
19990605-W-Roland_Garros-F-Steffi_Graf-Martina_Hingis,2,F-DTM,29,0,0,0,0,9,20
19990605-W-Roland_Garros-F-Steffi_Graf-Martina_Hingis,2,F-DTL,46,5,1,1,3,16,30
19990605-W-Roland_Garros-F-Steffi_Graf-Martina_Hingis,2,F-IO,33,7,3,2,2,22,11
19990605-W-Roland_Garros-F-Steffi_Graf-Martina_Hingis,2,B-XC,132,14,3,1,10,61,71
19990605-W-Roland_Garros-F-Steffi_Graf-Martina_Hingis,2,B-DTM,39,2,0,1,1,16,23
19990605-W-Roland_Garros-F-Steffi_Graf-Martina_Hingis,2,B-DTL,22,12,6,2,4,12,10
19990605-W-Roland_Garros-F-Steffi_Graf-Martina_Hingis,2,B-IO,13,3,1,0,2,5,8
19990605-W-Roland_Garros-F-Steffi_Graf-Martina_Hingis,2,S-XC,7,1,0,0,1,3,4
19990605-W-Roland_Garros-F-Steffi_Graf-Martina_Hingis,2,S-DTM,6,0,0,0,0,1,5
19990605-W-Roland_Garros-F-Steffi_Graf-Martina_Hingis,2,S-DTL,1,0,0,0,0,1,0
19990605-W-Roland_Garros-F-Steffi_Graf-Martina_Hingis,2,S-IO,2,1,0,0,1,0,2
20110420-W-Stuttgart-R16-Na_Li-Sabine_Lisicki,1,F-XC,42,7,0,4,3,23,19
20110420-W-Stuttgart-R16-Na_Li-Sabine_Lisicki,1,F-DTM,13,0,0,0,0,4,9
20110420-W-Stuttgart-R16-Na_Li-Sabine_Lisicki,1,F-DTL,16,8,3,1,4,7,9
20110420-W-Stuttgart-R16-Na_Li-Sabine_Lisicki,1,F-IO,4,3,2,1,0,3,1
20110420-W-Stuttgart-R16-Na_Li-Sabine_Lisicki,1,F-II,2,2,2,0,0,2,0
20110420-W-Stuttgart-R16-Na_Li-Sabine_Lisicki,1,B-XC,37,13,4,5,4,17,20
20110420-W-Stuttgart-R16-Na_Li-Sabine_Lisicki,1,B-DTM,13,2,0,1,1,8,5
20110420-W-Stuttgart-R16-Na_Li-Sabine_Lisicki,1,B-DTL,12,3,1,0,2,8,4
20110420-W-Stuttgart-R16-Na_Li-Sabine_Lisicki,1,B-IO,7,2,0,0,2,2,5
20110420-W-Stuttgart-R16-Na_Li-Sabine_Lisicki,1,S-XC,2,0,0,0,0,0,2
20110420-W-Stuttgart-R16-Na_Li-Sabine_Lisicki,1,S-DTM,3,0,0,0,0,0,3
20110420-W-Stuttgart-R16-Na_Li-Sabine_Lisicki,1,S-DTL,1,0,0,0,0,0,1
20110420-W-Stuttgart-R16-Na_Li-Sabine_Lisicki,2,F-XC,44,10,1,1,8,21,23
20110420-W-Stuttgart-R16-Na_Li-Sabine_Lisicki,2,F-DTM,4,0,0,0,0,0,4
20110420-W-Stuttgart-R16-Na_Li-Sabine_Lisicki,2,F-DTL,14,9,6,0,3,8,6
20110420-W-Stuttgart-R16-Na_Li-Sabine_Lisicki,2,F-IO,18,6,4,2,0,13,5
20110420-W-Stuttgart-R16-Na_Li-Sabine_Lisicki,2,B-XC,21,6,2,2,2,14,7
20110420-W-Stuttgart-R16-Na_Li-Sabine_Lisicki,2,B-DTM,13,2,0,0,2,8,5
20110420-W-Stuttgart-R16-Na_Li-Sabine_Lisicki,2,B-DTL,11,3,2,0,1,6,5
20110420-W-Stuttgart-R16-Na_Li-Sabine_Lisicki,2,B-IO,7,5,1,2,2,4,3
20110420-W-Stuttgart-R16-Na_Li-Sabine_Lisicki,2,S-DTM,1,0,0,0,0,1,0
20110420-W-Stuttgart-R16-Na_Li-Sabine_Lisicki,2,S-DTL,1,0,0,0,0,1,0
20200116-W-Adelaide-QF-Ashleigh_Barty-Marketa_Vondrousova,1,F-XC,70,17,5,3,9,45,25
20200116-W-Adelaide-QF-Ashleigh_Barty-Marketa_Vondrousova,1,F-DTM,8,1,0,0,1,6,2
20200116-W-Adelaide-QF-Ashleigh_Barty-Marketa_Vondrousova,1,F-DTL,20,7,0,2,5,12,8
20200116-W-Adelaide-QF-Ashleigh_Barty-Marketa_Vondrousova,1,F-IO,12,4,3,0,1,8,4
20200116-W-Adelaide-QF-Ashleigh_Barty-Marketa_Vondrousova,1,F-II,11,4,2,1,1,6,5
20200116-W-Adelaide-QF-Ashleigh_Barty-Marketa_Vondrousova,1,B-XC,10,5,0,2,3,6,4
20200116-W-Adelaide-QF-Ashleigh_Barty-Marketa_Vondrousova,1,B-DTM,13,2,0,0,2,6,7
20200116-W-Adelaide-QF-Ashleigh_Barty-Marketa_Vondrousova,1,B-DTL,4,1,0,1,0,4,0
20200116-W-Adelaide-QF-Ashleigh_Barty-Marketa_Vondrousova,1,S-XC,24,3,1,2,0,18,6
20200116-W-Adelaide-QF-Ashleigh_Barty-Marketa_Vondrousova,1,S-DTM,17,0,0,0,0,11,6
20200116-W-Adelaide-QF-Ashleigh_Barty-Marketa_Vondrousova,1,S-DTL,15,4,1,2,1,13,2
20200116-W-Adelaide-QF-Ashleigh_Barty-Marketa_Vondrousova,1,S-IO,1,0,0,0,0,1,0
20200116-W-Adelaide-QF-Ashleigh_Barty-Marketa_Vondrousova,2,F-XC,64,4,0,2,2,20,44
20200116-W-Adelaide-QF-Ashleigh_Barty-Marketa_Vondrousova,2,F-DTM,4,0,0,0,0,1,3
20200116-W-Adelaide-QF-Ashleigh_Barty-Marketa_Vondrousova,2,F-DTL,9,3,0,0,3,0,9
20200116-W-Adelaide-QF-Ashleigh_Barty-Marketa_Vondrousova,2,F-IO,3,1,0,0,1,2,1
20200116-W-Adelaide-QF-Ashleigh_Barty-Marketa_Vondrousova,2,B-XC,50,1,0,1,0,21,29
20200116-W-Adelaide-QF-Ashleigh_Barty-Marketa_Vondrousova,2,B-DTM,15,3,0,0,3,5,10
20200116-W-Adelaide-QF-Ashleigh_Barty-Marketa_Vondrousova,2,B-DTL,12,4,1,0,3,2,10
20200116-W-Adelaide-QF-Ashleigh_Barty-Marketa_Vondrousova,2,B-IO,6,1,1,0,0,4,2
20200116-W-Adelaide-QF-Ashleigh_Barty-Marketa_Vondrousova,2,S-XC,3,0,0,0,0,1,2
20200116-W-Adelaide-QF-Ashleigh_Barty-Marketa_Vondrousova,2,S-DTM,1,0,0,0,0,0,1
20200116-W-Adelaide-QF-Ashleigh_Barty-Marketa_Vondrousova,2,S-DTL,14,4,0,2,2,2,12
20200116-W-Adelaide-QF-Ashleigh_Barty-Marketa_Vondrousova,2,S-IO,3,0,0,0,0,1,2
19990221-W-Hanover-F-Venus_Williams-Jana_Novotna,1,F-XC,45,9,2,0,7,23,22
19990221-W-Hanover-F-Venus_Williams-Jana_Novotna,1,F-DTM,12,1,0,0,1,8,4
19990221-W-Hanover-F-Venus_Williams-Jana_Novotna,1,F-DTL,19,7,1,2,4,10,9
19990221-W-Hanover-F-Venus_Williams-Jana_Novotna,1,F-IO,9,3,2,1,0,5,4
19990221-W-Hanover-F-Venus_Williams-Jana_Novotna,1,B-XC,56,6,1,2,3,20,36
19990221-W-Hanover-F-Venus_Williams-Jana_Novotna,1,B-DTM,19,2,0,0,2,6,13
19990221-W-Hanover-F-Venus_Williams-Jana_Novotna,1,B-DTL,30,12,6,2,4,17,13
19990221-W-Hanover-F-Venus_Williams-Jana_Novotna,1,B-IO,8,2,1,0,1,5,3
19990221-W-Hanover-F-Venus_Williams-Jana_Novotna,1,S-XC,1,0,0,0,0,1,0
19990221-W-Hanover-F-Venus_Williams-Jana_Novotna,2,F-XC,49,6,3,1,2,22,27
19990221-W-Hanover-F-Venus_Williams-Jana_Novotna,2,F-DTM,9,0,0,0,0,5,4
19990221-W-Hanover-F-Venus_Williams-Jana_Novotna,2,F-DTL,24,3,0,1,2,14,10
19990221-W-Hanover-F-Venus_Williams-Jana_Novotna,2,F-IO,20,3,1,0,2,11,9
19990221-W-Hanover-F-Venus_Williams-Jana_Novotna,2,F-II,2,0,0,0,0,0,2
19990221-W-Hanover-F-Venus_Williams-Jana_Novotna,2,B-XC,2,2,1,1,0,2,0
19990221-W-Hanover-F-Venus_Williams-Jana_Novotna,2,B-DTM,2,0,0,0,0,2,0
19990221-W-Hanover-F-Venus_Williams-Jana_Novotna,2,S-XC,53,5,0,1,4,26,27
19990221-W-Hanover-F-Venus_Williams-Jana_Novotna,2,S-DTM,13,0,0,0,0,7,6
19990221-W-Hanover-F-Venus_Williams-Jana_Novotna,2,S-DTL,14,3,1,2,0,12,2
19990221-W-Hanover-F-Venus_Williams-Jana_Novotna,2,S-IO,1,0,0,0,0,1,0
19950828-W-US_Open-R128-Monica_Seles-Ruxandra_Dragomir_Ilie,1,F-XC,37,3,1,1,1,17,20
19950828-W-US_Open-R128-Monica_Seles-Ruxandra_Dragomir_Ilie,1,F-DTM,7,0,0,0,0,3,4
19950828-W-US_Open-R128-Monica_Seles-Ruxandra_Dragomir_Ilie,1,F-DTL,13,9,4,4,1,10,3
19950828-W-US_Open-R128-Monica_Seles-Ruxandra_Dragomir_Ilie,1,F-IO,6,3,0,1,2,2,4
19950828-W-US_Open-R128-Monica_Seles-Ruxandra_Dragomir_Ilie,1,B-XC,27,13,4,4,5,17,10
19950828-W-US_Open-R128-Monica_Seles-Ruxandra_Dragomir_Ilie,1,B-DTM,13,1,0,0,1,7,6
19950828-W-US_Open-R128-Monica_Seles-Ruxandra_Dragomir_Ilie,1,B-DTL,10,2,0,2,0,6,4
19950828-W-US_Open-R128-Monica_Seles-Ruxandra_Dragomir_Ilie,1,B-IO,13,3,1,1,1,9,4
19950828-W-US_Open-R128-Monica_Seles-Ruxandra_Dragomir_Ilie,1,S-DTM,3,0,0,0,0,0,3
19950828-W-US_Open-R128-Monica_Seles-Ruxandra_Dragomir_Ilie,1,S-IO,1,0,0,0,0,1,0
19950828-W-US_Open-R128-Monica_Seles-Ruxandra_Dragomir_Ilie,2,F-XC,32,3,0,3,0,18,14
19950828-W-US_Open-R128-Monica_Seles-Ruxandra_Dragomir_Ilie,2,F-DTM,10,0,0,0,0,4,6
19950828-W-US_Open-R128-Monica_Seles-Ruxandra_Dragomir_Ilie,2,F-DTL,3,0,0,0,0,1,2
19950828-W-US_Open-R128-Monica_Seles-Ruxandra_Dragomir_Ilie,2,F-IO,5,1,0,0,1,2,3
19950828-W-US_Open-R128-Monica_Seles-Ruxandra_Dragomir_Ilie,2,F-II,1,1,0,0,1,0,1
19950828-W-US_Open-R128-Monica_Seles-Ruxandra_Dragomir_Ilie,2,B-XC,32,4,0,1,3,17,15
19950828-W-US_Open-R128-Monica_Seles-Ruxandra_Dragomir_Ilie,2,B-DTM,13,2,0,0,2,5,8
19950828-W-US_Open-R128-Monica_Seles-Ruxandra_Dragomir_Ilie,2,B-DTL,8,5,2,1,2,3,5
19950828-W-US_Open-R128-Monica_Seles-Ruxandra_Dragomir_Ilie,2,B-IO,2,0,0,0,0,0,2
19950828-W-US_Open-R128-Monica_Seles-Ruxandra_Dragomir_Ilie,2,S-XC,10,0,0,0,0,4,6
19950828-W-US_Open-R128-Monica_Seles-Ruxandra_Dragomir_Ilie,2,S-DTM,6,0,0,0,0,3,3
19950828-W-US_Open-R128-Monica_Seles-Ruxandra_Dragomir_Ilie,2,S-DTL,3,1,0,1,0,2,1
20200306-W-Monterrey-QF-Leylah_Annie_Fernandez-Elina_Svitolina,1,F-XC,59,18,3,4,11,26,33
20200306-W-Monterrey-QF-Leylah_Annie_Fernandez-Elina_Svitolina,1,F-DTM,22,3,0,0,3,10,12
20200306-W-Monterrey-QF-Leylah_Annie_Fernandez-Elina_Svitolina,1,F-DTL,16,6,4,0,2,8,8
20200306-W-Monterrey-QF-Leylah_Annie_Fernandez-Elina_Svitolina,1,F-IO,7,3,2,0,1,4,3
20200306-W-Monterrey-QF-Leylah_Annie_Fernandez-Elina_Svitolina,1,F-II,1,0,0,0,0,1,0
20200306-W-Monterrey-QF-Leylah_Annie_Fernandez-Elina_Svitolina,1,B-XC,18,5,1,1,3,10,8
20200306-W-Monterrey-QF-Leylah_Annie_Fernandez-Elina_Svitolina,1,B-DTM,22,2,0,0,2,12,10
20200306-W-Monterrey-QF-Leylah_Annie_Fernandez-Elina_Svitolina,1,B-DTL,13,7,1,1,5,3,10
20200306-W-Monterrey-QF-Leylah_Annie_Fernandez-Elina_Svitolina,1,B-IO,7,1,0,0,1,1,6
20200306-W-Monterrey-QF-Leylah_Annie_Fernandez-Elina_Svitolina,1,S-DTM,1,0,0,0,0,0,1
20200306-W-Monterrey-QF-Leylah_Annie_Fernandez-Elina_Svitolina,1,S-DTL,2,0,0,0,0,2,0
20200306-W-Monterrey-QF-Leylah_Annie_Fernandez-Elina_Svitolina,2,F-XC,32,8,1,3,4,13,19
20200306-W-Monterrey-QF-Leylah_Annie_Fernandez-Elina_Svitolina,2,F-DTM,24,1,0,0,1,15,9
20200306-W-Monterrey-QF-Leylah_Annie_Fernandez-Elina_Svitolina,2,F-DTL,10,2,1,0,1,5,5
20200306-W-Monterrey-QF-Leylah_Annie_Fernandez-Elina_Svitolina,2,F-IO,14,8,2,3,3,8,6
20200306-W-Monterrey-QF-Leylah_Annie_Fernandez-Elina_Svitolina,2,B-XC,41,9,4,3,2,26,15
20200306-W-Monterrey-QF-Leylah_Annie_Fernandez-Elina_Svitolina,2,B-DTM,22,0,0,0,0,19,3
20200306-W-Monterrey-QF-Leylah_Annie_Fernandez-Elina_Svitolina,2,B-DTL,12,5,1,0,4,4,8
20200306-W-Monterrey-QF-Leylah_Annie_Fernandez-Elina_Svitolina,2,B-IO,4,1,0,0,1,1,3
20200306-W-Monterrey-QF-Leylah_Annie_Fernandez-Elina_Svitolina,2,S-XC,3,0,0,0,0,0,3
20200306-W-Monterrey-QF-Leylah_Annie_Fernandez-Elina_Svitolina,2,S-DTM,4,0,0,0,0,1,3
20180312-W-Indian_Wells-R32-Venus_Williams-Serena_Williams,1,F-XC,27,5,3,1,1,14,13
20180312-W-Indian_Wells-R32-Venus_Williams-Serena_Williams,1,F-DTM,9,0,0,0,0,4,5
20180312-W-Indian_Wells-R32-Venus_Williams-Serena_Williams,1,F-DTL,11,8,4,0,4,5,6
20180312-W-Indian_Wells-R32-Venus_Williams-Serena_Williams,1,F-IO,13,6,3,2,1,8,5
20180312-W-Indian_Wells-R32-Venus_Williams-Serena_Williams,1,F-II,2,1,1,0,0,1,1
20180312-W-Indian_Wells-R32-Venus_Williams-Serena_Williams,1,B-XC,18,0,0,0,0,6,12
20180312-W-Indian_Wells-R32-Venus_Williams-Serena_Williams,1,B-DTM,9,1,0,1,0,5,4
20180312-W-Indian_Wells-R32-Venus_Williams-Serena_Williams,1,B-DTL,4,3,0,0,3,1,3
20180312-W-Indian_Wells-R32-Venus_Williams-Serena_Williams,1,B-IO,2,1,1,0,0,1,1
20180312-W-Indian_Wells-R32-Venus_Williams-Serena_Williams,1,S-XC,5,0,0,0,0,3,2
20180312-W-Indian_Wells-R32-Venus_Williams-Serena_Williams,1,S-DTM,2,0,0,0,0,0,2
20180312-W-Indian_Wells-R32-Venus_Williams-Serena_Williams,1,S-DTL,1,0,0,0,0,1,0
20180312-W-Indian_Wells-R32-Venus_Williams-Serena_Williams,2,F-XC,25,12,4,1,7,11,14
20180312-W-Indian_Wells-R32-Venus_Williams-Serena_Williams,2,F-DTM,8,0,0,0,0,4,4
20180312-W-Indian_Wells-R32-Venus_Williams-Serena_Williams,2,F-DTL,10,6,1,1,4,4,6
20180312-W-Indian_Wells-R32-Venus_Williams-Serena_Williams,2,F-IO,10,6,2,1,3,4,6
20180312-W-Indian_Wells-R32-Venus_Williams-Serena_Williams,2,B-XC,36,11,2,3,6,20,16
20180312-W-Indian_Wells-R32-Venus_Williams-Serena_Williams,2,B-DTM,8,0,0,0,0,4,4
20180312-W-Indian_Wells-R32-Venus_Williams-Serena_Williams,2,B-DTL,14,4,3,0,1,11,3
20180312-W-Indian_Wells-R32-Venus_Williams-Serena_Williams,2,B-IO,1,0,0,0,0,1,0
20180312-W-Indian_Wells-R32-Venus_Williams-Serena_Williams,2,S-XC,1,0,0,0,0,0,1
20180312-W-Indian_Wells-R32-Venus_Williams-Serena_Williams,2,S-DTM,4,0,0,0,0,1,3
20171111-W-Fed_Cup_World_Group_F-RR-Aliaksandra_Sasnovich-Coco_Vandeweghe,1,F-XC,22,4,2,1,1,15,7
20171111-W-Fed_Cup_World_Group_F-RR-Aliaksandra_Sasnovich-Coco_Vandeweghe,1,F-DTM,5,0,0,0,0,4,1
20171111-W-Fed_Cup_World_Group_F-RR-Aliaksandra_Sasnovich-Coco_Vandeweghe,1,F-DTL,22,3,1,1,1,11,11
20171111-W-Fed_Cup_World_Group_F-RR-Aliaksandra_Sasnovich-Coco_Vandeweghe,1,F-IO,18,7,0,1,6,4,14
20171111-W-Fed_Cup_World_Group_F-RR-Aliaksandra_Sasnovich-Coco_Vandeweghe,1,F-II,1,1,1,0,0,1,0
20171111-W-Fed_Cup_World_Group_F-RR-Aliaksandra_Sasnovich-Coco_Vandeweghe,1,B-XC,45,9,1,2,6,20,25
20171111-W-Fed_Cup_World_Group_F-RR-Aliaksandra_Sasnovich-Coco_Vandeweghe,1,B-DTM,12,0,0,0,0,4,8
20171111-W-Fed_Cup_World_Group_F-RR-Aliaksandra_Sasnovich-Coco_Vandeweghe,1,B-DTL,16,9,1,5,3,8,8
20171111-W-Fed_Cup_World_Group_F-RR-Aliaksandra_Sasnovich-Coco_Vandeweghe,1,B-IO,4,3,2,0,1,3,1
20171111-W-Fed_Cup_World_Group_F-RR-Aliaksandra_Sasnovich-Coco_Vandeweghe,1,S-XC,2,0,0,0,0,0,2
20171111-W-Fed_Cup_World_Group_F-RR-Aliaksandra_Sasnovich-Coco_Vandeweghe,1,S-DTM,1,0,0,0,0,0,1
20171111-W-Fed_Cup_World_Group_F-RR-Aliaksandra_Sasnovich-Coco_Vandeweghe,2,F-XC,40,11,4,3,4,19,21
20171111-W-Fed_Cup_World_Group_F-RR-Aliaksandra_Sasnovich-Coco_Vandeweghe,2,F-DTM,12,1,0,0,1,6,6
20171111-W-Fed_Cup_World_Group_F-RR-Aliaksandra_Sasnovich-Coco_Vandeweghe,2,F-DTL,3,1,0,0,1,1,2
20171111-W-Fed_Cup_World_Group_F-RR-Aliaksandra_Sasnovich-Coco_Vandeweghe,2,F-IO,9,3,3,0,0,7,2
20171111-W-Fed_Cup_World_Group_F-RR-Aliaksandra_Sasnovich-Coco_Vandeweghe,2,F-II,3,3,1,1,1,2,1
20171111-W-Fed_Cup_World_Group_F-RR-Aliaksandra_Sasnovich-Coco_Vandeweghe,2,B-XC,50,11,0,7,4,30,20
20171111-W-Fed_Cup_World_Group_F-RR-Aliaksandra_Sasnovich-Coco_Vandeweghe,2,B-DTM,10,0,0,0,0,8,2
20171111-W-Fed_Cup_World_Group_F-RR-Aliaksandra_Sasnovich-Coco_Vandeweghe,2,B-DTL,9,4,1,2,1,5,4
20171111-W-Fed_Cup_World_Group_F-RR-Aliaksandra_Sasnovich-Coco_Vandeweghe,2,B-IO,1,1,0,0,1,0,1
20171111-W-Fed_Cup_World_Group_F-RR-Aliaksandra_Sasnovich-Coco_Vandeweghe,2,S-XC,6,1,0,0,1,0,6
20171111-W-Fed_Cup_World_Group_F-RR-Aliaksandra_Sasnovich-Coco_Vandeweghe,2,S-DTM,3,0,0,0,0,3,0
20171111-W-Fed_Cup_World_Group_F-RR-Aliaksandra_Sasnovich-Coco_Vandeweghe,2,S-DTL,4,3,0,1,2,1,3
20030703-W-Wimbledon-SF-Venus_Williams-Kim_Clijsters,1,F-XC,57,11,2,5,4,27,30
20030703-W-Wimbledon-SF-Venus_Williams-Kim_Clijsters,1,F-DTM,15,1,0,1,0,8,7
20030703-W-Wimbledon-SF-Venus_Williams-Kim_Clijsters,1,F-DTL,37,6,2,1,3,14,23
20030703-W-Wimbledon-SF-Venus_Williams-Kim_Clijsters,1,F-IO,14,9,1,4,4,8,6
20030703-W-Wimbledon-SF-Venus_Williams-Kim_Clijsters,1,B-XC,68,9,0,5,4,34,34
20030703-W-Wimbledon-SF-Venus_Williams-Kim_Clijsters,1,B-DTM,25,2,0,0,2,9,16
20030703-W-Wimbledon-SF-Venus_Williams-Kim_Clijsters,1,B-DTL,43,24,2,15,7,23,20
20030703-W-Wimbledon-SF-Venus_Williams-Kim_Clijsters,1,B-IO,9,2,0,1,1,5,4
20030703-W-Wimbledon-SF-Venus_Williams-Kim_Clijsters,1,S-XC,3,0,0,0,0,2,1
20030703-W-Wimbledon-SF-Venus_Williams-Kim_Clijsters,1,S-DTM,1,0,0,0,0,0,1
20030703-W-Wimbledon-SF-Venus_Williams-Kim_Clijsters,1,S-DTL,1,0,0,0,0,0,1
20030703-W-Wimbledon-SF-Venus_Williams-Kim_Clijsters,2,F-XC,61,9,1,5,3,36,25
20030703-W-Wimbledon-SF-Venus_Williams-Kim_Clijsters,2,F-DTM,13,0,0,0,0,5,8
20030703-W-Wimbledon-SF-Venus_Williams-Kim_Clijsters,2,F-DTL,21,7,4,0,3,11,10
20030703-W-Wimbledon-SF-Venus_Williams-Kim_Clijsters,2,F-IO,22,5,3,2,0,16,6
20030703-W-Wimbledon-SF-Venus_Williams-Kim_Clijsters,2,B-XC,85,14,3,2,9,44,41
20030703-W-Wimbledon-SF-Venus_Williams-Kim_Clijsters,2,B-DTM,14,0,0,0,0,4,10
20030703-W-Wimbledon-SF-Venus_Williams-Kim_Clijsters,2,B-DTL,26,13,6,1,6,15,11
20030703-W-Wimbledon-SF-Venus_Williams-Kim_Clijsters,2,B-IO,8,1,0,1,0,5,3
20030703-W-Wimbledon-SF-Venus_Williams-Kim_Clijsters,2,S-XC,8,1,0,0,1,1,7
20030703-W-Wimbledon-SF-Venus_Williams-Kim_Clijsters,2,S-DTM,2,0,0,0,0,1,1
20030703-W-Wimbledon-SF-Venus_Williams-Kim_Clijsters,2,S-DTL,2,0,0,0,0,2,0
20150419-W-Fed_Cup_World_Group_PO-RR-Serena_Williams-Sara_Errani,1,F-XC,44,9,3,1,5,20,24
20150419-W-Fed_Cup_World_Group_PO-RR-Serena_Williams-Sara_Errani,1,F-DTM,9,1,0,1,0,3,6
20150419-W-Fed_Cup_World_Group_PO-RR-Serena_Williams-Sara_Errani,1,F-DTL,15,8,4,0,4,6,9
20150419-W-Fed_Cup_World_Group_PO-RR-Serena_Williams-Sara_Errani,1,F-IO,18,7,5,0,2,10,8
20150419-W-Fed_Cup_World_Group_PO-RR-Serena_Williams-Sara_Errani,1,F-II,2,0,0,0,0,1,1
20150419-W-Fed_Cup_World_Group_PO-RR-Serena_Williams-Sara_Errani,1,B-XC,112,24,8,1,15,52,60
20150419-W-Fed_Cup_World_Group_PO-RR-Serena_Williams-Sara_Errani,1,B-DTM,24,0,0,0,0,11,13
20150419-W-Fed_Cup_World_Group_PO-RR-Serena_Williams-Sara_Errani,1,B-DTL,42,20,7,2,11,20,22
20150419-W-Fed_Cup_World_Group_PO-RR-Serena_Williams-Sara_Errani,1,B-IO,13,4,3,0,1,7,6
20150419-W-Fed_Cup_World_Group_PO-RR-Serena_Williams-Sara_Errani,1,S-XC,1,0,0,0,0,0,1
20150419-W-Fed_Cup_World_Group_PO-RR-Serena_Williams-Sara_Errani,1,S-DTM,3,0,0,0,0,0,3
20150419-W-Fed_Cup_World_Group_PO-RR-Serena_Williams-Sara_Errani,1,S-IO,1,0,0,0,0,1,0
20150419-W-Fed_Cup_World_Group_PO-RR-Serena_Williams-Sara_Errani,2,F-XC,38,7,1,3,3,22,16
20150419-W-Fed_Cup_World_Group_PO-RR-Serena_Williams-Sara_Errani,2,F-DTM,20,3,0,2,1,12,8
20150419-W-Fed_Cup_World_Group_PO-RR-Serena_Williams-Sara_Errani,2,F-DTL,31,8,2,5,1,21,10
20150419-W-Fed_Cup_World_Group_PO-RR-Serena_Williams-Sara_Errani,2,F-IO,19,5,0,1,4,7,12
20150419-W-Fed_Cup_World_Group_PO-RR-Serena_Williams-Sara_Errani,2,F-II,9,2,0,2,0,7,2
20150419-W-Fed_Cup_World_Group_PO-RR-Serena_Williams-Sara_Errani,2,B-XC,79,7,2,1,4,44,35
20150419-W-Fed_Cup_World_Group_PO-RR-Serena_Williams-Sara_Errani,2,B-DTM,23,1,0,1,0,11,12
20150419-W-Fed_Cup_World_Group_PO-RR-Serena_Williams-Sara_Errani,2,B-DTL,11,6,0,3,3,7,4
20150419-W-Fed_Cup_World_Group_PO-RR-Serena_Williams-Sara_Errani,2,B-IO,1,0,0,0,0,1,0
20150419-W-Fed_Cup_World_Group_PO-RR-Serena_Williams-Sara_Errani,2,S-XC,12,0,0,0,0,4,8
20150419-W-Fed_Cup_World_Group_PO-RR-Serena_Williams-Sara_Errani,2,S-DTM,4,0,0,0,0,1,3
20150419-W-Fed_Cup_World_Group_PO-RR-Serena_Williams-Sara_Errani,2,S-DTL,4,0,0,0,0,1,3
20171029-W-Singapore-F-Caroline_Wozniacki-Venus_Williams,1,F-XC,45,4,1,0,3,28,17
20171029-W-Singapore-F-Caroline_Wozniacki-Venus_Williams,1,F-DTM,23,1,1,0,0,14,9
20171029-W-Singapore-F-Caroline_Wozniacki-Venus_Williams,1,F-DTL,24,2,2,0,0,13,11
20171029-W-Singapore-F-Caroline_Wozniacki-Venus_Williams,1,F-IO,12,3,3,0,0,9,3
20171029-W-Singapore-F-Caroline_Wozniacki-Venus_Williams,1,B-XC,36,3,1,2,0,24,12
20171029-W-Singapore-F-Caroline_Wozniacki-Venus_Williams,1,B-DTM,15,0,0,0,0,8,7
20171029-W-Singapore-F-Caroline_Wozniacki-Venus_Williams,1,B-DTL,9,4,4,0,0,7,2
20171029-W-Singapore-F-Caroline_Wozniacki-Venus_Williams,1,B-IO,7,2,1,0,1,3,4
20171029-W-Singapore-F-Caroline_Wozniacki-Venus_Williams,1,S-XC,1,0,0,0,0,1,0
20171029-W-Singapore-F-Caroline_Wozniacki-Venus_Williams,1,S-DTM,2,0,0,0,0,0,2
20171029-W-Singapore-F-Caroline_Wozniacki-Venus_Williams,1,S-DTL,2,0,0,0,0,1,1
20171029-W-Singapore-F-Caroline_Wozniacki-Venus_Williams,2,F-XC,50,12,3,0,9,17,33
20171029-W-Singapore-F-Caroline_Wozniacki-Venus_Williams,2,F-DTM,17,2,0,0,2,2,15
20171029-W-Singapore-F-Caroline_Wozniacki-Venus_Williams,2,F-DTL,15,10,5,2,3,10,5
20171029-W-Singapore-F-Caroline_Wozniacki-Venus_Williams,2,F-IO,17,11,6,2,3,11,6
20171029-W-Singapore-F-Caroline_Wozniacki-Venus_Williams,2,B-XC,50,12,0,2,10,20,30
20171029-W-Singapore-F-Caroline_Wozniacki-Venus_Williams,2,B-DTM,15,1,0,0,1,4,11
20171029-W-Singapore-F-Caroline_Wozniacki-Venus_Williams,2,B-DTL,20,8,3,4,1,10,10
20171029-W-Singapore-F-Caroline_Wozniacki-Venus_Williams,2,B-IO,13,4,1,1,2,8,5
20171029-W-Singapore-F-Caroline_Wozniacki-Venus_Williams,2,S-DTM,3,1,0,0,1,0,3
20171029-W-Singapore-F-Caroline_Wozniacki-Venus_Williams,2,S-DTL,2,0,0,0,0,1,1
19990313-W-Indian_Wells-F-Serena_Williams-Steffi_Graf,1,F-XC,40,11,4,3,4,22,18
19990313-W-Indian_Wells-F-Serena_Williams-Steffi_Graf,1,F-DTM,18,2,0,0,2,8,10
19990313-W-Indian_Wells-F-Serena_Williams-Steffi_Graf,1,F-DTL,16,5,3,1,1,9,7
19990313-W-Indian_Wells-F-Serena_Williams-Steffi_Graf,1,F-IO,11,6,1,1,4,5,6
19990313-W-Indian_Wells-F-Serena_Williams-Steffi_Graf,1,B-XC,57,9,3,1,5,25,32
19990313-W-Indian_Wells-F-Serena_Williams-Steffi_Graf,1,B-DTM,27,4,1,0,3,13,14
19990313-W-Indian_Wells-F-Serena_Williams-Steffi_Graf,1,B-DTL,10,5,1,1,3,4,6
19990313-W-Indian_Wells-F-Serena_Williams-Steffi_Graf,1,B-IO,9,4,2,1,1,6,3
19990313-W-Indian_Wells-F-Serena_Williams-Steffi_Graf,1,S-XC,1,0,0,0,0,1,0
19990313-W-Indian_Wells-F-Serena_Williams-Steffi_Graf,1,S-DTM,2,0,0,0,0,1,1
19990313-W-Indian_Wells-F-Serena_Williams-Steffi_Graf,2,F-XC,59,11,1,5,5,35,24
19990313-W-Indian_Wells-F-Serena_Williams-Steffi_Graf,2,F-DTM,34,3,0,0,3,12,22
19990313-W-Indian_Wells-F-Serena_Williams-Steffi_Graf,2,F-DTL,9,3,1,2,0,5,4
19990313-W-Indian_Wells-F-Serena_Williams-Steffi_Graf,2,F-IO,25,7,0,3,4,13,12
19990313-W-Indian_Wells-F-Serena_Williams-Steffi_Graf,2,F-II,5,3,1,1,1,3,2
19990313-W-Indian_Wells-F-Serena_Williams-Steffi_Graf,2,B-XC,2,0,0,0,0,1,1
19990313-W-Indian_Wells-F-Serena_Williams-Steffi_Graf,2,B-DTL,6,2,2,0,0,2,4
19990313-W-Indian_Wells-F-Serena_Williams-Steffi_Graf,2,B-IO,1,0,0,0,0,0,1
19990313-W-Indian_Wells-F-Serena_Williams-Steffi_Graf,2,S-XC,37,7,0,2,5,19,18
19990313-W-Indian_Wells-F-Serena_Williams-Steffi_Graf,2,S-DTM,18,1,0,0,1,10,8
19990313-W-Indian_Wells-F-Serena_Williams-Steffi_Graf,2,S-DTL,3,0,0,0,0,3,0
19880908-W-US_Open-SF-Zina_Garrison-Gabriela_Sabatini,1,F-XC,21,6,2,0,4,11,10
19880908-W-US_Open-SF-Zina_Garrison-Gabriela_Sabatini,1,F-DTM,5,0,0,0,0,1,4
19880908-W-US_Open-SF-Zina_Garrison-Gabriela_Sabatini,1,F-DTL,13,2,0,2,0,8,5
19880908-W-US_Open-SF-Zina_Garrison-Gabriela_Sabatini,1,F-IO,15,6,1,1,4,9,6
19880908-W-US_Open-SF-Zina_Garrison-Gabriela_Sabatini,1,F-II,3,0,0,0,0,1,2
19880908-W-US_Open-SF-Zina_Garrison-Gabriela_Sabatini,1,B-XC,13,1,1,0,0,4,9
19880908-W-US_Open-SF-Zina_Garrison-Gabriela_Sabatini,1,B-DTM,6,1,0,1,0,5,1
19880908-W-US_Open-SF-Zina_Garrison-Gabriela_Sabatini,1,B-DTL,4,1,0,1,0,2,2
19880908-W-US_Open-SF-Zina_Garrison-Gabriela_Sabatini,1,S-XC,37,7,0,2,5,18,19
19880908-W-US_Open-SF-Zina_Garrison-Gabriela_Sabatini,1,S-DTM,9,1,0,1,0,3,6
19880908-W-US_Open-SF-Zina_Garrison-Gabriela_Sabatini,1,S-DTL,7,3,0,0,3,2,5
19880908-W-US_Open-SF-Zina_Garrison-Gabriela_Sabatini,1,S-IO,3,1,0,1,0,3,0
19880908-W-US_Open-SF-Zina_Garrison-Gabriela_Sabatini,2,F-XC,24,7,4,3,0,15,9
19880908-W-US_Open-SF-Zina_Garrison-Gabriela_Sabatini,2,F-DTM,9,0,0,0,0,1,8
19880908-W-US_Open-SF-Zina_Garrison-Gabriela_Sabatini,2,F-DTL,15,1,0,0,1,8,7
19880908-W-US_Open-SF-Zina_Garrison-Gabriela_Sabatini,2,F-IO,23,5,2,2,1,11,12
19880908-W-US_Open-SF-Zina_Garrison-Gabriela_Sabatini,2,F-II,6,0,0,0,0,4,2
19880908-W-US_Open-SF-Zina_Garrison-Gabriela_Sabatini,2,B-XC,33,6,2,2,2,23,10
19880908-W-US_Open-SF-Zina_Garrison-Gabriela_Sabatini,2,B-DTM,17,3,0,2,1,9,8
19880908-W-US_Open-SF-Zina_Garrison-Gabriela_Sabatini,2,B-DTL,9,1,1,0,0,3,6
19880908-W-US_Open-SF-Zina_Garrison-Gabriela_Sabatini,2,B-IO,2,2,1,1,0,2,0
19880908-W-US_Open-SF-Zina_Garrison-Gabriela_Sabatini,2,S-XC,12,1,0,1,0,6,6
19880908-W-US_Open-SF-Zina_Garrison-Gabriela_Sabatini,2,S-DTM,5,0,0,0,0,2,3
19880908-W-US_Open-SF-Zina_Garrison-Gabriela_Sabatini,2,S-DTL,4,3,0,2,1,2,2
19880908-W-US_Open-SF-Zina_Garrison-Gabriela_Sabatini,2,S-IO,1,0,0,0,0,1,0
20200814-W-Lexington-QF-Cori_Gauff-Ons_Jabeur,1,F-XC,21,6,0,4,2,14,7
20200814-W-Lexington-QF-Cori_Gauff-Ons_Jabeur,1,F-DTM,10,0,0,0,0,5,5
20200814-W-Lexington-QF-Cori_Gauff-Ons_Jabeur,1,F-DTL,26,6,4,0,2,17,9
20200814-W-Lexington-QF-Cori_Gauff-Ons_Jabeur,1,F-IO,17,1,0,0,1,10,7
20200814-W-Lexington-QF-Cori_Gauff-Ons_Jabeur,1,F-II,2,0,0,0,0,1,1
20200814-W-Lexington-QF-Cori_Gauff-Ons_Jabeur,1,B-XC,59,12,5,2,5,32,27
20200814-W-Lexington-QF-Cori_Gauff-Ons_Jabeur,1,B-DTM,13,2,0,0,2,8,5
20200814-W-Lexington-QF-Cori_Gauff-Ons_Jabeur,1,B-DTL,8,5,1,1,3,4,4
20200814-W-Lexington-QF-Cori_Gauff-Ons_Jabeur,1,B-IO,4,1,0,0,1,2,2
20200814-W-Lexington-QF-Cori_Gauff-Ons_Jabeur,1,S-XC,9,1,0,0,1,4,5
20200814-W-Lexington-QF-Cori_Gauff-Ons_Jabeur,1,S-DTM,4,0,0,0,0,1,3
20200814-W-Lexington-QF-Cori_Gauff-Ons_Jabeur,1,S-DTL,2,1,0,1,0,1,1
20200814-W-Lexington-QF-Cori_Gauff-Ons_Jabeur,2,F-XC,27,8,2,4,2,14,13
20200814-W-Lexington-QF-Cori_Gauff-Ons_Jabeur,2,F-DTM,17,1,1,0,0,5,12
20200814-W-Lexington-QF-Cori_Gauff-Ons_Jabeur,2,F-DTL,7,2,0,2,0,3,4
20200814-W-Lexington-QF-Cori_Gauff-Ons_Jabeur,2,F-IO,14,6,2,3,1,8,6
20200814-W-Lexington-QF-Cori_Gauff-Ons_Jabeur,2,F-II,4,3,1,0,2,2,2
20200814-W-Lexington-QF-Cori_Gauff-Ons_Jabeur,2,B-XC,32,10,1,2,7,13,19
20200814-W-Lexington-QF-Cori_Gauff-Ons_Jabeur,2,B-DTM,7,0,0,0,0,3,4
20200814-W-Lexington-QF-Cori_Gauff-Ons_Jabeur,2,B-DTL,13,7,2,0,5,5,8
20200814-W-Lexington-QF-Cori_Gauff-Ons_Jabeur,2,B-IO,2,0,0,0,0,1,1
20200814-W-Lexington-QF-Cori_Gauff-Ons_Jabeur,2,S-XC,33,3,1,0,2,16,17
20200814-W-Lexington-QF-Cori_Gauff-Ons_Jabeur,2,S-DTM,8,0,0,0,0,5,3
20200814-W-Lexington-QF-Cori_Gauff-Ons_Jabeur,2,S-DTL,9,2,0,1,1,4,5
20050904-W-US_Open-R16-Serena_Williams-Venus_Williams,1,F-XC,27,5,3,0,2,12,15
20050904-W-US_Open-R16-Serena_Williams-Venus_Williams,1,F-DTM,13,3,0,0,3,2,11
20050904-W-US_Open-R16-Serena_Williams-Venus_Williams,1,F-DTL,9,4,2,1,1,4,5
20050904-W-US_Open-R16-Serena_Williams-Venus_Williams,1,F-IO,10,7,1,2,4,5,5
20050904-W-US_Open-R16-Serena_Williams-Venus_Williams,1,B-XC,22,4,0,2,2,7,15
20050904-W-US_Open-R16-Serena_Williams-Venus_Williams,1,B-DTM,27,1,0,0,1,6,21
20050904-W-US_Open-R16-Serena_Williams-Venus_Williams,1,B-DTL,12,3,1,0,2,6,6
20050904-W-US_Open-R16-Serena_Williams-Venus_Williams,1,B-IO,5,2,0,0,2,1,4
20050904-W-US_Open-R16-Serena_Williams-Venus_Williams,1,S-XC,2,1,0,0,1,0,2
20050904-W-US_Open-R16-Serena_Williams-Venus_Williams,1,S-DTM,3,0,0,0,0,0,3
20050904-W-US_Open-R16-Serena_Williams-Venus_Williams,2,F-XC,43,17,4,3,10,26,17
20050904-W-US_Open-R16-Serena_Williams-Venus_Williams,2,F-DTM,14,1,0,0,1,12,2
20050904-W-US_Open-R16-Serena_Williams-Venus_Williams,2,F-DTL,3,3,0,1,2,1,2
20050904-W-US_Open-R16-Serena_Williams-Venus_Williams,2,F-IO,17,6,2,2,2,14,3
20050904-W-US_Open-R16-Serena_Williams-Venus_Williams,2,B-XC,26,5,1,2,2,19,7
20050904-W-US_Open-R16-Serena_Williams-Venus_Williams,2,B-DTM,12,2,0,1,1,6,6
20050904-W-US_Open-R16-Serena_Williams-Venus_Williams,2,B-DTL,10,8,2,2,4,5,5
20050904-W-US_Open-R16-Serena_Williams-Venus_Williams,2,B-IO,6,3,2,0,1,5,1
20090215-W-Paris-F-Amelie_Mauresmo-Elena_Dementieva,1,F-XC,55,17,4,5,8,23,32
20090215-W-Paris-F-Amelie_Mauresmo-Elena_Dementieva,1,F-DTM,18,1,0,0,1,7,11
20090215-W-Paris-F-Amelie_Mauresmo-Elena_Dementieva,1,F-DTL,70,7,2,1,4,32,38
20090215-W-Paris-F-Amelie_Mauresmo-Elena_Dementieva,1,F-IO,34,9,1,4,4,12,22
20090215-W-Paris-F-Amelie_Mauresmo-Elena_Dementieva,1,F-II,4,3,1,0,2,1,3
20090215-W-Paris-F-Amelie_Mauresmo-Elena_Dementieva,1,B-XC,52,8,2,2,4,24,28
20090215-W-Paris-F-Amelie_Mauresmo-Elena_Dementieva,1,B-DTM,17,3,0,1,2,7,10
20090215-W-Paris-F-Amelie_Mauresmo-Elena_Dementieva,1,B-DTL,7,1,0,0,1,1,6
20090215-W-Paris-F-Amelie_Mauresmo-Elena_Dementieva,1,B-IO,3,0,0,0,0,2,1
20090215-W-Paris-F-Amelie_Mauresmo-Elena_Dementieva,1,S-XC,41,1,0,0,1,18,23
20090215-W-Paris-F-Amelie_Mauresmo-Elena_Dementieva,1,S-DTM,25,1,1,0,0,13,12
20090215-W-Paris-F-Amelie_Mauresmo-Elena_Dementieva,1,S-DTL,8,1,0,0,1,1,7
20090215-W-Paris-F-Amelie_Mauresmo-Elena_Dementieva,1,S-IO,3,0,0,0,0,2,1
20090215-W-Paris-F-Amelie_Mauresmo-Elena_Dementieva,2,F-XC,82,9,4,3,2,50,32
20090215-W-Paris-F-Amelie_Mauresmo-Elena_Dementieva,2,F-DTM,25,3,1,0,2,17,8
20090215-W-Paris-F-Amelie_Mauresmo-Elena_Dementieva,2,F-DTL,23,6,3,1,2,15,8
20090215-W-Paris-F-Amelie_Mauresmo-Elena_Dementieva,2,F-IO,40,22,6,7,9,24,16
20090215-W-Paris-F-Amelie_Mauresmo-Elena_Dementieva,2,F-II,8,3,0,2,1,6,2
20090215-W-Paris-F-Amelie_Mauresmo-Elena_Dementieva,2,B-XC,109,18,3,10,5,66,43
20090215-W-Paris-F-Amelie_Mauresmo-Elena_Dementieva,2,B-DTM,30,1,0,0,1,14,16
20090215-W-Paris-F-Amelie_Mauresmo-Elena_Dementieva,2,B-DTL,18,3,1,0,2,8,10
20090215-W-Paris-F-Amelie_Mauresmo-Elena_Dementieva,2,B-IO,4,2,1,0,1,2,2
20090215-W-Paris-F-Amelie_Mauresmo-Elena_Dementieva,2,S-XC,7,1,0,1,0,4,3
20090215-W-Paris-F-Amelie_Mauresmo-Elena_Dementieva,2,S-DTM,4,1,0,0,1,1,3
20090215-W-Paris-F-Amelie_Mauresmo-Elena_Dementieva,2,S-DTL,8,1,0,0,1,2,6
20200826-W-Cincinnati-QF-Jessica_Pegula-Elise_Mertens,1,F-XC,27,6,3,0,3,12,15
20200826-W-Cincinnati-QF-Jessica_Pegula-Elise_Mertens,1,F-DTM,22,1,0,1,0,7,15
20200826-W-Cincinnati-QF-Jessica_Pegula-Elise_Mertens,1,F-DTL,2,0,0,0,0,0,2
20200826-W-Cincinnati-QF-Jessica_Pegula-Elise_Mertens,1,F-IO,10,3,0,1,2,5,5
20200826-W-Cincinnati-QF-Jessica_Pegula-Elise_Mertens,1,F-II,1,0,0,0,0,1,0
20200826-W-Cincinnati-QF-Jessica_Pegula-Elise_Mertens,1,B-XC,19,6,0,1,5,6,13
20200826-W-Cincinnati-QF-Jessica_Pegula-Elise_Mertens,1,B-DTM,22,1,0,1,0,8,14
20200826-W-Cincinnati-QF-Jessica_Pegula-Elise_Mertens,1,B-DTL,9,4,2,0,2,2,7
20200826-W-Cincinnati-QF-Jessica_Pegula-Elise_Mertens,1,B-IO,5,1,1,0,0,2,3
20200826-W-Cincinnati-QF-Jessica_Pegula-Elise_Mertens,1,S-XC,6,1,0,0,1,2,4
20200826-W-Cincinnati-QF-Jessica_Pegula-Elise_Mertens,1,S-DTM,7,0,0,0,0,2,5
20200826-W-Cincinnati-QF-Jessica_Pegula-Elise_Mertens,1,S-DTL,2,1,0,1,0,1,1
20200826-W-Cincinnati-QF-Jessica_Pegula-Elise_Mertens,1,S-IO,2,1,0,1,0,1,1
20200826-W-Cincinnati-QF-Jessica_Pegula-Elise_Mertens,2,F-XC,19,4,1,2,1,14,5
20200826-W-Cincinnati-QF-Jessica_Pegula-Elise_Mertens,2,F-DTM,29,3,0,2,1,18,11
20200826-W-Cincinnati-QF-Jessica_Pegula-Elise_Mertens,2,F-DTL,13,2,2,0,0,10,3
20200826-W-Cincinnati-QF-Jessica_Pegula-Elise_Mertens,2,F-IO,15,0,0,0,0,11,4
20200826-W-Cincinnati-QF-Jessica_Pegula-Elise_Mertens,2,B-XC,19,3,1,1,1,14,5
20200826-W-Cincinnati-QF-Jessica_Pegula-Elise_Mertens,2,B-DTM,20,3,0,2,1,13,7
20200826-W-Cincinnati-QF-Jessica_Pegula-Elise_Mertens,2,B-DTL,3,1,1,0,0,2,1
20200826-W-Cincinnati-QF-Jessica_Pegula-Elise_Mertens,2,B-IO,8,4,2,1,1,6,2
20200826-W-Cincinnati-QF-Jessica_Pegula-Elise_Mertens,2,S-XC,3,0,0,0,0,0,3
20200826-W-Cincinnati-QF-Jessica_Pegula-Elise_Mertens,2,S-DTM,2,0,0,0,0,1,1
20200826-W-Cincinnati-QF-Jessica_Pegula-Elise_Mertens,2,S-DTL,1,0,0,0,0,1,0
20200826-W-Cincinnati-QF-Jessica_Pegula-Elise_Mertens,2,S-IO,1,0,0,0,0,0,1
19970123-W-Australian_Open-SF-Mary_Pierce-Amanda_Coetzer,1,F-XC,62,15,6,4,5,31,31
19970123-W-Australian_Open-SF-Mary_Pierce-Amanda_Coetzer,1,F-DTM,9,0,0,0,0,4,5
19970123-W-Australian_Open-SF-Mary_Pierce-Amanda_Coetzer,1,F-DTL,19,8,3,2,3,14,5
19970123-W-Australian_Open-SF-Mary_Pierce-Amanda_Coetzer,1,F-IO,14,2,1,1,0,8,6
19970123-W-Australian_Open-SF-Mary_Pierce-Amanda_Coetzer,1,F-II,4,2,1,0,1,2,2
19970123-W-Australian_Open-SF-Mary_Pierce-Amanda_Coetzer,1,B-XC,58,13,5,3,5,36,22
19970123-W-Australian_Open-SF-Mary_Pierce-Amanda_Coetzer,1,B-DTM,9,1,0,1,0,3,6
19970123-W-Australian_Open-SF-Mary_Pierce-Amanda_Coetzer,1,B-DTL,19,8,7,1,0,14,5
19970123-W-Australian_Open-SF-Mary_Pierce-Amanda_Coetzer,1,B-IO,8,3,2,0,1,5,3
19970123-W-Australian_Open-SF-Mary_Pierce-Amanda_Coetzer,1,S-XC,2,0,0,0,0,1,1
19970123-W-Australian_Open-SF-Mary_Pierce-Amanda_Coetzer,1,S-DTM,3,0,0,0,0,3,0
19970123-W-Australian_Open-SF-Mary_Pierce-Amanda_Coetzer,1,S-IO,1,0,0,0,0,1,0
19970123-W-Australian_Open-SF-Mary_Pierce-Amanda_Coetzer,2,F-XC,48,10,6,1,3,24,24
19970123-W-Australian_Open-SF-Mary_Pierce-Amanda_Coetzer,2,F-DTM,20,0,0,0,0,9,11
19970123-W-Australian_Open-SF-Mary_Pierce-Amanda_Coetzer,2,F-DTL,23,2,1,1,0,10,13
19970123-W-Australian_Open-SF-Mary_Pierce-Amanda_Coetzer,2,F-IO,11,1,1,0,0,5,6
19970123-W-Australian_Open-SF-Mary_Pierce-Amanda_Coetzer,2,F-II,1,0,0,0,0,1,0
19970123-W-Australian_Open-SF-Mary_Pierce-Amanda_Coetzer,2,B-XC,29,1,0,1,0,15,14
19970123-W-Australian_Open-SF-Mary_Pierce-Amanda_Coetzer,2,B-DTM,26,1,0,0,1,10,16
19970123-W-Australian_Open-SF-Mary_Pierce-Amanda_Coetzer,2,B-DTL,16,1,1,0,0,10,6
19970123-W-Australian_Open-SF-Mary_Pierce-Amanda_Coetzer,2,B-IO,3,1,0,0,1,0,3
19970123-W-Australian_Open-SF-Mary_Pierce-Amanda_Coetzer,2,S-XC,14,2,0,1,1,4,10
19970123-W-Australian_Open-SF-Mary_Pierce-Amanda_Coetzer,2,S-DTM,7,0,0,0,0,2,5
19970123-W-Australian_Open-SF-Mary_Pierce-Amanda_Coetzer,2,S-DTL,3,0,0,0,0,0,3
20200826-W-Cincinnati-QF-Maria_Sakkari-Johanna_Konta,1,F-XC,18,6,1,2,3,9,9
20200826-W-Cincinnati-QF-Maria_Sakkari-Johanna_Konta,1,F-DTM,19,2,0,1,1,5,14
20200826-W-Cincinnati-QF-Maria_Sakkari-Johanna_Konta,1,F-DTL,8,1,0,1,0,5,3
20200826-W-Cincinnati-QF-Maria_Sakkari-Johanna_Konta,1,F-IO,9,3,0,1,2,3,6
20200826-W-Cincinnati-QF-Maria_Sakkari-Johanna_Konta,1,F-II,2,1,1,0,0,2,0
20200826-W-Cincinnati-QF-Maria_Sakkari-Johanna_Konta,1,B-XC,20,4,0,1,3,4,16
20200826-W-Cincinnati-QF-Maria_Sakkari-Johanna_Konta,1,B-DTM,26,5,0,2,3,11,15
20200826-W-Cincinnati-QF-Maria_Sakkari-Johanna_Konta,1,B-DTL,3,1,0,0,1,1,2
20200826-W-Cincinnati-QF-Maria_Sakkari-Johanna_Konta,1,B-IO,2,1,1,0,0,2,0
20200826-W-Cincinnati-QF-Maria_Sakkari-Johanna_Konta,1,S-XC,6,0,0,0,0,3,3
20200826-W-Cincinnati-QF-Maria_Sakkari-Johanna_Konta,1,S-DTM,3,0,0,0,0,1,2
20200826-W-Cincinnati-QF-Maria_Sakkari-Johanna_Konta,1,S-DTL,1,1,0,1,0,1,0
20200826-W-Cincinnati-QF-Maria_Sakkari-Johanna_Konta,2,F-XC,29,11,4,5,2,18,11
20200826-W-Cincinnati-QF-Maria_Sakkari-Johanna_Konta,2,F-DTM,13,3,0,1,2,8,5
20200826-W-Cincinnati-QF-Maria_Sakkari-Johanna_Konta,2,F-DTL,8,5,2,2,1,5,3
20200826-W-Cincinnati-QF-Maria_Sakkari-Johanna_Konta,2,F-IO,13,4,2,0,2,9,4
20200826-W-Cincinnati-QF-Maria_Sakkari-Johanna_Konta,2,F-II,2,0,0,0,0,0,2
20200826-W-Cincinnati-QF-Maria_Sakkari-Johanna_Konta,2,B-XC,25,10,3,4,3,19,6
20200826-W-Cincinnati-QF-Maria_Sakkari-Johanna_Konta,2,B-DTM,14,5,0,4,1,9,5
20200826-W-Cincinnati-QF-Maria_Sakkari-Johanna_Konta,2,B-DTL,6,4,2,2,0,5,1
20200826-W-Cincinnati-QF-Maria_Sakkari-Johanna_Konta,2,B-IO,1,1,1,0,0,1,0
20200826-W-Cincinnati-QF-Maria_Sakkari-Johanna_Konta,2,S-XC,3,0,0,0,0,2,1
20200826-W-Cincinnati-QF-Maria_Sakkari-Johanna_Konta,2,S-DTM,2,0,0,0,0,1,1
20200826-W-Cincinnati-QF-Maria_Sakkari-Johanna_Konta,2,S-DTL,4,2,0,1,1,2,2
20200826-W-Cincinnati-QF-Maria_Sakkari-Johanna_Konta,2,S-IO,1,0,0,0,0,0,1
20200901-W-US_Open-R128-Victoria_Azarenka-Barbara_Haas,1,F-XC,25,6,4,1,1,17,8
20200901-W-US_Open-R128-Victoria_Azarenka-Barbara_Haas,1,F-DTM,22,1,0,1,0,15,7
20200901-W-US_Open-R128-Victoria_Azarenka-Barbara_Haas,1,F-DTL,18,3,0,1,2,11,7
20200901-W-US_Open-R128-Victoria_Azarenka-Barbara_Haas,1,F-IO,22,6,4,1,1,13,9
20200901-W-US_Open-R128-Victoria_Azarenka-Barbara_Haas,1,B-XC,14,4,0,3,1,12,2
20200901-W-US_Open-R128-Victoria_Azarenka-Barbara_Haas,1,B-DTM,21,0,0,0,0,9,12
20200901-W-US_Open-R128-Victoria_Azarenka-Barbara_Haas,1,B-DTL,10,4,4,0,0,7,3
20200901-W-US_Open-R128-Victoria_Azarenka-Barbara_Haas,1,B-IO,11,1,0,1,0,8,3
20200901-W-US_Open-R128-Victoria_Azarenka-Barbara_Haas,1,S-IO,1,0,0,0,0,0,1
20200901-W-US_Open-R128-Victoria_Azarenka-Barbara_Haas,2,F-XC,31,3,0,3,0,14,17
20200901-W-US_Open-R128-Victoria_Azarenka-Barbara_Haas,2,F-DTM,25,2,0,1,1,9,16
20200901-W-US_Open-R128-Victoria_Azarenka-Barbara_Haas,2,F-DTL,6,3,2,1,0,4,2
20200901-W-US_Open-R128-Victoria_Azarenka-Barbara_Haas,2,F-IO,4,0,0,0,0,3,1
20200901-W-US_Open-R128-Victoria_Azarenka-Barbara_Haas,2,B-XC,22,5,0,3,2,10,12
20200901-W-US_Open-R128-Victoria_Azarenka-Barbara_Haas,2,B-DTM,34,3,0,0,3,8,26
20200901-W-US_Open-R128-Victoria_Azarenka-Barbara_Haas,2,B-DTL,4,1,0,1,0,3,1
20200901-W-US_Open-R128-Victoria_Azarenka-Barbara_Haas,2,B-IO,6,1,0,1,0,3,3
20200901-W-US_Open-R128-Victoria_Azarenka-Barbara_Haas,2,S-XC,1,0,0,0,0,0,1
20200901-W-US_Open-R128-Victoria_Azarenka-Barbara_Haas,2,S-DTM,2,0,0,0,0,0,2
20200901-W-US_Open-R128-Victoria_Azarenka-Barbara_Haas,2,S-DTL,1,0,0,0,0,0,1
20200901-W-US_Open-R128-Victoria_Azarenka-Barbara_Haas,2,S-IO,1,0,0,0,0,0,1
20190426-W-Stuttgart-QF-Naomi_Osaka-Donna_Vekic,1,F-XC,62,26,8,8,10,36,26
20190426-W-Stuttgart-QF-Naomi_Osaka-Donna_Vekic,1,F-DTM,13,0,0,0,0,8,5
20190426-W-Stuttgart-QF-Naomi_Osaka-Donna_Vekic,1,F-DTL,16,9,3,2,4,10,6
20190426-W-Stuttgart-QF-Naomi_Osaka-Donna_Vekic,1,F-IO,13,7,2,1,4,8,5
20190426-W-Stuttgart-QF-Naomi_Osaka-Donna_Vekic,1,F-II,2,0,0,0,0,1,1
20190426-W-Stuttgart-QF-Naomi_Osaka-Donna_Vekic,1,B-XC,46,10,1,2,7,25,21
20190426-W-Stuttgart-QF-Naomi_Osaka-Donna_Vekic,1,B-DTM,17,1,0,0,1,9,8
20190426-W-Stuttgart-QF-Naomi_Osaka-Donna_Vekic,1,B-DTL,11,7,1,4,2,7,4
20190426-W-Stuttgart-QF-Naomi_Osaka-Donna_Vekic,1,B-IO,11,2,0,0,2,2,9
20190426-W-Stuttgart-QF-Naomi_Osaka-Donna_Vekic,1,S-DTM,1,0,0,0,0,0,1
20190426-W-Stuttgart-QF-Naomi_Osaka-Donna_Vekic,2,F-XC,41,11,4,4,3,22,19
20190426-W-Stuttgart-QF-Naomi_Osaka-Donna_Vekic,2,F-DTM,18,1,0,0,1,8,10
20190426-W-Stuttgart-QF-Naomi_Osaka-Donna_Vekic,2,F-DTL,10,4,3,0,1,5,5
20190426-W-Stuttgart-QF-Naomi_Osaka-Donna_Vekic,2,F-IO,28,11,5,2,4,14,14
20190426-W-Stuttgart-QF-Naomi_Osaka-Donna_Vekic,2,F-II,2,1,0,0,1,0,2
20190426-W-Stuttgart-QF-Naomi_Osaka-Donna_Vekic,2,B-XC,33,6,0,1,5,12,21
20190426-W-Stuttgart-QF-Naomi_Osaka-Donna_Vekic,2,B-DTM,23,2,1,0,1,13,10
20190426-W-Stuttgart-QF-Naomi_Osaka-Donna_Vekic,2,B-DTL,17,7,1,0,6,5,12
20190426-W-Stuttgart-QF-Naomi_Osaka-Donna_Vekic,2,B-IO,5,2,1,0,1,2,3
20200831-W-US_Open-R128-Ajla_Tomljanovic-Angelique_Kerber,1,F-XC,44,10,0,5,5,14,30
20200831-W-US_Open-R128-Ajla_Tomljanovic-Angelique_Kerber,1,F-DTM,45,1,0,0,1,19,26
20200831-W-US_Open-R128-Ajla_Tomljanovic-Angelique_Kerber,1,F-DTL,23,9,3,1,5,12,11
20200831-W-US_Open-R128-Ajla_Tomljanovic-Angelique_Kerber,1,F-IO,6,3,2,0,1,3,3
20200831-W-US_Open-R128-Ajla_Tomljanovic-Angelique_Kerber,1,F-II,1,0,0,0,0,0,1
20200831-W-US_Open-R128-Ajla_Tomljanovic-Angelique_Kerber,1,B-XC,47,6,4,1,1,23,24
20200831-W-US_Open-R128-Ajla_Tomljanovic-Angelique_Kerber,1,B-DTM,45,8,0,4,4,22,23
20200831-W-US_Open-R128-Ajla_Tomljanovic-Angelique_Kerber,1,B-DTL,5,3,2,1,0,5,0
20200831-W-US_Open-R128-Ajla_Tomljanovic-Angelique_Kerber,1,B-IO,12,5,1,0,4,4,8
20200831-W-US_Open-R128-Ajla_Tomljanovic-Angelique_Kerber,1,S-XC,9,1,0,0,1,4,5
20200831-W-US_Open-R128-Ajla_Tomljanovic-Angelique_Kerber,1,S-DTM,11,1,0,0,1,4,7
20200831-W-US_Open-R128-Ajla_Tomljanovic-Angelique_Kerber,1,S-DTL,6,0,0,0,0,4,2
20200831-W-US_Open-R128-Ajla_Tomljanovic-Angelique_Kerber,2,F-XC,93,10,1,7,2,52,41
20200831-W-US_Open-R128-Ajla_Tomljanovic-Angelique_Kerber,2,F-DTM,19,0,0,0,0,10,9
20200831-W-US_Open-R128-Ajla_Tomljanovic-Angelique_Kerber,2,F-DTL,21,7,3,3,1,13,8
20200831-W-US_Open-R128-Ajla_Tomljanovic-Angelique_Kerber,2,F-IO,42,13,3,2,8,27,15
20200831-W-US_Open-R128-Ajla_Tomljanovic-Angelique_Kerber,2,F-II,1,0,0,0,0,1,0
20200831-W-US_Open-R128-Ajla_Tomljanovic-Angelique_Kerber,2,B-XC,42,2,1,0,1,24,18
20200831-W-US_Open-R128-Ajla_Tomljanovic-Angelique_Kerber,2,B-DTM,18,2,0,1,1,7,11
20200831-W-US_Open-R128-Ajla_Tomljanovic-Angelique_Kerber,2,B-DTL,3,3,2,0,1,2,1
20200831-W-US_Open-R128-Ajla_Tomljanovic-Angelique_Kerber,2,B-IO,3,1,0,1,0,1,2
20200831-W-US_Open-R128-Ajla_Tomljanovic-Angelique_Kerber,2,S-XC,7,0,0,0,0,3,4
20200831-W-US_Open-R128-Ajla_Tomljanovic-Angelique_Kerber,2,S-DTM,1,0,0,0,0,1,0
20200831-W-US_Open-R128-Ajla_Tomljanovic-Angelique_Kerber,2,S-DTL,3,0,0,0,0,2,1
20200831-W-US_Open-R128-Ajla_Tomljanovic-Angelique_Kerber,2,S-IO,2,0,0,0,0,1,1
20200902-W-US_Open-R64-Caroline_Garcia-Karolina_Pliskova,1,F-XC,30,16,10,4,2,21,9
20200902-W-US_Open-R64-Caroline_Garcia-Karolina_Pliskova,1,F-DTM,5,1,0,1,0,3,2
20200902-W-US_Open-R64-Caroline_Garcia-Karolina_Pliskova,1,F-DTL,4,4,2,0,2,2,2
20200902-W-US_Open-R64-Caroline_Garcia-Karolina_Pliskova,1,F-IO,7,3,1,0,2,3,4
20200902-W-US_Open-R64-Caroline_Garcia-Karolina_Pliskova,1,B-XC,18,5,2,1,2,9,9
20200902-W-US_Open-R64-Caroline_Garcia-Karolina_Pliskova,1,B-DTM,10,2,0,0,2,5,5
20200902-W-US_Open-R64-Caroline_Garcia-Karolina_Pliskova,1,B-DTL,2,2,0,0,2,0,2
20200902-W-US_Open-R64-Caroline_Garcia-Karolina_Pliskova,1,B-IO,2,1,0,0,1,1,1
20200902-W-US_Open-R64-Caroline_Garcia-Karolina_Pliskova,1,S-XC,2,0,0,0,0,1,1
20200902-W-US_Open-R64-Caroline_Garcia-Karolina_Pliskova,1,S-DTM,1,0,0,0,0,0,1
20200902-W-US_Open-R64-Caroline_Garcia-Karolina_Pliskova,2,F-XC,8,4,0,3,1,4,4
20200902-W-US_Open-R64-Caroline_Garcia-Karolina_Pliskova,2,F-DTM,13,4,0,2,2,7,6
20200902-W-US_Open-R64-Caroline_Garcia-Karolina_Pliskova,2,F-DTL,5,3,1,0,2,1,4
20200902-W-US_Open-R64-Caroline_Garcia-Karolina_Pliskova,2,F-IO,4,4,1,0,3,1,3
20200902-W-US_Open-R64-Caroline_Garcia-Karolina_Pliskova,2,F-II,1,0,0,0,0,0,1
20200902-W-US_Open-R64-Caroline_Garcia-Karolina_Pliskova,2,B-XC,12,3,1,0,2,6,6
20200902-W-US_Open-R64-Caroline_Garcia-Karolina_Pliskova,2,B-DTM,10,0,0,0,0,4,6
20200902-W-US_Open-R64-Caroline_Garcia-Karolina_Pliskova,2,B-DTL,10,10,3,5,2,8,2
20200902-W-US_Open-R64-Caroline_Garcia-Karolina_Pliskova,2,B-IO,2,2,1,1,0,2,0
20200902-W-US_Open-R64-Caroline_Garcia-Karolina_Pliskova,2,S-XC,2,0,0,0,0,1,1
20200902-W-US_Open-R64-Caroline_Garcia-Karolina_Pliskova,2,S-DTM,6,0,0,0,0,0,6
20200907-W-US_Open-R16-Serena_Williams-Maria_Sakkari,1,F-XC,36,11,2,6,3,17,19
20200907-W-US_Open-R16-Serena_Williams-Maria_Sakkari,1,F-DTM,23,1,0,0,1,12,11
20200907-W-US_Open-R16-Serena_Williams-Maria_Sakkari,1,F-DTL,4,4,2,2,0,4,0
20200907-W-US_Open-R16-Serena_Williams-Maria_Sakkari,1,F-IO,16,1,1,0,0,10,6
20200907-W-US_Open-R16-Serena_Williams-Maria_Sakkari,1,B-XC,67,9,0,5,4,33,34
20200907-W-US_Open-R16-Serena_Williams-Maria_Sakkari,1,B-DTM,38,4,0,1,3,15,23
20200907-W-US_Open-R16-Serena_Williams-Maria_Sakkari,1,B-DTL,24,8,3,1,4,11,13
20200907-W-US_Open-R16-Serena_Williams-Maria_Sakkari,1,B-IO,16,6,1,2,3,10,6
20200907-W-US_Open-R16-Serena_Williams-Maria_Sakkari,1,S-XC,4,0,0,0,0,1,3
20200907-W-US_Open-R16-Serena_Williams-Maria_Sakkari,1,S-DTM,2,0,0,0,0,1,1
20200907-W-US_Open-R16-Serena_Williams-Maria_Sakkari,1,S-DTL,1,0,0,0,0,0,1
20200907-W-US_Open-R16-Serena_Williams-Maria_Sakkari,1,S-IO,1,0,0,0,0,1,0
20200907-W-US_Open-R16-Serena_Williams-Maria_Sakkari,2,F-XC,47,22,9,5,8,28,19
20200907-W-US_Open-R16-Serena_Williams-Maria_Sakkari,2,F-DTM,25,4,1,0,3,9,16
20200907-W-US_Open-R16-Serena_Williams-Maria_Sakkari,2,F-DTL,22,3,1,1,1,14,8
20200907-W-US_Open-R16-Serena_Williams-Maria_Sakkari,2,F-IO,22,5,0,2,3,9,13
20200907-W-US_Open-R16-Serena_Williams-Maria_Sakkari,2,F-II,1,1,1,0,0,1,0
20200907-W-US_Open-R16-Serena_Williams-Maria_Sakkari,2,B-XC,59,12,4,4,4,34,25
20200907-W-US_Open-R16-Serena_Williams-Maria_Sakkari,2,B-DTM,29,3,0,1,2,11,18
20200907-W-US_Open-R16-Serena_Williams-Maria_Sakkari,2,B-DTL,12,7,3,1,3,6,6
20200907-W-US_Open-R16-Serena_Williams-Maria_Sakkari,2,B-IO,2,1,1,0,0,2,0
20200907-W-US_Open-R16-Serena_Williams-Maria_Sakkari,2,S-XC,7,0,0,0,0,5,2
20200907-W-US_Open-R16-Serena_Williams-Maria_Sakkari,2,S-DTM,4,0,0,0,0,3,1
20200907-W-US_Open-R16-Serena_Williams-Maria_Sakkari,2,S-DTL,1,1,0,1,0,1,0
20200822-W-Cincinnati-R64-Victoria_Azarenka-Donna_Vekic,1,F-XC,17,1,0,0,1,9,8
20200822-W-Cincinnati-R64-Victoria_Azarenka-Donna_Vekic,1,F-DTM,11,0,0,0,0,7,4
20200822-W-Cincinnati-R64-Victoria_Azarenka-Donna_Vekic,1,F-DTL,9,2,1,1,0,8,1
20200822-W-Cincinnati-R64-Victoria_Azarenka-Donna_Vekic,1,F-IO,6,4,1,1,2,4,2
20200822-W-Cincinnati-R64-Victoria_Azarenka-Donna_Vekic,1,B-XC,12,6,2,3,1,7,5
20200822-W-Cincinnati-R64-Victoria_Azarenka-Donna_Vekic,1,B-DTM,19,2,0,1,1,13,6
20200822-W-Cincinnati-R64-Victoria_Azarenka-Donna_Vekic,1,B-DTL,5,5,4,0,1,4,1
20200822-W-Cincinnati-R64-Victoria_Azarenka-Donna_Vekic,1,B-IO,4,2,2,0,0,3,1
20200822-W-Cincinnati-R64-Victoria_Azarenka-Donna_Vekic,1,S-XC,3,0,0,0,0,0,3
20200822-W-Cincinnati-R64-Victoria_Azarenka-Donna_Vekic,1,S-DTM,3,0,0,0,0,1,2
20200822-W-Cincinnati-R64-Victoria_Azarenka-Donna_Vekic,2,F-XC,21,5,0,2,3,9,12
20200822-W-Cincinnati-R64-Victoria_Azarenka-Donna_Vekic,2,F-DTM,15,3,0,1,2,4,11
20200822-W-Cincinnati-R64-Victoria_Azarenka-Donna_Vekic,2,F-DTL,3,2,0,0,2,1,2
20200822-W-Cincinnati-R64-Victoria_Azarenka-Donna_Vekic,2,F-IO,19,6,4,1,1,12,7
20200822-W-Cincinnati-R64-Victoria_Azarenka-Donna_Vekic,2,F-II,2,1,1,0,0,1,1
20200822-W-Cincinnati-R64-Victoria_Azarenka-Donna_Vekic,2,B-XC,9,3,1,0,2,4,5
20200822-W-Cincinnati-R64-Victoria_Azarenka-Donna_Vekic,2,B-DTM,9,0,0,0,0,4,5
20200822-W-Cincinnati-R64-Victoria_Azarenka-Donna_Vekic,2,B-DTL,5,4,1,2,1,3,2
20200822-W-Cincinnati-R64-Victoria_Azarenka-Donna_Vekic,2,B-IO,4,2,1,1,0,2,2
20200909-W-US_Open-QF-Victoria_Azarenka-Elise_Mertens,1,F-XC,28,8,2,6,0,19,9
20200909-W-US_Open-QF-Victoria_Azarenka-Elise_Mertens,1,F-DTM,12,0,0,0,0,5,7
20200909-W-US_Open-QF-Victoria_Azarenka-Elise_Mertens,1,F-DTL,13,3,1,1,1,8,5
20200909-W-US_Open-QF-Victoria_Azarenka-Elise_Mertens,1,F-IO,12,5,2,3,0,7,5
20200909-W-US_Open-QF-Victoria_Azarenka-Elise_Mertens,1,B-XC,21,4,1,2,1,13,8
20200909-W-US_Open-QF-Victoria_Azarenka-Elise_Mertens,1,B-DTM,18,0,0,0,0,9,9
20200909-W-US_Open-QF-Victoria_Azarenka-Elise_Mertens,1,B-DTL,18,8,4,2,2,13,5
20200909-W-US_Open-QF-Victoria_Azarenka-Elise_Mertens,1,B-IO,10,2,1,1,0,7,3
20200909-W-US_Open-QF-Victoria_Azarenka-Elise_Mertens,1,S-XC,2,1,0,0,1,0,2
20200909-W-US_Open-QF-Victoria_Azarenka-Elise_Mertens,1,S-DTM,3,0,0,0,0,3,0
20200909-W-US_Open-QF-Victoria_Azarenka-Elise_Mertens,1,S-DTL,1,0,0,0,0,0,1
20200909-W-US_Open-QF-Victoria_Azarenka-Elise_Mertens,2,F-XC,29,8,1,3,4,11,18
20200909-W-US_Open-QF-Victoria_Azarenka-Elise_Mertens,2,F-DTM,10,0,0,0,0,6,4
20200909-W-US_Open-QF-Victoria_Azarenka-Elise_Mertens,2,F-DTL,18,8,2,3,3,6,12
20200909-W-US_Open-QF-Victoria_Azarenka-Elise_Mertens,2,F-IO,10,2,2,0,0,5,5
20200909-W-US_Open-QF-Victoria_Azarenka-Elise_Mertens,2,B-XC,18,4,1,1,2,9,9
20200909-W-US_Open-QF-Victoria_Azarenka-Elise_Mertens,2,B-DTM,18,2,0,1,1,7,11
20200909-W-US_Open-QF-Victoria_Azarenka-Elise_Mertens,2,B-DTL,14,5,2,2,1,9,5
20200909-W-US_Open-QF-Victoria_Azarenka-Elise_Mertens,2,B-IO,9,0,0,0,0,2,7
20200909-W-US_Open-QF-Victoria_Azarenka-Elise_Mertens,2,S-XC,4,0,0,0,0,1,3
20200909-W-US_Open-QF-Victoria_Azarenka-Elise_Mertens,2,S-DTM,3,0,0,0,0,1,2
20200909-W-US_Open-QF-Victoria_Azarenka-Elise_Mertens,2,S-DTL,1,0,0,0,0,0,1
20200905-W-US_Open-R32-Victoria_Azarenka-Iga_Swiatek,1,F-XC,21,2,1,0,1,12,9
20200905-W-US_Open-R32-Victoria_Azarenka-Iga_Swiatek,1,F-DTM,25,1,0,1,0,10,15
20200905-W-US_Open-R32-Victoria_Azarenka-Iga_Swiatek,1,F-DTL,20,6,0,3,3,12,8
20200905-W-US_Open-R32-Victoria_Azarenka-Iga_Swiatek,1,F-IO,17,5,1,2,2,12,5
20200905-W-US_Open-R32-Victoria_Azarenka-Iga_Swiatek,1,B-XC,25,5,2,2,1,13,12
20200905-W-US_Open-R32-Victoria_Azarenka-Iga_Swiatek,1,B-DTM,18,1,0,0,1,8,10
20200905-W-US_Open-R32-Victoria_Azarenka-Iga_Swiatek,1,B-DTL,14,7,3,1,3,9,5
20200905-W-US_Open-R32-Victoria_Azarenka-Iga_Swiatek,1,B-IO,9,3,3,0,0,7,2
20200905-W-US_Open-R32-Victoria_Azarenka-Iga_Swiatek,1,S-XC,4,1,1,0,0,2,2
20200905-W-US_Open-R32-Victoria_Azarenka-Iga_Swiatek,1,S-DTM,7,0,0,0,0,3,4
20200905-W-US_Open-R32-Victoria_Azarenka-Iga_Swiatek,1,S-IO,2,0,0,0,0,2,0
20200905-W-US_Open-R32-Victoria_Azarenka-Iga_Swiatek,2,F-XC,40,13,3,3,7,17,23
20200905-W-US_Open-R32-Victoria_Azarenka-Iga_Swiatek,2,F-DTM,16,4,1,1,2,6,10
20200905-W-US_Open-R32-Victoria_Azarenka-Iga_Swiatek,2,F-DTL,7,3,1,0,2,3,4
20200905-W-US_Open-R32-Victoria_Azarenka-Iga_Swiatek,2,F-IO,21,5,2,2,1,10,11
20200905-W-US_Open-R32-Victoria_Azarenka-Iga_Swiatek,2,F-II,2,2,1,0,1,1,1
20200905-W-US_Open-R32-Victoria_Azarenka-Iga_Swiatek,2,B-XC,39,12,6,2,4,22,17
20200905-W-US_Open-R32-Victoria_Azarenka-Iga_Swiatek,2,B-DTM,28,1,0,0,1,8,20
20200905-W-US_Open-R32-Victoria_Azarenka-Iga_Swiatek,2,B-DTL,14,8,4,1,2,8,6
20200905-W-US_Open-R32-Victoria_Azarenka-Iga_Swiatek,2,B-IO,6,2,2,0,0,5,1
20200905-W-US_Open-R32-Victoria_Azarenka-Iga_Swiatek,2,S-XC,1,0,0,0,0,1,0
20200905-W-US_Open-R32-Victoria_Azarenka-Iga_Swiatek,2,S-DTM,3,0,0,0,0,1,2
20200904-W-US_Open-R32-Jennifer_Brady-Caroline_Garcia,1,F-XC,26,6,2,2,2,19,7
20200904-W-US_Open-R32-Jennifer_Brady-Caroline_Garcia,1,F-DTM,17,1,0,0,1,9,8
20200904-W-US_Open-R32-Jennifer_Brady-Caroline_Garcia,1,F-DTL,1,1,0,0,1,0,1
20200904-W-US_Open-R32-Jennifer_Brady-Caroline_Garcia,1,F-IO,9,4,2,2,0,8,1
20200904-W-US_Open-R32-Jennifer_Brady-Caroline_Garcia,1,F-II,4,2,1,1,0,4,0
20200904-W-US_Open-R32-Jennifer_Brady-Caroline_Garcia,1,B-XC,15,6,1,3,2,10,5
20200904-W-US_Open-R32-Jennifer_Brady-Caroline_Garcia,1,B-DTM,13,2,0,1,1,6,7
20200904-W-US_Open-R32-Jennifer_Brady-Caroline_Garcia,1,B-DTL,3,2,1,0,1,2,1
20200904-W-US_Open-R32-Jennifer_Brady-Caroline_Garcia,1,B-IO,4,0,0,0,0,3,1
20200904-W-US_Open-R32-Jennifer_Brady-Caroline_Garcia,2,F-XC,31,10,2,3,5,13,18
20200904-W-US_Open-R32-Jennifer_Brady-Caroline_Garcia,2,F-DTM,15,2,1,0,1,4,11
20200904-W-US_Open-R32-Jennifer_Brady-Caroline_Garcia,2,F-DTL,8,6,1,0,5,1,7
20200904-W-US_Open-R32-Jennifer_Brady-Caroline_Garcia,2,F-IO,14,7,4,0,3,5,9
20200904-W-US_Open-R32-Jennifer_Brady-Caroline_Garcia,2,F-II,2,1,0,0,1,0,2
20200904-W-US_Open-R32-Jennifer_Brady-Caroline_Garcia,2,B-XC,10,3,0,1,2,5,5
20200904-W-US_Open-R32-Jennifer_Brady-Caroline_Garcia,2,B-DTM,10,1,0,0,1,3,7
20200904-W-US_Open-R32-Jennifer_Brady-Caroline_Garcia,2,B-DTL,3,2,0,1,1,2,1
20200904-W-US_Open-R32-Jennifer_Brady-Caroline_Garcia,2,B-IO,3,1,0,0,1,1,2
20200904-W-US_Open-R32-Jennifer_Brady-Caroline_Garcia,2,S-XC,1,0,0,0,0,0,1
20200910-W-US_Open-SF-Victoria_Azarenka-Serena_Williams,1,F-XC,34,5,2,1,2,23,11
20200910-W-US_Open-SF-Victoria_Azarenka-Serena_Williams,1,F-DTM,19,0,0,0,0,9,10
20200910-W-US_Open-SF-Victoria_Azarenka-Serena_Williams,1,F-DTL,21,8,3,1,4,13,8
20200910-W-US_Open-SF-Victoria_Azarenka-Serena_Williams,1,F-IO,16,3,1,1,1,9,7
20200910-W-US_Open-SF-Victoria_Azarenka-Serena_Williams,1,B-XC,28,6,5,1,0,20,8
20200910-W-US_Open-SF-Victoria_Azarenka-Serena_Williams,1,B-DTM,29,4,0,1,3,15,14
20200910-W-US_Open-SF-Victoria_Azarenka-Serena_Williams,1,B-DTL,13,7,4,2,1,10,3
20200910-W-US_Open-SF-Victoria_Azarenka-Serena_Williams,1,B-IO,13,5,1,1,3,6,7
20200910-W-US_Open-SF-Victoria_Azarenka-Serena_Williams,1,S-XC,7,0,0,0,0,2,5
20200910-W-US_Open-SF-Victoria_Azarenka-Serena_Williams,1,S-DTM,5,0,0,0,0,1,4
20200910-W-US_Open-SF-Victoria_Azarenka-Serena_Williams,1,S-DTL,2,1,0,0,1,0,2
20200910-W-US_Open-SF-Victoria_Azarenka-Serena_Williams,2,F-XC,50,18,6,3,9,21,29
20200910-W-US_Open-SF-Victoria_Azarenka-Serena_Williams,2,F-DTM,23,2,1,0,1,8,15
20200910-W-US_Open-SF-Victoria_Azarenka-Serena_Williams,2,F-DTL,12,5,2,0,3,5,7
20200910-W-US_Open-SF-Victoria_Azarenka-Serena_Williams,2,F-IO,19,9,5,2,2,11,8
20200910-W-US_Open-SF-Victoria_Azarenka-Serena_Williams,2,F-II,2,1,1,0,0,2,0
20200910-W-US_Open-SF-Victoria_Azarenka-Serena_Williams,2,B-XC,41,9,2,2,5,21,20
20200910-W-US_Open-SF-Victoria_Azarenka-Serena_Williams,2,B-DTM,29,2,0,0,2,12,17
20200910-W-US_Open-SF-Victoria_Azarenka-Serena_Williams,2,B-DTL,7,2,1,0,1,5,2
20200910-W-US_Open-SF-Victoria_Azarenka-Serena_Williams,2,B-IO,9,2,1,0,1,1,8
20200910-W-US_Open-SF-Victoria_Azarenka-Serena_Williams,2,S-XC,1,0,0,0,0,0,1
20200910-W-US_Open-SF-Victoria_Azarenka-Serena_Williams,2,S-DTM,2,1,1,0,0,1,1
20200907-W-US_Open-R16-Victoria_Azarenka-Karolina_Muchova,1,F-XC,62,9,5,3,1,40,22
20200907-W-US_Open-R16-Victoria_Azarenka-Karolina_Muchova,1,F-DTM,30,1,0,0,1,14,16
20200907-W-US_Open-R16-Victoria_Azarenka-Karolina_Muchova,1,F-DTL,40,9,3,1,5,22,18
20200907-W-US_Open-R16-Victoria_Azarenka-Karolina_Muchova,1,F-IO,51,12,2,5,5,27,24
20200907-W-US_Open-R16-Victoria_Azarenka-Karolina_Muchova,1,F-II,1,0,0,0,0,1,0
20200907-W-US_Open-R16-Victoria_Azarenka-Karolina_Muchova,1,B-XC,24,3,0,1,2,14,10
20200907-W-US_Open-R16-Victoria_Azarenka-Karolina_Muchova,1,B-DTM,34,2,0,0,2,19,15
20200907-W-US_Open-R16-Victoria_Azarenka-Karolina_Muchova,1,B-DTL,8,3,0,1,2,3,5
20200907-W-US_Open-R16-Victoria_Azarenka-Karolina_Muchova,1,B-IO,22,10,4,2,4,12,10
20200907-W-US_Open-R16-Victoria_Azarenka-Karolina_Muchova,1,S-XC,3,0,0,0,0,1,2
20200907-W-US_Open-R16-Victoria_Azarenka-Karolina_Muchova,1,S-DTM,10,0,0,0,0,3,7
20200907-W-US_Open-R16-Victoria_Azarenka-Karolina_Muchova,1,S-DTL,4,1,0,1,0,2,2
20200907-W-US_Open-R16-Victoria_Azarenka-Karolina_Muchova,2,F-XC,56,9,2,3,4,28,28
20200907-W-US_Open-R16-Victoria_Azarenka-Karolina_Muchova,2,F-DTM,45,7,0,0,7,13,32
20200907-W-US_Open-R16-Victoria_Azarenka-Karolina_Muchova,2,F-DTL,21,11,3,1,7,7,14
20200907-W-US_Open-R16-Victoria_Azarenka-Karolina_Muchova,2,F-IO,27,14,4,3,7,16,11
20200907-W-US_Open-R16-Victoria_Azarenka-Karolina_Muchova,2,F-II,4,2,1,0,1,1,3
20200907-W-US_Open-R16-Victoria_Azarenka-Karolina_Muchova,2,B-XC,29,8,3,1,4,18,11
20200907-W-US_Open-R16-Victoria_Azarenka-Karolina_Muchova,2,B-DTM,35,3,0,2,1,20,15
20200907-W-US_Open-R16-Victoria_Azarenka-Karolina_Muchova,2,B-DTL,19,5,1,2,2,11,8
20200907-W-US_Open-R16-Victoria_Azarenka-Karolina_Muchova,2,B-IO,10,7,1,1,5,2,8
20200907-W-US_Open-R16-Victoria_Azarenka-Karolina_Muchova,2,S-XC,13,2,0,0,2,5,8
20200907-W-US_Open-R16-Victoria_Azarenka-Karolina_Muchova,2,S-DTM,27,3,0,1,2,9,18
20200907-W-US_Open-R16-Victoria_Azarenka-Karolina_Muchova,2,S-DTL,10,0,0,0,0,1,9
20200907-W-US_Open-R16-Victoria_Azarenka-Karolina_Muchova,2,S-IO,7,2,0,0,2,4,3
20200910-W-US_Open-SF-Naomi_Osaka-Jennifer_Brady,1,F-XC,40,16,5,5,6,28,12
20200910-W-US_Open-SF-Naomi_Osaka-Jennifer_Brady,1,F-DTM,21,1,0,0,1,9,12
20200910-W-US_Open-SF-Naomi_Osaka-Jennifer_Brady,1,F-DTL,8,5,3,1,1,6,2
20200910-W-US_Open-SF-Naomi_Osaka-Jennifer_Brady,1,F-IO,12,7,4,2,1,9,3
20200910-W-US_Open-SF-Naomi_Osaka-Jennifer_Brady,1,B-XC,61,14,9,2,3,44,17
20200910-W-US_Open-SF-Naomi_Osaka-Jennifer_Brady,1,B-DTM,22,3,0,0,3,12,10
20200910-W-US_Open-SF-Naomi_Osaka-Jennifer_Brady,1,B-DTL,7,1,0,0,1,4,3
20200910-W-US_Open-SF-Naomi_Osaka-Jennifer_Brady,1,B-IO,9,4,1,1,2,3,6
20200910-W-US_Open-SF-Naomi_Osaka-Jennifer_Brady,1,S-XC,4,1,0,0,1,2,2
20200910-W-US_Open-SF-Naomi_Osaka-Jennifer_Brady,1,S-DTM,1,0,0,0,0,0,1
20200910-W-US_Open-SF-Naomi_Osaka-Jennifer_Brady,2,F-XC,35,13,5,5,3,17,18
20200910-W-US_Open-SF-Naomi_Osaka-Jennifer_Brady,2,F-DTM,24,2,0,0,2,9,15
20200910-W-US_Open-SF-Naomi_Osaka-Jennifer_Brady,2,F-DTL,6,3,1,1,1,3,3
20200910-W-US_Open-SF-Naomi_Osaka-Jennifer_Brady,2,F-IO,16,8,5,2,1,12,4
20200910-W-US_Open-SF-Naomi_Osaka-Jennifer_Brady,2,F-II,5,4,2,1,1,4,1
20200910-W-US_Open-SF-Naomi_Osaka-Jennifer_Brady,2,B-XC,41,8,1,2,5,11,30
20200910-W-US_Open-SF-Naomi_Osaka-Jennifer_Brady,2,B-DTM,39,3,0,0,3,16,23
20200910-W-US_Open-SF-Naomi_Osaka-Jennifer_Brady,2,B-DTL,9,6,2,2,2,6,3
20200910-W-US_Open-SF-Naomi_Osaka-Jennifer_Brady,2,B-IO,3,1,0,0,1,2,1
20200910-W-US_Open-SF-Naomi_Osaka-Jennifer_Brady,2,S-DTM,4,0,0,0,0,1,3
20200910-W-US_Open-SF-Naomi_Osaka-Jennifer_Brady,2,S-DTL,4,1,0,0,1,1,3
20200910-W-US_Open-SF-Naomi_Osaka-Jennifer_Brady,2,S-IO,1,0,0,0,0,0,1
20200915-W-Rome-R64-Katerina_Siniakova-Angelique_Kerber,1,F-XC,16,3,1,1,1,9,7
20200915-W-Rome-R64-Katerina_Siniakova-Angelique_Kerber,1,F-DTM,12,0,0,0,0,6,6
20200915-W-Rome-R64-Katerina_Siniakova-Angelique_Kerber,1,F-DTL,26,8,4,1,3,17,9
20200915-W-Rome-R64-Katerina_Siniakova-Angelique_Kerber,1,F-IO,11,4,1,2,1,7,4
20200915-W-Rome-R64-Katerina_Siniakova-Angelique_Kerber,1,B-XC,15,3,1,0,2,9,6
20200915-W-Rome-R64-Katerina_Siniakova-Angelique_Kerber,1,B-DTM,11,2,0,1,1,7,4
20200915-W-Rome-R64-Katerina_Siniakova-Angelique_Kerber,1,B-DTL,22,8,4,2,2,15,7
20200915-W-Rome-R64-Katerina_Siniakova-Angelique_Kerber,1,B-IO,7,4,4,0,0,5,2
20200915-W-Rome-R64-Katerina_Siniakova-Angelique_Kerber,1,S-XC,1,0,0,0,0,1,0
20200915-W-Rome-R64-Katerina_Siniakova-Angelique_Kerber,1,S-DTM,2,0,0,0,0,1,1
20200915-W-Rome-R64-Katerina_Siniakova-Angelique_Kerber,2,F-XC,38,8,3,1,4,17,21
20200915-W-Rome-R64-Katerina_Siniakova-Angelique_Kerber,2,F-DTM,5,3,0,0,3,1,4
20200915-W-Rome-R64-Katerina_Siniakova-Angelique_Kerber,2,F-DTL,17,5,0,3,2,6,11
20200915-W-Rome-R64-Katerina_Siniakova-Angelique_Kerber,2,F-IO,14,8,3,3,2,10,4
20200915-W-Rome-R64-Katerina_Siniakova-Angelique_Kerber,2,B-XC,27,4,1,0,3,11,16
20200915-W-Rome-R64-Katerina_Siniakova-Angelique_Kerber,2,B-DTM,11,0,0,0,0,3,8
20200915-W-Rome-R64-Katerina_Siniakova-Angelique_Kerber,2,B-DTL,1,0,0,0,0,0,1
20200915-W-Rome-R64-Katerina_Siniakova-Angelique_Kerber,2,B-IO,2,1,0,0,1,0,2
20200915-W-Rome-R64-Katerina_Siniakova-Angelique_Kerber,2,S-XC,5,0,0,0,0,2,3
20200915-W-Rome-R64-Katerina_Siniakova-Angelique_Kerber,2,S-DTM,3,0,0,0,0,1,2
20200915-W-Rome-R64-Katerina_Siniakova-Angelique_Kerber,2,S-DTL,2,1,1,0,0,1,1
20200912-W-US_Open-F-Naomi_Osaka-Victoria_Azarenka,1,F-XC,49,13,4,5,4,30,19
20200912-W-US_Open-F-Naomi_Osaka-Victoria_Azarenka,1,F-DTM,22,1,0,0,1,11,11
20200912-W-US_Open-F-Naomi_Osaka-Victoria_Azarenka,1,F-DTL,16,12,3,2,7,6,10
20200912-W-US_Open-F-Naomi_Osaka-Victoria_Azarenka,1,F-IO,21,11,6,2,3,15,6
20200912-W-US_Open-F-Naomi_Osaka-Victoria_Azarenka,1,F-II,3,2,1,0,1,2,1
20200912-W-US_Open-F-Naomi_Osaka-Victoria_Azarenka,1,B-XC,42,14,4,3,7,22,20
20200912-W-US_Open-F-Naomi_Osaka-Victoria_Azarenka,1,B-DTM,42,3,0,0,3,21,21
20200912-W-US_Open-F-Naomi_Osaka-Victoria_Azarenka,1,B-DTL,21,7,1,3,3,11,10
20200912-W-US_Open-F-Naomi_Osaka-Victoria_Azarenka,1,B-IO,8,2,2,0,0,6,2
20200912-W-US_Open-F-Naomi_Osaka-Victoria_Azarenka,1,S-XC,2,0,0,0,0,0,2
20200912-W-US_Open-F-Naomi_Osaka-Victoria_Azarenka,1,S-DTM,4,0,0,0,0,1,3
20200912-W-US_Open-F-Naomi_Osaka-Victoria_Azarenka,1,S-DTL,1,0,0,0,0,0,1
20200912-W-US_Open-F-Naomi_Osaka-Victoria_Azarenka,2,F-XC,40,6,1,3,2,23,17
20200912-W-US_Open-F-Naomi_Osaka-Victoria_Azarenka,2,F-DTM,27,1,1,0,0,8,19
20200912-W-US_Open-F-Naomi_Osaka-Victoria_Azarenka,2,F-DTL,26,9,4,2,3,13,13
20200912-W-US_Open-F-Naomi_Osaka-Victoria_Azarenka,2,F-IO,35,12,4,2,6,22,13
20200912-W-US_Open-F-Naomi_Osaka-Victoria_Azarenka,2,B-XC,33,7,1,0,6,15,18
20200912-W-US_Open-F-Naomi_Osaka-Victoria_Azarenka,2,B-DTM,18,1,0,0,1,4,14
20200912-W-US_Open-F-Naomi_Osaka-Victoria_Azarenka,2,B-DTL,16,7,1,4,2,10,6
20200912-W-US_Open-F-Naomi_Osaka-Victoria_Azarenka,2,B-IO,13,6,2,1,3,6,7
20200912-W-US_Open-F-Naomi_Osaka-Victoria_Azarenka,2,S-XC,9,0,0,0,0,2,7
20200912-W-US_Open-F-Naomi_Osaka-Victoria_Azarenka,2,S-DTM,8,0,0,0,0,2,6
20200912-W-US_Open-F-Naomi_Osaka-Victoria_Azarenka,2,S-DTL,1,0,0,0,0,1,0
20200912-W-US_Open-F-Naomi_Osaka-Victoria_Azarenka,2,S-IO,1,0,0,0,0,1,0
20200902-W-US_Open-R64-Angelique_Kerber-Anna_Lena_Friedsam,1,F-XC,81,6,3,2,1,47,34
20200902-W-US_Open-R64-Angelique_Kerber-Anna_Lena_Friedsam,1,F-DTM,16,0,0,0,0,4,12
20200902-W-US_Open-R64-Angelique_Kerber-Anna_Lena_Friedsam,1,F-DTL,28,15,3,4,8,15,13
20200902-W-US_Open-R64-Angelique_Kerber-Anna_Lena_Friedsam,1,F-IO,22,9,3,4,2,15,7
20200902-W-US_Open-R64-Angelique_Kerber-Anna_Lena_Friedsam,1,F-II,4,2,2,0,0,2,2
20200902-W-US_Open-R64-Angelique_Kerber-Anna_Lena_Friedsam,1,B-XC,57,9,2,5,2,24,33
20200902-W-US_Open-R64-Angelique_Kerber-Anna_Lena_Friedsam,1,B-DTM,30,2,0,1,1,12,18
20200902-W-US_Open-R64-Angelique_Kerber-Anna_Lena_Friedsam,1,B-DTL,10,4,0,1,3,4,6
20200902-W-US_Open-R64-Angelique_Kerber-Anna_Lena_Friedsam,1,B-IO,3,0,0,0,0,1,2
20200902-W-US_Open-R64-Angelique_Kerber-Anna_Lena_Friedsam,1,S-XC,10,1,1,0,0,3,7
20200902-W-US_Open-R64-Angelique_Kerber-Anna_Lena_Friedsam,1,S-DTM,3,0,0,0,0,1,2
20200902-W-US_Open-R64-Angelique_Kerber-Anna_Lena_Friedsam,1,S-DTL,3,1,0,0,1,2,1
20200902-W-US_Open-R64-Angelique_Kerber-Anna_Lena_Friedsam,1,S-IO,3,0,0,0,0,2,1
20200902-W-US_Open-R64-Angelique_Kerber-Anna_Lena_Friedsam,2,F-XC,80,14,1,3,10,47,33
20200902-W-US_Open-R64-Angelique_Kerber-Anna_Lena_Friedsam,2,F-DTM,25,3,1,0,2,10,15
20200902-W-US_Open-R64-Angelique_Kerber-Anna_Lena_Friedsam,2,F-DTL,18,8,2,4,2,14,4
20200902-W-US_Open-R64-Angelique_Kerber-Anna_Lena_Friedsam,2,F-IO,12,6,4,1,1,9,3
20200902-W-US_Open-R64-Angelique_Kerber-Anna_Lena_Friedsam,2,F-II,2,0,0,0,0,1,1
20200902-W-US_Open-R64-Angelique_Kerber-Anna_Lena_Friedsam,2,B-XC,44,9,6,0,3,25,19
20200902-W-US_Open-R64-Angelique_Kerber-Anna_Lena_Friedsam,2,B-DTM,20,1,0,0,1,9,11
20200902-W-US_Open-R64-Angelique_Kerber-Anna_Lena_Friedsam,2,B-DTL,14,7,3,2,2,9,5
20200902-W-US_Open-R64-Angelique_Kerber-Anna_Lena_Friedsam,2,B-IO,3,0,0,0,0,3,0
20200902-W-US_Open-R64-Angelique_Kerber-Anna_Lena_Friedsam,2,B-II,1,0,0,0,0,1,0
20200902-W-US_Open-R64-Angelique_Kerber-Anna_Lena_Friedsam,2,S-XC,14,0,0,0,0,4,10
20200902-W-US_Open-R64-Angelique_Kerber-Anna_Lena_Friedsam,2,S-DTM,14,0,0,0,0,7,7
20200902-W-US_Open-R64-Angelique_Kerber-Anna_Lena_Friedsam,2,S-DTL,7,0,0,0,0,3,4
20200906-W-US_Open-R16-Jennifer_Brady-Angelique_Kerber,1,F-XC,43,4,2,1,1,28,15
20200906-W-US_Open-R16-Jennifer_Brady-Angelique_Kerber,1,F-DTM,35,0,0,0,0,18,17
20200906-W-US_Open-R16-Jennifer_Brady-Angelique_Kerber,1,F-DTL,13,8,2,2,4,8,5
20200906-W-US_Open-R16-Jennifer_Brady-Angelique_Kerber,1,F-IO,18,8,7,1,0,16,2
20200906-W-US_Open-R16-Jennifer_Brady-Angelique_Kerber,1,F-II,3,2,1,0,1,2,1
20200906-W-US_Open-R16-Jennifer_Brady-Angelique_Kerber,1,B-XC,52,7,3,2,2,29,23
20200906-W-US_Open-R16-Jennifer_Brady-Angelique_Kerber,1,B-DTM,25,0,0,0,0,15,10
20200906-W-US_Open-R16-Jennifer_Brady-Angelique_Kerber,1,B-DTL,13,4,2,0,2,6,7
20200906-W-US_Open-R16-Jennifer_Brady-Angelique_Kerber,1,B-IO,1,0,0,0,0,1,0
20200906-W-US_Open-R16-Jennifer_Brady-Angelique_Kerber,1,S-XC,2,0,0,0,0,1,1
20200906-W-US_Open-R16-Jennifer_Brady-Angelique_Kerber,1,S-DTM,8,1,0,0,1,5,3
20200906-W-US_Open-R16-Jennifer_Brady-Angelique_Kerber,1,S-DTL,3,0,0,0,0,2,1
20200906-W-US_Open-R16-Jennifer_Brady-Angelique_Kerber,2,F-XC,73,10,4,1,5,29,44
20200906-W-US_Open-R16-Jennifer_Brady-Angelique_Kerber,2,F-DTM,20,3,1,0,2,7,13
20200906-W-US_Open-R16-Jennifer_Brady-Angelique_Kerber,2,F-DTL,16,9,3,1,5,7,9
20200906-W-US_Open-R16-Jennifer_Brady-Angelique_Kerber,2,F-IO,22,9,2,5,2,14,8
20200906-W-US_Open-R16-Jennifer_Brady-Angelique_Kerber,2,F-II,2,2,0,1,1,1,1
20200906-W-US_Open-R16-Jennifer_Brady-Angelique_Kerber,2,B-XC,35,10,1,4,5,20,15
20200906-W-US_Open-R16-Jennifer_Brady-Angelique_Kerber,2,B-DTM,25,1,0,0,1,7,18
20200906-W-US_Open-R16-Jennifer_Brady-Angelique_Kerber,2,B-DTL,6,1,0,0,1,3,3
20200906-W-US_Open-R16-Jennifer_Brady-Angelique_Kerber,2,B-IO,5,2,1,1,0,3,2
20200906-W-US_Open-R16-Jennifer_Brady-Angelique_Kerber,2,S-XC,5,0,0,0,0,0,5
20200906-W-US_Open-R16-Jennifer_Brady-Angelique_Kerber,2,S-DTM,3,0,0,0,0,0,3
20200907-W-US_Open-R16-Sofia_Kenin-Elise_Mertens,1,F-XC,27,14,6,1,7,13,14
20200907-W-US_Open-R16-Sofia_Kenin-Elise_Mertens,1,F-DTM,10,0,0,0,0,6,4
20200907-W-US_Open-R16-Sofia_Kenin-Elise_Mertens,1,F-DTL,6,5,3,1,1,4,2
20200907-W-US_Open-R16-Sofia_Kenin-Elise_Mertens,1,F-IO,3,0,0,0,0,1,2
20200907-W-US_Open-R16-Sofia_Kenin-Elise_Mertens,1,B-XC,46,18,6,4,8,24,22
20200907-W-US_Open-R16-Sofia_Kenin-Elise_Mertens,1,B-DTM,15,2,0,0,2,7,8
20200907-W-US_Open-R16-Sofia_Kenin-Elise_Mertens,1,B-DTL,13,7,4,1,2,7,6
20200907-W-US_Open-R16-Sofia_Kenin-Elise_Mertens,1,B-IO,11,3,1,1,1,7,4
20200907-W-US_Open-R16-Sofia_Kenin-Elise_Mertens,1,S-XC,4,0,0,0,0,3,1
20200907-W-US_Open-R16-Sofia_Kenin-Elise_Mertens,2,F-XC,11,1,1,0,0,6,5
20200907-W-US_Open-R16-Sofia_Kenin-Elise_Mertens,2,F-DTM,14,0,0,0,0,5,9
20200907-W-US_Open-R16-Sofia_Kenin-Elise_Mertens,2,F-DTL,14,3,2,1,0,11,3
20200907-W-US_Open-R16-Sofia_Kenin-Elise_Mertens,2,F-IO,8,2,0,1,1,5,3
20200907-W-US_Open-R16-Sofia_Kenin-Elise_Mertens,2,B-XC,15,2,0,0,2,3,12
20200907-W-US_Open-R16-Sofia_Kenin-Elise_Mertens,2,B-DTM,20,1,0,0,1,7,13
20200907-W-US_Open-R16-Sofia_Kenin-Elise_Mertens,2,B-DTL,12,4,4,0,0,9,3
20200907-W-US_Open-R16-Sofia_Kenin-Elise_Mertens,2,B-IO,7,1,0,1,0,4,3
20200907-W-US_Open-R16-Sofia_Kenin-Elise_Mertens,2,S-XC,7,2,1,0,1,3,4
20200907-W-US_Open-R16-Sofia_Kenin-Elise_Mertens,2,S-DTM,2,0,0,0,0,1,1
20200909-W-US_Open-QF-Serena_Williams-Tsvetana_Pironkova,1,F-XC,37,13,4,3,6,22,15
20200909-W-US_Open-QF-Serena_Williams-Tsvetana_Pironkova,1,F-DTM,28,6,0,2,4,13,15
20200909-W-US_Open-QF-Serena_Williams-Tsvetana_Pironkova,1,F-DTL,8,4,2,0,2,3,5
20200909-W-US_Open-QF-Serena_Williams-Tsvetana_Pironkova,1,F-IO,16,8,5,0,3,6,10
20200909-W-US_Open-QF-Serena_Williams-Tsvetana_Pironkova,1,B-XC,55,12,3,5,4,29,26
20200909-W-US_Open-QF-Serena_Williams-Tsvetana_Pironkova,1,B-DTM,33,2,0,0,2,18,15
20200909-W-US_Open-QF-Serena_Williams-Tsvetana_Pironkova,1,B-DTL,15,7,4,0,3,5,10
20200909-W-US_Open-QF-Serena_Williams-Tsvetana_Pironkova,1,B-IO,12,2,0,0,2,5,7
20200909-W-US_Open-QF-Serena_Williams-Tsvetana_Pironkova,1,S-XC,8,2,0,1,1,4,4
20200909-W-US_Open-QF-Serena_Williams-Tsvetana_Pironkova,1,S-DTM,1,0,0,0,0,0,1
20200909-W-US_Open-QF-Serena_Williams-Tsvetana_Pironkova,1,S-IO,1,0,0,0,0,0,1
20200909-W-US_Open-QF-Serena_Williams-Tsvetana_Pironkova,2,F-XC,22,5,2,1,2,11,11
20200909-W-US_Open-QF-Serena_Williams-Tsvetana_Pironkova,2,F-DTM,30,7,1,0,6,15,15
20200909-W-US_Open-QF-Serena_Williams-Tsvetana_Pironkova,2,F-DTL,13,3,2,0,1,9,4
20200909-W-US_Open-QF-Serena_Williams-Tsvetana_Pironkova,2,F-IO,13,4,2,1,1,7,6
20200909-W-US_Open-QF-Serena_Williams-Tsvetana_Pironkova,2,B-XC,37,4,1,2,1,18,19
20200909-W-US_Open-QF-Serena_Williams-Tsvetana_Pironkova,2,B-DTM,25,3,0,1,2,12,13
20200909-W-US_Open-QF-Serena_Williams-Tsvetana_Pironkova,2,B-DTL,22,14,5,5,4,14,8
20200909-W-US_Open-QF-Serena_Williams-Tsvetana_Pironkova,2,B-IO,10,5,2,0,3,3,7
20200909-W-US_Open-QF-Serena_Williams-Tsvetana_Pironkova,2,S-DTM,2,0,0,0,0,1,1
20200909-W-US_Open-QF-Serena_Williams-Tsvetana_Pironkova,2,S-IO,1,0,0,0,0,1,0
20171028-W-Singapore-SF-Caroline_Garcia-Venus_Williams,1,F-XC,38,8,4,0,4,17,21
20171028-W-Singapore-SF-Caroline_Garcia-Venus_Williams,1,F-DTM,15,1,1,0,0,6,9
20171028-W-Singapore-SF-Caroline_Garcia-Venus_Williams,1,F-DTL,10,4,2,0,2,4,6
20171028-W-Singapore-SF-Caroline_Garcia-Venus_Williams,1,F-IO,18,12,5,2,5,11,7
20171028-W-Singapore-SF-Caroline_Garcia-Venus_Williams,1,F-II,5,3,2,0,1,3,2
20171028-W-Singapore-SF-Caroline_Garcia-Venus_Williams,1,B-XC,47,13,2,4,7,18,29
20171028-W-Singapore-SF-Caroline_Garcia-Venus_Williams,1,B-DTM,22,3,0,0,3,10,12
20171028-W-Singapore-SF-Caroline_Garcia-Venus_Williams,1,B-DTL,11,9,3,3,3,6,5
20171028-W-Singapore-SF-Caroline_Garcia-Venus_Williams,1,B-IO,3,1,0,1,0,2,1
20171028-W-Singapore-SF-Caroline_Garcia-Venus_Williams,1,S-XC,1,0,0,0,0,0,1
20171028-W-Singapore-SF-Caroline_Garcia-Venus_Williams,1,S-DTM,2,0,0,0,0,0,2
20171028-W-Singapore-SF-Caroline_Garcia-Venus_Williams,2,F-XC,31,11,4,4,3,20,11
20171028-W-Singapore-SF-Caroline_Garcia-Venus_Williams,2,F-DTM,21,2,0,0,2,13,8
20171028-W-Singapore-SF-Caroline_Garcia-Venus_Williams,2,F-DTL,8,4,1,1,2,4,4
20171028-W-Singapore-SF-Caroline_Garcia-Venus_Williams,2,F-IO,21,11,4,2,5,12,9
20171028-W-Singapore-SF-Caroline_Garcia-Venus_Williams,2,F-II,1,1,1,0,0,1,0
20171028-W-Singapore-SF-Caroline_Garcia-Venus_Williams,2,B-XC,56,14,4,4,6,32,24
20171028-W-Singapore-SF-Caroline_Garcia-Venus_Williams,2,B-DTM,22,6,2,0,4,14,8
20171028-W-Singapore-SF-Caroline_Garcia-Venus_Williams,2,B-DTL,8,6,3,1,2,5,3
20171028-W-Singapore-SF-Caroline_Garcia-Venus_Williams,2,B-IO,5,4,2,0,2,2,3
20171028-W-Singapore-SF-Caroline_Garcia-Venus_Williams,2,S-XC,3,0,0,0,0,2,1
20171028-W-Singapore-SF-Caroline_Garcia-Venus_Williams,2,S-DTM,6,0,0,0,0,2,4
20200918-W-Rome-R16-Victoria_Azarenka-Daria_Kasatkina,1,F-XC,29,5,0,2,3,14,15
20200918-W-Rome-R16-Victoria_Azarenka-Daria_Kasatkina,1,F-DTM,16,2,1,1,0,6,10
20200918-W-Rome-R16-Victoria_Azarenka-Daria_Kasatkina,1,F-DTL,25,3,1,1,1,13,12
20200918-W-Rome-R16-Victoria_Azarenka-Daria_Kasatkina,1,F-IO,16,9,4,3,2,11,5
20200918-W-Rome-R16-Victoria_Azarenka-Daria_Kasatkina,1,B-XC,27,5,2,1,2,17,10
20200918-W-Rome-R16-Victoria_Azarenka-Daria_Kasatkina,1,B-DTM,21,0,0,0,0,13,8
20200918-W-Rome-R16-Victoria_Azarenka-Daria_Kasatkina,1,B-DTL,10,4,2,0,2,6,4
20200918-W-Rome-R16-Victoria_Azarenka-Daria_Kasatkina,1,B-IO,11,2,0,0,2,5,6
20200918-W-Rome-R16-Victoria_Azarenka-Daria_Kasatkina,1,S-XC,4,0,0,0,0,1,3
20200918-W-Rome-R16-Victoria_Azarenka-Daria_Kasatkina,1,S-DTM,1,0,0,0,0,0,1
20200918-W-Rome-R16-Victoria_Azarenka-Daria_Kasatkina,1,S-DTL,2,1,0,0,1,0,2
20200918-W-Rome-R16-Victoria_Azarenka-Daria_Kasatkina,1,S-IO,2,0,0,0,0,1,1
20200918-W-Rome-R16-Victoria_Azarenka-Daria_Kasatkina,2,F-XC,47,10,3,3,4,26,21
20200918-W-Rome-R16-Victoria_Azarenka-Daria_Kasatkina,2,F-DTM,17,0,0,0,0,7,10
20200918-W-Rome-R16-Victoria_Azarenka-Daria_Kasatkina,2,F-DTL,12,5,2,2,1,6,6
20200918-W-Rome-R16-Victoria_Azarenka-Daria_Kasatkina,2,F-IO,20,6,1,2,3,10,10
20200918-W-Rome-R16-Victoria_Azarenka-Daria_Kasatkina,2,F-II,2,1,1,0,0,1,1
20200918-W-Rome-R16-Victoria_Azarenka-Daria_Kasatkina,2,B-XC,16,4,1,1,2,10,6
20200918-W-Rome-R16-Victoria_Azarenka-Daria_Kasatkina,2,B-DTM,22,1,0,0,1,8,14
20200918-W-Rome-R16-Victoria_Azarenka-Daria_Kasatkina,2,B-DTL,9,3,2,1,0,7,2
20200918-W-Rome-R16-Victoria_Azarenka-Daria_Kasatkina,2,B-IO,1,1,0,1,0,1,0
20200918-W-Rome-R16-Victoria_Azarenka-Daria_Kasatkina,2,S-XC,8,1,1,0,0,3,5
20200918-W-Rome-R16-Victoria_Azarenka-Daria_Kasatkina,2,S-DTM,8,0,0,0,0,2,6
20200918-W-Rome-R16-Victoria_Azarenka-Daria_Kasatkina,2,S-DTL,3,1,0,1,0,1,2
20200907-W-US_Open-R16-Alize_Cornet-Tsvetana_Pironkova,1,F-XC,61,10,3,0,7,27,34
20200907-W-US_Open-R16-Alize_Cornet-Tsvetana_Pironkova,1,F-DTM,56,5,0,0,5,27,29
20200907-W-US_Open-R16-Alize_Cornet-Tsvetana_Pironkova,1,F-DTL,20,7,5,0,2,12,8
20200907-W-US_Open-R16-Alize_Cornet-Tsvetana_Pironkova,1,F-IO,14,5,2,1,2,9,5
20200907-W-US_Open-R16-Alize_Cornet-Tsvetana_Pironkova,1,B-XC,57,2,0,2,0,31,26
20200907-W-US_Open-R16-Alize_Cornet-Tsvetana_Pironkova,1,B-DTM,81,3,0,1,2,37,44
20200907-W-US_Open-R16-Alize_Cornet-Tsvetana_Pironkova,1,B-DTL,13,2,0,1,1,6,7
20200907-W-US_Open-R16-Alize_Cornet-Tsvetana_Pironkova,1,B-IO,13,4,1,0,3,6,7
20200907-W-US_Open-R16-Alize_Cornet-Tsvetana_Pironkova,1,S-XC,9,0,0,0,0,5,4
20200907-W-US_Open-R16-Alize_Cornet-Tsvetana_Pironkova,1,S-DTM,20,1,0,0,1,9,11
20200907-W-US_Open-R16-Alize_Cornet-Tsvetana_Pironkova,1,S-DTL,7,0,0,0,0,5,2
20200907-W-US_Open-R16-Alize_Cornet-Tsvetana_Pironkova,1,S-IO,5,0,0,0,0,3,2
20200907-W-US_Open-R16-Alize_Cornet-Tsvetana_Pironkova,2,F-XC,62,9,4,1,4,37,25
20200907-W-US_Open-R16-Alize_Cornet-Tsvetana_Pironkova,2,F-DTM,37,5,0,0,5,14,23
20200907-W-US_Open-R16-Alize_Cornet-Tsvetana_Pironkova,2,F-DTL,26,7,3,0,4,14,12
20200907-W-US_Open-R16-Alize_Cornet-Tsvetana_Pironkova,2,F-IO,15,5,4,0,1,11,4
20200907-W-US_Open-R16-Alize_Cornet-Tsvetana_Pironkova,2,B-XC,96,21,9,1,11,48,48
20200907-W-US_Open-R16-Alize_Cornet-Tsvetana_Pironkova,2,B-DTM,61,8,0,1,7,26,35
20200907-W-US_Open-R16-Alize_Cornet-Tsvetana_Pironkova,2,B-DTL,22,9,6,1,2,15,7
20200907-W-US_Open-R16-Alize_Cornet-Tsvetana_Pironkova,2,B-IO,36,11,2,4,5,20,16
20200907-W-US_Open-R16-Alize_Cornet-Tsvetana_Pironkova,2,B-II,3,0,0,0,0,1,2
20200907-W-US_Open-R16-Alize_Cornet-Tsvetana_Pironkova,2,S-XC,3,1,1,0,0,1,2
20200907-W-US_Open-R16-Alize_Cornet-Tsvetana_Pironkova,2,S-DTM,3,0,0,0,0,1,2
20200907-W-US_Open-R16-Alize_Cornet-Tsvetana_Pironkova,2,S-DTL,1,0,0,0,0,1,0
20200907-W-US_Open-R16-Alize_Cornet-Tsvetana_Pironkova,2,S-IO,1,0,0,0,0,1,0
20200906-W-US_Open-R16-Petra_Kvitova-Shelby_Rogers,1,F-XC,45,15,7,3,5,27,18
20200906-W-US_Open-R16-Petra_Kvitova-Shelby_Rogers,1,F-DTM,41,7,3,0,4,18,23
20200906-W-US_Open-R16-Petra_Kvitova-Shelby_Rogers,1,F-DTL,7,7,3,2,2,5,2
20200906-W-US_Open-R16-Petra_Kvitova-Shelby_Rogers,1,F-IO,20,11,7,0,4,12,8
20200906-W-US_Open-R16-Petra_Kvitova-Shelby_Rogers,1,F-II,2,2,2,0,0,2,0
20200906-W-US_Open-R16-Petra_Kvitova-Shelby_Rogers,1,B-XC,39,14,7,4,3,26,13
20200906-W-US_Open-R16-Petra_Kvitova-Shelby_Rogers,1,B-DTM,29,2,0,0,2,14,15
20200906-W-US_Open-R16-Petra_Kvitova-Shelby_Rogers,1,B-DTL,7,5,2,1,2,4,3
20200906-W-US_Open-R16-Petra_Kvitova-Shelby_Rogers,1,B-IO,17,10,6,2,2,14,3
20200906-W-US_Open-R16-Petra_Kvitova-Shelby_Rogers,1,S-XC,3,0,0,0,0,1,2
20200906-W-US_Open-R16-Petra_Kvitova-Shelby_Rogers,1,S-DTM,5,0,0,0,0,1,4
20200906-W-US_Open-R16-Petra_Kvitova-Shelby_Rogers,1,S-DTL,2,0,0,0,0,1,1
20200906-W-US_Open-R16-Petra_Kvitova-Shelby_Rogers,1,S-IO,3,1,0,0,1,2,1
20200906-W-US_Open-R16-Petra_Kvitova-Shelby_Rogers,2,F-XC,32,6,2,2,2,17,15
20200906-W-US_Open-R16-Petra_Kvitova-Shelby_Rogers,2,F-DTM,45,3,0,0,3,16,29
20200906-W-US_Open-R16-Petra_Kvitova-Shelby_Rogers,2,F-DTL,10,5,2,1,2,7,3
20200906-W-US_Open-R16-Petra_Kvitova-Shelby_Rogers,2,F-IO,22,9,4,4,1,18,4
20200906-W-US_Open-R16-Petra_Kvitova-Shelby_Rogers,2,B-XC,12,5,0,2,3,3,9
20200906-W-US_Open-R16-Petra_Kvitova-Shelby_Rogers,2,B-DTM,51,9,0,3,6,19,32
20200906-W-US_Open-R16-Petra_Kvitova-Shelby_Rogers,2,B-DTL,11,7,1,2,4,5,6
20200906-W-US_Open-R16-Petra_Kvitova-Shelby_Rogers,2,B-IO,5,3,0,0,3,1,4
20200906-W-US_Open-R16-Petra_Kvitova-Shelby_Rogers,2,S-XC,2,0,0,0,0,0,2
20200906-W-US_Open-R16-Petra_Kvitova-Shelby_Rogers,2,S-DTM,8,0,0,0,0,1,7
20200906-W-US_Open-R16-Petra_Kvitova-Shelby_Rogers,2,S-DTL,3,0,0,0,0,2,1
20200906-W-US_Open-R16-Petra_Kvitova-Shelby_Rogers,2,S-IO,2,0,0,0,0,0,2
20200930-W-Roland_Garros-R64-Kiki_Bertens-Sara_Errani,1,F-XC,111,18,10,4,4,65,46
20200930-W-Roland_Garros-R64-Kiki_Bertens-Sara_Errani,1,F-DTM,26,0,0,0,0,13,13
20200930-W-Roland_Garros-R64-Kiki_Bertens-Sara_Errani,1,F-DTL,33,11,2,2,7,16,17
20200930-W-Roland_Garros-R64-Kiki_Bertens-Sara_Errani,1,F-IO,35,11,5,2,4,20,15
20200930-W-Roland_Garros-R64-Kiki_Bertens-Sara_Errani,1,F-II,9,3,1,1,1,7,2
20200930-W-Roland_Garros-R64-Kiki_Bertens-Sara_Errani,1,B-XC,95,8,0,3,5,45,50
20200930-W-Roland_Garros-R64-Kiki_Bertens-Sara_Errani,1,B-DTM,70,6,0,2,4,28,42
20200930-W-Roland_Garros-R64-Kiki_Bertens-Sara_Errani,1,B-DTL,22,12,3,2,7,9,13
20200930-W-Roland_Garros-R64-Kiki_Bertens-Sara_Errani,1,B-IO,5,3,0,0,3,2,3
20200930-W-Roland_Garros-R64-Kiki_Bertens-Sara_Errani,1,S-XC,40,6,3,0,3,16,24
20200930-W-Roland_Garros-R64-Kiki_Bertens-Sara_Errani,1,S-DTM,29,3,0,0,3,8,21
20200930-W-Roland_Garros-R64-Kiki_Bertens-Sara_Errani,1,S-DTL,14,4,2,1,1,9,5
20200930-W-Roland_Garros-R64-Kiki_Bertens-Sara_Errani,1,S-IO,1,0,0,0,0,1,0
20200930-W-Roland_Garros-R64-Kiki_Bertens-Sara_Errani,2,F-XC,109,10,2,3,5,46,63
20200930-W-Roland_Garros-R64-Kiki_Bertens-Sara_Errani,2,F-DTM,33,1,0,0,1,20,13
20200930-W-Roland_Garros-R64-Kiki_Bertens-Sara_Errani,2,F-DTL,43,6,2,1,3,19,24
20200930-W-Roland_Garros-R64-Kiki_Bertens-Sara_Errani,2,F-IO,43,11,1,7,3,29,14
20200930-W-Roland_Garros-R64-Kiki_Bertens-Sara_Errani,2,F-II,6,1,1,0,0,4,2
20200930-W-Roland_Garros-R64-Kiki_Bertens-Sara_Errani,2,B-XC,129,12,5,1,6,77,52
20200930-W-Roland_Garros-R64-Kiki_Bertens-Sara_Errani,2,B-DTM,48,3,0,1,2,21,27
20200930-W-Roland_Garros-R64-Kiki_Bertens-Sara_Errani,2,B-DTL,17,10,7,1,2,11,6
20200930-W-Roland_Garros-R64-Kiki_Bertens-Sara_Errani,2,B-IO,4,0,0,0,0,3,1
20200930-W-Roland_Garros-R64-Kiki_Bertens-Sara_Errani,2,S-XC,23,1,0,0,1,15,8
20200930-W-Roland_Garros-R64-Kiki_Bertens-Sara_Errani,2,S-DTM,10,0,0,0,0,4,6
20200930-W-Roland_Garros-R64-Kiki_Bertens-Sara_Errani,2,S-DTL,13,2,1,1,0,8,5
20200930-W-Roland_Garros-R64-Kiki_Bertens-Sara_Errani,2,S-IO,1,0,0,0,0,1,0
20201002-W-Roland_Garros-R32-Kiki_Bertens-Katerina_Siniakova,1,F-XC,39,5,1,1,3,23,16
20201002-W-Roland_Garros-R32-Kiki_Bertens-Katerina_Siniakova,1,F-DTM,5,0,0,0,0,4,1
20201002-W-Roland_Garros-R32-Kiki_Bertens-Katerina_Siniakova,1,F-DTL,3,0,0,0,0,2,1
20201002-W-Roland_Garros-R32-Kiki_Bertens-Katerina_Siniakova,1,F-IO,8,1,1,0,0,6,2
20201002-W-Roland_Garros-R32-Kiki_Bertens-Katerina_Siniakova,1,F-II,4,1,0,1,0,3,1
20201002-W-Roland_Garros-R32-Kiki_Bertens-Katerina_Siniakova,1,B-XC,9,0,0,0,0,7,2
20201002-W-Roland_Garros-R32-Kiki_Bertens-Katerina_Siniakova,1,B-DTM,18,0,0,0,0,11,7
20201002-W-Roland_Garros-R32-Kiki_Bertens-Katerina_Siniakova,1,B-DTL,4,2,0,0,2,0,4
20201002-W-Roland_Garros-R32-Kiki_Bertens-Katerina_Siniakova,1,S-XC,10,4,2,1,1,6,4
20201002-W-Roland_Garros-R32-Kiki_Bertens-Katerina_Siniakova,1,S-DTM,9,0,0,0,0,5,4
20201002-W-Roland_Garros-R32-Kiki_Bertens-Katerina_Siniakova,2,F-XC,21,6,0,1,5,5,16
20201002-W-Roland_Garros-R32-Kiki_Bertens-Katerina_Siniakova,2,F-DTM,10,1,0,0,1,2,8
20201002-W-Roland_Garros-R32-Kiki_Bertens-Katerina_Siniakova,2,F-DTL,14,4,1,0,3,7,7
20201002-W-Roland_Garros-R32-Kiki_Bertens-Katerina_Siniakova,2,F-IO,10,1,0,0,1,6,4
20201002-W-Roland_Garros-R32-Kiki_Bertens-Katerina_Siniakova,2,B-XC,23,3,0,1,2,8,15
20201002-W-Roland_Garros-R32-Kiki_Bertens-Katerina_Siniakova,2,B-DTM,9,1,0,0,1,2,7
20201002-W-Roland_Garros-R32-Kiki_Bertens-Katerina_Siniakova,2,B-DTL,11,5,2,1,2,5,6
20201002-W-Roland_Garros-R32-Kiki_Bertens-Katerina_Siniakova,2,B-IO,15,3,1,1,1,7,8
20201002-W-Roland_Garros-R32-Kiki_Bertens-Katerina_Siniakova,2,S-DTM,4,1,1,0,0,3,1
20200917-W-Rome-R32-Kiki_Bertens-Polona_Hercog,1,F-XC,18,7,2,0,5,5,13
20200917-W-Rome-R32-Kiki_Bertens-Polona_Hercog,1,F-DTM,12,1,0,0,1,4,8
20200917-W-Rome-R32-Kiki_Bertens-Polona_Hercog,1,F-DTL,9,3,1,0,2,5,4
20200917-W-Rome-R32-Kiki_Bertens-Polona_Hercog,1,F-IO,44,6,0,1,5,19,25
20200917-W-Rome-R32-Kiki_Bertens-Polona_Hercog,1,F-II,3,2,1,0,1,1,2
20200917-W-Rome-R32-Kiki_Bertens-Polona_Hercog,1,B-XC,52,6,0,1,5,24,28
20200917-W-Rome-R32-Kiki_Bertens-Polona_Hercog,1,B-DTM,18,1,0,0,1,7,11
20200917-W-Rome-R32-Kiki_Bertens-Polona_Hercog,1,B-DTL,7,3,0,1,2,2,5
20200917-W-Rome-R32-Kiki_Bertens-Polona_Hercog,1,S-XC,4,1,0,0,1,0,4
20200917-W-Rome-R32-Kiki_Bertens-Polona_Hercog,1,S-DTM,1,0,0,0,0,0,1
20200917-W-Rome-R32-Kiki_Bertens-Polona_Hercog,1,S-DTL,1,0,0,0,0,0,1
20200917-W-Rome-R32-Kiki_Bertens-Polona_Hercog,2,F-XC,30,12,4,3,5,20,10
20200917-W-Rome-R32-Kiki_Bertens-Polona_Hercog,2,F-DTM,24,2,0,1,1,14,10
20200917-W-Rome-R32-Kiki_Bertens-Polona_Hercog,2,F-DTL,1,1,0,1,0,1,0
20200917-W-Rome-R32-Kiki_Bertens-Polona_Hercog,2,F-IO,44,8,1,4,3,30,14
20200917-W-Rome-R32-Kiki_Bertens-Polona_Hercog,2,F-II,4,3,0,1,2,2,2
20200917-W-Rome-R32-Kiki_Bertens-Polona_Hercog,2,B-XC,27,2,0,0,2,14,13
20200917-W-Rome-R32-Kiki_Bertens-Polona_Hercog,2,B-DTM,10,4,0,1,3,6,4
20200917-W-Rome-R32-Kiki_Bertens-Polona_Hercog,2,S-XC,24,6,0,0,6,9,15
20200917-W-Rome-R32-Kiki_Bertens-Polona_Hercog,2,S-DTM,9,1,0,0,1,1,8
20200917-W-Rome-R32-Kiki_Bertens-Polona_Hercog,2,S-DTL,2,1,1,0,0,2,0
20200915-W-Rome-R64-Iga_Swiatek-Arantxa_Rus,1,F-XC,74,25,6,9,10,46,28
20200915-W-Rome-R64-Iga_Swiatek-Arantxa_Rus,1,F-DTM,22,2,0,0,2,15,7
20200915-W-Rome-R64-Iga_Swiatek-Arantxa_Rus,1,F-DTL,11,6,3,1,2,5,6
20200915-W-Rome-R64-Iga_Swiatek-Arantxa_Rus,1,F-IO,34,16,4,3,9,17,17
20200915-W-Rome-R64-Iga_Swiatek-Arantxa_Rus,1,F-II,5,2,2,0,0,5,0
20200915-W-Rome-R64-Iga_Swiatek-Arantxa_Rus,1,B-XC,42,8,6,1,1,28,14
20200915-W-Rome-R64-Iga_Swiatek-Arantxa_Rus,1,B-DTM,16,1,0,1,0,9,7
20200915-W-Rome-R64-Iga_Swiatek-Arantxa_Rus,1,B-DTL,11,5,1,2,2,9,2
20200915-W-Rome-R64-Iga_Swiatek-Arantxa_Rus,1,B-IO,8,3,1,1,1,4,4
20200915-W-Rome-R64-Iga_Swiatek-Arantxa_Rus,1,S-XC,1,0,0,0,0,1,0
20200915-W-Rome-R64-Iga_Swiatek-Arantxa_Rus,1,S-DTM,5,1,0,0,1,2,3
20200915-W-Rome-R64-Iga_Swiatek-Arantxa_Rus,1,S-DTL,1,0,0,0,0,1,0
20200915-W-Rome-R64-Iga_Swiatek-Arantxa_Rus,2,F-XC,71,15,4,8,3,32,39
20200915-W-Rome-R64-Iga_Swiatek-Arantxa_Rus,2,F-DTM,43,3,1,1,1,23,20
20200915-W-Rome-R64-Iga_Swiatek-Arantxa_Rus,2,F-DTL,9,3,2,0,1,5,4
20200915-W-Rome-R64-Iga_Swiatek-Arantxa_Rus,2,F-IO,17,5,3,2,0,8,9
20200915-W-Rome-R64-Iga_Swiatek-Arantxa_Rus,2,B-XC,25,1,0,0,1,6,19
20200915-W-Rome-R64-Iga_Swiatek-Arantxa_Rus,2,B-DTM,43,1,0,0,1,17,26
20200915-W-Rome-R64-Iga_Swiatek-Arantxa_Rus,2,B-DTL,10,1,0,0,1,3,7
20200915-W-Rome-R64-Iga_Swiatek-Arantxa_Rus,2,B-IO,5,2,0,1,1,2,3
20200915-W-Rome-R64-Iga_Swiatek-Arantxa_Rus,2,S-XC,4,1,0,1,0,2,2
20200915-W-Rome-R64-Iga_Swiatek-Arantxa_Rus,2,S-DTM,5,0,0,0,0,0,5
20200915-W-Rome-R64-Iga_Swiatek-Arantxa_Rus,2,S-DTL,2,0,0,0,0,0,2
20200109-W-Shenzhen-R32-Yafan_Wang-Sara_Sorribes_Tormo,1,F-XC,70,14,3,5,6,35,35
20200109-W-Shenzhen-R32-Yafan_Wang-Sara_Sorribes_Tormo,1,F-DTM,31,2,0,1,1,15,16
20200109-W-Shenzhen-R32-Yafan_Wang-Sara_Sorribes_Tormo,1,F-DTL,15,8,3,2,3,7,8
20200109-W-Shenzhen-R32-Yafan_Wang-Sara_Sorribes_Tormo,1,F-IO,49,9,3,3,3,25,24
20200109-W-Shenzhen-R32-Yafan_Wang-Sara_Sorribes_Tormo,1,F-II,12,6,2,1,3,6,6
20200109-W-Shenzhen-R32-Yafan_Wang-Sara_Sorribes_Tormo,1,B-XC,77,10,3,2,5,45,32
20200109-W-Shenzhen-R32-Yafan_Wang-Sara_Sorribes_Tormo,1,B-DTM,50,1,0,0,1,24,26
20200109-W-Shenzhen-R32-Yafan_Wang-Sara_Sorribes_Tormo,1,B-DTL,14,8,3,0,5,8,6
20200109-W-Shenzhen-R32-Yafan_Wang-Sara_Sorribes_Tormo,1,B-IO,2,2,0,0,2,0,2
20200109-W-Shenzhen-R32-Yafan_Wang-Sara_Sorribes_Tormo,1,S-XC,3,1,0,0,1,1,2
20200109-W-Shenzhen-R32-Yafan_Wang-Sara_Sorribes_Tormo,1,S-DTM,4,1,0,0,1,1,3
20200109-W-Shenzhen-R32-Yafan_Wang-Sara_Sorribes_Tormo,1,S-DTL,5,2,0,0,2,1,4
20200109-W-Shenzhen-R32-Yafan_Wang-Sara_Sorribes_Tormo,2,F-XC,28,5,0,3,2,14,14
20200109-W-Shenzhen-R32-Yafan_Wang-Sara_Sorribes_Tormo,2,F-DTM,54,2,0,1,1,27,27
20200109-W-Shenzhen-R32-Yafan_Wang-Sara_Sorribes_Tormo,2,F-DTL,26,8,2,2,4,14,12
20200109-W-Shenzhen-R32-Yafan_Wang-Sara_Sorribes_Tormo,2,F-IO,43,5,0,1,4,16,27
20200109-W-Shenzhen-R32-Yafan_Wang-Sara_Sorribes_Tormo,2,F-II,3,2,1,1,0,2,1
20200109-W-Shenzhen-R32-Yafan_Wang-Sara_Sorribes_Tormo,2,B-XC,13,2,0,1,1,5,8
20200109-W-Shenzhen-R32-Yafan_Wang-Sara_Sorribes_Tormo,2,B-DTM,25,3,0,1,2,13,12
20200109-W-Shenzhen-R32-Yafan_Wang-Sara_Sorribes_Tormo,2,B-DTL,6,3,0,1,2,2,4
20200109-W-Shenzhen-R32-Yafan_Wang-Sara_Sorribes_Tormo,2,B-IO,1,1,0,1,0,1,0
20200109-W-Shenzhen-R32-Yafan_Wang-Sara_Sorribes_Tormo,2,S-XC,52,2,0,0,2,24,28
20200109-W-Shenzhen-R32-Yafan_Wang-Sara_Sorribes_Tormo,2,S-DTM,54,3,0,2,1,29,25
20200109-W-Shenzhen-R32-Yafan_Wang-Sara_Sorribes_Tormo,2,S-DTL,5,2,1,0,1,3,2
20200109-W-Shenzhen-R32-Yafan_Wang-Sara_Sorribes_Tormo,2,S-IO,4,0,0,0,0,2,2
20201004-W-Roland_Garros-R16-Martina_Trevisan-Kiki_Bertens,1,F-XC,82,10,0,5,5,46,36
20201004-W-Roland_Garros-R16-Martina_Trevisan-Kiki_Bertens,1,F-DTM,25,1,0,0,1,14,11
20201004-W-Roland_Garros-R16-Martina_Trevisan-Kiki_Bertens,1,F-DTL,12,4,3,0,1,8,4
20201004-W-Roland_Garros-R16-Martina_Trevisan-Kiki_Bertens,1,F-IO,33,9,2,3,4,19,14
20201004-W-Roland_Garros-R16-Martina_Trevisan-Kiki_Bertens,1,F-II,2,0,0,0,0,1,1
20201004-W-Roland_Garros-R16-Martina_Trevisan-Kiki_Bertens,1,B-XC,34,7,2,2,3,20,14
20201004-W-Roland_Garros-R16-Martina_Trevisan-Kiki_Bertens,1,B-DTM,40,1,0,0,1,24,16
20201004-W-Roland_Garros-R16-Martina_Trevisan-Kiki_Bertens,1,B-DTL,16,2,0,0,2,9,7
20201004-W-Roland_Garros-R16-Martina_Trevisan-Kiki_Bertens,1,B-IO,7,3,0,0,3,4,3
20201004-W-Roland_Garros-R16-Martina_Trevisan-Kiki_Bertens,1,S-DTM,6,0,0,0,0,4,2
20201004-W-Roland_Garros-R16-Martina_Trevisan-Kiki_Bertens,1,S-DTL,3,0,0,0,0,2,1
20201004-W-Roland_Garros-R16-Martina_Trevisan-Kiki_Bertens,1,S-IO,1,0,0,0,0,0,1
20201004-W-Roland_Garros-R16-Martina_Trevisan-Kiki_Bertens,2,F-XC,77,10,1,0,9,30,47
20201004-W-Roland_Garros-R16-Martina_Trevisan-Kiki_Bertens,2,F-DTM,23,2,0,0,2,7,16
20201004-W-Roland_Garros-R16-Martina_Trevisan-Kiki_Bertens,2,F-DTL,6,2,0,0,2,2,4
20201004-W-Roland_Garros-R16-Martina_Trevisan-Kiki_Bertens,2,F-IO,13,3,0,3,0,7,6
20201004-W-Roland_Garros-R16-Martina_Trevisan-Kiki_Bertens,2,F-II,4,1,0,0,1,1,3
20201004-W-Roland_Garros-R16-Martina_Trevisan-Kiki_Bertens,2,B-XC,35,5,1,2,2,13,22
20201004-W-Roland_Garros-R16-Martina_Trevisan-Kiki_Bertens,2,B-DTM,42,3,0,0,3,15,27
20201004-W-Roland_Garros-R16-Martina_Trevisan-Kiki_Bertens,2,B-DTL,8,4,1,1,2,4,4
20201004-W-Roland_Garros-R16-Martina_Trevisan-Kiki_Bertens,2,B-IO,3,1,1,0,0,2,1
20201004-W-Roland_Garros-R16-Martina_Trevisan-Kiki_Bertens,2,S-XC,10,2,0,1,1,6,4
20201004-W-Roland_Garros-R16-Martina_Trevisan-Kiki_Bertens,2,S-DTM,13,1,0,0,1,3,10
20201004-W-Roland_Garros-R16-Martina_Trevisan-Kiki_Bertens,2,S-DTL,3,0,0,0,0,2,1
20201006-W-Roland_Garros-QF-Iga_Swiatek-Martina_Trevisan,1,F-XC,40,8,2,2,4,26,14
20201006-W-Roland_Garros-QF-Iga_Swiatek-Martina_Trevisan,1,F-DTM,24,2,0,1,1,13,11
20201006-W-Roland_Garros-QF-Iga_Swiatek-Martina_Trevisan,1,F-DTL,5,3,3,0,0,4,1
20201006-W-Roland_Garros-QF-Iga_Swiatek-Martina_Trevisan,1,F-IO,13,7,1,3,3,5,8
20201006-W-Roland_Garros-QF-Iga_Swiatek-Martina_Trevisan,1,F-II,1,1,0,0,1,0,1
20201006-W-Roland_Garros-QF-Iga_Swiatek-Martina_Trevisan,1,B-XC,37,8,2,4,2,23,14
20201006-W-Roland_Garros-QF-Iga_Swiatek-Martina_Trevisan,1,B-DTM,18,1,0,0,1,8,10
20201006-W-Roland_Garros-QF-Iga_Swiatek-Martina_Trevisan,1,B-DTL,23,12,4,5,3,17,6
20201006-W-Roland_Garros-QF-Iga_Swiatek-Martina_Trevisan,1,B-IO,10,3,0,2,1,8,2
20201006-W-Roland_Garros-QF-Iga_Swiatek-Martina_Trevisan,1,S-XC,4,1,1,0,0,2,2
20201006-W-Roland_Garros-QF-Iga_Swiatek-Martina_Trevisan,1,S-DTM,1,0,0,0,0,0,1
20201006-W-Roland_Garros-QF-Iga_Swiatek-Martina_Trevisan,2,F-XC,44,5,2,0,3,21,23
20201006-W-Roland_Garros-QF-Iga_Swiatek-Martina_Trevisan,2,F-DTM,13,1,0,0,1,5,8
20201006-W-Roland_Garros-QF-Iga_Swiatek-Martina_Trevisan,2,F-DTL,12,6,2,2,2,6,6
20201006-W-Roland_Garros-QF-Iga_Swiatek-Martina_Trevisan,2,F-IO,14,4,3,1,0,13,1
20201006-W-Roland_Garros-QF-Iga_Swiatek-Martina_Trevisan,2,B-XC,16,1,0,0,1,2,14
20201006-W-Roland_Garros-QF-Iga_Swiatek-Martina_Trevisan,2,B-DTM,27,2,0,0,2,8,19
20201006-W-Roland_Garros-QF-Iga_Swiatek-Martina_Trevisan,2,B-DTL,13,3,0,0,3,6,7
20201006-W-Roland_Garros-QF-Iga_Swiatek-Martina_Trevisan,2,B-IO,12,1,0,0,1,4,8
20201006-W-Roland_Garros-QF-Iga_Swiatek-Martina_Trevisan,2,S-XC,2,0,0,0,0,0,2
20201006-W-Roland_Garros-QF-Iga_Swiatek-Martina_Trevisan,2,S-DTM,4,0,0,0,0,0,4
20201006-W-Roland_Garros-QF-Iga_Swiatek-Martina_Trevisan,2,S-DTL,4,0,0,0,0,1,3
20201008-W-Roland_Garros-SF-Iga_Swiatek-Nadia_Podoroska,1,F-XC,33,11,6,2,3,26,7
20201008-W-Roland_Garros-SF-Iga_Swiatek-Nadia_Podoroska,1,F-DTM,12,0,0,0,0,7,5
20201008-W-Roland_Garros-SF-Iga_Swiatek-Nadia_Podoroska,1,F-DTL,7,2,1,0,1,4,3
20201008-W-Roland_Garros-SF-Iga_Swiatek-Nadia_Podoroska,1,F-IO,19,9,4,3,2,13,6
20201008-W-Roland_Garros-SF-Iga_Swiatek-Nadia_Podoroska,1,B-XC,34,11,5,2,4,19,15
20201008-W-Roland_Garros-SF-Iga_Swiatek-Nadia_Podoroska,1,B-DTM,17,1,0,1,0,11,6
20201008-W-Roland_Garros-SF-Iga_Swiatek-Nadia_Podoroska,1,B-DTL,6,5,0,3,2,4,2
20201008-W-Roland_Garros-SF-Iga_Swiatek-Nadia_Podoroska,1,B-IO,4,2,2,0,0,4,0
20201008-W-Roland_Garros-SF-Iga_Swiatek-Nadia_Podoroska,1,S-XC,1,1,1,0,0,1,0
20201008-W-Roland_Garros-SF-Iga_Swiatek-Nadia_Podoroska,2,F-XC,26,4,1,1,2,10,16
20201008-W-Roland_Garros-SF-Iga_Swiatek-Nadia_Podoroska,2,F-DTM,14,1,1,0,0,5,9
20201008-W-Roland_Garros-SF-Iga_Swiatek-Nadia_Podoroska,2,F-DTL,4,3,0,0,3,0,4
20201008-W-Roland_Garros-SF-Iga_Swiatek-Nadia_Podoroska,2,F-IO,8,4,1,0,3,3,5
20201008-W-Roland_Garros-SF-Iga_Swiatek-Nadia_Podoroska,2,F-II,3,3,2,1,0,3,0
20201008-W-Roland_Garros-SF-Iga_Swiatek-Nadia_Podoroska,2,B-XC,28,6,0,3,3,12,16
20201008-W-Roland_Garros-SF-Iga_Swiatek-Nadia_Podoroska,2,B-DTM,13,0,0,0,0,5,8
20201008-W-Roland_Garros-SF-Iga_Swiatek-Nadia_Podoroska,2,B-DTL,6,4,0,1,3,2,4
20201008-W-Roland_Garros-SF-Iga_Swiatek-Nadia_Podoroska,2,B-IO,1,0,0,0,0,0,1
20201008-W-Roland_Garros-SF-Iga_Swiatek-Nadia_Podoroska,2,S-XC,3,0,0,0,0,2,1
20201008-W-Roland_Garros-SF-Iga_Swiatek-Nadia_Podoroska,2,S-DTM,5,0,0,0,0,2,3
20100127-W-Australian_Open-QF-Serena_Williams-Victoria_Azarenka,1,F-XC,60,17,5,2,10,28,32
20100127-W-Australian_Open-QF-Serena_Williams-Victoria_Azarenka,1,F-DTM,16,3,0,1,2,6,10
20100127-W-Australian_Open-QF-Serena_Williams-Victoria_Azarenka,1,F-DTL,24,12,7,1,4,13,11
20100127-W-Australian_Open-QF-Serena_Williams-Victoria_Azarenka,1,F-IO,12,4,1,1,2,7,5
20100127-W-Australian_Open-QF-Serena_Williams-Victoria_Azarenka,1,B-XC,57,10,2,4,4,32,25
20100127-W-Australian_Open-QF-Serena_Williams-Victoria_Azarenka,1,B-DTM,35,1,1,0,0,16,19
20100127-W-Australian_Open-QF-Serena_Williams-Victoria_Azarenka,1,B-DTL,17,6,4,0,2,8,9
20100127-W-Australian_Open-QF-Serena_Williams-Victoria_Azarenka,1,B-IO,17,5,1,3,1,7,10
20100127-W-Australian_Open-QF-Serena_Williams-Victoria_Azarenka,1,S-XC,2,1,0,0,1,1,1
20100127-W-Australian_Open-QF-Serena_Williams-Victoria_Azarenka,1,S-DTM,1,0,0,0,0,0,1
20100127-W-Australian_Open-QF-Serena_Williams-Victoria_Azarenka,1,S-IO,1,0,0,0,0,1,0
20100127-W-Australian_Open-QF-Serena_Williams-Victoria_Azarenka,2,F-XC,45,9,2,4,3,29,16
20100127-W-Australian_Open-QF-Serena_Williams-Victoria_Azarenka,2,F-DTM,21,0,0,0,0,9,12
20100127-W-Australian_Open-QF-Serena_Williams-Victoria_Azarenka,2,F-DTL,39,11,3,4,4,24,15
20100127-W-Australian_Open-QF-Serena_Williams-Victoria_Azarenka,2,F-IO,28,6,2,4,0,16,12
20100127-W-Australian_Open-QF-Serena_Williams-Victoria_Azarenka,2,F-II,1,0,0,0,0,0,1
20100127-W-Australian_Open-QF-Serena_Williams-Victoria_Azarenka,2,B-XC,36,10,1,6,3,17,19
20100127-W-Australian_Open-QF-Serena_Williams-Victoria_Azarenka,2,B-DTM,25,1,0,0,1,12,13
20100127-W-Australian_Open-QF-Serena_Williams-Victoria_Azarenka,2,B-DTL,25,9,3,4,2,14,11
20100127-W-Australian_Open-QF-Serena_Williams-Victoria_Azarenka,2,B-IO,12,5,3,1,1,6,6
20100127-W-Australian_Open-QF-Serena_Williams-Victoria_Azarenka,2,S-XC,1,0,0,0,0,0,1
20100127-W-Australian_Open-QF-Serena_Williams-Victoria_Azarenka,2,S-DTM,5,0,0,0,0,2,3
20100127-W-Australian_Open-QF-Serena_Williams-Victoria_Azarenka,2,S-DTL,2,0,0,0,0,1,1
20100127-W-Australian_Open-QF-Serena_Williams-Victoria_Azarenka,2,S-IO,1,0,0,0,0,1,0
20200928-W-Roland_Garros-R128-Katarina_Zavatska-Kiki_Bertens,1,F-XC,73,7,1,2,4,31,42
20200928-W-Roland_Garros-R128-Katarina_Zavatska-Kiki_Bertens,1,F-DTM,41,4,0,1,3,18,23
20200928-W-Roland_Garros-R128-Katarina_Zavatska-Kiki_Bertens,1,F-DTL,22,2,0,1,1,7,15
20200928-W-Roland_Garros-R128-Katarina_Zavatska-Kiki_Bertens,1,F-IO,16,0,0,0,0,3,13
20200928-W-Roland_Garros-R128-Katarina_Zavatska-Kiki_Bertens,1,F-II,1,0,0,0,0,1,0
20200928-W-Roland_Garros-R128-Katarina_Zavatska-Kiki_Bertens,1,B-XC,112,19,3,5,11,48,64
20200928-W-Roland_Garros-R128-Katarina_Zavatska-Kiki_Bertens,1,B-DTM,35,3,0,1,2,7,28
20200928-W-Roland_Garros-R128-Katarina_Zavatska-Kiki_Bertens,1,B-DTL,7,1,1,0,0,5,2
20200928-W-Roland_Garros-R128-Katarina_Zavatska-Kiki_Bertens,1,B-IO,7,1,1,0,0,5,2
20200928-W-Roland_Garros-R128-Katarina_Zavatska-Kiki_Bertens,1,S-XC,6,0,0,0,0,3,3
20200928-W-Roland_Garros-R128-Katarina_Zavatska-Kiki_Bertens,1,S-DTM,9,0,0,0,0,5,4
20200928-W-Roland_Garros-R128-Katarina_Zavatska-Kiki_Bertens,1,S-DTL,2,0,0,0,0,0,2
20200928-W-Roland_Garros-R128-Katarina_Zavatska-Kiki_Bertens,2,F-XC,95,11,2,4,5,59,36
20200928-W-Roland_Garros-R128-Katarina_Zavatska-Kiki_Bertens,2,F-DTM,27,1,1,0,0,18,9
20200928-W-Roland_Garros-R128-Katarina_Zavatska-Kiki_Bertens,2,F-DTL,9,4,1,1,2,5,4
20200928-W-Roland_Garros-R128-Katarina_Zavatska-Kiki_Bertens,2,F-IO,23,11,4,6,1,16,7
20200928-W-Roland_Garros-R128-Katarina_Zavatska-Kiki_Bertens,2,F-II,2,0,0,0,0,2,0
20200928-W-Roland_Garros-R128-Katarina_Zavatska-Kiki_Bertens,2,B-XC,60,7,0,1,6,35,25
20200928-W-Roland_Garros-R128-Katarina_Zavatska-Kiki_Bertens,2,B-DTM,55,3,0,1,2,34,21
20200928-W-Roland_Garros-R128-Katarina_Zavatska-Kiki_Bertens,2,B-DTL,6,2,0,0,2,2,4
20200928-W-Roland_Garros-R128-Katarina_Zavatska-Kiki_Bertens,2,B-IO,3,2,2,0,0,3,0
20200928-W-Roland_Garros-R128-Katarina_Zavatska-Kiki_Bertens,2,S-XC,24,1,0,0,1,14,10
20200928-W-Roland_Garros-R128-Katarina_Zavatska-Kiki_Bertens,2,S-DTM,14,1,0,0,1,7,7
20200928-W-Roland_Garros-R128-Katarina_Zavatska-Kiki_Bertens,2,S-DTL,4,1,1,0,0,2,2
20200928-W-Roland_Garros-R128-Katarina_Zavatska-Kiki_Bertens,2,S-IO,1,0,0,0,0,0,1
20201010-W-Roland_Garros-F-Iga_Swiatek-Sofia_Kenin,1,F-XC,31,9,5,1,3,19,12
20201010-W-Roland_Garros-F-Iga_Swiatek-Sofia_Kenin,1,F-DTM,17,2,1,0,1,14,3
20201010-W-Roland_Garros-F-Iga_Swiatek-Sofia_Kenin,1,F-DTL,14,5,3,1,1,9,5
20201010-W-Roland_Garros-F-Iga_Swiatek-Sofia_Kenin,1,F-IO,15,2,1,0,1,9,6
20201010-W-Roland_Garros-F-Iga_Swiatek-Sofia_Kenin,1,F-II,1,1,1,0,0,1,0
20201010-W-Roland_Garros-F-Iga_Swiatek-Sofia_Kenin,1,B-XC,27,6,3,0,3,14,13
20201010-W-Roland_Garros-F-Iga_Swiatek-Sofia_Kenin,1,B-DTM,19,3,0,0,3,14,5
20201010-W-Roland_Garros-F-Iga_Swiatek-Sofia_Kenin,1,B-DTL,12,8,4,2,2,9,3
20201010-W-Roland_Garros-F-Iga_Swiatek-Sofia_Kenin,1,B-IO,5,2,0,2,0,5,0
20201010-W-Roland_Garros-F-Iga_Swiatek-Sofia_Kenin,1,S-XC,1,0,0,0,0,1,0
20201010-W-Roland_Garros-F-Iga_Swiatek-Sofia_Kenin,1,S-DTM,2,0,0,0,0,2,0
20201010-W-Roland_Garros-F-Iga_Swiatek-Sofia_Kenin,2,F-XC,39,10,3,2,5,15,24
20201010-W-Roland_Garros-F-Iga_Swiatek-Sofia_Kenin,2,F-DTM,10,0,0,0,0,2,8
20201010-W-Roland_Garros-F-Iga_Swiatek-Sofia_Kenin,2,F-DTL,4,0,0,0,0,1,3
20201010-W-Roland_Garros-F-Iga_Swiatek-Sofia_Kenin,2,F-IO,5,2,0,0,2,1,4
20201010-W-Roland_Garros-F-Iga_Swiatek-Sofia_Kenin,2,B-XC,44,9,0,2,7,16,28
20201010-W-Roland_Garros-F-Iga_Swiatek-Sofia_Kenin,2,B-DTM,11,0,0,0,0,3,8
20201010-W-Roland_Garros-F-Iga_Swiatek-Sofia_Kenin,2,B-DTL,7,1,1,0,0,3,4
20201010-W-Roland_Garros-F-Iga_Swiatek-Sofia_Kenin,2,B-IO,5,2,0,0,2,1,4
20201010-W-Roland_Garros-F-Iga_Swiatek-Sofia_Kenin,2,S-XC,5,0,0,0,0,2,3
20201010-W-Roland_Garros-F-Iga_Swiatek-Sofia_Kenin,2,S-DTM,3,0,0,0,0,1,2
20201010-W-Roland_Garros-F-Iga_Swiatek-Sofia_Kenin,2,S-DTL,1,0,0,0,0,0,1
20201010-W-Roland_Garros-F-Iga_Swiatek-Sofia_Kenin,2,S-IO,1,1,0,1,0,1,0
20200824-W-Cincinnati-R32-Naomi_Osaka-Karolina_Muchova,1,F-XC,39,18,2,10,6,23,16
20200824-W-Cincinnati-R32-Naomi_Osaka-Karolina_Muchova,1,F-DTM,22,2,0,0,2,10,12
20200824-W-Cincinnati-R32-Naomi_Osaka-Karolina_Muchova,1,F-DTL,11,4,2,0,2,6,5
20200824-W-Cincinnati-R32-Naomi_Osaka-Karolina_Muchova,1,F-IO,20,8,1,2,5,7,13
20200824-W-Cincinnati-R32-Naomi_Osaka-Karolina_Muchova,1,B-XC,51,18,6,4,8,31,20
20200824-W-Cincinnati-R32-Naomi_Osaka-Karolina_Muchova,1,B-DTM,19,2,0,0,2,4,15
20200824-W-Cincinnati-R32-Naomi_Osaka-Karolina_Muchova,1,B-DTL,11,5,3,2,0,6,5
20200824-W-Cincinnati-R32-Naomi_Osaka-Karolina_Muchova,1,B-IO,9,4,1,2,1,7,2
20200824-W-Cincinnati-R32-Naomi_Osaka-Karolina_Muchova,1,S-XC,1,0,0,0,0,1,0
20200824-W-Cincinnati-R32-Naomi_Osaka-Karolina_Muchova,1,S-IO,1,0,0,0,0,0,1
20200824-W-Cincinnati-R32-Naomi_Osaka-Karolina_Muchova,2,F-XC,22,6,1,3,2,12,10
20200824-W-Cincinnati-R32-Naomi_Osaka-Karolina_Muchova,2,F-DTM,22,4,0,1,3,10,12
20200824-W-Cincinnati-R32-Naomi_Osaka-Karolina_Muchova,2,F-DTL,12,5,3,0,2,7,5
20200824-W-Cincinnati-R32-Naomi_Osaka-Karolina_Muchova,2,F-IO,27,15,7,4,4,18,9
20200824-W-Cincinnati-R32-Naomi_Osaka-Karolina_Muchova,2,F-II,2,1,1,0,0,1,1
20200824-W-Cincinnati-R32-Naomi_Osaka-Karolina_Muchova,2,B-XC,19,6,1,2,3,11,8
20200824-W-Cincinnati-R32-Naomi_Osaka-Karolina_Muchova,2,B-DTM,26,0,0,0,0,11,15
20200824-W-Cincinnati-R32-Naomi_Osaka-Karolina_Muchova,2,B-DTL,10,3,0,0,3,3,7
20200824-W-Cincinnati-R32-Naomi_Osaka-Karolina_Muchova,2,S-XC,12,2,0,0,2,4,8
20200824-W-Cincinnati-R32-Naomi_Osaka-Karolina_Muchova,2,S-DTM,11,0,0,0,0,8,3
20200824-W-Cincinnati-R32-Naomi_Osaka-Karolina_Muchova,2,S-DTL,9,3,0,1,2,3,6
20200824-W-Cincinnati-R32-Naomi_Osaka-Karolina_Muchova,2,S-IO,1,0,0,0,0,1,0
20200928-W-Roland_Garros-R128-Arantxa_Rus-Clara_Burel,1,F-XC,126,15,4,2,9,53,73
20200928-W-Roland_Garros-R128-Arantxa_Rus-Clara_Burel,1,F-DTM,97,3,0,0,3,46,51
20200928-W-Roland_Garros-R128-Arantxa_Rus-Clara_Burel,1,F-DTL,15,3,0,1,2,6,9
20200928-W-Roland_Garros-R128-Arantxa_Rus-Clara_Burel,1,F-IO,65,17,5,7,5,34,31
20200928-W-Roland_Garros-R128-Arantxa_Rus-Clara_Burel,1,F-II,17,9,2,3,4,9,8
20200928-W-Roland_Garros-R128-Arantxa_Rus-Clara_Burel,1,B-XC,74,9,1,1,7,30,44
20200928-W-Roland_Garros-R128-Arantxa_Rus-Clara_Burel,1,B-DTM,110,7,0,0,7,46,64
20200928-W-Roland_Garros-R128-Arantxa_Rus-Clara_Burel,1,B-DTL,27,7,2,0,5,11,16
20200928-W-Roland_Garros-R128-Arantxa_Rus-Clara_Burel,1,B-IO,21,5,0,2,3,7,14
20200928-W-Roland_Garros-R128-Arantxa_Rus-Clara_Burel,1,S-XC,5,1,1,0,0,1,4
20200928-W-Roland_Garros-R128-Arantxa_Rus-Clara_Burel,1,S-DTM,11,1,0,0,1,5,6
20200928-W-Roland_Garros-R128-Arantxa_Rus-Clara_Burel,1,S-DTL,3,1,0,0,1,0,3
20200928-W-Roland_Garros-R128-Arantxa_Rus-Clara_Burel,1,S-IO,1,0,0,0,0,0,1
20200928-W-Roland_Garros-R128-Arantxa_Rus-Clara_Burel,2,F-XC,144,11,4,1,6,75,69
20200928-W-Roland_Garros-R128-Arantxa_Rus-Clara_Burel,2,F-DTM,80,3,0,0,3,52,28
20200928-W-Roland_Garros-R128-Arantxa_Rus-Clara_Burel,2,F-DTL,27,14,2,1,11,9,18
20200928-W-Roland_Garros-R128-Arantxa_Rus-Clara_Burel,2,F-IO,53,32,11,5,16,25,28
20200928-W-Roland_Garros-R128-Arantxa_Rus-Clara_Burel,2,F-II,3,2,0,0,2,1,2
20200928-W-Roland_Garros-R128-Arantxa_Rus-Clara_Burel,2,B-XC,68,16,6,7,3,44,24
20200928-W-Roland_Garros-R128-Arantxa_Rus-Clara_Burel,2,B-DTM,84,3,0,0,3,53,31
20200928-W-Roland_Garros-R128-Arantxa_Rus-Clara_Burel,2,B-DTL,18,2,0,1,1,9,9
20200928-W-Roland_Garros-R128-Arantxa_Rus-Clara_Burel,2,B-IO,17,1,0,0,1,10,7
20200928-W-Roland_Garros-R128-Arantxa_Rus-Clara_Burel,2,S-XC,10,1,1,0,0,6,4
20200928-W-Roland_Garros-R128-Arantxa_Rus-Clara_Burel,2,S-DTM,23,1,0,0,1,12,11
20200928-W-Roland_Garros-R128-Arantxa_Rus-Clara_Burel,2,S-DTL,6,1,1,0,0,3,3
20200928-W-Roland_Garros-R128-Arantxa_Rus-Clara_Burel,2,S-IO,3,0,0,0,0,1,2
20200928-W-Roland_Garros-R128-Kaja_Juvan-Angelique_Kerber,1,F-XC,38,7,2,1,4,20,18
20200928-W-Roland_Garros-R128-Kaja_Juvan-Angelique_Kerber,1,F-DTM,12,0,0,0,0,7,5
20200928-W-Roland_Garros-R128-Kaja_Juvan-Angelique_Kerber,1,F-DTL,8,6,2,0,4,4,4
20200928-W-Roland_Garros-R128-Kaja_Juvan-Angelique_Kerber,1,F-IO,9,7,2,2,3,5,4
20200928-W-Roland_Garros-R128-Kaja_Juvan-Angelique_Kerber,1,F-II,1,0,0,0,0,1,0
20200928-W-Roland_Garros-R128-Kaja_Juvan-Angelique_Kerber,1,B-XC,19,6,3,0,3,11,8
20200928-W-Roland_Garros-R128-Kaja_Juvan-Angelique_Kerber,1,B-DTM,24,2,0,0,2,14,10
20200928-W-Roland_Garros-R128-Kaja_Juvan-Angelique_Kerber,1,B-DTL,7,4,2,1,1,5,2
20200928-W-Roland_Garros-R128-Kaja_Juvan-Angelique_Kerber,1,B-IO,6,1,1,0,0,4,2
20200928-W-Roland_Garros-R128-Kaja_Juvan-Angelique_Kerber,1,S-XC,5,1,1,0,0,2,3
20200928-W-Roland_Garros-R128-Kaja_Juvan-Angelique_Kerber,1,S-DTM,17,1,0,0,1,8,9
20200928-W-Roland_Garros-R128-Kaja_Juvan-Angelique_Kerber,1,S-DTL,3,0,0,0,0,2,1
20200928-W-Roland_Garros-R128-Kaja_Juvan-Angelique_Kerber,1,S-IO,1,0,0,0,0,0,1
20200928-W-Roland_Garros-R128-Kaja_Juvan-Angelique_Kerber,2,F-XC,42,9,2,1,6,17,25
20200928-W-Roland_Garros-R128-Kaja_Juvan-Angelique_Kerber,2,F-DTM,13,1,0,0,1,6,7
20200928-W-Roland_Garros-R128-Kaja_Juvan-Angelique_Kerber,2,F-DTL,9,3,1,2,0,6,3
20200928-W-Roland_Garros-R128-Kaja_Juvan-Angelique_Kerber,2,F-IO,22,6,2,1,3,12,10
20200928-W-Roland_Garros-R128-Kaja_Juvan-Angelique_Kerber,2,F-II,2,0,0,0,0,1,1
20200928-W-Roland_Garros-R128-Kaja_Juvan-Angelique_Kerber,2,B-XC,31,8,1,1,6,14,17
20200928-W-Roland_Garros-R128-Kaja_Juvan-Angelique_Kerber,2,B-DTM,19,2,0,0,2,8,11
20200928-W-Roland_Garros-R128-Kaja_Juvan-Angelique_Kerber,2,B-DTL,5,2,1,1,0,3,2
20200928-W-Roland_Garros-R128-Kaja_Juvan-Angelique_Kerber,2,B-IO,7,2,1,0,1,4,3
20200928-W-Roland_Garros-R128-Kaja_Juvan-Angelique_Kerber,2,S-XC,4,2,1,0,1,2,2
20200928-W-Roland_Garros-R128-Kaja_Juvan-Angelique_Kerber,2,S-DTM,4,0,0,0,0,1,3
20200928-W-Roland_Garros-R128-Kaja_Juvan-Angelique_Kerber,2,S-DTL,2,1,0,0,1,1,1
20200928-W-Roland_Garros-R128-Kaja_Juvan-Angelique_Kerber,2,S-IO,2,0,0,0,0,0,2
20190309-W-Indian_Wells-R64-Amanda_Anisimova-Elise_Mertens,1,F-XC,29,9,1,4,4,10,19
20190309-W-Indian_Wells-R64-Amanda_Anisimova-Elise_Mertens,1,F-DTM,13,3,0,0,3,2,11
20190309-W-Indian_Wells-R64-Amanda_Anisimova-Elise_Mertens,1,F-DTL,10,4,2,1,1,6,4
20190309-W-Indian_Wells-R64-Amanda_Anisimova-Elise_Mertens,1,F-IO,18,8,4,3,1,14,4
20190309-W-Indian_Wells-R64-Amanda_Anisimova-Elise_Mertens,1,F-II,2,0,0,0,0,2,0
20190309-W-Indian_Wells-R64-Amanda_Anisimova-Elise_Mertens,1,B-XC,31,5,1,2,2,12,19
20190309-W-Indian_Wells-R64-Amanda_Anisimova-Elise_Mertens,1,B-DTM,13,0,0,0,0,4,9
20190309-W-Indian_Wells-R64-Amanda_Anisimova-Elise_Mertens,1,B-DTL,8,2,1,0,1,3,5
20190309-W-Indian_Wells-R64-Amanda_Anisimova-Elise_Mertens,1,B-IO,6,1,0,0,1,3,3
20190309-W-Indian_Wells-R64-Amanda_Anisimova-Elise_Mertens,1,S-DTM,1,0,0,0,0,0,1
20190309-W-Indian_Wells-R64-Amanda_Anisimova-Elise_Mertens,1,S-DTL,1,0,0,0,0,0,1
20190309-W-Indian_Wells-R64-Amanda_Anisimova-Elise_Mertens,2,F-XC,16,3,0,3,0,12,4
20190309-W-Indian_Wells-R64-Amanda_Anisimova-Elise_Mertens,2,F-DTM,19,0,0,0,0,10,9
20190309-W-Indian_Wells-R64-Amanda_Anisimova-Elise_Mertens,2,F-DTL,10,3,1,0,1,6,4
20190309-W-Indian_Wells-R64-Amanda_Anisimova-Elise_Mertens,2,F-IO,15,4,2,1,1,13,2
20190309-W-Indian_Wells-R64-Amanda_Anisimova-Elise_Mertens,2,B-XC,21,3,0,2,1,10,11
20190309-W-Indian_Wells-R64-Amanda_Anisimova-Elise_Mertens,2,B-DTM,28,4,0,3,1,17,11
20190309-W-Indian_Wells-R64-Amanda_Anisimova-Elise_Mertens,2,B-DTL,8,4,2,1,1,6,2
20190309-W-Indian_Wells-R64-Amanda_Anisimova-Elise_Mertens,2,B-IO,3,0,0,0,0,2,1
20190309-W-Indian_Wells-R64-Amanda_Anisimova-Elise_Mertens,2,S-XC,4,0,0,0,0,2,2
20190309-W-Indian_Wells-R64-Amanda_Anisimova-Elise_Mertens,2,S-DTM,4,0,0,0,0,3,1
20200918-W-Rome-R16-Karolina_Pliskova-Anna_Blinkova,1,F-XC,22,9,3,5,1,17,5
20200918-W-Rome-R16-Karolina_Pliskova-Anna_Blinkova,1,F-DTM,6,1,1,0,0,4,2
20200918-W-Rome-R16-Karolina_Pliskova-Anna_Blinkova,1,F-DTL,4,2,1,0,1,3,1
20200918-W-Rome-R16-Karolina_Pliskova-Anna_Blinkova,1,F-IO,12,5,2,0,3,7,5
20200918-W-Rome-R16-Karolina_Pliskova-Anna_Blinkova,1,B-XC,15,3,1,2,0,11,4
20200918-W-Rome-R16-Karolina_Pliskova-Anna_Blinkova,1,B-DTM,10,2,0,0,2,2,8
20200918-W-Rome-R16-Karolina_Pliskova-Anna_Blinkova,1,B-DTL,11,7,5,2,0,11,0
20200918-W-Rome-R16-Karolina_Pliskova-Anna_Blinkova,1,B-IO,6,4,2,0,2,3,3
20200918-W-Rome-R16-Karolina_Pliskova-Anna_Blinkova,1,S-XC,1,0,0,0,0,0,1
20200918-W-Rome-R16-Karolina_Pliskova-Anna_Blinkova,1,S-DTM,3,0,0,0,0,1,2
20200918-W-Rome-R16-Karolina_Pliskova-Anna_Blinkova,2,F-XC,21,9,2,3,4,8,13
20200918-W-Rome-R16-Karolina_Pliskova-Anna_Blinkova,2,F-DTM,10,0,0,0,0,4,6
20200918-W-Rome-R16-Karolina_Pliskova-Anna_Blinkova,2,F-DTL,8,4,2,1,1,5,3
20200918-W-Rome-R16-Karolina_Pliskova-Anna_Blinkova,2,F-IO,4,1,1,0,0,3,1
20200918-W-Rome-R16-Karolina_Pliskova-Anna_Blinkova,2,B-XC,26,9,2,3,4,9,17
20200918-W-Rome-R16-Karolina_Pliskova-Anna_Blinkova,2,B-DTM,10,1,0,1,0,6,4
20200918-W-Rome-R16-Karolina_Pliskova-Anna_Blinkova,2,B-DTL,3,2,1,0,1,1,2
20200918-W-Rome-R16-Karolina_Pliskova-Anna_Blinkova,2,B-IO,3,2,2,0,0,3,0
20200918-W-Rome-R16-Karolina_Pliskova-Anna_Blinkova,2,S-DTM,2,0,0,0,0,0,2
20190918-W-Guangzhou-R16-Aleksandra_Krunic-Anna_Blinkova,1,F-XC,26,16,3,5,8,13,13
20190918-W-Guangzhou-R16-Aleksandra_Krunic-Anna_Blinkova,1,F-DTM,10,2,0,1,1,5,5
20190918-W-Guangzhou-R16-Aleksandra_Krunic-Anna_Blinkova,1,F-DTL,10,3,2,0,1,5,5
20190918-W-Guangzhou-R16-Aleksandra_Krunic-Anna_Blinkova,1,F-IO,8,4,2,0,2,5,3
20190918-W-Guangzhou-R16-Aleksandra_Krunic-Anna_Blinkova,1,F-II,1,0,0,0,0,1,0
20190918-W-Guangzhou-R16-Aleksandra_Krunic-Anna_Blinkova,1,B-XC,20,8,1,1,6,7,13
20190918-W-Guangzhou-R16-Aleksandra_Krunic-Anna_Blinkova,1,B-DTM,17,5,0,3,2,7,10
20190918-W-Guangzhou-R16-Aleksandra_Krunic-Anna_Blinkova,1,B-DTL,4,1,0,0,1,0,4
20190918-W-Guangzhou-R16-Aleksandra_Krunic-Anna_Blinkova,1,B-IO,3,1,1,0,0,1,2
20190918-W-Guangzhou-R16-Aleksandra_Krunic-Anna_Blinkova,1,S-XC,5,1,0,0,1,1,4
20190918-W-Guangzhou-R16-Aleksandra_Krunic-Anna_Blinkova,1,S-DTM,2,0,0,0,0,0,2
20190918-W-Guangzhou-R16-Aleksandra_Krunic-Anna_Blinkova,1,S-DTL,3,2,0,1,1,1,2
20190918-W-Guangzhou-R16-Aleksandra_Krunic-Anna_Blinkova,2,F-XC,17,9,3,4,2,12,5
20190918-W-Guangzhou-R16-Aleksandra_Krunic-Anna_Blinkova,2,F-DTM,10,0,0,0,0,5,5
20190918-W-Guangzhou-R16-Aleksandra_Krunic-Anna_Blinkova,2,F-DTL,5,3,1,2,0,5,0
20190918-W-Guangzhou-R16-Aleksandra_Krunic-Anna_Blinkova,2,F-IO,7,1,1,0,0,4,3
20190918-W-Guangzhou-R16-Aleksandra_Krunic-Anna_Blinkova,2,B-XC,25,6,1,2,3,19,6
20190918-W-Guangzhou-R16-Aleksandra_Krunic-Anna_Blinkova,2,B-DTM,21,1,0,1,0,9,12
20190918-W-Guangzhou-R16-Aleksandra_Krunic-Anna_Blinkova,2,B-DTL,4,3,0,0,2,2,2
20190918-W-Guangzhou-R16-Aleksandra_Krunic-Anna_Blinkova,2,B-IO,3,0,0,0,0,2,1
20190918-W-Guangzhou-R16-Aleksandra_Krunic-Anna_Blinkova,2,S-XC,1,0,0,0,0,0,1
20190918-W-Guangzhou-R16-Aleksandra_Krunic-Anna_Blinkova,2,S-DTM,2,0,0,0,0,0,2
20190918-W-Guangzhou-R16-Aleksandra_Krunic-Anna_Blinkova,2,S-DTL,1,1,0,1,0,1,0
20190918-W-Guangzhou-R16-Aleksandra_Krunic-Anna_Blinkova,2,S-IO,1,0,0,0,0,0,1
20200831-W-US_Open-R128-Jennifer_Brady-Anna_Blinkova,1,F-XC,27,10,3,5,2,14,13
20200831-W-US_Open-R128-Jennifer_Brady-Anna_Blinkova,1,F-DTM,19,0,0,0,0,5,14
20200831-W-US_Open-R128-Jennifer_Brady-Anna_Blinkova,1,F-DTL,5,3,2,0,1,3,2
20200831-W-US_Open-R128-Jennifer_Brady-Anna_Blinkova,1,F-IO,16,7,4,2,1,12,4
20200831-W-US_Open-R128-Jennifer_Brady-Anna_Blinkova,1,F-II,3,3,2,0,1,2,1
20200831-W-US_Open-R128-Jennifer_Brady-Anna_Blinkova,1,B-XC,27,5,1,2,2,6,21
20200831-W-US_Open-R128-Jennifer_Brady-Anna_Blinkova,1,B-DTM,24,1,0,0,1,8,16
20200831-W-US_Open-R128-Jennifer_Brady-Anna_Blinkova,1,B-DTL,11,3,1,1,1,4,7
20200831-W-US_Open-R128-Jennifer_Brady-Anna_Blinkova,1,B-IO,2,0,0,0,0,0,2
20200831-W-US_Open-R128-Jennifer_Brady-Anna_Blinkova,1,S-XC,1,0,0,0,0,0,1
20200831-W-US_Open-R128-Jennifer_Brady-Anna_Blinkova,1,S-DTM,1,0,0,0,0,0,1
20200831-W-US_Open-R128-Jennifer_Brady-Anna_Blinkova,1,S-DTL,1,0,0,0,0,0,1
20200831-W-US_Open-R128-Jennifer_Brady-Anna_Blinkova,2,F-XC,34,15,3,7,5,22,12
20200831-W-US_Open-R128-Jennifer_Brady-Anna_Blinkova,2,F-DTM,16,1,0,0,1,6,10
20200831-W-US_Open-R128-Jennifer_Brady-Anna_Blinkova,2,F-DTL,5,1,0,0,1,4,1
20200831-W-US_Open-R128-Jennifer_Brady-Anna_Blinkova,2,F-IO,16,5,4,0,1,13,3
20200831-W-US_Open-R128-Jennifer_Brady-Anna_Blinkova,2,B-XC,39,9,5,3,1,32,7
20200831-W-US_Open-R128-Jennifer_Brady-Anna_Blinkova,2,B-DTM,23,2,0,0,2,11,12
20200831-W-US_Open-R128-Jennifer_Brady-Anna_Blinkova,2,B-DTL,2,1,0,1,0,2,0
20200831-W-US_Open-R128-Jennifer_Brady-Anna_Blinkova,2,B-IO,4,3,2,1,0,4,0
20200831-W-US_Open-R128-Jennifer_Brady-Anna_Blinkova,2,S-XC,1,0,0,0,0,1,0
20200831-W-US_Open-R128-Jennifer_Brady-Anna_Blinkova,2,S-DTM,2,0,0,0,0,1,1
20200831-W-US_Open-R128-Jennifer_Brady-Anna_Blinkova,2,S-IO,1,1,0,0,1,0,1
20200927-W-Roland_Garros-R128-Anna_Blinkova-Astra_Sharma,1,F-XC,66,20,5,5,10,29,37
20200927-W-Roland_Garros-R128-Anna_Blinkova-Astra_Sharma,1,F-DTM,25,1,0,0,1,3,22
20200927-W-Roland_Garros-R128-Anna_Blinkova-Astra_Sharma,1,F-DTL,22,5,0,1,4,10,12
20200927-W-Roland_Garros-R128-Anna_Blinkova-Astra_Sharma,1,F-IO,38,9,2,3,4,17,21
20200927-W-Roland_Garros-R128-Anna_Blinkova-Astra_Sharma,1,F-II,1,1,1,0,0,1,0
20200927-W-Roland_Garros-R128-Anna_Blinkova-Astra_Sharma,1,B-XC,67,12,2,3,7,22,45
20200927-W-Roland_Garros-R128-Anna_Blinkova-Astra_Sharma,1,B-DTM,24,3,0,3,0,13,11
20200927-W-Roland_Garros-R128-Anna_Blinkova-Astra_Sharma,1,B-DTL,14,10,6,1,3,10,4
20200927-W-Roland_Garros-R128-Anna_Blinkova-Astra_Sharma,1,B-IO,4,1,0,1,0,3,1
20200927-W-Roland_Garros-R128-Anna_Blinkova-Astra_Sharma,1,S-XC,2,0,0,0,0,1,1
20200927-W-Roland_Garros-R128-Anna_Blinkova-Astra_Sharma,1,S-DTM,4,0,0,0,0,3,1
20200927-W-Roland_Garros-R128-Anna_Blinkova-Astra_Sharma,1,S-DTL,2,0,0,0,0,0,2
20200927-W-Roland_Garros-R128-Anna_Blinkova-Astra_Sharma,2,F-XC,53,12,3,5,4,34,19
20200927-W-Roland_Garros-R128-Anna_Blinkova-Astra_Sharma,2,F-DTM,30,3,0,1,2,16,14
20200927-W-Roland_Garros-R128-Anna_Blinkova-Astra_Sharma,2,F-DTL,26,12,7,3,2,17,9
20200927-W-Roland_Garros-R128-Anna_Blinkova-Astra_Sharma,2,F-IO,30,13,8,2,3,18,12
20200927-W-Roland_Garros-R128-Anna_Blinkova-Astra_Sharma,2,F-II,6,3,1,0,2,2,4
20200927-W-Roland_Garros-R128-Anna_Blinkova-Astra_Sharma,2,B-XC,23,4,0,1,3,14,9
20200927-W-Roland_Garros-R128-Anna_Blinkova-Astra_Sharma,2,B-DTM,20,2,0,1,1,11,9
20200927-W-Roland_Garros-R128-Anna_Blinkova-Astra_Sharma,2,B-DTL,11,4,2,0,2,7,4
20200927-W-Roland_Garros-R128-Anna_Blinkova-Astra_Sharma,2,B-IO,1,0,0,0,0,1,0
20200927-W-Roland_Garros-R128-Anna_Blinkova-Astra_Sharma,2,S-XC,20,1,0,0,1,13,7
20200927-W-Roland_Garros-R128-Anna_Blinkova-Astra_Sharma,2,S-DTM,30,2,0,0,2,17,13
20200927-W-Roland_Garros-R128-Anna_Blinkova-Astra_Sharma,2,S-DTL,11,2,1,1,0,10,1
20200927-W-Roland_Garros-R128-Anna_Blinkova-Astra_Sharma,2,S-IO,2,0,0,0,0,1,1
20200812-W-Lexington-R16-Anna_Blinkova-Marie_Bouzkova,1,F-XC,51,11,5,2,4,27,24
20200812-W-Lexington-R16-Anna_Blinkova-Marie_Bouzkova,1,F-DTM,14,2,0,2,0,6,8
20200812-W-Lexington-R16-Anna_Blinkova-Marie_Bouzkova,1,F-DTL,4,2,2,0,0,2,2
20200812-W-Lexington-R16-Anna_Blinkova-Marie_Bouzkova,1,F-IO,8,5,2,1,2,5,3
20200812-W-Lexington-R16-Anna_Blinkova-Marie_Bouzkova,1,F-II,1,1,1,0,0,1,0
20200812-W-Lexington-R16-Anna_Blinkova-Marie_Bouzkova,1,B-XC,59,6,0,2,4,19,40
20200812-W-Lexington-R16-Anna_Blinkova-Marie_Bouzkova,1,B-DTM,12,0,0,0,0,5,7
20200812-W-Lexington-R16-Anna_Blinkova-Marie_Bouzkova,1,B-DTL,4,3,1,1,1,3,1
20200812-W-Lexington-R16-Anna_Blinkova-Marie_Bouzkova,1,B-IO,1,0,0,0,0,1,0
20200812-W-Lexington-R16-Anna_Blinkova-Marie_Bouzkova,1,S-XC,5,1,0,1,0,2,3
20200812-W-Lexington-R16-Anna_Blinkova-Marie_Bouzkova,1,S-DTM,3,1,0,0,1,1,2
20200812-W-Lexington-R16-Anna_Blinkova-Marie_Bouzkova,2,F-XC,37,10,3,4,3,21,16
20200812-W-Lexington-R16-Anna_Blinkova-Marie_Bouzkova,2,F-DTM,16,1,0,0,1,6,10
20200812-W-Lexington-R16-Anna_Blinkova-Marie_Bouzkova,2,F-DTL,13,5,1,2,2,7,6
20200812-W-Lexington-R16-Anna_Blinkova-Marie_Bouzkova,2,F-IO,9,2,1,0,1,7,2
20200812-W-Lexington-R16-Anna_Blinkova-Marie_Bouzkova,2,F-II,1,0,0,0,0,1,0
20200812-W-Lexington-R16-Anna_Blinkova-Marie_Bouzkova,2,B-XC,28,1,0,0,1,19,9
20200812-W-Lexington-R16-Anna_Blinkova-Marie_Bouzkova,2,B-DTM,17,1,0,1,0,10,7
20200812-W-Lexington-R16-Anna_Blinkova-Marie_Bouzkova,2,B-DTL,15,7,2,4,1,12,3
20200812-W-Lexington-R16-Anna_Blinkova-Marie_Bouzkova,2,B-IO,5,1,0,1,0,2,3
20200812-W-Lexington-R16-Anna_Blinkova-Marie_Bouzkova,2,S-XC,10,0,0,0,0,6,4
20200812-W-Lexington-R16-Anna_Blinkova-Marie_Bouzkova,2,S-DTM,10,1,0,0,1,5,5
20200812-W-Lexington-R16-Anna_Blinkova-Marie_Bouzkova,2,S-DTL,4,0,0,0,0,3,1
20000220-W-Hanover-F-Serena_Williams-Denisa_Chladkova,1,F-XC,8,4,1,2,1,7,1
20000220-W-Hanover-F-Serena_Williams-Denisa_Chladkova,1,F-DTM,5,0,0,0,0,2,3
20000220-W-Hanover-F-Serena_Williams-Denisa_Chladkova,1,F-DTL,5,3,1,1,1,4,1
20000220-W-Hanover-F-Serena_Williams-Denisa_Chladkova,1,F-IO,1,1,0,0,1,0,1
20000220-W-Hanover-F-Serena_Williams-Denisa_Chladkova,1,B-XC,10,2,0,1,1,7,3
20000220-W-Hanover-F-Serena_Williams-Denisa_Chladkova,1,B-DTM,9,0,0,0,0,5,4
20000220-W-Hanover-F-Serena_Williams-Denisa_Chladkova,1,B-DTL,4,2,1,1,0,4,0
20000220-W-Hanover-F-Serena_Williams-Denisa_Chladkova,1,B-IO,4,3,0,1,2,1,3
20000220-W-Hanover-F-Serena_Williams-Denisa_Chladkova,1,S-DTM,1,0,0,0,0,1,0
20000220-W-Hanover-F-Serena_Williams-Denisa_Chladkova,1,S-DTL,1,0,0,0,0,0,1
20000220-W-Hanover-F-Serena_Williams-Denisa_Chladkova,2,F-XC,22,12,4,1,7,7,15
20000220-W-Hanover-F-Serena_Williams-Denisa_Chladkova,2,F-DTM,8,3,0,0,3,1,7
20000220-W-Hanover-F-Serena_Williams-Denisa_Chladkova,2,F-DTL,2,1,0,0,1,1,1
20000220-W-Hanover-F-Serena_Williams-Denisa_Chladkova,2,F-IO,6,2,1,0,1,4,2
20000220-W-Hanover-F-Serena_Williams-Denisa_Chladkova,2,F-II,2,1,0,1,0,2,0
20000220-W-Hanover-F-Serena_Williams-Denisa_Chladkova,2,B-XC,13,3,0,0,3,2,11
20000220-W-Hanover-F-Serena_Williams-Denisa_Chladkova,2,B-DTM,5,0,0,0,0,3,2
20000220-W-Hanover-F-Serena_Williams-Denisa_Chladkova,2,B-DTL,1,1,0,0,1,0,1
20000220-W-Hanover-F-Serena_Williams-Denisa_Chladkova,2,S-XC,1,0,0,0,0,1,0
19960803-W-Olympics-F-Lindsay_Davenport-Arantxa_Sanchez_Vicario,1,F-XC,74,24,7,8,9,44,30
19960803-W-Olympics-F-Lindsay_Davenport-Arantxa_Sanchez_Vicario,1,F-DTM,7,0,0,0,0,6,1
19960803-W-Olympics-F-Lindsay_Davenport-Arantxa_Sanchez_Vicario,1,F-DTL,10,5,1,0,4,5,5
19960803-W-Olympics-F-Lindsay_Davenport-Arantxa_Sanchez_Vicario,1,F-IO,13,8,2,3,3,9,4
19960803-W-Olympics-F-Lindsay_Davenport-Arantxa_Sanchez_Vicario,1,F-II,2,1,0,0,1,0,2
19960803-W-Olympics-F-Lindsay_Davenport-Arantxa_Sanchez_Vicario,1,B-XC,54,12,2,6,4,29,25
19960803-W-Olympics-F-Lindsay_Davenport-Arantxa_Sanchez_Vicario,1,B-DTM,17,2,0,0,2,7,10
19960803-W-Olympics-F-Lindsay_Davenport-Arantxa_Sanchez_Vicario,1,B-DTL,9,4,1,0,3,2,7
19960803-W-Olympics-F-Lindsay_Davenport-Arantxa_Sanchez_Vicario,1,B-IO,5,1,1,0,0,3,2
19960803-W-Olympics-F-Lindsay_Davenport-Arantxa_Sanchez_Vicario,1,S-DTL,1,0,0,0,0,1,0
19960803-W-Olympics-F-Lindsay_Davenport-Arantxa_Sanchez_Vicario,2,F-XC,38,8,4,1,3,16,22
19960803-W-Olympics-F-Lindsay_Davenport-Arantxa_Sanchez_Vicario,2,F-DTM,20,3,0,0,3,7,13
19960803-W-Olympics-F-Lindsay_Davenport-Arantxa_Sanchez_Vicario,2,F-DTL,12,4,2,1,1,7,5
19960803-W-Olympics-F-Lindsay_Davenport-Arantxa_Sanchez_Vicario,2,F-IO,5,2,1,0,1,3,2
19960803-W-Olympics-F-Lindsay_Davenport-Arantxa_Sanchez_Vicario,2,B-XC,34,3,2,0,1,20,14
19960803-W-Olympics-F-Lindsay_Davenport-Arantxa_Sanchez_Vicario,2,B-DTM,21,3,0,0,3,9,12
19960803-W-Olympics-F-Lindsay_Davenport-Arantxa_Sanchez_Vicario,2,B-DTL,11,6,2,1,3,7,4
19960803-W-Olympics-F-Lindsay_Davenport-Arantxa_Sanchez_Vicario,2,B-IO,5,0,0,0,0,0,5
19960803-W-Olympics-F-Lindsay_Davenport-Arantxa_Sanchez_Vicario,2,S-XC,8,0,0,0,0,4,4
19960803-W-Olympics-F-Lindsay_Davenport-Arantxa_Sanchez_Vicario,2,S-DTM,4,0,0,0,0,1,3
19960803-W-Olympics-F-Lindsay_Davenport-Arantxa_Sanchez_Vicario,2,S-DTL,3,1,1,0,0,2,1
19960803-W-Olympics-F-Lindsay_Davenport-Arantxa_Sanchez_Vicario,2,S-IO,4,1,0,0,1,1,3
19940408-W-Amelia_Island-QF-Mary_Pierce-Gabriela_Sabatini,1,F-XC,26,9,2,1,6,13,13
19940408-W-Amelia_Island-QF-Mary_Pierce-Gabriela_Sabatini,1,F-DTM,3,0,0,0,0,1,2
19940408-W-Amelia_Island-QF-Mary_Pierce-Gabriela_Sabatini,1,F-DTL,9,1,0,0,1,2,7
19940408-W-Amelia_Island-QF-Mary_Pierce-Gabriela_Sabatini,1,F-IO,15,5,2,0,3,7,8
19940408-W-Amelia_Island-QF-Mary_Pierce-Gabriela_Sabatini,1,B-XC,64,12,3,4,5,30,34
19940408-W-Amelia_Island-QF-Mary_Pierce-Gabriela_Sabatini,1,B-DTM,9,1,0,0,1,2,7
19940408-W-Amelia_Island-QF-Mary_Pierce-Gabriela_Sabatini,1,B-DTL,31,10,3,3,4,19,12
19940408-W-Amelia_Island-QF-Mary_Pierce-Gabriela_Sabatini,1,B-IO,8,1,0,0,1,0,8
19940408-W-Amelia_Island-QF-Mary_Pierce-Gabriela_Sabatini,1,S-XC,1,0,0,0,0,0,1
19940408-W-Amelia_Island-QF-Mary_Pierce-Gabriela_Sabatini,1,S-DTM,1,0,0,0,0,0,1
19940408-W-Amelia_Island-QF-Mary_Pierce-Gabriela_Sabatini,2,F-XC,29,6,5,1,0,21,8
19940408-W-Amelia_Island-QF-Mary_Pierce-Gabriela_Sabatini,2,F-DTM,12,0,0,0,0,8,4
19940408-W-Amelia_Island-QF-Mary_Pierce-Gabriela_Sabatini,2,F-DTL,21,3,2,0,1,9,12
19940408-W-Amelia_Island-QF-Mary_Pierce-Gabriela_Sabatini,2,F-IO,14,4,0,1,3,8,6
19940408-W-Amelia_Island-QF-Mary_Pierce-Gabriela_Sabatini,2,F-II,1,0,0,0,0,1,0
19940408-W-Amelia_Island-QF-Mary_Pierce-Gabriela_Sabatini,2,B-XC,11,2,1,1,0,5,6
19940408-W-Amelia_Island-QF-Mary_Pierce-Gabriela_Sabatini,2,B-DTM,7,0,0,0,0,5,2
19940408-W-Amelia_Island-QF-Mary_Pierce-Gabriela_Sabatini,2,B-DTL,3,2,1,1,0,2,1
19940408-W-Amelia_Island-QF-Mary_Pierce-Gabriela_Sabatini,2,S-XC,48,3,0,1,2,28,20
19940408-W-Amelia_Island-QF-Mary_Pierce-Gabriela_Sabatini,2,S-DTM,5,0,0,0,0,4,1
19940408-W-Amelia_Island-QF-Mary_Pierce-Gabriela_Sabatini,2,S-DTL,4,1,0,1,0,3,1
19981005-W-Filderstadt-R32-Venus_Williams-Silvia_Farina_Elia,1,F-XC,46,10,3,3,4,27,19
19981005-W-Filderstadt-R32-Venus_Williams-Silvia_Farina_Elia,1,F-DTM,29,3,1,1,1,14,15
19981005-W-Filderstadt-R32-Venus_Williams-Silvia_Farina_Elia,1,F-DTL,35,8,2,1,5,19,16
19981005-W-Filderstadt-R32-Venus_Williams-Silvia_Farina_Elia,1,F-IO,22,5,2,2,1,15,7
19981005-W-Filderstadt-R32-Venus_Williams-Silvia_Farina_Elia,1,B-XC,57,10,3,4,3,30,27
19981005-W-Filderstadt-R32-Venus_Williams-Silvia_Farina_Elia,1,B-DTM,34,0,0,0,0,19,15
19981005-W-Filderstadt-R32-Venus_Williams-Silvia_Farina_Elia,1,B-DTL,16,9,5,2,2,12,4
19981005-W-Filderstadt-R32-Venus_Williams-Silvia_Farina_Elia,1,B-IO,8,4,1,1,2,6,2
19981005-W-Filderstadt-R32-Venus_Williams-Silvia_Farina_Elia,1,S-XC,3,1,0,1,0,3,0
19981005-W-Filderstadt-R32-Venus_Williams-Silvia_Farina_Elia,1,S-DTM,2,0,0,0,0,0,2
19981005-W-Filderstadt-R32-Venus_Williams-Silvia_Farina_Elia,2,F-XC,72,16,3,9,4,35,37
19981005-W-Filderstadt-R32-Venus_Williams-Silvia_Farina_Elia,2,F-DTM,24,1,0,0,1,12,12
19981005-W-Filderstadt-R32-Venus_Williams-Silvia_Farina_Elia,2,F-DTL,17,8,1,1,6,5,12
19981005-W-Filderstadt-R32-Venus_Williams-Silvia_Farina_Elia,2,F-IO,24,13,4,4,5,14,10
19981005-W-Filderstadt-R32-Venus_Williams-Silvia_Farina_Elia,2,F-II,8,2,0,2,0,6,2
19981005-W-Filderstadt-R32-Venus_Williams-Silvia_Farina_Elia,2,B-XC,46,4,0,1,3,20,26
19981005-W-Filderstadt-R32-Venus_Williams-Silvia_Farina_Elia,2,B-DTM,21,1,0,0,1,6,15
19981005-W-Filderstadt-R32-Venus_Williams-Silvia_Farina_Elia,2,B-DTL,12,3,0,2,1,10,2
19981005-W-Filderstadt-R32-Venus_Williams-Silvia_Farina_Elia,2,B-IO,1,0,0,0,0,0,1
19981005-W-Filderstadt-R32-Venus_Williams-Silvia_Farina_Elia,2,S-XC,18,2,0,0,2,4,14
19981005-W-Filderstadt-R32-Venus_Williams-Silvia_Farina_Elia,2,S-DTM,9,1,0,0,1,3,6
19981005-W-Filderstadt-R32-Venus_Williams-Silvia_Farina_Elia,2,S-DTL,4,2,0,0,2,0,4
20201001-W-Roland_Garros-R64-Elena_Rybakina-Fiona_Ferro,1,F-XC,69,9,2,1,6,40,29
20201001-W-Roland_Garros-R64-Elena_Rybakina-Fiona_Ferro,1,F-DTM,33,3,0,0,3,15,18
20201001-W-Roland_Garros-R64-Elena_Rybakina-Fiona_Ferro,1,F-DTL,14,5,0,1,4,7,7
20201001-W-Roland_Garros-R64-Elena_Rybakina-Fiona_Ferro,1,F-IO,28,6,2,1,3,18,10
20201001-W-Roland_Garros-R64-Elena_Rybakina-Fiona_Ferro,1,B-XC,56,8,1,3,4,31,25
20201001-W-Roland_Garros-R64-Elena_Rybakina-Fiona_Ferro,1,B-DTM,36,3,1,1,1,19,17
20201001-W-Roland_Garros-R64-Elena_Rybakina-Fiona_Ferro,1,B-DTL,5,2,0,1,1,3,2
20201001-W-Roland_Garros-R64-Elena_Rybakina-Fiona_Ferro,1,B-IO,5,5,3,1,1,4,1
20201001-W-Roland_Garros-R64-Elena_Rybakina-Fiona_Ferro,1,S-XC,4,0,0,0,0,4,0
20201001-W-Roland_Garros-R64-Elena_Rybakina-Fiona_Ferro,1,S-DTM,1,1,0,0,1,0,1
20201001-W-Roland_Garros-R64-Elena_Rybakina-Fiona_Ferro,1,S-DTL,3,0,0,0,0,1,2
20201001-W-Roland_Garros-R64-Elena_Rybakina-Fiona_Ferro,2,F-XC,47,10,2,3,5,26,21
20201001-W-Roland_Garros-R64-Elena_Rybakina-Fiona_Ferro,2,F-DTM,46,3,0,0,3,15,31
20201001-W-Roland_Garros-R64-Elena_Rybakina-Fiona_Ferro,2,F-DTL,20,10,3,0,7,8,12
20201001-W-Roland_Garros-R64-Elena_Rybakina-Fiona_Ferro,2,F-IO,25,11,4,4,3,16,9
20201001-W-Roland_Garros-R64-Elena_Rybakina-Fiona_Ferro,2,F-II,5,2,0,1,1,2,3
20201001-W-Roland_Garros-R64-Elena_Rybakina-Fiona_Ferro,2,B-XC,44,8,2,3,3,20,24
20201001-W-Roland_Garros-R64-Elena_Rybakina-Fiona_Ferro,2,B-DTM,31,2,0,0,2,9,22
20201001-W-Roland_Garros-R64-Elena_Rybakina-Fiona_Ferro,2,B-DTL,20,10,4,1,5,11,9
20201001-W-Roland_Garros-R64-Elena_Rybakina-Fiona_Ferro,2,B-IO,7,5,2,2,1,5,2
20201001-W-Roland_Garros-R64-Elena_Rybakina-Fiona_Ferro,2,S-XC,9,1,0,0,1,2,7
20201001-W-Roland_Garros-R64-Elena_Rybakina-Fiona_Ferro,2,S-DTM,10,1,0,0,1,3,7
20201001-W-Roland_Garros-R64-Elena_Rybakina-Fiona_Ferro,2,S-DTL,2,2,1,0,1,1,1
19981025-W-Moscow-F-Monica_Seles-Mary_Pierce,1,F-XC,31,8,3,1,4,20,11
19981025-W-Moscow-F-Monica_Seles-Mary_Pierce,1,F-DTM,19,4,0,0,4,8,11
19981025-W-Moscow-F-Monica_Seles-Mary_Pierce,1,F-DTL,5,5,2,1,2,3,2
19981025-W-Moscow-F-Monica_Seles-Mary_Pierce,1,F-IO,6,4,2,1,1,4,2
19981025-W-Moscow-F-Monica_Seles-Mary_Pierce,1,B-XC,22,10,9,0,1,12,10
19981025-W-Moscow-F-Monica_Seles-Mary_Pierce,1,B-DTM,14,2,0,0,2,8,6
19981025-W-Moscow-F-Monica_Seles-Mary_Pierce,1,B-DTL,8,3,0,1,2,2,6
19981025-W-Moscow-F-Monica_Seles-Mary_Pierce,1,B-IO,4,2,2,0,0,4,0
19981025-W-Moscow-F-Monica_Seles-Mary_Pierce,1,S-XC,1,0,0,0,0,0,1
19981025-W-Moscow-F-Monica_Seles-Mary_Pierce,1,S-DTM,2,0,0,0,0,0,2
19981025-W-Moscow-F-Monica_Seles-Mary_Pierce,1,S-DTL,4,0,0,0,0,0,4
19981025-W-Moscow-F-Monica_Seles-Mary_Pierce,2,F-XC,29,13,5,4,4,18,11
19981025-W-Moscow-F-Monica_Seles-Mary_Pierce,2,F-DTM,10,1,1,0,0,5,5
19981025-W-Moscow-F-Monica_Seles-Mary_Pierce,2,F-DTL,7,6,5,1,0,6,1
19981025-W-Moscow-F-Monica_Seles-Mary_Pierce,2,F-IO,6,5,2,0,3,2,4
19981025-W-Moscow-F-Monica_Seles-Mary_Pierce,2,B-XC,21,5,2,1,2,13,8
19981025-W-Moscow-F-Monica_Seles-Mary_Pierce,2,B-DTM,29,3,0,0,3,10,19
19981025-W-Moscow-F-Monica_Seles-Mary_Pierce,2,B-DTL,9,3,1,0,2,4,5
19981025-W-Moscow-F-Monica_Seles-Mary_Pierce,2,B-IO,9,7,5,0,2,7,2
19981025-W-Moscow-F-Monica_Seles-Mary_Pierce,2,S-XC,1,0,0,0,0,1,0
19981025-W-Moscow-F-Monica_Seles-Mary_Pierce,2,S-DTL,1,0,0,0,0,0,1
20200918-W-Rome-R16-Elena_Rybakina-Yulia_Putintseva,1,F-XC,60,30,8,11,11,34,26
20200918-W-Rome-R16-Elena_Rybakina-Yulia_Putintseva,1,F-DTM,32,2,0,0,2,8,24
20200918-W-Rome-R16-Elena_Rybakina-Yulia_Putintseva,1,F-DTL,15,5,3,0,2,7,8
20200918-W-Rome-R16-Elena_Rybakina-Yulia_Putintseva,1,F-IO,34,12,3,3,6,19,15
20200918-W-Rome-R16-Elena_Rybakina-Yulia_Putintseva,1,F-II,6,1,0,1,0,5,1
20200918-W-Rome-R16-Elena_Rybakina-Yulia_Putintseva,1,B-XC,64,16,2,2,12,23,41
20200918-W-Rome-R16-Elena_Rybakina-Yulia_Putintseva,1,B-DTM,30,5,0,0,5,11,19
20200918-W-Rome-R16-Elena_Rybakina-Yulia_Putintseva,1,B-DTL,23,9,5,0,4,11,12
20200918-W-Rome-R16-Elena_Rybakina-Yulia_Putintseva,1,B-IO,17,9,3,2,4,9,8
20200918-W-Rome-R16-Elena_Rybakina-Yulia_Putintseva,1,S-DTM,1,0,0,0,0,0,1
20200918-W-Rome-R16-Elena_Rybakina-Yulia_Putintseva,2,F-XC,40,7,3,3,1,26,14
20200918-W-Rome-R16-Elena_Rybakina-Yulia_Putintseva,2,F-DTM,38,1,0,0,1,21,17
20200918-W-Rome-R16-Elena_Rybakina-Yulia_Putintseva,2,F-DTL,24,2,1,0,1,12,12
20200918-W-Rome-R16-Elena_Rybakina-Yulia_Putintseva,2,F-IO,24,5,1,2,2,16,8
20200918-W-Rome-R16-Elena_Rybakina-Yulia_Putintseva,2,F-II,6,3,1,0,2,3,3
20200918-W-Rome-R16-Elena_Rybakina-Yulia_Putintseva,2,B-XC,34,7,2,4,1,24,10
20200918-W-Rome-R16-Elena_Rybakina-Yulia_Putintseva,2,B-DTM,25,1,0,0,1,15,10
20200918-W-Rome-R16-Elena_Rybakina-Yulia_Putintseva,2,B-DTL,3,1,0,0,1,1,2
20200918-W-Rome-R16-Elena_Rybakina-Yulia_Putintseva,2,S-XC,14,1,0,0,1,6,8
20200918-W-Rome-R16-Elena_Rybakina-Yulia_Putintseva,2,S-DTM,19,1,0,0,1,8,11
20200918-W-Rome-R16-Elena_Rybakina-Yulia_Putintseva,2,S-DTL,6,0,0,0,0,2,4
20200918-W-Rome-R16-Elena_Rybakina-Yulia_Putintseva,2,S-IO,2,1,1,0,0,2,0
20170704-W-Wimbledon-R128-Bianca_Andreescu-Kristina_Kucova,1,F-XC,25,8,1,1,6,12,13
20170704-W-Wimbledon-R128-Bianca_Andreescu-Kristina_Kucova,1,F-DTM,15,2,0,0,2,7,8
20170704-W-Wimbledon-R128-Bianca_Andreescu-Kristina_Kucova,1,F-DTL,3,0,0,0,0,2,1
20170704-W-Wimbledon-R128-Bianca_Andreescu-Kristina_Kucova,1,F-IO,5,2,1,0,1,3,2
20170704-W-Wimbledon-R128-Bianca_Andreescu-Kristina_Kucova,1,B-XC,16,4,1,1,2,9,7
20170704-W-Wimbledon-R128-Bianca_Andreescu-Kristina_Kucova,1,B-DTM,18,1,0,1,0,11,7
20170704-W-Wimbledon-R128-Bianca_Andreescu-Kristina_Kucova,1,B-DTL,2,2,1,0,1,1,1
20170704-W-Wimbledon-R128-Bianca_Andreescu-Kristina_Kucova,1,B-IO,1,1,0,0,1,0,1
20170704-W-Wimbledon-R128-Bianca_Andreescu-Kristina_Kucova,1,S-DTM,2,1,0,0,1,0,2
20170704-W-Wimbledon-R128-Bianca_Andreescu-Kristina_Kucova,2,F-XC,27,10,1,3,6,15,12
20170704-W-Wimbledon-R128-Bianca_Andreescu-Kristina_Kucova,2,F-DTM,13,2,0,1,1,6,7
20170704-W-Wimbledon-R128-Bianca_Andreescu-Kristina_Kucova,2,F-DTL,2,1,0,0,1,1,1
20170704-W-Wimbledon-R128-Bianca_Andreescu-Kristina_Kucova,2,F-IO,4,2,1,0,1,2,2
20170704-W-Wimbledon-R128-Bianca_Andreescu-Kristina_Kucova,2,F-II,1,1,1,0,0,1,0
20170704-W-Wimbledon-R128-Bianca_Andreescu-Kristina_Kucova,2,B-XC,16,5,1,2,2,8,8
20170704-W-Wimbledon-R128-Bianca_Andreescu-Kristina_Kucova,2,B-DTM,15,0,0,0,0,6,9
20170704-W-Wimbledon-R128-Bianca_Andreescu-Kristina_Kucova,2,B-DTL,4,0,0,0,0,1,3
20170704-W-Wimbledon-R128-Bianca_Andreescu-Kristina_Kucova,2,B-IO,2,0,0,0,0,1,1
20170704-W-Wimbledon-R128-Bianca_Andreescu-Kristina_Kucova,2,S-XC,1,0,0,0,0,1,0
20200929-W-Roland_Garros-R128-Irina_Maria_Bara-Donna_Vekic,1,F-XC,17,7,2,2,3,11,6
20200929-W-Roland_Garros-R128-Irina_Maria_Bara-Donna_Vekic,1,F-DTM,21,0,0,0,0,13,8
20200929-W-Roland_Garros-R128-Irina_Maria_Bara-Donna_Vekic,1,F-DTL,7,2,1,1,0,4,3
20200929-W-Roland_Garros-R128-Irina_Maria_Bara-Donna_Vekic,1,F-IO,11,3,2,0,1,5,6
20200929-W-Roland_Garros-R128-Irina_Maria_Bara-Donna_Vekic,1,F-II,1,1,0,0,1,0,1
20200929-W-Roland_Garros-R128-Irina_Maria_Bara-Donna_Vekic,1,B-XC,32,1,0,0,1,18,14
20200929-W-Roland_Garros-R128-Irina_Maria_Bara-Donna_Vekic,1,B-DTM,25,1,0,0,1,13,12
20200929-W-Roland_Garros-R128-Irina_Maria_Bara-Donna_Vekic,1,B-DTL,8,3,1,2,0,6,2
20200929-W-Roland_Garros-R128-Irina_Maria_Bara-Donna_Vekic,1,B-IO,6,1,0,0,1,4,2
20200929-W-Roland_Garros-R128-Irina_Maria_Bara-Donna_Vekic,1,S-XC,10,0,0,0,0,6,4
20200929-W-Roland_Garros-R128-Irina_Maria_Bara-Donna_Vekic,1,S-DTM,16,1,0,0,1,9,7
20200929-W-Roland_Garros-R128-Irina_Maria_Bara-Donna_Vekic,2,F-XC,30,13,3,3,7,14,16
20200929-W-Roland_Garros-R128-Irina_Maria_Bara-Donna_Vekic,2,F-DTM,17,3,0,0,3,5,12
20200929-W-Roland_Garros-R128-Irina_Maria_Bara-Donna_Vekic,2,F-DTL,6,2,2,0,0,5,1
20200929-W-Roland_Garros-R128-Irina_Maria_Bara-Donna_Vekic,2,F-IO,35,14,5,3,6,20,15
20200929-W-Roland_Garros-R128-Irina_Maria_Bara-Donna_Vekic,2,F-II,4,3,2,0,1,3,1
20200929-W-Roland_Garros-R128-Irina_Maria_Bara-Donna_Vekic,2,B-XC,37,2,0,1,1,16,21
20200929-W-Roland_Garros-R128-Irina_Maria_Bara-Donna_Vekic,2,B-DTM,21,1,0,0,1,5,16
20200929-W-Roland_Garros-R128-Irina_Maria_Bara-Donna_Vekic,2,B-DTL,10,5,4,0,1,5,5
20200929-W-Roland_Garros-R128-Irina_Maria_Bara-Donna_Vekic,2,B-IO,7,3,0,0,3,3,4
20200929-W-Roland_Garros-R128-Irina_Maria_Bara-Donna_Vekic,2,S-XC,1,0,0,0,0,1,0
20200929-W-Roland_Garros-R128-Irina_Maria_Bara-Donna_Vekic,2,S-DTM,1,0,0,0,0,0,1
20200929-W-Roland_Garros-R128-Irina_Maria_Bara-Donna_Vekic,2,S-DTL,1,1,1,0,0,1,0
20200929-W-Roland_Garros-R128-Irina_Maria_Bara-Donna_Vekic,2,S-IO,1,1,0,0,1,0,1
20210111-W-Abu_Dhabi-QF-Veronika_Kudermetova-Elina_Svitolina,1,F-XC,60,15,9,1,5,41,19
20210111-W-Abu_Dhabi-QF-Veronika_Kudermetova-Elina_Svitolina,1,F-DTM,49,7,1,1,5,19,30
20210111-W-Abu_Dhabi-QF-Veronika_Kudermetova-Elina_Svitolina,1,F-DTL,15,7,4,0,3,8,7
20210111-W-Abu_Dhabi-QF-Veronika_Kudermetova-Elina_Svitolina,1,F-IO,35,15,7,1,7,17,18
20210111-W-Abu_Dhabi-QF-Veronika_Kudermetova-Elina_Svitolina,1,F-II,1,1,1,0,0,1,0
20210111-W-Abu_Dhabi-QF-Veronika_Kudermetova-Elina_Svitolina,1,B-XC,40,6,2,0,4,16,24
20210111-W-Abu_Dhabi-QF-Veronika_Kudermetova-Elina_Svitolina,1,B-DTM,43,4,0,0,4,21,22
20210111-W-Abu_Dhabi-QF-Veronika_Kudermetova-Elina_Svitolina,1,B-DTL,7,6,2,0,4,3,4
20210111-W-Abu_Dhabi-QF-Veronika_Kudermetova-Elina_Svitolina,1,B-IO,13,4,1,1,2,7,6
20210111-W-Abu_Dhabi-QF-Veronika_Kudermetova-Elina_Svitolina,1,S-XC,14,1,0,0,1,9,5
20210111-W-Abu_Dhabi-QF-Veronika_Kudermetova-Elina_Svitolina,1,S-DTM,11,3,0,0,2,3,8
20210111-W-Abu_Dhabi-QF-Veronika_Kudermetova-Elina_Svitolina,1,S-DTL,1,0,0,0,0,0,1
20210111-W-Abu_Dhabi-QF-Veronika_Kudermetova-Elina_Svitolina,2,F-XC,52,9,3,0,6,24,28
20210111-W-Abu_Dhabi-QF-Veronika_Kudermetova-Elina_Svitolina,2,F-DTM,54,4,0,1,3,28,26
20210111-W-Abu_Dhabi-QF-Veronika_Kudermetova-Elina_Svitolina,2,F-DTL,11,2,0,0,2,5,6
20210111-W-Abu_Dhabi-QF-Veronika_Kudermetova-Elina_Svitolina,2,F-IO,24,8,4,1,3,15,9
20210111-W-Abu_Dhabi-QF-Veronika_Kudermetova-Elina_Svitolina,2,F-II,4,2,1,0,1,3,1
20210111-W-Abu_Dhabi-QF-Veronika_Kudermetova-Elina_Svitolina,2,B-XC,48,9,2,1,6,22,26
20210111-W-Abu_Dhabi-QF-Veronika_Kudermetova-Elina_Svitolina,2,B-DTM,55,3,0,0,3,27,28
20210111-W-Abu_Dhabi-QF-Veronika_Kudermetova-Elina_Svitolina,2,B-DTL,11,8,3,3,2,9,2
20210111-W-Abu_Dhabi-QF-Veronika_Kudermetova-Elina_Svitolina,2,B-IO,4,2,0,1,1,2,2
20210111-W-Abu_Dhabi-QF-Veronika_Kudermetova-Elina_Svitolina,2,S-XC,4,1,0,0,1,2,2
20210111-W-Abu_Dhabi-QF-Veronika_Kudermetova-Elina_Svitolina,2,S-DTM,5,1,0,0,1,1,4
20210111-W-Abu_Dhabi-QF-Veronika_Kudermetova-Elina_Svitolina,2,S-DTL,1,0,0,0,0,0,1
20150401-W-Miami-QF-Serena_Williams-Sabine_Lisicki,1,F-XC,41,18,3,4,10,20,21
20150401-W-Miami-QF-Serena_Williams-Sabine_Lisicki,1,F-DTM,28,2,0,0,2,15,13
20150401-W-Miami-QF-Serena_Williams-Sabine_Lisicki,1,F-DTL,12,6,2,1,3,8,4
20150401-W-Miami-QF-Serena_Williams-Sabine_Lisicki,1,F-IO,18,8,4,1,3,11,7
20150401-W-Miami-QF-Serena_Williams-Sabine_Lisicki,1,B-XC,43,9,1,1,7,13,30
20150401-W-Miami-QF-Serena_Williams-Sabine_Lisicki,1,B-DTM,21,2,1,1,0,9,12
20150401-W-Miami-QF-Serena_Williams-Sabine_Lisicki,1,B-DTL,15,8,2,1,5,7,8
20150401-W-Miami-QF-Serena_Williams-Sabine_Lisicki,1,B-IO,10,0,0,0,0,5,5
20150401-W-Miami-QF-Serena_Williams-Sabine_Lisicki,1,S-XC,4,1,0,1,0,2,2
20150401-W-Miami-QF-Serena_Williams-Sabine_Lisicki,1,S-DTM,2,0,0,0,0,1,1
20150401-W-Miami-QF-Serena_Williams-Sabine_Lisicki,1,S-DTL,1,1,1,0,0,1,0
20150401-W-Miami-QF-Serena_Williams-Sabine_Lisicki,2,F-XC,41,9,2,3,4,19,22
20150401-W-Miami-QF-Serena_Williams-Sabine_Lisicki,2,F-DTM,27,1,0,1,0,16,11
20150401-W-Miami-QF-Serena_Williams-Sabine_Lisicki,2,F-DTL,6,4,0,2,2,4,2
20150401-W-Miami-QF-Serena_Williams-Sabine_Lisicki,2,F-IO,10,4,1,1,2,5,5
20150401-W-Miami-QF-Serena_Williams-Sabine_Lisicki,2,F-II,2,1,0,0,1,0,2
20150401-W-Miami-QF-Serena_Williams-Sabine_Lisicki,2,B-XC,32,8,2,1,5,17,15
20150401-W-Miami-QF-Serena_Williams-Sabine_Lisicki,2,B-DTM,38,2,0,0,2,20,18
20150401-W-Miami-QF-Serena_Williams-Sabine_Lisicki,2,B-DTL,8,5,3,1,1,5,3
20150401-W-Miami-QF-Serena_Williams-Sabine_Lisicki,2,B-IO,1,1,0,1,0,1,0
20150401-W-Miami-QF-Serena_Williams-Sabine_Lisicki,2,S-XC,1,0,0,0,0,1,0
20150401-W-Miami-QF-Serena_Williams-Sabine_Lisicki,2,S-DTM,4,0,0,0,0,3,1
20150401-W-Miami-QF-Serena_Williams-Sabine_Lisicki,2,S-DTL,2,0,0,0,0,1,1
20150401-W-Miami-QF-Serena_Williams-Sabine_Lisicki,2,S-IO,2,1,0,1,0,1,1
19790928-W-US_Open-F-Tracy_Austin-Chris_Evert,1,F-XC,111,17,2,4,11,67,44
19790928-W-US_Open-F-Tracy_Austin-Chris_Evert,1,F-DTM,26,2,0,0,2,10,16
19790928-W-US_Open-F-Tracy_Austin-Chris_Evert,1,F-DTL,19,5,3,0,2,10,9
19790928-W-US_Open-F-Tracy_Austin-Chris_Evert,1,F-IO,26,1,0,0,1,16,10
19790928-W-US_Open-F-Tracy_Austin-Chris_Evert,1,B-XC,159,9,2,0,7,89,70
19790928-W-US_Open-F-Tracy_Austin-Chris_Evert,1,B-DTM,64,6,0,0,6,41,23
19790928-W-US_Open-F-Tracy_Austin-Chris_Evert,1,B-DTL,31,11,2,4,5,17,14
19790928-W-US_Open-F-Tracy_Austin-Chris_Evert,1,B-IO,5,0,0,0,0,1,4
19790928-W-US_Open-F-Tracy_Austin-Chris_Evert,1,S-XC,3,0,0,0,0,3,0
19790928-W-US_Open-F-Tracy_Austin-Chris_Evert,1,S-DTM,1,0,0,0,0,1,0
19790928-W-US_Open-F-Tracy_Austin-Chris_Evert,2,F-XC,74,4,0,0,4,29,45
19790928-W-US_Open-F-Tracy_Austin-Chris_Evert,2,F-DTM,38,2,0,0,2,14,24
19790928-W-US_Open-F-Tracy_Austin-Chris_Evert,2,F-DTL,39,6,1,0,5,14,25
19790928-W-US_Open-F-Tracy_Austin-Chris_Evert,2,F-IO,32,2,1,0,1,11,21
19790928-W-US_Open-F-Tracy_Austin-Chris_Evert,2,B-XC,144,7,0,1,6,58,86
19790928-W-US_Open-F-Tracy_Austin-Chris_Evert,2,B-DTM,53,3,0,0,3,24,29
19790928-W-US_Open-F-Tracy_Austin-Chris_Evert,2,B-DTL,34,6,2,1,3,18,16
19790928-W-US_Open-F-Tracy_Austin-Chris_Evert,2,B-IO,4,0,0,0,0,2,2
19790928-W-US_Open-F-Tracy_Austin-Chris_Evert,2,S-XC,6,0,0,0,0,1,5
19790928-W-US_Open-F-Tracy_Austin-Chris_Evert,2,S-DTM,2,0,0,0,0,0,2
19790928-W-US_Open-F-Tracy_Austin-Chris_Evert,2,S-DTL,1,0,0,0,0,0,1
20130115-W-Australian_Open-R128-Nadia_Petrova-Kimiko_Date_Krumm,1,F-XC,36,7,0,3,4,14,22
20130115-W-Australian_Open-R128-Nadia_Petrova-Kimiko_Date_Krumm,1,F-DTM,10,2,0,0,2,4,6
20130115-W-Australian_Open-R128-Nadia_Petrova-Kimiko_Date_Krumm,1,F-DTL,12,4,1,0,3,6,6
20130115-W-Australian_Open-R128-Nadia_Petrova-Kimiko_Date_Krumm,1,F-IO,12,4,1,0,3,1,11
20130115-W-Australian_Open-R128-Nadia_Petrova-Kimiko_Date_Krumm,1,B-XC,17,3,0,0,3,6,11
20130115-W-Australian_Open-R128-Nadia_Petrova-Kimiko_Date_Krumm,1,B-DTM,13,2,0,1,1,6,7
20130115-W-Australian_Open-R128-Nadia_Petrova-Kimiko_Date_Krumm,1,B-DTL,2,0,0,0,0,1,1
20130115-W-Australian_Open-R128-Nadia_Petrova-Kimiko_Date_Krumm,1,B-IO,8,2,1,0,1,2,6
20130115-W-Australian_Open-R128-Nadia_Petrova-Kimiko_Date_Krumm,1,S-XC,4,0,0,0,0,1,3
20130115-W-Australian_Open-R128-Nadia_Petrova-Kimiko_Date_Krumm,1,S-DTM,2,0,0,0,0,0,2
20130115-W-Australian_Open-R128-Nadia_Petrova-Kimiko_Date_Krumm,1,S-DTL,6,2,0,1,1,1,5
20130115-W-Australian_Open-R128-Nadia_Petrova-Kimiko_Date_Krumm,1,S-IO,2,1,0,0,1,0,2
20130115-W-Australian_Open-R128-Nadia_Petrova-Kimiko_Date_Krumm,2,F-XC,34,5,4,1,0,20,14
20130115-W-Australian_Open-R128-Nadia_Petrova-Kimiko_Date_Krumm,2,F-DTM,21,1,0,0,1,13,8
20130115-W-Australian_Open-R128-Nadia_Petrova-Kimiko_Date_Krumm,2,F-DTL,12,5,4,1,0,8,4
20130115-W-Australian_Open-R128-Nadia_Petrova-Kimiko_Date_Krumm,2,F-IO,7,3,1,1,1,6,1
20130115-W-Australian_Open-R128-Nadia_Petrova-Kimiko_Date_Krumm,2,F-II,1,1,0,0,1,0,1
20130115-W-Australian_Open-R128-Nadia_Petrova-Kimiko_Date_Krumm,2,B-XC,21,5,1,0,4,13,8
20130115-W-Australian_Open-R128-Nadia_Petrova-Kimiko_Date_Krumm,2,B-DTM,12,2,0,1,1,9,3
20130115-W-Australian_Open-R128-Nadia_Petrova-Kimiko_Date_Krumm,2,B-DTL,11,5,0,2,3,6,5
20130115-W-Australian_Open-R128-Nadia_Petrova-Kimiko_Date_Krumm,2,B-IO,5,0,0,0,0,5,0
20130115-W-Australian_Open-R128-Nadia_Petrova-Kimiko_Date_Krumm,2,S-XC,2,0,0,0,0,2,0
20130115-W-Australian_Open-R128-Nadia_Petrova-Kimiko_Date_Krumm,2,S-DTM,4,0,0,0,0,2,2
20130115-W-Australian_Open-R128-Nadia_Petrova-Kimiko_Date_Krumm,2,S-DTL,3,1,0,0,1,1,2
20210110-W-Abu_Dhabi-R16-Ekaterina_Alexandrova-Elina_Svitolina,1,F-XC,73,19,7,5,7,43,30
20210110-W-Abu_Dhabi-R16-Ekaterina_Alexandrova-Elina_Svitolina,1,F-DTM,32,4,1,1,2,15,17
20210110-W-Abu_Dhabi-R16-Ekaterina_Alexandrova-Elina_Svitolina,1,F-DTL,38,15,6,3,6,24,14
20210110-W-Abu_Dhabi-R16-Ekaterina_Alexandrova-Elina_Svitolina,1,F-IO,44,14,2,4,8,23,21
20210110-W-Abu_Dhabi-R16-Ekaterina_Alexandrova-Elina_Svitolina,1,F-II,1,0,0,0,0,1,0
20210110-W-Abu_Dhabi-R16-Ekaterina_Alexandrova-Elina_Svitolina,1,B-XC,42,10,2,3,5,19,23
20210110-W-Abu_Dhabi-R16-Ekaterina_Alexandrova-Elina_Svitolina,1,B-DTM,43,3,0,0,3,17,26
20210110-W-Abu_Dhabi-R16-Ekaterina_Alexandrova-Elina_Svitolina,1,B-DTL,30,10,3,0,7,15,15
20210110-W-Abu_Dhabi-R16-Ekaterina_Alexandrova-Elina_Svitolina,1,B-IO,29,11,3,1,7,15,14
20210110-W-Abu_Dhabi-R16-Ekaterina_Alexandrova-Elina_Svitolina,1,S-XC,1,1,0,1,0,1,0
20210110-W-Abu_Dhabi-R16-Ekaterina_Alexandrova-Elina_Svitolina,1,S-DTL,1,0,0,0,0,1,0
20210110-W-Abu_Dhabi-R16-Ekaterina_Alexandrova-Elina_Svitolina,1,S-IO,1,0,0,0,0,1,0
20210110-W-Abu_Dhabi-R16-Ekaterina_Alexandrova-Elina_Svitolina,2,F-XC,80,12,1,5,6,33,47
20210110-W-Abu_Dhabi-R16-Ekaterina_Alexandrova-Elina_Svitolina,2,F-DTM,55,1,0,1,0,30,25
20210110-W-Abu_Dhabi-R16-Ekaterina_Alexandrova-Elina_Svitolina,2,F-DTL,7,3,2,1,0,3,4
20210110-W-Abu_Dhabi-R16-Ekaterina_Alexandrova-Elina_Svitolina,2,F-IO,16,3,2,0,1,11,5
20210110-W-Abu_Dhabi-R16-Ekaterina_Alexandrova-Elina_Svitolina,2,B-XC,69,10,1,3,6,33,36
20210110-W-Abu_Dhabi-R16-Ekaterina_Alexandrova-Elina_Svitolina,2,B-DTM,60,6,0,4,2,26,34
20210110-W-Abu_Dhabi-R16-Ekaterina_Alexandrova-Elina_Svitolina,2,B-DTL,7,6,2,1,3,3,4
20210110-W-Abu_Dhabi-R16-Ekaterina_Alexandrova-Elina_Svitolina,2,B-IO,7,3,1,1,1,5,2
20210110-W-Abu_Dhabi-R16-Ekaterina_Alexandrova-Elina_Svitolina,2,S-XC,4,0,0,0,0,2,2
20210110-W-Abu_Dhabi-R16-Ekaterina_Alexandrova-Elina_Svitolina,2,S-DTM,3,0,0,0,0,1,2
20210110-W-Abu_Dhabi-R16-Ekaterina_Alexandrova-Elina_Svitolina,2,S-DTL,1,0,0,0,0,0,1
20200929-W-Roland_Garros-R128-Clara_Tauson-Jennifer_Brady,1,F-XC,87,28,15,4,9,59,28
20200929-W-Roland_Garros-R128-Clara_Tauson-Jennifer_Brady,1,F-DTM,33,9,1,0,8,12,21
20200929-W-Roland_Garros-R128-Clara_Tauson-Jennifer_Brady,1,F-DTL,25,9,2,0,7,11,14
20200929-W-Roland_Garros-R128-Clara_Tauson-Jennifer_Brady,1,F-IO,49,19,8,5,6,30,19
20200929-W-Roland_Garros-R128-Clara_Tauson-Jennifer_Brady,1,F-II,2,2,2,0,0,2,0
20200929-W-Roland_Garros-R128-Clara_Tauson-Jennifer_Brady,1,B-XC,59,8,3,4,1,38,21
20200929-W-Roland_Garros-R128-Clara_Tauson-Jennifer_Brady,1,B-DTM,26,2,0,0,2,7,19
20200929-W-Roland_Garros-R128-Clara_Tauson-Jennifer_Brady,1,B-DTL,16,9,4,0,5,8,8
20200929-W-Roland_Garros-R128-Clara_Tauson-Jennifer_Brady,1,B-IO,12,5,4,0,1,7,5
20200929-W-Roland_Garros-R128-Clara_Tauson-Jennifer_Brady,1,S-XC,3,0,0,0,0,3,0
20200929-W-Roland_Garros-R128-Clara_Tauson-Jennifer_Brady,1,S-DTM,2,0,0,0,0,0,2
20200929-W-Roland_Garros-R128-Clara_Tauson-Jennifer_Brady,1,S-IO,1,0,0,0,0,0,1
20200929-W-Roland_Garros-R128-Clara_Tauson-Jennifer_Brady,2,F-XC,58,13,5,2,6,25,33
20200929-W-Roland_Garros-R128-Clara_Tauson-Jennifer_Brady,2,F-DTM,53,7,0,2,5,24,29
20200929-W-Roland_Garros-R128-Clara_Tauson-Jennifer_Brady,2,F-DTL,6,4,1,2,1,5,1
20200929-W-Roland_Garros-R128-Clara_Tauson-Jennifer_Brady,2,F-IO,28,13,10,1,2,20,8
20200929-W-Roland_Garros-R128-Clara_Tauson-Jennifer_Brady,2,F-II,1,0,0,0,0,0,1
20200929-W-Roland_Garros-R128-Clara_Tauson-Jennifer_Brady,2,B-XC,43,7,3,2,2,19,24
20200929-W-Roland_Garros-R128-Clara_Tauson-Jennifer_Brady,2,B-DTM,48,1,0,1,0,21,27
20200929-W-Roland_Garros-R128-Clara_Tauson-Jennifer_Brady,2,B-DTL,20,7,4,1,2,12,8
20200929-W-Roland_Garros-R128-Clara_Tauson-Jennifer_Brady,2,B-IO,6,2,0,0,2,4,2
20200929-W-Roland_Garros-R128-Clara_Tauson-Jennifer_Brady,2,S-XC,2,1,0,1,0,1,1
20200929-W-Roland_Garros-R128-Clara_Tauson-Jennifer_Brady,2,S-DTM,14,1,0,0,1,4,10
20200929-W-Roland_Garros-R128-Clara_Tauson-Jennifer_Brady,2,S-DTL,15,3,2,1,0,7,8
20200929-W-Roland_Garros-R128-Clara_Tauson-Jennifer_Brady,2,S-IO,2,0,0,0,0,1,1
20210131-W-Gippsland_Trophy-R64-Jasmine_Paolini-Rebecca_Marino,1,F-XC,30,4,0,2,2,19,11
20210131-W-Gippsland_Trophy-R64-Jasmine_Paolini-Rebecca_Marino,1,F-DTM,35,5,0,1,4,18,17
20210131-W-Gippsland_Trophy-R64-Jasmine_Paolini-Rebecca_Marino,1,F-DTL,7,3,1,1,1,5,2
20210131-W-Gippsland_Trophy-R64-Jasmine_Paolini-Rebecca_Marino,1,F-IO,9,3,1,0,2,4,5
20210131-W-Gippsland_Trophy-R64-Jasmine_Paolini-Rebecca_Marino,1,F-II,1,0,0,0,0,1,0
20210131-W-Gippsland_Trophy-R64-Jasmine_Paolini-Rebecca_Marino,1,B-XC,25,4,0,0,4,12,13
20210131-W-Gippsland_Trophy-R64-Jasmine_Paolini-Rebecca_Marino,1,B-DTM,33,3,1,0,2,21,12
20210131-W-Gippsland_Trophy-R64-Jasmine_Paolini-Rebecca_Marino,1,B-DTL,3,2,0,0,2,1,2
20210131-W-Gippsland_Trophy-R64-Jasmine_Paolini-Rebecca_Marino,1,B-IO,4,1,0,1,0,2,2
20210131-W-Gippsland_Trophy-R64-Jasmine_Paolini-Rebecca_Marino,1,S-XC,3,0,0,0,0,1,2
20210131-W-Gippsland_Trophy-R64-Jasmine_Paolini-Rebecca_Marino,1,S-DTM,2,0,0,0,0,1,1
20210131-W-Gippsland_Trophy-R64-Jasmine_Paolini-Rebecca_Marino,1,S-DTL,1,1,1,0,0,1,0
20210131-W-Gippsland_Trophy-R64-Jasmine_Paolini-Rebecca_Marino,2,F-XC,43,13,2,1,10,17,26
20210131-W-Gippsland_Trophy-R64-Jasmine_Paolini-Rebecca_Marino,2,F-DTM,20,9,0,0,9,6,14
20210131-W-Gippsland_Trophy-R64-Jasmine_Paolini-Rebecca_Marino,2,F-DTL,10,6,2,0,4,3,7
20210131-W-Gippsland_Trophy-R64-Jasmine_Paolini-Rebecca_Marino,2,F-IO,16,9,2,1,6,4,12
20210131-W-Gippsland_Trophy-R64-Jasmine_Paolini-Rebecca_Marino,2,F-II,1,1,1,0,0,1,0
20210131-W-Gippsland_Trophy-R64-Jasmine_Paolini-Rebecca_Marino,2,B-XC,23,4,1,0,3,11,12
20210131-W-Gippsland_Trophy-R64-Jasmine_Paolini-Rebecca_Marino,2,B-DTM,26,2,1,0,1,14,12
20210131-W-Gippsland_Trophy-R64-Jasmine_Paolini-Rebecca_Marino,2,B-DTL,4,3,2,0,1,2,2
20210131-W-Gippsland_Trophy-R64-Jasmine_Paolini-Rebecca_Marino,2,B-IO,7,4,3,0,1,3,4
20210131-W-Gippsland_Trophy-R64-Jasmine_Paolini-Rebecca_Marino,2,S-XC,6,2,0,0,2,1,5
20210131-W-Gippsland_Trophy-R64-Jasmine_Paolini-Rebecca_Marino,2,S-DTM,4,0,0,0,0,0,4
20210131-W-Gippsland_Trophy-R64-Jasmine_Paolini-Rebecca_Marino,2,S-DTL,2,0,0,0,0,1,1
20210131-W-Gippsland_Trophy-R64-Jasmine_Paolini-Rebecca_Marino,2,S-IO,1,0,0,0,0,0,1
20210202-W-Gippsland_Trophy-R32-Kaja_Juvan-Iga_Swiatek,1,F-XC,27,9,1,2,6,11,16
20210202-W-Gippsland_Trophy-R32-Kaja_Juvan-Iga_Swiatek,1,F-DTM,24,5,0,1,4,10,14
20210202-W-Gippsland_Trophy-R32-Kaja_Juvan-Iga_Swiatek,1,F-DTL,7,3,2,1,0,4,3
20210202-W-Gippsland_Trophy-R32-Kaja_Juvan-Iga_Swiatek,1,F-IO,11,3,1,0,2,7,4
20210202-W-Gippsland_Trophy-R32-Kaja_Juvan-Iga_Swiatek,1,B-XC,35,7,0,2,5,13,22
20210202-W-Gippsland_Trophy-R32-Kaja_Juvan-Iga_Swiatek,1,B-DTM,27,5,0,1,4,15,12
20210202-W-Gippsland_Trophy-R32-Kaja_Juvan-Iga_Swiatek,1,B-DTL,4,3,2,0,1,3,1
20210202-W-Gippsland_Trophy-R32-Kaja_Juvan-Iga_Swiatek,1,B-IO,1,1,1,0,0,1,0
20210202-W-Gippsland_Trophy-R32-Kaja_Juvan-Iga_Swiatek,1,S-XC,3,0,0,0,0,2,1
20210202-W-Gippsland_Trophy-R32-Kaja_Juvan-Iga_Swiatek,1,S-DTM,2,0,0,0,0,1,1
20210202-W-Gippsland_Trophy-R32-Kaja_Juvan-Iga_Swiatek,1,S-DTL,2,1,0,0,1,1,1
20210202-W-Gippsland_Trophy-R32-Kaja_Juvan-Iga_Swiatek,1,S-IO,1,0,0,0,0,0,1
20210202-W-Gippsland_Trophy-R32-Kaja_Juvan-Iga_Swiatek,2,F-XC,37,13,4,2,7,24,13
20210202-W-Gippsland_Trophy-R32-Kaja_Juvan-Iga_Swiatek,2,F-DTM,9,0,0,0,0,4,5
20210202-W-Gippsland_Trophy-R32-Kaja_Juvan-Iga_Swiatek,2,F-DTL,11,3,2,1,0,7,4
20210202-W-Gippsland_Trophy-R32-Kaja_Juvan-Iga_Swiatek,2,F-IO,17,8,2,1,5,7,10
20210202-W-Gippsland_Trophy-R32-Kaja_Juvan-Iga_Swiatek,2,B-XC,37,8,0,5,3,22,15
20210202-W-Gippsland_Trophy-R32-Kaja_Juvan-Iga_Swiatek,2,B-DTM,21,2,0,0,2,9,12
20210202-W-Gippsland_Trophy-R32-Kaja_Juvan-Iga_Swiatek,2,B-DTL,6,3,1,0,2,3,3
20210202-W-Gippsland_Trophy-R32-Kaja_Juvan-Iga_Swiatek,2,B-IO,11,3,0,1,2,3,8
20210202-W-Gippsland_Trophy-R32-Kaja_Juvan-Iga_Swiatek,2,S-XC,5,0,0,0,0,2,3
20210202-W-Gippsland_Trophy-R32-Kaja_Juvan-Iga_Swiatek,2,S-DTM,1,0,0,0,0,1,0
20210202-W-Yarra_Valley_Classic-R32-Venus_Williams-Petra_Kvitova,1,F-XC,31,10,5,0,5,12,19
20210202-W-Yarra_Valley_Classic-R32-Venus_Williams-Petra_Kvitova,1,F-DTM,22,4,0,2,2,6,16
20210202-W-Yarra_Valley_Classic-R32-Venus_Williams-Petra_Kvitova,1,F-DTL,5,2,0,1,1,1,4
20210202-W-Yarra_Valley_Classic-R32-Venus_Williams-Petra_Kvitova,1,F-IO,7,3,1,1,1,3,4
20210202-W-Yarra_Valley_Classic-R32-Venus_Williams-Petra_Kvitova,1,F-II,2,1,1,0,0,2,0
20210202-W-Yarra_Valley_Classic-R32-Venus_Williams-Petra_Kvitova,1,B-XC,17,2,1,0,1,8,9
20210202-W-Yarra_Valley_Classic-R32-Venus_Williams-Petra_Kvitova,1,B-DTM,18,3,0,2,1,7,11
20210202-W-Yarra_Valley_Classic-R32-Venus_Williams-Petra_Kvitova,1,B-DTL,2,0,0,0,0,1,1
20210202-W-Yarra_Valley_Classic-R32-Venus_Williams-Petra_Kvitova,1,B-IO,4,0,0,0,0,1,3
20210202-W-Yarra_Valley_Classic-R32-Venus_Williams-Petra_Kvitova,1,S-XC,2,0,0,0,0,0,2
20210202-W-Yarra_Valley_Classic-R32-Venus_Williams-Petra_Kvitova,1,S-DTM,2,0,0,0,0,1,1
20210202-W-Yarra_Valley_Classic-R32-Venus_Williams-Petra_Kvitova,1,S-DTL,2,0,0,0,0,1,1
20210202-W-Yarra_Valley_Classic-R32-Venus_Williams-Petra_Kvitova,1,S-IO,1,1,0,0,1,0,1
20210202-W-Yarra_Valley_Classic-R32-Venus_Williams-Petra_Kvitova,2,F-XC,33,15,9,2,4,23,10
20210202-W-Yarra_Valley_Classic-R32-Venus_Williams-Petra_Kvitova,2,F-DTM,15,5,0,1,4,7,8
20210202-W-Yarra_Valley_Classic-R32-Venus_Williams-Petra_Kvitova,2,F-DTL,10,9,6,1,2,8,2
20210202-W-Yarra_Valley_Classic-R32-Venus_Williams-Petra_Kvitova,2,F-IO,17,14,8,5,1,16,1
20210202-W-Yarra_Valley_Classic-R32-Venus_Williams-Petra_Kvitova,2,B-XC,17,6,4,2,0,14,3
20210202-W-Yarra_Valley_Classic-R32-Venus_Williams-Petra_Kvitova,2,B-DTM,17,4,0,3,1,11,6
20210202-W-Yarra_Valley_Classic-R32-Venus_Williams-Petra_Kvitova,2,B-DTL,7,4,1,0,3,3,4
20210202-W-Yarra_Valley_Classic-R32-Venus_Williams-Petra_Kvitova,2,B-IO,4,3,2,0,1,3,1
20210202-W-Yarra_Valley_Classic-R32-Venus_Williams-Petra_Kvitova,2,S-XC,1,0,0,0,0,0,1
20210202-W-Yarra_Valley_Classic-R32-Venus_Williams-Petra_Kvitova,2,S-DTM,5,0,0,0,0,3,2
20210202-W-Yarra_Valley_Classic-R32-Venus_Williams-Petra_Kvitova,2,S-DTL,1,0,0,0,0,0,1
19980121-W-Australian_Open-R64-Serena_Williams-Venus_Williams,1,F-XC,51,10,3,2,5,17,34
19980121-W-Australian_Open-R64-Serena_Williams-Venus_Williams,1,F-DTM,13,0,0,0,0,5,8
19980121-W-Australian_Open-R64-Serena_Williams-Venus_Williams,1,F-DTL,8,2,1,0,1,1,7
19980121-W-Australian_Open-R64-Serena_Williams-Venus_Williams,1,F-IO,8,4,3,0,1,4,4
19980121-W-Australian_Open-R64-Serena_Williams-Venus_Williams,1,F-II,1,1,0,0,1,0,1
19980121-W-Australian_Open-R64-Serena_Williams-Venus_Williams,1,B-XC,47,9,2,1,6,18,29
19980121-W-Australian_Open-R64-Serena_Williams-Venus_Williams,1,B-DTM,44,3,0,0,3,20,24
19980121-W-Australian_Open-R64-Serena_Williams-Venus_Williams,1,B-DTL,14,5,2,2,1,4,10
19980121-W-Australian_Open-R64-Serena_Williams-Venus_Williams,1,B-IO,7,1,0,0,1,1,6
19980121-W-Australian_Open-R64-Serena_Williams-Venus_Williams,1,S-XC,8,2,0,0,2,1,7
19980121-W-Australian_Open-R64-Serena_Williams-Venus_Williams,1,S-DTM,2,0,0,0,0,2,0
19980121-W-Australian_Open-R64-Serena_Williams-Venus_Williams,2,F-XC,34,10,4,3,3,27,7
19980121-W-Australian_Open-R64-Serena_Williams-Venus_Williams,2,F-DTM,32,3,0,0,3,19,13
19980121-W-Australian_Open-R64-Serena_Williams-Venus_Williams,2,F-DTL,21,2,1,1,0,13,8
19980121-W-Australian_Open-R64-Serena_Williams-Venus_Williams,2,F-IO,14,3,0,1,2,8,6
19980121-W-Australian_Open-R64-Serena_Williams-Venus_Williams,2,F-II,1,1,1,0,0,1,0
19980121-W-Australian_Open-R64-Serena_Williams-Venus_Williams,2,B-XC,47,7,2,1,4,29,18
19980121-W-Australian_Open-R64-Serena_Williams-Venus_Williams,2,B-DTM,27,1,0,0,1,12,15
19980121-W-Australian_Open-R64-Serena_Williams-Venus_Williams,2,B-DTL,10,3,1,0,2,6,4
19980121-W-Australian_Open-R64-Serena_Williams-Venus_Williams,2,B-IO,13,7,2,2,3,8,5
19980121-W-Australian_Open-R64-Serena_Williams-Venus_Williams,2,S-XC,2,0,0,0,0,2,0
20210203-W-Gippsland_Trophy-R16-Jasmine_Paolini-Karolina_Muchova,1,F-XC,44,18,7,1,10,22,22
20210203-W-Gippsland_Trophy-R16-Jasmine_Paolini-Karolina_Muchova,1,F-DTM,27,4,1,1,2,16,11
20210203-W-Gippsland_Trophy-R16-Jasmine_Paolini-Karolina_Muchova,1,F-DTL,6,3,1,1,1,4,2
20210203-W-Gippsland_Trophy-R16-Jasmine_Paolini-Karolina_Muchova,1,F-IO,26,6,2,0,4,15,11
20210203-W-Gippsland_Trophy-R16-Jasmine_Paolini-Karolina_Muchova,1,F-II,1,0,0,0,0,1,0
20210203-W-Gippsland_Trophy-R16-Jasmine_Paolini-Karolina_Muchova,1,B-XC,27,6,1,1,4,15,12
20210203-W-Gippsland_Trophy-R16-Jasmine_Paolini-Karolina_Muchova,1,B-DTM,28,2,0,1,1,16,12
20210203-W-Gippsland_Trophy-R16-Jasmine_Paolini-Karolina_Muchova,1,B-DTL,3,1,0,0,1,1,2
20210203-W-Gippsland_Trophy-R16-Jasmine_Paolini-Karolina_Muchova,1,B-IO,1,1,0,1,0,1,0
20210203-W-Gippsland_Trophy-R16-Jasmine_Paolini-Karolina_Muchova,1,S-DTM,4,0,0,0,0,0,4
20210203-W-Gippsland_Trophy-R16-Jasmine_Paolini-Karolina_Muchova,2,F-XC,29,11,2,6,3,17,12
20210203-W-Gippsland_Trophy-R16-Jasmine_Paolini-Karolina_Muchova,2,F-DTM,20,4,0,0,4,5,15
20210203-W-Gippsland_Trophy-R16-Jasmine_Paolini-Karolina_Muchova,2,F-DTL,8,5,2,1,2,6,2
20210203-W-Gippsland_Trophy-R16-Jasmine_Paolini-Karolina_Muchova,2,F-IO,18,7,1,2,4,9,9
20210203-W-Gippsland_Trophy-R16-Jasmine_Paolini-Karolina_Muchova,2,F-II,1,1,0,0,1,0,1
20210203-W-Gippsland_Trophy-R16-Jasmine_Paolini-Karolina_Muchova,2,B-XC,18,8,0,1,7,7,11
20210203-W-Gippsland_Trophy-R16-Jasmine_Paolini-Karolina_Muchova,2,B-DTM,39,2,0,0,2,15,24
20210203-W-Gippsland_Trophy-R16-Jasmine_Paolini-Karolina_Muchova,2,B-DTL,5,3,1,1,1,2,3
20210203-W-Gippsland_Trophy-R16-Jasmine_Paolini-Karolina_Muchova,2,B-IO,2,1,0,0,1,1,1
20210203-W-Gippsland_Trophy-R16-Jasmine_Paolini-Karolina_Muchova,2,S-XC,4,2,0,1,1,1,3
20210203-W-Gippsland_Trophy-R16-Jasmine_Paolini-Karolina_Muchova,2,S-DTM,9,1,0,0,1,4,5
20210203-W-Gippsland_Trophy-R16-Jasmine_Paolini-Karolina_Muchova,2,S-DTL,2,1,0,1,0,1,1
20210203-W-Gippsland_Trophy-R16-Jasmine_Paolini-Karolina_Muchova,2,S-IO,1,1,0,1,0,1,0
20210203-W-Grampians_Trophy-R32-Sorana_Cirstea-Oksana_Kalashnikova,1,F-XC,6,3,2,0,1,3,3
20210203-W-Grampians_Trophy-R32-Sorana_Cirstea-Oksana_Kalashnikova,1,F-DTM,2,1,0,0,1,1,1
20210203-W-Grampians_Trophy-R32-Sorana_Cirstea-Oksana_Kalashnikova,1,F-DTL,2,1,1,0,0,1,1
20210203-W-Grampians_Trophy-R32-Sorana_Cirstea-Oksana_Kalashnikova,1,F-IO,3,0,0,0,0,2,1
20210203-W-Grampians_Trophy-R32-Sorana_Cirstea-Oksana_Kalashnikova,1,B-XC,6,4,1,1,2,4,2
20210203-W-Grampians_Trophy-R32-Sorana_Cirstea-Oksana_Kalashnikova,1,B-DTM,6,0,0,0,0,3,3
20210203-W-Grampians_Trophy-R32-Sorana_Cirstea-Oksana_Kalashnikova,1,B-DTL,3,2,1,1,0,3,0
20210203-W-Grampians_Trophy-R32-Sorana_Cirstea-Oksana_Kalashnikova,1,B-IO,1,0,0,0,0,0,1
20210203-W-Grampians_Trophy-R32-Sorana_Cirstea-Oksana_Kalashnikova,2,F-XC,5,3,1,1,1,2,3
20210203-W-Grampians_Trophy-R32-Sorana_Cirstea-Oksana_Kalashnikova,2,F-DTM,5,1,0,0,1,3,2
20210203-W-Grampians_Trophy-R32-Sorana_Cirstea-Oksana_Kalashnikova,2,F-DTL,7,7,1,2,4,3,4
20210203-W-Grampians_Trophy-R32-Sorana_Cirstea-Oksana_Kalashnikova,2,F-IO,5,5,3,0,2,3,2
20210203-W-Grampians_Trophy-R32-Sorana_Cirstea-Oksana_Kalashnikova,2,B-XC,5,2,0,1,1,2,3
20210203-W-Grampians_Trophy-R32-Sorana_Cirstea-Oksana_Kalashnikova,2,B-DTM,8,2,0,0,2,3,5
20210203-W-Grampians_Trophy-R32-Sorana_Cirstea-Oksana_Kalashnikova,2,B-DTL,2,2,0,1,1,1,1
20210203-W-Grampians_Trophy-R32-Sorana_Cirstea-Oksana_Kalashnikova,2,S-IO,1,1,0,0,1,0,1
20210203-W-Grampians_Trophy-R32-Marta_Kostyuk-Gabriela_Dabrowski,1,F-XC,28,7,1,2,4,15,13
20210203-W-Grampians_Trophy-R32-Marta_Kostyuk-Gabriela_Dabrowski,1,F-DTM,25,2,1,1,0,14,11
20210203-W-Grampians_Trophy-R32-Marta_Kostyuk-Gabriela_Dabrowski,1,F-DTL,6,2,1,0,1,4,2
20210203-W-Grampians_Trophy-R32-Marta_Kostyuk-Gabriela_Dabrowski,1,F-IO,14,4,3,0,1,8,6
20210203-W-Grampians_Trophy-R32-Marta_Kostyuk-Gabriela_Dabrowski,1,B-XC,15,3,1,1,1,9,6
20210203-W-Grampians_Trophy-R32-Marta_Kostyuk-Gabriela_Dabrowski,1,B-DTM,13,0,0,0,0,8,5
20210203-W-Grampians_Trophy-R32-Marta_Kostyuk-Gabriela_Dabrowski,1,B-DTL,7,2,1,1,0,4,3
20210203-W-Grampians_Trophy-R32-Marta_Kostyuk-Gabriela_Dabrowski,1,B-IO,5,2,1,0,1,3,2
20210203-W-Grampians_Trophy-R32-Marta_Kostyuk-Gabriela_Dabrowski,1,S-DTM,3,0,0,0,0,2,1
20210203-W-Grampians_Trophy-R32-Marta_Kostyuk-Gabriela_Dabrowski,1,S-IO,1,0,0,0,0,1,0
20210203-W-Grampians_Trophy-R32-Marta_Kostyuk-Gabriela_Dabrowski,2,F-XC,15,5,1,0,4,4,11
20210203-W-Grampians_Trophy-R32-Marta_Kostyuk-Gabriela_Dabrowski,2,F-DTM,18,0,0,0,0,8,10
20210203-W-Grampians_Trophy-R32-Marta_Kostyuk-Gabriela_Dabrowski,2,F-DTL,4,2,0,0,2,0,4
20210203-W-Grampians_Trophy-R32-Marta_Kostyuk-Gabriela_Dabrowski,2,F-IO,5,4,0,1,3,1,4
20210203-W-Grampians_Trophy-R32-Marta_Kostyuk-Gabriela_Dabrowski,2,B-XC,10,1,0,0,1,5,5
20210203-W-Grampians_Trophy-R32-Marta_Kostyuk-Gabriela_Dabrowski,2,B-DTM,15,0,0,0,0,6,9
20210203-W-Grampians_Trophy-R32-Marta_Kostyuk-Gabriela_Dabrowski,2,B-DTL,10,4,3,0,1,8,2
20210203-W-Grampians_Trophy-R32-Marta_Kostyuk-Gabriela_Dabrowski,2,B-IO,11,1,1,0,0,6,5
20210203-W-Grampians_Trophy-R32-Marta_Kostyuk-Gabriela_Dabrowski,2,S-XC,4,0,0,0,0,1,3
20210203-W-Grampians_Trophy-R32-Marta_Kostyuk-Gabriela_Dabrowski,2,S-DTM,3,1,0,1,0,1,2
20210203-W-Grampians_Trophy-R32-Marta_Kostyuk-Gabriela_Dabrowski,2,S-IO,1,0,0,0,0,0,1
20080602-W-Roland_Garros-R16-Dinara_Safina-Maria_Sharapova,1,F-XC,84,14,2,8,4,51,33
20080602-W-Roland_Garros-R16-Dinara_Safina-Maria_Sharapova,1,F-DTM,32,1,1,0,0,16,16
20080602-W-Roland_Garros-R16-Dinara_Safina-Maria_Sharapova,1,F-DTL,22,9,4,2,3,12,10
20080602-W-Roland_Garros-R16-Dinara_Safina-Maria_Sharapova,1,F-IO,13,6,1,0,5,6,7
20080602-W-Roland_Garros-R16-Dinara_Safina-Maria_Sharapova,1,F-II,1,1,1,0,0,1,0
20080602-W-Roland_Garros-R16-Dinara_Safina-Maria_Sharapova,1,B-XC,69,10,3,2,5,25,44
20080602-W-Roland_Garros-R16-Dinara_Safina-Maria_Sharapova,1,B-DTM,42,4,0,1,3,23,19
20080602-W-Roland_Garros-R16-Dinara_Safina-Maria_Sharapova,1,B-DTL,13,9,4,0,5,7,6
20080602-W-Roland_Garros-R16-Dinara_Safina-Maria_Sharapova,1,B-IO,8,3,0,0,3,2,6
20080602-W-Roland_Garros-R16-Dinara_Safina-Maria_Sharapova,1,S-XC,2,0,0,0,0,0,2
20080602-W-Roland_Garros-R16-Dinara_Safina-Maria_Sharapova,1,S-DTM,3,1,0,0,1,1,2
20080602-W-Roland_Garros-R16-Dinara_Safina-Maria_Sharapova,1,S-DTL,1,0,0,0,0,0,1
20080602-W-Roland_Garros-R16-Dinara_Safina-Maria_Sharapova,2,F-XC,86,15,2,4,9,38,48
20080602-W-Roland_Garros-R16-Dinara_Safina-Maria_Sharapova,2,F-DTM,31,2,0,0,2,13,18
20080602-W-Roland_Garros-R16-Dinara_Safina-Maria_Sharapova,2,F-DTL,26,14,6,4,4,13,13
20080602-W-Roland_Garros-R16-Dinara_Safina-Maria_Sharapova,2,F-IO,21,5,3,0,2,12,9
20080602-W-Roland_Garros-R16-Dinara_Safina-Maria_Sharapova,2,F-II,3,0,0,0,0,3,0
20080602-W-Roland_Garros-R16-Dinara_Safina-Maria_Sharapova,2,B-XC,71,17,2,8,7,45,26
20080602-W-Roland_Garros-R16-Dinara_Safina-Maria_Sharapova,2,B-DTM,38,2,0,2,0,23,15
20080602-W-Roland_Garros-R16-Dinara_Safina-Maria_Sharapova,2,B-DTL,25,13,5,4,4,14,11
20080602-W-Roland_Garros-R16-Dinara_Safina-Maria_Sharapova,2,B-IO,9,2,1,0,1,4,5
20080602-W-Roland_Garros-R16-Dinara_Safina-Maria_Sharapova,2,S-XC,3,1,0,0,1,1,2
20080602-W-Roland_Garros-R16-Dinara_Safina-Maria_Sharapova,2,S-DTL,1,0,0,0,0,0,1
20190516-W-Rome-R16-Venus_Williams-Johanna_Konta,1,F-XC,14,6,4,1,1,6,8
20190516-W-Rome-R16-Venus_Williams-Johanna_Konta,1,F-DTM,5,0,0,0,0,3,2
20190516-W-Rome-R16-Venus_Williams-Johanna_Konta,1,F-IO,4,1,0,0,1,0,4
20190516-W-Rome-R16-Venus_Williams-Johanna_Konta,1,F-II,1,0,0,0,0,0,1
20190516-W-Rome-R16-Venus_Williams-Johanna_Konta,1,B-XC,16,5,0,3,2,8,8
20190516-W-Rome-R16-Venus_Williams-Johanna_Konta,1,B-DTM,18,3,0,2,1,5,13
20190516-W-Rome-R16-Venus_Williams-Johanna_Konta,1,B-DTL,4,2,2,0,0,3,1
20190516-W-Rome-R16-Venus_Williams-Johanna_Konta,1,B-IO,3,0,0,0,0,1,2
20190516-W-Rome-R16-Venus_Williams-Johanna_Konta,1,S-XC,2,0,0,0,0,1,1
20190516-W-Rome-R16-Venus_Williams-Johanna_Konta,2,F-XC,22,15,9,3,3,17,5
20190516-W-Rome-R16-Venus_Williams-Johanna_Konta,2,F-DTM,8,0,0,0,0,6,2
20190516-W-Rome-R16-Venus_Williams-Johanna_Konta,2,F-DTL,5,2,2,0,0,3,2
20190516-W-Rome-R16-Venus_Williams-Johanna_Konta,2,F-IO,6,3,2,0,1,5,1
20190516-W-Rome-R16-Venus_Williams-Johanna_Konta,2,B-XC,16,6,2,2,2,9,7
20190516-W-Rome-R16-Venus_Williams-Johanna_Konta,2,B-DTM,6,3,1,1,1,3,3
20190516-W-Rome-R16-Venus_Williams-Johanna_Konta,2,B-DTL,8,7,4,0,3,5,3
20190516-W-Rome-R16-Venus_Williams-Johanna_Konta,2,B-IO,1,1,1,0,0,1,0
20190516-W-Rome-R16-Venus_Williams-Johanna_Konta,2,S-DTM,1,0,0,0,0,0,1
20190516-W-Rome-R16-Venus_Williams-Johanna_Konta,2,S-DTL,1,0,0,0,0,0,1
20210202-W-Yarra_Valley_Classic-R32-Marie_Bouzkova-Aliona_Bolsova,1,F-XC,68,13,4,3,6,39,29
20210202-W-Yarra_Valley_Classic-R32-Marie_Bouzkova-Aliona_Bolsova,1,F-DTM,45,1,0,0,1,23,22
20210202-W-Yarra_Valley_Classic-R32-Marie_Bouzkova-Aliona_Bolsova,1,F-DTL,15,2,1,0,1,8,7
20210202-W-Yarra_Valley_Classic-R32-Marie_Bouzkova-Aliona_Bolsova,1,F-IO,41,7,3,0,4,25,16
20210202-W-Yarra_Valley_Classic-R32-Marie_Bouzkova-Aliona_Bolsova,1,B-XC,91,7,1,1,5,51,40
20210202-W-Yarra_Valley_Classic-R32-Marie_Bouzkova-Aliona_Bolsova,1,B-DTM,45,1,0,0,1,28,17
20210202-W-Yarra_Valley_Classic-R32-Marie_Bouzkova-Aliona_Bolsova,1,B-DTL,12,9,2,1,6,4,8
20210202-W-Yarra_Valley_Classic-R32-Marie_Bouzkova-Aliona_Bolsova,1,B-IO,10,1,1,0,0,6,4
20210202-W-Yarra_Valley_Classic-R32-Marie_Bouzkova-Aliona_Bolsova,1,S-XC,7,0,0,0,0,1,6
20210202-W-Yarra_Valley_Classic-R32-Marie_Bouzkova-Aliona_Bolsova,1,S-DTM,5,0,0,0,0,2,3
20210202-W-Yarra_Valley_Classic-R32-Marie_Bouzkova-Aliona_Bolsova,1,S-DTL,3,0,0,0,0,2,1
20210202-W-Yarra_Valley_Classic-R32-Marie_Bouzkova-Aliona_Bolsova,1,S-IO,1,0,0,0,0,1,0
20210202-W-Yarra_Valley_Classic-R32-Marie_Bouzkova-Aliona_Bolsova,2,F-XC,50,12,5,2,5,28,22
20210202-W-Yarra_Valley_Classic-R32-Marie_Bouzkova-Aliona_Bolsova,2,F-DTM,45,1,0,0,1,20,25
20210202-W-Yarra_Valley_Classic-R32-Marie_Bouzkova-Aliona_Bolsova,2,F-DTL,31,12,1,4,7,13,18
20210202-W-Yarra_Valley_Classic-R32-Marie_Bouzkova-Aliona_Bolsova,2,F-IO,38,9,4,2,3,23,15
20210202-W-Yarra_Valley_Classic-R32-Marie_Bouzkova-Aliona_Bolsova,2,F-II,1,1,0,0,1,0,1
20210202-W-Yarra_Valley_Classic-R32-Marie_Bouzkova-Aliona_Bolsova,2,B-XC,53,10,3,1,6,26,27
20210202-W-Yarra_Valley_Classic-R32-Marie_Bouzkova-Aliona_Bolsova,2,B-DTM,64,3,0,0,3,29,35
20210202-W-Yarra_Valley_Classic-R32-Marie_Bouzkova-Aliona_Bolsova,2,B-DTL,22,8,3,0,5,10,12
20210202-W-Yarra_Valley_Classic-R32-Marie_Bouzkova-Aliona_Bolsova,2,B-IO,18,9,2,2,5,6,12
20210202-W-Yarra_Valley_Classic-R32-Marie_Bouzkova-Aliona_Bolsova,2,S-XC,9,0,0,0,0,2,7
20210202-W-Yarra_Valley_Classic-R32-Marie_Bouzkova-Aliona_Bolsova,2,S-DTM,26,0,0,0,0,10,16
20210202-W-Yarra_Valley_Classic-R32-Marie_Bouzkova-Aliona_Bolsova,2,S-DTL,9,0,0,0,0,4,5
20210202-W-Yarra_Valley_Classic-R32-Marie_Bouzkova-Aliona_Bolsova,2,S-IO,5,0,0,0,0,0,5
20210205-W-Yarra_Valley_Classic-QF-Sofia_Kenin-Garbine_Muguruza,1,F-XC,45,12,3,3,6,21,24
20210205-W-Yarra_Valley_Classic-QF-Sofia_Kenin-Garbine_Muguruza,1,F-DTM,15,2,1,1,0,6,9
20210205-W-Yarra_Valley_Classic-QF-Sofia_Kenin-Garbine_Muguruza,1,F-DTL,11,4,2,1,1,8,3
20210205-W-Yarra_Valley_Classic-QF-Sofia_Kenin-Garbine_Muguruza,1,F-IO,6,3,0,0,3,1,5
20210205-W-Yarra_Valley_Classic-QF-Sofia_Kenin-Garbine_Muguruza,1,B-XC,28,7,3,1,3,12,16
20210205-W-Yarra_Valley_Classic-QF-Sofia_Kenin-Garbine_Muguruza,1,B-DTM,13,2,0,1,1,6,7
20210205-W-Yarra_Valley_Classic-QF-Sofia_Kenin-Garbine_Muguruza,1,B-DTL,7,3,2,1,0,6,1
20210205-W-Yarra_Valley_Classic-QF-Sofia_Kenin-Garbine_Muguruza,1,B-IO,9,2,1,0,1,5,4
20210205-W-Yarra_Valley_Classic-QF-Sofia_Kenin-Garbine_Muguruza,1,S-XC,1,0,0,0,0,0,1
20210205-W-Yarra_Valley_Classic-QF-Sofia_Kenin-Garbine_Muguruza,1,S-DTM,2,1,0,1,0,1,1
20210205-W-Yarra_Valley_Classic-QF-Sofia_Kenin-Garbine_Muguruza,2,F-XC,30,8,2,2,4,15,15
20210205-W-Yarra_Valley_Classic-QF-Sofia_Kenin-Garbine_Muguruza,2,F-DTM,17,2,0,1,1,8,9
20210205-W-Yarra_Valley_Classic-QF-Sofia_Kenin-Garbine_Muguruza,2,F-DTL,11,6,3,2,1,8,3
20210205-W-Yarra_Valley_Classic-QF-Sofia_Kenin-Garbine_Muguruza,2,F-IO,10,2,0,1,1,7,3
20210205-W-Yarra_Valley_Classic-QF-Sofia_Kenin-Garbine_Muguruza,2,B-XC,16,5,2,2,1,10,6
20210205-W-Yarra_Valley_Classic-QF-Sofia_Kenin-Garbine_Muguruza,2,B-DTM,18,3,0,2,1,11,7
20210205-W-Yarra_Valley_Classic-QF-Sofia_Kenin-Garbine_Muguruza,2,B-DTL,12,4,0,3,1,6,6
20210205-W-Yarra_Valley_Classic-QF-Sofia_Kenin-Garbine_Muguruza,2,B-IO,5,2,1,1,0,2,3
20210205-W-Yarra_Valley_Classic-QF-Sofia_Kenin-Garbine_Muguruza,2,S-DTM,2,0,0,0,0,2,0
20210205-W-Yarra_Valley_Classic-QF-Sofia_Kenin-Garbine_Muguruza,2,S-IO,1,0,0,0,0,1,0
20200929-W-Roland_Garros-R128-Danielle_Collins-Monica_Niculescu,1,F-XC,50,16,4,3,9,25,25
20200929-W-Roland_Garros-R128-Danielle_Collins-Monica_Niculescu,1,F-DTM,13,1,0,1,0,8,5
20200929-W-Roland_Garros-R128-Danielle_Collins-Monica_Niculescu,1,F-DTL,12,7,0,1,6,4,8
20200929-W-Roland_Garros-R128-Danielle_Collins-Monica_Niculescu,1,F-IO,18,12,8,0,4,12,6
20200929-W-Roland_Garros-R128-Danielle_Collins-Monica_Niculescu,1,F-II,4,4,3,1,0,4,0
20200929-W-Roland_Garros-R128-Danielle_Collins-Monica_Niculescu,1,B-XC,46,11,7,1,3,26,20
20200929-W-Roland_Garros-R128-Danielle_Collins-Monica_Niculescu,1,B-DTM,13,2,1,0,1,6,7
20200929-W-Roland_Garros-R128-Danielle_Collins-Monica_Niculescu,1,B-DTL,11,7,2,0,5,5,6
20200929-W-Roland_Garros-R128-Danielle_Collins-Monica_Niculescu,1,B-IO,9,7,6,0,1,7,2
20200929-W-Roland_Garros-R128-Danielle_Collins-Monica_Niculescu,1,S-DTM,1,0,0,0,0,0,1
20200929-W-Roland_Garros-R128-Danielle_Collins-Monica_Niculescu,1,S-DTL,1,0,0,0,0,0,1
20200929-W-Roland_Garros-R128-Danielle_Collins-Monica_Niculescu,2,F-DTM,3,0,0,0,0,0,3
20200929-W-Roland_Garros-R128-Danielle_Collins-Monica_Niculescu,2,F-DTL,5,2,2,0,0,3,2
20200929-W-Roland_Garros-R128-Danielle_Collins-Monica_Niculescu,2,B-XC,19,6,1,2,3,8,11
20200929-W-Roland_Garros-R128-Danielle_Collins-Monica_Niculescu,2,B-DTM,31,2,0,1,1,15,16
20200929-W-Roland_Garros-R128-Danielle_Collins-Monica_Niculescu,2,B-DTL,6,4,3,1,0,5,1
20200929-W-Roland_Garros-R128-Danielle_Collins-Monica_Niculescu,2,B-IO,4,2,2,0,0,3,1
20200929-W-Roland_Garros-R128-Danielle_Collins-Monica_Niculescu,2,S-XC,4,0,0,0,0,3,1
20200929-W-Roland_Garros-R128-Danielle_Collins-Monica_Niculescu,2,S-DTM,5,0,0,0,0,0,5
20200929-W-Roland_Garros-R128-Danielle_Collins-Monica_Niculescu,2,S-IO,1,0,0,0,0,1,0
20210206-W-Grampians_Trophy-QF-Sorana_Cirstea-Ann_Li,1,F-XC,20,7,0,5,2,8,12
20210206-W-Grampians_Trophy-QF-Sorana_Cirstea-Ann_Li,1,F-DTM,11,0,0,0,0,7,4
20210206-W-Grampians_Trophy-QF-Sorana_Cirstea-Ann_Li,1,F-DTL,10,5,1,2,2,5,5
20210206-W-Grampians_Trophy-QF-Sorana_Cirstea-Ann_Li,1,F-IO,5,3,1,1,1,2,3
20210206-W-Grampians_Trophy-QF-Sorana_Cirstea-Ann_Li,1,B-XC,7,1,0,1,0,6,1
20210206-W-Grampians_Trophy-QF-Sorana_Cirstea-Ann_Li,1,B-DTM,4,0,0,0,0,0,4
20210206-W-Grampians_Trophy-QF-Sorana_Cirstea-Ann_Li,1,B-DTL,6,4,1,2,1,3,3
20210206-W-Grampians_Trophy-QF-Sorana_Cirstea-Ann_Li,1,B-IO,5,3,0,0,3,1,4
20210206-W-Grampians_Trophy-QF-Sorana_Cirstea-Ann_Li,2,F-XC,19,5,2,3,0,13,6
20210206-W-Grampians_Trophy-QF-Sorana_Cirstea-Ann_Li,2,F-DTM,8,1,0,0,1,3,5
20210206-W-Grampians_Trophy-QF-Sorana_Cirstea-Ann_Li,2,F-DTL,3,3,1,0,2,1,2
20210206-W-Grampians_Trophy-QF-Sorana_Cirstea-Ann_Li,2,F-IO,3,1,1,0,0,2,1
20210206-W-Grampians_Trophy-QF-Sorana_Cirstea-Ann_Li,2,B-XC,8,4,1,2,1,5,3
20210206-W-Grampians_Trophy-QF-Sorana_Cirstea-Ann_Li,2,B-DTM,8,2,0,1,1,5,3
20210206-W-Grampians_Trophy-QF-Sorana_Cirstea-Ann_Li,2,B-DTL,2,1,0,0,1,1,1
20210206-W-Grampians_Trophy-QF-Sorana_Cirstea-Ann_Li,2,B-IO,3,0,0,0,0,2,1
20210206-W-Grampians_Trophy-QF-Sorana_Cirstea-Ann_Li,2,S-XC,2,0,0,0,0,2,0
20210206-W-Grampians_Trophy-QF-Sorana_Cirstea-Ann_Li,2,S-DTM,2,1,0,1,0,1,1
20210206-W-Grampians_Trophy-QF-Sorana_Cirstea-Ann_Li,2,S-DTL,2,1,1,0,0,1,1
20210203-W-Yarra_Valley_Classic-R16-Petra_Kvitova-Nadia_Podoroska,1,F-XC,61,25,5,9,11,37,24
20210203-W-Yarra_Valley_Classic-R16-Petra_Kvitova-Nadia_Podoroska,1,F-DTM,28,4,1,1,2,16,12
20210203-W-Yarra_Valley_Classic-R16-Petra_Kvitova-Nadia_Podoroska,1,F-DTL,8,6,1,0,5,2,6
20210203-W-Yarra_Valley_Classic-R16-Petra_Kvitova-Nadia_Podoroska,1,F-IO,16,7,4,0,3,10,6
20210203-W-Yarra_Valley_Classic-R16-Petra_Kvitova-Nadia_Podoroska,1,F-II,1,1,0,1,0,1,0
20210203-W-Yarra_Valley_Classic-R16-Petra_Kvitova-Nadia_Podoroska,1,B-XC,29,12,2,4,6,20,9
20210203-W-Yarra_Valley_Classic-R16-Petra_Kvitova-Nadia_Podoroska,1,B-DTM,17,2,0,2,0,11,6
20210203-W-Yarra_Valley_Classic-R16-Petra_Kvitova-Nadia_Podoroska,1,B-DTL,12,8,5,1,2,8,4
20210203-W-Yarra_Valley_Classic-R16-Petra_Kvitova-Nadia_Podoroska,1,B-IO,17,9,2,2,5,11,6
20210203-W-Yarra_Valley_Classic-R16-Petra_Kvitova-Nadia_Podoroska,1,S-XC,1,0,0,0,0,1,0
20210203-W-Yarra_Valley_Classic-R16-Petra_Kvitova-Nadia_Podoroska,1,S-IO,1,0,0,0,0,1,0
20210203-W-Yarra_Valley_Classic-R16-Petra_Kvitova-Nadia_Podoroska,2,F-XC,31,7,1,3,3,12,19
20210203-W-Yarra_Valley_Classic-R16-Petra_Kvitova-Nadia_Podoroska,2,F-DTM,31,1,0,0,1,9,22
20210203-W-Yarra_Valley_Classic-R16-Petra_Kvitova-Nadia_Podoroska,2,F-DTL,11,5,2,1,2,4,7
20210203-W-Yarra_Valley_Classic-R16-Petra_Kvitova-Nadia_Podoroska,2,F-IO,20,11,5,3,3,10,10
20210203-W-Yarra_Valley_Classic-R16-Petra_Kvitova-Nadia_Podoroska,2,F-II,4,2,1,0,1,1,3
20210203-W-Yarra_Valley_Classic-R16-Petra_Kvitova-Nadia_Podoroska,2,B-XC,31,10,4,3,3,15,16
20210203-W-Yarra_Valley_Classic-R16-Petra_Kvitova-Nadia_Podoroska,2,B-DTM,28,2,0,0,2,14,14
20210203-W-Yarra_Valley_Classic-R16-Petra_Kvitova-Nadia_Podoroska,2,B-DTL,7,4,1,0,3,2,5
20210203-W-Yarra_Valley_Classic-R16-Petra_Kvitova-Nadia_Podoroska,2,B-IO,3,1,0,0,1,0,3
20210203-W-Yarra_Valley_Classic-R16-Petra_Kvitova-Nadia_Podoroska,2,S-XC,1,0,0,0,0,0,1
20210203-W-Yarra_Valley_Classic-R16-Petra_Kvitova-Nadia_Podoroska,2,S-DTM,4,0,0,0,0,0,4
20210203-W-Yarra_Valley_Classic-R16-Petra_Kvitova-Nadia_Podoroska,2,S-DTL,1,0,0,0,0,0,1
20210208-W-Australian_Open-R128-Iga_Swiatek-Arantxa_Rus,1,F-XC,49,17,5,4,8,28,21
20210208-W-Australian_Open-R128-Iga_Swiatek-Arantxa_Rus,1,F-DTM,24,0,0,0,0,15,9
20210208-W-Australian_Open-R128-Iga_Swiatek-Arantxa_Rus,1,F-DTL,7,2,1,1,0,6,1
20210208-W-Australian_Open-R128-Iga_Swiatek-Arantxa_Rus,1,F-IO,12,3,0,1,2,7,5
20210208-W-Australian_Open-R128-Iga_Swiatek-Arantxa_Rus,1,F-II,2,2,1,0,1,1,1
20210208-W-Australian_Open-R128-Iga_Swiatek-Arantxa_Rus,1,B-XC,33,7,2,3,2,18,15
20210208-W-Australian_Open-R128-Iga_Swiatek-Arantxa_Rus,1,B-DTM,21,0,0,0,0,12,9
20210208-W-Australian_Open-R128-Iga_Swiatek-Arantxa_Rus,1,B-DTL,6,3,2,0,1,5,1
20210208-W-Australian_Open-R128-Iga_Swiatek-Arantxa_Rus,1,B-IO,7,3,1,1,1,5,2
20210208-W-Australian_Open-R128-Iga_Swiatek-Arantxa_Rus,1,S-DTM,3,0,0,0,0,2,1
20210208-W-Australian_Open-R128-Iga_Swiatek-Arantxa_Rus,1,S-DTL,1,0,0,0,0,0,1
20210208-W-Australian_Open-R128-Iga_Swiatek-Arantxa_Rus,2,F-XC,49,9,2,0,7,18,31
20210208-W-Australian_Open-R128-Iga_Swiatek-Arantxa_Rus,2,F-DTM,29,3,0,2,1,11,18
20210208-W-Australian_Open-R128-Iga_Swiatek-Arantxa_Rus,2,F-DTL,8,2,0,0,2,1,7
20210208-W-Australian_Open-R128-Iga_Swiatek-Arantxa_Rus,2,F-IO,16,6,3,0,3,6,10
20210208-W-Australian_Open-R128-Iga_Swiatek-Arantxa_Rus,2,F-II,2,2,2,0,0,2,0
20210208-W-Australian_Open-R128-Iga_Swiatek-Arantxa_Rus,2,B-XC,25,8,4,1,3,13,12
20210208-W-Australian_Open-R128-Iga_Swiatek-Arantxa_Rus,2,B-DTM,38,6,0,0,6,18,20
20210208-W-Australian_Open-R128-Iga_Swiatek-Arantxa_Rus,2,B-DTL,10,3,2,0,1,5,5
20210208-W-Australian_Open-R128-Iga_Swiatek-Arantxa_Rus,2,B-IO,7,3,0,0,3,3,4
20210208-W-Australian_Open-R128-Iga_Swiatek-Arantxa_Rus,2,S-XC,2,0,0,0,0,0,2
20210208-W-Australian_Open-R128-Iga_Swiatek-Arantxa_Rus,2,S-DTM,3,0,0,0,0,1,2
20210208-W-Australian_Open-R128-Iga_Swiatek-Arantxa_Rus,2,S-DTL,2,1,0,1,0,1,1
20210207-W-Australian_Open-R128-Bianca_Andreescu-Mihaela_Buzarnescu,1,F-XC,38,12,2,2,8,22,16
20210207-W-Australian_Open-R128-Bianca_Andreescu-Mihaela_Buzarnescu,1,F-DTM,35,4,0,1,3,18,17
20210207-W-Australian_Open-R128-Bianca_Andreescu-Mihaela_Buzarnescu,1,F-DTL,7,2,2,0,0,7,0
20210207-W-Australian_Open-R128-Bianca_Andreescu-Mihaela_Buzarnescu,1,F-IO,19,12,8,1,3,15,4
20210207-W-Australian_Open-R128-Bianca_Andreescu-Mihaela_Buzarnescu,1,B-XC,26,6,2,2,2,16,10
20210207-W-Australian_Open-R128-Bianca_Andreescu-Mihaela_Buzarnescu,1,B-DTM,41,9,1,1,7,15,26
20210207-W-Australian_Open-R128-Bianca_Andreescu-Mihaela_Buzarnescu,1,B-DTL,10,6,0,1,5,3,7
20210207-W-Australian_Open-R128-Bianca_Andreescu-Mihaela_Buzarnescu,1,B-IO,11,3,1,0,2,3,8
20210207-W-Australian_Open-R128-Bianca_Andreescu-Mihaela_Buzarnescu,1,S-DTM,13,0,0,0,0,7,6
20210207-W-Australian_Open-R128-Bianca_Andreescu-Mihaela_Buzarnescu,1,S-DTL,4,1,0,0,1,2,2
20210207-W-Australian_Open-R128-Bianca_Andreescu-Mihaela_Buzarnescu,1,S-IO,2,0,0,0,0,1,1
20210207-W-Australian_Open-R128-Bianca_Andreescu-Mihaela_Buzarnescu,2,F-XC,58,6,1,1,4,30,28
20210207-W-Australian_Open-R128-Bianca_Andreescu-Mihaela_Buzarnescu,2,F-DTM,34,1,0,0,1,18,16
20210207-W-Australian_Open-R128-Bianca_Andreescu-Mihaela_Buzarnescu,2,F-DTL,4,3,1,0,2,1,3
20210207-W-Australian_Open-R128-Bianca_Andreescu-Mihaela_Buzarnescu,2,F-IO,2,1,1,0,0,2,0
20210207-W-Australian_Open-R128-Bianca_Andreescu-Mihaela_Buzarnescu,2,B-XC,50,8,2,3,3,25,25
20210207-W-Australian_Open-R128-Bianca_Andreescu-Mihaela_Buzarnescu,2,B-DTM,37,7,0,2,5,20,17
20210207-W-Australian_Open-R128-Bianca_Andreescu-Mihaela_Buzarnescu,2,B-DTL,3,2,1,0,1,2,1
20210207-W-Australian_Open-R128-Bianca_Andreescu-Mihaela_Buzarnescu,2,B-IO,9,5,2,1,2,6,3
20210207-W-Australian_Open-R128-Bianca_Andreescu-Mihaela_Buzarnescu,2,S-XC,1,0,0,0,0,0,1
20210207-W-Australian_Open-R128-Bianca_Andreescu-Mihaela_Buzarnescu,2,S-DTM,10,2,0,0,2,1,9
20210207-W-Australian_Open-R128-Bianca_Andreescu-Mihaela_Buzarnescu,2,S-DTL,1,0,0,0,0,1,0
20210208-W-Australian_Open-R128-Tsvetana_Pironkova-Su_Wei_Hsieh,1,F-XC,32,4,0,0,4,11,21
20210208-W-Australian_Open-R128-Tsvetana_Pironkova-Su_Wei_Hsieh,1,F-DTM,26,3,0,0,3,11,15
20210208-W-Australian_Open-R128-Tsvetana_Pironkova-Su_Wei_Hsieh,1,F-DTL,7,1,0,1,0,4,3
20210208-W-Australian_Open-R128-Tsvetana_Pironkova-Su_Wei_Hsieh,1,F-IO,6,3,1,0,2,2,4
20210208-W-Australian_Open-R128-Tsvetana_Pironkova-Su_Wei_Hsieh,1,B-XC,25,8,3,3,2,15,10
20210208-W-Australian_Open-R128-Tsvetana_Pironkova-Su_Wei_Hsieh,1,B-DTM,17,1,0,0,1,5,12
20210208-W-Australian_Open-R128-Tsvetana_Pironkova-Su_Wei_Hsieh,1,B-DTL,6,4,1,2,1,3,3
20210208-W-Australian_Open-R128-Tsvetana_Pironkova-Su_Wei_Hsieh,1,B-IO,11,4,3,0,1,6,5
20210208-W-Australian_Open-R128-Tsvetana_Pironkova-Su_Wei_Hsieh,1,S-XC,1,0,0,0,0,1,0
20210208-W-Australian_Open-R128-Tsvetana_Pironkova-Su_Wei_Hsieh,1,S-DTM,1,0,0,0,0,0,1
20210208-W-Australian_Open-R128-Tsvetana_Pironkova-Su_Wei_Hsieh,1,S-DTL,1,0,0,0,0,0,1
20210208-W-Australian_Open-R128-Tsvetana_Pironkova-Su_Wei_Hsieh,2,F-XC,40,7,2,0,5,20,20
20210208-W-Australian_Open-R128-Tsvetana_Pironkova-Su_Wei_Hsieh,2,F-DTM,18,1,0,0,1,12,6
20210208-W-Australian_Open-R128-Tsvetana_Pironkova-Su_Wei_Hsieh,2,F-DTL,5,4,1,2,1,4,1
20210208-W-Australian_Open-R128-Tsvetana_Pironkova-Su_Wei_Hsieh,2,F-IO,9,5,1,1,3,4,5
20210208-W-Australian_Open-R128-Tsvetana_Pironkova-Su_Wei_Hsieh,2,B-XC,19,6,3,1,2,12,7
20210208-W-Australian_Open-R128-Tsvetana_Pironkova-Su_Wei_Hsieh,2,B-DTM,24,3,0,0,3,13,11
20210208-W-Australian_Open-R128-Tsvetana_Pironkova-Su_Wei_Hsieh,2,B-DTL,13,7,2,1,4,7,6
20210208-W-Australian_Open-R128-Tsvetana_Pironkova-Su_Wei_Hsieh,2,B-IO,5,1,1,0,0,2,3
20210208-W-Australian_Open-R128-Tsvetana_Pironkova-Su_Wei_Hsieh,2,S-DTM,2,0,0,0,0,2,0
20210208-W-Australian_Open-R128-Tsvetana_Pironkova-Su_Wei_Hsieh,2,S-DTL,2,1,0,0,1,1,1
20210208-W-Australian_Open-R128-Tsvetana_Pironkova-Su_Wei_Hsieh,2,S-IO,2,0,0,0,0,2,0
20210210-W-Australian_Open-R64-Bianca_Andreescu-Su_Wei_Hsieh,1,F-XC,24,11,3,5,3,14,10
20210210-W-Australian_Open-R64-Bianca_Andreescu-Su_Wei_Hsieh,1,F-DTM,23,2,0,0,2,11,12
20210210-W-Australian_Open-R64-Bianca_Andreescu-Su_Wei_Hsieh,1,F-DTL,5,0,0,0,0,2,3
20210210-W-Australian_Open-R64-Bianca_Andreescu-Su_Wei_Hsieh,1,F-IO,20,3,1,1,1,12,8
20210210-W-Australian_Open-R64-Bianca_Andreescu-Su_Wei_Hsieh,1,F-II,2,1,0,0,1,1,1
20210210-W-Australian_Open-R64-Bianca_Andreescu-Su_Wei_Hsieh,1,B-XC,19,4,1,0,3,8,11
20210210-W-Australian_Open-R64-Bianca_Andreescu-Su_Wei_Hsieh,1,B-DTM,17,4,0,3,1,8,9
20210210-W-Australian_Open-R64-Bianca_Andreescu-Su_Wei_Hsieh,1,B-DTL,8,3,1,0,2,2,6
20210210-W-Australian_Open-R64-Bianca_Andreescu-Su_Wei_Hsieh,1,B-IO,4,0,0,0,0,4,0
20210210-W-Australian_Open-R64-Bianca_Andreescu-Su_Wei_Hsieh,1,S-XC,2,1,0,1,0,1,1
20210210-W-Australian_Open-R64-Bianca_Andreescu-Su_Wei_Hsieh,1,S-DTM,7,0,0,0,0,1,6
20210210-W-Australian_Open-R64-Bianca_Andreescu-Su_Wei_Hsieh,2,F-XC,28,8,2,5,1,17,11
20210210-W-Australian_Open-R64-Bianca_Andreescu-Su_Wei_Hsieh,2,F-DTM,11,0,0,0,0,5,6
20210210-W-Australian_Open-R64-Bianca_Andreescu-Su_Wei_Hsieh,2,F-DTL,2,0,0,0,0,1,1
20210210-W-Australian_Open-R64-Bianca_Andreescu-Su_Wei_Hsieh,2,F-IO,18,7,2,2,3,13,5
20210210-W-Australian_Open-R64-Bianca_Andreescu-Su_Wei_Hsieh,2,B-XC,22,2,1,1,0,13,9
20210210-W-Australian_Open-R64-Bianca_Andreescu-Su_Wei_Hsieh,2,B-DTM,29,1,0,1,0,14,15
20210210-W-Australian_Open-R64-Bianca_Andreescu-Su_Wei_Hsieh,2,B-DTL,1,1,0,0,1,0,1
20210210-W-Australian_Open-R64-Bianca_Andreescu-Su_Wei_Hsieh,2,B-IO,3,2,0,1,1,2,1
20210210-W-Australian_Open-R64-Bianca_Andreescu-Su_Wei_Hsieh,2,S-XC,2,0,0,0,0,2,0
20210210-W-Australian_Open-R64-Bianca_Andreescu-Su_Wei_Hsieh,2,S-DTM,6,0,0,0,0,0,6
20210210-W-Australian_Open-R64-Bianca_Andreescu-Su_Wei_Hsieh,2,S-DTL,1,0,0,0,0,1,0
20210208-W-Australian_Open-R128-Serena_Williams-Laura_Siegemund,1,F-XC,15,8,3,3,2,9,6
20210208-W-Australian_Open-R128-Serena_Williams-Laura_Siegemund,1,F-DTM,5,0,0,0,0,4,1
20210208-W-Australian_Open-R128-Serena_Williams-Laura_Siegemund,1,F-DTL,2,0,0,0,0,0,2
20210208-W-Australian_Open-R128-Serena_Williams-Laura_Siegemund,1,F-IO,5,2,0,1,1,3,2
20210208-W-Australian_Open-R128-Serena_Williams-Laura_Siegemund,1,B-XC,17,4,2,0,2,7,10
20210208-W-Australian_Open-R128-Serena_Williams-Laura_Siegemund,1,B-DTM,9,1,0,1,0,5,4
20210208-W-Australian_Open-R128-Serena_Williams-Laura_Siegemund,1,B-DTL,9,6,2,3,1,8,1
20210208-W-Australian_Open-R128-Serena_Williams-Laura_Siegemund,1,B-IO,6,2,0,1,1,5,1
20210208-W-Australian_Open-R128-Serena_Williams-Laura_Siegemund,1,S-DTM,1,0,0,0,0,0,1
20210208-W-Australian_Open-R128-Serena_Williams-Laura_Siegemund,1,S-IO,1,0,0,0,0,1,0
20210208-W-Australian_Open-R128-Serena_Williams-Laura_Siegemund,2,F-XC,12,5,0,2,3,7,5
20210208-W-Australian_Open-R128-Serena_Williams-Laura_Siegemund,2,F-DTM,8,1,0,0,1,3,5
20210208-W-Australian_Open-R128-Serena_Williams-Laura_Siegemund,2,F-DTL,6,0,0,0,0,1,5
20210208-W-Australian_Open-R128-Serena_Williams-Laura_Siegemund,2,F-IO,6,2,0,0,2,1,5
20210208-W-Australian_Open-R128-Serena_Williams-Laura_Siegemund,2,B-XC,15,4,1,3,0,11,4
20210208-W-Australian_Open-R128-Serena_Williams-Laura_Siegemund,2,B-DTM,8,0,0,0,0,3,5
20210208-W-Australian_Open-R128-Serena_Williams-Laura_Siegemund,2,B-DTL,3,1,0,0,1,0,3
20210208-W-Australian_Open-R128-Serena_Williams-Laura_Siegemund,2,B-IO,2,1,0,0,1,1,1
20210208-W-Australian_Open-R128-Serena_Williams-Laura_Siegemund,2,S-XC,1,0,0,0,0,0,1
20210208-W-Australian_Open-R128-Serena_Williams-Laura_Siegemund,2,S-DTM,3,1,0,1,0,1,2
20210211-W-Australian_Open-R32-Naomi_Osaka-Ons_Jabeur,1,F-XC,24,9,2,1,6,12,12
20210211-W-Australian_Open-R32-Naomi_Osaka-Ons_Jabeur,1,F-DTM,7,2,0,0,2,3,4
20210211-W-Australian_Open-R32-Naomi_Osaka-Ons_Jabeur,1,F-DTL,5,4,0,0,4,1,4
20210211-W-Australian_Open-R32-Naomi_Osaka-Ons_Jabeur,1,F-IO,7,4,4,0,0,6,1
20210211-W-Australian_Open-R32-Naomi_Osaka-Ons_Jabeur,1,B-XC,29,9,2,1,6,14,15
20210211-W-Australian_Open-R32-Naomi_Osaka-Ons_Jabeur,1,B-DTM,7,0,0,0,0,2,5
20210211-W-Australian_Open-R32-Naomi_Osaka-Ons_Jabeur,1,B-DTL,6,2,1,1,0,4,2
20210211-W-Australian_Open-R32-Naomi_Osaka-Ons_Jabeur,1,B-IO,11,4,1,3,0,6,5
20210211-W-Australian_Open-R32-Naomi_Osaka-Ons_Jabeur,1,S-DTM,1,0,0,0,0,0,1
20210211-W-Australian_Open-R32-Naomi_Osaka-Ons_Jabeur,2,F-XC,17,6,1,2,3,11,6
20210211-W-Australian_Open-R32-Naomi_Osaka-Ons_Jabeur,2,F-DTM,16,3,0,0,3,7,9
20210211-W-Australian_Open-R32-Naomi_Osaka-Ons_Jabeur,2,F-DTL,4,2,0,0,2,2,2
20210211-W-Australian_Open-R32-Naomi_Osaka-Ons_Jabeur,2,F-IO,4,3,1,1,1,2,2
20210211-W-Australian_Open-R32-Naomi_Osaka-Ons_Jabeur,2,F-II,2,2,2,0,0,2,0
20210211-W-Australian_Open-R32-Naomi_Osaka-Ons_Jabeur,2,B-XC,8,1,0,1,0,4,4
20210211-W-Australian_Open-R32-Naomi_Osaka-Ons_Jabeur,2,B-DTM,5,1,0,0,1,0,5
20210211-W-Australian_Open-R32-Naomi_Osaka-Ons_Jabeur,2,B-DTL,7,4,1,0,3,3,4
20210211-W-Australian_Open-R32-Naomi_Osaka-Ons_Jabeur,2,S-XC,5,1,0,1,0,4,1
20210211-W-Australian_Open-R32-Naomi_Osaka-Ons_Jabeur,2,S-DTM,6,1,0,0,1,0,6
20210211-W-Australian_Open-R32-Naomi_Osaka-Ons_Jabeur,2,S-DTL,1,1,0,0,1,0,1
20210211-W-Australian_Open-R32-Naomi_Osaka-Ons_Jabeur,2,S-IO,1,0,0,0,0,1,0
20210211-W-Australian_Open-R32-Anastasia_Potapova-Serena_Williams,1,F-XC,51,11,3,2,6,25,26
20210211-W-Australian_Open-R32-Anastasia_Potapova-Serena_Williams,1,F-DTM,17,2,0,0,2,9,8
20210211-W-Australian_Open-R32-Anastasia_Potapova-Serena_Williams,1,F-DTL,17,4,2,0,2,10,7
20210211-W-Australian_Open-R32-Anastasia_Potapova-Serena_Williams,1,F-IO,11,4,1,1,2,6,5
20210211-W-Australian_Open-R32-Anastasia_Potapova-Serena_Williams,1,B-XC,32,7,3,1,3,18,14
20210211-W-Australian_Open-R32-Anastasia_Potapova-Serena_Williams,1,B-DTM,17,3,0,0,3,8,9
20210211-W-Australian_Open-R32-Anastasia_Potapova-Serena_Williams,1,B-DTL,9,4,2,0,2,3,6
20210211-W-Australian_Open-R32-Anastasia_Potapova-Serena_Williams,1,B-IO,3,0,0,0,0,2,1
20210211-W-Australian_Open-R32-Anastasia_Potapova-Serena_Williams,1,S-XC,1,1,0,0,1,0,1
20210211-W-Australian_Open-R32-Anastasia_Potapova-Serena_Williams,1,S-DTM,1,0,0,0,0,0,1
20210211-W-Australian_Open-R32-Anastasia_Potapova-Serena_Williams,2,F-XC,44,12,4,3,5,24,20
20210211-W-Australian_Open-R32-Anastasia_Potapova-Serena_Williams,2,F-DTM,21,2,0,0,2,11,10
20210211-W-Australian_Open-R32-Anastasia_Potapova-Serena_Williams,2,F-DTL,11,4,0,1,3,5,6
20210211-W-Australian_Open-R32-Anastasia_Potapova-Serena_Williams,2,F-IO,5,3,1,0,2,2,3
20210211-W-Australian_Open-R32-Anastasia_Potapova-Serena_Williams,2,B-XC,33,7,0,0,7,11,22
20210211-W-Australian_Open-R32-Anastasia_Potapova-Serena_Williams,2,B-DTM,26,3,0,1,2,14,12
20210211-W-Australian_Open-R32-Anastasia_Potapova-Serena_Williams,2,B-DTL,5,0,0,0,0,3,2
20210211-W-Australian_Open-R32-Anastasia_Potapova-Serena_Williams,2,B-IO,13,4,1,0,3,5,8
20210211-W-Australian_Open-R32-Anastasia_Potapova-Serena_Williams,2,S-DTM,3,0,0,0,0,2,1
20210211-W-Australian_Open-R32-Anastasia_Potapova-Serena_Williams,2,S-DTL,2,0,0,0,0,0,2
20210213-W-Australian_Open-R32-Karolina_Pliskova-Karolina_Muchova,1,F-XC,37,17,6,5,6,21,16
20210213-W-Australian_Open-R32-Karolina_Pliskova-Karolina_Muchova,1,F-DTM,20,2,0,0,2,9,11
20210213-W-Australian_Open-R32-Karolina_Pliskova-Karolina_Muchova,1,F-DTL,7,3,1,1,1,4,3
20210213-W-Australian_Open-R32-Karolina_Pliskova-Karolina_Muchova,1,F-IO,27,6,1,1,4,15,12
20210213-W-Australian_Open-R32-Karolina_Pliskova-Karolina_Muchova,1,B-XC,30,5,0,2,3,16,14
20210213-W-Australian_Open-R32-Karolina_Pliskova-Karolina_Muchova,1,B-DTM,33,2,0,1,1,16,17
20210213-W-Australian_Open-R32-Karolina_Pliskova-Karolina_Muchova,1,B-DTL,3,3,1,1,1,2,1
20210213-W-Australian_Open-R32-Karolina_Pliskova-Karolina_Muchova,1,B-IO,5,3,1,0,2,1,4
20210213-W-Australian_Open-R32-Karolina_Pliskova-Karolina_Muchova,1,S-XC,3,0,0,0,0,3,0
20210213-W-Australian_Open-R32-Karolina_Pliskova-Karolina_Muchova,1,S-DTM,2,0,0,0,0,0,2
20210213-W-Australian_Open-R32-Karolina_Pliskova-Karolina_Muchova,2,F-XC,21,7,2,4,1,14,7
20210213-W-Australian_Open-R32-Karolina_Pliskova-Karolina_Muchova,2,F-DTM,21,4,0,1,3,9,12
20210213-W-Australian_Open-R32-Karolina_Pliskova-Karolina_Muchova,2,F-DTL,10,5,2,1,2,6,4
20210213-W-Australian_Open-R32-Karolina_Pliskova-Karolina_Muchova,2,F-IO,23,8,0,1,7,9,14
20210213-W-Australian_Open-R32-Karolina_Pliskova-Karolina_Muchova,2,F-II,3,3,3,0,0,3,0
20210213-W-Australian_Open-R32-Karolina_Pliskova-Karolina_Muchova,2,B-XC,23,7,2,0,5,8,15
20210213-W-Australian_Open-R32-Karolina_Pliskova-Karolina_Muchova,2,B-DTM,35,5,0,1,4,18,17
20210213-W-Australian_Open-R32-Karolina_Pliskova-Karolina_Muchova,2,B-DTL,6,6,2,1,3,3,3
20210213-W-Australian_Open-R32-Karolina_Pliskova-Karolina_Muchova,2,B-IO,3,1,0,0,1,1,2
20210213-W-Australian_Open-R32-Karolina_Pliskova-Karolina_Muchova,2,S-XC,7,0,0,0,0,2,5
20210213-W-Australian_Open-R32-Karolina_Pliskova-Karolina_Muchova,2,S-DTM,14,0,0,0,0,5,9
20210213-W-Australian_Open-R32-Karolina_Pliskova-Karolina_Muchova,2,S-DTL,1,1,0,0,1,0,1
20210213-W-Australian_Open-R32-Karolina_Pliskova-Karolina_Muchova,2,S-IO,1,0,0,0,0,0,1
20210215-W-Phillip_Island_Trophy-R32-Madison_Brengle-Bianca_Andreescu,1,F-XC,37,5,1,1,3,20,17
20210215-W-Phillip_Island_Trophy-R32-Madison_Brengle-Bianca_Andreescu,1,F-DTM,44,3,0,0,3,25,19
20210215-W-Phillip_Island_Trophy-R32-Madison_Brengle-Bianca_Andreescu,1,F-DTL,13,0,0,0,0,8,5
20210215-W-Phillip_Island_Trophy-R32-Madison_Brengle-Bianca_Andreescu,1,F-IO,17,0,0,0,0,10,7
20210215-W-Phillip_Island_Trophy-R32-Madison_Brengle-Bianca_Andreescu,1,B-XC,70,20,9,6,5,42,28
20210215-W-Phillip_Island_Trophy-R32-Madison_Brengle-Bianca_Andreescu,1,B-DTM,68,2,0,0,2,39,29
20210215-W-Phillip_Island_Trophy-R32-Madison_Brengle-Bianca_Andreescu,1,B-DTL,14,8,3,2,3,9,5
20210215-W-Phillip_Island_Trophy-R32-Madison_Brengle-Bianca_Andreescu,1,B-IO,12,1,0,1,0,10,2
20210215-W-Phillip_Island_Trophy-R32-Madison_Brengle-Bianca_Andreescu,1,S-XC,9,1,1,0,0,4,5
20210215-W-Phillip_Island_Trophy-R32-Madison_Brengle-Bianca_Andreescu,1,S-DTM,7,0,0,0,0,2,5
20210215-W-Phillip_Island_Trophy-R32-Madison_Brengle-Bianca_Andreescu,2,F-XC,69,23,9,3,11,34,35
20210215-W-Phillip_Island_Trophy-R32-Madison_Brengle-Bianca_Andreescu,2,F-DTM,39,2,0,0,2,17,22
20210215-W-Phillip_Island_Trophy-R32-Madison_Brengle-Bianca_Andreescu,2,F-DTL,14,9,1,2,6,7,7
20210215-W-Phillip_Island_Trophy-R32-Madison_Brengle-Bianca_Andreescu,2,F-IO,46,19,11,3,5,25,21
20210215-W-Phillip_Island_Trophy-R32-Madison_Brengle-Bianca_Andreescu,2,B-XC,61,14,4,6,4,34,27
20210215-W-Phillip_Island_Trophy-R32-Madison_Brengle-Bianca_Andreescu,2,B-DTM,48,10,0,0,10,13,35
20210215-W-Phillip_Island_Trophy-R32-Madison_Brengle-Bianca_Andreescu,2,B-DTL,12,6,1,3,2,8,4
20210215-W-Phillip_Island_Trophy-R32-Madison_Brengle-Bianca_Andreescu,2,B-IO,14,8,3,1,4,6,8
20210215-W-Phillip_Island_Trophy-R32-Madison_Brengle-Bianca_Andreescu,2,S-XC,4,0,0,0,0,2,2
20210215-W-Phillip_Island_Trophy-R32-Madison_Brengle-Bianca_Andreescu,2,S-DTM,17,2,0,0,2,5,12
20210215-W-Phillip_Island_Trophy-R32-Madison_Brengle-Bianca_Andreescu,2,S-DTL,5,3,0,1,2,2,3
20210215-W-Phillip_Island_Trophy-R32-Madison_Brengle-Bianca_Andreescu,2,S-IO,7,1,0,0,1,2,5
20210216-W-Phillip_Island_Trophy-R16-Zarina_Diyas-Bianca_Andreescu,1,F-XC,4,2,0,1,1,3,1
20210216-W-Phillip_Island_Trophy-R16-Zarina_Diyas-Bianca_Andreescu,1,F-DTM,8,2,0,0,2,2,6
20210216-W-Phillip_Island_Trophy-R16-Zarina_Diyas-Bianca_Andreescu,1,F-DTL,1,0,0,0,0,0,1
20210216-W-Phillip_Island_Trophy-R16-Zarina_Diyas-Bianca_Andreescu,1,F-IO,4,3,0,0,3,1,3
20210216-W-Phillip_Island_Trophy-R16-Zarina_Diyas-Bianca_Andreescu,1,B-XC,4,0,0,0,0,0,4
20210216-W-Phillip_Island_Trophy-R16-Zarina_Diyas-Bianca_Andreescu,1,B-DTM,15,5,0,0,5,4,11
20210216-W-Phillip_Island_Trophy-R16-Zarina_Diyas-Bianca_Andreescu,1,B-IO,4,0,0,0,0,1,3
20210216-W-Phillip_Island_Trophy-R16-Zarina_Diyas-Bianca_Andreescu,1,S-XC,2,2,0,0,2,0,2
20210216-W-Phillip_Island_Trophy-R16-Zarina_Diyas-Bianca_Andreescu,2,F-XC,12,4,2,1,1,9,3
20210216-W-Phillip_Island_Trophy-R16-Zarina_Diyas-Bianca_Andreescu,2,F-DTM,10,2,0,0,2,5,5
20210216-W-Phillip_Island_Trophy-R16-Zarina_Diyas-Bianca_Andreescu,2,F-DTL,2,1,0,0,1,1,1
20210216-W-Phillip_Island_Trophy-R16-Zarina_Diyas-Bianca_Andreescu,2,F-IO,3,0,0,0,0,2,1
20210216-W-Phillip_Island_Trophy-R16-Zarina_Diyas-Bianca_Andreescu,2,B-XC,5,1,0,1,0,3,2
20210216-W-Phillip_Island_Trophy-R16-Zarina_Diyas-Bianca_Andreescu,2,B-DTM,5,0,0,0,0,5,0
20210216-W-Phillip_Island_Trophy-R16-Zarina_Diyas-Bianca_Andreescu,2,B-IO,3,2,1,0,1,2,1
20210217-W-Australian_Open-QF-Ashleigh_Barty-Karolina_Muchova,1,F-XC,39,17,6,3,8,21,18
20210217-W-Australian_Open-QF-Ashleigh_Barty-Karolina_Muchova,1,F-DTM,24,4,0,2,2,9,15
20210217-W-Australian_Open-QF-Ashleigh_Barty-Karolina_Muchova,1,F-DTL,2,1,1,0,0,1,1
20210217-W-Australian_Open-QF-Ashleigh_Barty-Karolina_Muchova,1,F-IO,16,5,1,1,3,7,9
20210217-W-Australian_Open-QF-Ashleigh_Barty-Karolina_Muchova,1,F-II,5,2,0,1,1,2,3
20210217-W-Australian_Open-QF-Ashleigh_Barty-Karolina_Muchova,1,B-XC,18,3,1,1,1,11,7
20210217-W-Australian_Open-QF-Ashleigh_Barty-Karolina_Muchova,1,B-DTM,26,2,0,0,2,10,16
20210217-W-Australian_Open-QF-Ashleigh_Barty-Karolina_Muchova,1,B-DTL,4,0,0,0,0,3,1
20210217-W-Australian_Open-QF-Ashleigh_Barty-Karolina_Muchova,1,B-IO,1,1,0,0,1,0,1
20210217-W-Australian_Open-QF-Ashleigh_Barty-Karolina_Muchova,1,S-XC,32,1,0,0,1,21,11
20210217-W-Australian_Open-QF-Ashleigh_Barty-Karolina_Muchova,1,S-DTM,21,4,0,1,3,8,13
20210217-W-Australian_Open-QF-Ashleigh_Barty-Karolina_Muchova,1,S-DTL,2,0,0,0,0,0,2
20210217-W-Australian_Open-QF-Ashleigh_Barty-Karolina_Muchova,1,S-IO,2,0,0,0,0,2,0
20210217-W-Australian_Open-QF-Ashleigh_Barty-Karolina_Muchova,2,F-XC,26,6,1,3,2,14,12
20210217-W-Australian_Open-QF-Ashleigh_Barty-Karolina_Muchova,2,F-DTM,20,2,0,0,2,12,8
20210217-W-Australian_Open-QF-Ashleigh_Barty-Karolina_Muchova,2,F-DTL,18,10,2,3,5,10,8
20210217-W-Australian_Open-QF-Ashleigh_Barty-Karolina_Muchova,2,F-IO,35,11,2,4,5,17,18
20210217-W-Australian_Open-QF-Ashleigh_Barty-Karolina_Muchova,2,F-II,3,2,0,1,1,1,2
20210217-W-Australian_Open-QF-Ashleigh_Barty-Karolina_Muchova,2,B-XC,23,3,0,1,2,10,13
20210217-W-Australian_Open-QF-Ashleigh_Barty-Karolina_Muchova,2,B-DTM,19,2,0,0,2,9,10
20210217-W-Australian_Open-QF-Ashleigh_Barty-Karolina_Muchova,2,B-DTL,2,2,0,0,2,0,2
20210217-W-Australian_Open-QF-Ashleigh_Barty-Karolina_Muchova,2,B-IO,6,3,0,3,0,5,1
20210217-W-Australian_Open-QF-Ashleigh_Barty-Karolina_Muchova,2,S-XC,18,0,0,0,0,8,10
20210217-W-Australian_Open-QF-Ashleigh_Barty-Karolina_Muchova,2,S-DTM,13,2,0,1,1,5,8
20210217-W-Australian_Open-QF-Ashleigh_Barty-Karolina_Muchova,2,S-DTL,2,0,0,0,0,0,2
20210217-W-Australian_Open-QF-Ashleigh_Barty-Karolina_Muchova,2,S-IO,1,0,0,0,0,1,0
20210217-W-Australian_Open-QF-Jennifer_Brady-Jessica_Pegula,1,F-XC,38,11,4,5,2,22,16
20210217-W-Australian_Open-QF-Jennifer_Brady-Jessica_Pegula,1,F-DTM,25,2,0,2,0,17,8
20210217-W-Australian_Open-QF-Jennifer_Brady-Jessica_Pegula,1,F-DTL,7,2,2,0,0,3,4
20210217-W-Australian_Open-QF-Jennifer_Brady-Jessica_Pegula,1,F-IO,18,6,2,2,2,10,8
20210217-W-Australian_Open-QF-Jennifer_Brady-Jessica_Pegula,1,F-II,1,0,0,0,0,1,0
20210217-W-Australian_Open-QF-Jennifer_Brady-Jessica_Pegula,1,B-XC,31,4,0,2,2,16,15
20210217-W-Australian_Open-QF-Jennifer_Brady-Jessica_Pegula,1,B-DTM,24,4,0,1,3,12,12
20210217-W-Australian_Open-QF-Jennifer_Brady-Jessica_Pegula,1,B-DTL,15,1,1,0,0,6,9
20210217-W-Australian_Open-QF-Jennifer_Brady-Jessica_Pegula,1,B-IO,6,1,0,0,1,3,3
20210217-W-Australian_Open-QF-Jennifer_Brady-Jessica_Pegula,1,S-XC,2,0,0,0,0,1,1
20210217-W-Australian_Open-QF-Jennifer_Brady-Jessica_Pegula,1,S-DTM,10,0,0,0,0,4,6
20210217-W-Australian_Open-QF-Jennifer_Brady-Jessica_Pegula,1,S-DTL,3,2,0,2,0,2,1
20210217-W-Australian_Open-QF-Jennifer_Brady-Jessica_Pegula,2,F-XC,40,8,0,5,3,19,21
20210217-W-Australian_Open-QF-Jennifer_Brady-Jessica_Pegula,2,F-DTM,26,2,0,1,1,12,14
20210217-W-Australian_Open-QF-Jennifer_Brady-Jessica_Pegula,2,F-DTL,12,3,1,1,1,6,6
20210217-W-Australian_Open-QF-Jennifer_Brady-Jessica_Pegula,2,F-IO,17,9,5,1,3,10,7
20210217-W-Australian_Open-QF-Jennifer_Brady-Jessica_Pegula,2,B-XC,39,9,1,3,5,18,21
20210217-W-Australian_Open-QF-Jennifer_Brady-Jessica_Pegula,2,B-DTM,31,6,0,4,2,13,18
20210217-W-Australian_Open-QF-Jennifer_Brady-Jessica_Pegula,2,B-DTL,5,4,1,1,2,2,3
20210217-W-Australian_Open-QF-Jennifer_Brady-Jessica_Pegula,2,B-IO,4,2,1,1,0,3,1
20210217-W-Australian_Open-QF-Jennifer_Brady-Jessica_Pegula,2,S-XC,8,2,0,2,0,4,4
20210217-W-Australian_Open-QF-Jennifer_Brady-Jessica_Pegula,2,S-DTM,6,0,0,0,0,4,2
20210217-W-Australian_Open-QF-Jennifer_Brady-Jessica_Pegula,2,S-DTL,2,0,0,0,0,1,1
20210218-W-Australian_Open-SF-Jennifer_Brady-Karolina_Muchova,1,F-XC,27,12,3,4,5,15,12
20210218-W-Australian_Open-SF-Jennifer_Brady-Karolina_Muchova,1,F-DTM,24,2,0,0,2,8,16
20210218-W-Australian_Open-SF-Jennifer_Brady-Karolina_Muchova,1,F-DTL,1,0,0,0,0,1,0
20210218-W-Australian_Open-SF-Jennifer_Brady-Karolina_Muchova,1,F-IO,37,14,3,2,9,20,17
20210218-W-Australian_Open-SF-Jennifer_Brady-Karolina_Muchova,1,B-XC,26,2,2,0,0,14,12
20210218-W-Australian_Open-SF-Jennifer_Brady-Karolina_Muchova,1,B-DTM,36,8,0,1,7,15,21
20210218-W-Australian_Open-SF-Jennifer_Brady-Karolina_Muchova,1,B-DTL,9,5,0,1,4,2,7
20210218-W-Australian_Open-SF-Jennifer_Brady-Karolina_Muchova,1,B-IO,5,2,0,1,1,3,2
20210218-W-Australian_Open-SF-Jennifer_Brady-Karolina_Muchova,1,S-XC,2,0,0,0,0,1,1
20210218-W-Australian_Open-SF-Jennifer_Brady-Karolina_Muchova,1,S-DTM,3,1,0,0,1,1,2
20210218-W-Australian_Open-SF-Jennifer_Brady-Karolina_Muchova,1,S-DTL,2,1,0,1,0,1,1
20210218-W-Australian_Open-SF-Jennifer_Brady-Karolina_Muchova,2,F-XC,23,9,3,4,2,18,5
20210218-W-Australian_Open-SF-Jennifer_Brady-Karolina_Muchova,2,F-DTM,27,5,0,0,5,16,11
20210218-W-Australian_Open-SF-Jennifer_Brady-Karolina_Muchova,2,F-DTL,9,5,0,1,4,4,5
20210218-W-Australian_Open-SF-Jennifer_Brady-Karolina_Muchova,2,F-IO,22,10,4,2,4,13,9
20210218-W-Australian_Open-SF-Jennifer_Brady-Karolina_Muchova,2,F-II,1,1,0,1,0,1,0
20210218-W-Australian_Open-SF-Jennifer_Brady-Karolina_Muchova,2,B-XC,22,5,1,0,4,9,13
20210218-W-Australian_Open-SF-Jennifer_Brady-Karolina_Muchova,2,B-DTM,33,4,0,0,4,16,17
20210218-W-Australian_Open-SF-Jennifer_Brady-Karolina_Muchova,2,B-DTL,3,2,1,0,1,1,2
20210218-W-Australian_Open-SF-Jennifer_Brady-Karolina_Muchova,2,B-IO,1,0,0,0,0,1,0
20210218-W-Australian_Open-SF-Jennifer_Brady-Karolina_Muchova,2,S-XC,6,1,0,0,1,2,4
20210218-W-Australian_Open-SF-Jennifer_Brady-Karolina_Muchova,2,S-DTM,13,1,0,1,0,9,4
20010331-W-Miami-F-Jennifer_Capriati-Venus_Williams,1,F-XC,51,7,0,3,4,23,28
20010331-W-Miami-F-Jennifer_Capriati-Venus_Williams,1,F-DTM,61,5,0,1,4,16,45
20010331-W-Miami-F-Jennifer_Capriati-Venus_Williams,1,F-DTL,7,2,1,1,0,3,4
20010331-W-Miami-F-Jennifer_Capriati-Venus_Williams,1,F-IO,22,10,0,2,8,8,14
20010331-W-Miami-F-Jennifer_Capriati-Venus_Williams,1,F-II,2,1,0,1,0,1,1
20010331-W-Miami-F-Jennifer_Capriati-Venus_Williams,1,B-XC,31,8,3,4,1,19,12
20010331-W-Miami-F-Jennifer_Capriati-Venus_Williams,1,B-DTM,63,3,0,1,2,33,30
20010331-W-Miami-F-Jennifer_Capriati-Venus_Williams,1,B-DTL,15,5,2,1,2,9,6
20010331-W-Miami-F-Jennifer_Capriati-Venus_Williams,1,B-IO,10,2,0,0,2,6,4
20010331-W-Miami-F-Jennifer_Capriati-Venus_Williams,1,S-XC,3,0,0,0,0,2,1
20010331-W-Miami-F-Jennifer_Capriati-Venus_Williams,1,S-DTM,6,0,0,0,0,2,4
20010331-W-Miami-F-Jennifer_Capriati-Venus_Williams,1,S-DTL,3,0,0,0,0,0,3
20010331-W-Miami-F-Jennifer_Capriati-Venus_Williams,2,F-XC,52,9,3,1,5,33,19
20010331-W-Miami-F-Jennifer_Capriati-Venus_Williams,2,F-DTM,43,2,0,0,2,22,21
20010331-W-Miami-F-Jennifer_Capriati-Venus_Williams,2,F-DTL,23,8,1,1,6,11,12
20010331-W-Miami-F-Jennifer_Capriati-Venus_Williams,2,F-IO,27,6,0,2,4,10,17
20010331-W-Miami-F-Jennifer_Capriati-Venus_Williams,2,B-XC,44,4,0,2,2,22,22
20010331-W-Miami-F-Jennifer_Capriati-Venus_Williams,2,B-DTM,36,5,0,0,5,16,20
20010331-W-Miami-F-Jennifer_Capriati-Venus_Williams,2,B-DTL,14,4,1,2,1,9,5
20010331-W-Miami-F-Jennifer_Capriati-Venus_Williams,2,B-IO,9,2,0,0,2,5,4
20010331-W-Miami-F-Jennifer_Capriati-Venus_Williams,2,S-XC,1,0,0,0,0,0,1
20010331-W-Miami-F-Jennifer_Capriati-Venus_Williams,2,S-DTM,2,0,0,0,0,1,1
20210218-W-Australian_Open-SF-Naomi_Osaka-Serena_Williams,1,F-XC,21,8,3,2,3,15,6
20210218-W-Australian_Open-SF-Naomi_Osaka-Serena_Williams,1,F-DTM,9,1,1,0,0,4,5
20210218-W-Australian_Open-SF-Naomi_Osaka-Serena_Williams,1,F-DTL,7,4,2,1,1,5,2
20210218-W-Australian_Open-SF-Naomi_Osaka-Serena_Williams,1,F-IO,10,6,2,0,4,4,6
20210218-W-Australian_Open-SF-Naomi_Osaka-Serena_Williams,1,B-XC,17,4,2,1,1,12,5
20210218-W-Australian_Open-SF-Naomi_Osaka-Serena_Williams,1,B-DTM,15,2,0,0,2,12,3
20210218-W-Australian_Open-SF-Naomi_Osaka-Serena_Williams,1,B-DTL,9,5,3,2,0,8,1
20210218-W-Australian_Open-SF-Naomi_Osaka-Serena_Williams,1,B-IO,5,3,1,0,2,3,2
20210218-W-Australian_Open-SF-Naomi_Osaka-Serena_Williams,1,S-DTM,1,0,0,0,0,0,1
20210218-W-Australian_Open-SF-Naomi_Osaka-Serena_Williams,2,F-XC,14,7,0,1,6,4,10
20210218-W-Australian_Open-SF-Naomi_Osaka-Serena_Williams,2,F-DTM,12,1,0,0,1,4,8
20210218-W-Australian_Open-SF-Naomi_Osaka-Serena_Williams,2,F-DTL,5,2,0,0,2,1,4
20210218-W-Australian_Open-SF-Naomi_Osaka-Serena_Williams,2,F-IO,4,3,2,0,1,2,2
20210218-W-Australian_Open-SF-Naomi_Osaka-Serena_Williams,2,B-XC,25,7,0,2,5,9,16
20210218-W-Australian_Open-SF-Naomi_Osaka-Serena_Williams,2,B-DTM,22,1,0,0,1,7,15
20210218-W-Australian_Open-SF-Naomi_Osaka-Serena_Williams,2,B-DTL,6,3,2,1,0,3,3
20210218-W-Australian_Open-SF-Naomi_Osaka-Serena_Williams,2,B-IO,3,0,0,0,0,1,2
20210218-W-Australian_Open-SF-Naomi_Osaka-Serena_Williams,2,S-XC,2,0,0,0,0,0,2
20210218-W-Australian_Open-SF-Naomi_Osaka-Serena_Williams,2,S-DTM,1,0,0,0,0,0,1
20061006-W-Stuttgart-QF-Tatiana_Golovin-Michaella_Krajicek,1,F-XC,42,12,6,4,2,26,16
20061006-W-Stuttgart-QF-Tatiana_Golovin-Michaella_Krajicek,1,F-DTM,13,3,2,0,1,8,5
20061006-W-Stuttgart-QF-Tatiana_Golovin-Michaella_Krajicek,1,F-DTL,24,6,3,3,0,14,10
20061006-W-Stuttgart-QF-Tatiana_Golovin-Michaella_Krajicek,1,F-IO,21,5,2,3,0,16,5
20061006-W-Stuttgart-QF-Tatiana_Golovin-Michaella_Krajicek,1,F-II,6,5,4,1,0,6,0
20061006-W-Stuttgart-QF-Tatiana_Golovin-Michaella_Krajicek,1,B-XC,27,2,2,0,0,18,9
20061006-W-Stuttgart-QF-Tatiana_Golovin-Michaella_Krajicek,1,B-DTM,26,0,0,0,0,14,12
20061006-W-Stuttgart-QF-Tatiana_Golovin-Michaella_Krajicek,1,B-DTL,17,2,0,0,2,6,11
20061006-W-Stuttgart-QF-Tatiana_Golovin-Michaella_Krajicek,1,B-IO,4,0,0,0,0,2,2
20061006-W-Stuttgart-QF-Tatiana_Golovin-Michaella_Krajicek,1,S-XC,1,0,0,0,0,1,0
20061006-W-Stuttgart-QF-Tatiana_Golovin-Michaella_Krajicek,1,S-DTM,4,0,0,0,0,2,2
20061006-W-Stuttgart-QF-Tatiana_Golovin-Michaella_Krajicek,1,S-DTL,2,0,0,0,0,1,1
20061006-W-Stuttgart-QF-Tatiana_Golovin-Michaella_Krajicek,2,F-XC,65,11,1,7,3,33,32
20061006-W-Stuttgart-QF-Tatiana_Golovin-Michaella_Krajicek,2,F-DTM,13,1,0,0,1,3,10
20061006-W-Stuttgart-QF-Tatiana_Golovin-Michaella_Krajicek,2,F-DTL,11,3,1,0,2,6,5
20061006-W-Stuttgart-QF-Tatiana_Golovin-Michaella_Krajicek,2,F-IO,14,3,1,0,2,6,8
20061006-W-Stuttgart-QF-Tatiana_Golovin-Michaella_Krajicek,2,F-II,2,2,0,1,1,1,1
20061006-W-Stuttgart-QF-Tatiana_Golovin-Michaella_Krajicek,2,B-XC,54,7,2,1,4,22,32
20061006-W-Stuttgart-QF-Tatiana_Golovin-Michaella_Krajicek,2,B-DTM,11,0,0,0,0,2,9
20061006-W-Stuttgart-QF-Tatiana_Golovin-Michaella_Krajicek,2,B-DTL,10,6,3,2,1,7,3
20061006-W-Stuttgart-QF-Tatiana_Golovin-Michaella_Krajicek,2,B-IO,2,1,0,1,0,1,1
20061006-W-Stuttgart-QF-Tatiana_Golovin-Michaella_Krajicek,2,S-XC,3,0,0,0,0,0,3
20061006-W-Stuttgart-QF-Tatiana_Golovin-Michaella_Krajicek,2,S-DTM,2,0,0,0,0,1,1
20061006-W-Stuttgart-QF-Tatiana_Golovin-Michaella_Krajicek,2,S-DTL,2,0,0,0,0,0,2
20210220-W-Australian_Open-F-Naomi_Osaka-Jennifer_Brady,1,F-XC,27,10,2,4,4,14,13
20210220-W-Australian_Open-F-Naomi_Osaka-Jennifer_Brady,1,F-DTM,6,1,0,0,1,5,1
20210220-W-Australian_Open-F-Naomi_Osaka-Jennifer_Brady,1,F-DTL,7,4,0,2,2,2,5
20210220-W-Australian_Open-F-Naomi_Osaka-Jennifer_Brady,1,F-IO,7,3,2,0,1,4,3
20210220-W-Australian_Open-F-Naomi_Osaka-Jennifer_Brady,1,B-XC,34,13,2,5,6,16,18
20210220-W-Australian_Open-F-Naomi_Osaka-Jennifer_Brady,1,B-DTM,20,4,0,0,4,8,12
20210220-W-Australian_Open-F-Naomi_Osaka-Jennifer_Brady,1,B-DTL,5,1,0,0,1,2,3
20210220-W-Australian_Open-F-Naomi_Osaka-Jennifer_Brady,1,B-IO,9,4,2,0,2,4,5
20210220-W-Australian_Open-F-Naomi_Osaka-Jennifer_Brady,1,S-XC,1,0,0,0,0,0,1
20210220-W-Australian_Open-F-Naomi_Osaka-Jennifer_Brady,1,S-DTM,1,0,0,0,0,1,0
20210220-W-Australian_Open-F-Naomi_Osaka-Jennifer_Brady,2,F-XC,12,4,1,0,3,6,6
20210220-W-Australian_Open-F-Naomi_Osaka-Jennifer_Brady,2,F-DTM,16,4,0,0,4,6,10
20210220-W-Australian_Open-F-Naomi_Osaka-Jennifer_Brady,2,F-DTL,9,2,0,1,1,5,4
20210220-W-Australian_Open-F-Naomi_Osaka-Jennifer_Brady,2,F-IO,17,10,4,1,5,11,6
20210220-W-Australian_Open-F-Naomi_Osaka-Jennifer_Brady,2,F-II,2,2,1,0,1,1,1
20210220-W-Australian_Open-F-Naomi_Osaka-Jennifer_Brady,2,B-XC,20,5,2,0,3,9,11
20210220-W-Australian_Open-F-Naomi_Osaka-Jennifer_Brady,2,B-DTM,17,5,0,0,5,5,12
20210220-W-Australian_Open-F-Naomi_Osaka-Jennifer_Brady,2,B-DTL,5,3,1,1,1,3,2
20210220-W-Australian_Open-F-Naomi_Osaka-Jennifer_Brady,2,B-IO,4,2,1,1,0,3,1
20210220-W-Australian_Open-F-Naomi_Osaka-Jennifer_Brady,2,S-XC,1,0,0,0,0,0,1
20210220-W-Australian_Open-F-Naomi_Osaka-Jennifer_Brady,2,S-DTM,3,0,0,0,0,3,0
20210220-W-Australian_Open-F-Naomi_Osaka-Jennifer_Brady,2,S-DTL,3,0,0,0,0,1,2
20200928-W-Roland_Garros-R128-Christina_Mchale-Karolina_Muchova,1,F-XC,30,6,2,2,2,17,13
20200928-W-Roland_Garros-R128-Christina_Mchale-Karolina_Muchova,1,F-DTM,20,1,0,0,1,11,9
20200928-W-Roland_Garros-R128-Christina_Mchale-Karolina_Muchova,1,F-DTL,9,3,1,2,0,6,3
20200928-W-Roland_Garros-R128-Christina_Mchale-Karolina_Muchova,1,F-IO,28,3,0,1,2,19,9
20200928-W-Roland_Garros-R128-Christina_Mchale-Karolina_Muchova,1,F-II,1,0,0,0,0,1,0
20200928-W-Roland_Garros-R128-Christina_Mchale-Karolina_Muchova,1,B-XC,25,2,0,1,1,11,14
20200928-W-Roland_Garros-R128-Christina_Mchale-Karolina_Muchova,1,B-DTM,46,1,0,0,1,24,22
20200928-W-Roland_Garros-R128-Christina_Mchale-Karolina_Muchova,1,B-DTL,8,6,2,0,4,3,5
20200928-W-Roland_Garros-R128-Christina_Mchale-Karolina_Muchova,1,B-IO,6,2,1,0,1,3,3
20200928-W-Roland_Garros-R128-Christina_Mchale-Karolina_Muchova,1,S-XC,3,0,0,0,0,2,1
20200928-W-Roland_Garros-R128-Christina_Mchale-Karolina_Muchova,1,S-DTM,3,0,0,0,0,0,3
20200928-W-Roland_Garros-R128-Christina_Mchale-Karolina_Muchova,1,S-DTL,3,1,1,0,0,2,1
20200928-W-Roland_Garros-R128-Christina_Mchale-Karolina_Muchova,1,S-IO,2,0,0,0,0,1,1
20200928-W-Roland_Garros-R128-Christina_Mchale-Karolina_Muchova,2,F-XC,25,8,2,1,5,10,15
20200928-W-Roland_Garros-R128-Christina_Mchale-Karolina_Muchova,2,F-DTM,27,3,0,0,3,12,15
20200928-W-Roland_Garros-R128-Christina_Mchale-Karolina_Muchova,2,F-DTL,15,6,0,2,4,6,9
20200928-W-Roland_Garros-R128-Christina_Mchale-Karolina_Muchova,2,F-IO,24,7,4,0,3,15,9
20200928-W-Roland_Garros-R128-Christina_Mchale-Karolina_Muchova,2,F-II,1,1,0,0,1,0,1
20200928-W-Roland_Garros-R128-Christina_Mchale-Karolina_Muchova,2,B-XC,32,6,0,0,6,14,18
20200928-W-Roland_Garros-R128-Christina_Mchale-Karolina_Muchova,2,B-DTM,30,2,0,0,2,15,15
20200928-W-Roland_Garros-R128-Christina_Mchale-Karolina_Muchova,2,B-DTL,4,2,1,0,1,2,2
20200928-W-Roland_Garros-R128-Christina_Mchale-Karolina_Muchova,2,B-IO,4,3,0,0,3,1,3
20200928-W-Roland_Garros-R128-Christina_Mchale-Karolina_Muchova,2,S-XC,6,2,0,0,2,1,5
20200928-W-Roland_Garros-R128-Christina_Mchale-Karolina_Muchova,2,S-DTM,12,0,0,0,0,5,7
20200928-W-Roland_Garros-R128-Christina_Mchale-Karolina_Muchova,2,S-DTL,4,3,0,1,2,1,3
20200928-W-Roland_Garros-R128-Christina_Mchale-Karolina_Muchova,2,S-IO,1,1,0,0,1,0,1
20210217-W-Phillip_Island_Trophy-QF-Irina_Camelia_Begu-Bianca_Andreescu,1,F-XC,33,7,1,1,5,12,21
20210217-W-Phillip_Island_Trophy-QF-Irina_Camelia_Begu-Bianca_Andreescu,1,F-DTM,57,3,0,0,3,22,35
20210217-W-Phillip_Island_Trophy-QF-Irina_Camelia_Begu-Bianca_Andreescu,1,F-DTL,8,5,3,0,2,4,4
20210217-W-Phillip_Island_Trophy-QF-Irina_Camelia_Begu-Bianca_Andreescu,1,F-IO,27,11,4,2,5,15,12
20210217-W-Phillip_Island_Trophy-QF-Irina_Camelia_Begu-Bianca_Andreescu,1,F-II,2,1,1,0,0,1,1
20210217-W-Phillip_Island_Trophy-QF-Irina_Camelia_Begu-Bianca_Andreescu,1,B-XC,42,12,4,2,6,23,19
20210217-W-Phillip_Island_Trophy-QF-Irina_Camelia_Begu-Bianca_Andreescu,1,B-DTM,58,5,0,0,5,26,32
20210217-W-Phillip_Island_Trophy-QF-Irina_Camelia_Begu-Bianca_Andreescu,1,B-DTL,8,8,1,2,5,3,5
20210217-W-Phillip_Island_Trophy-QF-Irina_Camelia_Begu-Bianca_Andreescu,1,B-IO,23,10,2,0,8,7,16
20210217-W-Phillip_Island_Trophy-QF-Irina_Camelia_Begu-Bianca_Andreescu,1,S-XC,2,0,0,0,0,0,2
20210217-W-Phillip_Island_Trophy-QF-Irina_Camelia_Begu-Bianca_Andreescu,1,S-DTM,10,0,0,0,0,0,10
20210217-W-Phillip_Island_Trophy-QF-Irina_Camelia_Begu-Bianca_Andreescu,1,S-DTL,1,0,0,0,0,0,1
20210217-W-Phillip_Island_Trophy-QF-Irina_Camelia_Begu-Bianca_Andreescu,1,S-IO,3,0,0,0,0,2,1
20210217-W-Phillip_Island_Trophy-QF-Irina_Camelia_Begu-Bianca_Andreescu,2,F-XC,52,21,5,7,9,33,19
20210217-W-Phillip_Island_Trophy-QF-Irina_Camelia_Begu-Bianca_Andreescu,2,F-DTM,63,7,0,1,6,33,30
20210217-W-Phillip_Island_Trophy-QF-Irina_Camelia_Begu-Bianca_Andreescu,2,F-DTL,12,4,1,1,2,6,6
20210217-W-Phillip_Island_Trophy-QF-Irina_Camelia_Begu-Bianca_Andreescu,2,F-IO,33,8,4,1,3,22,11
20210217-W-Phillip_Island_Trophy-QF-Irina_Camelia_Begu-Bianca_Andreescu,2,B-XC,39,12,2,5,5,22,17
20210217-W-Phillip_Island_Trophy-QF-Irina_Camelia_Begu-Bianca_Andreescu,2,B-DTM,39,3,0,1,2,21,18
20210217-W-Phillip_Island_Trophy-QF-Irina_Camelia_Begu-Bianca_Andreescu,2,B-DTL,11,5,1,0,4,5,6
20210217-W-Phillip_Island_Trophy-QF-Irina_Camelia_Begu-Bianca_Andreescu,2,B-IO,4,2,2,0,0,4,0
20210217-W-Phillip_Island_Trophy-QF-Irina_Camelia_Begu-Bianca_Andreescu,2,S-XC,4,0,0,0,0,2,2
20210217-W-Phillip_Island_Trophy-QF-Irina_Camelia_Begu-Bianca_Andreescu,2,S-DTM,2,0,0,0,0,2,0
20210217-W-Phillip_Island_Trophy-QF-Irina_Camelia_Begu-Bianca_Andreescu,2,S-DTL,1,1,0,0,1,0,1
20210217-W-Phillip_Island_Trophy-QF-Irina_Camelia_Begu-Bianca_Andreescu,2,S-IO,5,3,0,0,3,1,4
20210219-W-Phillip_Island_Trophy-F-Marie_Bouzkova-Daria_Kasatkina,1,F-XC,54,16,5,3,8,25,29
20210219-W-Phillip_Island_Trophy-F-Marie_Bouzkova-Daria_Kasatkina,1,F-DTM,49,1,0,0,1,16,33
20210219-W-Phillip_Island_Trophy-F-Marie_Bouzkova-Daria_Kasatkina,1,F-DTL,8,2,1,0,1,3,5
20210219-W-Phillip_Island_Trophy-F-Marie_Bouzkova-Daria_Kasatkina,1,F-IO,35,14,7,2,5,21,14
20210219-W-Phillip_Island_Trophy-F-Marie_Bouzkova-Daria_Kasatkina,1,B-XC,83,7,1,0,6,36,47
20210219-W-Phillip_Island_Trophy-F-Marie_Bouzkova-Daria_Kasatkina,1,B-DTM,62,3,0,1,2,25,37
20210219-W-Phillip_Island_Trophy-F-Marie_Bouzkova-Daria_Kasatkina,1,B-DTL,5,1,1,0,0,4,1
20210219-W-Phillip_Island_Trophy-F-Marie_Bouzkova-Daria_Kasatkina,1,B-IO,15,6,2,1,3,8,7
20210219-W-Phillip_Island_Trophy-F-Marie_Bouzkova-Daria_Kasatkina,1,S-XC,7,0,0,0,0,1,6
20210219-W-Phillip_Island_Trophy-F-Marie_Bouzkova-Daria_Kasatkina,1,S-DTM,10,1,0,0,1,4,6
20210219-W-Phillip_Island_Trophy-F-Marie_Bouzkova-Daria_Kasatkina,1,S-IO,1,0,0,0,0,0,1
20210219-W-Phillip_Island_Trophy-F-Marie_Bouzkova-Daria_Kasatkina,2,F-XC,41,14,6,2,6,27,14
20210219-W-Phillip_Island_Trophy-F-Marie_Bouzkova-Daria_Kasatkina,2,F-DTM,52,4,1,2,1,29,23
20210219-W-Phillip_Island_Trophy-F-Marie_Bouzkova-Daria_Kasatkina,2,F-DTL,17,6,3,0,3,11,6
20210219-W-Phillip_Island_Trophy-F-Marie_Bouzkova-Daria_Kasatkina,2,F-IO,41,9,6,2,1,23,18
20210219-W-Phillip_Island_Trophy-F-Marie_Bouzkova-Daria_Kasatkina,2,F-II,2,2,1,0,1,1,1
20210219-W-Phillip_Island_Trophy-F-Marie_Bouzkova-Daria_Kasatkina,2,B-XC,49,5,3,0,2,30,19
20210219-W-Phillip_Island_Trophy-F-Marie_Bouzkova-Daria_Kasatkina,2,B-DTM,56,0,0,0,0,33,23
20210219-W-Phillip_Island_Trophy-F-Marie_Bouzkova-Daria_Kasatkina,2,B-DTL,11,2,0,1,1,9,2
20210219-W-Phillip_Island_Trophy-F-Marie_Bouzkova-Daria_Kasatkina,2,B-IO,9,1,1,0,0,5,4
20210219-W-Phillip_Island_Trophy-F-Marie_Bouzkova-Daria_Kasatkina,2,S-XC,9,0,0,0,0,5,4
20210219-W-Phillip_Island_Trophy-F-Marie_Bouzkova-Daria_Kasatkina,2,S-DTM,19,0,0,0,0,8,11
20210219-W-Phillip_Island_Trophy-F-Marie_Bouzkova-Daria_Kasatkina,2,S-DTL,5,3,3,0,0,5,0
20210219-W-Phillip_Island_Trophy-F-Marie_Bouzkova-Daria_Kasatkina,2,S-IO,2,0,0,0,0,2,0
20210209-W-Australian_Open-R128-Chloe_Paquet-Mayar_Sherif,1,F-XC,40,6,3,2,1,21,19
20210209-W-Australian_Open-R128-Chloe_Paquet-Mayar_Sherif,1,F-DTM,40,2,0,0,2,19,21
20210209-W-Australian_Open-R128-Chloe_Paquet-Mayar_Sherif,1,F-DTL,13,3,1,1,1,5,8
20210209-W-Australian_Open-R128-Chloe_Paquet-Mayar_Sherif,1,F-IO,28,6,1,2,3,14,14
20210209-W-Australian_Open-R128-Chloe_Paquet-Mayar_Sherif,1,F-II,3,1,0,0,1,1,2
20210209-W-Australian_Open-R128-Chloe_Paquet-Mayar_Sherif,1,B-XC,50,6,1,1,4,27,23
20210209-W-Australian_Open-R128-Chloe_Paquet-Mayar_Sherif,1,B-DTM,39,2,0,0,2,16,23
20210209-W-Australian_Open-R128-Chloe_Paquet-Mayar_Sherif,1,B-DTL,7,0,0,0,0,1,6
20210209-W-Australian_Open-R128-Chloe_Paquet-Mayar_Sherif,1,B-IO,5,4,1,1,2,3,2
20210209-W-Australian_Open-R128-Chloe_Paquet-Mayar_Sherif,1,S-XC,1,0,0,0,0,1,0
20210209-W-Australian_Open-R128-Chloe_Paquet-Mayar_Sherif,1,S-DTM,1,0,0,0,0,0,1
20210209-W-Australian_Open-R128-Chloe_Paquet-Mayar_Sherif,1,S-DTL,1,0,0,0,0,0,1
20210209-W-Australian_Open-R128-Chloe_Paquet-Mayar_Sherif,2,F-XC,47,11,4,2,5,25,22
20210209-W-Australian_Open-R128-Chloe_Paquet-Mayar_Sherif,2,F-DTM,30,3,2,1,0,22,8
20210209-W-Australian_Open-R128-Chloe_Paquet-Mayar_Sherif,2,F-DTL,15,4,1,0,3,10,5
20210209-W-Australian_Open-R128-Chloe_Paquet-Mayar_Sherif,2,F-IO,52,10,3,1,6,27,25
20210209-W-Australian_Open-R128-Chloe_Paquet-Mayar_Sherif,2,F-II,9,6,1,2,3,5,4
20210209-W-Australian_Open-R128-Chloe_Paquet-Mayar_Sherif,2,B-XC,30,6,2,1,3,18,12
20210209-W-Australian_Open-R128-Chloe_Paquet-Mayar_Sherif,2,B-DTM,22,3,0,0,3,10,12
20210209-W-Australian_Open-R128-Chloe_Paquet-Mayar_Sherif,2,B-DTL,7,2,0,1,1,2,5
20210209-W-Australian_Open-R128-Chloe_Paquet-Mayar_Sherif,2,B-IO,1,1,1,0,0,1,0
20210209-W-Australian_Open-R128-Chloe_Paquet-Mayar_Sherif,2,S-XC,3,0,0,0,0,0,3
20210209-W-Australian_Open-R128-Chloe_Paquet-Mayar_Sherif,2,S-DTM,9,0,0,0,0,3,6
20210209-W-Australian_Open-R128-Chloe_Paquet-Mayar_Sherif,2,S-DTL,5,1,0,0,1,2,3
20210214-W-Australian_Open-R16-Karolina_Muchova-Elise_Mertens,1,F-XC,57,15,6,4,5,41,16
20210214-W-Australian_Open-R16-Karolina_Muchova-Elise_Mertens,1,F-DTM,13,1,0,0,1,8,5
20210214-W-Australian_Open-R16-Karolina_Muchova-Elise_Mertens,1,F-DTL,12,7,0,1,6,4,8
20210214-W-Australian_Open-R16-Karolina_Muchova-Elise_Mertens,1,F-IO,13,2,0,0,2,4,9
20210214-W-Australian_Open-R16-Karolina_Muchova-Elise_Mertens,1,F-II,6,3,1,1,1,4,2
20210214-W-Australian_Open-R16-Karolina_Muchova-Elise_Mertens,1,B-XC,37,5,0,2,3,22,15
20210214-W-Australian_Open-R16-Karolina_Muchova-Elise_Mertens,1,B-DTM,27,1,0,0,1,16,11
20210214-W-Australian_Open-R16-Karolina_Muchova-Elise_Mertens,1,B-DTL,17,2,1,0,1,14,3
20210214-W-Australian_Open-R16-Karolina_Muchova-Elise_Mertens,1,B-IO,10,5,1,0,4,4,6
20210214-W-Australian_Open-R16-Karolina_Muchova-Elise_Mertens,1,S-XC,10,1,0,0,1,5,5
20210214-W-Australian_Open-R16-Karolina_Muchova-Elise_Mertens,1,S-DTM,16,1,0,1,0,7,9
20210214-W-Australian_Open-R16-Karolina_Muchova-Elise_Mertens,1,S-DTL,5,2,0,1,1,3,2
20210214-W-Australian_Open-R16-Karolina_Muchova-Elise_Mertens,1,S-IO,1,0,0,0,0,0,1
20210214-W-Australian_Open-R16-Karolina_Muchova-Elise_Mertens,2,F-XC,41,9,3,1,5,18,23
20210214-W-Australian_Open-R16-Karolina_Muchova-Elise_Mertens,2,F-DTM,27,6,0,1,5,10,17
20210214-W-Australian_Open-R16-Karolina_Muchova-Elise_Mertens,2,F-DTL,39,10,2,1,7,13,26
20210214-W-Australian_Open-R16-Karolina_Muchova-Elise_Mertens,2,F-IO,27,1,0,0,1,10,17
20210214-W-Australian_Open-R16-Karolina_Muchova-Elise_Mertens,2,B-XC,40,5,2,0,3,17,23
20210214-W-Australian_Open-R16-Karolina_Muchova-Elise_Mertens,2,B-DTM,19,0,0,0,0,9,10
20210214-W-Australian_Open-R16-Karolina_Muchova-Elise_Mertens,2,B-DTL,18,9,2,3,4,10,8
20210214-W-Australian_Open-R16-Karolina_Muchova-Elise_Mertens,2,B-IO,8,4,0,0,4,2,6
20210214-W-Australian_Open-R16-Karolina_Muchova-Elise_Mertens,2,S-XC,3,0,0,0,0,2,1
20210214-W-Australian_Open-R16-Karolina_Muchova-Elise_Mertens,2,S-DTM,5,0,0,0,0,2,3
20210203-W-ITF_Manacor-R32-Ana_Lantigua_De_La_Nuez-Alexandra_Eala,1,F-XC,20,3,0,1,2,7,13
20210203-W-ITF_Manacor-R32-Ana_Lantigua_De_La_Nuez-Alexandra_Eala,1,F-DTM,21,2,0,2,0,5,16
20210203-W-ITF_Manacor-R32-Ana_Lantigua_De_La_Nuez-Alexandra_Eala,1,F-DTL,16,8,2,2,4,5,11
20210203-W-ITF_Manacor-R32-Ana_Lantigua_De_La_Nuez-Alexandra_Eala,1,F-IO,13,4,3,0,1,8,5
20210203-W-ITF_Manacor-R32-Ana_Lantigua_De_La_Nuez-Alexandra_Eala,1,F-II,1,1,0,0,1,0,1
20210203-W-ITF_Manacor-R32-Ana_Lantigua_De_La_Nuez-Alexandra_Eala,1,B-XC,32,6,3,2,1,14,18
20210203-W-ITF_Manacor-R32-Ana_Lantigua_De_La_Nuez-Alexandra_Eala,1,B-DTM,20,2,0,1,1,7,13
20210203-W-ITF_Manacor-R32-Ana_Lantigua_De_La_Nuez-Alexandra_Eala,1,B-DTL,6,1,0,0,1,2,4
20210203-W-ITF_Manacor-R32-Ana_Lantigua_De_La_Nuez-Alexandra_Eala,1,B-IO,1,1,0,0,1,0,1
20210203-W-ITF_Manacor-R32-Ana_Lantigua_De_La_Nuez-Alexandra_Eala,1,S-XC,1,0,0,0,0,1,0
20210203-W-ITF_Manacor-R32-Ana_Lantigua_De_La_Nuez-Alexandra_Eala,1,S-DTM,5,0,0,0,0,4,1
20210203-W-ITF_Manacor-R32-Ana_Lantigua_De_La_Nuez-Alexandra_Eala,1,S-IO,1,0,0,0,0,0,1
20210203-W-ITF_Manacor-R32-Ana_Lantigua_De_La_Nuez-Alexandra_Eala,2,F-XC,51,10,1,5,4,29,22
20210203-W-ITF_Manacor-R32-Ana_Lantigua_De_La_Nuez-Alexandra_Eala,2,F-DTM,19,1,0,1,0,13,6
20210203-W-ITF_Manacor-R32-Ana_Lantigua_De_La_Nuez-Alexandra_Eala,2,F-DTL,10,7,4,2,1,8,2
20210203-W-ITF_Manacor-R32-Ana_Lantigua_De_La_Nuez-Alexandra_Eala,2,F-IO,13,5,2,3,0,11,2
20210203-W-ITF_Manacor-R32-Ana_Lantigua_De_La_Nuez-Alexandra_Eala,2,B-XC,31,9,7,2,0,24,7
20210203-W-ITF_Manacor-R32-Ana_Lantigua_De_La_Nuez-Alexandra_Eala,2,B-DTM,10,2,0,0,2,5,5
20210203-W-ITF_Manacor-R32-Ana_Lantigua_De_La_Nuez-Alexandra_Eala,2,B-DTL,3,2,2,0,0,2,1
20210203-W-ITF_Manacor-R32-Ana_Lantigua_De_La_Nuez-Alexandra_Eala,2,B-IO,4,2,1,1,0,3,1
20210203-W-ITF_Manacor-R32-Ana_Lantigua_De_La_Nuez-Alexandra_Eala,2,S-XC,1,0,0,0,0,0,1
20210227-W-Adelaide-F-Iga_Swiatek-Belinda_Bencic,1,F-XC,14,5,4,0,1,10,4
20210227-W-Adelaide-F-Iga_Swiatek-Belinda_Bencic,1,F-DTM,17,4,1,1,2,8,9
20210227-W-Adelaide-F-Iga_Swiatek-Belinda_Bencic,1,F-DTL,4,3,2,0,1,2,2
20210227-W-Adelaide-F-Iga_Swiatek-Belinda_Bencic,1,F-IO,8,7,4,2,1,7,1
20210227-W-Adelaide-F-Iga_Swiatek-Belinda_Bencic,1,B-XC,17,6,4,0,2,13,4
20210227-W-Adelaide-F-Iga_Swiatek-Belinda_Bencic,1,B-DTM,9,2,0,0,2,5,4
20210227-W-Adelaide-F-Iga_Swiatek-Belinda_Bencic,1,B-IO,3,2,2,0,0,3,0
20210227-W-Adelaide-F-Iga_Swiatek-Belinda_Bencic,1,S-DTM,3,0,0,0,0,1,2
20210227-W-Adelaide-F-Iga_Swiatek-Belinda_Bencic,2,F-XC,16,4,0,2,2,8,8
20210227-W-Adelaide-F-Iga_Swiatek-Belinda_Bencic,2,F-DTM,17,3,0,0,3,6,11
20210227-W-Adelaide-F-Iga_Swiatek-Belinda_Bencic,2,F-DTL,3,2,0,2,0,3,0
20210227-W-Adelaide-F-Iga_Swiatek-Belinda_Bencic,2,F-IO,9,4,2,0,2,5,4
20210227-W-Adelaide-F-Iga_Swiatek-Belinda_Bencic,2,B-XC,12,4,1,2,1,5,7
20210227-W-Adelaide-F-Iga_Swiatek-Belinda_Bencic,2,B-DTM,13,1,0,0,1,4,9
20210227-W-Adelaide-F-Iga_Swiatek-Belinda_Bencic,2,B-DTL,1,1,0,0,1,0,1
20210227-W-Adelaide-F-Iga_Swiatek-Belinda_Bencic,2,B-IO,1,0,0,0,0,0,1
20210226-W-Adelaide-SF-Iga_Swiatek-Jil_Teichmann,1,F-XC,32,15,6,4,5,22,10
20210226-W-Adelaide-SF-Iga_Swiatek-Jil_Teichmann,1,F-DTM,14,1,0,0,1,9,5
20210226-W-Adelaide-SF-Iga_Swiatek-Jil_Teichmann,1,F-IO,10,2,0,0,2,6,4
20210226-W-Adelaide-SF-Iga_Swiatek-Jil_Teichmann,1,F-II,1,0,0,0,0,1,0
20210226-W-Adelaide-SF-Iga_Swiatek-Jil_Teichmann,1,B-XC,23,5,2,1,2,17,6
20210226-W-Adelaide-SF-Iga_Swiatek-Jil_Teichmann,1,B-DTM,22,3,0,0,3,14,8
20210226-W-Adelaide-SF-Iga_Swiatek-Jil_Teichmann,1,B-DTL,6,3,3,0,0,4,2
20210226-W-Adelaide-SF-Iga_Swiatek-Jil_Teichmann,1,B-IO,9,2,2,0,0,8,1
20210226-W-Adelaide-SF-Iga_Swiatek-Jil_Teichmann,1,S-XC,2,0,0,0,0,1,1
20210226-W-Adelaide-SF-Iga_Swiatek-Jil_Teichmann,1,S-DTM,1,0,0,0,0,0,1
20210226-W-Adelaide-SF-Iga_Swiatek-Jil_Teichmann,2,F-XC,21,4,1,0,3,8,13
20210226-W-Adelaide-SF-Iga_Swiatek-Jil_Teichmann,2,F-DTM,21,3,0,0,3,7,14
20210226-W-Adelaide-SF-Iga_Swiatek-Jil_Teichmann,2,F-DTL,9,6,0,1,5,3,6
20210226-W-Adelaide-SF-Iga_Swiatek-Jil_Teichmann,2,F-IO,9,2,1,1,0,3,6
20210226-W-Adelaide-SF-Iga_Swiatek-Jil_Teichmann,2,B-XC,9,4,2,0,2,5,4
20210226-W-Adelaide-SF-Iga_Swiatek-Jil_Teichmann,2,B-DTM,25,2,0,0,2,6,19
20210226-W-Adelaide-SF-Iga_Swiatek-Jil_Teichmann,2,B-DTL,1,1,0,0,1,0,1
20210226-W-Adelaide-SF-Iga_Swiatek-Jil_Teichmann,2,B-IO,4,1,0,1,0,3,1
20210226-W-Adelaide-SF-Iga_Swiatek-Jil_Teichmann,2,S-XC,3,1,0,0,1,2,1
20210226-W-Adelaide-SF-Iga_Swiatek-Jil_Teichmann,2,S-DTM,13,3,0,1,2,3,10
20210226-W-Adelaide-SF-Iga_Swiatek-Jil_Teichmann,2,S-DTL,2,0,0,0,0,0,2
20210209-W-Australian_Open-R128-Cori_Gauff-Jil_Teichmann,1,F-XC,15,1,1,0,0,12,3
20210209-W-Australian_Open-R128-Cori_Gauff-Jil_Teichmann,1,F-DTM,24,2,0,0,2,11,13
20210209-W-Australian_Open-R128-Cori_Gauff-Jil_Teichmann,1,F-DTL,6,4,1,2,1,4,2
20210209-W-Australian_Open-R128-Cori_Gauff-Jil_Teichmann,1,F-IO,6,3,1,2,0,5,1
20210209-W-Australian_Open-R128-Cori_Gauff-Jil_Teichmann,1,F-II,1,0,0,0,0,0,1
20210209-W-Australian_Open-R128-Cori_Gauff-Jil_Teichmann,1,B-XC,9,3,2,0,1,6,3
20210209-W-Australian_Open-R128-Cori_Gauff-Jil_Teichmann,1,B-DTM,13,3,0,1,2,6,7
20210209-W-Australian_Open-R128-Cori_Gauff-Jil_Teichmann,1,B-IO,5,0,0,0,0,3,2
20210209-W-Australian_Open-R128-Cori_Gauff-Jil_Teichmann,2,F-XC,18,13,6,1,6,9,9
20210209-W-Australian_Open-R128-Cori_Gauff-Jil_Teichmann,2,F-DTM,20,0,0,0,0,13,7
20210209-W-Australian_Open-R128-Cori_Gauff-Jil_Teichmann,2,F-DTL,5,2,0,1,1,1,4
20210209-W-Australian_Open-R128-Cori_Gauff-Jil_Teichmann,2,F-IO,10,6,0,2,4,4,6
20210209-W-Australian_Open-R128-Cori_Gauff-Jil_Teichmann,2,B-XC,9,2,0,0,2,2,7
20210209-W-Australian_Open-R128-Cori_Gauff-Jil_Teichmann,2,B-DTM,11,3,0,1,2,4,7
20210209-W-Australian_Open-R128-Cori_Gauff-Jil_Teichmann,2,B-DTL,3,1,0,0,1,1,2
20210209-W-Australian_Open-R128-Cori_Gauff-Jil_Teichmann,2,S-XC,5,3,0,1,2,1,4
20210209-W-Australian_Open-R128-Cori_Gauff-Jil_Teichmann,2,S-DTM,4,1,0,0,1,1,3
20210208-W-Australian_Open-R128-Rebecca_Marino-Kimberly_Birrell,1,F-XC,35,14,2,4,8,15,20
20210208-W-Australian_Open-R128-Rebecca_Marino-Kimberly_Birrell,1,F-DTM,37,10,0,1,9,15,22
20210208-W-Australian_Open-R128-Rebecca_Marino-Kimberly_Birrell,1,F-DTL,6,5,2,0,3,3,3
20210208-W-Australian_Open-R128-Rebecca_Marino-Kimberly_Birrell,1,F-IO,14,10,5,2,3,10,4
20210208-W-Australian_Open-R128-Rebecca_Marino-Kimberly_Birrell,1,B-XC,24,8,1,3,4,12,12
20210208-W-Australian_Open-R128-Rebecca_Marino-Kimberly_Birrell,1,B-DTM,24,4,0,0,4,12,12
20210208-W-Australian_Open-R128-Rebecca_Marino-Kimberly_Birrell,1,B-DTL,7,0,0,0,0,4,3
20210208-W-Australian_Open-R128-Rebecca_Marino-Kimberly_Birrell,1,B-IO,8,1,0,0,1,2,6
20210208-W-Australian_Open-R128-Rebecca_Marino-Kimberly_Birrell,1,S-DTM,2,1,0,0,1,1,1
20210208-W-Australian_Open-R128-Rebecca_Marino-Kimberly_Birrell,1,S-DTL,1,1,0,0,1,0,1
20210208-W-Australian_Open-R128-Rebecca_Marino-Kimberly_Birrell,1,S-IO,1,0,0,0,0,1,0
20210208-W-Australian_Open-R128-Rebecca_Marino-Kimberly_Birrell,2,F-XC,34,8,0,3,5,18,16
20210208-W-Australian_Open-R128-Rebecca_Marino-Kimberly_Birrell,2,F-DTM,39,4,0,0,4,21,18
20210208-W-Australian_Open-R128-Rebecca_Marino-Kimberly_Birrell,2,F-DTL,9,3,0,1,2,5,4
20210208-W-Australian_Open-R128-Rebecca_Marino-Kimberly_Birrell,2,F-IO,7,3,0,1,2,3,4
20210208-W-Australian_Open-R128-Rebecca_Marino-Kimberly_Birrell,2,B-XC,28,5,0,0,5,15,13
20210208-W-Australian_Open-R128-Rebecca_Marino-Kimberly_Birrell,2,B-DTM,43,4,0,0,4,18,25
20210208-W-Australian_Open-R128-Rebecca_Marino-Kimberly_Birrell,2,B-DTL,4,1,0,0,1,1,3
20210208-W-Australian_Open-R128-Rebecca_Marino-Kimberly_Birrell,2,B-IO,9,3,1,1,1,8,1
20210208-W-Australian_Open-R128-Rebecca_Marino-Kimberly_Birrell,2,S-DTM,1,0,0,0,0,0,1
20210209-W-Australian_Open-R128-Elina_Svitolina-Marie_Bouzkova,1,F-XC,44,5,2,1,2,29,15
20210209-W-Australian_Open-R128-Elina_Svitolina-Marie_Bouzkova,1,F-DTM,52,4,1,0,3,26,26
20210209-W-Australian_Open-R128-Elina_Svitolina-Marie_Bouzkova,1,F-DTL,7,2,0,1,1,4,3
20210209-W-Australian_Open-R128-Elina_Svitolina-Marie_Bouzkova,1,F-IO,28,9,4,2,3,16,12
20210209-W-Australian_Open-R128-Elina_Svitolina-Marie_Bouzkova,1,F-II,2,1,0,1,0,1,1
20210209-W-Australian_Open-R128-Elina_Svitolina-Marie_Bouzkova,1,B-XC,58,11,2,4,5,22,36
20210209-W-Australian_Open-R128-Elina_Svitolina-Marie_Bouzkova,1,B-DTM,37,1,0,0,1,22,15
20210209-W-Australian_Open-R128-Elina_Svitolina-Marie_Bouzkova,1,B-DTL,15,9,4,2,3,9,6
20210209-W-Australian_Open-R128-Elina_Svitolina-Marie_Bouzkova,1,B-IO,9,2,1,0,1,5,4
20210209-W-Australian_Open-R128-Elina_Svitolina-Marie_Bouzkova,1,S-XC,6,0,0,0,0,2,4
20210209-W-Australian_Open-R128-Elina_Svitolina-Marie_Bouzkova,1,S-DTM,8,1,0,0,1,3,5
20210209-W-Australian_Open-R128-Elina_Svitolina-Marie_Bouzkova,2,F-XC,40,8,3,2,3,18,22
20210209-W-Australian_Open-R128-Elina_Svitolina-Marie_Bouzkova,2,F-DTM,46,6,0,0,6,15,31
20210209-W-Australian_Open-R128-Elina_Svitolina-Marie_Bouzkova,2,F-DTL,10,5,4,1,0,9,1
20210209-W-Australian_Open-R128-Elina_Svitolina-Marie_Bouzkova,2,F-IO,34,6,2,1,3,18,16
20210209-W-Australian_Open-R128-Elina_Svitolina-Marie_Bouzkova,2,B-XC,52,3,1,0,2,27,25
20210209-W-Australian_Open-R128-Elina_Svitolina-Marie_Bouzkova,2,B-DTM,32,3,2,1,0,15,17
20210209-W-Australian_Open-R128-Elina_Svitolina-Marie_Bouzkova,2,B-DTL,11,3,1,2,0,8,3
20210209-W-Australian_Open-R128-Elina_Svitolina-Marie_Bouzkova,2,B-IO,13,4,0,0,4,5,8
20210209-W-Australian_Open-R128-Elina_Svitolina-Marie_Bouzkova,2,S-XC,7,0,0,0,0,5,2
20210209-W-Australian_Open-R128-Elina_Svitolina-Marie_Bouzkova,2,S-DTM,7,2,0,0,2,3,4
20210209-W-Australian_Open-R128-Elina_Svitolina-Marie_Bouzkova,2,S-DTL,2,1,0,1,0,2,0
20210128-W-ITF_Manacor-R16-Alba_Carrillo_Marin-Alexandra_Eala,1,F-XC,28,6,2,2,2,10,18
20210128-W-ITF_Manacor-R16-Alba_Carrillo_Marin-Alexandra_Eala,1,F-DTM,20,1,0,0,1,5,15
20210128-W-ITF_Manacor-R16-Alba_Carrillo_Marin-Alexandra_Eala,1,F-DTL,12,3,2,0,1,6,6
20210128-W-ITF_Manacor-R16-Alba_Carrillo_Marin-Alexandra_Eala,1,F-IO,14,3,2,0,1,10,4
20210128-W-ITF_Manacor-R16-Alba_Carrillo_Marin-Alexandra_Eala,1,F-II,2,1,0,0,1,0,2
20210128-W-ITF_Manacor-R16-Alba_Carrillo_Marin-Alexandra_Eala,1,B-XC,7,2,0,1,1,3,4
20210128-W-ITF_Manacor-R16-Alba_Carrillo_Marin-Alexandra_Eala,1,B-DTM,11,0,0,0,0,6,5
20210128-W-ITF_Manacor-R16-Alba_Carrillo_Marin-Alexandra_Eala,1,B-DTL,3,1,0,0,1,0,3
20210128-W-ITF_Manacor-R16-Alba_Carrillo_Marin-Alexandra_Eala,1,S-XC,9,1,0,1,0,4,5
20210128-W-ITF_Manacor-R16-Alba_Carrillo_Marin-Alexandra_Eala,1,S-DTM,10,1,0,0,1,4,6
20210128-W-ITF_Manacor-R16-Alba_Carrillo_Marin-Alexandra_Eala,1,S-DTL,1,0,0,0,0,0,1
20210128-W-ITF_Manacor-R16-Alba_Carrillo_Marin-Alexandra_Eala,2,F-XC,38,12,2,6,4,24,14
20210128-W-ITF_Manacor-R16-Alba_Carrillo_Marin-Alexandra_Eala,2,F-DTM,12,2,1,0,1,4,8
20210128-W-ITF_Manacor-R16-Alba_Carrillo_Marin-Alexandra_Eala,2,F-DTL,12,4,1,1,2,5,7
20210128-W-ITF_Manacor-R16-Alba_Carrillo_Marin-Alexandra_Eala,2,F-IO,13,6,0,3,3,9,4
20210128-W-ITF_Manacor-R16-Alba_Carrillo_Marin-Alexandra_Eala,2,B-XC,28,3,1,1,1,19,9
20210128-W-ITF_Manacor-R16-Alba_Carrillo_Marin-Alexandra_Eala,2,B-DTM,11,3,0,3,0,8,3
20210128-W-ITF_Manacor-R16-Alba_Carrillo_Marin-Alexandra_Eala,2,B-DTL,5,2,1,0,1,4,1
20210128-W-ITF_Manacor-R16-Alba_Carrillo_Marin-Alexandra_Eala,2,B-IO,2,0,0,0,0,0,2
20210128-W-ITF_Manacor-R16-Alba_Carrillo_Marin-Alexandra_Eala,2,S-XC,1,0,0,0,0,1,0
20210301-W-Doha-R32-Jelena_Ostapenko-Kiki_Bertens,1,F-XC,29,13,5,3,5,22,7
20210301-W-Doha-R32-Jelena_Ostapenko-Kiki_Bertens,1,F-DTM,4,0,0,0,0,3,1
20210301-W-Doha-R32-Jelena_Ostapenko-Kiki_Bertens,1,F-DTL,12,7,3,0,4,8,4
20210301-W-Doha-R32-Jelena_Ostapenko-Kiki_Bertens,1,F-IO,14,8,6,0,2,10,4
20210301-W-Doha-R32-Jelena_Ostapenko-Kiki_Bertens,1,B-XC,14,2,2,0,0,11,3
20210301-W-Doha-R32-Jelena_Ostapenko-Kiki_Bertens,1,B-DTM,6,1,0,0,1,3,3
20210301-W-Doha-R32-Jelena_Ostapenko-Kiki_Bertens,1,B-DTL,6,2,1,0,1,2,4
20210301-W-Doha-R32-Jelena_Ostapenko-Kiki_Bertens,1,B-IO,3,2,1,0,1,2,1
20210301-W-Doha-R32-Jelena_Ostapenko-Kiki_Bertens,2,F-XC,15,4,0,0,4,5,10
20210301-W-Doha-R32-Jelena_Ostapenko-Kiki_Bertens,2,F-DTM,12,0,0,0,0,2,10
20210301-W-Doha-R32-Jelena_Ostapenko-Kiki_Bertens,2,F-IO,1,1,1,0,0,1,0
20210301-W-Doha-R32-Jelena_Ostapenko-Kiki_Bertens,2,F-II,1,0,0,0,0,0,1
20210301-W-Doha-R32-Jelena_Ostapenko-Kiki_Bertens,2,B-XC,4,0,0,0,0,2,2
20210301-W-Doha-R32-Jelena_Ostapenko-Kiki_Bertens,2,B-DTM,18,3,0,1,2,6,12
20210301-W-Doha-R32-Jelena_Ostapenko-Kiki_Bertens,2,B-DTL,3,1,0,0,1,0,3
20210301-W-Doha-R32-Jelena_Ostapenko-Kiki_Bertens,2,B-IO,3,2,0,0,2,1,2
20210301-W-Doha-R32-Jelena_Ostapenko-Kiki_Bertens,2,S-XC,2,0,0,0,0,0,2
20210301-W-Doha-R32-Jelena_Ostapenko-Kiki_Bertens,2,S-DTM,8,1,0,0,1,2,6
20210301-W-Doha-R32-Jelena_Ostapenko-Kiki_Bertens,2,S-DTL,3,0,0,0,0,1,2
20210301-W-Lyon-R32-Arantxa_Rus-Xiyu_Wang,1,F-XC,21,4,1,2,1,15,6
20210301-W-Lyon-R32-Arantxa_Rus-Xiyu_Wang,1,F-DTM,46,2,0,0,2,19,27
20210301-W-Lyon-R32-Arantxa_Rus-Xiyu_Wang,1,F-DTL,8,5,3,0,2,4,4
20210301-W-Lyon-R32-Arantxa_Rus-Xiyu_Wang,1,F-IO,27,4,0,2,2,14,13
20210301-W-Lyon-R32-Arantxa_Rus-Xiyu_Wang,1,B-XC,20,2,0,1,1,10,10
20210301-W-Lyon-R32-Arantxa_Rus-Xiyu_Wang,1,B-DTM,60,5,0,2,3,35,25
20210301-W-Lyon-R32-Arantxa_Rus-Xiyu_Wang,1,B-DTL,2,1,0,0,1,1,1
20210301-W-Lyon-R32-Arantxa_Rus-Xiyu_Wang,1,B-IO,5,1,0,0,1,1,4
20210301-W-Lyon-R32-Arantxa_Rus-Xiyu_Wang,1,S-XC,2,0,0,0,0,2,0
20210301-W-Lyon-R32-Arantxa_Rus-Xiyu_Wang,1,S-DTM,5,0,0,0,0,1,4
20210301-W-Lyon-R32-Arantxa_Rus-Xiyu_Wang,2,F-XC,52,21,3,8,10,27,25
20210301-W-Lyon-R32-Arantxa_Rus-Xiyu_Wang,2,F-DTM,37,3,0,0,3,16,21
20210301-W-Lyon-R32-Arantxa_Rus-Xiyu_Wang,2,F-DTL,10,7,1,1,5,3,7
20210301-W-Lyon-R32-Arantxa_Rus-Xiyu_Wang,2,F-IO,38,21,6,4,11,17,21
20210301-W-Lyon-R32-Arantxa_Rus-Xiyu_Wang,2,B-XC,43,8,1,3,4,20,23
20210301-W-Lyon-R32-Arantxa_Rus-Xiyu_Wang,2,B-DTM,33,4,0,1,3,19,14
20210301-W-Lyon-R32-Arantxa_Rus-Xiyu_Wang,2,B-DTL,11,10,2,3,5,5,6
20210301-W-Lyon-R32-Arantxa_Rus-Xiyu_Wang,2,B-IO,2,1,0,0,1,0,2
20210301-W-Lyon-R32-Arantxa_Rus-Xiyu_Wang,2,S-XC,1,0,0,0,0,0,1
20210301-W-Lyon-R32-Arantxa_Rus-Xiyu_Wang,2,S-DTM,3,0,0,0,0,1,2
20210301-W-Lyon-R32-Arantxa_Rus-Xiyu_Wang,2,S-IO,1,0,0,0,0,0,1
20010124-W-Australian_Open-QF-Serena_Williams-Martina_Hingis,1,F-XC,45,11,3,3,5,22,23
20010124-W-Australian_Open-QF-Serena_Williams-Martina_Hingis,1,F-DTM,21,0,0,0,0,6,15
20010124-W-Australian_Open-QF-Serena_Williams-Martina_Hingis,1,F-DTL,22,9,2,1,6,12,10
20010124-W-Australian_Open-QF-Serena_Williams-Martina_Hingis,1,F-IO,20,8,1,3,4,12,8
20010124-W-Australian_Open-QF-Serena_Williams-Martina_Hingis,1,F-II,1,0,0,0,0,0,1
20010124-W-Australian_Open-QF-Serena_Williams-Martina_Hingis,1,B-XC,86,9,1,4,4,40,46
20010124-W-Australian_Open-QF-Serena_Williams-Martina_Hingis,1,B-DTM,67,4,0,1,3,27,40
20010124-W-Australian_Open-QF-Serena_Williams-Martina_Hingis,1,B-DTL,38,16,5,4,7,20,18
20010124-W-Australian_Open-QF-Serena_Williams-Martina_Hingis,1,B-IO,20,6,2,0,4,6,14
20010124-W-Australian_Open-QF-Serena_Williams-Martina_Hingis,1,S-XC,13,1,0,0,1,3,10
20010124-W-Australian_Open-QF-Serena_Williams-Martina_Hingis,1,S-DTM,7,0,0,0,0,4,3
20010124-W-Australian_Open-QF-Serena_Williams-Martina_Hingis,1,S-DTL,1,0,0,0,0,1,0
20010124-W-Australian_Open-QF-Serena_Williams-Martina_Hingis,2,F-XC,48,7,0,3,4,26,22
20010124-W-Australian_Open-QF-Serena_Williams-Martina_Hingis,2,F-DTM,19,0,0,0,0,10,9
20010124-W-Australian_Open-QF-Serena_Williams-Martina_Hingis,2,F-DTL,41,7,0,5,2,26,15
20010124-W-Australian_Open-QF-Serena_Williams-Martina_Hingis,2,F-IO,50,9,1,6,2,27,23
20010124-W-Australian_Open-QF-Serena_Williams-Martina_Hingis,2,F-II,1,0,0,0,0,1,0
20010124-W-Australian_Open-QF-Serena_Williams-Martina_Hingis,2,B-XC,86,10,0,7,3,45,41
20010124-W-Australian_Open-QF-Serena_Williams-Martina_Hingis,2,B-DTM,30,0,0,0,0,20,10
20010124-W-Australian_Open-QF-Serena_Williams-Martina_Hingis,2,B-DTL,20,8,2,2,4,10,10
20010124-W-Australian_Open-QF-Serena_Williams-Martina_Hingis,2,B-IO,16,7,0,4,3,12,4
20010124-W-Australian_Open-QF-Serena_Williams-Martina_Hingis,2,S-XC,10,0,0,0,0,4,6
20010124-W-Australian_Open-QF-Serena_Williams-Martina_Hingis,2,S-DTM,6,0,0,0,0,2,4
20010124-W-Australian_Open-QF-Serena_Williams-Martina_Hingis,2,S-DTL,1,0,0,0,0,1,0
20010124-W-Australian_Open-QF-Serena_Williams-Martina_Hingis,2,S-IO,1,0,0,0,0,0,1
20210225-W-Adelaide-QF-Jil_Teichmann-Anastasija_Sevastova,1,F-XC,142,20,6,3,11,73,69
20210225-W-Adelaide-QF-Jil_Teichmann-Anastasija_Sevastova,1,F-DTM,77,7,0,0,7,38,39
20210225-W-Adelaide-QF-Jil_Teichmann-Anastasija_Sevastova,1,F-DTL,23,12,3,2,7,11,12
20210225-W-Adelaide-QF-Jil_Teichmann-Anastasija_Sevastova,1,F-IO,26,14,8,2,4,18,8
20210225-W-Adelaide-QF-Jil_Teichmann-Anastasija_Sevastova,1,F-II,1,0,0,0,0,1,0
20210225-W-Adelaide-QF-Jil_Teichmann-Anastasija_Sevastova,1,B-XC,38,6,2,1,3,18,20
20210225-W-Adelaide-QF-Jil_Teichmann-Anastasija_Sevastova,1,B-DTM,58,5,0,1,4,26,32
20210225-W-Adelaide-QF-Jil_Teichmann-Anastasija_Sevastova,1,B-DTL,4,4,0,0,4,0,4
20210225-W-Adelaide-QF-Jil_Teichmann-Anastasija_Sevastova,1,B-IO,7,2,0,2,0,4,3
20210225-W-Adelaide-QF-Jil_Teichmann-Anastasija_Sevastova,1,S-XC,9,1,0,1,0,4,5
20210225-W-Adelaide-QF-Jil_Teichmann-Anastasija_Sevastova,1,S-DTM,29,0,0,0,0,13,16
20210225-W-Adelaide-QF-Jil_Teichmann-Anastasija_Sevastova,1,S-DTL,6,1,0,0,1,2,4
20210225-W-Adelaide-QF-Jil_Teichmann-Anastasija_Sevastova,1,S-IO,3,0,0,0,0,1,2
20210225-W-Adelaide-QF-Jil_Teichmann-Anastasija_Sevastova,2,F-XC,78,18,3,4,11,45,33
20210225-W-Adelaide-QF-Jil_Teichmann-Anastasija_Sevastova,2,F-DTM,65,5,0,0,5,30,35
20210225-W-Adelaide-QF-Jil_Teichmann-Anastasija_Sevastova,2,F-DTL,16,6,1,1,4,10,6
20210225-W-Adelaide-QF-Jil_Teichmann-Anastasija_Sevastova,2,F-IO,35,5,0,1,4,13,22
20210225-W-Adelaide-QF-Jil_Teichmann-Anastasija_Sevastova,2,F-II,1,1,0,1,0,1,0
20210225-W-Adelaide-QF-Jil_Teichmann-Anastasija_Sevastova,2,B-XC,110,22,1,8,13,52,58
20210225-W-Adelaide-QF-Jil_Teichmann-Anastasija_Sevastova,2,B-DTM,68,1,0,0,1,37,31
20210225-W-Adelaide-QF-Jil_Teichmann-Anastasija_Sevastova,2,B-DTL,15,8,3,2,3,10,5
20210225-W-Adelaide-QF-Jil_Teichmann-Anastasija_Sevastova,2,B-IO,9,5,2,1,2,7,2
20210225-W-Adelaide-QF-Jil_Teichmann-Anastasija_Sevastova,2,S-XC,8,1,0,1,0,6,2
20210225-W-Adelaide-QF-Jil_Teichmann-Anastasija_Sevastova,2,S-DTM,12,0,0,0,0,2,10
20210225-W-Adelaide-QF-Jil_Teichmann-Anastasija_Sevastova,2,S-DTL,3,0,0,0,0,1,2
20210225-W-Adelaide-QF-Jil_Teichmann-Anastasija_Sevastova,2,S-IO,2,1,0,0,1,1,1
20210303-W-Doha-R16-Elina_Svitolina-Misaki_Doi,1,F-XC,26,7,4,0,3,16,10
20210303-W-Doha-R16-Elina_Svitolina-Misaki_Doi,1,F-DTM,17,1,0,0,1,9,8
20210303-W-Doha-R16-Elina_Svitolina-Misaki_Doi,1,F-DTL,9,5,2,1,2,6,3
20210303-W-Doha-R16-Elina_Svitolina-Misaki_Doi,1,F-IO,14,10,8,1,1,11,3
20210303-W-Doha-R16-Elina_Svitolina-Misaki_Doi,1,F-II,1,1,0,0,1,0,1
20210303-W-Doha-R16-Elina_Svitolina-Misaki_Doi,1,B-XC,15,5,3,1,1,9,6
20210303-W-Doha-R16-Elina_Svitolina-Misaki_Doi,1,B-DTM,9,2,0,1,1,5,4
20210303-W-Doha-R16-Elina_Svitolina-Misaki_Doi,1,B-DTL,4,2,0,0,2,1,3
20210303-W-Doha-R16-Elina_Svitolina-Misaki_Doi,1,B-IO,3,2,2,0,0,2,1
20210303-W-Doha-R16-Elina_Svitolina-Misaki_Doi,1,S-XC,5,0,0,0,0,3,2
20210303-W-Doha-R16-Elina_Svitolina-Misaki_Doi,1,S-DTM,3,0,0,0,0,1,2
20210303-W-Doha-R16-Elina_Svitolina-Misaki_Doi,1,S-DTL,1,0,0,0,0,0,1
20210303-W-Doha-R16-Elina_Svitolina-Misaki_Doi,1,S-IO,1,0,0,0,0,0,1
20210303-W-Doha-R16-Elina_Svitolina-Misaki_Doi,2,F-XC,31,7,2,2,3,14,17
20210303-W-Doha-R16-Elina_Svitolina-Misaki_Doi,2,F-DTM,17,1,0,0,1,4,13
20210303-W-Doha-R16-Elina_Svitolina-Misaki_Doi,2,F-DTL,12,7,3,1,3,7,5
20210303-W-Doha-R16-Elina_Svitolina-Misaki_Doi,2,F-IO,13,3,0,2,1,8,5
20210303-W-Doha-R16-Elina_Svitolina-Misaki_Doi,2,B-XC,13,2,0,0,2,5,8
20210303-W-Doha-R16-Elina_Svitolina-Misaki_Doi,2,B-DTM,11,2,0,0,2,6,5
20210303-W-Doha-R16-Elina_Svitolina-Misaki_Doi,2,B-DTL,2,1,1,0,0,1,1
20210303-W-Doha-R16-Elina_Svitolina-Misaki_Doi,2,S-XC,1,0,0,0,0,0,1
20210303-W-Doha-R16-Elina_Svitolina-Misaki_Doi,2,S-DTM,3,1,0,0,1,1,2
20210205-W-ITF_Manacor-QF-Oksana_Selekhmeteva-Alexandra_Eala,1,F-XC,58,21,9,7,5,34,24
20210205-W-ITF_Manacor-QF-Oksana_Selekhmeteva-Alexandra_Eala,1,F-DTM,31,4,0,2,2,17,14
20210205-W-ITF_Manacor-QF-Oksana_Selekhmeteva-Alexandra_Eala,1,F-DTL,9,6,1,2,3,6,3
20210205-W-ITF_Manacor-QF-Oksana_Selekhmeteva-Alexandra_Eala,1,F-IO,15,6,4,1,1,11,4
20210205-W-ITF_Manacor-QF-Oksana_Selekhmeteva-Alexandra_Eala,1,F-II,1,0,0,0,0,1,0
20210205-W-ITF_Manacor-QF-Oksana_Selekhmeteva-Alexandra_Eala,1,B-XC,17,5,2,2,1,12,5
20210205-W-ITF_Manacor-QF-Oksana_Selekhmeteva-Alexandra_Eala,1,B-DTM,10,1,1,0,0,9,1
20210205-W-ITF_Manacor-QF-Oksana_Selekhmeteva-Alexandra_Eala,1,B-DTL,1,0,0,0,0,1,0
20210205-W-ITF_Manacor-QF-Oksana_Selekhmeteva-Alexandra_Eala,1,B-IO,1,1,0,1,0,1,0
20210205-W-ITF_Manacor-QF-Oksana_Selekhmeteva-Alexandra_Eala,1,S-XC,12,1,0,0,1,6,6
20210205-W-ITF_Manacor-QF-Oksana_Selekhmeteva-Alexandra_Eala,1,S-DTM,12,2,0,1,1,7,5
20210205-W-ITF_Manacor-QF-Oksana_Selekhmeteva-Alexandra_Eala,1,S-DTL,1,0,0,0,0,1,0
20210205-W-ITF_Manacor-QF-Oksana_Selekhmeteva-Alexandra_Eala,1,S-IO,1,0,0,0,0,1,0
20210205-W-ITF_Manacor-QF-Oksana_Selekhmeteva-Alexandra_Eala,2,F-XC,50,7,0,4,3,22,28
20210205-W-ITF_Manacor-QF-Oksana_Selekhmeteva-Alexandra_Eala,2,F-DTM,27,2,0,1,1,12,15
20210205-W-ITF_Manacor-QF-Oksana_Selekhmeteva-Alexandra_Eala,2,F-DTL,10,4,0,1,3,3,7
20210205-W-ITF_Manacor-QF-Oksana_Selekhmeteva-Alexandra_Eala,2,F-IO,9,2,1,0,1,2,7
20210205-W-ITF_Manacor-QF-Oksana_Selekhmeteva-Alexandra_Eala,2,B-XC,29,5,2,2,1,11,18
20210205-W-ITF_Manacor-QF-Oksana_Selekhmeteva-Alexandra_Eala,2,B-DTM,22,2,0,2,0,10,12
20210205-W-ITF_Manacor-QF-Oksana_Selekhmeteva-Alexandra_Eala,2,B-DTL,5,3,0,1,2,1,4
20210205-W-ITF_Manacor-QF-Oksana_Selekhmeteva-Alexandra_Eala,2,B-IO,1,0,0,0,0,1,0
20210205-W-ITF_Manacor-QF-Oksana_Selekhmeteva-Alexandra_Eala,2,S-XC,3,0,0,0,0,2,1
20210205-W-ITF_Manacor-QF-Oksana_Selekhmeteva-Alexandra_Eala,2,S-DTM,2,0,0,0,0,0,2
20201001-W-Roland_Garros-R64-Leylah_Annie_Fernandez-Polona_Hercog,1,F-XC,59,6,3,0,3,25,34
20201001-W-Roland_Garros-R64-Leylah_Annie_Fernandez-Polona_Hercog,1,F-DTM,40,1,0,0,1,20,20
20201001-W-Roland_Garros-R64-Leylah_Annie_Fernandez-Polona_Hercog,1,F-DTL,16,6,2,1,3,9,7
20201001-W-Roland_Garros-R64-Leylah_Annie_Fernandez-Polona_Hercog,1,F-IO,23,7,3,2,2,15,8
20201001-W-Roland_Garros-R64-Leylah_Annie_Fernandez-Polona_Hercog,1,F-II,6,2,2,0,0,5,1
20201001-W-Roland_Garros-R64-Leylah_Annie_Fernandez-Polona_Hercog,1,B-XC,49,6,2,2,2,25,24
20201001-W-Roland_Garros-R64-Leylah_Annie_Fernandez-Polona_Hercog,1,B-DTM,21,2,0,0,2,6,15
20201001-W-Roland_Garros-R64-Leylah_Annie_Fernandez-Polona_Hercog,1,B-DTL,9,5,3,0,2,6,3
20201001-W-Roland_Garros-R64-Leylah_Annie_Fernandez-Polona_Hercog,1,B-IO,8,1,0,0,1,4,4
20201001-W-Roland_Garros-R64-Leylah_Annie_Fernandez-Polona_Hercog,1,S-XC,1,0,0,0,0,1,0
20201001-W-Roland_Garros-R64-Leylah_Annie_Fernandez-Polona_Hercog,1,S-DTM,3,0,0,0,0,0,3
20201001-W-Roland_Garros-R64-Leylah_Annie_Fernandez-Polona_Hercog,1,S-DTL,5,0,0,0,0,2,3
20201001-W-Roland_Garros-R64-Leylah_Annie_Fernandez-Polona_Hercog,2,F-XC,63,21,9,5,7,39,24
20201001-W-Roland_Garros-R64-Leylah_Annie_Fernandez-Polona_Hercog,2,F-DTM,50,6,0,0,6,17,33
20201001-W-Roland_Garros-R64-Leylah_Annie_Fernandez-Polona_Hercog,2,F-DTL,20,13,4,1,8,9,11
20201001-W-Roland_Garros-R64-Leylah_Annie_Fernandez-Polona_Hercog,2,F-IO,24,11,2,3,6,13,11
20201001-W-Roland_Garros-R64-Leylah_Annie_Fernandez-Polona_Hercog,2,F-II,1,0,0,0,0,1,0
20201001-W-Roland_Garros-R64-Leylah_Annie_Fernandez-Polona_Hercog,2,B-XC,36,12,1,7,4,21,15
20201001-W-Roland_Garros-R64-Leylah_Annie_Fernandez-Polona_Hercog,2,B-DTM,24,3,1,2,0,16,8
20201001-W-Roland_Garros-R64-Leylah_Annie_Fernandez-Polona_Hercog,2,B-DTL,7,2,0,1,1,6,1
20201001-W-Roland_Garros-R64-Leylah_Annie_Fernandez-Polona_Hercog,2,B-IO,2,1,1,0,0,1,1
20201001-W-Roland_Garros-R64-Leylah_Annie_Fernandez-Polona_Hercog,2,S-XC,6,1,0,0,1,4,2
20201001-W-Roland_Garros-R64-Leylah_Annie_Fernandez-Polona_Hercog,2,S-DTM,17,1,0,0,1,7,10
20201001-W-Roland_Garros-R64-Leylah_Annie_Fernandez-Polona_Hercog,2,S-DTL,9,0,0,0,0,4,5
20201001-W-Roland_Garros-R64-Leylah_Annie_Fernandez-Polona_Hercog,2,S-IO,2,1,1,0,0,2,0
20210209-W-Australian_Open-R128-Destanee_Aiava-Samantha_Stosur,1,F-XC,40,9,2,1,6,19,21
20210209-W-Australian_Open-R128-Destanee_Aiava-Samantha_Stosur,1,F-DTM,47,6,0,2,4,18,29
20210209-W-Australian_Open-R128-Destanee_Aiava-Samantha_Stosur,1,F-DTL,13,6,4,2,0,11,2
20210209-W-Australian_Open-R128-Destanee_Aiava-Samantha_Stosur,1,F-IO,28,9,3,4,2,15,13
20210209-W-Australian_Open-R128-Destanee_Aiava-Samantha_Stosur,1,F-II,1,1,1,0,0,1,0
20210209-W-Australian_Open-R128-Destanee_Aiava-Samantha_Stosur,1,B-XC,38,7,1,2,4,18,20
20210209-W-Australian_Open-R128-Destanee_Aiava-Samantha_Stosur,1,B-DTM,44,5,0,2,3,19,25
20210209-W-Australian_Open-R128-Destanee_Aiava-Samantha_Stosur,1,B-DTL,4,2,1,1,0,3,1
20210209-W-Australian_Open-R128-Destanee_Aiava-Samantha_Stosur,1,B-IO,10,4,0,1,3,3,7
20210209-W-Australian_Open-R128-Destanee_Aiava-Samantha_Stosur,1,S-XC,6,0,0,0,0,2,4
20210209-W-Australian_Open-R128-Destanee_Aiava-Samantha_Stosur,1,S-DTM,9,2,0,0,2,4,5
20210209-W-Australian_Open-R128-Destanee_Aiava-Samantha_Stosur,1,S-DTL,1,0,0,0,0,0,1
20210209-W-Australian_Open-R128-Destanee_Aiava-Samantha_Stosur,1,S-IO,1,1,0,0,1,0,1
20210209-W-Australian_Open-R128-Destanee_Aiava-Samantha_Stosur,2,F-XC,36,9,3,2,4,19,17
20210209-W-Australian_Open-R128-Destanee_Aiava-Samantha_Stosur,2,F-DTM,47,1,0,0,1,23,24
20210209-W-Australian_Open-R128-Destanee_Aiava-Samantha_Stosur,2,F-DTL,15,3,0,2,1,10,5
20210209-W-Australian_Open-R128-Destanee_Aiava-Samantha_Stosur,2,F-IO,48,16,3,5,8,26,22
20210209-W-Australian_Open-R128-Destanee_Aiava-Samantha_Stosur,2,F-II,4,3,0,2,1,3,1
20210209-W-Australian_Open-R128-Destanee_Aiava-Samantha_Stosur,2,B-XC,1,0,0,0,0,1,0
20210209-W-Australian_Open-R128-Destanee_Aiava-Samantha_Stosur,2,B-DTM,12,1,1,0,0,6,6
20210209-W-Australian_Open-R128-Destanee_Aiava-Samantha_Stosur,2,B-DTL,7,5,3,1,1,6,1
20210209-W-Australian_Open-R128-Destanee_Aiava-Samantha_Stosur,2,B-IO,3,1,0,0,1,1,2
20210209-W-Australian_Open-R128-Destanee_Aiava-Samantha_Stosur,2,S-XC,15,2,1,0,1,8,7
20210209-W-Australian_Open-R128-Destanee_Aiava-Samantha_Stosur,2,S-DTM,39,2,0,0,2,19,20
20210209-W-Australian_Open-R128-Destanee_Aiava-Samantha_Stosur,2,S-DTL,1,0,0,0,0,0,1
20210209-W-Australian_Open-R128-Destanee_Aiava-Samantha_Stosur,2,S-IO,1,0,0,0,0,0,1
20210309-W-Dubai-R32-Tereza_Martincova-Kiki_Bertens,1,F-XC,42,6,0,2,4,23,19
20210309-W-Dubai-R32-Tereza_Martincova-Kiki_Bertens,1,F-DTM,50,4,1,1,2,31,19
20210309-W-Dubai-R32-Tereza_Martincova-Kiki_Bertens,1,F-DTL,12,4,2,0,2,8,4
20210309-W-Dubai-R32-Tereza_Martincova-Kiki_Bertens,1,F-IO,25,12,5,2,5,12,13
20210309-W-Dubai-R32-Tereza_Martincova-Kiki_Bertens,1,B-XC,10,2,1,1,0,8,2
20210309-W-Dubai-R32-Tereza_Martincova-Kiki_Bertens,1,B-DTM,24,2,0,0,2,16,8
20210309-W-Dubai-R32-Tereza_Martincova-Kiki_Bertens,1,B-DTL,2,2,1,1,0,2,0
20210309-W-Dubai-R32-Tereza_Martincova-Kiki_Bertens,1,B-IO,1,0,0,0,0,0,1
20210309-W-Dubai-R32-Tereza_Martincova-Kiki_Bertens,1,S-DTM,1,0,0,0,0,0,1
20210309-W-Dubai-R32-Tereza_Martincova-Kiki_Bertens,1,S-DTL,1,0,0,0,0,0,1
20210309-W-Dubai-R32-Tereza_Martincova-Kiki_Bertens,1,S-IO,1,0,0,0,0,0,1
20210309-W-Dubai-R32-Tereza_Martincova-Kiki_Bertens,2,F-XC,59,18,5,4,9,29,30
20210309-W-Dubai-R32-Tereza_Martincova-Kiki_Bertens,2,F-DTM,36,5,1,0,4,15,21
20210309-W-Dubai-R32-Tereza_Martincova-Kiki_Bertens,2,F-DTL,5,2,0,0,2,0,5
20210309-W-Dubai-R32-Tereza_Martincova-Kiki_Bertens,2,F-IO,13,7,1,2,4,7,6
20210309-W-Dubai-R32-Tereza_Martincova-Kiki_Bertens,2,F-II,2,1,0,1,0,2,0
20210309-W-Dubai-R32-Tereza_Martincova-Kiki_Bertens,2,B-XC,19,5,0,0,5,3,16
20210309-W-Dubai-R32-Tereza_Martincova-Kiki_Bertens,2,B-DTM,26,3,0,0,3,13,13
20210309-W-Dubai-R32-Tereza_Martincova-Kiki_Bertens,2,B-DTL,5,3,0,0,3,0,5
20210309-W-Dubai-R32-Tereza_Martincova-Kiki_Bertens,2,B-IO,3,1,0,0,1,2,1
20210309-W-Dubai-R32-Tereza_Martincova-Kiki_Bertens,2,S-XC,2,1,1,0,0,2,0
20210309-W-Dubai-R32-Tereza_Martincova-Kiki_Bertens,2,S-DTM,8,0,0,0,0,5,3
20210309-W-Dubai-R32-Tereza_Martincova-Kiki_Bertens,2,S-DTL,1,0,0,0,0,0,1
20210304-W-Lyon-R16-Arantxa_Rus-Greet_Minnen,1,F-XC,71,12,2,2,8,42,29
20210304-W-Lyon-R16-Arantxa_Rus-Greet_Minnen,1,F-DTM,65,6,0,2,4,33,32
20210304-W-Lyon-R16-Arantxa_Rus-Greet_Minnen,1,F-DTL,4,1,0,0,1,2,2
20210304-W-Lyon-R16-Arantxa_Rus-Greet_Minnen,1,F-IO,33,13,4,5,4,20,13
20210304-W-Lyon-R16-Arantxa_Rus-Greet_Minnen,1,B-XC,18,6,1,3,2,8,10
20210304-W-Lyon-R16-Arantxa_Rus-Greet_Minnen,1,B-DTM,37,2,0,0,2,19,18
20210304-W-Lyon-R16-Arantxa_Rus-Greet_Minnen,1,B-DTL,9,2,1,1,0,6,3
20210304-W-Lyon-R16-Arantxa_Rus-Greet_Minnen,1,B-IO,12,3,0,0,3,3,9
20210304-W-Lyon-R16-Arantxa_Rus-Greet_Minnen,1,S-XC,4,1,0,1,0,4,0
20210304-W-Lyon-R16-Arantxa_Rus-Greet_Minnen,1,S-DTM,1,0,0,0,0,1,0
20210304-W-Lyon-R16-Arantxa_Rus-Greet_Minnen,2,F-XC,45,9,0,5,4,24,21
20210304-W-Lyon-R16-Arantxa_Rus-Greet_Minnen,2,F-DTM,50,4,0,1,3,21,29
20210304-W-Lyon-R16-Arantxa_Rus-Greet_Minnen,2,F-DTL,11,6,1,3,2,5,6
20210304-W-Lyon-R16-Arantxa_Rus-Greet_Minnen,2,F-IO,36,15,4,3,8,18,18
20210304-W-Lyon-R16-Arantxa_Rus-Greet_Minnen,2,F-II,1,0,0,0,0,0,1
20210304-W-Lyon-R16-Arantxa_Rus-Greet_Minnen,2,B-XC,41,8,0,4,4,21,20
20210304-W-Lyon-R16-Arantxa_Rus-Greet_Minnen,2,B-DTM,55,6,0,1,5,19,36
20210304-W-Lyon-R16-Arantxa_Rus-Greet_Minnen,2,B-DTL,6,4,1,2,1,4,2
20210304-W-Lyon-R16-Arantxa_Rus-Greet_Minnen,2,S-XC,7,0,0,0,0,2,5
20210304-W-Lyon-R16-Arantxa_Rus-Greet_Minnen,2,S-DTM,10,0,0,0,0,6,4
20210304-W-Lyon-R16-Arantxa_Rus-Greet_Minnen,2,S-DTL,3,1,0,0,1,1,2
20210307-W-Lyon-F-Clara_Tauson-Viktorija_Golubic,1,F-XC,35,10,3,3,4,24,11
20210307-W-Lyon-F-Clara_Tauson-Viktorija_Golubic,1,F-DTM,19,1,1,0,0,11,8
20210307-W-Lyon-F-Clara_Tauson-Viktorija_Golubic,1,F-DTL,6,4,2,0,2,3,3
20210307-W-Lyon-F-Clara_Tauson-Viktorija_Golubic,1,F-IO,22,8,6,1,1,16,6
20210307-W-Lyon-F-Clara_Tauson-Viktorija_Golubic,1,F-II,2,2,1,1,0,2,0
20210307-W-Lyon-F-Clara_Tauson-Viktorija_Golubic,1,B-XC,38,8,1,3,4,20,18
20210307-W-Lyon-F-Clara_Tauson-Viktorija_Golubic,1,B-DTM,36,4,0,2,2,21,15
20210307-W-Lyon-F-Clara_Tauson-Viktorija_Golubic,1,B-DTL,7,4,2,0,2,4,3
20210307-W-Lyon-F-Clara_Tauson-Viktorija_Golubic,1,B-IO,13,9,5,1,3,9,4
20210307-W-Lyon-F-Clara_Tauson-Viktorija_Golubic,1,S-XC,4,1,0,0,1,1,3
20210307-W-Lyon-F-Clara_Tauson-Viktorija_Golubic,1,S-DTM,4,0,0,0,0,2,2
20210307-W-Lyon-F-Clara_Tauson-Viktorija_Golubic,2,F-XC,19,5,2,1,2,9,10
20210307-W-Lyon-F-Clara_Tauson-Viktorija_Golubic,2,F-DTM,25,4,0,1,3,10,15
20210307-W-Lyon-F-Clara_Tauson-Viktorija_Golubic,2,F-DTL,9,1,0,1,0,6,3
20210307-W-Lyon-F-Clara_Tauson-Viktorija_Golubic,2,F-IO,20,1,1,0,0,10,10
20210307-W-Lyon-F-Clara_Tauson-Viktorija_Golubic,2,B-XC,12,5,0,2,3,4,8
20210307-W-Lyon-F-Clara_Tauson-Viktorija_Golubic,2,B-DTM,35,5,0,1,4,12,23
20210307-W-Lyon-F-Clara_Tauson-Viktorija_Golubic,2,B-DTL,3,2,0,0,2,0,3
20210307-W-Lyon-F-Clara_Tauson-Viktorija_Golubic,2,B-IO,4,1,0,0,1,0,4
20210307-W-Lyon-F-Clara_Tauson-Viktorija_Golubic,2,S-XC,16,1,1,0,0,7,9
20210307-W-Lyon-F-Clara_Tauson-Viktorija_Golubic,2,S-DTM,15,0,0,0,0,6,9
20210307-W-Lyon-F-Clara_Tauson-Viktorija_Golubic,2,S-DTL,3,0,0,0,0,1,2
20210312-W-Dubai-SF-Jil_Teichmann-Barbora_Krejcikova,1,F-XC,26,6,1,1,4,11,15
20210312-W-Dubai-SF-Jil_Teichmann-Barbora_Krejcikova,1,F-DTM,35,2,0,0,2,13,22
20210312-W-Dubai-SF-Jil_Teichmann-Barbora_Krejcikova,1,F-DTL,7,2,0,0,2,4,3
20210312-W-Dubai-SF-Jil_Teichmann-Barbora_Krejcikova,1,F-IO,11,5,2,0,3,3,8
20210312-W-Dubai-SF-Jil_Teichmann-Barbora_Krejcikova,1,F-II,2,1,0,0,1,1,1
20210312-W-Dubai-SF-Jil_Teichmann-Barbora_Krejcikova,1,B-XC,34,9,2,2,5,19,15
20210312-W-Dubai-SF-Jil_Teichmann-Barbora_Krejcikova,1,B-DTM,51,7,0,0,7,23,28
20210312-W-Dubai-SF-Jil_Teichmann-Barbora_Krejcikova,1,B-DTL,5,3,1,1,1,3,2
20210312-W-Dubai-SF-Jil_Teichmann-Barbora_Krejcikova,1,B-IO,3,2,0,0,2,1,2
20210312-W-Dubai-SF-Jil_Teichmann-Barbora_Krejcikova,1,S-XC,6,1,0,0,1,3,3
20210312-W-Dubai-SF-Jil_Teichmann-Barbora_Krejcikova,1,S-DTM,10,2,0,0,2,4,6
20210312-W-Dubai-SF-Jil_Teichmann-Barbora_Krejcikova,1,S-DTL,1,1,0,1,0,1,0
20210312-W-Dubai-SF-Jil_Teichmann-Barbora_Krejcikova,2,F-XC,78,15,1,5,9,36,42
20210312-W-Dubai-SF-Jil_Teichmann-Barbora_Krejcikova,2,F-DTM,29,5,1,0,4,18,11
20210312-W-Dubai-SF-Jil_Teichmann-Barbora_Krejcikova,2,F-DTL,6,6,3,1,2,4,2
20210312-W-Dubai-SF-Jil_Teichmann-Barbora_Krejcikova,2,F-IO,17,11,7,1,3,10,7
20210312-W-Dubai-SF-Jil_Teichmann-Barbora_Krejcikova,2,B-XC,26,7,0,2,5,16,10
20210312-W-Dubai-SF-Jil_Teichmann-Barbora_Krejcikova,2,B-DTM,23,3,0,2,1,14,9
20210312-W-Dubai-SF-Jil_Teichmann-Barbora_Krejcikova,2,B-DTL,9,6,2,1,3,3,6
20210312-W-Dubai-SF-Jil_Teichmann-Barbora_Krejcikova,2,B-IO,15,5,0,1,4,8,7
20210312-W-Dubai-SF-Jil_Teichmann-Barbora_Krejcikova,2,S-IO,1,0,0,0,0,0,1
20210313-W-Guadalajara-F-Eugenie_Bouchard-Sara_Sorribes_Tormo,1,F-XC,70,20,2,8,10,34,36
20210313-W-Guadalajara-F-Eugenie_Bouchard-Sara_Sorribes_Tormo,1,F-DTM,36,4,0,0,4,18,18
20210313-W-Guadalajara-F-Eugenie_Bouchard-Sara_Sorribes_Tormo,1,F-DTL,2,2,0,0,2,0,2
20210313-W-Guadalajara-F-Eugenie_Bouchard-Sara_Sorribes_Tormo,1,F-IO,42,15,6,3,6,20,22
20210313-W-Guadalajara-F-Eugenie_Bouchard-Sara_Sorribes_Tormo,1,F-II,1,0,0,0,0,0,1
20210313-W-Guadalajara-F-Eugenie_Bouchard-Sara_Sorribes_Tormo,1,B-XC,71,20,4,3,13,33,38
20210313-W-Guadalajara-F-Eugenie_Bouchard-Sara_Sorribes_Tormo,1,B-DTM,31,3,1,1,1,12,19
20210313-W-Guadalajara-F-Eugenie_Bouchard-Sara_Sorribes_Tormo,1,B-DTL,5,2,1,0,1,1,4
20210313-W-Guadalajara-F-Eugenie_Bouchard-Sara_Sorribes_Tormo,1,B-IO,6,4,0,3,1,4,2
20210313-W-Guadalajara-F-Eugenie_Bouchard-Sara_Sorribes_Tormo,1,S-XC,4,0,0,0,0,0,4
20210313-W-Guadalajara-F-Eugenie_Bouchard-Sara_Sorribes_Tormo,1,S-DTM,1,0,0,0,0,1,0
20210313-W-Guadalajara-F-Eugenie_Bouchard-Sara_Sorribes_Tormo,1,S-IO,2,1,0,0,1,0,2
20210313-W-Guadalajara-F-Eugenie_Bouchard-Sara_Sorribes_Tormo,2,F-XC,21,3,0,3,0,13,8
20210313-W-Guadalajara-F-Eugenie_Bouchard-Sara_Sorribes_Tormo,2,F-DTM,79,1,0,1,0,41,38
20210313-W-Guadalajara-F-Eugenie_Bouchard-Sara_Sorribes_Tormo,2,F-DTL,11,4,1,0,3,6,5
20210313-W-Guadalajara-F-Eugenie_Bouchard-Sara_Sorribes_Tormo,2,F-IO,29,2,0,0,2,14,15
20210313-W-Guadalajara-F-Eugenie_Bouchard-Sara_Sorribes_Tormo,2,B-XC,4,1,0,1,0,3,1
20210313-W-Guadalajara-F-Eugenie_Bouchard-Sara_Sorribes_Tormo,2,B-DTM,32,4,0,1,3,15,17
20210313-W-Guadalajara-F-Eugenie_Bouchard-Sara_Sorribes_Tormo,2,B-DTL,5,0,0,0,0,1,4
20210313-W-Guadalajara-F-Eugenie_Bouchard-Sara_Sorribes_Tormo,2,B-IO,2,1,0,0,1,1,1
20210313-W-Guadalajara-F-Eugenie_Bouchard-Sara_Sorribes_Tormo,2,S-XC,20,2,0,1,1,13,7
20210313-W-Guadalajara-F-Eugenie_Bouchard-Sara_Sorribes_Tormo,2,S-DTM,44,4,0,0,4,28,16
20210313-W-Guadalajara-F-Eugenie_Bouchard-Sara_Sorribes_Tormo,2,S-DTL,2,1,1,0,0,1,1
20210313-W-Guadalajara-F-Eugenie_Bouchard-Sara_Sorribes_Tormo,2,S-IO,5,1,0,0,1,3,2
20210312-W-Guadalajara-SF-Sara_Sorribes_Tormo-Marie_Bouzkova,1,F-XC,20,3,1,1,1,15,5
20210312-W-Guadalajara-SF-Sara_Sorribes_Tormo-Marie_Bouzkova,1,F-DTM,83,5,0,1,4,51,32
20210312-W-Guadalajara-SF-Sara_Sorribes_Tormo-Marie_Bouzkova,1,F-DTL,6,0,0,0,0,4,2
20210312-W-Guadalajara-SF-Sara_Sorribes_Tormo-Marie_Bouzkova,1,F-IO,46,4,0,2,2,29,17
20210312-W-Guadalajara-SF-Sara_Sorribes_Tormo-Marie_Bouzkova,1,B-XC,4,0,0,0,0,2,2
20210312-W-Guadalajara-SF-Sara_Sorribes_Tormo-Marie_Bouzkova,1,B-DTM,28,6,0,3,3,12,16
20210312-W-Guadalajara-SF-Sara_Sorribes_Tormo-Marie_Bouzkova,1,B-DTL,1,0,0,0,0,0,1
20210312-W-Guadalajara-SF-Sara_Sorribes_Tormo-Marie_Bouzkova,1,B-IO,2,0,0,0,0,1,1
20210312-W-Guadalajara-SF-Sara_Sorribes_Tormo-Marie_Bouzkova,1,S-XC,28,1,0,0,1,21,7
20210312-W-Guadalajara-SF-Sara_Sorribes_Tormo-Marie_Bouzkova,1,S-DTM,78,4,0,0,4,41,37
20210312-W-Guadalajara-SF-Sara_Sorribes_Tormo-Marie_Bouzkova,1,S-DTL,5,1,0,1,0,4,1
20210312-W-Guadalajara-SF-Sara_Sorribes_Tormo-Marie_Bouzkova,1,S-IO,3,1,0,1,0,2,1
20210312-W-Guadalajara-SF-Sara_Sorribes_Tormo-Marie_Bouzkova,2,F-XC,42,13,2,5,6,15,27
20210312-W-Guadalajara-SF-Sara_Sorribes_Tormo-Marie_Bouzkova,2,F-DTM,61,8,0,1,7,21,40
20210312-W-Guadalajara-SF-Sara_Sorribes_Tormo-Marie_Bouzkova,2,F-DTL,7,3,1,0,2,4,3
20210312-W-Guadalajara-SF-Sara_Sorribes_Tormo-Marie_Bouzkova,2,F-IO,48,18,5,4,9,26,22
20210312-W-Guadalajara-SF-Sara_Sorribes_Tormo-Marie_Bouzkova,2,B-XC,49,7,0,1,6,19,30
20210312-W-Guadalajara-SF-Sara_Sorribes_Tormo-Marie_Bouzkova,2,B-DTM,65,7,0,2,5,24,41
20210312-W-Guadalajara-SF-Sara_Sorribes_Tormo-Marie_Bouzkova,2,B-DTL,13,6,4,0,2,8,5
20210312-W-Guadalajara-SF-Sara_Sorribes_Tormo-Marie_Bouzkova,2,B-IO,18,11,3,2,6,10,8
20210312-W-Guadalajara-SF-Sara_Sorribes_Tormo-Marie_Bouzkova,2,S-XC,11,2,0,0,2,2,9
20210312-W-Guadalajara-SF-Sara_Sorribes_Tormo-Marie_Bouzkova,2,S-DTM,13,1,0,0,1,4,9
20210312-W-Guadalajara-SF-Sara_Sorribes_Tormo-Marie_Bouzkova,2,S-DTL,2,2,0,0,2,0,2
20210308-W-Guadalajara-R32-Marie_Bouzkova-Irina_Maria_Bara,1,F-XC,39,6,1,3,2,19,20
20210308-W-Guadalajara-R32-Marie_Bouzkova-Irina_Maria_Bara,1,F-DTM,36,4,0,0,4,17,19
20210308-W-Guadalajara-R32-Marie_Bouzkova-Irina_Maria_Bara,1,F-DTL,15,3,0,1,2,6,9
20210308-W-Guadalajara-R32-Marie_Bouzkova-Irina_Maria_Bara,1,F-IO,20,6,1,2,3,10,10
20210308-W-Guadalajara-R32-Marie_Bouzkova-Irina_Maria_Bara,1,B-XC,35,6,0,3,3,19,16
20210308-W-Guadalajara-R32-Marie_Bouzkova-Irina_Maria_Bara,1,B-DTM,55,5,1,0,4,32,23
20210308-W-Guadalajara-R32-Marie_Bouzkova-Irina_Maria_Bara,1,B-DTL,8,4,3,0,1,6,2
20210308-W-Guadalajara-R32-Marie_Bouzkova-Irina_Maria_Bara,1,B-IO,11,7,2,3,2,7,4
20210308-W-Guadalajara-R32-Marie_Bouzkova-Irina_Maria_Bara,1,S-XC,3,2,0,0,2,1,2
20210308-W-Guadalajara-R32-Marie_Bouzkova-Irina_Maria_Bara,1,S-DTM,5,1,0,0,1,2,3
20210308-W-Guadalajara-R32-Marie_Bouzkova-Irina_Maria_Bara,1,S-DTL,1,0,0,0,0,0,1
20210308-W-Guadalajara-R32-Marie_Bouzkova-Irina_Maria_Bara,1,S-IO,1,0,0,0,0,0,1
20210308-W-Guadalajara-R32-Marie_Bouzkova-Irina_Maria_Bara,2,F-XC,38,14,4,3,7,21,17
20210308-W-Guadalajara-R32-Marie_Bouzkova-Irina_Maria_Bara,2,F-DTM,48,7,0,1,6,15,33
20210308-W-Guadalajara-R32-Marie_Bouzkova-Irina_Maria_Bara,2,F-DTL,11,2,1,1,0,6,5
20210308-W-Guadalajara-R32-Marie_Bouzkova-Irina_Maria_Bara,2,F-IO,33,7,0,2,5,12,21
20210308-W-Guadalajara-R32-Marie_Bouzkova-Irina_Maria_Bara,2,B-XC,29,5,1,2,2,14,15
20210308-W-Guadalajara-R32-Marie_Bouzkova-Irina_Maria_Bara,2,B-DTM,40,3,0,0,3,14,26
20210308-W-Guadalajara-R32-Marie_Bouzkova-Irina_Maria_Bara,2,B-DTL,5,3,1,1,1,4,1
20210308-W-Guadalajara-R32-Marie_Bouzkova-Irina_Maria_Bara,2,B-IO,12,4,1,0,3,9,3
20210308-W-Guadalajara-R32-Marie_Bouzkova-Irina_Maria_Bara,2,S-XC,4,0,0,0,0,3,1
20210308-W-Guadalajara-R32-Marie_Bouzkova-Irina_Maria_Bara,2,S-DTM,12,1,0,0,1,5,7
20210317-W-St_Petersburg-R16-Jaqueline_Adina_Cristian-Jelena_Ostapenko,1,F-XC,43,7,2,2,3,21,22
20210317-W-St_Petersburg-R16-Jaqueline_Adina_Cristian-Jelena_Ostapenko,1,F-DTM,36,0,0,0,0,18,18
20210317-W-St_Petersburg-R16-Jaqueline_Adina_Cristian-Jelena_Ostapenko,1,F-DTL,3,1,0,0,1,1,2
20210317-W-St_Petersburg-R16-Jaqueline_Adina_Cristian-Jelena_Ostapenko,1,F-IO,13,5,1,1,3,5,8
20210317-W-St_Petersburg-R16-Jaqueline_Adina_Cristian-Jelena_Ostapenko,1,F-II,2,2,1,0,1,1,1
20210317-W-St_Petersburg-R16-Jaqueline_Adina_Cristian-Jelena_Ostapenko,1,B-XC,32,7,5,1,1,19,13
20210317-W-St_Petersburg-R16-Jaqueline_Adina_Cristian-Jelena_Ostapenko,1,B-DTM,28,4,0,0,4,7,21
20210317-W-St_Petersburg-R16-Jaqueline_Adina_Cristian-Jelena_Ostapenko,1,B-DTL,3,0,0,0,0,1,2
20210317-W-St_Petersburg-R16-Jaqueline_Adina_Cristian-Jelena_Ostapenko,1,B-IO,7,3,1,1,1,5,2
20210317-W-St_Petersburg-R16-Jaqueline_Adina_Cristian-Jelena_Ostapenko,1,S-XC,2,0,0,0,0,2,0
20210317-W-St_Petersburg-R16-Jaqueline_Adina_Cristian-Jelena_Ostapenko,1,S-DTM,12,0,0,0,0,4,8
20210317-W-St_Petersburg-R16-Jaqueline_Adina_Cristian-Jelena_Ostapenko,1,S-DTL,1,0,0,0,0,0,1
20210317-W-St_Petersburg-R16-Jaqueline_Adina_Cristian-Jelena_Ostapenko,2,F-XC,57,25,3,10,12,29,28
20210317-W-St_Petersburg-R16-Jaqueline_Adina_Cristian-Jelena_Ostapenko,2,F-DTM,15,0,0,0,0,9,6
20210317-W-St_Petersburg-R16-Jaqueline_Adina_Cristian-Jelena_Ostapenko,2,F-DTL,16,8,4,1,3,9,7
20210317-W-St_Petersburg-R16-Jaqueline_Adina_Cristian-Jelena_Ostapenko,2,F-IO,17,8,2,3,3,12,5
20210317-W-St_Petersburg-R16-Jaqueline_Adina_Cristian-Jelena_Ostapenko,2,F-II,1,0,0,0,0,1,0
20210317-W-St_Petersburg-R16-Jaqueline_Adina_Cristian-Jelena_Ostapenko,2,B-XC,38,12,2,2,8,17,21
20210317-W-St_Petersburg-R16-Jaqueline_Adina_Cristian-Jelena_Ostapenko,2,B-DTM,34,1,0,0,1,22,12
20210317-W-St_Petersburg-R16-Jaqueline_Adina_Cristian-Jelena_Ostapenko,2,B-DTL,15,8,3,0,5,6,9
20210317-W-St_Petersburg-R16-Jaqueline_Adina_Cristian-Jelena_Ostapenko,2,B-IO,8,4,0,0,4,2,6
20210317-W-St_Petersburg-R16-Jaqueline_Adina_Cristian-Jelena_Ostapenko,2,S-DTM,1,0,0,0,0,1,0
20210317-W-St_Petersburg-R16-Jaqueline_Adina_Cristian-Jelena_Ostapenko,2,S-DTL,1,0,0,0,0,0,1
20210317-W-St_Petersburg-R16-Jaqueline_Adina_Cristian-Jelena_Ostapenko,2,S-IO,1,0,0,0,0,1,0
20090416-W-Charleston-R16-Sabine_Lisicki-Venus_Williams,1,F-XC,24,14,5,3,6,14,10
20090416-W-Charleston-R16-Sabine_Lisicki-Venus_Williams,1,F-DTM,10,1,0,1,0,5,5
20090416-W-Charleston-R16-Sabine_Lisicki-Venus_Williams,1,F-DTL,6,2,1,0,1,5,1
20090416-W-Charleston-R16-Sabine_Lisicki-Venus_Williams,1,F-IO,10,5,3,2,0,8,2
20090416-W-Charleston-R16-Sabine_Lisicki-Venus_Williams,1,B-XC,22,6,2,1,3,12,10
20090416-W-Charleston-R16-Sabine_Lisicki-Venus_Williams,1,B-DTM,24,4,1,1,2,11,13
20090416-W-Charleston-R16-Sabine_Lisicki-Venus_Williams,1,B-DTL,7,4,2,0,2,4,3
20090416-W-Charleston-R16-Sabine_Lisicki-Venus_Williams,1,B-IO,1,0,0,0,0,1,0
20090416-W-Charleston-R16-Sabine_Lisicki-Venus_Williams,1,S-XC,2,0,0,0,0,1,1
20090416-W-Charleston-R16-Sabine_Lisicki-Venus_Williams,1,S-IO,1,0,0,0,0,1,0
20090416-W-Charleston-R16-Sabine_Lisicki-Venus_Williams,2,F-XC,23,6,1,1,4,10,13
20090416-W-Charleston-R16-Sabine_Lisicki-Venus_Williams,2,F-DTM,8,0,0,0,0,5,3
20090416-W-Charleston-R16-Sabine_Lisicki-Venus_Williams,2,F-DTL,5,2,0,2,0,2,3
20090416-W-Charleston-R16-Sabine_Lisicki-Venus_Williams,2,F-IO,17,6,1,0,5,9,8
20090416-W-Charleston-R16-Sabine_Lisicki-Venus_Williams,2,F-II,1,0,0,0,0,1,0
20090416-W-Charleston-R16-Sabine_Lisicki-Venus_Williams,2,B-XC,29,2,0,1,1,16,13
20090416-W-Charleston-R16-Sabine_Lisicki-Venus_Williams,2,B-DTM,10,0,0,0,0,3,7
20090416-W-Charleston-R16-Sabine_Lisicki-Venus_Williams,2,B-DTL,10,6,2,1,3,4,6
20090416-W-Charleston-R16-Sabine_Lisicki-Venus_Williams,2,S-DTM,1,0,0,0,0,0,1
20210321-W-Monterrey-F-Leylah_Annie_Fernandez-Viktorija_Golubic,1,F-XC,47,11,2,3,6,30,17
20210321-W-Monterrey-F-Leylah_Annie_Fernandez-Viktorija_Golubic,1,F-DTM,36,1,0,0,1,19,17
20210321-W-Monterrey-F-Leylah_Annie_Fernandez-Viktorija_Golubic,1,F-DTL,9,6,3,1,2,7,2
20210321-W-Monterrey-F-Leylah_Annie_Fernandez-Viktorija_Golubic,1,F-IO,17,6,2,2,2,12,5
20210321-W-Monterrey-F-Leylah_Annie_Fernandez-Viktorija_Golubic,1,F-II,1,1,1,0,0,1,0
20210321-W-Monterrey-F-Leylah_Annie_Fernandez-Viktorija_Golubic,1,B-XC,29,2,1,0,1,20,9
20210321-W-Monterrey-F-Leylah_Annie_Fernandez-Viktorija_Golubic,1,B-DTM,41,4,2,0,2,24,17
20210321-W-Monterrey-F-Leylah_Annie_Fernandez-Viktorija_Golubic,1,B-DTL,11,4,1,0,3,7,4
20210321-W-Monterrey-F-Leylah_Annie_Fernandez-Viktorija_Golubic,1,B-IO,10,3,0,2,1,6,4
20210321-W-Monterrey-F-Leylah_Annie_Fernandez-Viktorija_Golubic,1,S-XC,1,0,0,0,0,0,1
20210321-W-Monterrey-F-Leylah_Annie_Fernandez-Viktorija_Golubic,1,S-DTM,2,0,0,0,0,1,1
20210321-W-Monterrey-F-Leylah_Annie_Fernandez-Viktorija_Golubic,1,S-DTL,3,2,1,1,0,2,1
20210321-W-Monterrey-F-Leylah_Annie_Fernandez-Viktorija_Golubic,1,S-IO,2,1,0,0,1,1,1
20210321-W-Monterrey-F-Leylah_Annie_Fernandez-Viktorija_Golubic,2,F-XC,30,8,1,0,7,9,21
20210321-W-Monterrey-F-Leylah_Annie_Fernandez-Viktorija_Golubic,2,F-DTM,44,2,0,1,1,18,26
20210321-W-Monterrey-F-Leylah_Annie_Fernandez-Viktorija_Golubic,2,F-DTL,7,1,0,1,0,3,4
20210321-W-Monterrey-F-Leylah_Annie_Fernandez-Viktorija_Golubic,2,F-IO,11,5,3,0,2,6,5
20210321-W-Monterrey-F-Leylah_Annie_Fernandez-Viktorija_Golubic,2,B-XC,19,7,2,3,2,13,6
20210321-W-Monterrey-F-Leylah_Annie_Fernandez-Viktorija_Golubic,2,B-DTM,20,2,0,0,2,8,12
20210321-W-Monterrey-F-Leylah_Annie_Fernandez-Viktorija_Golubic,2,B-DTL,7,4,0,0,4,1,6
20210321-W-Monterrey-F-Leylah_Annie_Fernandez-Viktorija_Golubic,2,B-IO,8,2,1,1,0,6,2
20210321-W-Monterrey-F-Leylah_Annie_Fernandez-Viktorija_Golubic,2,S-XC,11,3,0,1,2,2,9
20210321-W-Monterrey-F-Leylah_Annie_Fernandez-Viktorija_Golubic,2,S-DTM,23,1,0,0,1,6,17
20210321-W-Monterrey-F-Leylah_Annie_Fernandez-Viktorija_Golubic,2,S-DTL,1,0,0,0,0,0,1
20210321-W-Monterrey-F-Leylah_Annie_Fernandez-Viktorija_Golubic,2,S-IO,3,0,0,0,0,0,3
20210318-W-Monterrey-R16-Lauren_Davis-Viktorija_Golubic,1,F-XC,19,5,1,1,3,7,12
20210318-W-Monterrey-R16-Lauren_Davis-Viktorija_Golubic,1,F-DTM,24,1,0,0,1,9,15
20210318-W-Monterrey-R16-Lauren_Davis-Viktorija_Golubic,1,F-DTL,6,3,1,0,2,2,4
20210318-W-Monterrey-R16-Lauren_Davis-Viktorija_Golubic,1,F-IO,15,4,1,1,2,5,10
20210318-W-Monterrey-R16-Lauren_Davis-Viktorija_Golubic,1,B-XC,16,5,2,0,3,7,9
20210318-W-Monterrey-R16-Lauren_Davis-Viktorija_Golubic,1,B-DTM,34,3,0,0,3,15,19
20210318-W-Monterrey-R16-Lauren_Davis-Viktorija_Golubic,1,B-DTL,8,5,1,0,4,2,6
20210318-W-Monterrey-R16-Lauren_Davis-Viktorija_Golubic,1,B-IO,4,2,1,0,1,2,2
20210318-W-Monterrey-R16-Lauren_Davis-Viktorija_Golubic,1,S-XC,3,0,0,0,0,0,3
20210318-W-Monterrey-R16-Lauren_Davis-Viktorija_Golubic,1,S-DTM,6,0,0,0,0,2,4
20210318-W-Monterrey-R16-Lauren_Davis-Viktorija_Golubic,1,S-DTL,2,1,0,0,1,0,2
20210318-W-Monterrey-R16-Lauren_Davis-Viktorija_Golubic,1,S-IO,1,0,0,0,0,0,1
20210318-W-Monterrey-R16-Lauren_Davis-Viktorija_Golubic,2,F-XC,20,3,1,2,0,12,8
20210318-W-Monterrey-R16-Lauren_Davis-Viktorija_Golubic,2,F-DTM,31,2,0,0,2,19,12
20210318-W-Monterrey-R16-Lauren_Davis-Viktorija_Golubic,2,F-DTL,4,3,1,1,1,3,1
20210318-W-Monterrey-R16-Lauren_Davis-Viktorija_Golubic,2,F-IO,20,2,2,0,0,15,5
20210318-W-Monterrey-R16-Lauren_Davis-Viktorija_Golubic,2,B-XC,7,3,1,0,2,3,4
20210318-W-Monterrey-R16-Lauren_Davis-Viktorija_Golubic,2,B-DTM,21,3,0,0,3,10,11
20210318-W-Monterrey-R16-Lauren_Davis-Viktorija_Golubic,2,B-DTL,1,1,0,0,1,0,1
20210318-W-Monterrey-R16-Lauren_Davis-Viktorija_Golubic,2,B-IO,9,5,2,2,1,7,2
20210318-W-Monterrey-R16-Lauren_Davis-Viktorija_Golubic,2,S-XC,12,1,0,1,0,8,4
20210318-W-Monterrey-R16-Lauren_Davis-Viktorija_Golubic,2,S-DTM,13,0,0,0,0,8,5
20210316-W-Monterrey-R32-Kaja_Juvan-Maria_Camila_Osorio_Serrano,1,F-XC,26,5,2,1,2,13,13
20210316-W-Monterrey-R32-Kaja_Juvan-Maria_Camila_Osorio_Serrano,1,F-DTM,25,1,0,0,1,14,11
20210316-W-Monterrey-R32-Kaja_Juvan-Maria_Camila_Osorio_Serrano,1,F-DTL,9,5,2,1,2,6,3
20210316-W-Monterrey-R32-Kaja_Juvan-Maria_Camila_Osorio_Serrano,1,F-IO,19,10,4,1,5,11,8
20210316-W-Monterrey-R32-Kaja_Juvan-Maria_Camila_Osorio_Serrano,1,F-II,1,0,0,0,0,1,0
20210316-W-Monterrey-R32-Kaja_Juvan-Maria_Camila_Osorio_Serrano,1,B-XC,17,2,0,0,2,5,12
20210316-W-Monterrey-R32-Kaja_Juvan-Maria_Camila_Osorio_Serrano,1,B-DTM,24,3,1,0,2,12,12
20210316-W-Monterrey-R32-Kaja_Juvan-Maria_Camila_Osorio_Serrano,1,B-DTL,7,3,1,0,2,4,3
20210316-W-Monterrey-R32-Kaja_Juvan-Maria_Camila_Osorio_Serrano,1,B-IO,6,4,1,2,1,5,1
20210316-W-Monterrey-R32-Kaja_Juvan-Maria_Camila_Osorio_Serrano,1,S-XC,7,0,0,0,0,3,4
20210316-W-Monterrey-R32-Kaja_Juvan-Maria_Camila_Osorio_Serrano,1,S-DTM,4,0,0,0,0,2,2
20210316-W-Monterrey-R32-Kaja_Juvan-Maria_Camila_Osorio_Serrano,1,S-DTL,2,1,0,0,1,0,2
20210316-W-Monterrey-R32-Kaja_Juvan-Maria_Camila_Osorio_Serrano,2,F-XC,33,11,2,3,6,13,20
20210316-W-Monterrey-R32-Kaja_Juvan-Maria_Camila_Osorio_Serrano,2,F-DTM,20,3,0,2,1,12,8
20210316-W-Monterrey-R32-Kaja_Juvan-Maria_Camila_Osorio_Serrano,2,F-DTL,8,2,0,1,1,5,3
20210316-W-Monterrey-R32-Kaja_Juvan-Maria_Camila_Osorio_Serrano,2,F-IO,31,13,4,2,7,16,15
20210316-W-Monterrey-R32-Kaja_Juvan-Maria_Camila_Osorio_Serrano,2,F-II,4,2,0,1,1,2,2
20210316-W-Monterrey-R32-Kaja_Juvan-Maria_Camila_Osorio_Serrano,2,B-XC,12,2,0,0,2,1,11
20210316-W-Monterrey-R32-Kaja_Juvan-Maria_Camila_Osorio_Serrano,2,B-DTM,26,1,0,0,1,13,13
20210316-W-Monterrey-R32-Kaja_Juvan-Maria_Camila_Osorio_Serrano,2,B-DTL,7,3,2,0,1,4,3
20210316-W-Monterrey-R32-Kaja_Juvan-Maria_Camila_Osorio_Serrano,2,B-IO,3,2,1,0,1,2,1
20210316-W-Monterrey-R32-Kaja_Juvan-Maria_Camila_Osorio_Serrano,2,S-XC,11,1,0,0,1,6,5
20210316-W-Monterrey-R32-Kaja_Juvan-Maria_Camila_Osorio_Serrano,2,S-DTM,1,0,0,0,0,0,1
20210316-W-Monterrey-R32-Kaja_Juvan-Maria_Camila_Osorio_Serrano,2,S-IO,1,0,0,0,0,1,0
20210315-W-Monterrey-R32-Ann_Li-Arantxa_Rus,1,F-XC,30,9,3,3,3,19,11
20210315-W-Monterrey-R32-Ann_Li-Arantxa_Rus,1,F-DTM,16,1,0,0,1,11,5
20210315-W-Monterrey-R32-Ann_Li-Arantxa_Rus,1,F-DTL,6,4,2,0,2,3,3
20210315-W-Monterrey-R32-Ann_Li-Arantxa_Rus,1,F-IO,21,11,5,1,5,10,11
20210315-W-Monterrey-R32-Ann_Li-Arantxa_Rus,1,F-II,1,1,0,0,1,0,1
20210315-W-Monterrey-R32-Ann_Li-Arantxa_Rus,1,B-XC,15,5,1,1,3,8,7
20210315-W-Monterrey-R32-Ann_Li-Arantxa_Rus,1,B-DTM,18,3,0,1,2,10,8
20210315-W-Monterrey-R32-Ann_Li-Arantxa_Rus,1,B-DTL,3,3,1,0,2,1,2
20210315-W-Monterrey-R32-Ann_Li-Arantxa_Rus,1,S-XC,4,0,0,0,0,2,2
20210315-W-Monterrey-R32-Ann_Li-Arantxa_Rus,1,S-DTM,2,0,0,0,0,1,1
20210315-W-Monterrey-R32-Ann_Li-Arantxa_Rus,1,S-DTL,1,0,0,0,0,0,1
20210315-W-Monterrey-R32-Ann_Li-Arantxa_Rus,2,F-XC,29,6,1,1,4,11,18
20210315-W-Monterrey-R32-Ann_Li-Arantxa_Rus,2,F-DTM,25,0,0,0,0,13,12
20210315-W-Monterrey-R32-Ann_Li-Arantxa_Rus,2,F-DTL,2,2,0,1,1,1,1
20210315-W-Monterrey-R32-Ann_Li-Arantxa_Rus,2,F-IO,12,9,2,4,3,6,6
20210315-W-Monterrey-R32-Ann_Li-Arantxa_Rus,2,B-XC,17,8,0,3,5,8,9
20210315-W-Monterrey-R32-Ann_Li-Arantxa_Rus,2,B-DTM,13,1,0,0,1,5,8
20210315-W-Monterrey-R32-Ann_Li-Arantxa_Rus,2,B-DTL,7,4,0,0,4,2,5
20210315-W-Monterrey-R32-Ann_Li-Arantxa_Rus,2,B-IO,7,3,0,2,1,6,1
20210315-W-Monterrey-R32-Ann_Li-Arantxa_Rus,2,S-XC,1,0,0,0,0,0,1
20210315-W-Monterrey-R32-Ann_Li-Arantxa_Rus,2,S-DTM,5,0,0,0,0,4,1
20210326-W-Miami-R64-Xin_Yu_Wang-Garbine_Muguruza,1,F-XC,29,9,5,1,3,14,15
20210326-W-Miami-R64-Xin_Yu_Wang-Garbine_Muguruza,1,F-DTM,17,2,0,2,0,9,8
20210326-W-Miami-R64-Xin_Yu_Wang-Garbine_Muguruza,1,F-DTL,9,1,0,0,1,5,4
20210326-W-Miami-R64-Xin_Yu_Wang-Garbine_Muguruza,1,F-IO,19,4,0,1,3,8,11
20210326-W-Miami-R64-Xin_Yu_Wang-Garbine_Muguruza,1,B-XC,25,10,2,2,6,9,16
20210326-W-Miami-R64-Xin_Yu_Wang-Garbine_Muguruza,1,B-DTM,22,4,0,0,4,9,13
20210326-W-Miami-R64-Xin_Yu_Wang-Garbine_Muguruza,1,B-DTL,4,2,1,0,1,2,2
20210326-W-Miami-R64-Xin_Yu_Wang-Garbine_Muguruza,1,B-IO,2,1,0,0,1,0,2
20210326-W-Miami-R64-Xin_Yu_Wang-Garbine_Muguruza,2,F-XC,17,8,3,3,2,11,6
20210326-W-Miami-R64-Xin_Yu_Wang-Garbine_Muguruza,2,F-DTM,18,1,0,1,0,9,9
20210326-W-Miami-R64-Xin_Yu_Wang-Garbine_Muguruza,2,F-DTL,5,2,2,0,0,5,0
20210326-W-Miami-R64-Xin_Yu_Wang-Garbine_Muguruza,2,F-IO,7,3,1,0,2,3,4
20210326-W-Miami-R64-Xin_Yu_Wang-Garbine_Muguruza,2,B-XC,22,4,2,1,1,13,9
20210326-W-Miami-R64-Xin_Yu_Wang-Garbine_Muguruza,2,B-DTM,32,2,0,2,0,20,12
20210326-W-Miami-R64-Xin_Yu_Wang-Garbine_Muguruza,2,B-DTL,7,2,1,0,1,3,4
20210326-W-Miami-R64-Xin_Yu_Wang-Garbine_Muguruza,2,B-IO,8,4,0,3,1,5,3
20210326-W-Miami-R64-Xin_Yu_Wang-Garbine_Muguruza,2,S-DTM,2,1,0,0,1,1,1
20210326-W-Miami-R64-Xin_Yu_Wang-Garbine_Muguruza,2,S-DTL,1,1,0,0,1,0,1
20210326-W-Miami-R64-Xin_Yu_Wang-Garbine_Muguruza,2,S-IO,3,0,0,0,0,1,2
20210329-W-Miami-R16-Ashleigh_Barty-Victoria_Azarenka,1,F-XC,50,18,3,8,7,26,24
20210329-W-Miami-R16-Ashleigh_Barty-Victoria_Azarenka,1,F-DTM,28,2,0,1,1,17,11
20210329-W-Miami-R16-Ashleigh_Barty-Victoria_Azarenka,1,F-DTL,6,4,1,1,2,4,2
20210329-W-Miami-R16-Ashleigh_Barty-Victoria_Azarenka,1,F-IO,8,5,3,1,1,5,3
20210329-W-Miami-R16-Ashleigh_Barty-Victoria_Azarenka,1,F-II,3,3,2,1,0,3,0
20210329-W-Miami-R16-Ashleigh_Barty-Victoria_Azarenka,1,B-XC,16,4,0,1,3,6,10
20210329-W-Miami-R16-Ashleigh_Barty-Victoria_Azarenka,1,B-DTM,19,3,0,2,1,11,8
20210329-W-Miami-R16-Ashleigh_Barty-Victoria_Azarenka,1,B-DTL,3,2,1,0,1,2,1
20210329-W-Miami-R16-Ashleigh_Barty-Victoria_Azarenka,1,B-IO,4,3,1,0,2,2,2
20210329-W-Miami-R16-Ashleigh_Barty-Victoria_Azarenka,1,S-XC,22,3,1,0,2,14,8
20210329-W-Miami-R16-Ashleigh_Barty-Victoria_Azarenka,1,S-DTM,32,4,0,0,4,12,20
20210329-W-Miami-R16-Ashleigh_Barty-Victoria_Azarenka,1,S-DTL,1,0,0,0,0,1,0
20210329-W-Miami-R16-Ashleigh_Barty-Victoria_Azarenka,1,S-IO,1,0,0,0,0,0,1
20210329-W-Miami-R16-Ashleigh_Barty-Victoria_Azarenka,2,F-XC,32,7,2,3,2,17,15
20210329-W-Miami-R16-Ashleigh_Barty-Victoria_Azarenka,2,F-DTM,28,1,0,0,1,12,16
20210329-W-Miami-R16-Ashleigh_Barty-Victoria_Azarenka,2,F-DTL,21,11,3,1,7,12,9
20210329-W-Miami-R16-Ashleigh_Barty-Victoria_Azarenka,2,F-IO,29,9,1,3,5,12,17
20210329-W-Miami-R16-Ashleigh_Barty-Victoria_Azarenka,2,B-XC,39,9,3,1,5,21,18
20210329-W-Miami-R16-Ashleigh_Barty-Victoria_Azarenka,2,B-DTM,16,0,0,0,0,7,9
20210329-W-Miami-R16-Ashleigh_Barty-Victoria_Azarenka,2,B-DTL,7,4,2,2,0,6,1
20210329-W-Miami-R16-Ashleigh_Barty-Victoria_Azarenka,2,B-IO,14,5,2,0,3,5,9
20210329-W-Miami-R16-Ashleigh_Barty-Victoria_Azarenka,2,S-XC,6,0,0,0,0,0,6
20210329-W-Miami-R16-Ashleigh_Barty-Victoria_Azarenka,2,S-DTM,1,1,0,0,1,0,1
20210329-W-Miami-R16-Ashleigh_Barty-Victoria_Azarenka,2,S-DTL,3,0,0,0,0,1,2
20210329-W-Miami-R16-Ashleigh_Barty-Victoria_Azarenka,2,S-IO,1,0,0,0,0,0,1
20210324-W-Miami-R128-Katerina_Siniakova-Ana_Konjuh,1,F-XC,31,8,4,2,2,16,15
20210324-W-Miami-R128-Katerina_Siniakova-Ana_Konjuh,1,F-DTM,18,2,0,0,2,7,11
20210324-W-Miami-R128-Katerina_Siniakova-Ana_Konjuh,1,F-DTL,16,5,2,1,2,10,6
20210324-W-Miami-R128-Katerina_Siniakova-Ana_Konjuh,1,F-IO,13,2,1,1,0,10,3
20210324-W-Miami-R128-Katerina_Siniakova-Ana_Konjuh,1,B-XC,32,11,3,5,3,16,16
20210324-W-Miami-R128-Katerina_Siniakova-Ana_Konjuh,1,B-DTM,30,1,0,0,1,21,9
20210324-W-Miami-R128-Katerina_Siniakova-Ana_Konjuh,1,B-DTL,8,5,2,1,2,4,4
20210324-W-Miami-R128-Katerina_Siniakova-Ana_Konjuh,1,B-IO,18,6,2,2,2,10,8
20210324-W-Miami-R128-Katerina_Siniakova-Ana_Konjuh,1,S-XC,1,0,0,0,0,0,1
20210324-W-Miami-R128-Katerina_Siniakova-Ana_Konjuh,1,S-DTM,4,0,0,0,0,0,4
20210324-W-Miami-R128-Katerina_Siniakova-Ana_Konjuh,2,F-XC,49,16,6,0,10,23,26
20210324-W-Miami-R128-Katerina_Siniakova-Ana_Konjuh,2,F-DTM,15,3,0,1,2,8,7
20210324-W-Miami-R128-Katerina_Siniakova-Ana_Konjuh,2,F-DTL,12,5,4,0,1,11,1
20210324-W-Miami-R128-Katerina_Siniakova-Ana_Konjuh,2,F-IO,7,3,1,0,2,2,5
20210324-W-Miami-R128-Katerina_Siniakova-Ana_Konjuh,2,B-XC,36,17,9,4,4,18,18
20210324-W-Miami-R128-Katerina_Siniakova-Ana_Konjuh,2,B-DTM,23,2,0,0,2,9,14
20210324-W-Miami-R128-Katerina_Siniakova-Ana_Konjuh,2,B-DTL,12,4,3,0,1,8,4
20210324-W-Miami-R128-Katerina_Siniakova-Ana_Konjuh,2,B-IO,9,3,1,1,1,4,5
20210324-W-Miami-R128-Katerina_Siniakova-Ana_Konjuh,2,S-XC,2,0,0,0,0,1,1
20210324-W-Miami-R128-Katerina_Siniakova-Ana_Konjuh,2,S-DTM,3,0,0,0,0,0,3
20210329-W-Miami-R16-Garbine_Muguruza-Bianca_Andreescu,1,F-XC,43,14,2,6,6,21,22
20210329-W-Miami-R16-Garbine_Muguruza-Bianca_Andreescu,1,F-DTM,35,4,0,0,4,15,20
20210329-W-Miami-R16-Garbine_Muguruza-Bianca_Andreescu,1,F-DTL,7,4,0,2,2,4,3
20210329-W-Miami-R16-Garbine_Muguruza-Bianca_Andreescu,1,F-IO,16,6,1,2,3,9,7
20210329-W-Miami-R16-Garbine_Muguruza-Bianca_Andreescu,1,F-II,1,1,1,0,0,1,0
20210329-W-Miami-R16-Garbine_Muguruza-Bianca_Andreescu,1,B-XC,57,10,2,3,5,27,30
20210329-W-Miami-R16-Garbine_Muguruza-Bianca_Andreescu,1,B-DTM,53,7,0,3,4,24,29
20210329-W-Miami-R16-Garbine_Muguruza-Bianca_Andreescu,1,B-DTL,4,4,2,0,2,2,2
20210329-W-Miami-R16-Garbine_Muguruza-Bianca_Andreescu,1,B-IO,13,6,2,0,4,4,9
20210329-W-Miami-R16-Garbine_Muguruza-Bianca_Andreescu,1,S-XC,2,0,0,0,0,1,1
20210329-W-Miami-R16-Garbine_Muguruza-Bianca_Andreescu,1,S-DTM,2,0,0,0,0,0,2
20210329-W-Miami-R16-Garbine_Muguruza-Bianca_Andreescu,2,F-XC,40,14,6,3,5,25,15
20210329-W-Miami-R16-Garbine_Muguruza-Bianca_Andreescu,2,F-DTM,44,2,0,1,1,23,21
20210329-W-Miami-R16-Garbine_Muguruza-Bianca_Andreescu,2,F-DTL,14,2,2,0,0,10,4
20210329-W-Miami-R16-Garbine_Muguruza-Bianca_Andreescu,2,F-IO,20,4,3,0,1,11,9
20210329-W-Miami-R16-Garbine_Muguruza-Bianca_Andreescu,2,F-II,1,1,0,0,1,0,1
20210329-W-Miami-R16-Garbine_Muguruza-Bianca_Andreescu,2,B-XC,31,4,2,1,1,18,13
20210329-W-Miami-R16-Garbine_Muguruza-Bianca_Andreescu,2,B-DTM,33,3,0,2,1,19,14
20210329-W-Miami-R16-Garbine_Muguruza-Bianca_Andreescu,2,B-DTL,9,4,2,1,1,4,5
20210329-W-Miami-R16-Garbine_Muguruza-Bianca_Andreescu,2,B-IO,6,3,2,1,0,5,1
20210329-W-Miami-R16-Garbine_Muguruza-Bianca_Andreescu,2,S-XC,3,0,0,0,0,1,2
20210329-W-Miami-R16-Garbine_Muguruza-Bianca_Andreescu,2,S-DTM,6,0,0,0,0,2,4
20210329-W-Miami-R16-Garbine_Muguruza-Bianca_Andreescu,2,S-DTL,4,1,0,0,1,1,3
20210323-W-Miami-R128-Arantxa_Rus-Marie_Bouzkova,1,F-XC,32,6,1,1,4,18,14
20210323-W-Miami-R128-Arantxa_Rus-Marie_Bouzkova,1,F-DTM,34,1,0,0,1,19,15
20210323-W-Miami-R128-Arantxa_Rus-Marie_Bouzkova,1,F-DTL,9,5,1,0,4,3,6
20210323-W-Miami-R128-Arantxa_Rus-Marie_Bouzkova,1,F-IO,18,9,3,4,2,13,5
20210323-W-Miami-R128-Arantxa_Rus-Marie_Bouzkova,1,F-II,2,1,1,0,0,2,0
20210323-W-Miami-R128-Arantxa_Rus-Marie_Bouzkova,1,B-XC,42,9,5,2,2,29,13
20210323-W-Miami-R128-Arantxa_Rus-Marie_Bouzkova,1,B-DTM,35,3,1,1,1,20,15
20210323-W-Miami-R128-Arantxa_Rus-Marie_Bouzkova,1,B-DTL,3,1,1,0,0,3,0
20210323-W-Miami-R128-Arantxa_Rus-Marie_Bouzkova,1,B-IO,4,0,0,0,0,2,2
20210323-W-Miami-R128-Arantxa_Rus-Marie_Bouzkova,1,S-XC,4,3,3,0,0,3,1
20210323-W-Miami-R128-Arantxa_Rus-Marie_Bouzkova,2,F-XC,42,8,1,1,6,12,30
20210323-W-Miami-R128-Arantxa_Rus-Marie_Bouzkova,2,F-DTM,31,4,0,0,4,13,18
20210323-W-Miami-R128-Arantxa_Rus-Marie_Bouzkova,2,F-DTL,10,3,1,0,2,5,5
20210323-W-Miami-R128-Arantxa_Rus-Marie_Bouzkova,2,F-IO,24,6,2,1,3,13,11
20210323-W-Miami-R128-Arantxa_Rus-Marie_Bouzkova,2,F-II,1,1,1,0,0,1,0
20210323-W-Miami-R128-Arantxa_Rus-Marie_Bouzkova,2,B-XC,20,2,0,1,1,7,13
20210323-W-Miami-R128-Arantxa_Rus-Marie_Bouzkova,2,B-DTM,23,4,0,0,4,6,17
20210323-W-Miami-R128-Arantxa_Rus-Marie_Bouzkova,2,B-DTL,9,2,0,0,2,6,3
20210323-W-Miami-R128-Arantxa_Rus-Marie_Bouzkova,2,B-IO,4,1,0,0,1,2,2
20210326-W-Miami-R64-Liudmila_Samsonova-Kiki_Bertens,1,F-XC,29,13,4,4,5,19,10
20210326-W-Miami-R64-Liudmila_Samsonova-Kiki_Bertens,1,F-DTM,8,1,0,0,1,7,1
20210326-W-Miami-R64-Liudmila_Samsonova-Kiki_Bertens,1,F-DTL,1,1,0,1,0,1,0
20210326-W-Miami-R64-Liudmila_Samsonova-Kiki_Bertens,1,F-IO,13,5,5,0,0,12,1
20210326-W-Miami-R64-Liudmila_Samsonova-Kiki_Bertens,1,F-II,1,1,0,0,1,0,1
20210326-W-Miami-R64-Liudmila_Samsonova-Kiki_Bertens,1,B-XC,11,1,1,0,0,10,1
20210326-W-Miami-R64-Liudmila_Samsonova-Kiki_Bertens,1,B-DTM,6,0,0,0,0,5,1
20210326-W-Miami-R64-Liudmila_Samsonova-Kiki_Bertens,1,B-IO,1,1,0,0,1,0,1
20210326-W-Miami-R64-Liudmila_Samsonova-Kiki_Bertens,1,S-DTL,1,0,0,0,0,1,0
20210326-W-Miami-R64-Liudmila_Samsonova-Kiki_Bertens,2,F-XC,18,5,0,0,5,7,11
20210326-W-Miami-R64-Liudmila_Samsonova-Kiki_Bertens,2,F-DTM,13,3,0,0,3,4,9
20210326-W-Miami-R64-Liudmila_Samsonova-Kiki_Bertens,2,F-DTL,2,2,1,0,1,1,1
20210326-W-Miami-R64-Liudmila_Samsonova-Kiki_Bertens,2,F-IO,7,2,1,0,1,1,6
20210326-W-Miami-R64-Liudmila_Samsonova-Kiki_Bertens,2,F-II,1,0,0,0,0,0,1
20210326-W-Miami-R64-Liudmila_Samsonova-Kiki_Bertens,2,B-XC,4,2,1,0,1,2,2
20210326-W-Miami-R64-Liudmila_Samsonova-Kiki_Bertens,2,B-DTM,14,1,0,0,1,1,13
20210326-W-Miami-R64-Liudmila_Samsonova-Kiki_Bertens,2,S-DTM,6,0,0,0,0,0,6
20210331-W-Miami-QF-Naomi_Osaka-Maria_Sakkari,1,F-XC,7,1,0,1,0,3,4
20210331-W-Miami-QF-Naomi_Osaka-Maria_Sakkari,1,F-DTM,13,6,0,0,6,4,9
20210331-W-Miami-QF-Naomi_Osaka-Maria_Sakkari,1,F-DTL,3,1,0,0,1,1,2
20210331-W-Miami-QF-Naomi_Osaka-Maria_Sakkari,1,F-IO,7,3,0,1,2,3,4
20210331-W-Miami-QF-Naomi_Osaka-Maria_Sakkari,1,B-XC,24,9,0,4,5,11,13
20210331-W-Miami-QF-Naomi_Osaka-Maria_Sakkari,1,B-DTM,22,3,0,1,2,9,13
20210331-W-Miami-QF-Naomi_Osaka-Maria_Sakkari,1,B-DTL,9,3,0,1,2,4,5
20210331-W-Miami-QF-Naomi_Osaka-Maria_Sakkari,1,B-IO,9,5,2,0,3,4,5
20210331-W-Miami-QF-Naomi_Osaka-Maria_Sakkari,1,S-DTL,1,0,0,0,0,0,1
20210331-W-Miami-QF-Naomi_Osaka-Maria_Sakkari,2,F-XC,9,6,4,0,2,6,3
20210331-W-Miami-QF-Naomi_Osaka-Maria_Sakkari,2,F-DTM,15,2,0,1,1,11,4
20210331-W-Miami-QF-Naomi_Osaka-Maria_Sakkari,2,F-DTL,5,2,1,0,1,2,3
20210331-W-Miami-QF-Naomi_Osaka-Maria_Sakkari,2,F-IO,11,6,2,1,3,6,5
20210331-W-Miami-QF-Naomi_Osaka-Maria_Sakkari,2,B-XC,18,6,3,1,2,8,10
20210331-W-Miami-QF-Naomi_Osaka-Maria_Sakkari,2,B-DTM,19,1,1,0,0,13,6
20210331-W-Miami-QF-Naomi_Osaka-Maria_Sakkari,2,S-XC,5,1,0,0,1,2,3
20210331-W-Miami-QF-Naomi_Osaka-Maria_Sakkari,2,S-DTM,2,0,0,0,0,1,1
20210331-W-Miami-QF-Naomi_Osaka-Maria_Sakkari,2,S-DTL,1,1,0,0,1,0,1
20210218-W-Phillip_Island_Trophy-SF-Marie_Bouzkova-Bianca_Andreescu,1,F-XC,75,15,5,4,6,45,30
20210218-W-Phillip_Island_Trophy-SF-Marie_Bouzkova-Bianca_Andreescu,1,F-DTM,55,4,0,1,3,24,31
20210218-W-Phillip_Island_Trophy-SF-Marie_Bouzkova-Bianca_Andreescu,1,F-DTL,20,6,1,3,2,10,10
20210218-W-Phillip_Island_Trophy-SF-Marie_Bouzkova-Bianca_Andreescu,1,F-IO,32,13,2,6,5,18,14
20210218-W-Phillip_Island_Trophy-SF-Marie_Bouzkova-Bianca_Andreescu,1,F-II,2,0,0,0,0,0,2
20210218-W-Phillip_Island_Trophy-SF-Marie_Bouzkova-Bianca_Andreescu,1,B-XC,63,5,0,2,3,33,30
20210218-W-Phillip_Island_Trophy-SF-Marie_Bouzkova-Bianca_Andreescu,1,B-DTM,53,2,0,0,2,21,32
20210218-W-Phillip_Island_Trophy-SF-Marie_Bouzkova-Bianca_Andreescu,1,B-DTL,15,7,1,3,3,7,8
20210218-W-Phillip_Island_Trophy-SF-Marie_Bouzkova-Bianca_Andreescu,1,B-IO,10,3,2,0,1,6,4
20210218-W-Phillip_Island_Trophy-SF-Marie_Bouzkova-Bianca_Andreescu,1,S-XC,14,1,1,0,0,9,5
20210218-W-Phillip_Island_Trophy-SF-Marie_Bouzkova-Bianca_Andreescu,1,S-DTM,7,0,0,0,0,1,6
20210218-W-Phillip_Island_Trophy-SF-Marie_Bouzkova-Bianca_Andreescu,1,S-DTL,1,1,0,0,1,0,1
20210218-W-Phillip_Island_Trophy-SF-Marie_Bouzkova-Bianca_Andreescu,2,F-XC,76,21,5,6,10,40,36
20210218-W-Phillip_Island_Trophy-SF-Marie_Bouzkova-Bianca_Andreescu,2,F-DTM,44,4,0,1,3,28,16
20210218-W-Phillip_Island_Trophy-SF-Marie_Bouzkova-Bianca_Andreescu,2,F-DTL,24,8,2,3,3,10,14
20210218-W-Phillip_Island_Trophy-SF-Marie_Bouzkova-Bianca_Andreescu,2,F-IO,35,10,4,0,6,21,14
20210218-W-Phillip_Island_Trophy-SF-Marie_Bouzkova-Bianca_Andreescu,2,F-II,4,3,2,0,1,3,1
20210218-W-Phillip_Island_Trophy-SF-Marie_Bouzkova-Bianca_Andreescu,2,B-XC,65,7,1,2,4,39,26
20210218-W-Phillip_Island_Trophy-SF-Marie_Bouzkova-Bianca_Andreescu,2,B-DTM,45,6,2,0,4,20,25
20210218-W-Phillip_Island_Trophy-SF-Marie_Bouzkova-Bianca_Andreescu,2,B-DTL,18,5,2,1,2,8,10
20210218-W-Phillip_Island_Trophy-SF-Marie_Bouzkova-Bianca_Andreescu,2,B-IO,5,2,1,1,0,5,0
20210218-W-Phillip_Island_Trophy-SF-Marie_Bouzkova-Bianca_Andreescu,2,S-XC,6,1,0,0,1,2,4
20210218-W-Phillip_Island_Trophy-SF-Marie_Bouzkova-Bianca_Andreescu,2,S-DTM,7,1,0,0,1,1,6
20210218-W-Phillip_Island_Trophy-SF-Marie_Bouzkova-Bianca_Andreescu,2,S-DTL,4,0,0,0,0,2,2
20210218-W-Phillip_Island_Trophy-SF-Marie_Bouzkova-Bianca_Andreescu,2,S-IO,4,0,0,0,0,4,0
20210331-W-Miami-QF-Bianca_Andreescu-Sara_Sorribes_Tormo,1,F-XC,72,17,3,8,6,37,35
20210331-W-Miami-QF-Bianca_Andreescu-Sara_Sorribes_Tormo,1,F-DTM,57,2,0,1,1,23,34
20210331-W-Miami-QF-Bianca_Andreescu-Sara_Sorribes_Tormo,1,F-DTL,6,4,3,0,1,5,1
20210331-W-Miami-QF-Bianca_Andreescu-Sara_Sorribes_Tormo,1,F-IO,41,6,2,0,4,20,21
20210331-W-Miami-QF-Bianca_Andreescu-Sara_Sorribes_Tormo,1,F-II,7,5,1,3,1,5,2
20210331-W-Miami-QF-Bianca_Andreescu-Sara_Sorribes_Tormo,1,B-XC,67,19,4,6,9,32,35
20210331-W-Miami-QF-Bianca_Andreescu-Sara_Sorribes_Tormo,1,B-DTM,48,4,0,0,4,19,29
20210331-W-Miami-QF-Bianca_Andreescu-Sara_Sorribes_Tormo,1,B-DTL,16,6,3,0,3,9,7
20210331-W-Miami-QF-Bianca_Andreescu-Sara_Sorribes_Tormo,1,B-IO,6,5,2,0,3,3,3
20210331-W-Miami-QF-Bianca_Andreescu-Sara_Sorribes_Tormo,1,S-XC,7,1,0,0,1,5,2
20210331-W-Miami-QF-Bianca_Andreescu-Sara_Sorribes_Tormo,1,S-DTM,14,1,0,0,1,5,9
20210331-W-Miami-QF-Bianca_Andreescu-Sara_Sorribes_Tormo,1,S-DTL,3,0,0,0,0,1,2
20210331-W-Miami-QF-Bianca_Andreescu-Sara_Sorribes_Tormo,1,S-IO,4,0,0,0,0,2,2
20210331-W-Miami-QF-Bianca_Andreescu-Sara_Sorribes_Tormo,2,F-XC,51,11,7,3,1,31,20
20210331-W-Miami-QF-Bianca_Andreescu-Sara_Sorribes_Tormo,2,F-DTM,93,3,0,1,2,45,48
20210331-W-Miami-QF-Bianca_Andreescu-Sara_Sorribes_Tormo,2,F-DTL,12,1,0,0,1,5,7
20210331-W-Miami-QF-Bianca_Andreescu-Sara_Sorribes_Tormo,2,F-IO,54,9,3,4,2,29,25
20210331-W-Miami-QF-Bianca_Andreescu-Sara_Sorribes_Tormo,2,F-II,1,1,0,0,1,0,1
20210331-W-Miami-QF-Bianca_Andreescu-Sara_Sorribes_Tormo,2,B-XC,24,2,1,0,1,14,10
20210331-W-Miami-QF-Bianca_Andreescu-Sara_Sorribes_Tormo,2,B-DTM,52,3,0,0,3,33,19
20210331-W-Miami-QF-Bianca_Andreescu-Sara_Sorribes_Tormo,2,B-DTL,4,2,2,0,0,3,1
20210331-W-Miami-QF-Bianca_Andreescu-Sara_Sorribes_Tormo,2,B-IO,5,2,1,1,0,2,3
20210331-W-Miami-QF-Bianca_Andreescu-Sara_Sorribes_Tormo,2,S-XC,30,3,1,0,2,15,15
20210331-W-Miami-QF-Bianca_Andreescu-Sara_Sorribes_Tormo,2,S-DTM,30,0,0,0,0,11,19
20210331-W-Miami-QF-Bianca_Andreescu-Sara_Sorribes_Tormo,2,S-DTL,5,1,0,0,1,3,2
20210403-W-Miami-F-Ashleigh_Barty-Bianca_Andreescu,1,F-XC,37,14,6,7,1,31,6
20210403-W-Miami-F-Ashleigh_Barty-Bianca_Andreescu,1,F-DTM,22,5,2,0,3,13,9
20210403-W-Miami-F-Ashleigh_Barty-Bianca_Andreescu,1,F-DTL,1,0,0,0,0,1,0
20210403-W-Miami-F-Ashleigh_Barty-Bianca_Andreescu,1,F-IO,19,5,2,0,3,13,6
20210403-W-Miami-F-Ashleigh_Barty-Bianca_Andreescu,1,F-II,1,1,0,1,0,1,0
20210403-W-Miami-F-Ashleigh_Barty-Bianca_Andreescu,1,B-XC,7,1,1,0,0,4,3
20210403-W-Miami-F-Ashleigh_Barty-Bianca_Andreescu,1,B-DTM,9,2,0,0,2,3,6
20210403-W-Miami-F-Ashleigh_Barty-Bianca_Andreescu,1,B-DTL,1,0,0,0,0,1,0
20210403-W-Miami-F-Ashleigh_Barty-Bianca_Andreescu,1,B-IO,2,0,0,0,0,2,0
20210403-W-Miami-F-Ashleigh_Barty-Bianca_Andreescu,1,S-XC,6,1,0,0,1,4,2
20210403-W-Miami-F-Ashleigh_Barty-Bianca_Andreescu,1,S-DTM,6,2,0,0,2,2,4
20210403-W-Miami-F-Ashleigh_Barty-Bianca_Andreescu,1,S-DTL,2,0,0,0,0,1,1
20210403-W-Miami-F-Ashleigh_Barty-Bianca_Andreescu,2,F-XC,24,6,3,1,2,10,14
20210403-W-Miami-F-Ashleigh_Barty-Bianca_Andreescu,2,F-DTM,15,1,0,0,1,6,9
20210403-W-Miami-F-Ashleigh_Barty-Bianca_Andreescu,2,F-DTL,3,1,0,0,1,1,2
20210403-W-Miami-F-Ashleigh_Barty-Bianca_Andreescu,2,F-IO,7,0,0,0,0,4,3
20210403-W-Miami-F-Ashleigh_Barty-Bianca_Andreescu,2,F-II,1,0,0,0,0,0,1
20210403-W-Miami-F-Ashleigh_Barty-Bianca_Andreescu,2,B-XC,14,4,0,1,3,5,9
20210403-W-Miami-F-Ashleigh_Barty-Bianca_Andreescu,2,B-DTM,12,0,0,0,0,2,10
20210403-W-Miami-F-Ashleigh_Barty-Bianca_Andreescu,2,B-DTL,2,2,1,0,1,1,1
20210403-W-Miami-F-Ashleigh_Barty-Bianca_Andreescu,2,B-IO,2,1,0,0,1,0,2
20210403-W-Miami-F-Ashleigh_Barty-Bianca_Andreescu,2,S-XC,2,1,0,0,1,1,1
20210403-W-Miami-F-Ashleigh_Barty-Bianca_Andreescu,2,S-DTM,6,0,0,0,0,0,6
20210403-W-Miami-F-Ashleigh_Barty-Bianca_Andreescu,2,S-DTL,2,0,0,0,0,0,2
20210328-W-Miami-R32-Amanda_Anisimova-Bianca_Andreescu,1,F-XC,36,13,6,1,6,22,14
20210328-W-Miami-R32-Amanda_Anisimova-Bianca_Andreescu,1,F-DTM,31,5,0,0,5,16,15
20210328-W-Miami-R32-Amanda_Anisimova-Bianca_Andreescu,1,F-DTL,6,4,2,0,2,2,4
20210328-W-Miami-R32-Amanda_Anisimova-Bianca_Andreescu,1,F-IO,23,10,3,2,5,16,7
20210328-W-Miami-R32-Amanda_Anisimova-Bianca_Andreescu,1,F-II,1,1,0,0,1,0,1
20210328-W-Miami-R32-Amanda_Anisimova-Bianca_Andreescu,1,B-XC,38,20,7,6,7,24,14
20210328-W-Miami-R32-Amanda_Anisimova-Bianca_Andreescu,1,B-DTM,40,7,0,1,6,18,22
20210328-W-Miami-R32-Amanda_Anisimova-Bianca_Andreescu,1,B-DTL,6,6,3,2,1,5,1
20210328-W-Miami-R32-Amanda_Anisimova-Bianca_Andreescu,1,B-IO,6,5,1,2,2,4,2
20210328-W-Miami-R32-Amanda_Anisimova-Bianca_Andreescu,1,S-XC,1,0,0,0,0,1,0
20210328-W-Miami-R32-Amanda_Anisimova-Bianca_Andreescu,1,S-DTM,3,0,0,0,0,2,1
20210328-W-Miami-R32-Amanda_Anisimova-Bianca_Andreescu,2,F-XC,21,7,1,3,3,9,12
20210328-W-Miami-R32-Amanda_Anisimova-Bianca_Andreescu,2,F-DTM,35,4,0,1,3,17,18
20210328-W-Miami-R32-Amanda_Anisimova-Bianca_Andreescu,2,F-DTL,4,2,0,0,2,1,3
20210328-W-Miami-R32-Amanda_Anisimova-Bianca_Andreescu,2,F-IO,15,4,1,2,1,5,10
20210328-W-Miami-R32-Amanda_Anisimova-Bianca_Andreescu,2,B-XC,15,6,1,0,5,5,10
20210328-W-Miami-R32-Amanda_Anisimova-Bianca_Andreescu,2,B-DTM,30,3,1,1,1,17,13
20210328-W-Miami-R32-Amanda_Anisimova-Bianca_Andreescu,2,B-DTL,7,4,2,0,2,3,4
20210328-W-Miami-R32-Amanda_Anisimova-Bianca_Andreescu,2,B-IO,4,3,2,0,1,2,2
20210328-W-Miami-R32-Amanda_Anisimova-Bianca_Andreescu,2,S-XC,3,0,0,0,0,1,2
20210328-W-Miami-R32-Amanda_Anisimova-Bianca_Andreescu,2,S-DTM,9,2,0,0,2,2,7
20210328-W-Miami-R32-Amanda_Anisimova-Bianca_Andreescu,2,S-DTL,4,0,0,0,0,2,2
20210328-W-Miami-R32-Amanda_Anisimova-Bianca_Andreescu,2,S-IO,1,1,0,0,1,0,1
20210326-W-Miami-R64-Tereza_Martincova-Bianca_Andreescu,1,F-XC,29,5,1,1,3,12,17
20210326-W-Miami-R64-Tereza_Martincova-Bianca_Andreescu,1,F-DTM,38,0,0,0,0,16,22
20210326-W-Miami-R64-Tereza_Martincova-Bianca_Andreescu,1,F-DTL,15,4,1,2,1,5,10
20210326-W-Miami-R64-Tereza_Martincova-Bianca_Andreescu,1,F-IO,31,11,2,0,9,13,18
20210326-W-Miami-R64-Tereza_Martincova-Bianca_Andreescu,1,B-XC,37,5,1,2,2,17,20
20210326-W-Miami-R64-Tereza_Martincova-Bianca_Andreescu,1,B-DTM,43,2,0,0,2,18,25
20210326-W-Miami-R64-Tereza_Martincova-Bianca_Andreescu,1,B-DTL,6,3,1,0,2,1,5
20210326-W-Miami-R64-Tereza_Martincova-Bianca_Andreescu,1,B-IO,1,0,0,0,0,0,1
20210326-W-Miami-R64-Tereza_Martincova-Bianca_Andreescu,1,S-DTM,7,1,0,0,1,3,4
20210326-W-Miami-R64-Tereza_Martincova-Bianca_Andreescu,1,S-DTL,5,2,0,1,1,2,3
20210326-W-Miami-R64-Tereza_Martincova-Bianca_Andreescu,1,S-IO,1,0,0,0,0,1,0
20210326-W-Miami-R64-Tereza_Martincova-Bianca_Andreescu,2,F-XC,40,14,3,6,5,27,13
20210326-W-Miami-R64-Tereza_Martincova-Bianca_Andreescu,2,F-DTM,29,1,0,0,1,17,12
20210326-W-Miami-R64-Tereza_Martincova-Bianca_Andreescu,2,F-DTL,11,3,1,1,1,6,5
20210326-W-Miami-R64-Tereza_Martincova-Bianca_Andreescu,2,F-IO,28,7,3,2,2,20,8
20210326-W-Miami-R64-Tereza_Martincova-Bianca_Andreescu,2,F-II,3,1,1,0,0,2,1
20210326-W-Miami-R64-Tereza_Martincova-Bianca_Andreescu,2,B-XC,34,15,4,3,8,18,16
20210326-W-Miami-R64-Tereza_Martincova-Bianca_Andreescu,2,B-DTM,27,6,0,1,5,12,15
20210326-W-Miami-R64-Tereza_Martincova-Bianca_Andreescu,2,B-DTL,10,6,2,1,3,6,4
20210326-W-Miami-R64-Tereza_Martincova-Bianca_Andreescu,2,S-XC,5,1,0,0,1,2,3
20210326-W-Miami-R64-Tereza_Martincova-Bianca_Andreescu,2,S-DTM,12,1,0,0,1,6,6
20210326-W-Miami-R64-Tereza_Martincova-Bianca_Andreescu,2,S-DTL,3,0,0,0,0,3,0
20210326-W-Miami-R64-Tereza_Martincova-Bianca_Andreescu,2,S-IO,2,0,0,0,0,2,0
20210406-W-Bogota-R32-Sara_Errani-Sara_Sorribes_Tormo,1,F-XC,58,7,1,1,5,33,25
20210406-W-Bogota-R32-Sara_Errani-Sara_Sorribes_Tormo,1,F-DTM,35,0,0,0,0,19,16
20210406-W-Bogota-R32-Sara_Errani-Sara_Sorribes_Tormo,1,F-DTL,21,6,0,3,3,12,9
20210406-W-Bogota-R32-Sara_Errani-Sara_Sorribes_Tormo,1,F-IO,76,6,1,3,2,45,31
20210406-W-Bogota-R32-Sara_Errani-Sara_Sorribes_Tormo,1,F-II,2,0,0,0,0,2,0
20210406-W-Bogota-R32-Sara_Errani-Sara_Sorribes_Tormo,1,B-XC,131,9,0,1,8,71,60
20210406-W-Bogota-R32-Sara_Errani-Sara_Sorribes_Tormo,1,B-DTM,66,4,0,1,3,43,23
20210406-W-Bogota-R32-Sara_Errani-Sara_Sorribes_Tormo,1,B-DTL,13,5,1,1,3,6,7
20210406-W-Bogota-R32-Sara_Errani-Sara_Sorribes_Tormo,1,B-IO,3,2,0,1,1,1,2
20210406-W-Bogota-R32-Sara_Errani-Sara_Sorribes_Tormo,1,S-XC,15,2,0,0,2,5,10
20210406-W-Bogota-R32-Sara_Errani-Sara_Sorribes_Tormo,1,S-DTM,8,0,0,0,0,4,4
20210406-W-Bogota-R32-Sara_Errani-Sara_Sorribes_Tormo,1,S-DTL,4,1,0,1,0,3,1
20210406-W-Bogota-R32-Sara_Errani-Sara_Sorribes_Tormo,1,S-IO,1,0,0,0,0,1,0
20210406-W-Bogota-R32-Sara_Errani-Sara_Sorribes_Tormo,2,F-XC,60,12,6,2,4,27,33
20210406-W-Bogota-R32-Sara_Errani-Sara_Sorribes_Tormo,2,F-DTM,74,4,0,1,3,30,44
20210406-W-Bogota-R32-Sara_Errani-Sara_Sorribes_Tormo,2,F-DTL,9,2,0,0,2,2,7
20210406-W-Bogota-R32-Sara_Errani-Sara_Sorribes_Tormo,2,F-IO,64,6,0,1,5,28,36
20210406-W-Bogota-R32-Sara_Errani-Sara_Sorribes_Tormo,2,F-II,6,1,0,1,0,5,1
20210406-W-Bogota-R32-Sara_Errani-Sara_Sorribes_Tormo,2,B-XC,48,4,1,0,3,18,30
20210406-W-Bogota-R32-Sara_Errani-Sara_Sorribes_Tormo,2,B-DTM,87,6,0,0,6,35,52
20210406-W-Bogota-R32-Sara_Errani-Sara_Sorribes_Tormo,2,B-DTL,17,8,3,0,5,10,7
20210406-W-Bogota-R32-Sara_Errani-Sara_Sorribes_Tormo,2,B-IO,4,1,0,0,1,0,4
20210406-W-Bogota-R32-Sara_Errani-Sara_Sorribes_Tormo,2,S-XC,52,5,0,0,5,19,33
20210406-W-Bogota-R32-Sara_Errani-Sara_Sorribes_Tormo,2,S-DTM,26,1,0,0,1,11,15
20210406-W-Bogota-R32-Sara_Errani-Sara_Sorribes_Tormo,2,S-DTL,3,1,0,1,0,1,2
20210406-W-Bogota-R32-Arantxa_Rus-Irina_Maria_Bara,1,F-XC,80,21,5,5,11,44,36
20210406-W-Bogota-R32-Arantxa_Rus-Irina_Maria_Bara,1,F-DTM,76,9,1,2,6,44,32
20210406-W-Bogota-R32-Arantxa_Rus-Irina_Maria_Bara,1,F-DTL,6,4,1,1,2,4,2
20210406-W-Bogota-R32-Arantxa_Rus-Irina_Maria_Bara,1,F-IO,36,16,3,3,10,16,20
20210406-W-Bogota-R32-Arantxa_Rus-Irina_Maria_Bara,1,F-II,4,1,1,0,0,3,1
20210406-W-Bogota-R32-Arantxa_Rus-Irina_Maria_Bara,1,B-XC,56,7,1,1,5,35,21
20210406-W-Bogota-R32-Arantxa_Rus-Irina_Maria_Bara,1,B-DTM,105,11,0,2,9,58,47
20210406-W-Bogota-R32-Arantxa_Rus-Irina_Maria_Bara,1,B-IO,11,3,1,1,1,8,3
20210406-W-Bogota-R32-Arantxa_Rus-Irina_Maria_Bara,1,S-XC,3,1,0,1,0,3,0
20210406-W-Bogota-R32-Arantxa_Rus-Irina_Maria_Bara,1,S-DTM,2,0,0,0,0,1,1
20210406-W-Bogota-R32-Arantxa_Rus-Irina_Maria_Bara,1,S-DTL,1,0,0,0,0,1,0
20210406-W-Bogota-R32-Arantxa_Rus-Irina_Maria_Bara,1,S-IO,2,0,0,0,0,1,1
20210406-W-Bogota-R32-Arantxa_Rus-Irina_Maria_Bara,2,F-XC,99,12,0,5,7,41,58
20210406-W-Bogota-R32-Arantxa_Rus-Irina_Maria_Bara,2,F-DTM,71,9,0,0,9,30,41
20210406-W-Bogota-R32-Arantxa_Rus-Irina_Maria_Bara,2,F-DTL,16,8,0,4,4,6,10
20210406-W-Bogota-R32-Arantxa_Rus-Irina_Maria_Bara,2,F-IO,41,8,1,0,7,15,26
20210406-W-Bogota-R32-Arantxa_Rus-Irina_Maria_Bara,2,B-XC,41,4,0,2,2,21,20
20210406-W-Bogota-R32-Arantxa_Rus-Irina_Maria_Bara,2,B-DTM,72,6,0,1,5,34,38
20210406-W-Bogota-R32-Arantxa_Rus-Irina_Maria_Bara,2,B-DTL,12,6,3,1,2,5,7
20210406-W-Bogota-R32-Arantxa_Rus-Irina_Maria_Bara,2,B-IO,15,2,0,0,2,5,10
20210406-W-Bogota-R32-Arantxa_Rus-Irina_Maria_Bara,2,S-XC,5,0,0,0,0,2,3
20210406-W-Bogota-R32-Arantxa_Rus-Irina_Maria_Bara,2,S-DTM,6,1,0,0,1,2,4
20210406-W-Bogota-R32-Arantxa_Rus-Irina_Maria_Bara,2,S-IO,2,1,0,0,1,1,1
20150125-W-Australian_Open-R16-Agnieszka_Radwanska-Venus_Williams,1,F-XC,33,5,3,1,1,20,13
20150125-W-Australian_Open-R16-Agnieszka_Radwanska-Venus_Williams,1,F-DTM,32,1,0,0,1,18,14
20150125-W-Australian_Open-R16-Agnieszka_Radwanska-Venus_Williams,1,F-DTL,23,3,1,1,1,14,9
20150125-W-Australian_Open-R16-Agnieszka_Radwanska-Venus_Williams,1,F-IO,24,4,3,0,1,12,12
20150125-W-Australian_Open-R16-Agnieszka_Radwanska-Venus_Williams,1,F-II,1,0,0,0,0,1,0
20150125-W-Australian_Open-R16-Agnieszka_Radwanska-Venus_Williams,1,B-XC,49,7,2,1,4,25,24
20150125-W-Australian_Open-R16-Agnieszka_Radwanska-Venus_Williams,1,B-DTM,66,2,0,0,2,31,35
20150125-W-Australian_Open-R16-Agnieszka_Radwanska-Venus_Williams,1,B-DTL,13,5,0,1,4,6,7
20150125-W-Australian_Open-R16-Agnieszka_Radwanska-Venus_Williams,1,B-IO,10,2,2,0,0,5,5
20150125-W-Australian_Open-R16-Agnieszka_Radwanska-Venus_Williams,1,S-XC,7,1,0,0,1,0,7
20150125-W-Australian_Open-R16-Agnieszka_Radwanska-Venus_Williams,1,S-DTM,6,0,0,0,0,5,1
20150125-W-Australian_Open-R16-Agnieszka_Radwanska-Venus_Williams,1,S-DTL,5,0,0,0,0,1,4
20150125-W-Australian_Open-R16-Agnieszka_Radwanska-Venus_Williams,1,S-IO,1,0,0,0,0,1,0
20150125-W-Australian_Open-R16-Agnieszka_Radwanska-Venus_Williams,2,F-XC,82,22,7,5,10,35,47
20150125-W-Australian_Open-R16-Agnieszka_Radwanska-Venus_Williams,2,F-DTM,18,1,0,0,1,9,9
20150125-W-Australian_Open-R16-Agnieszka_Radwanska-Venus_Williams,2,F-DTL,13,7,1,3,3,10,3
20150125-W-Australian_Open-R16-Agnieszka_Radwanska-Venus_Williams,2,F-IO,48,21,7,4,10,25,23
20150125-W-Australian_Open-R16-Agnieszka_Radwanska-Venus_Williams,2,F-II,2,1,0,1,0,1,1
20150125-W-Australian_Open-R16-Agnieszka_Radwanska-Venus_Williams,2,B-XC,74,10,3,3,4,37,37
20150125-W-Australian_Open-R16-Agnieszka_Radwanska-Venus_Williams,2,B-DTM,30,1,0,0,1,13,17
20150125-W-Australian_Open-R16-Agnieszka_Radwanska-Venus_Williams,2,B-DTL,13,10,4,4,2,9,4
20150125-W-Australian_Open-R16-Agnieszka_Radwanska-Venus_Williams,2,B-IO,5,3,1,1,1,3,2
20150125-W-Australian_Open-R16-Agnieszka_Radwanska-Venus_Williams,2,S-XC,6,1,0,0,1,2,4
20150125-W-Australian_Open-R16-Agnieszka_Radwanska-Venus_Williams,2,S-DTM,7,0,0,0,0,4,3
20150125-W-Australian_Open-R16-Agnieszka_Radwanska-Venus_Williams,2,S-DTL,1,0,0,0,0,0,1
20210401-W-Miami-SF-Bianca_Andreescu-Maria_Sakkari,1,F-XC,39,12,3,5,4,21,18
20210401-W-Miami-SF-Bianca_Andreescu-Maria_Sakkari,1,F-DTM,43,3,0,0,3,23,20
20210401-W-Miami-SF-Bianca_Andreescu-Maria_Sakkari,1,F-DTL,10,3,0,0,3,3,7
20210401-W-Miami-SF-Bianca_Andreescu-Maria_Sakkari,1,F-IO,23,3,0,1,2,13,10
20210401-W-Miami-SF-Bianca_Andreescu-Maria_Sakkari,1,F-II,7,3,1,2,0,6,1
20210401-W-Miami-SF-Bianca_Andreescu-Maria_Sakkari,1,B-XC,49,12,2,4,6,24,25
20210401-W-Miami-SF-Bianca_Andreescu-Maria_Sakkari,1,B-DTM,48,7,0,4,3,28,20
20210401-W-Miami-SF-Bianca_Andreescu-Maria_Sakkari,1,B-DTL,11,5,0,1,4,6,5
20210401-W-Miami-SF-Bianca_Andreescu-Maria_Sakkari,1,B-IO,6,4,2,1,1,4,2
20210401-W-Miami-SF-Bianca_Andreescu-Maria_Sakkari,1,S-XC,1,0,0,0,0,0,1
20210401-W-Miami-SF-Bianca_Andreescu-Maria_Sakkari,1,S-DTM,18,2,0,0,2,3,15
20210401-W-Miami-SF-Bianca_Andreescu-Maria_Sakkari,1,S-DTL,2,0,0,0,0,1,1
20210401-W-Miami-SF-Bianca_Andreescu-Maria_Sakkari,1,S-IO,1,0,0,0,0,0,1
20210401-W-Miami-SF-Bianca_Andreescu-Maria_Sakkari,2,F-XC,35,11,4,1,6,16,19
20210401-W-Miami-SF-Bianca_Andreescu-Maria_Sakkari,2,F-DTM,54,8,0,2,6,21,33
20210401-W-Miami-SF-Bianca_Andreescu-Maria_Sakkari,2,F-DTL,14,3,2,0,1,6,8
20210401-W-Miami-SF-Bianca_Andreescu-Maria_Sakkari,2,F-IO,35,10,2,2,6,20,15
20210401-W-Miami-SF-Bianca_Andreescu-Maria_Sakkari,2,F-II,3,3,3,0,0,3,0
20210401-W-Miami-SF-Bianca_Andreescu-Maria_Sakkari,2,B-XC,64,17,2,4,11,35,29
20210401-W-Miami-SF-Bianca_Andreescu-Maria_Sakkari,2,B-DTM,40,4,0,2,2,19,21
20210401-W-Miami-SF-Bianca_Andreescu-Maria_Sakkari,2,B-DTL,4,3,1,1,1,3,1
20210401-W-Miami-SF-Bianca_Andreescu-Maria_Sakkari,2,B-IO,3,1,0,0,1,1,2
20210401-W-Miami-SF-Bianca_Andreescu-Maria_Sakkari,2,S-XC,4,0,0,0,0,1,3
20210401-W-Miami-SF-Bianca_Andreescu-Maria_Sakkari,2,S-DTM,3,0,0,0,0,0,3
20191130-W-ITF_Solarino-F-Urszula_Radwanska-Indy_De_Vroome,1,F-XC,14,3,2,0,1,9,5
20191130-W-ITF_Solarino-F-Urszula_Radwanska-Indy_De_Vroome,1,F-DTM,16,1,0,0,1,6,10
20191130-W-ITF_Solarino-F-Urszula_Radwanska-Indy_De_Vroome,1,F-DTL,2,0,0,0,0,1,1
20191130-W-ITF_Solarino-F-Urszula_Radwanska-Indy_De_Vroome,1,F-IO,5,1,0,1,0,3,2
20191130-W-ITF_Solarino-F-Urszula_Radwanska-Indy_De_Vroome,1,B-XC,11,3,1,0,2,6,5
20191130-W-ITF_Solarino-F-Urszula_Radwanska-Indy_De_Vroome,1,B-DTM,18,1,0,0,1,10,8
20191130-W-ITF_Solarino-F-Urszula_Radwanska-Indy_De_Vroome,1,B-DTL,3,2,2,0,0,2,1
20191130-W-ITF_Solarino-F-Urszula_Radwanska-Indy_De_Vroome,1,B-IO,2,2,1,1,0,2,0
20191130-W-ITF_Solarino-F-Urszula_Radwanska-Indy_De_Vroome,1,S-XC,8,0,0,0,0,2,6
20191130-W-ITF_Solarino-F-Urszula_Radwanska-Indy_De_Vroome,1,S-DTM,12,3,0,0,3,4,8
20191130-W-ITF_Solarino-F-Urszula_Radwanska-Indy_De_Vroome,2,F-XC,12,1,0,0,1,4,8
20191130-W-ITF_Solarino-F-Urszula_Radwanska-Indy_De_Vroome,2,F-DTM,7,2,0,0,2,3,4
20191130-W-ITF_Solarino-F-Urszula_Radwanska-Indy_De_Vroome,2,F-DTL,9,4,0,0,4,4,5
20191130-W-ITF_Solarino-F-Urszula_Radwanska-Indy_De_Vroome,2,F-IO,18,8,3,2,3,9,9
20191130-W-ITF_Solarino-F-Urszula_Radwanska-Indy_De_Vroome,2,B-XC,16,5,3,1,1,10,6
20191130-W-ITF_Solarino-F-Urszula_Radwanska-Indy_De_Vroome,2,B-DTM,18,1,0,0,1,9,9
20191130-W-ITF_Solarino-F-Urszula_Radwanska-Indy_De_Vroome,2,B-DTL,13,5,4,0,1,10,3
20191130-W-ITF_Solarino-F-Urszula_Radwanska-Indy_De_Vroome,2,B-IO,20,8,8,0,0,15,5
20191130-W-ITF_Solarino-F-Urszula_Radwanska-Indy_De_Vroome,2,S-DTL,2,1,0,0,1,0,2
20210326-W-Miami-R64-Paula_Badosa-Ons_Jabeur,1,F-XC,32,11,8,2,1,23,9
20210326-W-Miami-R64-Paula_Badosa-Ons_Jabeur,1,F-DTM,39,6,0,1,5,11,28
20210326-W-Miami-R64-Paula_Badosa-Ons_Jabeur,1,F-DTL,20,4,2,0,2,10,10
20210326-W-Miami-R64-Paula_Badosa-Ons_Jabeur,1,F-IO,35,6,0,3,3,17,18
20210326-W-Miami-R64-Paula_Badosa-Ons_Jabeur,1,F-II,1,0,0,0,0,1,0
20210326-W-Miami-R64-Paula_Badosa-Ons_Jabeur,1,B-XC,44,4,1,2,1,27,17
20210326-W-Miami-R64-Paula_Badosa-Ons_Jabeur,1,B-DTM,39,2,1,0,1,14,25
20210326-W-Miami-R64-Paula_Badosa-Ons_Jabeur,1,B-DTL,19,7,2,1,4,7,12
20210326-W-Miami-R64-Paula_Badosa-Ons_Jabeur,1,B-IO,8,3,1,1,1,6,2
20210326-W-Miami-R64-Paula_Badosa-Ons_Jabeur,1,S-XC,2,0,0,0,0,0,2
20210326-W-Miami-R64-Paula_Badosa-Ons_Jabeur,1,S-DTM,2,0,0,0,0,0,2
20210326-W-Miami-R64-Paula_Badosa-Ons_Jabeur,1,S-DTL,2,0,0,0,0,1,1
20210326-W-Miami-R64-Paula_Badosa-Ons_Jabeur,2,F-XC,50,16,3,6,7,30,20
20210326-W-Miami-R64-Paula_Badosa-Ons_Jabeur,2,F-DTM,30,5,0,1,4,14,16
20210326-W-Miami-R64-Paula_Badosa-Ons_Jabeur,2,F-DTL,12,7,6,0,1,9,3
20210326-W-Miami-R64-Paula_Badosa-Ons_Jabeur,2,F-IO,21,13,6,3,4,14,7
20210326-W-Miami-R64-Paula_Badosa-Ons_Jabeur,2,F-II,1,1,1,0,0,1,0
20210326-W-Miami-R64-Paula_Badosa-Ons_Jabeur,2,B-XC,44,15,6,1,8,24,20
20210326-W-Miami-R64-Paula_Badosa-Ons_Jabeur,2,B-DTM,36,3,0,0,3,14,22
20210326-W-Miami-R64-Paula_Badosa-Ons_Jabeur,2,B-DTL,15,11,4,0,7,5,10
20210326-W-Miami-R64-Paula_Badosa-Ons_Jabeur,2,B-IO,7,0,0,0,0,6,1
20210326-W-Miami-R64-Paula_Badosa-Ons_Jabeur,2,S-XC,10,2,0,1,1,8,2
20210326-W-Miami-R64-Paula_Badosa-Ons_Jabeur,2,S-DTM,10,0,0,0,0,5,5
20210326-W-Miami-R64-Paula_Badosa-Ons_Jabeur,2,S-DTL,4,0,0,0,0,2,2
20210326-W-Miami-R64-Paula_Badosa-Ons_Jabeur,2,S-IO,2,0,0,0,0,2,0
20210407-W-Bogota-R16-Arantxa_Rus-Nuria_Parrizas_Diaz,1,F-XC,52,10,3,2,5,24,28
20210407-W-Bogota-R16-Arantxa_Rus-Nuria_Parrizas_Diaz,1,F-DTM,58,10,0,1,9,22,36
20210407-W-Bogota-R16-Arantxa_Rus-Nuria_Parrizas_Diaz,1,F-DTL,7,3,0,0,3,1,6
20210407-W-Bogota-R16-Arantxa_Rus-Nuria_Parrizas_Diaz,1,F-IO,43,19,4,4,11,24,19
20210407-W-Bogota-R16-Arantxa_Rus-Nuria_Parrizas_Diaz,1,F-II,2,2,1,1,0,2,0
20210407-W-Bogota-R16-Arantxa_Rus-Nuria_Parrizas_Diaz,1,B-XC,28,8,0,0,8,14,14
20210407-W-Bogota-R16-Arantxa_Rus-Nuria_Parrizas_Diaz,1,B-DTM,63,5,0,0,5,39,24
20210407-W-Bogota-R16-Arantxa_Rus-Nuria_Parrizas_Diaz,1,B-DTL,6,3,1,1,1,4,2
20210407-W-Bogota-R16-Arantxa_Rus-Nuria_Parrizas_Diaz,1,B-IO,11,7,1,1,5,3,8
20210407-W-Bogota-R16-Arantxa_Rus-Nuria_Parrizas_Diaz,1,S-XC,1,0,0,0,0,0,1
20210407-W-Bogota-R16-Arantxa_Rus-Nuria_Parrizas_Diaz,1,S-DTM,4,1,0,0,1,1,3
20210407-W-Bogota-R16-Arantxa_Rus-Nuria_Parrizas_Diaz,2,F-XC,81,23,3,2,18,30,51
20210407-W-Bogota-R16-Arantxa_Rus-Nuria_Parrizas_Diaz,2,F-DTM,49,4,0,0,4,22,27
20210407-W-Bogota-R16-Arantxa_Rus-Nuria_Parrizas_Diaz,2,F-DTL,9,4,2,0,2,7,2
20210407-W-Bogota-R16-Arantxa_Rus-Nuria_Parrizas_Diaz,2,F-IO,21,13,0,2,11,9,12
20210407-W-Bogota-R16-Arantxa_Rus-Nuria_Parrizas_Diaz,2,F-II,1,1,0,0,1,0,1
20210407-W-Bogota-R16-Arantxa_Rus-Nuria_Parrizas_Diaz,2,B-XC,38,7,0,4,3,27,11
20210407-W-Bogota-R16-Arantxa_Rus-Nuria_Parrizas_Diaz,2,B-DTM,59,8,0,0,8,28,31
20210407-W-Bogota-R16-Arantxa_Rus-Nuria_Parrizas_Diaz,2,B-DTL,4,1,0,0,1,2,2
20210407-W-Bogota-R16-Arantxa_Rus-Nuria_Parrizas_Diaz,2,B-IO,4,2,1,1,0,3,1
20210309-W-Guadalajara-R32-Nadia_Podoroska-Giuliana_Olmos,1,F-XC,51,24,7,4,13,26,25
20210309-W-Guadalajara-R32-Nadia_Podoroska-Giuliana_Olmos,1,F-DTM,60,9,0,1,8,33,27
20210309-W-Guadalajara-R32-Nadia_Podoroska-Giuliana_Olmos,1,F-DTL,4,4,3,1,0,4,0
20210309-W-Guadalajara-R32-Nadia_Podoroska-Giuliana_Olmos,1,F-IO,49,14,5,1,8,29,20
20210309-W-Guadalajara-R32-Nadia_Podoroska-Giuliana_Olmos,1,B-XC,37,15,4,1,10,18,19
20210309-W-Guadalajara-R32-Nadia_Podoroska-Giuliana_Olmos,1,B-DTM,50,10,0,1,9,21,29
20210309-W-Guadalajara-R32-Nadia_Podoroska-Giuliana_Olmos,1,B-DTL,2,1,0,0,1,1,1
20210309-W-Guadalajara-R32-Nadia_Podoroska-Giuliana_Olmos,1,B-IO,4,2,1,0,1,2,2
20210309-W-Guadalajara-R32-Nadia_Podoroska-Giuliana_Olmos,1,S-XC,6,0,0,0,0,2,4
20210309-W-Guadalajara-R32-Nadia_Podoroska-Giuliana_Olmos,1,S-DTM,4,0,0,0,0,1,3
20210309-W-Guadalajara-R32-Nadia_Podoroska-Giuliana_Olmos,2,F-XC,33,8,0,2,6,14,19
20210309-W-Guadalajara-R32-Nadia_Podoroska-Giuliana_Olmos,2,F-DTM,64,8,1,0,7,35,29
20210309-W-Guadalajara-R32-Nadia_Podoroska-Giuliana_Olmos,2,F-DTL,3,1,0,0,1,0,3
20210309-W-Guadalajara-R32-Nadia_Podoroska-Giuliana_Olmos,2,F-IO,20,3,0,1,2,9,11
20210309-W-Guadalajara-R32-Nadia_Podoroska-Giuliana_Olmos,2,F-II,1,0,0,0,0,1,0
20210309-W-Guadalajara-R32-Nadia_Podoroska-Giuliana_Olmos,2,B-XC,42,5,0,1,4,20,22
20210309-W-Guadalajara-R32-Nadia_Podoroska-Giuliana_Olmos,2,B-DTM,59,9,0,0,9,24,35
20210309-W-Guadalajara-R32-Nadia_Podoroska-Giuliana_Olmos,2,B-DTL,8,6,3,1,2,5,3
20210309-W-Guadalajara-R32-Nadia_Podoroska-Giuliana_Olmos,2,B-IO,9,5,0,2,3,3,6
20210309-W-Guadalajara-R32-Nadia_Podoroska-Giuliana_Olmos,2,S-XC,2,0,0,0,0,1,1
20210309-W-Guadalajara-R32-Nadia_Podoroska-Giuliana_Olmos,2,S-DTM,2,0,0,0,0,0,2
20210416-W-Charleston_2-QF-Maria_Camila_Osorio_Serrano-Clara_Tauson,1,F-XC,17,5,1,3,1,10,7
20210416-W-Charleston_2-QF-Maria_Camila_Osorio_Serrano-Clara_Tauson,1,F-DTM,10,1,0,0,1,8,2
20210416-W-Charleston_2-QF-Maria_Camila_Osorio_Serrano-Clara_Tauson,1,F-DTL,7,2,0,0,2,4,3
20210416-W-Charleston_2-QF-Maria_Camila_Osorio_Serrano-Clara_Tauson,1,F-IO,15,3,1,2,0,14,1
20210416-W-Charleston_2-QF-Maria_Camila_Osorio_Serrano-Clara_Tauson,1,F-II,1,0,0,0,0,0,1
20210416-W-Charleston_2-QF-Maria_Camila_Osorio_Serrano-Clara_Tauson,1,B-XC,8,2,0,2,0,6,2
20210416-W-Charleston_2-QF-Maria_Camila_Osorio_Serrano-Clara_Tauson,1,B-DTM,18,1,0,0,1,10,8
20210416-W-Charleston_2-QF-Maria_Camila_Osorio_Serrano-Clara_Tauson,1,B-DTL,6,4,0,2,2,3,3
20210416-W-Charleston_2-QF-Maria_Camila_Osorio_Serrano-Clara_Tauson,1,B-IO,4,1,1,0,0,2,2
20210416-W-Charleston_2-QF-Maria_Camila_Osorio_Serrano-Clara_Tauson,1,S-XC,7,1,1,0,0,5,2
20210416-W-Charleston_2-QF-Maria_Camila_Osorio_Serrano-Clara_Tauson,1,S-DTM,7,2,0,1,1,6,1
20210416-W-Charleston_2-QF-Maria_Camila_Osorio_Serrano-Clara_Tauson,1,S-DTL,1,1,1,0,0,1,0
20210416-W-Charleston_2-QF-Maria_Camila_Osorio_Serrano-Clara_Tauson,2,F-XC,20,3,1,0,2,9,11
20210416-W-Charleston_2-QF-Maria_Camila_Osorio_Serrano-Clara_Tauson,2,F-DTM,10,0,0,0,0,2,8
20210416-W-Charleston_2-QF-Maria_Camila_Osorio_Serrano-Clara_Tauson,2,F-DTL,6,3,0,1,2,3,3
20210416-W-Charleston_2-QF-Maria_Camila_Osorio_Serrano-Clara_Tauson,2,F-IO,9,1,0,1,0,3,6
20210416-W-Charleston_2-QF-Maria_Camila_Osorio_Serrano-Clara_Tauson,2,B-XC,21,1,1,0,0,4,17
20210416-W-Charleston_2-QF-Maria_Camila_Osorio_Serrano-Clara_Tauson,2,B-DTM,13,0,0,0,0,3,10
20210416-W-Charleston_2-QF-Maria_Camila_Osorio_Serrano-Clara_Tauson,2,B-DTL,5,4,2,1,1,4,1
20210416-W-Charleston_2-QF-Maria_Camila_Osorio_Serrano-Clara_Tauson,2,B-IO,6,4,1,1,2,2,4
20210416-W-Charleston_2-QF-Maria_Camila_Osorio_Serrano-Clara_Tauson,2,S-XC,1,0,0,0,0,1,0
20210416-W-Charleston_2-QF-Maria_Camila_Osorio_Serrano-Clara_Tauson,2,S-DTM,1,0,0,0,0,0,1
20210416-W-Charleston_2-QF-Maria_Camila_Osorio_Serrano-Clara_Tauson,2,S-DTL,3,0,0,0,0,1,2
20210417-W-BJK_Cup-RR-Xiyu_Wang-Lesley_Kerkhove,1,F-XC,48,18,5,4,9,29,19
20210417-W-BJK_Cup-RR-Xiyu_Wang-Lesley_Kerkhove,1,F-DTM,31,5,0,0,5,19,12
20210417-W-BJK_Cup-RR-Xiyu_Wang-Lesley_Kerkhove,1,F-DTL,11,5,3,0,2,6,5
20210417-W-BJK_Cup-RR-Xiyu_Wang-Lesley_Kerkhove,1,F-IO,5,3,2,0,1,3,2
20210417-W-BJK_Cup-RR-Xiyu_Wang-Lesley_Kerkhove,1,F-II,1,1,0,0,1,0,1
20210417-W-BJK_Cup-RR-Xiyu_Wang-Lesley_Kerkhove,1,B-XC,21,5,1,1,3,12,9
20210417-W-BJK_Cup-RR-Xiyu_Wang-Lesley_Kerkhove,1,B-DTM,19,1,0,0,1,12,7
20210417-W-BJK_Cup-RR-Xiyu_Wang-Lesley_Kerkhove,1,B-DTL,5,5,2,1,2,3,2
20210417-W-BJK_Cup-RR-Xiyu_Wang-Lesley_Kerkhove,1,B-IO,2,2,1,1,0,2,0
20210417-W-BJK_Cup-RR-Xiyu_Wang-Lesley_Kerkhove,1,S-XC,1,0,0,0,0,0,1
20210417-W-BJK_Cup-RR-Xiyu_Wang-Lesley_Kerkhove,1,S-DTM,2,0,0,0,0,0,2
20210417-W-BJK_Cup-RR-Xiyu_Wang-Lesley_Kerkhove,2,F-XC,30,8,4,1,3,15,15
20210417-W-BJK_Cup-RR-Xiyu_Wang-Lesley_Kerkhove,2,F-DTM,27,5,0,2,3,13,14
20210417-W-BJK_Cup-RR-Xiyu_Wang-Lesley_Kerkhove,2,F-DTL,7,4,2,0,2,3,4
20210417-W-BJK_Cup-RR-Xiyu_Wang-Lesley_Kerkhove,2,F-IO,22,15,7,1,7,11,11
20210417-W-BJK_Cup-RR-Xiyu_Wang-Lesley_Kerkhove,2,B-XC,29,5,0,2,3,12,17
20210417-W-BJK_Cup-RR-Xiyu_Wang-Lesley_Kerkhove,2,B-DTM,28,3,0,1,2,12,16
20210417-W-BJK_Cup-RR-Xiyu_Wang-Lesley_Kerkhove,2,B-DTL,5,4,1,0,3,1,4
20210417-W-BJK_Cup-RR-Xiyu_Wang-Lesley_Kerkhove,2,S-DTM,2,1,0,0,1,0,2
20210417-W-BJK_Cup-RR-Arantxa_Rus-Xin_Yu_Wang,1,F-XC,27,6,4,0,2,14,13
20210417-W-BJK_Cup-RR-Arantxa_Rus-Xin_Yu_Wang,1,F-DTM,46,5,1,1,3,17,29
20210417-W-BJK_Cup-RR-Arantxa_Rus-Xin_Yu_Wang,1,F-DTL,11,8,3,2,3,5,6
20210417-W-BJK_Cup-RR-Arantxa_Rus-Xin_Yu_Wang,1,F-IO,19,5,2,2,1,10,9
20210417-W-BJK_Cup-RR-Arantxa_Rus-Xin_Yu_Wang,1,F-II,1,1,1,0,0,1,0
20210417-W-BJK_Cup-RR-Arantxa_Rus-Xin_Yu_Wang,1,B-XC,24,1,1,0,0,10,14
20210417-W-BJK_Cup-RR-Arantxa_Rus-Xin_Yu_Wang,1,B-DTM,56,3,0,1,2,21,35
20210417-W-BJK_Cup-RR-Arantxa_Rus-Xin_Yu_Wang,1,B-DTL,2,1,1,0,0,2,0
20210417-W-BJK_Cup-RR-Arantxa_Rus-Xin_Yu_Wang,1,B-IO,9,3,0,1,2,5,4
20210417-W-BJK_Cup-RR-Arantxa_Rus-Xin_Yu_Wang,1,S-DTM,2,0,0,0,0,1,1
20210417-W-BJK_Cup-RR-Arantxa_Rus-Xin_Yu_Wang,1,S-DTL,2,0,0,0,0,1,1
20210417-W-BJK_Cup-RR-Arantxa_Rus-Xin_Yu_Wang,2,F-XC,51,6,0,4,2,27,24
20210417-W-BJK_Cup-RR-Arantxa_Rus-Xin_Yu_Wang,2,F-DTM,27,4,1,1,2,16,11
20210417-W-BJK_Cup-RR-Arantxa_Rus-Xin_Yu_Wang,2,F-DTL,9,7,4,0,3,6,3
20210417-W-BJK_Cup-RR-Arantxa_Rus-Xin_Yu_Wang,2,F-IO,35,13,7,2,4,25,10
20210417-W-BJK_Cup-RR-Arantxa_Rus-Xin_Yu_Wang,2,B-XC,26,8,2,3,3,15,11
20210417-W-BJK_Cup-RR-Arantxa_Rus-Xin_Yu_Wang,2,B-DTM,35,4,0,0,4,18,17
20210417-W-BJK_Cup-RR-Arantxa_Rus-Xin_Yu_Wang,2,B-DTL,5,2,1,0,1,1,4
20210417-W-BJK_Cup-RR-Arantxa_Rus-Xin_Yu_Wang,2,B-IO,5,1,1,0,0,4,1
20210417-W-BJK_Cup-RR-Arantxa_Rus-Xin_Yu_Wang,2,S-DTM,4,2,0,1,1,1,3
20210410-W-Bogota-SF-Harmony_Tan-Maria_Camila_Osorio_Serrano,1,F-XC,28,4,1,1,2,13,15
20210410-W-Bogota-SF-Harmony_Tan-Maria_Camila_Osorio_Serrano,1,F-DTM,13,1,0,1,0,6,7
20210410-W-Bogota-SF-Harmony_Tan-Maria_Camila_Osorio_Serrano,1,F-DTL,6,1,0,0,1,3,3
20210410-W-Bogota-SF-Harmony_Tan-Maria_Camila_Osorio_Serrano,1,F-IO,11,1,1,0,0,8,3
20210410-W-Bogota-SF-Harmony_Tan-Maria_Camila_Osorio_Serrano,1,B-XC,25,8,1,1,6,8,17
20210410-W-Bogota-SF-Harmony_Tan-Maria_Camila_Osorio_Serrano,1,B-DTM,21,4,0,0,4,7,14
20210410-W-Bogota-SF-Harmony_Tan-Maria_Camila_Osorio_Serrano,1,B-DTL,10,6,2,0,4,4,6
20210410-W-Bogota-SF-Harmony_Tan-Maria_Camila_Osorio_Serrano,1,B-IO,2,1,0,1,0,2,0
20210410-W-Bogota-SF-Harmony_Tan-Maria_Camila_Osorio_Serrano,1,S-XC,7,2,0,0,2,2,5
20210410-W-Bogota-SF-Harmony_Tan-Maria_Camila_Osorio_Serrano,1,S-DTM,1,0,0,0,0,0,1
20210410-W-Bogota-SF-Harmony_Tan-Maria_Camila_Osorio_Serrano,1,S-IO,3,0,0,0,0,2,1
20210410-W-Bogota-SF-Harmony_Tan-Maria_Camila_Osorio_Serrano,2,F-XC,18,7,1,3,3,12,6
20210410-W-Bogota-SF-Harmony_Tan-Maria_Camila_Osorio_Serrano,2,F-DTM,16,0,0,0,0,8,8
20210410-W-Bogota-SF-Harmony_Tan-Maria_Camila_Osorio_Serrano,2,F-DTL,11,7,2,0,5,6,5
20210410-W-Bogota-SF-Harmony_Tan-Maria_Camila_Osorio_Serrano,2,F-IO,6,2,1,0,1,5,1
20210410-W-Bogota-SF-Harmony_Tan-Maria_Camila_Osorio_Serrano,2,F-II,3,3,1,1,1,2,1
20210410-W-Bogota-SF-Harmony_Tan-Maria_Camila_Osorio_Serrano,2,B-XC,14,4,2,1,1,11,3
20210410-W-Bogota-SF-Harmony_Tan-Maria_Camila_Osorio_Serrano,2,B-DTM,8,1,1,0,0,6,2
20210410-W-Bogota-SF-Harmony_Tan-Maria_Camila_Osorio_Serrano,2,B-DTL,4,2,0,2,0,4,0
20210410-W-Bogota-SF-Harmony_Tan-Maria_Camila_Osorio_Serrano,2,B-IO,2,1,1,0,0,1,1
20210410-W-Bogota-SF-Harmony_Tan-Maria_Camila_Osorio_Serrano,2,S-XC,9,1,0,1,0,4,5
20210410-W-Bogota-SF-Harmony_Tan-Maria_Camila_Osorio_Serrano,2,S-DTM,14,2,0,0,2,4,10
20210410-W-Bogota-SF-Harmony_Tan-Maria_Camila_Osorio_Serrano,2,S-DTL,7,2,2,0,0,5,2
20210410-W-Bogota-SF-Harmony_Tan-Maria_Camila_Osorio_Serrano,2,S-IO,2,1,0,0,1,1,1
20210418-W-Charleston_2-F-Astra_Sharma-Ons_Jabeur,1,F-XC,21,4,1,2,1,12,9
20210418-W-Charleston_2-F-Astra_Sharma-Ons_Jabeur,1,F-DTM,29,4,0,1,3,12,17
20210418-W-Charleston_2-F-Astra_Sharma-Ons_Jabeur,1,F-DTL,11,5,2,1,2,7,4
20210418-W-Charleston_2-F-Astra_Sharma-Ons_Jabeur,1,F-IO,30,8,1,1,6,14,16
20210418-W-Charleston_2-F-Astra_Sharma-Ons_Jabeur,1,F-II,5,1,0,1,0,5,0
20210418-W-Charleston_2-F-Astra_Sharma-Ons_Jabeur,1,B-XC,26,4,0,1,3,14,12
20210418-W-Charleston_2-F-Astra_Sharma-Ons_Jabeur,1,B-DTM,18,3,2,0,1,8,10
20210418-W-Charleston_2-F-Astra_Sharma-Ons_Jabeur,1,B-DTL,2,0,0,0,0,1,1
20210418-W-Charleston_2-F-Astra_Sharma-Ons_Jabeur,1,B-IO,1,0,0,0,0,1,0
20210418-W-Charleston_2-F-Astra_Sharma-Ons_Jabeur,1,B-II,1,1,0,1,0,1,0
20210418-W-Charleston_2-F-Astra_Sharma-Ons_Jabeur,1,S-XC,9,1,0,0,1,3,6
20210418-W-Charleston_2-F-Astra_Sharma-Ons_Jabeur,1,S-DTM,4,1,0,0,1,1,3
20210418-W-Charleston_2-F-Astra_Sharma-Ons_Jabeur,1,S-DTL,2,1,0,0,1,1,1
20210418-W-Charleston_2-F-Astra_Sharma-Ons_Jabeur,1,S-II,1,0,0,0,0,0,1
20210418-W-Charleston_2-F-Astra_Sharma-Ons_Jabeur,2,F-XC,33,13,6,2,5,19,14
20210418-W-Charleston_2-F-Astra_Sharma-Ons_Jabeur,2,F-DTM,16,3,2,0,1,7,9
20210418-W-Charleston_2-F-Astra_Sharma-Ons_Jabeur,2,F-DTL,10,1,0,0,1,2,8
20210418-W-Charleston_2-F-Astra_Sharma-Ons_Jabeur,2,F-IO,17,6,3,2,1,12,5
20210418-W-Charleston_2-F-Astra_Sharma-Ons_Jabeur,2,F-II,1,0,0,0,0,0,1
20210418-W-Charleston_2-F-Astra_Sharma-Ons_Jabeur,2,B-XC,35,10,1,2,7,16,19
20210418-W-Charleston_2-F-Astra_Sharma-Ons_Jabeur,2,B-DTM,17,2,0,0,2,9,8
20210418-W-Charleston_2-F-Astra_Sharma-Ons_Jabeur,2,B-DTL,14,5,2,1,2,7,7
20210418-W-Charleston_2-F-Astra_Sharma-Ons_Jabeur,2,B-IO,6,3,1,1,1,5,1
20210418-W-Charleston_2-F-Astra_Sharma-Ons_Jabeur,2,B-II,2,2,0,1,1,1,1
20210418-W-Charleston_2-F-Astra_Sharma-Ons_Jabeur,2,S-XC,5,0,0,0,0,3,2
20210418-W-Charleston_2-F-Astra_Sharma-Ons_Jabeur,2,S-DTM,3,1,0,0,1,1,2
20210418-W-Charleston_2-F-Astra_Sharma-Ons_Jabeur,2,S-DTL,3,2,2,0,0,3,0
20210418-W-Charleston_2-F-Astra_Sharma-Ons_Jabeur,2,S-IO,1,1,1,0,0,1,0
20210419-W-Stuttgart-R32-Andrea_Petkovic-Maria_Sakkari,1,F-XC,21,8,0,3,5,8,13
20210419-W-Stuttgart-R32-Andrea_Petkovic-Maria_Sakkari,1,F-DTM,12,1,1,0,0,4,8
20210419-W-Stuttgart-R32-Andrea_Petkovic-Maria_Sakkari,1,F-DTL,7,3,0,0,3,2,5
20210419-W-Stuttgart-R32-Andrea_Petkovic-Maria_Sakkari,1,F-IO,11,1,0,0,1,2,9
20210419-W-Stuttgart-R32-Andrea_Petkovic-Maria_Sakkari,1,F-II,1,0,0,0,0,0,1
20210419-W-Stuttgart-R32-Andrea_Petkovic-Maria_Sakkari,1,B-XC,16,4,1,1,2,7,9
20210419-W-Stuttgart-R32-Andrea_Petkovic-Maria_Sakkari,1,B-DTM,13,1,0,0,1,2,11
20210419-W-Stuttgart-R32-Andrea_Petkovic-Maria_Sakkari,1,B-DTL,4,2,0,0,2,1,3
20210419-W-Stuttgart-R32-Andrea_Petkovic-Maria_Sakkari,1,B-IO,4,0,0,0,0,3,1
20210419-W-Stuttgart-R32-Andrea_Petkovic-Maria_Sakkari,1,S-XC,1,0,0,0,0,0,1
20210419-W-Stuttgart-R32-Andrea_Petkovic-Maria_Sakkari,1,S-DTM,3,0,0,0,0,2,1
20210419-W-Stuttgart-R32-Andrea_Petkovic-Maria_Sakkari,1,S-DTL,2,0,0,0,0,1,1
20210419-W-Stuttgart-R32-Andrea_Petkovic-Maria_Sakkari,1,S-IO,1,1,1,0,0,1,0
20210419-W-Stuttgart-R32-Andrea_Petkovic-Maria_Sakkari,2,F-XC,24,9,7,1,1,20,4
20210419-W-Stuttgart-R32-Andrea_Petkovic-Maria_Sakkari,2,F-DTM,17,1,0,0,1,7,10
20210419-W-Stuttgart-R32-Andrea_Petkovic-Maria_Sakkari,2,F-DTL,2,2,1,0,1,1,1
20210419-W-Stuttgart-R32-Andrea_Petkovic-Maria_Sakkari,2,F-IO,9,5,2,1,2,7,2
20210419-W-Stuttgart-R32-Andrea_Petkovic-Maria_Sakkari,2,F-II,2,2,1,0,1,1,1
20210419-W-Stuttgart-R32-Andrea_Petkovic-Maria_Sakkari,2,B-XC,17,6,3,2,1,13,4
20210419-W-Stuttgart-R32-Andrea_Petkovic-Maria_Sakkari,2,B-DTM,19,3,0,0,3,8,11
20210419-W-Stuttgart-R32-Andrea_Petkovic-Maria_Sakkari,2,B-DTL,3,3,1,1,1,2,1
20210419-W-Stuttgart-R32-Andrea_Petkovic-Maria_Sakkari,2,B-IO,1,0,0,0,0,1,0
20210419-W-Stuttgart-R32-Andrea_Petkovic-Maria_Sakkari,2,S-XC,2,0,0,0,0,1,1
20210419-W-Stuttgart-R32-Andrea_Petkovic-Maria_Sakkari,2,S-DTM,5,0,0,0,0,4,1
20210420-W-Stuttgart-R32-Anna_Lena_Friedsam-Ulrikke_Eikeri,1,F-XC,60,13,6,1,6,39,21
20210420-W-Stuttgart-R32-Anna_Lena_Friedsam-Ulrikke_Eikeri,1,F-DTM,26,3,1,1,1,18,8
20210420-W-Stuttgart-R32-Anna_Lena_Friedsam-Ulrikke_Eikeri,1,F-DTL,8,6,3,1,2,5,3
20210420-W-Stuttgart-R32-Anna_Lena_Friedsam-Ulrikke_Eikeri,1,F-IO,16,5,4,0,1,13,3
20210420-W-Stuttgart-R32-Anna_Lena_Friedsam-Ulrikke_Eikeri,1,F-II,1,1,0,1,0,1,0
20210420-W-Stuttgart-R32-Anna_Lena_Friedsam-Ulrikke_Eikeri,1,B-XC,47,6,1,1,4,30,17
20210420-W-Stuttgart-R32-Anna_Lena_Friedsam-Ulrikke_Eikeri,1,B-DTM,19,0,0,0,0,14,5
20210420-W-Stuttgart-R32-Anna_Lena_Friedsam-Ulrikke_Eikeri,1,B-DTL,18,9,5,1,3,14,4
20210420-W-Stuttgart-R32-Anna_Lena_Friedsam-Ulrikke_Eikeri,1,B-IO,4,1,0,0,1,3,1
20210420-W-Stuttgart-R32-Anna_Lena_Friedsam-Ulrikke_Eikeri,1,S-XC,9,3,0,0,3,4,5
20210420-W-Stuttgart-R32-Anna_Lena_Friedsam-Ulrikke_Eikeri,1,S-DTM,1,0,0,0,0,1,0
20210420-W-Stuttgart-R32-Anna_Lena_Friedsam-Ulrikke_Eikeri,2,F-XC,38,6,1,1,4,14,24
20210420-W-Stuttgart-R32-Anna_Lena_Friedsam-Ulrikke_Eikeri,2,F-DTM,31,1,0,0,1,3,28
20210420-W-Stuttgart-R32-Anna_Lena_Friedsam-Ulrikke_Eikeri,2,F-DTL,14,4,0,0,4,5,9
20210420-W-Stuttgart-R32-Anna_Lena_Friedsam-Ulrikke_Eikeri,2,F-IO,9,0,0,0,0,4,5
20210420-W-Stuttgart-R32-Anna_Lena_Friedsam-Ulrikke_Eikeri,2,B-XC,34,3,1,0,2,10,24
20210420-W-Stuttgart-R32-Anna_Lena_Friedsam-Ulrikke_Eikeri,2,B-DTM,40,2,0,0,2,15,25
20210420-W-Stuttgart-R32-Anna_Lena_Friedsam-Ulrikke_Eikeri,2,B-DTL,12,3,0,0,3,5,7
20210420-W-Stuttgart-R32-Anna_Lena_Friedsam-Ulrikke_Eikeri,2,B-IO,8,1,0,0,1,2,6
20210420-W-Stuttgart-R32-Anna_Lena_Friedsam-Ulrikke_Eikeri,2,S-XC,1,1,0,0,1,0,1
20210420-W-Stuttgart-R32-Anna_Lena_Friedsam-Ulrikke_Eikeri,2,S-DTM,2,0,0,0,0,1,1
20210420-W-Stuttgart-R32-Anna_Lena_Friedsam-Ulrikke_Eikeri,2,S-DTL,1,0,0,0,0,0,1
20210420-W-Stuttgart-R32-Anna_Lena_Friedsam-Ulrikke_Eikeri,2,S-IO,2,0,0,0,0,0,2
20210420-W-Stuttgart-R32-Julia_Middendorf-Anett_Kontaveit,1,F-XC,25,6,3,2,1,12,13
20210420-W-Stuttgart-R32-Julia_Middendorf-Anett_Kontaveit,1,F-DTM,8,0,0,0,0,2,6
20210420-W-Stuttgart-R32-Julia_Middendorf-Anett_Kontaveit,1,F-DTL,6,6,2,0,4,2,4
20210420-W-Stuttgart-R32-Julia_Middendorf-Anett_Kontaveit,1,F-IO,12,10,6,2,2,9,3
20210420-W-Stuttgart-R32-Julia_Middendorf-Anett_Kontaveit,1,B-XC,24,8,2,0,6,13,11
20210420-W-Stuttgart-R32-Julia_Middendorf-Anett_Kontaveit,1,B-DTM,22,5,0,2,3,10,12
20210420-W-Stuttgart-R32-Julia_Middendorf-Anett_Kontaveit,1,B-DTL,2,2,1,0,1,1,1
20210420-W-Stuttgart-R32-Julia_Middendorf-Anett_Kontaveit,1,B-IO,2,2,0,1,1,1,1
20210420-W-Stuttgart-R32-Julia_Middendorf-Anett_Kontaveit,1,S-XC,1,0,0,0,0,0,1
20210420-W-Stuttgart-R32-Julia_Middendorf-Anett_Kontaveit,1,S-DTM,3,0,0,0,0,2,1
20210420-W-Stuttgart-R32-Julia_Middendorf-Anett_Kontaveit,2,F-XC,29,8,5,2,1,23,6
20210420-W-Stuttgart-R32-Julia_Middendorf-Anett_Kontaveit,2,F-DTM,17,1,0,1,0,7,10
20210420-W-Stuttgart-R32-Julia_Middendorf-Anett_Kontaveit,2,F-DTL,6,2,0,1,1,5,1
20210420-W-Stuttgart-R32-Julia_Middendorf-Anett_Kontaveit,2,F-IO,5,2,0,0,2,1,4
20210420-W-Stuttgart-R32-Julia_Middendorf-Anett_Kontaveit,2,B-XC,26,8,0,2,6,14,12
20210420-W-Stuttgart-R32-Julia_Middendorf-Anett_Kontaveit,2,B-DTM,10,1,0,0,1,3,7
20210420-W-Stuttgart-R32-Julia_Middendorf-Anett_Kontaveit,2,B-DTL,3,1,0,0,1,1,2
20210420-W-Stuttgart-R32-Julia_Middendorf-Anett_Kontaveit,2,B-IO,2,2,0,1,1,1,1
20210420-W-Stuttgart-R32-Julia_Middendorf-Anett_Kontaveit,2,S-XC,1,0,0,0,0,0,1
20210420-W-Stuttgart-R32-Julia_Middendorf-Anett_Kontaveit,2,S-DTM,4,0,0,0,0,1,3
20210420-W-Stuttgart-R32-Julia_Middendorf-Anett_Kontaveit,2,S-DTL,1,1,0,0,1,0,1
20210421-W-Stuttgart-R16-Ashleigh_Barty-Laura_Siegemund,1,F-XC,35,15,3,7,5,21,14
20210421-W-Stuttgart-R16-Ashleigh_Barty-Laura_Siegemund,1,F-DTM,9,0,0,0,0,6,3
20210421-W-Stuttgart-R16-Ashleigh_Barty-Laura_Siegemund,1,F-DTL,7,4,2,1,1,5,2
20210421-W-Stuttgart-R16-Ashleigh_Barty-Laura_Siegemund,1,F-IO,6,1,0,1,0,2,4
20210421-W-Stuttgart-R16-Ashleigh_Barty-Laura_Siegemund,1,F-II,2,1,1,0,0,2,0
20210421-W-Stuttgart-R16-Ashleigh_Barty-Laura_Siegemund,1,B-XC,11,2,1,0,1,4,7
20210421-W-Stuttgart-R16-Ashleigh_Barty-Laura_Siegemund,1,B-DTM,8,1,0,0,1,4,4
20210421-W-Stuttgart-R16-Ashleigh_Barty-Laura_Siegemund,1,B-DTL,4,2,1,0,1,3,1
20210421-W-Stuttgart-R16-Ashleigh_Barty-Laura_Siegemund,1,B-IO,2,1,0,0,1,0,2
20210421-W-Stuttgart-R16-Ashleigh_Barty-Laura_Siegemund,1,S-XC,16,4,0,1,3,8,8
20210421-W-Stuttgart-R16-Ashleigh_Barty-Laura_Siegemund,1,S-DTM,17,2,0,0,2,6,11
20210421-W-Stuttgart-R16-Ashleigh_Barty-Laura_Siegemund,1,S-DTL,4,1,1,0,0,1,3
20210421-W-Stuttgart-R16-Ashleigh_Barty-Laura_Siegemund,1,S-IO,1,1,0,0,1,0,1
20210421-W-Stuttgart-R16-Ashleigh_Barty-Laura_Siegemund,2,F-XC,24,8,0,0,8,8,16
20210421-W-Stuttgart-R16-Ashleigh_Barty-Laura_Siegemund,2,F-DTM,12,1,0,0,1,7,5
20210421-W-Stuttgart-R16-Ashleigh_Barty-Laura_Siegemund,2,F-DTL,13,2,0,0,2,8,5
20210421-W-Stuttgart-R16-Ashleigh_Barty-Laura_Siegemund,2,F-IO,17,4,3,0,1,12,5
20210421-W-Stuttgart-R16-Ashleigh_Barty-Laura_Siegemund,2,F-II,2,0,0,0,0,1,1
20210421-W-Stuttgart-R16-Ashleigh_Barty-Laura_Siegemund,2,B-XC,17,5,1,0,4,5,12
20210421-W-Stuttgart-R16-Ashleigh_Barty-Laura_Siegemund,2,B-DTM,5,0,0,0,0,1,4
20210421-W-Stuttgart-R16-Ashleigh_Barty-Laura_Siegemund,2,B-DTL,6,1,1,0,0,6,0
20210421-W-Stuttgart-R16-Ashleigh_Barty-Laura_Siegemund,2,B-IO,2,0,0,0,0,1,1
20210421-W-Stuttgart-R16-Ashleigh_Barty-Laura_Siegemund,2,S-XC,4,0,0,0,0,3,1
20210421-W-Stuttgart-R16-Ashleigh_Barty-Laura_Siegemund,2,S-DTM,4,0,0,0,0,2,2
20210421-W-Stuttgart-R16-Ashleigh_Barty-Laura_Siegemund,2,S-DTL,3,1,0,0,1,0,3
20210421-W-Stuttgart-R16-Ashleigh_Barty-Laura_Siegemund,2,S-IO,1,0,0,0,0,0,1
20210421-W-Stuttgart-R16-Petra_Kvitova-Maria_Sakkari,1,F-XC,60,17,5,7,4,33,27
20210421-W-Stuttgart-R16-Petra_Kvitova-Maria_Sakkari,1,F-DTM,14,0,0,0,0,9,5
20210421-W-Stuttgart-R16-Petra_Kvitova-Maria_Sakkari,1,F-DTL,15,9,4,2,3,10,5
20210421-W-Stuttgart-R16-Petra_Kvitova-Maria_Sakkari,1,F-IO,22,11,7,2,2,13,9
20210421-W-Stuttgart-R16-Petra_Kvitova-Maria_Sakkari,1,F-II,1,1,0,0,1,0,1
20210421-W-Stuttgart-R16-Petra_Kvitova-Maria_Sakkari,1,B-XC,58,18,5,3,10,28,30
20210421-W-Stuttgart-R16-Petra_Kvitova-Maria_Sakkari,1,B-DTM,27,11,0,0,11,8,19
20210421-W-Stuttgart-R16-Petra_Kvitova-Maria_Sakkari,1,B-DTL,9,1,0,0,1,5,4
20210421-W-Stuttgart-R16-Petra_Kvitova-Maria_Sakkari,1,B-IO,11,5,2,0,3,7,4
20210421-W-Stuttgart-R16-Petra_Kvitova-Maria_Sakkari,1,S-XC,3,0,0,0,0,2,1
20210421-W-Stuttgart-R16-Petra_Kvitova-Maria_Sakkari,1,S-DTM,5,0,0,0,0,1,4
20210421-W-Stuttgart-R16-Petra_Kvitova-Maria_Sakkari,1,S-DTL,4,1,0,1,0,4,0
20210421-W-Stuttgart-R16-Petra_Kvitova-Maria_Sakkari,1,S-IO,1,0,0,0,0,0,1
20210421-W-Stuttgart-R16-Petra_Kvitova-Maria_Sakkari,2,F-XC,47,2,0,1,1,24,23
20210421-W-Stuttgart-R16-Petra_Kvitova-Maria_Sakkari,2,F-DTM,41,4,0,0,4,17,24
20210421-W-Stuttgart-R16-Petra_Kvitova-Maria_Sakkari,2,F-DTL,6,2,0,1,1,2,4
20210421-W-Stuttgart-R16-Petra_Kvitova-Maria_Sakkari,2,F-IO,9,4,0,0,4,4,5
20210421-W-Stuttgart-R16-Petra_Kvitova-Maria_Sakkari,2,B-XC,28,7,4,1,2,16,12
20210421-W-Stuttgart-R16-Petra_Kvitova-Maria_Sakkari,2,B-DTM,39,5,0,2,3,14,25
20210421-W-Stuttgart-R16-Petra_Kvitova-Maria_Sakkari,2,B-DTL,12,3,0,1,2,7,5
20210421-W-Stuttgart-R16-Petra_Kvitova-Maria_Sakkari,2,B-IO,8,0,0,0,0,3,5
20210421-W-Stuttgart-R16-Petra_Kvitova-Maria_Sakkari,2,S-XC,5,0,0,0,0,2,3
20210421-W-Stuttgart-R16-Petra_Kvitova-Maria_Sakkari,2,S-DTM,8,0,0,0,0,3,5
20210421-W-Stuttgart-R16-Petra_Kvitova-Maria_Sakkari,2,S-DTL,4,1,0,0,1,1,3
20210423-W-Stuttgart-QF-Karolina_Pliskova-Ashleigh_Barty,1,F-XC,45,8,0,2,6,14,31
20210423-W-Stuttgart-QF-Karolina_Pliskova-Ashleigh_Barty,1,F-DTM,19,0,0,0,0,5,14
20210423-W-Stuttgart-QF-Karolina_Pliskova-Ashleigh_Barty,1,F-DTL,14,6,1,4,1,10,4
20210423-W-Stuttgart-QF-Karolina_Pliskova-Ashleigh_Barty,1,F-IO,42,13,5,1,7,23,19
20210423-W-Stuttgart-QF-Karolina_Pliskova-Ashleigh_Barty,1,F-II,1,0,0,0,0,0,1
20210423-W-Stuttgart-QF-Karolina_Pliskova-Ashleigh_Barty,1,B-XC,62,7,0,0,7,16,46
20210423-W-Stuttgart-QF-Karolina_Pliskova-Ashleigh_Barty,1,B-DTM,25,2,0,0,2,5,20
20210423-W-Stuttgart-QF-Karolina_Pliskova-Ashleigh_Barty,1,B-DTL,6,1,0,0,1,3,3
20210423-W-Stuttgart-QF-Karolina_Pliskova-Ashleigh_Barty,1,B-IO,3,1,0,0,1,1,2
20210423-W-Stuttgart-QF-Karolina_Pliskova-Ashleigh_Barty,1,S-XC,13,2,0,1,1,5,8
20210423-W-Stuttgart-QF-Karolina_Pliskova-Ashleigh_Barty,1,S-DTM,8,0,0,0,0,3,5
20210423-W-Stuttgart-QF-Karolina_Pliskova-Ashleigh_Barty,1,S-DTL,1,0,0,0,0,0,1
20210423-W-Stuttgart-QF-Karolina_Pliskova-Ashleigh_Barty,1,S-IO,1,0,0,0,0,1,0
20210423-W-Stuttgart-QF-Karolina_Pliskova-Ashleigh_Barty,2,F-XC,46,14,4,10,0,35,11
20210423-W-Stuttgart-QF-Karolina_Pliskova-Ashleigh_Barty,2,F-DTM,22,0,0,0,0,16,6
20210423-W-Stuttgart-QF-Karolina_Pliskova-Ashleigh_Barty,2,F-DTL,12,4,2,0,2,7,5
20210423-W-Stuttgart-QF-Karolina_Pliskova-Ashleigh_Barty,2,F-IO,16,6,2,0,4,11,5
20210423-W-Stuttgart-QF-Karolina_Pliskova-Ashleigh_Barty,2,F-II,1,0,0,0,0,1,0
20210423-W-Stuttgart-QF-Karolina_Pliskova-Ashleigh_Barty,2,B-XC,18,3,2,0,1,13,5
20210423-W-Stuttgart-QF-Karolina_Pliskova-Ashleigh_Barty,2,B-DTM,17,2,0,0,2,8,9
20210423-W-Stuttgart-QF-Karolina_Pliskova-Ashleigh_Barty,2,B-DTL,5,3,2,0,1,3,2
20210423-W-Stuttgart-QF-Karolina_Pliskova-Ashleigh_Barty,2,B-IO,4,1,1,0,0,3,1
20210423-W-Stuttgart-QF-Karolina_Pliskova-Ashleigh_Barty,2,S-XC,48,8,0,1,7,28,20
20210423-W-Stuttgart-QF-Karolina_Pliskova-Ashleigh_Barty,2,S-DTM,21,2,1,0,1,10,11
20210423-W-Stuttgart-QF-Karolina_Pliskova-Ashleigh_Barty,2,S-DTL,12,2,0,2,0,10,2
20210423-W-Stuttgart-QF-Karolina_Pliskova-Ashleigh_Barty,2,S-IO,5,1,0,0,1,3,2
20210423-W-Stuttgart-QF-Elina_Svitolina-Petra_Kvitova,1,F-XC,42,8,1,2,5,21,21
20210423-W-Stuttgart-QF-Elina_Svitolina-Petra_Kvitova,1,F-DTM,37,3,0,2,1,21,16
20210423-W-Stuttgart-QF-Elina_Svitolina-Petra_Kvitova,1,F-DTL,8,4,1,1,2,4,4
20210423-W-Stuttgart-QF-Elina_Svitolina-Petra_Kvitova,1,F-IO,11,5,1,1,3,5,6
20210423-W-Stuttgart-QF-Elina_Svitolina-Petra_Kvitova,1,B-XC,32,7,2,1,4,17,15
20210423-W-Stuttgart-QF-Elina_Svitolina-Petra_Kvitova,1,B-DTM,37,2,0,1,1,20,17
20210423-W-Stuttgart-QF-Elina_Svitolina-Petra_Kvitova,1,B-DTL,12,5,2,1,2,6,6
20210423-W-Stuttgart-QF-Elina_Svitolina-Petra_Kvitova,1,B-IO,5,4,0,2,2,3,2
20210423-W-Stuttgart-QF-Elina_Svitolina-Petra_Kvitova,1,S-XC,8,2,1,1,0,5,3
20210423-W-Stuttgart-QF-Elina_Svitolina-Petra_Kvitova,1,S-DTM,6,0,0,0,0,5,1
20210423-W-Stuttgart-QF-Elina_Svitolina-Petra_Kvitova,1,S-DTL,2,2,2,0,0,2,0
20210423-W-Stuttgart-QF-Elina_Svitolina-Petra_Kvitova,1,S-IO,1,0,0,0,0,1,0
20210423-W-Stuttgart-QF-Elina_Svitolina-Petra_Kvitova,2,F-XC,59,24,5,7,12,30,29
20210423-W-Stuttgart-QF-Elina_Svitolina-Petra_Kvitova,2,F-DTM,35,5,1,1,3,12,23
20210423-W-Stuttgart-QF-Elina_Svitolina-Petra_Kvitova,2,F-DTL,10,9,4,3,2,8,2
20210423-W-Stuttgart-QF-Elina_Svitolina-Petra_Kvitova,2,F-IO,21,11,3,4,4,12,9
20210423-W-Stuttgart-QF-Elina_Svitolina-Petra_Kvitova,2,F-II,5,2,2,0,0,3,2
20210423-W-Stuttgart-QF-Elina_Svitolina-Petra_Kvitova,2,B-XC,35,8,0,3,5,13,22
20210423-W-Stuttgart-QF-Elina_Svitolina-Petra_Kvitova,2,B-DTM,25,5,0,1,4,11,14
20210423-W-Stuttgart-QF-Elina_Svitolina-Petra_Kvitova,2,B-DTL,10,3,2,0,1,7,3
20210423-W-Stuttgart-QF-Elina_Svitolina-Petra_Kvitova,2,B-IO,10,2,1,0,1,4,6
20210423-W-Stuttgart-QF-Elina_Svitolina-Petra_Kvitova,2,S-XC,2,0,0,0,0,2,0
20210423-W-Stuttgart-QF-Elina_Svitolina-Petra_Kvitova,2,S-DTM,1,0,0,0,0,0,1
20210423-W-Stuttgart-QF-Elina_Svitolina-Petra_Kvitova,2,S-DTL,3,0,0,0,0,1,2
20210423-W-Stuttgart-QF-Elina_Svitolina-Petra_Kvitova,2,S-IO,1,0,0,0,0,0,1
20050628-W-Wimbledon-QF-Venus_Williams-Mary_Pierce,1,F-XC,26,14,3,7,4,18,8
20050628-W-Wimbledon-QF-Venus_Williams-Mary_Pierce,1,F-DTM,17,3,0,1,2,9,8
20050628-W-Wimbledon-QF-Venus_Williams-Mary_Pierce,1,F-DTL,9,3,2,1,0,8,1
20050628-W-Wimbledon-QF-Venus_Williams-Mary_Pierce,1,F-IO,6,5,1,1,3,3,3
20050628-W-Wimbledon-QF-Venus_Williams-Mary_Pierce,1,B-XC,25,10,5,2,3,14,11
20050628-W-Wimbledon-QF-Venus_Williams-Mary_Pierce,1,B-DTM,13,3,0,3,0,8,5
20050628-W-Wimbledon-QF-Venus_Williams-Mary_Pierce,1,B-DTL,4,0,0,0,0,0,4
20050628-W-Wimbledon-QF-Venus_Williams-Mary_Pierce,1,B-IO,3,2,1,1,0,3,0
20050628-W-Wimbledon-QF-Venus_Williams-Mary_Pierce,1,S-DTM,1,0,0,0,0,1,0
20050628-W-Wimbledon-QF-Venus_Williams-Mary_Pierce,2,F-XC,14,8,4,2,2,9,5
20050628-W-Wimbledon-QF-Venus_Williams-Mary_Pierce,2,F-DTM,10,0,0,0,0,4,6
20050628-W-Wimbledon-QF-Venus_Williams-Mary_Pierce,2,F-DTL,7,4,4,0,0,6,1
20050628-W-Wimbledon-QF-Venus_Williams-Mary_Pierce,2,F-IO,9,4,2,2,0,6,3
20050628-W-Wimbledon-QF-Venus_Williams-Mary_Pierce,2,B-XC,16,5,1,0,4,8,8
20050628-W-Wimbledon-QF-Venus_Williams-Mary_Pierce,2,B-DTM,14,4,0,1,3,6,8
20050628-W-Wimbledon-QF-Venus_Williams-Mary_Pierce,2,B-DTL,15,7,3,1,3,7,8
20050628-W-Wimbledon-QF-Venus_Williams-Mary_Pierce,2,B-IO,14,5,2,1,2,6,8
20050628-W-Wimbledon-QF-Venus_Williams-Mary_Pierce,2,S-DTM,2,0,0,0,0,1,1
20210211-W-Australian_Open-R64-Samantha_Stosur-Jessica_Pegula,1,F-XC,14,2,0,0,2,1,13
20210211-W-Australian_Open-R64-Samantha_Stosur-Jessica_Pegula,1,F-DTM,20,0,0,0,0,8,12
20210211-W-Australian_Open-R64-Samantha_Stosur-Jessica_Pegula,1,F-DTL,3,3,1,0,2,1,2
20210211-W-Australian_Open-R64-Samantha_Stosur-Jessica_Pegula,1,F-IO,15,3,0,0,3,4,11
20210211-W-Australian_Open-R64-Samantha_Stosur-Jessica_Pegula,1,F-II,1,1,0,0,1,0,1
20210211-W-Australian_Open-R64-Samantha_Stosur-Jessica_Pegula,1,B-XC,4,0,0,0,0,0,4
20210211-W-Australian_Open-R64-Samantha_Stosur-Jessica_Pegula,1,B-DTM,9,0,0,0,0,0,9
20210211-W-Australian_Open-R64-Samantha_Stosur-Jessica_Pegula,1,B-DTL,2,2,1,0,1,1,1
20210211-W-Australian_Open-R64-Samantha_Stosur-Jessica_Pegula,1,S-XC,5,1,0,0,1,2,3
20210211-W-Australian_Open-R64-Samantha_Stosur-Jessica_Pegula,1,S-DTM,12,1,1,0,0,3,9
20210211-W-Australian_Open-R64-Samantha_Stosur-Jessica_Pegula,1,S-DTL,3,1,0,1,0,1,2
20210211-W-Australian_Open-R64-Samantha_Stosur-Jessica_Pegula,2,F-XC,18,9,4,3,2,13,5
20210211-W-Australian_Open-R64-Samantha_Stosur-Jessica_Pegula,2,F-DTM,18,2,0,2,0,14,4
20210211-W-Australian_Open-R64-Samantha_Stosur-Jessica_Pegula,2,F-DTL,3,2,1,0,1,2,1
20210211-W-Australian_Open-R64-Samantha_Stosur-Jessica_Pegula,2,F-IO,8,3,2,0,1,6,2
20210211-W-Australian_Open-R64-Samantha_Stosur-Jessica_Pegula,2,B-XC,18,4,2,1,1,14,4
20210211-W-Australian_Open-R64-Samantha_Stosur-Jessica_Pegula,2,B-DTM,17,2,0,1,1,11,6
20210211-W-Australian_Open-R64-Samantha_Stosur-Jessica_Pegula,2,B-DTL,3,2,1,1,0,3,0
20210211-W-Australian_Open-R64-Samantha_Stosur-Jessica_Pegula,2,B-IO,3,2,2,0,0,3,0
20210211-W-Australian_Open-R64-Samantha_Stosur-Jessica_Pegula,2,S-XC,3,1,0,1,0,2,1
20210211-W-Australian_Open-R64-Samantha_Stosur-Jessica_Pegula,2,S-DTM,2,0,0,0,0,2,0
20210416-W-BJK_Cup-RR-Xin_Yu_Wang-Kiki_Bertens,1,F-XC,31,8,1,1,6,9,22
20210416-W-BJK_Cup-RR-Xin_Yu_Wang-Kiki_Bertens,1,F-DTM,26,4,0,1,3,14,12
20210416-W-BJK_Cup-RR-Xin_Yu_Wang-Kiki_Bertens,1,F-DTL,10,4,0,0,4,1,9
20210416-W-BJK_Cup-RR-Xin_Yu_Wang-Kiki_Bertens,1,F-IO,30,7,3,1,3,17,13
20210416-W-BJK_Cup-RR-Xin_Yu_Wang-Kiki_Bertens,1,B-XC,20,5,0,2,3,12,8
20210416-W-BJK_Cup-RR-Xin_Yu_Wang-Kiki_Bertens,1,B-DTM,11,1,0,0,1,5,6
20210416-W-BJK_Cup-RR-Xin_Yu_Wang-Kiki_Bertens,1,B-IO,1,1,1,0,0,1,0
20210416-W-BJK_Cup-RR-Xin_Yu_Wang-Kiki_Bertens,1,S-XC,1,1,0,1,0,1,0
20210416-W-BJK_Cup-RR-Xin_Yu_Wang-Kiki_Bertens,1,S-DTM,2,1,0,0,1,0,2
20210416-W-BJK_Cup-RR-Xin_Yu_Wang-Kiki_Bertens,1,S-DTL,1,0,0,0,0,0,1
20210416-W-BJK_Cup-RR-Xin_Yu_Wang-Kiki_Bertens,2,F-XC,18,3,2,1,0,15,3
20210416-W-BJK_Cup-RR-Xin_Yu_Wang-Kiki_Bertens,2,F-DTM,17,0,0,0,0,9,8
20210416-W-BJK_Cup-RR-Xin_Yu_Wang-Kiki_Bertens,2,F-DTL,4,2,1,1,0,3,1
20210416-W-BJK_Cup-RR-Xin_Yu_Wang-Kiki_Bertens,2,F-IO,6,4,2,1,1,4,2
20210416-W-BJK_Cup-RR-Xin_Yu_Wang-Kiki_Bertens,2,F-II,2,1,1,0,0,2,0
20210416-W-BJK_Cup-RR-Xin_Yu_Wang-Kiki_Bertens,2,B-XC,11,4,0,2,2,4,7
20210416-W-BJK_Cup-RR-Xin_Yu_Wang-Kiki_Bertens,2,B-DTM,22,4,0,1,3,8,14
20210416-W-BJK_Cup-RR-Xin_Yu_Wang-Kiki_Bertens,2,B-DTL,4,3,2,0,1,2,2
20210416-W-BJK_Cup-RR-Xin_Yu_Wang-Kiki_Bertens,2,B-IO,3,1,0,0,1,2,1
20210416-W-BJK_Cup-RR-Xin_Yu_Wang-Kiki_Bertens,2,S-XC,5,0,0,0,0,3,2
20210416-W-BJK_Cup-RR-Xin_Yu_Wang-Kiki_Bertens,2,S-DTM,14,2,0,1,1,4,10
20210416-W-BJK_Cup-RR-Xin_Yu_Wang-Kiki_Bertens,2,S-DTL,3,2,1,1,0,3,0
20210416-W-BJK_Cup-RR-Xiyu_Wang-Arantxa_Rus,1,F-XC,65,17,1,6,10,31,34
20210416-W-BJK_Cup-RR-Xiyu_Wang-Arantxa_Rus,1,F-DTM,37,5,0,2,3,17,20
20210416-W-BJK_Cup-RR-Xiyu_Wang-Arantxa_Rus,1,F-DTL,19,13,7,0,6,9,10
20210416-W-BJK_Cup-RR-Xiyu_Wang-Arantxa_Rus,1,F-IO,29,13,7,2,4,19,10
20210416-W-BJK_Cup-RR-Xiyu_Wang-Arantxa_Rus,1,F-II,1,0,0,0,0,0,1
20210416-W-BJK_Cup-RR-Xiyu_Wang-Arantxa_Rus,1,B-XC,36,10,3,3,4,21,15
20210416-W-BJK_Cup-RR-Xiyu_Wang-Arantxa_Rus,1,B-DTM,25,6,3,1,2,15,10
20210416-W-BJK_Cup-RR-Xiyu_Wang-Arantxa_Rus,1,B-DTL,7,3,2,0,1,6,1
20210416-W-BJK_Cup-RR-Xiyu_Wang-Arantxa_Rus,1,B-IO,11,4,1,3,0,8,3
20210416-W-BJK_Cup-RR-Xiyu_Wang-Arantxa_Rus,1,S-XC,9,2,0,0,2,2,7
20210416-W-BJK_Cup-RR-Xiyu_Wang-Arantxa_Rus,1,S-DTM,4,0,0,0,0,1,3
20210416-W-BJK_Cup-RR-Xiyu_Wang-Arantxa_Rus,1,S-DTL,1,0,0,0,0,0,1
20210416-W-BJK_Cup-RR-Xiyu_Wang-Arantxa_Rus,2,F-XC,47,10,4,4,2,27,20
20210416-W-BJK_Cup-RR-Xiyu_Wang-Arantxa_Rus,2,F-DTM,60,2,0,2,0,30,30
20210416-W-BJK_Cup-RR-Xiyu_Wang-Arantxa_Rus,2,F-DTL,11,8,1,2,5,3,8
20210416-W-BJK_Cup-RR-Xiyu_Wang-Arantxa_Rus,2,F-IO,21,6,1,0,5,5,16
20210416-W-BJK_Cup-RR-Xiyu_Wang-Arantxa_Rus,2,F-II,3,3,2,1,0,3,0
20210416-W-BJK_Cup-RR-Xiyu_Wang-Arantxa_Rus,2,B-XC,21,7,5,0,2,10,11
20210416-W-BJK_Cup-RR-Xiyu_Wang-Arantxa_Rus,2,B-DTM,52,5,1,1,3,27,25
20210416-W-BJK_Cup-RR-Xiyu_Wang-Arantxa_Rus,2,B-DTL,4,1,0,0,1,2,2
20210416-W-BJK_Cup-RR-Xiyu_Wang-Arantxa_Rus,2,B-IO,9,2,0,0,2,4,5
20210416-W-BJK_Cup-RR-Xiyu_Wang-Arantxa_Rus,2,S-XC,7,0,0,0,0,4,3
20210416-W-BJK_Cup-RR-Xiyu_Wang-Arantxa_Rus,2,S-DTM,8,0,0,0,0,4,4
20210416-W-BJK_Cup-RR-Xiyu_Wang-Arantxa_Rus,2,S-IO,1,0,0,0,0,0,1
20210425-W-Istanbul-F-Sorana_Cirstea-Elise_Mertens,1,F-XC,34,6,2,0,4,15,19
20210425-W-Istanbul-F-Sorana_Cirstea-Elise_Mertens,1,F-DTM,31,5,0,0,5,12,19
20210425-W-Istanbul-F-Sorana_Cirstea-Elise_Mertens,1,F-DTL,6,4,1,0,3,3,3
20210425-W-Istanbul-F-Sorana_Cirstea-Elise_Mertens,1,F-IO,14,4,1,1,2,10,4
20210425-W-Istanbul-F-Sorana_Cirstea-Elise_Mertens,1,B-XC,30,7,1,1,5,16,14
20210425-W-Istanbul-F-Sorana_Cirstea-Elise_Mertens,1,B-DTM,27,3,0,1,2,13,14
20210425-W-Istanbul-F-Sorana_Cirstea-Elise_Mertens,1,B-DTL,11,6,4,0,2,7,4
20210425-W-Istanbul-F-Sorana_Cirstea-Elise_Mertens,1,B-IO,10,4,1,0,3,6,4
20210425-W-Istanbul-F-Sorana_Cirstea-Elise_Mertens,1,S-XC,2,0,0,0,0,1,1
20210425-W-Istanbul-F-Sorana_Cirstea-Elise_Mertens,1,S-DTM,1,1,0,0,1,0,1
20210425-W-Istanbul-F-Sorana_Cirstea-Elise_Mertens,1,S-DTL,1,0,0,0,0,1,0
20210425-W-Istanbul-F-Sorana_Cirstea-Elise_Mertens,1,S-IO,1,0,0,0,0,0,1
20210425-W-Istanbul-F-Sorana_Cirstea-Elise_Mertens,2,F-XC,29,5,1,2,2,17,12
20210425-W-Istanbul-F-Sorana_Cirstea-Elise_Mertens,2,F-DTM,28,2,0,0,2,12,16
20210425-W-Istanbul-F-Sorana_Cirstea-Elise_Mertens,2,F-DTL,8,3,1,1,1,6,2
20210425-W-Istanbul-F-Sorana_Cirstea-Elise_Mertens,2,F-IO,8,3,1,0,2,4,4
20210425-W-Istanbul-F-Sorana_Cirstea-Elise_Mertens,2,B-XC,20,4,0,1,3,10,10
20210425-W-Istanbul-F-Sorana_Cirstea-Elise_Mertens,2,B-DTM,26,2,0,0,2,11,15
20210425-W-Istanbul-F-Sorana_Cirstea-Elise_Mertens,2,B-DTL,7,4,1,0,3,2,5
20210425-W-Istanbul-F-Sorana_Cirstea-Elise_Mertens,2,B-IO,9,4,0,1,3,3,6
20210425-W-Istanbul-F-Sorana_Cirstea-Elise_Mertens,2,S-XC,3,0,0,0,0,0,3
20210425-W-Istanbul-F-Sorana_Cirstea-Elise_Mertens,2,S-DTM,8,1,0,0,1,1,7
20210425-W-Istanbul-F-Sorana_Cirstea-Elise_Mertens,2,S-IO,2,1,0,0,1,1,1
20210210-W-Australian_Open-R64-Rebecca_Marino-Marketa_Vondrousova,1,F-XC,42,12,4,3,5,23,19
20210210-W-Australian_Open-R64-Rebecca_Marino-Marketa_Vondrousova,1,F-DTM,25,4,1,0,3,12,13
20210210-W-Australian_Open-R64-Rebecca_Marino-Marketa_Vondrousova,1,F-DTL,2,1,0,0,1,0,2
20210210-W-Australian_Open-R64-Rebecca_Marino-Marketa_Vondrousova,1,F-IO,18,10,5,0,5,8,10
20210210-W-Australian_Open-R64-Rebecca_Marino-Marketa_Vondrousova,1,F-II,1,0,0,0,0,1,0
20210210-W-Australian_Open-R64-Rebecca_Marino-Marketa_Vondrousova,1,B-XC,27,8,0,3,5,10,17
20210210-W-Australian_Open-R64-Rebecca_Marino-Marketa_Vondrousova,1,B-DTM,29,5,0,1,4,13,16
20210210-W-Australian_Open-R64-Rebecca_Marino-Marketa_Vondrousova,1,B-DTL,9,3,0,1,2,5,4
20210210-W-Australian_Open-R64-Rebecca_Marino-Marketa_Vondrousova,1,B-IO,8,1,0,0,1,4,4
20210210-W-Australian_Open-R64-Rebecca_Marino-Marketa_Vondrousova,1,S-XC,3,1,0,0,1,0,3
20210210-W-Australian_Open-R64-Rebecca_Marino-Marketa_Vondrousova,1,S-DTM,4,0,0,0,0,2,2
20210210-W-Australian_Open-R64-Rebecca_Marino-Marketa_Vondrousova,1,S-DTL,4,2,0,1,1,1,3
20210210-W-Australian_Open-R64-Rebecca_Marino-Marketa_Vondrousova,1,S-IO,3,1,0,0,1,1,2
20210210-W-Australian_Open-R64-Rebecca_Marino-Marketa_Vondrousova,2,F-XC,36,5,3,1,1,23,13
20210210-W-Australian_Open-R64-Rebecca_Marino-Marketa_Vondrousova,2,F-DTM,40,2,0,0,2,20,20
20210210-W-Australian_Open-R64-Rebecca_Marino-Marketa_Vondrousova,2,F-DTL,4,4,2,2,0,4,0
20210210-W-Australian_Open-R64-Rebecca_Marino-Marketa_Vondrousova,2,F-IO,2,0,0,0,0,2,0
20210210-W-Australian_Open-R64-Rebecca_Marino-Marketa_Vondrousova,2,B-XC,25,6,0,3,3,14,11
20210210-W-Australian_Open-R64-Rebecca_Marino-Marketa_Vondrousova,2,B-DTM,21,2,0,0,2,9,12
20210210-W-Australian_Open-R64-Rebecca_Marino-Marketa_Vondrousova,2,B-DTL,1,1,1,0,0,1,0
20210210-W-Australian_Open-R64-Rebecca_Marino-Marketa_Vondrousova,2,B-IO,5,1,0,0,1,3,2
20210210-W-Australian_Open-R64-Rebecca_Marino-Marketa_Vondrousova,2,S-XC,7,0,0,0,0,4,3
20210210-W-Australian_Open-R64-Rebecca_Marino-Marketa_Vondrousova,2,S-DTM,17,1,0,0,1,8,9
20210210-W-Australian_Open-R64-Rebecca_Marino-Marketa_Vondrousova,2,S-DTL,1,0,0,0,0,0,1
20210419-W-Istanbul-R32-Sara_Errani-Ana_Konjuh,1,F-XC,31,3,1,0,2,20,11
20210419-W-Istanbul-R32-Sara_Errani-Ana_Konjuh,1,F-DTM,21,0,0,0,0,13,8
20210419-W-Istanbul-R32-Sara_Errani-Ana_Konjuh,1,F-DTL,4,3,1,0,2,2,2
20210419-W-Istanbul-R32-Sara_Errani-Ana_Konjuh,1,F-IO,12,3,1,0,2,5,7
20210419-W-Istanbul-R32-Sara_Errani-Ana_Konjuh,1,B-XC,20,6,0,3,3,9,11
20210419-W-Istanbul-R32-Sara_Errani-Ana_Konjuh,1,B-DTM,36,2,0,0,2,18,18
20210419-W-Istanbul-R32-Sara_Errani-Ana_Konjuh,1,B-DTL,4,0,0,0,0,3,1
20210419-W-Istanbul-R32-Sara_Errani-Ana_Konjuh,1,B-IO,1,1,0,1,0,1,0
20210419-W-Istanbul-R32-Sara_Errani-Ana_Konjuh,1,S-XC,3,0,0,0,0,2,1
20210419-W-Istanbul-R32-Sara_Errani-Ana_Konjuh,1,S-DTM,12,1,0,0,1,3,9
20210419-W-Istanbul-R32-Sara_Errani-Ana_Konjuh,1,S-DTL,2,0,0,0,0,0,2
20210419-W-Istanbul-R32-Sara_Errani-Ana_Konjuh,1,S-IO,2,1,0,0,1,1,1
20210419-W-Istanbul-R32-Sara_Errani-Ana_Konjuh,2,F-XC,48,17,4,5,8,24,24
20210419-W-Istanbul-R32-Sara_Errani-Ana_Konjuh,2,F-DTM,13,0,0,0,0,5,8
20210419-W-Istanbul-R32-Sara_Errani-Ana_Konjuh,2,F-DTL,13,9,3,2,4,7,6
20210419-W-Istanbul-R32-Sara_Errani-Ana_Konjuh,2,F-IO,14,5,3,2,0,11,3
20210419-W-Istanbul-R32-Sara_Errani-Ana_Konjuh,2,B-XC,43,13,6,0,7,21,22
20210419-W-Istanbul-R32-Sara_Errani-Ana_Konjuh,2,B-DTM,18,2,0,0,2,9,9
20210419-W-Istanbul-R32-Sara_Errani-Ana_Konjuh,2,B-DTL,5,4,2,0,2,2,3
20210419-W-Istanbul-R32-Sara_Errani-Ana_Konjuh,2,B-IO,10,4,0,1,3,4,6
20210419-W-Istanbul-R32-Sara_Errani-Ana_Konjuh,2,S-XC,4,2,2,0,0,3,1
20210419-W-Istanbul-R32-Sara_Errani-Ana_Konjuh,2,S-DTM,4,1,0,0,1,2,2
20210419-W-Istanbul-R32-Sara_Errani-Ana_Konjuh,2,S-IO,1,0,0,0,0,0,1
20210429-W-Madrid-R64-Kiki_Bertens-Victoria_Jimenez_Kasintseva,1,F-XC,42,6,2,4,0,23,19
20210429-W-Madrid-R64-Kiki_Bertens-Victoria_Jimenez_Kasintseva,1,F-DTM,16,1,0,0,1,10,6
20210429-W-Madrid-R64-Kiki_Bertens-Victoria_Jimenez_Kasintseva,1,F-DTL,4,3,1,0,2,2,2
20210429-W-Madrid-R64-Kiki_Bertens-Victoria_Jimenez_Kasintseva,1,F-IO,8,2,1,1,0,6,2
20210429-W-Madrid-R64-Kiki_Bertens-Victoria_Jimenez_Kasintseva,1,B-XC,16,5,1,0,4,6,10
20210429-W-Madrid-R64-Kiki_Bertens-Victoria_Jimenez_Kasintseva,1,B-DTM,12,0,0,0,0,5,7
20210429-W-Madrid-R64-Kiki_Bertens-Victoria_Jimenez_Kasintseva,1,B-DTL,5,2,0,0,2,1,4
20210429-W-Madrid-R64-Kiki_Bertens-Victoria_Jimenez_Kasintseva,1,S-XC,1,0,0,0,0,1,0
20210429-W-Madrid-R64-Kiki_Bertens-Victoria_Jimenez_Kasintseva,1,S-DTM,4,0,0,0,0,2,2
20210429-W-Madrid-R64-Kiki_Bertens-Victoria_Jimenez_Kasintseva,1,S-DTL,4,1,1,0,0,3,1
20210429-W-Madrid-R64-Kiki_Bertens-Victoria_Jimenez_Kasintseva,2,F-XC,22,1,0,0,1,9,13
20210429-W-Madrid-R64-Kiki_Bertens-Victoria_Jimenez_Kasintseva,2,F-DTM,17,2,0,0,2,7,10
20210429-W-Madrid-R64-Kiki_Bertens-Victoria_Jimenez_Kasintseva,2,F-DTL,5,2,0,0,2,0,5
20210429-W-Madrid-R64-Kiki_Bertens-Victoria_Jimenez_Kasintseva,2,F-IO,13,7,2,1,4,5,8
20210429-W-Madrid-R64-Kiki_Bertens-Victoria_Jimenez_Kasintseva,2,B-XC,27,7,0,1,5,11,16
20210429-W-Madrid-R64-Kiki_Bertens-Victoria_Jimenez_Kasintseva,2,B-DTM,25,1,0,0,1,12,13
20210429-W-Madrid-R64-Kiki_Bertens-Victoria_Jimenez_Kasintseva,2,B-DTL,6,3,2,1,0,5,1
20210429-W-Madrid-R64-Kiki_Bertens-Victoria_Jimenez_Kasintseva,2,B-IO,4,0,0,0,0,2,2
20210429-W-Madrid-R64-Kiki_Bertens-Victoria_Jimenez_Kasintseva,2,S-XC,1,0,0,0,0,0,1
20210429-W-Madrid-R64-Iga_Swiatek-Alison_Riske,1,F-XC,29,10,7,0,3,21,8
20210429-W-Madrid-R64-Iga_Swiatek-Alison_Riske,1,F-DTM,12,0,0,0,0,8,4
20210429-W-Madrid-R64-Iga_Swiatek-Alison_Riske,1,F-DTL,7,4,1,1,2,4,3
20210429-W-Madrid-R64-Iga_Swiatek-Alison_Riske,1,F-IO,7,4,3,0,1,5,2
20210429-W-Madrid-R64-Iga_Swiatek-Alison_Riske,1,B-XC,36,11,3,2,6,26,10
20210429-W-Madrid-R64-Iga_Swiatek-Alison_Riske,1,B-DTM,7,1,1,0,0,6,1
20210429-W-Madrid-R64-Iga_Swiatek-Alison_Riske,1,B-DTL,4,2,2,0,0,4,0
20210429-W-Madrid-R64-Iga_Swiatek-Alison_Riske,1,B-IO,6,3,2,0,1,2,4
20210429-W-Madrid-R64-Iga_Swiatek-Alison_Riske,2,F-XC,11,1,0,0,1,5,6
20210429-W-Madrid-R64-Iga_Swiatek-Alison_Riske,2,F-DTM,26,6,0,0,6,10,16
20210429-W-Madrid-R64-Iga_Swiatek-Alison_Riske,2,F-DTL,10,4,2,0,2,5,5
20210429-W-Madrid-R64-Iga_Swiatek-Alison_Riske,2,F-IO,5,1,1,0,0,2,3
20210429-W-Madrid-R64-Iga_Swiatek-Alison_Riske,2,B-XC,20,2,0,0,2,4,16
20210429-W-Madrid-R64-Iga_Swiatek-Alison_Riske,2,B-DTM,18,1,0,0,1,4,14
20210429-W-Madrid-R64-Iga_Swiatek-Alison_Riske,2,B-DTL,9,2,0,0,2,2,7
20210429-W-Madrid-R64-Iga_Swiatek-Alison_Riske,2,B-IO,5,3,1,0,2,1,4
20210429-W-Madrid-R64-Iga_Swiatek-Alison_Riske,2,S-XC,1,0,0,0,0,0,1
20210429-W-Madrid-R64-Iga_Swiatek-Alison_Riske,2,S-DTM,1,0,0,0,0,0,1
20210430-W-Madrid-R64-Misaki_Doi-Naomi_Osaka,1,F-XC,40,10,2,0,8,22,18
20210430-W-Madrid-R64-Misaki_Doi-Naomi_Osaka,1,F-DTM,16,0,0,0,0,9,7
20210430-W-Madrid-R64-Misaki_Doi-Naomi_Osaka,1,F-DTL,11,8,5,1,2,7,4
20210430-W-Madrid-R64-Misaki_Doi-Naomi_Osaka,1,F-IO,18,6,2,2,2,9,9
20210430-W-Madrid-R64-Misaki_Doi-Naomi_Osaka,1,B-XC,19,5,0,1,4,6,13
20210430-W-Madrid-R64-Misaki_Doi-Naomi_Osaka,1,B-DTM,12,0,0,0,0,4,8
20210430-W-Madrid-R64-Misaki_Doi-Naomi_Osaka,1,B-DTL,6,2,0,0,2,1,5
20210430-W-Madrid-R64-Misaki_Doi-Naomi_Osaka,1,B-IO,2,1,1,0,0,2,0
20210430-W-Madrid-R64-Misaki_Doi-Naomi_Osaka,1,S-XC,10,2,0,0,2,0,10
20210430-W-Madrid-R64-Misaki_Doi-Naomi_Osaka,1,S-DTM,6,1,0,0,1,2,4
20210430-W-Madrid-R64-Misaki_Doi-Naomi_Osaka,1,S-DTL,1,0,0,0,0,0,1
20210430-W-Madrid-R64-Misaki_Doi-Naomi_Osaka,2,F-XC,38,14,4,4,6,25,13
20210430-W-Madrid-R64-Misaki_Doi-Naomi_Osaka,2,F-DTM,16,2,0,0,2,4,12
20210430-W-Madrid-R64-Misaki_Doi-Naomi_Osaka,2,F-DTL,5,2,2,0,0,4,1
20210430-W-Madrid-R64-Misaki_Doi-Naomi_Osaka,2,F-IO,12,5,4,1,0,11,1
20210430-W-Madrid-R64-Misaki_Doi-Naomi_Osaka,2,F-II,2,0,0,0,0,2,0
20210430-W-Madrid-R64-Misaki_Doi-Naomi_Osaka,2,B-XC,26,11,2,4,5,11,15
20210430-W-Madrid-R64-Misaki_Doi-Naomi_Osaka,2,B-DTM,17,2,0,1,1,8,9
20210430-W-Madrid-R64-Misaki_Doi-Naomi_Osaka,2,B-DTL,8,2,1,0,1,5,3
20210430-W-Madrid-R64-Misaki_Doi-Naomi_Osaka,2,B-IO,9,6,1,0,5,4,5
20210430-W-Madrid-R64-Misaki_Doi-Naomi_Osaka,2,S-XC,2,0,0,0,0,0,2
20210430-W-Madrid-R64-Misaki_Doi-Naomi_Osaka,2,S-DTM,1,0,0,0,0,0,1
20210430-W-Madrid-R64-Karolina_Pliskova-Cori_Gauff,1,F-XC,38,14,5,2,7,19,19
20210430-W-Madrid-R64-Karolina_Pliskova-Cori_Gauff,1,F-DTM,19,4,0,0,4,8,11
20210430-W-Madrid-R64-Karolina_Pliskova-Cori_Gauff,1,F-DTL,6,4,1,1,2,4,2
20210430-W-Madrid-R64-Karolina_Pliskova-Cori_Gauff,1,F-IO,22,9,6,0,3,11,11
20210430-W-Madrid-R64-Karolina_Pliskova-Cori_Gauff,1,F-II,4,1,0,0,1,2,2
20210430-W-Madrid-R64-Karolina_Pliskova-Cori_Gauff,1,B-XC,30,4,0,0,4,12,18
20210430-W-Madrid-R64-Karolina_Pliskova-Cori_Gauff,1,B-DTM,25,1,0,0,1,11,14
20210430-W-Madrid-R64-Karolina_Pliskova-Cori_Gauff,1,B-DTL,11,8,5,1,2,7,4
20210430-W-Madrid-R64-Karolina_Pliskova-Cori_Gauff,1,B-IO,8,2,2,0,0,5,3
20210430-W-Madrid-R64-Karolina_Pliskova-Cori_Gauff,1,S-XC,9,2,1,0,1,4,5
20210430-W-Madrid-R64-Karolina_Pliskova-Cori_Gauff,1,S-DTM,3,0,0,0,0,0,3
20210430-W-Madrid-R64-Karolina_Pliskova-Cori_Gauff,1,S-DTL,1,0,0,0,0,0,1
20210430-W-Madrid-R64-Karolina_Pliskova-Cori_Gauff,2,F-XC,19,9,1,4,4,10,9
20210430-W-Madrid-R64-Karolina_Pliskova-Cori_Gauff,2,F-DTM,22,3,0,1,2,11,11
20210430-W-Madrid-R64-Karolina_Pliskova-Cori_Gauff,2,F-DTL,13,6,2,0,4,7,6
20210430-W-Madrid-R64-Karolina_Pliskova-Cori_Gauff,2,F-IO,16,7,0,2,5,8,8
20210430-W-Madrid-R64-Karolina_Pliskova-Cori_Gauff,2,F-II,1,1,0,1,0,1,0
20210430-W-Madrid-R64-Karolina_Pliskova-Cori_Gauff,2,B-XC,31,4,0,0,4,18,13
20210430-W-Madrid-R64-Karolina_Pliskova-Cori_Gauff,2,B-DTM,23,4,0,0,4,12,11
20210430-W-Madrid-R64-Karolina_Pliskova-Cori_Gauff,2,B-DTL,9,3,1,0,2,4,5
20210430-W-Madrid-R64-Karolina_Pliskova-Cori_Gauff,2,B-IO,2,1,1,0,0,2,0
20210430-W-Madrid-R64-Karolina_Pliskova-Cori_Gauff,2,S-XC,4,0,0,0,0,2,2
20210430-W-Madrid-R64-Karolina_Pliskova-Cori_Gauff,2,S-DTM,3,1,0,0,1,2,1
20210430-W-Madrid-R64-Karolina_Pliskova-Cori_Gauff,2,S-DTL,1,0,0,0,0,1,0
20210503-W-Madrid-R16-Iga_Swiatek-Ashleigh_Barty,1,F-XC,58,10,0,4,6,35,23
20210503-W-Madrid-R16-Iga_Swiatek-Ashleigh_Barty,1,F-DTM,10,3,0,0,3,3,7
20210503-W-Madrid-R16-Iga_Swiatek-Ashleigh_Barty,1,F-DTL,13,5,2,0,3,8,5
20210503-W-Madrid-R16-Iga_Swiatek-Ashleigh_Barty,1,F-IO,9,3,2,0,1,7,2
20210503-W-Madrid-R16-Iga_Swiatek-Ashleigh_Barty,1,F-II,3,1,0,0,1,1,2
20210503-W-Madrid-R16-Iga_Swiatek-Ashleigh_Barty,1,B-XC,27,6,2,0,4,11,16
20210503-W-Madrid-R16-Iga_Swiatek-Ashleigh_Barty,1,B-DTM,16,2,0,0,2,7,9
20210503-W-Madrid-R16-Iga_Swiatek-Ashleigh_Barty,1,B-DTL,15,6,2,2,2,10,5
20210503-W-Madrid-R16-Iga_Swiatek-Ashleigh_Barty,1,B-IO,7,2,1,0,1,5,2
20210503-W-Madrid-R16-Iga_Swiatek-Ashleigh_Barty,1,S-XC,3,1,0,0,1,1,2
20210503-W-Madrid-R16-Iga_Swiatek-Ashleigh_Barty,1,S-DTM,1,0,0,0,0,1,0
20210503-W-Madrid-R16-Iga_Swiatek-Ashleigh_Barty,2,F-XC,63,20,6,5,9,31,32
20210503-W-Madrid-R16-Iga_Swiatek-Ashleigh_Barty,2,F-DTM,23,3,1,2,0,13,10
20210503-W-Madrid-R16-Iga_Swiatek-Ashleigh_Barty,2,F-DTL,10,2,1,0,1,2,8
20210503-W-Madrid-R16-Iga_Swiatek-Ashleigh_Barty,2,F-IO,14,5,1,2,2,7,7
20210503-W-Madrid-R16-Iga_Swiatek-Ashleigh_Barty,2,B-XC,2,0,0,0,0,2,0
20210503-W-Madrid-R16-Iga_Swiatek-Ashleigh_Barty,2,B-DTM,7,0,0,0,0,3,4
20210503-W-Madrid-R16-Iga_Swiatek-Ashleigh_Barty,2,B-DTL,1,0,0,0,0,0,1
20210503-W-Madrid-R16-Iga_Swiatek-Ashleigh_Barty,2,B-IO,1,0,0,0,0,0,1
20210503-W-Madrid-R16-Iga_Swiatek-Ashleigh_Barty,2,S-XC,20,2,1,0,1,11,9
20210503-W-Madrid-R16-Iga_Swiatek-Ashleigh_Barty,2,S-DTM,12,2,0,0,2,5,7
20210503-W-Madrid-R16-Iga_Swiatek-Ashleigh_Barty,2,S-DTL,6,2,0,0,2,0,6
20210503-W-Madrid-R16-Iga_Swiatek-Ashleigh_Barty,2,S-IO,1,0,0,0,0,1,0
20210502-W-Madrid-R32-Naomi_Osaka-Karolina_Muchova,1,F-XC,46,16,6,2,8,21,25
20210502-W-Madrid-R32-Naomi_Osaka-Karolina_Muchova,1,F-DTM,22,1,0,0,1,4,18
20210502-W-Madrid-R32-Naomi_Osaka-Karolina_Muchova,1,F-DTL,9,3,0,1,2,2,7
20210502-W-Madrid-R32-Naomi_Osaka-Karolina_Muchova,1,F-IO,14,3,3,0,0,9,5
20210502-W-Madrid-R32-Naomi_Osaka-Karolina_Muchova,1,F-II,2,1,1,0,0,2,0
20210502-W-Madrid-R32-Naomi_Osaka-Karolina_Muchova,1,B-XC,38,10,4,2,4,17,21
20210502-W-Madrid-R32-Naomi_Osaka-Karolina_Muchova,1,B-DTM,11,2,0,2,0,6,5
20210502-W-Madrid-R32-Naomi_Osaka-Karolina_Muchova,1,B-DTL,8,3,0,1,2,4,4
20210502-W-Madrid-R32-Naomi_Osaka-Karolina_Muchova,1,B-IO,9,2,0,0,2,2,7
20210502-W-Madrid-R32-Naomi_Osaka-Karolina_Muchova,1,S-DTM,3,0,0,0,0,1,2
20210502-W-Madrid-R32-Naomi_Osaka-Karolina_Muchova,1,S-DTL,2,0,0,0,0,2,0
20210502-W-Madrid-R32-Naomi_Osaka-Karolina_Muchova,2,F-XC,41,9,2,3,4,31,10
20210502-W-Madrid-R32-Naomi_Osaka-Karolina_Muchova,2,F-DTM,13,2,0,0,2,4,9
20210502-W-Madrid-R32-Naomi_Osaka-Karolina_Muchova,2,F-DTL,10,6,2,2,2,6,4
20210502-W-Madrid-R32-Naomi_Osaka-Karolina_Muchova,2,F-IO,19,9,3,2,4,13,6
20210502-W-Madrid-R32-Naomi_Osaka-Karolina_Muchova,2,F-II,2,1,1,0,0,2,0
20210502-W-Madrid-R32-Naomi_Osaka-Karolina_Muchova,2,B-XC,22,7,3,1,3,13,9
20210502-W-Madrid-R32-Naomi_Osaka-Karolina_Muchova,2,B-DTM,16,1,0,0,1,8,8
20210502-W-Madrid-R32-Naomi_Osaka-Karolina_Muchova,2,B-DTL,8,4,2,1,1,6,2
20210502-W-Madrid-R32-Naomi_Osaka-Karolina_Muchova,2,B-IO,3,2,2,0,0,3,0
20210502-W-Madrid-R32-Naomi_Osaka-Karolina_Muchova,2,S-XC,7,0,0,0,0,4,3
20210502-W-Madrid-R32-Naomi_Osaka-Karolina_Muchova,2,S-DTM,14,0,0,0,0,6,8
20210502-W-Madrid-R32-Naomi_Osaka-Karolina_Muchova,2,S-DTL,2,1,1,0,0,1,1
20210502-W-Madrid-R32-Naomi_Osaka-Karolina_Muchova,2,S-II,2,0,0,0,0,0,2
20210504-W-Madrid-R16-Elise_Mertens-Simona_Halep,1,F-XC,43,5,2,0,3,23,20
20210504-W-Madrid-R16-Elise_Mertens-Simona_Halep,1,F-DTM,41,0,0,0,0,17,24
20210504-W-Madrid-R16-Elise_Mertens-Simona_Halep,1,F-DTL,27,10,4,3,3,15,12
20210504-W-Madrid-R16-Elise_Mertens-Simona_Halep,1,F-IO,23,4,2,1,1,12,11
20210504-W-Madrid-R16-Elise_Mertens-Simona_Halep,1,B-XC,51,7,1,2,4,27,24
20210504-W-Madrid-R16-Elise_Mertens-Simona_Halep,1,B-DTM,58,6,2,0,4,29,29
20210504-W-Madrid-R16-Elise_Mertens-Simona_Halep,1,B-DTL,19,10,3,2,5,10,9
20210504-W-Madrid-R16-Elise_Mertens-Simona_Halep,1,B-IO,14,5,1,2,2,7,7
20210504-W-Madrid-R16-Elise_Mertens-Simona_Halep,1,S-XC,8,0,0,0,0,3,5
20210504-W-Madrid-R16-Elise_Mertens-Simona_Halep,1,S-DTM,8,0,0,0,0,1,7
20210504-W-Madrid-R16-Elise_Mertens-Simona_Halep,2,F-XC,89,31,14,7,10,59,30
20210504-W-Madrid-R16-Elise_Mertens-Simona_Halep,2,F-DTM,42,4,0,0,4,14,28
20210504-W-Madrid-R16-Elise_Mertens-Simona_Halep,2,F-DTL,12,3,0,0,3,5,7
20210504-W-Madrid-R16-Elise_Mertens-Simona_Halep,2,F-IO,49,12,3,1,8,26,23
20210504-W-Madrid-R16-Elise_Mertens-Simona_Halep,2,F-II,9,4,3,1,0,6,3
20210504-W-Madrid-R16-Elise_Mertens-Simona_Halep,2,B-XC,83,21,10,0,11,41,42
20210504-W-Madrid-R16-Elise_Mertens-Simona_Halep,2,B-DTM,36,3,0,1,2,19,17
20210504-W-Madrid-R16-Elise_Mertens-Simona_Halep,2,B-DTL,18,7,2,2,3,10,8
20210504-W-Madrid-R16-Elise_Mertens-Simona_Halep,2,B-IO,14,5,1,1,3,8,6
20210504-W-Madrid-R16-Elise_Mertens-Simona_Halep,2,S-XC,1,0,0,0,0,1,0
20210504-W-Madrid-R16-Elise_Mertens-Simona_Halep,2,S-DTM,4,0,0,0,0,2,2
20210504-W-Madrid-R16-Elise_Mertens-Simona_Halep,2,S-DTL,4,0,0,0,0,3,1
20210504-W-Madrid-R16-Elise_Mertens-Simona_Halep,2,S-IO,1,0,0,0,0,0,1
20210504-W-Madrid-R16-Maria_Sakkari-Karolina_Muchova,1,F-XC,43,21,7,5,9,19,24
20210504-W-Madrid-R16-Maria_Sakkari-Karolina_Muchova,1,F-DTM,37,7,0,1,5,11,26
20210504-W-Madrid-R16-Maria_Sakkari-Karolina_Muchova,1,F-DTL,9,5,1,1,3,3,6
20210504-W-Madrid-R16-Maria_Sakkari-Karolina_Muchova,1,F-IO,43,11,2,4,5,19,24
20210504-W-Madrid-R16-Maria_Sakkari-Karolina_Muchova,1,F-II,3,0,0,0,0,2,1
20210504-W-Madrid-R16-Maria_Sakkari-Karolina_Muchova,1,B-XC,89,17,3,4,10,43,46
20210504-W-Madrid-R16-Maria_Sakkari-Karolina_Muchova,1,B-DTM,51,7,0,0,7,21,30
20210504-W-Madrid-R16-Maria_Sakkari-Karolina_Muchova,1,B-DTL,9,8,4,0,4,4,5
20210504-W-Madrid-R16-Maria_Sakkari-Karolina_Muchova,1,S-XC,7,0,0,0,0,4,3
20210504-W-Madrid-R16-Maria_Sakkari-Karolina_Muchova,1,S-DTM,5,0,0,0,0,0,5
20210504-W-Madrid-R16-Maria_Sakkari-Karolina_Muchova,1,S-DTL,1,1,0,0,1,0,1
20210504-W-Madrid-R16-Maria_Sakkari-Karolina_Muchova,2,F-XC,29,9,2,4,3,22,7
20210504-W-Madrid-R16-Maria_Sakkari-Karolina_Muchova,2,F-DTM,29,2,0,0,2,16,13
20210504-W-Madrid-R16-Maria_Sakkari-Karolina_Muchova,2,F-DTL,7,4,1,1,2,4,3
20210504-W-Madrid-R16-Maria_Sakkari-Karolina_Muchova,2,F-IO,37,7,1,1,5,19,18
20210504-W-Madrid-R16-Maria_Sakkari-Karolina_Muchova,2,F-II,2,2,0,1,1,1,1
20210504-W-Madrid-R16-Maria_Sakkari-Karolina_Muchova,2,B-XC,60,8,2,1,5,27,33
20210504-W-Madrid-R16-Maria_Sakkari-Karolina_Muchova,2,B-DTM,53,7,0,1,6,26,27
20210504-W-Madrid-R16-Maria_Sakkari-Karolina_Muchova,2,B-DTL,11,9,3,0,6,5,6
20210504-W-Madrid-R16-Maria_Sakkari-Karolina_Muchova,2,B-IO,3,1,0,1,0,2,1
20210504-W-Madrid-R16-Maria_Sakkari-Karolina_Muchova,2,S-XC,28,2,0,0,2,16,12
20210504-W-Madrid-R16-Maria_Sakkari-Karolina_Muchova,2,S-DTM,19,0,0,0,0,15,4
20210504-W-Madrid-R16-Maria_Sakkari-Karolina_Muchova,2,S-DTL,4,0,0,0,0,3,1
20210505-W-Madrid-QF-Ashleigh_Barty-Petra_Kvitova,1,F-XC,34,8,2,2,4,16,18
20210505-W-Madrid-QF-Ashleigh_Barty-Petra_Kvitova,1,F-DTM,14,1,0,0,1,10,4
20210505-W-Madrid-QF-Ashleigh_Barty-Petra_Kvitova,1,F-DTL,3,0,0,0,0,2,1
20210505-W-Madrid-QF-Ashleigh_Barty-Petra_Kvitova,1,F-IO,9,5,1,3,1,5,4
20210505-W-Madrid-QF-Ashleigh_Barty-Petra_Kvitova,1,B-XC,8,0,0,0,0,2,6
20210505-W-Madrid-QF-Ashleigh_Barty-Petra_Kvitova,1,B-DTM,16,1,0,0,1,9,7
20210505-W-Madrid-QF-Ashleigh_Barty-Petra_Kvitova,1,B-DTL,3,1,0,0,1,0,3
20210505-W-Madrid-QF-Ashleigh_Barty-Petra_Kvitova,1,S-XC,18,3,0,1,2,10,8
20210505-W-Madrid-QF-Ashleigh_Barty-Petra_Kvitova,1,S-DTM,21,2,0,1,1,10,11
20210505-W-Madrid-QF-Ashleigh_Barty-Petra_Kvitova,1,S-DTL,1,0,0,0,0,0,1
20210505-W-Madrid-QF-Ashleigh_Barty-Petra_Kvitova,1,S-IO,1,1,0,0,1,0,1
20210505-W-Madrid-QF-Ashleigh_Barty-Petra_Kvitova,2,F-XC,53,14,2,2,10,26,27
20210505-W-Madrid-QF-Ashleigh_Barty-Petra_Kvitova,2,F-DTM,9,3,0,1,2,4,5
20210505-W-Madrid-QF-Ashleigh_Barty-Petra_Kvitova,2,F-DTL,6,5,1,1,3,3,3
20210505-W-Madrid-QF-Ashleigh_Barty-Petra_Kvitova,2,F-IO,12,7,1,1,5,6,6
20210505-W-Madrid-QF-Ashleigh_Barty-Petra_Kvitova,2,B-XC,27,9,3,2,4,14,13
20210505-W-Madrid-QF-Ashleigh_Barty-Petra_Kvitova,2,B-DTM,11,4,1,1,2,7,4
20210505-W-Madrid-QF-Ashleigh_Barty-Petra_Kvitova,2,B-DTL,4,0,0,0,0,3,1
20210505-W-Madrid-QF-Ashleigh_Barty-Petra_Kvitova,2,B-IO,11,3,1,0,2,1,10
20210505-W-Madrid-QF-Ashleigh_Barty-Petra_Kvitova,2,S-XC,2,0,0,0,0,0,2
20210505-W-Madrid-QF-Ashleigh_Barty-Petra_Kvitova,2,S-DTM,1,0,0,0,0,0,1
20210430-W-Madrid-R64-Sara_Sorribes_Tormo-Simona_Halep,1,F-XC,29,3,0,1,2,13,16
20210430-W-Madrid-R64-Sara_Sorribes_Tormo-Simona_Halep,1,F-DTM,59,5,0,0,5,23,36
20210430-W-Madrid-R64-Sara_Sorribes_Tormo-Simona_Halep,1,F-DTL,12,2,0,1,1,3,9
20210430-W-Madrid-R64-Sara_Sorribes_Tormo-Simona_Halep,1,F-IO,19,3,2,0,1,8,11
20210430-W-Madrid-R64-Sara_Sorribes_Tormo-Simona_Halep,1,F-II,2,2,1,1,0,2,0
20210430-W-Madrid-R64-Sara_Sorribes_Tormo-Simona_Halep,1,B-XC,27,2,0,0,2,9,18
20210430-W-Madrid-R64-Sara_Sorribes_Tormo-Simona_Halep,1,B-DTM,59,5,0,1,4,24,35
20210430-W-Madrid-R64-Sara_Sorribes_Tormo-Simona_Halep,1,B-DTL,4,1,1,0,0,3,1
20210430-W-Madrid-R64-Sara_Sorribes_Tormo-Simona_Halep,1,B-IO,3,0,0,0,0,0,3
20210430-W-Madrid-R64-Sara_Sorribes_Tormo-Simona_Halep,1,S-XC,21,5,0,0,5,4,17
20210430-W-Madrid-R64-Sara_Sorribes_Tormo-Simona_Halep,1,S-DTM,18,0,0,0,0,5,13
20210430-W-Madrid-R64-Sara_Sorribes_Tormo-Simona_Halep,1,S-DTL,4,0,0,0,0,3,1
20210430-W-Madrid-R64-Sara_Sorribes_Tormo-Simona_Halep,1,S-IO,1,0,0,0,0,0,1
20210430-W-Madrid-R64-Sara_Sorribes_Tormo-Simona_Halep,2,F-XC,64,14,4,3,7,36,28
20210430-W-Madrid-R64-Sara_Sorribes_Tormo-Simona_Halep,2,F-DTM,23,0,0,0,0,18,5
20210430-W-Madrid-R64-Sara_Sorribes_Tormo-Simona_Halep,2,F-DTL,15,2,1,0,1,9,6
20210430-W-Madrid-R64-Sara_Sorribes_Tormo-Simona_Halep,2,F-IO,47,9,4,2,3,28,19
20210430-W-Madrid-R64-Sara_Sorribes_Tormo-Simona_Halep,2,F-II,8,3,0,2,1,7,1
20210430-W-Madrid-R64-Sara_Sorribes_Tormo-Simona_Halep,2,B-XC,49,4,2,0,2,32,17
20210430-W-Madrid-R64-Sara_Sorribes_Tormo-Simona_Halep,2,B-DTM,31,3,1,0,2,16,15
20210430-W-Madrid-R64-Sara_Sorribes_Tormo-Simona_Halep,2,B-DTL,5,3,1,0,2,3,2
20210430-W-Madrid-R64-Sara_Sorribes_Tormo-Simona_Halep,2,B-IO,8,3,1,1,1,4,4
20210430-W-Madrid-R64-Sara_Sorribes_Tormo-Simona_Halep,2,S-XC,2,0,0,0,0,1,1
20210430-W-Madrid-R64-Sara_Sorribes_Tormo-Simona_Halep,2,S-DTM,2,0,0,0,0,0,2
20210430-W-Madrid-R64-Sara_Sorribes_Tormo-Simona_Halep,2,S-DTL,1,0,0,0,0,1,0
20210501-W-Madrid-R32-Veronika_Kudermetova-Kiki_Bertens,1,F-XC,24,10,3,4,3,15,9
20210501-W-Madrid-R32-Veronika_Kudermetova-Kiki_Bertens,1,F-DTM,24,2,0,0,2,14,10
20210501-W-Madrid-R32-Veronika_Kudermetova-Kiki_Bertens,1,F-DTL,11,6,3,0,3,6,5
20210501-W-Madrid-R32-Veronika_Kudermetova-Kiki_Bertens,1,F-IO,16,6,2,3,1,9,7
20210501-W-Madrid-R32-Veronika_Kudermetova-Kiki_Bertens,1,B-XC,13,2,0,1,1,7,6
20210501-W-Madrid-R32-Veronika_Kudermetova-Kiki_Bertens,1,B-DTM,11,0,0,0,0,7,4
20210501-W-Madrid-R32-Veronika_Kudermetova-Kiki_Bertens,1,B-DTL,4,4,3,0,1,3,1
20210501-W-Madrid-R32-Veronika_Kudermetova-Kiki_Bertens,1,B-IO,4,2,1,0,1,3,1
20210501-W-Madrid-R32-Veronika_Kudermetova-Kiki_Bertens,1,S-XC,6,0,0,0,0,3,3
20210501-W-Madrid-R32-Veronika_Kudermetova-Kiki_Bertens,1,S-DTM,3,1,0,1,0,1,2
20210501-W-Madrid-R32-Veronika_Kudermetova-Kiki_Bertens,2,F-XC,31,4,0,1,3,12,19
20210501-W-Madrid-R32-Veronika_Kudermetova-Kiki_Bertens,2,F-DTM,10,2,0,0,2,3,7
20210501-W-Madrid-R32-Veronika_Kudermetova-Kiki_Bertens,2,F-DTL,4,3,1,1,1,3,1
20210501-W-Madrid-R32-Veronika_Kudermetova-Kiki_Bertens,2,F-IO,10,6,2,1,3,5,5
20210501-W-Madrid-R32-Veronika_Kudermetova-Kiki_Bertens,2,F-II,1,1,1,0,0,1,0
20210501-W-Madrid-R32-Veronika_Kudermetova-Kiki_Bertens,2,B-XC,8,0,0,0,0,6,2
20210501-W-Madrid-R32-Veronika_Kudermetova-Kiki_Bertens,2,B-DTM,18,1,0,0,1,5,13
20210501-W-Madrid-R32-Veronika_Kudermetova-Kiki_Bertens,2,B-DTL,4,2,1,0,1,1,3
20210501-W-Madrid-R32-Veronika_Kudermetova-Kiki_Bertens,2,B-IO,1,1,1,0,0,1,0
20210501-W-Madrid-R32-Veronika_Kudermetova-Kiki_Bertens,2,S-XC,5,2,0,0,2,0,5
20210501-W-Madrid-R32-Veronika_Kudermetova-Kiki_Bertens,2,S-DTM,12,1,0,0,1,6,6
20210501-W-Madrid-R32-Veronika_Kudermetova-Kiki_Bertens,2,S-DTL,2,0,0,0,0,0,2
20210429-W-Madrid-R64-Elina_Svitolina-Jil_Teichmann,1,F-XC,72,14,4,1,9,44,28
20210429-W-Madrid-R64-Elina_Svitolina-Jil_Teichmann,1,F-DTM,48,2,0,0,2,22,26
20210429-W-Madrid-R64-Elina_Svitolina-Jil_Teichmann,1,F-DTL,7,4,0,1,3,2,5
20210429-W-Madrid-R64-Elina_Svitolina-Jil_Teichmann,1,F-IO,31,7,3,1,3,13,18
20210429-W-Madrid-R64-Elina_Svitolina-Jil_Teichmann,1,F-II,1,0,0,0,0,0,1
20210429-W-Madrid-R64-Elina_Svitolina-Jil_Teichmann,1,B-XC,91,15,5,3,7,42,49
20210429-W-Madrid-R64-Elina_Svitolina-Jil_Teichmann,1,B-DTM,38,0,0,0,0,18,20
20210429-W-Madrid-R64-Elina_Svitolina-Jil_Teichmann,1,B-DTL,17,11,6,2,3,10,7
20210429-W-Madrid-R64-Elina_Svitolina-Jil_Teichmann,1,B-IO,5,1,0,0,1,0,5
20210429-W-Madrid-R64-Elina_Svitolina-Jil_Teichmann,1,S-XC,4,0,0,0,0,2,2
20210429-W-Madrid-R64-Elina_Svitolina-Jil_Teichmann,1,S-DTM,3,0,0,0,0,3,0
20210429-W-Madrid-R64-Elina_Svitolina-Jil_Teichmann,1,S-DTL,1,0,0,0,0,0,1
20210429-W-Madrid-R64-Elina_Svitolina-Jil_Teichmann,2,F-XC,115,20,6,5,9,65,50
20210429-W-Madrid-R64-Elina_Svitolina-Jil_Teichmann,2,F-DTM,49,9,2,0,7,22,27
20210429-W-Madrid-R64-Elina_Svitolina-Jil_Teichmann,2,F-DTL,29,17,7,1,9,16,13
20210429-W-Madrid-R64-Elina_Svitolina-Jil_Teichmann,2,F-IO,29,10,4,2,4,18,11
20210429-W-Madrid-R64-Elina_Svitolina-Jil_Teichmann,2,F-II,3,1,0,0,1,1,2
20210429-W-Madrid-R64-Elina_Svitolina-Jil_Teichmann,2,B-XC,45,8,2,1,5,19,26
20210429-W-Madrid-R64-Elina_Svitolina-Jil_Teichmann,2,B-DTM,41,3,0,2,1,23,18
20210429-W-Madrid-R64-Elina_Svitolina-Jil_Teichmann,2,B-DTL,9,6,1,0,5,1,8
20210429-W-Madrid-R64-Elina_Svitolina-Jil_Teichmann,2,B-IO,3,1,0,0,1,1,2
20210429-W-Madrid-R64-Elina_Svitolina-Jil_Teichmann,2,S-XC,6,2,0,0,2,4,2
20210429-W-Madrid-R64-Elina_Svitolina-Jil_Teichmann,2,S-DTM,16,2,0,0,2,5,11
20210429-W-Madrid-R64-Elina_Svitolina-Jil_Teichmann,2,S-DTL,3,1,0,1,0,2,1
20210429-W-Madrid-R64-Elina_Svitolina-Jil_Teichmann,2,S-IO,1,0,0,0,0,1,0
20210503-W-Madrid-R16-Paula_Badosa-Anastasija_Sevastova,1,F-XC,47,15,8,4,3,31,16
20210503-W-Madrid-R16-Paula_Badosa-Anastasija_Sevastova,1,F-DTM,46,7,0,2,5,21,25
20210503-W-Madrid-R16-Paula_Badosa-Anastasija_Sevastova,1,F-DTL,19,5,0,1,4,9,10
20210503-W-Madrid-R16-Paula_Badosa-Anastasija_Sevastova,1,F-IO,39,11,7,3,1,22,17
20210503-W-Madrid-R16-Paula_Badosa-Anastasija_Sevastova,1,F-II,4,1,0,1,0,3,1
20210503-W-Madrid-R16-Paula_Badosa-Anastasija_Sevastova,1,B-XC,78,11,5,0,6,33,45
20210503-W-Madrid-R16-Paula_Badosa-Anastasija_Sevastova,1,B-DTM,64,8,0,1,7,23,41
20210503-W-Madrid-R16-Paula_Badosa-Anastasija_Sevastova,1,B-DTL,25,11,6,1,4,11,14
20210503-W-Madrid-R16-Paula_Badosa-Anastasija_Sevastova,1,B-IO,13,7,2,1,4,5,8
20210503-W-Madrid-R16-Paula_Badosa-Anastasija_Sevastova,1,S-DTM,1,0,0,0,0,0,1
20210503-W-Madrid-R16-Paula_Badosa-Anastasija_Sevastova,1,S-DTL,3,2,1,1,0,2,1
20210503-W-Madrid-R16-Paula_Badosa-Anastasija_Sevastova,1,S-IO,1,0,0,0,0,1,0
20210503-W-Madrid-R16-Paula_Badosa-Anastasija_Sevastova,2,F-XC,63,18,6,5,7,36,27
20210503-W-Madrid-R16-Paula_Badosa-Anastasija_Sevastova,2,F-DTM,30,3,0,0,3,8,22
20210503-W-Madrid-R16-Paula_Badosa-Anastasija_Sevastova,2,F-DTL,12,4,2,2,0,9,3
20210503-W-Madrid-R16-Paula_Badosa-Anastasija_Sevastova,2,F-IO,33,8,2,4,2,24,9
20210503-W-Madrid-R16-Paula_Badosa-Anastasija_Sevastova,2,F-II,3,2,0,0,2,1,2
20210503-W-Madrid-R16-Paula_Badosa-Anastasija_Sevastova,2,B-XC,95,17,0,2,15,51,44
20210503-W-Madrid-R16-Paula_Badosa-Anastasija_Sevastova,2,B-DTM,43,3,0,0,3,26,17
20210503-W-Madrid-R16-Paula_Badosa-Anastasija_Sevastova,2,B-DTL,9,5,3,1,1,5,4
20210503-W-Madrid-R16-Paula_Badosa-Anastasija_Sevastova,2,B-IO,8,2,1,1,0,7,1
20210503-W-Madrid-R16-Paula_Badosa-Anastasija_Sevastova,2,S-XC,13,1,0,0,1,2,11
20210503-W-Madrid-R16-Paula_Badosa-Anastasija_Sevastova,2,S-DTM,3,0,0,0,0,1,2
20210503-W-Madrid-R16-Paula_Badosa-Anastasija_Sevastova,2,S-DTL,2,0,0,0,0,1,1
20210516-W-Rome-F-Iga_Swiatek-Karolina_Pliskova,1,F-XC,12,6,3,3,0,9,3
20210516-W-Rome-F-Iga_Swiatek-Karolina_Pliskova,1,F-DTM,7,1,0,0,1,3,4
20210516-W-Rome-F-Iga_Swiatek-Karolina_Pliskova,1,F-DTL,4,3,1,1,1,3,1
20210516-W-Rome-F-Iga_Swiatek-Karolina_Pliskova,1,F-IO,10,5,4,1,0,9,1
20210516-W-Rome-F-Iga_Swiatek-Karolina_Pliskova,1,F-II,2,1,1,0,0,1,1
20210516-W-Rome-F-Iga_Swiatek-Karolina_Pliskova,1,B-XC,16,2,1,0,1,12,4
20210516-W-Rome-F-Iga_Swiatek-Karolina_Pliskova,1,B-DTM,8,1,1,0,0,6,2
20210516-W-Rome-F-Iga_Swiatek-Karolina_Pliskova,1,B-DTL,4,3,3,0,0,3,1
20210516-W-Rome-F-Iga_Swiatek-Karolina_Pliskova,1,B-IO,2,1,1,0,0,2,0
20210516-W-Rome-F-Iga_Swiatek-Karolina_Pliskova,2,F-XC,12,2,0,1,1,6,6
20210516-W-Rome-F-Iga_Swiatek-Karolina_Pliskova,2,F-DTM,8,2,0,0,2,2,6
20210516-W-Rome-F-Iga_Swiatek-Karolina_Pliskova,2,F-DTL,4,3,2,0,1,3,1
20210516-W-Rome-F-Iga_Swiatek-Karolina_Pliskova,2,F-IO,5,2,0,0,2,1,4
20210516-W-Rome-F-Iga_Swiatek-Karolina_Pliskova,2,B-XC,16,2,0,0,2,5,11
20210516-W-Rome-F-Iga_Swiatek-Karolina_Pliskova,2,B-DTM,9,0,0,0,0,1,8
20210516-W-Rome-F-Iga_Swiatek-Karolina_Pliskova,2,B-DTL,3,2,1,0,1,2,1
20210516-W-Rome-F-Iga_Swiatek-Karolina_Pliskova,2,B-IO,1,0,0,0,0,0,1
20210516-W-Rome-F-Iga_Swiatek-Karolina_Pliskova,2,S-XC,3,1,0,0,1,1,2
20210516-W-Rome-F-Iga_Swiatek-Karolina_Pliskova,2,S-DTM,3,0,0,0,0,0,3
20210522-W-Parma-F-Cori_Gauff-Qiang_Wang,1,F-XC,21,5,2,2,1,17,4
20210522-W-Parma-F-Cori_Gauff-Qiang_Wang,1,F-DTM,30,3,1,0,2,20,10
20210522-W-Parma-F-Cori_Gauff-Qiang_Wang,1,F-DTL,6,2,1,0,1,4,2
20210522-W-Parma-F-Cori_Gauff-Qiang_Wang,1,F-IO,25,3,1,2,0,21,4
20210522-W-Parma-F-Cori_Gauff-Qiang_Wang,1,F-II,2,2,0,1,1,1,1
20210522-W-Parma-F-Cori_Gauff-Qiang_Wang,1,B-XC,53,12,4,5,3,37,16
20210522-W-Parma-F-Cori_Gauff-Qiang_Wang,1,B-DTM,28,5,1,2,2,20,8
20210522-W-Parma-F-Cori_Gauff-Qiang_Wang,1,B-DTL,16,11,6,3,2,13,3
20210522-W-Parma-F-Cori_Gauff-Qiang_Wang,1,B-IO,7,3,2,0,1,6,1
20210522-W-Parma-F-Cori_Gauff-Qiang_Wang,1,S-DTM,4,0,0,0,0,2,2
20210522-W-Parma-F-Cori_Gauff-Qiang_Wang,2,F-XC,17,3,2,1,0,6,11
20210522-W-Parma-F-Cori_Gauff-Qiang_Wang,2,F-DTM,33,3,0,2,1,7,26
20210522-W-Parma-F-Cori_Gauff-Qiang_Wang,2,F-DTL,12,6,0,1,5,2,10
20210522-W-Parma-F-Cori_Gauff-Qiang_Wang,2,F-IO,30,11,5,2,4,16,14
20210522-W-Parma-F-Cori_Gauff-Qiang_Wang,2,B-XC,61,5,1,0,4,17,44
20210522-W-Parma-F-Cori_Gauff-Qiang_Wang,2,B-DTM,18,1,0,0,1,6,12
20210522-W-Parma-F-Cori_Gauff-Qiang_Wang,2,B-DTL,11,2,0,0,2,1,10
20210522-W-Parma-F-Cori_Gauff-Qiang_Wang,2,B-IO,2,1,0,0,1,0,2
20210522-W-Parma-F-Cori_Gauff-Qiang_Wang,2,S-XC,2,0,0,0,0,0,2
20210522-W-Parma-F-Cori_Gauff-Qiang_Wang,2,S-DTM,1,0,0,0,0,1,0
20210516-W-ITF_La_Bisbal-F-Arantxa_Rus-Irina_Khromacheva,1,F-XC,35,17,9,2,6,22,13
20210516-W-ITF_La_Bisbal-F-Arantxa_Rus-Irina_Khromacheva,1,F-DTM,62,4,0,1,3,37,25
20210516-W-ITF_La_Bisbal-F-Arantxa_Rus-Irina_Khromacheva,1,F-DTL,11,2,1,0,1,8,3
20210516-W-ITF_La_Bisbal-F-Arantxa_Rus-Irina_Khromacheva,1,F-IO,64,14,4,3,7,41,23
20210516-W-ITF_La_Bisbal-F-Arantxa_Rus-Irina_Khromacheva,1,F-II,7,4,3,1,0,6,1
20210516-W-ITF_La_Bisbal-F-Arantxa_Rus-Irina_Khromacheva,1,B-XC,49,11,3,2,6,25,24
20210516-W-ITF_La_Bisbal-F-Arantxa_Rus-Irina_Khromacheva,1,B-DTM,45,0,0,0,0,27,18
20210516-W-ITF_La_Bisbal-F-Arantxa_Rus-Irina_Khromacheva,1,B-DTL,15,5,2,2,1,9,6
20210516-W-ITF_La_Bisbal-F-Arantxa_Rus-Irina_Khromacheva,1,B-IO,10,3,0,0,3,5,5
20210516-W-ITF_La_Bisbal-F-Arantxa_Rus-Irina_Khromacheva,1,S-XC,7,3,2,0,1,2,5
20210516-W-ITF_La_Bisbal-F-Arantxa_Rus-Irina_Khromacheva,1,S-DTM,4,0,0,0,0,1,3
20210516-W-ITF_La_Bisbal-F-Arantxa_Rus-Irina_Khromacheva,1,S-DTL,2,1,1,0,0,1,1
20210516-W-ITF_La_Bisbal-F-Arantxa_Rus-Irina_Khromacheva,1,S-IO,1,0,0,0,0,0,1
20210516-W-ITF_La_Bisbal-F-Arantxa_Rus-Irina_Khromacheva,2,F-XC,34,7,0,1,6,15,19
20210516-W-ITF_La_Bisbal-F-Arantxa_Rus-Irina_Khromacheva,2,F-DTM,18,1,0,0,1,7,11
20210516-W-ITF_La_Bisbal-F-Arantxa_Rus-Irina_Khromacheva,2,F-DTL,7,4,2,1,1,5,2
20210516-W-ITF_La_Bisbal-F-Arantxa_Rus-Irina_Khromacheva,2,F-IO,14,3,2,0,1,8,6
20210516-W-ITF_La_Bisbal-F-Arantxa_Rus-Irina_Khromacheva,2,B-XC,65,17,5,1,11,27,38
20210516-W-ITF_La_Bisbal-F-Arantxa_Rus-Irina_Khromacheva,2,B-DTM,36,0,0,0,0,13,23
20210516-W-ITF_La_Bisbal-F-Arantxa_Rus-Irina_Khromacheva,2,B-DTL,19,10,7,2,1,12,7
20210516-W-ITF_La_Bisbal-F-Arantxa_Rus-Irina_Khromacheva,2,B-IO,19,13,5,3,5,9,10
20210516-W-ITF_La_Bisbal-F-Arantxa_Rus-Irina_Khromacheva,2,S-XC,18,0,0,0,0,7,11
20210516-W-ITF_La_Bisbal-F-Arantxa_Rus-Irina_Khromacheva,2,S-DTM,11,0,0,0,0,5,6
20210516-W-ITF_La_Bisbal-F-Arantxa_Rus-Irina_Khromacheva,2,S-IO,1,1,0,0,1,0,1
20210510-W-Rome-R64-Camila_Giorgi-Sara_Sorribes_Tormo,1,F-XC,159,36,8,7,21,82,77
20210510-W-Rome-R64-Camila_Giorgi-Sara_Sorribes_Tormo,1,F-DTM,75,10,0,2,8,33,42
20210510-W-Rome-R64-Camila_Giorgi-Sara_Sorribes_Tormo,1,F-DTL,9,7,3,1,2,6,3
20210510-W-Rome-R64-Camila_Giorgi-Sara_Sorribes_Tormo,1,F-IO,89,26,9,3,14,45,44
20210510-W-Rome-R64-Camila_Giorgi-Sara_Sorribes_Tormo,1,F-II,3,1,1,0,0,3,0
20210510-W-Rome-R64-Camila_Giorgi-Sara_Sorribes_Tormo,1,B-XC,108,19,4,2,13,50,58
20210510-W-Rome-R64-Camila_Giorgi-Sara_Sorribes_Tormo,1,B-DTM,57,2,0,0,2,30,27
20210510-W-Rome-R64-Camila_Giorgi-Sara_Sorribes_Tormo,1,B-DTL,17,7,3,1,3,11,6
20210510-W-Rome-R64-Camila_Giorgi-Sara_Sorribes_Tormo,1,B-IO,21,7,4,2,1,12,9
20210510-W-Rome-R64-Camila_Giorgi-Sara_Sorribes_Tormo,1,S-XC,1,0,0,0,0,0,1
20210510-W-Rome-R64-Camila_Giorgi-Sara_Sorribes_Tormo,1,S-DTM,1,0,0,0,0,1,0
20210510-W-Rome-R64-Camila_Giorgi-Sara_Sorribes_Tormo,1,S-DTL,1,0,0,0,0,1,0
20210510-W-Rome-R64-Camila_Giorgi-Sara_Sorribes_Tormo,2,F-XC,45,3,1,2,0,23,22
20210510-W-Rome-R64-Camila_Giorgi-Sara_Sorribes_Tormo,2,F-DTM,156,7,0,2,5,69,87
20210510-W-Rome-R64-Camila_Giorgi-Sara_Sorribes_Tormo,2,F-DTL,22,5,2,0,3,11,11
20210510-W-Rome-R64-Camila_Giorgi-Sara_Sorribes_Tormo,2,F-IO,49,6,4,0,2,28,21
20210510-W-Rome-R64-Camila_Giorgi-Sara_Sorribes_Tormo,2,F-II,2,1,1,0,0,2,0
20210510-W-Rome-R64-Camila_Giorgi-Sara_Sorribes_Tormo,2,B-XC,25,5,0,2,3,12,13
20210510-W-Rome-R64-Camila_Giorgi-Sara_Sorribes_Tormo,2,B-DTM,70,7,0,2,5,36,34
20210510-W-Rome-R64-Camila_Giorgi-Sara_Sorribes_Tormo,2,B-DTL,12,8,6,1,1,10,2
20210510-W-Rome-R64-Camila_Giorgi-Sara_Sorribes_Tormo,2,B-IO,15,4,2,1,1,11,4
20210510-W-Rome-R64-Camila_Giorgi-Sara_Sorribes_Tormo,2,S-XC,38,1,0,1,0,19,19
20210510-W-Rome-R64-Camila_Giorgi-Sara_Sorribes_Tormo,2,S-DTM,62,1,0,0,1,22,40
20210510-W-Rome-R64-Camila_Giorgi-Sara_Sorribes_Tormo,2,S-DTL,3,0,0,0,0,3,0
20210510-W-Rome-R64-Camila_Giorgi-Sara_Sorribes_Tormo,2,S-IO,4,0,0,0,0,3,1
20210524-W-Strasbourg-R32-Andrea_Lazaro_Garcia-Bianca_Andreescu,1,F-XC,32,6,2,0,4,17,15
20210524-W-Strasbourg-R32-Andrea_Lazaro_Garcia-Bianca_Andreescu,1,F-DTM,25,4,0,0,4,10,15
20210524-W-Strasbourg-R32-Andrea_Lazaro_Garcia-Bianca_Andreescu,1,F-DTL,4,1,0,0,1,3,1
20210524-W-Strasbourg-R32-Andrea_Lazaro_Garcia-Bianca_Andreescu,1,F-IO,11,4,2,0,2,4,7
20210524-W-Strasbourg-R32-Andrea_Lazaro_Garcia-Bianca_Andreescu,1,F-II,1,0,0,0,0,0,1
20210524-W-Strasbourg-R32-Andrea_Lazaro_Garcia-Bianca_Andreescu,1,B-XC,10,2,0,0,2,2,8
20210524-W-Strasbourg-R32-Andrea_Lazaro_Garcia-Bianca_Andreescu,1,B-DTM,10,0,0,0,0,5,5
20210524-W-Strasbourg-R32-Andrea_Lazaro_Garcia-Bianca_Andreescu,1,S-XC,3,1,0,0,1,0,3
20210524-W-Strasbourg-R32-Andrea_Lazaro_Garcia-Bianca_Andreescu,1,S-DTM,2,0,0,0,0,0,2
20210524-W-Strasbourg-R32-Andrea_Lazaro_Garcia-Bianca_Andreescu,1,S-DTL,1,0,0,0,0,0,1
20210524-W-Strasbourg-R32-Andrea_Lazaro_Garcia-Bianca_Andreescu,2,F-XC,27,8,3,2,3,13,14
20210524-W-Strasbourg-R32-Andrea_Lazaro_Garcia-Bianca_Andreescu,2,F-DTM,18,2,0,0,2,7,11
20210524-W-Strasbourg-R32-Andrea_Lazaro_Garcia-Bianca_Andreescu,2,F-DTL,8,1,1,0,0,5,3
20210524-W-Strasbourg-R32-Andrea_Lazaro_Garcia-Bianca_Andreescu,2,F-IO,12,5,3,0,2,8,4
20210524-W-Strasbourg-R32-Andrea_Lazaro_Garcia-Bianca_Andreescu,2,F-II,1,0,0,0,0,1,0
20210524-W-Strasbourg-R32-Andrea_Lazaro_Garcia-Bianca_Andreescu,2,B-XC,11,2,1,0,1,10,1
20210524-W-Strasbourg-R32-Andrea_Lazaro_Garcia-Bianca_Andreescu,2,B-DTM,10,1,0,0,1,5,5
20210524-W-Strasbourg-R32-Andrea_Lazaro_Garcia-Bianca_Andreescu,2,B-IO,3,3,1,1,1,2,1
20210524-W-Strasbourg-R32-Andrea_Lazaro_Garcia-Bianca_Andreescu,2,S-XC,1,0,0,0,0,0,1
20210524-W-Strasbourg-R32-Andrea_Lazaro_Garcia-Bianca_Andreescu,2,S-DTM,3,2,0,0,2,0,3
20210524-W-Strasbourg-R32-Andrea_Lazaro_Garcia-Bianca_Andreescu,2,S-DTL,1,1,1,0,0,1,0
20210525-W-Strasbourg-R16-Bianca_Andreescu-Maryna_Zanevska,1,F-XC,25,10,4,1,5,16,9
20210525-W-Strasbourg-R16-Bianca_Andreescu-Maryna_Zanevska,1,F-DTM,15,0,0,0,0,9,6
20210525-W-Strasbourg-R16-Bianca_Andreescu-Maryna_Zanevska,1,F-DTL,9,5,2,2,1,6,3
20210525-W-Strasbourg-R16-Bianca_Andreescu-Maryna_Zanevska,1,F-IO,12,5,3,2,0,11,1
20210525-W-Strasbourg-R16-Bianca_Andreescu-Maryna_Zanevska,1,B-XC,10,1,0,0,1,6,4
20210525-W-Strasbourg-R16-Bianca_Andreescu-Maryna_Zanevska,1,B-DTM,11,2,0,0,2,5,6
20210525-W-Strasbourg-R16-Bianca_Andreescu-Maryna_Zanevska,1,B-DTL,4,2,0,2,0,4,0
20210525-W-Strasbourg-R16-Bianca_Andreescu-Maryna_Zanevska,1,B-IO,2,2,2,0,0,2,0
20210525-W-Strasbourg-R16-Bianca_Andreescu-Maryna_Zanevska,1,S-XC,1,0,0,0,0,1,0
20210525-W-Strasbourg-R16-Bianca_Andreescu-Maryna_Zanevska,1,S-DTM,5,0,0,0,0,3,2
20210525-W-Strasbourg-R16-Bianca_Andreescu-Maryna_Zanevska,1,S-DTL,2,2,0,0,2,0,2
20210525-W-Strasbourg-R16-Bianca_Andreescu-Maryna_Zanevska,2,F-XC,22,5,1,1,3,8,14
20210525-W-Strasbourg-R16-Bianca_Andreescu-Maryna_Zanevska,2,F-DTM,11,0,0,0,0,4,7
20210525-W-Strasbourg-R16-Bianca_Andreescu-Maryna_Zanevska,2,F-DTL,1,1,0,0,1,0,1
20210525-W-Strasbourg-R16-Bianca_Andreescu-Maryna_Zanevska,2,F-IO,18,7,3,1,3,8,10
20210525-W-Strasbourg-R16-Bianca_Andreescu-Maryna_Zanevska,2,B-XC,7,2,0,1,1,4,3
20210525-W-Strasbourg-R16-Bianca_Andreescu-Maryna_Zanevska,2,B-DTM,15,2,0,0,2,2,13
20210525-W-Strasbourg-R16-Bianca_Andreescu-Maryna_Zanevska,2,B-DTL,4,2,1,0,1,2,2
20210525-W-Strasbourg-R16-Bianca_Andreescu-Maryna_Zanevska,2,B-IO,4,0,0,0,0,0,4
20210525-W-Strasbourg-R16-Bianca_Andreescu-Maryna_Zanevska,2,S-XC,4,0,0,0,0,2,2
20210525-W-Strasbourg-R16-Bianca_Andreescu-Maryna_Zanevska,2,S-DTL,1,0,0,0,0,1,0
20210525-W-Strasbourg-R16-Bianca_Andreescu-Maryna_Zanevska,2,S-IO,1,1,0,0,1,0,1
20210525-W-Strasbourg-R32-Jessica_Pegula-Arantxa_Rus,1,F-XC,75,18,5,3,10,34,41
20210525-W-Strasbourg-R32-Jessica_Pegula-Arantxa_Rus,1,F-DTM,27,4,0,0,4,13,14
20210525-W-Strasbourg-R32-Jessica_Pegula-Arantxa_Rus,1,F-DTL,9,6,3,1,2,4,5
20210525-W-Strasbourg-R32-Jessica_Pegula-Arantxa_Rus,1,F-IO,14,6,3,0,3,10,4
20210525-W-Strasbourg-R32-Jessica_Pegula-Arantxa_Rus,1,B-XC,19,2,1,0,1,9,10
20210525-W-Strasbourg-R32-Jessica_Pegula-Arantxa_Rus,1,B-DTM,27,2,0,0,2,10,17
20210525-W-Strasbourg-R32-Jessica_Pegula-Arantxa_Rus,1,B-DTL,5,2,0,0,2,1,4
20210525-W-Strasbourg-R32-Jessica_Pegula-Arantxa_Rus,1,B-IO,7,4,0,0,4,2,5
20210525-W-Strasbourg-R32-Jessica_Pegula-Arantxa_Rus,1,S-XC,7,1,0,1,0,4,3
20210525-W-Strasbourg-R32-Jessica_Pegula-Arantxa_Rus,1,S-DTM,3,0,0,0,0,1,2
20210525-W-Strasbourg-R32-Jessica_Pegula-Arantxa_Rus,1,S-IO,1,0,0,0,0,0,1
20210525-W-Strasbourg-R32-Jessica_Pegula-Arantxa_Rus,2,F-XC,26,7,3,2,2,18,8
20210525-W-Strasbourg-R32-Jessica_Pegula-Arantxa_Rus,2,F-DTM,45,1,0,0,1,19,26
20210525-W-Strasbourg-R32-Jessica_Pegula-Arantxa_Rus,2,F-DTL,7,1,1,0,0,5,2
20210525-W-Strasbourg-R32-Jessica_Pegula-Arantxa_Rus,2,F-IO,13,4,2,1,1,9,4
20210525-W-Strasbourg-R32-Jessica_Pegula-Arantxa_Rus,2,B-XC,36,5,1,1,3,22,14
20210525-W-Strasbourg-R32-Jessica_Pegula-Arantxa_Rus,2,B-DTM,41,3,0,1,2,21,20
20210525-W-Strasbourg-R32-Jessica_Pegula-Arantxa_Rus,2,B-DTL,9,3,1,1,1,6,3
20210525-W-Strasbourg-R32-Jessica_Pegula-Arantxa_Rus,2,B-IO,6,1,0,0,1,2,4
20210525-W-Strasbourg-R32-Jessica_Pegula-Arantxa_Rus,2,S-XC,1,0,0,0,0,1,0
20210525-W-Strasbourg-R32-Jessica_Pegula-Arantxa_Rus,2,S-DTM,8,0,0,0,0,3,5
20210416-W-BJK_Cup-RR-Elena_Rybakina-Maria_Lourdes_Carle,1,F-XC,62,23,5,6,12,29,33
20210416-W-BJK_Cup-RR-Elena_Rybakina-Maria_Lourdes_Carle,1,F-DTM,19,4,0,1,3,9,10
20210416-W-BJK_Cup-RR-Elena_Rybakina-Maria_Lourdes_Carle,1,F-DTL,7,2,2,0,0,5,2
20210416-W-BJK_Cup-RR-Elena_Rybakina-Maria_Lourdes_Carle,1,F-IO,27,13,5,4,4,16,11
20210416-W-BJK_Cup-RR-Elena_Rybakina-Maria_Lourdes_Carle,1,F-II,5,1,1,0,0,2,3
20210416-W-BJK_Cup-RR-Elena_Rybakina-Maria_Lourdes_Carle,1,B-XC,57,12,1,2,9,22,35
20210416-W-BJK_Cup-RR-Elena_Rybakina-Maria_Lourdes_Carle,1,B-DTM,22,4,0,2,2,7,15
20210416-W-BJK_Cup-RR-Elena_Rybakina-Maria_Lourdes_Carle,1,B-DTL,11,5,2,1,2,5,6
20210416-W-BJK_Cup-RR-Elena_Rybakina-Maria_Lourdes_Carle,1,B-IO,4,2,0,0,2,1,3
20210416-W-BJK_Cup-RR-Elena_Rybakina-Maria_Lourdes_Carle,1,S-XC,3,0,0,0,0,1,2
20210416-W-BJK_Cup-RR-Elena_Rybakina-Maria_Lourdes_Carle,1,S-DTM,5,1,0,0,1,1,4
20210416-W-BJK_Cup-RR-Elena_Rybakina-Maria_Lourdes_Carle,1,S-DTL,2,1,0,1,0,2,0
20210416-W-BJK_Cup-RR-Elena_Rybakina-Maria_Lourdes_Carle,1,S-IO,1,0,0,0,0,0,1
20210416-W-BJK_Cup-RR-Elena_Rybakina-Maria_Lourdes_Carle,2,F-XC,28,8,4,3,1,19,9
20210416-W-BJK_Cup-RR-Elena_Rybakina-Maria_Lourdes_Carle,2,F-DTM,34,4,0,1,3,19,15
20210416-W-BJK_Cup-RR-Elena_Rybakina-Maria_Lourdes_Carle,2,F-DTL,11,3,0,1,2,5,6
20210416-W-BJK_Cup-RR-Elena_Rybakina-Maria_Lourdes_Carle,2,F-IO,41,4,1,1,2,27,14
20210416-W-BJK_Cup-RR-Elena_Rybakina-Maria_Lourdes_Carle,2,F-II,1,1,1,0,0,1,0
20210416-W-BJK_Cup-RR-Elena_Rybakina-Maria_Lourdes_Carle,2,B-XC,5,0,0,0,0,3,2
20210416-W-BJK_Cup-RR-Elena_Rybakina-Maria_Lourdes_Carle,2,B-DTM,22,1,0,0,1,10,12
20210416-W-BJK_Cup-RR-Elena_Rybakina-Maria_Lourdes_Carle,2,B-DTL,5,1,1,0,0,2,3
20210416-W-BJK_Cup-RR-Elena_Rybakina-Maria_Lourdes_Carle,2,B-IO,2,1,1,0,0,1,1
20210416-W-BJK_Cup-RR-Elena_Rybakina-Maria_Lourdes_Carle,2,S-XC,21,3,1,0,2,11,10
20210416-W-BJK_Cup-RR-Elena_Rybakina-Maria_Lourdes_Carle,2,S-DTM,24,2,1,0,1,11,13
20210416-W-BJK_Cup-RR-Elena_Rybakina-Maria_Lourdes_Carle,2,S-DTL,4,1,1,0,0,3,1
20210416-W-BJK_Cup-RR-Elena_Rybakina-Maria_Lourdes_Carle,2,S-IO,1,0,0,0,0,1,0
20210525-W-Strasbourg-R32-Diane_Parry-Jule_Niemeier,1,F-XC,26,11,4,4,3,15,11
20210525-W-Strasbourg-R32-Diane_Parry-Jule_Niemeier,1,F-DTM,25,2,0,0,2,9,16
20210525-W-Strasbourg-R32-Diane_Parry-Jule_Niemeier,1,F-DTL,8,2,0,0,2,4,4
20210525-W-Strasbourg-R32-Diane_Parry-Jule_Niemeier,1,F-IO,22,7,1,1,5,10,12
20210525-W-Strasbourg-R32-Diane_Parry-Jule_Niemeier,1,F-II,1,1,0,1,0,1,0
20210525-W-Strasbourg-R32-Diane_Parry-Jule_Niemeier,1,B-XC,9,2,1,0,1,7,2
20210525-W-Strasbourg-R32-Diane_Parry-Jule_Niemeier,1,B-DTM,12,2,0,0,2,6,6
20210525-W-Strasbourg-R32-Diane_Parry-Jule_Niemeier,1,B-DTL,1,1,0,0,1,0,1
20210525-W-Strasbourg-R32-Diane_Parry-Jule_Niemeier,1,S-XC,18,4,0,0,4,8,10
20210525-W-Strasbourg-R32-Diane_Parry-Jule_Niemeier,1,S-DTM,13,3,0,1,2,5,8
20210525-W-Strasbourg-R32-Diane_Parry-Jule_Niemeier,1,S-IO,2,1,1,0,0,2,0
20210525-W-Strasbourg-R32-Diane_Parry-Jule_Niemeier,2,F-XC,27,8,2,1,5,17,10
20210525-W-Strasbourg-R32-Diane_Parry-Jule_Niemeier,2,F-DTM,17,2,0,0,2,8,9
20210525-W-Strasbourg-R32-Diane_Parry-Jule_Niemeier,2,F-DTL,4,3,0,2,1,3,1
20210525-W-Strasbourg-R32-Diane_Parry-Jule_Niemeier,2,F-IO,20,8,5,1,2,15,5
20210525-W-Strasbourg-R32-Diane_Parry-Jule_Niemeier,2,F-II,2,1,0,0,1,0,2
20210525-W-Strasbourg-R32-Diane_Parry-Jule_Niemeier,2,B-XC,18,2,1,1,0,11,7
20210525-W-Strasbourg-R32-Diane_Parry-Jule_Niemeier,2,B-DTM,13,1,0,0,1,3,10
20210525-W-Strasbourg-R32-Diane_Parry-Jule_Niemeier,2,B-DTL,4,2,0,0,2,1,3
20210525-W-Strasbourg-R32-Diane_Parry-Jule_Niemeier,2,S-XC,3,1,0,0,1,1,2
20210525-W-Strasbourg-R32-Diane_Parry-Jule_Niemeier,2,S-DTM,12,2,0,0,2,3,9
20210525-W-Strasbourg-R32-Diane_Parry-Jule_Niemeier,2,S-DTL,2,1,0,0,1,1,1
20210525-W-Strasbourg-R32-Diane_Parry-Jule_Niemeier,2,S-IO,1,0,0,0,0,0,1
20210527-W-Strasbourg-QF-Arantxa_Rus-Jule_Niemeier,1,F-XC,24,8,3,2,3,9,15
20210527-W-Strasbourg-QF-Arantxa_Rus-Jule_Niemeier,1,F-DTM,30,3,0,1,2,9,21
20210527-W-Strasbourg-QF-Arantxa_Rus-Jule_Niemeier,1,F-DTL,5,1,1,0,0,2,3
20210527-W-Strasbourg-QF-Arantxa_Rus-Jule_Niemeier,1,F-IO,14,4,2,1,1,6,8
20210527-W-Strasbourg-QF-Arantxa_Rus-Jule_Niemeier,1,B-XC,16,3,1,1,1,8,8
20210527-W-Strasbourg-QF-Arantxa_Rus-Jule_Niemeier,1,B-DTM,24,0,0,0,0,5,19
20210527-W-Strasbourg-QF-Arantxa_Rus-Jule_Niemeier,1,B-DTL,6,2,1,0,1,4,2
20210527-W-Strasbourg-QF-Arantxa_Rus-Jule_Niemeier,1,B-IO,6,1,0,0,1,2,4
20210527-W-Strasbourg-QF-Arantxa_Rus-Jule_Niemeier,1,S-DTM,1,1,0,1,0,1,0
20210527-W-Strasbourg-QF-Arantxa_Rus-Jule_Niemeier,1,S-DTL,4,0,0,0,0,2,2
20210527-W-Strasbourg-QF-Arantxa_Rus-Jule_Niemeier,2,F-XC,42,11,3,2,6,26,16
20210527-W-Strasbourg-QF-Arantxa_Rus-Jule_Niemeier,2,F-DTM,14,1,0,1,0,9,5
20210527-W-Strasbourg-QF-Arantxa_Rus-Jule_Niemeier,2,F-DTL,6,5,3,1,1,5,1
20210527-W-Strasbourg-QF-Arantxa_Rus-Jule_Niemeier,2,F-IO,23,15,10,1,4,18,5
20210527-W-Strasbourg-QF-Arantxa_Rus-Jule_Niemeier,2,B-XC,15,5,2,1,2,12,3
20210527-W-Strasbourg-QF-Arantxa_Rus-Jule_Niemeier,2,B-DTM,17,0,0,0,0,13,4
20210527-W-Strasbourg-QF-Arantxa_Rus-Jule_Niemeier,2,B-DTL,3,1,0,0,1,1,2
20210527-W-Strasbourg-QF-Arantxa_Rus-Jule_Niemeier,2,B-IO,5,0,0,0,0,3,2
20210527-W-Strasbourg-QF-Arantxa_Rus-Jule_Niemeier,2,S-XC,4,1,0,0,1,1,3
20210527-W-Strasbourg-QF-Arantxa_Rus-Jule_Niemeier,2,S-DTM,4,0,0,0,0,2,2
20210526-W-Strasbourg-R16-Arantxa_Rus-Harmony_Tan,1,F-XC,22,5,2,1,2,12,10
20210526-W-Strasbourg-R16-Arantxa_Rus-Harmony_Tan,1,F-DTM,30,0,0,0,0,18,12
20210526-W-Strasbourg-R16-Arantxa_Rus-Harmony_Tan,1,F-DTL,6,4,1,2,1,5,1
20210526-W-Strasbourg-R16-Arantxa_Rus-Harmony_Tan,1,F-IO,20,5,5,0,0,14,6
20210526-W-Strasbourg-R16-Arantxa_Rus-Harmony_Tan,1,F-II,4,1,0,1,0,2,2
20210526-W-Strasbourg-R16-Arantxa_Rus-Harmony_Tan,1,B-XC,1,1,0,0,1,0,1
20210526-W-Strasbourg-R16-Arantxa_Rus-Harmony_Tan,1,B-DTM,23,1,0,1,0,17,6
20210526-W-Strasbourg-R16-Arantxa_Rus-Harmony_Tan,1,B-IO,19,1,0,0,1,10,9
20210526-W-Strasbourg-R16-Arantxa_Rus-Harmony_Tan,1,B-II,3,0,0,0,0,1,2
20210526-W-Strasbourg-R16-Arantxa_Rus-Harmony_Tan,1,S-XC,1,0,0,0,0,1,0
20210526-W-Strasbourg-R16-Arantxa_Rus-Harmony_Tan,1,S-DTM,1,0,0,0,0,1,0
20210526-W-Strasbourg-R16-Arantxa_Rus-Harmony_Tan,1,S-IO,1,0,0,0,0,1,0
20210526-W-Strasbourg-R16-Arantxa_Rus-Harmony_Tan,1,S-II,2,1,1,0,0,2,0
20210526-W-Strasbourg-R16-Arantxa_Rus-Harmony_Tan,2,F-XC,46,8,2,1,5,23,23
20210526-W-Strasbourg-R16-Arantxa_Rus-Harmony_Tan,2,F-DTM,13,0,0,0,0,4,9
20210526-W-Strasbourg-R16-Arantxa_Rus-Harmony_Tan,2,F-DTL,6,3,1,0,2,4,2
20210526-W-Strasbourg-R16-Arantxa_Rus-Harmony_Tan,2,F-IO,6,5,0,2,3,2,4
20210526-W-Strasbourg-R16-Arantxa_Rus-Harmony_Tan,2,F-II,1,0,0,0,0,0,1
20210526-W-Strasbourg-R16-Arantxa_Rus-Harmony_Tan,2,B-XC,23,3,0,2,1,10,13
20210526-W-Strasbourg-R16-Arantxa_Rus-Harmony_Tan,2,B-DTM,16,1,0,0,1,6,10
20210526-W-Strasbourg-R16-Arantxa_Rus-Harmony_Tan,2,B-DTL,10,3,0,1,2,2,8
20210526-W-Strasbourg-R16-Arantxa_Rus-Harmony_Tan,2,B-IO,5,2,1,0,1,1,4
20210526-W-Strasbourg-R16-Arantxa_Rus-Harmony_Tan,2,S-XC,2,0,0,0,0,0,2
20210526-W-Strasbourg-R16-Arantxa_Rus-Harmony_Tan,2,S-DTM,2,0,0,0,0,1,1
20210526-W-Strasbourg-R16-Arantxa_Rus-Harmony_Tan,2,S-DTL,1,0,0,0,0,0,1
20210531-W-Roland_Garros-R128-Arantxa_Rus-Mihaela_Buzarnescu,1,F-XC,52,13,3,5,5,26,26
20210531-W-Roland_Garros-R128-Arantxa_Rus-Mihaela_Buzarnescu,1,F-DTM,55,2,0,0,2,19,36
20210531-W-Roland_Garros-R128-Arantxa_Rus-Mihaela_Buzarnescu,1,F-DTL,8,4,0,3,1,4,4
20210531-W-Roland_Garros-R128-Arantxa_Rus-Mihaela_Buzarnescu,1,F-IO,22,9,2,2,5,11,11
20210531-W-Roland_Garros-R128-Arantxa_Rus-Mihaela_Buzarnescu,1,F-II,1,1,0,1,0,1,0
20210531-W-Roland_Garros-R128-Arantxa_Rus-Mihaela_Buzarnescu,1,B-XC,29,9,1,1,7,9,20
20210531-W-Roland_Garros-R128-Arantxa_Rus-Mihaela_Buzarnescu,1,B-DTM,45,5,0,0,5,15,30
20210531-W-Roland_Garros-R128-Arantxa_Rus-Mihaela_Buzarnescu,1,B-DTL,8,5,0,0,5,2,6
20210531-W-Roland_Garros-R128-Arantxa_Rus-Mihaela_Buzarnescu,1,B-IO,5,1,0,0,1,2,3
20210531-W-Roland_Garros-R128-Arantxa_Rus-Mihaela_Buzarnescu,1,S-DTM,5,0,0,0,0,1,4
20210531-W-Roland_Garros-R128-Arantxa_Rus-Mihaela_Buzarnescu,1,S-DTL,1,1,0,1,0,1,0
20210531-W-Roland_Garros-R128-Arantxa_Rus-Mihaela_Buzarnescu,2,F-XC,71,12,2,4,6,47,24
20210531-W-Roland_Garros-R128-Arantxa_Rus-Mihaela_Buzarnescu,2,F-DTM,33,2,0,0,2,17,16
20210531-W-Roland_Garros-R128-Arantxa_Rus-Mihaela_Buzarnescu,2,F-DTL,8,6,3,0,3,5,3
20210531-W-Roland_Garros-R128-Arantxa_Rus-Mihaela_Buzarnescu,2,F-IO,8,3,2,1,0,8,0
20210531-W-Roland_Garros-R128-Arantxa_Rus-Mihaela_Buzarnescu,2,B-XC,57,15,3,5,7,34,23
20210531-W-Roland_Garros-R128-Arantxa_Rus-Mihaela_Buzarnescu,2,B-DTM,28,2,0,0,2,15,13
20210531-W-Roland_Garros-R128-Arantxa_Rus-Mihaela_Buzarnescu,2,B-DTL,3,3,1,1,1,2,1
20210531-W-Roland_Garros-R128-Arantxa_Rus-Mihaela_Buzarnescu,2,B-IO,2,1,0,0,1,0,2
20210531-W-Roland_Garros-R128-Arantxa_Rus-Mihaela_Buzarnescu,2,S-XC,3,0,0,0,0,2,1
20210531-W-Roland_Garros-R128-Arantxa_Rus-Mihaela_Buzarnescu,2,S-DTM,6,0,0,0,0,2,4
20210531-W-Roland_Garros-R128-Arantxa_Rus-Mihaela_Buzarnescu,2,S-DTL,1,0,0,0,0,0,1
20210531-W-Roland_Garros-R128-Kiki_Bertens-Polona_Hercog,1,F-XC,53,10,1,3,6,28,25
20210531-W-Roland_Garros-R128-Kiki_Bertens-Polona_Hercog,1,F-DTM,18,2,0,1,1,6,12
20210531-W-Roland_Garros-R128-Kiki_Bertens-Polona_Hercog,1,F-DTL,7,3,0,1,2,5,2
20210531-W-Roland_Garros-R128-Kiki_Bertens-Polona_Hercog,1,F-IO,33,8,3,4,1,22,11
20210531-W-Roland_Garros-R128-Kiki_Bertens-Polona_Hercog,1,F-II,3,2,1,0,1,2,1
20210531-W-Roland_Garros-R128-Kiki_Bertens-Polona_Hercog,1,B-XC,43,7,1,2,4,21,22
20210531-W-Roland_Garros-R128-Kiki_Bertens-Polona_Hercog,1,B-DTM,13,2,0,0,2,5,8
20210531-W-Roland_Garros-R128-Kiki_Bertens-Polona_Hercog,1,B-DTL,9,4,1,0,3,5,4
20210531-W-Roland_Garros-R128-Kiki_Bertens-Polona_Hercog,1,B-IO,2,2,1,1,0,2,0
20210531-W-Roland_Garros-R128-Kiki_Bertens-Polona_Hercog,1,S-XC,7,0,0,0,0,5,2
20210531-W-Roland_Garros-R128-Kiki_Bertens-Polona_Hercog,1,S-DTM,7,2,0,1,1,2,5
20210531-W-Roland_Garros-R128-Kiki_Bertens-Polona_Hercog,1,S-DTL,2,0,0,0,0,1,1
20210531-W-Roland_Garros-R128-Kiki_Bertens-Polona_Hercog,2,F-XC,50,21,10,5,6,28,22
20210531-W-Roland_Garros-R128-Kiki_Bertens-Polona_Hercog,2,F-DTM,48,6,1,0,5,16,32
20210531-W-Roland_Garros-R128-Kiki_Bertens-Polona_Hercog,2,F-DTL,4,1,1,0,0,2,2
20210531-W-Roland_Garros-R128-Kiki_Bertens-Polona_Hercog,2,F-IO,25,8,1,2,5,13,12
20210531-W-Roland_Garros-R128-Kiki_Bertens-Polona_Hercog,2,F-II,8,4,1,1,2,3,5
20210531-W-Roland_Garros-R128-Kiki_Bertens-Polona_Hercog,2,B-XC,24,4,0,3,1,13,11
20210531-W-Roland_Garros-R128-Kiki_Bertens-Polona_Hercog,2,B-DTM,11,0,0,0,0,6,5
20210531-W-Roland_Garros-R128-Kiki_Bertens-Polona_Hercog,2,B-DTL,1,1,1,0,0,1,0
20210531-W-Roland_Garros-R128-Kiki_Bertens-Polona_Hercog,2,S-XC,22,3,0,1,2,11,11
20210531-W-Roland_Garros-R128-Kiki_Bertens-Polona_Hercog,2,S-DTM,13,0,0,0,0,6,7
20210601-W-Roland_Garros-R128-Carla_Suarez_Navarro-Sloane_Stephens,1,F-XC,56,13,5,3,5,30,26
20210601-W-Roland_Garros-R128-Carla_Suarez_Navarro-Sloane_Stephens,1,F-DTM,37,1,0,0,1,18,19
20210601-W-Roland_Garros-R128-Carla_Suarez_Navarro-Sloane_Stephens,1,F-DTL,11,1,0,0,1,5,6
20210601-W-Roland_Garros-R128-Carla_Suarez_Navarro-Sloane_Stephens,1,F-IO,46,11,1,5,5,27,19
20210601-W-Roland_Garros-R128-Carla_Suarez_Navarro-Sloane_Stephens,1,F-II,2,2,1,1,0,2,0
20210601-W-Roland_Garros-R128-Carla_Suarez_Navarro-Sloane_Stephens,1,B-XC,70,8,0,4,4,35,35
20210601-W-Roland_Garros-R128-Carla_Suarez_Navarro-Sloane_Stephens,1,B-DTM,32,3,0,0,3,18,14
20210601-W-Roland_Garros-R128-Carla_Suarez_Navarro-Sloane_Stephens,1,B-DTL,11,6,1,1,4,4,7
20210601-W-Roland_Garros-R128-Carla_Suarez_Navarro-Sloane_Stephens,1,B-IO,3,2,0,0,2,1,2
20210601-W-Roland_Garros-R128-Carla_Suarez_Navarro-Sloane_Stephens,1,S-XC,9,1,0,0,1,3,6
20210601-W-Roland_Garros-R128-Carla_Suarez_Navarro-Sloane_Stephens,1,S-DTM,5,0,0,0,0,1,4
20210601-W-Roland_Garros-R128-Carla_Suarez_Navarro-Sloane_Stephens,1,S-DTL,1,0,0,0,0,0,1
20210601-W-Roland_Garros-R128-Carla_Suarez_Navarro-Sloane_Stephens,2,F-XC,51,21,5,4,12,28,23
20210601-W-Roland_Garros-R128-Carla_Suarez_Navarro-Sloane_Stephens,2,F-DTM,43,3,0,1,2,20,23
20210601-W-Roland_Garros-R128-Carla_Suarez_Navarro-Sloane_Stephens,2,F-DTL,5,3,2,0,1,4,1
20210601-W-Roland_Garros-R128-Carla_Suarez_Navarro-Sloane_Stephens,2,F-IO,25,11,5,1,5,13,12
20210601-W-Roland_Garros-R128-Carla_Suarez_Navarro-Sloane_Stephens,2,F-II,7,4,2,1,1,3,4
20210601-W-Roland_Garros-R128-Carla_Suarez_Navarro-Sloane_Stephens,2,B-XC,47,9,2,0,7,30,17
20210601-W-Roland_Garros-R128-Carla_Suarez_Navarro-Sloane_Stephens,2,B-DTM,67,10,1,1,8,23,44
20210601-W-Roland_Garros-R128-Carla_Suarez_Navarro-Sloane_Stephens,2,B-DTL,22,12,4,3,5,13,9
20210601-W-Roland_Garros-R128-Carla_Suarez_Navarro-Sloane_Stephens,2,B-IO,10,5,3,1,1,6,4
20210601-W-Roland_Garros-R128-Carla_Suarez_Navarro-Sloane_Stephens,2,S-XC,10,1,0,0,1,5,5
20210601-W-Roland_Garros-R128-Carla_Suarez_Navarro-Sloane_Stephens,2,S-DTM,10,0,0,0,0,1,9
20210601-W-Roland_Garros-R128-Carla_Suarez_Navarro-Sloane_Stephens,2,S-DTL,2,2,1,0,1,1,1
20210601-W-Roland_Garros-R128-Carla_Suarez_Navarro-Sloane_Stephens,2,S-IO,1,0,0,0,0,1,0
20210606-W-Roland_Garros-R16-Marketa_Vondrousova-Paula_Badosa,1,F-XC,120,17,2,5,10,58,62
20210606-W-Roland_Garros-R16-Marketa_Vondrousova-Paula_Badosa,1,F-DTM,25,1,0,0,1,7,18
20210606-W-Roland_Garros-R16-Marketa_Vondrousova-Paula_Badosa,1,F-DTL,9,5,2,0,3,3,6
20210606-W-Roland_Garros-R16-Marketa_Vondrousova-Paula_Badosa,1,F-IO,15,9,5,1,3,8,7
20210606-W-Roland_Garros-R16-Marketa_Vondrousova-Paula_Badosa,1,B-XC,29,15,5,4,6,13,16
20210606-W-Roland_Garros-R16-Marketa_Vondrousova-Paula_Badosa,1,B-DTM,39,1,0,0,1,12,27
20210606-W-Roland_Garros-R16-Marketa_Vondrousova-Paula_Badosa,1,B-DTL,2,1,0,0,1,1,1
20210606-W-Roland_Garros-R16-Marketa_Vondrousova-Paula_Badosa,1,B-IO,12,1,0,0,1,7,5
20210606-W-Roland_Garros-R16-Marketa_Vondrousova-Paula_Badosa,1,S-DTM,3,1,0,0,1,1,2
20210606-W-Roland_Garros-R16-Marketa_Vondrousova-Paula_Badosa,1,S-DTL,2,0,0,0,0,1,1
20210606-W-Roland_Garros-R16-Marketa_Vondrousova-Paula_Badosa,1,S-IO,2,0,0,0,0,0,2
20210606-W-Roland_Garros-R16-Marketa_Vondrousova-Paula_Badosa,2,F-XC,37,9,4,3,2,26,11
20210606-W-Roland_Garros-R16-Marketa_Vondrousova-Paula_Badosa,2,F-DTM,41,3,0,3,0,26,15
20210606-W-Roland_Garros-R16-Marketa_Vondrousova-Paula_Badosa,2,F-DTL,11,5,4,1,0,9,2
20210606-W-Roland_Garros-R16-Marketa_Vondrousova-Paula_Badosa,2,F-IO,46,11,6,2,3,28,18
20210606-W-Roland_Garros-R16-Marketa_Vondrousova-Paula_Badosa,2,F-II,6,1,1,0,0,5,1
20210606-W-Roland_Garros-R16-Marketa_Vondrousova-Paula_Badosa,2,B-XC,36,6,0,0,6,17,19
20210606-W-Roland_Garros-R16-Marketa_Vondrousova-Paula_Badosa,2,B-DTM,79,5,1,0,4,43,36
20210606-W-Roland_Garros-R16-Marketa_Vondrousova-Paula_Badosa,2,B-DTL,17,8,4,1,3,9,8
20210606-W-Roland_Garros-R16-Marketa_Vondrousova-Paula_Badosa,2,B-IO,6,1,0,0,1,4,2
20210606-W-Roland_Garros-R16-Marketa_Vondrousova-Paula_Badosa,2,S-DTM,1,0,0,0,0,0,1
20210606-W-Roland_Garros-R16-Marketa_Vondrousova-Paula_Badosa,2,S-DTL,1,0,0,0,0,0,1
20210606-W-Roland_Garros-R16-Marketa_Vondrousova-Paula_Badosa,2,S-IO,1,1,1,0,0,1,0
20210607-W-Roland_Garros-R16-Iga_Swiatek-Marta_Kostyuk,1,F-XC,37,11,4,5,2,22,15
20210607-W-Roland_Garros-R16-Iga_Swiatek-Marta_Kostyuk,1,F-DTM,17,3,0,2,1,8,9
20210607-W-Roland_Garros-R16-Iga_Swiatek-Marta_Kostyuk,1,F-DTL,14,4,1,0,3,7,7
20210607-W-Roland_Garros-R16-Iga_Swiatek-Marta_Kostyuk,1,F-IO,20,6,2,2,2,13,7
20210607-W-Roland_Garros-R16-Iga_Swiatek-Marta_Kostyuk,1,B-XC,54,11,3,3,5,24,30
20210607-W-Roland_Garros-R16-Iga_Swiatek-Marta_Kostyuk,1,B-DTM,24,1,0,0,1,9,15
20210607-W-Roland_Garros-R16-Iga_Swiatek-Marta_Kostyuk,1,B-DTL,11,5,3,0,2,6,5
20210607-W-Roland_Garros-R16-Iga_Swiatek-Marta_Kostyuk,1,B-IO,6,2,1,0,1,4,2
20210607-W-Roland_Garros-R16-Iga_Swiatek-Marta_Kostyuk,1,S-XC,1,0,0,0,0,1,0
20210607-W-Roland_Garros-R16-Iga_Swiatek-Marta_Kostyuk,1,S-DTM,2,0,0,0,0,1,1
20210607-W-Roland_Garros-R16-Iga_Swiatek-Marta_Kostyuk,2,F-XC,27,4,1,1,2,14,13
20210607-W-Roland_Garros-R16-Iga_Swiatek-Marta_Kostyuk,2,F-DTM,26,2,0,1,1,14,12
20210607-W-Roland_Garros-R16-Iga_Swiatek-Marta_Kostyuk,2,F-DTL,10,4,2,1,1,6,4
20210607-W-Roland_Garros-R16-Iga_Swiatek-Marta_Kostyuk,2,F-IO,20,6,2,0,4,9,11
20210607-W-Roland_Garros-R16-Iga_Swiatek-Marta_Kostyuk,2,B-XC,35,4,1,1,2,20,15
20210607-W-Roland_Garros-R16-Iga_Swiatek-Marta_Kostyuk,2,B-DTM,31,1,0,0,1,13,18
20210607-W-Roland_Garros-R16-Iga_Swiatek-Marta_Kostyuk,2,B-DTL,17,10,3,1,6,8,9
20210607-W-Roland_Garros-R16-Iga_Swiatek-Marta_Kostyuk,2,B-IO,2,1,1,0,0,2,0
20210607-W-Roland_Garros-R16-Iga_Swiatek-Marta_Kostyuk,2,S-XC,2,0,0,0,0,2,0
20210607-W-Roland_Garros-R16-Iga_Swiatek-Marta_Kostyuk,2,S-DTM,6,0,0,0,0,3,3
20210531-W-Roland_Garros-R128-Tamara_Zidansek-Bianca_Andreescu,1,F-XC,65,22,13,5,4,45,20
20210531-W-Roland_Garros-R128-Tamara_Zidansek-Bianca_Andreescu,1,F-DTM,54,9,0,0,9,21,33
20210531-W-Roland_Garros-R128-Tamara_Zidansek-Bianca_Andreescu,1,F-DTL,7,5,2,2,1,5,2
20210531-W-Roland_Garros-R128-Tamara_Zidansek-Bianca_Andreescu,1,F-IO,57,17,8,5,4,40,17
20210531-W-Roland_Garros-R128-Tamara_Zidansek-Bianca_Andreescu,1,F-II,6,2,1,0,1,4,2
20210531-W-Roland_Garros-R128-Tamara_Zidansek-Bianca_Andreescu,1,B-XC,20,5,2,1,2,13,7
20210531-W-Roland_Garros-R128-Tamara_Zidansek-Bianca_Andreescu,1,B-DTM,38,5,0,0,5,22,16
20210531-W-Roland_Garros-R128-Tamara_Zidansek-Bianca_Andreescu,1,B-DTL,9,5,1,1,3,5,4
20210531-W-Roland_Garros-R128-Tamara_Zidansek-Bianca_Andreescu,1,B-IO,7,3,1,1,1,4,3
20210531-W-Roland_Garros-R128-Tamara_Zidansek-Bianca_Andreescu,1,S-XC,7,1,0,1,0,3,4
20210531-W-Roland_Garros-R128-Tamara_Zidansek-Bianca_Andreescu,1,S-DTM,9,2,0,0,2,1,8
20210531-W-Roland_Garros-R128-Tamara_Zidansek-Bianca_Andreescu,1,S-IO,2,0,0,0,0,1,1
20210531-W-Roland_Garros-R128-Tamara_Zidansek-Bianca_Andreescu,2,F-XC,46,16,6,2,8,24,22
20210531-W-Roland_Garros-R128-Tamara_Zidansek-Bianca_Andreescu,2,F-DTM,42,5,0,0,5,20,22
20210531-W-Roland_Garros-R128-Tamara_Zidansek-Bianca_Andreescu,2,F-DTL,26,11,3,2,6,15,11
20210531-W-Roland_Garros-R128-Tamara_Zidansek-Bianca_Andreescu,2,F-IO,45,22,8,3,11,25,20
20210531-W-Roland_Garros-R128-Tamara_Zidansek-Bianca_Andreescu,2,F-II,3,2,1,1,0,2,1
20210531-W-Roland_Garros-R128-Tamara_Zidansek-Bianca_Andreescu,2,B-XC,43,10,1,5,4,23,20
20210531-W-Roland_Garros-R128-Tamara_Zidansek-Bianca_Andreescu,2,B-DTM,36,4,0,1,3,16,20
20210531-W-Roland_Garros-R128-Tamara_Zidansek-Bianca_Andreescu,2,B-DTL,7,2,1,0,1,3,4
20210531-W-Roland_Garros-R128-Tamara_Zidansek-Bianca_Andreescu,2,B-IO,6,2,0,1,1,2,4
20210531-W-Roland_Garros-R128-Tamara_Zidansek-Bianca_Andreescu,2,S-XC,8,3,0,0,3,1,7
20210531-W-Roland_Garros-R128-Tamara_Zidansek-Bianca_Andreescu,2,S-DTM,10,3,0,0,3,2,8
20210531-W-Roland_Garros-R128-Tamara_Zidansek-Bianca_Andreescu,2,S-DTL,3,2,0,2,0,2,1
20210608-W-Roland_Garros-QF-Tamara_Zidansek-Paula_Badosa,1,F-XC,65,15,9,3,3,42,23
20210608-W-Roland_Garros-QF-Tamara_Zidansek-Paula_Badosa,1,F-DTM,35,3,0,0,3,14,21
20210608-W-Roland_Garros-QF-Tamara_Zidansek-Paula_Badosa,1,F-DTL,6,5,2,1,2,3,3
20210608-W-Roland_Garros-QF-Tamara_Zidansek-Paula_Badosa,1,F-IO,64,20,11,0,9,36,28
20210608-W-Roland_Garros-QF-Tamara_Zidansek-Paula_Badosa,1,F-II,6,3,2,0,1,4,2
20210608-W-Roland_Garros-QF-Tamara_Zidansek-Paula_Badosa,1,B-XC,59,7,2,0,5,32,27
20210608-W-Roland_Garros-QF-Tamara_Zidansek-Paula_Badosa,1,B-DTM,56,4,1,0,3,26,30
20210608-W-Roland_Garros-QF-Tamara_Zidansek-Paula_Badosa,1,B-DTL,13,8,3,0,5,6,7
20210608-W-Roland_Garros-QF-Tamara_Zidansek-Paula_Badosa,1,B-IO,1,0,0,0,0,0,1
20210608-W-Roland_Garros-QF-Tamara_Zidansek-Paula_Badosa,1,S-XC,7,1,0,0,1,2,5
20210608-W-Roland_Garros-QF-Tamara_Zidansek-Paula_Badosa,1,S-DTM,9,0,0,0,0,5,4
20210608-W-Roland_Garros-QF-Tamara_Zidansek-Paula_Badosa,1,S-DTL,3,1,0,1,0,2,1
20210608-W-Roland_Garros-QF-Tamara_Zidansek-Paula_Badosa,1,S-IO,1,0,0,0,0,1,0
20210608-W-Roland_Garros-QF-Tamara_Zidansek-Paula_Badosa,2,F-XC,46,21,9,8,4,34,12
20210608-W-Roland_Garros-QF-Tamara_Zidansek-Paula_Badosa,2,F-DTM,55,1,0,0,1,19,36
20210608-W-Roland_Garros-QF-Tamara_Zidansek-Paula_Badosa,2,F-DTL,32,11,2,2,7,12,20
20210608-W-Roland_Garros-QF-Tamara_Zidansek-Paula_Badosa,2,F-IO,66,14,4,7,3,43,23
20210608-W-Roland_Garros-QF-Tamara_Zidansek-Paula_Badosa,2,F-II,5,0,0,0,0,2,3
20210608-W-Roland_Garros-QF-Tamara_Zidansek-Paula_Badosa,2,B-XC,50,8,1,3,4,25,25
20210608-W-Roland_Garros-QF-Tamara_Zidansek-Paula_Badosa,2,B-DTM,47,2,0,0,2,22,25
20210608-W-Roland_Garros-QF-Tamara_Zidansek-Paula_Badosa,2,B-DTL,14,11,1,2,8,3,11
20210608-W-Roland_Garros-QF-Tamara_Zidansek-Paula_Badosa,2,B-IO,3,1,1,0,0,3,0
20210608-W-Roland_Garros-QF-Tamara_Zidansek-Paula_Badosa,2,S-XC,2,0,0,0,0,1,1
20210608-W-Roland_Garros-QF-Tamara_Zidansek-Paula_Badosa,2,S-DTM,3,0,0,0,0,1,2
20210608-W-Roland_Garros-QF-Tamara_Zidansek-Paula_Badosa,2,S-DTL,1,1,0,0,1,0,1
20210609-W-Roland_Garros-QF-Cori_Gauff-Barbora_Krejcikova,1,F-XC,27,7,3,3,1,19,8
20210609-W-Roland_Garros-QF-Cori_Gauff-Barbora_Krejcikova,1,F-DTM,35,2,0,1,1,15,20
20210609-W-Roland_Garros-QF-Cori_Gauff-Barbora_Krejcikova,1,F-DTL,10,5,1,2,2,7,3
20210609-W-Roland_Garros-QF-Cori_Gauff-Barbora_Krejcikova,1,F-IO,27,8,1,3,4,16,11
20210609-W-Roland_Garros-QF-Cori_Gauff-Barbora_Krejcikova,1,F-II,2,2,0,0,2,0,2
20210609-W-Roland_Garros-QF-Cori_Gauff-Barbora_Krejcikova,1,B-XC,36,10,3,1,6,21,15
20210609-W-Roland_Garros-QF-Cori_Gauff-Barbora_Krejcikova,1,B-DTM,31,3,1,0,2,13,18
20210609-W-Roland_Garros-QF-Cori_Gauff-Barbora_Krejcikova,1,B-DTL,12,5,2,0,3,8,4
20210609-W-Roland_Garros-QF-Cori_Gauff-Barbora_Krejcikova,1,B-IO,12,8,5,0,3,9,3
20210609-W-Roland_Garros-QF-Cori_Gauff-Barbora_Krejcikova,1,S-DTM,1,0,0,0,0,1,0
20210609-W-Roland_Garros-QF-Cori_Gauff-Barbora_Krejcikova,1,S-DTL,1,1,0,0,1,0,1
20210609-W-Roland_Garros-QF-Cori_Gauff-Barbora_Krejcikova,2,F-XC,51,13,4,3,6,24,27
20210609-W-Roland_Garros-QF-Cori_Gauff-Barbora_Krejcikova,2,F-DTM,14,0,0,0,0,8,6
20210609-W-Roland_Garros-QF-Cori_Gauff-Barbora_Krejcikova,2,F-DTL,7,5,2,1,2,3,4
20210609-W-Roland_Garros-QF-Cori_Gauff-Barbora_Krejcikova,2,F-IO,12,8,3,2,3,9,3
20210609-W-Roland_Garros-QF-Cori_Gauff-Barbora_Krejcikova,2,F-II,1,1,1,0,0,1,0
20210609-W-Roland_Garros-QF-Cori_Gauff-Barbora_Krejcikova,2,B-XC,55,8,2,2,4,26,29
20210609-W-Roland_Garros-QF-Cori_Gauff-Barbora_Krejcikova,2,B-DTM,23,2,0,1,1,7,16
20210609-W-Roland_Garros-QF-Cori_Gauff-Barbora_Krejcikova,2,B-DTL,9,6,3,0,3,3,6
20210609-W-Roland_Garros-QF-Cori_Gauff-Barbora_Krejcikova,2,B-IO,8,3,1,1,1,5,3
20210609-W-Roland_Garros-QF-Cori_Gauff-Barbora_Krejcikova,2,S-XC,4,0,0,0,0,2,2
20210609-W-Roland_Garros-QF-Cori_Gauff-Barbora_Krejcikova,2,S-DTM,3,0,0,0,0,2,1
20210609-W-Roland_Garros-QF-Cori_Gauff-Barbora_Krejcikova,2,S-IO,1,0,0,0,0,0,1
20210505-W-Madrid-QF-Belinda_Bencic-Paula_Badosa,1,F-XC,35,11,2,1,8,16,19
20210505-W-Madrid-QF-Belinda_Bencic-Paula_Badosa,1,F-DTM,27,5,1,0,4,12,15
20210505-W-Madrid-QF-Belinda_Bencic-Paula_Badosa,1,F-DTL,7,2,1,1,0,6,1
20210505-W-Madrid-QF-Belinda_Bencic-Paula_Badosa,1,F-IO,26,10,2,1,7,12,14
20210505-W-Madrid-QF-Belinda_Bencic-Paula_Badosa,1,B-XC,47,10,3,2,5,31,16
20210505-W-Madrid-QF-Belinda_Bencic-Paula_Badosa,1,B-DTM,28,4,0,0,4,11,17
20210505-W-Madrid-QF-Belinda_Bencic-Paula_Badosa,1,B-DTL,7,6,4,2,0,7,0
20210505-W-Madrid-QF-Belinda_Bencic-Paula_Badosa,1,B-IO,13,4,3,0,1,10,3
20210505-W-Madrid-QF-Belinda_Bencic-Paula_Badosa,1,S-XC,2,0,0,0,0,1,1
20210505-W-Madrid-QF-Belinda_Bencic-Paula_Badosa,2,F-XC,18,5,3,0,2,15,3
20210505-W-Madrid-QF-Belinda_Bencic-Paula_Badosa,2,F-DTM,33,1,0,0,1,13,20
20210505-W-Madrid-QF-Belinda_Bencic-Paula_Badosa,2,F-DTL,10,7,4,2,1,7,3
20210505-W-Madrid-QF-Belinda_Bencic-Paula_Badosa,2,F-IO,17,4,1,0,3,7,10
20210505-W-Madrid-QF-Belinda_Bencic-Paula_Badosa,2,F-II,2,0,0,0,0,1,1
20210505-W-Madrid-QF-Belinda_Bencic-Paula_Badosa,2,B-XC,24,6,3,1,2,11,13
20210505-W-Madrid-QF-Belinda_Bencic-Paula_Badosa,2,B-DTM,49,5,1,1,3,24,25
20210505-W-Madrid-QF-Belinda_Bencic-Paula_Badosa,2,B-DTL,8,3,1,1,1,4,4
20210505-W-Madrid-QF-Belinda_Bencic-Paula_Badosa,2,B-IO,8,3,3,0,0,6,2
20210505-W-Madrid-QF-Belinda_Bencic-Paula_Badosa,2,S-XC,2,0,0,0,0,0,2
20210505-W-Madrid-QF-Belinda_Bencic-Paula_Badosa,2,S-DTM,6,0,0,0,0,1,5
20200929-W-Roland_Garros-R128-Alison_Riske-Julia_Goerges,1,F-XC,28,7,2,3,2,14,14
20200929-W-Roland_Garros-R128-Alison_Riske-Julia_Goerges,1,F-DTM,29,5,0,2,3,13,16
20200929-W-Roland_Garros-R128-Alison_Riske-Julia_Goerges,1,F-DTL,14,3,2,0,1,8,6
20200929-W-Roland_Garros-R128-Alison_Riske-Julia_Goerges,1,F-IO,17,4,0,1,3,9,8
20200929-W-Roland_Garros-R128-Alison_Riske-Julia_Goerges,1,B-XC,36,4,2,0,2,16,20
20200929-W-Roland_Garros-R128-Alison_Riske-Julia_Goerges,1,B-DTM,21,1,0,0,1,9,12
20200929-W-Roland_Garros-R128-Alison_Riske-Julia_Goerges,1,B-DTL,6,2,0,1,1,3,3
20200929-W-Roland_Garros-R128-Alison_Riske-Julia_Goerges,1,B-IO,10,8,3,1,4,5,5
20200929-W-Roland_Garros-R128-Alison_Riske-Julia_Goerges,1,S-XC,3,1,1,0,0,2,1
20200929-W-Roland_Garros-R128-Alison_Riske-Julia_Goerges,1,S-DTM,4,0,0,0,0,2,2
20200929-W-Roland_Garros-R128-Alison_Riske-Julia_Goerges,2,F-XC,37,12,4,3,5,20,17
20200929-W-Roland_Garros-R128-Alison_Riske-Julia_Goerges,2,F-DTM,17,0,0,0,0,4,13
20200929-W-Roland_Garros-R128-Alison_Riske-Julia_Goerges,2,F-DTL,17,9,3,1,5,9,8
20200929-W-Roland_Garros-R128-Alison_Riske-Julia_Goerges,2,F-IO,27,14,7,1,6,15,12
20200929-W-Roland_Garros-R128-Alison_Riske-Julia_Goerges,2,F-II,6,4,2,2,0,6,0
20200929-W-Roland_Garros-R128-Alison_Riske-Julia_Goerges,2,B-XC,14,6,3,0,3,8,6
20200929-W-Roland_Garros-R128-Alison_Riske-Julia_Goerges,2,B-DTM,17,2,0,0,2,7,10
20200929-W-Roland_Garros-R128-Alison_Riske-Julia_Goerges,2,B-DTL,25,18,8,0,10,13,12
20200929-W-Roland_Garros-R128-Alison_Riske-Julia_Goerges,2,B-IO,6,3,2,1,0,6,0
20200929-W-Roland_Garros-R128-Alison_Riske-Julia_Goerges,2,S-XC,2,1,0,0,1,0,2
20200929-W-Roland_Garros-R128-Alison_Riske-Julia_Goerges,2,S-DTM,4,0,0,0,0,2,2
20210616-W-Berlin-R16-Alize_Cornet-Bianca_Andreescu,1,F-XC,37,10,4,3,3,21,16
20210616-W-Berlin-R16-Alize_Cornet-Bianca_Andreescu,1,F-DTM,33,3,0,0,3,9,24
20210616-W-Berlin-R16-Alize_Cornet-Bianca_Andreescu,1,F-DTL,14,5,3,2,0,9,5
20210616-W-Berlin-R16-Alize_Cornet-Bianca_Andreescu,1,F-IO,24,6,2,1,3,16,8
20210616-W-Berlin-R16-Alize_Cornet-Bianca_Andreescu,1,B-XC,27,6,2,1,3,18,9
20210616-W-Berlin-R16-Alize_Cornet-Bianca_Andreescu,1,B-DTM,34,2,0,0,2,19,15
20210616-W-Berlin-R16-Alize_Cornet-Bianca_Andreescu,1,B-DTL,3,2,2,0,0,3,0
20210616-W-Berlin-R16-Alize_Cornet-Bianca_Andreescu,1,B-IO,1,1,1,0,0,1,0
20210616-W-Berlin-R16-Alize_Cornet-Bianca_Andreescu,1,S-XC,7,1,0,0,1,3,4
20210616-W-Berlin-R16-Alize_Cornet-Bianca_Andreescu,1,S-DTM,5,1,0,1,0,2,3
20210616-W-Berlin-R16-Alize_Cornet-Bianca_Andreescu,2,F-XC,30,6,2,0,4,17,13
20210616-W-Berlin-R16-Alize_Cornet-Bianca_Andreescu,2,F-DTM,32,4,0,1,3,18,14
20210616-W-Berlin-R16-Alize_Cornet-Bianca_Andreescu,2,F-DTL,8,5,1,3,1,6,2
20210616-W-Berlin-R16-Alize_Cornet-Bianca_Andreescu,2,F-IO,18,9,3,3,3,11,7
20210616-W-Berlin-R16-Alize_Cornet-Bianca_Andreescu,2,B-XC,21,3,1,1,1,12,9
20210616-W-Berlin-R16-Alize_Cornet-Bianca_Andreescu,2,B-DTM,31,4,0,0,4,13,18
20210616-W-Berlin-R16-Alize_Cornet-Bianca_Andreescu,2,B-DTL,11,5,3,0,2,7,4
20210616-W-Berlin-R16-Alize_Cornet-Bianca_Andreescu,2,B-IO,7,3,1,2,0,7,0
20210616-W-Berlin-R16-Alize_Cornet-Bianca_Andreescu,2,S-XC,1,0,0,0,0,0,1
20210616-W-Berlin-R16-Alize_Cornet-Bianca_Andreescu,2,S-DTM,14,3,0,0,3,4,10
20210616-W-Berlin-R16-Alize_Cornet-Bianca_Andreescu,2,S-DTL,6,1,0,1,0,2,4
20210616-W-Berlin-R16-Alize_Cornet-Bianca_Andreescu,2,S-IO,3,1,0,0,1,1,2
20210417-W-BJK_Cup-RR-Magdalena_Frech-Laura_Pigossi,1,F-XC,87,11,4,2,5,54,33
20210417-W-BJK_Cup-RR-Magdalena_Frech-Laura_Pigossi,1,F-DTM,66,3,0,0,3,33,33
20210417-W-BJK_Cup-RR-Magdalena_Frech-Laura_Pigossi,1,F-DTL,33,7,1,2,4,16,17
20210417-W-BJK_Cup-RR-Magdalena_Frech-Laura_Pigossi,1,F-IO,66,18,7,2,9,35,31
20210417-W-BJK_Cup-RR-Magdalena_Frech-Laura_Pigossi,1,F-II,1,1,1,0,0,1,0
20210417-W-BJK_Cup-RR-Magdalena_Frech-Laura_Pigossi,1,B-XC,112,9,2,1,6,62,50
20210417-W-BJK_Cup-RR-Magdalena_Frech-Laura_Pigossi,1,B-DTM,56,4,0,0,4,28,28
20210417-W-BJK_Cup-RR-Magdalena_Frech-Laura_Pigossi,1,B-DTL,19,12,3,3,6,8,11
20210417-W-BJK_Cup-RR-Magdalena_Frech-Laura_Pigossi,1,B-IO,14,4,0,2,2,8,6
20210417-W-BJK_Cup-RR-Magdalena_Frech-Laura_Pigossi,1,S-XC,19,0,0,0,0,7,12
20210417-W-BJK_Cup-RR-Magdalena_Frech-Laura_Pigossi,1,S-DTM,17,0,0,0,0,6,11
20210417-W-BJK_Cup-RR-Magdalena_Frech-Laura_Pigossi,1,S-DTL,1,0,0,0,0,0,1
20210417-W-BJK_Cup-RR-Magdalena_Frech-Laura_Pigossi,2,F-XC,93,16,6,3,7,41,52
20210417-W-BJK_Cup-RR-Magdalena_Frech-Laura_Pigossi,2,F-DTM,61,4,0,2,2,24,37
20210417-W-BJK_Cup-RR-Magdalena_Frech-Laura_Pigossi,2,F-DTL,19,8,2,1,5,10,9
20210417-W-BJK_Cup-RR-Magdalena_Frech-Laura_Pigossi,2,F-IO,73,14,6,3,5,41,32
20210417-W-BJK_Cup-RR-Magdalena_Frech-Laura_Pigossi,2,F-II,11,1,0,1,0,9,2
20210417-W-BJK_Cup-RR-Magdalena_Frech-Laura_Pigossi,2,B-XC,95,17,3,5,9,53,42
20210417-W-BJK_Cup-RR-Magdalena_Frech-Laura_Pigossi,2,B-DTM,89,5,0,0,5,29,60
20210417-W-BJK_Cup-RR-Magdalena_Frech-Laura_Pigossi,2,B-DTL,22,9,0,5,4,13,9
20210417-W-BJK_Cup-RR-Magdalena_Frech-Laura_Pigossi,2,B-IO,8,0,0,0,0,4,4
20210417-W-BJK_Cup-RR-Magdalena_Frech-Laura_Pigossi,2,S-XC,5,1,0,0,1,1,4
20210417-W-BJK_Cup-RR-Magdalena_Frech-Laura_Pigossi,2,S-DTM,9,0,0,0,0,3,6
20210417-W-BJK_Cup-RR-Magdalena_Frech-Laura_Pigossi,2,S-DTL,7,1,0,1,0,2,5
20210417-W-BJK_Cup-RR-Magdalena_Frech-Laura_Pigossi,2,S-IO,1,0,0,0,0,1,0
20210612-W-Bol-F-Arantxa_Rus-Jasmine_Paolini,1,F-XC,45,10,4,2,4,26,19
20210612-W-Bol-F-Arantxa_Rus-Jasmine_Paolini,1,F-DTM,49,2,0,0,2,19,30
20210612-W-Bol-F-Arantxa_Rus-Jasmine_Paolini,1,F-DTL,16,7,4,1,2,9,7
20210612-W-Bol-F-Arantxa_Rus-Jasmine_Paolini,1,F-IO,30,6,1,2,3,18,12
20210612-W-Bol-F-Arantxa_Rus-Jasmine_Paolini,1,F-II,2,1,0,0,1,1,1
20210612-W-Bol-F-Arantxa_Rus-Jasmine_Paolini,1,B-XC,30,3,0,0,3,14,16
20210612-W-Bol-F-Arantxa_Rus-Jasmine_Paolini,1,B-DTM,34,2,0,0,2,13,21
20210612-W-Bol-F-Arantxa_Rus-Jasmine_Paolini,1,B-DTL,7,5,0,1,4,1,6
20210612-W-Bol-F-Arantxa_Rus-Jasmine_Paolini,1,B-IO,13,2,0,0,2,5,8
20210612-W-Bol-F-Arantxa_Rus-Jasmine_Paolini,1,S-XC,1,0,0,0,0,0,1
20210612-W-Bol-F-Arantxa_Rus-Jasmine_Paolini,1,S-DTM,3,0,0,0,0,1,2
20210612-W-Bol-F-Arantxa_Rus-Jasmine_Paolini,1,S-DTL,2,0,0,0,0,0,2
20210612-W-Bol-F-Arantxa_Rus-Jasmine_Paolini,1,S-IO,3,1,0,1,0,3,0
20210612-W-Bol-F-Arantxa_Rus-Jasmine_Paolini,2,F-XC,62,13,2,4,7,40,22
20210612-W-Bol-F-Arantxa_Rus-Jasmine_Paolini,2,F-DTM,42,2,0,1,1,20,22
20210612-W-Bol-F-Arantxa_Rus-Jasmine_Paolini,2,F-DTL,9,6,0,2,4,3,6
20210612-W-Bol-F-Arantxa_Rus-Jasmine_Paolini,2,F-IO,28,12,6,1,5,17,11
20210612-W-Bol-F-Arantxa_Rus-Jasmine_Paolini,2,F-II,4,1,1,0,0,3,1
20210612-W-Bol-F-Arantxa_Rus-Jasmine_Paolini,2,B-XC,32,8,3,2,3,19,13
20210612-W-Bol-F-Arantxa_Rus-Jasmine_Paolini,2,B-DTM,34,1,0,0,1,15,19
20210612-W-Bol-F-Arantxa_Rus-Jasmine_Paolini,2,B-DTL,6,3,1,0,2,4,2
20210612-W-Bol-F-Arantxa_Rus-Jasmine_Paolini,2,B-IO,10,1,0,0,1,4,6
20210612-W-Bol-F-Arantxa_Rus-Jasmine_Paolini,2,S-DTM,6,0,0,0,0,2,4
20210628-W-Wimbledon-R128-Su_Wei_Hsieh-Iga_Swiatek,1,F-XC,21,1,0,0,1,13,8
20210628-W-Wimbledon-R128-Su_Wei_Hsieh-Iga_Swiatek,1,F-DTM,9,2,0,2,0,6,3
20210628-W-Wimbledon-R128-Su_Wei_Hsieh-Iga_Swiatek,1,F-DTL,3,1,0,1,0,3,0
20210628-W-Wimbledon-R128-Su_Wei_Hsieh-Iga_Swiatek,1,F-IO,3,0,0,0,0,2,1
20210628-W-Wimbledon-R128-Su_Wei_Hsieh-Iga_Swiatek,1,B-XC,23,4,0,1,3,5,18
20210628-W-Wimbledon-R128-Su_Wei_Hsieh-Iga_Swiatek,1,B-DTM,9,1,0,1,0,8,1
20210628-W-Wimbledon-R128-Su_Wei_Hsieh-Iga_Swiatek,1,B-DTL,9,6,2,2,2,5,4
20210628-W-Wimbledon-R128-Su_Wei_Hsieh-Iga_Swiatek,1,B-IO,6,3,2,0,1,4,2
20210628-W-Wimbledon-R128-Su_Wei_Hsieh-Iga_Swiatek,1,S-XC,4,1,0,0,1,1,3
20210628-W-Wimbledon-R128-Su_Wei_Hsieh-Iga_Swiatek,1,S-DTM,5,0,0,0,0,1,4
20210628-W-Wimbledon-R128-Su_Wei_Hsieh-Iga_Swiatek,1,S-DTL,1,0,0,0,0,1,0
20210628-W-Wimbledon-R128-Su_Wei_Hsieh-Iga_Swiatek,2,F-XC,22,10,2,5,3,10,12
20210628-W-Wimbledon-R128-Su_Wei_Hsieh-Iga_Swiatek,2,F-DTM,14,1,0,0,1,5,9
20210628-W-Wimbledon-R128-Su_Wei_Hsieh-Iga_Swiatek,2,F-DTL,6,3,0,1,2,4,2
20210628-W-Wimbledon-R128-Su_Wei_Hsieh-Iga_Swiatek,2,F-IO,8,2,2,0,0,6,2
20210628-W-Wimbledon-R128-Su_Wei_Hsieh-Iga_Swiatek,2,B-XC,21,6,1,3,2,14,7
20210628-W-Wimbledon-R128-Su_Wei_Hsieh-Iga_Swiatek,2,B-DTM,13,4,0,2,2,6,7
20210628-W-Wimbledon-R128-Su_Wei_Hsieh-Iga_Swiatek,2,B-DTL,8,4,1,1,2,6,2
20210628-W-Wimbledon-R128-Su_Wei_Hsieh-Iga_Swiatek,2,B-IO,2,2,2,0,0,2,0
20210628-W-Wimbledon-R128-Su_Wei_Hsieh-Iga_Swiatek,2,S-XC,6,0,0,0,0,2,4
20210629-W-Wimbledon-R128-Ashleigh_Barty-Carla_Suarez_Navarro,1,F-XC,46,20,6,7,7,27,19
20210629-W-Wimbledon-R128-Ashleigh_Barty-Carla_Suarez_Navarro,1,F-DTM,27,4,0,1,3,9,18
20210629-W-Wimbledon-R128-Ashleigh_Barty-Carla_Suarez_Navarro,1,F-DTL,2,1,1,0,0,1,1
20210629-W-Wimbledon-R128-Ashleigh_Barty-Carla_Suarez_Navarro,1,F-IO,19,5,3,0,2,16,3
20210629-W-Wimbledon-R128-Ashleigh_Barty-Carla_Suarez_Navarro,1,F-II,4,1,1,0,0,4,0
20210629-W-Wimbledon-R128-Ashleigh_Barty-Carla_Suarez_Navarro,1,B-XC,13,3,2,0,1,10,3
20210629-W-Wimbledon-R128-Ashleigh_Barty-Carla_Suarez_Navarro,1,B-DTM,13,4,1,0,3,8,5
20210629-W-Wimbledon-R128-Ashleigh_Barty-Carla_Suarez_Navarro,1,B-DTL,3,0,0,0,0,2,1
20210629-W-Wimbledon-R128-Ashleigh_Barty-Carla_Suarez_Navarro,1,B-IO,2,1,0,1,0,1,1
20210629-W-Wimbledon-R128-Ashleigh_Barty-Carla_Suarez_Navarro,1,S-XC,34,3,0,2,1,17,17
20210629-W-Wimbledon-R128-Ashleigh_Barty-Carla_Suarez_Navarro,1,S-DTM,30,6,1,0,5,10,20
20210629-W-Wimbledon-R128-Ashleigh_Barty-Carla_Suarez_Navarro,1,S-DTL,11,5,1,1,3,5,6
20210629-W-Wimbledon-R128-Ashleigh_Barty-Carla_Suarez_Navarro,1,S-IO,3,1,0,0,1,2,1
20210629-W-Wimbledon-R128-Ashleigh_Barty-Carla_Suarez_Navarro,2,F-XC,28,7,3,2,2,18,10
20210629-W-Wimbledon-R128-Ashleigh_Barty-Carla_Suarez_Navarro,2,F-DTM,27,5,0,0,5,9,18
20210629-W-Wimbledon-R128-Ashleigh_Barty-Carla_Suarez_Navarro,2,F-DTL,14,6,1,3,2,7,7
20210629-W-Wimbledon-R128-Ashleigh_Barty-Carla_Suarez_Navarro,2,F-IO,28,6,2,2,2,15,13
20210629-W-Wimbledon-R128-Ashleigh_Barty-Carla_Suarez_Navarro,2,B-XC,33,4,1,1,2,20,13
20210629-W-Wimbledon-R128-Ashleigh_Barty-Carla_Suarez_Navarro,2,B-DTM,23,1,0,0,1,8,15
20210629-W-Wimbledon-R128-Ashleigh_Barty-Carla_Suarez_Navarro,2,B-DTL,4,3,0,1,2,1,3
20210629-W-Wimbledon-R128-Ashleigh_Barty-Carla_Suarez_Navarro,2,B-IO,4,2,1,0,1,3,1
20210629-W-Wimbledon-R128-Ashleigh_Barty-Carla_Suarez_Navarro,2,S-XC,26,4,0,1,3,10,16
20210629-W-Wimbledon-R128-Ashleigh_Barty-Carla_Suarez_Navarro,2,S-DTM,12,2,0,0,2,2,10
20210629-W-Wimbledon-R128-Ashleigh_Barty-Carla_Suarez_Navarro,2,S-DTL,4,1,0,1,0,3,1
20210629-W-Wimbledon-R128-Ashleigh_Barty-Carla_Suarez_Navarro,2,S-IO,4,1,0,1,0,2,2
20210629-W-Wimbledon-R128-Svetlana_Kuznetsova-Lesley_Kerkhove,1,F-XC,25,6,2,0,4,8,17
20210629-W-Wimbledon-R128-Svetlana_Kuznetsova-Lesley_Kerkhove,1,F-DTM,21,6,1,0,5,7,14
20210629-W-Wimbledon-R128-Svetlana_Kuznetsova-Lesley_Kerkhove,1,F-DTL,6,2,0,0,2,1,5
20210629-W-Wimbledon-R128-Svetlana_Kuznetsova-Lesley_Kerkhove,1,F-IO,7,1,0,1,0,3,4
20210629-W-Wimbledon-R128-Svetlana_Kuznetsova-Lesley_Kerkhove,1,B-XC,12,2,0,0,2,6,6
20210629-W-Wimbledon-R128-Svetlana_Kuznetsova-Lesley_Kerkhove,1,B-DTM,9,0,0,0,0,3,6
20210629-W-Wimbledon-R128-Svetlana_Kuznetsova-Lesley_Kerkhove,1,B-DTL,3,2,1,1,0,3,0
20210629-W-Wimbledon-R128-Svetlana_Kuznetsova-Lesley_Kerkhove,1,B-IO,2,0,0,0,0,0,2
20210629-W-Wimbledon-R128-Svetlana_Kuznetsova-Lesley_Kerkhove,1,S-XC,2,1,0,0,1,1,1
20210629-W-Wimbledon-R128-Svetlana_Kuznetsova-Lesley_Kerkhove,1,S-DTM,12,1,0,0,1,4,8
20210629-W-Wimbledon-R128-Svetlana_Kuznetsova-Lesley_Kerkhove,2,F-XC,27,6,1,3,2,19,8
20210629-W-Wimbledon-R128-Svetlana_Kuznetsova-Lesley_Kerkhove,2,F-DTM,17,2,0,0,2,10,7
20210629-W-Wimbledon-R128-Svetlana_Kuznetsova-Lesley_Kerkhove,2,F-DTL,9,5,4,1,0,8,1
20210629-W-Wimbledon-R128-Svetlana_Kuznetsova-Lesley_Kerkhove,2,F-IO,15,8,1,4,3,9,6
20210629-W-Wimbledon-R128-Svetlana_Kuznetsova-Lesley_Kerkhove,2,B-XC,16,5,1,0,4,4,12
20210629-W-Wimbledon-R128-Svetlana_Kuznetsova-Lesley_Kerkhove,2,B-DTM,21,3,0,0,3,15,6
20210629-W-Wimbledon-R128-Svetlana_Kuznetsova-Lesley_Kerkhove,2,B-DTL,5,3,0,2,1,3,2
20210629-W-Wimbledon-R128-Svetlana_Kuznetsova-Lesley_Kerkhove,2,B-IO,4,3,2,0,1,3,1
20210629-W-Wimbledon-R128-Svetlana_Kuznetsova-Lesley_Kerkhove,2,S-DTM,1,0,0,0,0,0,1
20210630-W-Wimbledon-R128-Bianca_Andreescu-Alize_Cornet,1,F-XC,28,11,2,3,6,12,16
20210630-W-Wimbledon-R128-Bianca_Andreescu-Alize_Cornet,1,F-DTM,15,4,0,2,2,6,9
20210630-W-Wimbledon-R128-Bianca_Andreescu-Alize_Cornet,1,F-DTL,1,1,0,0,1,0,1
20210630-W-Wimbledon-R128-Bianca_Andreescu-Alize_Cornet,1,F-IO,8,4,2,0,2,6,2
20210630-W-Wimbledon-R128-Bianca_Andreescu-Alize_Cornet,1,B-XC,23,10,3,4,3,12,11
20210630-W-Wimbledon-R128-Bianca_Andreescu-Alize_Cornet,1,B-DTM,35,4,0,0,3,11,24
20210630-W-Wimbledon-R128-Bianca_Andreescu-Alize_Cornet,1,B-DTL,7,2,0,0,2,3,4
20210630-W-Wimbledon-R128-Bianca_Andreescu-Alize_Cornet,1,B-IO,5,3,0,0,3,1,4
20210630-W-Wimbledon-R128-Bianca_Andreescu-Alize_Cornet,1,S-XC,2,1,0,0,1,0,2
20210630-W-Wimbledon-R128-Bianca_Andreescu-Alize_Cornet,1,S-DTM,3,0,0,0,0,2,1
20210630-W-Wimbledon-R128-Bianca_Andreescu-Alize_Cornet,1,S-DTL,1,0,0,0,0,0,1
20210630-W-Wimbledon-R128-Bianca_Andreescu-Alize_Cornet,2,F-XC,26,5,1,2,2,15,11
20210630-W-Wimbledon-R128-Bianca_Andreescu-Alize_Cornet,2,F-DTM,16,0,0,0,0,7,9
20210630-W-Wimbledon-R128-Bianca_Andreescu-Alize_Cornet,2,F-DTL,8,3,2,1,0,3,5
20210630-W-Wimbledon-R128-Bianca_Andreescu-Alize_Cornet,2,F-IO,23,5,1,1,3,16,7
20210630-W-Wimbledon-R128-Bianca_Andreescu-Alize_Cornet,2,B-XC,18,1,0,1,0,13,5
20210630-W-Wimbledon-R128-Bianca_Andreescu-Alize_Cornet,2,B-DTM,20,0,0,0,0,11,9
20210630-W-Wimbledon-R128-Bianca_Andreescu-Alize_Cornet,2,B-DTL,2,0,0,0,0,0,2
20210630-W-Wimbledon-R128-Bianca_Andreescu-Alize_Cornet,2,B-IO,2,1,1,0,0,2,0
20210630-W-Wimbledon-R128-Bianca_Andreescu-Alize_Cornet,2,S-DTM,3,1,0,1,0,2,1
20210630-W-Wimbledon-R128-Bianca_Andreescu-Alize_Cornet,2,S-DTL,1,0,0,0,0,0,1
20210630-W-Wimbledon-R128-Bianca_Andreescu-Alize_Cornet,2,S-IO,1,0,0,0,0,1,0
20210615-W-Berlin-R32-Elena_Rybakina-Shelby_Rogers,1,F-XC,32,15,3,2,10,12,20
20210615-W-Berlin-R32-Elena_Rybakina-Shelby_Rogers,1,F-DTM,8,1,0,0,1,3,5
20210615-W-Berlin-R32-Elena_Rybakina-Shelby_Rogers,1,F-DTL,11,8,5,0,3,7,4
20210615-W-Berlin-R32-Elena_Rybakina-Shelby_Rogers,1,F-IO,17,8,4,1,3,10,7
20210615-W-Berlin-R32-Elena_Rybakina-Shelby_Rogers,1,B-XC,27,10,2,4,4,12,15
20210615-W-Berlin-R32-Elena_Rybakina-Shelby_Rogers,1,B-DTM,17,2,0,0,2,5,12
20210615-W-Berlin-R32-Elena_Rybakina-Shelby_Rogers,1,B-DTL,8,4,3,0,1,6,2
20210615-W-Berlin-R32-Elena_Rybakina-Shelby_Rogers,1,B-IO,9,6,0,4,2,5,4
20210615-W-Berlin-R32-Elena_Rybakina-Shelby_Rogers,1,S-XC,1,0,0,0,0,0,1
20210615-W-Berlin-R32-Elena_Rybakina-Shelby_Rogers,1,S-DTM,3,1,0,0,1,1,2
20210615-W-Berlin-R32-Elena_Rybakina-Shelby_Rogers,1,S-DTL,1,0,0,0,0,1,0
20210615-W-Berlin-R32-Elena_Rybakina-Shelby_Rogers,1,S-IO,2,1,0,0,1,0,2
20210615-W-Berlin-R32-Elena_Rybakina-Shelby_Rogers,2,F-XC,17,5,2,2,1,10,7
20210615-W-Berlin-R32-Elena_Rybakina-Shelby_Rogers,2,F-DTM,21,2,0,1,1,15,6
20210615-W-Berlin-R32-Elena_Rybakina-Shelby_Rogers,2,F-DTL,6,3,1,1,1,4,2
20210615-W-Berlin-R32-Elena_Rybakina-Shelby_Rogers,2,F-IO,8,1,1,0,0,5,3
20210615-W-Berlin-R32-Elena_Rybakina-Shelby_Rogers,2,B-XC,14,4,1,1,2,8,6
20210615-W-Berlin-R32-Elena_Rybakina-Shelby_Rogers,2,B-DTM,20,4,0,0,4,11,9
20210615-W-Berlin-R32-Elena_Rybakina-Shelby_Rogers,2,B-DTL,7,4,2,1,1,3,4
20210615-W-Berlin-R32-Elena_Rybakina-Shelby_Rogers,2,B-IO,4,1,0,0,1,2,2
20210615-W-Berlin-R32-Elena_Rybakina-Shelby_Rogers,2,S-XC,3,0,0,0,0,1,2
20210615-W-Berlin-R32-Elena_Rybakina-Shelby_Rogers,2,S-DTM,13,1,0,0,1,8,5
20210401-W-Miami-SF-Elina_Svitolina-Ashleigh_Barty,1,F-XC,24,5,2,1,2,8,16
20210401-W-Miami-SF-Elina_Svitolina-Ashleigh_Barty,1,F-DTM,34,2,0,0,2,16,18
20210401-W-Miami-SF-Elina_Svitolina-Ashleigh_Barty,1,F-DTL,15,4,0,0,4,3,12
20210401-W-Miami-SF-Elina_Svitolina-Ashleigh_Barty,1,F-IO,21,6,0,3,3,13,8
20210401-W-Miami-SF-Elina_Svitolina-Ashleigh_Barty,1,B-XC,51,7,1,2,4,23,28
20210401-W-Miami-SF-Elina_Svitolina-Ashleigh_Barty,1,B-DTM,24,4,0,0,4,9,15
20210401-W-Miami-SF-Elina_Svitolina-Ashleigh_Barty,1,B-DTL,9,6,2,2,2,5,4
20210401-W-Miami-SF-Elina_Svitolina-Ashleigh_Barty,1,B-IO,8,3,0,1,2,4,4
20210401-W-Miami-SF-Elina_Svitolina-Ashleigh_Barty,1,S-XC,7,0,0,0,0,4,3
20210401-W-Miami-SF-Elina_Svitolina-Ashleigh_Barty,1,S-DTM,4,0,0,0,0,1,3
20210401-W-Miami-SF-Elina_Svitolina-Ashleigh_Barty,1,S-DTL,1,0,0,0,0,1,0
20210401-W-Miami-SF-Elina_Svitolina-Ashleigh_Barty,2,F-XC,46,15,6,2,7,27,19
20210401-W-Miami-SF-Elina_Svitolina-Ashleigh_Barty,2,F-DTM,19,2,0,0,2,9,10
20210401-W-Miami-SF-Elina_Svitolina-Ashleigh_Barty,2,F-DTL,10,5,4,0,1,8,2
20210401-W-Miami-SF-Elina_Svitolina-Ashleigh_Barty,2,F-IO,36,9,3,2,4,16,20
20210401-W-Miami-SF-Elina_Svitolina-Ashleigh_Barty,2,F-II,5,1,0,0,1,2,3
20210401-W-Miami-SF-Elina_Svitolina-Ashleigh_Barty,2,B-XC,8,2,1,0,1,5,3
20210401-W-Miami-SF-Elina_Svitolina-Ashleigh_Barty,2,B-DTM,18,1,0,1,0,11,7
20210401-W-Miami-SF-Elina_Svitolina-Ashleigh_Barty,2,B-DTL,5,3,0,1,2,3,2
20210401-W-Miami-SF-Elina_Svitolina-Ashleigh_Barty,2,S-XC,25,3,0,1,2,13,12
20210401-W-Miami-SF-Elina_Svitolina-Ashleigh_Barty,2,S-DTM,27,2,0,0,2,11,16
20210401-W-Miami-SF-Elina_Svitolina-Ashleigh_Barty,2,S-DTL,9,3,0,1,2,5,4
20210401-W-Miami-SF-Elina_Svitolina-Ashleigh_Barty,2,S-IO,1,0,0,0,0,1,0
20210513-W-Rome-R16-Iga_Swiatek-Barbora_Krejcikova,1,F-XC,49,16,10,1,5,27,22
20210513-W-Rome-R16-Iga_Swiatek-Barbora_Krejcikova,1,F-DTM,11,3,0,1,2,6,5
20210513-W-Rome-R16-Iga_Swiatek-Barbora_Krejcikova,1,F-DTL,11,6,4,0,2,7,4
20210513-W-Rome-R16-Iga_Swiatek-Barbora_Krejcikova,1,F-IO,20,12,4,0,8,9,11
20210513-W-Rome-R16-Iga_Swiatek-Barbora_Krejcikova,1,F-II,2,2,1,0,1,1,1
20210513-W-Rome-R16-Iga_Swiatek-Barbora_Krejcikova,1,B-XC,67,16,3,3,10,35,32
20210513-W-Rome-R16-Iga_Swiatek-Barbora_Krejcikova,1,B-DTM,30,6,1,0,5,18,12
20210513-W-Rome-R16-Iga_Swiatek-Barbora_Krejcikova,1,B-DTL,30,13,4,2,7,18,12
20210513-W-Rome-R16-Iga_Swiatek-Barbora_Krejcikova,1,B-IO,12,7,2,2,3,6,6
20210513-W-Rome-R16-Iga_Swiatek-Barbora_Krejcikova,1,S-XC,4,1,0,0,1,1,3
20210513-W-Rome-R16-Iga_Swiatek-Barbora_Krejcikova,1,S-DTM,3,0,0,0,0,0,3
20210513-W-Rome-R16-Iga_Swiatek-Barbora_Krejcikova,2,F-XC,37,13,3,2,8,17,20
20210513-W-Rome-R16-Iga_Swiatek-Barbora_Krejcikova,2,F-DTM,19,1,0,0,1,7,12
20210513-W-Rome-R16-Iga_Swiatek-Barbora_Krejcikova,2,F-DTL,9,4,0,1,3,4,5
20210513-W-Rome-R16-Iga_Swiatek-Barbora_Krejcikova,2,F-IO,24,7,4,1,2,14,10
20210513-W-Rome-R16-Iga_Swiatek-Barbora_Krejcikova,2,B-XC,55,7,3,0,4,28,27
20210513-W-Rome-R16-Iga_Swiatek-Barbora_Krejcikova,2,B-DTM,37,7,0,1,6,18,19
20210513-W-Rome-R16-Iga_Swiatek-Barbora_Krejcikova,2,B-DTL,10,7,4,1,2,5,5
20210513-W-Rome-R16-Iga_Swiatek-Barbora_Krejcikova,2,B-IO,7,6,4,1,1,6,1
20210513-W-Rome-R16-Iga_Swiatek-Barbora_Krejcikova,2,S-XC,12,3,0,0,3,5,7
20210513-W-Rome-R16-Iga_Swiatek-Barbora_Krejcikova,2,S-DTM,6,2,0,1,1,2,4
20210513-W-Rome-R16-Iga_Swiatek-Barbora_Krejcikova,2,S-DTL,2,0,0,0,0,0,2
20210701-W-Wimbledon-R64-Andrea_Petkovic-Barbora_Krejcikova,1,F-XC,20,9,2,4,3,9,11
20210701-W-Wimbledon-R64-Andrea_Petkovic-Barbora_Krejcikova,1,F-DTM,11,2,0,0,2,4,7
20210701-W-Wimbledon-R64-Andrea_Petkovic-Barbora_Krejcikova,1,F-DTL,4,3,2,0,1,3,1
20210701-W-Wimbledon-R64-Andrea_Petkovic-Barbora_Krejcikova,1,F-IO,12,4,2,1,1,6,6
20210701-W-Wimbledon-R64-Andrea_Petkovic-Barbora_Krejcikova,1,B-XC,16,1,0,0,1,5,11
20210701-W-Wimbledon-R64-Andrea_Petkovic-Barbora_Krejcikova,1,B-DTM,25,5,0,0,5,12,13
20210701-W-Wimbledon-R64-Andrea_Petkovic-Barbora_Krejcikova,1,B-DTL,4,0,0,0,0,1,3
20210701-W-Wimbledon-R64-Andrea_Petkovic-Barbora_Krejcikova,1,B-IO,4,3,0,0,3,0,4
20210701-W-Wimbledon-R64-Andrea_Petkovic-Barbora_Krejcikova,1,S-XC,3,0,0,0,0,2,1
20210701-W-Wimbledon-R64-Andrea_Petkovic-Barbora_Krejcikova,1,S-DTM,3,0,0,0,0,0,3
20210701-W-Wimbledon-R64-Andrea_Petkovic-Barbora_Krejcikova,1,S-DTL,2,0,0,0,0,0,2
20210701-W-Wimbledon-R64-Andrea_Petkovic-Barbora_Krejcikova,2,F-XC,26,13,5,4,4,19,7
20210701-W-Wimbledon-R64-Andrea_Petkovic-Barbora_Krejcikova,2,F-DTM,10,1,0,0,1,7,3
20210701-W-Wimbledon-R64-Andrea_Petkovic-Barbora_Krejcikova,2,F-DTL,5,3,2,1,0,5,0
20210701-W-Wimbledon-R64-Andrea_Petkovic-Barbora_Krejcikova,2,F-IO,10,4,2,0,2,4,6
20210701-W-Wimbledon-R64-Andrea_Petkovic-Barbora_Krejcikova,2,B-XC,17,5,1,2,2,14,3
20210701-W-Wimbledon-R64-Andrea_Petkovic-Barbora_Krejcikova,2,B-DTM,23,8,0,2,6,12,11
20210701-W-Wimbledon-R64-Andrea_Petkovic-Barbora_Krejcikova,2,B-DTL,3,3,1,0,2,1,2
20210701-W-Wimbledon-R64-Andrea_Petkovic-Barbora_Krejcikova,2,B-IO,4,2,0,0,2,0,4
20210701-W-Wimbledon-R64-Andrea_Petkovic-Barbora_Krejcikova,2,S-XC,7,2,0,0,1,5,2
20210701-W-Wimbledon-R64-Andrea_Petkovic-Barbora_Krejcikova,2,S-DTM,2,0,0,0,0,0,2
20210630-W-Wimbledon-R128-Leylah_Annie_Fernandez-Jelena_Ostapenko,1,F-XC,11,0,0,0,0,3,8
20210630-W-Wimbledon-R128-Leylah_Annie_Fernandez-Jelena_Ostapenko,1,F-DTM,12,2,0,1,1,3,9
20210630-W-Wimbledon-R128-Leylah_Annie_Fernandez-Jelena_Ostapenko,1,F-DTL,3,2,1,0,1,2,1
20210630-W-Wimbledon-R128-Leylah_Annie_Fernandez-Jelena_Ostapenko,1,F-IO,5,1,0,0,1,2,3
20210630-W-Wimbledon-R128-Leylah_Annie_Fernandez-Jelena_Ostapenko,1,B-XC,7,4,0,1,3,2,5
20210630-W-Wimbledon-R128-Leylah_Annie_Fernandez-Jelena_Ostapenko,1,B-DTM,9,1,0,0,1,0,9
20210630-W-Wimbledon-R128-Leylah_Annie_Fernandez-Jelena_Ostapenko,1,B-DTL,5,1,0,0,1,2,3
20210630-W-Wimbledon-R128-Leylah_Annie_Fernandez-Jelena_Ostapenko,1,B-IO,4,1,1,0,0,2,2
20210630-W-Wimbledon-R128-Leylah_Annie_Fernandez-Jelena_Ostapenko,1,S-DTM,5,1,0,0,1,1,4
20210630-W-Wimbledon-R128-Leylah_Annie_Fernandez-Jelena_Ostapenko,1,S-DTL,3,0,0,0,0,0,3
20210630-W-Wimbledon-R128-Leylah_Annie_Fernandez-Jelena_Ostapenko,1,S-IO,2,2,1,0,1,1,1
20210630-W-Wimbledon-R128-Leylah_Annie_Fernandez-Jelena_Ostapenko,2,F-XC,17,6,2,2,2,13,4
20210630-W-Wimbledon-R128-Leylah_Annie_Fernandez-Jelena_Ostapenko,2,F-DTM,4,0,0,0,0,3,1
20210630-W-Wimbledon-R128-Leylah_Annie_Fernandez-Jelena_Ostapenko,2,F-DTL,1,0,0,0,0,1,0
20210630-W-Wimbledon-R128-Leylah_Annie_Fernandez-Jelena_Ostapenko,2,F-IO,5,3,3,0,0,5,0
20210630-W-Wimbledon-R128-Leylah_Annie_Fernandez-Jelena_Ostapenko,2,B-XC,23,16,4,7,5,14,9
20210630-W-Wimbledon-R128-Leylah_Annie_Fernandez-Jelena_Ostapenko,2,B-DTM,8,1,0,0,1,5,3
20210630-W-Wimbledon-R128-Leylah_Annie_Fernandez-Jelena_Ostapenko,2,B-DTL,6,4,2,2,0,6,0
20210630-W-Wimbledon-R128-Leylah_Annie_Fernandez-Jelena_Ostapenko,2,B-IO,2,1,0,1,0,2,0
20210630-W-Wimbledon-R128-Leylah_Annie_Fernandez-Jelena_Ostapenko,2,S-DTM,1,1,0,0,1,0,1
20210630-W-Wimbledon-R128-Leylah_Annie_Fernandez-Jelena_Ostapenko,2,S-DTL,3,2,0,2,0,3,0
20210702-W-Wimbledon-R32-Sloane_Stephens-Liudmila_Samsonova,1,F-XC,26,8,4,2,2,18,8
20210702-W-Wimbledon-R32-Sloane_Stephens-Liudmila_Samsonova,1,F-DTM,33,6,0,1,5,16,17
20210702-W-Wimbledon-R32-Sloane_Stephens-Liudmila_Samsonova,1,F-DTL,11,4,2,1,1,5,6
20210702-W-Wimbledon-R32-Sloane_Stephens-Liudmila_Samsonova,1,F-IO,12,2,0,1,1,6,6
20210702-W-Wimbledon-R32-Sloane_Stephens-Liudmila_Samsonova,1,B-XC,10,3,0,0,3,5,5
20210702-W-Wimbledon-R32-Sloane_Stephens-Liudmila_Samsonova,1,B-DTM,33,4,0,0,4,14,19
20210702-W-Wimbledon-R32-Sloane_Stephens-Liudmila_Samsonova,1,B-DTL,4,0,0,0,0,2,2
20210702-W-Wimbledon-R32-Sloane_Stephens-Liudmila_Samsonova,1,B-IO,5,3,0,2,1,4,1
20210702-W-Wimbledon-R32-Sloane_Stephens-Liudmila_Samsonova,1,S-XC,1,0,0,0,0,0,1
20210702-W-Wimbledon-R32-Sloane_Stephens-Liudmila_Samsonova,1,S-DTM,9,1,0,0,1,1,8
20210702-W-Wimbledon-R32-Sloane_Stephens-Liudmila_Samsonova,1,S-IO,1,0,0,0,0,1,0
20210702-W-Wimbledon-R32-Sloane_Stephens-Liudmila_Samsonova,2,F-XC,42,13,4,1,8,23,19
20210702-W-Wimbledon-R32-Sloane_Stephens-Liudmila_Samsonova,2,F-DTM,21,9,0,1,8,7,14
20210702-W-Wimbledon-R32-Sloane_Stephens-Liudmila_Samsonova,2,F-DTL,8,5,3,0,2,6,2
20210702-W-Wimbledon-R32-Sloane_Stephens-Liudmila_Samsonova,2,F-IO,20,10,5,1,4,14,6
20210702-W-Wimbledon-R32-Sloane_Stephens-Liudmila_Samsonova,2,B-XC,25,10,2,3,5,11,14
20210702-W-Wimbledon-R32-Sloane_Stephens-Liudmila_Samsonova,2,B-DTM,31,9,0,1,8,10,21
20210702-W-Wimbledon-R32-Sloane_Stephens-Liudmila_Samsonova,2,B-DTL,5,0,0,0,0,2,3
20210702-W-Wimbledon-R32-Sloane_Stephens-Liudmila_Samsonova,2,B-IO,7,6,2,2,2,5,2
20210702-W-Wimbledon-R32-Sloane_Stephens-Liudmila_Samsonova,2,S-XC,1,0,0,0,0,1,0
20210702-W-Wimbledon-R32-Sloane_Stephens-Liudmila_Samsonova,2,S-DTM,1,0,0,0,0,1,0
20210702-W-Wimbledon-R32-Sloane_Stephens-Liudmila_Samsonova,2,S-DTL,1,1,1,0,0,1,0
20210702-W-Wimbledon-R32-Sloane_Stephens-Liudmila_Samsonova,2,S-IO,1,0,0,0,0,0,1
20210702-W-Wimbledon-R32-Iga_Swiatek-Irina_Camelia_Begu,1,F-XC,18,6,3,3,0,17,1
20210702-W-Wimbledon-R32-Iga_Swiatek-Irina_Camelia_Begu,1,F-DTM,9,0,0,0,0,7,2
20210702-W-Wimbledon-R32-Iga_Swiatek-Irina_Camelia_Begu,1,F-DTL,4,3,1,0,2,2,2
20210702-W-Wimbledon-R32-Iga_Swiatek-Irina_Camelia_Begu,1,F-IO,10,3,2,1,0,9,1
20210702-W-Wimbledon-R32-Iga_Swiatek-Irina_Camelia_Begu,1,B-XC,8,1,0,0,1,6,2
20210702-W-Wimbledon-R32-Iga_Swiatek-Irina_Camelia_Begu,1,B-DTM,10,1,0,0,1,8,2
20210702-W-Wimbledon-R32-Iga_Swiatek-Irina_Camelia_Begu,1,B-DTL,6,3,1,1,1,5,1
20210702-W-Wimbledon-R32-Iga_Swiatek-Irina_Camelia_Begu,1,B-IO,3,1,0,1,0,2,1
20210702-W-Wimbledon-R32-Iga_Swiatek-Irina_Camelia_Begu,1,S-XC,3,0,0,0,0,3,0
20210702-W-Wimbledon-R32-Iga_Swiatek-Irina_Camelia_Begu,1,S-DTL,2,0,0,0,0,2,0
20210702-W-Wimbledon-R32-Iga_Swiatek-Irina_Camelia_Begu,2,F-XC,10,2,0,0,2,2,8
20210702-W-Wimbledon-R32-Iga_Swiatek-Irina_Camelia_Begu,2,F-DTM,21,5,1,2,2,5,16
20210702-W-Wimbledon-R32-Iga_Swiatek-Irina_Camelia_Begu,2,F-DTL,3,1,0,0,1,0,3
20210702-W-Wimbledon-R32-Iga_Swiatek-Irina_Camelia_Begu,2,F-IO,9,3,0,0,3,1,8
20210702-W-Wimbledon-R32-Iga_Swiatek-Irina_Camelia_Begu,2,B-XC,12,5,1,0,4,2,10
20210702-W-Wimbledon-R32-Iga_Swiatek-Irina_Camelia_Begu,2,B-DTM,8,1,0,0,1,1,7
20210702-W-Wimbledon-R32-Iga_Swiatek-Irina_Camelia_Begu,2,B-DTL,4,2,0,0,2,0,4
20210702-W-Wimbledon-R32-Iga_Swiatek-Irina_Camelia_Begu,2,B-IO,1,1,0,0,1,0,1
20210702-W-Wimbledon-R32-Iga_Swiatek-Irina_Camelia_Begu,2,S-XC,5,0,0,0,0,0,5
20210702-W-Wimbledon-R32-Iga_Swiatek-Irina_Camelia_Begu,2,S-DTM,3,0,0,0,0,0,3
20210629-W-Wimbledon-R128-Marta_Kostyuk-Kiki_Bertens,1,F-XC,29,5,2,1,2,16,13
20210629-W-Wimbledon-R128-Marta_Kostyuk-Kiki_Bertens,1,F-DTM,17,0,0,0,0,10,7
20210629-W-Wimbledon-R128-Marta_Kostyuk-Kiki_Bertens,1,F-DTL,12,6,2,3,1,10,2
20210629-W-Wimbledon-R128-Marta_Kostyuk-Kiki_Bertens,1,F-IO,26,8,1,4,3,12,14
20210629-W-Wimbledon-R128-Marta_Kostyuk-Kiki_Bertens,1,B-XC,20,5,0,1,4,11,9
20210629-W-Wimbledon-R128-Marta_Kostyuk-Kiki_Bertens,1,B-DTM,20,3,0,1,2,9,11
20210629-W-Wimbledon-R128-Marta_Kostyuk-Kiki_Bertens,1,B-DTL,3,0,0,0,0,2,1
20210629-W-Wimbledon-R128-Marta_Kostyuk-Kiki_Bertens,1,B-IO,1,0,0,0,0,0,1
20210629-W-Wimbledon-R128-Marta_Kostyuk-Kiki_Bertens,1,S-XC,1,0,0,0,0,0,1
20210629-W-Wimbledon-R128-Marta_Kostyuk-Kiki_Bertens,1,S-DTM,3,0,0,0,0,2,1
20210629-W-Wimbledon-R128-Marta_Kostyuk-Kiki_Bertens,1,S-IO,2,1,0,0,1,1,1
20210629-W-Wimbledon-R128-Marta_Kostyuk-Kiki_Bertens,2,F-XC,41,8,4,0,4,21,20
20210629-W-Wimbledon-R128-Marta_Kostyuk-Kiki_Bertens,2,F-DTM,14,2,0,1,1,9,5
20210629-W-Wimbledon-R128-Marta_Kostyuk-Kiki_Bertens,2,F-DTL,14,10,3,1,6,6,8
20210629-W-Wimbledon-R128-Marta_Kostyuk-Kiki_Bertens,2,F-IO,14,6,2,1,3,7,7
20210629-W-Wimbledon-R128-Marta_Kostyuk-Kiki_Bertens,2,F-II,1,1,0,1,0,1,0
20210629-W-Wimbledon-R128-Marta_Kostyuk-Kiki_Bertens,2,B-XC,13,0,0,0,0,6,7
20210629-W-Wimbledon-R128-Marta_Kostyuk-Kiki_Bertens,2,B-DTM,19,1,0,0,1,7,12
20210629-W-Wimbledon-R128-Marta_Kostyuk-Kiki_Bertens,2,B-DTL,5,1,0,0,1,2,3
20210629-W-Wimbledon-R128-Marta_Kostyuk-Kiki_Bertens,2,B-IO,4,2,1,0,1,1,3
20210629-W-Wimbledon-R128-Marta_Kostyuk-Kiki_Bertens,2,S-XC,6,3,0,0,3,2,4
20210629-W-Wimbledon-R128-Marta_Kostyuk-Kiki_Bertens,2,S-DTM,10,2,0,0,2,5,5
20210629-W-Wimbledon-R128-Marta_Kostyuk-Kiki_Bertens,2,S-DTL,5,1,0,1,0,4,1
20201001-W-Roland_Garros-R64-Julia_Goerges-Laura_Siegemund,1,F-XC,30,11,4,2,5,11,19
20201001-W-Roland_Garros-R64-Julia_Goerges-Laura_Siegemund,1,F-DTM,8,2,0,0,2,1,7
20201001-W-Roland_Garros-R64-Julia_Goerges-Laura_Siegemund,1,F-DTL,12,7,4,0,3,8,4
20201001-W-Roland_Garros-R64-Julia_Goerges-Laura_Siegemund,1,F-IO,13,7,2,0,5,4,9
20201001-W-Roland_Garros-R64-Julia_Goerges-Laura_Siegemund,1,F-II,4,2,1,0,1,1,3
20201001-W-Roland_Garros-R64-Julia_Goerges-Laura_Siegemund,1,B-XC,5,3,1,1,1,3,2
20201001-W-Roland_Garros-R64-Julia_Goerges-Laura_Siegemund,1,B-DTM,13,2,0,0,2,6,7
20201001-W-Roland_Garros-R64-Julia_Goerges-Laura_Siegemund,1,B-DTL,13,8,4,1,3,5,8
20201001-W-Roland_Garros-R64-Julia_Goerges-Laura_Siegemund,1,B-IO,6,3,2,0,1,4,2
20201001-W-Roland_Garros-R64-Julia_Goerges-Laura_Siegemund,1,S-XC,1,0,0,0,0,0,1
20201001-W-Roland_Garros-R64-Julia_Goerges-Laura_Siegemund,1,S-DTM,3,0,0,0,0,1,2
20201001-W-Roland_Garros-R64-Julia_Goerges-Laura_Siegemund,2,F-XC,23,5,1,3,1,15,8
20201001-W-Roland_Garros-R64-Julia_Goerges-Laura_Siegemund,2,F-DTM,13,1,0,1,0,11,2
20201001-W-Roland_Garros-R64-Julia_Goerges-Laura_Siegemund,2,F-DTL,5,3,1,0,2,2,3
20201001-W-Roland_Garros-R64-Julia_Goerges-Laura_Siegemund,2,F-IO,10,2,0,2,0,6,4
20201001-W-Roland_Garros-R64-Julia_Goerges-Laura_Siegemund,2,B-XC,21,8,3,1,4,11,10
20201001-W-Roland_Garros-R64-Julia_Goerges-Laura_Siegemund,2,B-DTM,8,1,0,0,1,3,5
20201001-W-Roland_Garros-R64-Julia_Goerges-Laura_Siegemund,2,B-DTL,2,0,0,0,0,1,1
20201001-W-Roland_Garros-R64-Julia_Goerges-Laura_Siegemund,2,B-IO,1,1,0,0,1,0,1
20201001-W-Roland_Garros-R64-Julia_Goerges-Laura_Siegemund,2,S-XC,3,0,0,0,0,2,1
20201001-W-Roland_Garros-R64-Julia_Goerges-Laura_Siegemund,2,S-DTM,1,0,0,0,0,0,1
20201001-W-Roland_Garros-R64-Julia_Goerges-Laura_Siegemund,2,S-IO,1,0,0,0,0,1,0
20210622-W-Eastbourne-R32-Shelby_Rogers-Kiki_Bertens,1,F-XC,24,3,2,0,1,10,14
20210622-W-Eastbourne-R32-Shelby_Rogers-Kiki_Bertens,1,F-DTM,15,3,0,1,2,8,7
20210622-W-Eastbourne-R32-Shelby_Rogers-Kiki_Bertens,1,F-DTL,8,6,3,2,1,6,2
20210622-W-Eastbourne-R32-Shelby_Rogers-Kiki_Bertens,1,F-IO,10,3,1,1,1,4,6
20210622-W-Eastbourne-R32-Shelby_Rogers-Kiki_Bertens,1,B-XC,14,2,0,1,1,5,9
20210622-W-Eastbourne-R32-Shelby_Rogers-Kiki_Bertens,1,B-DTM,11,3,0,1,2,6,5
20210622-W-Eastbourne-R32-Shelby_Rogers-Kiki_Bertens,1,B-DTL,1,0,0,0,0,1,0
20210622-W-Eastbourne-R32-Shelby_Rogers-Kiki_Bertens,1,B-IO,6,2,0,0,2,3,3
20210622-W-Eastbourne-R32-Shelby_Rogers-Kiki_Bertens,1,S-XC,2,1,0,0,1,0,2
20210622-W-Eastbourne-R32-Shelby_Rogers-Kiki_Bertens,1,S-DTM,6,0,0,0,0,3,3
20210622-W-Eastbourne-R32-Shelby_Rogers-Kiki_Bertens,2,F-XC,24,7,0,1,6,9,15
20210622-W-Eastbourne-R32-Shelby_Rogers-Kiki_Bertens,2,F-DTM,9,0,0,0,0,7,2
20210622-W-Eastbourne-R32-Shelby_Rogers-Kiki_Bertens,2,F-DTL,10,5,1,1,3,3,7
20210622-W-Eastbourne-R32-Shelby_Rogers-Kiki_Bertens,2,F-IO,16,8,4,1,3,10,6
20210622-W-Eastbourne-R32-Shelby_Rogers-Kiki_Bertens,2,B-XC,5,1,0,0,1,4,1
20210622-W-Eastbourne-R32-Shelby_Rogers-Kiki_Bertens,2,B-DTM,14,3,0,1,2,7,7
20210622-W-Eastbourne-R32-Shelby_Rogers-Kiki_Bertens,2,B-DTL,2,2,0,1,1,1,1
20210622-W-Eastbourne-R32-Shelby_Rogers-Kiki_Bertens,2,B-IO,4,2,0,1,1,1,3
20210622-W-Eastbourne-R32-Shelby_Rogers-Kiki_Bertens,2,S-XC,2,0,0,0,0,2,0
20210622-W-Eastbourne-R32-Shelby_Rogers-Kiki_Bertens,2,S-DTM,3,0,0,0,0,2,1
20210622-W-Eastbourne-R32-Shelby_Rogers-Kiki_Bertens,2,S-DTL,3,2,1,1,0,3,0
20210701-W-Wimbledon-R64-Angelique_Kerber-Sara_Sorribes_Tormo,1,F-XC,185,14,5,5,4,93,92
20210701-W-Wimbledon-R64-Angelique_Kerber-Sara_Sorribes_Tormo,1,F-DTM,39,2,0,0,2,19,20
20210701-W-Wimbledon-R64-Angelique_Kerber-Sara_Sorribes_Tormo,1,F-DTL,27,12,5,3,4,17,10
20210701-W-Wimbledon-R64-Angelique_Kerber-Sara_Sorribes_Tormo,1,F-IO,64,20,5,7,8,39,25
20210701-W-Wimbledon-R64-Angelique_Kerber-Sara_Sorribes_Tormo,1,F-II,2,0,0,0,0,2,0
20210701-W-Wimbledon-R64-Angelique_Kerber-Sara_Sorribes_Tormo,1,B-XC,162,24,4,9,11,87,75
20210701-W-Wimbledon-R64-Angelique_Kerber-Sara_Sorribes_Tormo,1,B-DTM,103,4,0,0,4,54,49
20210701-W-Wimbledon-R64-Angelique_Kerber-Sara_Sorribes_Tormo,1,B-DTL,26,12,8,0,4,14,12
20210701-W-Wimbledon-R64-Angelique_Kerber-Sara_Sorribes_Tormo,1,B-IO,27,8,6,1,1,18,9
20210701-W-Wimbledon-R64-Angelique_Kerber-Sara_Sorribes_Tormo,1,S-XC,19,0,0,0,0,7,12
20210701-W-Wimbledon-R64-Angelique_Kerber-Sara_Sorribes_Tormo,1,S-DTM,16,0,0,0,0,7,9
20210701-W-Wimbledon-R64-Angelique_Kerber-Sara_Sorribes_Tormo,1,S-DTL,11,0,0,0,0,5,6
20210701-W-Wimbledon-R64-Angelique_Kerber-Sara_Sorribes_Tormo,1,S-IO,10,2,0,0,2,5,5
20210701-W-Wimbledon-R64-Angelique_Kerber-Sara_Sorribes_Tormo,2,F-XC,159,8,1,1,6,75,84
20210701-W-Wimbledon-R64-Angelique_Kerber-Sara_Sorribes_Tormo,2,F-DTM,117,2,0,0,2,38,79
20210701-W-Wimbledon-R64-Angelique_Kerber-Sara_Sorribes_Tormo,2,F-DTL,36,12,3,3,6,21,15
20210701-W-Wimbledon-R64-Angelique_Kerber-Sara_Sorribes_Tormo,2,F-IO,55,8,2,3,3,31,24
20210701-W-Wimbledon-R64-Angelique_Kerber-Sara_Sorribes_Tormo,2,F-II,4,1,1,0,0,2,2
20210701-W-Wimbledon-R64-Angelique_Kerber-Sara_Sorribes_Tormo,2,B-XC,13,2,1,0,1,3,10
20210701-W-Wimbledon-R64-Angelique_Kerber-Sara_Sorribes_Tormo,2,B-DTM,29,4,0,1,3,12,17
20210701-W-Wimbledon-R64-Angelique_Kerber-Sara_Sorribes_Tormo,2,B-DTL,11,0,0,0,0,7,4
20210701-W-Wimbledon-R64-Angelique_Kerber-Sara_Sorribes_Tormo,2,B-IO,7,1,1,0,0,5,2
20210701-W-Wimbledon-R64-Angelique_Kerber-Sara_Sorribes_Tormo,2,S-XC,73,5,0,4,1,35,38
20210701-W-Wimbledon-R64-Angelique_Kerber-Sara_Sorribes_Tormo,2,S-DTM,108,3,0,1,2,59,49
20210701-W-Wimbledon-R64-Angelique_Kerber-Sara_Sorribes_Tormo,2,S-DTL,37,4,0,3,1,20,17
20210701-W-Wimbledon-R64-Angelique_Kerber-Sara_Sorribes_Tormo,2,S-IO,12,1,0,0,1,5,7
20210705-W-Wimbledon-R16-Iga_Swiatek-Ons_Jabeur,1,F-XC,20,9,4,1,4,9,11
20210705-W-Wimbledon-R16-Iga_Swiatek-Ons_Jabeur,1,F-DTM,13,3,0,0,3,3,10
20210705-W-Wimbledon-R16-Iga_Swiatek-Ons_Jabeur,1,F-DTL,11,3,0,0,3,4,7
20210705-W-Wimbledon-R16-Iga_Swiatek-Ons_Jabeur,1,F-IO,13,8,4,2,2,7,6
20210705-W-Wimbledon-R16-Iga_Swiatek-Ons_Jabeur,1,B-XC,27,5,1,1,3,10,17
20210705-W-Wimbledon-R16-Iga_Swiatek-Ons_Jabeur,1,B-DTM,12,5,1,1,3,5,7
20210705-W-Wimbledon-R16-Iga_Swiatek-Ons_Jabeur,1,B-DTL,9,3,1,0,2,3,6
20210705-W-Wimbledon-R16-Iga_Swiatek-Ons_Jabeur,1,B-IO,7,6,4,0,2,4,3
20210705-W-Wimbledon-R16-Iga_Swiatek-Ons_Jabeur,1,S-XC,3,1,0,1,0,2,1
20210705-W-Wimbledon-R16-Iga_Swiatek-Ons_Jabeur,2,F-XC,27,11,7,2,2,19,8
20210705-W-Wimbledon-R16-Iga_Swiatek-Ons_Jabeur,2,F-DTM,15,3,0,1,2,7,8
20210705-W-Wimbledon-R16-Iga_Swiatek-Ons_Jabeur,2,F-DTL,2,2,0,0,2,0,2
20210705-W-Wimbledon-R16-Iga_Swiatek-Ons_Jabeur,2,F-IO,11,3,0,2,1,8,3
20210705-W-Wimbledon-R16-Iga_Swiatek-Ons_Jabeur,2,B-XC,15,4,1,2,1,11,4
20210705-W-Wimbledon-R16-Iga_Swiatek-Ons_Jabeur,2,B-DTM,5,0,0,0,0,3,2
20210705-W-Wimbledon-R16-Iga_Swiatek-Ons_Jabeur,2,B-DTL,7,4,1,2,1,5,2
20210705-W-Wimbledon-R16-Iga_Swiatek-Ons_Jabeur,2,B-IO,4,1,0,1,0,4,0
20210705-W-Wimbledon-R16-Iga_Swiatek-Ons_Jabeur,2,S-XC,9,2,0,0,2,2,7
20210705-W-Wimbledon-R16-Iga_Swiatek-Ons_Jabeur,2,S-DTM,12,1,0,1,0,7,5
20210705-W-Wimbledon-R16-Iga_Swiatek-Ons_Jabeur,2,S-DTL,2,1,0,0,1,1,1
20210630-W-Wimbledon-R64-Jessica_Pegula-Liudmila_Samsonova,1,F-XC,23,9,2,2,5,12,11
20210630-W-Wimbledon-R64-Jessica_Pegula-Liudmila_Samsonova,1,F-DTM,27,1,0,0,1,11,16
20210630-W-Wimbledon-R64-Jessica_Pegula-Liudmila_Samsonova,1,F-DTL,14,5,3,0,2,6,8
20210630-W-Wimbledon-R64-Jessica_Pegula-Liudmila_Samsonova,1,F-IO,20,5,1,1,3,14,6
20210630-W-Wimbledon-R64-Jessica_Pegula-Liudmila_Samsonova,1,B-XC,23,5,2,0,3,10,13
20210630-W-Wimbledon-R64-Jessica_Pegula-Liudmila_Samsonova,1,B-DTM,26,5,0,0,5,13,13
20210630-W-Wimbledon-R64-Jessica_Pegula-Liudmila_Samsonova,1,B-DTL,4,1,0,1,0,2,2
20210630-W-Wimbledon-R64-Jessica_Pegula-Liudmila_Samsonova,1,B-IO,2,1,0,0,1,0,2
20210630-W-Wimbledon-R64-Jessica_Pegula-Liudmila_Samsonova,1,S-XC,5,1,1,0,0,2,3
20210630-W-Wimbledon-R64-Jessica_Pegula-Liudmila_Samsonova,1,S-DTM,7,1,0,0,1,1,6
20210630-W-Wimbledon-R64-Jessica_Pegula-Liudmila_Samsonova,1,S-DTL,1,0,0,0,0,1,0
20210630-W-Wimbledon-R64-Jessica_Pegula-Liudmila_Samsonova,1,S-IO,3,0,0,0,0,1,2
20210630-W-Wimbledon-R64-Jessica_Pegula-Liudmila_Samsonova,2,F-XC,39,21,7,4,10,21,18
20210630-W-Wimbledon-R64-Jessica_Pegula-Liudmila_Samsonova,2,F-DTM,24,6,0,1,5,10,14
20210630-W-Wimbledon-R64-Jessica_Pegula-Liudmila_Samsonova,2,F-DTL,5,4,1,1,2,2,3
20210630-W-Wimbledon-R64-Jessica_Pegula-Liudmila_Samsonova,2,F-IO,21,10,3,3,4,15,6
20210630-W-Wimbledon-R64-Jessica_Pegula-Liudmila_Samsonova,2,B-XC,30,11,4,1,6,17,13
20210630-W-Wimbledon-R64-Jessica_Pegula-Liudmila_Samsonova,2,B-DTM,37,10,1,0,9,13,24
20210630-W-Wimbledon-R64-Jessica_Pegula-Liudmila_Samsonova,2,B-DTL,5,3,2,1,0,4,1
20210630-W-Wimbledon-R64-Jessica_Pegula-Liudmila_Samsonova,2,B-IO,2,1,0,0,1,1,1
20210630-W-Wimbledon-R64-Jessica_Pegula-Liudmila_Samsonova,2,S-DTM,5,0,0,0,0,1,4
20210630-W-Wimbledon-R64-Jessica_Pegula-Liudmila_Samsonova,2,S-DTL,1,0,0,0,0,0,1
20210705-W-Wimbledon-R16-Paula_Badosa-Karolina_Muchova,1,F-XC,47,12,3,2,7,21,26
20210705-W-Wimbledon-R16-Paula_Badosa-Karolina_Muchova,1,F-DTM,27,5,1,0,4,9,18
20210705-W-Wimbledon-R16-Paula_Badosa-Karolina_Muchova,1,F-DTL,14,5,2,1,2,5,9
20210705-W-Wimbledon-R16-Paula_Badosa-Karolina_Muchova,1,F-IO,22,7,1,3,3,11,11
20210705-W-Wimbledon-R16-Paula_Badosa-Karolina_Muchova,1,F-II,1,0,0,0,0,0,1
20210705-W-Wimbledon-R16-Paula_Badosa-Karolina_Muchova,1,B-XC,22,5,2,0,3,12,10
20210705-W-Wimbledon-R16-Paula_Badosa-Karolina_Muchova,1,B-DTM,23,2,0,0,2,9,14
20210705-W-Wimbledon-R16-Paula_Badosa-Karolina_Muchova,1,B-DTL,2,2,1,0,1,1,1
20210705-W-Wimbledon-R16-Paula_Badosa-Karolina_Muchova,1,B-IO,7,2,1,1,0,5,2
20210705-W-Wimbledon-R16-Paula_Badosa-Karolina_Muchova,1,S-XC,3,2,0,1,1,2,1
20210705-W-Wimbledon-R16-Paula_Badosa-Karolina_Muchova,1,S-DTM,1,0,0,0,0,0,1
20210705-W-Wimbledon-R16-Paula_Badosa-Karolina_Muchova,1,S-IO,1,0,0,0,0,1,0
20210705-W-Wimbledon-R16-Paula_Badosa-Karolina_Muchova,2,F-XC,44,12,1,3,8,27,17
20210705-W-Wimbledon-R16-Paula_Badosa-Karolina_Muchova,2,F-DTM,24,1,0,0,1,13,11
20210705-W-Wimbledon-R16-Paula_Badosa-Karolina_Muchova,2,F-DTL,12,11,2,3,6,6,6
20210705-W-Wimbledon-R16-Paula_Badosa-Karolina_Muchova,2,F-IO,8,2,2,0,0,8,0
20210705-W-Wimbledon-R16-Paula_Badosa-Karolina_Muchova,2,F-II,2,0,0,0,0,1,1
20210705-W-Wimbledon-R16-Paula_Badosa-Karolina_Muchova,2,B-XC,13,2,1,0,1,7,6
20210705-W-Wimbledon-R16-Paula_Badosa-Karolina_Muchova,2,B-DTM,13,0,0,0,0,5,8
20210705-W-Wimbledon-R16-Paula_Badosa-Karolina_Muchova,2,B-DTL,4,3,1,0,2,1,3
20210705-W-Wimbledon-R16-Paula_Badosa-Karolina_Muchova,2,B-IO,1,0,0,0,0,1,0
20210705-W-Wimbledon-R16-Paula_Badosa-Karolina_Muchova,2,S-XC,11,1,0,0,1,9,2
20210705-W-Wimbledon-R16-Paula_Badosa-Karolina_Muchova,2,S-DTM,13,0,0,0,0,8,5
20210705-W-Wimbledon-R16-Paula_Badosa-Karolina_Muchova,2,S-DTL,3,1,1,0,0,2,1
20210705-W-Wimbledon-R16-Paula_Badosa-Karolina_Muchova,2,S-IO,3,0,0,0,0,1,2
20210630-W-Wimbledon-R128-Vitalia_Diatchenko-Emma_Raducanu,1,F-XC,54,22,7,4,11,25,29
20210630-W-Wimbledon-R128-Vitalia_Diatchenko-Emma_Raducanu,1,F-DTM,30,5,0,1,4,9,21
20210630-W-Wimbledon-R128-Vitalia_Diatchenko-Emma_Raducanu,1,F-DTL,4,2,0,0,2,1,3
20210630-W-Wimbledon-R128-Vitalia_Diatchenko-Emma_Raducanu,1,F-IO,19,9,1,1,7,7,12
20210630-W-Wimbledon-R128-Vitalia_Diatchenko-Emma_Raducanu,1,F-II,1,0,0,0,0,0,1
20210630-W-Wimbledon-R128-Vitalia_Diatchenko-Emma_Raducanu,1,B-XC,43,12,1,5,6,19,24
20210630-W-Wimbledon-R128-Vitalia_Diatchenko-Emma_Raducanu,1,B-DTM,30,2,0,1,1,11,19
20210630-W-Wimbledon-R128-Vitalia_Diatchenko-Emma_Raducanu,1,B-DTL,13,7,5,1,1,10,3
20210630-W-Wimbledon-R128-Vitalia_Diatchenko-Emma_Raducanu,1,B-IO,14,8,2,1,5,6,8
20210630-W-Wimbledon-R128-Vitalia_Diatchenko-Emma_Raducanu,1,S-IO,1,0,0,0,0,1,0
20210630-W-Wimbledon-R128-Vitalia_Diatchenko-Emma_Raducanu,2,F-XC,33,4,2,1,1,22,11
20210630-W-Wimbledon-R128-Vitalia_Diatchenko-Emma_Raducanu,2,F-DTM,34,2,0,0,2,21,13
20210630-W-Wimbledon-R128-Vitalia_Diatchenko-Emma_Raducanu,2,F-DTL,7,2,1,0,1,4,3
20210630-W-Wimbledon-R128-Vitalia_Diatchenko-Emma_Raducanu,2,F-IO,7,3,1,2,0,5,2
20210630-W-Wimbledon-R128-Vitalia_Diatchenko-Emma_Raducanu,2,B-XC,30,4,1,1,2,17,13
20210630-W-Wimbledon-R128-Vitalia_Diatchenko-Emma_Raducanu,2,B-DTM,34,2,1,0,1,15,19
20210630-W-Wimbledon-R128-Vitalia_Diatchenko-Emma_Raducanu,2,B-DTL,8,6,2,1,3,5,3
20210630-W-Wimbledon-R128-Vitalia_Diatchenko-Emma_Raducanu,2,B-IO,6,1,0,0,1,4,2
20210630-W-Wimbledon-R128-Vitalia_Diatchenko-Emma_Raducanu,2,S-XC,6,0,0,0,0,5,1
20210630-W-Wimbledon-R128-Vitalia_Diatchenko-Emma_Raducanu,2,S-DTM,9,0,0,0,0,5,4
20210630-W-Wimbledon-R128-Vitalia_Diatchenko-Emma_Raducanu,2,S-DTL,3,0,0,0,0,2,1
20210630-W-Wimbledon-R128-Vitalia_Diatchenko-Emma_Raducanu,2,S-IO,2,0,0,0,0,2,0
20210627-W-ITF_Alkmaar-F-Quirine_Lemoine-Julia_Avdeeva,1,F-XC,37,13,2,3,8,23,14
20210627-W-ITF_Alkmaar-F-Quirine_Lemoine-Julia_Avdeeva,1,F-DTM,12,1,0,1,0,7,5
20210627-W-ITF_Alkmaar-F-Quirine_Lemoine-Julia_Avdeeva,1,F-DTL,3,2,1,1,0,3,0
20210627-W-ITF_Alkmaar-F-Quirine_Lemoine-Julia_Avdeeva,1,F-IO,4,3,1,2,0,4,0
20210627-W-ITF_Alkmaar-F-Quirine_Lemoine-Julia_Avdeeva,1,B-XC,39,11,4,2,5,24,15
20210627-W-ITF_Alkmaar-F-Quirine_Lemoine-Julia_Avdeeva,1,B-DTM,51,13,3,3,7,29,22
20210627-W-ITF_Alkmaar-F-Quirine_Lemoine-Julia_Avdeeva,1,B-DTL,1,0,0,0,0,0,1
20210627-W-ITF_Alkmaar-F-Quirine_Lemoine-Julia_Avdeeva,1,B-IO,5,2,0,1,1,2,3
20210627-W-ITF_Alkmaar-F-Quirine_Lemoine-Julia_Avdeeva,1,S-XC,1,0,0,0,0,0,1
20210627-W-ITF_Alkmaar-F-Quirine_Lemoine-Julia_Avdeeva,1,S-DTM,3,0,0,0,0,2,1
20210627-W-ITF_Alkmaar-F-Quirine_Lemoine-Julia_Avdeeva,1,S-DTL,1,0,0,0,0,0,1
20210627-W-ITF_Alkmaar-F-Quirine_Lemoine-Julia_Avdeeva,1,S-IO,2,0,0,0,0,2,0
20210627-W-ITF_Alkmaar-F-Quirine_Lemoine-Julia_Avdeeva,2,F-XC,46,17,2,3,12,18,28
20210627-W-ITF_Alkmaar-F-Quirine_Lemoine-Julia_Avdeeva,2,F-DTM,32,4,0,0,4,10,22
20210627-W-ITF_Alkmaar-F-Quirine_Lemoine-Julia_Avdeeva,2,F-DTL,12,9,4,0,5,6,6
20210627-W-ITF_Alkmaar-F-Quirine_Lemoine-Julia_Avdeeva,2,F-IO,12,7,2,2,3,6,6
20210627-W-ITF_Alkmaar-F-Quirine_Lemoine-Julia_Avdeeva,2,F-II,1,1,0,0,1,0,1
20210627-W-ITF_Alkmaar-F-Quirine_Lemoine-Julia_Avdeeva,2,B-XC,8,4,2,1,1,4,4
20210627-W-ITF_Alkmaar-F-Quirine_Lemoine-Julia_Avdeeva,2,B-DTM,11,3,0,0,3,5,6
20210627-W-ITF_Alkmaar-F-Quirine_Lemoine-Julia_Avdeeva,2,B-DTL,2,0,0,0,0,1,1
20210627-W-ITF_Alkmaar-F-Quirine_Lemoine-Julia_Avdeeva,2,B-IO,2,0,0,0,0,1,1
20210627-W-ITF_Alkmaar-F-Quirine_Lemoine-Julia_Avdeeva,2,S-XC,8,3,0,0,3,1,7
20210627-W-ITF_Alkmaar-F-Quirine_Lemoine-Julia_Avdeeva,2,S-DTM,15,0,0,0,0,5,10
20210627-W-ITF_Alkmaar-F-Quirine_Lemoine-Julia_Avdeeva,2,S-DTL,3,1,0,0,1,1,2
20210627-W-ITF_Alkmaar-F-Quirine_Lemoine-Julia_Avdeeva,2,S-IO,3,1,0,0,1,1,2
20210714-W-Lausanne-R32-Arantxa_Rus-Kamilla_Rakhimova,1,F-XC,92,18,8,4,6,48,44
20210714-W-Lausanne-R32-Arantxa_Rus-Kamilla_Rakhimova,1,F-DTM,82,7,0,0,7,39,43
20210714-W-Lausanne-R32-Arantxa_Rus-Kamilla_Rakhimova,1,F-DTL,21,10,4,0,6,9,12
20210714-W-Lausanne-R32-Arantxa_Rus-Kamilla_Rakhimova,1,F-IO,36,14,7,3,4,23,13
20210714-W-Lausanne-R32-Arantxa_Rus-Kamilla_Rakhimova,1,F-II,1,1,1,0,0,1,0
20210714-W-Lausanne-R32-Arantxa_Rus-Kamilla_Rakhimova,1,B-XC,49,15,3,5,7,28,21
20210714-W-Lausanne-R32-Arantxa_Rus-Kamilla_Rakhimova,1,B-DTM,53,5,1,2,2,22,31
20210714-W-Lausanne-R32-Arantxa_Rus-Kamilla_Rakhimova,1,B-DTL,13,5,1,2,2,8,5
20210714-W-Lausanne-R32-Arantxa_Rus-Kamilla_Rakhimova,1,B-IO,16,4,1,2,1,9,7
20210714-W-Lausanne-R32-Arantxa_Rus-Kamilla_Rakhimova,1,S-XC,6,0,0,0,0,2,4
20210714-W-Lausanne-R32-Arantxa_Rus-Kamilla_Rakhimova,1,S-DTM,12,0,0,0,0,2,10
20210714-W-Lausanne-R32-Arantxa_Rus-Kamilla_Rakhimova,1,S-DTL,5,1,0,0,1,0,5
20210714-W-Lausanne-R32-Arantxa_Rus-Kamilla_Rakhimova,1,S-IO,2,0,0,0,0,1,1
20210714-W-Lausanne-R32-Arantxa_Rus-Kamilla_Rakhimova,2,F-XC,120,30,5,8,17,63,57
20210714-W-Lausanne-R32-Arantxa_Rus-Kamilla_Rakhimova,2,F-DTM,33,5,0,1,4,11,22
20210714-W-Lausanne-R32-Arantxa_Rus-Kamilla_Rakhimova,2,F-DTL,12,3,1,1,1,7,5
20210714-W-Lausanne-R32-Arantxa_Rus-Kamilla_Rakhimova,2,F-IO,34,13,7,2,4,22,12
20210714-W-Lausanne-R32-Arantxa_Rus-Kamilla_Rakhimova,2,F-II,1,0,0,0,0,0,1
20210714-W-Lausanne-R32-Arantxa_Rus-Kamilla_Rakhimova,2,B-XC,73,5,0,0,5,35,38
20210714-W-Lausanne-R32-Arantxa_Rus-Kamilla_Rakhimova,2,B-DTM,57,3,0,2,1,34,23
20210714-W-Lausanne-R32-Arantxa_Rus-Kamilla_Rakhimova,2,B-DTL,12,4,1,2,1,8,4
20210714-W-Lausanne-R32-Arantxa_Rus-Kamilla_Rakhimova,2,B-IO,3,1,0,0,1,0,3
20210714-W-Lausanne-R32-Arantxa_Rus-Kamilla_Rakhimova,2,S-DTM,6,1,0,1,0,2,4
20210714-W-Lausanne-R32-Arantxa_Rus-Kamilla_Rakhimova,2,S-DTL,1,0,0,0,0,0,1
20210713-W-Lausanne-R32-Tess_Sugnaux-Lucia_Bronzetti,1,F-XC,60,14,0,2,12,22,38
20210713-W-Lausanne-R32-Tess_Sugnaux-Lucia_Bronzetti,1,F-DTM,33,1,0,0,1,12,21
20210713-W-Lausanne-R32-Tess_Sugnaux-Lucia_Bronzetti,1,F-DTL,9,5,2,1,2,6,3
20210713-W-Lausanne-R32-Tess_Sugnaux-Lucia_Bronzetti,1,F-IO,19,3,1,0,2,9,10
20210713-W-Lausanne-R32-Tess_Sugnaux-Lucia_Bronzetti,1,F-II,4,1,0,1,0,3,1
20210713-W-Lausanne-R32-Tess_Sugnaux-Lucia_Bronzetti,1,B-XC,36,4,0,0,4,16,20
20210713-W-Lausanne-R32-Tess_Sugnaux-Lucia_Bronzetti,1,B-DTM,18,2,0,0,2,5,13
20210713-W-Lausanne-R32-Tess_Sugnaux-Lucia_Bronzetti,1,B-DTL,8,5,3,2,0,7,1
20210713-W-Lausanne-R32-Tess_Sugnaux-Lucia_Bronzetti,1,B-IO,2,0,0,0,0,0,2
20210713-W-Lausanne-R32-Tess_Sugnaux-Lucia_Bronzetti,1,S-XC,5,0,0,0,0,3,2
20210713-W-Lausanne-R32-Tess_Sugnaux-Lucia_Bronzetti,1,S-DTM,8,0,0,0,0,4,4
20210713-W-Lausanne-R32-Tess_Sugnaux-Lucia_Bronzetti,1,S-DTL,1,0,0,0,0,1,0
20210713-W-Lausanne-R32-Tess_Sugnaux-Lucia_Bronzetti,2,F-XC,60,12,5,6,1,38,22
20210713-W-Lausanne-R32-Tess_Sugnaux-Lucia_Bronzetti,2,F-DTM,23,1,0,0,1,12,11
20210713-W-Lausanne-R32-Tess_Sugnaux-Lucia_Bronzetti,2,F-DTL,11,5,0,0,5,4,7
20210713-W-Lausanne-R32-Tess_Sugnaux-Lucia_Bronzetti,2,F-IO,27,3,1,0,2,12,15
20210713-W-Lausanne-R32-Tess_Sugnaux-Lucia_Bronzetti,2,F-II,7,1,0,0,1,6,1
20210713-W-Lausanne-R32-Tess_Sugnaux-Lucia_Bronzetti,2,B-XC,31,2,1,0,1,14,17
20210713-W-Lausanne-R32-Tess_Sugnaux-Lucia_Bronzetti,2,B-DTM,23,0,0,0,0,12,11
20210713-W-Lausanne-R32-Tess_Sugnaux-Lucia_Bronzetti,2,B-DTL,2,1,1,0,0,1,1
20210713-W-Lausanne-R32-Tess_Sugnaux-Lucia_Bronzetti,2,B-IO,5,0,0,0,0,5,0
20210713-W-Lausanne-R32-Tess_Sugnaux-Lucia_Bronzetti,2,S-DTM,2,0,0,0,0,1,1
20040926-W-Beijing-F-Svetlana_Kuznetsova-Serena_Williams,1,F-XC,28,12,4,2,6,17,11
20040926-W-Beijing-F-Svetlana_Kuznetsova-Serena_Williams,1,F-DTM,39,3,0,1,2,21,18
20040926-W-Beijing-F-Svetlana_Kuznetsova-Serena_Williams,1,F-DTL,19,14,3,4,7,10,9
20040926-W-Beijing-F-Svetlana_Kuznetsova-Serena_Williams,1,F-IO,21,8,3,2,3,16,5
20040926-W-Beijing-F-Svetlana_Kuznetsova-Serena_Williams,1,F-II,3,1,0,1,0,1,2
20040926-W-Beijing-F-Svetlana_Kuznetsova-Serena_Williams,1,B-XC,12,3,0,1,2,6,6
20040926-W-Beijing-F-Svetlana_Kuznetsova-Serena_Williams,1,B-DTM,19,3,0,1,2,11,8
20040926-W-Beijing-F-Svetlana_Kuznetsova-Serena_Williams,1,B-DTL,16,6,2,1,3,7,9
20040926-W-Beijing-F-Svetlana_Kuznetsova-Serena_Williams,1,B-IO,5,2,0,1,1,3,2
20040926-W-Beijing-F-Svetlana_Kuznetsova-Serena_Williams,1,S-XC,4,0,0,0,0,2,2
20040926-W-Beijing-F-Svetlana_Kuznetsova-Serena_Williams,1,S-DTM,2,0,0,0,0,1,1
20040926-W-Beijing-F-Svetlana_Kuznetsova-Serena_Williams,1,S-DTL,3,0,0,0,0,0,3
20040926-W-Beijing-F-Svetlana_Kuznetsova-Serena_Williams,2,F-XC,48,18,4,4,10,23,25
20040926-W-Beijing-F-Svetlana_Kuznetsova-Serena_Williams,2,F-DTM,20,1,0,0,1,7,13
20040926-W-Beijing-F-Svetlana_Kuznetsova-Serena_Williams,2,F-DTL,8,4,2,1,1,6,2
20040926-W-Beijing-F-Svetlana_Kuznetsova-Serena_Williams,2,F-IO,22,13,4,2,7,13,9
20040926-W-Beijing-F-Svetlana_Kuznetsova-Serena_Williams,2,F-II,1,0,0,0,0,1,0
20040926-W-Beijing-F-Svetlana_Kuznetsova-Serena_Williams,2,B-XC,31,9,2,1,6,13,18
20040926-W-Beijing-F-Svetlana_Kuznetsova-Serena_Williams,2,B-DTM,21,2,0,0,2,7,14
20040926-W-Beijing-F-Svetlana_Kuznetsova-Serena_Williams,2,B-DTL,8,3,1,0,2,2,6
20040926-W-Beijing-F-Svetlana_Kuznetsova-Serena_Williams,2,B-IO,9,2,0,0,2,2,7
20040926-W-Beijing-F-Svetlana_Kuznetsova-Serena_Williams,2,S-XC,2,0,0,0,0,1,1
20040926-W-Beijing-F-Svetlana_Kuznetsova-Serena_Williams,2,S-DTM,2,0,0,0,0,0,2
20040926-W-Beijing-F-Svetlana_Kuznetsova-Serena_Williams,2,S-IO,1,0,0,0,0,0,1
20210720-W-Gdynia-R32-Weronika_Baszak-Aliaksandra_Sasnovich,1,F-XC,41,11,4,1,6,16,25
20210720-W-Gdynia-R32-Weronika_Baszak-Aliaksandra_Sasnovich,1,F-DTM,35,2,0,1,1,13,22
20210720-W-Gdynia-R32-Weronika_Baszak-Aliaksandra_Sasnovich,1,F-IO,7,4,1,0,3,2,5
20210720-W-Gdynia-R32-Weronika_Baszak-Aliaksandra_Sasnovich,1,F-II,3,1,1,0,0,2,1
20210720-W-Gdynia-R32-Weronika_Baszak-Aliaksandra_Sasnovich,1,B-XC,15,1,1,0,0,6,9
20210720-W-Gdynia-R32-Weronika_Baszak-Aliaksandra_Sasnovich,1,B-DTM,28,2,0,0,2,12,16
20210720-W-Gdynia-R32-Weronika_Baszak-Aliaksandra_Sasnovich,1,B-DTL,4,0,0,0,0,3,1
20210720-W-Gdynia-R32-Weronika_Baszak-Aliaksandra_Sasnovich,1,B-IO,3,1,0,1,0,2,1
20210720-W-Gdynia-R32-Weronika_Baszak-Aliaksandra_Sasnovich,1,S-XC,1,0,0,0,0,0,1
20210720-W-Gdynia-R32-Weronika_Baszak-Aliaksandra_Sasnovich,1,S-DTM,11,4,0,2,2,2,9
20210720-W-Gdynia-R32-Weronika_Baszak-Aliaksandra_Sasnovich,1,S-DTL,1,0,0,0,0,0,1
20210720-W-Gdynia-R32-Weronika_Baszak-Aliaksandra_Sasnovich,2,F-XC,45,29,12,7,10,27,18
20210720-W-Gdynia-R32-Weronika_Baszak-Aliaksandra_Sasnovich,2,F-DTM,27,3,0,1,2,16,11
20210720-W-Gdynia-R32-Weronika_Baszak-Aliaksandra_Sasnovich,2,F-DTL,10,3,1,0,2,5,5
20210720-W-Gdynia-R32-Weronika_Baszak-Aliaksandra_Sasnovich,2,F-IO,24,10,4,4,2,16,8
20210720-W-Gdynia-R32-Weronika_Baszak-Aliaksandra_Sasnovich,2,B-XC,26,7,1,1,5,15,11
20210720-W-Gdynia-R32-Weronika_Baszak-Aliaksandra_Sasnovich,2,B-DTM,14,1,0,0,1,9,5
20210720-W-Gdynia-R32-Weronika_Baszak-Aliaksandra_Sasnovich,2,B-DTL,1,1,0,0,1,0,1
20210720-W-Gdynia-R32-Weronika_Baszak-Aliaksandra_Sasnovich,2,B-IO,2,0,0,0,0,2,0
20210720-W-Gdynia-R32-Weronika_Baszak-Aliaksandra_Sasnovich,2,S-XC,3,1,0,0,1,2,1
20210720-W-Gdynia-R32-Weronika_Baszak-Aliaksandra_Sasnovich,2,S-DTM,3,0,0,0,0,3,0
20210704-W-ITF_The_Hague-F-Panna_Udvardy-Quirine_Lemoine,1,F-XC,46,8,3,1,4,26,20
20210704-W-ITF_The_Hague-F-Panna_Udvardy-Quirine_Lemoine,1,F-DTM,19,2,0,0,2,8,11
20210704-W-ITF_The_Hague-F-Panna_Udvardy-Quirine_Lemoine,1,F-DTL,12,6,1,2,3,5,7
20210704-W-ITF_The_Hague-F-Panna_Udvardy-Quirine_Lemoine,1,F-IO,13,6,2,0,4,6,7
20210704-W-ITF_The_Hague-F-Panna_Udvardy-Quirine_Lemoine,1,B-XC,18,8,3,1,4,10,8
20210704-W-ITF_The_Hague-F-Panna_Udvardy-Quirine_Lemoine,1,B-DTM,17,2,0,0,2,9,8
20210704-W-ITF_The_Hague-F-Panna_Udvardy-Quirine_Lemoine,1,B-DTL,4,2,2,0,0,3,1
20210704-W-ITF_The_Hague-F-Panna_Udvardy-Quirine_Lemoine,1,B-IO,8,0,0,0,0,3,5
20210704-W-ITF_The_Hague-F-Panna_Udvardy-Quirine_Lemoine,1,S-DTM,1,1,0,0,1,0,1
20210704-W-ITF_The_Hague-F-Panna_Udvardy-Quirine_Lemoine,1,S-DTL,1,1,0,0,1,0,1
20210704-W-ITF_The_Hague-F-Panna_Udvardy-Quirine_Lemoine,2,F-XC,34,9,3,4,2,19,15
20210704-W-ITF_The_Hague-F-Panna_Udvardy-Quirine_Lemoine,2,F-DTM,20,3,1,1,1,12,8
20210704-W-ITF_The_Hague-F-Panna_Udvardy-Quirine_Lemoine,2,F-DTL,9,6,3,2,1,7,2
20210704-W-ITF_The_Hague-F-Panna_Udvardy-Quirine_Lemoine,2,F-IO,12,6,2,1,3,7,5
20210704-W-ITF_The_Hague-F-Panna_Udvardy-Quirine_Lemoine,2,B-XC,43,8,3,1,4,20,23
20210704-W-ITF_The_Hague-F-Panna_Udvardy-Quirine_Lemoine,2,B-DTM,31,7,0,1,6,14,17
20210704-W-ITF_The_Hague-F-Panna_Udvardy-Quirine_Lemoine,2,B-DTL,3,2,1,0,1,1,2
20210704-W-ITF_The_Hague-F-Panna_Udvardy-Quirine_Lemoine,2,B-IO,2,2,1,0,1,1,1
20210704-W-ITF_The_Hague-F-Panna_Udvardy-Quirine_Lemoine,2,S-DTM,1,0,0,0,0,0,1
20210704-W-ITF_The_Hague-F-Panna_Udvardy-Quirine_Lemoine,2,S-DTL,1,0,0,0,0,0,1
20210719-W-Gdynia-R32-Kateryna_Bondarenko-Weronika_Falkowska,1,F-XC,5,3,2,0,1,3,2
20210719-W-Gdynia-R32-Kateryna_Bondarenko-Weronika_Falkowska,1,F-DTM,10,2,0,0,2,2,8
20210719-W-Gdynia-R32-Kateryna_Bondarenko-Weronika_Falkowska,1,F-DTL,6,4,2,0,2,2,4
20210719-W-Gdynia-R32-Kateryna_Bondarenko-Weronika_Falkowska,1,F-IO,6,1,0,1,0,3,3
20210719-W-Gdynia-R32-Kateryna_Bondarenko-Weronika_Falkowska,1,B-XC,14,4,0,1,3,6,8
20210719-W-Gdynia-R32-Kateryna_Bondarenko-Weronika_Falkowska,1,B-DTM,15,3,0,0,3,2,13
20210719-W-Gdynia-R32-Kateryna_Bondarenko-Weronika_Falkowska,1,B-DTL,3,2,0,1,1,1,2
20210719-W-Gdynia-R32-Kateryna_Bondarenko-Weronika_Falkowska,1,B-IO,10,4,2,0,2,4,6
20210719-W-Gdynia-R32-Kateryna_Bondarenko-Weronika_Falkowska,1,S-XC,1,0,0,0,0,0,1
20210719-W-Gdynia-R32-Kateryna_Bondarenko-Weronika_Falkowska,1,S-DTL,1,0,0,0,0,0,1
20210719-W-Gdynia-R32-Kateryna_Bondarenko-Weronika_Falkowska,2,F-XC,11,6,2,3,1,9,2
20210719-W-Gdynia-R32-Kateryna_Bondarenko-Weronika_Falkowska,2,F-DTM,12,4,0,1,3,6,6
20210719-W-Gdynia-R32-Kateryna_Bondarenko-Weronika_Falkowska,2,F-DTL,1,0,0,0,0,0,1
20210719-W-Gdynia-R32-Kateryna_Bondarenko-Weronika_Falkowska,2,F-IO,3,1,1,0,0,3,0
20210719-W-Gdynia-R32-Kateryna_Bondarenko-Weronika_Falkowska,2,F-II,1,1,1,0,0,1,0
20210719-W-Gdynia-R32-Kateryna_Bondarenko-Weronika_Falkowska,2,B-XC,11,3,2,1,0,10,1
20210719-W-Gdynia-R32-Kateryna_Bondarenko-Weronika_Falkowska,2,B-DTM,14,3,0,0,3,5,9
20210719-W-Gdynia-R32-Kateryna_Bondarenko-Weronika_Falkowska,2,B-DTL,4,1,0,0,1,3,1
20210719-W-Gdynia-R32-Kateryna_Bondarenko-Weronika_Falkowska,2,B-IO,2,1,1,0,0,2,0
20210719-W-Gdynia-R32-Kateryna_Bondarenko-Weronika_Falkowska,2,S-DTM,3,0,0,0,0,2,1
20210419-W-Stuttgart-R32-Nastasja_Mariana_Schunk-Belinda_Bencic,1,F-XC,48,9,2,1,6,18,30
20210419-W-Stuttgart-R32-Nastasja_Mariana_Schunk-Belinda_Bencic,1,F-DTM,35,4,1,0,3,14,21
20210419-W-Stuttgart-R32-Nastasja_Mariana_Schunk-Belinda_Bencic,1,F-DTL,8,4,1,0,3,4,4
20210419-W-Stuttgart-R32-Nastasja_Mariana_Schunk-Belinda_Bencic,1,F-IO,10,2,1,0,1,6,4
20210419-W-Stuttgart-R32-Nastasja_Mariana_Schunk-Belinda_Bencic,1,B-XC,35,13,6,0,7,15,20
20210419-W-Stuttgart-R32-Nastasja_Mariana_Schunk-Belinda_Bencic,1,B-DTM,26,5,0,1,4,7,19
20210419-W-Stuttgart-R32-Nastasja_Mariana_Schunk-Belinda_Bencic,1,B-DTL,5,2,2,0,0,4,1
20210419-W-Stuttgart-R32-Nastasja_Mariana_Schunk-Belinda_Bencic,1,B-IO,1,0,0,0,0,0,1
20210419-W-Stuttgart-R32-Nastasja_Mariana_Schunk-Belinda_Bencic,1,S-XC,2,0,0,0,0,1,1
20210419-W-Stuttgart-R32-Nastasja_Mariana_Schunk-Belinda_Bencic,1,S-DTM,2,0,0,0,0,1,1
20210419-W-Stuttgart-R32-Nastasja_Mariana_Schunk-Belinda_Bencic,1,S-DTL,2,1,0,0,1,1,1
20210419-W-Stuttgart-R32-Nastasja_Mariana_Schunk-Belinda_Bencic,2,F-XC,28,5,3,1,1,18,10
20210419-W-Stuttgart-R32-Nastasja_Mariana_Schunk-Belinda_Bencic,2,F-DTM,26,4,1,0,3,16,10
20210419-W-Stuttgart-R32-Nastasja_Mariana_Schunk-Belinda_Bencic,2,F-DTL,5,2,0,1,1,4,1
20210419-W-Stuttgart-R32-Nastasja_Mariana_Schunk-Belinda_Bencic,2,F-IO,14,5,1,1,3,7,7
20210419-W-Stuttgart-R32-Nastasja_Mariana_Schunk-Belinda_Bencic,2,B-XC,46,11,5,2,4,32,14
20210419-W-Stuttgart-R32-Nastasja_Mariana_Schunk-Belinda_Bencic,2,B-DTM,25,2,0,0,2,9,16
20210419-W-Stuttgart-R32-Nastasja_Mariana_Schunk-Belinda_Bencic,2,B-DTL,9,6,1,3,2,6,3
20210419-W-Stuttgart-R32-Nastasja_Mariana_Schunk-Belinda_Bencic,2,B-IO,4,1,0,0,1,2,2
20210419-W-Stuttgart-R32-Nastasja_Mariana_Schunk-Belinda_Bencic,2,S-XC,1,0,0,0,0,0,1
20210419-W-Stuttgart-R32-Nastasja_Mariana_Schunk-Belinda_Bencic,2,S-DTM,1,0,0,0,0,0,1
20210720-W-Gdynia-R32-Harmony_Tan-Amina_Anshba,1,F-XC,136,16,7,2,7,53,83
20210720-W-Gdynia-R32-Harmony_Tan-Amina_Anshba,1,F-DTM,46,3,0,0,3,17,29
20210720-W-Gdynia-R32-Harmony_Tan-Amina_Anshba,1,F-DTL,24,10,4,2,4,11,13
20210720-W-Gdynia-R32-Harmony_Tan-Amina_Anshba,1,F-IO,41,12,1,0,11,10,31
20210720-W-Gdynia-R32-Harmony_Tan-Amina_Anshba,1,B-XC,39,7,2,0,5,14,25
20210720-W-Gdynia-R32-Harmony_Tan-Amina_Anshba,1,B-DTM,22,3,0,0,3,10,12
20210720-W-Gdynia-R32-Harmony_Tan-Amina_Anshba,1,B-DTL,13,4,1,0,3,7,6
20210720-W-Gdynia-R32-Harmony_Tan-Amina_Anshba,1,B-IO,3,2,0,1,1,1,2
20210720-W-Gdynia-R32-Harmony_Tan-Amina_Anshba,1,S-XC,2,0,0,0,0,1,1
20210720-W-Gdynia-R32-Harmony_Tan-Amina_Anshba,1,S-DTM,2,0,0,0,0,0,2
20210720-W-Gdynia-R32-Harmony_Tan-Amina_Anshba,1,S-DTL,2,1,1,0,0,1,1
20210720-W-Gdynia-R32-Harmony_Tan-Amina_Anshba,1,S-IO,1,0,0,0,0,0,1
20210720-W-Gdynia-R32-Harmony_Tan-Amina_Anshba,2,F-XC,50,3,1,0,2,33,17
20210720-W-Gdynia-R32-Harmony_Tan-Amina_Anshba,2,F-DTM,32,2,0,2,0,20,12
20210720-W-Gdynia-R32-Harmony_Tan-Amina_Anshba,2,F-DTL,9,2,1,1,0,6,3
20210720-W-Gdynia-R32-Harmony_Tan-Amina_Anshba,2,F-IO,8,1,0,0,1,2,6
20210720-W-Gdynia-R32-Harmony_Tan-Amina_Anshba,2,B-XC,69,5,2,1,2,46,23
20210720-W-Gdynia-R32-Harmony_Tan-Amina_Anshba,2,B-DTM,95,3,0,2,1,61,34
20210720-W-Gdynia-R32-Harmony_Tan-Amina_Anshba,2,B-DTL,5,2,0,1,1,2,3
20210720-W-Gdynia-R32-Harmony_Tan-Amina_Anshba,2,B-IO,8,3,1,1,1,4,4
20210720-W-Gdynia-R32-Harmony_Tan-Amina_Anshba,2,S-XC,2,0,0,0,0,1,1
20210720-W-Gdynia-R32-Harmony_Tan-Amina_Anshba,2,S-DTM,4,0,0,0,0,3,1
20210720-W-Gdynia-R32-Harmony_Tan-Amina_Anshba,2,S-IO,1,0,0,0,0,1,0
20210720-W-Gdynia-R32-Harmony_Tan-Amina_Anshba,2,S-II,1,0,0,0,0,0,1
20210724-W-Olympics-R64-Marketa_Vondrousova-Kiki_Bertens,1,F-XC,66,7,1,5,1,43,23
20210724-W-Olympics-R64-Marketa_Vondrousova-Kiki_Bertens,1,F-DTM,26,4,0,0,4,12,14
20210724-W-Olympics-R64-Marketa_Vondrousova-Kiki_Bertens,1,F-DTL,5,4,2,0,2,3,2
20210724-W-Olympics-R64-Marketa_Vondrousova-Kiki_Bertens,1,F-IO,9,6,4,0,2,4,5
20210724-W-Olympics-R64-Marketa_Vondrousova-Kiki_Bertens,1,B-XC,26,5,0,0,5,12,14
20210724-W-Olympics-R64-Marketa_Vondrousova-Kiki_Bertens,1,B-DTM,28,1,0,0,1,9,19
20210724-W-Olympics-R64-Marketa_Vondrousova-Kiki_Bertens,1,B-DTL,3,3,1,0,2,1,2
20210724-W-Olympics-R64-Marketa_Vondrousova-Kiki_Bertens,1,B-IO,5,1,1,0,0,3,2
20210724-W-Olympics-R64-Marketa_Vondrousova-Kiki_Bertens,1,S-XC,3,0,0,0,0,1,2
20210724-W-Olympics-R64-Marketa_Vondrousova-Kiki_Bertens,1,S-DTM,18,1,0,0,1,12,6
20210724-W-Olympics-R64-Marketa_Vondrousova-Kiki_Bertens,1,S-DTL,2,1,0,0,1,0,2
20210724-W-Olympics-R64-Marketa_Vondrousova-Kiki_Bertens,1,S-IO,1,0,0,0,0,1,0
20210724-W-Olympics-R64-Marketa_Vondrousova-Kiki_Bertens,2,F-XC,61,19,7,3,9,34,27
20210724-W-Olympics-R64-Marketa_Vondrousova-Kiki_Bertens,2,F-DTM,14,0,0,0,0,9,5
20210724-W-Olympics-R64-Marketa_Vondrousova-Kiki_Bertens,2,F-DTL,10,6,3,2,1,7,3
20210724-W-Olympics-R64-Marketa_Vondrousova-Kiki_Bertens,2,F-IO,26,14,2,3,9,8,18
20210724-W-Olympics-R64-Marketa_Vondrousova-Kiki_Bertens,2,F-II,4,4,3,0,1,3,1
20210724-W-Olympics-R64-Marketa_Vondrousova-Kiki_Bertens,2,B-XC,33,4,1,1,2,15,18
20210724-W-Olympics-R64-Marketa_Vondrousova-Kiki_Bertens,2,B-DTM,30,1,0,0,1,14,16
20210724-W-Olympics-R64-Marketa_Vondrousova-Kiki_Bertens,2,B-DTL,8,3,0,0,3,3,5
20210724-W-Olympics-R64-Marketa_Vondrousova-Kiki_Bertens,2,B-IO,4,1,0,0,1,2,2
20210724-W-Olympics-R64-Marketa_Vondrousova-Kiki_Bertens,2,S-XC,1,0,0,0,0,0,1
20210724-W-Olympics-R64-Marketa_Vondrousova-Kiki_Bertens,2,S-DTM,4,1,0,0,1,0,4
20210724-W-Olympics-R64-Marketa_Vondrousova-Kiki_Bertens,2,S-DTL,4,0,0,0,0,1,3
20210719-W-Gdynia-R32-Federica_Di_Sarra-Irina_Maria_Bara,1,F-XC,89,20,9,3,8,47,42
20210719-W-Gdynia-R32-Federica_Di_Sarra-Irina_Maria_Bara,1,F-DTM,65,6,2,0,4,25,40
20210719-W-Gdynia-R32-Federica_Di_Sarra-Irina_Maria_Bara,1,F-DTL,23,7,4,2,1,15,8
20210719-W-Gdynia-R32-Federica_Di_Sarra-Irina_Maria_Bara,1,F-IO,81,28,11,4,13,39,42
20210719-W-Gdynia-R32-Federica_Di_Sarra-Irina_Maria_Bara,1,F-II,12,2,0,0,2,3,9
20210719-W-Gdynia-R32-Federica_Di_Sarra-Irina_Maria_Bara,1,B-XC,101,14,1,1,12,46,55
20210719-W-Gdynia-R32-Federica_Di_Sarra-Irina_Maria_Bara,1,B-DTM,47,6,0,0,6,20,27
20210719-W-Gdynia-R32-Federica_Di_Sarra-Irina_Maria_Bara,1,B-DTL,14,9,3,0,6,6,8
20210719-W-Gdynia-R32-Federica_Di_Sarra-Irina_Maria_Bara,1,B-IO,4,1,0,0,1,2,2
20210719-W-Gdynia-R32-Federica_Di_Sarra-Irina_Maria_Bara,1,S-XC,9,0,0,0,0,3,6
20210719-W-Gdynia-R32-Federica_Di_Sarra-Irina_Maria_Bara,1,S-DTM,12,0,0,0,0,2,10
20210719-W-Gdynia-R32-Federica_Di_Sarra-Irina_Maria_Bara,1,S-DTL,2,1,0,1,0,2,0
20210719-W-Gdynia-R32-Federica_Di_Sarra-Irina_Maria_Bara,2,F-XC,48,7,2,1,4,26,22
20210719-W-Gdynia-R32-Federica_Di_Sarra-Irina_Maria_Bara,2,F-DTM,71,3,0,0,3,31,40
20210719-W-Gdynia-R32-Federica_Di_Sarra-Irina_Maria_Bara,2,F-DTL,12,1,0,1,0,6,6
20210719-W-Gdynia-R32-Federica_Di_Sarra-Irina_Maria_Bara,2,F-IO,32,3,1,1,1,21,11
20210719-W-Gdynia-R32-Federica_Di_Sarra-Irina_Maria_Bara,2,B-XC,111,7,0,0,7,54,57
20210719-W-Gdynia-R32-Federica_Di_Sarra-Irina_Maria_Bara,2,B-DTM,71,1,0,0,1,36,35
20210719-W-Gdynia-R32-Federica_Di_Sarra-Irina_Maria_Bara,2,B-DTL,17,5,3,0,2,13,4
20210719-W-Gdynia-R32-Federica_Di_Sarra-Irina_Maria_Bara,2,B-IO,7,0,0,0,0,5,2
20210719-W-Gdynia-R32-Federica_Di_Sarra-Irina_Maria_Bara,2,S-XC,19,0,0,0,0,13,6
20210719-W-Gdynia-R32-Federica_Di_Sarra-Irina_Maria_Bara,2,S-DTM,11,0,0,0,0,1,10
20210719-W-Gdynia-R32-Federica_Di_Sarra-Irina_Maria_Bara,2,S-DTL,5,0,0,0,0,2,3
20210611-W-Bol-SF-Arantxa_Rus-Irina_Maria_Bara,1,F-XC,40,7,4,3,0,28,12
20210611-W-Bol-SF-Arantxa_Rus-Irina_Maria_Bara,1,F-DTM,34,0,0,0,0,21,13
20210611-W-Bol-SF-Arantxa_Rus-Irina_Maria_Bara,1,F-DTL,1,1,0,0,1,0,1
20210611-W-Bol-SF-Arantxa_Rus-Irina_Maria_Bara,1,F-IO,23,8,3,1,4,16,7
20210611-W-Bol-SF-Arantxa_Rus-Irina_Maria_Bara,1,F-II,4,1,0,0,1,3,1
20210611-W-Bol-SF-Arantxa_Rus-Irina_Maria_Bara,1,B-XC,28,4,2,1,1,14,14
20210611-W-Bol-SF-Arantxa_Rus-Irina_Maria_Bara,1,B-DTM,42,1,0,0,1,24,18
20210611-W-Bol-SF-Arantxa_Rus-Irina_Maria_Bara,1,B-DTL,7,3,1,0,2,3,4
20210611-W-Bol-SF-Arantxa_Rus-Irina_Maria_Bara,1,B-IO,7,0,0,0,0,4,3
20210611-W-Bol-SF-Arantxa_Rus-Irina_Maria_Bara,1,S-XC,4,2,1,1,0,3,1
20210611-W-Bol-SF-Arantxa_Rus-Irina_Maria_Bara,1,S-DTM,3,1,0,0,1,2,1
20210611-W-Bol-SF-Arantxa_Rus-Irina_Maria_Bara,2,F-XC,45,7,1,0,6,12,33
20210611-W-Bol-SF-Arantxa_Rus-Irina_Maria_Bara,2,F-DTM,32,2,0,0,2,14,18
20210611-W-Bol-SF-Arantxa_Rus-Irina_Maria_Bara,2,F-DTL,6,3,1,0,2,2,4
20210611-W-Bol-SF-Arantxa_Rus-Irina_Maria_Bara,2,F-IO,12,7,3,2,2,7,5
20210611-W-Bol-SF-Arantxa_Rus-Irina_Maria_Bara,2,B-XC,22,5,1,1,3,8,14
20210611-W-Bol-SF-Arantxa_Rus-Irina_Maria_Bara,2,B-DTM,30,0,0,0,0,12,18
20210611-W-Bol-SF-Arantxa_Rus-Irina_Maria_Bara,2,B-DTL,7,2,0,1,1,3,4
20210611-W-Bol-SF-Arantxa_Rus-Irina_Maria_Bara,2,B-IO,18,3,0,0,3,9,9
20210611-W-Bol-SF-Arantxa_Rus-Irina_Maria_Bara,2,S-XC,3,0,0,0,0,1,2
20210611-W-Bol-SF-Arantxa_Rus-Irina_Maria_Bara,2,S-DTM,6,0,0,0,0,1,5
20210611-W-Bol-SF-Arantxa_Rus-Irina_Maria_Bara,2,S-DTL,2,0,0,0,0,1,1
20210611-W-Bol-SF-Arantxa_Rus-Irina_Maria_Bara,2,S-IO,1,0,0,0,0,0,1
20210622-W-Eastbourne-R32-Bianca_Andreescu-Christina_Mchale,1,F-XC,28,7,2,1,4,15,13
20210622-W-Eastbourne-R32-Bianca_Andreescu-Christina_Mchale,1,F-DTM,22,3,0,0,3,11,11
20210622-W-Eastbourne-R32-Bianca_Andreescu-Christina_Mchale,1,F-DTL,9,2,0,0,2,4,5
20210622-W-Eastbourne-R32-Bianca_Andreescu-Christina_Mchale,1,F-IO,27,9,1,6,2,18,9
20210622-W-Eastbourne-R32-Bianca_Andreescu-Christina_Mchale,1,B-XC,27,5,1,2,2,16,11
20210622-W-Eastbourne-R32-Bianca_Andreescu-Christina_Mchale,1,B-DTM,30,5,0,0,5,11,19
20210622-W-Eastbourne-R32-Bianca_Andreescu-Christina_Mchale,1,B-DTL,8,4,2,0,2,5,3
20210622-W-Eastbourne-R32-Bianca_Andreescu-Christina_Mchale,1,B-IO,12,3,0,1,2,8,4
20210622-W-Eastbourne-R32-Bianca_Andreescu-Christina_Mchale,1,S-XC,1,0,0,0,0,0,1
20210622-W-Eastbourne-R32-Bianca_Andreescu-Christina_Mchale,1,S-DTM,9,0,0,0,0,4,5
20210622-W-Eastbourne-R32-Bianca_Andreescu-Christina_Mchale,1,S-DTL,3,1,0,0,1,1,2
20210622-W-Eastbourne-R32-Bianca_Andreescu-Christina_Mchale,1,S-IO,3,2,0,0,2,0,3
20210622-W-Eastbourne-R32-Bianca_Andreescu-Christina_Mchale,2,F-XC,24,5,2,2,1,16,8
20210622-W-Eastbourne-R32-Bianca_Andreescu-Christina_Mchale,2,F-DTM,30,4,0,0,4,11,19
20210622-W-Eastbourne-R32-Bianca_Andreescu-Christina_Mchale,2,F-DTL,12,3,1,0,2,4,8
20210622-W-Eastbourne-R32-Bianca_Andreescu-Christina_Mchale,2,F-IO,27,8,2,0,6,11,16
20210622-W-Eastbourne-R32-Bianca_Andreescu-Christina_Mchale,2,F-II,3,2,1,1,0,3,0
20210622-W-Eastbourne-R32-Bianca_Andreescu-Christina_Mchale,2,B-XC,18,3,0,0,3,10,8
20210622-W-Eastbourne-R32-Bianca_Andreescu-Christina_Mchale,2,B-DTM,41,5,1,1,3,21,20
20210622-W-Eastbourne-R32-Bianca_Andreescu-Christina_Mchale,2,B-DTL,6,3,0,1,2,3,3
20210622-W-Eastbourne-R32-Bianca_Andreescu-Christina_Mchale,2,B-IO,4,2,2,0,0,4,0
20210622-W-Eastbourne-R32-Bianca_Andreescu-Christina_Mchale,2,S-XC,5,1,0,0,1,3,2
20210622-W-Eastbourne-R32-Bianca_Andreescu-Christina_Mchale,2,S-DTM,7,1,0,0,1,3,4
20210622-W-Eastbourne-R32-Bianca_Andreescu-Christina_Mchale,2,S-DTL,2,0,0,0,0,2,0
20210622-W-Eastbourne-R32-Bianca_Andreescu-Christina_Mchale,2,S-IO,2,0,0,0,0,1,1
20210729-W-Olympics-SF-Elina_Svitolina-Marketa_Vondrousova,1,F-XC,30,4,0,1,3,17,13
20210729-W-Olympics-SF-Elina_Svitolina-Marketa_Vondrousova,1,F-DTM,16,2,0,0,2,5,11
20210729-W-Olympics-SF-Elina_Svitolina-Marketa_Vondrousova,1,F-DTL,3,2,1,0,1,2,1
20210729-W-Olympics-SF-Elina_Svitolina-Marketa_Vondrousova,1,F-IO,12,4,1,1,2,3,9
20210729-W-Olympics-SF-Elina_Svitolina-Marketa_Vondrousova,1,B-XC,36,8,1,2,5,14,22
20210729-W-Olympics-SF-Elina_Svitolina-Marketa_Vondrousova,1,B-DTM,19,2,0,0,2,9,10
20210729-W-Olympics-SF-Elina_Svitolina-Marketa_Vondrousova,1,B-DTL,12,5,0,1,4,6,6
20210729-W-Olympics-SF-Elina_Svitolina-Marketa_Vondrousova,1,B-IO,3,1,1,0,0,2,1
20210729-W-Olympics-SF-Elina_Svitolina-Marketa_Vondrousova,1,S-XC,2,0,0,0,0,1,1
20210729-W-Olympics-SF-Elina_Svitolina-Marketa_Vondrousova,1,S-DTM,5,0,0,0,0,3,2
20210729-W-Olympics-SF-Elina_Svitolina-Marketa_Vondrousova,1,S-DTL,3,0,0,0,0,2,1
20210729-W-Olympics-SF-Elina_Svitolina-Marketa_Vondrousova,1,S-IO,1,1,0,0,1,0,1
20210729-W-Olympics-SF-Elina_Svitolina-Marketa_Vondrousova,2,F-XC,53,8,1,5,2,31,22
20210729-W-Olympics-SF-Elina_Svitolina-Marketa_Vondrousova,2,F-DTM,15,0,0,0,0,9,6
20210729-W-Olympics-SF-Elina_Svitolina-Marketa_Vondrousova,2,F-DTL,5,4,2,0,2,2,3
20210729-W-Olympics-SF-Elina_Svitolina-Marketa_Vondrousova,2,F-IO,8,5,3,0,2,4,4
20210729-W-Olympics-SF-Elina_Svitolina-Marketa_Vondrousova,2,F-II,1,1,1,0,0,1,0
20210729-W-Olympics-SF-Elina_Svitolina-Marketa_Vondrousova,2,B-XC,14,4,1,0,3,3,11
20210729-W-Olympics-SF-Elina_Svitolina-Marketa_Vondrousova,2,B-DTM,17,0,0,0,0,8,9
20210729-W-Olympics-SF-Elina_Svitolina-Marketa_Vondrousova,2,B-DTL,1,1,1,0,0,1,0
20210729-W-Olympics-SF-Elina_Svitolina-Marketa_Vondrousova,2,S-DTM,10,1,0,1,0,7,3
20210729-W-Olympics-SF-Elina_Svitolina-Marketa_Vondrousova,2,S-DTL,2,1,0,1,0,2,0
20210725-W-Olympics-R64-Carla_Suarez_Navarro-Ons_Jabeur,1,F-XC,17,7,4,1,2,12,5
20210725-W-Olympics-R64-Carla_Suarez_Navarro-Ons_Jabeur,1,F-DTM,10,1,0,1,0,6,4
20210725-W-Olympics-R64-Carla_Suarez_Navarro-Ons_Jabeur,1,F-DTL,5,1,0,1,0,3,2
20210725-W-Olympics-R64-Carla_Suarez_Navarro-Ons_Jabeur,1,F-IO,11,3,1,1,1,7,4
20210725-W-Olympics-R64-Carla_Suarez_Navarro-Ons_Jabeur,1,F-II,1,0,0,0,0,0,1
20210725-W-Olympics-R64-Carla_Suarez_Navarro-Ons_Jabeur,1,B-XC,11,2,1,0,1,6,5
20210725-W-Olympics-R64-Carla_Suarez_Navarro-Ons_Jabeur,1,B-DTM,14,0,0,0,0,6,8
20210725-W-Olympics-R64-Carla_Suarez_Navarro-Ons_Jabeur,1,B-DTL,5,3,3,0,0,5,0
20210725-W-Olympics-R64-Carla_Suarez_Navarro-Ons_Jabeur,1,B-IO,1,1,0,0,1,0,1
20210725-W-Olympics-R64-Carla_Suarez_Navarro-Ons_Jabeur,1,S-XC,5,0,0,0,0,3,2
20210725-W-Olympics-R64-Carla_Suarez_Navarro-Ons_Jabeur,1,S-DTM,4,0,0,0,0,3,1
20210725-W-Olympics-R64-Carla_Suarez_Navarro-Ons_Jabeur,1,S-DTL,1,0,0,0,0,0,1
20210725-W-Olympics-R64-Carla_Suarez_Navarro-Ons_Jabeur,2,F-XC,19,7,2,2,3,9,10
20210725-W-Olympics-R64-Carla_Suarez_Navarro-Ons_Jabeur,2,F-DTM,13,4,1,0,3,6,7
20210725-W-Olympics-R64-Carla_Suarez_Navarro-Ons_Jabeur,2,F-DTL,5,2,0,0,2,1,4
20210725-W-Olympics-R64-Carla_Suarez_Navarro-Ons_Jabeur,2,F-IO,9,6,2,0,4,2,7
20210725-W-Olympics-R64-Carla_Suarez_Navarro-Ons_Jabeur,2,B-XC,12,5,1,1,3,5,7
20210725-W-Olympics-R64-Carla_Suarez_Navarro-Ons_Jabeur,2,B-DTM,10,1,1,0,0,6,4
20210725-W-Olympics-R64-Carla_Suarez_Navarro-Ons_Jabeur,2,B-DTL,4,4,2,0,2,2,2
20210725-W-Olympics-R64-Carla_Suarez_Navarro-Ons_Jabeur,2,B-IO,3,1,0,0,1,2,1
20210725-W-Olympics-R64-Carla_Suarez_Navarro-Ons_Jabeur,2,S-XC,7,0,0,0,0,3,4
20210725-W-Olympics-R64-Carla_Suarez_Navarro-Ons_Jabeur,2,S-DTM,6,2,0,0,2,1,5
20210711-W-ITF_Amstelveen-F-Yana_Morderger-Quirine_Lemoine,1,F-XC,28,6,0,0,6,17,11
20210711-W-ITF_Amstelveen-F-Yana_Morderger-Quirine_Lemoine,1,F-DTM,16,0,0,0,0,11,5
20210711-W-ITF_Amstelveen-F-Yana_Morderger-Quirine_Lemoine,1,F-DTL,9,4,2,1,1,5,4
20210711-W-ITF_Amstelveen-F-Yana_Morderger-Quirine_Lemoine,1,F-IO,12,7,2,2,3,7,5
20210711-W-ITF_Amstelveen-F-Yana_Morderger-Quirine_Lemoine,1,F-II,1,1,1,0,0,1,0
20210711-W-ITF_Amstelveen-F-Yana_Morderger-Quirine_Lemoine,1,B-XC,44,14,6,5,3,23,21
20210711-W-ITF_Amstelveen-F-Yana_Morderger-Quirine_Lemoine,1,B-DTM,11,2,0,0,2,3,8
20210711-W-ITF_Amstelveen-F-Yana_Morderger-Quirine_Lemoine,1,B-DTL,10,5,2,0,3,4,6
20210711-W-ITF_Amstelveen-F-Yana_Morderger-Quirine_Lemoine,1,B-IO,10,7,3,1,3,7,3
20210711-W-ITF_Amstelveen-F-Yana_Morderger-Quirine_Lemoine,2,F-XC,39,17,6,3,8,21,18
20210711-W-ITF_Amstelveen-F-Yana_Morderger-Quirine_Lemoine,2,F-DTM,24,2,0,0,2,14,10
20210711-W-ITF_Amstelveen-F-Yana_Morderger-Quirine_Lemoine,2,F-DTL,10,5,3,0,2,6,4
20210711-W-ITF_Amstelveen-F-Yana_Morderger-Quirine_Lemoine,2,F-IO,7,4,1,2,1,4,3
20210711-W-ITF_Amstelveen-F-Yana_Morderger-Quirine_Lemoine,2,B-XC,21,9,3,2,4,10,11
20210711-W-ITF_Amstelveen-F-Yana_Morderger-Quirine_Lemoine,2,B-DTM,23,3,0,0,3,7,16
20210711-W-ITF_Amstelveen-F-Yana_Morderger-Quirine_Lemoine,2,B-DTL,3,2,0,1,1,1,2
20210711-W-ITF_Amstelveen-F-Yana_Morderger-Quirine_Lemoine,2,S-DTM,6,1,0,0,1,2,4
20210711-W-ITF_Amstelveen-F-Yana_Morderger-Quirine_Lemoine,2,S-DTL,1,1,0,1,0,1,0
20180314-W-Indian_Wells-QF-Karolina_Pliskova-Naomi_Osaka,1,F-XC,29,6,2,1,3,9,20
20180314-W-Indian_Wells-QF-Karolina_Pliskova-Naomi_Osaka,1,F-DTM,26,4,0,1,3,10,16
20180314-W-Indian_Wells-QF-Karolina_Pliskova-Naomi_Osaka,1,F-DTL,4,3,1,1,1,3,1
20180314-W-Indian_Wells-QF-Karolina_Pliskova-Naomi_Osaka,1,F-IO,13,3,0,0,3,6,7
20180314-W-Indian_Wells-QF-Karolina_Pliskova-Naomi_Osaka,1,F-II,1,1,1,0,0,1,0
20180314-W-Indian_Wells-QF-Karolina_Pliskova-Naomi_Osaka,1,B-XC,25,2,1,0,1,12,13
20180314-W-Indian_Wells-QF-Karolina_Pliskova-Naomi_Osaka,1,B-DTM,41,3,0,0,3,13,28
20180314-W-Indian_Wells-QF-Karolina_Pliskova-Naomi_Osaka,1,B-DTL,7,1,0,0,1,3,4
20180314-W-Indian_Wells-QF-Karolina_Pliskova-Naomi_Osaka,1,B-IO,5,2,0,0,2,3,2
20180314-W-Indian_Wells-QF-Karolina_Pliskova-Naomi_Osaka,1,S-XC,6,0,0,0,0,3,3
20180314-W-Indian_Wells-QF-Karolina_Pliskova-Naomi_Osaka,1,S-DTM,6,0,0,0,0,2,4
20180314-W-Indian_Wells-QF-Karolina_Pliskova-Naomi_Osaka,1,S-DTL,1,0,0,0,0,0,1
20180314-W-Indian_Wells-QF-Karolina_Pliskova-Naomi_Osaka,1,S-IO,1,0,0,0,0,1,0
20180314-W-Indian_Wells-QF-Karolina_Pliskova-Naomi_Osaka,2,F-XC,32,8,5,1,2,24,8
20180314-W-Indian_Wells-QF-Karolina_Pliskova-Naomi_Osaka,2,F-DTM,25,3,0,1,2,11,14
20180314-W-Indian_Wells-QF-Karolina_Pliskova-Naomi_Osaka,2,F-DTL,12,6,1,3,2,7,5
20180314-W-Indian_Wells-QF-Karolina_Pliskova-Naomi_Osaka,2,F-IO,16,8,1,2,5,8,8
20180314-W-Indian_Wells-QF-Karolina_Pliskova-Naomi_Osaka,2,F-II,1,1,0,1,0,1,0
20180314-W-Indian_Wells-QF-Karolina_Pliskova-Naomi_Osaka,2,B-XC,37,6,2,2,2,21,16
20180314-W-Indian_Wells-QF-Karolina_Pliskova-Naomi_Osaka,2,B-DTM,32,4,0,0,4,18,14
20180314-W-Indian_Wells-QF-Karolina_Pliskova-Naomi_Osaka,2,B-DTL,8,5,1,0,4,2,6
20180314-W-Indian_Wells-QF-Karolina_Pliskova-Naomi_Osaka,2,B-IO,10,3,2,1,0,9,1
20180314-W-Indian_Wells-QF-Karolina_Pliskova-Naomi_Osaka,2,S-XC,1,0,0,0,0,0,1
20180314-W-Indian_Wells-QF-Karolina_Pliskova-Naomi_Osaka,2,S-DTM,1,0,0,0,0,0,1
20180323-W-Miami-R64-Naomi_Osaka-Elina_Svitolina,1,F-XC,33,7,0,2,5,16,17
20180323-W-Miami-R64-Naomi_Osaka-Elina_Svitolina,1,F-DTM,22,2,0,0,2,10,12
20180323-W-Miami-R64-Naomi_Osaka-Elina_Svitolina,1,F-DTL,7,5,1,0,4,2,5
20180323-W-Miami-R64-Naomi_Osaka-Elina_Svitolina,1,F-IO,19,10,4,2,4,12,7
20180323-W-Miami-R64-Naomi_Osaka-Elina_Svitolina,1,B-XC,41,6,0,1,5,14,27
20180323-W-Miami-R64-Naomi_Osaka-Elina_Svitolina,1,B-DTM,24,1,0,0,1,6,18
20180323-W-Miami-R64-Naomi_Osaka-Elina_Svitolina,1,B-DTL,15,7,2,2,3,7,8
20180323-W-Miami-R64-Naomi_Osaka-Elina_Svitolina,1,B-IO,16,6,1,2,3,9,7
20180323-W-Miami-R64-Naomi_Osaka-Elina_Svitolina,1,S-DTM,2,0,0,0,0,0,2
20180323-W-Miami-R64-Naomi_Osaka-Elina_Svitolina,1,S-DTL,1,0,0,0,0,1,0
20180323-W-Miami-R64-Naomi_Osaka-Elina_Svitolina,2,F-XC,24,1,1,0,0,15,9
20180323-W-Miami-R64-Naomi_Osaka-Elina_Svitolina,2,F-DTM,23,1,1,0,0,11,12
20180323-W-Miami-R64-Naomi_Osaka-Elina_Svitolina,2,F-DTL,14,3,2,0,1,7,7
20180323-W-Miami-R64-Naomi_Osaka-Elina_Svitolina,2,F-IO,13,6,4,0,2,11,2
20180323-W-Miami-R64-Naomi_Osaka-Elina_Svitolina,2,B-XC,27,3,1,1,1,16,11
20180323-W-Miami-R64-Naomi_Osaka-Elina_Svitolina,2,B-DTM,24,1,0,0,1,12,12
20180323-W-Miami-R64-Naomi_Osaka-Elina_Svitolina,2,B-DTL,8,4,4,0,0,7,1
20180323-W-Miami-R64-Naomi_Osaka-Elina_Svitolina,2,B-IO,11,3,0,2,1,7,4
20180323-W-Miami-R64-Naomi_Osaka-Elina_Svitolina,2,S-XC,8,0,0,0,0,5,3
20180323-W-Miami-R64-Naomi_Osaka-Elina_Svitolina,2,S-DTM,4,0,0,0,0,2,2
20180323-W-Miami-R64-Naomi_Osaka-Elina_Svitolina,2,S-IO,1,1,0,0,1,0,1
20190618-W-Birmingham-R32-Maria_Sakkari-Naomi_Osaka,1,F-XC,21,9,2,5,2,14,7
20190618-W-Birmingham-R32-Maria_Sakkari-Naomi_Osaka,1,F-DTM,19,2,0,0,2,8,11
20190618-W-Birmingham-R32-Maria_Sakkari-Naomi_Osaka,1,F-DTL,4,1,0,0,1,2,2
20190618-W-Birmingham-R32-Maria_Sakkari-Naomi_Osaka,1,F-IO,11,6,1,0,5,3,8
20190618-W-Birmingham-R32-Maria_Sakkari-Naomi_Osaka,1,B-XC,19,8,1,3,4,11,8
20190618-W-Birmingham-R32-Maria_Sakkari-Naomi_Osaka,1,B-DTM,19,4,1,1,2,10,9
20190618-W-Birmingham-R32-Maria_Sakkari-Naomi_Osaka,1,B-DTL,2,1,1,0,0,1,1
20190618-W-Birmingham-R32-Maria_Sakkari-Naomi_Osaka,1,B-IO,7,1,0,0,1,2,5
20190618-W-Birmingham-R32-Maria_Sakkari-Naomi_Osaka,1,S-XC,11,0,0,0,0,9,2
20190618-W-Birmingham-R32-Maria_Sakkari-Naomi_Osaka,1,S-DTM,8,2,0,0,2,3,5
20190618-W-Birmingham-R32-Maria_Sakkari-Naomi_Osaka,1,S-DTL,1,0,0,0,0,0,1
20190618-W-Birmingham-R32-Maria_Sakkari-Naomi_Osaka,1,S-IO,2,2,0,2,0,2,0
20190618-W-Birmingham-R32-Maria_Sakkari-Naomi_Osaka,2,F-XC,21,12,4,5,3,16,5
20190618-W-Birmingham-R32-Maria_Sakkari-Naomi_Osaka,2,F-DTM,14,2,0,1,1,5,9
20190618-W-Birmingham-R32-Maria_Sakkari-Naomi_Osaka,2,F-DTL,7,2,2,0,0,2,5
20190618-W-Birmingham-R32-Maria_Sakkari-Naomi_Osaka,2,F-IO,15,7,4,2,1,9,6
20190618-W-Birmingham-R32-Maria_Sakkari-Naomi_Osaka,2,F-II,1,1,0,1,0,1,0
20190618-W-Birmingham-R32-Maria_Sakkari-Naomi_Osaka,2,B-XC,26,7,1,2,4,12,14
20190618-W-Birmingham-R32-Maria_Sakkari-Naomi_Osaka,2,B-DTM,22,3,0,0,3,9,13
20190618-W-Birmingham-R32-Maria_Sakkari-Naomi_Osaka,2,B-DTL,14,8,3,1,4,6,8
20190618-W-Birmingham-R32-Maria_Sakkari-Naomi_Osaka,2,B-IO,11,5,2,1,2,5,6
20190618-W-Birmingham-R32-Maria_Sakkari-Naomi_Osaka,2,S-XC,4,0,0,0,0,1,3
20190618-W-Birmingham-R32-Maria_Sakkari-Naomi_Osaka,2,S-DTM,3,1,0,0,1,1,2
20190618-W-Birmingham-R32-Maria_Sakkari-Naomi_Osaka,2,S-DTL,1,0,0,0,0,0,1
20200826-W-Cincinnati-QF-Naomi_Osaka-Anett_Kontaveit,1,F-XC,35,15,5,2,8,18,17
20200826-W-Cincinnati-QF-Naomi_Osaka-Anett_Kontaveit,1,F-DTM,28,4,0,1,3,16,12
20200826-W-Cincinnati-QF-Naomi_Osaka-Anett_Kontaveit,1,F-DTL,9,3,2,0,1,5,4
20200826-W-Cincinnati-QF-Naomi_Osaka-Anett_Kontaveit,1,F-IO,14,5,1,1,3,9,5
20200826-W-Cincinnati-QF-Naomi_Osaka-Anett_Kontaveit,1,B-XC,31,11,3,5,3,21,10
20200826-W-Cincinnati-QF-Naomi_Osaka-Anett_Kontaveit,1,B-DTM,40,2,0,0,2,20,20
20200826-W-Cincinnati-QF-Naomi_Osaka-Anett_Kontaveit,1,B-DTL,8,4,1,2,1,4,4
20200826-W-Cincinnati-QF-Naomi_Osaka-Anett_Kontaveit,1,B-IO,19,8,2,1,5,11,8
20200826-W-Cincinnati-QF-Naomi_Osaka-Anett_Kontaveit,1,S-XC,1,0,0,0,0,0,1
20200826-W-Cincinnati-QF-Naomi_Osaka-Anett_Kontaveit,1,S-DTM,3,0,0,0,0,0,3
20200826-W-Cincinnati-QF-Naomi_Osaka-Anett_Kontaveit,1,S-DTL,1,0,0,0,0,1,0
20200826-W-Cincinnati-QF-Naomi_Osaka-Anett_Kontaveit,2,F-XC,42,12,4,3,5,21,21
20200826-W-Cincinnati-QF-Naomi_Osaka-Anett_Kontaveit,2,F-DTM,35,4,1,0,3,17,18
20200826-W-Cincinnati-QF-Naomi_Osaka-Anett_Kontaveit,2,F-DTL,3,1,0,0,1,0,3
20200826-W-Cincinnati-QF-Naomi_Osaka-Anett_Kontaveit,2,F-IO,7,4,1,0,3,3,4
20200826-W-Cincinnati-QF-Naomi_Osaka-Anett_Kontaveit,2,F-II,1,1,1,0,0,1,0
20200826-W-Cincinnati-QF-Naomi_Osaka-Anett_Kontaveit,2,B-XC,38,11,3,1,7,18,20
20200826-W-Cincinnati-QF-Naomi_Osaka-Anett_Kontaveit,2,B-DTM,44,7,0,1,6,13,31
20200826-W-Cincinnati-QF-Naomi_Osaka-Anett_Kontaveit,2,B-DTL,9,4,1,0,3,3,6
20200826-W-Cincinnati-QF-Naomi_Osaka-Anett_Kontaveit,2,B-IO,6,4,2,0,2,4,2
20200826-W-Cincinnati-QF-Naomi_Osaka-Anett_Kontaveit,2,S-XC,2,0,0,0,0,1,1
20210205-W-Grampians_Trophy-QF-Jennifer_Brady-Barbora_Krejcikova,1,F-XC,18,6,1,1,4,9,9
20210205-W-Grampians_Trophy-QF-Jennifer_Brady-Barbora_Krejcikova,1,F-DTM,22,4,1,2,1,12,10
20210205-W-Grampians_Trophy-QF-Jennifer_Brady-Barbora_Krejcikova,1,F-DTL,4,1,1,0,0,3,1
20210205-W-Grampians_Trophy-QF-Jennifer_Brady-Barbora_Krejcikova,1,F-IO,13,7,4,0,3,7,6
20210205-W-Grampians_Trophy-QF-Jennifer_Brady-Barbora_Krejcikova,1,B-XC,17,7,5,0,2,13,4
20210205-W-Grampians_Trophy-QF-Jennifer_Brady-Barbora_Krejcikova,1,B-DTM,24,2,0,0,2,11,13
20210205-W-Grampians_Trophy-QF-Jennifer_Brady-Barbora_Krejcikova,1,B-DTL,9,4,2,0,2,5,4
20210205-W-Grampians_Trophy-QF-Jennifer_Brady-Barbora_Krejcikova,1,B-IO,4,2,1,0,1,2,2
20210205-W-Grampians_Trophy-QF-Jennifer_Brady-Barbora_Krejcikova,1,S-DTM,2,0,0,0,0,2,0
20210205-W-Grampians_Trophy-QF-Jennifer_Brady-Barbora_Krejcikova,1,S-DTL,5,0,0,0,0,1,4
20210205-W-Grampians_Trophy-QF-Jennifer_Brady-Barbora_Krejcikova,2,F-XC,20,10,4,4,2,13,7
20210205-W-Grampians_Trophy-QF-Jennifer_Brady-Barbora_Krejcikova,2,F-DTM,11,3,0,1,2,6,5
20210205-W-Grampians_Trophy-QF-Jennifer_Brady-Barbora_Krejcikova,2,F-DTL,10,4,2,0,2,5,5
20210205-W-Grampians_Trophy-QF-Jennifer_Brady-Barbora_Krejcikova,2,F-IO,34,13,5,1,7,15,19
20210205-W-Grampians_Trophy-QF-Jennifer_Brady-Barbora_Krejcikova,2,F-II,2,2,1,1,0,2,0
20210205-W-Grampians_Trophy-QF-Jennifer_Brady-Barbora_Krejcikova,2,B-XC,21,7,0,0,7,5,16
20210205-W-Grampians_Trophy-QF-Jennifer_Brady-Barbora_Krejcikova,2,B-DTM,14,0,0,0,0,7,7
20210205-W-Grampians_Trophy-QF-Jennifer_Brady-Barbora_Krejcikova,2,B-DTL,9,6,2,0,4,4,5
20210205-W-Grampians_Trophy-QF-Jennifer_Brady-Barbora_Krejcikova,2,B-IO,10,6,3,1,2,6,4
20210205-W-Grampians_Trophy-QF-Jennifer_Brady-Barbora_Krejcikova,2,S-XC,3,0,0,0,0,1,2
20210205-W-Grampians_Trophy-QF-Jennifer_Brady-Barbora_Krejcikova,2,S-DTM,2,0,0,0,0,1,1
20210502-W-Madrid-R32-Jennifer_Brady-Jelena_Ostapenko,1,F-XC,13,3,2,1,0,12,1
20210502-W-Madrid-R32-Jennifer_Brady-Jelena_Ostapenko,1,F-DTM,11,1,0,0,1,7,4
20210502-W-Madrid-R32-Jennifer_Brady-Jelena_Ostapenko,1,F-DTL,1,1,0,1,0,1,0
20210502-W-Madrid-R32-Jennifer_Brady-Jelena_Ostapenko,1,F-IO,11,4,2,0,2,8,3
20210502-W-Madrid-R32-Jennifer_Brady-Jelena_Ostapenko,1,B-XC,10,2,1,0,1,5,5
20210502-W-Madrid-R32-Jennifer_Brady-Jelena_Ostapenko,1,B-DTM,14,0,0,0,0,10,4
20210502-W-Madrid-R32-Jennifer_Brady-Jelena_Ostapenko,1,B-DTL,3,0,0,0,0,2,1
20210502-W-Madrid-R32-Jennifer_Brady-Jelena_Ostapenko,1,B-IO,1,1,1,0,0,1,0
20210502-W-Madrid-R32-Jennifer_Brady-Jelena_Ostapenko,1,S-DTM,3,0,0,0,0,1,2
20210502-W-Madrid-R32-Jennifer_Brady-Jelena_Ostapenko,1,S-DTL,6,1,1,0,0,4,2
20210502-W-Madrid-R32-Jennifer_Brady-Jelena_Ostapenko,2,F-XC,21,9,3,2,4,11,10
20210502-W-Madrid-R32-Jennifer_Brady-Jelena_Ostapenko,2,F-DTM,9,2,0,0,2,1,8
20210502-W-Madrid-R32-Jennifer_Brady-Jelena_Ostapenko,2,F-DTL,8,3,1,0,2,1,7
20210502-W-Madrid-R32-Jennifer_Brady-Jelena_Ostapenko,2,F-IO,10,5,2,1,2,5,5
20210502-W-Madrid-R32-Jennifer_Brady-Jelena_Ostapenko,2,B-XC,22,9,4,2,3,10,12
20210502-W-Madrid-R32-Jennifer_Brady-Jelena_Ostapenko,2,B-DTM,11,2,0,0,2,2,9
20210502-W-Madrid-R32-Jennifer_Brady-Jelena_Ostapenko,2,B-DTL,4,3,1,1,1,3,1
20210502-W-Madrid-R32-Jennifer_Brady-Jelena_Ostapenko,2,B-IO,6,5,3,0,2,4,2
20210502-W-Madrid-R32-Jennifer_Brady-Jelena_Ostapenko,2,S-XC,1,0,0,0,0,1,0
20210512-W-Rome-R32-Naomi_Osaka-Jessica_Pegula,1,F-XC,30,11,5,2,4,15,15
20210512-W-Rome-R32-Naomi_Osaka-Jessica_Pegula,1,F-DTM,13,2,0,0,2,5,8
20210512-W-Rome-R32-Naomi_Osaka-Jessica_Pegula,1,F-DTL,8,4,4,0,0,5,3
20210512-W-Rome-R32-Naomi_Osaka-Jessica_Pegula,1,F-IO,11,4,4,0,0,7,4
20210512-W-Rome-R32-Naomi_Osaka-Jessica_Pegula,1,B-XC,39,14,1,3,10,15,24
20210512-W-Rome-R32-Naomi_Osaka-Jessica_Pegula,1,B-DTM,12,3,0,0,3,2,10
20210512-W-Rome-R32-Naomi_Osaka-Jessica_Pegula,1,B-DTL,11,6,1,4,1,8,3
20210512-W-Rome-R32-Naomi_Osaka-Jessica_Pegula,1,B-IO,8,4,0,1,3,2,6
20210512-W-Rome-R32-Naomi_Osaka-Jessica_Pegula,1,S-DTM,2,1,0,0,1,0,2
20210512-W-Rome-R32-Naomi_Osaka-Jessica_Pegula,1,S-DTL,1,1,0,0,1,0,1
20210512-W-Rome-R32-Naomi_Osaka-Jessica_Pegula,2,F-XC,27,14,8,4,2,19,8
20210512-W-Rome-R32-Naomi_Osaka-Jessica_Pegula,2,F-DTM,20,2,0,2,0,14,6
20210512-W-Rome-R32-Naomi_Osaka-Jessica_Pegula,2,F-DTL,9,6,2,2,2,5,4
20210512-W-Rome-R32-Naomi_Osaka-Jessica_Pegula,2,F-IO,5,3,1,1,1,3,2
20210512-W-Rome-R32-Naomi_Osaka-Jessica_Pegula,2,B-XC,23,3,1,0,2,15,8
20210512-W-Rome-R32-Naomi_Osaka-Jessica_Pegula,2,B-DTM,24,3,0,1,2,15,9
20210512-W-Rome-R32-Naomi_Osaka-Jessica_Pegula,2,B-DTL,10,4,1,1,2,4,6
20210512-W-Rome-R32-Naomi_Osaka-Jessica_Pegula,2,B-IO,3,1,0,0,1,1,2
20210512-W-Rome-R32-Naomi_Osaka-Jessica_Pegula,2,S-XC,9,1,0,0,1,2,7
20210512-W-Rome-R32-Naomi_Osaka-Jessica_Pegula,2,S-DTM,5,0,0,0,0,3,2
20210805-W-Cluj_Napoca-R16-Alexandra_Eala-Mayar_Sherif,1,F-XC,37,9,3,3,3,20,17
20210805-W-Cluj_Napoca-R16-Alexandra_Eala-Mayar_Sherif,1,F-DTM,3,0,0,0,0,1,2
20210805-W-Cluj_Napoca-R16-Alexandra_Eala-Mayar_Sherif,1,F-DTL,4,2,0,1,1,1,3
20210805-W-Cluj_Napoca-R16-Alexandra_Eala-Mayar_Sherif,1,F-IO,8,3,1,1,1,5,3
20210805-W-Cluj_Napoca-R16-Alexandra_Eala-Mayar_Sherif,1,F-II,2,2,0,0,2,0,2
20210805-W-Cluj_Napoca-R16-Alexandra_Eala-Mayar_Sherif,1,B-XC,33,7,3,4,0,19,14
20210805-W-Cluj_Napoca-R16-Alexandra_Eala-Mayar_Sherif,1,B-DTM,5,2,0,2,0,3,2
20210805-W-Cluj_Napoca-R16-Alexandra_Eala-Mayar_Sherif,1,B-DTL,4,1,0,1,0,3,1
20210805-W-Cluj_Napoca-R16-Alexandra_Eala-Mayar_Sherif,1,B-IO,8,2,1,1,0,5,3
20210805-W-Cluj_Napoca-R16-Alexandra_Eala-Mayar_Sherif,2,F-XC,25,5,3,1,1,13,12
20210805-W-Cluj_Napoca-R16-Alexandra_Eala-Mayar_Sherif,2,F-DTM,7,1,0,1,0,4,3
20210805-W-Cluj_Napoca-R16-Alexandra_Eala-Mayar_Sherif,2,F-DTL,12,5,5,0,0,9,3
20210805-W-Cluj_Napoca-R16-Alexandra_Eala-Mayar_Sherif,2,F-IO,8,3,1,0,2,2,6
20210805-W-Cluj_Napoca-R16-Alexandra_Eala-Mayar_Sherif,2,F-II,1,0,0,0,0,0,1
20210805-W-Cluj_Napoca-R16-Alexandra_Eala-Mayar_Sherif,2,B-XC,19,4,1,1,2,9,10
20210805-W-Cluj_Napoca-R16-Alexandra_Eala-Mayar_Sherif,2,B-DTM,13,1,0,1,0,8,5
20210805-W-Cluj_Napoca-R16-Alexandra_Eala-Mayar_Sherif,2,B-DTL,4,0,0,0,0,1,3
20210805-W-Cluj_Napoca-R16-Alexandra_Eala-Mayar_Sherif,2,S-DTM,4,0,0,0,0,3,1
20210805-W-Cluj_Napoca-R16-Alexandra_Eala-Mayar_Sherif,2,S-DTL,4,1,0,0,1,0,4
20210726-W-Olympics-R32-Karolina_Pliskova-Carla_Suarez_Navarro,1,F-XC,27,8,4,3,1,21,6
20210726-W-Olympics-R32-Karolina_Pliskova-Carla_Suarez_Navarro,1,F-DTM,19,3,0,0,3,10,9
20210726-W-Olympics-R32-Karolina_Pliskova-Carla_Suarez_Navarro,1,F-DTL,2,1,0,1,0,2,0
20210726-W-Olympics-R32-Karolina_Pliskova-Carla_Suarez_Navarro,1,F-IO,21,12,8,2,2,18,3
20210726-W-Olympics-R32-Karolina_Pliskova-Carla_Suarez_Navarro,1,F-II,3,1,1,0,0,2,1
20210726-W-Olympics-R32-Karolina_Pliskova-Carla_Suarez_Navarro,1,B-XC,33,6,3,0,3,19,14
20210726-W-Olympics-R32-Karolina_Pliskova-Carla_Suarez_Navarro,1,B-DTM,42,7,0,2,5,21,21
20210726-W-Olympics-R32-Karolina_Pliskova-Carla_Suarez_Navarro,1,B-DTL,9,7,4,2,1,8,1
20210726-W-Olympics-R32-Karolina_Pliskova-Carla_Suarez_Navarro,1,B-IO,8,2,0,0,2,1,7
20210726-W-Olympics-R32-Karolina_Pliskova-Carla_Suarez_Navarro,1,S-XC,5,1,0,0,1,2,3
20210726-W-Olympics-R32-Karolina_Pliskova-Carla_Suarez_Navarro,1,S-DTM,7,0,0,0,0,2,5
20210726-W-Olympics-R32-Karolina_Pliskova-Carla_Suarez_Navarro,1,S-IO,2,1,0,1,0,2,0
20210726-W-Olympics-R32-Karolina_Pliskova-Carla_Suarez_Navarro,2,F-XC,23,12,9,0,3,14,9
20210726-W-Olympics-R32-Karolina_Pliskova-Carla_Suarez_Navarro,2,F-DTM,31,1,0,1,0,14,17
20210726-W-Olympics-R32-Karolina_Pliskova-Carla_Suarez_Navarro,2,F-DTL,19,10,4,0,6,8,11
20210726-W-Olympics-R32-Karolina_Pliskova-Carla_Suarez_Navarro,2,F-IO,27,10,3,1,6,10,17
20210726-W-Olympics-R32-Karolina_Pliskova-Carla_Suarez_Navarro,2,F-II,1,1,1,0,0,1,0
20210726-W-Olympics-R32-Karolina_Pliskova-Carla_Suarez_Navarro,2,B-XC,31,9,1,2,6,12,19
20210726-W-Olympics-R32-Karolina_Pliskova-Carla_Suarez_Navarro,2,B-DTM,35,3,0,1,2,20,15
20210726-W-Olympics-R32-Karolina_Pliskova-Carla_Suarez_Navarro,2,B-DTL,4,4,2,0,2,2,2
20210726-W-Olympics-R32-Karolina_Pliskova-Carla_Suarez_Navarro,2,B-IO,2,1,0,0,1,0,2
20210726-W-Olympics-R32-Karolina_Pliskova-Carla_Suarez_Navarro,2,S-XC,8,4,0,0,4,2,6
20210726-W-Olympics-R32-Karolina_Pliskova-Carla_Suarez_Navarro,2,S-DTM,7,0,0,0,0,2,5
20210726-W-Olympics-R32-Karolina_Pliskova-Carla_Suarez_Navarro,2,S-DTL,1,0,0,0,0,0,1
20200224-W-Doha-R64-Iga_Swiatek-Donna_Vekic,1,F-XC,40,13,6,2,5,24,16
20200224-W-Doha-R64-Iga_Swiatek-Donna_Vekic,1,F-DTM,20,4,2,0,2,9,11
20200224-W-Doha-R64-Iga_Swiatek-Donna_Vekic,1,F-DTL,8,2,1,0,1,4,4
20200224-W-Doha-R64-Iga_Swiatek-Donna_Vekic,1,F-IO,15,8,6,0,2,11,4
20200224-W-Doha-R64-Iga_Swiatek-Donna_Vekic,1,F-II,2,2,2,0,0,2,0
20200224-W-Doha-R64-Iga_Swiatek-Donna_Vekic,1,B-XC,25,6,1,1,4,15,10
20200224-W-Doha-R64-Iga_Swiatek-Donna_Vekic,1,B-DTM,33,2,0,1,1,16,17
20200224-W-Doha-R64-Iga_Swiatek-Donna_Vekic,1,B-DTL,13,8,4,0,4,5,8
20200224-W-Doha-R64-Iga_Swiatek-Donna_Vekic,1,B-IO,15,4,3,0,1,10,5
20200224-W-Doha-R64-Iga_Swiatek-Donna_Vekic,1,S-XC,3,1,0,0,1,1,2
20200224-W-Doha-R64-Iga_Swiatek-Donna_Vekic,1,S-DTM,1,0,0,0,0,0,1
20200224-W-Doha-R64-Iga_Swiatek-Donna_Vekic,1,S-DTL,1,0,0,0,0,0,1
20200224-W-Doha-R64-Iga_Swiatek-Donna_Vekic,1,S-IO,1,0,0,0,0,1,0
20200224-W-Doha-R64-Iga_Swiatek-Donna_Vekic,2,F-XC,32,2,0,0,2,17,15
20200224-W-Doha-R64-Iga_Swiatek-Donna_Vekic,2,F-DTM,43,4,1,1,2,19,24
20200224-W-Doha-R64-Iga_Swiatek-Donna_Vekic,2,F-DTL,6,2,1,0,1,3,3
20200224-W-Doha-R64-Iga_Swiatek-Donna_Vekic,2,F-IO,20,10,2,2,6,10,10
20200224-W-Doha-R64-Iga_Swiatek-Donna_Vekic,2,B-XC,21,1,0,1,0,9,12
20200224-W-Doha-R64-Iga_Swiatek-Donna_Vekic,2,B-DTM,28,3,0,1,2,9,19
20200224-W-Doha-R64-Iga_Swiatek-Donna_Vekic,2,B-DTL,4,3,2,0,1,2,2
20200224-W-Doha-R64-Iga_Swiatek-Donna_Vekic,2,B-IO,5,3,2,0,1,3,2
20200224-W-Doha-R64-Iga_Swiatek-Donna_Vekic,2,S-XC,1,0,0,0,0,0,1
20200224-W-Doha-R64-Iga_Swiatek-Donna_Vekic,2,S-DTL,1,0,0,0,0,0,1
20200224-W-Doha-R64-Iga_Swiatek-Donna_Vekic,2,S-IO,1,0,0,0,0,0,1
20210301-W-Doha-R32-Anett_Kontaveit-Jennifer_Brady,1,F-XC,17,3,1,0,2,9,8
20210301-W-Doha-R32-Anett_Kontaveit-Jennifer_Brady,1,F-DTM,11,2,1,0,1,8,3
20210301-W-Doha-R32-Anett_Kontaveit-Jennifer_Brady,1,F-DTL,4,2,0,1,1,2,2
20210301-W-Doha-R32-Anett_Kontaveit-Jennifer_Brady,1,F-IO,5,1,1,0,0,2,3
20210301-W-Doha-R32-Anett_Kontaveit-Jennifer_Brady,1,B-XC,19,6,4,1,1,13,6
20210301-W-Doha-R32-Anett_Kontaveit-Jennifer_Brady,1,B-DTM,9,0,0,0,0,4,5
20210301-W-Doha-R32-Anett_Kontaveit-Jennifer_Brady,1,B-DTL,1,0,0,0,0,1,0
20210301-W-Doha-R32-Anett_Kontaveit-Jennifer_Brady,1,B-IO,2,2,2,0,0,2,0
20210301-W-Doha-R32-Anett_Kontaveit-Jennifer_Brady,1,S-DTM,1,0,0,0,0,0,1
20210301-W-Doha-R32-Anett_Kontaveit-Jennifer_Brady,2,F-XC,21,7,1,1,5,8,13
20210301-W-Doha-R32-Anett_Kontaveit-Jennifer_Brady,2,F-DTM,8,0,0,0,0,4,4
20210301-W-Doha-R32-Anett_Kontaveit-Jennifer_Brady,2,F-DTL,4,3,1,0,2,2,2
20210301-W-Doha-R32-Anett_Kontaveit-Jennifer_Brady,2,F-IO,9,5,3,1,1,5,4
20210301-W-Doha-R32-Anett_Kontaveit-Jennifer_Brady,2,B-XC,11,3,1,0,2,5,6
20210301-W-Doha-R32-Anett_Kontaveit-Jennifer_Brady,2,B-DTM,12,3,1,1,1,6,6
20210301-W-Doha-R32-Anett_Kontaveit-Jennifer_Brady,2,B-DTL,7,5,1,0,4,1,6
20210301-W-Doha-R32-Anett_Kontaveit-Jennifer_Brady,2,B-IO,3,1,1,0,0,3,0
20210301-W-Doha-R32-Anett_Kontaveit-Jennifer_Brady,2,S-XC,1,0,0,0,0,0,1
20210301-W-Doha-R32-Anett_Kontaveit-Jennifer_Brady,2,S-DTM,2,0,0,0,0,1,1
20210301-W-Doha-R32-Anett_Kontaveit-Jennifer_Brady,2,S-DTL,1,0,0,0,0,0,1
20210301-W-Doha-R32-Anett_Kontaveit-Jennifer_Brady,2,S-IO,1,0,0,0,0,0,1
20210623-W-Eastbourne-R16-Bianca_Andreescu-Anett_Kontaveit,1,F-XC,23,8,1,0,7,9,14
20210623-W-Eastbourne-R16-Bianca_Andreescu-Anett_Kontaveit,1,F-DTM,22,1,0,0,1,6,16
20210623-W-Eastbourne-R16-Bianca_Andreescu-Anett_Kontaveit,1,F-DTL,5,1,0,0,1,1,4
20210623-W-Eastbourne-R16-Bianca_Andreescu-Anett_Kontaveit,1,F-IO,7,2,0,1,1,4,3
20210623-W-Eastbourne-R16-Bianca_Andreescu-Anett_Kontaveit,1,B-XC,6,3,1,0,2,1,5
20210623-W-Eastbourne-R16-Bianca_Andreescu-Anett_Kontaveit,1,B-DTM,10,1,0,0,1,6,4
20210623-W-Eastbourne-R16-Bianca_Andreescu-Anett_Kontaveit,1,B-DTL,4,2,0,0,2,0,4
20210623-W-Eastbourne-R16-Bianca_Andreescu-Anett_Kontaveit,1,B-IO,4,2,1,0,1,2,2
20210623-W-Eastbourne-R16-Bianca_Andreescu-Anett_Kontaveit,1,S-DTM,13,1,0,0,1,5,8
20210623-W-Eastbourne-R16-Bianca_Andreescu-Anett_Kontaveit,1,S-DTL,2,1,0,0,1,1,1
20210623-W-Eastbourne-R16-Bianca_Andreescu-Anett_Kontaveit,1,S-IO,2,1,0,0,1,1,1
20210623-W-Eastbourne-R16-Bianca_Andreescu-Anett_Kontaveit,2,F-XC,31,8,4,0,4,19,12
20210623-W-Eastbourne-R16-Bianca_Andreescu-Anett_Kontaveit,2,F-DTM,17,1,0,1,0,10,7
20210623-W-Eastbourne-R16-Bianca_Andreescu-Anett_Kontaveit,2,F-DTL,7,4,2,0,2,3,4
20210623-W-Eastbourne-R16-Bianca_Andreescu-Anett_Kontaveit,2,F-IO,10,6,2,1,3,5,5
20210623-W-Eastbourne-R16-Bianca_Andreescu-Anett_Kontaveit,2,B-XC,18,4,2,2,0,11,7
20210623-W-Eastbourne-R16-Bianca_Andreescu-Anett_Kontaveit,2,B-DTM,16,4,0,0,4,10,6
20210623-W-Eastbourne-R16-Bianca_Andreescu-Anett_Kontaveit,2,B-DTL,4,1,1,0,0,4,0
20210623-W-Eastbourne-R16-Bianca_Andreescu-Anett_Kontaveit,2,B-IO,6,3,1,1,1,2,4
20210623-W-Eastbourne-R16-Bianca_Andreescu-Anett_Kontaveit,2,S-XC,2,0,0,0,0,1,1
20210623-W-Eastbourne-R16-Bianca_Andreescu-Anett_Kontaveit,2,S-DTM,2,1,0,1,0,2,0
20210329-W-Miami-R16-Naomi_Osaka-Elise_Mertens,1,F-XC,17,10,6,1,3,10,7
20210329-W-Miami-R16-Naomi_Osaka-Elise_Mertens,1,F-DTM,13,0,0,0,0,6,7
20210329-W-Miami-R16-Naomi_Osaka-Elise_Mertens,1,F-DTL,3,2,0,2,0,2,1
20210329-W-Miami-R16-Naomi_Osaka-Elise_Mertens,1,F-IO,17,12,5,1,6,9,8
20210329-W-Miami-R16-Naomi_Osaka-Elise_Mertens,1,F-II,3,1,1,0,0,1,2
20210329-W-Miami-R16-Naomi_Osaka-Elise_Mertens,1,B-XC,44,8,2,1,5,20,24
20210329-W-Miami-R16-Naomi_Osaka-Elise_Mertens,1,B-DTM,21,3,0,0,3,7,14
20210329-W-Miami-R16-Naomi_Osaka-Elise_Mertens,1,B-DTL,8,1,0,0,1,5,3
20210329-W-Miami-R16-Naomi_Osaka-Elise_Mertens,1,B-IO,12,8,4,1,3,6,6
20210329-W-Miami-R16-Naomi_Osaka-Elise_Mertens,1,S-DTL,1,0,0,0,0,0,1
20210329-W-Miami-R16-Naomi_Osaka-Elise_Mertens,2,F-XC,9,1,0,0,1,4,5
20210329-W-Miami-R16-Naomi_Osaka-Elise_Mertens,2,F-DTM,12,1,0,0,1,6,6
20210329-W-Miami-R16-Naomi_Osaka-Elise_Mertens,2,F-DTL,13,4,1,2,1,8,5
20210329-W-Miami-R16-Naomi_Osaka-Elise_Mertens,2,F-IO,16,3,3,0,0,12,4
20210329-W-Miami-R16-Naomi_Osaka-Elise_Mertens,2,F-II,1,0,0,0,0,0,1
20210329-W-Miami-R16-Naomi_Osaka-Elise_Mertens,2,B-XC,22,5,2,0,3,13,9
20210329-W-Miami-R16-Naomi_Osaka-Elise_Mertens,2,B-DTM,21,1,0,0,1,11,10
20210329-W-Miami-R16-Naomi_Osaka-Elise_Mertens,2,B-DTL,8,7,4,0,3,5,3
20210329-W-Miami-R16-Naomi_Osaka-Elise_Mertens,2,B-IO,4,1,1,0,0,3,1
20210329-W-Miami-R16-Naomi_Osaka-Elise_Mertens,2,S-XC,8,2,1,0,1,2,6
20210329-W-Miami-R16-Naomi_Osaka-Elise_Mertens,2,S-DTM,10,1,0,0,1,3,7
20210329-W-Miami-R16-Naomi_Osaka-Elise_Mertens,2,S-DTL,2,0,0,0,0,0,2
20210329-W-Miami-R16-Naomi_Osaka-Elise_Mertens,2,S-IO,3,1,0,0,1,1,2
20210810-W-Montreal-R32-Bianca_Andreescu-Harriet_Dart,1,F-XC,30,10,2,4,4,18,12
20210810-W-Montreal-R32-Bianca_Andreescu-Harriet_Dart,1,F-DTM,35,6,0,0,6,9,26
20210810-W-Montreal-R32-Bianca_Andreescu-Harriet_Dart,1,F-DTL,7,3,1,1,1,3,4
20210810-W-Montreal-R32-Bianca_Andreescu-Harriet_Dart,1,F-IO,26,12,6,2,4,16,10
20210810-W-Montreal-R32-Bianca_Andreescu-Harriet_Dart,1,B-XC,19,9,4,3,2,12,7
20210810-W-Montreal-R32-Bianca_Andreescu-Harriet_Dart,1,B-DTM,23,2,0,0,2,11,12
20210810-W-Montreal-R32-Bianca_Andreescu-Harriet_Dart,1,B-DTL,3,1,0,1,0,2,1
20210810-W-Montreal-R32-Bianca_Andreescu-Harriet_Dart,1,B-IO,9,9,4,2,3,6,3
20210810-W-Montreal-R32-Bianca_Andreescu-Harriet_Dart,1,S-XC,5,0,0,0,0,4,1
20210810-W-Montreal-R32-Bianca_Andreescu-Harriet_Dart,1,S-DTM,12,1,0,0,1,5,7
20210810-W-Montreal-R32-Bianca_Andreescu-Harriet_Dart,1,S-DTL,4,2,1,0,1,1,3
20210810-W-Montreal-R32-Bianca_Andreescu-Harriet_Dart,2,F-XC,41,10,4,1,5,26,15
20210810-W-Montreal-R32-Bianca_Andreescu-Harriet_Dart,2,F-DTM,25,4,0,1,3,15,10
20210810-W-Montreal-R32-Bianca_Andreescu-Harriet_Dart,2,F-DTL,7,4,2,1,1,4,3
20210810-W-Montreal-R32-Bianca_Andreescu-Harriet_Dart,2,F-IO,17,4,2,2,0,10,7
20210810-W-Montreal-R32-Bianca_Andreescu-Harriet_Dart,2,F-II,2,1,0,0,1,0,2
20210810-W-Montreal-R32-Bianca_Andreescu-Harriet_Dart,2,B-XC,25,5,1,1,3,9,16
20210810-W-Montreal-R32-Bianca_Andreescu-Harriet_Dart,2,B-DTM,39,0,0,0,0,19,20
20210810-W-Montreal-R32-Bianca_Andreescu-Harriet_Dart,2,B-DTL,6,5,4,0,1,4,2
20210810-W-Montreal-R32-Bianca_Andreescu-Harriet_Dart,2,B-IO,8,3,1,0,2,5,3
20210810-W-Montreal-R32-Bianca_Andreescu-Harriet_Dart,2,S-XC,2,0,0,0,0,1,1
20210810-W-Montreal-R32-Bianca_Andreescu-Harriet_Dart,2,S-DTM,1,0,0,0,0,0,1
20210811-W-Montreal-R32-Rebecca_Marino-Paula_Badosa,1,F-XC,68,25,9,3,13,28,40
20210811-W-Montreal-R32-Rebecca_Marino-Paula_Badosa,1,F-DTM,39,9,0,0,9,14,25
20210811-W-Montreal-R32-Rebecca_Marino-Paula_Badosa,1,F-DTL,9,6,2,1,3,3,6
20210811-W-Montreal-R32-Rebecca_Marino-Paula_Badosa,1,F-IO,26,12,6,0,6,15,11
20210811-W-Montreal-R32-Rebecca_Marino-Paula_Badosa,1,F-II,2,2,0,1,1,1,1
20210811-W-Montreal-R32-Rebecca_Marino-Paula_Badosa,1,B-XC,58,16,2,3,11,24,34
20210811-W-Montreal-R32-Rebecca_Marino-Paula_Badosa,1,B-DTM,55,4,0,1,3,22,33
20210811-W-Montreal-R32-Rebecca_Marino-Paula_Badosa,1,B-DTL,17,6,3,1,2,10,7
20210811-W-Montreal-R32-Rebecca_Marino-Paula_Badosa,1,B-IO,9,2,1,0,1,6,3
20210811-W-Montreal-R32-Rebecca_Marino-Paula_Badosa,1,S-XC,2,0,0,0,0,0,2
20210811-W-Montreal-R32-Rebecca_Marino-Paula_Badosa,1,S-DTM,3,0,0,0,0,1,2
20210811-W-Montreal-R32-Rebecca_Marino-Paula_Badosa,1,S-DTL,5,1,0,0,1,1,4
20210811-W-Montreal-R32-Rebecca_Marino-Paula_Badosa,1,S-IO,2,0,0,0,0,2,0
20210811-W-Montreal-R32-Rebecca_Marino-Paula_Badosa,2,F-XC,28,10,4,3,3,19,9
20210811-W-Montreal-R32-Rebecca_Marino-Paula_Badosa,2,F-DTM,56,5,0,2,3,33,23
20210811-W-Montreal-R32-Rebecca_Marino-Paula_Badosa,2,F-DTL,20,3,2,0,1,12,8
20210811-W-Montreal-R32-Rebecca_Marino-Paula_Badosa,2,F-IO,28,3,1,2,0,17,11
20210811-W-Montreal-R32-Rebecca_Marino-Paula_Badosa,2,F-II,1,1,1,0,0,1,0
20210811-W-Montreal-R32-Rebecca_Marino-Paula_Badosa,2,B-XC,32,4,1,1,2,13,19
20210811-W-Montreal-R32-Rebecca_Marino-Paula_Badosa,2,B-DTM,61,3,0,0,3,33,28
20210811-W-Montreal-R32-Rebecca_Marino-Paula_Badosa,2,B-DTL,6,2,1,0,1,3,3
20210811-W-Montreal-R32-Rebecca_Marino-Paula_Badosa,2,B-IO,7,4,2,0,2,4,3
20210811-W-Montreal-R32-Rebecca_Marino-Paula_Badosa,2,S-XC,3,0,0,0,0,2,1
20210811-W-Montreal-R32-Rebecca_Marino-Paula_Badosa,2,S-DTM,7,0,0,0,0,4,3
20210811-W-Montreal-R32-Rebecca_Marino-Paula_Badosa,2,S-DTL,1,0,0,0,0,0,1
20210718-W-ITF_Telavi-F-Suzan_Lamens-Joanne_Zuger,1,F-XC,65,12,2,2,8,30,35
20210718-W-ITF_Telavi-F-Suzan_Lamens-Joanne_Zuger,1,F-DTM,47,3,0,0,3,22,25
20210718-W-ITF_Telavi-F-Suzan_Lamens-Joanne_Zuger,1,F-DTL,5,4,3,0,1,4,1
20210718-W-ITF_Telavi-F-Suzan_Lamens-Joanne_Zuger,1,F-IO,28,8,3,3,2,19,9
20210718-W-ITF_Telavi-F-Suzan_Lamens-Joanne_Zuger,1,F-II,2,0,0,0,0,2,0
20210718-W-ITF_Telavi-F-Suzan_Lamens-Joanne_Zuger,1,B-XC,33,6,0,1,5,13,20
20210718-W-ITF_Telavi-F-Suzan_Lamens-Joanne_Zuger,1,B-DTM,68,6,0,0,6,33,35
20210718-W-ITF_Telavi-F-Suzan_Lamens-Joanne_Zuger,1,B-DTL,4,3,0,0,3,0,4
20210718-W-ITF_Telavi-F-Suzan_Lamens-Joanne_Zuger,1,B-IO,6,1,0,0,1,3,3
20210718-W-ITF_Telavi-F-Suzan_Lamens-Joanne_Zuger,1,S-XC,3,0,0,0,0,3,0
20210718-W-ITF_Telavi-F-Suzan_Lamens-Joanne_Zuger,1,S-DTM,5,0,0,0,0,3,2
20210718-W-ITF_Telavi-F-Suzan_Lamens-Joanne_Zuger,2,F-XC,62,11,1,2,8,31,31
20210718-W-ITF_Telavi-F-Suzan_Lamens-Joanne_Zuger,2,F-DTM,64,3,0,0,3,30,34
20210718-W-ITF_Telavi-F-Suzan_Lamens-Joanne_Zuger,2,F-DTL,8,3,0,0,3,3,5
20210718-W-ITF_Telavi-F-Suzan_Lamens-Joanne_Zuger,2,F-IO,25,6,0,0,6,14,11
20210718-W-ITF_Telavi-F-Suzan_Lamens-Joanne_Zuger,2,B-XC,66,13,0,2,11,25,41
20210718-W-ITF_Telavi-F-Suzan_Lamens-Joanne_Zuger,2,B-DTM,48,7,1,2,4,26,22
20210718-W-ITF_Telavi-F-Suzan_Lamens-Joanne_Zuger,2,B-DTL,2,1,0,1,0,1,1
20210718-W-ITF_Telavi-F-Suzan_Lamens-Joanne_Zuger,2,B-IO,13,6,1,0,5,7,6
20210718-W-ITF_Telavi-F-Suzan_Lamens-Joanne_Zuger,2,S-XC,2,0,0,0,0,0,2
20210814-W-Montreal-SF-Camila_Giorgi-Jessica_Pegula,1,F-XC,58,13,7,2,4,32,26
20210814-W-Montreal-SF-Camila_Giorgi-Jessica_Pegula,1,F-DTM,58,9,0,1,8,24,34
20210814-W-Montreal-SF-Camila_Giorgi-Jessica_Pegula,1,F-DTL,10,7,4,0,3,4,6
20210814-W-Montreal-SF-Camila_Giorgi-Jessica_Pegula,1,F-IO,11,2,2,0,0,6,5
20210814-W-Montreal-SF-Camila_Giorgi-Jessica_Pegula,1,F-II,1,0,0,0,0,0,1
20210814-W-Montreal-SF-Camila_Giorgi-Jessica_Pegula,1,B-XC,34,8,1,2,5,21,13
20210814-W-Montreal-SF-Camila_Giorgi-Jessica_Pegula,1,B-DTM,57,10,0,3,7,27,30
20210814-W-Montreal-SF-Camila_Giorgi-Jessica_Pegula,1,B-DTL,5,2,1,0,1,1,4
20210814-W-Montreal-SF-Camila_Giorgi-Jessica_Pegula,1,B-IO,17,6,2,0,4,8,9
20210814-W-Montreal-SF-Camila_Giorgi-Jessica_Pegula,1,S-DTL,1,0,0,0,0,0,1
20210814-W-Montreal-SF-Camila_Giorgi-Jessica_Pegula,2,F-XC,44,16,7,2,7,24,20
20210814-W-Montreal-SF-Camila_Giorgi-Jessica_Pegula,2,F-DTM,59,5,0,1,4,27,32
20210814-W-Montreal-SF-Camila_Giorgi-Jessica_Pegula,2,F-DTL,12,5,1,1,3,4,8
20210814-W-Montreal-SF-Camila_Giorgi-Jessica_Pegula,2,F-IO,18,8,2,2,4,11,7
20210814-W-Montreal-SF-Camila_Giorgi-Jessica_Pegula,2,B-XC,17,2,0,0,2,10,7
20210814-W-Montreal-SF-Camila_Giorgi-Jessica_Pegula,2,B-DTM,48,5,0,0,5,26,22
20210814-W-Montreal-SF-Camila_Giorgi-Jessica_Pegula,2,B-DTL,13,2,0,0,2,3,10
20210814-W-Montreal-SF-Camila_Giorgi-Jessica_Pegula,2,B-IO,10,4,1,1,2,4,6
20210814-W-Montreal-SF-Camila_Giorgi-Jessica_Pegula,2,S-XC,2,0,0,0,0,1,1
20210814-W-Montreal-SF-Camila_Giorgi-Jessica_Pegula,2,S-DTM,7,0,0,0,0,4,3
20210814-W-Montreal-SF-Camila_Giorgi-Jessica_Pegula,2,S-DTL,1,0,0,0,0,1,0
20210814-W-Montreal-SF-Camila_Giorgi-Jessica_Pegula,2,S-IO,2,0,0,0,0,1,1
20210812-W-Montreal-R16-Danielle_Collins-Jessica_Pegula,1,F-XC,47,22,6,8,8,27,20
20210812-W-Montreal-R16-Danielle_Collins-Jessica_Pegula,1,F-DTM,33,4,0,1,3,20,13
20210812-W-Montreal-R16-Danielle_Collins-Jessica_Pegula,1,F-DTL,20,8,3,2,3,10,10
20210812-W-Montreal-R16-Danielle_Collins-Jessica_Pegula,1,F-IO,24,7,1,1,5,8,16
20210812-W-Montreal-R16-Danielle_Collins-Jessica_Pegula,1,F-II,2,1,0,1,0,1,1
20210812-W-Montreal-R16-Danielle_Collins-Jessica_Pegula,1,B-XC,44,10,2,5,3,26,18
20210812-W-Montreal-R16-Danielle_Collins-Jessica_Pegula,1,B-DTM,40,4,0,2,2,19,21
20210812-W-Montreal-R16-Danielle_Collins-Jessica_Pegula,1,B-DTL,8,6,6,0,0,6,2
20210812-W-Montreal-R16-Danielle_Collins-Jessica_Pegula,1,B-IO,12,7,2,1,4,7,5
20210812-W-Montreal-R16-Danielle_Collins-Jessica_Pegula,1,B-II,1,0,0,0,0,0,1
20210812-W-Montreal-R16-Danielle_Collins-Jessica_Pegula,1,S-DTM,1,0,0,0,0,0,1
20210812-W-Montreal-R16-Danielle_Collins-Jessica_Pegula,2,F-XC,32,12,1,3,8,17,15
20210812-W-Montreal-R16-Danielle_Collins-Jessica_Pegula,2,F-DTM,41,4,0,0,4,15,26
20210812-W-Montreal-R16-Danielle_Collins-Jessica_Pegula,2,F-DTL,7,2,1,1,0,6,1
20210812-W-Montreal-R16-Danielle_Collins-Jessica_Pegula,2,F-IO,22,16,8,4,4,15,7
20210812-W-Montreal-R16-Danielle_Collins-Jessica_Pegula,2,B-XC,27,9,3,3,3,17,10
20210812-W-Montreal-R16-Danielle_Collins-Jessica_Pegula,2,B-DTM,44,5,0,1,4,24,20
20210812-W-Montreal-R16-Danielle_Collins-Jessica_Pegula,2,B-DTL,17,8,1,2,5,5,12
20210812-W-Montreal-R16-Danielle_Collins-Jessica_Pegula,2,B-IO,12,3,2,1,0,5,7
20210812-W-Montreal-R16-Danielle_Collins-Jessica_Pegula,2,S-XC,7,1,0,0,1,2,5
20210812-W-Montreal-R16-Danielle_Collins-Jessica_Pegula,2,S-DTM,8,0,0,0,0,3,5
20210812-W-Montreal-R16-Danielle_Collins-Jessica_Pegula,2,S-DTL,2,0,0,0,0,0,2
20210812-W-Montreal-R16-Danielle_Collins-Jessica_Pegula,2,S-IO,1,1,0,0,1,0,1
20210813-W-Montreal-QF-Aryna_Sabalenka-Victoria_Azarenka,1,F-XC,24,13,9,0,4,16,8
20210813-W-Montreal-QF-Aryna_Sabalenka-Victoria_Azarenka,1,F-DTM,9,0,0,0,0,8,1
20210813-W-Montreal-QF-Aryna_Sabalenka-Victoria_Azarenka,1,F-DTL,4,3,2,0,1,3,1
20210813-W-Montreal-QF-Aryna_Sabalenka-Victoria_Azarenka,1,F-IO,8,7,3,0,4,4,4
20210813-W-Montreal-QF-Aryna_Sabalenka-Victoria_Azarenka,1,B-XC,20,8,4,1,3,13,7
20210813-W-Montreal-QF-Aryna_Sabalenka-Victoria_Azarenka,1,B-DTM,15,4,0,0,4,5,10
20210813-W-Montreal-QF-Aryna_Sabalenka-Victoria_Azarenka,1,B-DTL,6,4,3,1,0,6,0
20210813-W-Montreal-QF-Aryna_Sabalenka-Victoria_Azarenka,1,B-IO,2,1,0,0,1,1,1
20210813-W-Montreal-QF-Aryna_Sabalenka-Victoria_Azarenka,1,S-XC,2,0,0,0,0,1,1
20210813-W-Montreal-QF-Aryna_Sabalenka-Victoria_Azarenka,1,S-DTM,4,0,0,0,0,3,1
20210813-W-Montreal-QF-Aryna_Sabalenka-Victoria_Azarenka,1,S-DTL,2,0,0,0,0,0,2
20210813-W-Montreal-QF-Aryna_Sabalenka-Victoria_Azarenka,2,F-XC,15,4,2,1,1,7,8
20210813-W-Montreal-QF-Aryna_Sabalenka-Victoria_Azarenka,2,F-DTM,19,2,0,0,2,5,14
20210813-W-Montreal-QF-Aryna_Sabalenka-Victoria_Azarenka,2,F-DTL,7,2,0,0,2,2,5
20210813-W-Montreal-QF-Aryna_Sabalenka-Victoria_Azarenka,2,F-IO,9,3,2,0,1,3,6
20210813-W-Montreal-QF-Aryna_Sabalenka-Victoria_Azarenka,2,B-XC,12,2,1,0,1,5,7
20210813-W-Montreal-QF-Aryna_Sabalenka-Victoria_Azarenka,2,B-DTM,10,1,0,0,1,2,8
20210813-W-Montreal-QF-Aryna_Sabalenka-Victoria_Azarenka,2,B-DTL,4,3,1,0,2,1,3
20210813-W-Montreal-QF-Aryna_Sabalenka-Victoria_Azarenka,2,B-IO,2,0,0,0,0,1,1
20210813-W-Montreal-QF-Aryna_Sabalenka-Victoria_Azarenka,2,S-XC,3,0,0,0,0,3,0
20210813-W-Montreal-QF-Aryna_Sabalenka-Victoria_Azarenka,2,S-DTM,2,0,0,0,0,0,2
20210813-W-Montreal-QF-Aryna_Sabalenka-Victoria_Azarenka,2,S-DTL,1,0,0,0,0,0,1
20210810-W-Montreal-R64-Elena_Rybakina-Liudmila_Samsonova,1,F-XC,34,15,6,1,8,19,15
20210810-W-Montreal-R64-Elena_Rybakina-Liudmila_Samsonova,1,F-DTM,22,4,0,0,4,12,10
20210810-W-Montreal-R64-Elena_Rybakina-Liudmila_Samsonova,1,F-DTL,11,6,2,0,4,4,7
20210810-W-Montreal-R64-Elena_Rybakina-Liudmila_Samsonova,1,F-IO,5,1,0,0,1,2,3
20210810-W-Montreal-R64-Elena_Rybakina-Liudmila_Samsonova,1,B-XC,10,4,1,0,3,5,5
20210810-W-Montreal-R64-Elena_Rybakina-Liudmila_Samsonova,1,B-DTM,23,2,0,0,2,8,15
20210810-W-Montreal-R64-Elena_Rybakina-Liudmila_Samsonova,1,B-DTL,12,6,2,1,3,4,8
20210810-W-Montreal-R64-Elena_Rybakina-Liudmila_Samsonova,1,B-IO,5,2,0,0,2,0,5
20210810-W-Montreal-R64-Elena_Rybakina-Liudmila_Samsonova,1,S-XC,1,0,0,0,0,0,1
20210810-W-Montreal-R64-Elena_Rybakina-Liudmila_Samsonova,1,S-DTL,2,0,0,0,0,1,1
20210810-W-Montreal-R64-Elena_Rybakina-Liudmila_Samsonova,2,F-XC,39,19,6,5,8,25,14
20210810-W-Montreal-R64-Elena_Rybakina-Liudmila_Samsonova,2,F-DTM,17,3,0,0,3,5,12
20210810-W-Montreal-R64-Elena_Rybakina-Liudmila_Samsonova,2,F-DTL,3,1,0,1,0,3,0
20210810-W-Montreal-R64-Elena_Rybakina-Liudmila_Samsonova,2,F-IO,13,6,3,2,1,10,3
20210810-W-Montreal-R64-Elena_Rybakina-Liudmila_Samsonova,2,B-XC,24,14,3,4,7,14,10
20210810-W-Montreal-R64-Elena_Rybakina-Liudmila_Samsonova,2,B-DTM,24,3,0,0,3,12,12
20210810-W-Montreal-R64-Elena_Rybakina-Liudmila_Samsonova,2,B-DTL,4,1,0,0,1,2,2
20210810-W-Montreal-R64-Elena_Rybakina-Liudmila_Samsonova,2,B-IO,1,1,0,1,0,1,0
20210815-W-Montreal-F-Karolina_Pliskova-Camila_Giorgi,1,F-XC,45,8,2,1,5,21,24
20210815-W-Montreal-F-Karolina_Pliskova-Camila_Giorgi,1,F-DTM,29,8,0,1,7,9,20
20210815-W-Montreal-F-Karolina_Pliskova-Camila_Giorgi,1,F-DTL,7,2,0,1,1,4,3
20210815-W-Montreal-F-Karolina_Pliskova-Camila_Giorgi,1,F-IO,14,3,0,0,3,8,6
20210815-W-Montreal-F-Karolina_Pliskova-Camila_Giorgi,1,B-XC,17,4,0,1,3,10,7
20210815-W-Montreal-F-Karolina_Pliskova-Camila_Giorgi,1,B-DTM,29,6,0,1,5,11,18
20210815-W-Montreal-F-Karolina_Pliskova-Camila_Giorgi,1,B-DTL,8,2,1,0,1,5,3
20210815-W-Montreal-F-Karolina_Pliskova-Camila_Giorgi,1,B-IO,15,9,4,0,5,6,9
20210815-W-Montreal-F-Karolina_Pliskova-Camila_Giorgi,1,S-XC,6,1,0,1,0,4,2
20210815-W-Montreal-F-Karolina_Pliskova-Camila_Giorgi,1,S-DTM,2,0,0,0,0,0,2
20210815-W-Montreal-F-Karolina_Pliskova-Camila_Giorgi,2,F-XC,34,8,3,0,5,21,13
20210815-W-Montreal-F-Karolina_Pliskova-Camila_Giorgi,2,F-DTM,47,4,0,0,4,25,22
20210815-W-Montreal-F-Karolina_Pliskova-Camila_Giorgi,2,F-DTL,5,2,1,0,1,3,2
20210815-W-Montreal-F-Karolina_Pliskova-Camila_Giorgi,2,F-IO,5,2,1,0,1,3,2
20210815-W-Montreal-F-Karolina_Pliskova-Camila_Giorgi,2,B-XC,25,4,1,2,1,14,11
20210815-W-Montreal-F-Karolina_Pliskova-Camila_Giorgi,2,B-DTM,36,7,0,0,7,17,19
20210815-W-Montreal-F-Karolina_Pliskova-Camila_Giorgi,2,B-DTL,6,1,0,0,1,2,4
20210815-W-Montreal-F-Karolina_Pliskova-Camila_Giorgi,2,B-IO,5,2,1,0,1,3,2
20210815-W-Montreal-F-Karolina_Pliskova-Camila_Giorgi,2,S-XC,1,0,0,0,0,0,1
20210815-W-Montreal-F-Karolina_Pliskova-Camila_Giorgi,2,S-DTM,1,0,0,0,0,0,1
20210815-W-Montreal-F-Karolina_Pliskova-Camila_Giorgi,2,S-DTL,2,1,0,1,0,1,1
20210209-W-Australian_Open-R128-Barbora_Strycova-Svetlana_Kuznetsova,1,F-XC,32,3,0,1,2,14,18
20210209-W-Australian_Open-R128-Barbora_Strycova-Svetlana_Kuznetsova,1,F-DTM,32,4,0,0,4,17,15
20210209-W-Australian_Open-R128-Barbora_Strycova-Svetlana_Kuznetsova,1,F-DTL,10,3,0,1,2,3,7
20210209-W-Australian_Open-R128-Barbora_Strycova-Svetlana_Kuznetsova,1,F-IO,7,2,0,0,2,2,5
20210209-W-Australian_Open-R128-Barbora_Strycova-Svetlana_Kuznetsova,1,B-XC,27,1,0,0,1,11,16
20210209-W-Australian_Open-R128-Barbora_Strycova-Svetlana_Kuznetsova,1,B-DTM,30,3,0,0,3,12,18
20210209-W-Australian_Open-R128-Barbora_Strycova-Svetlana_Kuznetsova,1,B-DTL,4,0,0,0,0,0,4
20210209-W-Australian_Open-R128-Barbora_Strycova-Svetlana_Kuznetsova,1,B-IO,2,1,1,0,0,1,1
20210209-W-Australian_Open-R128-Barbora_Strycova-Svetlana_Kuznetsova,1,S-XC,4,0,0,0,0,1,3
20210209-W-Australian_Open-R128-Barbora_Strycova-Svetlana_Kuznetsova,1,S-DTM,4,0,0,0,0,0,4
20210209-W-Australian_Open-R128-Barbora_Strycova-Svetlana_Kuznetsova,1,S-IO,1,0,0,0,0,0,1
20210209-W-Australian_Open-R128-Barbora_Strycova-Svetlana_Kuznetsova,2,F-XC,34,8,2,2,4,20,14
20210209-W-Australian_Open-R128-Barbora_Strycova-Svetlana_Kuznetsova,2,F-DTM,28,0,0,0,0,16,12
20210209-W-Australian_Open-R128-Barbora_Strycova-Svetlana_Kuznetsova,2,F-DTL,17,8,4,0,4,9,8
20210209-W-Australian_Open-R128-Barbora_Strycova-Svetlana_Kuznetsova,2,F-IO,22,7,1,2,4,11,11
20210209-W-Australian_Open-R128-Barbora_Strycova-Svetlana_Kuznetsova,2,F-II,3,2,1,1,0,3,0
20210209-W-Australian_Open-R128-Barbora_Strycova-Svetlana_Kuznetsova,2,B-XC,26,8,4,0,4,14,12
20210209-W-Australian_Open-R128-Barbora_Strycova-Svetlana_Kuznetsova,2,B-DTM,21,1,0,1,0,16,5
20210209-W-Australian_Open-R128-Barbora_Strycova-Svetlana_Kuznetsova,2,B-DTL,8,5,3,1,1,5,3
20210209-W-Australian_Open-R128-Barbora_Strycova-Svetlana_Kuznetsova,2,B-IO,5,0,0,0,0,1,4
20210209-W-Australian_Open-R128-Barbora_Strycova-Svetlana_Kuznetsova,2,S-XC,5,1,1,0,0,4,1
20210209-W-Australian_Open-R128-Barbora_Strycova-Svetlana_Kuznetsova,2,S-DTM,5,0,0,0,0,4,1
20210209-W-Australian_Open-R128-Barbora_Strycova-Svetlana_Kuznetsova,2,S-DTL,2,2,0,0,2,0,2
20210816-W-Cincinnati-R64-Madison_Keys-Petra_Kvitova,1,F-XC,10,4,1,1,2,5,5
20210816-W-Cincinnati-R64-Madison_Keys-Petra_Kvitova,1,F-DTM,13,4,1,0,3,4,9
20210816-W-Cincinnati-R64-Madison_Keys-Petra_Kvitova,1,F-DTL,8,4,2,2,0,7,1
20210816-W-Cincinnati-R64-Madison_Keys-Petra_Kvitova,1,F-IO,6,4,3,1,0,4,2
20210816-W-Cincinnati-R64-Madison_Keys-Petra_Kvitova,1,B-XC,6,3,1,0,2,3,3
20210816-W-Cincinnati-R64-Madison_Keys-Petra_Kvitova,1,B-DTM,5,2,0,1,1,2,3
20210816-W-Cincinnati-R64-Madison_Keys-Petra_Kvitova,1,B-DTL,4,4,0,1,3,1,3
20210816-W-Cincinnati-R64-Madison_Keys-Petra_Kvitova,1,B-IO,4,1,1,0,0,3,1
20210816-W-Cincinnati-R64-Madison_Keys-Petra_Kvitova,1,S-XC,1,0,0,0,0,0,1
20210816-W-Cincinnati-R64-Madison_Keys-Petra_Kvitova,1,S-DTM,1,0,0,0,0,0,1
20210816-W-Cincinnati-R64-Madison_Keys-Petra_Kvitova,1,S-DTL,2,1,0,0,1,1,1
20210816-W-Cincinnati-R64-Madison_Keys-Petra_Kvitova,2,F-XC,14,8,2,2,4,8,6
20210816-W-Cincinnati-R64-Madison_Keys-Petra_Kvitova,2,F-DTM,6,0,0,0,0,1,5
20210816-W-Cincinnati-R64-Madison_Keys-Petra_Kvitova,2,F-DTL,3,1,0,0,1,1,2
20210816-W-Cincinnati-R64-Madison_Keys-Petra_Kvitova,2,F-IO,12,5,2,1,2,5,7
20210816-W-Cincinnati-R64-Madison_Keys-Petra_Kvitova,2,F-II,2,2,1,0,1,1,1
20210816-W-Cincinnati-R64-Madison_Keys-Petra_Kvitova,2,B-XC,15,9,4,3,2,10,5
20210816-W-Cincinnati-R64-Madison_Keys-Petra_Kvitova,2,B-DTM,10,2,0,1,1,6,4
20210816-W-Cincinnati-R64-Madison_Keys-Petra_Kvitova,2,B-IO,6,4,1,1,2,4,2
20210816-W-Cincinnati-R64-Madison_Keys-Petra_Kvitova,2,S-DTL,2,0,0,0,0,2,0
20210818-W-Cincinnati-R32-Bianca_Andreescu-Karolina_Muchova,1,F-XC,28,10,2,1,7,12,16
20210818-W-Cincinnati-R32-Bianca_Andreescu-Karolina_Muchova,1,F-DTM,19,1,0,0,1,6,13
20210818-W-Cincinnati-R32-Bianca_Andreescu-Karolina_Muchova,1,F-DTL,9,1,0,0,1,6,3
20210818-W-Cincinnati-R32-Bianca_Andreescu-Karolina_Muchova,1,F-IO,10,4,1,0,3,3,7
20210818-W-Cincinnati-R32-Bianca_Andreescu-Karolina_Muchova,1,B-XC,6,3,0,0,3,1,5
20210818-W-Cincinnati-R32-Bianca_Andreescu-Karolina_Muchova,1,B-DTM,16,1,0,0,1,6,10
20210818-W-Cincinnati-R32-Bianca_Andreescu-Karolina_Muchova,1,B-DTL,2,1,0,0,1,1,1
20210818-W-Cincinnati-R32-Bianca_Andreescu-Karolina_Muchova,1,B-IO,4,3,1,1,1,2,2
20210818-W-Cincinnati-R32-Bianca_Andreescu-Karolina_Muchova,1,S-XC,1,1,0,0,1,0,1
20210818-W-Cincinnati-R32-Bianca_Andreescu-Karolina_Muchova,1,S-DTL,1,0,0,0,0,0,1
20210818-W-Cincinnati-R32-Bianca_Andreescu-Karolina_Muchova,1,S-IO,2,1,0,0,1,1,1
20210818-W-Cincinnati-R32-Bianca_Andreescu-Karolina_Muchova,2,F-XC,26,2,1,1,0,16,10
20210818-W-Cincinnati-R32-Bianca_Andreescu-Karolina_Muchova,2,F-DTM,22,1,0,0,1,13,9
20210818-W-Cincinnati-R32-Bianca_Andreescu-Karolina_Muchova,2,F-DTL,1,1,1,0,0,1,0
20210818-W-Cincinnati-R32-Bianca_Andreescu-Karolina_Muchova,2,F-IO,10,6,2,1,3,5,5
20210818-W-Cincinnati-R32-Bianca_Andreescu-Karolina_Muchova,2,F-II,1,0,0,0,0,0,1
20210818-W-Cincinnati-R32-Bianca_Andreescu-Karolina_Muchova,2,B-XC,5,4,0,1,3,2,3
20210818-W-Cincinnati-R32-Bianca_Andreescu-Karolina_Muchova,2,B-DTM,15,4,0,0,4,8,7
20210818-W-Cincinnati-R32-Bianca_Andreescu-Karolina_Muchova,2,B-DTL,2,1,0,0,1,1,1
20210818-W-Cincinnati-R32-Bianca_Andreescu-Karolina_Muchova,2,B-IO,1,1,0,0,1,0,1
20210818-W-Cincinnati-R32-Bianca_Andreescu-Karolina_Muchova,2,S-XC,6,1,1,0,0,3,3
20210818-W-Cincinnati-R32-Bianca_Andreescu-Karolina_Muchova,2,S-DTM,2,0,0,0,0,2,0
20210818-W-Cincinnati-R32-Bianca_Andreescu-Karolina_Muchova,2,S-DTL,1,0,0,0,0,0,1
20210818-W-Cincinnati-R32-Bianca_Andreescu-Karolina_Muchova,2,S-IO,3,0,0,0,0,1,2
20210812-W-Montreal-R16-Camila_Giorgi-Petra_Kvitova,1,F-XC,26,7,3,1,3,15,11
20210812-W-Montreal-R16-Camila_Giorgi-Petra_Kvitova,1,F-DTM,22,4,0,1,3,10,12
20210812-W-Montreal-R16-Camila_Giorgi-Petra_Kvitova,1,F-DTL,4,3,1,1,1,3,1
20210812-W-Montreal-R16-Camila_Giorgi-Petra_Kvitova,1,F-IO,11,4,3,0,1,8,3
20210812-W-Montreal-R16-Camila_Giorgi-Petra_Kvitova,1,B-XC,19,7,2,2,3,9,10
20210812-W-Montreal-R16-Camila_Giorgi-Petra_Kvitova,1,B-DTM,22,5,0,1,4,9,13
20210812-W-Montreal-R16-Camila_Giorgi-Petra_Kvitova,1,B-DTL,1,1,1,0,0,1,0
20210812-W-Montreal-R16-Camila_Giorgi-Petra_Kvitova,1,B-IO,5,1,0,0,1,0,5
20210812-W-Montreal-R16-Camila_Giorgi-Petra_Kvitova,1,S-DTM,1,0,0,0,0,0,1
20210812-W-Montreal-R16-Camila_Giorgi-Petra_Kvitova,1,S-DTL,2,0,0,0,0,1,1
20210812-W-Montreal-R16-Camila_Giorgi-Petra_Kvitova,2,F-XC,19,7,2,1,4,10,9
20210812-W-Montreal-R16-Camila_Giorgi-Petra_Kvitova,2,F-DTM,27,8,0,0,8,12,15
20210812-W-Montreal-R16-Camila_Giorgi-Petra_Kvitova,2,F-DTL,7,4,4,0,0,5,2
20210812-W-Montreal-R16-Camila_Giorgi-Petra_Kvitova,2,F-IO,11,7,2,0,5,4,7
20210812-W-Montreal-R16-Camila_Giorgi-Petra_Kvitova,2,B-XC,14,4,1,0,3,7,7
20210812-W-Montreal-R16-Camila_Giorgi-Petra_Kvitova,2,B-DTM,10,1,1,0,0,8,2
20210812-W-Montreal-R16-Camila_Giorgi-Petra_Kvitova,2,B-DTL,4,2,0,0,2,1,3
20210812-W-Montreal-R16-Camila_Giorgi-Petra_Kvitova,2,B-IO,8,3,1,0,2,2,6
20210812-W-Montreal-R16-Camila_Giorgi-Petra_Kvitova,2,S-XC,3,1,0,0,1,2,1
20210812-W-Montreal-R16-Camila_Giorgi-Petra_Kvitova,2,S-DTM,6,0,0,0,0,4,2
20210812-W-Montreal-R16-Bianca_Andreescu-Ons_Jabeur,1,F-XC,30,14,3,7,4,18,12
20210812-W-Montreal-R16-Bianca_Andreescu-Ons_Jabeur,1,F-DTM,41,3,0,0,3,18,23
20210812-W-Montreal-R16-Bianca_Andreescu-Ons_Jabeur,1,F-DTL,10,4,1,0,3,5,5
20210812-W-Montreal-R16-Bianca_Andreescu-Ons_Jabeur,1,F-IO,17,6,1,2,3,10,7
20210812-W-Montreal-R16-Bianca_Andreescu-Ons_Jabeur,1,B-XC,19,5,0,1,4,11,8
20210812-W-Montreal-R16-Bianca_Andreescu-Ons_Jabeur,1,B-DTM,20,3,0,1,2,5,15
20210812-W-Montreal-R16-Bianca_Andreescu-Ons_Jabeur,1,B-DTL,5,4,2,0,2,2,3
20210812-W-Montreal-R16-Bianca_Andreescu-Ons_Jabeur,1,B-IO,4,2,1,0,1,1,3
20210812-W-Montreal-R16-Bianca_Andreescu-Ons_Jabeur,1,S-XC,1,0,0,0,0,0,1
20210812-W-Montreal-R16-Bianca_Andreescu-Ons_Jabeur,1,S-DTM,12,0,0,0,0,4,8
20210812-W-Montreal-R16-Bianca_Andreescu-Ons_Jabeur,1,S-DTL,2,0,0,0,0,1,1
20210812-W-Montreal-R16-Bianca_Andreescu-Ons_Jabeur,1,S-IO,2,0,0,0,0,1,1
20210812-W-Montreal-R16-Bianca_Andreescu-Ons_Jabeur,2,F-XC,44,15,9,0,6,25,19
20210812-W-Montreal-R16-Bianca_Andreescu-Ons_Jabeur,2,F-DTM,30,5,1,0,4,17,13
20210812-W-Montreal-R16-Bianca_Andreescu-Ons_Jabeur,2,F-DTL,5,3,1,2,0,4,1
20210812-W-Montreal-R16-Bianca_Andreescu-Ons_Jabeur,2,F-IO,18,7,4,1,2,13,5
20210812-W-Montreal-R16-Bianca_Andreescu-Ons_Jabeur,2,F-II,2,2,1,1,0,2,0
20210812-W-Montreal-R16-Bianca_Andreescu-Ons_Jabeur,2,B-XC,17,6,4,1,1,12,5
20210812-W-Montreal-R16-Bianca_Andreescu-Ons_Jabeur,2,B-DTM,15,1,0,0,1,6,9
20210812-W-Montreal-R16-Bianca_Andreescu-Ons_Jabeur,2,B-DTL,6,0,0,0,0,2,4
20210812-W-Montreal-R16-Bianca_Andreescu-Ons_Jabeur,2,B-IO,6,2,0,1,1,4,2
20210812-W-Montreal-R16-Bianca_Andreescu-Ons_Jabeur,2,S-XC,7,1,1,0,0,3,4
20210812-W-Montreal-R16-Bianca_Andreescu-Ons_Jabeur,2,S-DTM,10,1,0,1,0,1,9
20210812-W-Montreal-R16-Bianca_Andreescu-Ons_Jabeur,2,S-DTL,1,0,0,0,0,1,0
20210812-W-Montreal-R16-Bianca_Andreescu-Ons_Jabeur,2,S-IO,2,1,0,0,1,1,1
20210810-W-Montreal-R32-Fiona_Ferro-Petra_Kvitova,1,F-DTM,6,0,0,0,0,4,2
20210810-W-Montreal-R32-Fiona_Ferro-Petra_Kvitova,1,F-DTL,4,1,0,0,1,3,1
20210810-W-Montreal-R32-Fiona_Ferro-Petra_Kvitova,1,F-IO,8,4,0,1,3,5,3
20210810-W-Montreal-R32-Fiona_Ferro-Petra_Kvitova,1,B-XC,13,3,3,0,0,10,3
20210810-W-Montreal-R32-Fiona_Ferro-Petra_Kvitova,1,B-DTM,19,1,0,0,1,11,8
20210810-W-Montreal-R32-Fiona_Ferro-Petra_Kvitova,1,B-DTL,1,0,0,0,0,0,1
20210810-W-Montreal-R32-Fiona_Ferro-Petra_Kvitova,1,S-DTM,2,0,0,0,0,1,1
20210810-W-Montreal-R32-Fiona_Ferro-Petra_Kvitova,1,S-DTL,1,0,0,0,0,0,1
20210810-W-Montreal-R32-Fiona_Ferro-Petra_Kvitova,2,F-XC,28,15,3,2,10,8,20
20210810-W-Montreal-R32-Fiona_Ferro-Petra_Kvitova,2,F-DTM,6,1,0,0,1,2,4
20210810-W-Montreal-R32-Fiona_Ferro-Petra_Kvitova,2,F-DTL,8,7,2,0,5,2,6
20210810-W-Montreal-R32-Fiona_Ferro-Petra_Kvitova,2,F-IO,17,12,7,1,4,10,7
20210810-W-Montreal-R32-Fiona_Ferro-Petra_Kvitova,2,F-II,2,1,1,0,0,1,1
20210810-W-Montreal-R32-Fiona_Ferro-Petra_Kvitova,2,B-XC,7,6,2,2,2,5,2
20210810-W-Montreal-R32-Fiona_Ferro-Petra_Kvitova,2,B-DTM,6,2,0,0,2,2,4
20210810-W-Montreal-R32-Fiona_Ferro-Petra_Kvitova,2,B-DTL,2,2,1,1,0,2,0
20210818-W-Cincinnati-R32-Elina_Svitolina-Angelique_Kerber,1,F-XC,42,12,6,2,4,25,17
20210818-W-Cincinnati-R32-Elina_Svitolina-Angelique_Kerber,1,F-DTM,42,1,0,0,1,20,22
20210818-W-Cincinnati-R32-Elina_Svitolina-Angelique_Kerber,1,F-DTL,11,5,0,0,5,1,10
20210818-W-Cincinnati-R32-Elina_Svitolina-Angelique_Kerber,1,F-IO,21,7,4,1,2,11,10
20210818-W-Cincinnati-R32-Elina_Svitolina-Angelique_Kerber,1,F-II,1,1,1,0,0,1,0
20210818-W-Cincinnati-R32-Elina_Svitolina-Angelique_Kerber,1,B-XC,63,14,6,3,5,41,22
20210818-W-Cincinnati-R32-Elina_Svitolina-Angelique_Kerber,1,B-DTM,27,6,0,0,6,13,14
20210818-W-Cincinnati-R32-Elina_Svitolina-Angelique_Kerber,1,B-DTL,15,5,0,1,4,6,9
20210818-W-Cincinnati-R32-Elina_Svitolina-Angelique_Kerber,1,B-IO,10,7,2,2,3,6,4
20210818-W-Cincinnati-R32-Elina_Svitolina-Angelique_Kerber,1,S-XC,7,0,0,0,0,5,2
20210818-W-Cincinnati-R32-Elina_Svitolina-Angelique_Kerber,1,S-DTM,5,0,0,0,0,3,2
20210818-W-Cincinnati-R32-Elina_Svitolina-Angelique_Kerber,1,S-DTL,1,0,0,0,0,1,0
20210818-W-Cincinnati-R32-Elina_Svitolina-Angelique_Kerber,2,F-XC,82,16,5,2,9,41,41
20210818-W-Cincinnati-R32-Elina_Svitolina-Angelique_Kerber,2,F-DTM,27,2,0,0,2,8,19
20210818-W-Cincinnati-R32-Elina_Svitolina-Angelique_Kerber,2,F-DTL,34,17,5,2,10,14,20
20210818-W-Cincinnati-R32-Elina_Svitolina-Angelique_Kerber,2,F-IO,34,11,4,4,3,25,9
20210818-W-Cincinnati-R32-Elina_Svitolina-Angelique_Kerber,2,F-II,1,0,0,0,0,1,0
20210818-W-Cincinnati-R32-Elina_Svitolina-Angelique_Kerber,2,B-XC,40,11,3,0,8,21,19
20210818-W-Cincinnati-R32-Elina_Svitolina-Angelique_Kerber,2,B-DTM,39,3,0,0,3,17,22
20210818-W-Cincinnati-R32-Elina_Svitolina-Angelique_Kerber,2,B-DTL,4,3,1,0,2,2,2
20210818-W-Cincinnati-R32-Elina_Svitolina-Angelique_Kerber,2,B-IO,10,5,1,2,2,4,6
20210818-W-Cincinnati-R32-Elina_Svitolina-Angelique_Kerber,2,S-XC,1,0,0,0,0,1,0
20210818-W-Cincinnati-R32-Elina_Svitolina-Angelique_Kerber,2,S-IO,2,0,0,0,0,1,1
20210819-W-Cincinnati-R16-Petra_Kvitova-Ons_Jabeur,1,F-XC,8,4,0,1,3,3,5
20210819-W-Cincinnati-R16-Petra_Kvitova-Ons_Jabeur,1,F-DTM,6,2,0,0,2,3,3
20210819-W-Cincinnati-R16-Petra_Kvitova-Ons_Jabeur,1,F-DTL,6,3,1,0,2,2,4
20210819-W-Cincinnati-R16-Petra_Kvitova-Ons_Jabeur,1,F-IO,5,1,1,0,0,4,1
20210819-W-Cincinnati-R16-Petra_Kvitova-Ons_Jabeur,1,B-XC,9,6,3,1,2,6,3
20210819-W-Cincinnati-R16-Petra_Kvitova-Ons_Jabeur,1,B-DTM,7,2,0,1,1,5,2
20210819-W-Cincinnati-R16-Petra_Kvitova-Ons_Jabeur,1,B-DTL,4,2,0,1,1,2,2
20210819-W-Cincinnati-R16-Petra_Kvitova-Ons_Jabeur,1,B-IO,3,3,1,0,2,1,2
20210819-W-Cincinnati-R16-Petra_Kvitova-Ons_Jabeur,1,S-XC,2,0,0,0,0,2,0
20210819-W-Cincinnati-R16-Petra_Kvitova-Ons_Jabeur,1,S-DTM,1,0,0,0,0,1,0
20210819-W-Cincinnati-R16-Petra_Kvitova-Ons_Jabeur,1,S-DTL,1,1,0,1,0,1,0
20210819-W-Cincinnati-R16-Petra_Kvitova-Ons_Jabeur,2,F-XC,6,1,0,0,1,1,5
20210819-W-Cincinnati-R16-Petra_Kvitova-Ons_Jabeur,2,F-DTM,8,1,0,0,1,1,7
20210819-W-Cincinnati-R16-Petra_Kvitova-Ons_Jabeur,2,F-DTL,6,3,2,0,1,4,2
20210819-W-Cincinnati-R16-Petra_Kvitova-Ons_Jabeur,2,F-IO,3,2,0,0,2,1,2
20210819-W-Cincinnati-R16-Petra_Kvitova-Ons_Jabeur,2,B-XC,5,2,0,1,1,2,3
20210819-W-Cincinnati-R16-Petra_Kvitova-Ons_Jabeur,2,B-DTM,1,1,1,0,0,1,0
20210819-W-Cincinnati-R16-Petra_Kvitova-Ons_Jabeur,2,B-DTL,4,2,1,0,1,2,2
20210819-W-Cincinnati-R16-Petra_Kvitova-Ons_Jabeur,2,B-IO,3,0,0,0,0,2,1
20210819-W-Cincinnati-R16-Petra_Kvitova-Ons_Jabeur,2,S-XC,3,1,0,0,1,1,2
20210819-W-Cincinnati-R16-Petra_Kvitova-Ons_Jabeur,2,S-DTM,2,1,0,0,1,0,2
20210819-W-Cincinnati-R16-Petra_Kvitova-Ons_Jabeur,2,S-DTL,1,1,0,1,0,1,0
20210819-W-Cincinnati-R16-Petra_Kvitova-Ons_Jabeur,2,S-IO,2,1,0,0,1,0,2
20210818-W-Cincinnati-R32-Iga_Swiatek-Ons_Jabeur,1,F-XC,19,9,4,1,4,9,10
20210818-W-Cincinnati-R32-Iga_Swiatek-Ons_Jabeur,1,F-DTM,11,3,1,0,2,3,8
20210818-W-Cincinnati-R32-Iga_Swiatek-Ons_Jabeur,1,F-DTL,7,3,0,0,3,1,6
20210818-W-Cincinnati-R32-Iga_Swiatek-Ons_Jabeur,1,F-IO,14,6,2,0,4,7,7
20210818-W-Cincinnati-R32-Iga_Swiatek-Ons_Jabeur,1,B-XC,26,8,0,5,3,11,15
20210818-W-Cincinnati-R32-Iga_Swiatek-Ons_Jabeur,1,B-DTM,9,0,0,0,0,1,8
20210818-W-Cincinnati-R32-Iga_Swiatek-Ons_Jabeur,1,B-DTL,2,2,1,0,1,1,1
20210818-W-Cincinnati-R32-Iga_Swiatek-Ons_Jabeur,1,B-IO,6,2,0,0,2,2,4
20210818-W-Cincinnati-R32-Iga_Swiatek-Ons_Jabeur,1,S-DTM,2,0,0,0,0,0,2
20210818-W-Cincinnati-R32-Iga_Swiatek-Ons_Jabeur,2,F-XC,20,8,4,1,3,14,6
20210818-W-Cincinnati-R32-Iga_Swiatek-Ons_Jabeur,2,F-DTM,11,1,0,0,1,8,3
20210818-W-Cincinnati-R32-Iga_Swiatek-Ons_Jabeur,2,F-DTL,6,4,2,1,1,4,2
20210818-W-Cincinnati-R32-Iga_Swiatek-Ons_Jabeur,2,F-IO,11,4,4,0,0,6,5
20210818-W-Cincinnati-R32-Iga_Swiatek-Ons_Jabeur,2,F-II,1,0,0,0,0,0,1
20210818-W-Cincinnati-R32-Iga_Swiatek-Ons_Jabeur,2,B-XC,16,4,1,1,2,13,3
20210818-W-Cincinnati-R32-Iga_Swiatek-Ons_Jabeur,2,B-DTM,9,1,0,0,1,5,4
20210818-W-Cincinnati-R32-Iga_Swiatek-Ons_Jabeur,2,B-DTL,10,3,1,0,2,7,3
20210818-W-Cincinnati-R32-Iga_Swiatek-Ons_Jabeur,2,B-IO,3,1,1,0,0,1,2
20210818-W-Cincinnati-R32-Iga_Swiatek-Ons_Jabeur,2,S-XC,1,0,0,0,0,1,0
20210818-W-Cincinnati-R32-Iga_Swiatek-Ons_Jabeur,2,S-DTM,4,1,0,0,1,1,3
20210818-W-Cincinnati-R32-Iga_Swiatek-Ons_Jabeur,2,S-DTL,3,1,0,0,1,0,3
20210822-W-Cincinnati-F-Ashleigh_Barty-Jil_Teichmann,1,F-XC,36,13,5,2,6,26,10
20210822-W-Cincinnati-F-Ashleigh_Barty-Jil_Teichmann,1,F-DTM,20,2,0,0,2,9,11
20210822-W-Cincinnati-F-Ashleigh_Barty-Jil_Teichmann,1,F-DTL,3,2,2,0,0,3,0
20210822-W-Cincinnati-F-Ashleigh_Barty-Jil_Teichmann,1,F-IO,14,10,4,2,4,10,4
20210822-W-Cincinnati-F-Ashleigh_Barty-Jil_Teichmann,1,F-II,3,2,2,0,0,3,0
20210822-W-Cincinnati-F-Ashleigh_Barty-Jil_Teichmann,1,B-XC,5,2,2,0,0,5,0
20210822-W-Cincinnati-F-Ashleigh_Barty-Jil_Teichmann,1,B-DTM,9,1,0,0,1,3,6
20210822-W-Cincinnati-F-Ashleigh_Barty-Jil_Teichmann,1,B-DTL,2,1,0,0,1,0,2
20210822-W-Cincinnati-F-Ashleigh_Barty-Jil_Teichmann,1,B-IO,5,0,0,0,0,3,2
20210822-W-Cincinnati-F-Ashleigh_Barty-Jil_Teichmann,1,S-XC,9,2,0,0,2,4,5
20210822-W-Cincinnati-F-Ashleigh_Barty-Jil_Teichmann,1,S-DTM,9,0,0,0,0,5,4
20210822-W-Cincinnati-F-Ashleigh_Barty-Jil_Teichmann,1,S-DTL,2,0,0,0,0,2,0
20210822-W-Cincinnati-F-Ashleigh_Barty-Jil_Teichmann,1,S-IO,1,0,0,0,0,1,0
20210822-W-Cincinnati-F-Ashleigh_Barty-Jil_Teichmann,2,F-XC,27,2,0,0,2,11,16
20210822-W-Cincinnati-F-Ashleigh_Barty-Jil_Teichmann,2,F-DTM,17,2,1,0,1,6,11
20210822-W-Cincinnati-F-Ashleigh_Barty-Jil_Teichmann,2,F-DTL,6,3,1,0,2,1,5
20210822-W-Cincinnati-F-Ashleigh_Barty-Jil_Teichmann,2,F-IO,8,5,3,0,2,5,3
20210822-W-Cincinnati-F-Ashleigh_Barty-Jil_Teichmann,2,F-II,3,1,0,0,1,1,2
20210822-W-Cincinnati-F-Ashleigh_Barty-Jil_Teichmann,2,B-XC,10,2,0,0,2,2,8
20210822-W-Cincinnati-F-Ashleigh_Barty-Jil_Teichmann,2,B-DTM,21,2,0,0,2,5,16
20210822-W-Cincinnati-F-Ashleigh_Barty-Jil_Teichmann,2,B-DTL,6,2,0,0,2,2,4
20210822-W-Cincinnati-F-Ashleigh_Barty-Jil_Teichmann,2,B-IO,5,2,0,1,1,4,1
20210822-W-Cincinnati-F-Ashleigh_Barty-Jil_Teichmann,2,S-XC,7,0,0,0,0,2,5
20210822-W-Cincinnati-F-Ashleigh_Barty-Jil_Teichmann,2,S-DTM,7,1,0,0,1,2,5
20210822-W-Cincinnati-F-Ashleigh_Barty-Jil_Teichmann,2,S-IO,2,1,0,0,1,1,1
20210822-W-ITF_San_Bartolome_de_Tirajana-F-Arantxa_Rus-Victoria_Jimenez_Kasintseva,1,F-XC,23,3,0,2,1,16,7
20210822-W-ITF_San_Bartolome_de_Tirajana-F-Arantxa_Rus-Victoria_Jimenez_Kasintseva,1,F-DTM,20,3,0,0,3,9,11
20210822-W-ITF_San_Bartolome_de_Tirajana-F-Arantxa_Rus-Victoria_Jimenez_Kasintseva,1,F-DTL,4,0,0,0,0,2,2
20210822-W-ITF_San_Bartolome_de_Tirajana-F-Arantxa_Rus-Victoria_Jimenez_Kasintseva,1,F-IO,23,4,2,2,0,19,4
20210822-W-ITF_San_Bartolome_de_Tirajana-F-Arantxa_Rus-Victoria_Jimenez_Kasintseva,1,F-II,2,2,2,0,0,2,0
20210822-W-ITF_San_Bartolome_de_Tirajana-F-Arantxa_Rus-Victoria_Jimenez_Kasintseva,1,B-XC,22,3,1,2,0,14,8
20210822-W-ITF_San_Bartolome_de_Tirajana-F-Arantxa_Rus-Victoria_Jimenez_Kasintseva,1,B-DTM,19,1,0,0,1,10,9
20210822-W-ITF_San_Bartolome_de_Tirajana-F-Arantxa_Rus-Victoria_Jimenez_Kasintseva,1,B-DTL,4,2,1,0,1,3,1
20210822-W-ITF_San_Bartolome_de_Tirajana-F-Arantxa_Rus-Victoria_Jimenez_Kasintseva,1,B-IO,4,0,0,0,0,3,1
20210822-W-ITF_San_Bartolome_de_Tirajana-F-Arantxa_Rus-Victoria_Jimenez_Kasintseva,1,S-XC,2,0,0,0,0,1,1
20210822-W-ITF_San_Bartolome_de_Tirajana-F-Arantxa_Rus-Victoria_Jimenez_Kasintseva,1,S-DTM,4,0,0,0,0,0,4
20210822-W-ITF_San_Bartolome_de_Tirajana-F-Arantxa_Rus-Victoria_Jimenez_Kasintseva,1,S-DTL,2,2,0,2,0,2,0
20210822-W-ITF_San_Bartolome_de_Tirajana-F-Arantxa_Rus-Victoria_Jimenez_Kasintseva,1,S-IO,1,1,0,0,1,0,1
20210822-W-ITF_San_Bartolome_de_Tirajana-F-Arantxa_Rus-Victoria_Jimenez_Kasintseva,2,F-XC,24,2,1,1,0,13,11
20210822-W-ITF_San_Bartolome_de_Tirajana-F-Arantxa_Rus-Victoria_Jimenez_Kasintseva,2,F-DTM,16,2,0,0,2,3,13
20210822-W-ITF_San_Bartolome_de_Tirajana-F-Arantxa_Rus-Victoria_Jimenez_Kasintseva,2,F-DTL,9,6,0,0,6,2,7
20210822-W-ITF_San_Bartolome_de_Tirajana-F-Arantxa_Rus-Victoria_Jimenez_Kasintseva,2,F-IO,11,3,0,1,2,6,5
20210822-W-ITF_San_Bartolome_de_Tirajana-F-Arantxa_Rus-Victoria_Jimenez_Kasintseva,2,B-XC,31,5,1,0,4,8,23
20210822-W-ITF_San_Bartolome_de_Tirajana-F-Arantxa_Rus-Victoria_Jimenez_Kasintseva,2,B-DTM,23,3,0,0,3,9,14
20210822-W-ITF_San_Bartolome_de_Tirajana-F-Arantxa_Rus-Victoria_Jimenez_Kasintseva,2,B-DTL,9,4,1,2,1,4,5
20210822-W-ITF_San_Bartolome_de_Tirajana-F-Arantxa_Rus-Victoria_Jimenez_Kasintseva,2,B-IO,6,4,0,2,2,2,4
20210822-W-ITF_San_Bartolome_de_Tirajana-F-Arantxa_Rus-Victoria_Jimenez_Kasintseva,2,S-XC,1,0,0,0,0,0,1
20210822-W-ITF_San_Bartolome_de_Tirajana-F-Arantxa_Rus-Victoria_Jimenez_Kasintseva,2,S-DTM,2,0,0,0,0,1,1
20210815-W-ITF_San_Bartolome_de_Tirajana-F-Arantxa_Rus-Mayar_Sherif,1,F-XC,49,5,1,2,2,31,18
20210815-W-ITF_San_Bartolome_de_Tirajana-F-Arantxa_Rus-Mayar_Sherif,1,F-DTM,29,3,0,2,1,17,12
20210815-W-ITF_San_Bartolome_de_Tirajana-F-Arantxa_Rus-Mayar_Sherif,1,F-DTL,8,5,2,0,3,3,5
20210815-W-ITF_San_Bartolome_de_Tirajana-F-Arantxa_Rus-Mayar_Sherif,1,F-IO,25,6,5,1,0,18,7
20210815-W-ITF_San_Bartolome_de_Tirajana-F-Arantxa_Rus-Mayar_Sherif,1,F-II,4,1,0,1,0,2,2
20210815-W-ITF_San_Bartolome_de_Tirajana-F-Arantxa_Rus-Mayar_Sherif,1,B-XC,26,7,3,2,2,20,6
20210815-W-ITF_San_Bartolome_de_Tirajana-F-Arantxa_Rus-Mayar_Sherif,1,B-DTM,29,1,0,0,1,18,11
20210815-W-ITF_San_Bartolome_de_Tirajana-F-Arantxa_Rus-Mayar_Sherif,1,B-DTL,5,2,1,0,1,2,3
20210815-W-ITF_San_Bartolome_de_Tirajana-F-Arantxa_Rus-Mayar_Sherif,1,B-IO,4,0,0,0,0,2,2
20210815-W-ITF_San_Bartolome_de_Tirajana-F-Arantxa_Rus-Mayar_Sherif,1,S-XC,3,1,0,0,1,0,3
20210815-W-ITF_San_Bartolome_de_Tirajana-F-Arantxa_Rus-Mayar_Sherif,1,S-DTM,4,0,0,0,0,2,2
20210815-W-ITF_San_Bartolome_de_Tirajana-F-Arantxa_Rus-Mayar_Sherif,1,S-DTL,2,1,0,0,1,0,2
20210815-W-ITF_San_Bartolome_de_Tirajana-F-Arantxa_Rus-Mayar_Sherif,2,F-XC,57,8,3,1,4,25,32
20210815-W-ITF_San_Bartolome_de_Tirajana-F-Arantxa_Rus-Mayar_Sherif,2,F-DTM,14,1,0,0,1,7,7
20210815-W-ITF_San_Bartolome_de_Tirajana-F-Arantxa_Rus-Mayar_Sherif,2,F-DTL,11,6,2,1,3,4,7
20210815-W-ITF_San_Bartolome_de_Tirajana-F-Arantxa_Rus-Mayar_Sherif,2,F-IO,18,6,1,2,3,5,13
20210815-W-ITF_San_Bartolome_de_Tirajana-F-Arantxa_Rus-Mayar_Sherif,2,F-II,8,1,0,0,1,3,5
20210815-W-ITF_San_Bartolome_de_Tirajana-F-Arantxa_Rus-Mayar_Sherif,2,B-XC,24,8,3,2,3,13,11
20210815-W-ITF_San_Bartolome_de_Tirajana-F-Arantxa_Rus-Mayar_Sherif,2,B-DTM,30,4,0,0,4,6,24
20210815-W-ITF_San_Bartolome_de_Tirajana-F-Arantxa_Rus-Mayar_Sherif,2,B-DTL,14,7,0,1,6,5,9
20210815-W-ITF_San_Bartolome_de_Tirajana-F-Arantxa_Rus-Mayar_Sherif,2,B-IO,5,1,0,1,0,2,3
20210815-W-ITF_San_Bartolome_de_Tirajana-F-Arantxa_Rus-Mayar_Sherif,2,S-XC,1,0,0,0,0,0,1
20210815-W-ITF_San_Bartolome_de_Tirajana-F-Arantxa_Rus-Mayar_Sherif,2,S-DTM,3,0,0,0,0,0,3
20210815-W-ITF_San_Bartolome_de_Tirajana-F-Arantxa_Rus-Mayar_Sherif,2,S-IO,2,1,0,0,1,0,2
20210902-W-US_Open-R64-Bianca_Andreescu-Lauren_Davis,1,F-XC,28,11,3,4,4,14,14
20210902-W-US_Open-R64-Bianca_Andreescu-Lauren_Davis,1,F-DTM,30,3,0,0,3,11,19
20210902-W-US_Open-R64-Bianca_Andreescu-Lauren_Davis,1,F-DTL,6,3,1,0,2,2,4
20210902-W-US_Open-R64-Bianca_Andreescu-Lauren_Davis,1,F-IO,13,6,2,1,3,5,8
20210902-W-US_Open-R64-Bianca_Andreescu-Lauren_Davis,1,B-XC,23,6,2,1,3,12,11
20210902-W-US_Open-R64-Bianca_Andreescu-Lauren_Davis,1,B-DTM,38,2,0,1,1,22,16
20210902-W-US_Open-R64-Bianca_Andreescu-Lauren_Davis,1,B-DTL,5,1,0,0,1,3,2
20210902-W-US_Open-R64-Bianca_Andreescu-Lauren_Davis,1,B-IO,6,1,0,1,0,4,2
20210902-W-US_Open-R64-Bianca_Andreescu-Lauren_Davis,1,S-XC,1,0,0,0,0,1,0
20210902-W-US_Open-R64-Bianca_Andreescu-Lauren_Davis,1,S-DTM,8,1,0,0,1,5,3
20210902-W-US_Open-R64-Bianca_Andreescu-Lauren_Davis,1,S-DTL,1,0,0,0,0,1,0
20210902-W-US_Open-R64-Bianca_Andreescu-Lauren_Davis,1,S-IO,1,1,0,0,1,0,1
20210902-W-US_Open-R64-Bianca_Andreescu-Lauren_Davis,2,F-XC,20,8,1,2,5,10,10
20210902-W-US_Open-R64-Bianca_Andreescu-Lauren_Davis,2,F-DTM,35,2,0,0,2,15,20
20210902-W-US_Open-R64-Bianca_Andreescu-Lauren_Davis,2,F-DTL,7,1,0,0,1,3,4
20210902-W-US_Open-R64-Bianca_Andreescu-Lauren_Davis,2,F-IO,17,2,0,2,0,10,7
20210902-W-US_Open-R64-Bianca_Andreescu-Lauren_Davis,2,B-XC,21,9,2,2,5,11,10
20210902-W-US_Open-R64-Bianca_Andreescu-Lauren_Davis,2,B-DTM,40,8,0,3,5,19,21
20210902-W-US_Open-R64-Bianca_Andreescu-Lauren_Davis,2,B-DTL,5,3,2,0,1,3,2
20210902-W-US_Open-R64-Bianca_Andreescu-Lauren_Davis,2,B-IO,7,2,1,0,1,2,5
20210902-W-US_Open-R64-Bianca_Andreescu-Lauren_Davis,2,S-XC,5,0,0,0,0,2,3
20210902-W-US_Open-R64-Bianca_Andreescu-Lauren_Davis,2,S-DTM,2,0,0,0,0,0,2
20210831-W-US_Open-R128-Bianca_Andreescu-Viktorija_Golubic,1,F-XC,50,12,5,2,5,34,16
20210831-W-US_Open-R128-Bianca_Andreescu-Viktorija_Golubic,1,F-DTM,50,6,0,0,6,27,23
20210831-W-US_Open-R128-Bianca_Andreescu-Viktorija_Golubic,1,F-DTL,7,3,1,0,2,4,3
20210831-W-US_Open-R128-Bianca_Andreescu-Viktorija_Golubic,1,F-IO,22,8,3,2,3,12,10
20210831-W-US_Open-R128-Bianca_Andreescu-Viktorija_Golubic,1,F-II,1,0,0,0,0,0,1
20210831-W-US_Open-R128-Bianca_Andreescu-Viktorija_Golubic,1,B-XC,52,21,6,5,10,27,25
20210831-W-US_Open-R128-Bianca_Andreescu-Viktorija_Golubic,1,B-DTM,55,7,1,2,4,31,24
20210831-W-US_Open-R128-Bianca_Andreescu-Viktorija_Golubic,1,B-DTL,6,2,1,0,1,2,4
20210831-W-US_Open-R128-Bianca_Andreescu-Viktorija_Golubic,1,B-IO,9,7,2,0,5,2,7
20210831-W-US_Open-R128-Bianca_Andreescu-Viktorija_Golubic,1,S-XC,3,0,0,0,0,3,0
20210831-W-US_Open-R128-Bianca_Andreescu-Viktorija_Golubic,1,S-DTM,5,1,0,0,1,3,2
20210831-W-US_Open-R128-Bianca_Andreescu-Viktorija_Golubic,1,S-IO,2,1,0,0,1,0,2
20210831-W-US_Open-R128-Bianca_Andreescu-Viktorija_Golubic,2,F-XC,27,7,2,2,3,15,12
20210831-W-US_Open-R128-Bianca_Andreescu-Viktorija_Golubic,2,F-DTM,46,3,0,1,2,18,28
20210831-W-US_Open-R128-Bianca_Andreescu-Viktorija_Golubic,2,F-DTL,15,3,1,1,1,6,9
20210831-W-US_Open-R128-Bianca_Andreescu-Viktorija_Golubic,2,F-IO,29,8,4,1,3,16,13
20210831-W-US_Open-R128-Bianca_Andreescu-Viktorija_Golubic,2,B-XC,16,7,0,2,5,7,9
20210831-W-US_Open-R128-Bianca_Andreescu-Viktorija_Golubic,2,B-DTM,48,5,0,1,4,23,25
20210831-W-US_Open-R128-Bianca_Andreescu-Viktorija_Golubic,2,B-DTL,7,4,1,0,3,4,3
20210831-W-US_Open-R128-Bianca_Andreescu-Viktorija_Golubic,2,B-IO,8,5,3,0,2,5,3
20210831-W-US_Open-R128-Bianca_Andreescu-Viktorija_Golubic,2,S-XC,20,1,0,0,1,7,13
20210831-W-US_Open-R128-Bianca_Andreescu-Viktorija_Golubic,2,S-DTM,14,0,0,0,0,6,8
20210831-W-US_Open-R128-Bianca_Andreescu-Viktorija_Golubic,2,S-DTL,6,1,0,0,1,2,4
20210831-W-US_Open-R128-Bianca_Andreescu-Viktorija_Golubic,2,S-IO,1,0,0,0,0,0,1
20210831-W-US_Open-R128-Sara_Sorribes_Tormo-Karolina_Muchova,1,F-XC,47,3,0,1,2,28,19
20210831-W-US_Open-R128-Sara_Sorribes_Tormo-Karolina_Muchova,1,F-DTM,83,2,0,2,0,45,38
20210831-W-US_Open-R128-Sara_Sorribes_Tormo-Karolina_Muchova,1,F-DTL,29,6,3,0,3,13,16
20210831-W-US_Open-R128-Sara_Sorribes_Tormo-Karolina_Muchova,1,F-IO,54,6,0,3,3,26,28
20210831-W-US_Open-R128-Sara_Sorribes_Tormo-Karolina_Muchova,1,F-II,5,1,0,1,0,5,0
20210831-W-US_Open-R128-Sara_Sorribes_Tormo-Karolina_Muchova,1,B-XC,14,4,1,2,1,11,3
20210831-W-US_Open-R128-Sara_Sorribes_Tormo-Karolina_Muchova,1,B-DTM,43,1,0,0,1,22,21
20210831-W-US_Open-R128-Sara_Sorribes_Tormo-Karolina_Muchova,1,B-DTL,9,3,2,0,1,6,3
20210831-W-US_Open-R128-Sara_Sorribes_Tormo-Karolina_Muchova,1,B-IO,2,0,0,0,0,2,0
20210831-W-US_Open-R128-Sara_Sorribes_Tormo-Karolina_Muchova,1,S-XC,35,0,0,0,0,24,11
20210831-W-US_Open-R128-Sara_Sorribes_Tormo-Karolina_Muchova,1,S-DTM,29,1,0,0,1,17,12
20210831-W-US_Open-R128-Sara_Sorribes_Tormo-Karolina_Muchova,1,S-DTL,3,0,0,0,0,1,2
20210831-W-US_Open-R128-Sara_Sorribes_Tormo-Karolina_Muchova,1,S-IO,2,0,0,0,0,2,0
20210831-W-US_Open-R128-Sara_Sorribes_Tormo-Karolina_Muchova,2,F-XC,103,15,3,4,8,48,55
20210831-W-US_Open-R128-Sara_Sorribes_Tormo-Karolina_Muchova,2,F-DTM,43,4,0,0,4,19,24
20210831-W-US_Open-R128-Sara_Sorribes_Tormo-Karolina_Muchova,2,F-DTL,11,7,3,1,3,6,5
20210831-W-US_Open-R128-Sara_Sorribes_Tormo-Karolina_Muchova,2,F-IO,48,14,5,4,5,25,23
20210831-W-US_Open-R128-Sara_Sorribes_Tormo-Karolina_Muchova,2,F-II,3,2,0,0,2,0,3
20210831-W-US_Open-R128-Sara_Sorribes_Tormo-Karolina_Muchova,2,B-XC,68,5,0,1,4,29,39
20210831-W-US_Open-R128-Sara_Sorribes_Tormo-Karolina_Muchova,2,B-DTM,41,4,0,2,2,15,26
20210831-W-US_Open-R128-Sara_Sorribes_Tormo-Karolina_Muchova,2,B-DTL,10,4,0,2,2,5,5
20210831-W-US_Open-R128-Sara_Sorribes_Tormo-Karolina_Muchova,2,B-IO,9,5,0,0,5,2,7
20210831-W-US_Open-R128-Sara_Sorribes_Tormo-Karolina_Muchova,2,S-XC,17,1,0,0,1,3,14
20210831-W-US_Open-R128-Sara_Sorribes_Tormo-Karolina_Muchova,2,S-DTM,11,1,0,0,1,5,6
20210831-W-US_Open-R128-Sara_Sorribes_Tormo-Karolina_Muchova,2,S-DTL,4,0,0,0,0,0,4
20210831-W-US_Open-R128-Sara_Sorribes_Tormo-Karolina_Muchova,2,S-IO,1,0,0,0,0,0,1
20210902-W-US_Open-R64-Sara_Sorribes_Tormo-Su_Wei_Hsieh,1,F-XC,35,2,1,1,0,27,8
20210902-W-US_Open-R64-Sara_Sorribes_Tormo-Su_Wei_Hsieh,1,F-DTM,38,2,0,1,1,22,16
20210902-W-US_Open-R64-Sara_Sorribes_Tormo-Su_Wei_Hsieh,1,F-DTL,9,2,1,1,0,5,4
20210902-W-US_Open-R64-Sara_Sorribes_Tormo-Su_Wei_Hsieh,1,F-IO,21,1,0,0,1,10,11
20210902-W-US_Open-R64-Sara_Sorribes_Tormo-Su_Wei_Hsieh,1,F-II,1,1,1,0,0,1,0
20210902-W-US_Open-R64-Sara_Sorribes_Tormo-Su_Wei_Hsieh,1,B-XC,8,1,0,0,1,3,5
20210902-W-US_Open-R64-Sara_Sorribes_Tormo-Su_Wei_Hsieh,1,B-DTM,36,2,0,0,2,20,16
20210902-W-US_Open-R64-Sara_Sorribes_Tormo-Su_Wei_Hsieh,1,B-DTL,5,0,0,0,0,4,1
20210902-W-US_Open-R64-Sara_Sorribes_Tormo-Su_Wei_Hsieh,1,B-IO,4,1,1,0,0,4,0
20210902-W-US_Open-R64-Sara_Sorribes_Tormo-Su_Wei_Hsieh,1,S-XC,23,2,0,0,2,12,11
20210902-W-US_Open-R64-Sara_Sorribes_Tormo-Su_Wei_Hsieh,1,S-DTM,31,0,0,0,0,19,12
20210902-W-US_Open-R64-Sara_Sorribes_Tormo-Su_Wei_Hsieh,1,S-DTL,3,0,0,0,0,1,2
20210902-W-US_Open-R64-Sara_Sorribes_Tormo-Su_Wei_Hsieh,1,S-IO,1,0,0,0,0,0,1
20210902-W-US_Open-R64-Sara_Sorribes_Tormo-Su_Wei_Hsieh,2,F-XC,51,18,3,2,13,12,39
20210902-W-US_Open-R64-Sara_Sorribes_Tormo-Su_Wei_Hsieh,2,F-DTM,24,2,0,0,2,8,16
20210902-W-US_Open-R64-Sara_Sorribes_Tormo-Su_Wei_Hsieh,2,F-DTL,9,5,0,0,5,3,6
20210902-W-US_Open-R64-Sara_Sorribes_Tormo-Su_Wei_Hsieh,2,F-IO,24,8,3,2,3,14,10
20210902-W-US_Open-R64-Sara_Sorribes_Tormo-Su_Wei_Hsieh,2,B-XC,70,12,0,3,9,27,43
20210902-W-US_Open-R64-Sara_Sorribes_Tormo-Su_Wei_Hsieh,2,B-DTM,19,3,0,1,2,9,10
20210902-W-US_Open-R64-Sara_Sorribes_Tormo-Su_Wei_Hsieh,2,B-DTL,13,8,4,1,3,7,6
20210902-W-US_Open-R64-Sara_Sorribes_Tormo-Su_Wei_Hsieh,2,B-IO,13,6,1,0,5,3,10
20210902-W-US_Open-R64-Sara_Sorribes_Tormo-Su_Wei_Hsieh,2,S-XC,3,0,0,0,0,2,1
20210902-W-US_Open-R64-Sara_Sorribes_Tormo-Su_Wei_Hsieh,2,S-DTM,4,1,0,0,1,1,3
20210902-W-US_Open-R64-Sara_Sorribes_Tormo-Su_Wei_Hsieh,2,S-IO,2,0,0,0,0,1,1
20210904-W-US_Open-R32-Bianca_Andreescu-Greet_Minnen,1,F-XC,19,6,5,1,0,12,7
20210904-W-US_Open-R32-Bianca_Andreescu-Greet_Minnen,1,F-DTM,18,2,0,0,2,9,9
20210904-W-US_Open-R32-Bianca_Andreescu-Greet_Minnen,1,F-DTL,4,0,0,0,0,1,3
20210904-W-US_Open-R32-Bianca_Andreescu-Greet_Minnen,1,F-IO,7,2,0,1,1,3,4
20210904-W-US_Open-R32-Bianca_Andreescu-Greet_Minnen,1,B-XC,11,3,1,1,1,5,6
20210904-W-US_Open-R32-Bianca_Andreescu-Greet_Minnen,1,B-DTM,26,2,0,1,1,17,9
20210904-W-US_Open-R32-Bianca_Andreescu-Greet_Minnen,1,B-DTL,5,5,2,2,1,4,1
20210904-W-US_Open-R32-Bianca_Andreescu-Greet_Minnen,1,B-IO,7,5,4,0,1,5,2
20210904-W-US_Open-R32-Bianca_Andreescu-Greet_Minnen,1,S-XC,1,0,0,0,0,0,1
20210904-W-US_Open-R32-Bianca_Andreescu-Greet_Minnen,1,S-DTM,6,2,0,0,2,1,5
20210904-W-US_Open-R32-Bianca_Andreescu-Greet_Minnen,1,S-IO,4,0,0,0,0,2,2
20210904-W-US_Open-R32-Bianca_Andreescu-Greet_Minnen,2,F-XC,24,10,5,1,4,14,10
20210904-W-US_Open-R32-Bianca_Andreescu-Greet_Minnen,2,F-DTM,27,4,0,0,4,10,17
20210904-W-US_Open-R32-Bianca_Andreescu-Greet_Minnen,2,F-DTL,2,1,0,0,1,1,1
20210904-W-US_Open-R32-Bianca_Andreescu-Greet_Minnen,2,F-IO,23,11,4,0,7,10,13
20210904-W-US_Open-R32-Bianca_Andreescu-Greet_Minnen,2,F-II,2,2,2,0,0,2,0
20210904-W-US_Open-R32-Bianca_Andreescu-Greet_Minnen,2,B-XC,13,2,1,0,1,6,7
20210904-W-US_Open-R32-Bianca_Andreescu-Greet_Minnen,2,B-DTM,18,3,0,0,3,7,11
20210904-W-US_Open-R32-Bianca_Andreescu-Greet_Minnen,2,B-DTL,2,2,1,0,1,1,1
20210904-W-US_Open-R32-Bianca_Andreescu-Greet_Minnen,2,S-XC,1,0,0,0,0,1,0
20210904-W-US_Open-R32-Bianca_Andreescu-Greet_Minnen,2,S-DTM,3,0,0,0,0,2,1
20210904-W-US_Open-R32-Bianca_Andreescu-Greet_Minnen,2,S-DTL,1,0,0,0,0,1,0
20210904-W-US_Open-R32-Bianca_Andreescu-Greet_Minnen,2,S-IO,2,0,0,0,0,1,1
20210819-W-Cincinnati-R16-Victoria_Azarenka-Ashleigh_Barty,1,F-XC,18,5,2,2,1,13,5
20210819-W-Cincinnati-R16-Victoria_Azarenka-Ashleigh_Barty,1,F-DTM,17,0,0,0,0,7,10
20210819-W-Cincinnati-R16-Victoria_Azarenka-Ashleigh_Barty,1,F-DTL,20,5,0,1,4,14,6
20210819-W-Cincinnati-R16-Victoria_Azarenka-Ashleigh_Barty,1,F-IO,28,5,0,0,5,15,13
20210819-W-Cincinnati-R16-Victoria_Azarenka-Ashleigh_Barty,1,B-XC,18,4,2,0,2,10,8
20210819-W-Cincinnati-R16-Victoria_Azarenka-Ashleigh_Barty,1,B-DTM,9,2,0,0,2,3,6
20210819-W-Cincinnati-R16-Victoria_Azarenka-Ashleigh_Barty,1,B-DTL,6,3,1,2,0,5,1
20210819-W-Cincinnati-R16-Victoria_Azarenka-Ashleigh_Barty,1,B-IO,5,1,0,0,1,3,2
20210819-W-Cincinnati-R16-Victoria_Azarenka-Ashleigh_Barty,1,S-XC,9,2,0,0,2,4,5
20210819-W-Cincinnati-R16-Victoria_Azarenka-Ashleigh_Barty,1,S-DTM,2,0,0,0,0,0,2
20210819-W-Cincinnati-R16-Victoria_Azarenka-Ashleigh_Barty,1,S-DTL,1,1,0,0,1,0,1
20210819-W-Cincinnati-R16-Victoria_Azarenka-Ashleigh_Barty,2,F-XC,30,9,4,1,4,13,17
20210819-W-Cincinnati-R16-Victoria_Azarenka-Ashleigh_Barty,2,F-DTM,9,0,0,0,0,2,7
20210819-W-Cincinnati-R16-Victoria_Azarenka-Ashleigh_Barty,2,F-DTL,3,2,1,1,0,2,1
20210819-W-Cincinnati-R16-Victoria_Azarenka-Ashleigh_Barty,2,F-IO,14,8,7,0,1,10,4
20210819-W-Cincinnati-R16-Victoria_Azarenka-Ashleigh_Barty,2,F-II,4,3,0,1,2,2,2
20210819-W-Cincinnati-R16-Victoria_Azarenka-Ashleigh_Barty,2,B-XC,7,2,0,0,2,2,5
20210819-W-Cincinnati-R16-Victoria_Azarenka-Ashleigh_Barty,2,B-DTM,9,1,0,0,1,4,5
20210819-W-Cincinnati-R16-Victoria_Azarenka-Ashleigh_Barty,2,B-DTL,7,3,1,0,2,1,6
20210819-W-Cincinnati-R16-Victoria_Azarenka-Ashleigh_Barty,2,S-XC,20,5,1,1,3,8,12
20210819-W-Cincinnati-R16-Victoria_Azarenka-Ashleigh_Barty,2,S-DTM,12,1,0,0,1,5,7
20210819-W-Cincinnati-R16-Victoria_Azarenka-Ashleigh_Barty,2,S-DTL,9,2,0,0,2,3,6
20210819-W-Cincinnati-R16-Victoria_Azarenka-Ashleigh_Barty,2,S-IO,6,2,0,2,0,4,2
20210906-W-US_Open-R16-Bianca_Andreescu-Maria_Sakkari,1,F-XC,74,22,4,2,16,31,43
20210906-W-US_Open-R16-Bianca_Andreescu-Maria_Sakkari,1,F-DTM,57,4,0,0,4,24,33
20210906-W-US_Open-R16-Bianca_Andreescu-Maria_Sakkari,1,F-DTL,9,6,1,2,3,4,5
20210906-W-US_Open-R16-Bianca_Andreescu-Maria_Sakkari,1,F-IO,39,14,5,3,6,22,17
20210906-W-US_Open-R16-Bianca_Andreescu-Maria_Sakkari,1,B-XC,42,15,5,3,7,20,22
20210906-W-US_Open-R16-Bianca_Andreescu-Maria_Sakkari,1,B-DTM,74,5,0,1,4,44,30
20210906-W-US_Open-R16-Bianca_Andreescu-Maria_Sakkari,1,B-DTL,11,7,2,2,3,7,4
20210906-W-US_Open-R16-Bianca_Andreescu-Maria_Sakkari,1,B-IO,11,3,2,0,1,7,4
20210906-W-US_Open-R16-Bianca_Andreescu-Maria_Sakkari,1,S-XC,4,0,0,0,0,2,2
20210906-W-US_Open-R16-Bianca_Andreescu-Maria_Sakkari,1,S-DTM,7,1,0,0,1,3,4
20210906-W-US_Open-R16-Bianca_Andreescu-Maria_Sakkari,1,S-DTL,4,1,0,1,0,2,2
20210906-W-US_Open-R16-Bianca_Andreescu-Maria_Sakkari,1,S-IO,2,1,0,0,1,1,1
20210906-W-US_Open-R16-Bianca_Andreescu-Maria_Sakkari,2,F-XC,59,22,10,2,10,33,26
20210906-W-US_Open-R16-Bianca_Andreescu-Maria_Sakkari,2,F-DTM,87,9,0,1,8,33,54
20210906-W-US_Open-R16-Bianca_Andreescu-Maria_Sakkari,2,F-DTL,12,5,0,2,3,8,4
20210906-W-US_Open-R16-Bianca_Andreescu-Maria_Sakkari,2,F-IO,24,5,1,1,3,10,14
20210906-W-US_Open-R16-Bianca_Andreescu-Maria_Sakkari,2,F-II,3,1,0,1,0,3,0
20210906-W-US_Open-R16-Bianca_Andreescu-Maria_Sakkari,2,B-XC,57,16,9,4,3,31,26
20210906-W-US_Open-R16-Bianca_Andreescu-Maria_Sakkari,2,B-DTM,70,6,0,1,5,35,35
20210906-W-US_Open-R16-Bianca_Andreescu-Maria_Sakkari,2,B-IO,7,4,2,0,2,3,4
20210906-W-US_Open-R16-Bianca_Andreescu-Maria_Sakkari,2,S-XC,3,1,1,0,0,1,2
20210906-W-US_Open-R16-Bianca_Andreescu-Maria_Sakkari,2,S-DTM,5,0,0,0,0,1,4
20210906-W-US_Open-R16-Bianca_Andreescu-Maria_Sakkari,2,S-DTL,1,0,0,0,0,0,1
20210904-W-US_Open-R32-Iga_Swiatek-Anett_Kontaveit,1,F-XC,58,17,4,6,7,40,18
20210904-W-US_Open-R32-Iga_Swiatek-Anett_Kontaveit,1,F-DTM,33,2,0,0,2,20,13
20210904-W-US_Open-R32-Iga_Swiatek-Anett_Kontaveit,1,F-DTL,14,8,5,1,2,8,6
20210904-W-US_Open-R32-Iga_Swiatek-Anett_Kontaveit,1,F-IO,25,8,3,1,4,16,9
20210904-W-US_Open-R32-Iga_Swiatek-Anett_Kontaveit,1,B-XC,48,10,3,3,4,32,16
20210904-W-US_Open-R32-Iga_Swiatek-Anett_Kontaveit,1,B-DTM,42,3,0,0,3,22,20
20210904-W-US_Open-R32-Iga_Swiatek-Anett_Kontaveit,1,B-DTL,13,9,2,5,2,8,5
20210904-W-US_Open-R32-Iga_Swiatek-Anett_Kontaveit,1,B-IO,12,4,1,2,1,10,2
20210904-W-US_Open-R32-Iga_Swiatek-Anett_Kontaveit,1,S-XC,1,0,0,0,0,0,1
20210904-W-US_Open-R32-Iga_Swiatek-Anett_Kontaveit,1,S-DTM,4,0,0,0,0,2,2
20210904-W-US_Open-R32-Iga_Swiatek-Anett_Kontaveit,1,S-DTL,1,0,0,0,0,0,1
20210904-W-US_Open-R32-Iga_Swiatek-Anett_Kontaveit,2,F-XC,46,11,2,3,6,19,27
20210904-W-US_Open-R32-Iga_Swiatek-Anett_Kontaveit,2,F-DTM,51,7,0,1,6,17,34
20210904-W-US_Open-R32-Iga_Swiatek-Anett_Kontaveit,2,F-DTL,14,5,2,1,2,6,8
20210904-W-US_Open-R32-Iga_Swiatek-Anett_Kontaveit,2,F-IO,13,7,3,1,3,7,6
20210904-W-US_Open-R32-Iga_Swiatek-Anett_Kontaveit,2,B-XC,66,15,7,1,7,33,33
20210904-W-US_Open-R32-Iga_Swiatek-Anett_Kontaveit,2,B-DTM,53,6,0,0,6,13,40
20210904-W-US_Open-R32-Iga_Swiatek-Anett_Kontaveit,2,B-DTL,9,8,4,1,3,5,4
20210904-W-US_Open-R32-Iga_Swiatek-Anett_Kontaveit,2,B-IO,7,3,1,0,2,2,5
20210904-W-US_Open-R32-Iga_Swiatek-Anett_Kontaveit,2,S-XC,1,0,0,0,0,0,1
20210904-W-US_Open-R32-Iga_Swiatek-Anett_Kontaveit,2,S-DTM,3,0,0,0,0,0,3
20210904-W-US_Open-R32-Iga_Swiatek-Anett_Kontaveit,2,S-DTL,1,0,0,0,0,0,1
20210907-W-US_Open-QF-Leylah_Annie_Fernandez-Elina_Svitolina,1,F-XC,100,11,4,1,6,63,37
20210907-W-US_Open-QF-Leylah_Annie_Fernandez-Elina_Svitolina,1,F-DTM,71,7,0,1,6,34,37
20210907-W-US_Open-QF-Leylah_Annie_Fernandez-Elina_Svitolina,1,F-DTL,25,18,9,3,6,16,9
20210907-W-US_Open-QF-Leylah_Annie_Fernandez-Elina_Svitolina,1,F-IO,26,9,5,2,2,19,7
20210907-W-US_Open-QF-Leylah_Annie_Fernandez-Elina_Svitolina,1,B-XC,34,8,3,1,4,18,16
20210907-W-US_Open-QF-Leylah_Annie_Fernandez-Elina_Svitolina,1,B-DTM,57,5,1,0,4,28,29
20210907-W-US_Open-QF-Leylah_Annie_Fernandez-Elina_Svitolina,1,B-DTL,5,3,0,2,1,2,3
20210907-W-US_Open-QF-Leylah_Annie_Fernandez-Elina_Svitolina,1,B-IO,13,4,2,0,2,8,5
20210907-W-US_Open-QF-Leylah_Annie_Fernandez-Elina_Svitolina,1,S-DTM,8,1,0,0,1,0,8
20210907-W-US_Open-QF-Leylah_Annie_Fernandez-Elina_Svitolina,1,S-DTL,5,0,0,0,0,2,3
20210907-W-US_Open-QF-Leylah_Annie_Fernandez-Elina_Svitolina,1,S-IO,1,0,0,0,0,1,0
20210907-W-US_Open-QF-Leylah_Annie_Fernandez-Elina_Svitolina,2,F-XC,37,9,6,2,1,23,14
20210907-W-US_Open-QF-Leylah_Annie_Fernandez-Elina_Svitolina,2,F-DTM,68,2,0,1,1,28,40
20210907-W-US_Open-QF-Leylah_Annie_Fernandez-Elina_Svitolina,2,F-DTL,4,1,0,0,1,0,4
20210907-W-US_Open-QF-Leylah_Annie_Fernandez-Elina_Svitolina,2,F-IO,31,11,2,3,6,17,14
20210907-W-US_Open-QF-Leylah_Annie_Fernandez-Elina_Svitolina,2,F-II,1,1,1,0,0,1,0
20210907-W-US_Open-QF-Leylah_Annie_Fernandez-Elina_Svitolina,2,B-XC,57,10,3,3,4,29,28
20210907-W-US_Open-QF-Leylah_Annie_Fernandez-Elina_Svitolina,2,B-DTM,91,10,0,1,9,35,56
20210907-W-US_Open-QF-Leylah_Annie_Fernandez-Elina_Svitolina,2,B-DTL,9,2,1,1,0,6,3
20210907-W-US_Open-QF-Leylah_Annie_Fernandez-Elina_Svitolina,2,B-IO,14,3,2,0,1,9,5
20210907-W-US_Open-QF-Leylah_Annie_Fernandez-Elina_Svitolina,2,S-XC,5,1,1,0,0,2,3
20210907-W-US_Open-QF-Leylah_Annie_Fernandez-Elina_Svitolina,2,S-DTM,5,0,0,0,0,1,4
20210909-W-US_Open-SF-Emma_Raducanu-Maria_Sakkari,1,F-XC,28,4,1,0,3,17,11
20210909-W-US_Open-SF-Emma_Raducanu-Maria_Sakkari,1,F-DTM,24,2,0,1,1,15,9
20210909-W-US_Open-SF-Emma_Raducanu-Maria_Sakkari,1,F-DTL,5,1,0,0,1,2,3
20210909-W-US_Open-SF-Emma_Raducanu-Maria_Sakkari,1,F-IO,7,3,1,1,1,5,2
20210909-W-US_Open-SF-Emma_Raducanu-Maria_Sakkari,1,B-XC,16,5,3,0,2,10,6
20210909-W-US_Open-SF-Emma_Raducanu-Maria_Sakkari,1,B-DTM,36,3,0,0,3,19,17
20210909-W-US_Open-SF-Emma_Raducanu-Maria_Sakkari,1,B-DTL,11,8,4,2,2,8,3
20210909-W-US_Open-SF-Emma_Raducanu-Maria_Sakkari,1,B-IO,3,2,0,1,1,2,1
20210909-W-US_Open-SF-Emma_Raducanu-Maria_Sakkari,1,S-XC,1,0,0,0,0,1,0
20210909-W-US_Open-SF-Emma_Raducanu-Maria_Sakkari,1,S-DTM,1,0,0,0,0,1,0
20210909-W-US_Open-SF-Emma_Raducanu-Maria_Sakkari,1,S-DTL,1,0,0,0,0,0,1
20210909-W-US_Open-SF-Emma_Raducanu-Maria_Sakkari,1,S-IO,1,0,0,0,0,1,0
20210909-W-US_Open-SF-Emma_Raducanu-Maria_Sakkari,2,F-XC,31,14,6,4,4,17,14
20210909-W-US_Open-SF-Emma_Raducanu-Maria_Sakkari,2,F-DTM,32,7,0,3,4,9,23
20210909-W-US_Open-SF-Emma_Raducanu-Maria_Sakkari,2,F-DTL,8,2,1,0,1,3,5
20210909-W-US_Open-SF-Emma_Raducanu-Maria_Sakkari,2,F-IO,14,4,1,0,3,5,9
20210909-W-US_Open-SF-Emma_Raducanu-Maria_Sakkari,2,B-XC,21,3,0,1,2,11,10
20210909-W-US_Open-SF-Emma_Raducanu-Maria_Sakkari,2,B-DTM,23,7,1,0,6,7,16
20210909-W-US_Open-SF-Emma_Raducanu-Maria_Sakkari,2,B-IO,2,1,1,0,0,2,0
20210909-W-US_Open-SF-Emma_Raducanu-Maria_Sakkari,2,S-XC,3,2,0,0,2,1,2
20210909-W-US_Open-SF-Emma_Raducanu-Maria_Sakkari,2,S-DTM,4,0,0,0,0,1,3
20210908-W-US_Open-QF-Karolina_Pliskova-Maria_Sakkari,1,F-XC,26,12,3,2,7,10,16
20210908-W-US_Open-QF-Karolina_Pliskova-Maria_Sakkari,1,F-DTM,22,1,0,0,1,8,14
20210908-W-US_Open-QF-Karolina_Pliskova-Maria_Sakkari,1,F-DTL,3,1,1,0,0,1,2
20210908-W-US_Open-QF-Karolina_Pliskova-Maria_Sakkari,1,F-IO,16,5,0,1,4,9,7
20210908-W-US_Open-QF-Karolina_Pliskova-Maria_Sakkari,1,B-XC,14,5,0,2,3,4,10
20210908-W-US_Open-QF-Karolina_Pliskova-Maria_Sakkari,1,B-DTM,20,2,0,0,2,7,13
20210908-W-US_Open-QF-Karolina_Pliskova-Maria_Sakkari,1,B-DTL,8,3,0,1,2,3,5
20210908-W-US_Open-QF-Karolina_Pliskova-Maria_Sakkari,1,B-IO,7,1,0,0,1,2,5
20210908-W-US_Open-QF-Karolina_Pliskova-Maria_Sakkari,1,S-XC,3,0,0,0,0,1,2
20210908-W-US_Open-QF-Karolina_Pliskova-Maria_Sakkari,1,S-DTM,2,0,0,0,0,0,2
20210908-W-US_Open-QF-Karolina_Pliskova-Maria_Sakkari,1,S-DTL,1,0,0,0,0,1,0
20210908-W-US_Open-QF-Karolina_Pliskova-Maria_Sakkari,1,S-IO,1,0,0,0,0,1,0
20210908-W-US_Open-QF-Karolina_Pliskova-Maria_Sakkari,2,F-XC,14,4,1,0,3,9,5
20210908-W-US_Open-QF-Karolina_Pliskova-Maria_Sakkari,2,F-DTM,24,2,0,0,2,15,9
20210908-W-US_Open-QF-Karolina_Pliskova-Maria_Sakkari,2,F-DTL,10,3,2,0,1,6,4
20210908-W-US_Open-QF-Karolina_Pliskova-Maria_Sakkari,2,F-IO,11,4,1,1,2,7,4
20210908-W-US_Open-QF-Karolina_Pliskova-Maria_Sakkari,2,F-II,1,1,1,0,0,1,0
20210908-W-US_Open-QF-Karolina_Pliskova-Maria_Sakkari,2,B-XC,23,9,4,3,2,16,7
20210908-W-US_Open-QF-Karolina_Pliskova-Maria_Sakkari,2,B-DTM,19,1,0,1,0,11,8
20210908-W-US_Open-QF-Karolina_Pliskova-Maria_Sakkari,2,B-DTL,3,3,3,0,0,3,0
20210908-W-US_Open-QF-Karolina_Pliskova-Maria_Sakkari,2,B-IO,2,1,0,0,1,1,1
20210908-W-US_Open-QF-Karolina_Pliskova-Maria_Sakkari,2,S-XC,1,0,0,0,0,1,0
20210908-W-US_Open-QF-Karolina_Pliskova-Maria_Sakkari,2,S-DTM,1,0,0,0,0,0,1
20210903-W-US_Open-R32-Daria_Kasatkina-Elina_Svitolina,1,F-XC,35,6,3,1,2,11,24
20210903-W-US_Open-R32-Daria_Kasatkina-Elina_Svitolina,1,F-DTM,21,4,1,0,3,7,14
20210903-W-US_Open-R32-Daria_Kasatkina-Elina_Svitolina,1,F-DTL,17,6,4,0,2,10,7
20210903-W-US_Open-R32-Daria_Kasatkina-Elina_Svitolina,1,F-IO,48,10,6,1,3,29,19
20210903-W-US_Open-R32-Daria_Kasatkina-Elina_Svitolina,1,F-II,4,0,0,0,0,2,2
20210903-W-US_Open-R32-Daria_Kasatkina-Elina_Svitolina,1,B-XC,20,1,0,0,1,3,17
20210903-W-US_Open-R32-Daria_Kasatkina-Elina_Svitolina,1,B-DTM,21,1,0,0,1,8,13
20210903-W-US_Open-R32-Daria_Kasatkina-Elina_Svitolina,1,B-DTL,13,6,1,1,4,7,6
20210903-W-US_Open-R32-Daria_Kasatkina-Elina_Svitolina,1,B-IO,7,2,1,0,1,3,4
20210903-W-US_Open-R32-Daria_Kasatkina-Elina_Svitolina,1,S-XC,11,1,0,0,1,2,9
20210903-W-US_Open-R32-Daria_Kasatkina-Elina_Svitolina,1,S-DTM,10,1,0,0,1,2,8
20210903-W-US_Open-R32-Daria_Kasatkina-Elina_Svitolina,1,S-DTL,1,0,0,0,0,1,0
20210903-W-US_Open-R32-Daria_Kasatkina-Elina_Svitolina,1,S-IO,3,1,0,0,1,2,1
20210903-W-US_Open-R32-Daria_Kasatkina-Elina_Svitolina,2,F-XC,24,5,2,0,3,13,11
20210903-W-US_Open-R32-Daria_Kasatkina-Elina_Svitolina,2,F-DTM,29,2,0,1,1,20,9
20210903-W-US_Open-R32-Daria_Kasatkina-Elina_Svitolina,2,F-DTL,13,5,3,2,0,9,4
20210903-W-US_Open-R32-Daria_Kasatkina-Elina_Svitolina,2,F-IO,18,5,1,3,1,14,4
20210903-W-US_Open-R32-Daria_Kasatkina-Elina_Svitolina,2,F-II,1,1,1,0,0,1,0
20210903-W-US_Open-R32-Daria_Kasatkina-Elina_Svitolina,2,B-XC,53,6,1,1,4,34,19
20210903-W-US_Open-R32-Daria_Kasatkina-Elina_Svitolina,2,B-DTM,32,4,0,0,4,20,12
20210903-W-US_Open-R32-Daria_Kasatkina-Elina_Svitolina,2,B-DTL,12,4,2,1,1,8,4
20210903-W-US_Open-R32-Daria_Kasatkina-Elina_Svitolina,2,B-IO,7,4,3,1,0,7,0
20210903-W-US_Open-R32-Daria_Kasatkina-Elina_Svitolina,2,S-XC,3,0,0,0,0,1,2
20210903-W-US_Open-R32-Daria_Kasatkina-Elina_Svitolina,2,S-DTM,4,0,0,0,0,1,3
20210914-W-Luxembourg-R32-Anna_Lena_Friedsam-Arianne_Hartono,1,F-XC,45,10,2,3,5,21,24
20210914-W-Luxembourg-R32-Anna_Lena_Friedsam-Arianne_Hartono,1,F-DTM,33,5,0,0,5,8,25
20210914-W-Luxembourg-R32-Anna_Lena_Friedsam-Arianne_Hartono,1,F-DTL,11,5,0,1,4,4,7
20210914-W-Luxembourg-R32-Anna_Lena_Friedsam-Arianne_Hartono,1,F-IO,10,3,1,0,2,6,4
20210914-W-Luxembourg-R32-Anna_Lena_Friedsam-Arianne_Hartono,1,B-XC,54,6,1,2,3,29,25
20210914-W-Luxembourg-R32-Anna_Lena_Friedsam-Arianne_Hartono,1,B-DTM,54,3,1,0,2,26,28
20210914-W-Luxembourg-R32-Anna_Lena_Friedsam-Arianne_Hartono,1,B-DTL,4,2,1,0,1,2,2
20210914-W-Luxembourg-R32-Anna_Lena_Friedsam-Arianne_Hartono,1,B-IO,5,1,1,0,0,5,0
20210914-W-Luxembourg-R32-Anna_Lena_Friedsam-Arianne_Hartono,1,S-XC,17,3,0,1,2,5,12
20210914-W-Luxembourg-R32-Anna_Lena_Friedsam-Arianne_Hartono,1,S-DTM,20,1,0,0,1,7,13
20210914-W-Luxembourg-R32-Anna_Lena_Friedsam-Arianne_Hartono,1,S-DTL,1,0,0,0,0,0,1
20210914-W-Luxembourg-R32-Anna_Lena_Friedsam-Arianne_Hartono,1,S-IO,2,1,0,0,1,0,2
20210914-W-Luxembourg-R32-Anna_Lena_Friedsam-Arianne_Hartono,2,F-XC,81,34,14,2,18,52,29
20210914-W-Luxembourg-R32-Anna_Lena_Friedsam-Arianne_Hartono,2,F-DTM,30,4,0,0,4,13,17
20210914-W-Luxembourg-R32-Anna_Lena_Friedsam-Arianne_Hartono,2,F-DTL,17,10,6,0,4,9,8
20210914-W-Luxembourg-R32-Anna_Lena_Friedsam-Arianne_Hartono,2,F-IO,36,18,11,2,5,24,12
20210914-W-Luxembourg-R32-Anna_Lena_Friedsam-Arianne_Hartono,2,F-II,4,3,1,1,1,3,1
20210914-W-Luxembourg-R32-Anna_Lena_Friedsam-Arianne_Hartono,2,B-XC,64,17,4,3,10,34,30
20210914-W-Luxembourg-R32-Anna_Lena_Friedsam-Arianne_Hartono,2,B-DTM,55,3,0,0,3,21,34
20210914-W-Luxembourg-R32-Anna_Lena_Friedsam-Arianne_Hartono,2,B-DTL,7,5,3,1,1,5,2
20210914-W-Luxembourg-R32-Anna_Lena_Friedsam-Arianne_Hartono,2,B-IO,6,4,3,0,1,4,2
20210914-W-Luxembourg-R32-Anna_Lena_Friedsam-Arianne_Hartono,2,S-XC,2,1,0,0,1,1,1
20210914-W-Luxembourg-R32-Anna_Lena_Friedsam-Arianne_Hartono,2,S-DTM,3,0,0,0,0,1,2
20210914-W-Luxembourg-R32-Anna_Lena_Friedsam-Arianne_Hartono,2,S-DTL,2,1,1,0,0,2,0
20210825-W-US_Open-Q1-Emma_Raducanu-Bibiane_Schoofs,1,F-XC,33,9,2,5,2,22,11
20210825-W-US_Open-Q1-Emma_Raducanu-Bibiane_Schoofs,1,F-DTM,15,1,0,0,1,10,5
20210825-W-US_Open-Q1-Emma_Raducanu-Bibiane_Schoofs,1,F-DTL,5,2,1,1,0,4,1
20210825-W-US_Open-Q1-Emma_Raducanu-Bibiane_Schoofs,1,F-IO,5,2,0,0,2,2,3
20210825-W-US_Open-Q1-Emma_Raducanu-Bibiane_Schoofs,1,F-II,1,0,0,0,0,0,1
20210825-W-US_Open-Q1-Emma_Raducanu-Bibiane_Schoofs,1,B-XC,18,6,2,2,2,15,3
20210825-W-US_Open-Q1-Emma_Raducanu-Bibiane_Schoofs,1,B-DTM,18,1,0,0,1,8,10
20210825-W-US_Open-Q1-Emma_Raducanu-Bibiane_Schoofs,1,B-DTL,7,2,1,0,1,5,2
20210825-W-US_Open-Q1-Emma_Raducanu-Bibiane_Schoofs,1,B-IO,6,2,2,0,0,5,1
20210825-W-US_Open-Q1-Emma_Raducanu-Bibiane_Schoofs,1,S-XC,3,2,0,0,2,0,3
20210825-W-US_Open-Q1-Emma_Raducanu-Bibiane_Schoofs,1,S-DTM,3,1,0,1,0,1,2
20210825-W-US_Open-Q1-Emma_Raducanu-Bibiane_Schoofs,1,S-IO,1,1,0,0,1,0,1
20210825-W-US_Open-Q1-Emma_Raducanu-Bibiane_Schoofs,2,F-XC,26,8,1,2,5,5,21
20210825-W-US_Open-Q1-Emma_Raducanu-Bibiane_Schoofs,2,F-DTM,22,2,0,2,0,11,11
20210825-W-US_Open-Q1-Emma_Raducanu-Bibiane_Schoofs,2,F-DTL,5,0,0,0,0,2,3
20210825-W-US_Open-Q1-Emma_Raducanu-Bibiane_Schoofs,2,F-IO,10,4,1,0,3,5,5
20210825-W-US_Open-Q1-Emma_Raducanu-Bibiane_Schoofs,2,B-XC,7,0,0,0,0,3,4
20210825-W-US_Open-Q1-Emma_Raducanu-Bibiane_Schoofs,2,B-DTM,15,2,0,0,2,4,11
20210825-W-US_Open-Q1-Emma_Raducanu-Bibiane_Schoofs,2,B-IO,4,2,0,0,2,2,2
20210825-W-US_Open-Q1-Emma_Raducanu-Bibiane_Schoofs,2,S-XC,11,0,0,0,0,3,8
20210825-W-US_Open-Q1-Emma_Raducanu-Bibiane_Schoofs,2,S-DTM,7,2,0,0,2,2,5
20210825-W-US_Open-Q1-Emma_Raducanu-Bibiane_Schoofs,2,S-DTL,1,0,0,0,0,1,0
20210825-W-US_Open-Q1-Emma_Raducanu-Bibiane_Schoofs,2,S-IO,1,0,0,0,0,1,0
20210906-W-US_Open-R16-Iga_Swiatek-Belinda_Bencic,1,F-XC,50,19,8,2,9,25,25
20210906-W-US_Open-R16-Iga_Swiatek-Belinda_Bencic,1,F-DTM,32,3,1,0,2,18,14
20210906-W-US_Open-R16-Iga_Swiatek-Belinda_Bencic,1,F-DTL,9,4,3,1,0,5,4
20210906-W-US_Open-R16-Iga_Swiatek-Belinda_Bencic,1,F-IO,7,4,2,1,1,3,4
20210906-W-US_Open-R16-Iga_Swiatek-Belinda_Bencic,1,B-XC,22,7,0,2,5,10,12
20210906-W-US_Open-R16-Iga_Swiatek-Belinda_Bencic,1,B-DTM,28,4,0,0,4,10,18
20210906-W-US_Open-R16-Iga_Swiatek-Belinda_Bencic,1,B-DTL,7,3,3,0,0,6,1
20210906-W-US_Open-R16-Iga_Swiatek-Belinda_Bencic,1,B-IO,13,6,2,1,3,4,9
20210906-W-US_Open-R16-Iga_Swiatek-Belinda_Bencic,1,S-DTM,1,0,0,0,0,1,0
20210906-W-US_Open-R16-Iga_Swiatek-Belinda_Bencic,1,S-DTL,1,0,0,0,0,0,1
20210906-W-US_Open-R16-Iga_Swiatek-Belinda_Bencic,2,F-XC,54,17,7,3,7,32,22
20210906-W-US_Open-R16-Iga_Swiatek-Belinda_Bencic,2,F-DTM,32,2,0,0,2,12,20
20210906-W-US_Open-R16-Iga_Swiatek-Belinda_Bencic,2,F-DTL,10,2,1,0,1,4,6
20210906-W-US_Open-R16-Iga_Swiatek-Belinda_Bencic,2,F-IO,23,6,3,1,2,19,4
20210906-W-US_Open-R16-Iga_Swiatek-Belinda_Bencic,2,B-XC,20,7,2,1,4,9,11
20210906-W-US_Open-R16-Iga_Swiatek-Belinda_Bencic,2,B-DTM,16,2,0,1,1,9,7
20210906-W-US_Open-R16-Iga_Swiatek-Belinda_Bencic,2,B-DTL,12,6,3,1,2,8,4
20210906-W-US_Open-R16-Iga_Swiatek-Belinda_Bencic,2,B-IO,4,2,2,0,0,4,0
20210903-W-US_Open-R32-Leylah_Annie_Fernandez-Naomi_Osaka,1,F-XC,10,5,4,0,1,8,2
20210903-W-US_Open-R32-Leylah_Annie_Fernandez-Naomi_Osaka,1,F-DTM,28,0,0,0,0,15,13
20210903-W-US_Open-R32-Leylah_Annie_Fernandez-Naomi_Osaka,1,F-IO,40,7,2,2,3,30,10
20210903-W-US_Open-R32-Leylah_Annie_Fernandez-Naomi_Osaka,1,F-II,12,4,1,1,2,7,5
20210903-W-US_Open-R32-Leylah_Annie_Fernandez-Naomi_Osaka,1,B-XC,5,3,1,1,1,2,3
20210903-W-US_Open-R32-Leylah_Annie_Fernandez-Naomi_Osaka,1,B-DTM,28,4,1,0,3,17,11
20210903-W-US_Open-R32-Leylah_Annie_Fernandez-Naomi_Osaka,1,B-IO,20,8,3,1,4,9,11
20210903-W-US_Open-R32-Leylah_Annie_Fernandez-Naomi_Osaka,1,B-II,5,3,0,0,3,2,3
20210903-W-US_Open-R32-Leylah_Annie_Fernandez-Naomi_Osaka,1,S-XC,2,0,0,0,0,1,1
20210903-W-US_Open-R32-Leylah_Annie_Fernandez-Naomi_Osaka,1,S-DTM,2,0,0,0,0,1,1
20210903-W-US_Open-R32-Leylah_Annie_Fernandez-Naomi_Osaka,1,S-II,1,0,0,0,0,1,0
20210903-W-US_Open-R32-Leylah_Annie_Fernandez-Naomi_Osaka,2,F-XC,40,25,5,9,11,22,18
20210903-W-US_Open-R32-Leylah_Annie_Fernandez-Naomi_Osaka,2,F-DTM,23,2,0,1,1,11,12
20210903-W-US_Open-R32-Leylah_Annie_Fernandez-Naomi_Osaka,2,F-DTL,6,4,2,1,1,3,3
20210903-W-US_Open-R32-Leylah_Annie_Fernandez-Naomi_Osaka,2,F-IO,25,11,4,3,4,14,11
20210903-W-US_Open-R32-Leylah_Annie_Fernandez-Naomi_Osaka,2,F-II,1,1,1,0,0,1,0
20210903-W-US_Open-R32-Leylah_Annie_Fernandez-Naomi_Osaka,2,B-XC,29,12,4,2,6,13,16
20210903-W-US_Open-R32-Leylah_Annie_Fernandez-Naomi_Osaka,2,B-DTM,21,2,0,0,2,4,17
20210903-W-US_Open-R32-Leylah_Annie_Fernandez-Naomi_Osaka,2,B-DTL,9,6,2,0,4,3,6
20210903-W-US_Open-R32-Leylah_Annie_Fernandez-Naomi_Osaka,2,B-IO,16,6,1,3,2,9,7
20210903-W-US_Open-R32-Leylah_Annie_Fernandez-Naomi_Osaka,2,S-XC,1,0,0,0,0,0,1
20210905-W-US_Open-R16-Barbora_Krejcikova-Garbine_Muguruza,1,F-XC,50,17,7,3,7,28,22
20210905-W-US_Open-R16-Barbora_Krejcikova-Garbine_Muguruza,1,F-DTM,30,5,0,1,4,16,14
20210905-W-US_Open-R16-Barbora_Krejcikova-Garbine_Muguruza,1,F-DTL,7,3,1,2,0,5,2
20210905-W-US_Open-R16-Barbora_Krejcikova-Garbine_Muguruza,1,F-IO,14,5,1,1,3,9,5
20210905-W-US_Open-R16-Barbora_Krejcikova-Garbine_Muguruza,1,F-II,1,1,1,0,0,1,0
20210905-W-US_Open-R16-Barbora_Krejcikova-Garbine_Muguruza,1,B-XC,37,10,3,1,6,19,18
20210905-W-US_Open-R16-Barbora_Krejcikova-Garbine_Muguruza,1,B-DTM,36,5,0,1,4,15,21
20210905-W-US_Open-R16-Barbora_Krejcikova-Garbine_Muguruza,1,B-DTL,6,3,2,0,1,3,3
20210905-W-US_Open-R16-Barbora_Krejcikova-Garbine_Muguruza,1,B-IO,3,1,1,0,0,3,0
20210905-W-US_Open-R16-Barbora_Krejcikova-Garbine_Muguruza,1,S-XC,9,0,0,0,0,3,6
20210905-W-US_Open-R16-Barbora_Krejcikova-Garbine_Muguruza,1,S-DTM,7,0,0,0,0,4,3
20210905-W-US_Open-R16-Barbora_Krejcikova-Garbine_Muguruza,2,F-XC,26,8,3,2,3,13,13
20210905-W-US_Open-R16-Barbora_Krejcikova-Garbine_Muguruza,2,F-DTM,26,3,0,0,3,14,12
20210905-W-US_Open-R16-Barbora_Krejcikova-Garbine_Muguruza,2,F-DTL,15,3,1,1,1,6,9
20210905-W-US_Open-R16-Barbora_Krejcikova-Garbine_Muguruza,2,F-IO,19,5,2,0,3,9,10
20210905-W-US_Open-R16-Barbora_Krejcikova-Garbine_Muguruza,2,B-XC,41,4,1,0,3,23,18
20210905-W-US_Open-R16-Barbora_Krejcikova-Garbine_Muguruza,2,B-DTM,47,6,0,0,6,15,32
20210905-W-US_Open-R16-Barbora_Krejcikova-Garbine_Muguruza,2,B-DTL,9,5,3,0,2,6,3
20210905-W-US_Open-R16-Barbora_Krejcikova-Garbine_Muguruza,2,B-IO,11,6,2,1,3,4,7
20210904-W-US_Open-R32-Petra_Kvitova-Maria_Sakkari,1,F-XC,24,12,2,2,8,9,15
20210904-W-US_Open-R32-Petra_Kvitova-Maria_Sakkari,1,F-DTM,19,3,2,0,1,12,7
20210904-W-US_Open-R32-Petra_Kvitova-Maria_Sakkari,1,F-DTL,8,3,1,1,1,3,5
20210904-W-US_Open-R32-Petra_Kvitova-Maria_Sakkari,1,F-IO,12,8,3,0,5,3,9
20210904-W-US_Open-R32-Petra_Kvitova-Maria_Sakkari,1,B-XC,6,3,0,0,3,2,4
20210904-W-US_Open-R32-Petra_Kvitova-Maria_Sakkari,1,B-DTM,12,2,0,0,2,5,7
20210904-W-US_Open-R32-Petra_Kvitova-Maria_Sakkari,1,B-IO,3,1,0,0,1,1,2
20210904-W-US_Open-R32-Petra_Kvitova-Maria_Sakkari,1,S-DTM,1,0,0,0,0,0,1
20210904-W-US_Open-R32-Petra_Kvitova-Maria_Sakkari,1,S-IO,2,0,0,0,0,0,2
20210904-W-US_Open-R32-Petra_Kvitova-Maria_Sakkari,2,F-XC,11,7,2,1,4,7,4
20210904-W-US_Open-R32-Petra_Kvitova-Maria_Sakkari,2,F-DTM,18,3,2,1,0,12,6
20210904-W-US_Open-R32-Petra_Kvitova-Maria_Sakkari,2,F-DTL,6,3,1,1,1,3,3
20210904-W-US_Open-R32-Petra_Kvitova-Maria_Sakkari,2,F-IO,6,1,0,0,1,2,4
20210904-W-US_Open-R32-Petra_Kvitova-Maria_Sakkari,2,B-XC,8,3,1,0,2,3,5
20210904-W-US_Open-R32-Petra_Kvitova-Maria_Sakkari,2,B-DTM,20,2,0,1,1,14,6
20210904-W-US_Open-R32-Petra_Kvitova-Maria_Sakkari,2,S-XC,1,0,0,0,0,1,0
20210904-W-US_Open-R32-Petra_Kvitova-Maria_Sakkari,2,S-DTM,4,0,0,0,0,3,1
20210902-W-US_Open-R64-Shuai_Zhang-Emma_Raducanu,1,F-XC,32,14,6,5,3,19,13
20210902-W-US_Open-R64-Shuai_Zhang-Emma_Raducanu,1,F-DTM,45,3,0,1,2,17,28
20210902-W-US_Open-R64-Shuai_Zhang-Emma_Raducanu,1,F-DTL,6,4,2,1,1,4,2
20210902-W-US_Open-R64-Shuai_Zhang-Emma_Raducanu,1,F-IO,12,6,1,4,1,9,3
20210902-W-US_Open-R64-Shuai_Zhang-Emma_Raducanu,1,B-XC,16,6,3,1,2,9,7
20210902-W-US_Open-R64-Shuai_Zhang-Emma_Raducanu,1,B-DTM,45,4,0,1,3,17,28
20210902-W-US_Open-R64-Shuai_Zhang-Emma_Raducanu,1,B-DTL,8,1,0,1,0,5,3
20210902-W-US_Open-R64-Shuai_Zhang-Emma_Raducanu,1,B-IO,5,0,0,0,0,2,3
20210902-W-US_Open-R64-Shuai_Zhang-Emma_Raducanu,2,F-XC,26,11,4,4,3,17,9
20210902-W-US_Open-R64-Shuai_Zhang-Emma_Raducanu,2,F-DTM,38,3,1,0,2,20,18
20210902-W-US_Open-R64-Shuai_Zhang-Emma_Raducanu,2,F-DTL,8,3,1,2,0,5,3
20210902-W-US_Open-R64-Shuai_Zhang-Emma_Raducanu,2,F-IO,14,5,1,4,0,10,4
20210902-W-US_Open-R64-Shuai_Zhang-Emma_Raducanu,2,B-XC,15,5,3,0,2,8,7
20210902-W-US_Open-R64-Shuai_Zhang-Emma_Raducanu,2,B-DTM,44,1,0,0,1,22,22
20210902-W-US_Open-R64-Shuai_Zhang-Emma_Raducanu,2,B-DTL,4,0,0,0,0,3,1
20210902-W-US_Open-R64-Shuai_Zhang-Emma_Raducanu,2,B-IO,8,7,4,2,1,7,1
20210906-W-US_Open-R16-Karolina_Pliskova-Anastasia_Pavlyuchenkova,1,F-XC,34,13,5,2,6,19,15
20210906-W-US_Open-R16-Karolina_Pliskova-Anastasia_Pavlyuchenkova,1,F-DTM,14,4,1,0,3,9,5
20210906-W-US_Open-R16-Karolina_Pliskova-Anastasia_Pavlyuchenkova,1,F-DTL,2,0,0,0,0,1,1
20210906-W-US_Open-R16-Karolina_Pliskova-Anastasia_Pavlyuchenkova,1,F-IO,8,4,3,1,0,7,1
20210906-W-US_Open-R16-Karolina_Pliskova-Anastasia_Pavlyuchenkova,1,F-II,1,1,1,0,0,1,0
20210906-W-US_Open-R16-Karolina_Pliskova-Anastasia_Pavlyuchenkova,1,B-XC,16,3,2,1,0,10,6
20210906-W-US_Open-R16-Karolina_Pliskova-Anastasia_Pavlyuchenkova,1,B-DTM,23,3,0,1,2,13,10
20210906-W-US_Open-R16-Karolina_Pliskova-Anastasia_Pavlyuchenkova,1,B-DTL,9,4,2,0,2,5,4
20210906-W-US_Open-R16-Karolina_Pliskova-Anastasia_Pavlyuchenkova,1,B-IO,8,3,2,0,1,7,1
20210906-W-US_Open-R16-Karolina_Pliskova-Anastasia_Pavlyuchenkova,1,S-XC,5,0,0,0,0,3,2
20210906-W-US_Open-R16-Karolina_Pliskova-Anastasia_Pavlyuchenkova,1,S-DTM,3,0,0,0,0,1,2
20210906-W-US_Open-R16-Karolina_Pliskova-Anastasia_Pavlyuchenkova,2,F-XC,23,10,4,4,2,14,9
20210906-W-US_Open-R16-Karolina_Pliskova-Anastasia_Pavlyuchenkova,2,F-DTM,21,5,0,0,5,5,16
20210906-W-US_Open-R16-Karolina_Pliskova-Anastasia_Pavlyuchenkova,2,F-DTL,15,6,2,1,3,6,9
20210906-W-US_Open-R16-Karolina_Pliskova-Anastasia_Pavlyuchenkova,2,F-IO,16,7,3,2,2,9,7
20210906-W-US_Open-R16-Karolina_Pliskova-Anastasia_Pavlyuchenkova,2,B-XC,19,7,0,1,6,6,13
20210906-W-US_Open-R16-Karolina_Pliskova-Anastasia_Pavlyuchenkova,2,B-DTM,21,5,0,0,5,9,12
20210906-W-US_Open-R16-Karolina_Pliskova-Anastasia_Pavlyuchenkova,2,B-DTL,7,4,1,0,3,3,4
20210906-W-US_Open-R16-Karolina_Pliskova-Anastasia_Pavlyuchenkova,2,B-IO,2,0,0,0,0,0,2
20210906-W-US_Open-R16-Karolina_Pliskova-Anastasia_Pavlyuchenkova,2,S-XC,1,0,0,0,0,0,1
20210906-W-US_Open-R16-Karolina_Pliskova-Anastasia_Pavlyuchenkova,2,S-DTM,1,0,0,0,0,0,1
20210830-W-US_Open-R128-Elina_Svitolina-Rebecca_Marino,1,F-XC,13,2,2,0,0,11,2
20210830-W-US_Open-R128-Elina_Svitolina-Rebecca_Marino,1,F-DTM,26,0,0,0,0,21,5
20210830-W-US_Open-R128-Elina_Svitolina-Rebecca_Marino,1,F-DTL,5,3,1,0,2,2,3
20210830-W-US_Open-R128-Elina_Svitolina-Rebecca_Marino,1,F-IO,11,3,2,1,0,9,2
20210830-W-US_Open-R128-Elina_Svitolina-Rebecca_Marino,1,B-XC,15,3,0,2,1,7,8
20210830-W-US_Open-R128-Elina_Svitolina-Rebecca_Marino,1,B-DTM,23,1,0,0,1,17,6
20210830-W-US_Open-R128-Elina_Svitolina-Rebecca_Marino,1,B-DTL,4,3,0,2,1,3,1
20210830-W-US_Open-R128-Elina_Svitolina-Rebecca_Marino,1,B-IO,5,2,0,1,1,4,1
20210830-W-US_Open-R128-Elina_Svitolina-Rebecca_Marino,1,S-XC,2,0,0,0,0,1,1
20210830-W-US_Open-R128-Elina_Svitolina-Rebecca_Marino,1,S-DTM,1,0,0,0,0,0,1
20210830-W-US_Open-R128-Elina_Svitolina-Rebecca_Marino,1,S-DTL,1,0,0,0,0,0,1
20210830-W-US_Open-R128-Elina_Svitolina-Rebecca_Marino,2,F-XC,31,12,3,0,9,8,23
20210830-W-US_Open-R128-Elina_Svitolina-Rebecca_Marino,2,F-DTM,23,4,0,1,3,5,18
20210830-W-US_Open-R128-Elina_Svitolina-Rebecca_Marino,2,F-DTL,2,2,1,0,1,1,1
20210830-W-US_Open-R128-Elina_Svitolina-Rebecca_Marino,2,F-IO,20,13,7,1,5,12,8
20210830-W-US_Open-R128-Elina_Svitolina-Rebecca_Marino,2,F-II,1,1,1,0,0,1,0
20210830-W-US_Open-R128-Elina_Svitolina-Rebecca_Marino,2,B-XC,13,2,1,0,1,4,9
20210830-W-US_Open-R128-Elina_Svitolina-Rebecca_Marino,2,B-DTM,24,4,0,0,4,5,19
20210830-W-US_Open-R128-Elina_Svitolina-Rebecca_Marino,2,B-DTL,5,1,1,0,0,2,3
20210830-W-US_Open-R128-Elina_Svitolina-Rebecca_Marino,2,B-IO,2,1,0,0,1,0,2
20210830-W-US_Open-R128-Elina_Svitolina-Rebecca_Marino,2,S-XC,1,0,0,0,0,1,0
20210830-W-US_Open-R128-Elina_Svitolina-Rebecca_Marino,2,S-DTM,2,1,0,0,1,0,2
20210830-W-US_Open-R128-Elina_Svitolina-Rebecca_Marino,2,S-DTL,1,0,0,0,0,1,0
20210904-W-US_Open-R32-Ashleigh_Barty-Shelby_Rogers,1,F-XC,74,21,6,6,9,47,27
20210904-W-US_Open-R32-Ashleigh_Barty-Shelby_Rogers,1,F-DTM,36,5,0,1,4,15,21
20210904-W-US_Open-R32-Ashleigh_Barty-Shelby_Rogers,1,F-DTL,6,4,2,0,2,3,3
20210904-W-US_Open-R32-Ashleigh_Barty-Shelby_Rogers,1,F-IO,45,15,5,5,5,29,16
20210904-W-US_Open-R32-Ashleigh_Barty-Shelby_Rogers,1,F-II,10,4,2,0,2,5,5
20210904-W-US_Open-R32-Ashleigh_Barty-Shelby_Rogers,1,B-XC,15,7,0,2,5,3,12
20210904-W-US_Open-R32-Ashleigh_Barty-Shelby_Rogers,1,B-DTM,18,2,0,0,2,6,12
20210904-W-US_Open-R32-Ashleigh_Barty-Shelby_Rogers,1,B-DTL,8,1,0,0,1,2,6
20210904-W-US_Open-R32-Ashleigh_Barty-Shelby_Rogers,1,B-IO,3,1,1,0,0,3,0
20210904-W-US_Open-R32-Ashleigh_Barty-Shelby_Rogers,1,S-XC,36,4,1,0,3,18,18
20210904-W-US_Open-R32-Ashleigh_Barty-Shelby_Rogers,1,S-DTM,29,2,0,1,1,13,16
20210904-W-US_Open-R32-Ashleigh_Barty-Shelby_Rogers,1,S-DTL,11,3,0,1,2,6,5
20210904-W-US_Open-R32-Ashleigh_Barty-Shelby_Rogers,1,S-IO,9,1,0,0,1,2,7
20210904-W-US_Open-R32-Ashleigh_Barty-Shelby_Rogers,2,F-XC,27,4,2,1,1,13,14
20210904-W-US_Open-R32-Ashleigh_Barty-Shelby_Rogers,2,F-DTM,50,2,0,0,2,18,32
20210904-W-US_Open-R32-Ashleigh_Barty-Shelby_Rogers,2,F-DTL,43,8,2,0,6,20,23
20210904-W-US_Open-R32-Ashleigh_Barty-Shelby_Rogers,2,F-IO,49,5,1,3,1,30,19
20210904-W-US_Open-R32-Ashleigh_Barty-Shelby_Rogers,2,B-XC,35,4,0,0,4,17,18
20210904-W-US_Open-R32-Ashleigh_Barty-Shelby_Rogers,2,B-DTM,49,2,0,0,2,30,19
20210904-W-US_Open-R32-Ashleigh_Barty-Shelby_Rogers,2,B-DTL,12,7,2,2,3,5,7
20210904-W-US_Open-R32-Ashleigh_Barty-Shelby_Rogers,2,B-IO,2,0,0,0,0,2,0
20210904-W-US_Open-R32-Ashleigh_Barty-Shelby_Rogers,2,S-XC,10,0,0,0,0,4,6
20210904-W-US_Open-R32-Ashleigh_Barty-Shelby_Rogers,2,S-DTM,5,0,0,0,0,2,3
20210904-W-US_Open-R32-Ashleigh_Barty-Shelby_Rogers,2,S-DTL,1,0,0,0,0,0,1
20210901-W-US_Open-R64-Rebeka_Masarova-Elina_Svitolina,1,F-XC,49,8,2,1,5,20,29
20210901-W-US_Open-R64-Rebeka_Masarova-Elina_Svitolina,1,F-DTM,46,5,0,0,5,13,33
20210901-W-US_Open-R64-Rebeka_Masarova-Elina_Svitolina,1,F-DTL,7,4,1,0,3,2,5
20210901-W-US_Open-R64-Rebeka_Masarova-Elina_Svitolina,1,F-IO,10,4,2,0,2,7,3
20210901-W-US_Open-R64-Rebeka_Masarova-Elina_Svitolina,1,F-II,1,0,0,0,0,0,1
20210901-W-US_Open-R64-Rebeka_Masarova-Elina_Svitolina,1,B-XC,16,2,0,0,2,7,9
20210901-W-US_Open-R64-Rebeka_Masarova-Elina_Svitolina,1,B-DTM,32,2,0,1,1,5,27
20210901-W-US_Open-R64-Rebeka_Masarova-Elina_Svitolina,1,B-DTL,12,2,1,0,1,2,10
20210901-W-US_Open-R64-Rebeka_Masarova-Elina_Svitolina,1,B-IO,12,2,1,1,0,5,7
20210901-W-US_Open-R64-Rebeka_Masarova-Elina_Svitolina,1,S-XC,2,0,0,0,0,0,2
20210901-W-US_Open-R64-Rebeka_Masarova-Elina_Svitolina,1,S-DTM,10,1,0,0,1,3,7
20210901-W-US_Open-R64-Rebeka_Masarova-Elina_Svitolina,1,S-IO,2,0,0,0,0,0,2
20210901-W-US_Open-R64-Rebeka_Masarova-Elina_Svitolina,2,F-XC,50,7,4,0,3,35,15
20210901-W-US_Open-R64-Rebeka_Masarova-Elina_Svitolina,2,F-DTM,57,3,0,0,3,37,20
20210901-W-US_Open-R64-Rebeka_Masarova-Elina_Svitolina,2,F-DTL,9,1,1,0,0,9,0
20210901-W-US_Open-R64-Rebeka_Masarova-Elina_Svitolina,2,F-IO,30,11,4,5,2,23,7
20210901-W-US_Open-R64-Rebeka_Masarova-Elina_Svitolina,2,F-II,1,1,1,0,0,1,0
20210901-W-US_Open-R64-Rebeka_Masarova-Elina_Svitolina,2,B-XC,20,4,1,3,0,18,2
20210901-W-US_Open-R64-Rebeka_Masarova-Elina_Svitolina,2,B-DTM,16,1,0,0,1,8,8
20210901-W-US_Open-R64-Rebeka_Masarova-Elina_Svitolina,2,B-DTL,4,2,1,0,1,2,2
20210901-W-US_Open-R64-Rebeka_Masarova-Elina_Svitolina,2,B-IO,5,4,2,1,1,4,1
20210901-W-US_Open-R64-Rebeka_Masarova-Elina_Svitolina,2,S-DTM,5,0,0,0,0,2,3
20210901-W-US_Open-R64-Rebeka_Masarova-Elina_Svitolina,2,S-IO,1,0,0,0,0,1,0
20210904-W-US_Open-R32-Jessica_Pegula-Belinda_Bencic,1,F-XC,29,7,2,2,3,15,14
20210904-W-US_Open-R32-Jessica_Pegula-Belinda_Bencic,1,F-DTM,21,3,1,0,2,12,9
20210904-W-US_Open-R32-Jessica_Pegula-Belinda_Bencic,1,F-DTL,4,4,3,0,1,3,1
20210904-W-US_Open-R32-Jessica_Pegula-Belinda_Bencic,1,F-IO,9,4,2,1,1,7,2
20210904-W-US_Open-R32-Jessica_Pegula-Belinda_Bencic,1,B-XC,12,4,2,1,1,6,6
20210904-W-US_Open-R32-Jessica_Pegula-Belinda_Bencic,1,B-DTM,25,3,0,0,3,10,15
20210904-W-US_Open-R32-Jessica_Pegula-Belinda_Bencic,1,B-DTL,4,1,0,0,1,2,2
20210904-W-US_Open-R32-Jessica_Pegula-Belinda_Bencic,1,B-IO,6,1,0,0,1,2,4
20210904-W-US_Open-R32-Jessica_Pegula-Belinda_Bencic,1,S-XC,1,0,0,0,0,0,1
20210904-W-US_Open-R32-Jessica_Pegula-Belinda_Bencic,1,S-DTM,4,0,0,0,0,1,3
20210904-W-US_Open-R32-Jessica_Pegula-Belinda_Bencic,1,S-DTL,2,0,0,0,0,1,1
20210904-W-US_Open-R32-Jessica_Pegula-Belinda_Bencic,2,F-XC,24,5,0,2,3,14,10
20210904-W-US_Open-R32-Jessica_Pegula-Belinda_Bencic,2,F-DTM,22,2,0,0,2,8,14
20210904-W-US_Open-R32-Jessica_Pegula-Belinda_Bencic,2,F-DTL,6,1,0,0,1,4,2
20210904-W-US_Open-R32-Jessica_Pegula-Belinda_Bencic,2,F-IO,16,7,2,3,2,10,6
20210904-W-US_Open-R32-Jessica_Pegula-Belinda_Bencic,2,B-XC,6,3,1,1,1,4,2
20210904-W-US_Open-R32-Jessica_Pegula-Belinda_Bencic,2,B-DTM,21,2,0,0,2,8,13
20210904-W-US_Open-R32-Jessica_Pegula-Belinda_Bencic,2,B-DTL,8,6,2,2,2,5,3
20210904-W-US_Open-R32-Jessica_Pegula-Belinda_Bencic,2,B-IO,6,4,2,1,1,5,1
20210904-W-US_Open-R32-Jessica_Pegula-Belinda_Bencic,2,S-DTM,1,0,0,0,0,0,1
20210830-W-US_Open-R128-Leylah_Annie_Fernandez-Ana_Konjuh,1,F-XC,41,11,1,5,5,25,16
20210830-W-US_Open-R128-Leylah_Annie_Fernandez-Ana_Konjuh,1,F-DTM,18,3,0,2,1,11,7
20210830-W-US_Open-R128-Leylah_Annie_Fernandez-Ana_Konjuh,1,F-DTL,10,4,0,2,2,7,3
20210830-W-US_Open-R128-Leylah_Annie_Fernandez-Ana_Konjuh,1,F-IO,10,6,4,2,0,8,2
20210830-W-US_Open-R128-Leylah_Annie_Fernandez-Ana_Konjuh,1,F-II,2,0,0,0,0,2,0
20210830-W-US_Open-R128-Leylah_Annie_Fernandez-Ana_Konjuh,1,B-XC,15,5,1,1,3,9,6
20210830-W-US_Open-R128-Leylah_Annie_Fernandez-Ana_Konjuh,1,B-DTM,11,2,0,0,2,4,7
20210830-W-US_Open-R128-Leylah_Annie_Fernandez-Ana_Konjuh,1,B-DTL,4,3,1,0,2,2,2
20210830-W-US_Open-R128-Leylah_Annie_Fernandez-Ana_Konjuh,1,B-IO,6,2,1,0,1,5,1
20210830-W-US_Open-R128-Leylah_Annie_Fernandez-Ana_Konjuh,1,S-XC,2,0,0,0,0,1,1
20210830-W-US_Open-R128-Leylah_Annie_Fernandez-Ana_Konjuh,1,S-DTM,1,0,0,0,0,0,1
20210830-W-US_Open-R128-Leylah_Annie_Fernandez-Ana_Konjuh,1,S-DTL,5,1,0,0,1,1,4
20210830-W-US_Open-R128-Leylah_Annie_Fernandez-Ana_Konjuh,1,S-IO,2,1,0,0,1,0,2
20210830-W-US_Open-R128-Leylah_Annie_Fernandez-Ana_Konjuh,2,F-XC,19,11,1,4,6,9,10
20210830-W-US_Open-R128-Leylah_Annie_Fernandez-Ana_Konjuh,2,F-DTM,15,1,0,0,1,4,11
20210830-W-US_Open-R128-Leylah_Annie_Fernandez-Ana_Konjuh,2,F-DTL,6,5,1,1,3,2,4
20210830-W-US_Open-R128-Leylah_Annie_Fernandez-Ana_Konjuh,2,F-IO,11,6,3,1,2,8,3
20210830-W-US_Open-R128-Leylah_Annie_Fernandez-Ana_Konjuh,2,B-XC,29,9,2,2,5,9,20
20210830-W-US_Open-R128-Leylah_Annie_Fernandez-Ana_Konjuh,2,B-DTM,20,0,0,0,0,8,12
20210830-W-US_Open-R128-Leylah_Annie_Fernandez-Ana_Konjuh,2,B-DTL,4,1,0,0,1,1,3
20210830-W-US_Open-R128-Leylah_Annie_Fernandez-Ana_Konjuh,2,B-IO,4,2,0,0,2,1,3
20210830-W-US_Open-R128-Leylah_Annie_Fernandez-Ana_Konjuh,2,S-XC,6,1,1,0,0,3,3
20210830-W-US_Open-R128-Leylah_Annie_Fernandez-Ana_Konjuh,2,S-DTM,2,0,0,0,0,0,2
20210830-W-US_Open-R128-Leylah_Annie_Fernandez-Ana_Konjuh,2,S-IO,1,0,0,0,0,0,1
20210831-W-US_Open-R128-Marta_Kostyuk-Maria_Sakkari,1,F-XC,12,0,0,0,0,3,9
20210831-W-US_Open-R128-Marta_Kostyuk-Maria_Sakkari,1,F-DTM,15,2,1,0,1,9,6
20210831-W-US_Open-R128-Marta_Kostyuk-Maria_Sakkari,1,F-DTL,4,3,0,0,3,0,4
20210831-W-US_Open-R128-Marta_Kostyuk-Maria_Sakkari,1,F-IO,17,6,3,0,3,7,10
20210831-W-US_Open-R128-Marta_Kostyuk-Maria_Sakkari,1,B-XC,15,2,0,1,1,7,8
20210831-W-US_Open-R128-Marta_Kostyuk-Maria_Sakkari,1,B-DTM,25,5,0,0,5,8,17
20210831-W-US_Open-R128-Marta_Kostyuk-Maria_Sakkari,1,B-DTL,6,4,1,0,3,3,3
20210831-W-US_Open-R128-Marta_Kostyuk-Maria_Sakkari,1,B-IO,2,2,0,0,2,0,2
20210831-W-US_Open-R128-Marta_Kostyuk-Maria_Sakkari,1,S-XC,1,0,0,0,0,0,1
20210831-W-US_Open-R128-Marta_Kostyuk-Maria_Sakkari,1,S-DTM,3,0,0,0,0,0,3
20210831-W-US_Open-R128-Marta_Kostyuk-Maria_Sakkari,1,S-DTL,1,0,0,0,0,0,1
20210831-W-US_Open-R128-Marta_Kostyuk-Maria_Sakkari,1,S-IO,2,0,0,0,0,0,2
20210831-W-US_Open-R128-Marta_Kostyuk-Maria_Sakkari,2,F-XC,20,9,1,3,5,13,7
20210831-W-US_Open-R128-Marta_Kostyuk-Maria_Sakkari,2,F-DTM,15,4,0,0,4,5,10
20210831-W-US_Open-R128-Marta_Kostyuk-Maria_Sakkari,2,F-DTL,3,2,1,0,1,2,1
20210831-W-US_Open-R128-Marta_Kostyuk-Maria_Sakkari,2,F-IO,23,12,5,3,4,13,10
20210831-W-US_Open-R128-Marta_Kostyuk-Maria_Sakkari,2,B-XC,33,11,2,2,7,18,15
20210831-W-US_Open-R128-Marta_Kostyuk-Maria_Sakkari,2,B-DTM,17,4,0,4,0,11,6
20210831-W-US_Open-R128-Marta_Kostyuk-Maria_Sakkari,2,B-DTL,2,0,0,0,0,2,0
20210831-W-US_Open-R128-Marta_Kostyuk-Maria_Sakkari,2,S-XC,1,0,0,0,0,1,0
20050908-W-US_Open-SF-Mary_Pierce-Elena_Dementieva,1,F-XC,29,11,4,4,3,19,10
20050908-W-US_Open-SF-Mary_Pierce-Elena_Dementieva,1,F-DTM,25,4,0,1,3,11,14
20050908-W-US_Open-SF-Mary_Pierce-Elena_Dementieva,1,F-DTL,8,3,1,0,2,3,5
20050908-W-US_Open-SF-Mary_Pierce-Elena_Dementieva,1,F-IO,27,14,8,2,4,14,13
20050908-W-US_Open-SF-Mary_Pierce-Elena_Dementieva,1,B-XC,25,2,0,1,1,13,12
20050908-W-US_Open-SF-Mary_Pierce-Elena_Dementieva,1,B-DTM,26,0,0,0,0,7,19
20050908-W-US_Open-SF-Mary_Pierce-Elena_Dementieva,1,B-DTL,18,3,1,0,2,7,11
20050908-W-US_Open-SF-Mary_Pierce-Elena_Dementieva,1,B-IO,21,11,2,3,6,9,12
20050908-W-US_Open-SF-Mary_Pierce-Elena_Dementieva,1,S-XC,1,0,0,0,0,1,0
20050908-W-US_Open-SF-Mary_Pierce-Elena_Dementieva,1,S-DTM,1,0,0,0,0,1,0
20050908-W-US_Open-SF-Mary_Pierce-Elena_Dementieva,1,S-IO,1,1,0,1,0,1,0
20050908-W-US_Open-SF-Mary_Pierce-Elena_Dementieva,2,F-XC,36,12,6,2,4,21,15
20050908-W-US_Open-SF-Mary_Pierce-Elena_Dementieva,2,F-DTM,39,3,0,0,3,19,20
20050908-W-US_Open-SF-Mary_Pierce-Elena_Dementieva,2,F-DTL,10,2,1,0,1,8,2
20050908-W-US_Open-SF-Mary_Pierce-Elena_Dementieva,2,F-IO,17,10,4,1,5,8,9
20050908-W-US_Open-SF-Mary_Pierce-Elena_Dementieva,2,B-XC,26,4,1,1,2,14,12
20050908-W-US_Open-SF-Mary_Pierce-Elena_Dementieva,2,B-DTM,36,4,1,2,1,22,14
20050908-W-US_Open-SF-Mary_Pierce-Elena_Dementieva,2,B-DTL,6,3,3,0,0,4,2
20050908-W-US_Open-SF-Mary_Pierce-Elena_Dementieva,2,B-IO,4,1,0,0,1,3,1
20050908-W-US_Open-SF-Mary_Pierce-Elena_Dementieva,2,B-II,1,1,0,1,0,1,0
20050908-W-US_Open-SF-Mary_Pierce-Elena_Dementieva,2,S-XC,2,0,0,0,0,2,0
20050908-W-US_Open-SF-Mary_Pierce-Elena_Dementieva,2,S-DTM,3,1,0,1,0,1,2
20210830-W-US_Open-R128-Donna_Vekic-Garbine_Muguruza,1,F-XC,41,16,8,6,2,35,6
20210830-W-US_Open-R128-Donna_Vekic-Garbine_Muguruza,1,F-DTM,60,8,0,2,6,33,27
20210830-W-US_Open-R128-Donna_Vekic-Garbine_Muguruza,1,F-DTL,7,3,0,2,1,3,4
20210830-W-US_Open-R128-Donna_Vekic-Garbine_Muguruza,1,F-IO,25,11,7,2,2,17,8
20210830-W-US_Open-R128-Donna_Vekic-Garbine_Muguruza,1,F-II,1,1,0,0,1,0,1
20210830-W-US_Open-R128-Donna_Vekic-Garbine_Muguruza,1,B-XC,8,1,0,0,1,3,5
20210830-W-US_Open-R128-Donna_Vekic-Garbine_Muguruza,1,B-DTM,35,5,0,1,4,17,18
20210830-W-US_Open-R128-Donna_Vekic-Garbine_Muguruza,1,B-DTL,9,5,2,0,3,4,5
20210830-W-US_Open-R128-Donna_Vekic-Garbine_Muguruza,1,B-IO,12,5,1,1,3,6,6
20210830-W-US_Open-R128-Donna_Vekic-Garbine_Muguruza,1,B-II,1,0,0,0,0,0,1
20210830-W-US_Open-R128-Donna_Vekic-Garbine_Muguruza,1,S-DTM,1,0,0,0,0,1,0
20210830-W-US_Open-R128-Donna_Vekic-Garbine_Muguruza,2,F-XC,28,11,3,2,6,17,11
20210830-W-US_Open-R128-Donna_Vekic-Garbine_Muguruza,2,F-DTM,62,4,0,0,4,15,47
20210830-W-US_Open-R128-Donna_Vekic-Garbine_Muguruza,2,F-DTL,3,0,0,0,0,2,1
20210830-W-US_Open-R128-Donna_Vekic-Garbine_Muguruza,2,F-IO,21,11,2,6,3,12,9
20210830-W-US_Open-R128-Donna_Vekic-Garbine_Muguruza,2,B-XC,16,4,0,1,3,9,7
20210830-W-US_Open-R128-Donna_Vekic-Garbine_Muguruza,2,B-DTM,43,10,0,3,7,14,29
20210830-W-US_Open-R128-Donna_Vekic-Garbine_Muguruza,2,B-DTL,8,2,0,1,1,5,3
20210830-W-US_Open-R128-Donna_Vekic-Garbine_Muguruza,2,B-IO,14,5,2,1,2,9,5
20210830-W-US_Open-R128-Donna_Vekic-Garbine_Muguruza,2,S-DTM,1,0,0,0,0,0,1
20210916-W-Luxembourg-R16-Jelena_Ostapenko-Arianne_Hartono,1,F-XC,39,17,6,1,10,21,18
20210916-W-Luxembourg-R16-Jelena_Ostapenko-Arianne_Hartono,1,F-DTM,3,1,0,0,1,1,2
20210916-W-Luxembourg-R16-Jelena_Ostapenko-Arianne_Hartono,1,F-DTL,9,6,0,2,4,4,5
20210916-W-Luxembourg-R16-Jelena_Ostapenko-Arianne_Hartono,1,F-IO,5,4,2,1,1,3,2
20210916-W-Luxembourg-R16-Jelena_Ostapenko-Arianne_Hartono,1,B-XC,46,10,1,3,6,30,16
20210916-W-Luxembourg-R16-Jelena_Ostapenko-Arianne_Hartono,1,B-DTM,9,1,0,0,1,6,3
20210916-W-Luxembourg-R16-Jelena_Ostapenko-Arianne_Hartono,1,B-DTL,5,5,3,1,1,4,1
20210916-W-Luxembourg-R16-Jelena_Ostapenko-Arianne_Hartono,1,B-IO,3,1,1,0,0,3,0
20210916-W-Luxembourg-R16-Jelena_Ostapenko-Arianne_Hartono,1,S-XC,2,0,0,0,0,1,1
20210916-W-Luxembourg-R16-Jelena_Ostapenko-Arianne_Hartono,1,S-DTM,2,0,0,0,0,1,1
20210916-W-Luxembourg-R16-Jelena_Ostapenko-Arianne_Hartono,1,S-IO,1,1,0,0,1,0,1
20210916-W-Luxembourg-R16-Jelena_Ostapenko-Arianne_Hartono,2,F-XC,31,9,5,0,4,15,16
20210916-W-Luxembourg-R16-Jelena_Ostapenko-Arianne_Hartono,2,F-DTM,21,3,0,0,3,8,13
20210916-W-Luxembourg-R16-Jelena_Ostapenko-Arianne_Hartono,2,F-DTL,8,3,0,1,2,2,6
20210916-W-Luxembourg-R16-Jelena_Ostapenko-Arianne_Hartono,2,F-IO,5,3,2,0,1,3,2
20210916-W-Luxembourg-R16-Jelena_Ostapenko-Arianne_Hartono,2,F-II,1,1,0,0,1,0,1
20210916-W-Luxembourg-R16-Jelena_Ostapenko-Arianne_Hartono,2,B-XC,27,5,1,0,4,9,18
20210916-W-Luxembourg-R16-Jelena_Ostapenko-Arianne_Hartono,2,B-DTM,29,3,0,0,3,9,20
20210916-W-Luxembourg-R16-Jelena_Ostapenko-Arianne_Hartono,2,B-DTL,3,3,2,0,1,2,1
20210916-W-Luxembourg-R16-Jelena_Ostapenko-Arianne_Hartono,2,B-IO,2,1,1,0,0,2,0
20210916-W-Luxembourg-R16-Jelena_Ostapenko-Arianne_Hartono,2,S-XC,2,0,0,0,0,0,2
20210916-W-Luxembourg-R16-Jelena_Ostapenko-Arianne_Hartono,2,S-DTM,3,0,0,0,0,2,1
20210919-W-Portoroz-F-Jasmine_Paolini-Alison_Riske,1,F-XC,62,12,3,1,8,30,32
20210919-W-Portoroz-F-Jasmine_Paolini-Alison_Riske,1,F-DTM,47,4,0,0,4,28,19
20210919-W-Portoroz-F-Jasmine_Paolini-Alison_Riske,1,F-DTL,8,4,2,0,2,5,3
20210919-W-Portoroz-F-Jasmine_Paolini-Alison_Riske,1,F-IO,16,4,1,2,1,11,5
20210919-W-Portoroz-F-Jasmine_Paolini-Alison_Riske,1,F-II,2,0,0,0,0,1,1
20210919-W-Portoroz-F-Jasmine_Paolini-Alison_Riske,1,B-XC,67,10,2,1,7,42,25
20210919-W-Portoroz-F-Jasmine_Paolini-Alison_Riske,1,B-DTM,49,3,0,0,3,29,20
20210919-W-Portoroz-F-Jasmine_Paolini-Alison_Riske,1,B-DTL,4,3,1,0,2,2,2
20210919-W-Portoroz-F-Jasmine_Paolini-Alison_Riske,1,B-IO,3,2,1,0,1,2,1
20210919-W-Portoroz-F-Jasmine_Paolini-Alison_Riske,1,S-XC,1,0,0,0,0,1,0
20210919-W-Portoroz-F-Jasmine_Paolini-Alison_Riske,1,S-DTM,11,0,0,0,0,4,7
20210919-W-Portoroz-F-Jasmine_Paolini-Alison_Riske,2,F-XC,27,6,2,2,2,15,12
20210919-W-Portoroz-F-Jasmine_Paolini-Alison_Riske,2,F-DTM,42,1,0,0,1,16,26
20210919-W-Portoroz-F-Jasmine_Paolini-Alison_Riske,2,F-DTL,12,5,0,3,2,7,5
20210919-W-Portoroz-F-Jasmine_Paolini-Alison_Riske,2,F-IO,27,5,0,2,3,12,15
20210919-W-Portoroz-F-Jasmine_Paolini-Alison_Riske,2,B-XC,62,8,2,0,6,22,40
20210919-W-Portoroz-F-Jasmine_Paolini-Alison_Riske,2,B-DTM,60,8,0,1,7,18,42
20210919-W-Portoroz-F-Jasmine_Paolini-Alison_Riske,2,B-DTL,17,9,3,0,6,6,11
20210919-W-Portoroz-F-Jasmine_Paolini-Alison_Riske,2,B-IO,20,2,0,0,2,11,9
20210919-W-Portoroz-F-Jasmine_Paolini-Alison_Riske,2,S-DTM,1,0,0,0,0,0,1
20210831-W-US_Open-R128-Jil_Teichmann-Cristina_Bucsa,1,F-XC,17,7,2,1,4,8,9
20210831-W-US_Open-R128-Jil_Teichmann-Cristina_Bucsa,1,F-DTM,32,2,0,0,2,13,19
20210831-W-US_Open-R128-Jil_Teichmann-Cristina_Bucsa,1,F-DTL,1,0,0,0,0,1,0
20210831-W-US_Open-R128-Jil_Teichmann-Cristina_Bucsa,1,F-IO,32,3,0,0,3,12,20
20210831-W-US_Open-R128-Jil_Teichmann-Cristina_Bucsa,1,F-II,12,7,4,0,3,6,6
20210831-W-US_Open-R128-Jil_Teichmann-Cristina_Bucsa,1,B-XC,5,1,0,0,1,2,3
20210831-W-US_Open-R128-Jil_Teichmann-Cristina_Bucsa,1,B-DTM,35,4,0,1,3,12,23
20210831-W-US_Open-R128-Jil_Teichmann-Cristina_Bucsa,1,B-IO,22,8,1,3,4,11,11
20210831-W-US_Open-R128-Jil_Teichmann-Cristina_Bucsa,1,B-II,4,0,0,0,0,1,3
20210831-W-US_Open-R128-Jil_Teichmann-Cristina_Bucsa,1,S-XC,3,1,0,0,1,1,2
20210831-W-US_Open-R128-Jil_Teichmann-Cristina_Bucsa,1,S-DTM,14,0,0,0,0,5,9
20210831-W-US_Open-R128-Jil_Teichmann-Cristina_Bucsa,1,S-IO,10,2,0,1,1,7,3
20210831-W-US_Open-R128-Jil_Teichmann-Cristina_Bucsa,1,S-II,3,2,0,0,2,0,3
20210831-W-US_Open-R128-Jil_Teichmann-Cristina_Bucsa,2,F-XC,15,4,1,0,3,10,5
20210831-W-US_Open-R128-Jil_Teichmann-Cristina_Bucsa,2,F-DTM,24,4,0,0,4,10,14
20210831-W-US_Open-R128-Jil_Teichmann-Cristina_Bucsa,2,F-IO,53,10,2,2,6,33,20
20210831-W-US_Open-R128-Jil_Teichmann-Cristina_Bucsa,2,F-II,5,1,0,0,1,2,3
20210831-W-US_Open-R128-Jil_Teichmann-Cristina_Bucsa,2,B-XC,12,3,2,0,1,7,5
20210831-W-US_Open-R128-Jil_Teichmann-Cristina_Bucsa,2,B-DTM,38,3,0,0,3,21,17
20210831-W-US_Open-R128-Jil_Teichmann-Cristina_Bucsa,2,B-IO,19,4,1,1,2,8,11
20210831-W-US_Open-R128-Jil_Teichmann-Cristina_Bucsa,2,B-II,12,6,4,0,2,5,7
20210831-W-US_Open-R128-Jil_Teichmann-Cristina_Bucsa,2,S-DTM,3,0,0,0,0,1,2
20210831-W-US_Open-R128-Jil_Teichmann-Cristina_Bucsa,2,S-IO,2,0,0,0,0,1,1
20210901-W-US_Open-R64-Leylah_Annie_Fernandez-Kaia_Kanepi,1,F-XC,28,10,3,2,5,14,14
20210901-W-US_Open-R64-Leylah_Annie_Fernandez-Kaia_Kanepi,1,F-DTM,35,2,0,0,2,19,16
20210901-W-US_Open-R64-Leylah_Annie_Fernandez-Kaia_Kanepi,1,F-DTL,10,5,0,1,4,3,7
20210901-W-US_Open-R64-Leylah_Annie_Fernandez-Kaia_Kanepi,1,F-IO,23,12,7,3,2,16,7
20210901-W-US_Open-R64-Leylah_Annie_Fernandez-Kaia_Kanepi,1,F-II,4,1,0,1,0,2,2
20210901-W-US_Open-R64-Leylah_Annie_Fernandez-Kaia_Kanepi,1,B-XC,36,13,4,6,3,25,11
20210901-W-US_Open-R64-Leylah_Annie_Fernandez-Kaia_Kanepi,1,B-DTM,19,1,0,0,1,11,8
20210901-W-US_Open-R64-Leylah_Annie_Fernandez-Kaia_Kanepi,1,B-DTL,8,4,1,1,2,3,5
20210901-W-US_Open-R64-Leylah_Annie_Fernandez-Kaia_Kanepi,1,B-IO,6,1,0,0,1,4,2
20210901-W-US_Open-R64-Leylah_Annie_Fernandez-Kaia_Kanepi,1,S-XC,3,0,0,0,0,1,2
20210901-W-US_Open-R64-Leylah_Annie_Fernandez-Kaia_Kanepi,1,S-DTM,3,0,0,0,0,1,2
20210901-W-US_Open-R64-Leylah_Annie_Fernandez-Kaia_Kanepi,1,S-DTL,2,0,0,0,0,0,2
20210901-W-US_Open-R64-Leylah_Annie_Fernandez-Kaia_Kanepi,2,F-XC,39,13,4,4,5,20,19
20210901-W-US_Open-R64-Leylah_Annie_Fernandez-Kaia_Kanepi,2,F-DTM,35,5,0,0,5,12,23
20210901-W-US_Open-R64-Leylah_Annie_Fernandez-Kaia_Kanepi,2,F-DTL,9,6,2,1,3,5,4
20210901-W-US_Open-R64-Leylah_Annie_Fernandez-Kaia_Kanepi,2,F-IO,18,11,6,0,5,9,9
20210901-W-US_Open-R64-Leylah_Annie_Fernandez-Kaia_Kanepi,2,B-XC,27,9,5,0,4,17,10
20210901-W-US_Open-R64-Leylah_Annie_Fernandez-Kaia_Kanepi,2,B-DTM,34,6,1,1,4,13,21
20210901-W-US_Open-R64-Leylah_Annie_Fernandez-Kaia_Kanepi,2,B-DTL,13,6,0,3,3,9,4
20210901-W-US_Open-R64-Leylah_Annie_Fernandez-Kaia_Kanepi,2,B-IO,8,4,2,0,2,4,4
20210901-W-US_Open-R64-Leylah_Annie_Fernandez-Kaia_Kanepi,2,S-XC,2,0,0,0,0,1,1
20210901-W-US_Open-R64-Leylah_Annie_Fernandez-Kaia_Kanepi,2,S-DTM,2,0,0,0,0,0,2
20210901-W-US_Open-R64-Leylah_Annie_Fernandez-Kaia_Kanepi,2,S-DTL,1,0,0,0,0,0,1
20210901-W-US_Open-R64-Leylah_Annie_Fernandez-Kaia_Kanepi,2,S-IO,2,0,0,0,0,0,2
20210904-W-US_Open-R32-Karolina_Pliskova-Ajla_Tomljanovic,1,F-XC,24,9,1,2,6,13,11
20210904-W-US_Open-R32-Karolina_Pliskova-Ajla_Tomljanovic,1,F-DTM,12,2,0,0,2,7,5
20210904-W-US_Open-R32-Karolina_Pliskova-Ajla_Tomljanovic,1,F-DTL,3,1,1,0,0,2,1
20210904-W-US_Open-R32-Karolina_Pliskova-Ajla_Tomljanovic,1,F-IO,15,5,4,0,1,9,6
20210904-W-US_Open-R32-Karolina_Pliskova-Ajla_Tomljanovic,1,F-II,1,0,0,0,0,0,1
20210904-W-US_Open-R32-Karolina_Pliskova-Ajla_Tomljanovic,1,B-XC,8,3,0,1,2,4,4
20210904-W-US_Open-R32-Karolina_Pliskova-Ajla_Tomljanovic,1,B-DTM,16,5,0,0,5,3,13
20210904-W-US_Open-R32-Karolina_Pliskova-Ajla_Tomljanovic,1,B-DTL,7,0,0,0,0,3,4
20210904-W-US_Open-R32-Karolina_Pliskova-Ajla_Tomljanovic,1,B-IO,11,4,1,1,2,5,6
20210904-W-US_Open-R32-Karolina_Pliskova-Ajla_Tomljanovic,1,S-XC,6,1,0,1,0,2,4
20210904-W-US_Open-R32-Karolina_Pliskova-Ajla_Tomljanovic,1,S-DTM,2,0,0,0,0,1,1
20210904-W-US_Open-R32-Karolina_Pliskova-Ajla_Tomljanovic,1,S-DTL,1,0,0,0,0,0,1
20210904-W-US_Open-R32-Karolina_Pliskova-Ajla_Tomljanovic,2,F-XC,18,4,0,1,3,8,10
20210904-W-US_Open-R32-Karolina_Pliskova-Ajla_Tomljanovic,2,F-DTM,25,5,0,1,4,12,13
20210904-W-US_Open-R32-Karolina_Pliskova-Ajla_Tomljanovic,2,F-DTL,8,3,0,2,1,4,4
20210904-W-US_Open-R32-Karolina_Pliskova-Ajla_Tomljanovic,2,F-IO,11,5,1,0,4,6,5
20210904-W-US_Open-R32-Karolina_Pliskova-Ajla_Tomljanovic,2,B-XC,14,3,2,0,1,9,5
20210904-W-US_Open-R32-Karolina_Pliskova-Ajla_Tomljanovic,2,B-DTM,14,0,0,0,0,7,7
20210904-W-US_Open-R32-Karolina_Pliskova-Ajla_Tomljanovic,2,B-DTL,1,1,1,0,0,1,0
20210904-W-US_Open-R32-Karolina_Pliskova-Ajla_Tomljanovic,2,B-IO,5,1,1,0,0,3,2
20210904-W-US_Open-R32-Karolina_Pliskova-Ajla_Tomljanovic,2,S-XC,2,0,0,0,0,1,1
20210904-W-US_Open-R32-Karolina_Pliskova-Ajla_Tomljanovic,2,S-DTM,5,0,0,0,0,3,2
20210902-W-US_Open-R64-Maria_Sakkari-Katerina_Siniakova,1,F-XC,14,6,3,1,2,9,5
20210902-W-US_Open-R64-Maria_Sakkari-Katerina_Siniakova,1,F-DTM,23,2,0,0,2,12,11
20210902-W-US_Open-R64-Maria_Sakkari-Katerina_Siniakova,1,F-DTL,10,4,1,0,3,3,7
20210902-W-US_Open-R64-Maria_Sakkari-Katerina_Siniakova,1,F-IO,18,8,2,2,4,11,7
20210902-W-US_Open-R64-Maria_Sakkari-Katerina_Siniakova,1,B-XC,18,5,1,1,3,10,8
20210902-W-US_Open-R64-Maria_Sakkari-Katerina_Siniakova,1,B-DTM,27,5,0,1,4,13,14
20210902-W-US_Open-R64-Maria_Sakkari-Katerina_Siniakova,1,B-DTL,3,1,0,0,1,0,3
20210902-W-US_Open-R64-Maria_Sakkari-Katerina_Siniakova,1,B-IO,1,1,0,1,0,1,0
20210902-W-US_Open-R64-Maria_Sakkari-Katerina_Siniakova,1,S-XC,1,0,0,0,0,1,0
20210902-W-US_Open-R64-Maria_Sakkari-Katerina_Siniakova,1,S-DTM,2,0,0,0,0,1,1
20210902-W-US_Open-R64-Maria_Sakkari-Katerina_Siniakova,1,S-DTL,1,1,0,1,0,1,0
20210902-W-US_Open-R64-Maria_Sakkari-Katerina_Siniakova,1,S-IO,1,0,0,0,0,1,0
20210902-W-US_Open-R64-Maria_Sakkari-Katerina_Siniakova,2,F-XC,16,4,1,1,2,8,8
20210902-W-US_Open-R64-Maria_Sakkari-Katerina_Siniakova,2,F-DTM,27,6,0,1,5,10,17
20210902-W-US_Open-R64-Maria_Sakkari-Katerina_Siniakova,2,F-DTL,3,2,0,0,2,1,2
20210902-W-US_Open-R64-Maria_Sakkari-Katerina_Siniakova,2,F-IO,10,3,1,1,1,5,5
20210902-W-US_Open-R64-Maria_Sakkari-Katerina_Siniakova,2,B-XC,28,8,1,2,5,17,11
20210902-W-US_Open-R64-Maria_Sakkari-Katerina_Siniakova,2,B-DTM,30,6,0,1,5,10,20
20210902-W-US_Open-R64-Maria_Sakkari-Katerina_Siniakova,2,B-DTL,4,2,0,0,2,1,3
20210902-W-US_Open-R64-Maria_Sakkari-Katerina_Siniakova,2,B-IO,10,6,2,1,3,6,4
20210902-W-US_Open-R64-Maria_Sakkari-Katerina_Siniakova,2,S-XC,1,1,0,1,0,1,0
20210902-W-US_Open-R64-Maria_Sakkari-Katerina_Siniakova,2,S-DTM,2,0,0,0,0,0,2
20210902-W-US_Open-R64-Maria_Sakkari-Katerina_Siniakova,2,S-DTL,3,0,0,0,0,1,2
20210902-W-US_Open-R64-Maria_Sakkari-Katerina_Siniakova,2,S-IO,1,0,0,0,0,1,0
20210816-W-Cincinnati-R64-Paula_Badosa-Petra_Martic,1,F-XC,59,15,6,3,6,35,24
20210816-W-Cincinnati-R64-Paula_Badosa-Petra_Martic,1,F-DTM,56,2,0,0,2,31,25
20210816-W-Cincinnati-R64-Paula_Badosa-Petra_Martic,1,F-DTL,13,6,2,0,4,7,6
20210816-W-Cincinnati-R64-Paula_Badosa-Petra_Martic,1,F-IO,44,13,8,2,3,29,15
20210816-W-Cincinnati-R64-Paula_Badosa-Petra_Martic,1,F-II,3,0,0,0,0,3,0
20210816-W-Cincinnati-R64-Paula_Badosa-Petra_Martic,1,B-XC,83,7,2,2,3,52,31
20210816-W-Cincinnati-R64-Paula_Badosa-Petra_Martic,1,B-DTM,69,3,0,0,3,33,36
20210816-W-Cincinnati-R64-Paula_Badosa-Petra_Martic,1,B-DTL,21,14,7,2,5,14,7
20210816-W-Cincinnati-R64-Paula_Badosa-Petra_Martic,1,B-IO,10,5,5,0,0,9,1
20210816-W-Cincinnati-R64-Paula_Badosa-Petra_Martic,1,S-XC,4,0,0,0,0,4,0
20210816-W-Cincinnati-R64-Paula_Badosa-Petra_Martic,1,S-DTM,5,0,0,0,0,0,5
20210816-W-Cincinnati-R64-Paula_Badosa-Petra_Martic,1,S-DTL,1,0,0,0,0,1,0
20210816-W-Cincinnati-R64-Paula_Badosa-Petra_Martic,2,F-XC,62,12,4,0,8,34,28
20210816-W-Cincinnati-R64-Paula_Badosa-Petra_Martic,2,F-DTM,52,3,1,0,2,22,30
20210816-W-Cincinnati-R64-Paula_Badosa-Petra_Martic,2,F-DTL,12,3,0,1,2,3,9
20210816-W-Cincinnati-R64-Paula_Badosa-Petra_Martic,2,F-IO,54,11,2,2,7,27,27
20210816-W-Cincinnati-R64-Paula_Badosa-Petra_Martic,2,F-II,8,2,1,0,1,4,4
20210816-W-Cincinnati-R64-Paula_Badosa-Petra_Martic,2,B-XC,58,9,1,0,8,22,36
20210816-W-Cincinnati-R64-Paula_Badosa-Petra_Martic,2,B-DTM,45,3,0,1,2,18,27
20210816-W-Cincinnati-R64-Paula_Badosa-Petra_Martic,2,S-XC,40,1,0,0,1,14,26
20210816-W-Cincinnati-R64-Paula_Badosa-Petra_Martic,2,S-DTM,23,0,0,0,0,6,17
20210816-W-Cincinnati-R64-Paula_Badosa-Petra_Martic,2,S-DTL,1,0,0,0,0,0,1
20210725-W-Olympics-R64-Elina_Svitolina-Laura_Siegemund,1,F-XC,58,20,9,4,6,35,23
20210725-W-Olympics-R64-Elina_Svitolina-Laura_Siegemund,1,F-DTM,32,1,0,0,1,17,15
20210725-W-Olympics-R64-Elina_Svitolina-Laura_Siegemund,1,F-DTL,19,9,3,3,3,13,6
20210725-W-Olympics-R64-Elina_Svitolina-Laura_Siegemund,1,F-IO,35,17,6,2,9,21,14
20210725-W-Olympics-R64-Elina_Svitolina-Laura_Siegemund,1,F-II,4,3,3,0,0,3,1
20210725-W-Olympics-R64-Elina_Svitolina-Laura_Siegemund,1,B-XC,45,9,4,1,4,22,23
20210725-W-Olympics-R64-Elina_Svitolina-Laura_Siegemund,1,B-DTM,30,1,1,0,0,16,14
20210725-W-Olympics-R64-Elina_Svitolina-Laura_Siegemund,1,B-DTL,7,4,0,1,3,3,4
20210725-W-Olympics-R64-Elina_Svitolina-Laura_Siegemund,1,B-IO,2,1,1,0,0,1,1
20210725-W-Olympics-R64-Elina_Svitolina-Laura_Siegemund,1,S-XC,6,0,0,0,0,3,3
20210725-W-Olympics-R64-Elina_Svitolina-Laura_Siegemund,1,S-DTM,4,0,0,0,0,2,2
20210725-W-Olympics-R64-Elina_Svitolina-Laura_Siegemund,2,F-XC,40,10,5,4,1,23,17
20210725-W-Olympics-R64-Elina_Svitolina-Laura_Siegemund,2,F-DTM,24,5,0,1,4,10,14
20210725-W-Olympics-R64-Elina_Svitolina-Laura_Siegemund,2,F-DTL,15,9,6,1,2,10,5
20210725-W-Olympics-R64-Elina_Svitolina-Laura_Siegemund,2,F-IO,20,12,6,4,2,13,7
20210725-W-Olympics-R64-Elina_Svitolina-Laura_Siegemund,2,B-XC,34,8,1,2,5,17,17
20210725-W-Olympics-R64-Elina_Svitolina-Laura_Siegemund,2,B-DTM,26,2,0,0,2,7,19
20210725-W-Olympics-R64-Elina_Svitolina-Laura_Siegemund,2,B-DTL,12,4,3,0,1,6,6
20210725-W-Olympics-R64-Elina_Svitolina-Laura_Siegemund,2,B-IO,16,7,2,0,5,6,10
20210725-W-Olympics-R64-Elina_Svitolina-Laura_Siegemund,2,S-XC,15,3,0,1,2,8,7
20210725-W-Olympics-R64-Elina_Svitolina-Laura_Siegemund,2,S-DTM,12,1,0,0,1,3,9
20210725-W-Olympics-R64-Elina_Svitolina-Laura_Siegemund,2,S-DTL,5,1,0,0,1,0,5
20210725-W-Olympics-R64-Elina_Svitolina-Laura_Siegemund,2,S-IO,3,1,0,0,1,1,2
20210727-W-Olympics-R16-Elina_Svitolina-Maria_Sakkari,1,F-XC,58,12,4,2,6,25,33
20210727-W-Olympics-R16-Elina_Svitolina-Maria_Sakkari,1,F-DTM,71,7,0,0,7,24,47
20210727-W-Olympics-R16-Elina_Svitolina-Maria_Sakkari,1,F-DTL,3,0,0,0,0,1,2
20210727-W-Olympics-R16-Elina_Svitolina-Maria_Sakkari,1,F-IO,22,6,5,0,1,11,11
20210727-W-Olympics-R16-Elina_Svitolina-Maria_Sakkari,1,B-XC,60,10,3,3,4,38,22
20210727-W-Olympics-R16-Elina_Svitolina-Maria_Sakkari,1,B-DTM,36,2,0,0,2,16,20
20210727-W-Olympics-R16-Elina_Svitolina-Maria_Sakkari,1,B-DTL,10,5,1,2,2,5,5
20210727-W-Olympics-R16-Elina_Svitolina-Maria_Sakkari,1,B-IO,13,4,0,2,2,6,7
20210727-W-Olympics-R16-Elina_Svitolina-Maria_Sakkari,1,S-XC,13,1,0,0,1,5,8
20210727-W-Olympics-R16-Elina_Svitolina-Maria_Sakkari,1,S-DTM,13,0,0,0,0,5,8
20210727-W-Olympics-R16-Elina_Svitolina-Maria_Sakkari,1,S-DTL,3,2,1,1,0,2,1
20210727-W-Olympics-R16-Elina_Svitolina-Maria_Sakkari,1,S-IO,1,0,0,0,0,0,1
20210727-W-Olympics-R16-Elina_Svitolina-Maria_Sakkari,2,F-XC,67,16,8,1,7,33,34
20210727-W-Olympics-R16-Elina_Svitolina-Maria_Sakkari,2,F-DTM,56,6,2,1,3,40,16
20210727-W-Olympics-R16-Elina_Svitolina-Maria_Sakkari,2,F-DTL,15,4,1,0,3,3,12
20210727-W-Olympics-R16-Elina_Svitolina-Maria_Sakkari,2,F-IO,22,8,5,0,3,11,11
20210727-W-Olympics-R16-Elina_Svitolina-Maria_Sakkari,2,F-II,1,1,0,1,0,1,0
20210727-W-Olympics-R16-Elina_Svitolina-Maria_Sakkari,2,B-XC,78,19,6,4,9,44,34
20210727-W-Olympics-R16-Elina_Svitolina-Maria_Sakkari,2,B-DTM,40,2,0,0,2,22,18
20210727-W-Olympics-R16-Elina_Svitolina-Maria_Sakkari,2,B-DTL,7,5,0,0,5,1,6
20210727-W-Olympics-R16-Elina_Svitolina-Maria_Sakkari,2,B-IO,8,5,2,1,2,4,4
20210727-W-Olympics-R16-Elina_Svitolina-Maria_Sakkari,2,S-XC,10,0,0,0,0,5,5
20210727-W-Olympics-R16-Elina_Svitolina-Maria_Sakkari,2,S-DTM,4,1,0,0,1,0,4
20210727-W-Olympics-R16-Elina_Svitolina-Maria_Sakkari,2,S-DTL,3,2,1,1,0,2,1
20210925-W-Ostrava-SF-Petra_Kvitova-Anett_Kontaveit,1,F-XC,17,9,1,1,7,3,14
20210925-W-Ostrava-SF-Petra_Kvitova-Anett_Kontaveit,1,F-DTM,14,1,0,0,1,4,10
20210925-W-Ostrava-SF-Petra_Kvitova-Anett_Kontaveit,1,F-DTL,2,2,0,0,2,0,2
20210925-W-Ostrava-SF-Petra_Kvitova-Anett_Kontaveit,1,F-IO,5,3,1,1,1,3,2
20210925-W-Ostrava-SF-Petra_Kvitova-Anett_Kontaveit,1,B-XC,22,11,1,4,6,6,16
20210925-W-Ostrava-SF-Petra_Kvitova-Anett_Kontaveit,1,B-DTM,9,2,0,0,2,2,7
20210925-W-Ostrava-SF-Petra_Kvitova-Anett_Kontaveit,1,B-DTL,5,2,0,0,2,3,2
20210925-W-Ostrava-SF-Petra_Kvitova-Anett_Kontaveit,1,B-IO,4,4,3,0,1,3,1
20210925-W-Ostrava-SF-Petra_Kvitova-Anett_Kontaveit,1,S-XC,2,0,0,0,0,0,2
20210925-W-Ostrava-SF-Petra_Kvitova-Anett_Kontaveit,1,S-DTM,2,0,0,0,0,1,1
20210925-W-Ostrava-SF-Petra_Kvitova-Anett_Kontaveit,1,S-DTL,1,0,0,0,0,0,1
20210925-W-Ostrava-SF-Petra_Kvitova-Anett_Kontaveit,2,F-XC,24,4,0,1,3,17,7
20210925-W-Ostrava-SF-Petra_Kvitova-Anett_Kontaveit,2,F-DTM,8,0,0,0,0,6,2
20210925-W-Ostrava-SF-Petra_Kvitova-Anett_Kontaveit,2,F-DTL,3,3,2,1,0,3,0
20210925-W-Ostrava-SF-Petra_Kvitova-Anett_Kontaveit,2,F-IO,3,1,1,0,0,2,1
20210925-W-Ostrava-SF-Petra_Kvitova-Anett_Kontaveit,2,B-XC,16,6,3,0,2,11,5
20210925-W-Ostrava-SF-Petra_Kvitova-Anett_Kontaveit,2,B-DTM,6,1,0,0,1,2,4
20210925-W-Ostrava-SF-Petra_Kvitova-Anett_Kontaveit,2,B-DTL,6,3,2,1,0,5,1
20210925-W-Ostrava-SF-Petra_Kvitova-Anett_Kontaveit,2,B-IO,3,3,2,1,0,3,0
20210925-W-Ostrava-SF-Petra_Kvitova-Anett_Kontaveit,2,S-DTM,1,0,0,0,0,1,0
20210728-W-Olympics-QF-Camila_Giorgi-Elina_Svitolina,1,F-XC,38,7,3,0,4,19,19
20210728-W-Olympics-QF-Camila_Giorgi-Elina_Svitolina,1,F-DTM,16,0,0,0,0,8,8
20210728-W-Olympics-QF-Camila_Giorgi-Elina_Svitolina,1,F-DTL,2,1,0,1,0,1,1
20210728-W-Olympics-QF-Camila_Giorgi-Elina_Svitolina,1,F-IO,9,6,3,0,3,5,4
20210728-W-Olympics-QF-Camila_Giorgi-Elina_Svitolina,1,B-XC,37,11,2,1,8,12,25
20210728-W-Olympics-QF-Camila_Giorgi-Elina_Svitolina,1,B-DTM,25,7,1,1,5,10,15
20210728-W-Olympics-QF-Camila_Giorgi-Elina_Svitolina,1,B-DTL,6,4,3,0,1,4,2
20210728-W-Olympics-QF-Camila_Giorgi-Elina_Svitolina,1,B-IO,9,3,1,0,2,3,6
20210728-W-Olympics-QF-Camila_Giorgi-Elina_Svitolina,1,S-XC,1,0,0,0,0,1,0
20210728-W-Olympics-QF-Camila_Giorgi-Elina_Svitolina,1,S-DTM,1,0,0,0,0,0,1
20210728-W-Olympics-QF-Camila_Giorgi-Elina_Svitolina,2,F-XC,23,9,0,6,3,13,10
20210728-W-Olympics-QF-Camila_Giorgi-Elina_Svitolina,2,F-DTM,23,3,0,1,2,15,8
20210728-W-Olympics-QF-Camila_Giorgi-Elina_Svitolina,2,F-DTL,11,3,2,0,1,6,5
20210728-W-Olympics-QF-Camila_Giorgi-Elina_Svitolina,2,F-IO,10,6,2,0,4,4,6
20210728-W-Olympics-QF-Camila_Giorgi-Elina_Svitolina,2,B-XC,17,4,0,2,2,12,5
20210728-W-Olympics-QF-Camila_Giorgi-Elina_Svitolina,2,B-DTM,29,4,0,0,4,13,16
20210728-W-Olympics-QF-Camila_Giorgi-Elina_Svitolina,2,B-DTL,4,1,0,1,0,4,0
20210728-W-Olympics-QF-Camila_Giorgi-Elina_Svitolina,2,B-IO,1,0,0,0,0,1,0
20210728-W-Olympics-QF-Camila_Giorgi-Elina_Svitolina,2,S-XC,1,0,0,0,0,1,0
20210728-W-Olympics-QF-Camila_Giorgi-Elina_Svitolina,2,S-DTM,2,0,0,0,0,0,2
20210731-W-Olympics-BR-Elena_Rybakina-Elina_Svitolina,1,F-XC,102,28,7,5,16,47,55
20210731-W-Olympics-BR-Elena_Rybakina-Elina_Svitolina,1,F-DTM,22,4,0,0,4,11,11
20210731-W-Olympics-BR-Elena_Rybakina-Elina_Svitolina,1,F-DTL,22,13,6,2,5,13,9
20210731-W-Olympics-BR-Elena_Rybakina-Elina_Svitolina,1,F-IO,29,11,5,4,2,15,14
20210731-W-Olympics-BR-Elena_Rybakina-Elina_Svitolina,1,B-XC,46,12,4,2,6,30,16
20210731-W-Olympics-BR-Elena_Rybakina-Elina_Svitolina,1,B-DTM,30,2,0,0,2,11,19
20210731-W-Olympics-BR-Elena_Rybakina-Elina_Svitolina,1,B-DTL,17,12,7,0,5,10,7
20210731-W-Olympics-BR-Elena_Rybakina-Elina_Svitolina,1,B-IO,16,9,6,1,2,10,6
20210731-W-Olympics-BR-Elena_Rybakina-Elina_Svitolina,1,S-XC,2,0,0,0,0,1,1
20210731-W-Olympics-BR-Elena_Rybakina-Elina_Svitolina,1,S-DTM,2,0,0,0,0,1,1
20210731-W-Olympics-BR-Elena_Rybakina-Elina_Svitolina,2,F-XC,54,8,1,3,4,26,28
20210731-W-Olympics-BR-Elena_Rybakina-Elina_Svitolina,2,F-DTM,45,4,1,0,3,24,21
20210731-W-Olympics-BR-Elena_Rybakina-Elina_Svitolina,2,F-DTL,5,3,3,0,0,4,1
20210731-W-Olympics-BR-Elena_Rybakina-Elina_Svitolina,2,F-IO,16,5,4,1,0,14,2
20210731-W-Olympics-BR-Elena_Rybakina-Elina_Svitolina,2,F-II,2,2,0,0,2,0,2
20210731-W-Olympics-BR-Elena_Rybakina-Elina_Svitolina,2,B-XC,51,11,5,2,4,24,27
20210731-W-Olympics-BR-Elena_Rybakina-Elina_Svitolina,2,B-DTM,44,6,0,0,6,18,26
20210731-W-Olympics-BR-Elena_Rybakina-Elina_Svitolina,2,B-DTL,5,2,1,0,1,2,3
20210731-W-Olympics-BR-Elena_Rybakina-Elina_Svitolina,2,B-IO,2,1,0,1,0,2,0
20210731-W-Olympics-BR-Elena_Rybakina-Elina_Svitolina,2,S-XC,3,0,0,0,0,1,2
20210731-W-Olympics-BR-Elena_Rybakina-Elina_Svitolina,2,S-DTM,4,0,0,0,0,2,2
20210731-W-Olympics-BR-Elena_Rybakina-Elina_Svitolina,2,S-DTL,2,0,0,0,0,1,1
20210926-W-Ostrava-F-Anett_Kontaveit-Maria_Sakkari,1,F-XC,45,15,5,7,3,28,17
20210926-W-Ostrava-F-Anett_Kontaveit-Maria_Sakkari,1,F-DTM,13,0,0,0,0,11,2
20210926-W-Ostrava-F-Anett_Kontaveit-Maria_Sakkari,1,F-DTL,14,5,4,0,1,10,4
20210926-W-Ostrava-F-Anett_Kontaveit-Maria_Sakkari,1,F-IO,16,4,3,0,1,13,3
20210926-W-Ostrava-F-Anett_Kontaveit-Maria_Sakkari,1,F-II,2,0,0,0,0,2,0
20210926-W-Ostrava-F-Anett_Kontaveit-Maria_Sakkari,1,B-XC,51,15,5,3,7,31,20
20210926-W-Ostrava-F-Anett_Kontaveit-Maria_Sakkari,1,B-DTM,18,1,0,0,1,9,9
20210926-W-Ostrava-F-Anett_Kontaveit-Maria_Sakkari,1,B-DTL,13,8,2,2,4,5,8
20210926-W-Ostrava-F-Anett_Kontaveit-Maria_Sakkari,1,B-IO,5,2,0,0,2,2,3
20210926-W-Ostrava-F-Anett_Kontaveit-Maria_Sakkari,1,S-XC,4,1,0,0,1,1,3
20210926-W-Ostrava-F-Anett_Kontaveit-Maria_Sakkari,1,S-DTM,2,0,0,0,0,1,1
20210926-W-Ostrava-F-Anett_Kontaveit-Maria_Sakkari,2,F-XC,32,11,5,2,4,14,18
20210926-W-Ostrava-F-Anett_Kontaveit-Maria_Sakkari,2,F-DTM,27,0,0,0,0,10,17
20210926-W-Ostrava-F-Anett_Kontaveit-Maria_Sakkari,2,F-DTL,8,3,2,0,1,5,3
20210926-W-Ostrava-F-Anett_Kontaveit-Maria_Sakkari,2,F-IO,10,3,2,0,1,4,6
20210926-W-Ostrava-F-Anett_Kontaveit-Maria_Sakkari,2,F-II,2,1,1,0,0,1,1
20210926-W-Ostrava-F-Anett_Kontaveit-Maria_Sakkari,2,B-XC,46,5,0,0,5,16,30
20210926-W-Ostrava-F-Anett_Kontaveit-Maria_Sakkari,2,B-DTM,21,2,0,0,2,4,17
20210926-W-Ostrava-F-Anett_Kontaveit-Maria_Sakkari,2,B-DTL,13,7,3,2,2,9,4
20210926-W-Ostrava-F-Anett_Kontaveit-Maria_Sakkari,2,B-IO,5,1,0,1,0,4,1
20210926-W-Ostrava-F-Anett_Kontaveit-Maria_Sakkari,2,S-XC,7,0,0,0,0,5,2
20210926-W-Ostrava-F-Anett_Kontaveit-Maria_Sakkari,2,S-DTM,1,0,0,0,0,0,1
20210926-W-Ostrava-F-Anett_Kontaveit-Maria_Sakkari,2,S-DTL,3,1,0,1,0,1,2
19880929-W-Olympics-SF-Steffi_Graf-Zina_Garrison,1,F-XC,19,5,1,2,2,10,9
19880929-W-Olympics-SF-Steffi_Graf-Zina_Garrison,1,F-DTM,7,0,0,0,0,5,2
19880929-W-Olympics-SF-Steffi_Graf-Zina_Garrison,1,F-DTL,5,1,1,0,0,4,1
19880929-W-Olympics-SF-Steffi_Graf-Zina_Garrison,1,F-IO,10,4,1,1,2,4,6
19880929-W-Olympics-SF-Steffi_Graf-Zina_Garrison,1,F-II,4,1,0,1,0,3,1
19880929-W-Olympics-SF-Steffi_Graf-Zina_Garrison,1,B-XC,5,0,0,0,0,4,1
19880929-W-Olympics-SF-Steffi_Graf-Zina_Garrison,1,B-DTM,2,0,0,0,0,2,0
19880929-W-Olympics-SF-Steffi_Graf-Zina_Garrison,1,B-DTL,3,2,2,0,0,2,1
19880929-W-Olympics-SF-Steffi_Graf-Zina_Garrison,1,S-XC,26,4,1,2,1,18,8
19880929-W-Olympics-SF-Steffi_Graf-Zina_Garrison,1,S-DTM,3,0,0,0,0,2,1
19880929-W-Olympics-SF-Steffi_Graf-Zina_Garrison,1,S-DTL,18,2,1,0,1,13,5
19880929-W-Olympics-SF-Steffi_Graf-Zina_Garrison,1,S-IO,1,0,0,0,0,0,1
19880929-W-Olympics-SF-Steffi_Graf-Zina_Garrison,2,F-XC,16,2,0,1,1,6,10
19880929-W-Olympics-SF-Steffi_Graf-Zina_Garrison,2,F-DTM,6,1,0,0,1,4,2
19880929-W-Olympics-SF-Steffi_Graf-Zina_Garrison,2,F-DTL,9,0,0,0,0,1,8
19880929-W-Olympics-SF-Steffi_Graf-Zina_Garrison,2,F-IO,6,0,0,0,0,2,4
19880929-W-Olympics-SF-Steffi_Graf-Zina_Garrison,2,B-XC,3,1,0,0,1,0,3
19880929-W-Olympics-SF-Steffi_Graf-Zina_Garrison,2,S-XC,24,1,0,0,1,9,15
19880929-W-Olympics-SF-Steffi_Graf-Zina_Garrison,2,S-DTM,7,0,0,0,0,5,2
19880929-W-Olympics-SF-Steffi_Graf-Zina_Garrison,2,S-DTL,7,2,0,0,2,1,6
19880929-W-Olympics-SF-Steffi_Graf-Zina_Garrison,2,S-IO,1,0,0,0,0,0,1
20210927-W-Chicago-R64-Kim_Clijsters-Su_Wei_Hsieh,1,F-XC,80,29,6,5,18,40,40
20210927-W-Chicago-R64-Kim_Clijsters-Su_Wei_Hsieh,1,F-DTM,20,2,0,0,2,9,11
20210927-W-Chicago-R64-Kim_Clijsters-Su_Wei_Hsieh,1,F-DTL,14,9,6,0,3,10,4
20210927-W-Chicago-R64-Kim_Clijsters-Su_Wei_Hsieh,1,F-IO,21,12,6,1,5,12,9
20210927-W-Chicago-R64-Kim_Clijsters-Su_Wei_Hsieh,1,F-II,1,1,1,0,0,1,0
20210927-W-Chicago-R64-Kim_Clijsters-Su_Wei_Hsieh,1,B-XC,50,10,3,1,6,25,25
20210927-W-Chicago-R64-Kim_Clijsters-Su_Wei_Hsieh,1,B-DTM,19,1,0,0,1,14,5
20210927-W-Chicago-R64-Kim_Clijsters-Su_Wei_Hsieh,1,B-DTL,12,10,3,2,5,5,7
20210927-W-Chicago-R64-Kim_Clijsters-Su_Wei_Hsieh,1,B-IO,11,4,1,1,2,5,6
20210927-W-Chicago-R64-Kim_Clijsters-Su_Wei_Hsieh,1,S-XC,6,1,0,1,0,1,5
20210927-W-Chicago-R64-Kim_Clijsters-Su_Wei_Hsieh,1,S-DTM,3,2,0,1,1,1,2
20210927-W-Chicago-R64-Kim_Clijsters-Su_Wei_Hsieh,1,S-DTL,4,1,0,1,0,2,2
20210927-W-Chicago-R64-Kim_Clijsters-Su_Wei_Hsieh,2,F-XC,39,10,1,4,5,24,15
20210927-W-Chicago-R64-Kim_Clijsters-Su_Wei_Hsieh,2,F-DTM,24,0,0,0,0,10,14
20210927-W-Chicago-R64-Kim_Clijsters-Su_Wei_Hsieh,2,F-DTL,6,5,0,3,2,4,2
20210927-W-Chicago-R64-Kim_Clijsters-Su_Wei_Hsieh,2,F-IO,10,3,1,1,1,8,2
20210927-W-Chicago-R64-Kim_Clijsters-Su_Wei_Hsieh,2,B-XC,50,4,1,1,2,22,28
20210927-W-Chicago-R64-Kim_Clijsters-Su_Wei_Hsieh,2,B-DTM,28,4,1,1,2,11,17
20210927-W-Chicago-R64-Kim_Clijsters-Su_Wei_Hsieh,2,B-DTL,10,3,0,2,1,7,3
20210927-W-Chicago-R64-Kim_Clijsters-Su_Wei_Hsieh,2,B-IO,3,1,1,0,0,1,2
20210927-W-Chicago-R64-Kim_Clijsters-Su_Wei_Hsieh,2,S-XC,4,0,0,0,0,3,1
20210927-W-Chicago-R64-Kim_Clijsters-Su_Wei_Hsieh,2,S-DTM,8,1,1,0,0,4,4
20210929-W-Chicago-R32-Bianca_Andreescu-Shelby_Rogers,1,F-XC,31,12,4,2,6,15,16
20210929-W-Chicago-R32-Bianca_Andreescu-Shelby_Rogers,1,F-DTM,38,2,0,0,2,21,17
20210929-W-Chicago-R32-Bianca_Andreescu-Shelby_Rogers,1,F-DTL,10,4,1,1,2,4,6
20210929-W-Chicago-R32-Bianca_Andreescu-Shelby_Rogers,1,F-IO,17,8,3,1,4,9,8
20210929-W-Chicago-R32-Bianca_Andreescu-Shelby_Rogers,1,B-XC,23,11,6,2,3,12,11
20210929-W-Chicago-R32-Bianca_Andreescu-Shelby_Rogers,1,B-DTM,31,6,0,0,6,17,14
20210929-W-Chicago-R32-Bianca_Andreescu-Shelby_Rogers,1,B-DTL,2,0,0,0,0,1,1
20210929-W-Chicago-R32-Bianca_Andreescu-Shelby_Rogers,1,B-IO,6,4,2,0,2,4,2
20210929-W-Chicago-R32-Bianca_Andreescu-Shelby_Rogers,1,S-DTM,1,0,0,0,0,0,1
20210929-W-Chicago-R32-Bianca_Andreescu-Shelby_Rogers,1,S-IO,1,1,0,0,1,0,1
20210929-W-Chicago-R32-Bianca_Andreescu-Shelby_Rogers,2,F-XC,30,9,3,2,4,12,18
20210929-W-Chicago-R32-Bianca_Andreescu-Shelby_Rogers,2,F-DTM,34,3,0,0,3,13,21
20210929-W-Chicago-R32-Bianca_Andreescu-Shelby_Rogers,2,F-DTL,4,3,0,0,3,0,4
20210929-W-Chicago-R32-Bianca_Andreescu-Shelby_Rogers,2,F-IO,16,6,2,2,2,9,7
20210929-W-Chicago-R32-Bianca_Andreescu-Shelby_Rogers,2,B-XC,22,5,2,1,2,15,7
20210929-W-Chicago-R32-Bianca_Andreescu-Shelby_Rogers,2,B-DTM,26,2,0,0,2,13,13
20210929-W-Chicago-R32-Bianca_Andreescu-Shelby_Rogers,2,B-DTL,6,2,2,0,0,5,1
20210929-W-Chicago-R32-Bianca_Andreescu-Shelby_Rogers,2,B-IO,13,3,1,1,1,5,8
20210929-W-Chicago-R32-Bianca_Andreescu-Shelby_Rogers,2,S-DTM,2,1,0,0,1,0,2
20210919-W-ITF_Johannesburg-F-Richel_Hogenkamp-Valeria_Bhunu,1,F-XC,51,12,2,3,7,33,18
20210919-W-ITF_Johannesburg-F-Richel_Hogenkamp-Valeria_Bhunu,1,F-DTM,45,5,0,0,5,20,25
20210919-W-ITF_Johannesburg-F-Richel_Hogenkamp-Valeria_Bhunu,1,F-DTL,17,5,1,0,4,7,10
20210919-W-ITF_Johannesburg-F-Richel_Hogenkamp-Valeria_Bhunu,1,F-IO,37,9,0,4,5,23,14
20210919-W-ITF_Johannesburg-F-Richel_Hogenkamp-Valeria_Bhunu,1,B-XC,1,0,0,0,0,1,0
20210919-W-ITF_Johannesburg-F-Richel_Hogenkamp-Valeria_Bhunu,1,B-DTM,5,0,0,0,0,1,4
20210919-W-ITF_Johannesburg-F-Richel_Hogenkamp-Valeria_Bhunu,1,B-DTL,5,2,0,1,1,1,4
20210919-W-ITF_Johannesburg-F-Richel_Hogenkamp-Valeria_Bhunu,1,B-IO,5,3,1,1,1,4,1
20210919-W-ITF_Johannesburg-F-Richel_Hogenkamp-Valeria_Bhunu,1,S-XC,54,2,0,0,2,25,29
20210919-W-ITF_Johannesburg-F-Richel_Hogenkamp-Valeria_Bhunu,1,S-DTM,63,6,0,0,6,27,36
20210919-W-ITF_Johannesburg-F-Richel_Hogenkamp-Valeria_Bhunu,1,S-DTL,3,2,0,1,1,2,1
20210919-W-ITF_Johannesburg-F-Richel_Hogenkamp-Valeria_Bhunu,1,S-IO,11,3,1,0,2,8,3
20210919-W-ITF_Johannesburg-F-Richel_Hogenkamp-Valeria_Bhunu,2,F-XC,88,23,4,5,14,40,48
20210919-W-ITF_Johannesburg-F-Richel_Hogenkamp-Valeria_Bhunu,2,F-DTM,40,4,0,1,3,18,22
20210919-W-ITF_Johannesburg-F-Richel_Hogenkamp-Valeria_Bhunu,2,F-DTL,2,2,1,0,1,1,1
20210919-W-ITF_Johannesburg-F-Richel_Hogenkamp-Valeria_Bhunu,2,F-IO,34,13,6,0,7,20,14
20210919-W-ITF_Johannesburg-F-Richel_Hogenkamp-Valeria_Bhunu,2,B-XC,66,19,3,7,9,34,32
20210919-W-ITF_Johannesburg-F-Richel_Hogenkamp-Valeria_Bhunu,2,B-DTM,63,5,1,2,2,29,34
20210919-W-ITF_Johannesburg-F-Richel_Hogenkamp-Valeria_Bhunu,2,B-DTL,3,1,0,0,1,2,1
20210919-W-ITF_Johannesburg-F-Richel_Hogenkamp-Valeria_Bhunu,2,B-IO,2,0,0,0,0,2,0
20210919-W-ITF_Johannesburg-F-Richel_Hogenkamp-Valeria_Bhunu,2,S-XC,5,1,0,0,1,2,3
20210919-W-ITF_Johannesburg-F-Richel_Hogenkamp-Valeria_Bhunu,2,S-DTM,17,3,0,0,3,5,12
20210919-W-ITF_Johannesburg-F-Richel_Hogenkamp-Valeria_Bhunu,2,S-DTL,4,3,0,0,3,1,3
20210919-W-ITF_Johannesburg-F-Richel_Hogenkamp-Valeria_Bhunu,2,S-IO,6,0,0,0,0,3,3
20210607-W-Nottingham-R64-Emma_Raducanu-Harriet_Dart,1,F-XC,27,7,1,1,5,11,16
20210607-W-Nottingham-R64-Emma_Raducanu-Harriet_Dart,1,F-DTM,22,1,0,0,1,8,14
20210607-W-Nottingham-R64-Emma_Raducanu-Harriet_Dart,1,F-DTL,13,6,1,3,2,9,4
20210607-W-Nottingham-R64-Emma_Raducanu-Harriet_Dart,1,F-IO,5,3,2,0,1,3,2
20210607-W-Nottingham-R64-Emma_Raducanu-Harriet_Dart,1,B-XC,13,1,0,0,1,8,5
20210607-W-Nottingham-R64-Emma_Raducanu-Harriet_Dart,1,B-DTM,22,1,0,0,1,8,14
20210607-W-Nottingham-R64-Emma_Raducanu-Harriet_Dart,1,B-DTL,8,5,2,1,2,4,4
20210607-W-Nottingham-R64-Emma_Raducanu-Harriet_Dart,1,B-IO,4,0,0,0,0,1,3
20210607-W-Nottingham-R64-Emma_Raducanu-Harriet_Dart,1,S-XC,4,1,0,0,1,2,2
20210607-W-Nottingham-R64-Emma_Raducanu-Harriet_Dart,1,S-DTM,4,1,0,1,0,1,3
20210607-W-Nottingham-R64-Emma_Raducanu-Harriet_Dart,1,S-IO,1,0,0,0,0,0,1
20210607-W-Nottingham-R64-Emma_Raducanu-Harriet_Dart,2,F-XC,38,10,4,5,1,23,15
20210607-W-Nottingham-R64-Emma_Raducanu-Harriet_Dart,2,F-DTM,11,2,0,0,2,6,5
20210607-W-Nottingham-R64-Emma_Raducanu-Harriet_Dart,2,F-DTL,9,6,2,1,3,5,4
20210607-W-Nottingham-R64-Emma_Raducanu-Harriet_Dart,2,F-IO,13,4,2,2,0,5,8
20210607-W-Nottingham-R64-Emma_Raducanu-Harriet_Dart,2,F-II,2,2,0,0,2,0,2
20210607-W-Nottingham-R64-Emma_Raducanu-Harriet_Dart,2,B-XC,13,3,0,1,2,7,6
20210607-W-Nottingham-R64-Emma_Raducanu-Harriet_Dart,2,B-DTM,13,3,0,0,3,5,8
20210607-W-Nottingham-R64-Emma_Raducanu-Harriet_Dart,2,B-DTL,4,3,0,2,1,3,1
20210607-W-Nottingham-R64-Emma_Raducanu-Harriet_Dart,2,B-IO,5,2,1,0,1,4,1
20210607-W-Nottingham-R64-Emma_Raducanu-Harriet_Dart,2,S-XC,2,1,0,0,1,0,2
20210607-W-Nottingham-R64-Emma_Raducanu-Harriet_Dart,2,S-DTM,8,0,0,0,0,4,4
20210607-W-Nottingham-R64-Emma_Raducanu-Harriet_Dart,2,S-DTL,1,0,0,0,0,0,1
20210607-W-Nottingham-R64-Emma_Raducanu-Harriet_Dart,2,S-IO,1,1,1,0,0,1,0
20210928-W-Chicago-R32-Dayana_Yastremska-Elise_Mertens,1,F-XC,16,4,0,1,3,11,5
20210928-W-Chicago-R32-Dayana_Yastremska-Elise_Mertens,1,F-DTM,6,3,0,0,3,1,5
20210928-W-Chicago-R32-Dayana_Yastremska-Elise_Mertens,1,F-DTL,3,1,0,0,1,1,2
20210928-W-Chicago-R32-Dayana_Yastremska-Elise_Mertens,1,F-IO,8,3,1,1,1,4,4
20210928-W-Chicago-R32-Dayana_Yastremska-Elise_Mertens,1,B-XC,28,6,1,1,4,11,17
20210928-W-Chicago-R32-Dayana_Yastremska-Elise_Mertens,1,B-DTM,19,8,0,1,7,4,15
20210928-W-Chicago-R32-Dayana_Yastremska-Elise_Mertens,1,B-DTL,9,6,1,2,3,5,4
20210928-W-Chicago-R32-Dayana_Yastremska-Elise_Mertens,1,B-IO,7,5,0,1,4,3,4
20210928-W-Chicago-R32-Dayana_Yastremska-Elise_Mertens,1,S-DTM,1,0,0,0,0,1,0
20210928-W-Chicago-R32-Dayana_Yastremska-Elise_Mertens,2,F-XC,6,2,0,1,1,3,3
20210928-W-Chicago-R32-Dayana_Yastremska-Elise_Mertens,2,F-DTM,9,0,0,0,0,3,6
20210928-W-Chicago-R32-Dayana_Yastremska-Elise_Mertens,2,F-DTL,4,1,0,0,1,1,3
20210928-W-Chicago-R32-Dayana_Yastremska-Elise_Mertens,2,F-IO,8,0,0,0,0,5,3
20210928-W-Chicago-R32-Dayana_Yastremska-Elise_Mertens,2,B-XC,22,5,1,0,4,11,11
20210928-W-Chicago-R32-Dayana_Yastremska-Elise_Mertens,2,B-DTM,14,0,0,0,0,10,4
20210928-W-Chicago-R32-Dayana_Yastremska-Elise_Mertens,2,B-DTL,4,0,0,0,0,3,1
20210928-W-Chicago-R32-Dayana_Yastremska-Elise_Mertens,2,B-IO,1,0,0,0,0,0,1
20210928-W-Chicago-R32-Dayana_Yastremska-Elise_Mertens,2,S-XC,3,0,0,0,0,1,2
20210928-W-Chicago-R32-Dayana_Yastremska-Elise_Mertens,2,S-DTM,1,0,0,0,0,1,0
20210929-W-Chicago-R32-Amanda_Anisimova-Elina_Svitolina,1,F-XC,21,11,3,1,7,7,14
20210929-W-Chicago-R32-Amanda_Anisimova-Elina_Svitolina,1,F-DTM,9,1,0,0,1,2,7
20210929-W-Chicago-R32-Amanda_Anisimova-Elina_Svitolina,1,F-DTL,7,6,3,0,3,4,3
20210929-W-Chicago-R32-Amanda_Anisimova-Elina_Svitolina,1,F-IO,13,5,1,0,4,7,6
20210929-W-Chicago-R32-Amanda_Anisimova-Elina_Svitolina,1,F-II,1,0,0,0,0,1,0
20210929-W-Chicago-R32-Amanda_Anisimova-Elina_Svitolina,1,B-XC,29,8,2,2,4,17,12
20210929-W-Chicago-R32-Amanda_Anisimova-Elina_Svitolina,1,B-DTM,11,3,0,0,3,4,7
20210929-W-Chicago-R32-Amanda_Anisimova-Elina_Svitolina,1,B-DTL,9,4,2,0,2,5,4
20210929-W-Chicago-R32-Amanda_Anisimova-Elina_Svitolina,1,B-IO,5,3,2,0,1,4,1
20210929-W-Chicago-R32-Amanda_Anisimova-Elina_Svitolina,1,S-XC,2,0,0,0,0,1,1
20210929-W-Chicago-R32-Amanda_Anisimova-Elina_Svitolina,1,S-DTM,1,0,0,0,0,0,1
20210929-W-Chicago-R32-Amanda_Anisimova-Elina_Svitolina,1,S-DTL,1,0,0,0,0,0,1
20210929-W-Chicago-R32-Amanda_Anisimova-Elina_Svitolina,1,S-IO,1,0,0,0,0,0,1
20210929-W-Chicago-R32-Amanda_Anisimova-Elina_Svitolina,2,F-XC,12,5,5,0,0,9,3
20210929-W-Chicago-R32-Amanda_Anisimova-Elina_Svitolina,2,F-DTM,17,0,0,0,0,10,7
20210929-W-Chicago-R32-Amanda_Anisimova-Elina_Svitolina,2,F-DTL,4,1,1,0,0,2,2
20210929-W-Chicago-R32-Amanda_Anisimova-Elina_Svitolina,2,F-IO,8,4,0,1,3,3,5
20210929-W-Chicago-R32-Amanda_Anisimova-Elina_Svitolina,2,B-XC,23,3,0,0,3,8,15
20210929-W-Chicago-R32-Amanda_Anisimova-Elina_Svitolina,2,B-DTM,13,1,0,0,1,9,4
20210929-W-Chicago-R32-Amanda_Anisimova-Elina_Svitolina,2,B-DTL,2,2,0,0,2,0,2
20210929-W-Chicago-R32-Amanda_Anisimova-Elina_Svitolina,2,B-IO,2,2,0,1,1,1,1
20210929-W-Chicago-R32-Amanda_Anisimova-Elina_Svitolina,2,S-XC,4,1,0,0,1,2,2
20210929-W-Chicago-R32-Amanda_Anisimova-Elina_Svitolina,2,S-DTM,4,0,0,0,0,1,3
20210929-W-Chicago-R32-Amanda_Anisimova-Elina_Svitolina,2,S-DTL,3,1,0,0,1,1,2
20210930-W-Chicago-R16-Elena_Gabriela_Ruse-Elina_Svitolina,1,F-XC,43,12,2,5,5,24,19
20210930-W-Chicago-R16-Elena_Gabriela_Ruse-Elina_Svitolina,1,F-DTM,37,3,0,0,3,17,20
20210930-W-Chicago-R16-Elena_Gabriela_Ruse-Elina_Svitolina,1,F-DTL,7,4,2,0,2,3,4
20210930-W-Chicago-R16-Elena_Gabriela_Ruse-Elina_Svitolina,1,F-IO,15,7,5,0,2,10,5
20210930-W-Chicago-R16-Elena_Gabriela_Ruse-Elina_Svitolina,1,F-II,1,0,0,0,0,1,0
20210930-W-Chicago-R16-Elena_Gabriela_Ruse-Elina_Svitolina,1,B-XC,42,12,2,3,7,17,25
20210930-W-Chicago-R16-Elena_Gabriela_Ruse-Elina_Svitolina,1,B-DTM,41,6,0,0,6,13,28
20210930-W-Chicago-R16-Elena_Gabriela_Ruse-Elina_Svitolina,1,B-DTL,9,5,1,1,3,6,3
20210930-W-Chicago-R16-Elena_Gabriela_Ruse-Elina_Svitolina,1,B-IO,22,14,4,0,10,10,12
20210930-W-Chicago-R16-Elena_Gabriela_Ruse-Elina_Svitolina,1,S-XC,2,0,0,0,0,2,0
20210930-W-Chicago-R16-Elena_Gabriela_Ruse-Elina_Svitolina,1,S-DTM,3,0,0,0,0,0,3
20210930-W-Chicago-R16-Elena_Gabriela_Ruse-Elina_Svitolina,1,S-DTL,1,0,0,0,0,0,1
20210930-W-Chicago-R16-Elena_Gabriela_Ruse-Elina_Svitolina,2,F-XC,30,8,3,3,2,14,16
20210930-W-Chicago-R16-Elena_Gabriela_Ruse-Elina_Svitolina,2,F-DTM,49,2,0,0,2,25,24
20210930-W-Chicago-R16-Elena_Gabriela_Ruse-Elina_Svitolina,2,F-DTL,6,2,1,0,1,3,3
20210930-W-Chicago-R16-Elena_Gabriela_Ruse-Elina_Svitolina,2,F-IO,18,5,1,2,2,11,7
20210930-W-Chicago-R16-Elena_Gabriela_Ruse-Elina_Svitolina,2,F-II,1,1,0,0,1,0,1
20210930-W-Chicago-R16-Elena_Gabriela_Ruse-Elina_Svitolina,2,B-XC,25,3,0,1,2,11,14
20210930-W-Chicago-R16-Elena_Gabriela_Ruse-Elina_Svitolina,2,B-DTM,36,3,0,0,3,23,13
20210930-W-Chicago-R16-Elena_Gabriela_Ruse-Elina_Svitolina,2,B-DTL,9,5,2,0,3,5,4
20210930-W-Chicago-R16-Elena_Gabriela_Ruse-Elina_Svitolina,2,B-IO,8,3,2,0,1,6,2
20210930-W-Chicago-R16-Elena_Gabriela_Ruse-Elina_Svitolina,2,S-XC,1,0,0,0,0,1,0
20210930-W-Chicago-R16-Elena_Gabriela_Ruse-Elina_Svitolina,2,S-DTM,3,0,0,0,0,3,0
20051023-W-Zurich-F-Patty_Schnyder-Lindsey_Davenport,1,F-XC,33,6,1,2,3,12,21
20051023-W-Zurich-F-Patty_Schnyder-Lindsey_Davenport,1,F-DTM,25,2,0,0,2,10,15
20051023-W-Zurich-F-Patty_Schnyder-Lindsey_Davenport,1,F-DTL,9,6,6,0,0,7,2
20051023-W-Zurich-F-Patty_Schnyder-Lindsey_Davenport,1,F-IO,12,4,2,1,1,8,4
20051023-W-Zurich-F-Patty_Schnyder-Lindsey_Davenport,1,F-II,1,0,0,0,0,0,1
20051023-W-Zurich-F-Patty_Schnyder-Lindsey_Davenport,1,B-XC,26,10,3,2,5,11,15
20051023-W-Zurich-F-Patty_Schnyder-Lindsey_Davenport,1,B-DTM,34,3,0,0,3,14,20
20051023-W-Zurich-F-Patty_Schnyder-Lindsey_Davenport,1,B-DTL,11,4,1,0,3,5,6
20051023-W-Zurich-F-Patty_Schnyder-Lindsey_Davenport,1,B-IO,4,4,1,0,3,1,3
20051023-W-Zurich-F-Patty_Schnyder-Lindsey_Davenport,1,S-XC,1,0,0,0,0,1,0
20051023-W-Zurich-F-Patty_Schnyder-Lindsey_Davenport,1,S-DTM,13,1,0,0,1,3,10
20051023-W-Zurich-F-Patty_Schnyder-Lindsey_Davenport,1,S-DTL,3,1,0,0,1,1,2
20051023-W-Zurich-F-Patty_Schnyder-Lindsey_Davenport,2,F-XC,55,8,1,4,3,33,22
20051023-W-Zurich-F-Patty_Schnyder-Lindsey_Davenport,2,F-DTM,18,3,0,0,3,7,11
20051023-W-Zurich-F-Patty_Schnyder-Lindsey_Davenport,2,F-DTL,5,4,1,1,2,2,3
20051023-W-Zurich-F-Patty_Schnyder-Lindsey_Davenport,2,F-IO,13,9,3,2,4,7,6
20051023-W-Zurich-F-Patty_Schnyder-Lindsey_Davenport,2,B-XC,40,15,4,7,4,28,12
20051023-W-Zurich-F-Patty_Schnyder-Lindsey_Davenport,2,B-DTM,19,0,0,0,0,10,9
20051023-W-Zurich-F-Patty_Schnyder-Lindsey_Davenport,2,B-DTL,20,15,4,1,10,7,13
20051023-W-Zurich-F-Patty_Schnyder-Lindsey_Davenport,2,B-IO,17,5,1,0,4,10,7
20051023-W-Zurich-F-Patty_Schnyder-Lindsey_Davenport,2,S-XC,1,1,0,0,1,0,1
20051023-W-Zurich-F-Patty_Schnyder-Lindsey_Davenport,2,S-DTM,1,0,0,0,0,1,0
20210926-W-ITF_Valencia-F-Arantxa_Rus-Mihaela_Buzarnescu,1,F-XC,35,6,2,2,2,20,15
20210926-W-ITF_Valencia-F-Arantxa_Rus-Mihaela_Buzarnescu,1,F-DTM,36,5,1,1,3,18,18
20210926-W-ITF_Valencia-F-Arantxa_Rus-Mihaela_Buzarnescu,1,F-DTL,12,2,0,0,2,4,8
20210926-W-ITF_Valencia-F-Arantxa_Rus-Mihaela_Buzarnescu,1,F-IO,39,7,4,2,1,19,20
20210926-W-ITF_Valencia-F-Arantxa_Rus-Mihaela_Buzarnescu,1,F-II,1,0,0,0,0,1,0
20210926-W-ITF_Valencia-F-Arantxa_Rus-Mihaela_Buzarnescu,1,B-XC,45,6,1,2,3,24,21
20210926-W-ITF_Valencia-F-Arantxa_Rus-Mihaela_Buzarnescu,1,B-DTM,52,5,0,1,4,27,25
20210926-W-ITF_Valencia-F-Arantxa_Rus-Mihaela_Buzarnescu,1,B-DTL,6,3,0,1,2,2,4
20210926-W-ITF_Valencia-F-Arantxa_Rus-Mihaela_Buzarnescu,1,B-IO,4,3,0,1,2,1,3
20210926-W-ITF_Valencia-F-Arantxa_Rus-Mihaela_Buzarnescu,1,S-XC,4,2,1,1,0,3,1
20210926-W-ITF_Valencia-F-Arantxa_Rus-Mihaela_Buzarnescu,1,S-DTM,8,0,0,0,0,3,5
20210926-W-ITF_Valencia-F-Arantxa_Rus-Mihaela_Buzarnescu,1,S-IO,3,2,0,1,1,2,1
20210926-W-ITF_Valencia-F-Arantxa_Rus-Mihaela_Buzarnescu,2,F-XC,59,15,4,4,7,34,25
20210926-W-ITF_Valencia-F-Arantxa_Rus-Mihaela_Buzarnescu,2,F-DTM,20,2,0,0,2,10,10
20210926-W-ITF_Valencia-F-Arantxa_Rus-Mihaela_Buzarnescu,2,F-DTL,8,4,0,1,3,1,7
20210926-W-ITF_Valencia-F-Arantxa_Rus-Mihaela_Buzarnescu,2,F-IO,12,5,0,4,1,6,6
20210926-W-ITF_Valencia-F-Arantxa_Rus-Mihaela_Buzarnescu,2,B-XC,97,19,7,1,11,51,46
20210926-W-ITF_Valencia-F-Arantxa_Rus-Mihaela_Buzarnescu,2,B-DTM,34,2,0,0,2,17,17
20210926-W-ITF_Valencia-F-Arantxa_Rus-Mihaela_Buzarnescu,2,B-DTL,15,7,3,1,3,9,6
20210926-W-ITF_Valencia-F-Arantxa_Rus-Mihaela_Buzarnescu,2,B-IO,6,3,0,0,3,1,5
20210926-W-ITF_Valencia-F-Arantxa_Rus-Mihaela_Buzarnescu,2,S-XC,2,1,0,0,1,0,2
20210926-W-ITF_Valencia-F-Arantxa_Rus-Mihaela_Buzarnescu,2,S-DTM,8,1,1,0,0,3,5
20210926-W-ITF_Valencia-F-Arantxa_Rus-Mihaela_Buzarnescu,2,S-DTL,3,1,0,1,0,2,1
20210926-W-ITF_Valencia-F-Arantxa_Rus-Mihaela_Buzarnescu,2,S-IO,1,0,0,0,0,1,0
19990703-W-Wimbledon-SF-Alexandra_Stevenson-Lindsay_Davenport,1,F-XC,15,8,1,3,4,7,8
19990703-W-Wimbledon-SF-Alexandra_Stevenson-Lindsay_Davenport,1,F-DTM,8,1,0,0,1,5,3
19990703-W-Wimbledon-SF-Alexandra_Stevenson-Lindsay_Davenport,1,F-DTL,2,1,0,0,1,0,2
19990703-W-Wimbledon-SF-Alexandra_Stevenson-Lindsay_Davenport,1,F-IO,4,3,0,1,2,1,3
19990703-W-Wimbledon-SF-Alexandra_Stevenson-Lindsay_Davenport,1,F-II,2,1,0,0,1,0,2
19990703-W-Wimbledon-SF-Alexandra_Stevenson-Lindsay_Davenport,1,B-XC,10,3,1,0,2,6,4
19990703-W-Wimbledon-SF-Alexandra_Stevenson-Lindsay_Davenport,1,B-DTM,13,2,0,1,1,7,6
19990703-W-Wimbledon-SF-Alexandra_Stevenson-Lindsay_Davenport,1,B-DTL,2,2,1,0,1,1,1
19990703-W-Wimbledon-SF-Alexandra_Stevenson-Lindsay_Davenport,1,B-IO,4,2,1,0,1,2,2
19990703-W-Wimbledon-SF-Alexandra_Stevenson-Lindsay_Davenport,1,S-XC,5,0,0,0,0,4,1
19990703-W-Wimbledon-SF-Alexandra_Stevenson-Lindsay_Davenport,1,S-DTM,7,0,0,0,0,3,4
19990703-W-Wimbledon-SF-Alexandra_Stevenson-Lindsay_Davenport,1,S-DTL,3,1,0,0,1,1,2
19990703-W-Wimbledon-SF-Alexandra_Stevenson-Lindsay_Davenport,2,F-XC,14,4,2,1,1,8,6
19990703-W-Wimbledon-SF-Alexandra_Stevenson-Lindsay_Davenport,2,F-DTM,8,0,0,0,0,4,4
19990703-W-Wimbledon-SF-Alexandra_Stevenson-Lindsay_Davenport,2,F-DTL,3,0,0,0,0,2,1
19990703-W-Wimbledon-SF-Alexandra_Stevenson-Lindsay_Davenport,2,F-IO,10,4,1,2,1,5,5
19990703-W-Wimbledon-SF-Alexandra_Stevenson-Lindsay_Davenport,2,B-XC,24,5,1,2,2,12,12
19990703-W-Wimbledon-SF-Alexandra_Stevenson-Lindsay_Davenport,2,B-DTM,8,0,0,0,0,2,6
19990703-W-Wimbledon-SF-Alexandra_Stevenson-Lindsay_Davenport,2,B-DTL,4,2,0,1,1,1,3
19990703-W-Wimbledon-SF-Alexandra_Stevenson-Lindsay_Davenport,2,B-IO,3,2,1,1,0,2,1
20210927-W-Chicago-R64-Caroline_Garcia-Mai_Hontama,1,F-XC,31,14,3,1,10,8,23
20210927-W-Chicago-R64-Caroline_Garcia-Mai_Hontama,1,F-DTM,29,1,0,0,1,5,24
20210927-W-Chicago-R64-Caroline_Garcia-Mai_Hontama,1,F-DTL,4,3,0,1,2,1,3
20210927-W-Chicago-R64-Caroline_Garcia-Mai_Hontama,1,F-IO,12,8,2,1,5,6,6
20210927-W-Chicago-R64-Caroline_Garcia-Mai_Hontama,1,F-II,1,0,0,0,0,0,1
20210927-W-Chicago-R64-Caroline_Garcia-Mai_Hontama,1,B-XC,18,7,0,1,6,5,13
20210927-W-Chicago-R64-Caroline_Garcia-Mai_Hontama,1,B-DTM,12,1,0,0,1,2,10
20210927-W-Chicago-R64-Caroline_Garcia-Mai_Hontama,1,B-DTL,2,2,0,0,2,0,2
20210927-W-Chicago-R64-Caroline_Garcia-Mai_Hontama,1,B-IO,2,1,0,0,1,0,2
20210927-W-Chicago-R64-Caroline_Garcia-Mai_Hontama,1,S-XC,1,0,0,0,0,0,1
20210927-W-Chicago-R64-Caroline_Garcia-Mai_Hontama,2,F-XC,15,5,3,2,0,14,1
20210927-W-Chicago-R64-Caroline_Garcia-Mai_Hontama,2,F-DTM,27,4,0,1,3,22,5
20210927-W-Chicago-R64-Caroline_Garcia-Mai_Hontama,2,F-DTL,4,3,1,1,1,2,2
20210927-W-Chicago-R64-Caroline_Garcia-Mai_Hontama,2,F-IO,4,1,1,0,0,4,0
20210927-W-Chicago-R64-Caroline_Garcia-Mai_Hontama,2,B-XC,15,5,2,2,1,12,3
20210927-W-Chicago-R64-Caroline_Garcia-Mai_Hontama,2,B-DTM,27,0,0,0,0,23,4
20210927-W-Chicago-R64-Caroline_Garcia-Mai_Hontama,2,B-DTL,4,4,2,0,2,2,2
20210927-W-Chicago-R64-Caroline_Garcia-Mai_Hontama,2,B-IO,2,0,0,0,0,2,0
20210927-W-Chicago-R64-Caroline_Garcia-Mai_Hontama,2,S-XC,1,0,0,0,0,1,0
20210927-W-Chicago-R64-Caroline_Garcia-Mai_Hontama,2,S-DTM,5,0,0,0,0,0,5
20210927-W-Chicago-R64-Caroline_Garcia-Mai_Hontama,2,S-IO,1,0,0,0,0,0,1
20211003-W-Chicago-F-Ons_Jabeur-Garbine_Muguruza,1,F-XC,44,14,5,1,8,20,24
20211003-W-Chicago-F-Ons_Jabeur-Garbine_Muguruza,1,F-DTM,24,5,0,1,4,4,20
20211003-W-Chicago-F-Ons_Jabeur-Garbine_Muguruza,1,F-DTL,6,3,1,0,2,2,4
20211003-W-Chicago-F-Ons_Jabeur-Garbine_Muguruza,1,F-IO,20,9,1,0,8,4,16
20211003-W-Chicago-F-Ons_Jabeur-Garbine_Muguruza,1,B-XC,14,2,1,0,1,6,8
20211003-W-Chicago-F-Ons_Jabeur-Garbine_Muguruza,1,B-DTM,13,3,0,0,3,5,8
20211003-W-Chicago-F-Ons_Jabeur-Garbine_Muguruza,1,B-DTL,9,4,3,0,1,5,4
20211003-W-Chicago-F-Ons_Jabeur-Garbine_Muguruza,1,B-IO,5,0,0,0,0,3,2
20211003-W-Chicago-F-Ons_Jabeur-Garbine_Muguruza,1,S-XC,2,1,1,0,0,2,0
20211003-W-Chicago-F-Ons_Jabeur-Garbine_Muguruza,1,S-DTM,6,0,0,0,0,2,4
20211003-W-Chicago-F-Ons_Jabeur-Garbine_Muguruza,1,S-DTL,2,1,0,0,1,1,1
20211003-W-Chicago-F-Ons_Jabeur-Garbine_Muguruza,1,S-IO,1,0,0,0,0,0,1
20211003-W-Chicago-F-Ons_Jabeur-Garbine_Muguruza,2,F-XC,30,10,2,2,6,16,14
20211003-W-Chicago-F-Ons_Jabeur-Garbine_Muguruza,2,F-DTM,27,3,0,0,3,18,9
20211003-W-Chicago-F-Ons_Jabeur-Garbine_Muguruza,2,F-DTL,18,4,4,0,0,11,7
20211003-W-Chicago-F-Ons_Jabeur-Garbine_Muguruza,2,F-IO,9,3,0,1,2,4,5
20211003-W-Chicago-F-Ons_Jabeur-Garbine_Muguruza,2,F-II,1,1,1,0,0,1,0
20211003-W-Chicago-F-Ons_Jabeur-Garbine_Muguruza,2,B-XC,24,6,0,1,5,9,15
20211003-W-Chicago-F-Ons_Jabeur-Garbine_Muguruza,2,B-DTM,28,1,1,0,0,23,5
20211003-W-Chicago-F-Ons_Jabeur-Garbine_Muguruza,2,B-DTL,8,3,1,0,2,4,4
20211003-W-Chicago-F-Ons_Jabeur-Garbine_Muguruza,2,B-IO,9,4,2,1,1,7,2
20211003-W-Chicago-F-Ons_Jabeur-Garbine_Muguruza,2,S-XC,2,1,1,0,0,1,1
20211003-W-Chicago-F-Ons_Jabeur-Garbine_Muguruza,2,S-DTM,1,0,0,0,0,0,1
20211003-W-Chicago-F-Ons_Jabeur-Garbine_Muguruza,2,S-DTL,2,0,0,0,0,1,1
20211001-W-Chicago-QF-Elina_Svitolina-Ons_Jabeur,1,F-XC,22,9,0,4,5,10,12
20211001-W-Chicago-QF-Elina_Svitolina-Ons_Jabeur,1,F-DTM,22,4,0,0,4,9,13
20211001-W-Chicago-QF-Elina_Svitolina-Ons_Jabeur,1,F-DTL,5,2,1,0,1,3,2
20211001-W-Chicago-QF-Elina_Svitolina-Ons_Jabeur,1,F-IO,13,4,1,0,3,7,6
20211001-W-Chicago-QF-Elina_Svitolina-Ons_Jabeur,1,B-XC,30,7,2,3,2,16,14
20211001-W-Chicago-QF-Elina_Svitolina-Ons_Jabeur,1,B-DTM,13,2,0,0,2,4,9
20211001-W-Chicago-QF-Elina_Svitolina-Ons_Jabeur,1,B-DTL,3,3,2,0,1,2,1
20211001-W-Chicago-QF-Elina_Svitolina-Ons_Jabeur,1,B-IO,6,2,0,1,1,4,2
20211001-W-Chicago-QF-Elina_Svitolina-Ons_Jabeur,1,S-XC,9,2,0,1,1,2,7
20211001-W-Chicago-QF-Elina_Svitolina-Ons_Jabeur,1,S-DTM,5,1,0,0,1,1,4
20211001-W-Chicago-QF-Elina_Svitolina-Ons_Jabeur,1,S-DTL,4,1,1,0,0,1,3
20211001-W-Chicago-QF-Elina_Svitolina-Ons_Jabeur,2,F-XC,28,9,2,1,6,14,14
20211001-W-Chicago-QF-Elina_Svitolina-Ons_Jabeur,2,F-DTM,13,3,1,0,2,8,5
20211001-W-Chicago-QF-Elina_Svitolina-Ons_Jabeur,2,F-DTL,14,4,2,0,2,10,4
20211001-W-Chicago-QF-Elina_Svitolina-Ons_Jabeur,2,F-IO,16,3,3,0,0,12,4
20211001-W-Chicago-QF-Elina_Svitolina-Ons_Jabeur,2,F-II,1,1,0,0,1,0,1
20211001-W-Chicago-QF-Elina_Svitolina-Ons_Jabeur,2,B-XC,6,0,0,0,0,4,2
20211001-W-Chicago-QF-Elina_Svitolina-Ons_Jabeur,2,B-DTM,11,1,0,0,1,6,5
20211001-W-Chicago-QF-Elina_Svitolina-Ons_Jabeur,2,B-DTL,8,4,0,1,3,3,5
20211001-W-Chicago-QF-Elina_Svitolina-Ons_Jabeur,2,B-IO,9,4,2,0,2,5,4
20211001-W-Chicago-QF-Elina_Svitolina-Ons_Jabeur,2,S-XC,10,0,0,0,0,5,5
20211001-W-Chicago-QF-Elina_Svitolina-Ons_Jabeur,2,S-DTM,6,0,0,0,0,2,4
20211001-W-Chicago-QF-Elina_Svitolina-Ons_Jabeur,2,S-DTL,7,1,0,0,1,3,4
20211001-W-Chicago-QF-Elina_Svitolina-Ons_Jabeur,2,S-IO,1,0,0,0,0,1,0
20211006-W-Indian_Wells-R128-Shuai_Zhang-Marta_Kostyuk,1,F-XC,37,18,3,5,10,20,17
20211006-W-Indian_Wells-R128-Shuai_Zhang-Marta_Kostyuk,1,F-DTM,15,2,1,1,0,9,6
20211006-W-Indian_Wells-R128-Shuai_Zhang-Marta_Kostyuk,1,F-DTL,3,2,0,0,2,1,2
20211006-W-Indian_Wells-R128-Shuai_Zhang-Marta_Kostyuk,1,F-IO,14,7,4,1,2,10,4
20211006-W-Indian_Wells-R128-Shuai_Zhang-Marta_Kostyuk,1,B-XC,37,17,2,4,11,16,21
20211006-W-Indian_Wells-R128-Shuai_Zhang-Marta_Kostyuk,1,B-DTM,27,4,0,0,4,12,15
20211006-W-Indian_Wells-R128-Shuai_Zhang-Marta_Kostyuk,1,B-DTL,12,7,3,1,3,8,4
20211006-W-Indian_Wells-R128-Shuai_Zhang-Marta_Kostyuk,1,B-IO,7,6,3,0,3,3,4
20211006-W-Indian_Wells-R128-Shuai_Zhang-Marta_Kostyuk,2,F-XC,15,5,1,0,4,7,8
20211006-W-Indian_Wells-R128-Shuai_Zhang-Marta_Kostyuk,2,F-DTM,22,1,0,0,1,8,14
20211006-W-Indian_Wells-R128-Shuai_Zhang-Marta_Kostyuk,2,F-DTL,9,4,2,0,2,4,5
20211006-W-Indian_Wells-R128-Shuai_Zhang-Marta_Kostyuk,2,F-IO,18,3,2,0,1,9,9
20211006-W-Indian_Wells-R128-Shuai_Zhang-Marta_Kostyuk,2,B-XC,22,2,0,1,1,13,9
20211006-W-Indian_Wells-R128-Shuai_Zhang-Marta_Kostyuk,2,B-DTM,26,4,0,2,2,13,13
20211006-W-Indian_Wells-R128-Shuai_Zhang-Marta_Kostyuk,2,B-DTL,2,2,1,0,1,1,1
20211006-W-Indian_Wells-R128-Shuai_Zhang-Marta_Kostyuk,2,B-IO,4,1,0,0,1,1,3
20211006-W-Indian_Wells-R128-Shuai_Zhang-Marta_Kostyuk,2,S-DTM,4,0,0,0,0,1,3
20211009-W-Indian_Wells-R64-Alison_Riske-Bianca_Andreescu,1,F-XC,47,11,5,2,4,30,17
20211009-W-Indian_Wells-R64-Alison_Riske-Bianca_Andreescu,1,F-DTM,65,7,1,0,6,22,43
20211009-W-Indian_Wells-R64-Alison_Riske-Bianca_Andreescu,1,F-DTL,15,6,0,1,5,4,11
20211009-W-Indian_Wells-R64-Alison_Riske-Bianca_Andreescu,1,F-IO,39,7,0,2,5,18,21
20211009-W-Indian_Wells-R64-Alison_Riske-Bianca_Andreescu,1,B-XC,73,8,3,1,4,40,33
20211009-W-Indian_Wells-R64-Alison_Riske-Bianca_Andreescu,1,B-DTM,72,4,0,0,4,30,42
20211009-W-Indian_Wells-R64-Alison_Riske-Bianca_Andreescu,1,B-DTL,17,9,4,2,3,10,7
20211009-W-Indian_Wells-R64-Alison_Riske-Bianca_Andreescu,1,B-IO,24,9,3,2,4,13,11
20211009-W-Indian_Wells-R64-Alison_Riske-Bianca_Andreescu,1,S-DTM,1,0,0,0,0,0,1
20211009-W-Indian_Wells-R64-Alison_Riske-Bianca_Andreescu,2,F-XC,68,23,6,7,10,47,21
20211009-W-Indian_Wells-R64-Alison_Riske-Bianca_Andreescu,2,F-DTM,49,6,1,0,5,20,29
20211009-W-Indian_Wells-R64-Alison_Riske-Bianca_Andreescu,2,F-DTL,11,2,0,0,2,3,8
20211009-W-Indian_Wells-R64-Alison_Riske-Bianca_Andreescu,2,F-IO,16,3,1,1,1,10,6
20211009-W-Indian_Wells-R64-Alison_Riske-Bianca_Andreescu,2,B-XC,74,15,5,2,8,42,32
20211009-W-Indian_Wells-R64-Alison_Riske-Bianca_Andreescu,2,B-DTM,43,5,0,0,5,20,23
20211009-W-Indian_Wells-R64-Alison_Riske-Bianca_Andreescu,2,B-DTL,15,6,2,1,3,8,7
20211009-W-Indian_Wells-R64-Alison_Riske-Bianca_Andreescu,2,B-IO,18,10,4,1,5,12,6
20211009-W-Indian_Wells-R64-Alison_Riske-Bianca_Andreescu,2,S-XC,5,1,0,0,1,2,3
20211009-W-Indian_Wells-R64-Alison_Riske-Bianca_Andreescu,2,S-DTM,19,0,0,0,0,12,7
20211009-W-Indian_Wells-R64-Alison_Riske-Bianca_Andreescu,2,S-DTL,2,1,1,0,0,1,1
20211009-W-Indian_Wells-R64-Alison_Riske-Bianca_Andreescu,2,S-IO,5,1,0,0,1,1,4
20210905-W-US_Open-R16-Leylah_Annie_Fernandez-Angelique_Kerber,1,F-XC,82,21,12,5,4,48,34
20210905-W-US_Open-R16-Leylah_Annie_Fernandez-Angelique_Kerber,1,F-DTM,68,2,0,0,2,36,32
20210905-W-US_Open-R16-Leylah_Annie_Fernandez-Angelique_Kerber,1,F-DTL,28,14,4,3,7,16,12
20210905-W-US_Open-R16-Leylah_Annie_Fernandez-Angelique_Kerber,1,F-IO,26,9,6,2,1,16,10
20210905-W-US_Open-R16-Leylah_Annie_Fernandez-Angelique_Kerber,1,F-II,1,1,0,0,1,0,1
20210905-W-US_Open-R16-Leylah_Annie_Fernandez-Angelique_Kerber,1,B-XC,33,9,2,1,6,13,20
20210905-W-US_Open-R16-Leylah_Annie_Fernandez-Angelique_Kerber,1,B-DTM,31,1,0,0,1,17,14
20210905-W-US_Open-R16-Leylah_Annie_Fernandez-Angelique_Kerber,1,B-DTL,10,5,0,1,4,3,7
20210905-W-US_Open-R16-Leylah_Annie_Fernandez-Angelique_Kerber,1,B-IO,9,3,0,1,2,5,4
20210905-W-US_Open-R16-Leylah_Annie_Fernandez-Angelique_Kerber,1,S-XC,2,0,0,0,0,1,1
20210905-W-US_Open-R16-Leylah_Annie_Fernandez-Angelique_Kerber,1,S-DTM,11,1,0,0,1,5,6
20210905-W-US_Open-R16-Leylah_Annie_Fernandez-Angelique_Kerber,1,S-DTL,2,0,0,0,0,2,0
20210905-W-US_Open-R16-Leylah_Annie_Fernandez-Angelique_Kerber,1,S-IO,1,0,0,0,0,0,1
20210905-W-US_Open-R16-Leylah_Annie_Fernandez-Angelique_Kerber,2,F-XC,89,13,3,3,7,42,47
20210905-W-US_Open-R16-Leylah_Annie_Fernandez-Angelique_Kerber,2,F-DTM,46,0,0,0,0,14,32
20210905-W-US_Open-R16-Leylah_Annie_Fernandez-Angelique_Kerber,2,F-DTL,20,12,7,4,1,16,4
20210905-W-US_Open-R16-Leylah_Annie_Fernandez-Angelique_Kerber,2,F-IO,26,14,8,1,5,15,11
20210905-W-US_Open-R16-Leylah_Annie_Fernandez-Angelique_Kerber,2,F-II,2,0,0,0,0,2,0
20210905-W-US_Open-R16-Leylah_Annie_Fernandez-Angelique_Kerber,2,B-XC,42,5,2,0,3,24,18
20210905-W-US_Open-R16-Leylah_Annie_Fernandez-Angelique_Kerber,2,B-DTM,49,3,0,1,2,25,24
20210905-W-US_Open-R16-Leylah_Annie_Fernandez-Angelique_Kerber,2,B-DTL,3,2,1,0,1,2,1
20210905-W-US_Open-R16-Leylah_Annie_Fernandez-Angelique_Kerber,2,B-IO,9,2,1,1,0,6,3
20210905-W-US_Open-R16-Leylah_Annie_Fernandez-Angelique_Kerber,2,S-XC,6,1,0,0,1,3,3
20210905-W-US_Open-R16-Leylah_Annie_Fernandez-Angelique_Kerber,2,S-DTM,5,0,0,0,0,2,3
20210905-W-US_Open-R16-Leylah_Annie_Fernandez-Angelique_Kerber,2,S-DTL,2,0,0,0,0,0,2
20210905-W-US_Open-R16-Leylah_Annie_Fernandez-Angelique_Kerber,2,S-IO,2,0,0,0,0,1,1
20211006-W-Indian_Wells-R128-Arantxa_Rus-Alycia_Parks,1,F-XC,14,3,1,0,2,9,5
20211006-W-Indian_Wells-R128-Arantxa_Rus-Alycia_Parks,1,F-DTM,22,1,0,1,0,12,10
20211006-W-Indian_Wells-R128-Arantxa_Rus-Alycia_Parks,1,F-DTL,8,2,0,1,1,6,2
20211006-W-Indian_Wells-R128-Arantxa_Rus-Alycia_Parks,1,F-IO,13,2,0,1,1,9,4
20211006-W-Indian_Wells-R128-Arantxa_Rus-Alycia_Parks,1,F-II,1,1,1,0,0,1,0
20211006-W-Indian_Wells-R128-Arantxa_Rus-Alycia_Parks,1,B-XC,7,1,0,0,1,6,1
20211006-W-Indian_Wells-R128-Arantxa_Rus-Alycia_Parks,1,B-DTM,16,0,0,0,0,7,9
20211006-W-Indian_Wells-R128-Arantxa_Rus-Alycia_Parks,1,B-DTL,2,1,1,0,0,2,0
20211006-W-Indian_Wells-R128-Arantxa_Rus-Alycia_Parks,1,B-IO,4,0,0,0,0,4,0
20211006-W-Indian_Wells-R128-Arantxa_Rus-Alycia_Parks,1,S-XC,1,0,0,0,0,0,1
20211006-W-Indian_Wells-R128-Arantxa_Rus-Alycia_Parks,1,S-DTM,2,1,0,1,0,1,1
20211006-W-Indian_Wells-R128-Arantxa_Rus-Alycia_Parks,1,S-DTL,1,0,0,0,0,0,1
20211006-W-Indian_Wells-R128-Arantxa_Rus-Alycia_Parks,2,F-XC,18,10,1,0,9,3,15
20211006-W-Indian_Wells-R128-Arantxa_Rus-Alycia_Parks,2,F-DTM,17,4,0,0,4,6,11
20211006-W-Indian_Wells-R128-Arantxa_Rus-Alycia_Parks,2,F-DTL,6,3,1,0,2,1,5
20211006-W-Indian_Wells-R128-Arantxa_Rus-Alycia_Parks,2,F-IO,7,3,2,0,1,4,3
20211006-W-Indian_Wells-R128-Arantxa_Rus-Alycia_Parks,2,B-XC,14,4,0,1,3,4,10
20211006-W-Indian_Wells-R128-Arantxa_Rus-Alycia_Parks,2,B-DTM,17,2,0,0,2,5,12
20211006-W-Indian_Wells-R128-Arantxa_Rus-Alycia_Parks,2,B-DTL,1,1,0,1,0,1,0
20211006-W-Indian_Wells-R128-Arantxa_Rus-Alycia_Parks,2,B-IO,6,3,1,0,2,2,4
20211006-W-Indian_Wells-R128-Arantxa_Rus-Alycia_Parks,2,S-XC,2,0,0,0,0,1,1
20211006-W-Indian_Wells-R128-Arantxa_Rus-Alycia_Parks,2,S-DTM,1,0,0,0,0,0,1
20211006-W-Indian_Wells-R128-Arantxa_Rus-Alycia_Parks,2,S-DTL,1,0,0,0,0,0,1
20211009-W-Indian_Wells-R64-Cori_Gauff-Caroline_Garcia,1,F-XC,19,5,0,2,3,8,11
20211009-W-Indian_Wells-R64-Cori_Gauff-Caroline_Garcia,1,F-DTM,43,11,0,1,10,20,23
20211009-W-Indian_Wells-R64-Cori_Gauff-Caroline_Garcia,1,F-DTL,12,8,2,1,5,6,6
20211009-W-Indian_Wells-R64-Cori_Gauff-Caroline_Garcia,1,F-IO,12,4,2,0,2,4,8
20211009-W-Indian_Wells-R64-Cori_Gauff-Caroline_Garcia,1,F-II,1,0,0,0,0,0,1
20211009-W-Indian_Wells-R64-Cori_Gauff-Caroline_Garcia,1,B-XC,29,5,2,0,3,20,9
20211009-W-Indian_Wells-R64-Cori_Gauff-Caroline_Garcia,1,B-DTM,24,3,0,0,3,11,13
20211009-W-Indian_Wells-R64-Cori_Gauff-Caroline_Garcia,1,B-DTL,11,8,3,0,5,5,6
20211009-W-Indian_Wells-R64-Cori_Gauff-Caroline_Garcia,1,B-IO,9,4,4,0,0,8,1
20211009-W-Indian_Wells-R64-Cori_Gauff-Caroline_Garcia,1,S-XC,2,0,0,0,0,1,1
20211009-W-Indian_Wells-R64-Cori_Gauff-Caroline_Garcia,1,S-DTM,3,1,0,0,1,1,2
20211009-W-Indian_Wells-R64-Cori_Gauff-Caroline_Garcia,1,S-DTL,2,1,1,0,0,2,0
20211009-W-Indian_Wells-R64-Cori_Gauff-Caroline_Garcia,1,S-IO,1,0,0,0,0,1,0
20211009-W-Indian_Wells-R64-Cori_Gauff-Caroline_Garcia,2,F-XC,53,18,2,2,14,23,30
20211009-W-Indian_Wells-R64-Cori_Gauff-Caroline_Garcia,2,F-DTM,27,6,1,0,5,12,15
20211009-W-Indian_Wells-R64-Cori_Gauff-Caroline_Garcia,2,F-DTL,8,3,1,1,1,5,3
20211009-W-Indian_Wells-R64-Cori_Gauff-Caroline_Garcia,2,F-IO,17,6,3,1,2,6,11
20211009-W-Indian_Wells-R64-Cori_Gauff-Caroline_Garcia,2,F-II,2,2,1,0,1,1,1
20211009-W-Indian_Wells-R64-Cori_Gauff-Caroline_Garcia,2,B-XC,33,8,2,0,6,18,15
20211009-W-Indian_Wells-R64-Cori_Gauff-Caroline_Garcia,2,B-DTM,24,1,0,0,1,11,13
20211009-W-Indian_Wells-R64-Cori_Gauff-Caroline_Garcia,2,B-DTL,12,5,0,1,4,7,5
20211009-W-Indian_Wells-R64-Cori_Gauff-Caroline_Garcia,2,B-IO,5,2,0,0,2,2,3
20211009-W-Indian_Wells-R64-Cori_Gauff-Caroline_Garcia,2,S-XC,2,0,0,0,0,0,2
20211009-W-Indian_Wells-R64-Cori_Gauff-Caroline_Garcia,2,S-DTM,1,0,0,0,0,0,1
20211009-W-Indian_Wells-R64-Cori_Gauff-Caroline_Garcia,2,S-DTL,1,0,0,0,0,0,1
20211009-W-Indian_Wells-R64-Cori_Gauff-Caroline_Garcia,2,S-IO,1,0,0,0,0,1,0
20211006-W-Indian_Wells-R128-Liudmila_Samsonova-Kateryna_Kozlova,1,F-XC,60,20,5,4,11,31,29
20211006-W-Indian_Wells-R128-Liudmila_Samsonova-Kateryna_Kozlova,1,F-DTM,18,3,0,0,3,10,8
20211006-W-Indian_Wells-R128-Liudmila_Samsonova-Kateryna_Kozlova,1,F-DTL,6,5,5,0,0,6,0
20211006-W-Indian_Wells-R128-Liudmila_Samsonova-Kateryna_Kozlova,1,F-IO,29,16,10,1,5,20,9
20211006-W-Indian_Wells-R128-Liudmila_Samsonova-Kateryna_Kozlova,1,B-XC,31,11,3,2,6,14,17
20211006-W-Indian_Wells-R128-Liudmila_Samsonova-Kateryna_Kozlova,1,B-DTM,25,4,0,0,4,12,13
20211006-W-Indian_Wells-R128-Liudmila_Samsonova-Kateryna_Kozlova,1,B-DTL,1,1,0,0,1,0,1
20211006-W-Indian_Wells-R128-Liudmila_Samsonova-Kateryna_Kozlova,1,B-IO,2,1,1,0,0,2,0
20211006-W-Indian_Wells-R128-Liudmila_Samsonova-Kateryna_Kozlova,1,S-DTM,1,0,0,0,0,1,0
20211006-W-Indian_Wells-R128-Liudmila_Samsonova-Kateryna_Kozlova,1,S-DTL,1,0,0,0,0,1,0
20211006-W-Indian_Wells-R128-Liudmila_Samsonova-Kateryna_Kozlova,1,S-IO,1,1,0,0,1,0,1
20211006-W-Indian_Wells-R128-Liudmila_Samsonova-Kateryna_Kozlova,2,F-XC,21,4,1,0,3,5,16
20211006-W-Indian_Wells-R128-Liudmila_Samsonova-Kateryna_Kozlova,2,F-DTM,37,6,0,0,6,15,22
20211006-W-Indian_Wells-R128-Liudmila_Samsonova-Kateryna_Kozlova,2,F-DTL,14,2,1,0,1,5,9
20211006-W-Indian_Wells-R128-Liudmila_Samsonova-Kateryna_Kozlova,2,F-IO,9,3,0,2,1,4,5
20211006-W-Indian_Wells-R128-Liudmila_Samsonova-Kateryna_Kozlova,2,B-XC,19,3,0,0,3,9,10
20211006-W-Indian_Wells-R128-Liudmila_Samsonova-Kateryna_Kozlova,2,B-DTM,27,2,0,1,1,16,11
20211006-W-Indian_Wells-R128-Liudmila_Samsonova-Kateryna_Kozlova,2,B-DTL,8,5,1,2,2,4,4
20211006-W-Indian_Wells-R128-Liudmila_Samsonova-Kateryna_Kozlova,2,B-IO,2,0,0,0,0,0,2
20211006-W-Indian_Wells-R128-Liudmila_Samsonova-Kateryna_Kozlova,2,S-XC,3,1,0,0,1,0,3
20211006-W-Indian_Wells-R128-Liudmila_Samsonova-Kateryna_Kozlova,2,S-DTM,5,1,0,0,1,2,3
20211006-W-Indian_Wells-R128-Liudmila_Samsonova-Kateryna_Kozlova,2,S-IO,3,0,0,0,0,1,2
20211008-W-Indian_Wells-R64-Tereza_Martincova-Elina_Svitolina,1,F-XC,20,5,1,0,4,5,15
20211008-W-Indian_Wells-R64-Tereza_Martincova-Elina_Svitolina,1,F-DTM,15,1,0,0,1,7,8
20211008-W-Indian_Wells-R64-Tereza_Martincova-Elina_Svitolina,1,F-DTL,11,4,2,1,1,5,6
20211008-W-Indian_Wells-R64-Tereza_Martincova-Elina_Svitolina,1,F-IO,13,4,0,2,2,5,8
20211008-W-Indian_Wells-R64-Tereza_Martincova-Elina_Svitolina,1,B-XC,23,5,3,0,2,7,16
20211008-W-Indian_Wells-R64-Tereza_Martincova-Elina_Svitolina,1,B-DTM,12,2,0,0,2,6,6
20211008-W-Indian_Wells-R64-Tereza_Martincova-Elina_Svitolina,1,B-DTL,4,1,0,0,1,1,3
20211008-W-Indian_Wells-R64-Tereza_Martincova-Elina_Svitolina,1,B-IO,4,1,0,0,1,1,3
20211008-W-Indian_Wells-R64-Tereza_Martincova-Elina_Svitolina,1,S-XC,1,0,0,0,0,1,0
20211008-W-Indian_Wells-R64-Tereza_Martincova-Elina_Svitolina,1,S-DTM,5,1,0,0,1,2,3
20211008-W-Indian_Wells-R64-Tereza_Martincova-Elina_Svitolina,1,S-DTL,6,1,0,0,1,0,6
20211008-W-Indian_Wells-R64-Tereza_Martincova-Elina_Svitolina,2,F-XC,27,7,2,0,5,16,11
20211008-W-Indian_Wells-R64-Tereza_Martincova-Elina_Svitolina,2,F-DTM,14,3,0,1,2,10,4
20211008-W-Indian_Wells-R64-Tereza_Martincova-Elina_Svitolina,2,F-DTL,7,5,4,1,0,7,0
20211008-W-Indian_Wells-R64-Tereza_Martincova-Elina_Svitolina,2,F-IO,10,4,0,2,2,4,6
20211008-W-Indian_Wells-R64-Tereza_Martincova-Elina_Svitolina,2,F-II,1,0,0,0,0,1,0
20211008-W-Indian_Wells-R64-Tereza_Martincova-Elina_Svitolina,2,B-XC,27,5,1,3,1,20,7
20211008-W-Indian_Wells-R64-Tereza_Martincova-Elina_Svitolina,2,B-DTM,10,0,0,0,0,7,3
20211008-W-Indian_Wells-R64-Tereza_Martincova-Elina_Svitolina,2,B-DTL,8,6,3,2,1,6,2
20211008-W-Indian_Wells-R64-Tereza_Martincova-Elina_Svitolina,2,B-IO,9,5,1,2,2,6,3
20211008-W-Indian_Wells-R64-Tereza_Martincova-Elina_Svitolina,2,S-XC,2,0,0,0,0,1,1
20211011-W-Indian_Wells-R32-Bianca_Andreescu-Anett_Kontaveit,1,F-XC,26,11,1,2,8,8,18
20211011-W-Indian_Wells-R32-Bianca_Andreescu-Anett_Kontaveit,1,F-DTM,43,6,0,2,4,20,23
20211011-W-Indian_Wells-R32-Bianca_Andreescu-Anett_Kontaveit,1,F-DTL,14,5,3,1,1,12,2
20211011-W-Indian_Wells-R32-Bianca_Andreescu-Anett_Kontaveit,1,F-IO,15,5,4,0,1,11,4
20211011-W-Indian_Wells-R32-Bianca_Andreescu-Anett_Kontaveit,1,F-II,1,1,0,1,0,1,0
20211011-W-Indian_Wells-R32-Bianca_Andreescu-Anett_Kontaveit,1,B-XC,22,7,1,0,6,12,10
20211011-W-Indian_Wells-R32-Bianca_Andreescu-Anett_Kontaveit,1,B-DTM,40,5,1,0,4,19,21
20211011-W-Indian_Wells-R32-Bianca_Andreescu-Anett_Kontaveit,1,B-DTL,9,2,1,1,0,6,3
20211011-W-Indian_Wells-R32-Bianca_Andreescu-Anett_Kontaveit,1,B-IO,12,7,4,3,0,9,3
20211011-W-Indian_Wells-R32-Bianca_Andreescu-Anett_Kontaveit,1,S-XC,1,0,0,0,0,0,1
20211011-W-Indian_Wells-R32-Bianca_Andreescu-Anett_Kontaveit,1,S-DTM,10,0,0,0,0,2,8
20211011-W-Indian_Wells-R32-Bianca_Andreescu-Anett_Kontaveit,1,S-DTL,4,2,0,0,2,1,3
20211011-W-Indian_Wells-R32-Bianca_Andreescu-Anett_Kontaveit,1,S-IO,2,1,0,0,1,0,2
20211011-W-Indian_Wells-R32-Bianca_Andreescu-Anett_Kontaveit,2,F-XC,53,18,6,5,7,27,26
20211011-W-Indian_Wells-R32-Bianca_Andreescu-Anett_Kontaveit,2,F-DTM,28,2,0,0,2,12,16
20211011-W-Indian_Wells-R32-Bianca_Andreescu-Anett_Kontaveit,2,F-DTL,6,3,1,2,0,6,0
20211011-W-Indian_Wells-R32-Bianca_Andreescu-Anett_Kontaveit,2,F-IO,4,2,1,0,1,3,1
20211011-W-Indian_Wells-R32-Bianca_Andreescu-Anett_Kontaveit,2,F-II,1,0,0,0,0,1,0
20211011-W-Indian_Wells-R32-Bianca_Andreescu-Anett_Kontaveit,2,B-XC,57,7,1,2,4,25,32
20211011-W-Indian_Wells-R32-Bianca_Andreescu-Anett_Kontaveit,2,B-DTM,33,3,0,0,3,14,19
20211011-W-Indian_Wells-R32-Bianca_Andreescu-Anett_Kontaveit,2,B-DTL,1,0,0,0,0,0,1
20211011-W-Indian_Wells-R32-Bianca_Andreescu-Anett_Kontaveit,2,B-IO,2,1,0,0,1,1,1
20211011-W-Indian_Wells-R32-Bianca_Andreescu-Anett_Kontaveit,2,S-XC,1,1,0,1,0,1,0
20211011-W-Indian_Wells-R32-Bianca_Andreescu-Anett_Kontaveit,2,S-DTM,3,0,0,0,0,0,3
20211006-W-Indian_Wells-R128-Jasmine_Paolini-Mai_Hontama,1,F-XC,59,17,6,3,8,35,24
20211006-W-Indian_Wells-R128-Jasmine_Paolini-Mai_Hontama,1,F-DTM,46,5,0,0,5,22,24
20211006-W-Indian_Wells-R128-Jasmine_Paolini-Mai_Hontama,1,F-DTL,9,3,1,1,1,5,4
20211006-W-Indian_Wells-R128-Jasmine_Paolini-Mai_Hontama,1,F-IO,30,9,5,0,4,19,11
20211006-W-Indian_Wells-R128-Jasmine_Paolini-Mai_Hontama,1,F-II,2,2,0,1,1,1,1
20211006-W-Indian_Wells-R128-Jasmine_Paolini-Mai_Hontama,1,B-XC,42,8,1,0,7,22,20
20211006-W-Indian_Wells-R128-Jasmine_Paolini-Mai_Hontama,1,B-DTM,29,3,0,0,3,14,15
20211006-W-Indian_Wells-R128-Jasmine_Paolini-Mai_Hontama,1,B-DTL,6,5,3,1,1,5,1
20211006-W-Indian_Wells-R128-Jasmine_Paolini-Mai_Hontama,1,S-XC,1,1,0,0,1,0,1
20211006-W-Indian_Wells-R128-Jasmine_Paolini-Mai_Hontama,1,S-DTL,1,0,0,0,0,1,0
20211006-W-Indian_Wells-R128-Jasmine_Paolini-Mai_Hontama,2,F-XC,48,14,3,3,8,20,28
20211006-W-Indian_Wells-R128-Jasmine_Paolini-Mai_Hontama,2,F-DTM,36,3,0,1,2,16,20
20211006-W-Indian_Wells-R128-Jasmine_Paolini-Mai_Hontama,2,F-DTL,8,4,0,0,4,2,6
20211006-W-Indian_Wells-R128-Jasmine_Paolini-Mai_Hontama,2,F-IO,14,8,1,3,4,7,7
20211006-W-Indian_Wells-R128-Jasmine_Paolini-Mai_Hontama,2,F-II,2,2,1,0,1,1,1
20211006-W-Indian_Wells-R128-Jasmine_Paolini-Mai_Hontama,2,B-XC,28,4,2,1,1,15,13
20211006-W-Indian_Wells-R128-Jasmine_Paolini-Mai_Hontama,2,B-DTM,38,3,0,0,3,14,24
20211006-W-Indian_Wells-R128-Jasmine_Paolini-Mai_Hontama,2,B-DTL,7,2,1,0,1,4,3
20211006-W-Indian_Wells-R128-Jasmine_Paolini-Mai_Hontama,2,B-IO,10,5,2,0,3,6,4
20211006-W-Indian_Wells-R128-Jasmine_Paolini-Mai_Hontama,2,S-XC,6,0,0,0,0,4,2
20211006-W-Indian_Wells-R128-Jasmine_Paolini-Mai_Hontama,2,S-DTM,14,3,0,0,3,5,9
20211011-W-Indian_Wells-R32-Karolina_Pliskova-Beatriz_Haddad_Maia,1,F-XC,84,22,4,5,13,41,43
20211011-W-Indian_Wells-R32-Karolina_Pliskova-Beatriz_Haddad_Maia,1,F-DTM,47,9,0,2,7,21,26
20211011-W-Indian_Wells-R32-Karolina_Pliskova-Beatriz_Haddad_Maia,1,F-DTL,6,4,3,0,1,4,2
20211011-W-Indian_Wells-R32-Karolina_Pliskova-Beatriz_Haddad_Maia,1,F-IO,26,8,4,2,2,17,9
20211011-W-Indian_Wells-R32-Karolina_Pliskova-Beatriz_Haddad_Maia,1,F-II,5,4,1,2,1,4,1
20211011-W-Indian_Wells-R32-Karolina_Pliskova-Beatriz_Haddad_Maia,1,B-XC,36,4,0,2,2,20,16
20211011-W-Indian_Wells-R32-Karolina_Pliskova-Beatriz_Haddad_Maia,1,B-DTM,56,3,0,0,3,35,21
20211011-W-Indian_Wells-R32-Karolina_Pliskova-Beatriz_Haddad_Maia,1,B-DTL,2,2,0,0,2,0,2
20211011-W-Indian_Wells-R32-Karolina_Pliskova-Beatriz_Haddad_Maia,1,B-IO,9,5,1,1,3,4,5
20211011-W-Indian_Wells-R32-Karolina_Pliskova-Beatriz_Haddad_Maia,1,S-XC,1,1,0,0,1,0,1
20211011-W-Indian_Wells-R32-Karolina_Pliskova-Beatriz_Haddad_Maia,1,S-DTM,3,0,0,0,0,0,3
20211011-W-Indian_Wells-R32-Karolina_Pliskova-Beatriz_Haddad_Maia,2,F-XC,60,10,2,1,7,24,36
20211011-W-Indian_Wells-R32-Karolina_Pliskova-Beatriz_Haddad_Maia,2,F-DTM,57,4,0,1,3,22,35
20211011-W-Indian_Wells-R32-Karolina_Pliskova-Beatriz_Haddad_Maia,2,F-DTL,6,5,3,1,1,4,2
20211011-W-Indian_Wells-R32-Karolina_Pliskova-Beatriz_Haddad_Maia,2,F-IO,14,6,3,2,1,8,6
20211011-W-Indian_Wells-R32-Karolina_Pliskova-Beatriz_Haddad_Maia,2,F-II,1,0,0,0,0,0,1
20211011-W-Indian_Wells-R32-Karolina_Pliskova-Beatriz_Haddad_Maia,2,B-XC,45,7,2,0,5,22,23
20211011-W-Indian_Wells-R32-Karolina_Pliskova-Beatriz_Haddad_Maia,2,B-DTM,62,3,0,1,2,29,33
20211011-W-Indian_Wells-R32-Karolina_Pliskova-Beatriz_Haddad_Maia,2,B-DTL,7,5,0,0,5,1,6
20211011-W-Indian_Wells-R32-Karolina_Pliskova-Beatriz_Haddad_Maia,2,B-IO,5,2,1,0,1,4,1
20211011-W-Indian_Wells-R32-Karolina_Pliskova-Beatriz_Haddad_Maia,2,S-XC,1,0,0,0,0,0,1
20211011-W-Indian_Wells-R32-Karolina_Pliskova-Beatriz_Haddad_Maia,2,S-DTM,3,0,0,0,0,2,1
20211011-W-Indian_Wells-R32-Karolina_Pliskova-Beatriz_Haddad_Maia,2,S-DTL,2,0,0,0,0,2,0
20211008-W-Indian_Wells-R64-Emma_Raducanu-Aliaksandra_Sasnovich,1,F-XC,42,13,2,3,8,18,24
20211008-W-Indian_Wells-R64-Emma_Raducanu-Aliaksandra_Sasnovich,1,F-DTM,20,0,0,0,0,10,10
20211008-W-Indian_Wells-R64-Emma_Raducanu-Aliaksandra_Sasnovich,1,F-DTL,7,2,0,0,2,3,4
20211008-W-Indian_Wells-R64-Emma_Raducanu-Aliaksandra_Sasnovich,1,F-IO,9,3,0,2,1,4,5
20211008-W-Indian_Wells-R64-Emma_Raducanu-Aliaksandra_Sasnovich,1,F-II,2,2,2,0,0,2,0
20211008-W-Indian_Wells-R64-Emma_Raducanu-Aliaksandra_Sasnovich,1,B-XC,28,6,0,1,5,9,19
20211008-W-Indian_Wells-R64-Emma_Raducanu-Aliaksandra_Sasnovich,1,B-DTM,29,1,0,0,1,15,14
20211008-W-Indian_Wells-R64-Emma_Raducanu-Aliaksandra_Sasnovich,1,B-DTL,7,1,0,0,1,3,4
20211008-W-Indian_Wells-R64-Emma_Raducanu-Aliaksandra_Sasnovich,1,B-IO,9,5,3,0,2,6,3
20211008-W-Indian_Wells-R64-Emma_Raducanu-Aliaksandra_Sasnovich,1,S-XC,2,0,0,0,0,0,2
20211008-W-Indian_Wells-R64-Emma_Raducanu-Aliaksandra_Sasnovich,1,S-DTM,2,0,0,0,0,0,2
20211008-W-Indian_Wells-R64-Emma_Raducanu-Aliaksandra_Sasnovich,1,S-DTL,1,1,0,0,1,0,1
20211008-W-Indian_Wells-R64-Emma_Raducanu-Aliaksandra_Sasnovich,2,F-XC,37,9,2,3,4,21,16
20211008-W-Indian_Wells-R64-Emma_Raducanu-Aliaksandra_Sasnovich,2,F-DTM,26,7,1,0,6,10,16
20211008-W-Indian_Wells-R64-Emma_Raducanu-Aliaksandra_Sasnovich,2,F-DTL,11,4,2,2,0,8,3
20211008-W-Indian_Wells-R64-Emma_Raducanu-Aliaksandra_Sasnovich,2,F-IO,6,1,0,0,1,3,3
20211008-W-Indian_Wells-R64-Emma_Raducanu-Aliaksandra_Sasnovich,2,B-XC,29,8,2,1,5,19,10
20211008-W-Indian_Wells-R64-Emma_Raducanu-Aliaksandra_Sasnovich,2,B-DTM,23,0,0,0,0,12,11
20211008-W-Indian_Wells-R64-Emma_Raducanu-Aliaksandra_Sasnovich,2,B-DTL,7,3,2,1,0,6,1
20211008-W-Indian_Wells-R64-Emma_Raducanu-Aliaksandra_Sasnovich,2,B-IO,3,1,0,0,1,1,2
20211008-W-Indian_Wells-R64-Emma_Raducanu-Aliaksandra_Sasnovich,2,S-XC,2,0,0,0,0,0,2
20211008-W-Indian_Wells-R64-Emma_Raducanu-Aliaksandra_Sasnovich,2,S-DTM,1,0,0,0,0,1,0
20211011-W-Indian_Wells-R32-Viktorija_Golubic-Anna_Kalinskaya,1,F-XC,56,9,3,2,4,28,28
20211011-W-Indian_Wells-R32-Viktorija_Golubic-Anna_Kalinskaya,1,F-DTM,39,3,0,0,3,17,22
20211011-W-Indian_Wells-R32-Viktorija_Golubic-Anna_Kalinskaya,1,F-DTL,10,5,0,3,2,4,6
20211011-W-Indian_Wells-R32-Viktorija_Golubic-Anna_Kalinskaya,1,F-IO,30,5,1,2,2,15,15
20211011-W-Indian_Wells-R32-Viktorija_Golubic-Anna_Kalinskaya,1,F-II,2,1,0,1,0,2,0
20211011-W-Indian_Wells-R32-Viktorija_Golubic-Anna_Kalinskaya,1,B-XC,48,10,3,0,7,21,27
20211011-W-Indian_Wells-R32-Viktorija_Golubic-Anna_Kalinskaya,1,B-DTM,37,2,0,1,1,15,22
20211011-W-Indian_Wells-R32-Viktorija_Golubic-Anna_Kalinskaya,1,B-DTL,7,6,1,1,4,3,4
20211011-W-Indian_Wells-R32-Viktorija_Golubic-Anna_Kalinskaya,1,B-IO,7,3,2,0,1,3,4
20211011-W-Indian_Wells-R32-Viktorija_Golubic-Anna_Kalinskaya,1,S-XC,33,5,2,2,1,20,13
20211011-W-Indian_Wells-R32-Viktorija_Golubic-Anna_Kalinskaya,1,S-DTM,23,2,0,0,2,12,11
20211011-W-Indian_Wells-R32-Viktorija_Golubic-Anna_Kalinskaya,1,S-DTL,4,0,0,0,0,1,3
20211011-W-Indian_Wells-R32-Viktorija_Golubic-Anna_Kalinskaya,2,F-XC,48,8,3,2,3,26,22
20211011-W-Indian_Wells-R32-Viktorija_Golubic-Anna_Kalinskaya,2,F-DTM,42,1,0,0,1,18,24
20211011-W-Indian_Wells-R32-Viktorija_Golubic-Anna_Kalinskaya,2,F-DTL,9,5,4,0,1,5,4
20211011-W-Indian_Wells-R32-Viktorija_Golubic-Anna_Kalinskaya,2,F-IO,20,8,6,1,1,12,8
20211011-W-Indian_Wells-R32-Viktorija_Golubic-Anna_Kalinskaya,2,B-XC,86,8,1,0,7,39,47
20211011-W-Indian_Wells-R32-Viktorija_Golubic-Anna_Kalinskaya,2,B-DTM,52,1,0,0,1,31,21
20211011-W-Indian_Wells-R32-Viktorija_Golubic-Anna_Kalinskaya,2,B-DTL,12,11,4,3,4,7,5
20211011-W-Indian_Wells-R32-Viktorija_Golubic-Anna_Kalinskaya,2,B-IO,9,4,2,0,2,5,4
20211011-W-Indian_Wells-R32-Viktorija_Golubic-Anna_Kalinskaya,2,S-XC,4,1,0,0,1,2,2
20211011-W-Indian_Wells-R32-Viktorija_Golubic-Anna_Kalinskaya,2,S-DTM,5,0,0,0,0,2,3
20211011-W-Indian_Wells-R32-Viktorija_Golubic-Anna_Kalinskaya,2,S-DTL,1,0,0,0,0,0,1
20211011-W-Indian_Wells-R32-Viktorija_Golubic-Anna_Kalinskaya,2,S-IO,1,0,0,0,0,1,0
20211019-W-Tenerife-R32-Arantxa_Rus-Viktorija_Golubic,1,F-XC,73,8,4,2,2,41,32
20211019-W-Tenerife-R32-Arantxa_Rus-Viktorija_Golubic,1,F-DTM,50,3,0,1,2,23,27
20211019-W-Tenerife-R32-Arantxa_Rus-Viktorija_Golubic,1,F-DTL,9,5,1,1,3,4,5
20211019-W-Tenerife-R32-Arantxa_Rus-Viktorija_Golubic,1,F-IO,26,9,3,0,6,13,13
20211019-W-Tenerife-R32-Arantxa_Rus-Viktorija_Golubic,1,F-II,3,1,0,1,0,1,2
20211019-W-Tenerife-R32-Arantxa_Rus-Viktorija_Golubic,1,B-XC,58,9,0,2,7,23,35
20211019-W-Tenerife-R32-Arantxa_Rus-Viktorija_Golubic,1,B-DTM,55,6,0,3,3,30,25
20211019-W-Tenerife-R32-Arantxa_Rus-Viktorija_Golubic,1,B-DTL,16,3,0,0,3,3,13
20211019-W-Tenerife-R32-Arantxa_Rus-Viktorija_Golubic,1,B-IO,12,6,2,0,4,6,6
20211019-W-Tenerife-R32-Arantxa_Rus-Viktorija_Golubic,1,S-XC,11,1,1,0,0,4,7
20211019-W-Tenerife-R32-Arantxa_Rus-Viktorija_Golubic,1,S-DTM,9,0,0,0,0,1,8
20211019-W-Tenerife-R32-Arantxa_Rus-Viktorija_Golubic,1,S-DTL,4,0,0,0,0,3,1
20211019-W-Tenerife-R32-Arantxa_Rus-Viktorija_Golubic,1,S-IO,2,1,0,0,1,1,1
20211019-W-Tenerife-R32-Arantxa_Rus-Viktorija_Golubic,2,F-XC,92,9,2,3,4,57,35
20211019-W-Tenerife-R32-Arantxa_Rus-Viktorija_Golubic,2,F-DTM,28,2,0,0,2,9,19
20211019-W-Tenerife-R32-Arantxa_Rus-Viktorija_Golubic,2,F-DTL,12,7,2,2,3,6,6
20211019-W-Tenerife-R32-Arantxa_Rus-Viktorija_Golubic,2,F-IO,9,3,1,0,2,5,4
20211019-W-Tenerife-R32-Arantxa_Rus-Viktorija_Golubic,2,B-XC,41,7,0,1,6,23,18
20211019-W-Tenerife-R32-Arantxa_Rus-Viktorija_Golubic,2,B-DTM,46,8,0,2,6,21,25
20211019-W-Tenerife-R32-Arantxa_Rus-Viktorija_Golubic,2,B-DTL,12,4,2,1,1,9,3
20211019-W-Tenerife-R32-Arantxa_Rus-Viktorija_Golubic,2,B-IO,16,3,0,0,3,9,7
20211019-W-Tenerife-R32-Arantxa_Rus-Viktorija_Golubic,2,S-XC,15,4,0,1,3,4,11
20211019-W-Tenerife-R32-Arantxa_Rus-Viktorija_Golubic,2,S-DTM,17,0,0,0,0,11,6
20211019-W-Tenerife-R32-Arantxa_Rus-Viktorija_Golubic,2,S-DTL,10,1,0,1,0,5,5
20211019-W-Tenerife-R32-Arantxa_Rus-Viktorija_Golubic,2,S-IO,2,0,0,0,0,1,1
20211026-W-Cluj_Napoca-R32-Kaja_Juvan-Jaqueline_Adina_Cristian,1,F-XC,55,16,2,2,12,22,33
20211026-W-Cluj_Napoca-R32-Kaja_Juvan-Jaqueline_Adina_Cristian,1,F-DTM,50,8,1,0,7,17,33
20211026-W-Cluj_Napoca-R32-Kaja_Juvan-Jaqueline_Adina_Cristian,1,F-DTL,13,9,4,3,2,10,3
20211026-W-Cluj_Napoca-R32-Kaja_Juvan-Jaqueline_Adina_Cristian,1,F-IO,23,13,4,3,6,10,13
20211026-W-Cluj_Napoca-R32-Kaja_Juvan-Jaqueline_Adina_Cristian,1,F-II,3,1,0,1,0,2,1
20211026-W-Cluj_Napoca-R32-Kaja_Juvan-Jaqueline_Adina_Cristian,1,B-XC,72,10,0,1,9,30,42
20211026-W-Cluj_Napoca-R32-Kaja_Juvan-Jaqueline_Adina_Cristian,1,B-DTM,75,5,0,0,5,29,46
20211026-W-Cluj_Napoca-R32-Kaja_Juvan-Jaqueline_Adina_Cristian,1,B-DTL,11,3,0,1,2,4,7
20211026-W-Cluj_Napoca-R32-Kaja_Juvan-Jaqueline_Adina_Cristian,1,B-IO,3,1,0,0,1,2,1
20211026-W-Cluj_Napoca-R32-Kaja_Juvan-Jaqueline_Adina_Cristian,1,S-XC,2,0,0,0,0,1,1
20211026-W-Cluj_Napoca-R32-Kaja_Juvan-Jaqueline_Adina_Cristian,1,S-DTM,6,0,0,0,0,3,3
20211026-W-Cluj_Napoca-R32-Kaja_Juvan-Jaqueline_Adina_Cristian,1,S-DTL,1,1,0,0,1,0,1
20211026-W-Cluj_Napoca-R32-Kaja_Juvan-Jaqueline_Adina_Cristian,1,S-IO,1,0,0,0,0,0,1
20211026-W-Cluj_Napoca-R32-Kaja_Juvan-Jaqueline_Adina_Cristian,2,F-XC,66,20,5,5,10,35,31
20211026-W-Cluj_Napoca-R32-Kaja_Juvan-Jaqueline_Adina_Cristian,2,F-DTM,32,1,0,0,1,20,12
20211026-W-Cluj_Napoca-R32-Kaja_Juvan-Jaqueline_Adina_Cristian,2,F-DTL,20,7,2,1,4,11,9
20211026-W-Cluj_Napoca-R32-Kaja_Juvan-Jaqueline_Adina_Cristian,2,F-IO,70,18,4,8,6,49,21
20211026-W-Cluj_Napoca-R32-Kaja_Juvan-Jaqueline_Adina_Cristian,2,F-II,2,0,0,0,0,2,0
20211026-W-Cluj_Napoca-R32-Kaja_Juvan-Jaqueline_Adina_Cristian,2,B-XC,63,11,0,2,9,32,31
20211026-W-Cluj_Napoca-R32-Kaja_Juvan-Jaqueline_Adina_Cristian,2,B-DTM,41,7,0,2,5,25,16
20211026-W-Cluj_Napoca-R32-Kaja_Juvan-Jaqueline_Adina_Cristian,2,B-DTL,15,9,2,3,4,10,5
20211026-W-Cluj_Napoca-R32-Kaja_Juvan-Jaqueline_Adina_Cristian,2,B-IO,8,5,0,2,3,4,4
20211026-W-Cluj_Napoca-R32-Kaja_Juvan-Jaqueline_Adina_Cristian,2,S-DTM,2,0,0,0,0,0,2
20210531-W-Roland_Garros-R128-Shelby_Rogers-Rebecca_Peterson,1,F-XC,67,20,5,5,10,31,36
20210531-W-Roland_Garros-R128-Shelby_Rogers-Rebecca_Peterson,1,F-DTM,50,5,0,1,4,24,26
20210531-W-Roland_Garros-R128-Shelby_Rogers-Rebecca_Peterson,1,F-DTL,17,8,5,2,1,12,5
20210531-W-Roland_Garros-R128-Shelby_Rogers-Rebecca_Peterson,1,F-IO,47,11,7,2,2,29,18
20210531-W-Roland_Garros-R128-Shelby_Rogers-Rebecca_Peterson,1,F-II,3,1,1,0,0,1,2
20210531-W-Roland_Garros-R128-Shelby_Rogers-Rebecca_Peterson,1,B-XC,93,12,4,0,8,41,52
20210531-W-Roland_Garros-R128-Shelby_Rogers-Rebecca_Peterson,1,B-DTM,48,5,0,0,5,23,25
20210531-W-Roland_Garros-R128-Shelby_Rogers-Rebecca_Peterson,1,B-DTL,13,6,2,0,4,5,8
20210531-W-Roland_Garros-R128-Shelby_Rogers-Rebecca_Peterson,1,B-IO,7,2,2,0,0,5,2
20210531-W-Roland_Garros-R128-Shelby_Rogers-Rebecca_Peterson,1,S-XC,4,0,0,0,0,1,3
20210531-W-Roland_Garros-R128-Shelby_Rogers-Rebecca_Peterson,1,S-DTM,8,0,0,0,0,4,4
20210531-W-Roland_Garros-R128-Shelby_Rogers-Rebecca_Peterson,1,S-DTL,1,0,0,0,0,0,1
20210531-W-Roland_Garros-R128-Shelby_Rogers-Rebecca_Peterson,1,S-IO,1,0,0,0,0,0,1
20210531-W-Roland_Garros-R128-Shelby_Rogers-Rebecca_Peterson,2,F-XC,67,15,2,3,10,32,35
20210531-W-Roland_Garros-R128-Shelby_Rogers-Rebecca_Peterson,2,F-DTM,51,4,0,1,3,25,26
20210531-W-Roland_Garros-R128-Shelby_Rogers-Rebecca_Peterson,2,F-DTL,23,8,2,2,4,14,9
20210531-W-Roland_Garros-R128-Shelby_Rogers-Rebecca_Peterson,2,F-IO,59,27,12,5,10,37,22
20210531-W-Roland_Garros-R128-Shelby_Rogers-Rebecca_Peterson,2,F-II,11,6,2,1,3,7,4
20210531-W-Roland_Garros-R128-Shelby_Rogers-Rebecca_Peterson,2,B-XC,68,10,2,1,7,33,35
20210531-W-Roland_Garros-R128-Shelby_Rogers-Rebecca_Peterson,2,B-DTM,41,6,1,0,5,16,25
20210531-W-Roland_Garros-R128-Shelby_Rogers-Rebecca_Peterson,2,B-DTL,9,4,1,1,2,5,4
20210531-W-Roland_Garros-R128-Shelby_Rogers-Rebecca_Peterson,2,B-IO,2,0,0,0,0,1,1
20210531-W-Roland_Garros-R128-Shelby_Rogers-Rebecca_Peterson,2,S-XC,13,1,0,0,1,7,6
20210531-W-Roland_Garros-R128-Shelby_Rogers-Rebecca_Peterson,2,S-DTM,12,1,0,0,1,4,8
20210531-W-Roland_Garros-R128-Shelby_Rogers-Rebecca_Peterson,2,S-DTL,2,1,0,0,1,0,2
20210531-W-Roland_Garros-R128-Shelby_Rogers-Rebecca_Peterson,2,S-IO,1,1,0,0,1,0,1
19931114-W-Philadelphia-F-Conchita_Martinez-Steffi_Graf,1,F-XC,18,7,2,2,3,9,9
19931114-W-Philadelphia-F-Conchita_Martinez-Steffi_Graf,1,F-DTM,12,0,0,0,0,2,10
19931114-W-Philadelphia-F-Conchita_Martinez-Steffi_Graf,1,F-DTL,25,4,2,0,2,13,12
19931114-W-Philadelphia-F-Conchita_Martinez-Steffi_Graf,1,F-IO,33,5,4,1,0,24,9
19931114-W-Philadelphia-F-Conchita_Martinez-Steffi_Graf,1,F-II,5,2,1,0,1,4,1
19931114-W-Philadelphia-F-Conchita_Martinez-Steffi_Graf,1,B-XC,21,6,3,1,2,13,8
19931114-W-Philadelphia-F-Conchita_Martinez-Steffi_Graf,1,B-DTM,6,0,0,0,0,1,5
19931114-W-Philadelphia-F-Conchita_Martinez-Steffi_Graf,1,B-DTL,7,5,2,0,3,3,4
19931114-W-Philadelphia-F-Conchita_Martinez-Steffi_Graf,1,S-XC,60,6,0,0,6,29,31
19931114-W-Philadelphia-F-Conchita_Martinez-Steffi_Graf,1,S-DTM,18,1,0,0,1,8,10
19931114-W-Philadelphia-F-Conchita_Martinez-Steffi_Graf,1,S-DTL,13,1,0,1,0,6,7
19931114-W-Philadelphia-F-Conchita_Martinez-Steffi_Graf,1,S-IO,3,1,1,0,0,1,2
19931114-W-Philadelphia-F-Conchita_Martinez-Steffi_Graf,2,F-XC,21,6,2,0,4,10,11
19931114-W-Philadelphia-F-Conchita_Martinez-Steffi_Graf,2,F-DTM,5,0,0,0,0,3,2
19931114-W-Philadelphia-F-Conchita_Martinez-Steffi_Graf,2,F-DTL,10,4,2,1,1,6,4
19931114-W-Philadelphia-F-Conchita_Martinez-Steffi_Graf,2,F-IO,27,6,1,4,1,15,12
19931114-W-Philadelphia-F-Conchita_Martinez-Steffi_Graf,2,F-II,9,2,0,1,1,5,4
19931114-W-Philadelphia-F-Conchita_Martinez-Steffi_Graf,2,B-XC,2,1,0,0,1,1,1
19931114-W-Philadelphia-F-Conchita_Martinez-Steffi_Graf,2,B-DTM,1,0,0,0,0,1,0
19931114-W-Philadelphia-F-Conchita_Martinez-Steffi_Graf,2,B-DTL,1,1,0,0,1,0,1
19931114-W-Philadelphia-F-Conchita_Martinez-Steffi_Graf,2,S-XC,93,13,1,3,9,42,51
19931114-W-Philadelphia-F-Conchita_Martinez-Steffi_Graf,2,S-DTM,18,2,0,0,2,8,10
19931114-W-Philadelphia-F-Conchita_Martinez-Steffi_Graf,2,S-DTL,25,6,0,0,6,9,16
19931114-W-Philadelphia-F-Conchita_Martinez-Steffi_Graf,2,S-IO,1,0,0,0,0,0,1
19960707-W-Wimbledon-SF-Steffi_Graf-Kimiko_Date_Krumm,1,F-XC,55,11,1,2,8,25,30
19960707-W-Wimbledon-SF-Steffi_Graf-Kimiko_Date_Krumm,1,F-DTM,30,4,0,0,4,6,24
19960707-W-Wimbledon-SF-Steffi_Graf-Kimiko_Date_Krumm,1,F-DTL,19,9,4,0,5,10,9
19960707-W-Wimbledon-SF-Steffi_Graf-Kimiko_Date_Krumm,1,F-IO,34,9,3,0,6,21,13
19960707-W-Wimbledon-SF-Steffi_Graf-Kimiko_Date_Krumm,1,F-II,2,0,0,0,0,1,1
19960707-W-Wimbledon-SF-Steffi_Graf-Kimiko_Date_Krumm,1,B-XC,3,0,0,0,0,0,3
19960707-W-Wimbledon-SF-Steffi_Graf-Kimiko_Date_Krumm,1,B-DTM,2,0,0,0,0,2,0
19960707-W-Wimbledon-SF-Steffi_Graf-Kimiko_Date_Krumm,1,B-DTL,2,2,1,0,1,1,1
19960707-W-Wimbledon-SF-Steffi_Graf-Kimiko_Date_Krumm,1,S-XC,33,4,1,1,2,21,12
19960707-W-Wimbledon-SF-Steffi_Graf-Kimiko_Date_Krumm,1,S-DTM,30,3,0,0,3,15,15
19960707-W-Wimbledon-SF-Steffi_Graf-Kimiko_Date_Krumm,1,S-DTL,22,1,0,0,1,7,15
19960707-W-Wimbledon-SF-Steffi_Graf-Kimiko_Date_Krumm,1,S-IO,5,1,0,0,1,3,2
19960707-W-Wimbledon-SF-Steffi_Graf-Kimiko_Date_Krumm,2,F-XC,56,12,4,3,5,31,25
19960707-W-Wimbledon-SF-Steffi_Graf-Kimiko_Date_Krumm,2,F-DTM,24,2,0,0,2,11,13
19960707-W-Wimbledon-SF-Steffi_Graf-Kimiko_Date_Krumm,2,F-DTL,29,14,4,3,7,17,12
19960707-W-Wimbledon-SF-Steffi_Graf-Kimiko_Date_Krumm,2,F-IO,12,5,3,0,2,6,6
19960707-W-Wimbledon-SF-Steffi_Graf-Kimiko_Date_Krumm,2,F-II,3,2,0,2,0,3,0
19960707-W-Wimbledon-SF-Steffi_Graf-Kimiko_Date_Krumm,2,B-XC,52,12,2,2,8,21,31
19960707-W-Wimbledon-SF-Steffi_Graf-Kimiko_Date_Krumm,2,B-DTM,33,6,1,0,5,18,15
19960707-W-Wimbledon-SF-Steffi_Graf-Kimiko_Date_Krumm,2,B-DTL,14,6,0,1,5,4,10
19960707-W-Wimbledon-SF-Steffi_Graf-Kimiko_Date_Krumm,2,B-IO,3,2,1,0,1,2,1
19960707-W-Wimbledon-SF-Steffi_Graf-Kimiko_Date_Krumm,2,S-XC,4,1,0,0,1,2,2
19960707-W-Wimbledon-SF-Steffi_Graf-Kimiko_Date_Krumm,2,S-DTM,1,0,0,0,0,0,1
19960707-W-Wimbledon-SF-Steffi_Graf-Kimiko_Date_Krumm,2,S-DTL,1,0,0,0,0,1,0
20211029-W-Cluj_Napoca-QF-Emma_Raducanu-Marta_Kostyuk,1,F-XC,20,7,1,1,5,8,12
20211029-W-Cluj_Napoca-QF-Emma_Raducanu-Marta_Kostyuk,1,F-DTM,6,2,0,1,1,4,2
20211029-W-Cluj_Napoca-QF-Emma_Raducanu-Marta_Kostyuk,1,F-DTL,7,6,2,1,3,3,4
20211029-W-Cluj_Napoca-QF-Emma_Raducanu-Marta_Kostyuk,1,F-IO,11,5,3,0,2,8,3
20211029-W-Cluj_Napoca-QF-Emma_Raducanu-Marta_Kostyuk,1,B-XC,27,11,2,1,8,10,17
20211029-W-Cluj_Napoca-QF-Emma_Raducanu-Marta_Kostyuk,1,B-DTM,10,3,0,1,2,5,5
20211029-W-Cluj_Napoca-QF-Emma_Raducanu-Marta_Kostyuk,1,B-DTL,5,3,1,1,1,4,1
20211029-W-Cluj_Napoca-QF-Emma_Raducanu-Marta_Kostyuk,1,B-IO,9,5,1,1,3,5,4
20211029-W-Cluj_Napoca-QF-Emma_Raducanu-Marta_Kostyuk,1,S-XC,2,0,0,0,0,1,1
20211029-W-Cluj_Napoca-QF-Emma_Raducanu-Marta_Kostyuk,1,S-DTM,3,0,0,0,0,0,3
20211029-W-Cluj_Napoca-QF-Emma_Raducanu-Marta_Kostyuk,2,F-XC,12,2,0,1,1,6,6
20211029-W-Cluj_Napoca-QF-Emma_Raducanu-Marta_Kostyuk,2,F-DTM,12,0,0,0,0,5,7
20211029-W-Cluj_Napoca-QF-Emma_Raducanu-Marta_Kostyuk,2,F-DTL,2,0,0,0,0,2,0
20211029-W-Cluj_Napoca-QF-Emma_Raducanu-Marta_Kostyuk,2,F-IO,9,2,2,0,0,6,3
20211029-W-Cluj_Napoca-QF-Emma_Raducanu-Marta_Kostyuk,2,B-XC,14,0,0,0,0,7,7
20211029-W-Cluj_Napoca-QF-Emma_Raducanu-Marta_Kostyuk,2,B-DTM,16,1,0,0,1,9,7
20211029-W-Cluj_Napoca-QF-Emma_Raducanu-Marta_Kostyuk,2,B-DTL,5,4,3,0,1,3,2
20211029-W-Cluj_Napoca-QF-Emma_Raducanu-Marta_Kostyuk,2,B-IO,3,1,0,0,1,2,1
20211029-W-Cluj_Napoca-QF-Emma_Raducanu-Marta_Kostyuk,2,S-DTM,3,0,0,0,0,2,1
20211029-W-Cluj_Napoca-QF-Emma_Raducanu-Marta_Kostyuk,2,S-DTL,1,0,0,0,0,0,1
20211028-W-Cluj_Napoca-R16-Emma_Raducanu-Ana_Bogdan,1,F-XC,38,7,1,1,5,20,18
20211028-W-Cluj_Napoca-R16-Emma_Raducanu-Ana_Bogdan,1,F-DTM,22,2,0,1,1,11,11
20211028-W-Cluj_Napoca-R16-Emma_Raducanu-Ana_Bogdan,1,F-DTL,10,5,2,1,2,6,4
20211028-W-Cluj_Napoca-R16-Emma_Raducanu-Ana_Bogdan,1,F-IO,10,6,3,1,2,7,3
20211028-W-Cluj_Napoca-R16-Emma_Raducanu-Ana_Bogdan,1,B-XC,42,6,1,1,4,24,18
20211028-W-Cluj_Napoca-R16-Emma_Raducanu-Ana_Bogdan,1,B-DTM,39,3,0,1,2,21,18
20211028-W-Cluj_Napoca-R16-Emma_Raducanu-Ana_Bogdan,1,B-DTL,12,4,0,1,3,5,7
20211028-W-Cluj_Napoca-R16-Emma_Raducanu-Ana_Bogdan,1,B-IO,7,3,2,0,1,4,3
20211028-W-Cluj_Napoca-R16-Emma_Raducanu-Ana_Bogdan,1,S-DTM,2,1,0,0,1,0,2
20211028-W-Cluj_Napoca-R16-Emma_Raducanu-Ana_Bogdan,1,S-DTL,1,0,0,0,0,1,0
20211028-W-Cluj_Napoca-R16-Emma_Raducanu-Ana_Bogdan,1,S-IO,1,1,0,1,0,1,0
20211028-W-Cluj_Napoca-R16-Emma_Raducanu-Ana_Bogdan,2,F-XC,46,10,1,2,7,20,26
20211028-W-Cluj_Napoca-R16-Emma_Raducanu-Ana_Bogdan,2,F-DTM,17,1,0,0,1,9,8
20211028-W-Cluj_Napoca-R16-Emma_Raducanu-Ana_Bogdan,2,F-DTL,6,2,0,1,1,3,3
20211028-W-Cluj_Napoca-R16-Emma_Raducanu-Ana_Bogdan,2,F-IO,8,2,0,0,2,4,4
20211028-W-Cluj_Napoca-R16-Emma_Raducanu-Ana_Bogdan,2,B-XC,61,12,6,2,4,29,32
20211028-W-Cluj_Napoca-R16-Emma_Raducanu-Ana_Bogdan,2,B-DTM,30,5,0,2,3,15,15
20211028-W-Cluj_Napoca-R16-Emma_Raducanu-Ana_Bogdan,2,B-DTL,6,4,1,0,3,1,5
20211028-W-Cluj_Napoca-R16-Emma_Raducanu-Ana_Bogdan,2,B-IO,5,2,0,0,2,1,4
20211028-W-Cluj_Napoca-R16-Emma_Raducanu-Ana_Bogdan,2,S-XC,1,0,0,0,0,1,0
20211028-W-Cluj_Napoca-R16-Emma_Raducanu-Ana_Bogdan,2,S-DTM,1,0,0,0,0,0,1
20211028-W-Cluj_Napoca-R16-Emma_Raducanu-Ana_Bogdan,2,S-IO,1,0,0,0,0,0,1
20210802-W-San_Jose-R32-Caroline_Garcia-Emina_Bektas,1,F-XC,34,15,7,2,6,19,15
20210802-W-San_Jose-R32-Caroline_Garcia-Emina_Bektas,1,F-DTM,29,3,1,0,2,18,11
20210802-W-San_Jose-R32-Caroline_Garcia-Emina_Bektas,1,F-DTL,3,3,3,0,0,3,0
20210802-W-San_Jose-R32-Caroline_Garcia-Emina_Bektas,1,F-IO,11,3,2,0,1,5,6
20210802-W-San_Jose-R32-Caroline_Garcia-Emina_Bektas,1,F-II,1,1,1,0,0,1,0
20210802-W-San_Jose-R32-Caroline_Garcia-Emina_Bektas,1,B-XC,21,6,5,1,0,17,4
20210802-W-San_Jose-R32-Caroline_Garcia-Emina_Bektas,1,B-DTM,16,3,0,1,2,10,6
20210802-W-San_Jose-R32-Caroline_Garcia-Emina_Bektas,1,B-DTL,1,1,1,0,0,1,0
20210802-W-San_Jose-R32-Caroline_Garcia-Emina_Bektas,1,B-IO,1,0,0,0,0,1,0
20210802-W-San_Jose-R32-Caroline_Garcia-Emina_Bektas,1,S-XC,1,0,0,0,0,0,1
20210802-W-San_Jose-R32-Caroline_Garcia-Emina_Bektas,1,S-DTM,1,0,0,0,0,0,1
20210802-W-San_Jose-R32-Caroline_Garcia-Emina_Bektas,1,S-IO,1,0,0,0,0,0,1
20210802-W-San_Jose-R32-Caroline_Garcia-Emina_Bektas,2,F-XC,35,15,3,3,9,15,20
20210802-W-San_Jose-R32-Caroline_Garcia-Emina_Bektas,2,F-DTM,27,3,0,0,3,12,15
20210802-W-San_Jose-R32-Caroline_Garcia-Emina_Bektas,2,F-DTL,2,0,0,0,0,0,2
20210802-W-San_Jose-R32-Caroline_Garcia-Emina_Bektas,2,F-IO,6,3,3,0,0,5,1
20210802-W-San_Jose-R32-Caroline_Garcia-Emina_Bektas,2,F-II,2,2,2,0,0,2,0
20210802-W-San_Jose-R32-Caroline_Garcia-Emina_Bektas,2,B-XC,7,1,0,0,1,2,5
20210802-W-San_Jose-R32-Caroline_Garcia-Emina_Bektas,2,B-DTM,20,4,0,0,4,7,13
20210802-W-San_Jose-R32-Caroline_Garcia-Emina_Bektas,2,B-DTL,7,4,2,1,1,5,2
20210802-W-San_Jose-R32-Caroline_Garcia-Emina_Bektas,2,B-IO,6,3,2,0,1,2,4
20210802-W-San_Jose-R32-Caroline_Garcia-Emina_Bektas,2,S-XC,5,2,0,0,2,1,4
20210802-W-San_Jose-R32-Caroline_Garcia-Emina_Bektas,2,S-DTM,4,1,0,0,1,1,3
20210802-W-San_Jose-R32-Caroline_Garcia-Emina_Bektas,2,S-DTL,2,2,1,1,0,2,0
20210802-W-San_Jose-R32-Shuai_Zhang-Emma_Raducanu,1,F-XC,43,5,2,0,3,27,16
20210802-W-San_Jose-R32-Shuai_Zhang-Emma_Raducanu,1,F-DTM,20,2,0,0,2,10,10
20210802-W-San_Jose-R32-Shuai_Zhang-Emma_Raducanu,1,F-DTL,7,4,2,1,1,5,2
20210802-W-San_Jose-R32-Shuai_Zhang-Emma_Raducanu,1,F-IO,13,3,2,0,1,9,4
20210802-W-San_Jose-R32-Shuai_Zhang-Emma_Raducanu,1,F-II,2,0,0,0,0,2,0
20210802-W-San_Jose-R32-Shuai_Zhang-Emma_Raducanu,1,B-XC,27,6,2,2,2,20,7
20210802-W-San_Jose-R32-Shuai_Zhang-Emma_Raducanu,1,B-DTM,25,3,0,0,3,10,15
20210802-W-San_Jose-R32-Shuai_Zhang-Emma_Raducanu,1,B-DTL,14,10,6,1,3,10,4
20210802-W-San_Jose-R32-Shuai_Zhang-Emma_Raducanu,1,B-IO,10,5,4,0,1,7,3
20210802-W-San_Jose-R32-Shuai_Zhang-Emma_Raducanu,1,S-XC,1,0,0,0,0,1,0
20210802-W-San_Jose-R32-Shuai_Zhang-Emma_Raducanu,1,S-DTM,2,0,0,0,0,0,2
20210802-W-San_Jose-R32-Shuai_Zhang-Emma_Raducanu,2,F-XC,42,9,3,2,4,20,22
20210802-W-San_Jose-R32-Shuai_Zhang-Emma_Raducanu,2,F-DTM,28,2,0,0,2,8,20
20210802-W-San_Jose-R32-Shuai_Zhang-Emma_Raducanu,2,F-DTL,16,8,0,1,7,5,11
20210802-W-San_Jose-R32-Shuai_Zhang-Emma_Raducanu,2,F-IO,12,4,1,2,1,7,5
20210802-W-San_Jose-R32-Shuai_Zhang-Emma_Raducanu,2,B-XC,24,6,3,0,3,10,14
20210802-W-San_Jose-R32-Shuai_Zhang-Emma_Raducanu,2,B-DTM,22,2,1,0,1,9,13
20210802-W-San_Jose-R32-Shuai_Zhang-Emma_Raducanu,2,B-DTL,3,2,1,0,1,1,2
20210802-W-San_Jose-R32-Shuai_Zhang-Emma_Raducanu,2,B-IO,5,1,0,0,1,1,4
20210802-W-San_Jose-R32-Shuai_Zhang-Emma_Raducanu,2,S-XC,6,0,0,0,0,1,5
20210802-W-San_Jose-R32-Shuai_Zhang-Emma_Raducanu,2,S-DTM,4,0,0,0,0,0,4
19940227-W-Indian_Wells-F-Steffi_Graf-Amanda_Coetzer,1,F-XC,40,12,2,5,5,26,14
19940227-W-Indian_Wells-F-Steffi_Graf-Amanda_Coetzer,1,F-DTM,8,0,0,0,0,7,1
19940227-W-Indian_Wells-F-Steffi_Graf-Amanda_Coetzer,1,F-DTL,7,2,0,0,2,4,3
19940227-W-Indian_Wells-F-Steffi_Graf-Amanda_Coetzer,1,F-IO,34,11,3,3,5,23,11
19940227-W-Indian_Wells-F-Steffi_Graf-Amanda_Coetzer,1,F-II,13,5,2,1,2,8,5
19940227-W-Indian_Wells-F-Steffi_Graf-Amanda_Coetzer,1,B-XC,2,0,0,0,0,2,0
19940227-W-Indian_Wells-F-Steffi_Graf-Amanda_Coetzer,1,B-DTM,2,0,0,0,0,0,2
19940227-W-Indian_Wells-F-Steffi_Graf-Amanda_Coetzer,1,S-XC,50,4,0,1,3,37,13
19940227-W-Indian_Wells-F-Steffi_Graf-Amanda_Coetzer,1,S-DTM,2,0,0,0,0,1,1
19940227-W-Indian_Wells-F-Steffi_Graf-Amanda_Coetzer,1,S-DTL,6,5,1,1,3,3,3
19940227-W-Indian_Wells-F-Steffi_Graf-Amanda_Coetzer,2,F-XC,16,2,0,1,1,6,10
19940227-W-Indian_Wells-F-Steffi_Graf-Amanda_Coetzer,2,F-DTM,22,2,0,0,2,8,14
19940227-W-Indian_Wells-F-Steffi_Graf-Amanda_Coetzer,2,F-DTL,9,0,0,0,0,2,7
19940227-W-Indian_Wells-F-Steffi_Graf-Amanda_Coetzer,2,F-IO,9,2,0,0,2,3,6
19940227-W-Indian_Wells-F-Steffi_Graf-Amanda_Coetzer,2,B-XC,54,6,1,0,5,13,41
19940227-W-Indian_Wells-F-Steffi_Graf-Amanda_Coetzer,2,B-DTM,26,2,0,0,2,4,22
19940227-W-Indian_Wells-F-Steffi_Graf-Amanda_Coetzer,2,B-DTL,3,1,0,0,1,1,2
19940227-W-Indian_Wells-F-Steffi_Graf-Amanda_Coetzer,2,B-IO,1,0,0,0,0,0,1
19940227-W-Indian_Wells-F-Steffi_Graf-Amanda_Coetzer,2,B-II,1,0,0,0,0,1,0
19940227-W-Indian_Wells-F-Steffi_Graf-Amanda_Coetzer,2,S-XC,11,1,0,0,1,7,4
19940227-W-Indian_Wells-F-Steffi_Graf-Amanda_Coetzer,2,S-DTM,3,0,0,0,0,1,2
19940227-W-Indian_Wells-F-Steffi_Graf-Amanda_Coetzer,2,S-DTL,1,1,0,0,1,0,1
19880306-W-San_Antonio-F-Steffi_Graf-Katerina_Maleeva,1,F-XC,37,13,3,5,5,22,15
19880306-W-San_Antonio-F-Steffi_Graf-Katerina_Maleeva,1,F-DTM,15,1,0,0,1,8,7
19880306-W-San_Antonio-F-Steffi_Graf-Katerina_Maleeva,1,F-DTL,5,4,1,0,3,1,4
19880306-W-San_Antonio-F-Steffi_Graf-Katerina_Maleeva,1,F-IO,27,9,3,2,4,16,11
19880306-W-San_Antonio-F-Steffi_Graf-Katerina_Maleeva,1,F-II,5,4,2,0,2,2,3
19880306-W-San_Antonio-F-Steffi_Graf-Katerina_Maleeva,1,B-XC,14,3,0,2,1,11,3
19880306-W-San_Antonio-F-Steffi_Graf-Katerina_Maleeva,1,B-DTM,1,0,0,0,0,1,0
19880306-W-San_Antonio-F-Steffi_Graf-Katerina_Maleeva,1,S-XC,42,5,2,2,1,31,11
19880306-W-San_Antonio-F-Steffi_Graf-Katerina_Maleeva,1,S-DTM,14,0,0,0,0,12,2
19880306-W-San_Antonio-F-Steffi_Graf-Katerina_Maleeva,1,S-DTL,6,2,0,2,0,5,1
19880306-W-San_Antonio-F-Steffi_Graf-Katerina_Maleeva,1,S-IO,3,0,0,0,0,2,1
19880306-W-San_Antonio-F-Steffi_Graf-Katerina_Maleeva,2,F-XC,23,3,0,1,2,11,12
19880306-W-San_Antonio-F-Steffi_Graf-Katerina_Maleeva,2,F-DTM,17,1,0,0,1,8,9
19880306-W-San_Antonio-F-Steffi_Graf-Katerina_Maleeva,2,F-DTL,13,4,0,0,4,2,11
19880306-W-San_Antonio-F-Steffi_Graf-Katerina_Maleeva,2,F-IO,9,1,0,0,1,1,8
19880306-W-San_Antonio-F-Steffi_Graf-Katerina_Maleeva,2,F-II,1,0,0,0,0,0,1
19880306-W-San_Antonio-F-Steffi_Graf-Katerina_Maleeva,2,B-XC,43,5,0,1,4,12,31
19880306-W-San_Antonio-F-Steffi_Graf-Katerina_Maleeva,2,B-DTM,15,1,0,0,1,6,9
19880306-W-San_Antonio-F-Steffi_Graf-Katerina_Maleeva,2,B-DTL,8,2,1,0,1,5,3
19880306-W-San_Antonio-F-Steffi_Graf-Katerina_Maleeva,2,B-IO,2,1,1,0,0,1,1
19880306-W-San_Antonio-F-Steffi_Graf-Katerina_Maleeva,2,S-XC,23,4,0,0,4,5,18
19880306-W-San_Antonio-F-Steffi_Graf-Katerina_Maleeva,2,S-DTM,5,0,0,0,0,2,3
19880306-W-San_Antonio-F-Steffi_Graf-Katerina_Maleeva,2,S-DTL,2,0,0,0,0,1,1
19880306-W-San_Antonio-F-Steffi_Graf-Katerina_Maleeva,2,S-IO,1,1,0,0,1,0,1
19900415-W-Amelia_Island-F-Steffi_Graf-Arantxa_Sanchez_Vicario,1,F-XC,24,10,5,3,2,20,4
19900415-W-Amelia_Island-F-Steffi_Graf-Arantxa_Sanchez_Vicario,1,F-DTM,4,0,0,0,0,3,1
19900415-W-Amelia_Island-F-Steffi_Graf-Arantxa_Sanchez_Vicario,1,F-DTL,12,3,0,1,2,10,2
19900415-W-Amelia_Island-F-Steffi_Graf-Arantxa_Sanchez_Vicario,1,F-IO,18,6,3,2,1,15,3
19900415-W-Amelia_Island-F-Steffi_Graf-Arantxa_Sanchez_Vicario,1,F-II,5,2,1,0,1,4,1
19900415-W-Amelia_Island-F-Steffi_Graf-Arantxa_Sanchez_Vicario,1,B-XC,3,1,0,1,0,2,1
19900415-W-Amelia_Island-F-Steffi_Graf-Arantxa_Sanchez_Vicario,1,B-DTM,2,1,0,0,1,1,1
19900415-W-Amelia_Island-F-Steffi_Graf-Arantxa_Sanchez_Vicario,1,B-DTL,5,2,1,0,1,4,1
19900415-W-Amelia_Island-F-Steffi_Graf-Arantxa_Sanchez_Vicario,1,S-XC,47,5,2,0,3,37,10
19900415-W-Amelia_Island-F-Steffi_Graf-Arantxa_Sanchez_Vicario,1,S-DTM,6,1,0,1,0,5,1
19900415-W-Amelia_Island-F-Steffi_Graf-Arantxa_Sanchez_Vicario,1,S-DTL,3,0,0,0,0,3,0
19900415-W-Amelia_Island-F-Steffi_Graf-Arantxa_Sanchez_Vicario,1,S-IO,1,0,0,0,0,1,0
19900415-W-Amelia_Island-F-Steffi_Graf-Arantxa_Sanchez_Vicario,2,F-XC,13,1,0,0,1,1,12
19900415-W-Amelia_Island-F-Steffi_Graf-Arantxa_Sanchez_Vicario,2,F-DTM,8,0,0,0,0,2,6
19900415-W-Amelia_Island-F-Steffi_Graf-Arantxa_Sanchez_Vicario,2,F-DTL,7,3,0,0,3,0,7
19900415-W-Amelia_Island-F-Steffi_Graf-Arantxa_Sanchez_Vicario,2,F-II,1,0,0,0,0,1,0
19900415-W-Amelia_Island-F-Steffi_Graf-Arantxa_Sanchez_Vicario,2,B-XC,38,8,0,0,8,7,31
19900415-W-Amelia_Island-F-Steffi_Graf-Arantxa_Sanchez_Vicario,2,B-DTM,15,3,0,0,3,2,13
19900415-W-Amelia_Island-F-Steffi_Graf-Arantxa_Sanchez_Vicario,2,B-DTL,4,1,0,1,0,1,3
19900415-W-Amelia_Island-F-Steffi_Graf-Arantxa_Sanchez_Vicario,2,B-IO,1,0,0,0,0,0,1
19900415-W-Amelia_Island-F-Steffi_Graf-Arantxa_Sanchez_Vicario,2,S-XC,18,2,0,1,1,3,15
19900415-W-Amelia_Island-F-Steffi_Graf-Arantxa_Sanchez_Vicario,2,S-DTM,9,1,0,0,1,0,9
19900415-W-Amelia_Island-F-Steffi_Graf-Arantxa_Sanchez_Vicario,2,S-DTL,3,0,0,0,0,2,1
19900415-W-Amelia_Island-F-Steffi_Graf-Arantxa_Sanchez_Vicario,2,S-IO,1,0,0,0,0,0,1
19900204-W-Tokyo-F-Steffi_Graf-Arantxa_Sanchez_Vicario,1,F-XC,38,15,9,4,2,30,8
19900204-W-Tokyo-F-Steffi_Graf-Arantxa_Sanchez_Vicario,1,F-DTM,9,4,0,0,4,4,5
19900204-W-Tokyo-F-Steffi_Graf-Arantxa_Sanchez_Vicario,1,F-DTL,3,1,1,0,0,1,2
19900204-W-Tokyo-F-Steffi_Graf-Arantxa_Sanchez_Vicario,1,F-IO,15,5,1,2,2,11,4
19900204-W-Tokyo-F-Steffi_Graf-Arantxa_Sanchez_Vicario,1,F-II,7,1,0,0,1,4,3
19900204-W-Tokyo-F-Steffi_Graf-Arantxa_Sanchez_Vicario,1,B-XC,4,1,1,0,0,3,1
19900204-W-Tokyo-F-Steffi_Graf-Arantxa_Sanchez_Vicario,1,S-XC,19,1,0,1,0,12,7
19900204-W-Tokyo-F-Steffi_Graf-Arantxa_Sanchez_Vicario,1,S-DTM,3,1,0,0,1,0,3
19900204-W-Tokyo-F-Steffi_Graf-Arantxa_Sanchez_Vicario,1,S-DTL,9,0,0,0,0,7,2
19900204-W-Tokyo-F-Steffi_Graf-Arantxa_Sanchez_Vicario,2,F-XC,26,5,0,3,2,8,18
19900204-W-Tokyo-F-Steffi_Graf-Arantxa_Sanchez_Vicario,2,F-DTM,11,1,0,0,1,3,8
19900204-W-Tokyo-F-Steffi_Graf-Arantxa_Sanchez_Vicario,2,F-DTL,14,5,1,2,2,7,7
19900204-W-Tokyo-F-Steffi_Graf-Arantxa_Sanchez_Vicario,2,F-IO,2,0,0,0,0,1,1
19900204-W-Tokyo-F-Steffi_Graf-Arantxa_Sanchez_Vicario,2,F-II,1,0,0,0,0,0,1
19900204-W-Tokyo-F-Steffi_Graf-Arantxa_Sanchez_Vicario,2,B-XC,23,4,1,0,3,9,14
19900204-W-Tokyo-F-Steffi_Graf-Arantxa_Sanchez_Vicario,2,B-DTM,9,2,0,0,2,2,7
19900204-W-Tokyo-F-Steffi_Graf-Arantxa_Sanchez_Vicario,2,B-DTL,3,2,0,1,1,1,2
19900204-W-Tokyo-F-Steffi_Graf-Arantxa_Sanchez_Vicario,2,B-IO,1,1,1,0,0,1,0
19900204-W-Tokyo-F-Steffi_Graf-Arantxa_Sanchez_Vicario,2,B-II,1,0,0,0,0,0,1
19900204-W-Tokyo-F-Steffi_Graf-Arantxa_Sanchez_Vicario,2,S-XC,5,0,0,0,0,0,5
19900204-W-Tokyo-F-Steffi_Graf-Arantxa_Sanchez_Vicario,2,S-DTM,3,0,0,0,0,2,1
19900204-W-Tokyo-F-Steffi_Graf-Arantxa_Sanchez_Vicario,2,S-DTL,5,2,1,0,1,3,2
19900812-W-San_Diego-F-Manuela_Maleeva_Fragniere-Steffi_Graf,1,F-XC,19,4,3,0,1,9,10
19900812-W-San_Diego-F-Manuela_Maleeva_Fragniere-Steffi_Graf,1,F-DTM,24,4,0,0,4,6,18
19900812-W-San_Diego-F-Manuela_Maleeva_Fragniere-Steffi_Graf,1,F-DTL,18,3,0,0,3,6,12
19900812-W-San_Diego-F-Manuela_Maleeva_Fragniere-Steffi_Graf,1,F-IO,13,1,0,1,0,5,8
19900812-W-San_Diego-F-Manuela_Maleeva_Fragniere-Steffi_Graf,1,B-XC,40,6,1,0,5,17,23
19900812-W-San_Diego-F-Manuela_Maleeva_Fragniere-Steffi_Graf,1,B-DTM,14,3,0,0,3,7,7
19900812-W-San_Diego-F-Manuela_Maleeva_Fragniere-Steffi_Graf,1,B-DTL,11,5,1,1,3,5,6
19900812-W-San_Diego-F-Manuela_Maleeva_Fragniere-Steffi_Graf,1,B-IO,2,1,1,0,0,2,0
19900812-W-San_Diego-F-Manuela_Maleeva_Fragniere-Steffi_Graf,1,S-XC,18,1,0,0,1,6,12
19900812-W-San_Diego-F-Manuela_Maleeva_Fragniere-Steffi_Graf,1,S-DTM,4,0,0,0,0,0,4
19900812-W-San_Diego-F-Manuela_Maleeva_Fragniere-Steffi_Graf,1,S-DTL,3,2,0,0,2,0,3
19900812-W-San_Diego-F-Manuela_Maleeva_Fragniere-Steffi_Graf,2,F-XC,32,9,2,2,5,20,12
19900812-W-San_Diego-F-Manuela_Maleeva_Fragniere-Steffi_Graf,2,F-DTM,11,0,0,0,0,9,2
19900812-W-San_Diego-F-Manuela_Maleeva_Fragniere-Steffi_Graf,2,F-DTL,7,2,0,1,1,2,5
19900812-W-San_Diego-F-Manuela_Maleeva_Fragniere-Steffi_Graf,2,F-IO,33,9,2,3,4,19,14
19900812-W-San_Diego-F-Manuela_Maleeva_Fragniere-Steffi_Graf,2,F-II,10,6,2,1,3,5,5
19900812-W-San_Diego-F-Manuela_Maleeva_Fragniere-Steffi_Graf,2,B-XC,6,2,1,0,1,4,2
19900812-W-San_Diego-F-Manuela_Maleeva_Fragniere-Steffi_Graf,2,B-DTM,1,0,0,0,0,1,0
19900812-W-San_Diego-F-Manuela_Maleeva_Fragniere-Steffi_Graf,2,B-IO,1,0,0,0,0,1,0
19900812-W-San_Diego-F-Manuela_Maleeva_Fragniere-Steffi_Graf,2,S-XC,36,2,0,0,2,22,14
19900812-W-San_Diego-F-Manuela_Maleeva_Fragniere-Steffi_Graf,2,S-DTM,13,1,0,0,1,4,9
19900812-W-San_Diego-F-Manuela_Maleeva_Fragniere-Steffi_Graf,2,S-DTL,14,3,2,1,0,8,6
19940724-W-Mahwah-F-Steffi_Graf-Lisa_Raymond,1,F-XC,31,10,6,1,3,19,12
19940724-W-Mahwah-F-Steffi_Graf-Lisa_Raymond,1,F-DTM,6,1,0,0,1,3,3
19940724-W-Mahwah-F-Steffi_Graf-Lisa_Raymond,1,F-DTL,8,5,2,1,2,5,3
19940724-W-Mahwah-F-Steffi_Graf-Lisa_Raymond,1,F-IO,11,4,1,1,2,8,3
19940724-W-Mahwah-F-Steffi_Graf-Lisa_Raymond,1,F-II,5,2,1,0,1,2,3
19940724-W-Mahwah-F-Steffi_Graf-Lisa_Raymond,1,B-XC,2,1,0,0,1,0,2
19940724-W-Mahwah-F-Steffi_Graf-Lisa_Raymond,1,B-DTM,4,2,0,0,2,0,4
19940724-W-Mahwah-F-Steffi_Graf-Lisa_Raymond,1,S-XC,32,6,1,1,4,12,20
19940724-W-Mahwah-F-Steffi_Graf-Lisa_Raymond,1,S-DTM,6,1,0,0,1,3,3
19940724-W-Mahwah-F-Steffi_Graf-Lisa_Raymond,1,S-DTL,7,4,0,2,2,3,4
19940724-W-Mahwah-F-Steffi_Graf-Lisa_Raymond,2,F-XC,19,9,2,5,2,12,7
19940724-W-Mahwah-F-Steffi_Graf-Lisa_Raymond,2,F-DTM,5,3,0,0,3,1,4
19940724-W-Mahwah-F-Steffi_Graf-Lisa_Raymond,2,F-DTL,15,7,4,0,3,7,8
19940724-W-Mahwah-F-Steffi_Graf-Lisa_Raymond,2,F-IO,7,3,0,1,2,4,3
19940724-W-Mahwah-F-Steffi_Graf-Lisa_Raymond,2,B-XC,5,2,1,1,0,3,2
19940724-W-Mahwah-F-Steffi_Graf-Lisa_Raymond,2,B-DTM,3,1,0,0,1,1,2
19940724-W-Mahwah-F-Steffi_Graf-Lisa_Raymond,2,B-DTL,2,2,0,0,2,0,2
19940724-W-Mahwah-F-Steffi_Graf-Lisa_Raymond,2,S-XC,31,4,0,1,3,19,12
19940724-W-Mahwah-F-Steffi_Graf-Lisa_Raymond,2,S-DTM,9,1,0,0,1,4,5
19940724-W-Mahwah-F-Steffi_Graf-Lisa_Raymond,2,S-DTL,9,5,1,1,3,4,5
19940724-W-Mahwah-F-Steffi_Graf-Lisa_Raymond,2,S-II,1,0,0,0,0,1,0
19901028-W-Brighton-F-Steffi_Graf-Helena_Sukova,1,F-XC,27,9,4,3,2,19,8
19901028-W-Brighton-F-Steffi_Graf-Helena_Sukova,1,F-DTM,12,2,0,0,2,5,7
19901028-W-Brighton-F-Steffi_Graf-Helena_Sukova,1,F-DTL,6,1,1,0,0,5,1
19901028-W-Brighton-F-Steffi_Graf-Helena_Sukova,1,F-IO,11,5,2,0,3,6,5
19901028-W-Brighton-F-Steffi_Graf-Helena_Sukova,1,F-II,2,1,0,1,0,1,1
19901028-W-Brighton-F-Steffi_Graf-Helena_Sukova,1,B-XC,12,4,3,0,1,10,2
19901028-W-Brighton-F-Steffi_Graf-Helena_Sukova,1,B-DTM,4,0,0,0,0,0,4
19901028-W-Brighton-F-Steffi_Graf-Helena_Sukova,1,B-DTL,3,3,2,0,1,2,1
19901028-W-Brighton-F-Steffi_Graf-Helena_Sukova,1,B-IO,1,1,1,0,0,1,0
19901028-W-Brighton-F-Steffi_Graf-Helena_Sukova,1,S-XC,35,3,0,1,2,22,13
19901028-W-Brighton-F-Steffi_Graf-Helena_Sukova,1,S-DTM,7,0,0,0,0,5,2
19901028-W-Brighton-F-Steffi_Graf-Helena_Sukova,1,S-DTL,16,4,0,1,3,8,8
19901028-W-Brighton-F-Steffi_Graf-Helena_Sukova,1,S-IO,2,0,0,0,0,1,1
19901028-W-Brighton-F-Steffi_Graf-Helena_Sukova,2,F-XC,17,2,1,1,0,9,8
19901028-W-Brighton-F-Steffi_Graf-Helena_Sukova,2,F-DTM,14,2,0,0,2,6,8
19901028-W-Brighton-F-Steffi_Graf-Helena_Sukova,2,F-DTL,16,2,0,0,2,5,11
19901028-W-Brighton-F-Steffi_Graf-Helena_Sukova,2,F-IO,8,5,1,1,3,3,5
19901028-W-Brighton-F-Steffi_Graf-Helena_Sukova,2,F-II,3,3,0,1,2,1,2
19901028-W-Brighton-F-Steffi_Graf-Helena_Sukova,2,B-XC,7,1,0,0,1,0,7
19901028-W-Brighton-F-Steffi_Graf-Helena_Sukova,2,B-DTM,3,0,0,0,0,1,2
19901028-W-Brighton-F-Steffi_Graf-Helena_Sukova,2,B-DTL,3,1,1,0,0,2,1
19901028-W-Brighton-F-Steffi_Graf-Helena_Sukova,2,S-XC,35,5,1,0,4,14,21
19901028-W-Brighton-F-Steffi_Graf-Helena_Sukova,2,S-DTM,11,1,0,1,0,5,6
19901028-W-Brighton-F-Steffi_Graf-Helena_Sukova,2,S-DTL,7,2,1,1,0,2,5
19901028-W-Brighton-F-Steffi_Graf-Helena_Sukova,2,S-IO,3,2,0,1,1,1,2
19900930-W-Leipzig-F-Steffi_Graf-Arantxa_Sanchez_Vicario,1,F-XC,35,6,1,3,2,24,11
19900930-W-Leipzig-F-Steffi_Graf-Arantxa_Sanchez_Vicario,1,F-DTM,7,1,0,1,0,3,4
19900930-W-Leipzig-F-Steffi_Graf-Arantxa_Sanchez_Vicario,1,F-DTL,6,4,2,0,2,3,3
19900930-W-Leipzig-F-Steffi_Graf-Arantxa_Sanchez_Vicario,1,F-IO,25,7,0,5,2,14,11
19900930-W-Leipzig-F-Steffi_Graf-Arantxa_Sanchez_Vicario,1,F-II,7,5,2,2,1,4,3
19900930-W-Leipzig-F-Steffi_Graf-Arantxa_Sanchez_Vicario,1,B-XC,5,1,0,0,1,3,2
19900930-W-Leipzig-F-Steffi_Graf-Arantxa_Sanchez_Vicario,1,B-DTL,2,1,1,0,0,1,1
19900930-W-Leipzig-F-Steffi_Graf-Arantxa_Sanchez_Vicario,1,B-IO,1,0,0,0,0,1,0
19900930-W-Leipzig-F-Steffi_Graf-Arantxa_Sanchez_Vicario,1,S-XC,30,3,0,0,3,12,18
19900930-W-Leipzig-F-Steffi_Graf-Arantxa_Sanchez_Vicario,1,S-DTM,12,0,0,0,0,5,7
19900930-W-Leipzig-F-Steffi_Graf-Arantxa_Sanchez_Vicario,1,S-DTL,9,4,1,1,2,4,5
19900930-W-Leipzig-F-Steffi_Graf-Arantxa_Sanchez_Vicario,1,S-IO,2,0,0,0,0,2,0
19900930-W-Leipzig-F-Steffi_Graf-Arantxa_Sanchez_Vicario,2,F-XC,12,3,0,0,3,4,8
19900930-W-Leipzig-F-Steffi_Graf-Arantxa_Sanchez_Vicario,2,F-DTM,19,1,0,0,1,10,9
19900930-W-Leipzig-F-Steffi_Graf-Arantxa_Sanchez_Vicario,2,F-DTL,14,2,1,0,1,3,11
19900930-W-Leipzig-F-Steffi_Graf-Arantxa_Sanchez_Vicario,2,F-IO,8,2,0,1,1,6,2
19900930-W-Leipzig-F-Steffi_Graf-Arantxa_Sanchez_Vicario,2,F-II,1,0,0,0,0,0,1
19900930-W-Leipzig-F-Steffi_Graf-Arantxa_Sanchez_Vicario,2,B-XC,34,4,1,1,2,19,15
19900930-W-Leipzig-F-Steffi_Graf-Arantxa_Sanchez_Vicario,2,B-DTM,11,3,0,0,3,2,9
19900930-W-Leipzig-F-Steffi_Graf-Arantxa_Sanchez_Vicario,2,B-DTL,7,5,1,1,3,4,3
19900930-W-Leipzig-F-Steffi_Graf-Arantxa_Sanchez_Vicario,2,B-IO,1,0,0,0,0,0,1
19900930-W-Leipzig-F-Steffi_Graf-Arantxa_Sanchez_Vicario,2,S-XC,14,0,0,0,0,9,5
19900930-W-Leipzig-F-Steffi_Graf-Arantxa_Sanchez_Vicario,2,S-DTM,6,2,0,0,2,1,5
19900930-W-Leipzig-F-Steffi_Graf-Arantxa_Sanchez_Vicario,2,S-DTL,9,2,0,0,2,5,4
19900930-W-Leipzig-F-Steffi_Graf-Arantxa_Sanchez_Vicario,2,S-IO,1,0,0,0,0,0,1
20211102-W-BJK_Cup_Finals-RR-Storm_Sanders-Elise_Mertens,1,F-XC,49,11,2,2,7,19,30
20211102-W-BJK_Cup_Finals-RR-Storm_Sanders-Elise_Mertens,1,F-DTM,29,1,0,0,1,17,12
20211102-W-BJK_Cup_Finals-RR-Storm_Sanders-Elise_Mertens,1,F-DTL,13,7,5,1,1,10,3
20211102-W-BJK_Cup_Finals-RR-Storm_Sanders-Elise_Mertens,1,F-IO,17,5,4,0,1,10,7
20211102-W-BJK_Cup_Finals-RR-Storm_Sanders-Elise_Mertens,1,F-II,2,1,1,0,0,2,0
20211102-W-BJK_Cup_Finals-RR-Storm_Sanders-Elise_Mertens,1,B-XC,48,13,5,2,6,29,19
20211102-W-BJK_Cup_Finals-RR-Storm_Sanders-Elise_Mertens,1,B-DTM,27,2,0,0,2,13,14
20211102-W-BJK_Cup_Finals-RR-Storm_Sanders-Elise_Mertens,1,B-DTL,3,2,1,1,0,2,1
20211102-W-BJK_Cup_Finals-RR-Storm_Sanders-Elise_Mertens,1,B-IO,6,6,3,1,2,4,2
20211102-W-BJK_Cup_Finals-RR-Storm_Sanders-Elise_Mertens,1,S-XC,1,0,0,0,0,1,0
20211102-W-BJK_Cup_Finals-RR-Storm_Sanders-Elise_Mertens,2,F-XC,37,8,3,2,3,17,20
20211102-W-BJK_Cup_Finals-RR-Storm_Sanders-Elise_Mertens,2,F-DTM,27,0,0,0,0,9,18
20211102-W-BJK_Cup_Finals-RR-Storm_Sanders-Elise_Mertens,2,F-DTL,15,6,2,0,4,7,8
20211102-W-BJK_Cup_Finals-RR-Storm_Sanders-Elise_Mertens,2,F-IO,23,8,1,2,5,9,14
20211102-W-BJK_Cup_Finals-RR-Storm_Sanders-Elise_Mertens,2,F-II,1,0,0,0,0,1,0
20211102-W-BJK_Cup_Finals-RR-Storm_Sanders-Elise_Mertens,2,B-XC,24,8,3,1,4,14,10
20211102-W-BJK_Cup_Finals-RR-Storm_Sanders-Elise_Mertens,2,B-DTM,20,4,0,0,4,8,12
20211102-W-BJK_Cup_Finals-RR-Storm_Sanders-Elise_Mertens,2,B-DTL,13,7,2,1,4,8,5
20211102-W-BJK_Cup_Finals-RR-Storm_Sanders-Elise_Mertens,2,B-IO,11,6,4,0,2,6,5
20211102-W-BJK_Cup_Finals-RR-Storm_Sanders-Elise_Mertens,2,S-DTM,7,0,0,0,0,6,1
20210723-W-Gdynia-QF-Kristina_Kucova-Ekaterine_Gorgodze,1,F-XC,142,31,14,3,14,71,71
20210723-W-Gdynia-QF-Kristina_Kucova-Ekaterine_Gorgodze,1,F-DTM,78,6,0,0,6,32,46
20210723-W-Gdynia-QF-Kristina_Kucova-Ekaterine_Gorgodze,1,F-DTL,21,12,8,1,3,14,7
20210723-W-Gdynia-QF-Kristina_Kucova-Ekaterine_Gorgodze,1,F-IO,65,20,12,2,6,30,35
20210723-W-Gdynia-QF-Kristina_Kucova-Ekaterine_Gorgodze,1,F-II,5,2,1,0,1,4,1
20210723-W-Gdynia-QF-Kristina_Kucova-Ekaterine_Gorgodze,1,B-XC,83,14,3,5,6,41,42
20210723-W-Gdynia-QF-Kristina_Kucova-Ekaterine_Gorgodze,1,B-DTM,107,7,0,3,4,56,51
20210723-W-Gdynia-QF-Kristina_Kucova-Ekaterine_Gorgodze,1,B-DTL,30,9,3,1,5,14,16
20210723-W-Gdynia-QF-Kristina_Kucova-Ekaterine_Gorgodze,1,B-IO,19,3,3,0,0,11,8
20210723-W-Gdynia-QF-Kristina_Kucova-Ekaterine_Gorgodze,1,S-XC,3,1,0,1,0,1,2
20210723-W-Gdynia-QF-Kristina_Kucova-Ekaterine_Gorgodze,1,S-DTM,5,0,0,0,0,3,2
20210723-W-Gdynia-QF-Kristina_Kucova-Ekaterine_Gorgodze,1,S-DTL,2,0,0,0,0,1,1
20210723-W-Gdynia-QF-Kristina_Kucova-Ekaterine_Gorgodze,2,F-XC,136,23,11,5,7,83,53
20210723-W-Gdynia-QF-Kristina_Kucova-Ekaterine_Gorgodze,2,F-DTM,76,3,0,0,3,36,40
20210723-W-Gdynia-QF-Kristina_Kucova-Ekaterine_Gorgodze,2,F-DTL,43,20,7,5,8,27,16
20210723-W-Gdynia-QF-Kristina_Kucova-Ekaterine_Gorgodze,2,F-IO,71,22,9,2,11,37,34
20210723-W-Gdynia-QF-Kristina_Kucova-Ekaterine_Gorgodze,2,F-II,2,0,0,0,0,0,2
20210723-W-Gdynia-QF-Kristina_Kucova-Ekaterine_Gorgodze,2,B-XC,36,3,1,1,1,20,16
20210723-W-Gdynia-QF-Kristina_Kucova-Ekaterine_Gorgodze,2,B-DTM,88,6,0,0,6,38,50
20210723-W-Gdynia-QF-Kristina_Kucova-Ekaterine_Gorgodze,2,B-DTL,30,11,1,2,8,12,18
20210723-W-Gdynia-QF-Kristina_Kucova-Ekaterine_Gorgodze,2,B-IO,42,6,4,1,1,18,24
20210723-W-Gdynia-QF-Kristina_Kucova-Ekaterine_Gorgodze,2,S-XC,3,1,0,0,1,2,1
20210723-W-Gdynia-QF-Kristina_Kucova-Ekaterine_Gorgodze,2,S-DTM,17,2,0,1,1,11,6
20210723-W-Gdynia-QF-Kristina_Kucova-Ekaterine_Gorgodze,2,S-DTL,4,0,0,0,0,3,1
20210723-W-Gdynia-QF-Kristina_Kucova-Ekaterine_Gorgodze,2,S-IO,2,1,0,0,1,0,2
19910414-W-Amelia_Island-F-Gabriela_Sabatini-Steffi_Graf,1,F-XC,30,6,1,2,3,12,18
19910414-W-Amelia_Island-F-Gabriela_Sabatini-Steffi_Graf,1,F-DTM,17,1,0,0,1,3,14
19910414-W-Amelia_Island-F-Gabriela_Sabatini-Steffi_Graf,1,F-DTL,38,1,1,0,0,21,17
19910414-W-Amelia_Island-F-Gabriela_Sabatini-Steffi_Graf,1,F-IO,23,2,1,0,1,10,13
19910414-W-Amelia_Island-F-Gabriela_Sabatini-Steffi_Graf,1,F-II,4,1,0,1,0,3,1
19910414-W-Amelia_Island-F-Gabriela_Sabatini-Steffi_Graf,1,B-XC,87,12,3,4,5,52,35
19910414-W-Amelia_Island-F-Gabriela_Sabatini-Steffi_Graf,1,B-DTM,12,3,0,0,3,5,7
19910414-W-Amelia_Island-F-Gabriela_Sabatini-Steffi_Graf,1,B-DTL,14,7,3,2,2,10,4
19910414-W-Amelia_Island-F-Gabriela_Sabatini-Steffi_Graf,1,S-XC,76,7,1,1,5,43,33
19910414-W-Amelia_Island-F-Gabriela_Sabatini-Steffi_Graf,1,S-DTM,12,4,1,0,3,4,8
19910414-W-Amelia_Island-F-Gabriela_Sabatini-Steffi_Graf,1,S-DTL,12,2,1,1,0,7,5
19910414-W-Amelia_Island-F-Gabriela_Sabatini-Steffi_Graf,2,F-XC,43,4,0,2,2,23,20
19910414-W-Amelia_Island-F-Gabriela_Sabatini-Steffi_Graf,2,F-DTM,12,0,0,0,0,5,7
19910414-W-Amelia_Island-F-Gabriela_Sabatini-Steffi_Graf,2,F-DTL,8,4,1,1,2,2,6
19910414-W-Amelia_Island-F-Gabriela_Sabatini-Steffi_Graf,2,F-IO,59,13,3,5,5,29,30
19910414-W-Amelia_Island-F-Gabriela_Sabatini-Steffi_Graf,2,F-II,20,6,1,3,2,12,8
19910414-W-Amelia_Island-F-Gabriela_Sabatini-Steffi_Graf,2,B-XC,5,1,0,1,0,4,1
19910414-W-Amelia_Island-F-Gabriela_Sabatini-Steffi_Graf,2,B-DTM,4,1,0,0,1,2,2
19910414-W-Amelia_Island-F-Gabriela_Sabatini-Steffi_Graf,2,B-DTL,3,2,1,0,1,1,2
19910414-W-Amelia_Island-F-Gabriela_Sabatini-Steffi_Graf,2,S-XC,124,10,0,1,9,46,78
19910414-W-Amelia_Island-F-Gabriela_Sabatini-Steffi_Graf,2,S-DTM,17,3,1,0,2,8,9
19910414-W-Amelia_Island-F-Gabriela_Sabatini-Steffi_Graf,2,S-DTL,28,7,2,2,3,13,15
19910414-W-Amelia_Island-F-Gabriela_Sabatini-Steffi_Graf,2,S-IO,2,0,0,0,0,2,0
20210830-W-US_Open-R128-Carla_Suarez_Navarro-Danielle_Collins,1,F-XC,5,1,1,0,0,2,3
20210830-W-US_Open-R128-Carla_Suarez_Navarro-Danielle_Collins,1,F-DTM,3,0,0,0,0,0,3
20210830-W-US_Open-R128-Carla_Suarez_Navarro-Danielle_Collins,1,F-DTL,2,1,0,1,0,1,1
20210830-W-US_Open-R128-Carla_Suarez_Navarro-Danielle_Collins,1,F-IO,8,1,1,0,0,6,2
20210830-W-US_Open-R128-Carla_Suarez_Navarro-Danielle_Collins,1,B-XC,2,0,0,0,0,1,1
20210830-W-US_Open-R128-Carla_Suarez_Navarro-Danielle_Collins,1,B-DTM,7,1,0,0,1,4,3
20210830-W-US_Open-R128-Carla_Suarez_Navarro-Danielle_Collins,1,B-DTL,1,1,0,0,1,0,1
20210830-W-US_Open-R128-Carla_Suarez_Navarro-Danielle_Collins,1,S-XC,4,0,0,0,0,2,2
20210830-W-US_Open-R128-Carla_Suarez_Navarro-Danielle_Collins,1,S-DTM,5,0,0,0,0,1,4
20210830-W-US_Open-R128-Carla_Suarez_Navarro-Danielle_Collins,1,S-DTL,2,1,0,1,0,1,1
20210830-W-US_Open-R128-Carla_Suarez_Navarro-Danielle_Collins,1,S-IO,1,0,0,0,0,0,1
20210830-W-US_Open-R128-Carla_Suarez_Navarro-Danielle_Collins,2,F-XC,9,4,4,0,0,8,1
20210830-W-US_Open-R128-Carla_Suarez_Navarro-Danielle_Collins,2,F-DTM,2,0,0,0,0,1,1
20210830-W-US_Open-R128-Carla_Suarez_Navarro-Danielle_Collins,2,F-DTL,3,3,3,0,0,3,0
20210830-W-US_Open-R128-Carla_Suarez_Navarro-Danielle_Collins,2,F-IO,1,1,1,0,0,1,0
20210830-W-US_Open-R128-Carla_Suarez_Navarro-Danielle_Collins,2,B-XC,18,11,4,0,7,9,9
20210830-W-US_Open-R128-Carla_Suarez_Navarro-Danielle_Collins,2,B-DTM,7,2,1,1,0,5,2
20210830-W-US_Open-R128-Carla_Suarez_Navarro-Danielle_Collins,2,B-DTL,3,3,1,0,2,1,2
20210830-W-US_Open-R128-Carla_Suarez_Navarro-Danielle_Collins,2,B-IO,5,5,3,0,2,3,2
19911006-W-Leipzig-F-Jana_Novotna-Steffi_Graf,1,F-XC,11,1,0,0,1,2,9
19911006-W-Leipzig-F-Jana_Novotna-Steffi_Graf,1,F-DTM,4,1,0,0,1,1,3
19911006-W-Leipzig-F-Jana_Novotna-Steffi_Graf,1,F-DTL,6,0,0,0,0,3,3
19911006-W-Leipzig-F-Jana_Novotna-Steffi_Graf,1,F-IO,2,1,0,0,1,1,1
19911006-W-Leipzig-F-Jana_Novotna-Steffi_Graf,1,F-II,1,1,0,1,0,1,0
19911006-W-Leipzig-F-Jana_Novotna-Steffi_Graf,1,B-XC,1,0,0,0,0,1,0
19911006-W-Leipzig-F-Jana_Novotna-Steffi_Graf,1,B-DTL,1,1,0,1,0,1,0
19911006-W-Leipzig-F-Jana_Novotna-Steffi_Graf,1,S-XC,24,1,0,0,1,9,15
19911006-W-Leipzig-F-Jana_Novotna-Steffi_Graf,1,S-DTM,12,0,0,0,0,3,9
19911006-W-Leipzig-F-Jana_Novotna-Steffi_Graf,1,S-DTL,7,0,0,0,0,1,6
19911006-W-Leipzig-F-Jana_Novotna-Steffi_Graf,1,S-IO,1,1,1,0,0,1,0
19911006-W-Leipzig-F-Jana_Novotna-Steffi_Graf,2,F-XC,14,5,3,2,0,12,2
19911006-W-Leipzig-F-Jana_Novotna-Steffi_Graf,2,F-DTM,10,0,0,0,0,6,4
19911006-W-Leipzig-F-Jana_Novotna-Steffi_Graf,2,F-DTL,10,6,4,1,1,7,3
19911006-W-Leipzig-F-Jana_Novotna-Steffi_Graf,2,F-IO,34,13,6,3,4,26,8
19911006-W-Leipzig-F-Jana_Novotna-Steffi_Graf,2,F-II,9,5,2,1,2,6,3
19911006-W-Leipzig-F-Jana_Novotna-Steffi_Graf,2,B-XC,4,3,0,0,3,1,3
19911006-W-Leipzig-F-Jana_Novotna-Steffi_Graf,2,B-DTM,2,1,0,1,0,2,0
19911006-W-Leipzig-F-Jana_Novotna-Steffi_Graf,2,B-DTL,1,1,1,0,0,1,0
19911006-W-Leipzig-F-Jana_Novotna-Steffi_Graf,2,S-XC,11,3,2,0,1,6,5
19911006-W-Leipzig-F-Jana_Novotna-Steffi_Graf,2,S-DTM,3,2,0,0,2,0,3
19911006-W-Leipzig-F-Jana_Novotna-Steffi_Graf,2,S-DTL,2,0,0,0,0,1,1
20211019-W-Tenerife-R32-Varvara_Gracheva-Sara_Sorribes_Tormo,1,F-XC,172,26,7,4,15,75,97
20211019-W-Tenerife-R32-Varvara_Gracheva-Sara_Sorribes_Tormo,1,F-DTM,64,5,0,1,4,34,30
20211019-W-Tenerife-R32-Varvara_Gracheva-Sara_Sorribes_Tormo,1,F-DTL,26,11,5,1,5,11,15
20211019-W-Tenerife-R32-Varvara_Gracheva-Sara_Sorribes_Tormo,1,F-IO,62,22,7,3,12,26,36
20211019-W-Tenerife-R32-Varvara_Gracheva-Sara_Sorribes_Tormo,1,F-II,10,4,1,2,1,6,4
20211019-W-Tenerife-R32-Varvara_Gracheva-Sara_Sorribes_Tormo,1,B-XC,212,24,6,5,13,103,109
20211019-W-Tenerife-R32-Varvara_Gracheva-Sara_Sorribes_Tormo,1,B-DTM,41,3,0,0,3,16,25
20211019-W-Tenerife-R32-Varvara_Gracheva-Sara_Sorribes_Tormo,1,B-DTL,23,9,4,2,3,13,10
20211019-W-Tenerife-R32-Varvara_Gracheva-Sara_Sorribes_Tormo,1,B-IO,27,8,4,2,2,14,13
20211019-W-Tenerife-R32-Varvara_Gracheva-Sara_Sorribes_Tormo,1,S-XC,8,2,0,0,2,1,7
20211019-W-Tenerife-R32-Varvara_Gracheva-Sara_Sorribes_Tormo,1,S-DTM,8,2,0,0,2,1,7
20211019-W-Tenerife-R32-Varvara_Gracheva-Sara_Sorribes_Tormo,1,S-IO,4,0,0,0,0,2,2
20211019-W-Tenerife-R32-Varvara_Gracheva-Sara_Sorribes_Tormo,2,F-XC,67,3,0,1,2,38,29
20211019-W-Tenerife-R32-Varvara_Gracheva-Sara_Sorribes_Tormo,2,F-DTM,110,4,0,1,3,58,52
20211019-W-Tenerife-R32-Varvara_Gracheva-Sara_Sorribes_Tormo,2,F-DTL,50,10,4,3,3,31,19
20211019-W-Tenerife-R32-Varvara_Gracheva-Sara_Sorribes_Tormo,2,F-IO,51,2,1,0,1,26,25
20211019-W-Tenerife-R32-Varvara_Gracheva-Sara_Sorribes_Tormo,2,F-II,3,1,0,1,0,1,2
20211019-W-Tenerife-R32-Varvara_Gracheva-Sara_Sorribes_Tormo,2,B-XC,27,5,1,2,2,17,10
20211019-W-Tenerife-R32-Varvara_Gracheva-Sara_Sorribes_Tormo,2,B-DTM,64,4,0,1,3,33,31
20211019-W-Tenerife-R32-Varvara_Gracheva-Sara_Sorribes_Tormo,2,B-DTL,13,3,2,1,0,9,4
20211019-W-Tenerife-R32-Varvara_Gracheva-Sara_Sorribes_Tormo,2,S-XC,69,2,0,0,2,32,37
20211019-W-Tenerife-R32-Varvara_Gracheva-Sara_Sorribes_Tormo,2,S-DTM,90,4,0,1,3,50,40
20211019-W-Tenerife-R32-Varvara_Gracheva-Sara_Sorribes_Tormo,2,S-DTL,17,2,0,0,2,6,11
20211019-W-Tenerife-R32-Varvara_Gracheva-Sara_Sorribes_Tormo,2,S-IO,10,1,0,0,1,7,3
19880731-W-Hamburg-F-Steffi_Graf-Katerina_Maleeva,1,F-XC,42,13,5,5,3,29,13
19880731-W-Hamburg-F-Steffi_Graf-Katerina_Maleeva,1,F-DTM,12,1,1,0,0,6,6
19880731-W-Hamburg-F-Steffi_Graf-Katerina_Maleeva,1,F-DTL,12,5,2,0,3,7,5
19880731-W-Hamburg-F-Steffi_Graf-Katerina_Maleeva,1,F-IO,28,6,1,5,0,21,7
19880731-W-Hamburg-F-Steffi_Graf-Katerina_Maleeva,1,F-II,6,3,1,1,1,5,1
19880731-W-Hamburg-F-Steffi_Graf-Katerina_Maleeva,1,B-XC,25,3,1,0,2,18,7
19880731-W-Hamburg-F-Steffi_Graf-Katerina_Maleeva,1,B-DTM,3,0,0,0,0,2,1
19880731-W-Hamburg-F-Steffi_Graf-Katerina_Maleeva,1,B-DTL,2,0,0,0,0,2,0
19880731-W-Hamburg-F-Steffi_Graf-Katerina_Maleeva,1,S-XC,86,7,1,2,4,60,26
19880731-W-Hamburg-F-Steffi_Graf-Katerina_Maleeva,1,S-DTM,20,3,0,0,3,7,13
19880731-W-Hamburg-F-Steffi_Graf-Katerina_Maleeva,1,S-DTL,24,0,0,0,0,17,7
19880731-W-Hamburg-F-Steffi_Graf-Katerina_Maleeva,1,S-IO,4,0,0,0,0,3,1
19880731-W-Hamburg-F-Steffi_Graf-Katerina_Maleeva,2,F-XC,40,4,0,0,4,16,24
19880731-W-Hamburg-F-Steffi_Graf-Katerina_Maleeva,2,F-DTM,19,1,0,0,1,9,10
19880731-W-Hamburg-F-Steffi_Graf-Katerina_Maleeva,2,F-DTL,29,4,0,0,4,8,21
19880731-W-Hamburg-F-Steffi_Graf-Katerina_Maleeva,2,F-IO,12,2,1,0,1,5,7
19880731-W-Hamburg-F-Steffi_Graf-Katerina_Maleeva,2,F-II,5,3,1,1,1,3,2
19880731-W-Hamburg-F-Steffi_Graf-Katerina_Maleeva,2,B-XC,87,4,0,0,4,27,60
19880731-W-Hamburg-F-Steffi_Graf-Katerina_Maleeva,2,B-DTM,21,0,0,0,0,7,14
19880731-W-Hamburg-F-Steffi_Graf-Katerina_Maleeva,2,B-DTL,15,7,0,3,4,4,11
19880731-W-Hamburg-F-Steffi_Graf-Katerina_Maleeva,2,B-IO,2,1,0,0,1,0,2
19880731-W-Hamburg-F-Steffi_Graf-Katerina_Maleeva,2,S-XC,35,3,1,0,2,8,27
19880731-W-Hamburg-F-Steffi_Graf-Katerina_Maleeva,2,S-DTM,7,1,0,0,1,1,6
19880731-W-Hamburg-F-Steffi_Graf-Katerina_Maleeva,2,S-DTL,5,0,0,0,0,1,4
19880731-W-Hamburg-F-Steffi_Graf-Katerina_Maleeva,2,S-IO,1,0,0,0,0,0,1
20211026-W-Cluj_Napoca-R32-Emma_Raducanu-Polona_Hercog,1,F-XC,49,10,3,1,6,27,22
20211026-W-Cluj_Napoca-R32-Emma_Raducanu-Polona_Hercog,1,F-DTM,40,2,0,0,2,20,20
20211026-W-Cluj_Napoca-R32-Emma_Raducanu-Polona_Hercog,1,F-DTL,18,11,2,3,6,10,8
20211026-W-Cluj_Napoca-R32-Emma_Raducanu-Polona_Hercog,1,F-IO,26,9,6,0,3,15,11
20211026-W-Cluj_Napoca-R32-Emma_Raducanu-Polona_Hercog,1,F-II,1,0,0,0,0,1,0
20211026-W-Cluj_Napoca-R32-Emma_Raducanu-Polona_Hercog,1,B-XC,46,8,1,2,5,26,20
20211026-W-Cluj_Napoca-R32-Emma_Raducanu-Polona_Hercog,1,B-DTM,28,5,0,1,4,13,15
20211026-W-Cluj_Napoca-R32-Emma_Raducanu-Polona_Hercog,1,B-DTL,20,10,3,2,5,9,11
20211026-W-Cluj_Napoca-R32-Emma_Raducanu-Polona_Hercog,1,B-IO,10,3,1,0,2,5,5
20211026-W-Cluj_Napoca-R32-Emma_Raducanu-Polona_Hercog,1,S-XC,4,1,1,0,0,2,2
20211026-W-Cluj_Napoca-R32-Emma_Raducanu-Polona_Hercog,1,S-DTM,1,0,0,0,0,0,1
20211026-W-Cluj_Napoca-R32-Emma_Raducanu-Polona_Hercog,1,S-DTL,2,0,0,0,0,2,0
20211026-W-Cluj_Napoca-R32-Emma_Raducanu-Polona_Hercog,1,S-IO,1,1,0,1,0,1,0
20211026-W-Cluj_Napoca-R32-Emma_Raducanu-Polona_Hercog,2,F-XC,63,21,3,5,13,32,31
20211026-W-Cluj_Napoca-R32-Emma_Raducanu-Polona_Hercog,2,F-DTM,49,4,1,0,3,21,28
20211026-W-Cluj_Napoca-R32-Emma_Raducanu-Polona_Hercog,2,F-DTL,9,6,1,0,5,3,6
20211026-W-Cluj_Napoca-R32-Emma_Raducanu-Polona_Hercog,2,F-IO,24,7,1,1,5,14,10
20211026-W-Cluj_Napoca-R32-Emma_Raducanu-Polona_Hercog,2,F-II,6,3,1,0,2,2,4
20211026-W-Cluj_Napoca-R32-Emma_Raducanu-Polona_Hercog,2,B-XC,25,0,0,0,0,12,13
20211026-W-Cluj_Napoca-R32-Emma_Raducanu-Polona_Hercog,2,B-DTM,21,1,0,0,1,7,14
20211026-W-Cluj_Napoca-R32-Emma_Raducanu-Polona_Hercog,2,B-DTL,4,2,0,1,1,2,2
20211026-W-Cluj_Napoca-R32-Emma_Raducanu-Polona_Hercog,2,B-IO,2,0,0,0,0,1,1
20211026-W-Cluj_Napoca-R32-Emma_Raducanu-Polona_Hercog,2,S-XC,17,0,0,0,0,9,8
20211026-W-Cluj_Napoca-R32-Emma_Raducanu-Polona_Hercog,2,S-DTM,11,0,0,0,0,5,6
20211026-W-Cluj_Napoca-R32-Emma_Raducanu-Polona_Hercog,2,S-DTL,1,0,0,0,0,0,1
20211026-W-Cluj_Napoca-R32-Emma_Raducanu-Polona_Hercog,2,S-IO,1,1,0,0,1,0,1
20210602-W-Roland_Garros-R64-Veronika_Kudermetova-Katerina_Siniakova,1,F-XC,77,26,6,6,14,37,40
20210602-W-Roland_Garros-R64-Veronika_Kudermetova-Katerina_Siniakova,1,F-DTM,27,3,0,0,3,14,13
20210602-W-Roland_Garros-R64-Veronika_Kudermetova-Katerina_Siniakova,1,F-DTL,18,13,7,1,5,11,7
20210602-W-Roland_Garros-R64-Veronika_Kudermetova-Katerina_Siniakova,1,F-IO,30,9,3,3,3,15,15
20210602-W-Roland_Garros-R64-Veronika_Kudermetova-Katerina_Siniakova,1,B-XC,34,10,3,2,5,15,19
20210602-W-Roland_Garros-R64-Veronika_Kudermetova-Katerina_Siniakova,1,B-DTM,30,4,0,0,4,12,18
20210602-W-Roland_Garros-R64-Veronika_Kudermetova-Katerina_Siniakova,1,B-DTL,14,7,1,0,6,4,10
20210602-W-Roland_Garros-R64-Veronika_Kudermetova-Katerina_Siniakova,1,B-IO,14,6,2,0,4,5,9
20210602-W-Roland_Garros-R64-Veronika_Kudermetova-Katerina_Siniakova,1,S-XC,10,0,0,0,0,3,7
20210602-W-Roland_Garros-R64-Veronika_Kudermetova-Katerina_Siniakova,1,S-DTM,7,1,0,0,1,2,5
20210602-W-Roland_Garros-R64-Veronika_Kudermetova-Katerina_Siniakova,1,S-DTL,2,0,0,0,0,1,1
20210602-W-Roland_Garros-R64-Veronika_Kudermetova-Katerina_Siniakova,1,S-IO,1,1,0,0,1,0,1
20210602-W-Roland_Garros-R64-Veronika_Kudermetova-Katerina_Siniakova,2,F-XC,60,12,2,0,10,31,29
20210602-W-Roland_Garros-R64-Veronika_Kudermetova-Katerina_Siniakova,2,F-DTM,31,4,0,1,3,16,15
20210602-W-Roland_Garros-R64-Veronika_Kudermetova-Katerina_Siniakova,2,F-DTL,16,7,3,1,3,10,6
20210602-W-Roland_Garros-R64-Veronika_Kudermetova-Katerina_Siniakova,2,F-IO,15,4,2,0,2,9,6
20210602-W-Roland_Garros-R64-Veronika_Kudermetova-Katerina_Siniakova,2,B-XC,38,5,1,0,4,22,16
20210602-W-Roland_Garros-R64-Veronika_Kudermetova-Katerina_Siniakova,2,B-DTM,32,1,0,0,1,16,16
20210602-W-Roland_Garros-R64-Veronika_Kudermetova-Katerina_Siniakova,2,B-DTL,11,3,2,1,0,9,2
20210602-W-Roland_Garros-R64-Veronika_Kudermetova-Katerina_Siniakova,2,B-IO,10,5,3,0,2,4,6
20210602-W-Roland_Garros-R64-Veronika_Kudermetova-Katerina_Siniakova,2,S-XC,3,0,0,0,0,1,2
20210602-W-Roland_Garros-R64-Veronika_Kudermetova-Katerina_Siniakova,2,S-DTM,3,0,0,0,0,2,1
20210602-W-Roland_Garros-R64-Veronika_Kudermetova-Katerina_Siniakova,2,S-DTL,1,1,1,0,0,1,0
19911027-W-Brighton-F-Steffi_Graf-Zina_Garrison,1,F-XC,63,13,5,3,5,36,27
19911027-W-Brighton-F-Steffi_Graf-Zina_Garrison,1,F-DTM,19,2,0,0,2,8,11
19911027-W-Brighton-F-Steffi_Graf-Zina_Garrison,1,F-DTL,21,5,2,3,0,12,9
19911027-W-Brighton-F-Steffi_Graf-Zina_Garrison,1,F-IO,37,11,5,2,4,22,15
19911027-W-Brighton-F-Steffi_Graf-Zina_Garrison,1,F-II,22,5,1,2,2,17,5
19911027-W-Brighton-F-Steffi_Graf-Zina_Garrison,1,B-XC,4,1,1,0,0,3,1
19911027-W-Brighton-F-Steffi_Graf-Zina_Garrison,1,B-DTM,6,1,0,0,1,2,4
19911027-W-Brighton-F-Steffi_Graf-Zina_Garrison,1,B-DTL,6,4,3,0,1,3,3
19911027-W-Brighton-F-Steffi_Graf-Zina_Garrison,1,B-IO,2,0,0,0,0,0,2
19911027-W-Brighton-F-Steffi_Graf-Zina_Garrison,1,S-XC,35,3,0,1,2,14,21
19911027-W-Brighton-F-Steffi_Graf-Zina_Garrison,1,S-DTM,20,0,0,0,0,11,9
19911027-W-Brighton-F-Steffi_Graf-Zina_Garrison,1,S-DTL,13,3,1,1,1,6,7
19911027-W-Brighton-F-Steffi_Graf-Zina_Garrison,1,S-IO,2,0,0,0,0,0,2
19911027-W-Brighton-F-Steffi_Graf-Zina_Garrison,2,F-XC,49,12,5,1,6,26,23
19911027-W-Brighton-F-Steffi_Graf-Zina_Garrison,2,F-DTM,23,1,0,0,1,6,17
19911027-W-Brighton-F-Steffi_Graf-Zina_Garrison,2,F-DTL,22,5,4,0,1,10,12
19911027-W-Brighton-F-Steffi_Graf-Zina_Garrison,2,F-IO,11,2,0,1,1,7,4
19911027-W-Brighton-F-Steffi_Graf-Zina_Garrison,2,B-XC,7,2,2,0,0,6,1
19911027-W-Brighton-F-Steffi_Graf-Zina_Garrison,2,B-DTM,5,0,0,0,0,1,4
19911027-W-Brighton-F-Steffi_Graf-Zina_Garrison,2,B-DTL,4,3,1,0,2,1,3
19911027-W-Brighton-F-Steffi_Graf-Zina_Garrison,2,S-XC,44,6,1,1,4,19,25
19911027-W-Brighton-F-Steffi_Graf-Zina_Garrison,2,S-DTM,14,1,0,0,1,2,12
19911027-W-Brighton-F-Steffi_Graf-Zina_Garrison,2,S-DTL,13,4,1,3,0,10,3
19911027-W-Brighton-F-Steffi_Graf-Zina_Garrison,2,S-IO,5,1,0,0,1,1,4
19911027-W-Brighton-F-Steffi_Graf-Zina_Garrison,2,S-II,1,0,0,0,0,0,1
20150701-W-Wimbledon-R64-Su_Wei_Hsieh-Lucie_Safarova,1,F-XC,14,8,2,4,2,9,5
20150701-W-Wimbledon-R64-Su_Wei_Hsieh-Lucie_Safarova,1,F-DTM,6,1,0,0,1,2,4
20150701-W-Wimbledon-R64-Su_Wei_Hsieh-Lucie_Safarova,1,F-DTL,3,1,0,1,0,2,1
20150701-W-Wimbledon-R64-Su_Wei_Hsieh-Lucie_Safarova,1,F-IO,12,5,1,1,3,5,7
20150701-W-Wimbledon-R64-Su_Wei_Hsieh-Lucie_Safarova,1,F-II,2,2,1,0,1,1,1
20150701-W-Wimbledon-R64-Su_Wei_Hsieh-Lucie_Safarova,1,B-XC,20,4,3,0,1,10,10
20150701-W-Wimbledon-R64-Su_Wei_Hsieh-Lucie_Safarova,1,B-DTM,7,1,0,0,1,2,5
20150701-W-Wimbledon-R64-Su_Wei_Hsieh-Lucie_Safarova,1,B-DTL,9,4,1,0,3,6,3
20150701-W-Wimbledon-R64-Su_Wei_Hsieh-Lucie_Safarova,1,B-IO,1,0,0,0,0,1,0
20150701-W-Wimbledon-R64-Su_Wei_Hsieh-Lucie_Safarova,1,S-XC,2,0,0,0,0,1,1
20150701-W-Wimbledon-R64-Su_Wei_Hsieh-Lucie_Safarova,1,S-DTM,1,0,0,0,0,0,1
20150701-W-Wimbledon-R64-Su_Wei_Hsieh-Lucie_Safarova,2,F-XC,21,11,5,5,1,14,7
20150701-W-Wimbledon-R64-Su_Wei_Hsieh-Lucie_Safarova,2,F-DTM,10,1,0,0,1,4,6
20150701-W-Wimbledon-R64-Su_Wei_Hsieh-Lucie_Safarova,2,F-DTL,12,8,5,2,1,7,5
20150701-W-Wimbledon-R64-Su_Wei_Hsieh-Lucie_Safarova,2,F-IO,4,1,0,0,1,3,1
20150701-W-Wimbledon-R64-Su_Wei_Hsieh-Lucie_Safarova,2,F-II,2,1,1,0,0,2,0
20150701-W-Wimbledon-R64-Su_Wei_Hsieh-Lucie_Safarova,2,B-XC,4,2,2,0,0,3,1
20150701-W-Wimbledon-R64-Su_Wei_Hsieh-Lucie_Safarova,2,B-DTM,5,0,0,0,0,2,3
20150701-W-Wimbledon-R64-Su_Wei_Hsieh-Lucie_Safarova,2,B-DTL,7,4,0,3,1,4,3
20150701-W-Wimbledon-R64-Su_Wei_Hsieh-Lucie_Safarova,2,S-DTM,1,0,0,0,0,0,1
20150701-W-Wimbledon-R64-Su_Wei_Hsieh-Lucie_Safarova,2,S-DTL,2,0,0,0,0,0,2
19920823-W-Montreal-F-Monica_Seles-Arantxa_Sanchez_Vicario,1,F-XC,115,24,4,8,12,42,73
19920823-W-Montreal-F-Monica_Seles-Arantxa_Sanchez_Vicario,1,F-DTM,62,4,0,0,4,22,40
19920823-W-Montreal-F-Monica_Seles-Arantxa_Sanchez_Vicario,1,F-DTL,28,7,1,2,4,10,18
19920823-W-Montreal-F-Monica_Seles-Arantxa_Sanchez_Vicario,1,F-IO,29,12,2,2,8,11,18
19920823-W-Montreal-F-Monica_Seles-Arantxa_Sanchez_Vicario,1,B-XC,97,17,4,7,6,47,50
19920823-W-Montreal-F-Monica_Seles-Arantxa_Sanchez_Vicario,1,B-DTM,51,5,1,0,4,19,32
19920823-W-Montreal-F-Monica_Seles-Arantxa_Sanchez_Vicario,1,B-DTL,16,10,5,0,5,7,9
19920823-W-Montreal-F-Monica_Seles-Arantxa_Sanchez_Vicario,1,B-IO,6,1,1,0,0,4,2
19920823-W-Montreal-F-Monica_Seles-Arantxa_Sanchez_Vicario,1,S-XC,3,1,0,0,1,1,2
19920823-W-Montreal-F-Monica_Seles-Arantxa_Sanchez_Vicario,1,S-DTM,4,0,0,0,0,1,3
19920823-W-Montreal-F-Monica_Seles-Arantxa_Sanchez_Vicario,1,S-DTL,1,0,0,0,0,0,1
19920823-W-Montreal-F-Monica_Seles-Arantxa_Sanchez_Vicario,1,S-IO,2,0,0,0,0,1,1
19920823-W-Montreal-F-Monica_Seles-Arantxa_Sanchez_Vicario,2,F-XC,90,15,2,5,8,48,42
19920823-W-Montreal-F-Monica_Seles-Arantxa_Sanchez_Vicario,2,F-DTM,44,2,0,0,2,27,17
19920823-W-Montreal-F-Monica_Seles-Arantxa_Sanchez_Vicario,2,F-DTL,32,7,1,2,4,17,15
19920823-W-Montreal-F-Monica_Seles-Arantxa_Sanchez_Vicario,2,F-IO,17,3,0,0,3,11,6
19920823-W-Montreal-F-Monica_Seles-Arantxa_Sanchez_Vicario,2,B-XC,56,13,7,3,3,41,15
19920823-W-Montreal-F-Monica_Seles-Arantxa_Sanchez_Vicario,2,B-DTM,50,1,0,0,1,30,20
19920823-W-Montreal-F-Monica_Seles-Arantxa_Sanchez_Vicario,2,B-DTL,18,6,1,1,4,10,8
19920823-W-Montreal-F-Monica_Seles-Arantxa_Sanchez_Vicario,2,B-IO,7,2,1,1,0,7,0
19920823-W-Montreal-F-Monica_Seles-Arantxa_Sanchez_Vicario,2,S-XC,30,1,0,0,1,19,11
19920823-W-Montreal-F-Monica_Seles-Arantxa_Sanchez_Vicario,2,S-DTM,24,0,0,0,0,12,12
19920823-W-Montreal-F-Monica_Seles-Arantxa_Sanchez_Vicario,2,S-DTL,3,0,0,0,0,1,2
19920823-W-Montreal-F-Monica_Seles-Arantxa_Sanchez_Vicario,2,S-IO,4,2,1,0,1,2,2
19940821-W-Montreal-F-Steffi_Graf-Arantxa_Sanchez_Vicario,1,F-XC,100,18,3,7,8,48,52
19940821-W-Montreal-F-Steffi_Graf-Arantxa_Sanchez_Vicario,1,F-DTM,9,3,1,0,2,4,5
19940821-W-Montreal-F-Steffi_Graf-Arantxa_Sanchez_Vicario,1,F-DTL,20,7,3,0,4,11,9
19940821-W-Montreal-F-Steffi_Graf-Arantxa_Sanchez_Vicario,1,F-IO,58,10,1,3,6,31,27
19940821-W-Montreal-F-Steffi_Graf-Arantxa_Sanchez_Vicario,1,F-II,28,7,1,3,3,14,14
19940821-W-Montreal-F-Steffi_Graf-Arantxa_Sanchez_Vicario,1,B-XC,7,1,0,1,0,2,5
19940821-W-Montreal-F-Steffi_Graf-Arantxa_Sanchez_Vicario,1,B-DTM,3,0,0,0,0,1,2
19940821-W-Montreal-F-Steffi_Graf-Arantxa_Sanchez_Vicario,1,S-XC,127,10,0,1,9,50,77
19940821-W-Montreal-F-Steffi_Graf-Arantxa_Sanchez_Vicario,1,S-DTM,33,2,0,0,2,17,16
19940821-W-Montreal-F-Steffi_Graf-Arantxa_Sanchez_Vicario,1,S-DTL,56,5,0,1,4,24,32
19940821-W-Montreal-F-Steffi_Graf-Arantxa_Sanchez_Vicario,1,S-IO,7,1,0,0,1,4,3
19940821-W-Montreal-F-Steffi_Graf-Arantxa_Sanchez_Vicario,2,F-XC,73,18,6,2,10,40,33
19940821-W-Montreal-F-Steffi_Graf-Arantxa_Sanchez_Vicario,2,F-DTM,43,4,0,1,3,24,19
19940821-W-Montreal-F-Steffi_Graf-Arantxa_Sanchez_Vicario,2,F-DTL,69,12,3,0,9,38,31
19940821-W-Montreal-F-Steffi_Graf-Arantxa_Sanchez_Vicario,2,F-IO,18,1,0,1,0,7,11
19940821-W-Montreal-F-Steffi_Graf-Arantxa_Sanchez_Vicario,2,F-II,1,1,0,0,1,0,1
19940821-W-Montreal-F-Steffi_Graf-Arantxa_Sanchez_Vicario,2,B-XC,129,9,1,3,5,69,60
19940821-W-Montreal-F-Steffi_Graf-Arantxa_Sanchez_Vicario,2,B-DTM,17,2,1,0,1,9,8
19940821-W-Montreal-F-Steffi_Graf-Arantxa_Sanchez_Vicario,2,B-DTL,17,8,5,1,2,12,5
19940821-W-Montreal-F-Steffi_Graf-Arantxa_Sanchez_Vicario,2,B-II,1,0,0,0,0,1,0
19940821-W-Montreal-F-Steffi_Graf-Arantxa_Sanchez_Vicario,2,S-XC,37,4,1,0,3,22,15
19940821-W-Montreal-F-Steffi_Graf-Arantxa_Sanchez_Vicario,2,S-DTM,11,0,0,0,0,3,8
19940821-W-Montreal-F-Steffi_Graf-Arantxa_Sanchez_Vicario,2,S-DTL,10,2,0,1,1,2,8
19940821-W-Montreal-F-Steffi_Graf-Arantxa_Sanchez_Vicario,2,S-IO,2,0,0,0,0,0,2
20211112-W-Linz-F-Jaqueline_Adina_Cristian-Alison_Riske,1,F-XC,72,11,2,4,5,33,39
20211112-W-Linz-F-Jaqueline_Adina_Cristian-Alison_Riske,1,F-DTM,44,4,0,0,4,12,32
20211112-W-Linz-F-Jaqueline_Adina_Cristian-Alison_Riske,1,F-DTL,16,7,3,1,3,6,10
20211112-W-Linz-F-Jaqueline_Adina_Cristian-Alison_Riske,1,F-IO,37,4,1,2,1,21,16
20211112-W-Linz-F-Jaqueline_Adina_Cristian-Alison_Riske,1,F-II,2,2,2,0,0,2,0
20211112-W-Linz-F-Jaqueline_Adina_Cristian-Alison_Riske,1,B-XC,47,13,1,3,9,19,28
20211112-W-Linz-F-Jaqueline_Adina_Cristian-Alison_Riske,1,B-DTM,71,7,0,0,7,28,43
20211112-W-Linz-F-Jaqueline_Adina_Cristian-Alison_Riske,1,B-DTL,12,2,0,0,2,5,7
20211112-W-Linz-F-Jaqueline_Adina_Cristian-Alison_Riske,1,B-IO,13,3,2,0,1,7,6
20211112-W-Linz-F-Jaqueline_Adina_Cristian-Alison_Riske,1,S-XC,2,0,0,0,0,0,2
20211112-W-Linz-F-Jaqueline_Adina_Cristian-Alison_Riske,1,S-DTM,4,0,0,0,0,1,3
20211112-W-Linz-F-Jaqueline_Adina_Cristian-Alison_Riske,1,S-DTL,2,1,0,1,0,2,0
20211112-W-Linz-F-Jaqueline_Adina_Cristian-Alison_Riske,2,F-XC,56,10,2,2,6,32,24
20211112-W-Linz-F-Jaqueline_Adina_Cristian-Alison_Riske,2,F-DTM,55,7,0,0,7,30,25
20211112-W-Linz-F-Jaqueline_Adina_Cristian-Alison_Riske,2,F-DTL,21,8,0,1,7,9,12
20211112-W-Linz-F-Jaqueline_Adina_Cristian-Alison_Riske,2,F-IO,36,8,1,1,6,22,14
20211112-W-Linz-F-Jaqueline_Adina_Cristian-Alison_Riske,2,B-XC,48,6,1,3,2,27,21
20211112-W-Linz-F-Jaqueline_Adina_Cristian-Alison_Riske,2,B-DTM,71,3,0,2,1,38,33
20211112-W-Linz-F-Jaqueline_Adina_Cristian-Alison_Riske,2,B-DTL,15,4,2,1,1,9,6
20211112-W-Linz-F-Jaqueline_Adina_Cristian-Alison_Riske,2,B-IO,18,10,2,2,6,11,7
20211112-W-Linz-F-Jaqueline_Adina_Cristian-Alison_Riske,2,S-DTM,3,0,0,0,0,0,3
19850519-W-Berlin-F-Steffi_Graf-Chris_Evert,1,F-XC,54,16,4,2,10,28,26
19850519-W-Berlin-F-Steffi_Graf-Chris_Evert,1,F-DTM,21,2,0,0,2,8,13
19850519-W-Berlin-F-Steffi_Graf-Chris_Evert,1,F-DTL,16,8,3,1,4,9,7
19850519-W-Berlin-F-Steffi_Graf-Chris_Evert,1,F-IO,28,8,4,2,2,19,9
19850519-W-Berlin-F-Steffi_Graf-Chris_Evert,1,F-II,16,5,3,0,2,7,9
19850519-W-Berlin-F-Steffi_Graf-Chris_Evert,1,B-XC,12,3,1,0,2,4,8
19850519-W-Berlin-F-Steffi_Graf-Chris_Evert,1,B-DTM,2,1,0,0,1,1,1
19850519-W-Berlin-F-Steffi_Graf-Chris_Evert,1,B-DTL,3,3,1,1,1,2,1
19850519-W-Berlin-F-Steffi_Graf-Chris_Evert,1,S-XC,44,6,0,1,5,19,25
19850519-W-Berlin-F-Steffi_Graf-Chris_Evert,1,S-DTM,39,5,0,0,5,17,22
19850519-W-Berlin-F-Steffi_Graf-Chris_Evert,1,S-DTL,76,16,1,1,14,35,41
19850519-W-Berlin-F-Steffi_Graf-Chris_Evert,1,S-IO,8,1,0,0,1,3,5
19850519-W-Berlin-F-Steffi_Graf-Chris_Evert,2,F-XC,54,5,1,1,3,26,28
19850519-W-Berlin-F-Steffi_Graf-Chris_Evert,2,F-DTM,34,2,0,0,2,15,19
19850519-W-Berlin-F-Steffi_Graf-Chris_Evert,2,F-DTL,51,7,1,1,5,27,24
19850519-W-Berlin-F-Steffi_Graf-Chris_Evert,2,F-IO,29,1,1,0,0,15,14
19850519-W-Berlin-F-Steffi_Graf-Chris_Evert,2,B-XC,87,12,1,3,8,48,39
19850519-W-Berlin-F-Steffi_Graf-Chris_Evert,2,B-DTM,8,3,0,0,3,4,4
19850519-W-Berlin-F-Steffi_Graf-Chris_Evert,2,B-DTL,12,7,3,3,1,7,5
19850519-W-Berlin-F-Steffi_Graf-Chris_Evert,2,B-IO,5,1,0,1,0,4,1
19850519-W-Berlin-F-Steffi_Graf-Chris_Evert,2,S-XC,8,0,0,0,0,4,4
19850519-W-Berlin-F-Steffi_Graf-Chris_Evert,2,S-DTM,2,0,0,0,0,1,1
19850519-W-Berlin-F-Steffi_Graf-Chris_Evert,2,S-IO,2,0,0,0,0,2,0
20211121-W-Montevideo-F-Panna_Udvardy-Diane_Parry,1,F-XC,20,8,2,3,3,8,12
20211121-W-Montevideo-F-Panna_Udvardy-Diane_Parry,1,F-DTM,12,2,0,0,2,7,5
20211121-W-Montevideo-F-Panna_Udvardy-Diane_Parry,1,F-DTL,5,1,0,0,1,3,2
20211121-W-Montevideo-F-Panna_Udvardy-Diane_Parry,1,F-IO,13,2,0,1,1,9,4
20211121-W-Montevideo-F-Panna_Udvardy-Diane_Parry,1,B-XC,36,11,2,1,8,15,21
20211121-W-Montevideo-F-Panna_Udvardy-Diane_Parry,1,B-DTM,17,2,0,0,2,7,10
20211121-W-Montevideo-F-Panna_Udvardy-Diane_Parry,1,B-DTL,6,4,2,0,2,2,4
20211121-W-Montevideo-F-Panna_Udvardy-Diane_Parry,1,B-IO,3,1,0,1,0,2,1
20211121-W-Montevideo-F-Panna_Udvardy-Diane_Parry,1,S-XC,3,0,0,0,0,1,2
20211121-W-Montevideo-F-Panna_Udvardy-Diane_Parry,1,S-DTM,2,2,0,0,2,0,2
20211121-W-Montevideo-F-Panna_Udvardy-Diane_Parry,1,S-DTL,2,1,0,0,1,0,2
20211121-W-Montevideo-F-Panna_Udvardy-Diane_Parry,2,F-XC,13,3,1,1,1,8,5
20211121-W-Montevideo-F-Panna_Udvardy-Diane_Parry,2,F-DTM,21,2,0,1,1,12,9
20211121-W-Montevideo-F-Panna_Udvardy-Diane_Parry,2,F-DTL,6,3,1,0,2,3,3
20211121-W-Montevideo-F-Panna_Udvardy-Diane_Parry,2,F-IO,12,4,3,0,1,9,3
20211121-W-Montevideo-F-Panna_Udvardy-Diane_Parry,2,F-II,2,1,1,0,0,2,0
20211121-W-Montevideo-F-Panna_Udvardy-Diane_Parry,2,B-XC,11,1,0,0,1,7,4
20211121-W-Montevideo-F-Panna_Udvardy-Diane_Parry,2,B-DTM,12,1,0,0,1,4,8
20211121-W-Montevideo-F-Panna_Udvardy-Diane_Parry,2,B-DTL,4,2,0,0,2,2,2
20211121-W-Montevideo-F-Panna_Udvardy-Diane_Parry,2,B-IO,2,1,0,0,1,0,2
20211121-W-Montevideo-F-Panna_Udvardy-Diane_Parry,2,S-XC,12,2,0,0,2,5,7
20211121-W-Montevideo-F-Panna_Udvardy-Diane_Parry,2,S-DTM,17,3,0,0,3,6,11
20211121-W-Montevideo-F-Panna_Udvardy-Diane_Parry,2,S-IO,1,0,0,0,0,0,1
19920412-W-Amelia_Island-F-Steffi_Graf-Gabriela_Sabatini,1,F-XC,39,7,2,0,5,18,21
19920412-W-Amelia_Island-F-Steffi_Graf-Gabriela_Sabatini,1,F-DTM,12,1,1,0,0,5,7
19920412-W-Amelia_Island-F-Steffi_Graf-Gabriela_Sabatini,1,F-DTL,20,6,2,1,3,11,9
19920412-W-Amelia_Island-F-Steffi_Graf-Gabriela_Sabatini,1,F-IO,42,10,4,3,3,22,20
19920412-W-Amelia_Island-F-Steffi_Graf-Gabriela_Sabatini,1,F-II,20,4,1,2,1,11,9
19920412-W-Amelia_Island-F-Steffi_Graf-Gabriela_Sabatini,1,B-XC,13,3,0,0,3,6,7
19920412-W-Amelia_Island-F-Steffi_Graf-Gabriela_Sabatini,1,B-DTM,5,1,0,0,1,2,3
19920412-W-Amelia_Island-F-Steffi_Graf-Gabriela_Sabatini,1,B-DTL,6,1,1,0,0,2,4
19920412-W-Amelia_Island-F-Steffi_Graf-Gabriela_Sabatini,1,B-IO,1,0,0,0,0,0,1
19920412-W-Amelia_Island-F-Steffi_Graf-Gabriela_Sabatini,1,S-XC,71,6,0,2,4,30,41
19920412-W-Amelia_Island-F-Steffi_Graf-Gabriela_Sabatini,1,S-DTM,11,0,0,0,0,3,8
19920412-W-Amelia_Island-F-Steffi_Graf-Gabriela_Sabatini,1,S-DTL,27,5,1,1,3,9,18
19920412-W-Amelia_Island-F-Steffi_Graf-Gabriela_Sabatini,1,S-IO,1,1,0,0,1,0,1
19920412-W-Amelia_Island-F-Steffi_Graf-Gabriela_Sabatini,2,F-XC,48,10,1,4,5,28,20
19920412-W-Amelia_Island-F-Steffi_Graf-Gabriela_Sabatini,2,F-DTM,11,0,0,0,0,7,4
19920412-W-Amelia_Island-F-Steffi_Graf-Gabriela_Sabatini,2,F-DTL,39,10,2,4,4,24,15
19920412-W-Amelia_Island-F-Steffi_Graf-Gabriela_Sabatini,2,F-IO,10,4,1,1,2,8,2
19920412-W-Amelia_Island-F-Steffi_Graf-Gabriela_Sabatini,2,F-II,1,0,0,0,0,1,0
19920412-W-Amelia_Island-F-Steffi_Graf-Gabriela_Sabatini,2,B-XC,54,4,2,0,2,33,21
19920412-W-Amelia_Island-F-Steffi_Graf-Gabriela_Sabatini,2,B-DTM,11,1,0,0,1,5,6
19920412-W-Amelia_Island-F-Steffi_Graf-Gabriela_Sabatini,2,B-DTL,15,9,5,1,3,10,5
19920412-W-Amelia_Island-F-Steffi_Graf-Gabriela_Sabatini,2,B-IO,2,2,1,1,0,2,0
19920412-W-Amelia_Island-F-Steffi_Graf-Gabriela_Sabatini,2,S-XC,66,3,0,0,3,33,33
19920412-W-Amelia_Island-F-Steffi_Graf-Gabriela_Sabatini,2,S-DTM,9,1,0,0,1,2,7
19920412-W-Amelia_Island-F-Steffi_Graf-Gabriela_Sabatini,2,S-DTL,4,0,0,0,0,1,3
19920412-W-Amelia_Island-F-Steffi_Graf-Gabriela_Sabatini,2,S-IO,1,1,0,0,1,0,1
19860421-W-Amelia_Island-F-Steffi_Graf-Claudia_Kohde_Kilsch,1,F-XC,84,11,4,2,5,46,38
19860421-W-Amelia_Island-F-Steffi_Graf-Claudia_Kohde_Kilsch,1,F-DTM,37,2,0,0,2,17,20
19860421-W-Amelia_Island-F-Steffi_Graf-Claudia_Kohde_Kilsch,1,F-DTL,31,5,1,1,3,15,16
19860421-W-Amelia_Island-F-Steffi_Graf-Claudia_Kohde_Kilsch,1,F-IO,62,14,0,3,11,28,34
19860421-W-Amelia_Island-F-Steffi_Graf-Claudia_Kohde_Kilsch,1,F-II,6,2,0,1,1,4,2
19860421-W-Amelia_Island-F-Steffi_Graf-Claudia_Kohde_Kilsch,1,B-XC,14,5,1,1,3,3,11
19860421-W-Amelia_Island-F-Steffi_Graf-Claudia_Kohde_Kilsch,1,B-DTM,5,1,0,0,1,2,3
19860421-W-Amelia_Island-F-Steffi_Graf-Claudia_Kohde_Kilsch,1,B-DTL,7,3,2,0,1,4,3
19860421-W-Amelia_Island-F-Steffi_Graf-Claudia_Kohde_Kilsch,1,S-XC,269,16,0,0,16,137,132
19860421-W-Amelia_Island-F-Steffi_Graf-Claudia_Kohde_Kilsch,1,S-DTM,58,5,0,1,4,33,25
19860421-W-Amelia_Island-F-Steffi_Graf-Claudia_Kohde_Kilsch,1,S-DTL,69,12,2,3,7,32,37
19860421-W-Amelia_Island-F-Steffi_Graf-Claudia_Kohde_Kilsch,1,S-IO,10,1,0,0,1,8,2
19860421-W-Amelia_Island-F-Steffi_Graf-Claudia_Kohde_Kilsch,2,F-XC,85,14,1,4,9,43,42
19860421-W-Amelia_Island-F-Steffi_Graf-Claudia_Kohde_Kilsch,2,F-DTM,34,3,0,0,3,13,21
19860421-W-Amelia_Island-F-Steffi_Graf-Claudia_Kohde_Kilsch,2,F-DTL,67,11,0,1,10,28,39
19860421-W-Amelia_Island-F-Steffi_Graf-Claudia_Kohde_Kilsch,2,F-IO,22,7,0,0,7,9,13
19860421-W-Amelia_Island-F-Steffi_Graf-Claudia_Kohde_Kilsch,2,B-XC,16,7,2,1,4,7,9
19860421-W-Amelia_Island-F-Steffi_Graf-Claudia_Kohde_Kilsch,2,B-DTM,5,0,0,0,0,5,0
19860421-W-Amelia_Island-F-Steffi_Graf-Claudia_Kohde_Kilsch,2,B-DTL,4,3,0,1,2,1,3
19860421-W-Amelia_Island-F-Steffi_Graf-Claudia_Kohde_Kilsch,2,B-IO,1,0,0,0,0,0,1
19860421-W-Amelia_Island-F-Steffi_Graf-Claudia_Kohde_Kilsch,2,S-XC,298,8,0,3,5,139,159
19860421-W-Amelia_Island-F-Steffi_Graf-Claudia_Kohde_Kilsch,2,S-DTM,44,4,0,0,4,18,26
19860421-W-Amelia_Island-F-Steffi_Graf-Claudia_Kohde_Kilsch,2,S-DTL,35,7,2,1,4,16,19
19860421-W-Amelia_Island-F-Steffi_Graf-Claudia_Kohde_Kilsch,2,S-IO,14,4,1,2,1,8,6
19921025-W-Brighton-F-Steffi_Graf-Jana_Novotna,1,F-XC,92,14,4,4,6,44,48
19921025-W-Brighton-F-Steffi_Graf-Jana_Novotna,1,F-DTM,19,3,0,1,2,9,10
19921025-W-Brighton-F-Steffi_Graf-Jana_Novotna,1,F-DTL,14,2,1,1,0,7,7
19921025-W-Brighton-F-Steffi_Graf-Jana_Novotna,1,F-IO,61,16,6,4,6,35,26
19921025-W-Brighton-F-Steffi_Graf-Jana_Novotna,1,F-II,22,3,3,0,0,15,7
19921025-W-Brighton-F-Steffi_Graf-Jana_Novotna,1,B-XC,17,7,2,1,4,10,7
19921025-W-Brighton-F-Steffi_Graf-Jana_Novotna,1,B-DTM,7,5,0,0,5,1,6
19921025-W-Brighton-F-Steffi_Graf-Jana_Novotna,1,B-DTL,6,4,1,2,1,3,3
19921025-W-Brighton-F-Steffi_Graf-Jana_Novotna,1,B-IO,1,1,1,0,0,1,0
19921025-W-Brighton-F-Steffi_Graf-Jana_Novotna,1,S-XC,53,9,1,2,6,25,28
19921025-W-Brighton-F-Steffi_Graf-Jana_Novotna,1,S-DTM,20,2,1,0,1,13,7
19921025-W-Brighton-F-Steffi_Graf-Jana_Novotna,1,S-DTL,37,7,3,2,2,23,14
19921025-W-Brighton-F-Steffi_Graf-Jana_Novotna,1,S-IO,3,1,1,0,0,3,0
19921025-W-Brighton-F-Steffi_Graf-Jana_Novotna,2,F-XC,70,14,2,4,8,33,37
19921025-W-Brighton-F-Steffi_Graf-Jana_Novotna,2,F-DTM,30,1,0,0,1,9,21
19921025-W-Brighton-F-Steffi_Graf-Jana_Novotna,2,F-DTL,45,4,0,0,4,22,23
19921025-W-Brighton-F-Steffi_Graf-Jana_Novotna,2,F-IO,23,5,2,3,0,12,11
19921025-W-Brighton-F-Steffi_Graf-Jana_Novotna,2,F-II,1,1,0,0,1,0,1
19921025-W-Brighton-F-Steffi_Graf-Jana_Novotna,2,B-XC,2,1,0,0,1,0,2
19921025-W-Brighton-F-Steffi_Graf-Jana_Novotna,2,B-DTM,1,1,0,0,1,0,1
19921025-W-Brighton-F-Steffi_Graf-Jana_Novotna,2,B-DTL,1,1,1,0,0,1,0
19921025-W-Brighton-F-Steffi_Graf-Jana_Novotna,2,S-XC,85,10,0,2,8,41,44
19921025-W-Brighton-F-Steffi_Graf-Jana_Novotna,2,S-DTM,13,2,0,0,2,4,9
19921025-W-Brighton-F-Steffi_Graf-Jana_Novotna,2,S-DTL,16,6,1,3,2,10,6
20000708-W-Wimbledon-SF-Jelena_Dokic-Lindsay_Davenport,1,F-XC,21,5,3,0,2,9,12
20000708-W-Wimbledon-SF-Jelena_Dokic-Lindsay_Davenport,1,F-DTM,11,0,0,0,0,0,11
20000708-W-Wimbledon-SF-Jelena_Dokic-Lindsay_Davenport,1,F-DTL,3,0,0,0,0,0,3
20000708-W-Wimbledon-SF-Jelena_Dokic-Lindsay_Davenport,1,F-IO,7,3,0,1,2,1,6
20000708-W-Wimbledon-SF-Jelena_Dokic-Lindsay_Davenport,1,B-XC,29,10,4,0,6,10,19
20000708-W-Wimbledon-SF-Jelena_Dokic-Lindsay_Davenport,1,B-DTM,19,3,0,0,3,6,13
20000708-W-Wimbledon-SF-Jelena_Dokic-Lindsay_Davenport,1,B-DTL,6,4,1,2,1,3,3
20000708-W-Wimbledon-SF-Jelena_Dokic-Lindsay_Davenport,1,B-IO,2,2,0,0,2,0,2
20000708-W-Wimbledon-SF-Jelena_Dokic-Lindsay_Davenport,1,S-XC,1,0,0,0,0,0,1
20000708-W-Wimbledon-SF-Jelena_Dokic-Lindsay_Davenport,2,F-XC,17,6,2,1,3,10,7
20000708-W-Wimbledon-SF-Jelena_Dokic-Lindsay_Davenport,2,F-DTM,11,3,0,0,3,7,4
20000708-W-Wimbledon-SF-Jelena_Dokic-Lindsay_Davenport,2,F-DTL,8,6,1,3,2,5,3
20000708-W-Wimbledon-SF-Jelena_Dokic-Lindsay_Davenport,2,F-IO,9,5,0,1,4,4,5
20000708-W-Wimbledon-SF-Jelena_Dokic-Lindsay_Davenport,2,B-XC,23,5,2,1,2,16,7
20000708-W-Wimbledon-SF-Jelena_Dokic-Lindsay_Davenport,2,B-DTM,12,0,0,0,0,8,4
20000708-W-Wimbledon-SF-Jelena_Dokic-Lindsay_Davenport,2,B-DTL,4,3,2,1,0,3,1
20000708-W-Wimbledon-SF-Jelena_Dokic-Lindsay_Davenport,2,B-IO,4,3,2,1,0,4,0
20000708-W-Wimbledon-SF-Jelena_Dokic-Lindsay_Davenport,2,S-XC,2,0,0,0,0,1,1
20000708-W-Wimbledon-SF-Jelena_Dokic-Lindsay_Davenport,2,S-DTM,3,0,0,0,0,1,2
20000708-W-Wimbledon-SF-Jelena_Dokic-Lindsay_Davenport,2,S-DTL,1,0,0,0,0,1,0
19910704-W-Wimbledon-SF-Jennifer_Capriati-Gabriela_Sabatini,1,F-XC,38,7,2,2,3,20,18
19910704-W-Wimbledon-SF-Jennifer_Capriati-Gabriela_Sabatini,1,F-DTM,30,2,0,0,2,12,18
19910704-W-Wimbledon-SF-Jennifer_Capriati-Gabriela_Sabatini,1,F-DTL,25,10,1,1,8,10,15
19910704-W-Wimbledon-SF-Jennifer_Capriati-Gabriela_Sabatini,1,F-IO,11,4,0,1,3,2,9
19910704-W-Wimbledon-SF-Jennifer_Capriati-Gabriela_Sabatini,1,B-XC,53,9,3,3,3,25,28
19910704-W-Wimbledon-SF-Jennifer_Capriati-Gabriela_Sabatini,1,B-DTM,41,6,0,0,6,13,28
19910704-W-Wimbledon-SF-Jennifer_Capriati-Gabriela_Sabatini,1,B-DTL,13,3,1,0,2,4,9
19910704-W-Wimbledon-SF-Jennifer_Capriati-Gabriela_Sabatini,1,B-IO,12,2,0,0,2,4,8
19910704-W-Wimbledon-SF-Jennifer_Capriati-Gabriela_Sabatini,1,S-XC,4,0,0,0,0,2,2
19910704-W-Wimbledon-SF-Jennifer_Capriati-Gabriela_Sabatini,1,S-DTM,4,0,0,0,0,0,4
19910704-W-Wimbledon-SF-Jennifer_Capriati-Gabriela_Sabatini,1,S-DTL,1,1,1,0,0,1,0
19910704-W-Wimbledon-SF-Jennifer_Capriati-Gabriela_Sabatini,2,F-XC,37,4,2,1,1,26,11
19910704-W-Wimbledon-SF-Jennifer_Capriati-Gabriela_Sabatini,2,F-DTM,30,4,1,0,3,14,16
19910704-W-Wimbledon-SF-Jennifer_Capriati-Gabriela_Sabatini,2,F-DTL,27,8,1,1,6,10,17
19910704-W-Wimbledon-SF-Jennifer_Capriati-Gabriela_Sabatini,2,F-IO,20,3,1,1,1,13,7
19910704-W-Wimbledon-SF-Jennifer_Capriati-Gabriela_Sabatini,2,F-II,1,1,1,0,0,1,0
19910704-W-Wimbledon-SF-Jennifer_Capriati-Gabriela_Sabatini,2,B-XC,11,2,0,1,1,7,4
19910704-W-Wimbledon-SF-Jennifer_Capriati-Gabriela_Sabatini,2,B-DTM,16,2,0,0,2,10,6
19910704-W-Wimbledon-SF-Jennifer_Capriati-Gabriela_Sabatini,2,B-DTL,9,1,1,0,0,5,4
19910704-W-Wimbledon-SF-Jennifer_Capriati-Gabriela_Sabatini,2,B-IO,8,4,1,1,2,4,4
19910704-W-Wimbledon-SF-Jennifer_Capriati-Gabriela_Sabatini,2,S-XC,26,2,0,1,1,16,10
19910704-W-Wimbledon-SF-Jennifer_Capriati-Gabriela_Sabatini,2,S-DTM,18,0,0,0,0,11,7
19910704-W-Wimbledon-SF-Jennifer_Capriati-Gabriela_Sabatini,2,S-DTL,13,3,0,0,3,4,9
19910704-W-Wimbledon-SF-Jennifer_Capriati-Gabriela_Sabatini,2,S-IO,5,2,0,0,2,1,4
19930702-W-Wimbledon-SF-Martina_Navratilova-Jana_Novotna,1,F-XC,5,1,0,0,1,2,3
19930702-W-Wimbledon-SF-Martina_Navratilova-Jana_Novotna,1,F-DTM,2,0,0,0,0,0,2
19930702-W-Wimbledon-SF-Martina_Navratilova-Jana_Novotna,1,F-DTL,1,1,0,1,0,1,0
19930702-W-Wimbledon-SF-Martina_Navratilova-Jana_Novotna,1,F-IO,2,1,0,0,1,0,2
19930702-W-Wimbledon-SF-Martina_Navratilova-Jana_Novotna,1,B-XC,2,0,0,0,0,0,2
19930702-W-Wimbledon-SF-Martina_Navratilova-Jana_Novotna,1,B-IO,1,1,0,1,0,1,0
19930702-W-Wimbledon-SF-Martina_Navratilova-Jana_Novotna,1,S-XC,2,1,1,0,0,2,0
19930702-W-Wimbledon-SF-Martina_Navratilova-Jana_Novotna,1,S-DTM,2,1,0,0,1,0,2
19930702-W-Wimbledon-SF-Martina_Navratilova-Jana_Novotna,1,S-IO,1,0,0,0,0,0,1
19930702-W-Wimbledon-SF-Martina_Navratilova-Jana_Novotna,2,F-XC,1,0,0,0,0,0,1
19930702-W-Wimbledon-SF-Martina_Navratilova-Jana_Novotna,2,F-DTM,3,1,0,1,0,2,1
19930702-W-Wimbledon-SF-Martina_Navratilova-Jana_Novotna,2,F-DTL,4,3,2,1,0,3,1
19930702-W-Wimbledon-SF-Martina_Navratilova-Jana_Novotna,2,F-IO,4,3,0,1,2,1,3
19930702-W-Wimbledon-SF-Martina_Navratilova-Jana_Novotna,2,F-II,1,1,0,1,0,1,0
19930702-W-Wimbledon-SF-Martina_Navratilova-Jana_Novotna,2,B-XC,3,2,0,1,1,2,1
19930702-W-Wimbledon-SF-Martina_Navratilova-Jana_Novotna,2,B-DTL,2,2,1,0,1,1,1
19930702-W-Wimbledon-SF-Martina_Navratilova-Jana_Novotna,2,S-XC,2,0,0,0,0,0,2
19930702-W-Wimbledon-SF-Martina_Navratilova-Jana_Novotna,2,S-DTM,1,0,0,0,0,1,0
19930702-W-Wimbledon-SF-Martina_Navratilova-Jana_Novotna,2,S-DTL,4,3,2,1,0,3,1
19950416-W-Houston-F-Steffi_Graf-Asa_Carlsson,1,F-XC,38,13,5,3,5,25,13
19950416-W-Houston-F-Steffi_Graf-Asa_Carlsson,1,F-DTM,6,0,0,0,0,4,2
19950416-W-Houston-F-Steffi_Graf-Asa_Carlsson,1,F-DTL,14,5,3,1,1,12,2
19950416-W-Houston-F-Steffi_Graf-Asa_Carlsson,1,F-IO,17,5,3,0,2,12,5
19950416-W-Houston-F-Steffi_Graf-Asa_Carlsson,1,F-II,8,4,0,1,3,4,4
19950416-W-Houston-F-Steffi_Graf-Asa_Carlsson,1,B-XC,3,0,0,0,0,0,3
19950416-W-Houston-F-Steffi_Graf-Asa_Carlsson,1,S-XC,35,4,1,0,3,22,13
19950416-W-Houston-F-Steffi_Graf-Asa_Carlsson,1,S-DTM,11,2,0,0,2,4,7
19950416-W-Houston-F-Steffi_Graf-Asa_Carlsson,1,S-DTL,6,2,1,0,1,3,3
19950416-W-Houston-F-Steffi_Graf-Asa_Carlsson,2,F-XC,21,4,0,1,3,2,19
19950416-W-Houston-F-Steffi_Graf-Asa_Carlsson,2,F-DTM,10,2,0,0,2,5,5
19950416-W-Houston-F-Steffi_Graf-Asa_Carlsson,2,F-DTL,11,1,0,0,1,6,5
19950416-W-Houston-F-Steffi_Graf-Asa_Carlsson,2,F-IO,3,1,1,0,0,2,1
19950416-W-Houston-F-Steffi_Graf-Asa_Carlsson,2,B-XC,47,6,1,1,4,15,32
19950416-W-Houston-F-Steffi_Graf-Asa_Carlsson,2,B-DTM,15,2,0,0,2,5,10
19950416-W-Houston-F-Steffi_Graf-Asa_Carlsson,2,B-DTL,14,7,1,1,5,5,9
19950416-W-Houston-F-Steffi_Graf-Asa_Carlsson,2,B-IO,5,2,1,0,1,3,2
19950416-W-Houston-F-Steffi_Graf-Asa_Carlsson,2,S-XC,2,0,0,0,0,2,0
19950416-W-Houston-F-Steffi_Graf-Asa_Carlsson,2,S-DTM,2,0,0,0,0,1,1
19950416-W-Houston-F-Steffi_Graf-Asa_Carlsson,2,S-DTL,3,0,0,0,0,1,2
19931003-W-Leipzig-F-Steffi_Graf-Jana_Novotna,1,F-XC,13,7,3,2,2,10,3
19931003-W-Leipzig-F-Steffi_Graf-Jana_Novotna,1,F-DTM,4,1,1,0,0,4,0
19931003-W-Leipzig-F-Steffi_Graf-Jana_Novotna,1,F-DTL,4,2,1,1,0,3,1
19931003-W-Leipzig-F-Steffi_Graf-Jana_Novotna,1,F-IO,10,6,4,1,1,8,2
19931003-W-Leipzig-F-Steffi_Graf-Jana_Novotna,1,F-II,2,0,0,0,0,2,0
19931003-W-Leipzig-F-Steffi_Graf-Jana_Novotna,1,B-XC,2,1,0,0,1,1,1
19931003-W-Leipzig-F-Steffi_Graf-Jana_Novotna,1,B-DTL,1,0,0,0,0,1,0
19931003-W-Leipzig-F-Steffi_Graf-Jana_Novotna,1,S-XC,21,3,0,0,3,13,8
19931003-W-Leipzig-F-Steffi_Graf-Jana_Novotna,1,S-DTM,1,0,0,0,0,1,0
19931003-W-Leipzig-F-Steffi_Graf-Jana_Novotna,1,S-DTL,10,4,1,0,3,3,7
19931003-W-Leipzig-F-Steffi_Graf-Jana_Novotna,2,F-XC,6,2,0,0,2,2,4
19931003-W-Leipzig-F-Steffi_Graf-Jana_Novotna,2,F-DTM,6,1,0,0,1,1,5
19931003-W-Leipzig-F-Steffi_Graf-Jana_Novotna,2,F-DTL,8,2,0,0,2,2,6
19931003-W-Leipzig-F-Steffi_Graf-Jana_Novotna,2,F-IO,4,1,0,0,1,1,3
19931003-W-Leipzig-F-Steffi_Graf-Jana_Novotna,2,B-XC,5,4,1,0,3,2,3
19931003-W-Leipzig-F-Steffi_Graf-Jana_Novotna,2,B-DTM,2,0,0,0,0,0,2
19931003-W-Leipzig-F-Steffi_Graf-Jana_Novotna,2,B-IO,1,1,0,0,1,0,1
19931003-W-Leipzig-F-Steffi_Graf-Jana_Novotna,2,S-XC,14,5,0,0,5,4,10
19931003-W-Leipzig-F-Steffi_Graf-Jana_Novotna,2,S-DTM,4,1,0,0,1,1,3
19931003-W-Leipzig-F-Steffi_Graf-Jana_Novotna,2,S-DTL,6,2,0,0,2,1,5
19931003-W-Leipzig-F-Steffi_Graf-Jana_Novotna,2,S-IO,1,1,0,0,1,0,1
19980719-W-Mahwah-F-Steffi_Graf-Amanda_Coetzer,1,F-XC,33,9,2,4,3,15,18
19980719-W-Mahwah-F-Steffi_Graf-Amanda_Coetzer,1,F-DTM,11,0,0,0,0,5,6
19980719-W-Mahwah-F-Steffi_Graf-Amanda_Coetzer,1,F-DTL,10,3,2,0,1,3,7
19980719-W-Mahwah-F-Steffi_Graf-Amanda_Coetzer,1,F-IO,34,10,3,1,6,19,15
19980719-W-Mahwah-F-Steffi_Graf-Amanda_Coetzer,1,F-II,2,1,0,0,1,0,2
19980719-W-Mahwah-F-Steffi_Graf-Amanda_Coetzer,1,B-XC,1,1,0,1,0,1,0
19980719-W-Mahwah-F-Steffi_Graf-Amanda_Coetzer,1,S-XC,76,16,1,1,14,36,40
19980719-W-Mahwah-F-Steffi_Graf-Amanda_Coetzer,1,S-DTM,14,2,0,0,2,7,7
19980719-W-Mahwah-F-Steffi_Graf-Amanda_Coetzer,1,S-DTL,6,1,0,1,0,2,4
19980719-W-Mahwah-F-Steffi_Graf-Amanda_Coetzer,1,S-IO,1,1,0,0,1,0,1
19980719-W-Mahwah-F-Steffi_Graf-Amanda_Coetzer,2,F-XC,20,1,0,0,1,13,7
19980719-W-Mahwah-F-Steffi_Graf-Amanda_Coetzer,2,F-DTM,11,0,0,0,0,7,4
19980719-W-Mahwah-F-Steffi_Graf-Amanda_Coetzer,2,F-DTL,8,3,0,0,3,2,6
19980719-W-Mahwah-F-Steffi_Graf-Amanda_Coetzer,2,F-IO,18,2,0,0,2,8,10
19980719-W-Mahwah-F-Steffi_Graf-Amanda_Coetzer,2,B-XC,44,6,1,1,4,22,22
19980719-W-Mahwah-F-Steffi_Graf-Amanda_Coetzer,2,B-DTM,17,4,0,0,4,3,14
19980719-W-Mahwah-F-Steffi_Graf-Amanda_Coetzer,2,B-DTL,3,1,0,0,1,1,2
19980719-W-Mahwah-F-Steffi_Graf-Amanda_Coetzer,2,B-IO,2,1,0,0,1,1,1
19980719-W-Mahwah-F-Steffi_Graf-Amanda_Coetzer,2,S-XC,38,5,0,2,3,24,14
19980719-W-Mahwah-F-Steffi_Graf-Amanda_Coetzer,2,S-DTM,7,0,0,0,0,3,4
19980719-W-Mahwah-F-Steffi_Graf-Amanda_Coetzer,2,S-DTL,5,2,0,1,1,3,2
19980719-W-Mahwah-F-Steffi_Graf-Amanda_Coetzer,2,S-IO,1,0,0,0,0,0,1
20211023-W-Tenerife-SF-Maria_Camila_Osorio_Serrano-Camila_Giorgi,1,F-XC,12,3,1,0,2,8,4
20211023-W-Tenerife-SF-Maria_Camila_Osorio_Serrano-Camila_Giorgi,1,F-DTM,29,1,0,0,1,12,17
20211023-W-Tenerife-SF-Maria_Camila_Osorio_Serrano-Camila_Giorgi,1,F-DTL,7,2,0,0,2,3,4
20211023-W-Tenerife-SF-Maria_Camila_Osorio_Serrano-Camila_Giorgi,1,F-IO,9,6,1,1,4,4,5
20211023-W-Tenerife-SF-Maria_Camila_Osorio_Serrano-Camila_Giorgi,1,B-XC,17,4,2,0,2,12,5
20211023-W-Tenerife-SF-Maria_Camila_Osorio_Serrano-Camila_Giorgi,1,B-DTM,21,0,0,0,0,16,5
20211023-W-Tenerife-SF-Maria_Camila_Osorio_Serrano-Camila_Giorgi,1,B-DTL,3,1,1,0,0,3,0
20211023-W-Tenerife-SF-Maria_Camila_Osorio_Serrano-Camila_Giorgi,1,B-IO,15,9,5,0,4,9,6
20211023-W-Tenerife-SF-Maria_Camila_Osorio_Serrano-Camila_Giorgi,1,S-XC,2,1,0,1,0,2,0
20211023-W-Tenerife-SF-Maria_Camila_Osorio_Serrano-Camila_Giorgi,1,S-DTM,5,2,0,0,2,0,5
20211023-W-Tenerife-SF-Maria_Camila_Osorio_Serrano-Camila_Giorgi,1,S-IO,1,0,0,0,0,1,0
20211023-W-Tenerife-SF-Maria_Camila_Osorio_Serrano-Camila_Giorgi,2,F-XC,30,11,3,2,6,13,17
20211023-W-Tenerife-SF-Maria_Camila_Osorio_Serrano-Camila_Giorgi,2,F-DTM,26,7,0,0,7,9,17
20211023-W-Tenerife-SF-Maria_Camila_Osorio_Serrano-Camila_Giorgi,2,F-DTL,4,0,0,0,0,1,3
20211023-W-Tenerife-SF-Maria_Camila_Osorio_Serrano-Camila_Giorgi,2,F-IO,12,3,2,0,1,6,6
20211023-W-Tenerife-SF-Maria_Camila_Osorio_Serrano-Camila_Giorgi,2,B-XC,18,7,2,0,5,7,11
20211023-W-Tenerife-SF-Maria_Camila_Osorio_Serrano-Camila_Giorgi,2,B-DTM,39,9,2,0,6,15,24
20211023-W-Tenerife-SF-Maria_Camila_Osorio_Serrano-Camila_Giorgi,2,B-DTL,5,3,0,2,1,2,3
20211023-W-Tenerife-SF-Maria_Camila_Osorio_Serrano-Camila_Giorgi,2,B-IO,11,5,3,0,2,7,4
20210922-W-Ostrava-R16-Iga_Swiatek-Yulia_Putintseva,1,F-XC,56,12,2,3,7,31,25
20210922-W-Ostrava-R16-Iga_Swiatek-Yulia_Putintseva,1,F-DTM,28,1,0,0,1,17,11
20210922-W-Ostrava-R16-Iga_Swiatek-Yulia_Putintseva,1,F-DTL,11,2,0,1,1,8,3
20210922-W-Ostrava-R16-Iga_Swiatek-Yulia_Putintseva,1,F-IO,27,11,5,3,3,12,15
20210922-W-Ostrava-R16-Iga_Swiatek-Yulia_Putintseva,1,F-II,2,0,0,0,0,1,1
20210922-W-Ostrava-R16-Iga_Swiatek-Yulia_Putintseva,1,B-XC,95,9,0,2,7,60,35
20210922-W-Ostrava-R16-Iga_Swiatek-Yulia_Putintseva,1,B-DTM,35,1,0,0,1,19,16
20210922-W-Ostrava-R16-Iga_Swiatek-Yulia_Putintseva,1,B-DTL,26,11,4,1,6,12,14
20210922-W-Ostrava-R16-Iga_Swiatek-Yulia_Putintseva,1,B-IO,12,3,1,0,2,6,6
20210922-W-Ostrava-R16-Iga_Swiatek-Yulia_Putintseva,1,S-XC,6,1,0,0,1,2,4
20210922-W-Ostrava-R16-Iga_Swiatek-Yulia_Putintseva,1,S-DTM,2,0,0,0,0,0,2
20210922-W-Ostrava-R16-Iga_Swiatek-Yulia_Putintseva,2,F-XC,54,9,5,1,3,26,28
20210922-W-Ostrava-R16-Iga_Swiatek-Yulia_Putintseva,2,F-DTM,34,1,0,0,1,17,17
20210922-W-Ostrava-R16-Iga_Swiatek-Yulia_Putintseva,2,F-DTL,25,3,0,0,3,14,11
20210922-W-Ostrava-R16-Iga_Swiatek-Yulia_Putintseva,2,F-IO,18,1,0,0,1,8,10
20210922-W-Ostrava-R16-Iga_Swiatek-Yulia_Putintseva,2,F-II,2,1,1,0,0,1,1
20210922-W-Ostrava-R16-Iga_Swiatek-Yulia_Putintseva,2,B-XC,76,6,2,1,3,30,46
20210922-W-Ostrava-R16-Iga_Swiatek-Yulia_Putintseva,2,B-DTM,38,1,0,0,1,19,19
20210922-W-Ostrava-R16-Iga_Swiatek-Yulia_Putintseva,2,B-DTL,12,4,4,0,0,9,3
20210922-W-Ostrava-R16-Iga_Swiatek-Yulia_Putintseva,2,B-IO,4,2,0,1,1,2,2
20210922-W-Ostrava-R16-Iga_Swiatek-Yulia_Putintseva,2,B-II,1,0,0,0,0,0,1
20210922-W-Ostrava-R16-Iga_Swiatek-Yulia_Putintseva,2,S-XC,17,2,0,0,2,7,10
20210922-W-Ostrava-R16-Iga_Swiatek-Yulia_Putintseva,2,S-DTM,11,0,0,0,0,7,4
20210922-W-Ostrava-R16-Iga_Swiatek-Yulia_Putintseva,2,S-DTL,1,0,0,0,0,0,1
20210924-W-Ostrava-QF-Elena_Rybakina-Iga_Swiatek,1,F-XC,65,15,6,1,8,38,27
20210924-W-Ostrava-QF-Elena_Rybakina-Iga_Swiatek,1,F-DTM,22,3,0,1,2,8,14
20210924-W-Ostrava-QF-Elena_Rybakina-Iga_Swiatek,1,F-DTL,6,4,3,0,1,5,1
20210924-W-Ostrava-QF-Elena_Rybakina-Iga_Swiatek,1,F-IO,10,4,2,0,2,7,3
20210924-W-Ostrava-QF-Elena_Rybakina-Iga_Swiatek,1,B-XC,41,5,1,0,4,21,20
20210924-W-Ostrava-QF-Elena_Rybakina-Iga_Swiatek,1,B-DTM,19,1,0,0,1,10,9
20210924-W-Ostrava-QF-Elena_Rybakina-Iga_Swiatek,1,B-DTL,6,2,1,0,1,3,3
20210924-W-Ostrava-QF-Elena_Rybakina-Iga_Swiatek,1,B-IO,10,5,3,0,2,6,4
20210924-W-Ostrava-QF-Elena_Rybakina-Iga_Swiatek,1,B-II,1,0,0,0,0,1,0
20210924-W-Ostrava-QF-Elena_Rybakina-Iga_Swiatek,1,S-XC,1,1,0,0,1,0,1
20210924-W-Ostrava-QF-Elena_Rybakina-Iga_Swiatek,1,S-IO,1,0,0,0,0,1,0
20210924-W-Ostrava-QF-Elena_Rybakina-Iga_Swiatek,2,F-XC,42,9,3,1,5,19,23
20210924-W-Ostrava-QF-Elena_Rybakina-Iga_Swiatek,2,F-DTM,25,1,0,0,1,9,16
20210924-W-Ostrava-QF-Elena_Rybakina-Iga_Swiatek,2,F-DTL,11,2,0,1,1,4,7
20210924-W-Ostrava-QF-Elena_Rybakina-Iga_Swiatek,2,F-IO,11,7,2,1,4,6,5
20210924-W-Ostrava-QF-Elena_Rybakina-Iga_Swiatek,2,B-XC,32,6,1,1,4,14,18
20210924-W-Ostrava-QF-Elena_Rybakina-Iga_Swiatek,2,B-DTM,25,2,0,0,2,10,15
20210924-W-Ostrava-QF-Elena_Rybakina-Iga_Swiatek,2,B-DTL,8,3,1,0,2,3,5
20210924-W-Ostrava-QF-Elena_Rybakina-Iga_Swiatek,2,B-IO,6,3,1,1,1,4,2
20210924-W-Ostrava-QF-Elena_Rybakina-Iga_Swiatek,2,S-DTM,1,0,0,0,0,0,1
19980906-W-New_Haven-F-Steffi_Graf-Jana_Novotna,1,F-XC,28,5,1,1,3,15,13
19980906-W-New_Haven-F-Steffi_Graf-Jana_Novotna,1,F-DTM,5,0,0,0,0,3,2
19980906-W-New_Haven-F-Steffi_Graf-Jana_Novotna,1,F-DTL,11,1,1,0,0,4,7
19980906-W-New_Haven-F-Steffi_Graf-Jana_Novotna,1,F-IO,30,8,4,3,1,22,8
19980906-W-New_Haven-F-Steffi_Graf-Jana_Novotna,1,F-II,9,4,3,0,1,6,3
19980906-W-New_Haven-F-Steffi_Graf-Jana_Novotna,1,B-XC,2,2,1,1,0,2,0
19980906-W-New_Haven-F-Steffi_Graf-Jana_Novotna,1,B-DTM,2,0,0,0,0,1,1
19980906-W-New_Haven-F-Steffi_Graf-Jana_Novotna,1,B-DTL,5,3,2,0,1,4,1
19980906-W-New_Haven-F-Steffi_Graf-Jana_Novotna,1,S-XC,32,4,0,0,4,13,19
19980906-W-New_Haven-F-Steffi_Graf-Jana_Novotna,1,S-DTM,6,1,0,0,1,3,3
19980906-W-New_Haven-F-Steffi_Graf-Jana_Novotna,1,S-DTL,11,2,1,0,1,5,6
19980906-W-New_Haven-F-Steffi_Graf-Jana_Novotna,1,S-IO,3,0,0,0,0,1,2
19980906-W-New_Haven-F-Steffi_Graf-Jana_Novotna,2,F-XC,17,3,0,0,3,9,8
19980906-W-New_Haven-F-Steffi_Graf-Jana_Novotna,2,F-DTM,10,1,0,0,1,2,8
19980906-W-New_Haven-F-Steffi_Graf-Jana_Novotna,2,F-DTL,14,6,2,0,4,4,10
19980906-W-New_Haven-F-Steffi_Graf-Jana_Novotna,2,F-IO,8,3,0,0,3,3,5
19980906-W-New_Haven-F-Steffi_Graf-Jana_Novotna,2,F-II,1,0,0,0,0,0,1
19980906-W-New_Haven-F-Steffi_Graf-Jana_Novotna,2,B-DTM,1,0,0,0,0,0,1
19980906-W-New_Haven-F-Steffi_Graf-Jana_Novotna,2,B-DTL,2,1,0,0,1,1,1
19980906-W-New_Haven-F-Steffi_Graf-Jana_Novotna,2,S-XC,45,5,1,1,3,21,24
19980906-W-New_Haven-F-Steffi_Graf-Jana_Novotna,2,S-DTM,12,2,0,0,2,7,5
19980906-W-New_Haven-F-Steffi_Graf-Jana_Novotna,2,S-DTL,12,1,1,0,0,7,5
19980906-W-New_Haven-F-Steffi_Graf-Jana_Novotna,2,S-II,1,0,0,0,0,1,0
19950219-W-Paris-F-Steffi_Graf-Mary_Pierce,1,F-XC,29,11,8,1,2,17,12
19950219-W-Paris-F-Steffi_Graf-Mary_Pierce,1,F-DTM,7,0,0,0,0,4,3
19950219-W-Paris-F-Steffi_Graf-Mary_Pierce,1,F-DTL,12,6,1,2,3,7,5
19950219-W-Paris-F-Steffi_Graf-Mary_Pierce,1,F-IO,15,7,4,2,1,12,3
19950219-W-Paris-F-Steffi_Graf-Mary_Pierce,1,F-II,3,1,1,0,0,3,0
19950219-W-Paris-F-Steffi_Graf-Mary_Pierce,1,B-XC,3,2,0,1,1,1,2
19950219-W-Paris-F-Steffi_Graf-Mary_Pierce,1,B-DTM,1,0,0,0,0,1,0
19950219-W-Paris-F-Steffi_Graf-Mary_Pierce,1,B-DTL,1,1,0,0,1,0,1
19950219-W-Paris-F-Steffi_Graf-Mary_Pierce,1,S-XC,33,4,1,0,3,13,20
19950219-W-Paris-F-Steffi_Graf-Mary_Pierce,1,S-DTM,11,1,0,0,1,4,7
19950219-W-Paris-F-Steffi_Graf-Mary_Pierce,1,S-DTL,19,5,1,2,2,13,6
19950219-W-Paris-F-Steffi_Graf-Mary_Pierce,1,S-IO,4,0,0,0,0,3,1
19950219-W-Paris-F-Steffi_Graf-Mary_Pierce,2,F-XC,18,6,3,1,2,9,9
19950219-W-Paris-F-Steffi_Graf-Mary_Pierce,2,F-DTM,11,0,0,0,0,4,7
19950219-W-Paris-F-Steffi_Graf-Mary_Pierce,2,F-DTL,22,3,1,0,2,10,12
19950219-W-Paris-F-Steffi_Graf-Mary_Pierce,2,F-IO,6,4,1,0,3,1,5
19950219-W-Paris-F-Steffi_Graf-Mary_Pierce,2,B-XC,45,5,2,0,3,20,25
19950219-W-Paris-F-Steffi_Graf-Mary_Pierce,2,B-DTM,6,0,0,0,0,2,4
19950219-W-Paris-F-Steffi_Graf-Mary_Pierce,2,B-DTL,13,4,1,2,1,8,5
19950219-W-Paris-F-Steffi_Graf-Mary_Pierce,2,B-IO,2,0,0,0,0,1,1
19950219-W-Paris-F-Steffi_Graf-Mary_Pierce,2,S-XC,3,0,0,0,0,2,1
19950219-W-Paris-F-Steffi_Graf-Mary_Pierce,2,S-DTM,5,0,0,0,0,0,5
19950219-W-Paris-F-Steffi_Graf-Mary_Pierce,2,S-IO,1,0,0,0,0,1,0
19930808-W-San_Diego-F-Steffi_Graf-Arantxa_Sanchez_Vicario,1,F-XC,79,24,2,11,11,44,35
19930808-W-San_Diego-F-Steffi_Graf-Arantxa_Sanchez_Vicario,1,F-DTM,15,2,0,0,2,5,10
19930808-W-San_Diego-F-Steffi_Graf-Arantxa_Sanchez_Vicario,1,F-DTL,5,1,1,0,0,3,2
19930808-W-San_Diego-F-Steffi_Graf-Arantxa_Sanchez_Vicario,1,F-IO,18,5,3,1,1,6,12
19930808-W-San_Diego-F-Steffi_Graf-Arantxa_Sanchez_Vicario,1,F-II,11,3,1,1,1,9,2
19930808-W-San_Diego-F-Steffi_Graf-Arantxa_Sanchez_Vicario,1,B-XC,5,4,1,0,3,1,4
19930808-W-San_Diego-F-Steffi_Graf-Arantxa_Sanchez_Vicario,1,B-DTM,6,1,0,1,0,3,3
19930808-W-San_Diego-F-Steffi_Graf-Arantxa_Sanchez_Vicario,1,B-DTL,1,1,1,0,0,1,0
19930808-W-San_Diego-F-Steffi_Graf-Arantxa_Sanchez_Vicario,1,S-XC,71,8,1,1,6,33,38
19930808-W-San_Diego-F-Steffi_Graf-Arantxa_Sanchez_Vicario,1,S-DTM,15,1,0,0,1,5,10
19930808-W-San_Diego-F-Steffi_Graf-Arantxa_Sanchez_Vicario,1,S-DTL,21,7,0,2,5,12,9
19930808-W-San_Diego-F-Steffi_Graf-Arantxa_Sanchez_Vicario,1,S-IO,7,0,0,0,0,5,2
19930808-W-San_Diego-F-Steffi_Graf-Arantxa_Sanchez_Vicario,2,F-XC,36,4,2,1,1,15,21
19930808-W-San_Diego-F-Steffi_Graf-Arantxa_Sanchez_Vicario,2,F-DTM,24,1,0,0,1,13,11
19930808-W-San_Diego-F-Steffi_Graf-Arantxa_Sanchez_Vicario,2,F-DTL,33,4,0,0,4,12,21
19930808-W-San_Diego-F-Steffi_Graf-Arantxa_Sanchez_Vicario,2,F-IO,4,0,0,0,0,2,2
19930808-W-San_Diego-F-Steffi_Graf-Arantxa_Sanchez_Vicario,2,F-II,1,0,0,0,0,1,0
19930808-W-San_Diego-F-Steffi_Graf-Arantxa_Sanchez_Vicario,2,B-XC,63,11,5,3,3,33,30
19930808-W-San_Diego-F-Steffi_Graf-Arantxa_Sanchez_Vicario,2,B-DTM,22,0,0,0,0,11,11
19930808-W-San_Diego-F-Steffi_Graf-Arantxa_Sanchez_Vicario,2,B-DTL,4,4,3,0,1,3,1
19930808-W-San_Diego-F-Steffi_Graf-Arantxa_Sanchez_Vicario,2,B-IO,4,1,0,1,0,2,2
19930808-W-San_Diego-F-Steffi_Graf-Arantxa_Sanchez_Vicario,2,S-XC,25,1,0,1,0,15,10
19930808-W-San_Diego-F-Steffi_Graf-Arantxa_Sanchez_Vicario,2,S-DTM,4,0,0,0,0,2,2
19930808-W-San_Diego-F-Steffi_Graf-Arantxa_Sanchez_Vicario,2,S-DTL,8,1,0,0,1,5,3
20211012-W-Indian_Wells-R16-Jelena_Ostapenko-Iga_Swiatek,1,F-XC,39,16,6,2,8,23,16
20211012-W-Indian_Wells-R16-Jelena_Ostapenko-Iga_Swiatek,1,F-DTM,6,1,1,0,0,5,1
20211012-W-Indian_Wells-R16-Jelena_Ostapenko-Iga_Swiatek,1,F-DTL,7,3,1,0,2,3,4
20211012-W-Indian_Wells-R16-Jelena_Ostapenko-Iga_Swiatek,1,F-IO,10,7,4,2,1,8,2
20211012-W-Indian_Wells-R16-Jelena_Ostapenko-Iga_Swiatek,1,F-II,2,0,0,0,0,2,0
20211012-W-Indian_Wells-R16-Jelena_Ostapenko-Iga_Swiatek,1,B-XC,29,13,5,1,7,16,13
20211012-W-Indian_Wells-R16-Jelena_Ostapenko-Iga_Swiatek,1,B-DTM,10,1,1,0,0,7,3
20211012-W-Indian_Wells-R16-Jelena_Ostapenko-Iga_Swiatek,1,B-DTL,5,2,0,0,2,1,4
20211012-W-Indian_Wells-R16-Jelena_Ostapenko-Iga_Swiatek,1,B-IO,4,3,3,0,0,3,1
20211012-W-Indian_Wells-R16-Jelena_Ostapenko-Iga_Swiatek,2,F-XC,16,5,1,1,3,7,9
20211012-W-Indian_Wells-R16-Jelena_Ostapenko-Iga_Swiatek,2,F-DTM,11,2,0,0,2,3,8
20211012-W-Indian_Wells-R16-Jelena_Ostapenko-Iga_Swiatek,2,F-DTL,10,6,1,1,4,3,7
20211012-W-Indian_Wells-R16-Jelena_Ostapenko-Iga_Swiatek,2,F-IO,7,2,1,0,1,4,3
20211012-W-Indian_Wells-R16-Jelena_Ostapenko-Iga_Swiatek,2,F-II,1,0,0,0,0,0,1
20211012-W-Indian_Wells-R16-Jelena_Ostapenko-Iga_Swiatek,2,B-XC,16,5,0,1,4,7,9
20211012-W-Indian_Wells-R16-Jelena_Ostapenko-Iga_Swiatek,2,B-DTM,24,0,0,0,0,7,17
20211012-W-Indian_Wells-R16-Jelena_Ostapenko-Iga_Swiatek,2,B-DTL,2,1,1,0,0,1,1
20211012-W-Indian_Wells-R16-Jelena_Ostapenko-Iga_Swiatek,2,B-IO,2,1,0,1,0,2,0
20211012-W-Indian_Wells-R16-Jelena_Ostapenko-Iga_Swiatek,2,S-XC,2,0,0,0,0,1,1
20211012-W-Indian_Wells-R16-Jelena_Ostapenko-Iga_Swiatek,2,S-DTM,2,0,0,0,0,0,2
20211010-W-Indian_Wells-R32-Iga_Swiatek-Veronika_Kudermetova,1,F-XC,10,2,1,0,1,5,5
20211010-W-Indian_Wells-R32-Iga_Swiatek-Veronika_Kudermetova,1,F-DTM,15,2,1,0,1,8,7
20211010-W-Indian_Wells-R32-Iga_Swiatek-Veronika_Kudermetova,1,F-DTL,7,4,2,0,2,3,4
20211010-W-Indian_Wells-R32-Iga_Swiatek-Veronika_Kudermetova,1,F-IO,4,2,1,0,1,3,1
20211010-W-Indian_Wells-R32-Iga_Swiatek-Veronika_Kudermetova,1,B-XC,10,1,1,0,0,10,0
20211010-W-Indian_Wells-R32-Iga_Swiatek-Veronika_Kudermetova,1,B-DTM,7,0,0,0,0,4,3
20211010-W-Indian_Wells-R32-Iga_Swiatek-Veronika_Kudermetova,1,B-DTL,4,3,3,0,0,4,0
20211010-W-Indian_Wells-R32-Iga_Swiatek-Veronika_Kudermetova,1,B-IO,2,2,1,0,1,1,1
20211010-W-Indian_Wells-R32-Iga_Swiatek-Veronika_Kudermetova,1,S-XC,1,0,0,0,0,0,1
20211010-W-Indian_Wells-R32-Iga_Swiatek-Veronika_Kudermetova,1,S-DTM,1,0,0,0,0,0,1
20211010-W-Indian_Wells-R32-Iga_Swiatek-Veronika_Kudermetova,2,F-XC,15,5,2,0,3,7,8
20211010-W-Indian_Wells-R32-Iga_Swiatek-Veronika_Kudermetova,2,F-DTM,9,0,0,0,0,2,7
20211010-W-Indian_Wells-R32-Iga_Swiatek-Veronika_Kudermetova,2,F-DTL,1,0,0,0,0,1,0
20211010-W-Indian_Wells-R32-Iga_Swiatek-Veronika_Kudermetova,2,F-IO,5,4,1,1,2,2,3
20211010-W-Indian_Wells-R32-Iga_Swiatek-Veronika_Kudermetova,2,F-II,2,0,0,0,0,2,0
20211010-W-Indian_Wells-R32-Iga_Swiatek-Veronika_Kudermetova,2,B-XC,16,6,0,0,6,3,13
20211010-W-Indian_Wells-R32-Iga_Swiatek-Veronika_Kudermetova,2,B-DTM,18,5,0,0,5,6,12
20211010-W-Indian_Wells-R32-Iga_Swiatek-Veronika_Kudermetova,2,B-DTL,2,0,0,0,0,0,2
20211010-W-Indian_Wells-R32-Iga_Swiatek-Veronika_Kudermetova,2,B-IO,5,4,2,0,2,2,3
20211010-W-Indian_Wells-R32-Iga_Swiatek-Veronika_Kudermetova,2,S-XC,1,1,0,1,0,1,0
20211008-W-Indian_Wells-R64-Iga_Swiatek-Petra_Martic,1,F-XC,27,9,3,2,4,17,10
20211008-W-Indian_Wells-R64-Iga_Swiatek-Petra_Martic,1,F-DTM,9,3,1,0,2,5,4
20211008-W-Indian_Wells-R64-Iga_Swiatek-Petra_Martic,1,F-DTL,17,5,3,1,1,14,3
20211008-W-Indian_Wells-R64-Iga_Swiatek-Petra_Martic,1,F-IO,6,1,1,0,0,5,1
20211008-W-Indian_Wells-R64-Iga_Swiatek-Petra_Martic,1,F-II,1,1,1,0,0,1,0
20211008-W-Indian_Wells-R64-Iga_Swiatek-Petra_Martic,1,B-XC,16,2,1,0,1,12,4
20211008-W-Indian_Wells-R64-Iga_Swiatek-Petra_Martic,1,B-DTM,9,1,0,0,1,3,6
20211008-W-Indian_Wells-R64-Iga_Swiatek-Petra_Martic,1,B-DTL,3,2,1,0,1,2,1
20211008-W-Indian_Wells-R64-Iga_Swiatek-Petra_Martic,1,B-IO,1,1,1,0,0,1,0
20211008-W-Indian_Wells-R64-Iga_Swiatek-Petra_Martic,1,B-II,1,0,0,0,0,0,1
20211008-W-Indian_Wells-R64-Iga_Swiatek-Petra_Martic,1,S-XC,1,0,0,0,0,1,0
20211008-W-Indian_Wells-R64-Iga_Swiatek-Petra_Martic,1,S-DTM,1,0,0,0,0,0,1
20211008-W-Indian_Wells-R64-Iga_Swiatek-Petra_Martic,2,F-XC,29,9,1,0,8,9,20
20211008-W-Indian_Wells-R64-Iga_Swiatek-Petra_Martic,2,F-DTM,11,3,0,0,3,3,8
20211008-W-Indian_Wells-R64-Iga_Swiatek-Petra_Martic,2,F-DTL,3,2,1,0,1,2,1
20211008-W-Indian_Wells-R64-Iga_Swiatek-Petra_Martic,2,F-IO,8,4,2,1,1,6,2
20211008-W-Indian_Wells-R64-Iga_Swiatek-Petra_Martic,2,F-II,4,2,1,0,1,2,2
20211008-W-Indian_Wells-R64-Iga_Swiatek-Petra_Martic,2,B-XC,14,4,0,0,4,2,12
20211008-W-Indian_Wells-R64-Iga_Swiatek-Petra_Martic,2,B-DTM,7,3,0,0,3,1,6
20211008-W-Indian_Wells-R64-Iga_Swiatek-Petra_Martic,2,B-DTL,10,3,1,1,1,5,5
20211008-W-Indian_Wells-R64-Iga_Swiatek-Petra_Martic,2,B-IO,3,1,1,0,0,2,1
20211008-W-Indian_Wells-R64-Iga_Swiatek-Petra_Martic,2,B-II,1,0,0,0,0,1,0
20211008-W-Indian_Wells-R64-Iga_Swiatek-Petra_Martic,2,S-XC,2,0,0,0,0,1,1
20211008-W-Indian_Wells-R64-Iga_Swiatek-Petra_Martic,2,S-DTM,4,0,0,0,0,0,4
20211008-W-Indian_Wells-R64-Iga_Swiatek-Petra_Martic,2,S-DTL,5,1,0,0,1,0,5
20211008-W-Indian_Wells-R64-Iga_Swiatek-Petra_Martic,2,S-IO,1,1,0,1,0,1,0
20210925-W-Ostrava-SF-Iga_Swiatek-Maria_Sakkari,1,F-XC,43,11,6,3,2,23,20
20210925-W-Ostrava-SF-Iga_Swiatek-Maria_Sakkari,1,F-DTM,15,2,0,0,2,4,11
20210925-W-Ostrava-SF-Iga_Swiatek-Maria_Sakkari,1,F-DTL,21,7,1,2,4,8,13
20210925-W-Ostrava-SF-Iga_Swiatek-Maria_Sakkari,1,F-IO,17,2,0,0,2,8,9
20210925-W-Ostrava-SF-Iga_Swiatek-Maria_Sakkari,1,F-II,1,0,0,0,0,1,0
20210925-W-Ostrava-SF-Iga_Swiatek-Maria_Sakkari,1,B-XC,40,6,1,0,5,18,22
20210925-W-Ostrava-SF-Iga_Swiatek-Maria_Sakkari,1,B-DTM,23,2,0,0,2,7,16
20210925-W-Ostrava-SF-Iga_Swiatek-Maria_Sakkari,1,B-DTL,12,11,4,3,4,7,5
20210925-W-Ostrava-SF-Iga_Swiatek-Maria_Sakkari,1,B-IO,2,1,1,0,0,2,0
20210925-W-Ostrava-SF-Iga_Swiatek-Maria_Sakkari,1,S-XC,2,0,0,0,0,0,2
20210925-W-Ostrava-SF-Iga_Swiatek-Maria_Sakkari,2,F-XC,46,10,3,3,4,27,19
20210925-W-Ostrava-SF-Iga_Swiatek-Maria_Sakkari,2,F-DTM,18,5,1,0,4,10,8
20210925-W-Ostrava-SF-Iga_Swiatek-Maria_Sakkari,2,F-DTL,6,4,2,1,1,3,3
20210925-W-Ostrava-SF-Iga_Swiatek-Maria_Sakkari,2,F-IO,11,6,4,0,2,7,4
20210925-W-Ostrava-SF-Iga_Swiatek-Maria_Sakkari,2,F-II,2,2,0,1,1,1,1
20210925-W-Ostrava-SF-Iga_Swiatek-Maria_Sakkari,2,B-XC,48,7,2,1,4,29,19
20210925-W-Ostrava-SF-Iga_Swiatek-Maria_Sakkari,2,B-DTM,32,1,0,0,1,18,14
20210925-W-Ostrava-SF-Iga_Swiatek-Maria_Sakkari,2,B-DTL,6,0,0,0,0,2,4
20210925-W-Ostrava-SF-Iga_Swiatek-Maria_Sakkari,2,B-IO,2,0,0,0,0,2,0
20210925-W-Ostrava-SF-Iga_Swiatek-Maria_Sakkari,2,S-XC,1,1,0,1,0,1,0
20210513-W-Rome-R32-Iga_Swiatek-Madison_Keys,1,F-XC,11,5,2,1,2,6,5
20210513-W-Rome-R32-Iga_Swiatek-Madison_Keys,1,F-DTM,8,1,0,0,1,4,4
20210513-W-Rome-R32-Iga_Swiatek-Madison_Keys,1,F-DTL,8,4,0,3,1,6,2
20210513-W-Rome-R32-Iga_Swiatek-Madison_Keys,1,F-IO,11,2,1,0,1,6,5
20210513-W-Rome-R32-Iga_Swiatek-Madison_Keys,1,F-II,2,2,0,2,0,2,0
20210513-W-Rome-R32-Iga_Swiatek-Madison_Keys,1,B-XC,31,5,1,0,4,24,7
20210513-W-Rome-R32-Iga_Swiatek-Madison_Keys,1,B-DTM,12,4,0,0,4,6,6
20210513-W-Rome-R32-Iga_Swiatek-Madison_Keys,1,B-DTL,5,1,0,0,1,3,2
20210513-W-Rome-R32-Iga_Swiatek-Madison_Keys,1,B-IO,4,2,1,0,1,3,1
20210513-W-Rome-R32-Iga_Swiatek-Madison_Keys,1,B-II,1,0,0,0,0,0,1
20210513-W-Rome-R32-Iga_Swiatek-Madison_Keys,1,S-XC,3,0,0,0,0,3,0
20210513-W-Rome-R32-Iga_Swiatek-Madison_Keys,1,S-DTM,1,0,0,0,0,1,0
20210513-W-Rome-R32-Iga_Swiatek-Madison_Keys,1,S-DTL,1,0,0,0,0,1,0
20210513-W-Rome-R32-Iga_Swiatek-Madison_Keys,2,F-XC,17,6,0,0,6,5,12
20210513-W-Rome-R32-Iga_Swiatek-Madison_Keys,2,F-DTM,6,2,0,0,2,1,5
20210513-W-Rome-R32-Iga_Swiatek-Madison_Keys,2,F-DTL,7,4,1,1,2,3,4
20210513-W-Rome-R32-Iga_Swiatek-Madison_Keys,2,F-IO,24,15,6,2,7,9,15
20210513-W-Rome-R32-Iga_Swiatek-Madison_Keys,2,F-II,2,1,0,0,1,0,2
20210513-W-Rome-R32-Iga_Swiatek-Madison_Keys,2,B-XC,31,3,0,0,3,7,24
20210513-W-Rome-R32-Iga_Swiatek-Madison_Keys,2,B-DTM,15,4,0,0,4,6,9
20210513-W-Rome-R32-Iga_Swiatek-Madison_Keys,2,B-DTL,9,6,1,0,5,2,7
20210513-W-Rome-R32-Iga_Swiatek-Madison_Keys,2,B-IO,4,2,1,0,1,3,1
20210513-W-Rome-R32-Iga_Swiatek-Madison_Keys,2,S-XC,1,1,0,0,1,0,1
20210513-W-Rome-R32-Iga_Swiatek-Madison_Keys,2,S-DTL,1,0,0,0,0,0,1
19960317-W-Indian_Wells-F-Conchita_Martinez-Steffi_Graf,1,F-XC,33,5,2,2,1,15,18
19960317-W-Indian_Wells-F-Conchita_Martinez-Steffi_Graf,1,F-DTM,22,1,0,0,1,13,9
19960317-W-Indian_Wells-F-Conchita_Martinez-Steffi_Graf,1,F-DTL,38,9,4,0,5,17,21
19960317-W-Indian_Wells-F-Conchita_Martinez-Steffi_Graf,1,F-IO,33,7,3,0,4,16,17
19960317-W-Indian_Wells-F-Conchita_Martinez-Steffi_Graf,1,F-II,16,11,6,2,3,9,7
19960317-W-Indian_Wells-F-Conchita_Martinez-Steffi_Graf,1,B-XC,4,3,1,0,2,1,3
19960317-W-Indian_Wells-F-Conchita_Martinez-Steffi_Graf,1,B-DTL,1,1,0,0,1,0,1
19960317-W-Indian_Wells-F-Conchita_Martinez-Steffi_Graf,1,B-IO,1,0,0,0,0,0,1
19960317-W-Indian_Wells-F-Conchita_Martinez-Steffi_Graf,1,S-XC,116,11,0,0,11,45,71
19960317-W-Indian_Wells-F-Conchita_Martinez-Steffi_Graf,1,S-DTM,12,2,0,0,2,8,4
19960317-W-Indian_Wells-F-Conchita_Martinez-Steffi_Graf,1,S-DTL,22,6,1,0,4,7,15
19960317-W-Indian_Wells-F-Conchita_Martinez-Steffi_Graf,1,S-IO,1,0,0,0,0,0,1
19960317-W-Indian_Wells-F-Conchita_Martinez-Steffi_Graf,2,F-XC,43,13,5,3,5,25,18
19960317-W-Indian_Wells-F-Conchita_Martinez-Steffi_Graf,2,F-DTM,13,0,0,0,0,4,9
19960317-W-Indian_Wells-F-Conchita_Martinez-Steffi_Graf,2,F-DTL,16,4,2,1,1,12,4
19960317-W-Indian_Wells-F-Conchita_Martinez-Steffi_Graf,2,F-IO,49,18,5,4,9,29,20
19960317-W-Indian_Wells-F-Conchita_Martinez-Steffi_Graf,2,F-II,20,10,3,1,6,9,11
19960317-W-Indian_Wells-F-Conchita_Martinez-Steffi_Graf,2,B-XC,2,1,0,0,1,0,2
19960317-W-Indian_Wells-F-Conchita_Martinez-Steffi_Graf,2,B-DTM,4,0,0,0,0,1,3
19960317-W-Indian_Wells-F-Conchita_Martinez-Steffi_Graf,2,B-DTL,1,1,1,0,0,1,0
19960317-W-Indian_Wells-F-Conchita_Martinez-Steffi_Graf,2,S-XC,109,14,0,1,13,59,50
19960317-W-Indian_Wells-F-Conchita_Martinez-Steffi_Graf,2,S-DTM,11,2,0,0,2,2,9
19960317-W-Indian_Wells-F-Conchita_Martinez-Steffi_Graf,2,S-DTL,32,6,2,1,3,19,13
19960317-W-Indian_Wells-F-Conchita_Martinez-Steffi_Graf,2,S-IO,2,0,0,0,0,1,1
20220104-W-Adelaide-R32-Victoria_Azarenka-Paula_Badosa,1,F-XC,28,7,0,5,2,19,9
20220104-W-Adelaide-R32-Victoria_Azarenka-Paula_Badosa,1,F-DTM,11,1,0,1,0,5,6
20220104-W-Adelaide-R32-Victoria_Azarenka-Paula_Badosa,1,F-DTL,16,6,3,2,1,13,3
20220104-W-Adelaide-R32-Victoria_Azarenka-Paula_Badosa,1,F-IO,15,3,0,3,0,11,4
20220104-W-Adelaide-R32-Victoria_Azarenka-Paula_Badosa,1,B-XC,38,10,4,6,0,26,12
20220104-W-Adelaide-R32-Victoria_Azarenka-Paula_Badosa,1,B-DTM,10,0,0,0,0,5,5
20220104-W-Adelaide-R32-Victoria_Azarenka-Paula_Badosa,1,B-DTL,2,1,0,0,1,0,2
20220104-W-Adelaide-R32-Victoria_Azarenka-Paula_Badosa,1,B-IO,10,1,1,0,0,6,4
20220104-W-Adelaide-R32-Victoria_Azarenka-Paula_Badosa,1,S-XC,1,0,0,0,0,0,1
20220104-W-Adelaide-R32-Victoria_Azarenka-Paula_Badosa,1,S-DTM,1,0,0,0,0,1,0
20220104-W-Adelaide-R32-Victoria_Azarenka-Paula_Badosa,2,F-XC,27,6,3,2,1,13,14
20220104-W-Adelaide-R32-Victoria_Azarenka-Paula_Badosa,2,F-DTM,24,2,2,0,0,11,13
20220104-W-Adelaide-R32-Victoria_Azarenka-Paula_Badosa,2,F-DTL,9,3,1,0,2,2,7
20220104-W-Adelaide-R32-Victoria_Azarenka-Paula_Badosa,2,F-IO,9,4,2,1,1,5,4
20220104-W-Adelaide-R32-Victoria_Azarenka-Paula_Badosa,2,F-II,1,1,1,0,0,1,0
20220104-W-Adelaide-R32-Victoria_Azarenka-Paula_Badosa,2,B-XC,24,7,2,2,3,11,13
20220104-W-Adelaide-R32-Victoria_Azarenka-Paula_Badosa,2,B-DTM,31,3,0,3,0,10,21
20220104-W-Adelaide-R32-Victoria_Azarenka-Paula_Badosa,2,B-DTL,8,5,1,2,2,3,5
20220104-W-Adelaide-R32-Victoria_Azarenka-Paula_Badosa,2,B-IO,3,2,0,2,0,2,1
20220104-W-Adelaide-R32-Victoria_Azarenka-Paula_Badosa,2,S-DTM,6,0,0,0,0,1,5
20220104-W-Adelaide-R32-Victoria_Azarenka-Paula_Badosa,2,S-DTL,3,0,0,0,0,0,3
20211014-W-Indian_Wells-QF-Paula_Badosa-Angelique_Kerber,1,F-XC,45,9,5,2,2,25,20
20211014-W-Indian_Wells-QF-Paula_Badosa-Angelique_Kerber,1,F-DTM,40,0,0,0,0,23,17
20211014-W-Indian_Wells-QF-Paula_Badosa-Angelique_Kerber,1,F-DTL,16,6,1,1,4,8,8
20211014-W-Indian_Wells-QF-Paula_Badosa-Angelique_Kerber,1,F-IO,20,8,4,1,3,11,9
20211014-W-Indian_Wells-QF-Paula_Badosa-Angelique_Kerber,1,B-XC,27,4,3,0,1,13,14
20211014-W-Indian_Wells-QF-Paula_Badosa-Angelique_Kerber,1,B-DTM,32,0,0,0,0,16,16
20211014-W-Indian_Wells-QF-Paula_Badosa-Angelique_Kerber,1,B-DTL,11,3,1,0,2,7,4
20211014-W-Indian_Wells-QF-Paula_Badosa-Angelique_Kerber,1,B-IO,4,0,0,0,0,1,3
20211014-W-Indian_Wells-QF-Paula_Badosa-Angelique_Kerber,1,S-XC,2,0,0,0,0,1,1
20211014-W-Indian_Wells-QF-Paula_Badosa-Angelique_Kerber,1,S-DTM,6,0,0,0,0,5,1
20211014-W-Indian_Wells-QF-Paula_Badosa-Angelique_Kerber,1,S-DTL,2,1,0,0,1,0,2
20211014-W-Indian_Wells-QF-Paula_Badosa-Angelique_Kerber,2,F-XC,49,4,2,0,2,22,27
20211014-W-Indian_Wells-QF-Paula_Badosa-Angelique_Kerber,2,F-DTM,21,2,0,0,2,7,14
20211014-W-Indian_Wells-QF-Paula_Badosa-Angelique_Kerber,2,F-DTL,19,7,4,0,3,12,7
20211014-W-Indian_Wells-QF-Paula_Badosa-Angelique_Kerber,2,F-IO,41,20,7,4,9,20,21
20211014-W-Indian_Wells-QF-Paula_Badosa-Angelique_Kerber,2,F-II,3,2,0,0,2,1,2
20211014-W-Indian_Wells-QF-Paula_Badosa-Angelique_Kerber,2,B-XC,37,11,0,4,7,16,21
20211014-W-Indian_Wells-QF-Paula_Badosa-Angelique_Kerber,2,B-DTM,21,1,0,1,0,14,7
20211014-W-Indian_Wells-QF-Paula_Badosa-Angelique_Kerber,2,B-DTL,7,3,1,1,1,3,4
20211014-W-Indian_Wells-QF-Paula_Badosa-Angelique_Kerber,2,B-IO,11,3,0,0,3,3,8
20211014-W-Indian_Wells-QF-Paula_Badosa-Angelique_Kerber,2,S-XC,2,0,0,0,0,1,1
20211014-W-Indian_Wells-QF-Paula_Badosa-Angelique_Kerber,2,S-DTM,4,0,0,0,0,3,1
20211014-W-Indian_Wells-QF-Paula_Badosa-Angelique_Kerber,2,S-DTL,1,1,1,0,0,1,0
20211012-W-Indian_Wells-R16-Jessica_Pegula-Elina_Svitolina,1,F-XC,18,9,3,4,2,14,4
20211012-W-Indian_Wells-R16-Jessica_Pegula-Elina_Svitolina,1,F-DTM,12,1,0,0,1,7,5
20211012-W-Indian_Wells-R16-Jessica_Pegula-Elina_Svitolina,1,F-DTL,5,3,1,1,1,3,2
20211012-W-Indian_Wells-R16-Jessica_Pegula-Elina_Svitolina,1,F-IO,13,3,1,0,2,9,4
20211012-W-Indian_Wells-R16-Jessica_Pegula-Elina_Svitolina,1,B-XC,30,7,2,3,2,21,9
20211012-W-Indian_Wells-R16-Jessica_Pegula-Elina_Svitolina,1,B-DTM,25,3,0,1,2,14,11
20211012-W-Indian_Wells-R16-Jessica_Pegula-Elina_Svitolina,1,B-DTL,6,4,1,1,2,3,3
20211012-W-Indian_Wells-R16-Jessica_Pegula-Elina_Svitolina,1,B-IO,3,0,0,0,0,3,0
20211012-W-Indian_Wells-R16-Jessica_Pegula-Elina_Svitolina,1,S-XC,5,0,0,0,0,5,0
20211012-W-Indian_Wells-R16-Jessica_Pegula-Elina_Svitolina,1,S-DTM,3,0,0,0,0,2,1
20211012-W-Indian_Wells-R16-Jessica_Pegula-Elina_Svitolina,2,F-XC,18,6,3,2,1,8,10
20211012-W-Indian_Wells-R16-Jessica_Pegula-Elina_Svitolina,2,F-DTM,22,1,0,0,1,10,12
20211012-W-Indian_Wells-R16-Jessica_Pegula-Elina_Svitolina,2,F-DTL,9,3,1,0,2,3,6
20211012-W-Indian_Wells-R16-Jessica_Pegula-Elina_Svitolina,2,F-IO,21,8,2,1,5,7,14
20211012-W-Indian_Wells-R16-Jessica_Pegula-Elina_Svitolina,2,B-XC,32,5,0,1,4,9,23
20211012-W-Indian_Wells-R16-Jessica_Pegula-Elina_Svitolina,2,B-DTM,19,2,0,0,2,8,11
20211012-W-Indian_Wells-R16-Jessica_Pegula-Elina_Svitolina,2,B-DTL,5,4,2,0,2,2,3
20211012-W-Indian_Wells-R16-Jessica_Pegula-Elina_Svitolina,2,B-IO,9,2,1,0,1,3,6
20211012-W-Indian_Wells-R16-Jessica_Pegula-Elina_Svitolina,2,S-XC,5,0,0,0,0,1,4
20211012-W-Indian_Wells-R16-Jessica_Pegula-Elina_Svitolina,2,S-DTM,3,0,0,0,0,1,2
20220106-W-Adelaide-R16-Iga_Swiatek-Leylah_Annie_Fernandez,1,F-XC,28,9,5,2,2,19,9
20220106-W-Adelaide-R16-Iga_Swiatek-Leylah_Annie_Fernandez,1,F-DTM,7,0,0,0,0,5,2
20220106-W-Adelaide-R16-Iga_Swiatek-Leylah_Annie_Fernandez,1,F-DTL,4,2,0,1,1,3,1
20220106-W-Adelaide-R16-Iga_Swiatek-Leylah_Annie_Fernandez,1,F-IO,12,6,3,2,1,8,4
20220106-W-Adelaide-R16-Iga_Swiatek-Leylah_Annie_Fernandez,1,B-XC,35,11,5,3,3,24,11
20220106-W-Adelaide-R16-Iga_Swiatek-Leylah_Annie_Fernandez,1,B-DTM,19,1,0,0,1,7,12
20220106-W-Adelaide-R16-Iga_Swiatek-Leylah_Annie_Fernandez,1,B-DTL,6,4,1,3,0,5,1
20220106-W-Adelaide-R16-Iga_Swiatek-Leylah_Annie_Fernandez,1,B-IO,6,1,0,0,1,4,2
20220106-W-Adelaide-R16-Iga_Swiatek-Leylah_Annie_Fernandez,1,S-XC,2,0,0,0,0,2,0
20220106-W-Adelaide-R16-Iga_Swiatek-Leylah_Annie_Fernandez,2,F-XC,46,10,3,4,3,21,25
20220106-W-Adelaide-R16-Iga_Swiatek-Leylah_Annie_Fernandez,2,F-DTM,20,2,0,1,1,9,11
20220106-W-Adelaide-R16-Iga_Swiatek-Leylah_Annie_Fernandez,2,F-DTL,14,8,4,1,3,7,7
20220106-W-Adelaide-R16-Iga_Swiatek-Leylah_Annie_Fernandez,2,F-IO,9,6,4,0,2,6,3
20220106-W-Adelaide-R16-Iga_Swiatek-Leylah_Annie_Fernandez,2,F-II,1,0,0,0,0,0,1
20220106-W-Adelaide-R16-Iga_Swiatek-Leylah_Annie_Fernandez,2,B-XC,10,1,0,0,1,4,6
20220106-W-Adelaide-R16-Iga_Swiatek-Leylah_Annie_Fernandez,2,B-DTM,13,0,0,0,0,4,9
20220106-W-Adelaide-R16-Iga_Swiatek-Leylah_Annie_Fernandez,2,B-DTL,4,1,1,0,0,3,1
20220106-W-Adelaide-R16-Iga_Swiatek-Leylah_Annie_Fernandez,2,B-IO,3,2,0,0,2,1,2
20220106-W-Adelaide-R16-Iga_Swiatek-Leylah_Annie_Fernandez,2,S-XC,1,0,0,0,0,0,1
20220106-W-Adelaide-R16-Iga_Swiatek-Leylah_Annie_Fernandez,2,S-DTM,2,0,0,0,0,0,2
20220106-W-Adelaide-R16-Iga_Swiatek-Leylah_Annie_Fernandez,2,S-DTL,3,0,0,0,0,0,3
20220106-W-Adelaide-R16-Iga_Swiatek-Leylah_Annie_Fernandez,2,S-IO,1,0,0,0,0,0,1
20210412-W-Charleston-R32-Misaki_Doi-Nao_Hibino,1,F-XC,145,27,8,8,11,72,73
20210412-W-Charleston-R32-Misaki_Doi-Nao_Hibino,1,F-DTM,41,3,0,0,3,15,26
20210412-W-Charleston-R32-Misaki_Doi-Nao_Hibino,1,F-DTL,31,14,8,1,5,18,13
20210412-W-Charleston-R32-Misaki_Doi-Nao_Hibino,1,F-IO,56,21,6,4,11,28,28
20210412-W-Charleston-R32-Misaki_Doi-Nao_Hibino,1,F-II,6,4,2,0,2,3,3
20210412-W-Charleston-R32-Misaki_Doi-Nao_Hibino,1,B-XC,59,16,1,2,13,26,33
20210412-W-Charleston-R32-Misaki_Doi-Nao_Hibino,1,B-DTM,41,4,0,0,4,19,22
20210412-W-Charleston-R32-Misaki_Doi-Nao_Hibino,1,B-DTL,10,5,3,0,2,7,3
20210412-W-Charleston-R32-Misaki_Doi-Nao_Hibino,1,B-IO,1,0,0,0,0,1,0
20210412-W-Charleston-R32-Misaki_Doi-Nao_Hibino,1,S-XC,6,0,0,0,0,3,3
20210412-W-Charleston-R32-Misaki_Doi-Nao_Hibino,1,S-DTM,13,1,0,0,1,2,11
20210412-W-Charleston-R32-Misaki_Doi-Nao_Hibino,1,S-DTL,3,2,0,1,1,1,2
20210412-W-Charleston-R32-Misaki_Doi-Nao_Hibino,1,S-IO,1,0,0,0,0,0,1
20210412-W-Charleston-R32-Misaki_Doi-Nao_Hibino,2,F-XC,77,11,4,1,6,40,37
20210412-W-Charleston-R32-Misaki_Doi-Nao_Hibino,2,F-DTM,45,3,0,0,3,23,22
20210412-W-Charleston-R32-Misaki_Doi-Nao_Hibino,2,F-DTL,30,14,3,3,8,13,17
20210412-W-Charleston-R32-Misaki_Doi-Nao_Hibino,2,F-IO,29,10,5,2,3,15,14
20210412-W-Charleston-R32-Misaki_Doi-Nao_Hibino,2,F-II,5,1,0,0,1,4,1
20210412-W-Charleston-R32-Misaki_Doi-Nao_Hibino,2,B-XC,69,14,6,3,5,37,32
20210412-W-Charleston-R32-Misaki_Doi-Nao_Hibino,2,B-DTM,66,6,0,1,5,37,29
20210412-W-Charleston-R32-Misaki_Doi-Nao_Hibino,2,B-DTL,31,13,1,2,10,11,20
20210412-W-Charleston-R32-Misaki_Doi-Nao_Hibino,2,B-IO,15,6,2,2,2,11,4
20210412-W-Charleston-R32-Misaki_Doi-Nao_Hibino,2,S-XC,4,0,0,0,0,1,3
20210412-W-Charleston-R32-Misaki_Doi-Nao_Hibino,2,S-DTM,4,0,0,0,0,1,3
20210412-W-Charleston-R32-Misaki_Doi-Nao_Hibino,2,S-DTL,3,0,0,0,0,3,0
20210412-W-Charleston-R32-Misaki_Doi-Nao_Hibino,2,S-IO,1,0,0,0,0,1,0
20211109-W-Linz-R16-Emma_Raducanu-Xin_Yu_Wang,1,F-XC,73,14,5,3,6,38,35
20211109-W-Linz-R16-Emma_Raducanu-Xin_Yu_Wang,1,F-DTM,48,7,0,1,6,17,31
20211109-W-Linz-R16-Emma_Raducanu-Xin_Yu_Wang,1,F-DTL,21,12,4,2,6,8,13
20211109-W-Linz-R16-Emma_Raducanu-Xin_Yu_Wang,1,F-IO,24,5,0,3,2,12,12
20211109-W-Linz-R16-Emma_Raducanu-Xin_Yu_Wang,1,B-XC,44,7,1,0,6,15,29
20211109-W-Linz-R16-Emma_Raducanu-Xin_Yu_Wang,1,B-DTM,53,5,0,0,5,17,36
20211109-W-Linz-R16-Emma_Raducanu-Xin_Yu_Wang,1,B-DTL,13,7,3,1,3,7,6
20211109-W-Linz-R16-Emma_Raducanu-Xin_Yu_Wang,1,B-IO,9,2,0,1,1,3,6
20211109-W-Linz-R16-Emma_Raducanu-Xin_Yu_Wang,1,S-XC,9,0,0,0,0,4,5
20211109-W-Linz-R16-Emma_Raducanu-Xin_Yu_Wang,1,S-DTM,8,0,0,0,0,4,4
20211109-W-Linz-R16-Emma_Raducanu-Xin_Yu_Wang,1,S-DTL,1,1,0,0,1,0,1
20211109-W-Linz-R16-Emma_Raducanu-Xin_Yu_Wang,1,S-IO,3,0,0,0,0,1,2
20211109-W-Linz-R16-Emma_Raducanu-Xin_Yu_Wang,2,F-XC,85,8,3,2,3,49,36
20211109-W-Linz-R16-Emma_Raducanu-Xin_Yu_Wang,2,F-DTM,52,9,0,2,7,30,22
20211109-W-Linz-R16-Emma_Raducanu-Xin_Yu_Wang,2,F-DTL,23,10,6,0,4,13,10
20211109-W-Linz-R16-Emma_Raducanu-Xin_Yu_Wang,2,F-IO,26,16,10,3,3,20,6
20211109-W-Linz-R16-Emma_Raducanu-Xin_Yu_Wang,2,F-II,3,1,0,0,1,1,2
20211109-W-Linz-R16-Emma_Raducanu-Xin_Yu_Wang,2,B-XC,59,10,0,4,6,36,23
20211109-W-Linz-R16-Emma_Raducanu-Xin_Yu_Wang,2,B-DTM,36,2,0,0,2,21,15
20211109-W-Linz-R16-Emma_Raducanu-Xin_Yu_Wang,2,B-DTL,11,7,3,2,2,8,3
20211109-W-Linz-R16-Emma_Raducanu-Xin_Yu_Wang,2,B-IO,11,6,3,1,2,9,2
20211109-W-Linz-R16-Emma_Raducanu-Xin_Yu_Wang,2,S-XC,3,0,0,0,0,3,0
20211109-W-Linz-R16-Emma_Raducanu-Xin_Yu_Wang,2,S-DTM,6,0,0,0,0,1,5
20211109-W-Linz-R16-Emma_Raducanu-Xin_Yu_Wang,2,S-DTL,2,1,0,0,1,0,2
20210602-W-Roland_Garros-R64-Serena_Williams-Mihaela_Buzarnescu,1,F-XC,46,9,3,1,5,18,28
20210602-W-Roland_Garros-R64-Serena_Williams-Mihaela_Buzarnescu,1,F-DTM,19,3,0,0,3,6,13
20210602-W-Roland_Garros-R64-Serena_Williams-Mihaela_Buzarnescu,1,F-DTL,12,5,2,2,1,8,4
20210602-W-Roland_Garros-R64-Serena_Williams-Mihaela_Buzarnescu,1,F-IO,17,6,3,2,1,10,7
20210602-W-Roland_Garros-R64-Serena_Williams-Mihaela_Buzarnescu,1,B-XC,36,6,0,1,5,18,18
20210602-W-Roland_Garros-R64-Serena_Williams-Mihaela_Buzarnescu,1,B-DTM,22,1,1,0,0,10,12
20210602-W-Roland_Garros-R64-Serena_Williams-Mihaela_Buzarnescu,1,B-DTL,15,10,1,5,4,9,6
20210602-W-Roland_Garros-R64-Serena_Williams-Mihaela_Buzarnescu,1,B-IO,16,8,3,3,2,12,4
20210602-W-Roland_Garros-R64-Serena_Williams-Mihaela_Buzarnescu,1,S-XC,2,1,0,0,1,0,2
20210602-W-Roland_Garros-R64-Serena_Williams-Mihaela_Buzarnescu,1,S-DTM,1,0,0,0,0,1,0
20210602-W-Roland_Garros-R64-Serena_Williams-Mihaela_Buzarnescu,1,S-DTL,1,0,0,0,0,0,1
20210602-W-Roland_Garros-R64-Serena_Williams-Mihaela_Buzarnescu,2,F-XC,56,17,3,2,12,26,30
20210602-W-Roland_Garros-R64-Serena_Williams-Mihaela_Buzarnescu,2,F-DTM,23,1,0,0,1,10,13
20210602-W-Roland_Garros-R64-Serena_Williams-Mihaela_Buzarnescu,2,F-DTL,14,11,6,2,3,10,4
20210602-W-Roland_Garros-R64-Serena_Williams-Mihaela_Buzarnescu,2,F-IO,6,4,4,0,0,4,2
20210602-W-Roland_Garros-R64-Serena_Williams-Mihaela_Buzarnescu,2,F-II,1,0,0,0,0,1,0
20210602-W-Roland_Garros-R64-Serena_Williams-Mihaela_Buzarnescu,2,B-XC,49,15,5,1,9,26,23
20210602-W-Roland_Garros-R64-Serena_Williams-Mihaela_Buzarnescu,2,B-DTM,31,3,1,1,1,16,15
20210602-W-Roland_Garros-R64-Serena_Williams-Mihaela_Buzarnescu,2,B-DTL,5,5,2,1,2,3,2
20210602-W-Roland_Garros-R64-Serena_Williams-Mihaela_Buzarnescu,2,B-IO,2,1,1,0,0,2,0
20210602-W-Roland_Garros-R64-Serena_Williams-Mihaela_Buzarnescu,2,S-XC,1,0,0,0,0,0,1
20210602-W-Roland_Garros-R64-Serena_Williams-Mihaela_Buzarnescu,2,S-DTM,8,1,0,1,0,4,4
20210602-W-Roland_Garros-R64-Serena_Williams-Mihaela_Buzarnescu,2,S-DTL,2,0,0,0,0,1,1
20211219-W-Dutch_Championships-F-Suzan_Lamens-Stephanie_Judith_Visscher,1,F-XC,26,9,3,3,3,14,12
20211219-W-Dutch_Championships-F-Suzan_Lamens-Stephanie_Judith_Visscher,1,F-DTM,17,1,0,0,1,9,8
20211219-W-Dutch_Championships-F-Suzan_Lamens-Stephanie_Judith_Visscher,1,F-DTL,5,1,1,0,0,3,2
20211219-W-Dutch_Championships-F-Suzan_Lamens-Stephanie_Judith_Visscher,1,F-IO,11,2,0,1,1,6,5
20211219-W-Dutch_Championships-F-Suzan_Lamens-Stephanie_Judith_Visscher,1,B-XC,28,4,0,0,4,9,19
20211219-W-Dutch_Championships-F-Suzan_Lamens-Stephanie_Judith_Visscher,1,B-DTM,29,2,0,0,2,11,18
20211219-W-Dutch_Championships-F-Suzan_Lamens-Stephanie_Judith_Visscher,1,B-DTL,6,3,0,1,2,2,4
20211219-W-Dutch_Championships-F-Suzan_Lamens-Stephanie_Judith_Visscher,1,B-IO,3,2,2,0,0,2,1
20211219-W-Dutch_Championships-F-Suzan_Lamens-Stephanie_Judith_Visscher,1,S-XC,6,0,0,0,0,2,4
20211219-W-Dutch_Championships-F-Suzan_Lamens-Stephanie_Judith_Visscher,1,S-DTM,4,0,0,0,0,1,3
20211219-W-Dutch_Championships-F-Suzan_Lamens-Stephanie_Judith_Visscher,1,S-DTL,3,1,0,0,1,1,2
20211219-W-Dutch_Championships-F-Suzan_Lamens-Stephanie_Judith_Visscher,2,F-XC,31,9,2,2,5,12,19
20211219-W-Dutch_Championships-F-Suzan_Lamens-Stephanie_Judith_Visscher,2,F-DTM,18,3,1,0,2,11,7
20211219-W-Dutch_Championships-F-Suzan_Lamens-Stephanie_Judith_Visscher,2,F-DTL,9,1,1,0,0,8,1
20211219-W-Dutch_Championships-F-Suzan_Lamens-Stephanie_Judith_Visscher,2,F-IO,31,10,1,2,7,20,11
20211219-W-Dutch_Championships-F-Suzan_Lamens-Stephanie_Judith_Visscher,2,F-II,4,3,1,1,1,2,2
20211219-W-Dutch_Championships-F-Suzan_Lamens-Stephanie_Judith_Visscher,2,B-XC,29,2,0,0,2,17,12
20211219-W-Dutch_Championships-F-Suzan_Lamens-Stephanie_Judith_Visscher,2,B-DTM,14,0,0,0,0,5,9
20211219-W-Dutch_Championships-F-Suzan_Lamens-Stephanie_Judith_Visscher,2,B-IO,1,1,0,0,1,0,1
20211219-W-Dutch_Championships-F-Suzan_Lamens-Stephanie_Judith_Visscher,2,S-XC,2,0,0,0,0,1,1
20211219-W-Dutch_Championships-F-Suzan_Lamens-Stephanie_Judith_Visscher,2,S-DTM,2,0,0,0,0,1,1
20220111-W-Sydney-R16-Garbine_Muguruza-Ekaterina_Alexandrova,1,F-XC,40,10,2,6,2,26,14
20220111-W-Sydney-R16-Garbine_Muguruza-Ekaterina_Alexandrova,1,F-DTM,15,2,0,1,1,9,6
20220111-W-Sydney-R16-Garbine_Muguruza-Ekaterina_Alexandrova,1,F-DTL,10,0,0,0,0,7,3
20220111-W-Sydney-R16-Garbine_Muguruza-Ekaterina_Alexandrova,1,F-IO,13,3,1,0,2,6,7
20220111-W-Sydney-R16-Garbine_Muguruza-Ekaterina_Alexandrova,1,B-XC,43,8,1,6,1,28,15
20220111-W-Sydney-R16-Garbine_Muguruza-Ekaterina_Alexandrova,1,B-DTM,22,1,0,1,0,14,8
20220111-W-Sydney-R16-Garbine_Muguruza-Ekaterina_Alexandrova,1,B-DTL,18,10,4,4,2,13,5
20220111-W-Sydney-R16-Garbine_Muguruza-Ekaterina_Alexandrova,1,B-IO,4,2,0,1,1,3,1
20220111-W-Sydney-R16-Garbine_Muguruza-Ekaterina_Alexandrova,1,S-XC,1,0,0,0,0,0,1
20220111-W-Sydney-R16-Garbine_Muguruza-Ekaterina_Alexandrova,2,F-XC,31,7,6,1,0,16,15
20220111-W-Sydney-R16-Garbine_Muguruza-Ekaterina_Alexandrova,2,F-DTM,15,1,0,0,1,6,9
20220111-W-Sydney-R16-Garbine_Muguruza-Ekaterina_Alexandrova,2,F-DTL,12,6,2,2,2,6,6
20220111-W-Sydney-R16-Garbine_Muguruza-Ekaterina_Alexandrova,2,F-IO,8,1,0,0,1,3,5
20220111-W-Sydney-R16-Garbine_Muguruza-Ekaterina_Alexandrova,2,B-XC,37,1,0,1,0,13,24
20220111-W-Sydney-R16-Garbine_Muguruza-Ekaterina_Alexandrova,2,B-DTM,21,3,0,1,2,9,12
20220111-W-Sydney-R16-Garbine_Muguruza-Ekaterina_Alexandrova,2,B-DTL,15,5,2,2,1,9,6
20220111-W-Sydney-R16-Garbine_Muguruza-Ekaterina_Alexandrova,2,B-IO,14,4,2,0,2,5,9
20220111-W-Sydney-R16-Garbine_Muguruza-Ekaterina_Alexandrova,2,S-XC,1,0,0,0,0,1,0
20220111-W-Sydney-R16-Garbine_Muguruza-Ekaterina_Alexandrova,2,S-DTM,3,0,0,0,0,0,3
20220111-W-Sydney-R16-Garbine_Muguruza-Ekaterina_Alexandrova,2,S-DTL,1,0,0,0,0,0,1
20220104-W-Adelaide-R32-Iga_Swiatek-Daria_Gavrilova,1,F-XC,31,13,4,4,5,16,15
20220104-W-Adelaide-R32-Iga_Swiatek-Daria_Gavrilova,1,F-DTM,15,1,0,0,1,8,7
20220104-W-Adelaide-R32-Iga_Swiatek-Daria_Gavrilova,1,F-DTL,13,4,2,0,2,6,7
20220104-W-Adelaide-R32-Iga_Swiatek-Daria_Gavrilova,1,F-IO,16,6,4,1,1,10,6
20220104-W-Adelaide-R32-Iga_Swiatek-Daria_Gavrilova,1,F-II,4,2,2,0,0,3,1
20220104-W-Adelaide-R32-Iga_Swiatek-Daria_Gavrilova,1,B-XC,29,5,1,1,3,16,13
20220104-W-Adelaide-R32-Iga_Swiatek-Daria_Gavrilova,1,B-DTM,9,3,0,0,3,3,6
20220104-W-Adelaide-R32-Iga_Swiatek-Daria_Gavrilova,1,B-DTL,7,3,0,2,1,3,4
20220104-W-Adelaide-R32-Iga_Swiatek-Daria_Gavrilova,1,B-IO,1,0,0,0,0,0,1
20220104-W-Adelaide-R32-Iga_Swiatek-Daria_Gavrilova,1,S-DTM,1,0,0,0,0,1,0
20220104-W-Adelaide-R32-Iga_Swiatek-Daria_Gavrilova,2,F-XC,20,5,2,0,3,12,8
20220104-W-Adelaide-R32-Iga_Swiatek-Daria_Gavrilova,2,F-DTM,14,1,0,0,1,5,9
20220104-W-Adelaide-R32-Iga_Swiatek-Daria_Gavrilova,2,F-DTL,6,3,3,0,0,4,2
20220104-W-Adelaide-R32-Iga_Swiatek-Daria_Gavrilova,2,F-IO,23,7,2,0,5,10,13
20220104-W-Adelaide-R32-Iga_Swiatek-Daria_Gavrilova,2,F-II,3,1,0,0,1,2,1
20220104-W-Adelaide-R32-Iga_Swiatek-Daria_Gavrilova,2,B-XC,18,2,0,0,2,7,11
20220104-W-Adelaide-R32-Iga_Swiatek-Daria_Gavrilova,2,B-DTM,17,1,0,0,1,7,10
20220104-W-Adelaide-R32-Iga_Swiatek-Daria_Gavrilova,2,B-DTL,9,2,0,1,1,6,3
20220104-W-Adelaide-R32-Iga_Swiatek-Daria_Gavrilova,2,B-IO,2,2,1,0,1,1,1
20220104-W-Adelaide-R32-Iga_Swiatek-Daria_Gavrilova,2,B-II,1,0,0,0,0,0,1
20220104-W-Adelaide-R32-Iga_Swiatek-Daria_Gavrilova,2,S-XC,3,0,0,0,0,2,1
20220104-W-Adelaide-R32-Iga_Swiatek-Daria_Gavrilova,2,S-DTM,1,1,0,0,1,0,1
20220104-W-Adelaide-R32-Iga_Swiatek-Daria_Gavrilova,2,S-DTL,2,0,0,0,0,1,1
20220113-W-Sydney-QF-Garbine_Muguruza-Daria_Kasatkina,1,F-XC,29,8,1,4,3,15,14
20220113-W-Sydney-QF-Garbine_Muguruza-Daria_Kasatkina,1,F-DTM,6,0,0,0,0,1,5
20220113-W-Sydney-QF-Garbine_Muguruza-Daria_Kasatkina,1,F-DTL,15,6,1,1,4,4,11
20220113-W-Sydney-QF-Garbine_Muguruza-Daria_Kasatkina,1,F-IO,19,9,3,2,4,11,8
20220113-W-Sydney-QF-Garbine_Muguruza-Daria_Kasatkina,1,B-XC,52,11,0,3,8,13,39
20220113-W-Sydney-QF-Garbine_Muguruza-Daria_Kasatkina,1,B-DTM,31,2,0,1,1,16,15
20220113-W-Sydney-QF-Garbine_Muguruza-Daria_Kasatkina,1,B-DTL,10,1,1,0,0,5,5
20220113-W-Sydney-QF-Garbine_Muguruza-Daria_Kasatkina,1,B-IO,9,5,2,2,1,6,3
20220113-W-Sydney-QF-Garbine_Muguruza-Daria_Kasatkina,1,S-DTM,2,0,0,0,0,0,2
20220113-W-Sydney-QF-Garbine_Muguruza-Daria_Kasatkina,2,F-XC,21,5,2,1,2,14,7
20220113-W-Sydney-QF-Garbine_Muguruza-Daria_Kasatkina,2,F-DTM,20,2,0,1,1,13,7
20220113-W-Sydney-QF-Garbine_Muguruza-Daria_Kasatkina,2,F-DTL,9,3,3,0,0,6,3
20220113-W-Sydney-QF-Garbine_Muguruza-Daria_Kasatkina,2,F-IO,25,8,2,3,3,14,11
20220113-W-Sydney-QF-Garbine_Muguruza-Daria_Kasatkina,2,F-II,1,0,0,0,0,0,1
20220113-W-Sydney-QF-Garbine_Muguruza-Daria_Kasatkina,2,B-XC,35,6,0,5,1,25,10
20220113-W-Sydney-QF-Garbine_Muguruza-Daria_Kasatkina,2,B-DTM,23,0,0,0,0,14,9
20220113-W-Sydney-QF-Garbine_Muguruza-Daria_Kasatkina,2,B-DTL,8,4,2,1,1,7,1
20220113-W-Sydney-QF-Garbine_Muguruza-Daria_Kasatkina,2,B-IO,5,0,0,0,0,3,2
20220113-W-Sydney-QF-Garbine_Muguruza-Daria_Kasatkina,2,S-XC,6,0,0,0,0,3,3
20220113-W-Sydney-QF-Garbine_Muguruza-Daria_Kasatkina,2,S-DTM,8,0,0,0,0,5,3
19920503-W-Hamburg-F-Steffi_Graf-Arantxa_Sanchez_Vicario,1,F-XC,68,12,4,2,6,36,32
19920503-W-Hamburg-F-Steffi_Graf-Arantxa_Sanchez_Vicario,1,F-DTM,22,1,0,0,1,10,12
19920503-W-Hamburg-F-Steffi_Graf-Arantxa_Sanchez_Vicario,1,F-DTL,13,4,0,1,3,6,7
19920503-W-Hamburg-F-Steffi_Graf-Arantxa_Sanchez_Vicario,1,F-IO,46,6,2,1,3,29,17
19920503-W-Hamburg-F-Steffi_Graf-Arantxa_Sanchez_Vicario,1,F-II,27,9,2,5,2,17,10
19920503-W-Hamburg-F-Steffi_Graf-Arantxa_Sanchez_Vicario,1,B-XC,6,4,1,0,3,1,5
19920503-W-Hamburg-F-Steffi_Graf-Arantxa_Sanchez_Vicario,1,B-DTM,4,0,0,0,0,2,2
19920503-W-Hamburg-F-Steffi_Graf-Arantxa_Sanchez_Vicario,1,B-DTL,3,3,2,1,0,3,0
19920503-W-Hamburg-F-Steffi_Graf-Arantxa_Sanchez_Vicario,1,S-XC,105,12,0,4,8,52,53
19920503-W-Hamburg-F-Steffi_Graf-Arantxa_Sanchez_Vicario,1,S-DTM,23,1,0,0,1,11,12
19920503-W-Hamburg-F-Steffi_Graf-Arantxa_Sanchez_Vicario,1,S-DTL,20,3,0,1,2,8,12
19920503-W-Hamburg-F-Steffi_Graf-Arantxa_Sanchez_Vicario,1,S-IO,6,1,1,0,0,2,4
19920503-W-Hamburg-F-Steffi_Graf-Arantxa_Sanchez_Vicario,2,F-XC,31,4,2,0,2,12,19
19920503-W-Hamburg-F-Steffi_Graf-Arantxa_Sanchez_Vicario,2,F-DTM,32,3,0,0,3,17,15
19920503-W-Hamburg-F-Steffi_Graf-Arantxa_Sanchez_Vicario,2,F-DTL,35,6,0,1,5,17,18
19920503-W-Hamburg-F-Steffi_Graf-Arantxa_Sanchez_Vicario,2,F-IO,12,1,0,1,0,7,5
19920503-W-Hamburg-F-Steffi_Graf-Arantxa_Sanchez_Vicario,2,F-II,2,1,0,0,1,0,2
19920503-W-Hamburg-F-Steffi_Graf-Arantxa_Sanchez_Vicario,2,B-XC,113,7,2,1,4,48,65
19920503-W-Hamburg-F-Steffi_Graf-Arantxa_Sanchez_Vicario,2,B-DTM,25,1,0,0,1,14,11
19920503-W-Hamburg-F-Steffi_Graf-Arantxa_Sanchez_Vicario,2,B-DTL,6,5,3,0,2,4,2
19920503-W-Hamburg-F-Steffi_Graf-Arantxa_Sanchez_Vicario,2,B-IO,2,2,0,1,1,1,1
19920503-W-Hamburg-F-Steffi_Graf-Arantxa_Sanchez_Vicario,2,S-XC,26,2,0,0,2,10,16
19920503-W-Hamburg-F-Steffi_Graf-Arantxa_Sanchez_Vicario,2,S-DTM,12,0,0,0,0,3,9
19920503-W-Hamburg-F-Steffi_Graf-Arantxa_Sanchez_Vicario,2,S-DTL,11,3,1,0,2,6,5
19920503-W-Hamburg-F-Steffi_Graf-Arantxa_Sanchez_Vicario,2,S-IO,1,0,0,0,0,1,0
20210604-W-Roland_Garros-R32-Tamara_Zidansek-Katerina_Siniakova,1,F-XC,59,13,3,2,8,29,30
20210604-W-Roland_Garros-R32-Tamara_Zidansek-Katerina_Siniakova,1,F-DTM,35,3,0,1,2,17,18
20210604-W-Roland_Garros-R32-Tamara_Zidansek-Katerina_Siniakova,1,F-DTL,20,12,3,3,6,8,12
20210604-W-Roland_Garros-R32-Tamara_Zidansek-Katerina_Siniakova,1,F-IO,30,12,5,3,4,15,15
20210604-W-Roland_Garros-R32-Tamara_Zidansek-Katerina_Siniakova,1,F-II,5,1,1,0,0,5,0
20210604-W-Roland_Garros-R32-Tamara_Zidansek-Katerina_Siniakova,1,B-XC,30,4,2,0,2,15,15
20210604-W-Roland_Garros-R32-Tamara_Zidansek-Katerina_Siniakova,1,B-DTM,36,0,0,0,0,12,24
20210604-W-Roland_Garros-R32-Tamara_Zidansek-Katerina_Siniakova,1,B-DTL,16,3,0,0,3,3,13
20210604-W-Roland_Garros-R32-Tamara_Zidansek-Katerina_Siniakova,1,B-IO,4,0,0,0,0,2,2
20210604-W-Roland_Garros-R32-Tamara_Zidansek-Katerina_Siniakova,1,S-XC,11,1,0,0,1,4,7
20210604-W-Roland_Garros-R32-Tamara_Zidansek-Katerina_Siniakova,1,S-DTM,5,0,0,0,0,1,4
20210604-W-Roland_Garros-R32-Tamara_Zidansek-Katerina_Siniakova,1,S-DTL,2,1,1,0,0,2,0
20210604-W-Roland_Garros-R32-Tamara_Zidansek-Katerina_Siniakova,1,S-IO,1,0,0,0,0,0,1
20210604-W-Roland_Garros-R32-Tamara_Zidansek-Katerina_Siniakova,2,F-XC,47,10,3,3,4,28,19
20210604-W-Roland_Garros-R32-Tamara_Zidansek-Katerina_Siniakova,2,F-DTM,29,3,0,0,3,16,13
20210604-W-Roland_Garros-R32-Tamara_Zidansek-Katerina_Siniakova,2,F-DTL,33,14,3,1,10,13,20
20210604-W-Roland_Garros-R32-Tamara_Zidansek-Katerina_Siniakova,2,F-IO,28,4,2,1,1,19,9
20210604-W-Roland_Garros-R32-Tamara_Zidansek-Katerina_Siniakova,2,F-II,1,0,0,0,0,1,0
20210604-W-Roland_Garros-R32-Tamara_Zidansek-Katerina_Siniakova,2,B-XC,57,8,2,1,5,37,20
20210604-W-Roland_Garros-R32-Tamara_Zidansek-Katerina_Siniakova,2,B-DTM,21,2,1,0,1,12,9
20210604-W-Roland_Garros-R32-Tamara_Zidansek-Katerina_Siniakova,2,B-DTL,16,12,5,0,7,6,10
20210604-W-Roland_Garros-R32-Tamara_Zidansek-Katerina_Siniakova,2,B-IO,20,10,4,1,5,11,9
20210604-W-Roland_Garros-R32-Tamara_Zidansek-Katerina_Siniakova,2,S-DTM,7,0,0,0,0,3,4
20220112-W-Australian_Open-Q2-Indy_De_Vroome-Dalma_Galfi,1,F-XC,30,8,3,0,5,16,14
20220112-W-Australian_Open-Q2-Indy_De_Vroome-Dalma_Galfi,1,F-DTM,25,4,0,1,3,7,18
20220112-W-Australian_Open-Q2-Indy_De_Vroome-Dalma_Galfi,1,F-DTL,15,6,2,1,3,10,5
20220112-W-Australian_Open-Q2-Indy_De_Vroome-Dalma_Galfi,1,F-IO,11,1,0,1,0,8,3
20220112-W-Australian_Open-Q2-Indy_De_Vroome-Dalma_Galfi,1,B-XC,59,17,2,4,11,32,27
20220112-W-Australian_Open-Q2-Indy_De_Vroome-Dalma_Galfi,1,B-DTM,50,6,0,1,5,24,26
20220112-W-Australian_Open-Q2-Indy_De_Vroome-Dalma_Galfi,1,B-DTL,14,9,2,2,5,7,7
20220112-W-Australian_Open-Q2-Indy_De_Vroome-Dalma_Galfi,1,B-IO,22,12,6,0,6,13,9
20220112-W-Australian_Open-Q2-Indy_De_Vroome-Dalma_Galfi,1,S-XC,1,0,0,0,0,1,0
20220112-W-Australian_Open-Q2-Indy_De_Vroome-Dalma_Galfi,1,S-DTL,1,0,0,0,0,1,0
20220112-W-Australian_Open-Q2-Indy_De_Vroome-Dalma_Galfi,2,F-XC,27,9,2,1,6,14,13
20220112-W-Australian_Open-Q2-Indy_De_Vroome-Dalma_Galfi,2,F-DTM,23,5,0,0,5,7,16
20220112-W-Australian_Open-Q2-Indy_De_Vroome-Dalma_Galfi,2,F-DTL,22,11,5,1,5,12,10
20220112-W-Australian_Open-Q2-Indy_De_Vroome-Dalma_Galfi,2,F-IO,41,19,10,0,9,20,21
20220112-W-Australian_Open-Q2-Indy_De_Vroome-Dalma_Galfi,2,B-XC,29,8,1,1,6,13,16
20220112-W-Australian_Open-Q2-Indy_De_Vroome-Dalma_Galfi,2,B-DTM,41,3,0,0,3,19,22
20220112-W-Australian_Open-Q2-Indy_De_Vroome-Dalma_Galfi,2,B-DTL,18,11,3,1,7,7,11
20220112-W-Australian_Open-Q2-Indy_De_Vroome-Dalma_Galfi,2,B-IO,22,11,5,1,5,13,9
20220112-W-Australian_Open-Q2-Indy_De_Vroome-Dalma_Galfi,2,S-XC,8,0,0,0,0,3,5
20220112-W-Australian_Open-Q2-Indy_De_Vroome-Dalma_Galfi,2,S-DTM,6,0,0,0,0,0,6
20220112-W-Australian_Open-Q2-Indy_De_Vroome-Dalma_Galfi,2,S-DTL,4,2,0,0,2,1,3
20220112-W-Australian_Open-Q2-Indy_De_Vroome-Dalma_Galfi,2,S-IO,1,0,0,0,0,1,0
20220114-W-Sydney-SF-Anett_Kontaveit-Barbora_Krejcikova,1,F-XC,37,15,6,2,7,20,17
20220114-W-Sydney-SF-Anett_Kontaveit-Barbora_Krejcikova,1,F-DTM,14,2,1,0,1,9,5
20220114-W-Sydney-SF-Anett_Kontaveit-Barbora_Krejcikova,1,F-DTL,7,4,1,1,2,4,3
20220114-W-Sydney-SF-Anett_Kontaveit-Barbora_Krejcikova,1,F-IO,11,3,3,0,0,8,3
20220114-W-Sydney-SF-Anett_Kontaveit-Barbora_Krejcikova,1,B-XC,57,17,5,1,11,37,20
20220114-W-Sydney-SF-Anett_Kontaveit-Barbora_Krejcikova,1,B-DTM,28,0,0,0,0,13,15
20220114-W-Sydney-SF-Anett_Kontaveit-Barbora_Krejcikova,1,B-DTL,14,9,6,0,3,10,4
20220114-W-Sydney-SF-Anett_Kontaveit-Barbora_Krejcikova,1,B-IO,3,3,3,0,0,3,0
20220114-W-Sydney-SF-Anett_Kontaveit-Barbora_Krejcikova,1,S-XC,2,0,0,0,0,1,1
20220114-W-Sydney-SF-Anett_Kontaveit-Barbora_Krejcikova,1,S-DTM,2,0,0,0,0,0,2
20220114-W-Sydney-SF-Anett_Kontaveit-Barbora_Krejcikova,1,S-IO,1,0,0,0,0,1,0
20220114-W-Sydney-SF-Anett_Kontaveit-Barbora_Krejcikova,2,F-XC,39,16,5,4,7,22,17
20220114-W-Sydney-SF-Anett_Kontaveit-Barbora_Krejcikova,2,F-DTM,15,2,0,0,2,5,10
20220114-W-Sydney-SF-Anett_Kontaveit-Barbora_Krejcikova,2,F-DTL,8,5,2,0,3,5,3
20220114-W-Sydney-SF-Anett_Kontaveit-Barbora_Krejcikova,2,F-IO,19,12,7,1,4,10,9
20220114-W-Sydney-SF-Anett_Kontaveit-Barbora_Krejcikova,2,F-II,3,3,1,2,0,3,0
20220114-W-Sydney-SF-Anett_Kontaveit-Barbora_Krejcikova,2,B-XC,45,11,3,0,8,19,26
20220114-W-Sydney-SF-Anett_Kontaveit-Barbora_Krejcikova,2,B-DTM,20,4,0,0,4,2,18
20220114-W-Sydney-SF-Anett_Kontaveit-Barbora_Krejcikova,2,B-DTL,6,5,3,1,1,5,1
20220114-W-Sydney-SF-Anett_Kontaveit-Barbora_Krejcikova,2,B-IO,5,2,1,0,1,2,3
20220114-W-Sydney-SF-Anett_Kontaveit-Barbora_Krejcikova,2,S-XC,6,1,0,0,1,2,4
20220114-W-Sydney-SF-Anett_Kontaveit-Barbora_Krejcikova,2,S-DTM,9,0,0,0,0,1,8
20220113-W-Sydney-QF-Paula_Badosa-Belinda_Bencic,1,F-XC,64,15,7,3,5,33,31
20220113-W-Sydney-QF-Paula_Badosa-Belinda_Bencic,1,F-DTM,27,3,1,0,2,14,13
20220113-W-Sydney-QF-Paula_Badosa-Belinda_Bencic,1,F-DTL,21,9,5,0,4,11,10
20220113-W-Sydney-QF-Paula_Badosa-Belinda_Bencic,1,F-IO,12,4,0,1,3,4,8
20220113-W-Sydney-QF-Paula_Badosa-Belinda_Bencic,1,F-II,1,0,0,0,0,1,0
20220113-W-Sydney-QF-Paula_Badosa-Belinda_Bencic,1,B-XC,24,2,0,2,0,14,10
20220113-W-Sydney-QF-Paula_Badosa-Belinda_Bencic,1,B-DTM,48,1,0,0,1,26,22
20220113-W-Sydney-QF-Paula_Badosa-Belinda_Bencic,1,B-DTL,14,6,2,0,4,5,9
20220113-W-Sydney-QF-Paula_Badosa-Belinda_Bencic,1,B-IO,6,0,0,0,0,4,2
20220113-W-Sydney-QF-Paula_Badosa-Belinda_Bencic,1,S-XC,2,0,0,0,0,2,0
20220113-W-Sydney-QF-Paula_Badosa-Belinda_Bencic,1,S-DTM,6,0,0,0,0,1,5
20220113-W-Sydney-QF-Paula_Badosa-Belinda_Bencic,1,S-DTL,1,0,0,0,0,1,0
20220113-W-Sydney-QF-Paula_Badosa-Belinda_Bencic,2,F-XC,68,14,4,2,8,36,32
20220113-W-Sydney-QF-Paula_Badosa-Belinda_Bencic,2,F-DTM,32,7,0,0,7,10,22
20220113-W-Sydney-QF-Paula_Badosa-Belinda_Bencic,2,F-DTL,16,8,4,1,3,10,6
20220113-W-Sydney-QF-Paula_Badosa-Belinda_Bencic,2,F-IO,25,10,5,2,3,15,10
20220113-W-Sydney-QF-Paula_Badosa-Belinda_Bencic,2,F-II,1,1,0,1,0,1,0
20220113-W-Sydney-QF-Paula_Badosa-Belinda_Bencic,2,B-XC,47,12,5,0,7,25,22
20220113-W-Sydney-QF-Paula_Badosa-Belinda_Bencic,2,B-DTM,24,4,1,2,1,9,15
20220113-W-Sydney-QF-Paula_Badosa-Belinda_Bencic,2,B-DTL,13,9,6,1,2,9,4
20220113-W-Sydney-QF-Paula_Badosa-Belinda_Bencic,2,B-IO,15,11,4,1,6,8,7
20220113-W-Sydney-QF-Paula_Badosa-Belinda_Bencic,2,S-DTM,1,0,0,0,0,0,1
20220113-W-Sydney-QF-Paula_Badosa-Belinda_Bencic,2,S-DTL,1,0,0,0,0,0,1
20220111-W-Sydney-R32-Elena_Rybakina-Emma_Raducanu,1,F-XC,30,18,8,5,5,24,6
20220111-W-Sydney-R32-Elena_Rybakina-Emma_Raducanu,1,F-DTM,7,3,0,0,3,3,4
20220111-W-Sydney-R32-Elena_Rybakina-Emma_Raducanu,1,F-DTL,7,4,1,1,2,4,3
20220111-W-Sydney-R32-Elena_Rybakina-Emma_Raducanu,1,F-IO,6,3,2,1,0,6,0
20220111-W-Sydney-R32-Elena_Rybakina-Emma_Raducanu,1,F-II,1,1,1,0,0,1,0
20220111-W-Sydney-R32-Elena_Rybakina-Emma_Raducanu,1,B-XC,9,2,1,1,0,4,5
20220111-W-Sydney-R32-Elena_Rybakina-Emma_Raducanu,1,B-DTM,10,2,0,1,1,5,5
20220111-W-Sydney-R32-Elena_Rybakina-Emma_Raducanu,1,B-DTL,3,2,0,0,2,1,2
20220111-W-Sydney-R32-Elena_Rybakina-Emma_Raducanu,1,B-IO,1,0,0,0,0,1,0
20220111-W-Sydney-R32-Elena_Rybakina-Emma_Raducanu,2,F-XC,10,2,2,0,0,3,7
20220111-W-Sydney-R32-Elena_Rybakina-Emma_Raducanu,2,F-DTM,16,3,0,0,3,2,14
20220111-W-Sydney-R32-Elena_Rybakina-Emma_Raducanu,2,F-IO,6,3,1,0,2,3,3
20220111-W-Sydney-R32-Elena_Rybakina-Emma_Raducanu,2,B-XC,10,2,0,0,2,5,5
20220111-W-Sydney-R32-Elena_Rybakina-Emma_Raducanu,2,B-DTM,14,2,0,1,1,5,9
20220111-W-Sydney-R32-Elena_Rybakina-Emma_Raducanu,2,B-DTL,3,0,0,0,0,2,1
20220111-W-Sydney-R32-Elena_Rybakina-Emma_Raducanu,2,B-IO,3,0,0,0,0,1,2
20220111-W-Sydney-R32-Elena_Rybakina-Emma_Raducanu,2,S-DTM,2,0,0,0,0,0,2
20220111-W-Sydney-R32-Elena_Rybakina-Emma_Raducanu,2,S-IO,1,0,0,0,0,1,0
20220114-W-Australian_Open-Q3-Arianne_Hartono-Jule_Niemeier,1,F-XC,55,12,3,1,8,41,14
20220114-W-Australian_Open-Q3-Arianne_Hartono-Jule_Niemeier,1,F-DTM,29,5,1,1,3,21,8
20220114-W-Australian_Open-Q3-Arianne_Hartono-Jule_Niemeier,1,F-DTL,1,1,1,0,0,1,0
20220114-W-Australian_Open-Q3-Arianne_Hartono-Jule_Niemeier,1,F-IO,8,6,2,2,2,4,4
20220114-W-Australian_Open-Q3-Arianne_Hartono-Jule_Niemeier,1,F-II,1,1,1,0,0,1,0
20220114-W-Australian_Open-Q3-Arianne_Hartono-Jule_Niemeier,1,B-XC,31,11,0,3,8,17,14
20220114-W-Australian_Open-Q3-Arianne_Hartono-Jule_Niemeier,1,B-DTM,28,2,0,0,2,20,8
20220114-W-Australian_Open-Q3-Arianne_Hartono-Jule_Niemeier,1,B-DTL,3,0,0,0,0,1,2
20220114-W-Australian_Open-Q3-Arianne_Hartono-Jule_Niemeier,1,B-IO,4,2,0,0,2,1,3
20220114-W-Australian_Open-Q3-Arianne_Hartono-Jule_Niemeier,1,S-XC,2,0,0,0,0,0,2
20220114-W-Australian_Open-Q3-Arianne_Hartono-Jule_Niemeier,1,S-DTM,5,1,0,1,0,3,2
20220114-W-Australian_Open-Q3-Arianne_Hartono-Jule_Niemeier,1,S-DTL,1,0,0,0,0,0,1
20220114-W-Australian_Open-Q3-Arianne_Hartono-Jule_Niemeier,2,F-XC,46,11,2,2,7,12,34
20220114-W-Australian_Open-Q3-Arianne_Hartono-Jule_Niemeier,2,F-DTM,33,10,0,0,10,1,32
20220114-W-Australian_Open-Q3-Arianne_Hartono-Jule_Niemeier,2,F-DTL,9,2,1,0,1,4,5
20220114-W-Australian_Open-Q3-Arianne_Hartono-Jule_Niemeier,2,F-IO,22,14,4,0,10,7,15
20220114-W-Australian_Open-Q3-Arianne_Hartono-Jule_Niemeier,2,B-XC,20,5,0,4,1,12,8
20220114-W-Australian_Open-Q3-Arianne_Hartono-Jule_Niemeier,2,B-DTM,19,4,0,1,3,8,11
20220114-W-Australian_Open-Q3-Arianne_Hartono-Jule_Niemeier,2,B-DTL,6,4,2,1,1,3,3
20220114-W-Australian_Open-Q3-Arianne_Hartono-Jule_Niemeier,2,B-IO,6,3,2,0,1,2,4
20220114-W-Australian_Open-Q3-Arianne_Hartono-Jule_Niemeier,2,S-XC,5,2,0,1,1,2,3
20220114-W-Australian_Open-Q3-Arianne_Hartono-Jule_Niemeier,2,S-DTM,3,1,0,0,1,1,2
20220114-W-Australian_Open-Q3-Arianne_Hartono-Jule_Niemeier,2,S-DTL,1,0,0,0,0,0,1
20220117-W-Australian_Open-R128-Naomi_Osaka-Maria_Camila_Osorio_Serrano,1,F-XC,24,13,1,5,7,10,14
20220117-W-Australian_Open-R128-Naomi_Osaka-Maria_Camila_Osorio_Serrano,1,F-DTM,12,4,0,0,4,4,8
20220117-W-Australian_Open-R128-Naomi_Osaka-Maria_Camila_Osorio_Serrano,1,F-DTL,7,4,2,1,1,3,4
20220117-W-Australian_Open-R128-Naomi_Osaka-Maria_Camila_Osorio_Serrano,1,F-IO,15,5,1,0,4,6,9
20220117-W-Australian_Open-R128-Naomi_Osaka-Maria_Camila_Osorio_Serrano,1,F-II,2,0,0,0,0,1,1
20220117-W-Australian_Open-R128-Naomi_Osaka-Maria_Camila_Osorio_Serrano,1,B-XC,34,11,3,4,4,18,16
20220117-W-Australian_Open-R128-Naomi_Osaka-Maria_Camila_Osorio_Serrano,1,B-DTM,7,0,0,0,0,5,2
20220117-W-Australian_Open-R128-Naomi_Osaka-Maria_Camila_Osorio_Serrano,1,B-DTL,5,2,2,0,0,3,2
20220117-W-Australian_Open-R128-Naomi_Osaka-Maria_Camila_Osorio_Serrano,1,B-IO,1,1,0,0,1,0,1
20220117-W-Australian_Open-R128-Naomi_Osaka-Maria_Camila_Osorio_Serrano,1,S-XC,3,1,0,0,1,1,2
20220117-W-Australian_Open-R128-Naomi_Osaka-Maria_Camila_Osorio_Serrano,1,S-DTL,1,1,0,1,0,1,0
20220117-W-Australian_Open-R128-Naomi_Osaka-Maria_Camila_Osorio_Serrano,2,F-XC,12,1,0,1,0,8,4
20220117-W-Australian_Open-R128-Naomi_Osaka-Maria_Camila_Osorio_Serrano,2,F-DTM,8,3,0,1,2,4,4
20220117-W-Australian_Open-R128-Naomi_Osaka-Maria_Camila_Osorio_Serrano,2,F-DTL,1,1,0,0,1,0,1
20220117-W-Australian_Open-R128-Naomi_Osaka-Maria_Camila_Osorio_Serrano,2,F-IO,8,2,1,0,1,4,4
20220117-W-Australian_Open-R128-Naomi_Osaka-Maria_Camila_Osorio_Serrano,2,B-XC,14,2,0,1,1,7,7
20220117-W-Australian_Open-R128-Naomi_Osaka-Maria_Camila_Osorio_Serrano,2,B-DTM,16,1,0,0,1,9,7
20220117-W-Australian_Open-R128-Naomi_Osaka-Maria_Camila_Osorio_Serrano,2,B-DTL,5,1,0,0,1,3,2
20220117-W-Australian_Open-R128-Naomi_Osaka-Maria_Camila_Osorio_Serrano,2,B-IO,6,2,0,0,2,2,4
20220117-W-Australian_Open-R128-Naomi_Osaka-Maria_Camila_Osorio_Serrano,2,S-XC,5,0,0,0,0,5,0
20220117-W-Australian_Open-R128-Naomi_Osaka-Maria_Camila_Osorio_Serrano,2,S-DTM,8,0,0,0,0,6,2
20220117-W-Australian_Open-R128-Naomi_Osaka-Maria_Camila_Osorio_Serrano,2,S-DTL,3,0,0,0,0,1,2
20220117-W-Australian_Open-R128-Naomi_Osaka-Maria_Camila_Osorio_Serrano,2,S-IO,1,1,0,0,1,0,1
20220105-W-Melbourne-R32-Shuai_Zhang-Clara_Burel,1,F-XC,38,12,1,1,10,11,27
20220105-W-Melbourne-R32-Shuai_Zhang-Clara_Burel,1,F-DTM,20,3,0,0,3,7,13
20220105-W-Melbourne-R32-Shuai_Zhang-Clara_Burel,1,F-DTL,13,7,2,0,5,6,7
20220105-W-Melbourne-R32-Shuai_Zhang-Clara_Burel,1,F-IO,25,11,4,0,7,14,11
20220105-W-Melbourne-R32-Shuai_Zhang-Clara_Burel,1,F-II,2,0,0,0,0,1,1
20220105-W-Melbourne-R32-Shuai_Zhang-Clara_Burel,1,B-XC,19,3,0,0,3,5,14
20220105-W-Melbourne-R32-Shuai_Zhang-Clara_Burel,1,B-DTM,19,1,0,0,1,7,12
20220105-W-Melbourne-R32-Shuai_Zhang-Clara_Burel,1,B-DTL,7,1,0,0,1,1,6
20220105-W-Melbourne-R32-Shuai_Zhang-Clara_Burel,1,B-IO,6,2,0,0,2,1,5
20220105-W-Melbourne-R32-Shuai_Zhang-Clara_Burel,2,F-XC,28,7,2,2,3,16,12
20220105-W-Melbourne-R32-Shuai_Zhang-Clara_Burel,2,F-DTM,29,1,0,0,1,22,7
20220105-W-Melbourne-R32-Shuai_Zhang-Clara_Burel,2,F-DTL,9,6,3,0,3,5,4
20220105-W-Melbourne-R32-Shuai_Zhang-Clara_Burel,2,F-IO,8,5,3,0,2,6,2
20220105-W-Melbourne-R32-Shuai_Zhang-Clara_Burel,2,B-XC,16,8,2,1,5,7,9
20220105-W-Melbourne-R32-Shuai_Zhang-Clara_Burel,2,B-DTM,28,3,0,0,3,17,11
20220105-W-Melbourne-R32-Shuai_Zhang-Clara_Burel,2,B-DTL,6,1,1,0,0,3,3
20220105-W-Melbourne-R32-Shuai_Zhang-Clara_Burel,2,B-IO,4,2,0,0,2,1,3
20220105-W-Melbourne-R32-Shuai_Zhang-Clara_Burel,2,S-XC,2,0,0,0,0,1,1
20220105-W-Melbourne-R32-Shuai_Zhang-Clara_Burel,2,S-DTM,3,0,0,0,0,1,2
20220105-W-Melbourne-R32-Shuai_Zhang-Clara_Burel,2,S-DTL,1,1,1,0,0,1,0
20220105-W-Melbourne-R32-Shuai_Zhang-Clara_Burel,2,S-IO,2,0,0,0,0,2,0
20220106-W-Melbourne-R16-Andrea_Petkovic-Clara_Burel,1,F-XC,54,13,3,0,10,23,31
20220106-W-Melbourne-R16-Andrea_Petkovic-Clara_Burel,1,F-DTM,29,1,0,0,1,13,16
20220106-W-Melbourne-R16-Andrea_Petkovic-Clara_Burel,1,F-DTL,13,3,2,0,1,5,8
20220106-W-Melbourne-R16-Andrea_Petkovic-Clara_Burel,1,F-IO,24,7,2,0,5,12,12
20220106-W-Melbourne-R16-Andrea_Petkovic-Clara_Burel,1,F-II,7,2,0,0,2,1,6
20220106-W-Melbourne-R16-Andrea_Petkovic-Clara_Burel,1,B-XC,54,11,1,1,9,26,28
20220106-W-Melbourne-R16-Andrea_Petkovic-Clara_Burel,1,B-DTM,41,3,0,0,3,23,18
20220106-W-Melbourne-R16-Andrea_Petkovic-Clara_Burel,1,B-DTL,7,4,0,0,4,1,6
20220106-W-Melbourne-R16-Andrea_Petkovic-Clara_Burel,1,B-IO,4,2,0,1,1,3,1
20220106-W-Melbourne-R16-Andrea_Petkovic-Clara_Burel,1,S-XC,4,0,0,0,0,1,3
20220106-W-Melbourne-R16-Andrea_Petkovic-Clara_Burel,1,S-DTL,1,0,0,0,0,0,1
20220106-W-Melbourne-R16-Andrea_Petkovic-Clara_Burel,2,F-XC,45,17,8,1,8,26,19
20220106-W-Melbourne-R16-Andrea_Petkovic-Clara_Burel,2,F-DTM,41,7,1,0,6,19,22
20220106-W-Melbourne-R16-Andrea_Petkovic-Clara_Burel,2,F-DTL,15,9,5,0,4,10,5
20220106-W-Melbourne-R16-Andrea_Petkovic-Clara_Burel,2,F-IO,21,10,7,0,3,13,8
20220106-W-Melbourne-R16-Andrea_Petkovic-Clara_Burel,2,F-II,2,2,1,0,1,1,1
20220106-W-Melbourne-R16-Andrea_Petkovic-Clara_Burel,2,B-XC,39,8,1,1,6,20,19
20220106-W-Melbourne-R16-Andrea_Petkovic-Clara_Burel,2,B-DTM,52,8,0,0,8,17,35
20220106-W-Melbourne-R16-Andrea_Petkovic-Clara_Burel,2,B-DTL,15,11,4,2,5,10,5
20220106-W-Melbourne-R16-Andrea_Petkovic-Clara_Burel,2,B-IO,11,8,3,0,5,4,7
20220106-W-Melbourne-R16-Andrea_Petkovic-Clara_Burel,2,S-XC,5,1,1,0,0,4,1
20220106-W-Melbourne-R16-Andrea_Petkovic-Clara_Burel,2,S-DTM,3,0,0,0,0,3,0
20220106-W-Melbourne-R16-Andrea_Petkovic-Clara_Burel,2,S-DTL,2,0,0,0,0,2,0
20220106-W-Melbourne-R16-Andrea_Petkovic-Clara_Burel,2,S-IO,1,0,0,0,0,0,1
19850818-W-Mahwah-F-Steffi_Graf-Kathy_Rinaldi_Stunkel,1,F-XC,98,14,2,4,8,61,37
19850818-W-Mahwah-F-Steffi_Graf-Kathy_Rinaldi_Stunkel,1,F-DTM,61,5,0,0,5,31,30
19850818-W-Mahwah-F-Steffi_Graf-Kathy_Rinaldi_Stunkel,1,F-DTL,23,5,1,0,4,10,13
19850818-W-Mahwah-F-Steffi_Graf-Kathy_Rinaldi_Stunkel,1,F-IO,101,20,5,5,10,53,48
19850818-W-Mahwah-F-Steffi_Graf-Kathy_Rinaldi_Stunkel,1,F-II,19,8,4,4,0,13,6
19850818-W-Mahwah-F-Steffi_Graf-Kathy_Rinaldi_Stunkel,1,B-XC,16,5,2,0,3,8,8
19850818-W-Mahwah-F-Steffi_Graf-Kathy_Rinaldi_Stunkel,1,B-DTM,9,0,0,0,0,5,4
19850818-W-Mahwah-F-Steffi_Graf-Kathy_Rinaldi_Stunkel,1,B-DTL,3,2,1,0,1,2,1
19850818-W-Mahwah-F-Steffi_Graf-Kathy_Rinaldi_Stunkel,1,S-XC,188,14,0,0,13,94,94
19850818-W-Mahwah-F-Steffi_Graf-Kathy_Rinaldi_Stunkel,1,S-DTM,49,4,0,0,4,23,26
19850818-W-Mahwah-F-Steffi_Graf-Kathy_Rinaldi_Stunkel,1,S-DTL,30,6,0,1,5,18,12
19850818-W-Mahwah-F-Steffi_Graf-Kathy_Rinaldi_Stunkel,1,S-IO,3,0,0,0,0,1,2
19850818-W-Mahwah-F-Steffi_Graf-Kathy_Rinaldi_Stunkel,2,F-XC,93,21,0,6,15,34,59
19850818-W-Mahwah-F-Steffi_Graf-Kathy_Rinaldi_Stunkel,2,F-DTM,52,1,0,0,1,26,26
19850818-W-Mahwah-F-Steffi_Graf-Kathy_Rinaldi_Stunkel,2,F-DTL,17,2,0,0,2,3,14
19850818-W-Mahwah-F-Steffi_Graf-Kathy_Rinaldi_Stunkel,2,F-IO,25,3,0,1,2,11,14
19850818-W-Mahwah-F-Steffi_Graf-Kathy_Rinaldi_Stunkel,2,B-XC,264,14,0,3,11,130,134
19850818-W-Mahwah-F-Steffi_Graf-Kathy_Rinaldi_Stunkel,2,B-DTM,73,4,0,0,4,28,45
19850818-W-Mahwah-F-Steffi_Graf-Kathy_Rinaldi_Stunkel,2,B-DTL,21,12,3,4,5,9,12
19850818-W-Mahwah-F-Steffi_Graf-Kathy_Rinaldi_Stunkel,2,B-IO,5,3,1,1,1,4,1
19850818-W-Mahwah-F-Steffi_Graf-Kathy_Rinaldi_Stunkel,2,S-XC,7,1,1,0,0,5,2
19850818-W-Mahwah-F-Steffi_Graf-Kathy_Rinaldi_Stunkel,2,S-DTM,2,0,0,0,0,0,2
19850818-W-Mahwah-F-Steffi_Graf-Kathy_Rinaldi_Stunkel,2,S-DTL,1,0,0,0,0,0,1
19970906-W-US_Open-SF-Martina_Hingis-Lindsey_Davenport,1,F-XC,30,8,4,3,1,20,10
19970906-W-US_Open-SF-Martina_Hingis-Lindsey_Davenport,1,F-DTM,21,1,0,0,1,11,10
19970906-W-US_Open-SF-Martina_Hingis-Lindsey_Davenport,1,F-DTL,15,4,0,1,3,9,6
19970906-W-US_Open-SF-Martina_Hingis-Lindsey_Davenport,1,F-IO,24,4,1,1,2,14,10
19970906-W-US_Open-SF-Martina_Hingis-Lindsey_Davenport,1,B-XC,32,10,4,2,4,21,11
19970906-W-US_Open-SF-Martina_Hingis-Lindsey_Davenport,1,B-DTM,25,0,0,0,0,11,14
19970906-W-US_Open-SF-Martina_Hingis-Lindsey_Davenport,1,B-DTL,14,7,2,2,3,8,6
19970906-W-US_Open-SF-Martina_Hingis-Lindsey_Davenport,1,B-IO,11,3,2,0,1,6,5
19970906-W-US_Open-SF-Martina_Hingis-Lindsey_Davenport,1,S-XC,3,0,0,0,0,3,0
19970906-W-US_Open-SF-Martina_Hingis-Lindsey_Davenport,1,S-DTM,2,0,0,0,0,1,1
19970906-W-US_Open-SF-Martina_Hingis-Lindsey_Davenport,1,S-DTL,2,0,0,0,0,1,1
19970906-W-US_Open-SF-Martina_Hingis-Lindsey_Davenport,2,F-XC,35,7,3,2,2,19,16
19970906-W-US_Open-SF-Martina_Hingis-Lindsey_Davenport,2,F-DTM,26,1,0,0,1,8,18
19970906-W-US_Open-SF-Martina_Hingis-Lindsey_Davenport,2,F-DTL,11,8,3,2,3,6,5
19970906-W-US_Open-SF-Martina_Hingis-Lindsey_Davenport,2,F-IO,11,4,1,0,3,3,8
19970906-W-US_Open-SF-Martina_Hingis-Lindsey_Davenport,2,F-II,1,1,0,0,1,0,1
19970906-W-US_Open-SF-Martina_Hingis-Lindsey_Davenport,2,B-XC,48,10,3,1,6,21,27
19970906-W-US_Open-SF-Martina_Hingis-Lindsey_Davenport,2,B-DTM,31,2,0,0,2,11,20
19970906-W-US_Open-SF-Martina_Hingis-Lindsey_Davenport,2,B-DTL,11,6,2,0,4,2,9
19970906-W-US_Open-SF-Martina_Hingis-Lindsey_Davenport,2,B-IO,8,5,3,0,2,4,4
19970906-W-US_Open-SF-Martina_Hingis-Lindsey_Davenport,2,S-XC,4,0,0,0,0,1,3
19970906-W-US_Open-SF-Martina_Hingis-Lindsey_Davenport,2,S-DTM,6,0,0,0,0,1,5
20220104-W-Melbourne-R32-Anhelina_Kalinina-Clara_Tauson,1,F-XC,30,3,0,0,3,13,17
20220104-W-Melbourne-R32-Anhelina_Kalinina-Clara_Tauson,1,F-DTM,16,3,0,0,3,10,6
20220104-W-Melbourne-R32-Anhelina_Kalinina-Clara_Tauson,1,F-DTL,10,1,0,0,1,4,6
20220104-W-Melbourne-R32-Anhelina_Kalinina-Clara_Tauson,1,F-IO,9,3,2,1,0,6,3
20220104-W-Melbourne-R32-Anhelina_Kalinina-Clara_Tauson,1,F-II,1,0,0,0,0,1,0
20220104-W-Melbourne-R32-Anhelina_Kalinina-Clara_Tauson,1,B-XC,40,11,1,2,8,21,19
20220104-W-Melbourne-R32-Anhelina_Kalinina-Clara_Tauson,1,B-DTM,21,2,0,0,2,7,14
20220104-W-Melbourne-R32-Anhelina_Kalinina-Clara_Tauson,1,B-DTL,9,5,1,2,2,6,3
20220104-W-Melbourne-R32-Anhelina_Kalinina-Clara_Tauson,1,B-IO,3,0,0,0,0,2,1
20220104-W-Melbourne-R32-Anhelina_Kalinina-Clara_Tauson,1,B-II,1,0,0,0,0,1,0
20220104-W-Melbourne-R32-Anhelina_Kalinina-Clara_Tauson,1,S-DTM,1,0,0,0,0,0,1
20220104-W-Melbourne-R32-Anhelina_Kalinina-Clara_Tauson,1,S-DTL,1,0,0,0,0,1,0
20220104-W-Melbourne-R32-Anhelina_Kalinina-Clara_Tauson,2,F-XC,37,14,6,1,7,19,18
20220104-W-Melbourne-R32-Anhelina_Kalinina-Clara_Tauson,2,F-DTM,20,2,0,0,2,11,9
20220104-W-Melbourne-R32-Anhelina_Kalinina-Clara_Tauson,2,F-DTL,10,5,3,0,2,6,4
20220104-W-Melbourne-R32-Anhelina_Kalinina-Clara_Tauson,2,F-IO,12,7,2,2,3,7,5
20220104-W-Melbourne-R32-Anhelina_Kalinina-Clara_Tauson,2,F-II,2,1,1,0,0,1,1
20220104-W-Melbourne-R32-Anhelina_Kalinina-Clara_Tauson,2,B-XC,37,5,1,1,3,18,19
20220104-W-Melbourne-R32-Anhelina_Kalinina-Clara_Tauson,2,B-DTM,14,2,0,0,2,2,12
20220104-W-Melbourne-R32-Anhelina_Kalinina-Clara_Tauson,2,B-DTL,9,3,3,0,0,7,2
20220104-W-Melbourne-R32-Anhelina_Kalinina-Clara_Tauson,2,B-IO,3,3,2,0,1,2,1
20220104-W-Melbourne-R32-Anhelina_Kalinina-Clara_Tauson,2,S-XC,4,3,2,0,1,2,2
20220104-W-Melbourne-R32-Anhelina_Kalinina-Clara_Tauson,2,S-DTM,2,1,0,0,1,0,2
20220106-W-Melbourne-R16-Clara_Tauson-Lin_Zhu,1,F-XC,12,7,1,2,4,7,5
20220106-W-Melbourne-R16-Clara_Tauson-Lin_Zhu,1,F-DTM,8,4,1,1,2,6,2
20220106-W-Melbourne-R16-Clara_Tauson-Lin_Zhu,1,F-DTL,1,0,0,0,0,0,1
20220106-W-Melbourne-R16-Clara_Tauson-Lin_Zhu,1,F-IO,9,6,5,1,0,8,1
20220106-W-Melbourne-R16-Clara_Tauson-Lin_Zhu,1,F-II,1,0,0,0,0,1,0
20220106-W-Melbourne-R16-Clara_Tauson-Lin_Zhu,1,B-XC,19,2,1,0,1,15,4
20220106-W-Melbourne-R16-Clara_Tauson-Lin_Zhu,1,B-DTM,13,2,0,0,2,6,7
20220106-W-Melbourne-R16-Clara_Tauson-Lin_Zhu,1,B-DTL,3,2,0,2,0,3,0
20220106-W-Melbourne-R16-Clara_Tauson-Lin_Zhu,1,S-XC,5,1,0,0,1,2,3
20220106-W-Melbourne-R16-Clara_Tauson-Lin_Zhu,1,S-DTM,3,3,0,0,3,0,3
20220106-W-Melbourne-R16-Clara_Tauson-Lin_Zhu,2,F-XC,9,3,0,0,3,2,7
20220106-W-Melbourne-R16-Clara_Tauson-Lin_Zhu,2,F-DTM,12,2,0,0,2,5,7
20220106-W-Melbourne-R16-Clara_Tauson-Lin_Zhu,2,F-DTL,3,1,0,0,1,1,2
20220106-W-Melbourne-R16-Clara_Tauson-Lin_Zhu,2,F-IO,8,3,0,1,2,2,6
20220106-W-Melbourne-R16-Clara_Tauson-Lin_Zhu,2,F-II,2,2,0,1,1,1,1
20220106-W-Melbourne-R16-Clara_Tauson-Lin_Zhu,2,B-XC,18,3,0,0,3,8,10
20220106-W-Melbourne-R16-Clara_Tauson-Lin_Zhu,2,B-DTM,14,3,0,0,3,3,11
20220106-W-Melbourne-R16-Clara_Tauson-Lin_Zhu,2,B-DTL,2,2,0,0,2,0,2
20220106-W-Melbourne-R16-Clara_Tauson-Lin_Zhu,2,B-IO,1,1,0,0,1,0,1
20220106-W-Melbourne-R16-Clara_Tauson-Lin_Zhu,2,S-XC,1,0,0,0,0,0,1
20220106-W-Melbourne-R16-Clara_Tauson-Lin_Zhu,2,S-DTL,2,1,0,0,1,0,2
19840908-W-US_Open-SF-Carling_Bassett_Seguso-Chris_Evert,1,F-XC,70,6,1,0,5,27,43
19840908-W-US_Open-SF-Carling_Bassett_Seguso-Chris_Evert,1,F-DTM,43,3,0,0,3,11,32
19840908-W-US_Open-SF-Carling_Bassett_Seguso-Chris_Evert,1,F-DTL,8,1,0,0,1,0,8
19840908-W-US_Open-SF-Carling_Bassett_Seguso-Chris_Evert,1,F-IO,2,0,0,0,0,0,2
19840908-W-US_Open-SF-Carling_Bassett_Seguso-Chris_Evert,1,B-XC,83,9,1,3,5,30,53
19840908-W-US_Open-SF-Carling_Bassett_Seguso-Chris_Evert,1,B-DTM,56,5,0,1,4,13,43
19840908-W-US_Open-SF-Carling_Bassett_Seguso-Chris_Evert,1,B-DTL,15,5,0,1,4,2,13
19840908-W-US_Open-SF-Carling_Bassett_Seguso-Chris_Evert,1,B-IO,6,1,0,0,1,2,4
19840908-W-US_Open-SF-Carling_Bassett_Seguso-Chris_Evert,1,S-XC,1,0,0,0,0,1,0
19840908-W-US_Open-SF-Carling_Bassett_Seguso-Chris_Evert,1,S-DTM,3,0,0,0,0,0,3
19840908-W-US_Open-SF-Carling_Bassett_Seguso-Chris_Evert,1,S-DTL,3,1,1,0,0,1,2
19840908-W-US_Open-SF-Carling_Bassett_Seguso-Chris_Evert,2,F-XC,82,12,5,3,4,61,21
19840908-W-US_Open-SF-Carling_Bassett_Seguso-Chris_Evert,2,F-DTM,20,0,0,0,0,13,7
19840908-W-US_Open-SF-Carling_Bassett_Seguso-Chris_Evert,2,F-DTL,40,7,0,2,5,26,14
19840908-W-US_Open-SF-Carling_Bassett_Seguso-Chris_Evert,2,F-IO,27,2,1,1,0,20,7
19840908-W-US_Open-SF-Carling_Bassett_Seguso-Chris_Evert,2,F-II,1,1,0,0,1,0,1
19840908-W-US_Open-SF-Carling_Bassett_Seguso-Chris_Evert,2,B-XC,75,13,4,4,5,51,24
19840908-W-US_Open-SF-Carling_Bassett_Seguso-Chris_Evert,2,B-DTM,27,0,0,0,0,23,4
19840908-W-US_Open-SF-Carling_Bassett_Seguso-Chris_Evert,2,B-DTL,16,4,1,0,3,9,7
19840908-W-US_Open-SF-Carling_Bassett_Seguso-Chris_Evert,2,B-IO,16,2,1,0,1,9,7
19840908-W-US_Open-SF-Carling_Bassett_Seguso-Chris_Evert,2,S-XC,1,1,0,1,0,1,0
19840908-W-US_Open-SF-Carling_Bassett_Seguso-Chris_Evert,2,S-DTM,1,0,0,0,0,0,1
20220105-W-Adelaide-R16-Elena_Rybakina-Marie_Bouzkova,1,F-XC,64,18,6,6,6,36,28
20220105-W-Adelaide-R16-Elena_Rybakina-Marie_Bouzkova,1,F-DTM,17,1,0,0,1,7,10
20220105-W-Adelaide-R16-Elena_Rybakina-Marie_Bouzkova,1,F-DTL,12,8,5,1,2,6,6
20220105-W-Adelaide-R16-Elena_Rybakina-Marie_Bouzkova,1,F-IO,5,2,1,1,0,2,3
20220105-W-Adelaide-R16-Elena_Rybakina-Marie_Bouzkova,1,F-II,1,0,0,0,0,1,0
20220105-W-Adelaide-R16-Elena_Rybakina-Marie_Bouzkova,1,B-XC,45,14,6,1,7,26,19
20220105-W-Adelaide-R16-Elena_Rybakina-Marie_Bouzkova,1,B-DTM,19,0,0,0,0,12,7
20220105-W-Adelaide-R16-Elena_Rybakina-Marie_Bouzkova,1,B-DTL,11,6,2,3,1,6,5
20220105-W-Adelaide-R16-Elena_Rybakina-Marie_Bouzkova,1,B-IO,4,0,0,0,0,2,2
20220105-W-Adelaide-R16-Elena_Rybakina-Marie_Bouzkova,1,S-DTM,1,0,0,0,0,1,0
20220105-W-Adelaide-R16-Elena_Rybakina-Marie_Bouzkova,1,S-DTL,1,0,0,0,0,0,1
20220105-W-Adelaide-R16-Elena_Rybakina-Marie_Bouzkova,2,F-XC,35,6,0,1,5,16,19
20220105-W-Adelaide-R16-Elena_Rybakina-Marie_Bouzkova,2,F-DTM,31,0,0,0,0,15,16
20220105-W-Adelaide-R16-Elena_Rybakina-Marie_Bouzkova,2,F-DTL,16,5,4,0,1,9,7
20220105-W-Adelaide-R16-Elena_Rybakina-Marie_Bouzkova,2,F-IO,14,2,0,0,2,7,7
20220105-W-Adelaide-R16-Elena_Rybakina-Marie_Bouzkova,2,F-II,2,1,1,0,0,2,0
20220105-W-Adelaide-R16-Elena_Rybakina-Marie_Bouzkova,2,B-XC,31,2,0,0,2,13,18
20220105-W-Adelaide-R16-Elena_Rybakina-Marie_Bouzkova,2,B-DTM,18,0,0,0,0,7,11
20220105-W-Adelaide-R16-Elena_Rybakina-Marie_Bouzkova,2,B-DTL,8,3,2,0,1,5,3
20220105-W-Adelaide-R16-Elena_Rybakina-Marie_Bouzkova,2,B-IO,6,1,0,1,0,4,2
20220105-W-Adelaide-R16-Elena_Rybakina-Marie_Bouzkova,2,S-XC,5,0,0,0,0,3,2
20220105-W-Adelaide-R16-Elena_Rybakina-Marie_Bouzkova,2,S-DTM,4,0,0,0,0,2,2
20220105-W-Adelaide-R16-Elena_Rybakina-Marie_Bouzkova,2,S-DTL,1,0,0,0,0,0,1
20220105-W-Adelaide-R16-Elena_Rybakina-Marie_Bouzkova,2,S-IO,1,0,0,0,0,0,1
20220122-W-Australian_Open-R32-Ashleigh_Barty-Camila_Giorgi,1,F-XC,13,5,2,0,3,6,7
20220122-W-Australian_Open-R32-Ashleigh_Barty-Camila_Giorgi,1,F-DTM,12,0,0,0,0,7,5
20220122-W-Australian_Open-R32-Ashleigh_Barty-Camila_Giorgi,1,F-DTL,3,2,1,1,0,2,1
20220122-W-Australian_Open-R32-Ashleigh_Barty-Camila_Giorgi,1,F-IO,11,5,1,0,4,4,7
20220122-W-Australian_Open-R32-Ashleigh_Barty-Camila_Giorgi,1,F-II,1,1,0,1,0,1,0
20220122-W-Australian_Open-R32-Ashleigh_Barty-Camila_Giorgi,1,B-XC,1,0,0,0,0,0,1
20220122-W-Australian_Open-R32-Ashleigh_Barty-Camila_Giorgi,1,B-DTM,2,0,0,0,0,1,1
20220122-W-Australian_Open-R32-Ashleigh_Barty-Camila_Giorgi,1,S-XC,6,0,0,0,0,3,3
20220122-W-Australian_Open-R32-Ashleigh_Barty-Camila_Giorgi,1,S-DTM,10,1,0,0,1,4,6
20220122-W-Australian_Open-R32-Ashleigh_Barty-Camila_Giorgi,1,S-DTL,1,0,0,0,0,0,1
20220122-W-Australian_Open-R32-Ashleigh_Barty-Camila_Giorgi,2,F-XC,17,6,2,2,2,12,5
20220122-W-Australian_Open-R32-Ashleigh_Barty-Camila_Giorgi,2,F-DTM,8,3,0,0,3,2,6
20220122-W-Australian_Open-R32-Ashleigh_Barty-Camila_Giorgi,2,F-DTL,4,2,0,0,2,1,3
20220122-W-Australian_Open-R32-Ashleigh_Barty-Camila_Giorgi,2,F-IO,5,3,1,1,1,3,2
20220122-W-Australian_Open-R32-Ashleigh_Barty-Camila_Giorgi,2,B-XC,17,7,0,2,5,10,7
20220122-W-Australian_Open-R32-Ashleigh_Barty-Camila_Giorgi,2,B-DTM,11,1,0,0,1,6,5
20220122-W-Australian_Open-R32-Ashleigh_Barty-Camila_Giorgi,2,B-DTL,5,3,1,1,1,4,1
20220122-W-Australian_Open-R32-Ashleigh_Barty-Camila_Giorgi,2,B-IO,5,4,1,2,1,4,1
20220122-W-Australian_Open-R32-Ashleigh_Barty-Camila_Giorgi,2,S-DTL,1,0,0,0,0,0,1
20220122-W-Australian_Open-R32-Ashleigh_Barty-Camila_Giorgi,2,S-IO,1,1,0,0,1,0,1
20220117-W-Australian_Open-R128-Camila_Giorgi-Anastasia_Potapova,1,F-XC,25,9,0,3,6,12,13
20220117-W-Australian_Open-R128-Camila_Giorgi-Anastasia_Potapova,1,F-DTM,24,4,0,0,4,11,13
20220117-W-Australian_Open-R128-Camila_Giorgi-Anastasia_Potapova,1,F-DTL,5,3,0,1,2,2,3
20220117-W-Australian_Open-R128-Camila_Giorgi-Anastasia_Potapova,1,F-IO,12,4,1,2,1,6,6
20220117-W-Australian_Open-R128-Camila_Giorgi-Anastasia_Potapova,1,B-XC,26,10,0,5,5,12,14
20220117-W-Australian_Open-R128-Camila_Giorgi-Anastasia_Potapova,1,B-DTM,20,1,0,0,1,15,5
20220117-W-Australian_Open-R128-Camila_Giorgi-Anastasia_Potapova,1,B-DTL,8,3,3,0,0,6,2
20220117-W-Australian_Open-R128-Camila_Giorgi-Anastasia_Potapova,1,B-IO,4,4,2,1,1,3,1
20220117-W-Australian_Open-R128-Camila_Giorgi-Anastasia_Potapova,1,S-DTL,2,1,1,0,0,2,0
20220117-W-Australian_Open-R128-Camila_Giorgi-Anastasia_Potapova,2,F-XC,19,4,1,2,1,10,9
20220117-W-Australian_Open-R128-Camila_Giorgi-Anastasia_Potapova,2,F-DTM,16,4,0,0,4,6,10
20220117-W-Australian_Open-R128-Camila_Giorgi-Anastasia_Potapova,2,F-DTL,8,2,0,1,1,2,6
20220117-W-Australian_Open-R128-Camila_Giorgi-Anastasia_Potapova,2,F-IO,6,2,0,0,2,1,5
20220117-W-Australian_Open-R128-Camila_Giorgi-Anastasia_Potapova,2,B-XC,19,3,1,1,1,10,9
20220117-W-Australian_Open-R128-Camila_Giorgi-Anastasia_Potapova,2,B-DTM,35,4,0,0,4,17,18
20220117-W-Australian_Open-R128-Camila_Giorgi-Anastasia_Potapova,2,B-IO,6,3,0,0,3,3,3
20220117-W-Australian_Open-R128-Camila_Giorgi-Anastasia_Potapova,2,S-XC,2,0,0,0,0,0,2
20220117-W-Australian_Open-R128-Camila_Giorgi-Anastasia_Potapova,2,S-DTL,1,0,0,0,0,1,0
20220111-W-Australian_Open-Q1-Urszula_Radwanska-Indy_De_Vroome,1,F-XC,59,6,0,1,5,35,24
20220111-W-Australian_Open-Q1-Urszula_Radwanska-Indy_De_Vroome,1,F-DTM,34,3,0,0,3,19,15
20220111-W-Australian_Open-Q1-Urszula_Radwanska-Indy_De_Vroome,1,F-DTL,9,4,1,0,3,3,6
20220111-W-Australian_Open-Q1-Urszula_Radwanska-Indy_De_Vroome,1,F-IO,17,4,2,1,1,9,8
20220111-W-Australian_Open-Q1-Urszula_Radwanska-Indy_De_Vroome,1,B-XC,18,5,0,1,4,6,12
20220111-W-Australian_Open-Q1-Urszula_Radwanska-Indy_De_Vroome,1,B-DTM,35,6,0,1,5,16,19
20220111-W-Australian_Open-Q1-Urszula_Radwanska-Indy_De_Vroome,1,B-DTL,2,0,0,0,0,2,0
20220111-W-Australian_Open-Q1-Urszula_Radwanska-Indy_De_Vroome,1,B-IO,8,1,0,0,1,5,3
20220111-W-Australian_Open-Q1-Urszula_Radwanska-Indy_De_Vroome,1,S-XC,6,1,0,0,1,1,5
20220111-W-Australian_Open-Q1-Urszula_Radwanska-Indy_De_Vroome,1,S-DTM,13,1,1,0,0,11,2
20220111-W-Australian_Open-Q1-Urszula_Radwanska-Indy_De_Vroome,2,F-XC,66,21,4,4,13,26,40
20220111-W-Australian_Open-Q1-Urszula_Radwanska-Indy_De_Vroome,2,F-DTM,32,7,0,0,7,7,25
20220111-W-Australian_Open-Q1-Urszula_Radwanska-Indy_De_Vroome,2,F-DTL,23,11,5,1,5,11,12
20220111-W-Australian_Open-Q1-Urszula_Radwanska-Indy_De_Vroome,2,F-IO,25,9,4,1,4,16,9
20220111-W-Australian_Open-Q1-Urszula_Radwanska-Indy_De_Vroome,2,F-II,1,0,0,0,0,1,0
20220111-W-Australian_Open-Q1-Urszula_Radwanska-Indy_De_Vroome,2,B-XC,24,6,1,2,3,12,12
20220111-W-Australian_Open-Q1-Urszula_Radwanska-Indy_De_Vroome,2,B-DTM,26,0,0,0,0,14,12
20220111-W-Australian_Open-Q1-Urszula_Radwanska-Indy_De_Vroome,2,B-DTL,13,11,5,1,5,7,6
20220111-W-Australian_Open-Q1-Urszula_Radwanska-Indy_De_Vroome,2,B-IO,32,16,7,2,7,16,16
20220111-W-Australian_Open-Q1-Urszula_Radwanska-Indy_De_Vroome,2,S-IO,1,0,0,0,0,0,1
20220117-W-Australian_Open-R128-Kirsten_Flipkens-Sara_Sorribes_Tormo,1,F-XC,21,6,0,2,4,5,16
20220117-W-Australian_Open-R128-Kirsten_Flipkens-Sara_Sorribes_Tormo,1,F-DTM,11,2,0,1,1,5,6
20220117-W-Australian_Open-R128-Kirsten_Flipkens-Sara_Sorribes_Tormo,1,F-DTL,9,5,1,0,4,4,5
20220117-W-Australian_Open-R128-Kirsten_Flipkens-Sara_Sorribes_Tormo,1,F-IO,42,10,1,5,4,22,20
20220117-W-Australian_Open-R128-Kirsten_Flipkens-Sara_Sorribes_Tormo,1,F-II,6,3,2,0,1,2,4
20220117-W-Australian_Open-R128-Kirsten_Flipkens-Sara_Sorribes_Tormo,1,B-XC,19,5,0,1,4,6,13
20220117-W-Australian_Open-R128-Kirsten_Flipkens-Sara_Sorribes_Tormo,1,B-DTM,9,1,0,1,0,2,7
20220117-W-Australian_Open-R128-Kirsten_Flipkens-Sara_Sorribes_Tormo,1,B-DTL,5,3,1,0,2,1,4
20220117-W-Australian_Open-R128-Kirsten_Flipkens-Sara_Sorribes_Tormo,1,S-XC,43,8,0,2,6,7,36
20220117-W-Australian_Open-R128-Kirsten_Flipkens-Sara_Sorribes_Tormo,1,S-DTM,7,1,0,0,1,1,6
20220117-W-Australian_Open-R128-Kirsten_Flipkens-Sara_Sorribes_Tormo,1,S-DTL,3,0,0,0,0,0,3
20220117-W-Australian_Open-R128-Kirsten_Flipkens-Sara_Sorribes_Tormo,2,F-XC,11,3,2,1,0,10,1
20220117-W-Australian_Open-R128-Kirsten_Flipkens-Sara_Sorribes_Tormo,2,F-DTM,12,1,1,0,0,8,4
20220117-W-Australian_Open-R128-Kirsten_Flipkens-Sara_Sorribes_Tormo,2,F-DTL,16,4,2,2,0,11,5
20220117-W-Australian_Open-R128-Kirsten_Flipkens-Sara_Sorribes_Tormo,2,F-IO,45,5,3,1,1,36,9
20220117-W-Australian_Open-R128-Kirsten_Flipkens-Sara_Sorribes_Tormo,2,F-II,13,3,1,1,1,8,5
20220117-W-Australian_Open-R128-Kirsten_Flipkens-Sara_Sorribes_Tormo,2,B-XC,15,2,1,1,0,7,8
20220117-W-Australian_Open-R128-Kirsten_Flipkens-Sara_Sorribes_Tormo,2,B-DTM,9,4,1,2,1,5,4
20220117-W-Australian_Open-R128-Kirsten_Flipkens-Sara_Sorribes_Tormo,2,B-DTL,8,2,1,0,1,4,4
20220117-W-Australian_Open-R128-Kirsten_Flipkens-Sara_Sorribes_Tormo,2,S-XC,31,0,0,0,0,20,11
20220117-W-Australian_Open-R128-Kirsten_Flipkens-Sara_Sorribes_Tormo,2,S-DTM,10,0,0,0,0,5,5
20220117-W-Australian_Open-R128-Kirsten_Flipkens-Sara_Sorribes_Tormo,2,S-DTL,7,1,0,0,1,4,3
20220121-W-Australian_Open-R32-Marta_Kostyuk-Paula_Badosa,1,F-XC,44,8,1,2,5,18,26
20220121-W-Australian_Open-R32-Marta_Kostyuk-Paula_Badosa,1,F-DTM,33,3,0,0,3,19,14
20220121-W-Australian_Open-R32-Marta_Kostyuk-Paula_Badosa,1,F-DTL,22,13,3,3,7,10,12
20220121-W-Australian_Open-R32-Marta_Kostyuk-Paula_Badosa,1,F-IO,40,9,3,1,5,20,20
20220121-W-Australian_Open-R32-Marta_Kostyuk-Paula_Badosa,1,F-II,1,0,0,0,0,0,1
20220121-W-Australian_Open-R32-Marta_Kostyuk-Paula_Badosa,1,B-XC,43,9,2,1,6,18,25
20220121-W-Australian_Open-R32-Marta_Kostyuk-Paula_Badosa,1,B-DTM,54,6,0,2,4,17,37
20220121-W-Australian_Open-R32-Marta_Kostyuk-Paula_Badosa,1,B-DTL,14,11,8,0,3,9,5
20220121-W-Australian_Open-R32-Marta_Kostyuk-Paula_Badosa,1,B-IO,10,2,2,0,0,6,4
20220121-W-Australian_Open-R32-Marta_Kostyuk-Paula_Badosa,1,S-XC,3,0,0,0,0,2,1
20220121-W-Australian_Open-R32-Marta_Kostyuk-Paula_Badosa,1,S-DTM,4,1,0,0,1,2,2
20220121-W-Australian_Open-R32-Marta_Kostyuk-Paula_Badosa,2,F-XC,51,15,3,3,9,27,24
20220121-W-Australian_Open-R32-Marta_Kostyuk-Paula_Badosa,2,F-DTM,37,3,0,1,2,23,14
20220121-W-Australian_Open-R32-Marta_Kostyuk-Paula_Badosa,2,F-DTL,16,8,4,0,4,11,5
20220121-W-Australian_Open-R32-Marta_Kostyuk-Paula_Badosa,2,F-IO,28,8,6,1,1,20,8
20220121-W-Australian_Open-R32-Marta_Kostyuk-Paula_Badosa,2,F-II,1,0,0,0,0,1,0
20220121-W-Australian_Open-R32-Marta_Kostyuk-Paula_Badosa,2,B-XC,61,8,3,3,2,36,25
20220121-W-Australian_Open-R32-Marta_Kostyuk-Paula_Badosa,2,B-DTM,61,3,0,0,3,29,32
20220121-W-Australian_Open-R32-Marta_Kostyuk-Paula_Badosa,2,B-DTL,16,5,0,2,3,7,9
20220121-W-Australian_Open-R32-Marta_Kostyuk-Paula_Badosa,2,B-IO,13,6,2,0,4,7,6
20220121-W-Australian_Open-R32-Marta_Kostyuk-Paula_Badosa,2,S-XC,2,0,0,0,0,1,1
20220121-W-Australian_Open-R32-Marta_Kostyuk-Paula_Badosa,2,S-DTM,3,0,0,0,0,1,2
20220118-W-Australian_Open-R128-Arantxa_Rus-Tamara_Zidansek,1,F-XC,87,20,2,3,15,40,47
20220118-W-Australian_Open-R128-Arantxa_Rus-Tamara_Zidansek,1,F-DTM,50,6,0,0,6,24,26
20220118-W-Australian_Open-R128-Arantxa_Rus-Tamara_Zidansek,1,F-DTL,19,8,6,1,1,11,8
20220118-W-Australian_Open-R128-Arantxa_Rus-Tamara_Zidansek,1,F-IO,53,18,5,4,9,22,31
20220118-W-Australian_Open-R128-Arantxa_Rus-Tamara_Zidansek,1,F-II,3,1,0,0,1,0,3
20220118-W-Australian_Open-R128-Arantxa_Rus-Tamara_Zidansek,1,B-XC,34,5,0,0,5,13,21
20220118-W-Australian_Open-R128-Arantxa_Rus-Tamara_Zidansek,1,B-DTM,58,2,0,0,2,24,34
20220118-W-Australian_Open-R128-Arantxa_Rus-Tamara_Zidansek,1,B-DTL,25,12,2,2,8,13,12
20220118-W-Australian_Open-R128-Arantxa_Rus-Tamara_Zidansek,1,B-IO,20,6,0,1,5,10,10
20220118-W-Australian_Open-R128-Arantxa_Rus-Tamara_Zidansek,1,S-DTM,3,0,0,0,0,1,2
20220118-W-Australian_Open-R128-Arantxa_Rus-Tamara_Zidansek,1,S-DTL,3,0,0,0,0,0,3
20220118-W-Australian_Open-R128-Arantxa_Rus-Tamara_Zidansek,1,S-IO,1,0,0,0,0,0,1
20220118-W-Australian_Open-R128-Arantxa_Rus-Tamara_Zidansek,2,F-XC,84,15,2,4,9,46,38
20220118-W-Australian_Open-R128-Arantxa_Rus-Tamara_Zidansek,2,F-DTM,54,3,0,0,3,31,23
20220118-W-Australian_Open-R128-Arantxa_Rus-Tamara_Zidansek,2,F-DTL,14,10,3,2,5,6,8
20220118-W-Australian_Open-R128-Arantxa_Rus-Tamara_Zidansek,2,F-IO,43,25,8,7,10,22,21
20220118-W-Australian_Open-R128-Arantxa_Rus-Tamara_Zidansek,2,F-II,2,0,0,0,0,2,0
20220118-W-Australian_Open-R128-Arantxa_Rus-Tamara_Zidansek,2,B-XC,52,5,0,0,5,24,28
20220118-W-Australian_Open-R128-Arantxa_Rus-Tamara_Zidansek,2,B-DTM,79,4,0,1,3,45,34
20220118-W-Australian_Open-R128-Arantxa_Rus-Tamara_Zidansek,2,B-DTL,11,8,2,0,6,4,7
20220118-W-Australian_Open-R128-Arantxa_Rus-Tamara_Zidansek,2,B-IO,6,2,0,0,2,3,3
20220118-W-Australian_Open-R128-Arantxa_Rus-Tamara_Zidansek,2,S-XC,4,0,0,0,0,2,2
20220118-W-Australian_Open-R128-Arantxa_Rus-Tamara_Zidansek,2,S-DTM,5,1,0,0,1,2,3
20220118-W-Australian_Open-R128-Arantxa_Rus-Tamara_Zidansek,2,S-DTL,1,0,0,0,0,1,0
20220119-W-Australian_Open-R64-Tereza_Martincova-Camila_Giorgi,1,F-XC,31,3,2,0,1,20,11
20220119-W-Australian_Open-R64-Tereza_Martincova-Camila_Giorgi,1,F-DTM,44,2,0,0,2,16,28
20220119-W-Australian_Open-R64-Tereza_Martincova-Camila_Giorgi,1,F-DTL,6,1,1,0,0,2,4
20220119-W-Australian_Open-R64-Tereza_Martincova-Camila_Giorgi,1,F-IO,14,7,1,0,6,6,8
20220119-W-Australian_Open-R64-Tereza_Martincova-Camila_Giorgi,1,B-XC,26,1,0,0,1,7,19
20220119-W-Australian_Open-R64-Tereza_Martincova-Camila_Giorgi,1,B-DTM,25,4,0,0,4,9,16
20220119-W-Australian_Open-R64-Tereza_Martincova-Camila_Giorgi,1,B-DTL,6,0,0,0,0,2,4
20220119-W-Australian_Open-R64-Tereza_Martincova-Camila_Giorgi,1,B-IO,1,1,0,0,1,0,1
20220119-W-Australian_Open-R64-Tereza_Martincova-Camila_Giorgi,1,S-XC,1,0,0,0,0,1,0
20220119-W-Australian_Open-R64-Tereza_Martincova-Camila_Giorgi,1,S-DTM,4,0,0,0,0,1,3
20220119-W-Australian_Open-R64-Tereza_Martincova-Camila_Giorgi,1,S-DTL,1,0,0,0,0,0,1
20220119-W-Australian_Open-R64-Tereza_Martincova-Camila_Giorgi,2,F-XC,47,14,3,4,7,25,22
20220119-W-Australian_Open-R64-Tereza_Martincova-Camila_Giorgi,2,F-DTM,34,9,0,1,8,18,16
20220119-W-Australian_Open-R64-Tereza_Martincova-Camila_Giorgi,2,F-DTL,8,6,2,0,4,3,5
20220119-W-Australian_Open-R64-Tereza_Martincova-Camila_Giorgi,2,F-IO,5,3,2,1,0,5,0
20220119-W-Australian_Open-R64-Tereza_Martincova-Camila_Giorgi,2,F-II,2,0,0,0,0,1,1
20220119-W-Australian_Open-R64-Tereza_Martincova-Camila_Giorgi,2,B-XC,29,7,2,3,2,23,6
20220119-W-Australian_Open-R64-Tereza_Martincova-Camila_Giorgi,2,B-DTM,33,3,0,0,3,14,19
20220119-W-Australian_Open-R64-Tereza_Martincova-Camila_Giorgi,2,B-DTL,12,7,4,3,0,10,2
20220119-W-Australian_Open-R64-Tereza_Martincova-Camila_Giorgi,2,B-IO,5,2,0,0,2,2,3
20220119-W-Australian_Open-R64-Tereza_Martincova-Camila_Giorgi,2,S-DTM,1,0,0,0,0,1,0
20220110-W-Australian_Open-Q1-Yuliya_Hatouka-Caroline_Dolehide,1,F-XC,16,9,3,2,4,10,6
20220110-W-Australian_Open-Q1-Yuliya_Hatouka-Caroline_Dolehide,1,F-DTM,5,1,0,0,1,1,4
20220110-W-Australian_Open-Q1-Yuliya_Hatouka-Caroline_Dolehide,1,F-DTL,5,5,4,1,0,5,0
20220110-W-Australian_Open-Q1-Yuliya_Hatouka-Caroline_Dolehide,1,F-IO,18,9,4,1,4,10,8
20220110-W-Australian_Open-Q1-Yuliya_Hatouka-Caroline_Dolehide,1,F-II,1,0,0,0,0,0,1
20220110-W-Australian_Open-Q1-Yuliya_Hatouka-Caroline_Dolehide,1,B-XC,24,11,2,1,8,10,14
20220110-W-Australian_Open-Q1-Yuliya_Hatouka-Caroline_Dolehide,1,B-DTM,8,1,0,0,1,2,6
20220110-W-Australian_Open-Q1-Yuliya_Hatouka-Caroline_Dolehide,1,B-DTL,2,0,0,0,0,1,1
20220110-W-Australian_Open-Q1-Yuliya_Hatouka-Caroline_Dolehide,1,B-IO,7,5,3,0,2,3,4
20220110-W-Australian_Open-Q1-Yuliya_Hatouka-Caroline_Dolehide,2,F-XC,11,6,3,2,1,9,2
20220110-W-Australian_Open-Q1-Yuliya_Hatouka-Caroline_Dolehide,2,F-DTM,12,1,0,0,1,5,7
20220110-W-Australian_Open-Q1-Yuliya_Hatouka-Caroline_Dolehide,2,F-DTL,4,2,2,0,0,3,1
20220110-W-Australian_Open-Q1-Yuliya_Hatouka-Caroline_Dolehide,2,F-IO,8,5,2,0,3,4,4
20220110-W-Australian_Open-Q1-Yuliya_Hatouka-Caroline_Dolehide,2,F-II,3,2,1,1,0,3,0
20220110-W-Australian_Open-Q1-Yuliya_Hatouka-Caroline_Dolehide,2,B-XC,10,1,0,0,1,4,6
20220110-W-Australian_Open-Q1-Yuliya_Hatouka-Caroline_Dolehide,2,B-DTM,8,0,0,0,0,4,4
20220110-W-Australian_Open-Q1-Yuliya_Hatouka-Caroline_Dolehide,2,B-DTL,2,0,0,0,0,1,1
20220110-W-Australian_Open-Q1-Yuliya_Hatouka-Caroline_Dolehide,2,S-XC,7,1,1,0,0,4,3
20220110-W-Australian_Open-Q1-Yuliya_Hatouka-Caroline_Dolehide,2,S-DTM,5,0,0,0,0,4,1
20220111-W-Australian_Open-Q1-Simona_Waltert-Paula_Ormaechea,1,F-XC,38,21,7,5,9,22,16
20220111-W-Australian_Open-Q1-Simona_Waltert-Paula_Ormaechea,1,F-DTM,27,3,0,0,3,10,17
20220111-W-Australian_Open-Q1-Simona_Waltert-Paula_Ormaechea,1,F-DTL,11,5,4,0,1,8,3
20220111-W-Australian_Open-Q1-Simona_Waltert-Paula_Ormaechea,1,F-IO,23,15,6,1,8,12,11
20220111-W-Australian_Open-Q1-Simona_Waltert-Paula_Ormaechea,1,F-II,1,1,0,0,1,0,1
20220111-W-Australian_Open-Q1-Simona_Waltert-Paula_Ormaechea,1,B-XC,28,12,3,4,5,16,12
20220111-W-Australian_Open-Q1-Simona_Waltert-Paula_Ormaechea,1,B-DTM,33,3,0,0,3,13,20
20220111-W-Australian_Open-Q1-Simona_Waltert-Paula_Ormaechea,1,B-DTL,9,6,4,0,2,5,4
20220111-W-Australian_Open-Q1-Simona_Waltert-Paula_Ormaechea,1,B-IO,9,6,2,1,3,4,5
20220111-W-Australian_Open-Q1-Simona_Waltert-Paula_Ormaechea,1,S-XC,1,0,0,0,0,1,0
20220111-W-Australian_Open-Q1-Simona_Waltert-Paula_Ormaechea,1,S-DTM,6,1,0,0,1,2,4
20220111-W-Australian_Open-Q1-Simona_Waltert-Paula_Ormaechea,1,S-DTL,2,0,0,0,0,1,1
20220111-W-Australian_Open-Q1-Simona_Waltert-Paula_Ormaechea,1,S-IO,1,0,0,0,0,0,1
20220111-W-Australian_Open-Q1-Simona_Waltert-Paula_Ormaechea,2,F-XC,22,6,3,0,3,11,11
20220111-W-Australian_Open-Q1-Simona_Waltert-Paula_Ormaechea,2,F-DTM,30,3,0,0,3,19,11
20220111-W-Australian_Open-Q1-Simona_Waltert-Paula_Ormaechea,2,F-DTL,13,3,1,0,2,6,7
20220111-W-Australian_Open-Q1-Simona_Waltert-Paula_Ormaechea,2,F-IO,18,4,0,1,3,10,8
20220111-W-Australian_Open-Q1-Simona_Waltert-Paula_Ormaechea,2,B-XC,19,2,0,1,1,11,8
20220111-W-Australian_Open-Q1-Simona_Waltert-Paula_Ormaechea,2,B-DTM,25,1,0,0,1,14,11
20220111-W-Australian_Open-Q1-Simona_Waltert-Paula_Ormaechea,2,B-DTL,7,4,2,0,2,2,5
20220111-W-Australian_Open-Q1-Simona_Waltert-Paula_Ormaechea,2,B-IO,10,5,1,1,3,5,5
20220111-W-Australian_Open-Q1-Simona_Waltert-Paula_Ormaechea,2,S-XC,2,0,0,0,0,1,1
20220111-W-Australian_Open-Q1-Simona_Waltert-Paula_Ormaechea,2,S-DTM,7,0,0,0,0,2,5
20220111-W-Australian_Open-Q1-Simona_Waltert-Paula_Ormaechea,2,S-DTL,1,0,0,0,0,0,1
20220111-W-Australian_Open-Q1-Simona_Waltert-Paula_Ormaechea,2,S-IO,2,1,0,0,1,0,2
20220117-W-Australian_Open-R128-Viktoria_Kuzmova-Xiyu_Wang,1,F-XC,47,14,3,4,7,21,26
20220117-W-Australian_Open-R128-Viktoria_Kuzmova-Xiyu_Wang,1,F-DTM,17,5,0,1,4,4,13
20220117-W-Australian_Open-R128-Viktoria_Kuzmova-Xiyu_Wang,1,F-DTL,15,5,2,1,2,10,5
20220117-W-Australian_Open-R128-Viktoria_Kuzmova-Xiyu_Wang,1,F-IO,15,10,5,1,4,7,8
20220117-W-Australian_Open-R128-Viktoria_Kuzmova-Xiyu_Wang,1,F-II,2,2,2,0,0,2,0
20220117-W-Australian_Open-R128-Viktoria_Kuzmova-Xiyu_Wang,1,B-XC,20,6,3,2,1,8,12
20220117-W-Australian_Open-R128-Viktoria_Kuzmova-Xiyu_Wang,1,B-DTM,15,2,0,0,2,3,12
20220117-W-Australian_Open-R128-Viktoria_Kuzmova-Xiyu_Wang,1,B-DTL,9,3,0,0,3,1,8
20220117-W-Australian_Open-R128-Viktoria_Kuzmova-Xiyu_Wang,1,B-IO,5,0,0,0,0,0,5
20220117-W-Australian_Open-R128-Viktoria_Kuzmova-Xiyu_Wang,1,S-XC,1,0,0,0,0,0,1
20220117-W-Australian_Open-R128-Viktoria_Kuzmova-Xiyu_Wang,1,S-DTM,1,0,0,0,0,0,1
20220117-W-Australian_Open-R128-Viktoria_Kuzmova-Xiyu_Wang,1,S-II,1,0,0,0,0,0,1
20220117-W-Australian_Open-R128-Viktoria_Kuzmova-Xiyu_Wang,2,F-XC,15,6,4,1,1,11,4
20220117-W-Australian_Open-R128-Viktoria_Kuzmova-Xiyu_Wang,2,F-DTM,24,2,0,0,2,15,9
20220117-W-Australian_Open-R128-Viktoria_Kuzmova-Xiyu_Wang,2,F-DTL,17,10,7,2,1,14,3
20220117-W-Australian_Open-R128-Viktoria_Kuzmova-Xiyu_Wang,2,F-IO,7,0,0,0,0,6,1
20220117-W-Australian_Open-R128-Viktoria_Kuzmova-Xiyu_Wang,2,B-XC,21,8,5,1,2,13,8
20220117-W-Australian_Open-R128-Viktoria_Kuzmova-Xiyu_Wang,2,B-DTM,27,5,0,2,3,18,9
20220117-W-Australian_Open-R128-Viktoria_Kuzmova-Xiyu_Wang,2,B-DTL,10,3,3,0,0,8,2
20220117-W-Australian_Open-R128-Viktoria_Kuzmova-Xiyu_Wang,2,B-IO,2,0,0,0,0,1,1
20220126-W-Australian_Open-QF-Iga_Swiatek-Kaia_Kanepi,1,F-XC,68,20,5,5,10,48,20
20220126-W-Australian_Open-QF-Iga_Swiatek-Kaia_Kanepi,1,F-DTM,45,5,2,0,3,28,17
20220126-W-Australian_Open-QF-Iga_Swiatek-Kaia_Kanepi,1,F-DTL,8,6,5,0,1,6,2
20220126-W-Australian_Open-QF-Iga_Swiatek-Kaia_Kanepi,1,F-IO,20,9,2,3,4,14,6
20220126-W-Australian_Open-QF-Iga_Swiatek-Kaia_Kanepi,1,B-XC,58,11,5,2,4,41,17
20220126-W-Australian_Open-QF-Iga_Swiatek-Kaia_Kanepi,1,B-DTM,43,3,0,0,3,28,15
20220126-W-Australian_Open-QF-Iga_Swiatek-Kaia_Kanepi,1,B-DTL,9,4,0,1,3,4,5
20220126-W-Australian_Open-QF-Iga_Swiatek-Kaia_Kanepi,1,B-IO,13,5,3,0,2,10,3
20220126-W-Australian_Open-QF-Iga_Swiatek-Kaia_Kanepi,1,S-XC,2,0,0,0,0,1,1
20220126-W-Australian_Open-QF-Iga_Swiatek-Kaia_Kanepi,1,S-DTM,5,0,0,0,0,2,3
20220126-W-Australian_Open-QF-Iga_Swiatek-Kaia_Kanepi,2,F-XC,48,16,2,5,9,16,32
20220126-W-Australian_Open-QF-Iga_Swiatek-Kaia_Kanepi,2,F-DTM,56,6,0,0,6,17,39
20220126-W-Australian_Open-QF-Iga_Swiatek-Kaia_Kanepi,2,F-DTL,16,10,1,0,9,2,14
20220126-W-Australian_Open-QF-Iga_Swiatek-Kaia_Kanepi,2,F-IO,39,19,9,3,7,20,19
20220126-W-Australian_Open-QF-Iga_Swiatek-Kaia_Kanepi,2,F-II,3,1,1,0,0,2,1
20220126-W-Australian_Open-QF-Iga_Swiatek-Kaia_Kanepi,2,B-XC,47,12,1,5,6,21,26
20220126-W-Australian_Open-QF-Iga_Swiatek-Kaia_Kanepi,2,B-DTM,48,4,0,0,4,13,35
20220126-W-Australian_Open-QF-Iga_Swiatek-Kaia_Kanepi,2,B-DTL,14,8,2,1,5,5,9
20220126-W-Australian_Open-QF-Iga_Swiatek-Kaia_Kanepi,2,B-IO,8,6,3,0,3,3,5
20220126-W-Australian_Open-QF-Iga_Swiatek-Kaia_Kanepi,2,S-XC,2,0,0,0,0,0,2
20220126-W-Australian_Open-QF-Iga_Swiatek-Kaia_Kanepi,2,S-DTM,8,0,0,0,0,2,6
20220126-W-Australian_Open-QF-Iga_Swiatek-Kaia_Kanepi,2,S-DTL,1,0,0,0,0,0,1
20220126-W-Australian_Open-QF-Iga_Swiatek-Kaia_Kanepi,2,S-IO,1,0,0,0,0,0,1
20220118-W-Australian_Open-R128-Rebecca_Marino-Marie_Bouzkova,1,F-XC,45,12,5,0,7,20,25
20220118-W-Australian_Open-R128-Rebecca_Marino-Marie_Bouzkova,1,F-DTM,37,6,0,0,6,14,23
20220118-W-Australian_Open-R128-Rebecca_Marino-Marie_Bouzkova,1,F-DTL,5,1,1,0,0,2,3
20220118-W-Australian_Open-R128-Rebecca_Marino-Marie_Bouzkova,1,F-IO,22,8,3,0,5,9,13
20220118-W-Australian_Open-R128-Rebecca_Marino-Marie_Bouzkova,1,F-II,3,1,1,0,0,2,1
20220118-W-Australian_Open-R128-Rebecca_Marino-Marie_Bouzkova,1,B-XC,32,7,0,2,5,13,19
20220118-W-Australian_Open-R128-Rebecca_Marino-Marie_Bouzkova,1,B-DTM,27,2,0,0,2,11,16
20220118-W-Australian_Open-R128-Rebecca_Marino-Marie_Bouzkova,1,B-DTL,4,1,1,0,0,3,1
20220118-W-Australian_Open-R128-Rebecca_Marino-Marie_Bouzkova,1,B-IO,7,4,0,0,4,0,7
20220118-W-Australian_Open-R128-Rebecca_Marino-Marie_Bouzkova,1,S-XC,3,2,0,0,2,0,3
20220118-W-Australian_Open-R128-Rebecca_Marino-Marie_Bouzkova,1,S-DTM,4,0,0,0,0,3,1
20220118-W-Australian_Open-R128-Rebecca_Marino-Marie_Bouzkova,1,S-DTL,2,0,0,0,0,0,2
20220118-W-Australian_Open-R128-Rebecca_Marino-Marie_Bouzkova,1,S-IO,4,1,0,1,0,2,2
20220118-W-Australian_Open-R128-Rebecca_Marino-Marie_Bouzkova,2,F-XC,23,2,0,1,1,14,9
20220118-W-Australian_Open-R128-Rebecca_Marino-Marie_Bouzkova,2,F-DTM,43,3,0,0,3,25,18
20220118-W-Australian_Open-R128-Rebecca_Marino-Marie_Bouzkova,2,F-DTL,11,4,0,2,2,7,4
20220118-W-Australian_Open-R128-Rebecca_Marino-Marie_Bouzkova,2,F-IO,9,1,0,1,0,5,4
20220118-W-Australian_Open-R128-Rebecca_Marino-Marie_Bouzkova,2,B-XC,27,4,0,3,1,20,7
20220118-W-Australian_Open-R128-Rebecca_Marino-Marie_Bouzkova,2,B-DTM,30,1,1,0,0,17,13
20220118-W-Australian_Open-R128-Rebecca_Marino-Marie_Bouzkova,2,B-DTL,5,3,2,0,1,3,2
20220118-W-Australian_Open-R128-Rebecca_Marino-Marie_Bouzkova,2,B-IO,5,0,0,0,0,2,3
20220118-W-Australian_Open-R128-Rebecca_Marino-Marie_Bouzkova,2,S-XC,7,0,0,0,0,2,5
20220118-W-Australian_Open-R128-Rebecca_Marino-Marie_Bouzkova,2,S-DTM,5,0,0,0,0,3,2
20220118-W-Australian_Open-R128-Rebecca_Marino-Marie_Bouzkova,2,S-DTL,1,0,0,0,0,0,1
20220118-W-Australian_Open-R128-Rebecca_Marino-Marie_Bouzkova,2,S-IO,1,1,0,0,1,0,1
20220206-W-ITF_Tucuman-F-Brenda_Fruhvirtova-Carolina_Alves,1,F-XC,70,11,4,2,5,50,20
20220206-W-ITF_Tucuman-F-Brenda_Fruhvirtova-Carolina_Alves,1,F-DTM,23,1,1,0,0,14,9
20220206-W-ITF_Tucuman-F-Brenda_Fruhvirtova-Carolina_Alves,1,F-DTL,18,3,1,0,2,12,6
20220206-W-ITF_Tucuman-F-Brenda_Fruhvirtova-Carolina_Alves,1,F-IO,9,0,0,0,0,7,2
20220206-W-ITF_Tucuman-F-Brenda_Fruhvirtova-Carolina_Alves,1,B-XC,58,10,6,2,2,41,17
20220206-W-ITF_Tucuman-F-Brenda_Fruhvirtova-Carolina_Alves,1,B-DTM,23,0,0,0,0,13,10
20220206-W-ITF_Tucuman-F-Brenda_Fruhvirtova-Carolina_Alves,1,B-DTL,1,0,0,0,0,1,0
20220206-W-ITF_Tucuman-F-Brenda_Fruhvirtova-Carolina_Alves,1,B-IO,5,0,0,0,0,3,2
20220206-W-ITF_Tucuman-F-Brenda_Fruhvirtova-Carolina_Alves,1,S-XC,2,0,0,0,0,1,1
20220206-W-ITF_Tucuman-F-Brenda_Fruhvirtova-Carolina_Alves,1,S-DTM,1,1,0,1,0,1,0
20220206-W-ITF_Tucuman-F-Brenda_Fruhvirtova-Carolina_Alves,2,F-XC,56,3,0,0,3,20,36
20220206-W-ITF_Tucuman-F-Brenda_Fruhvirtova-Carolina_Alves,2,F-DTM,35,3,1,0,2,9,26
20220206-W-ITF_Tucuman-F-Brenda_Fruhvirtova-Carolina_Alves,2,F-DTL,12,6,3,0,3,6,6
20220206-W-ITF_Tucuman-F-Brenda_Fruhvirtova-Carolina_Alves,2,F-IO,20,4,0,0,4,6,14
20220206-W-ITF_Tucuman-F-Brenda_Fruhvirtova-Carolina_Alves,2,F-II,3,1,1,0,0,1,2
20220206-W-ITF_Tucuman-F-Brenda_Fruhvirtova-Carolina_Alves,2,B-XC,9,0,0,0,0,3,6
20220206-W-ITF_Tucuman-F-Brenda_Fruhvirtova-Carolina_Alves,2,B-DTM,30,0,0,0,0,9,21
20220206-W-ITF_Tucuman-F-Brenda_Fruhvirtova-Carolina_Alves,2,B-DTL,16,4,4,0,0,10,6
20220206-W-ITF_Tucuman-F-Brenda_Fruhvirtova-Carolina_Alves,2,B-IO,6,1,0,0,1,1,5
20220206-W-ITF_Tucuman-F-Brenda_Fruhvirtova-Carolina_Alves,2,S-XC,6,1,0,0,1,2,4
20220206-W-ITF_Tucuman-F-Brenda_Fruhvirtova-Carolina_Alves,2,S-DTM,12,1,0,0,1,4,8
20220206-W-ITF_Tucuman-F-Brenda_Fruhvirtova-Carolina_Alves,2,S-IO,1,0,0,0,0,1,0
20220209-W-St_Petersburg-R16-Anett_Kontaveit-Sorana_Cirstea,1,F-XC,42,10,2,1,7,16,26
20220209-W-St_Petersburg-R16-Anett_Kontaveit-Sorana_Cirstea,1,F-DTM,20,1,1,0,0,11,9
20220209-W-St_Petersburg-R16-Anett_Kontaveit-Sorana_Cirstea,1,F-DTL,8,6,3,1,2,6,2
20220209-W-St_Petersburg-R16-Anett_Kontaveit-Sorana_Cirstea,1,F-IO,12,7,4,2,1,10,2
20220209-W-St_Petersburg-R16-Anett_Kontaveit-Sorana_Cirstea,1,F-II,1,1,1,0,0,1,0
20220209-W-St_Petersburg-R16-Anett_Kontaveit-Sorana_Cirstea,1,B-XC,30,4,3,0,1,14,16
20220209-W-St_Petersburg-R16-Anett_Kontaveit-Sorana_Cirstea,1,B-DTM,14,1,0,0,1,6,8
20220209-W-St_Petersburg-R16-Anett_Kontaveit-Sorana_Cirstea,1,B-DTL,12,4,0,1,3,4,8
20220209-W-St_Petersburg-R16-Anett_Kontaveit-Sorana_Cirstea,1,B-IO,3,1,0,0,1,1,2
20220209-W-St_Petersburg-R16-Anett_Kontaveit-Sorana_Cirstea,1,S-XC,2,1,0,0,1,0,2
20220209-W-St_Petersburg-R16-Anett_Kontaveit-Sorana_Cirstea,2,F-XC,43,12,3,3,6,25,18
20220209-W-St_Petersburg-R16-Anett_Kontaveit-Sorana_Cirstea,2,F-DTM,18,2,0,0,2,7,11
20220209-W-St_Petersburg-R16-Anett_Kontaveit-Sorana_Cirstea,2,F-DTL,8,1,0,0,1,5,3
20220209-W-St_Petersburg-R16-Anett_Kontaveit-Sorana_Cirstea,2,F-IO,10,5,1,1,3,6,4
20220209-W-St_Petersburg-R16-Anett_Kontaveit-Sorana_Cirstea,2,B-XC,23,4,1,0,3,13,10
20220209-W-St_Petersburg-R16-Anett_Kontaveit-Sorana_Cirstea,2,B-DTM,19,2,0,0,2,12,7
20220209-W-St_Petersburg-R16-Anett_Kontaveit-Sorana_Cirstea,2,B-DTL,12,10,4,1,5,6,6
20220209-W-St_Petersburg-R16-Anett_Kontaveit-Sorana_Cirstea,2,B-IO,2,1,1,0,0,2,0
20220209-W-St_Petersburg-R16-Anett_Kontaveit-Sorana_Cirstea,2,S-DTL,3,1,1,0,0,3,0
20220209-W-St_Petersburg-R32-Varvara_Gracheva-Elena_Rybakina,1,F-XC,31,6,1,0,5,12,19
20220209-W-St_Petersburg-R32-Varvara_Gracheva-Elena_Rybakina,1,F-DTM,19,2,0,0,2,5,14
20220209-W-St_Petersburg-R32-Varvara_Gracheva-Elena_Rybakina,1,F-DTL,4,2,1,0,1,2,2
20220209-W-St_Petersburg-R32-Varvara_Gracheva-Elena_Rybakina,1,F-IO,4,2,0,1,1,1,3
20220209-W-St_Petersburg-R32-Varvara_Gracheva-Elena_Rybakina,1,B-XC,19,4,1,1,2,10,9
20220209-W-St_Petersburg-R32-Varvara_Gracheva-Elena_Rybakina,1,B-DTM,11,6,1,0,5,2,9
20220209-W-St_Petersburg-R32-Varvara_Gracheva-Elena_Rybakina,1,B-DTL,1,0,0,0,0,0,1
20220209-W-St_Petersburg-R32-Varvara_Gracheva-Elena_Rybakina,1,S-XC,1,0,0,0,0,0,1
20220209-W-St_Petersburg-R32-Varvara_Gracheva-Elena_Rybakina,1,S-DTM,4,1,0,0,1,2,2
20220209-W-St_Petersburg-R32-Varvara_Gracheva-Elena_Rybakina,1,S-DTL,1,0,0,0,0,1,0
20220209-W-St_Petersburg-R32-Varvara_Gracheva-Elena_Rybakina,2,F-XC,34,10,4,3,3,22,12
20220209-W-St_Petersburg-R32-Varvara_Gracheva-Elena_Rybakina,2,F-DTM,9,2,0,1,1,6,3
20220209-W-St_Petersburg-R32-Varvara_Gracheva-Elena_Rybakina,2,F-DTL,3,2,1,0,1,2,1
20220209-W-St_Petersburg-R32-Varvara_Gracheva-Elena_Rybakina,2,F-IO,5,4,2,1,1,3,2
20220209-W-St_Petersburg-R32-Varvara_Gracheva-Elena_Rybakina,2,B-XC,19,9,2,5,2,14,5
20220209-W-St_Petersburg-R32-Varvara_Gracheva-Elena_Rybakina,2,B-DTM,13,2,1,0,1,7,6
20220209-W-St_Petersburg-R32-Varvara_Gracheva-Elena_Rybakina,2,B-DTL,3,1,0,0,1,1,2
20220209-W-St_Petersburg-R32-Varvara_Gracheva-Elena_Rybakina,2,B-IO,1,0,0,0,0,1,0
20220209-W-St_Petersburg-R32-Varvara_Gracheva-Elena_Rybakina,2,S-DTM,2,0,0,0,0,2,0
20220209-W-St_Petersburg-R32-Varvara_Gracheva-Elena_Rybakina,2,S-DTL,2,0,0,0,0,1,1
20220207-W-St_Petersburg-R32-Anett_Kontaveit-Jil_Teichmann,1,F-XC,38,11,2,3,6,19,19
20220207-W-St_Petersburg-R32-Anett_Kontaveit-Jil_Teichmann,1,F-DTM,37,4,0,1,3,17,20
20220207-W-St_Petersburg-R32-Anett_Kontaveit-Jil_Teichmann,1,F-DTL,7,3,1,0,2,4,3
20220207-W-St_Petersburg-R32-Anett_Kontaveit-Jil_Teichmann,1,F-IO,19,7,2,0,5,11,8
20220207-W-St_Petersburg-R32-Anett_Kontaveit-Jil_Teichmann,1,B-XC,48,16,2,4,10,23,25
20220207-W-St_Petersburg-R32-Anett_Kontaveit-Jil_Teichmann,1,B-DTM,18,2,0,0,2,7,11
20220207-W-St_Petersburg-R32-Anett_Kontaveit-Jil_Teichmann,1,B-DTL,9,5,3,1,1,6,3
20220207-W-St_Petersburg-R32-Anett_Kontaveit-Jil_Teichmann,1,B-IO,7,3,3,0,0,6,1
20220207-W-St_Petersburg-R32-Anett_Kontaveit-Jil_Teichmann,2,F-XC,42,6,0,2,4,20,22
20220207-W-St_Petersburg-R32-Anett_Kontaveit-Jil_Teichmann,2,F-DTM,41,5,0,1,4,21,20
20220207-W-St_Petersburg-R32-Anett_Kontaveit-Jil_Teichmann,2,F-DTL,13,9,5,0,4,7,6
20220207-W-St_Petersburg-R32-Anett_Kontaveit-Jil_Teichmann,2,F-IO,10,5,2,1,2,6,4
20220207-W-St_Petersburg-R32-Anett_Kontaveit-Jil_Teichmann,2,B-XC,19,4,2,2,0,14,5
20220207-W-St_Petersburg-R32-Anett_Kontaveit-Jil_Teichmann,2,B-DTM,40,8,0,0,8,12,28
20220207-W-St_Petersburg-R32-Anett_Kontaveit-Jil_Teichmann,2,B-DTL,3,0,0,0,0,1,2
20220207-W-St_Petersburg-R32-Anett_Kontaveit-Jil_Teichmann,2,B-IO,3,1,0,1,0,2,1
20220207-W-St_Petersburg-R32-Anett_Kontaveit-Jil_Teichmann,2,S-XC,3,1,0,0,1,2,1
20220207-W-St_Petersburg-R32-Anett_Kontaveit-Jil_Teichmann,2,S-DTM,4,1,0,0,1,2,2
20220207-W-St_Petersburg-R32-Anett_Kontaveit-Jil_Teichmann,2,S-DTL,1,0,0,0,0,1,0
20220210-W-St_Petersburg-R16-Jelena_Ostapenko-Andrea_Petkovic,1,F-XC,25,14,8,0,6,18,7
20220210-W-St_Petersburg-R16-Jelena_Ostapenko-Andrea_Petkovic,1,F-DTM,4,2,0,1,1,3,1
20220210-W-St_Petersburg-R16-Jelena_Ostapenko-Andrea_Petkovic,1,F-DTL,1,1,1,0,0,1,0
20220210-W-St_Petersburg-R16-Jelena_Ostapenko-Andrea_Petkovic,1,F-IO,6,3,2,0,1,3,3
20220210-W-St_Petersburg-R16-Jelena_Ostapenko-Andrea_Petkovic,1,B-XC,14,8,4,2,2,10,4
20220210-W-St_Petersburg-R16-Jelena_Ostapenko-Andrea_Petkovic,1,B-DTM,9,1,0,0,1,6,3
20220210-W-St_Petersburg-R16-Jelena_Ostapenko-Andrea_Petkovic,1,B-DTL,5,3,3,0,0,5,0
20220210-W-St_Petersburg-R16-Jelena_Ostapenko-Andrea_Petkovic,1,B-IO,1,1,0,0,1,0,1
20220210-W-St_Petersburg-R16-Jelena_Ostapenko-Andrea_Petkovic,1,S-XC,1,0,0,0,0,1,0
20220210-W-St_Petersburg-R16-Jelena_Ostapenko-Andrea_Petkovic,1,S-DTM,1,0,0,0,0,1,0
20220210-W-St_Petersburg-R16-Jelena_Ostapenko-Andrea_Petkovic,2,F-XC,7,3,0,0,3,1,6
20220210-W-St_Petersburg-R16-Jelena_Ostapenko-Andrea_Petkovic,2,F-DTM,11,1,0,0,1,3,8
20220210-W-St_Petersburg-R16-Jelena_Ostapenko-Andrea_Petkovic,2,F-DTL,1,0,0,0,0,0,1
20220210-W-St_Petersburg-R16-Jelena_Ostapenko-Andrea_Petkovic,2,F-IO,6,1,1,0,0,2,4
20220210-W-St_Petersburg-R16-Jelena_Ostapenko-Andrea_Petkovic,2,B-XC,7,3,1,0,2,3,4
20220210-W-St_Petersburg-R16-Jelena_Ostapenko-Andrea_Petkovic,2,B-DTM,12,1,0,0,1,5,7
20220210-W-St_Petersburg-R16-Jelena_Ostapenko-Andrea_Petkovic,2,B-DTL,2,1,0,0,1,0,2
20220210-W-St_Petersburg-R16-Jelena_Ostapenko-Andrea_Petkovic,2,S-XC,1,0,0,0,0,0,1
20220210-W-St_Petersburg-R16-Jelena_Ostapenko-Andrea_Petkovic,2,S-DTM,1,0,0,0,0,0,1
20220118-W-Australian_Open-R128-Robin_Anderson-Samantha_Stosur,1,F-XC,42,9,5,0,4,22,20
20220118-W-Australian_Open-R128-Robin_Anderson-Samantha_Stosur,1,F-DTM,30,2,0,0,2,13,17
20220118-W-Australian_Open-R128-Robin_Anderson-Samantha_Stosur,1,F-DTL,12,3,2,0,1,9,3
20220118-W-Australian_Open-R128-Robin_Anderson-Samantha_Stosur,1,F-IO,18,5,1,0,4,8,10
20220118-W-Australian_Open-R128-Robin_Anderson-Samantha_Stosur,1,F-II,2,1,0,0,1,1,1
20220118-W-Australian_Open-R128-Robin_Anderson-Samantha_Stosur,1,B-XC,68,11,0,4,7,39,29
20220118-W-Australian_Open-R128-Robin_Anderson-Samantha_Stosur,1,B-DTM,25,1,0,0,1,13,12
20220118-W-Australian_Open-R128-Robin_Anderson-Samantha_Stosur,1,B-DTL,6,5,3,0,2,4,2
20220118-W-Australian_Open-R128-Robin_Anderson-Samantha_Stosur,1,B-IO,2,1,1,0,0,2,0
20220118-W-Australian_Open-R128-Robin_Anderson-Samantha_Stosur,1,S-XC,29,5,0,1,4,14,15
20220118-W-Australian_Open-R128-Robin_Anderson-Samantha_Stosur,1,S-DTM,10,3,0,1,2,4,6
20220118-W-Australian_Open-R128-Robin_Anderson-Samantha_Stosur,1,S-DTL,5,2,0,0,2,2,3
20220118-W-Australian_Open-R128-Robin_Anderson-Samantha_Stosur,1,S-IO,1,0,0,0,0,0,1
20220118-W-Australian_Open-R128-Robin_Anderson-Samantha_Stosur,2,F-XC,42,14,2,3,9,22,20
20220118-W-Australian_Open-R128-Robin_Anderson-Samantha_Stosur,2,F-DTM,37,10,0,5,5,19,18
20220118-W-Australian_Open-R128-Robin_Anderson-Samantha_Stosur,2,F-DTL,19,9,3,2,4,12,7
20220118-W-Australian_Open-R128-Robin_Anderson-Samantha_Stosur,2,F-IO,50,15,3,3,9,24,26
20220118-W-Australian_Open-R128-Robin_Anderson-Samantha_Stosur,2,F-II,6,2,0,0,2,3,3
20220118-W-Australian_Open-R128-Robin_Anderson-Samantha_Stosur,2,B-XC,8,1,0,0,1,5,3
20220118-W-Australian_Open-R128-Robin_Anderson-Samantha_Stosur,2,B-DTM,12,3,0,1,2,5,7
20220118-W-Australian_Open-R128-Robin_Anderson-Samantha_Stosur,2,B-DTL,6,2,1,0,1,3,3
20220118-W-Australian_Open-R128-Robin_Anderson-Samantha_Stosur,2,B-IO,2,1,0,0,1,0,2
20220118-W-Australian_Open-R128-Robin_Anderson-Samantha_Stosur,2,S-XC,48,4,0,0,4,15,33
20220118-W-Australian_Open-R128-Robin_Anderson-Samantha_Stosur,2,S-DTM,13,0,0,0,0,5,8
20220118-W-Australian_Open-R128-Robin_Anderson-Samantha_Stosur,2,S-DTL,5,2,0,0,2,1,4
20220118-W-Australian_Open-R128-Robin_Anderson-Samantha_Stosur,2,S-IO,2,0,0,0,0,0,2
20220125-W-Australian_Open-QF-Jessica_Pegula-Ashleigh_Barty,1,F-XC,22,4,1,0,3,8,14
20220125-W-Australian_Open-QF-Jessica_Pegula-Ashleigh_Barty,1,F-DTM,16,4,0,0,4,4,12
20220125-W-Australian_Open-QF-Jessica_Pegula-Ashleigh_Barty,1,F-DTL,6,2,0,0,2,1,5
20220125-W-Australian_Open-QF-Jessica_Pegula-Ashleigh_Barty,1,F-IO,15,4,1,0,3,6,9
20220125-W-Australian_Open-QF-Jessica_Pegula-Ashleigh_Barty,1,B-XC,30,2,0,0,2,11,19
20220125-W-Australian_Open-QF-Jessica_Pegula-Ashleigh_Barty,1,B-DTM,16,1,0,0,1,5,11
20220125-W-Australian_Open-QF-Jessica_Pegula-Ashleigh_Barty,1,B-DTL,4,1,1,0,0,2,2
20220125-W-Australian_Open-QF-Jessica_Pegula-Ashleigh_Barty,1,B-IO,1,0,0,0,0,0,1
20220125-W-Australian_Open-QF-Jessica_Pegula-Ashleigh_Barty,1,S-XC,10,2,0,0,2,2,8
20220125-W-Australian_Open-QF-Jessica_Pegula-Ashleigh_Barty,1,S-DTM,3,0,0,0,0,2,1
20220125-W-Australian_Open-QF-Jessica_Pegula-Ashleigh_Barty,1,S-DTL,1,0,0,0,0,0,1
20220125-W-Australian_Open-QF-Jessica_Pegula-Ashleigh_Barty,1,S-IO,1,0,0,0,0,0,1
20220125-W-Australian_Open-QF-Jessica_Pegula-Ashleigh_Barty,2,F-XC,23,9,3,5,1,16,7
20220125-W-Australian_Open-QF-Jessica_Pegula-Ashleigh_Barty,2,F-DTM,18,1,0,0,1,12,6
20220125-W-Australian_Open-QF-Jessica_Pegula-Ashleigh_Barty,2,F-DTL,5,3,1,0,2,3,2
20220125-W-Australian_Open-QF-Jessica_Pegula-Ashleigh_Barty,2,F-IO,22,9,3,0,6,12,10
20220125-W-Australian_Open-QF-Jessica_Pegula-Ashleigh_Barty,2,F-II,2,1,1,0,0,1,1
20220125-W-Australian_Open-QF-Jessica_Pegula-Ashleigh_Barty,2,B-XC,7,5,0,2,3,3,4
20220125-W-Australian_Open-QF-Jessica_Pegula-Ashleigh_Barty,2,B-DTM,8,2,0,2,0,3,5
20220125-W-Australian_Open-QF-Jessica_Pegula-Ashleigh_Barty,2,B-DTL,1,0,0,0,0,1,0
20220125-W-Australian_Open-QF-Jessica_Pegula-Ashleigh_Barty,2,S-XC,15,3,0,1,2,9,6
20220125-W-Australian_Open-QF-Jessica_Pegula-Ashleigh_Barty,2,S-DTM,24,3,0,0,3,17,7
20220125-W-Australian_Open-QF-Jessica_Pegula-Ashleigh_Barty,2,S-DTL,3,1,0,1,0,2,1
20220125-W-Australian_Open-QF-Jessica_Pegula-Ashleigh_Barty,2,S-IO,4,0,0,0,0,3,1
20220120-W-Australian_Open-R64-Samantha_Stosur-Anastasia_Pavlyuchenkova,1,F-XC,13,3,0,1,2,3,10
20220120-W-Australian_Open-R64-Samantha_Stosur-Anastasia_Pavlyuchenkova,1,F-DTM,19,3,1,0,2,7,12
20220120-W-Australian_Open-R64-Samantha_Stosur-Anastasia_Pavlyuchenkova,1,F-DTL,3,1,0,0,1,0,3
20220120-W-Australian_Open-R64-Samantha_Stosur-Anastasia_Pavlyuchenkova,1,F-IO,19,6,1,1,4,10,9
20220120-W-Australian_Open-R64-Samantha_Stosur-Anastasia_Pavlyuchenkova,1,F-II,1,0,0,0,0,1,0
20220120-W-Australian_Open-R64-Samantha_Stosur-Anastasia_Pavlyuchenkova,1,B-XC,6,3,0,1,2,2,4
20220120-W-Australian_Open-R64-Samantha_Stosur-Anastasia_Pavlyuchenkova,1,B-DTM,11,3,0,0,3,0,11
20220120-W-Australian_Open-R64-Samantha_Stosur-Anastasia_Pavlyuchenkova,1,B-DTL,4,0,0,0,0,1,3
20220120-W-Australian_Open-R64-Samantha_Stosur-Anastasia_Pavlyuchenkova,1,B-IO,1,0,0,0,0,0,1
20220120-W-Australian_Open-R64-Samantha_Stosur-Anastasia_Pavlyuchenkova,1,S-XC,13,2,0,0,2,4,9
20220120-W-Australian_Open-R64-Samantha_Stosur-Anastasia_Pavlyuchenkova,1,S-DTM,10,1,0,0,1,1,9
20220120-W-Australian_Open-R64-Samantha_Stosur-Anastasia_Pavlyuchenkova,2,F-XC,26,11,6,3,2,21,5
20220120-W-Australian_Open-R64-Samantha_Stosur-Anastasia_Pavlyuchenkova,2,F-DTM,13,2,0,1,1,9,4
20220120-W-Australian_Open-R64-Samantha_Stosur-Anastasia_Pavlyuchenkova,2,F-DTL,6,2,1,0,1,4,2
20220120-W-Australian_Open-R64-Samantha_Stosur-Anastasia_Pavlyuchenkova,2,F-IO,21,6,4,1,1,19,2
20220120-W-Australian_Open-R64-Samantha_Stosur-Anastasia_Pavlyuchenkova,2,F-II,2,0,0,0,0,1,1
20220120-W-Australian_Open-R64-Samantha_Stosur-Anastasia_Pavlyuchenkova,2,B-XC,25,6,2,1,3,13,12
20220120-W-Australian_Open-R64-Samantha_Stosur-Anastasia_Pavlyuchenkova,2,B-DTM,8,1,0,0,1,5,3
20220120-W-Australian_Open-R64-Samantha_Stosur-Anastasia_Pavlyuchenkova,2,B-DTL,2,1,1,0,0,1,1
20220120-W-Australian_Open-R64-Samantha_Stosur-Anastasia_Pavlyuchenkova,2,S-XC,1,1,0,0,1,0,1
20220120-W-Australian_Open-R64-Samantha_Stosur-Anastasia_Pavlyuchenkova,2,S-DTM,2,0,0,0,0,1,1
20220211-W-St_Petersburg-QF-Anett_Kontaveit-Belinda_Bencic,1,F-XC,25,9,5,0,4,14,11
20220211-W-St_Petersburg-QF-Anett_Kontaveit-Belinda_Bencic,1,F-DTM,12,2,1,0,1,8,4
20220211-W-St_Petersburg-QF-Anett_Kontaveit-Belinda_Bencic,1,F-DTL,5,1,1,0,0,4,1
20220211-W-St_Petersburg-QF-Anett_Kontaveit-Belinda_Bencic,1,F-IO,6,4,3,0,1,4,2
20220211-W-St_Petersburg-QF-Anett_Kontaveit-Belinda_Bencic,1,B-XC,22,5,2,1,2,14,8
20220211-W-St_Petersburg-QF-Anett_Kontaveit-Belinda_Bencic,1,B-DTM,22,1,0,0,1,12,10
20220211-W-St_Petersburg-QF-Anett_Kontaveit-Belinda_Bencic,1,B-DTL,1,0,0,0,0,0,1
20220211-W-St_Petersburg-QF-Anett_Kontaveit-Belinda_Bencic,1,B-IO,7,6,5,1,0,7,0
20220211-W-St_Petersburg-QF-Anett_Kontaveit-Belinda_Bencic,1,S-XC,1,0,0,0,0,1,0
20220211-W-St_Petersburg-QF-Anett_Kontaveit-Belinda_Bencic,1,S-DTM,2,0,0,0,0,1,1
20220211-W-St_Petersburg-QF-Anett_Kontaveit-Belinda_Bencic,2,F-XC,18,4,1,2,1,10,8
20220211-W-St_Petersburg-QF-Anett_Kontaveit-Belinda_Bencic,2,F-DTM,18,3,0,2,1,8,10
20220211-W-St_Petersburg-QF-Anett_Kontaveit-Belinda_Bencic,2,F-DTL,4,3,1,0,2,2,2
20220211-W-St_Petersburg-QF-Anett_Kontaveit-Belinda_Bencic,2,F-IO,13,7,2,0,5,4,9
20220211-W-St_Petersburg-QF-Anett_Kontaveit-Belinda_Bencic,2,F-II,1,1,1,0,0,1,0
20220211-W-St_Petersburg-QF-Anett_Kontaveit-Belinda_Bencic,2,B-XC,18,6,2,0,4,9,9
20220211-W-St_Petersburg-QF-Anett_Kontaveit-Belinda_Bencic,2,B-DTM,21,5,0,0,5,4,17
20220211-W-St_Petersburg-QF-Anett_Kontaveit-Belinda_Bencic,2,B-DTL,6,2,0,1,1,2,4
20220211-W-St_Petersburg-QF-Anett_Kontaveit-Belinda_Bencic,2,B-IO,4,2,0,1,1,2,2
20220212-W-St_Petersburg-SF-Jelena_Ostapenko-Anett_Kontaveit,1,F-XC,32,16,5,2,9,16,16
20220212-W-St_Petersburg-SF-Jelena_Ostapenko-Anett_Kontaveit,1,F-DTM,5,2,0,0,2,2,3
20220212-W-St_Petersburg-SF-Jelena_Ostapenko-Anett_Kontaveit,1,F-DTL,6,4,1,0,3,1,5
20220212-W-St_Petersburg-SF-Jelena_Ostapenko-Anett_Kontaveit,1,F-IO,2,1,0,0,1,0,2
20220212-W-St_Petersburg-SF-Jelena_Ostapenko-Anett_Kontaveit,1,B-XC,17,7,2,0,5,9,8
20220212-W-St_Petersburg-SF-Jelena_Ostapenko-Anett_Kontaveit,1,B-DTM,11,2,1,0,1,6,5
20220212-W-St_Petersburg-SF-Jelena_Ostapenko-Anett_Kontaveit,1,B-DTL,12,9,5,0,4,6,6
20220212-W-St_Petersburg-SF-Jelena_Ostapenko-Anett_Kontaveit,1,B-IO,3,2,0,0,2,1,2
20220212-W-St_Petersburg-SF-Jelena_Ostapenko-Anett_Kontaveit,2,F-XC,17,2,1,0,1,10,7
20220212-W-St_Petersburg-SF-Jelena_Ostapenko-Anett_Kontaveit,2,F-DTM,12,3,0,0,3,1,11
20220212-W-St_Petersburg-SF-Jelena_Ostapenko-Anett_Kontaveit,2,F-DTL,2,1,1,0,0,1,1
20220212-W-St_Petersburg-SF-Jelena_Ostapenko-Anett_Kontaveit,2,F-IO,2,1,0,1,0,1,1
20220212-W-St_Petersburg-SF-Jelena_Ostapenko-Anett_Kontaveit,2,B-XC,16,2,0,1,1,6,10
20220212-W-St_Petersburg-SF-Jelena_Ostapenko-Anett_Kontaveit,2,B-DTM,12,1,0,0,1,5,7
20220212-W-St_Petersburg-SF-Jelena_Ostapenko-Anett_Kontaveit,2,B-DTL,2,0,0,0,0,1,1
20220212-W-St_Petersburg-SF-Jelena_Ostapenko-Anett_Kontaveit,2,B-IO,3,2,2,0,0,3,0
20220212-W-St_Petersburg-SF-Jelena_Ostapenko-Anett_Kontaveit,2,S-DTM,1,0,0,0,0,1,0
20220211-W-St_Petersburg-QF-Jelena_Ostapenko-Aliaksandra_Sasnovich,1,F-XC,41,15,3,3,9,19,22
20220211-W-St_Petersburg-QF-Jelena_Ostapenko-Aliaksandra_Sasnovich,1,F-DTM,8,2,0,0,2,4,4
20220211-W-St_Petersburg-QF-Jelena_Ostapenko-Aliaksandra_Sasnovich,1,F-DTL,14,9,5,1,3,10,4
20220211-W-St_Petersburg-QF-Jelena_Ostapenko-Aliaksandra_Sasnovich,1,F-IO,9,4,3,0,1,6,3
20220211-W-St_Petersburg-QF-Jelena_Ostapenko-Aliaksandra_Sasnovich,1,F-II,3,2,1,1,0,3,0
20220211-W-St_Petersburg-QF-Jelena_Ostapenko-Aliaksandra_Sasnovich,1,B-XC,26,15,4,4,7,12,14
20220211-W-St_Petersburg-QF-Jelena_Ostapenko-Aliaksandra_Sasnovich,1,B-DTM,14,0,0,0,0,6,8
20220211-W-St_Petersburg-QF-Jelena_Ostapenko-Aliaksandra_Sasnovich,1,B-DTL,16,11,6,0,5,9,7
20220211-W-St_Petersburg-QF-Jelena_Ostapenko-Aliaksandra_Sasnovich,1,B-IO,6,5,2,0,3,3,3
20220211-W-St_Petersburg-QF-Jelena_Ostapenko-Aliaksandra_Sasnovich,2,F-XC,30,12,5,1,6,17,13
20220211-W-St_Petersburg-QF-Jelena_Ostapenko-Aliaksandra_Sasnovich,2,F-DTM,12,5,0,0,5,2,10
20220211-W-St_Petersburg-QF-Jelena_Ostapenko-Aliaksandra_Sasnovich,2,F-DTL,10,3,1,0,2,7,3
20220211-W-St_Petersburg-QF-Jelena_Ostapenko-Aliaksandra_Sasnovich,2,F-IO,4,2,1,0,1,2,2
20220211-W-St_Petersburg-QF-Jelena_Ostapenko-Aliaksandra_Sasnovich,2,B-XC,16,5,4,1,0,11,5
20220211-W-St_Petersburg-QF-Jelena_Ostapenko-Aliaksandra_Sasnovich,2,B-DTM,13,2,0,0,2,6,7
20220211-W-St_Petersburg-QF-Jelena_Ostapenko-Aliaksandra_Sasnovich,2,B-DTL,8,6,2,1,3,4,4
20220211-W-St_Petersburg-QF-Jelena_Ostapenko-Aliaksandra_Sasnovich,2,B-IO,11,5,2,0,3,6,5
20220211-W-St_Petersburg-QF-Jelena_Ostapenko-Aliaksandra_Sasnovich,2,S-XC,1,1,1,0,0,1,0
20220211-W-St_Petersburg-QF-Jelena_Ostapenko-Aliaksandra_Sasnovich,2,S-DTM,3,1,0,0,1,1,2
20220211-W-St_Petersburg-QF-Jelena_Ostapenko-Aliaksandra_Sasnovich,2,S-IO,1,0,0,0,0,0,1
20220213-W-St_Petersburg-F-Anett_Kontaveit-Maria_Sakkari,1,F-XC,82,23,11,2,10,51,31
20220213-W-St_Petersburg-F-Anett_Kontaveit-Maria_Sakkari,1,F-DTM,43,6,0,0,6,22,21
20220213-W-St_Petersburg-F-Anett_Kontaveit-Maria_Sakkari,1,F-DTL,15,9,1,1,7,4,11
20220213-W-St_Petersburg-F-Anett_Kontaveit-Maria_Sakkari,1,F-IO,20,5,1,1,3,12,8
20220213-W-St_Petersburg-F-Anett_Kontaveit-Maria_Sakkari,1,B-XC,67,12,2,1,9,45,22
20220213-W-St_Petersburg-F-Anett_Kontaveit-Maria_Sakkari,1,B-DTM,37,4,0,1,3,20,17
20220213-W-St_Petersburg-F-Anett_Kontaveit-Maria_Sakkari,1,B-DTL,8,6,3,1,2,5,3
20220213-W-St_Petersburg-F-Anett_Kontaveit-Maria_Sakkari,1,B-IO,8,5,2,2,1,5,3
20220213-W-St_Petersburg-F-Anett_Kontaveit-Maria_Sakkari,1,S-XC,2,0,0,0,0,2,0
20220213-W-St_Petersburg-F-Anett_Kontaveit-Maria_Sakkari,1,S-DTM,3,0,0,0,0,3,0
20220213-W-St_Petersburg-F-Anett_Kontaveit-Maria_Sakkari,2,F-XC,63,18,6,0,12,30,33
20220213-W-St_Petersburg-F-Anett_Kontaveit-Maria_Sakkari,2,F-DTM,46,8,2,1,5,15,31
20220213-W-St_Petersburg-F-Anett_Kontaveit-Maria_Sakkari,2,F-DTL,15,10,2,2,6,4,11
20220213-W-St_Petersburg-F-Anett_Kontaveit-Maria_Sakkari,2,F-IO,15,9,3,2,4,5,10
20220213-W-St_Petersburg-F-Anett_Kontaveit-Maria_Sakkari,2,F-II,2,1,0,1,0,1,1
20220213-W-St_Petersburg-F-Anett_Kontaveit-Maria_Sakkari,2,B-XC,49,17,2,3,12,16,33
20220213-W-St_Petersburg-F-Anett_Kontaveit-Maria_Sakkari,2,B-DTM,68,8,2,0,6,27,41
20220213-W-St_Petersburg-F-Anett_Kontaveit-Maria_Sakkari,2,B-DTL,16,10,5,1,4,7,9
20220213-W-St_Petersburg-F-Anett_Kontaveit-Maria_Sakkari,2,B-IO,8,1,0,0,1,7,1
20220213-W-St_Petersburg-F-Anett_Kontaveit-Maria_Sakkari,2,S-XC,3,0,0,0,0,0,3
20220213-W-St_Petersburg-F-Anett_Kontaveit-Maria_Sakkari,2,S-DTM,6,0,0,0,0,2,4
20220213-W-St_Petersburg-F-Anett_Kontaveit-Maria_Sakkari,2,S-DTL,2,0,0,0,0,0,2
20220213-W-St_Petersburg-F-Anett_Kontaveit-Maria_Sakkari,2,S-IO,1,0,0,0,0,1,0
20220214-W-Dubai-R32-Iga_Swiatek-Daria_Kasatkina,1,F-XC,26,8,4,0,4,18,8
20220214-W-Dubai-R32-Iga_Swiatek-Daria_Kasatkina,1,F-DTM,17,2,0,0,2,8,9
20220214-W-Dubai-R32-Iga_Swiatek-Daria_Kasatkina,1,F-DTL,10,2,1,0,1,5,5
20220214-W-Dubai-R32-Iga_Swiatek-Daria_Kasatkina,1,F-IO,17,7,6,0,1,11,6
20220214-W-Dubai-R32-Iga_Swiatek-Daria_Kasatkina,1,F-II,1,0,0,0,0,1,0
20220214-W-Dubai-R32-Iga_Swiatek-Daria_Kasatkina,1,B-XC,17,6,2,1,3,9,8
20220214-W-Dubai-R32-Iga_Swiatek-Daria_Kasatkina,1,B-DTM,21,2,0,0,2,8,13
20220214-W-Dubai-R32-Iga_Swiatek-Daria_Kasatkina,1,B-DTL,5,2,1,0,1,4,1
20220214-W-Dubai-R32-Iga_Swiatek-Daria_Kasatkina,1,B-IO,7,5,3,1,1,5,2
20220214-W-Dubai-R32-Iga_Swiatek-Daria_Kasatkina,1,S-XC,2,0,0,0,0,1,1
20220214-W-Dubai-R32-Iga_Swiatek-Daria_Kasatkina,1,S-DTM,1,0,0,0,0,0,1
20220214-W-Dubai-R32-Iga_Swiatek-Daria_Kasatkina,2,F-XC,27,11,3,0,8,9,18
20220214-W-Dubai-R32-Iga_Swiatek-Daria_Kasatkina,2,F-DTM,24,1,0,0,1,8,16
20220214-W-Dubai-R32-Iga_Swiatek-Daria_Kasatkina,2,F-DTL,8,3,1,0,2,2,6
20220214-W-Dubai-R32-Iga_Swiatek-Daria_Kasatkina,2,F-IO,15,5,4,0,1,11,4
20220214-W-Dubai-R32-Iga_Swiatek-Daria_Kasatkina,2,B-XC,14,4,0,0,4,7,7
20220214-W-Dubai-R32-Iga_Swiatek-Daria_Kasatkina,2,B-DTM,19,1,0,0,1,9,10
20220214-W-Dubai-R32-Iga_Swiatek-Daria_Kasatkina,2,B-DTL,7,2,0,0,2,4,3
20220214-W-Dubai-R32-Iga_Swiatek-Daria_Kasatkina,2,B-IO,1,1,1,0,0,1,0
20220214-W-Dubai-R32-Iga_Swiatek-Daria_Kasatkina,2,S-XC,2,0,0,0,0,1,1
20220214-W-Dubai-R32-Iga_Swiatek-Daria_Kasatkina,2,S-DTM,3,0,0,0,0,2,1
