match_id,player,row,shots,pt_ending,winners,induced_forced,unforced,shots_in_pts_won,shots_in_pts_lost
19751219-M-Davis_Cup_World_Group_F-RR-Bjorn_Borg-Jiri_Hrebec,1,F-XC,27,6,2,3,1,17,10,,,,,,,,,,
19751219-M-Davis_Cup_World_Group_F-RR-Bjorn_Borg-Jiri_Hrebec,1,F-DTM,23,0,0,0,0,15,8,,,,,,,,,,
19751219-M-Davis_Cup_World_Group_F-RR-Bjorn_Borg-Jiri_Hrebec,1,F-DTL,10,1,1,0,0,5,5,,,,,,,,,,
19751219-M-Davis_Cup_World_Group_F-RR-Bjorn_Borg-Jiri_Hrebec,1,F-IO,19,1,0,1,0,11,8,,,,,,,,,,
19751219-M-Davis_Cup_World_Group_F-RR-Bjorn_Borg-Jiri_Hrebec,1,B-XC,57,6,3,1,2,36,21,,,,,,,,,,
19751219-M-Davis_Cup_World_Group_F-RR-Bjorn_Borg-Jiri_Hrebec,1,B-DTM,17,3,0,2,1,9,8,,,,,,,,,,
19751219-M-Davis_Cup_World_Group_F-RR-Bjorn_Borg-Jiri_Hrebec,1,B-DTL,8,4,2,0,2,5,3,,,,,,,,,,
19751219-M-Davis_Cup_World_Group_F-RR-Bjorn_Borg-Jiri_Hrebec,1,B-IO,3,2,1,0,1,2,1,,,,,,,,,,
19751219-M-Davis_Cup_World_Group_F-RR-Bjorn_Borg-Jiri_Hrebec,1,S-XC,3,2,0,1,1,1,2,,,,,,,,,,
19751219-M-Davis_Cup_World_Group_F-RR-Bjorn_Borg-Jiri_Hrebec,1,S-DTM,3,0,0,0,0,1,2,,,,,,,,,,
19751219-M-Davis_Cup_World_Group_F-RR-Bjorn_Borg-Jiri_Hrebec,1,S-DTL,1,1,1,0,0,1,0,,,,,,,,,,
19751219-M-Davis_Cup_World_Group_F-RR-Bjorn_Borg-Jiri_Hrebec,2,F-XC,30,12,3,5,4,16,14,,,,,,,,,,
19751219-M-Davis_Cup_World_Group_F-RR-Bjorn_Borg-Jiri_Hrebec,2,F-DTM,26,2,0,0,2,9,17,,,,,,,,,,
19751219-M-Davis_Cup_World_Group_F-RR-Bjorn_Borg-Jiri_Hrebec,2,F-DTL,4,1,0,0,1,0,4,,,,,,,,,,
19751219-M-Davis_Cup_World_Group_F-RR-Bjorn_Borg-Jiri_Hrebec,2,F-IO,25,8,2,2,4,13,12,,,,,,,,,,
19751219-M-Davis_Cup_World_Group_F-RR-Bjorn_Borg-Jiri_Hrebec,2,F-II,2,1,0,1,0,2,0,,,,,,,,,,
19751219-M-Davis_Cup_World_Group_F-RR-Bjorn_Borg-Jiri_Hrebec,2,B-XC,17,0,0,0,0,5,12,,,,,,,,,,
19751219-M-Davis_Cup_World_Group_F-RR-Bjorn_Borg-Jiri_Hrebec,2,B-DTM,13,0,0,0,0,4,9,,,,,,,,,,
19751219-M-Davis_Cup_World_Group_F-RR-Bjorn_Borg-Jiri_Hrebec,2,B-DTL,6,2,1,0,1,1,5,,,,,,,,,,
19751219-M-Davis_Cup_World_Group_F-RR-Bjorn_Borg-Jiri_Hrebec,2,B-IO,1,0,0,0,0,1,0,,,,,,,,,,
19751219-M-Davis_Cup_World_Group_F-RR-Bjorn_Borg-Jiri_Hrebec,2,S-XC,32,2,0,0,2,13,19,,,,,,,,,,
19751219-M-Davis_Cup_World_Group_F-RR-Bjorn_Borg-Jiri_Hrebec,2,S-DTM,13,2,0,0,2,3,10,,,,,,,,,,
19751219-M-Davis_Cup_World_Group_F-RR-Bjorn_Borg-Jiri_Hrebec,2,S-DTL,7,2,0,0,2,0,7,,,,,,,,,,
19780125-M-Pepsi_Grand_Slam-SF-Brian_Gottfried-Bjorn_Borg,1,F-XC,20,1,0,0,1,3,17,,,,,,,,,,
19780125-M-Pepsi_Grand_Slam-SF-Brian_Gottfried-Bjorn_Borg,1,F-DTM,13,0,0,0,0,3,10,,,,,,,,,,
19780125-M-Pepsi_Grand_Slam-SF-Brian_Gottfried-Bjorn_Borg,1,F-DTL,4,1,0,1,0,2,2,,,,,,,,,,
19780125-M-Pepsi_Grand_Slam-SF-Brian_Gottfried-Bjorn_Borg,1,F-IO,5,1,0,1,0,2,3,,,,,,,,,,
19780125-M-Pepsi_Grand_Slam-SF-Brian_Gottfried-Bjorn_Borg,1,B-XC,17,0,0,0,0,6,11,,,,,,,,,,
19780125-M-Pepsi_Grand_Slam-SF-Brian_Gottfried-Bjorn_Borg,1,B-DTM,7,1,0,0,1,3,4,,,,,,,,,,
19780125-M-Pepsi_Grand_Slam-SF-Brian_Gottfried-Bjorn_Borg,1,B-DTL,3,2,0,0,2,1,2,,,,,,,,,,
19780125-M-Pepsi_Grand_Slam-SF-Brian_Gottfried-Bjorn_Borg,1,B-IO,2,1,1,0,0,2,0,,,,,,,,,,
19780125-M-Pepsi_Grand_Slam-SF-Brian_Gottfried-Bjorn_Borg,1,S-XC,51,7,0,1,6,17,34,,,,,,,,,,
19780125-M-Pepsi_Grand_Slam-SF-Brian_Gottfried-Bjorn_Borg,1,S-DTM,13,2,0,0,2,6,7,,,,,,,,,,
19780125-M-Pepsi_Grand_Slam-SF-Brian_Gottfried-Bjorn_Borg,1,S-DTL,13,5,0,0,5,6,7,,,,,,,,,,
19780125-M-Pepsi_Grand_Slam-SF-Brian_Gottfried-Bjorn_Borg,1,S-IO,6,3,0,0,3,2,4,,,,,,,,,,
19780125-M-Pepsi_Grand_Slam-SF-Brian_Gottfried-Bjorn_Borg,2,F-XC,48,5,2,0,3,32,16,,,,,,,,,,
19780125-M-Pepsi_Grand_Slam-SF-Brian_Gottfried-Bjorn_Borg,2,F-DTM,26,2,1,0,1,14,12,,,,,,,,,,
19780125-M-Pepsi_Grand_Slam-SF-Brian_Gottfried-Bjorn_Borg,2,F-DTL,9,2,1,0,1,5,4,,,,,,,,,,
19780125-M-Pepsi_Grand_Slam-SF-Brian_Gottfried-Bjorn_Borg,2,F-IO,9,1,1,0,0,7,2,,,,,,,,,,
19780125-M-Pepsi_Grand_Slam-SF-Brian_Gottfried-Bjorn_Borg,2,F-II,1,1,0,1,0,1,0,,,,,,,,,,
19780125-M-Pepsi_Grand_Slam-SF-Brian_Gottfried-Bjorn_Borg,2,B-XC,77,14,4,3,7,45,32,,,,,,,,,,
19780125-M-Pepsi_Grand_Slam-SF-Brian_Gottfried-Bjorn_Borg,2,B-DTM,16,0,0,0,0,11,5,,,,,,,,,,
19780125-M-Pepsi_Grand_Slam-SF-Brian_Gottfried-Bjorn_Borg,2,B-DTL,9,6,1,2,3,6,3,,,,,,,,,,
19780125-M-Pepsi_Grand_Slam-SF-Brian_Gottfried-Bjorn_Borg,2,B-IO,1,0,0,0,0,1,0,,,,,,,,,,
19780125-M-Pepsi_Grand_Slam-SF-Brian_Gottfried-Bjorn_Borg,2,B-II,1,1,0,0,1,0,1,,,,,,,,,,
19780125-M-Pepsi_Grand_Slam-SF-Brian_Gottfried-Bjorn_Borg,2,S-XC,7,1,1,0,0,4,3,,,,,,,,,,
19780125-M-Pepsi_Grand_Slam-SF-Brian_Gottfried-Bjorn_Borg,2,S-DTM,3,0,0,0,0,1,2,,,,,,,,,,
19780125-M-Pepsi_Grand_Slam-SF-Brian_Gottfried-Bjorn_Borg,2,S-DTL,1,0,0,0,0,0,1,,,,,,,,,,
19800705-M-Wimbledon-F-John_Mcenroe-Bjorn_Borg,1,F-XC,12,4,1,0,3,7,5,,,,,,,,,,
19800705-M-Wimbledon-F-John_Mcenroe-Bjorn_Borg,1,F-DTM,7,1,1,0,0,3,4,,,,,,,,,,
19800705-M-Wimbledon-F-John_Mcenroe-Bjorn_Borg,1,F-DTL,12,7,3,0,4,3,9,,,,,,,,,,
19800705-M-Wimbledon-F-John_Mcenroe-Bjorn_Borg,1,F-IO,6,4,1,1,2,4,2,,,,,,,,,,
19800705-M-Wimbledon-F-John_Mcenroe-Bjorn_Borg,1,B-XC,25,10,6,1,3,13,12,,,,,,,,,,
19800705-M-Wimbledon-F-John_Mcenroe-Bjorn_Borg,1,B-DTM,16,4,0,0,4,7,9,,,,,,,,,,
19800705-M-Wimbledon-F-John_Mcenroe-Bjorn_Borg,1,B-DTL,16,10,1,1,8,5,11,,,,,,,,,,
19800705-M-Wimbledon-F-John_Mcenroe-Bjorn_Borg,1,B-IO,11,6,3,1,2,5,6,,,,,,,,,,
19800705-M-Wimbledon-F-John_Mcenroe-Bjorn_Borg,1,B-II,2,1,0,0,1,0,2,,,,,,,,,,
19800705-M-Wimbledon-F-John_Mcenroe-Bjorn_Borg,1,S-XC,6,0,0,0,0,3,3,,,,,,,,,,
19800705-M-Wimbledon-F-John_Mcenroe-Bjorn_Borg,1,S-DTM,2,1,0,0,1,1,1,,,,,,,,,,
19800705-M-Wimbledon-F-John_Mcenroe-Bjorn_Borg,1,S-DTL,12,4,0,0,4,5,7,,,,,,,,,,
19800705-M-Wimbledon-F-John_Mcenroe-Bjorn_Borg,2,F-XC,36,7,3,1,3,20,16,,,,,,,,,,
19800705-M-Wimbledon-F-John_Mcenroe-Bjorn_Borg,2,F-DTM,14,3,2,0,1,8,6,,,,,,,,,,
19800705-M-Wimbledon-F-John_Mcenroe-Bjorn_Borg,2,F-DTL,15,8,7,0,1,13,2,,,,,,,,,,
19800705-M-Wimbledon-F-John_Mcenroe-Bjorn_Borg,2,F-IO,12,5,1,1,3,7,5,,,,,,,,,,
19800705-M-Wimbledon-F-John_Mcenroe-Bjorn_Borg,2,B-XC,21,12,4,5,3,13,8,,,,,,,,,,
19800705-M-Wimbledon-F-John_Mcenroe-Bjorn_Borg,2,B-DTM,10,3,1,0,2,3,7,,,,,,,,,,
19800705-M-Wimbledon-F-John_Mcenroe-Bjorn_Borg,2,B-DTL,15,4,1,0,3,7,8,,,,,,,,,,
19800705-M-Wimbledon-F-John_Mcenroe-Bjorn_Borg,2,B-IO,4,2,0,1,1,3,1,,,,,,,,,,
19800705-M-Wimbledon-F-John_Mcenroe-Bjorn_Borg,2,S-XC,1,0,0,0,0,1,0,,,,,,,,,,
19800705-M-Wimbledon-F-John_Mcenroe-Bjorn_Borg,2,S-DTM,5,0,0,0,0,2,3,,,,,,,,,,
19800705-M-Wimbledon-F-John_Mcenroe-Bjorn_Borg,2,S-DTL,6,0,0,0,0,2,4,,,,,,,,,,
19800705-M-Wimbledon-F-John_Mcenroe-Bjorn_Borg,2,S-IO,2,1,0,0,1,0,2,,,,,,,,,,
19810607-M-Roland_Garros-F-Bjorn_Borg-Ivan_Lendl,1,F-XC,95,8,3,3,2,59,36,,,,,,,,,,
19810607-M-Roland_Garros-F-Bjorn_Borg-Ivan_Lendl,1,F-DTM,76,2,0,1,1,41,35,,,,,,,,,,
19810607-M-Roland_Garros-F-Bjorn_Borg-Ivan_Lendl,1,F-DTL,17,2,0,2,0,9,8,,,,,,,,,,
19810607-M-Roland_Garros-F-Bjorn_Borg-Ivan_Lendl,1,F-IO,39,5,0,1,4,16,23,,,,,,,,,,
19810607-M-Roland_Garros-F-Bjorn_Borg-Ivan_Lendl,1,F-II,10,0,0,0,0,5,5,,,,,,,,,,
19810607-M-Roland_Garros-F-Bjorn_Borg-Ivan_Lendl,1,B-XC,155,8,2,2,4,82,73,,,,,,,,,,
19810607-M-Roland_Garros-F-Bjorn_Borg-Ivan_Lendl,1,B-DTM,66,2,0,0,2,31,35,,,,,,,,,,
19810607-M-Roland_Garros-F-Bjorn_Borg-Ivan_Lendl,1,B-DTL,24,4,1,2,1,18,6,,,,,,,,,,
19810607-M-Roland_Garros-F-Bjorn_Borg-Ivan_Lendl,1,B-IO,10,0,0,0,0,7,3,,,,,,,,,,
19810607-M-Roland_Garros-F-Bjorn_Borg-Ivan_Lendl,1,S-XC,6,0,0,0,0,1,5,,,,,,,,,,
19810607-M-Roland_Garros-F-Bjorn_Borg-Ivan_Lendl,1,S-DTM,10,0,0,0,0,0,10,,,,,,,,,,
19810607-M-Roland_Garros-F-Bjorn_Borg-Ivan_Lendl,1,S-DTL,2,0,0,0,0,1,1,,,,,,,,,,
19810607-M-Roland_Garros-F-Bjorn_Borg-Ivan_Lendl,2,F-XC,101,12,2,4,6,43,58,,,,,,,,,,
19810607-M-Roland_Garros-F-Bjorn_Borg-Ivan_Lendl,2,F-DTM,64,4,1,0,3,23,41,,,,,,,,,,
19810607-M-Roland_Garros-F-Bjorn_Borg-Ivan_Lendl,2,F-DTL,25,8,2,2,4,13,12,,,,,,,,,,
19810607-M-Roland_Garros-F-Bjorn_Borg-Ivan_Lendl,2,F-IO,52,13,5,2,6,32,20,,,,,,,,,,
19810607-M-Roland_Garros-F-Bjorn_Borg-Ivan_Lendl,2,F-II,9,4,1,1,2,3,6,,,,,,,,,,
19810607-M-Roland_Garros-F-Bjorn_Borg-Ivan_Lendl,2,B-XC,143,7,1,2,4,77,66,,,,,,,,,,
19810607-M-Roland_Garros-F-Bjorn_Borg-Ivan_Lendl,2,B-DTM,53,1,0,0,1,24,29,,,,,,,,,,
19810607-M-Roland_Garros-F-Bjorn_Borg-Ivan_Lendl,2,B-DTL,5,3,3,0,0,5,0,,,,,,,,,,
19810607-M-Roland_Garros-F-Bjorn_Borg-Ivan_Lendl,2,B-IO,5,3,1,1,1,3,2,,,,,,,,,,
19810607-M-Roland_Garros-F-Bjorn_Borg-Ivan_Lendl,2,S-XC,35,3,1,0,2,11,24,,,,,,,,,,
19810607-M-Roland_Garros-F-Bjorn_Borg-Ivan_Lendl,2,S-DTM,22,1,0,0,1,9,13,,,,,,,,,,
19810607-M-Roland_Garros-F-Bjorn_Borg-Ivan_Lendl,2,S-DTL,4,1,1,0,0,2,2,,,,,,,,,,
19810607-M-Roland_Garros-F-Bjorn_Borg-Ivan_Lendl,2,S-IO,2,0,0,0,0,0,2,,,,,,,,,,
19810704-M-Wimbledon-F-John_Mcenroe-Bjorn_Borg,1,F-XC,23,7,4,0,3,7,16,,,,,,,,,,
19810704-M-Wimbledon-F-John_Mcenroe-Bjorn_Borg,1,F-DTM,5,0,0,0,0,4,1,,,,,,,,,,
19810704-M-Wimbledon-F-John_Mcenroe-Bjorn_Borg,1,F-DTL,4,2,1,0,1,1,3,,,,,,,,,,
19810704-M-Wimbledon-F-John_Mcenroe-Bjorn_Borg,1,F-IO,2,0,0,0,0,0,2,,,,,,,,,,
19810704-M-Wimbledon-F-John_Mcenroe-Bjorn_Borg,1,B-XC,18,7,3,0,4,5,13,,,,,,,,,,
19810704-M-Wimbledon-F-John_Mcenroe-Bjorn_Borg,1,B-DTM,12,2,0,0,2,7,5,,,,,,,,,,
19810704-M-Wimbledon-F-John_Mcenroe-Bjorn_Borg,1,B-DTL,7,4,1,2,1,4,3,,,,,,,,,,
19810704-M-Wimbledon-F-John_Mcenroe-Bjorn_Borg,1,B-IO,4,2,1,0,1,2,2,,,,,,,,,,
19810704-M-Wimbledon-F-John_Mcenroe-Bjorn_Borg,1,B-II,1,1,0,0,1,0,1,,,,,,,,,,
19810704-M-Wimbledon-F-John_Mcenroe-Bjorn_Borg,1,S-XC,11,2,0,1,1,5,6,,,,,,,,,,
19810704-M-Wimbledon-F-John_Mcenroe-Bjorn_Borg,1,S-DTM,20,1,0,0,1,10,10,,,,,,,,,,
19810704-M-Wimbledon-F-John_Mcenroe-Bjorn_Borg,1,S-DTL,9,3,1,0,2,2,7,,,,,,,,,,
19810704-M-Wimbledon-F-John_Mcenroe-Bjorn_Borg,1,S-IO,7,0,0,0,0,2,5,,,,,,,,,,
19810704-M-Wimbledon-F-John_Mcenroe-Bjorn_Borg,2,F-XC,37,9,3,4,2,25,12,,,,,,,,,,
19810704-M-Wimbledon-F-John_Mcenroe-Bjorn_Borg,2,F-DTM,19,1,0,0,1,8,11,,,,,,,,,,
19810704-M-Wimbledon-F-John_Mcenroe-Bjorn_Borg,2,F-DTL,13,8,2,5,1,11,2,,,,,,,,,,
19810704-M-Wimbledon-F-John_Mcenroe-Bjorn_Borg,2,F-IO,11,5,1,2,2,8,3,,,,,,,,,,
19810704-M-Wimbledon-F-John_Mcenroe-Bjorn_Borg,2,F-II,2,1,0,1,0,1,1,,,,,,,,,,
19810704-M-Wimbledon-F-John_Mcenroe-Bjorn_Borg,2,B-XC,27,6,3,1,2,14,13,,,,,,,,,,
19810704-M-Wimbledon-F-John_Mcenroe-Bjorn_Borg,2,B-DTM,25,1,1,0,0,12,13,,,,,,,,,,
19810704-M-Wimbledon-F-John_Mcenroe-Bjorn_Borg,2,B-DTL,15,2,2,0,0,8,7,,,,,,,,,,
19810704-M-Wimbledon-F-John_Mcenroe-Bjorn_Borg,2,B-IO,12,2,1,0,1,3,9,,,,,,,,,,
19810704-M-Wimbledon-F-John_Mcenroe-Bjorn_Borg,2,B-II,1,0,0,0,0,1,0,,,,,,,,,,
19810704-M-Wimbledon-F-John_Mcenroe-Bjorn_Borg,2,S-XC,2,0,0,0,0,1,1,,,,,,,,,,
19810704-M-Wimbledon-F-John_Mcenroe-Bjorn_Borg,2,S-DTM,4,0,0,0,0,3,1,,,,,,,,,,
19810704-M-Wimbledon-F-John_Mcenroe-Bjorn_Borg,2,S-DTL,2,1,0,1,0,1,1,,,,,,,,,,
19810704-M-Wimbledon-F-John_Mcenroe-Bjorn_Borg,2,S-IO,1,0,0,0,0,1,0,,,,,,,,,,
19810913-M-US_Open-F-John_Mcenroe-Bjorn_Borg,1,F-XC,58,8,2,1,5,33,25,,,,,,,,,,
19810913-M-US_Open-F-John_Mcenroe-Bjorn_Borg,1,F-DTM,26,2,0,1,1,12,14,,,,,,,,,,
19810913-M-US_Open-F-John_Mcenroe-Bjorn_Borg,1,F-DTL,8,4,2,1,1,3,5,,,,,,,,,,
19810913-M-US_Open-F-John_Mcenroe-Bjorn_Borg,1,F-IO,6,2,1,1,0,4,2,,,,,,,,,,
19810913-M-US_Open-F-John_Mcenroe-Bjorn_Borg,1,B-XC,18,7,3,2,2,12,6,,,,,,,,,,
19810913-M-US_Open-F-John_Mcenroe-Bjorn_Borg,1,B-DTM,15,1,0,1,0,11,4,,,,,,,,,,
19810913-M-US_Open-F-John_Mcenroe-Bjorn_Borg,1,B-DTL,3,2,0,1,1,1,2,,,,,,,,,,
19810913-M-US_Open-F-John_Mcenroe-Bjorn_Borg,1,S-XC,20,2,1,0,1,13,7,,,,,,,,,,
19810913-M-US_Open-F-John_Mcenroe-Bjorn_Borg,1,S-DTM,28,4,0,0,4,10,18,,,,,,,,,,
19810913-M-US_Open-F-John_Mcenroe-Bjorn_Borg,1,S-DTL,10,2,1,0,1,5,5,,,,,,,,,,
19810913-M-US_Open-F-John_Mcenroe-Bjorn_Borg,1,S-IO,3,0,0,0,0,2,1,,,,,,,,,,
19810913-M-US_Open-F-John_Mcenroe-Bjorn_Borg,2,F-XC,53,10,2,6,2,30,23,,,,,,,,,,
19810913-M-US_Open-F-John_Mcenroe-Bjorn_Borg,2,F-DTM,31,1,0,0,1,12,19,,,,,,,,,,
19810913-M-US_Open-F-John_Mcenroe-Bjorn_Borg,2,F-DTL,6,3,0,2,1,4,2,,,,,,,,,,
19810913-M-US_Open-F-John_Mcenroe-Bjorn_Borg,2,F-IO,20,6,0,2,4,9,11,,,,,,,,,,
19810913-M-US_Open-F-John_Mcenroe-Bjorn_Borg,2,B-XC,59,14,2,6,6,27,32,,,,,,,,,,
19810913-M-US_Open-F-John_Mcenroe-Bjorn_Borg,2,B-DTM,37,2,0,0,2,17,20,,,,,,,,,,
19810913-M-US_Open-F-John_Mcenroe-Bjorn_Borg,2,B-DTL,19,6,1,2,3,7,12,,,,,,,,,,
19810913-M-US_Open-F-John_Mcenroe-Bjorn_Borg,2,B-IO,9,2,1,0,1,2,7,,,,,,,,,,
19810913-M-US_Open-F-John_Mcenroe-Bjorn_Borg,2,S-XC,3,1,0,0,1,0,3,,,,,,,,,,
19810913-M-US_Open-F-John_Mcenroe-Bjorn_Borg,2,S-DTM,2,0,0,0,0,0,2,,,,,,,,,,
19810913-M-US_Open-F-John_Mcenroe-Bjorn_Borg,2,S-DTL,3,1,0,1,0,2,1,,,,,,,,,,
19810913-M-US_Open-F-John_Mcenroe-Bjorn_Borg,2,S-IO,2,1,1,0,0,2,0,,,,,,,,,,
19820912-M-US_Open-F-Jimmy_Connors-Ivan_Lendl,1,F-XC,115,13,1,3,9,60,55,,,,,,,,,,
19820912-M-US_Open-F-Jimmy_Connors-Ivan_Lendl,1,F-DTM,62,4,0,1,3,29,33,,,,,,,,,,
19820912-M-US_Open-F-Jimmy_Connors-Ivan_Lendl,1,F-DTL,17,4,3,1,0,9,8,,,,,,,,,,
19820912-M-US_Open-F-Jimmy_Connors-Ivan_Lendl,1,F-IO,30,8,2,2,4,20,10,,,,,,,,,,
19820912-M-US_Open-F-Jimmy_Connors-Ivan_Lendl,1,F-II,1,0,0,0,0,1,0,,,,,,,,,,
19820912-M-US_Open-F-Jimmy_Connors-Ivan_Lendl,1,B-XC,64,17,6,5,6,42,22,,,,,,,,,,
19820912-M-US_Open-F-Jimmy_Connors-Ivan_Lendl,1,B-DTM,53,3,0,0,3,30,23,,,,,,,,,,
19820912-M-US_Open-F-Jimmy_Connors-Ivan_Lendl,1,B-DTL,20,5,2,2,1,16,4,,,,,,,,,,
19820912-M-US_Open-F-Jimmy_Connors-Ivan_Lendl,1,B-IO,23,7,2,1,4,12,11,,,,,,,,,,
19820912-M-US_Open-F-Jimmy_Connors-Ivan_Lendl,1,S-XC,12,1,0,0,1,6,6,,,,,,,,,,
19820912-M-US_Open-F-Jimmy_Connors-Ivan_Lendl,1,S-DTM,16,3,0,0,3,7,9,,,,,,,,,,
19820912-M-US_Open-F-Jimmy_Connors-Ivan_Lendl,1,S-DTL,6,2,0,2,0,3,3,,,,,,,,,,
19820912-M-US_Open-F-Jimmy_Connors-Ivan_Lendl,1,S-IO,5,1,0,0,1,3,2,,,,,,,,,,
19820912-M-US_Open-F-Jimmy_Connors-Ivan_Lendl,1,S-II,1,1,0,0,1,0,1,,,,,,,,,,
19820912-M-US_Open-F-Jimmy_Connors-Ivan_Lendl,2,F-XC,87,13,2,1,10,35,52,,,,,,,,,,
19820912-M-US_Open-F-Jimmy_Connors-Ivan_Lendl,2,F-DTM,57,3,0,0,3,19,38,,,,,,,,,,
19820912-M-US_Open-F-Jimmy_Connors-Ivan_Lendl,2,F-DTL,29,15,7,2,6,15,14,,,,,,,,,,
19820912-M-US_Open-F-Jimmy_Connors-Ivan_Lendl,2,F-IO,30,7,2,2,3,16,14,,,,,,,,,,
19820912-M-US_Open-F-Jimmy_Connors-Ivan_Lendl,2,F-II,2,0,0,0,0,1,1,,,,,,,,,,
19820912-M-US_Open-F-Jimmy_Connors-Ivan_Lendl,2,B-XC,48,12,3,2,7,19,29,,,,,,,,,,
19820912-M-US_Open-F-Jimmy_Connors-Ivan_Lendl,2,B-DTM,62,3,0,1,2,27,35,,,,,,,,,,
19820912-M-US_Open-F-Jimmy_Connors-Ivan_Lendl,2,B-DTL,15,8,2,0,6,4,11,,,,,,,,,,
19820912-M-US_Open-F-Jimmy_Connors-Ivan_Lendl,2,B-IO,6,2,2,0,0,3,3,,,,,,,,,,
19820912-M-US_Open-F-Jimmy_Connors-Ivan_Lendl,2,B-II,1,0,0,0,0,0,1,,,,,,,,,,
19820912-M-US_Open-F-Jimmy_Connors-Ivan_Lendl,2,S-XC,31,2,0,0,2,11,20,,,,,,,,,,
19820912-M-US_Open-F-Jimmy_Connors-Ivan_Lendl,2,S-DTM,50,3,0,0,3,23,27,,,,,,,,,,
19820912-M-US_Open-F-Jimmy_Connors-Ivan_Lendl,2,S-DTL,12,3,0,0,3,4,8,,,,,,,,,,
19820912-M-US_Open-F-Jimmy_Connors-Ivan_Lendl,2,S-IO,6,0,0,0,0,2,4,,,,,,,,,,
19840506-M-Forest_Hills_WCT-F-John_Mcenroe-Ivan_Lendl,1,F-XC,18,5,1,1,3,12,6,,,,,,,,,,
19840506-M-Forest_Hills_WCT-F-John_Mcenroe-Ivan_Lendl,1,F-DTM,15,3,0,2,1,11,4,,,,,,,,,,
19840506-M-Forest_Hills_WCT-F-John_Mcenroe-Ivan_Lendl,1,F-DTL,3,1,0,0,1,1,2,,,,,,,,,,
19840506-M-Forest_Hills_WCT-F-John_Mcenroe-Ivan_Lendl,1,F-IO,5,0,0,0,0,3,2,,,,,,,,,,
19840506-M-Forest_Hills_WCT-F-John_Mcenroe-Ivan_Lendl,1,B-XC,12,2,0,1,1,9,3,,,,,,,,,,
19840506-M-Forest_Hills_WCT-F-John_Mcenroe-Ivan_Lendl,1,B-DTM,11,0,0,0,0,5,6,,,,,,,,,,
19840506-M-Forest_Hills_WCT-F-John_Mcenroe-Ivan_Lendl,1,B-DTL,3,2,2,0,0,3,0,,,,,,,,,,
19840506-M-Forest_Hills_WCT-F-John_Mcenroe-Ivan_Lendl,1,B-IO,2,0,0,0,0,2,0,,,,,,,,,,
19840506-M-Forest_Hills_WCT-F-John_Mcenroe-Ivan_Lendl,1,S-XC,16,0,0,0,0,11,5,,,,,,,,,,
19840506-M-Forest_Hills_WCT-F-John_Mcenroe-Ivan_Lendl,1,S-DTM,16,4,0,0,4,6,10,,,,,,,,,,
19840506-M-Forest_Hills_WCT-F-John_Mcenroe-Ivan_Lendl,1,S-DTL,13,0,0,0,0,6,7,,,,,,,,,,
19840506-M-Forest_Hills_WCT-F-John_Mcenroe-Ivan_Lendl,1,S-IO,5,1,0,0,1,1,4,,,,,,,,,,
19840506-M-Forest_Hills_WCT-F-John_Mcenroe-Ivan_Lendl,2,F-XC,42,4,1,2,1,18,24,,,,,,,,,,
19840506-M-Forest_Hills_WCT-F-John_Mcenroe-Ivan_Lendl,2,F-DTM,25,5,0,3,2,9,16,,,,,,,,,,
19840506-M-Forest_Hills_WCT-F-John_Mcenroe-Ivan_Lendl,2,F-DTL,4,2,0,0,2,0,4,,,,,,,,,,
19840506-M-Forest_Hills_WCT-F-John_Mcenroe-Ivan_Lendl,2,F-IO,4,1,1,0,0,1,3,,,,,,,,,,
19840506-M-Forest_Hills_WCT-F-John_Mcenroe-Ivan_Lendl,2,F-II,1,0,0,0,0,1,0,,,,,,,,,,
19840506-M-Forest_Hills_WCT-F-John_Mcenroe-Ivan_Lendl,2,B-XC,15,4,0,1,3,7,8,,,,,,,,,,
19840506-M-Forest_Hills_WCT-F-John_Mcenroe-Ivan_Lendl,2,B-DTM,20,0,0,0,0,7,13,,,,,,,,,,
19840506-M-Forest_Hills_WCT-F-John_Mcenroe-Ivan_Lendl,2,B-DTL,15,3,1,0,2,7,8,,,,,,,,,,
19840506-M-Forest_Hills_WCT-F-John_Mcenroe-Ivan_Lendl,2,B-IO,8,0,0,0,0,3,5,,,,,,,,,,
19840506-M-Forest_Hills_WCT-F-John_Mcenroe-Ivan_Lendl,2,S-XC,4,2,0,1,1,2,2,,,,,,,,,,
19840506-M-Forest_Hills_WCT-F-John_Mcenroe-Ivan_Lendl,2,S-DTM,3,0,0,0,0,1,2,,,,,,,,,,
19840506-M-Forest_Hills_WCT-F-John_Mcenroe-Ivan_Lendl,2,S-DTL,2,1,0,0,1,0,2,,,,,,,,,,
19840506-M-Forest_Hills_WCT-F-John_Mcenroe-Ivan_Lendl,2,S-IO,1,0,0,0,0,0,1,,,,,,,,,,
19840909-M-US_Open-F-John_Mcenroe-Ivan_Lendl,1,F-XC,7,3,1,1,1,6,1,,,,,,,,,,
19840909-M-US_Open-F-John_Mcenroe-Ivan_Lendl,1,F-DTM,3,0,0,0,0,1,2,,,,,,,,,,
19840909-M-US_Open-F-John_Mcenroe-Ivan_Lendl,1,F-DTL,3,2,1,0,1,1,2,,,,,,,,,,
19840909-M-US_Open-F-John_Mcenroe-Ivan_Lendl,1,F-IO,6,4,1,2,1,5,1,,,,,,,,,,
19840909-M-US_Open-F-John_Mcenroe-Ivan_Lendl,1,F-II,1,1,1,0,0,1,0,,,,,,,,,,
19840909-M-US_Open-F-John_Mcenroe-Ivan_Lendl,1,B-XC,7,4,2,0,2,5,2,,,,,,,,,,
19840909-M-US_Open-F-John_Mcenroe-Ivan_Lendl,1,B-DTM,6,2,0,0,2,1,5,,,,,,,,,,
19840909-M-US_Open-F-John_Mcenroe-Ivan_Lendl,1,B-DTL,3,0,0,0,0,2,1,,,,,,,,,,
19840909-M-US_Open-F-John_Mcenroe-Ivan_Lendl,1,B-IO,3,1,1,0,0,2,1,,,,,,,,,,
19840909-M-US_Open-F-John_Mcenroe-Ivan_Lendl,1,S-XC,3,1,1,0,0,3,0,,,,,,,,,,
19840909-M-US_Open-F-John_Mcenroe-Ivan_Lendl,1,S-DTM,5,0,0,0,0,2,3,,,,,,,,,,
19840909-M-US_Open-F-John_Mcenroe-Ivan_Lendl,1,S-DTL,3,1,1,0,0,3,0,,,,,,,,,,
19840909-M-US_Open-F-John_Mcenroe-Ivan_Lendl,2,F-XC,18,5,1,4,0,10,8,,,,,,,,,,
19840909-M-US_Open-F-John_Mcenroe-Ivan_Lendl,2,F-DTM,7,2,0,1,1,4,3,,,,,,,,,,
19840909-M-US_Open-F-John_Mcenroe-Ivan_Lendl,2,F-IO,5,1,1,0,0,2,3,,,,,,,,,,
19840909-M-US_Open-F-John_Mcenroe-Ivan_Lendl,2,B-XC,12,6,5,1,0,8,4,,,,,,,,,,
19840909-M-US_Open-F-John_Mcenroe-Ivan_Lendl,2,B-DTM,12,2,0,0,2,3,9,,,,,,,,,,
19840909-M-US_Open-F-John_Mcenroe-Ivan_Lendl,2,B-DTL,8,3,1,0,2,2,6,,,,,,,,,,
19840909-M-US_Open-F-John_Mcenroe-Ivan_Lendl,2,B-IO,3,2,0,0,2,1,2,,,,,,,,,,
19840909-M-US_Open-F-John_Mcenroe-Ivan_Lendl,2,B-II,1,1,0,0,1,0,1,,,,,,,,,,
19840909-M-US_Open-F-John_Mcenroe-Ivan_Lendl,2,S-XC,5,0,0,0,0,1,4,,,,,,,,,,
19840909-M-US_Open-F-John_Mcenroe-Ivan_Lendl,2,S-DTM,2,0,0,0,0,0,2,,,,,,,,,,
19840909-M-US_Open-F-John_Mcenroe-Ivan_Lendl,2,S-DTL,1,0,0,0,0,1,0,,,,,,,,,,
19850707-M-Wimbledon-F-Boris_Becker-Kevin_Curren,1,F-XC,7,5,5,0,0,6,1,,,,,,,,,,
19850707-M-Wimbledon-F-Boris_Becker-Kevin_Curren,1,F-DTM,1,1,0,0,1,0,1,,,,,,,,,,
19850707-M-Wimbledon-F-Boris_Becker-Kevin_Curren,1,F-DTL,6,5,1,2,2,3,3,,,,,,,,,,
19850707-M-Wimbledon-F-Boris_Becker-Kevin_Curren,1,F-IO,2,2,1,1,0,2,0,,,,,,,,,,
19850707-M-Wimbledon-F-Boris_Becker-Kevin_Curren,1,B-XC,3,2,2,0,0,2,1,,,,,,,,,,
19850707-M-Wimbledon-F-Boris_Becker-Kevin_Curren,1,B-DTM,3,1,0,0,1,2,1,,,,,,,,,,
19850707-M-Wimbledon-F-Boris_Becker-Kevin_Curren,1,B-DTL,5,3,0,1,2,2,3,,,,,,,,,,
19850707-M-Wimbledon-F-Boris_Becker-Kevin_Curren,1,B-IO,2,0,0,0,0,1,1,,,,,,,,,,
19850707-M-Wimbledon-F-Boris_Becker-Kevin_Curren,1,S-XC,1,1,0,1,0,1,0,,,,,,,,,,
19850707-M-Wimbledon-F-Boris_Becker-Kevin_Curren,1,S-DTM,1,0,0,0,0,0,1,,,,,,,,,,
19850707-M-Wimbledon-F-Boris_Becker-Kevin_Curren,1,S-DTL,2,0,0,0,0,1,1,,,,,,,,,,
19850707-M-Wimbledon-F-Boris_Becker-Kevin_Curren,2,F-XC,6,3,1,1,1,2,4,,,,,,,,,,
19850707-M-Wimbledon-F-Boris_Becker-Kevin_Curren,2,F-DTM,5,1,1,0,0,1,4,,,,,,,,,,
19850707-M-Wimbledon-F-Boris_Becker-Kevin_Curren,2,F-DTL,3,0,0,0,0,0,3,,,,,,,,,,
19850707-M-Wimbledon-F-Boris_Becker-Kevin_Curren,2,F-IO,5,3,2,1,0,3,2,,,,,,,,,,
19850707-M-Wimbledon-F-Boris_Becker-Kevin_Curren,2,B-XC,4,2,1,1,0,2,2,,,,,,,,,,
19850707-M-Wimbledon-F-Boris_Becker-Kevin_Curren,2,B-DTM,2,1,0,0,1,0,2,,,,,,,,,,
19850707-M-Wimbledon-F-Boris_Becker-Kevin_Curren,2,B-DTL,5,5,2,0,3,2,3,,,,,,,,,,
19850707-M-Wimbledon-F-Boris_Becker-Kevin_Curren,2,B-IO,2,1,0,0,1,0,2,,,,,,,,,,
19850707-M-Wimbledon-F-Boris_Becker-Kevin_Curren,2,S-XC,2,0,0,0,0,1,1,,,,,,,,,,
19850707-M-Wimbledon-F-Boris_Becker-Kevin_Curren,2,S-DTM,3,1,1,0,0,1,2,,,,,,,,,,
19850707-M-Wimbledon-F-Boris_Becker-Kevin_Curren,2,S-DTL,1,1,0,1,0,1,0,,,,,,,,,,
19850707-M-Wimbledon-F-Boris_Becker-Kevin_Curren,2,S-IO,3,0,0,0,0,1,2,,,,,,,,,,
19850908-M-US_Open-F-John_Mcenroe-Ivan_Lendl,1,F-XC,12,2,0,0,2,4,8,,,,,,,,,,
19850908-M-US_Open-F-John_Mcenroe-Ivan_Lendl,1,F-DTM,9,2,0,0,2,0,9,,,,,,,,,,
19850908-M-US_Open-F-John_Mcenroe-Ivan_Lendl,1,F-DTL,3,2,1,1,0,3,0,,,,,,,,,,
19850908-M-US_Open-F-John_Mcenroe-Ivan_Lendl,1,F-IO,3,1,0,1,0,1,2,,,,,,,,,,
19850908-M-US_Open-F-John_Mcenroe-Ivan_Lendl,1,B-XC,3,1,1,0,0,1,2,,,,,,,,,,
19850908-M-US_Open-F-John_Mcenroe-Ivan_Lendl,1,B-DTM,5,0,0,0,0,0,5,,,,,,,,,,
19850908-M-US_Open-F-John_Mcenroe-Ivan_Lendl,1,S-XC,5,0,0,0,0,1,4,,,,,,,,,,
19850908-M-US_Open-F-John_Mcenroe-Ivan_Lendl,1,S-DTM,4,1,0,1,0,2,2,,,,,,,,,,
19850908-M-US_Open-F-John_Mcenroe-Ivan_Lendl,1,S-DTL,3,1,0,0,1,0,3,,,,,,,,,,
19850908-M-US_Open-F-John_Mcenroe-Ivan_Lendl,2,F-XC,21,14,8,6,0,19,2,,,,,,,,,,
19850908-M-US_Open-F-John_Mcenroe-Ivan_Lendl,2,F-DTM,6,2,0,1,1,4,2,,,,,,,,,,
19850908-M-US_Open-F-John_Mcenroe-Ivan_Lendl,2,F-DTL,4,1,0,0,1,2,2,,,,,,,,,,
19850908-M-US_Open-F-John_Mcenroe-Ivan_Lendl,2,F-IO,11,3,2,1,0,8,3,,,,,,,,,,
19850908-M-US_Open-F-John_Mcenroe-Ivan_Lendl,2,F-II,3,0,0,0,0,2,1,,,,,,,,,,
19850908-M-US_Open-F-John_Mcenroe-Ivan_Lendl,2,B-XC,14,6,2,1,3,7,7,,,,,,,,,,
19850908-M-US_Open-F-John_Mcenroe-Ivan_Lendl,2,B-DTM,9,1,1,0,0,6,3,,,,,,,,,,
19850908-M-US_Open-F-John_Mcenroe-Ivan_Lendl,2,B-DTL,7,5,2,2,1,6,1,,,,,,,,,,
19850908-M-US_Open-F-John_Mcenroe-Ivan_Lendl,2,B-IO,5,3,1,0,2,3,2,,,,,,,,,,
19850908-M-US_Open-F-John_Mcenroe-Ivan_Lendl,2,B-II,2,2,1,0,1,1,1,,,,,,,,,,
19850908-M-US_Open-F-John_Mcenroe-Ivan_Lendl,2,S-XC,3,1,1,0,0,1,2,,,,,,,,,,
19850908-M-US_Open-F-John_Mcenroe-Ivan_Lendl,2,S-DTL,1,0,0,0,0,1,0,,,,,,,,,,
19850908-M-US_Open-F-John_Mcenroe-Ivan_Lendl,2,S-IO,1,0,0,0,0,1,0,,,,,,,,,,
19870901-M-US_Open-QF-John_Mcenroe-Ivan_Lendl,1,F-XC,9,1,1,0,0,4,5,,,,,,,,,,
19870901-M-US_Open-QF-John_Mcenroe-Ivan_Lendl,1,F-DTM,2,2,0,1,1,1,1,,,,,,,,,,
19870901-M-US_Open-QF-John_Mcenroe-Ivan_Lendl,1,F-DTL,2,1,0,1,0,1,1,,,,,,,,,,
19870901-M-US_Open-QF-John_Mcenroe-Ivan_Lendl,1,F-IO,4,1,1,0,0,2,2,,,,,,,,,,
19870901-M-US_Open-QF-John_Mcenroe-Ivan_Lendl,1,B-XC,3,0,0,0,0,1,2,,,,,,,,,,
19870901-M-US_Open-QF-John_Mcenroe-Ivan_Lendl,1,B-DTM,4,2,0,0,2,0,4,,,,,,,,,,
19870901-M-US_Open-QF-John_Mcenroe-Ivan_Lendl,1,B-DTL,6,2,0,0,2,1,5,,,,,,,,,,
19870901-M-US_Open-QF-John_Mcenroe-Ivan_Lendl,1,B-IO,2,0,0,0,0,1,1,,,,,,,,,,
19870901-M-US_Open-QF-John_Mcenroe-Ivan_Lendl,1,S-XC,1,0,0,0,0,0,1,,,,,,,,,,
19870901-M-US_Open-QF-John_Mcenroe-Ivan_Lendl,1,S-DTM,9,0,0,0,0,5,4,,,,,,,,,,
19870901-M-US_Open-QF-John_Mcenroe-Ivan_Lendl,1,S-DTL,1,0,0,0,0,0,1,,,,,,,,,,
19870901-M-US_Open-QF-John_Mcenroe-Ivan_Lendl,1,S-IO,1,1,0,0,1,0,1,,,,,,,,,,
19870901-M-US_Open-QF-John_Mcenroe-Ivan_Lendl,2,F-XC,17,6,2,2,2,9,8,,,,,,,,,,
19870901-M-US_Open-QF-John_Mcenroe-Ivan_Lendl,2,F-DTM,4,0,0,0,0,3,1,,,,,,,,,,
19870901-M-US_Open-QF-John_Mcenroe-Ivan_Lendl,2,F-DTL,5,3,1,1,1,2,3,,,,,,,,,,
19870901-M-US_Open-QF-John_Mcenroe-Ivan_Lendl,2,F-IO,12,8,5,2,1,8,4,,,,,,,,,,
19870901-M-US_Open-QF-John_Mcenroe-Ivan_Lendl,2,F-II,2,0,0,0,0,2,0,,,,,,,,,,
19870901-M-US_Open-QF-John_Mcenroe-Ivan_Lendl,2,B-XC,12,5,1,1,3,7,5,,,,,,,,,,
19870901-M-US_Open-QF-John_Mcenroe-Ivan_Lendl,2,B-DTM,7,2,0,2,0,6,1,,,,,,,,,,
19870901-M-US_Open-QF-John_Mcenroe-Ivan_Lendl,2,B-DTL,9,5,4,0,1,8,1,,,,,,,,,,
19870901-M-US_Open-QF-John_Mcenroe-Ivan_Lendl,2,B-IO,1,1,0,1,0,1,0,,,,,,,,,,
19870901-M-US_Open-QF-John_Mcenroe-Ivan_Lendl,2,S-XC,3,1,1,0,0,1,2,,,,,,,,,,
19870901-M-US_Open-QF-John_Mcenroe-Ivan_Lendl,2,S-DTM,5,0,0,0,0,2,3,,,,,,,,,,
19870901-M-US_Open-QF-John_Mcenroe-Ivan_Lendl,2,S-DTL,2,0,0,0,0,1,1,,,,,,,,,,
19870901-M-US_Open-QF-John_Mcenroe-Ivan_Lendl,2,S-IO,1,0,0,0,0,1,0,,,,,,,,,,
19880911-M-US_Open-F-Mats_Wilander-Ivan_Lendl,1,F-XC,75,7,1,2,4,48,27,,,,,,,,,,
19880911-M-US_Open-F-Mats_Wilander-Ivan_Lendl,1,F-DTM,148,7,2,0,5,83,65,,,,,,,,,,
19880911-M-US_Open-F-Mats_Wilander-Ivan_Lendl,1,F-DTL,47,6,3,0,3,25,22,,,,,,,,,,
19880911-M-US_Open-F-Mats_Wilander-Ivan_Lendl,1,F-IO,69,3,1,1,1,41,28,,,,,,,,,,
19880911-M-US_Open-F-Mats_Wilander-Ivan_Lendl,1,F-II,3,0,0,0,0,2,1,,,,,,,,,,
19880911-M-US_Open-F-Mats_Wilander-Ivan_Lendl,1,B-XC,50,3,0,1,2,29,21,,,,,,,,,,
19880911-M-US_Open-F-Mats_Wilander-Ivan_Lendl,1,B-DTM,42,1,0,0,1,24,18,,,,,,,,,,
19880911-M-US_Open-F-Mats_Wilander-Ivan_Lendl,1,B-DTL,19,3,0,0,3,5,14,,,,,,,,,,
19880911-M-US_Open-F-Mats_Wilander-Ivan_Lendl,1,B-IO,16,4,1,1,2,7,9,,,,,,,,,,
19880911-M-US_Open-F-Mats_Wilander-Ivan_Lendl,1,S-XC,246,2,0,0,2,146,100,,,,,,,,,,
19880911-M-US_Open-F-Mats_Wilander-Ivan_Lendl,1,S-DTM,88,4,0,0,4,52,36,,,,,,,,,,
19880911-M-US_Open-F-Mats_Wilander-Ivan_Lendl,1,S-DTL,34,2,0,1,1,16,18,,,,,,,,,,
19880911-M-US_Open-F-Mats_Wilander-Ivan_Lendl,1,S-IO,10,0,0,0,0,9,1,,,,,,,,,,
19880911-M-US_Open-F-Mats_Wilander-Ivan_Lendl,1,S-II,2,0,0,0,0,1,1,,,,,,,,,,
19880911-M-US_Open-F-Mats_Wilander-Ivan_Lendl,2,F-XC,115,28,12,5,11,57,58,,,,,,,,,,
19880911-M-US_Open-F-Mats_Wilander-Ivan_Lendl,2,F-DTM,105,5,1,0,4,41,64,,,,,,,,,,
19880911-M-US_Open-F-Mats_Wilander-Ivan_Lendl,2,F-DTL,42,6,0,2,4,21,21,,,,,,,,,,
19880911-M-US_Open-F-Mats_Wilander-Ivan_Lendl,2,F-IO,130,25,5,7,13,65,65,,,,,,,,,,
19880911-M-US_Open-F-Mats_Wilander-Ivan_Lendl,2,F-II,23,5,0,1,4,6,17,,,,,,,,,,
19880911-M-US_Open-F-Mats_Wilander-Ivan_Lendl,2,B-XC,126,14,5,1,8,56,70,,,,,,,,,,
19880911-M-US_Open-F-Mats_Wilander-Ivan_Lendl,2,B-DTM,108,8,1,2,5,51,57,,,,,,,,,,
19880911-M-US_Open-F-Mats_Wilander-Ivan_Lendl,2,B-DTL,39,24,12,2,10,21,18,,,,,,,,,,
19880911-M-US_Open-F-Mats_Wilander-Ivan_Lendl,2,B-IO,11,3,3,0,0,7,4,,,,,,,,,,
19880911-M-US_Open-F-Mats_Wilander-Ivan_Lendl,2,S-XC,109,4,1,0,3,41,68,,,,,,,,,,
19880911-M-US_Open-F-Mats_Wilander-Ivan_Lendl,2,S-DTM,75,6,1,0,5,21,54,,,,,,,,,,
19880911-M-US_Open-F-Mats_Wilander-Ivan_Lendl,2,S-DTL,22,3,2,0,1,8,14,,,,,,,,,,
19880911-M-US_Open-F-Mats_Wilander-Ivan_Lendl,2,S-IO,8,1,0,0,1,2,6,,,,,,,,,,
19890709-M-Wimbledon-F-Boris_Becker-Stefan_Edberg,1,F-XC,6,3,3,0,0,5,1,,,,,,,,,,
19890709-M-Wimbledon-F-Boris_Becker-Stefan_Edberg,1,F-DTM,1,1,0,0,1,0,1,,,,,,,,,,
19890709-M-Wimbledon-F-Boris_Becker-Stefan_Edberg,1,F-DTL,2,1,1,0,0,1,1,,,,,,,,,,
19890709-M-Wimbledon-F-Boris_Becker-Stefan_Edberg,1,F-IO,1,1,1,0,0,1,0,,,,,,,,,,
19890709-M-Wimbledon-F-Boris_Becker-Stefan_Edberg,1,B-XC,6,5,3,1,1,5,1,,,,,,,,,,
19890709-M-Wimbledon-F-Boris_Becker-Stefan_Edberg,1,B-DTM,3,0,0,0,0,1,2,,,,,,,,,,
19890709-M-Wimbledon-F-Boris_Becker-Stefan_Edberg,1,B-DTL,7,3,2,1,0,4,3,,,,,,,,,,
19890709-M-Wimbledon-F-Boris_Becker-Stefan_Edberg,1,B-IO,2,2,1,0,1,1,1,,,,,,,,,,
19890709-M-Wimbledon-F-Boris_Becker-Stefan_Edberg,1,S-XC,1,1,0,1,0,1,0,,,,,,,,,,
19890709-M-Wimbledon-F-Boris_Becker-Stefan_Edberg,2,F-XC,1,1,1,0,0,1,0,,,,,,,,,,
19890709-M-Wimbledon-F-Boris_Becker-Stefan_Edberg,2,F-DTM,1,0,0,0,0,0,1,,,,,,,,,,
19890709-M-Wimbledon-F-Boris_Becker-Stefan_Edberg,2,F-DTL,2,0,0,0,0,0,2,,,,,,,,,,
19890709-M-Wimbledon-F-Boris_Becker-Stefan_Edberg,2,F-IO,2,0,0,0,0,1,1,,,,,,,,,,
19890709-M-Wimbledon-F-Boris_Becker-Stefan_Edberg,2,B-XC,2,0,0,0,0,0,2,,,,,,,,,,
19890709-M-Wimbledon-F-Boris_Becker-Stefan_Edberg,2,B-DTM,2,0,0,0,0,0,2,,,,,,,,,,
19890709-M-Wimbledon-F-Boris_Becker-Stefan_Edberg,2,B-DTL,3,2,1,1,0,2,1,,,,,,,,,,
19890709-M-Wimbledon-F-Boris_Becker-Stefan_Edberg,2,B-IO,3,2,1,0,1,2,1,,,,,,,,,,
19890709-M-Wimbledon-F-Boris_Becker-Stefan_Edberg,2,S-XC,3,2,0,1,1,2,1,,,,,,,,,,
19890709-M-Wimbledon-F-Boris_Becker-Stefan_Edberg,2,S-DTM,2,0,0,0,0,0,2,,,,,,,,,,
19890709-M-Wimbledon-F-Boris_Becker-Stefan_Edberg,2,S-DTL,1,1,1,0,0,1,0,,,,,,,,,,
19890910-M-US_Open-F-Boris_Becker-Ivan_Lendl,1,F-XC,22,6,1,4,1,15,7,,,,,,,,,,
19890910-M-US_Open-F-Boris_Becker-Ivan_Lendl,1,F-DTM,29,3,0,0,3,15,14,,,,,,,,,,
19890910-M-US_Open-F-Boris_Becker-Ivan_Lendl,1,F-DTL,8,0,0,0,0,5,3,,,,,,,,,,
19890910-M-US_Open-F-Boris_Becker-Ivan_Lendl,1,F-IO,44,12,1,3,8,22,22,,,,,,,,,,
19890910-M-US_Open-F-Boris_Becker-Ivan_Lendl,1,F-II,2,2,0,1,1,1,1,,,,,,,,,,
19890910-M-US_Open-F-Boris_Becker-Ivan_Lendl,1,B-XC,22,5,0,0,5,5,17,,,,,,,,,,
19890910-M-US_Open-F-Boris_Becker-Ivan_Lendl,1,B-DTM,26,4,0,0,4,16,10,,,,,,,,,,
19890910-M-US_Open-F-Boris_Becker-Ivan_Lendl,1,B-DTL,13,6,1,0,5,6,7,,,,,,,,,,
19890910-M-US_Open-F-Boris_Becker-Ivan_Lendl,1,B-IO,1,1,1,0,0,1,0,,,,,,,,,,
19890910-M-US_Open-F-Boris_Becker-Ivan_Lendl,1,S-XC,57,2,0,1,1,32,25,,,,,,,,,,
19890910-M-US_Open-F-Boris_Becker-Ivan_Lendl,1,S-DTM,26,4,0,0,4,13,13,,,,,,,,,,
19890910-M-US_Open-F-Boris_Becker-Ivan_Lendl,1,S-DTL,8,3,0,1,2,3,5,,,,,,,,,,
19890910-M-US_Open-F-Boris_Becker-Ivan_Lendl,1,S-IO,3,3,0,2,1,2,1,,,,,,,,,,
19890910-M-US_Open-F-Boris_Becker-Ivan_Lendl,2,F-XC,35,14,6,2,6,17,18,,,,,,,,,,
19890910-M-US_Open-F-Boris_Becker-Ivan_Lendl,2,F-DTM,33,5,0,2,3,16,17,,,,,,,,,,
19890910-M-US_Open-F-Boris_Becker-Ivan_Lendl,2,F-DTL,13,4,4,0,0,4,9,,,,,,,,,,
19890910-M-US_Open-F-Boris_Becker-Ivan_Lendl,2,F-IO,53,10,4,1,5,28,25,,,,,,,,,,
19890910-M-US_Open-F-Boris_Becker-Ivan_Lendl,2,F-II,6,4,2,2,0,4,2,,,,,,,,,,
19890910-M-US_Open-F-Boris_Becker-Ivan_Lendl,2,B-XC,45,6,2,0,4,25,20,,,,,,,,,,
19890910-M-US_Open-F-Boris_Becker-Ivan_Lendl,2,B-DTM,23,1,0,0,1,9,14,,,,,,,,,,
19890910-M-US_Open-F-Boris_Becker-Ivan_Lendl,2,B-DTL,11,9,3,1,5,4,7,,,,,,,,,,
19890910-M-US_Open-F-Boris_Becker-Ivan_Lendl,2,B-IO,2,0,0,0,0,1,1,,,,,,,,,,
19890910-M-US_Open-F-Boris_Becker-Ivan_Lendl,2,S-XC,57,3,1,1,1,30,27,,,,,,,,,,
19890910-M-US_Open-F-Boris_Becker-Ivan_Lendl,2,S-DTM,36,4,0,0,4,12,24,,,,,,,,,,
19890910-M-US_Open-F-Boris_Becker-Ivan_Lendl,2,S-DTL,7,2,1,0,1,4,3,,,,,,,,,,
19890910-M-US_Open-F-Boris_Becker-Ivan_Lendl,2,S-IO,1,0,0,0,0,1,0,,,,,,,,,,
19900128-M-Australian_Open-F-Ivan_Lendl-Stefan_Edberg,1,F-XC,47,11,7,3,1,24,23,,,,,,,,,,
19900128-M-Australian_Open-F-Ivan_Lendl-Stefan_Edberg,1,F-DTM,38,0,0,0,0,17,21,,,,,,,,,,
19900128-M-Australian_Open-F-Ivan_Lendl-Stefan_Edberg,1,F-DTL,21,5,2,2,1,12,9,,,,,,,,,,
19900128-M-Australian_Open-F-Ivan_Lendl-Stefan_Edberg,1,F-IO,47,9,3,2,4,28,19,,,,,,,,,,
19900128-M-Australian_Open-F-Ivan_Lendl-Stefan_Edberg,1,F-II,10,4,3,0,1,9,1,,,,,,,,,,
19900128-M-Australian_Open-F-Ivan_Lendl-Stefan_Edberg,1,B-XC,49,6,2,1,3,23,26,,,,,,,,,,
19900128-M-Australian_Open-F-Ivan_Lendl-Stefan_Edberg,1,B-DTM,55,2,0,0,2,21,34,,,,,,,,,,
19900128-M-Australian_Open-F-Ivan_Lendl-Stefan_Edberg,1,B-DTL,15,8,4,1,3,8,7,,,,,,,,,,
19900128-M-Australian_Open-F-Ivan_Lendl-Stefan_Edberg,1,B-IO,8,0,0,0,0,4,4,,,,,,,,,,
19900128-M-Australian_Open-F-Ivan_Lendl-Stefan_Edberg,1,S-XC,34,4,1,0,3,18,16,,,,,,,,,,
19900128-M-Australian_Open-F-Ivan_Lendl-Stefan_Edberg,1,S-DTM,31,1,0,0,1,11,20,,,,,,,,,,
19900128-M-Australian_Open-F-Ivan_Lendl-Stefan_Edberg,1,S-DTL,11,1,0,0,1,7,4,,,,,,,,,,
19900128-M-Australian_Open-F-Ivan_Lendl-Stefan_Edberg,1,S-IO,4,1,0,0,1,2,2,,,,,,,,,,
19900128-M-Australian_Open-F-Ivan_Lendl-Stefan_Edberg,2,F-XC,51,6,0,1,5,24,27,,,,,,,,,,
19900128-M-Australian_Open-F-Ivan_Lendl-Stefan_Edberg,2,F-DTM,46,0,0,0,0,23,23,,,,,,,,,,
19900128-M-Australian_Open-F-Ivan_Lendl-Stefan_Edberg,2,F-DTL,18,3,0,1,2,9,9,,,,,,,,,,
19900128-M-Australian_Open-F-Ivan_Lendl-Stefan_Edberg,2,F-IO,35,3,2,0,1,21,14,,,,,,,,,,
19900128-M-Australian_Open-F-Ivan_Lendl-Stefan_Edberg,2,F-II,2,0,0,0,0,0,2,,,,,,,,,,
19900128-M-Australian_Open-F-Ivan_Lendl-Stefan_Edberg,2,B-XC,75,7,0,3,4,42,33,,,,,,,,,,
19900128-M-Australian_Open-F-Ivan_Lendl-Stefan_Edberg,2,B-DTM,35,4,0,1,3,19,16,,,,,,,,,,
19900128-M-Australian_Open-F-Ivan_Lendl-Stefan_Edberg,2,B-DTL,7,2,0,1,1,3,4,,,,,,,,,,
19900128-M-Australian_Open-F-Ivan_Lendl-Stefan_Edberg,2,B-IO,6,2,1,0,1,3,3,,,,,,,,,,
19900128-M-Australian_Open-F-Ivan_Lendl-Stefan_Edberg,2,B-II,1,0,0,0,0,0,1,,,,,,,,,,
19900128-M-Australian_Open-F-Ivan_Lendl-Stefan_Edberg,2,S-XC,39,5,0,1,4,18,21,,,,,,,,,,
19900128-M-Australian_Open-F-Ivan_Lendl-Stefan_Edberg,2,S-DTM,10,1,0,0,1,3,7,,,,,,,,,,
19900128-M-Australian_Open-F-Ivan_Lendl-Stefan_Edberg,2,S-DTL,1,0,0,0,0,0,1,,,,,,,,,,
19900128-M-Australian_Open-F-Ivan_Lendl-Stefan_Edberg,2,S-IO,1,0,0,0,0,1,0,,,,,,,,,,
19900611-M-Queens_Club-F-Boris_Becker-Ivan_Lendl,1,F-XC,1,1,1,0,0,1,0,,,,,,,,,,
19900611-M-Queens_Club-F-Boris_Becker-Ivan_Lendl,1,F-DTM,2,1,0,1,0,1,1,,,,,,,,,,
19900611-M-Queens_Club-F-Boris_Becker-Ivan_Lendl,1,F-DTL,1,0,0,0,0,1,0,,,,,,,,,,
19900611-M-Queens_Club-F-Boris_Becker-Ivan_Lendl,1,F-IO,1,1,1,0,0,1,0,,,,,,,,,,
19900611-M-Queens_Club-F-Boris_Becker-Ivan_Lendl,1,B-XC,3,1,0,0,1,0,3,,,,,,,,,,
19900611-M-Queens_Club-F-Boris_Becker-Ivan_Lendl,1,B-DTM,1,1,0,1,0,1,0,,,,,,,,,,
19900611-M-Queens_Club-F-Boris_Becker-Ivan_Lendl,1,B-DTL,5,3,2,1,0,5,0,,,,,,,,,,
19900611-M-Queens_Club-F-Boris_Becker-Ivan_Lendl,1,B-IO,1,1,0,0,1,0,1,,,,,,,,,,
19900611-M-Queens_Club-F-Boris_Becker-Ivan_Lendl,2,F-DTL,1,1,1,0,0,1,0,,,,,,,,,,
19900611-M-Queens_Club-F-Boris_Becker-Ivan_Lendl,2,F-IO,1,1,0,0,1,0,1,,,,,,,,,,
19900611-M-Queens_Club-F-Boris_Becker-Ivan_Lendl,2,B-XC,2,1,1,0,0,1,1,,,,,,,,,,
19900611-M-Queens_Club-F-Boris_Becker-Ivan_Lendl,2,B-DTM,3,3,0,2,1,2,1,,,,,,,,,,
19900611-M-Queens_Club-F-Boris_Becker-Ivan_Lendl,2,S-DTL,1,0,0,0,0,0,1,,,,,,,,,,
19900909-M-US_Open-F-Andre_Agassi-Pete_Sampras,1,F-XC,33,11,0,4,7,12,21,,,,,,,,,,
19900909-M-US_Open-F-Andre_Agassi-Pete_Sampras,1,F-DTM,34,5,0,0,5,13,21,,,,,,,,,,
19900909-M-US_Open-F-Andre_Agassi-Pete_Sampras,1,F-DTL,8,3,2,0,1,2,6,,,,,,,,,,
19900909-M-US_Open-F-Andre_Agassi-Pete_Sampras,1,F-IO,27,5,1,0,4,14,13,,,,,,,,,,
19900909-M-US_Open-F-Andre_Agassi-Pete_Sampras,1,F-II,4,2,0,1,1,2,2,,,,,,,,,,
19900909-M-US_Open-F-Andre_Agassi-Pete_Sampras,1,B-XC,42,5,1,2,2,20,22,,,,,,,,,,
19900909-M-US_Open-F-Andre_Agassi-Pete_Sampras,1,B-DTM,21,3,0,2,1,11,10,,,,,,,,,,
19900909-M-US_Open-F-Andre_Agassi-Pete_Sampras,1,B-DTL,20,10,1,6,3,13,7,,,,,,,,,,
19900909-M-US_Open-F-Andre_Agassi-Pete_Sampras,1,B-IO,7,4,1,0,3,2,5,,,,,,,,,,
19900909-M-US_Open-F-Andre_Agassi-Pete_Sampras,1,S-XC,3,1,0,0,1,0,3,,,,,,,,,,
19900909-M-US_Open-F-Andre_Agassi-Pete_Sampras,1,S-DTM,1,0,0,0,0,0,1,,,,,,,,,,
19900909-M-US_Open-F-Andre_Agassi-Pete_Sampras,1,S-DTL,2,1,1,0,0,1,1,,,,,,,,,,
19900909-M-US_Open-F-Andre_Agassi-Pete_Sampras,2,F-XC,21,5,1,1,3,14,7,,,,,,,,,,
19900909-M-US_Open-F-Andre_Agassi-Pete_Sampras,2,F-DTM,13,2,0,1,1,5,8,,,,,,,,,,
19900909-M-US_Open-F-Andre_Agassi-Pete_Sampras,2,F-DTL,11,3,1,1,1,6,5,,,,,,,,,,
19900909-M-US_Open-F-Andre_Agassi-Pete_Sampras,2,F-IO,19,9,2,4,3,11,8,,,,,,,,,,
19900909-M-US_Open-F-Andre_Agassi-Pete_Sampras,2,F-II,1,1,1,0,0,1,0,,,,,,,,,,
19900909-M-US_Open-F-Andre_Agassi-Pete_Sampras,2,B-XC,18,3,1,0,2,8,10,,,,,,,,,,
19900909-M-US_Open-F-Andre_Agassi-Pete_Sampras,2,B-DTM,27,1,0,0,1,17,10,,,,,,,,,,
19900909-M-US_Open-F-Andre_Agassi-Pete_Sampras,2,B-DTL,13,5,2,0,3,7,6,,,,,,,,,,
19900909-M-US_Open-F-Andre_Agassi-Pete_Sampras,2,B-IO,3,2,0,0,2,0,3,,,,,,,,,,
19900909-M-US_Open-F-Andre_Agassi-Pete_Sampras,2,S-XC,9,0,0,0,0,3,6,,,,,,,,,,
19900909-M-US_Open-F-Andre_Agassi-Pete_Sampras,2,S-DTM,8,3,0,0,3,3,5,,,,,,,,,,
19900909-M-US_Open-F-Andre_Agassi-Pete_Sampras,2,S-DTL,3,3,0,1,2,1,2,,,,,,,,,,
19900909-M-US_Open-F-Andre_Agassi-Pete_Sampras,2,S-IO,4,1,0,0,1,2,2,,,,,,,,,,
19910127-M-Australian_Open-F-Ivan_Lendl-Boris_Becker,1,F-XC,34,8,2,3,3,16,18,,,,,,,,,,
19910127-M-Australian_Open-F-Ivan_Lendl-Boris_Becker,1,F-DTM,30,1,0,1,0,14,16,,,,,,,,,,
19910127-M-Australian_Open-F-Ivan_Lendl-Boris_Becker,1,F-DTL,16,6,4,0,2,9,7,,,,,,,,,,
19910127-M-Australian_Open-F-Ivan_Lendl-Boris_Becker,1,F-IO,28,6,2,2,2,16,12,,,,,,,,,,
19910127-M-Australian_Open-F-Ivan_Lendl-Boris_Becker,1,F-II,7,3,1,1,1,3,4,,,,,,,,,,
19910127-M-Australian_Open-F-Ivan_Lendl-Boris_Becker,1,B-XC,34,9,3,2,4,16,18,,,,,,,,,,
19910127-M-Australian_Open-F-Ivan_Lendl-Boris_Becker,1,B-DTM,28,4,1,2,1,9,19,,,,,,,,,,
19910127-M-Australian_Open-F-Ivan_Lendl-Boris_Becker,1,B-DTL,15,8,6,0,2,9,6,,,,,,,,,,
19910127-M-Australian_Open-F-Ivan_Lendl-Boris_Becker,1,B-IO,5,1,1,0,0,1,4,,,,,,,,,,
19910127-M-Australian_Open-F-Ivan_Lendl-Boris_Becker,1,S-XC,27,1,0,0,1,18,9,,,,,,,,,,
19910127-M-Australian_Open-F-Ivan_Lendl-Boris_Becker,1,S-DTM,12,0,0,0,0,3,9,,,,,,,,,,
19910127-M-Australian_Open-F-Ivan_Lendl-Boris_Becker,1,S-DTL,7,2,0,1,1,3,4,,,,,,,,,,
19910127-M-Australian_Open-F-Ivan_Lendl-Boris_Becker,1,S-IO,3,0,0,0,0,1,2,,,,,,,,,,
19910127-M-Australian_Open-F-Ivan_Lendl-Boris_Becker,2,F-XC,45,9,1,7,1,30,15,,,,,,,,,,
19910127-M-Australian_Open-F-Ivan_Lendl-Boris_Becker,2,F-DTM,31,3,0,1,2,15,16,,,,,,,,,,
19910127-M-Australian_Open-F-Ivan_Lendl-Boris_Becker,2,F-DTL,16,5,2,1,2,10,6,,,,,,,,,,
19910127-M-Australian_Open-F-Ivan_Lendl-Boris_Becker,2,F-IO,25,7,2,1,4,12,13,,,,,,,,,,
19910127-M-Australian_Open-F-Ivan_Lendl-Boris_Becker,2,F-II,1,0,0,0,0,1,0,,,,,,,,,,
19910127-M-Australian_Open-F-Ivan_Lendl-Boris_Becker,2,B-XC,24,6,1,2,3,13,11,,,,,,,,,,
19910127-M-Australian_Open-F-Ivan_Lendl-Boris_Becker,2,B-DTM,13,1,0,1,0,7,6,,,,,,,,,,
19910127-M-Australian_Open-F-Ivan_Lendl-Boris_Becker,2,B-DTL,14,10,4,1,5,7,7,,,,,,,,,,
19910127-M-Australian_Open-F-Ivan_Lendl-Boris_Becker,2,B-IO,5,3,0,0,3,0,5,,,,,,,,,,
19910127-M-Australian_Open-F-Ivan_Lendl-Boris_Becker,2,S-XC,36,3,0,1,2,17,19,,,,,,,,,,
19910127-M-Australian_Open-F-Ivan_Lendl-Boris_Becker,2,S-DTM,12,1,0,0,1,6,6,,,,,,,,,,
19910127-M-Australian_Open-F-Ivan_Lendl-Boris_Becker,2,S-DTL,16,4,1,2,1,9,7,,,,,,,,,,
19910127-M-Australian_Open-F-Ivan_Lendl-Boris_Becker,2,S-IO,1,0,0,0,0,1,0,,,,,,,,,,
19910908-M-US_Open-F-Jim_Courier-Stefan_Edberg,1,F-XC,24,12,6,2,4,12,12,,,,,,,,,,
19910908-M-US_Open-F-Jim_Courier-Stefan_Edberg,1,F-DTM,27,3,0,1,2,10,17,,,,,,,,,,
19910908-M-US_Open-F-Jim_Courier-Stefan_Edberg,1,F-DTL,5,2,0,1,1,2,3,,,,,,,,,,
19910908-M-US_Open-F-Jim_Courier-Stefan_Edberg,1,F-IO,15,7,2,2,3,7,8,,,,,,,,,,
19910908-M-US_Open-F-Jim_Courier-Stefan_Edberg,1,F-II,6,2,0,0,2,2,4,,,,,,,,,,
19910908-M-US_Open-F-Jim_Courier-Stefan_Edberg,1,B-XC,16,4,0,1,3,7,9,,,,,,,,,,
19910908-M-US_Open-F-Jim_Courier-Stefan_Edberg,1,B-DTM,12,1,0,0,1,2,10,,,,,,,,,,
19910908-M-US_Open-F-Jim_Courier-Stefan_Edberg,1,B-DTL,6,2,0,2,0,4,2,,,,,,,,,,
19910908-M-US_Open-F-Jim_Courier-Stefan_Edberg,1,B-IO,5,4,0,2,2,2,3,,,,,,,,,,
19910908-M-US_Open-F-Jim_Courier-Stefan_Edberg,1,S-XC,5,1,1,0,0,1,4,,,,,,,,,,
19910908-M-US_Open-F-Jim_Courier-Stefan_Edberg,1,S-DTM,5,0,0,0,0,1,4,,,,,,,,,,
19910908-M-US_Open-F-Jim_Courier-Stefan_Edberg,1,S-DTL,6,0,0,0,0,1,5,,,,,,,,,,
19910908-M-US_Open-F-Jim_Courier-Stefan_Edberg,1,S-IO,2,0,0,0,0,0,2,,,,,,,,,,
19910908-M-US_Open-F-Jim_Courier-Stefan_Edberg,2,F-XC,16,7,2,2,3,10,6,,,,,,,,,,
19910908-M-US_Open-F-Jim_Courier-Stefan_Edberg,2,F-DTM,13,0,0,0,0,6,7,,,,,,,,,,
19910908-M-US_Open-F-Jim_Courier-Stefan_Edberg,2,F-DTL,6,2,0,2,0,5,1,,,,,,,,,,
19910908-M-US_Open-F-Jim_Courier-Stefan_Edberg,2,F-IO,6,2,0,2,0,4,2,,,,,,,,,,
19910908-M-US_Open-F-Jim_Courier-Stefan_Edberg,2,B-XC,4,4,1,0,3,1,3,,,,,,,,,,
19910908-M-US_Open-F-Jim_Courier-Stefan_Edberg,2,B-DTM,7,2,0,0,2,2,5,,,,,,,,,,
19910908-M-US_Open-F-Jim_Courier-Stefan_Edberg,2,B-DTL,1,0,0,0,0,1,0,,,,,,,,,,
19910908-M-US_Open-F-Jim_Courier-Stefan_Edberg,2,S-XC,14,0,0,0,0,11,3,,,,,,,,,,
19910908-M-US_Open-F-Jim_Courier-Stefan_Edberg,2,S-DTM,6,1,0,1,0,6,0,,,,,,,,,,
19910908-M-US_Open-F-Jim_Courier-Stefan_Edberg,2,S-DTL,4,2,1,0,1,3,1,,,,,,,,,,
19910908-M-US_Open-F-Jim_Courier-Stefan_Edberg,2,S-IO,2,0,0,0,0,1,1,,,,,,,,,,
19920126-M-Australian_Open-F-Jim_Courier-Stefan_Edberg,1,F-XC,36,14,8,4,2,24,12,,,,,,,,,,
19920126-M-Australian_Open-F-Jim_Courier-Stefan_Edberg,1,F-DTM,22,3,0,1,2,10,12,,,,,,,,,,
19920126-M-Australian_Open-F-Jim_Courier-Stefan_Edberg,1,F-DTL,11,4,1,0,3,6,5,,,,,,,,,,
19920126-M-Australian_Open-F-Jim_Courier-Stefan_Edberg,1,F-IO,35,8,3,3,2,22,13,,,,,,,,,,
19920126-M-Australian_Open-F-Jim_Courier-Stefan_Edberg,1,F-II,6,1,0,1,0,4,2,,,,,,,,,,
19920126-M-Australian_Open-F-Jim_Courier-Stefan_Edberg,1,B-XC,33,7,2,5,0,17,16,,,,,,,,,,
19920126-M-Australian_Open-F-Jim_Courier-Stefan_Edberg,1,B-DTM,26,2,1,0,1,11,15,,,,,,,,,,
19920126-M-Australian_Open-F-Jim_Courier-Stefan_Edberg,1,B-DTL,16,8,8,0,0,9,7,,,,,,,,,,
19920126-M-Australian_Open-F-Jim_Courier-Stefan_Edberg,1,B-IO,1,1,0,1,0,1,0,,,,,,,,,,
19920126-M-Australian_Open-F-Jim_Courier-Stefan_Edberg,1,S-XC,10,0,0,0,0,5,5,,,,,,,,,,
19920126-M-Australian_Open-F-Jim_Courier-Stefan_Edberg,1,S-DTL,5,1,1,0,0,4,1,,,,,,,,,,
19920126-M-Australian_Open-F-Jim_Courier-Stefan_Edberg,1,S-IO,1,0,0,0,0,0,1,,,,,,,,,,
19920126-M-Australian_Open-F-Jim_Courier-Stefan_Edberg,2,F-XC,23,4,0,1,3,11,12,,,,,,,,,,
19920126-M-Australian_Open-F-Jim_Courier-Stefan_Edberg,2,F-DTM,7,0,0,0,0,3,4,,,,,,,,,,
19920126-M-Australian_Open-F-Jim_Courier-Stefan_Edberg,2,F-DTL,12,4,2,1,1,6,6,,,,,,,,,,
19920126-M-Australian_Open-F-Jim_Courier-Stefan_Edberg,2,F-IO,2,0,0,0,0,1,1,,,,,,,,,,
19920126-M-Australian_Open-F-Jim_Courier-Stefan_Edberg,2,B-XC,41,3,0,2,1,24,17,,,,,,,,,,
19920126-M-Australian_Open-F-Jim_Courier-Stefan_Edberg,2,B-DTM,8,0,0,0,0,5,3,,,,,,,,,,
19920126-M-Australian_Open-F-Jim_Courier-Stefan_Edberg,2,B-DTL,7,5,1,2,2,3,4,,,,,,,,,,
19920126-M-Australian_Open-F-Jim_Courier-Stefan_Edberg,2,B-IO,3,3,0,2,1,2,1,,,,,,,,,,
19920126-M-Australian_Open-F-Jim_Courier-Stefan_Edberg,2,S-XC,18,2,0,2,0,9,9,,,,,,,,,,
19920126-M-Australian_Open-F-Jim_Courier-Stefan_Edberg,2,S-DTM,7,0,0,0,0,3,4,,,,,,,,,,
19920126-M-Australian_Open-F-Jim_Courier-Stefan_Edberg,2,S-DTL,4,1,0,0,1,0,4,,,,,,,,,,
19920126-M-Australian_Open-F-Jim_Courier-Stefan_Edberg,2,S-IO,2,0,0,0,0,0,2,,,,,,,,,,
19920704-M-Wimbledon-SF-John_Mcenroe-Andre_Agassi,1,F-XC,9,2,0,1,1,3,6,,,,,,,,,,
19920704-M-Wimbledon-SF-John_Mcenroe-Andre_Agassi,1,F-DTM,6,0,0,0,0,2,4,,,,,,,,,,
19920704-M-Wimbledon-SF-John_Mcenroe-Andre_Agassi,1,F-DTL,1,0,0,0,0,1,0,,,,,,,,,,
19920704-M-Wimbledon-SF-John_Mcenroe-Andre_Agassi,1,F-IO,2,0,0,0,0,1,1,,,,,,,,,,
19920704-M-Wimbledon-SF-John_Mcenroe-Andre_Agassi,1,B-XC,1,0,0,0,0,0,1,,,,,,,,,,
19920704-M-Wimbledon-SF-John_Mcenroe-Andre_Agassi,1,B-DTM,5,1,0,0,1,2,3,,,,,,,,,,
19920704-M-Wimbledon-SF-John_Mcenroe-Andre_Agassi,1,B-DTL,2,0,0,0,0,1,1,,,,,,,,,,
19920704-M-Wimbledon-SF-John_Mcenroe-Andre_Agassi,1,B-IO,1,1,1,0,0,1,0,,,,,,,,,,
19920704-M-Wimbledon-SF-John_Mcenroe-Andre_Agassi,1,S-XC,6,1,0,0,1,1,5,,,,,,,,,,
19920704-M-Wimbledon-SF-John_Mcenroe-Andre_Agassi,1,S-DTM,4,0,0,0,0,1,3,,,,,,,,,,
19920704-M-Wimbledon-SF-John_Mcenroe-Andre_Agassi,1,S-DTL,6,0,0,0,0,2,4,,,,,,,,,,
19920704-M-Wimbledon-SF-John_Mcenroe-Andre_Agassi,1,S-IO,2,0,0,0,0,2,0,,,,,,,,,,
19920704-M-Wimbledon-SF-John_Mcenroe-Andre_Agassi,2,F-XC,22,10,7,2,1,16,6,,,,,,,,,,
19920704-M-Wimbledon-SF-John_Mcenroe-Andre_Agassi,2,F-DTM,11,2,0,1,1,5,6,,,,,,,,,,
19920704-M-Wimbledon-SF-John_Mcenroe-Andre_Agassi,2,F-DTL,8,5,4,0,1,7,1,,,,,,,,,,
19920704-M-Wimbledon-SF-John_Mcenroe-Andre_Agassi,2,F-IO,8,3,1,2,0,6,2,,,,,,,,,,
19920704-M-Wimbledon-SF-John_Mcenroe-Andre_Agassi,2,F-II,1,0,0,0,0,1,0,,,,,,,,,,
19920704-M-Wimbledon-SF-John_Mcenroe-Andre_Agassi,2,B-XC,22,8,7,0,1,15,7,,,,,,,,,,
19920704-M-Wimbledon-SF-John_Mcenroe-Andre_Agassi,2,B-DTM,10,2,0,0,2,3,7,,,,,,,,,,
19920704-M-Wimbledon-SF-John_Mcenroe-Andre_Agassi,2,B-DTL,13,5,2,3,0,9,4,,,,,,,,,,
19920704-M-Wimbledon-SF-John_Mcenroe-Andre_Agassi,2,B-IO,6,3,2,0,1,4,2,,,,,,,,,,
19920704-M-Wimbledon-SF-John_Mcenroe-Andre_Agassi,2,S-DTM,2,2,1,0,1,1,1,,,,,,,,,,
19920704-M-Wimbledon-SF-John_Mcenroe-Andre_Agassi,2,S-DTL,2,1,0,0,1,0,2,,,,,,,,,,
19920704-M-Wimbledon-SF-John_Mcenroe-Andre_Agassi,2,S-IO,2,0,0,0,0,2,0,,,,,,,,,,
19920705-M-Wimbledon-F-Andre_Agassi-Goran_Ivanisevic,1,F-XC,46,6,1,5,0,34,12,,,,,,,,,,
19920705-M-Wimbledon-F-Andre_Agassi-Goran_Ivanisevic,1,F-DTM,27,2,1,1,0,17,10,,,,,,,,,,
19920705-M-Wimbledon-F-Andre_Agassi-Goran_Ivanisevic,1,F-DTL,3,0,0,0,0,2,1,,,,,,,,,,
19920705-M-Wimbledon-F-Andre_Agassi-Goran_Ivanisevic,1,F-IO,12,8,3,2,2,7,5,,,,,,,,,,
19920705-M-Wimbledon-F-Andre_Agassi-Goran_Ivanisevic,1,F-II,2,0,0,0,0,1,1,,,,,,,,,,
19920705-M-Wimbledon-F-Andre_Agassi-Goran_Ivanisevic,1,B-XC,26,11,7,2,2,18,8,,,,,,,,,,
19920705-M-Wimbledon-F-Andre_Agassi-Goran_Ivanisevic,1,B-DTM,35,0,0,0,0,24,11,,,,,,,,,,
19920705-M-Wimbledon-F-Andre_Agassi-Goran_Ivanisevic,1,B-DTL,15,6,4,0,2,7,8,,,,,,,,,,
19920705-M-Wimbledon-F-Andre_Agassi-Goran_Ivanisevic,1,B-IO,22,3,1,0,2,14,8,,,,,,,,,,
19920705-M-Wimbledon-F-Andre_Agassi-Goran_Ivanisevic,1,S-XC,3,1,1,0,0,2,1,,,,,,,,,,
19920705-M-Wimbledon-F-Andre_Agassi-Goran_Ivanisevic,1,S-DTM,2,0,0,0,0,1,1,,,,,,,,,,
19920705-M-Wimbledon-F-Andre_Agassi-Goran_Ivanisevic,2,F-XC,19,6,1,2,3,9,10,,,,,,,,,,
19920705-M-Wimbledon-F-Andre_Agassi-Goran_Ivanisevic,2,F-DTM,9,1,0,0,1,5,4,,,,,,,,,,
19920705-M-Wimbledon-F-Andre_Agassi-Goran_Ivanisevic,2,F-DTL,6,2,0,0,2,2,4,,,,,,,,,,
19920705-M-Wimbledon-F-Andre_Agassi-Goran_Ivanisevic,2,F-IO,16,10,4,0,6,7,9,,,,,,,,,,
19920705-M-Wimbledon-F-Andre_Agassi-Goran_Ivanisevic,2,F-II,1,0,0,0,0,0,1,,,,,,,,,,
19920705-M-Wimbledon-F-Andre_Agassi-Goran_Ivanisevic,2,B-XC,6,3,1,1,1,2,4,,,,,,,,,,
19920705-M-Wimbledon-F-Andre_Agassi-Goran_Ivanisevic,2,B-DTM,24,4,0,0,4,8,16,,,,,,,,,,
19920705-M-Wimbledon-F-Andre_Agassi-Goran_Ivanisevic,2,B-DTL,7,0,0,0,0,3,4,,,,,,,,,,
19920705-M-Wimbledon-F-Andre_Agassi-Goran_Ivanisevic,2,B-IO,5,2,1,0,1,2,3,,,,,,,,,,
19920705-M-Wimbledon-F-Andre_Agassi-Goran_Ivanisevic,2,S-XC,8,1,0,0,1,3,5,,,,,,,,,,
19920705-M-Wimbledon-F-Andre_Agassi-Goran_Ivanisevic,2,S-DTM,27,5,0,2,3,6,21,,,,,,,,,,
19920705-M-Wimbledon-F-Andre_Agassi-Goran_Ivanisevic,2,S-DTL,7,2,0,0,2,3,4,,,,,,,,,,
19920705-M-Wimbledon-F-Andre_Agassi-Goran_Ivanisevic,2,S-IO,6,3,0,1,2,2,4,,,,,,,,,,
19920913-M-US_Open-F-Pete_Sampras-Stefan_Edberg,1,F-XC,8,1,0,0,1,5,3,,,,,,,,,,
19920913-M-US_Open-F-Pete_Sampras-Stefan_Edberg,1,F-DTM,3,1,0,0,1,1,2,,,,,,,,,,
19920913-M-US_Open-F-Pete_Sampras-Stefan_Edberg,1,F-DTL,13,7,4,1,2,8,5,,,,,,,,,,
19920913-M-US_Open-F-Pete_Sampras-Stefan_Edberg,1,F-IO,14,4,1,2,1,8,6,,,,,,,,,,
19920913-M-US_Open-F-Pete_Sampras-Stefan_Edberg,1,F-II,4,2,2,0,0,3,1,,,,,,,,,,
19920913-M-US_Open-F-Pete_Sampras-Stefan_Edberg,1,B-XC,21,8,3,1,4,12,9,,,,,,,,,,
19920913-M-US_Open-F-Pete_Sampras-Stefan_Edberg,1,B-DTM,16,2,0,0,2,4,12,,,,,,,,,,
19920913-M-US_Open-F-Pete_Sampras-Stefan_Edberg,1,B-DTL,14,7,2,3,2,9,5,,,,,,,,,,
19920913-M-US_Open-F-Pete_Sampras-Stefan_Edberg,1,B-IO,7,2,2,0,0,6,1,,,,,,,,,,
19920913-M-US_Open-F-Pete_Sampras-Stefan_Edberg,1,S-XC,4,0,0,0,0,2,2,,,,,,,,,,
19920913-M-US_Open-F-Pete_Sampras-Stefan_Edberg,1,S-DTM,3,0,0,0,0,0,3,,,,,,,,,,
19920913-M-US_Open-F-Pete_Sampras-Stefan_Edberg,1,S-DTL,6,2,0,1,1,4,2,,,,,,,,,,
19920913-M-US_Open-F-Pete_Sampras-Stefan_Edberg,1,S-IO,1,1,0,0,1,0,1,,,,,,,,,,
19920913-M-US_Open-F-Pete_Sampras-Stefan_Edberg,2,F-XC,13,5,4,0,1,7,6,,,,,,,,,,
19920913-M-US_Open-F-Pete_Sampras-Stefan_Edberg,2,F-DTM,4,1,0,0,1,1,3,,,,,,,,,,
19920913-M-US_Open-F-Pete_Sampras-Stefan_Edberg,2,F-DTL,12,2,0,0,2,2,10,,,,,,,,,,
19920913-M-US_Open-F-Pete_Sampras-Stefan_Edberg,2,F-IO,9,3,1,0,2,6,3,,,,,,,,,,
19920913-M-US_Open-F-Pete_Sampras-Stefan_Edberg,2,B-XC,22,6,1,2,3,9,13,,,,,,,,,,
19920913-M-US_Open-F-Pete_Sampras-Stefan_Edberg,2,B-DTM,6,2,0,1,1,3,3,,,,,,,,,,
19920913-M-US_Open-F-Pete_Sampras-Stefan_Edberg,2,B-DTL,6,4,2,1,1,4,2,,,,,,,,,,
19920913-M-US_Open-F-Pete_Sampras-Stefan_Edberg,2,B-IO,2,1,0,0,1,0,2,,,,,,,,,,
19920913-M-US_Open-F-Pete_Sampras-Stefan_Edberg,2,S-XC,14,1,0,0,1,8,6,,,,,,,,,,
19920913-M-US_Open-F-Pete_Sampras-Stefan_Edberg,2,S-DTM,1,0,0,0,0,0,1,,,,,,,,,,
19920913-M-US_Open-F-Pete_Sampras-Stefan_Edberg,2,S-DTL,1,1,0,0,1,0,1,,,,,,,,,,
19930912-M-US_Open-F-Cedric_Pioline-Pete_Sampras,1,F-XC,17,2,0,0,2,7,10,,,,,,,,,,
19930912-M-US_Open-F-Cedric_Pioline-Pete_Sampras,1,F-DTM,32,3,0,1,2,13,19,,,,,,,,,,
19930912-M-US_Open-F-Cedric_Pioline-Pete_Sampras,1,F-DTL,9,5,2,2,1,6,3,,,,,,,,,,
19930912-M-US_Open-F-Cedric_Pioline-Pete_Sampras,1,F-IO,31,5,0,1,4,13,18,,,,,,,,,,
19930912-M-US_Open-F-Cedric_Pioline-Pete_Sampras,1,F-II,1,1,1,0,0,1,0,,,,,,,,,,
19930912-M-US_Open-F-Cedric_Pioline-Pete_Sampras,1,B-XC,37,7,1,1,5,13,24,,,,,,,,,,
19930912-M-US_Open-F-Cedric_Pioline-Pete_Sampras,1,B-DTM,41,5,0,0,5,11,30,,,,,,,,,,
19930912-M-US_Open-F-Cedric_Pioline-Pete_Sampras,1,B-DTL,9,5,2,0,3,2,7,,,,,,,,,,
19930912-M-US_Open-F-Cedric_Pioline-Pete_Sampras,1,B-IO,8,2,0,0,2,3,5,,,,,,,,,,
19930912-M-US_Open-F-Cedric_Pioline-Pete_Sampras,1,S-XC,14,1,0,0,1,6,8,,,,,,,,,,
19930912-M-US_Open-F-Cedric_Pioline-Pete_Sampras,1,S-DTM,4,0,0,0,0,2,2,,,,,,,,,,
19930912-M-US_Open-F-Cedric_Pioline-Pete_Sampras,1,S-DTL,1,1,0,1,0,1,0,,,,,,,,,,
19930912-M-US_Open-F-Cedric_Pioline-Pete_Sampras,1,S-IO,2,1,0,0,1,1,1,,,,,,,,,,
19930912-M-US_Open-F-Cedric_Pioline-Pete_Sampras,2,F-XC,36,13,1,3,9,17,19,,,,,,,,,,
19930912-M-US_Open-F-Cedric_Pioline-Pete_Sampras,2,F-DTM,24,1,0,1,0,16,8,,,,,,,,,,
19930912-M-US_Open-F-Cedric_Pioline-Pete_Sampras,2,F-DTL,3,0,0,0,0,2,1,,,,,,,,,,
19930912-M-US_Open-F-Cedric_Pioline-Pete_Sampras,2,F-IO,28,7,1,2,4,20,8,,,,,,,,,,
19930912-M-US_Open-F-Cedric_Pioline-Pete_Sampras,2,F-II,1,0,0,0,0,1,0,,,,,,,,,,
19930912-M-US_Open-F-Cedric_Pioline-Pete_Sampras,2,B-XC,34,4,0,0,4,16,18,,,,,,,,,,
19930912-M-US_Open-F-Cedric_Pioline-Pete_Sampras,2,B-DTM,32,2,0,1,1,19,13,,,,,,,,,,
19930912-M-US_Open-F-Cedric_Pioline-Pete_Sampras,2,B-DTL,3,2,0,0,2,0,3,,,,,,,,,,
19930912-M-US_Open-F-Cedric_Pioline-Pete_Sampras,2,S-XC,13,0,0,0,0,7,6,,,,,,,,,,
19930912-M-US_Open-F-Cedric_Pioline-Pete_Sampras,2,S-DTM,9,1,0,0,1,3,6,,,,,,,,,,
19930912-M-US_Open-F-Cedric_Pioline-Pete_Sampras,2,S-DTL,2,0,0,0,0,1,1,,,,,,,,,,
19950129-M-Australian_Open-F-Pete_Sampras-Andre_Agassi,1,F-XC,39,14,3,2,9,20,19,,,,,,,,,,
19950129-M-Australian_Open-F-Pete_Sampras-Andre_Agassi,1,F-DTM,13,4,0,0,4,6,7,,,,,,,,,,
19950129-M-Australian_Open-F-Pete_Sampras-Andre_Agassi,1,F-DTL,24,11,7,1,3,13,11,,,,,,,,,,
19950129-M-Australian_Open-F-Pete_Sampras-Andre_Agassi,1,F-IO,11,3,1,0,2,6,5,,,,,,,,,,
19950129-M-Australian_Open-F-Pete_Sampras-Andre_Agassi,1,F-II,4,1,0,0,1,1,3,,,,,,,,,,
19950129-M-Australian_Open-F-Pete_Sampras-Andre_Agassi,1,B-XC,38,3,0,1,2,12,26,,,,,,,,,,
19950129-M-Australian_Open-F-Pete_Sampras-Andre_Agassi,1,B-DTM,27,7,0,0,7,7,20,,,,,,,,,,
19950129-M-Australian_Open-F-Pete_Sampras-Andre_Agassi,1,B-DTL,12,4,2,2,0,9,3,,,,,,,,,,
19950129-M-Australian_Open-F-Pete_Sampras-Andre_Agassi,1,B-IO,4,1,0,0,1,0,4,,,,,,,,,,
19950129-M-Australian_Open-F-Pete_Sampras-Andre_Agassi,1,S-XC,20,1,0,0,1,7,13,,,,,,,,,,
19950129-M-Australian_Open-F-Pete_Sampras-Andre_Agassi,1,S-DTM,13,1,1,0,0,6,7,,,,,,,,,,
19950129-M-Australian_Open-F-Pete_Sampras-Andre_Agassi,1,S-DTL,12,3,0,1,2,6,6,,,,,,,,,,
19950129-M-Australian_Open-F-Pete_Sampras-Andre_Agassi,1,S-IO,3,0,0,0,0,1,2,,,,,,,,,,
19950129-M-Australian_Open-F-Pete_Sampras-Andre_Agassi,1,S-II,1,0,0,0,0,0,1,,,,,,,,,,
19950129-M-Australian_Open-F-Pete_Sampras-Andre_Agassi,2,F-XC,63,17,12,2,3,36,27,,,,,,,,,,
19950129-M-Australian_Open-F-Pete_Sampras-Andre_Agassi,2,F-DTM,29,2,0,0,2,14,15,,,,,,,,,,
19950129-M-Australian_Open-F-Pete_Sampras-Andre_Agassi,2,F-DTL,18,8,4,2,2,11,7,,,,,,,,,,
19950129-M-Australian_Open-F-Pete_Sampras-Andre_Agassi,2,F-IO,20,4,2,0,2,12,8,,,,,,,,,,
19950129-M-Australian_Open-F-Pete_Sampras-Andre_Agassi,2,F-II,9,4,3,1,0,8,1,,,,,,,,,,
19950129-M-Australian_Open-F-Pete_Sampras-Andre_Agassi,2,B-XC,73,10,2,2,6,42,31,,,,,,,,,,
19950129-M-Australian_Open-F-Pete_Sampras-Andre_Agassi,2,B-DTM,12,1,0,0,1,6,6,,,,,,,,,,
19950129-M-Australian_Open-F-Pete_Sampras-Andre_Agassi,2,B-DTL,9,4,3,1,0,6,3,,,,,,,,,,
19950129-M-Australian_Open-F-Pete_Sampras-Andre_Agassi,2,B-IO,5,3,2,1,0,5,0,,,,,,,,,,
19950129-M-Australian_Open-F-Pete_Sampras-Andre_Agassi,2,S-XC,10,0,0,0,0,4,6,,,,,,,,,,
19950129-M-Australian_Open-F-Pete_Sampras-Andre_Agassi,2,S-DTM,2,0,0,0,0,1,1,,,,,,,,,,
19950129-M-Australian_Open-F-Pete_Sampras-Andre_Agassi,2,S-DTL,1,0,0,0,0,1,0,,,,,,,,,,
19950129-M-Australian_Open-F-Pete_Sampras-Andre_Agassi,2,S-II,1,0,0,0,0,1,0,,,,,,,,,,
19950709-M-Wimbledon-F-Pete_Sampras-Boris_Becker,1,F-XC,4,2,2,0,0,3,1,,,,,,,,,,
19950709-M-Wimbledon-F-Pete_Sampras-Boris_Becker,1,F-DTL,3,2,2,0,0,2,1,,,,,,,,,,
19950709-M-Wimbledon-F-Pete_Sampras-Boris_Becker,1,F-IO,1,1,1,0,0,1,0,,,,,,,,,,
19950709-M-Wimbledon-F-Pete_Sampras-Boris_Becker,1,B-XC,9,6,3,1,2,5,4,,,,,,,,,,
19950709-M-Wimbledon-F-Pete_Sampras-Boris_Becker,1,B-DTM,1,0,0,0,0,1,0,,,,,,,,,,
19950709-M-Wimbledon-F-Pete_Sampras-Boris_Becker,1,B-DTL,5,4,4,0,0,5,0,,,,,,,,,,
19950709-M-Wimbledon-F-Pete_Sampras-Boris_Becker,1,S-XC,1,0,0,0,0,0,1,,,,,,,,,,
19950709-M-Wimbledon-F-Pete_Sampras-Boris_Becker,2,F-XC,4,3,2,0,1,2,2,,,,,,,,,,
19950709-M-Wimbledon-F-Pete_Sampras-Boris_Becker,2,F-DTM,1,0,0,0,0,0,1,,,,,,,,,,
19950709-M-Wimbledon-F-Pete_Sampras-Boris_Becker,2,F-DTL,2,0,0,0,0,0,2,,,,,,,,,,
19950709-M-Wimbledon-F-Pete_Sampras-Boris_Becker,2,F-IO,2,1,1,0,0,1,1,,,,,,,,,,
19950709-M-Wimbledon-F-Pete_Sampras-Boris_Becker,2,B-XC,2,1,0,0,1,0,2,,,,,,,,,,
19950709-M-Wimbledon-F-Pete_Sampras-Boris_Becker,2,B-DTL,4,3,2,0,1,2,2,,,,,,,,,,
19950709-M-Wimbledon-F-Pete_Sampras-Boris_Becker,2,B-IO,1,1,0,0,1,0,1,,,,,,,,,,
19950709-M-Wimbledon-F-Pete_Sampras-Boris_Becker,2,S-XC,2,1,0,0,1,1,1,,,,,,,,,,
19950709-M-Wimbledon-F-Pete_Sampras-Boris_Becker,2,S-DTM,1,0,0,0,0,0,1,,,,,,,,,,
19950709-M-Wimbledon-F-Pete_Sampras-Boris_Becker,2,S-DTL,1,0,0,0,0,1,0,,,,,,,,,,
19950910-M-US_Open-F-Pete_Sampras-Andre_Agassi,1,F-XC,36,9,2,1,6,19,17,,,,,,,,,,
19950910-M-US_Open-F-Pete_Sampras-Andre_Agassi,1,F-DTM,14,3,0,0,3,2,12,,,,,,,,,,
19950910-M-US_Open-F-Pete_Sampras-Andre_Agassi,1,F-DTL,10,4,3,1,0,8,2,,,,,,,,,,
19950910-M-US_Open-F-Pete_Sampras-Andre_Agassi,1,F-IO,16,4,2,0,2,8,8,,,,,,,,,,
19950910-M-US_Open-F-Pete_Sampras-Andre_Agassi,1,F-II,4,2,0,0,2,2,2,,,,,,,,,,
19950910-M-US_Open-F-Pete_Sampras-Andre_Agassi,1,B-XC,51,4,2,1,1,20,31,,,,,,,,,,
19950910-M-US_Open-F-Pete_Sampras-Andre_Agassi,1,B-DTM,26,2,0,1,1,9,17,,,,,,,,,,
19950910-M-US_Open-F-Pete_Sampras-Andre_Agassi,1,B-DTL,13,5,2,0,3,7,6,,,,,,,,,,
19950910-M-US_Open-F-Pete_Sampras-Andre_Agassi,1,B-IO,3,1,0,0,1,1,2,,,,,,,,,,
19950910-M-US_Open-F-Pete_Sampras-Andre_Agassi,1,S-XC,11,1,0,0,1,7,4,,,,,,,,,,
19950910-M-US_Open-F-Pete_Sampras-Andre_Agassi,1,S-DTM,8,0,0,0,0,6,2,,,,,,,,,,
19950910-M-US_Open-F-Pete_Sampras-Andre_Agassi,1,S-DTL,6,1,0,1,0,4,2,,,,,,,,,,
19950910-M-US_Open-F-Pete_Sampras-Andre_Agassi,2,F-XC,51,22,7,8,7,28,23,,,,,,,,,,
19950910-M-US_Open-F-Pete_Sampras-Andre_Agassi,2,F-DTM,22,2,0,0,2,9,13,,,,,,,,,,
19950910-M-US_Open-F-Pete_Sampras-Andre_Agassi,2,F-DTL,12,3,1,1,1,6,6,,,,,,,,,,
19950910-M-US_Open-F-Pete_Sampras-Andre_Agassi,2,F-IO,41,7,1,5,1,22,19,,,,,,,,,,
19950910-M-US_Open-F-Pete_Sampras-Andre_Agassi,2,F-II,5,2,2,0,0,4,1,,,,,,,,,,
19950910-M-US_Open-F-Pete_Sampras-Andre_Agassi,2,B-XC,70,14,3,5,6,44,26,,,,,,,,,,
19950910-M-US_Open-F-Pete_Sampras-Andre_Agassi,2,B-DTM,12,2,0,0,2,7,5,,,,,,,,,,
19950910-M-US_Open-F-Pete_Sampras-Andre_Agassi,2,B-DTL,13,5,3,1,1,7,6,,,,,,,,,,
19950910-M-US_Open-F-Pete_Sampras-Andre_Agassi,2,B-IO,4,3,1,2,0,3,1,,,,,,,,,,
19950910-M-US_Open-F-Pete_Sampras-Andre_Agassi,2,S-XC,5,2,1,1,0,3,2,,,,,,,,,,
19950910-M-US_Open-F-Pete_Sampras-Andre_Agassi,2,S-DTM,5,0,0,0,0,2,3,,,,,,,,,,
19950910-M-US_Open-F-Pete_Sampras-Andre_Agassi,2,S-DTL,1,0,0,0,0,0,1,,,,,,,,,,
19960128-M-Australian_Open-F-Michael_Chang-Boris_Becker,1,F-XC,24,3,1,0,2,10,14,,,,,,,,,,
19960128-M-Australian_Open-F-Michael_Chang-Boris_Becker,1,F-DTM,31,2,0,1,1,13,18,,,,,,,,,,
19960128-M-Australian_Open-F-Michael_Chang-Boris_Becker,1,F-DTL,19,4,3,0,1,8,11,,,,,,,,,,
19960128-M-Australian_Open-F-Michael_Chang-Boris_Becker,1,F-IO,13,2,0,1,1,6,7,,,,,,,,,,
19960128-M-Australian_Open-F-Michael_Chang-Boris_Becker,1,F-II,3,0,0,0,0,1,2,,,,,,,,,,
19960128-M-Australian_Open-F-Michael_Chang-Boris_Becker,1,B-XC,37,7,4,1,2,13,24,,,,,,,,,,
19960128-M-Australian_Open-F-Michael_Chang-Boris_Becker,1,B-DTM,30,3,0,0,3,11,19,,,,,,,,,,
19960128-M-Australian_Open-F-Michael_Chang-Boris_Becker,1,B-DTL,18,7,3,1,3,7,11,,,,,,,,,,
19960128-M-Australian_Open-F-Michael_Chang-Boris_Becker,1,B-IO,2,1,0,0,1,1,1,,,,,,,,,,
19960128-M-Australian_Open-F-Michael_Chang-Boris_Becker,1,S-XC,4,1,0,0,1,1,3,,,,,,,,,,
19960128-M-Australian_Open-F-Michael_Chang-Boris_Becker,1,S-DTM,4,1,0,1,0,2,2,,,,,,,,,,
19960128-M-Australian_Open-F-Michael_Chang-Boris_Becker,1,S-DTL,2,0,0,0,0,0,2,,,,,,,,,,
19960128-M-Australian_Open-F-Michael_Chang-Boris_Becker,2,F-XC,28,8,1,4,3,17,11,,,,,,,,,,
19960128-M-Australian_Open-F-Michael_Chang-Boris_Becker,2,F-DTM,12,1,0,0,1,6,6,,,,,,,,,,
19960128-M-Australian_Open-F-Michael_Chang-Boris_Becker,2,F-DTL,11,5,3,1,1,9,2,,,,,,,,,,
19960128-M-Australian_Open-F-Michael_Chang-Boris_Becker,2,F-IO,19,5,1,2,2,13,6,,,,,,,,,,
19960128-M-Australian_Open-F-Michael_Chang-Boris_Becker,2,F-II,1,1,1,0,0,1,0,,,,,,,,,,
19960128-M-Australian_Open-F-Michael_Chang-Boris_Becker,2,B-XC,20,3,0,1,2,12,8,,,,,,,,,,
19960128-M-Australian_Open-F-Michael_Chang-Boris_Becker,2,B-DTM,15,2,0,0,2,5,10,,,,,,,,,,
19960128-M-Australian_Open-F-Michael_Chang-Boris_Becker,2,B-DTL,12,6,0,1,5,7,5,,,,,,,,,,
19960128-M-Australian_Open-F-Michael_Chang-Boris_Becker,2,B-IO,4,1,0,0,1,2,2,,,,,,,,,,
19960128-M-Australian_Open-F-Michael_Chang-Boris_Becker,2,S-XC,13,2,0,1,1,8,5,,,,,,,,,,
19960128-M-Australian_Open-F-Michael_Chang-Boris_Becker,2,S-DTM,3,1,0,0,1,1,2,,,,,,,,,,
19960128-M-Australian_Open-F-Michael_Chang-Boris_Becker,2,S-DTL,2,1,0,0,1,0,2,,,,,,,,,,
19960908-M-US_Open-F-Pete_Sampras-Michael_Chang,1,F-XC,13,8,4,1,3,8,5,,,,,,,,,,
19960908-M-US_Open-F-Pete_Sampras-Michael_Chang,1,F-DTM,7,1,0,1,0,5,2,,,,,,,,,,
19960908-M-US_Open-F-Pete_Sampras-Michael_Chang,1,F-DTL,5,4,1,1,2,3,2,,,,,,,,,,
19960908-M-US_Open-F-Pete_Sampras-Michael_Chang,1,F-IO,19,8,4,3,1,16,3,,,,,,,,,,
19960908-M-US_Open-F-Pete_Sampras-Michael_Chang,1,F-II,8,6,3,1,2,5,3,,,,,,,,,,
19960908-M-US_Open-F-Pete_Sampras-Michael_Chang,1,B-XC,59,2,0,1,1,33,26,,,,,,,,,,
19960908-M-US_Open-F-Pete_Sampras-Michael_Chang,1,B-DTM,19,2,0,1,1,11,8,,,,,,,,,,
19960908-M-US_Open-F-Pete_Sampras-Michael_Chang,1,B-DTL,12,5,3,0,2,8,4,,,,,,,,,,
19960908-M-US_Open-F-Pete_Sampras-Michael_Chang,1,B-IO,2,1,1,0,0,2,0,,,,,,,,,,
19960908-M-US_Open-F-Pete_Sampras-Michael_Chang,1,S-XC,6,1,0,0,1,0,6,,,,,,,,,,
19960908-M-US_Open-F-Pete_Sampras-Michael_Chang,1,S-DTM,2,0,0,0,0,2,0,,,,,,,,,,
19960908-M-US_Open-F-Pete_Sampras-Michael_Chang,1,S-DTL,3,2,0,1,1,1,2,,,,,,,,,,
19960908-M-US_Open-F-Pete_Sampras-Michael_Chang,2,F-XC,14,9,3,3,3,9,5,,,,,,,,,,
19960908-M-US_Open-F-Pete_Sampras-Michael_Chang,2,F-DTM,15,2,1,0,1,5,10,,,,,,,,,,
19960908-M-US_Open-F-Pete_Sampras-Michael_Chang,2,F-DTL,4,0,0,0,0,1,3,,,,,,,,,,
19960908-M-US_Open-F-Pete_Sampras-Michael_Chang,2,F-IO,25,5,2,1,2,12,13,,,,,,,,,,
19960908-M-US_Open-F-Pete_Sampras-Michael_Chang,2,F-II,8,5,1,3,1,5,3,,,,,,,,,,
19960908-M-US_Open-F-Pete_Sampras-Michael_Chang,2,B-XC,60,4,1,0,3,27,33,,,,,,,,,,
19960908-M-US_Open-F-Pete_Sampras-Michael_Chang,2,B-DTM,13,1,0,0,1,5,8,,,,,,,,,,
19960908-M-US_Open-F-Pete_Sampras-Michael_Chang,2,B-DTL,11,7,3,1,3,6,5,,,,,,,,,,
19960908-M-US_Open-F-Pete_Sampras-Michael_Chang,2,B-IO,1,0,0,0,0,0,1,,,,,,,,,,
19960908-M-US_Open-F-Pete_Sampras-Michael_Chang,2,S-XC,8,1,0,1,0,4,4,,,,,,,,,,
19961119-M-Tour_Finals-RR-Pete_Sampras-Andre_Agassi,1,F-XC,8,5,2,1,2,5,3,,,,,,,,,,
19961119-M-Tour_Finals-RR-Pete_Sampras-Andre_Agassi,1,F-DTM,4,0,0,0,0,2,2,,,,,,,,,,
19961119-M-Tour_Finals-RR-Pete_Sampras-Andre_Agassi,1,F-DTL,7,6,5,0,1,5,2,,,,,,,,,,
19961119-M-Tour_Finals-RR-Pete_Sampras-Andre_Agassi,1,F-IO,2,2,2,0,0,2,0,,,,,,,,,,
19961119-M-Tour_Finals-RR-Pete_Sampras-Andre_Agassi,1,B-XC,6,1,0,0,1,3,3,,,,,,,,,,
19961119-M-Tour_Finals-RR-Pete_Sampras-Andre_Agassi,1,B-DTM,5,0,0,0,0,1,4,,,,,,,,,,
19961119-M-Tour_Finals-RR-Pete_Sampras-Andre_Agassi,1,B-DTL,4,4,3,0,1,3,1,,,,,,,,,,
19961119-M-Tour_Finals-RR-Pete_Sampras-Andre_Agassi,1,B-IO,2,2,0,1,1,1,1,,,,,,,,,,
19961119-M-Tour_Finals-RR-Pete_Sampras-Andre_Agassi,1,S-XC,3,1,0,0,1,2,1,,,,,,,,,,
19961119-M-Tour_Finals-RR-Pete_Sampras-Andre_Agassi,1,S-DTM,2,0,0,0,0,1,1,,,,,,,,,,
19961119-M-Tour_Finals-RR-Pete_Sampras-Andre_Agassi,1,S-DTL,1,0,0,0,0,1,0,,,,,,,,,,
19961119-M-Tour_Finals-RR-Pete_Sampras-Andre_Agassi,2,F-XC,11,2,0,0,2,3,8,,,,,,,,,,
19961119-M-Tour_Finals-RR-Pete_Sampras-Andre_Agassi,2,F-DTM,7,4,0,1,3,4,3,,,,,,,,,,
19961119-M-Tour_Finals-RR-Pete_Sampras-Andre_Agassi,2,F-DTL,1,0,0,0,0,1,0,,,,,,,,,,
19961119-M-Tour_Finals-RR-Pete_Sampras-Andre_Agassi,2,F-IO,4,3,1,2,0,4,0,,,,,,,,,,
19961119-M-Tour_Finals-RR-Pete_Sampras-Andre_Agassi,2,B-XC,15,4,0,0,4,2,13,,,,,,,,,,
19961119-M-Tour_Finals-RR-Pete_Sampras-Andre_Agassi,2,B-DTM,3,1,0,0,1,2,1,,,,,,,,,,
19961119-M-Tour_Finals-RR-Pete_Sampras-Andre_Agassi,2,B-DTL,4,2,0,1,1,2,2,,,,,,,,,,
19961119-M-Tour_Finals-RR-Pete_Sampras-Andre_Agassi,2,B-IO,1,1,0,0,1,0,1,,,,,,,,,,
19961119-M-Tour_Finals-RR-Pete_Sampras-Andre_Agassi,2,S-XC,2,0,0,0,0,1,1,,,,,,,,,,
19961119-M-Tour_Finals-RR-Pete_Sampras-Andre_Agassi,2,S-DTL,2,0,0,0,0,0,2,,,,,,,,,,
19970608-M-Roland_Garros-F-Sergi_Bruguera-Gustavo_Kuerten,1,F-XC,57,10,3,4,3,26,31,,,,,,,,,,
19970608-M-Roland_Garros-F-Sergi_Bruguera-Gustavo_Kuerten,1,F-DTM,53,1,0,0,1,17,36,,,,,,,,,,
19970608-M-Roland_Garros-F-Sergi_Bruguera-Gustavo_Kuerten,1,F-DTL,23,5,3,2,0,9,14,,,,,,,,,,
19970608-M-Roland_Garros-F-Sergi_Bruguera-Gustavo_Kuerten,1,F-IO,53,7,2,2,3,24,29,,,,,,,,,,
19970608-M-Roland_Garros-F-Sergi_Bruguera-Gustavo_Kuerten,1,F-II,5,1,0,1,0,5,0,,,,,,,,,,
19970608-M-Roland_Garros-F-Sergi_Bruguera-Gustavo_Kuerten,1,B-XC,59,9,1,4,4,27,32,,,,,,,,,,
19970608-M-Roland_Garros-F-Sergi_Bruguera-Gustavo_Kuerten,1,B-DTM,42,1,0,1,0,19,23,,,,,,,,,,
19970608-M-Roland_Garros-F-Sergi_Bruguera-Gustavo_Kuerten,1,B-DTL,13,5,5,0,0,7,6,,,,,,,,,,
19970608-M-Roland_Garros-F-Sergi_Bruguera-Gustavo_Kuerten,1,B-IO,4,2,0,2,0,3,1,,,,,,,,,,
19970608-M-Roland_Garros-F-Sergi_Bruguera-Gustavo_Kuerten,1,S-XC,9,1,0,0,1,1,8,,,,,,,,,,
19970608-M-Roland_Garros-F-Sergi_Bruguera-Gustavo_Kuerten,1,S-DTM,5,0,0,0,0,1,4,,,,,,,,,,
19970608-M-Roland_Garros-F-Sergi_Bruguera-Gustavo_Kuerten,1,S-DTL,3,0,0,0,0,1,2,,,,,,,,,,
19970608-M-Roland_Garros-F-Sergi_Bruguera-Gustavo_Kuerten,1,S-IO,1,1,0,0,1,0,1,,,,,,,,,,
19970608-M-Roland_Garros-F-Sergi_Bruguera-Gustavo_Kuerten,2,F-XC,73,23,6,9,8,46,27,,,,,,,,,,
19970608-M-Roland_Garros-F-Sergi_Bruguera-Gustavo_Kuerten,2,F-DTM,32,4,0,2,2,16,16,,,,,,,,,,
19970608-M-Roland_Garros-F-Sergi_Bruguera-Gustavo_Kuerten,2,F-DTL,9,1,0,1,0,7,2,,,,,,,,,,
19970608-M-Roland_Garros-F-Sergi_Bruguera-Gustavo_Kuerten,2,F-IO,56,23,11,8,4,36,20,,,,,,,,,,
19970608-M-Roland_Garros-F-Sergi_Bruguera-Gustavo_Kuerten,2,F-II,15,8,2,3,3,12,3,,,,,,,,,,
19970608-M-Roland_Garros-F-Sergi_Bruguera-Gustavo_Kuerten,2,B-XC,70,6,1,2,3,41,29,,,,,,,,,,
19970608-M-Roland_Garros-F-Sergi_Bruguera-Gustavo_Kuerten,2,B-DTM,38,1,0,0,1,24,14,,,,,,,,,,
19970608-M-Roland_Garros-F-Sergi_Bruguera-Gustavo_Kuerten,2,B-DTL,12,8,2,3,3,8,4,,,,,,,,,,
19970608-M-Roland_Garros-F-Sergi_Bruguera-Gustavo_Kuerten,2,B-IO,5,2,1,0,1,3,2,,,,,,,,,,
19970608-M-Roland_Garros-F-Sergi_Bruguera-Gustavo_Kuerten,2,S-XC,4,0,0,0,0,1,3,,,,,,,,,,
19970608-M-Roland_Garros-F-Sergi_Bruguera-Gustavo_Kuerten,2,S-DTM,10,1,0,1,0,7,3,,,,,,,,,,
19970608-M-Roland_Garros-F-Sergi_Bruguera-Gustavo_Kuerten,2,S-DTL,2,0,0,0,0,0,2,,,,,,,,,,
19970907-M-US_Open-F-Patrick_Rafter-Greg_Rusedski,1,F-XC,11,5,2,2,1,9,2,,,,,,,,,,
19970907-M-US_Open-F-Patrick_Rafter-Greg_Rusedski,1,F-DTM,5,3,1,1,1,3,2,,,,,,,,,,
19970907-M-US_Open-F-Patrick_Rafter-Greg_Rusedski,1,F-DTL,7,3,2,1,0,6,1,,,,,,,,,,
19970907-M-US_Open-F-Patrick_Rafter-Greg_Rusedski,1,F-IO,3,2,0,1,1,2,1,,,,,,,,,,
19970907-M-US_Open-F-Patrick_Rafter-Greg_Rusedski,1,F-II,1,1,0,0,1,0,1,,,,,,,,,,
19970907-M-US_Open-F-Patrick_Rafter-Greg_Rusedski,1,B-XC,10,9,3,2,4,6,4,,,,,,,,,,
19970907-M-US_Open-F-Patrick_Rafter-Greg_Rusedski,1,B-DTM,3,3,0,1,2,1,2,,,,,,,,,,
19970907-M-US_Open-F-Patrick_Rafter-Greg_Rusedski,1,B-DTL,5,2,2,0,0,4,1,,,,,,,,,,
19970907-M-US_Open-F-Patrick_Rafter-Greg_Rusedski,1,B-IO,2,1,0,1,0,2,0,,,,,,,,,,
19970907-M-US_Open-F-Patrick_Rafter-Greg_Rusedski,1,S-XC,2,1,0,0,1,1,1,,,,,,,,,,
19970907-M-US_Open-F-Patrick_Rafter-Greg_Rusedski,1,S-DTM,4,0,0,0,0,4,0,,,,,,,,,,
19970907-M-US_Open-F-Patrick_Rafter-Greg_Rusedski,1,S-DTL,3,1,0,0,1,1,2,,,,,,,,,,
19970907-M-US_Open-F-Patrick_Rafter-Greg_Rusedski,1,S-IO,2,0,0,0,0,1,1,,,,,,,,,,
19970907-M-US_Open-F-Patrick_Rafter-Greg_Rusedski,2,F-XC,14,5,3,1,1,8,6,,,,,,,,,,
19970907-M-US_Open-F-Patrick_Rafter-Greg_Rusedski,2,F-DTM,4,1,0,0,1,0,4,,,,,,,,,,
19970907-M-US_Open-F-Patrick_Rafter-Greg_Rusedski,2,F-DTL,8,2,1,1,0,5,3,,,,,,,,,,
19970907-M-US_Open-F-Patrick_Rafter-Greg_Rusedski,2,F-IO,5,2,1,0,1,2,3,,,,,,,,,,
19970907-M-US_Open-F-Patrick_Rafter-Greg_Rusedski,2,F-II,1,0,0,0,0,0,1,,,,,,,,,,
19970907-M-US_Open-F-Patrick_Rafter-Greg_Rusedski,2,B-XC,5,3,1,1,1,2,3,,,,,,,,,,
19970907-M-US_Open-F-Patrick_Rafter-Greg_Rusedski,2,B-DTM,3,1,0,1,0,3,0,,,,,,,,,,
19970907-M-US_Open-F-Patrick_Rafter-Greg_Rusedski,2,B-DTL,4,2,1,0,1,2,2,,,,,,,,,,
19970907-M-US_Open-F-Patrick_Rafter-Greg_Rusedski,2,S-XC,4,1,0,0,1,0,4,,,,,,,,,,
19970907-M-US_Open-F-Patrick_Rafter-Greg_Rusedski,2,S-DTM,5,0,0,0,0,1,4,,,,,,,,,,
19970907-M-US_Open-F-Patrick_Rafter-Greg_Rusedski,2,S-DTL,4,2,0,2,0,3,1,,,,,,,,,,
19970907-M-US_Open-F-Patrick_Rafter-Greg_Rusedski,2,S-IO,1,1,0,1,0,1,0,,,,,,,,,,
19970923-M-Grand_Slam_Cup-QF-Pete_Sampras-Jonas_Bjorkman,1,F-XC,7,5,2,0,3,4,3,,,,,,,,,,
19970923-M-Grand_Slam_Cup-QF-Pete_Sampras-Jonas_Bjorkman,1,F-DTM,1,0,0,0,0,1,0,,,,,,,,,,
19970923-M-Grand_Slam_Cup-QF-Pete_Sampras-Jonas_Bjorkman,1,F-DTL,2,1,1,0,0,2,0,,,,,,,,,,
19970923-M-Grand_Slam_Cup-QF-Pete_Sampras-Jonas_Bjorkman,1,F-IO,4,2,1,0,1,3,1,,,,,,,,,,
19970923-M-Grand_Slam_Cup-QF-Pete_Sampras-Jonas_Bjorkman,1,F-II,3,2,0,1,1,2,1,,,,,,,,,,
19970923-M-Grand_Slam_Cup-QF-Pete_Sampras-Jonas_Bjorkman,1,B-XC,16,4,1,1,2,7,9,,,,,,,,,,
19970923-M-Grand_Slam_Cup-QF-Pete_Sampras-Jonas_Bjorkman,1,B-DTM,9,1,0,1,0,3,6,,,,,,,,,,
19970923-M-Grand_Slam_Cup-QF-Pete_Sampras-Jonas_Bjorkman,1,B-DTL,4,2,1,0,1,2,2,,,,,,,,,,
19970923-M-Grand_Slam_Cup-QF-Pete_Sampras-Jonas_Bjorkman,1,B-IO,1,1,1,0,0,1,0,,,,,,,,,,
19970923-M-Grand_Slam_Cup-QF-Pete_Sampras-Jonas_Bjorkman,1,S-XC,6,1,0,0,1,4,2,,,,,,,,,,
19970923-M-Grand_Slam_Cup-QF-Pete_Sampras-Jonas_Bjorkman,1,S-DTM,2,0,0,0,0,2,0,,,,,,,,,,
19970923-M-Grand_Slam_Cup-QF-Pete_Sampras-Jonas_Bjorkman,1,S-DTL,3,1,0,0,1,1,2,,,,,,,,,,
19970923-M-Grand_Slam_Cup-QF-Pete_Sampras-Jonas_Bjorkman,2,F-XC,5,2,0,0,2,1,4,,,,,,,,,,
19970923-M-Grand_Slam_Cup-QF-Pete_Sampras-Jonas_Bjorkman,2,F-DTM,1,1,0,0,1,0,1,,,,,,,,,,
19970923-M-Grand_Slam_Cup-QF-Pete_Sampras-Jonas_Bjorkman,2,F-DTL,2,2,1,0,1,1,1,,,,,,,,,,
19970923-M-Grand_Slam_Cup-QF-Pete_Sampras-Jonas_Bjorkman,2,F-IO,4,3,0,2,1,3,1,,,,,,,,,,
19970923-M-Grand_Slam_Cup-QF-Pete_Sampras-Jonas_Bjorkman,2,B-XC,25,3,0,0,3,13,12,,,,,,,,,,
19970923-M-Grand_Slam_Cup-QF-Pete_Sampras-Jonas_Bjorkman,2,B-DTM,6,2,0,1,1,3,3,,,,,,,,,,
19970923-M-Grand_Slam_Cup-QF-Pete_Sampras-Jonas_Bjorkman,2,B-DTL,6,3,1,2,0,4,2,,,,,,,,,,
19970923-M-Grand_Slam_Cup-QF-Pete_Sampras-Jonas_Bjorkman,2,B-IO,1,1,0,1,0,1,0,,,,,,,,,,
19970923-M-Grand_Slam_Cup-QF-Pete_Sampras-Jonas_Bjorkman,2,S-XC,4,0,0,0,0,0,4,,,,,,,,,,
19970923-M-Grand_Slam_Cup-QF-Pete_Sampras-Jonas_Bjorkman,2,S-DTM,1,0,0,0,0,1,0,,,,,,,,,,
19971020-M-Stuttgart_Masters-R32-Pete_Sampras-Magnus_Gustafsson,1,F-XC,9,6,3,1,2,6,3,,,,,,,,,,
19971020-M-Stuttgart_Masters-R32-Pete_Sampras-Magnus_Gustafsson,1,F-DTM,7,1,0,1,0,3,4,,,,,,,,,,
19971020-M-Stuttgart_Masters-R32-Pete_Sampras-Magnus_Gustafsson,1,F-DTL,4,3,1,0,2,1,3,,,,,,,,,,
19971020-M-Stuttgart_Masters-R32-Pete_Sampras-Magnus_Gustafsson,1,F-IO,13,6,0,3,3,5,8,,,,,,,,,,
19971020-M-Stuttgart_Masters-R32-Pete_Sampras-Magnus_Gustafsson,1,F-II,2,1,1,0,0,2,0,,,,,,,,,,
19971020-M-Stuttgart_Masters-R32-Pete_Sampras-Magnus_Gustafsson,1,B-XC,13,2,1,1,0,9,4,,,,,,,,,,
19971020-M-Stuttgart_Masters-R32-Pete_Sampras-Magnus_Gustafsson,1,B-DTM,6,1,0,0,1,2,4,,,,,,,,,,
19971020-M-Stuttgart_Masters-R32-Pete_Sampras-Magnus_Gustafsson,1,B-DTL,4,1,0,0,1,1,3,,,,,,,,,,
19971020-M-Stuttgart_Masters-R32-Pete_Sampras-Magnus_Gustafsson,1,B-IO,1,1,0,0,1,0,1,,,,,,,,,,
19971020-M-Stuttgart_Masters-R32-Pete_Sampras-Magnus_Gustafsson,1,S-XC,2,0,0,0,0,2,0,,,,,,,,,,
19971020-M-Stuttgart_Masters-R32-Pete_Sampras-Magnus_Gustafsson,1,S-DTM,1,0,0,0,0,0,1,,,,,,,,,,
19971020-M-Stuttgart_Masters-R32-Pete_Sampras-Magnus_Gustafsson,1,S-DTL,2,1,0,1,0,1,1,,,,,,,,,,
19971020-M-Stuttgart_Masters-R32-Pete_Sampras-Magnus_Gustafsson,1,S-IO,2,1,0,0,1,1,1,,,,,,,,,,
19971020-M-Stuttgart_Masters-R32-Pete_Sampras-Magnus_Gustafsson,2,F-XC,10,5,2,2,1,7,3,,,,,,,,,,
19971020-M-Stuttgart_Masters-R32-Pete_Sampras-Magnus_Gustafsson,2,F-DTM,17,0,0,0,0,9,8,,,,,,,,,,
19971020-M-Stuttgart_Masters-R32-Pete_Sampras-Magnus_Gustafsson,2,F-DTL,4,0,0,0,0,1,3,,,,,,,,,,
19971020-M-Stuttgart_Masters-R32-Pete_Sampras-Magnus_Gustafsson,2,F-IO,20,6,4,2,0,10,10,,,,,,,,,,
19971020-M-Stuttgart_Masters-R32-Pete_Sampras-Magnus_Gustafsson,2,F-II,1,0,0,0,0,1,0,,,,,,,,,,
19971020-M-Stuttgart_Masters-R32-Pete_Sampras-Magnus_Gustafsson,2,B-XC,6,0,0,0,0,5,1,,,,,,,,,,
19971020-M-Stuttgart_Masters-R32-Pete_Sampras-Magnus_Gustafsson,2,B-DTM,9,1,1,0,0,3,6,,,,,,,,,,
19971020-M-Stuttgart_Masters-R32-Pete_Sampras-Magnus_Gustafsson,2,B-DTL,3,3,0,3,0,3,0,,,,,,,,,,
19971020-M-Stuttgart_Masters-R32-Pete_Sampras-Magnus_Gustafsson,2,B-IO,1,0,0,0,0,0,1,,,,,,,,,,
19971020-M-Stuttgart_Masters-R32-Pete_Sampras-Magnus_Gustafsson,2,S-DTM,2,0,0,0,0,1,1,,,,,,,,,,
19971020-M-Stuttgart_Masters-R32-Pete_Sampras-Magnus_Gustafsson,2,S-DTL,1,1,0,0,1,0,1,,,,,,,,,,
19971027-M-Paris_Masters-SF-Pete_Sampras-Yevgeny_Kafelnikov,1,F-XC,31,9,5,1,3,17,14,,,,,,,,,,
19971027-M-Paris_Masters-SF-Pete_Sampras-Yevgeny_Kafelnikov,1,F-DTM,9,1,0,0,1,3,6,,,,,,,,,,
19971027-M-Paris_Masters-SF-Pete_Sampras-Yevgeny_Kafelnikov,1,F-DTL,11,6,1,1,4,4,7,,,,,,,,,,
19971027-M-Paris_Masters-SF-Pete_Sampras-Yevgeny_Kafelnikov,1,F-IO,9,4,3,1,0,6,3,,,,,,,,,,
19971027-M-Paris_Masters-SF-Pete_Sampras-Yevgeny_Kafelnikov,1,F-II,4,4,1,0,3,1,3,,,,,,,,,,
19971027-M-Paris_Masters-SF-Pete_Sampras-Yevgeny_Kafelnikov,1,B-XC,40,6,0,3,3,16,24,,,,,,,,,,
19971027-M-Paris_Masters-SF-Pete_Sampras-Yevgeny_Kafelnikov,1,B-DTM,14,0,0,0,0,9,5,,,,,,,,,,
19971027-M-Paris_Masters-SF-Pete_Sampras-Yevgeny_Kafelnikov,1,B-DTL,7,4,3,0,1,4,3,,,,,,,,,,
19971027-M-Paris_Masters-SF-Pete_Sampras-Yevgeny_Kafelnikov,1,S-XC,11,2,0,0,2,4,7,,,,,,,,,,
19971027-M-Paris_Masters-SF-Pete_Sampras-Yevgeny_Kafelnikov,1,S-DTM,3,0,0,0,0,2,1,,,,,,,,,,
19971027-M-Paris_Masters-SF-Pete_Sampras-Yevgeny_Kafelnikov,1,S-DTL,4,1,0,0,1,0,4,,,,,,,,,,
19971027-M-Paris_Masters-SF-Pete_Sampras-Yevgeny_Kafelnikov,1,S-IO,2,1,0,0,1,1,1,,,,,,,,,,
19971027-M-Paris_Masters-SF-Pete_Sampras-Yevgeny_Kafelnikov,2,F-XC,37,13,3,3,7,16,21,,,,,,,,,,
19971027-M-Paris_Masters-SF-Pete_Sampras-Yevgeny_Kafelnikov,2,F-DTM,15,3,0,1,2,5,10,,,,,,,,,,
19971027-M-Paris_Masters-SF-Pete_Sampras-Yevgeny_Kafelnikov,2,F-DTL,10,2,1,0,1,7,3,,,,,,,,,,
19971027-M-Paris_Masters-SF-Pete_Sampras-Yevgeny_Kafelnikov,2,F-IO,13,1,1,0,0,8,5,,,,,,,,,,
19971027-M-Paris_Masters-SF-Pete_Sampras-Yevgeny_Kafelnikov,2,F-II,3,1,0,1,0,2,1,,,,,,,,,,
19971027-M-Paris_Masters-SF-Pete_Sampras-Yevgeny_Kafelnikov,2,B-XC,49,10,1,3,6,30,19,,,,,,,,,,
19971027-M-Paris_Masters-SF-Pete_Sampras-Yevgeny_Kafelnikov,2,B-DTM,7,0,0,0,0,1,6,,,,,,,,,,
19971027-M-Paris_Masters-SF-Pete_Sampras-Yevgeny_Kafelnikov,2,B-DTL,10,6,1,2,3,6,4,,,,,,,,,,
19971027-M-Paris_Masters-SF-Pete_Sampras-Yevgeny_Kafelnikov,2,B-IO,4,2,1,0,1,3,1,,,,,,,,,,
19971027-M-Paris_Masters-SF-Pete_Sampras-Yevgeny_Kafelnikov,2,S-XC,8,0,0,0,0,5,3,,,,,,,,,,
19971027-M-Paris_Masters-SF-Pete_Sampras-Yevgeny_Kafelnikov,2,S-DTL,2,0,0,0,0,2,0,,,,,,,,,,
19971110-M-Tour_Finals-RR-Patrick_Rafter-Pete_Sampras,1,F-XC,5,0,0,0,0,3,2,,,,,,,,,,
19971110-M-Tour_Finals-RR-Patrick_Rafter-Pete_Sampras,1,F-DTL,4,2,1,0,1,2,2,,,,,,,,,,
19971110-M-Tour_Finals-RR-Patrick_Rafter-Pete_Sampras,1,F-IO,1,1,0,1,0,1,0,,,,,,,,,,
19971110-M-Tour_Finals-RR-Patrick_Rafter-Pete_Sampras,1,B-XC,9,1,0,0,1,6,3,,,,,,,,,,
19971110-M-Tour_Finals-RR-Patrick_Rafter-Pete_Sampras,1,B-DTM,5,1,0,0,1,1,4,,,,,,,,,,
19971110-M-Tour_Finals-RR-Patrick_Rafter-Pete_Sampras,1,B-DTL,3,0,0,0,0,1,2,,,,,,,,,,
19971110-M-Tour_Finals-RR-Patrick_Rafter-Pete_Sampras,1,B-IO,1,1,0,1,0,1,0,,,,,,,,,,
19971110-M-Tour_Finals-RR-Patrick_Rafter-Pete_Sampras,2,F-XC,7,3,0,2,1,5,2,,,,,,,,,,
19971110-M-Tour_Finals-RR-Patrick_Rafter-Pete_Sampras,2,F-DTM,1,1,0,1,0,1,0,,,,,,,,,,
19971110-M-Tour_Finals-RR-Patrick_Rafter-Pete_Sampras,2,F-DTL,2,1,0,0,1,0,2,,,,,,,,,,
19971110-M-Tour_Finals-RR-Patrick_Rafter-Pete_Sampras,2,F-IO,3,1,0,1,0,2,1,,,,,,,,,,
19971110-M-Tour_Finals-RR-Patrick_Rafter-Pete_Sampras,2,F-II,2,0,0,0,0,0,2,,,,,,,,,,
19971110-M-Tour_Finals-RR-Patrick_Rafter-Pete_Sampras,2,B-XC,8,1,0,0,1,3,5,,,,,,,,,,
19971110-M-Tour_Finals-RR-Patrick_Rafter-Pete_Sampras,2,B-DTM,2,1,0,0,1,0,2,,,,,,,,,,
19971110-M-Tour_Finals-RR-Patrick_Rafter-Pete_Sampras,2,B-DTL,2,2,1,1,0,2,0,,,,,,,,,,
19971110-M-Tour_Finals-RR-Patrick_Rafter-Pete_Sampras,2,B-IO,1,1,0,0,1,0,1,,,,,,,,,,
19971110-M-Tour_Finals-RR-Patrick_Rafter-Pete_Sampras,2,S-XC,4,1,0,1,0,3,1,,,,,,,,,,
19971110-M-Tour_Finals-RR-Patrick_Rafter-Pete_Sampras,2,S-DTM,1,0,0,0,0,0,1,,,,,,,,,,
19971110-M-Tour_Finals-RR-Patrick_Rafter-Pete_Sampras,2,S-DTL,1,0,0,0,0,0,1,,,,,,,,,,
19971110-M-Tour_Finals-RR-Patrick_Rafter-Pete_Sampras,2,S-IO,1,1,0,1,0,1,0,,,,,,,,,,
19971110-M-Tour_Finals-SF-Pete_Sampras-Jonas_Bjorkman,1,F-XC,15,5,3,0,2,8,7,,,,,,,,,,
19971110-M-Tour_Finals-SF-Pete_Sampras-Jonas_Bjorkman,1,F-DTM,2,1,0,0,1,1,1,,,,,,,,,,
19971110-M-Tour_Finals-SF-Pete_Sampras-Jonas_Bjorkman,1,F-DTL,2,0,0,0,0,0,2,,,,,,,,,,
19971110-M-Tour_Finals-SF-Pete_Sampras-Jonas_Bjorkman,1,F-IO,12,8,2,2,4,5,7,,,,,,,,,,
19971110-M-Tour_Finals-SF-Pete_Sampras-Jonas_Bjorkman,1,F-II,7,4,2,1,1,6,1,,,,,,,,,,
19971110-M-Tour_Finals-SF-Pete_Sampras-Jonas_Bjorkman,1,B-XC,33,8,0,3,5,15,18,,,,,,,,,,
19971110-M-Tour_Finals-SF-Pete_Sampras-Jonas_Bjorkman,1,B-DTM,10,2,0,0,2,4,6,,,,,,,,,,
19971110-M-Tour_Finals-SF-Pete_Sampras-Jonas_Bjorkman,1,B-DTL,11,8,3,1,4,7,4,,,,,,,,,,
19971110-M-Tour_Finals-SF-Pete_Sampras-Jonas_Bjorkman,1,B-IO,1,0,0,0,0,0,1,,,,,,,,,,
19971110-M-Tour_Finals-SF-Pete_Sampras-Jonas_Bjorkman,1,S-XC,2,0,0,0,0,1,1,,,,,,,,,,
19971110-M-Tour_Finals-SF-Pete_Sampras-Jonas_Bjorkman,1,S-DTM,1,0,0,0,0,1,0,,,,,,,,,,
19971110-M-Tour_Finals-SF-Pete_Sampras-Jonas_Bjorkman,1,S-DTL,3,0,0,0,0,1,2,,,,,,,,,,
19971110-M-Tour_Finals-SF-Pete_Sampras-Jonas_Bjorkman,1,S-IO,2,0,0,0,0,0,2,,,,,,,,,,
19971110-M-Tour_Finals-SF-Pete_Sampras-Jonas_Bjorkman,2,F-XC,7,1,0,1,0,4,3,,,,,,,,,,
19971110-M-Tour_Finals-SF-Pete_Sampras-Jonas_Bjorkman,2,F-DTM,5,0,0,0,0,1,4,,,,,,,,,,
19971110-M-Tour_Finals-SF-Pete_Sampras-Jonas_Bjorkman,2,F-DTL,10,1,0,0,1,2,8,,,,,,,,,,
19971110-M-Tour_Finals-SF-Pete_Sampras-Jonas_Bjorkman,2,F-IO,5,0,0,0,0,2,3,,,,,,,,,,
19971110-M-Tour_Finals-SF-Pete_Sampras-Jonas_Bjorkman,2,B-XC,40,9,1,4,4,21,19,,,,,,,,,,
19971110-M-Tour_Finals-SF-Pete_Sampras-Jonas_Bjorkman,2,B-DTM,6,1,0,0,1,4,2,,,,,,,,,,
19971110-M-Tour_Finals-SF-Pete_Sampras-Jonas_Bjorkman,2,B-DTL,8,4,0,2,2,3,5,,,,,,,,,,
19971110-M-Tour_Finals-SF-Pete_Sampras-Jonas_Bjorkman,2,B-IO,3,1,0,0,1,2,1,,,,,,,,,,
19971110-M-Tour_Finals-SF-Pete_Sampras-Jonas_Bjorkman,2,S-XC,6,0,0,0,0,3,3,,,,,,,,,,
19971110-M-Tour_Finals-SF-Pete_Sampras-Jonas_Bjorkman,2,S-DTM,1,0,0,0,0,0,1,,,,,,,,,,
19980201-M-Australian_Open-F-Petr_Korda-Marcelo_Rios,1,F-XC,26,17,9,6,2,17,9,,,,,,,,,,
19980201-M-Australian_Open-F-Petr_Korda-Marcelo_Rios,1,F-DTM,7,1,0,0,1,5,2,,,,,,,,,,
19980201-M-Australian_Open-F-Petr_Korda-Marcelo_Rios,1,F-DTL,7,5,2,2,1,5,2,,,,,,,,,,
19980201-M-Australian_Open-F-Petr_Korda-Marcelo_Rios,1,F-IO,14,8,3,0,5,6,8,,,,,,,,,,
19980201-M-Australian_Open-F-Petr_Korda-Marcelo_Rios,1,F-II,2,2,0,1,1,1,1,,,,,,,,,,
19980201-M-Australian_Open-F-Petr_Korda-Marcelo_Rios,1,B-XC,37,5,3,0,2,27,10,,,,,,,,,,
19980201-M-Australian_Open-F-Petr_Korda-Marcelo_Rios,1,B-DTM,9,0,0,0,0,5,4,,,,,,,,,,
19980201-M-Australian_Open-F-Petr_Korda-Marcelo_Rios,1,B-DTL,9,5,1,2,2,6,3,,,,,,,,,,
19980201-M-Australian_Open-F-Petr_Korda-Marcelo_Rios,1,B-IO,2,1,0,0,1,1,1,,,,,,,,,,
19980201-M-Australian_Open-F-Petr_Korda-Marcelo_Rios,1,S-XC,13,0,0,0,0,12,1,,,,,,,,,,
19980201-M-Australian_Open-F-Petr_Korda-Marcelo_Rios,1,S-DTM,8,1,0,0,1,4,4,,,,,,,,,,
19980201-M-Australian_Open-F-Petr_Korda-Marcelo_Rios,1,S-IO,2,0,0,0,0,2,0,,,,,,,,,,
19980201-M-Australian_Open-F-Petr_Korda-Marcelo_Rios,2,F-XC,19,8,2,3,3,9,10,,,,,,,,,,
19980201-M-Australian_Open-F-Petr_Korda-Marcelo_Rios,2,F-DTM,14,2,1,0,1,6,8,,,,,,,,,,
19980201-M-Australian_Open-F-Petr_Korda-Marcelo_Rios,2,F-DTL,8,2,1,0,1,3,5,,,,,,,,,,
19980201-M-Australian_Open-F-Petr_Korda-Marcelo_Rios,2,F-IO,19,7,0,3,4,7,12,,,,,,,,,,
19980201-M-Australian_Open-F-Petr_Korda-Marcelo_Rios,2,F-II,2,2,0,0,2,0,2,,,,,,,,,,
19980201-M-Australian_Open-F-Petr_Korda-Marcelo_Rios,2,B-XC,31,6,0,2,4,10,21,,,,,,,,,,
19980201-M-Australian_Open-F-Petr_Korda-Marcelo_Rios,2,B-DTM,16,3,0,0,3,4,12,,,,,,,,,,
19980201-M-Australian_Open-F-Petr_Korda-Marcelo_Rios,2,B-DTL,13,7,0,1,6,2,11,,,,,,,,,,
19980201-M-Australian_Open-F-Petr_Korda-Marcelo_Rios,2,B-IO,1,1,0,0,1,0,1,,,,,,,,,,
19980201-M-Australian_Open-F-Petr_Korda-Marcelo_Rios,2,S-XC,5,0,0,0,0,0,5,,,,,,,,,,
19980201-M-Australian_Open-F-Petr_Korda-Marcelo_Rios,2,S-DTM,2,0,0,0,0,0,2,,,,,,,,,,
19980209-M-San_Jose-F-Pete_Sampras-Andre_Agassi,1,F-XC,12,4,2,1,1,6,6,,,,,,,,,,
19980209-M-San_Jose-F-Pete_Sampras-Andre_Agassi,1,F-DTM,7,0,0,0,0,1,6,,,,,,,,,,
19980209-M-San_Jose-F-Pete_Sampras-Andre_Agassi,1,F-DTL,2,2,1,0,1,1,1,,,,,,,,,,
19980209-M-San_Jose-F-Pete_Sampras-Andre_Agassi,1,F-IO,5,4,2,1,1,3,2,,,,,,,,,,
19980209-M-San_Jose-F-Pete_Sampras-Andre_Agassi,1,B-XC,16,4,0,1,3,3,13,,,,,,,,,,
19980209-M-San_Jose-F-Pete_Sampras-Andre_Agassi,1,B-DTM,8,2,1,0,1,2,6,,,,,,,,,,
19980209-M-San_Jose-F-Pete_Sampras-Andre_Agassi,1,B-DTL,3,1,0,0,1,0,3,,,,,,,,,,
19980209-M-San_Jose-F-Pete_Sampras-Andre_Agassi,1,B-IO,3,3,2,0,1,2,1,,,,,,,,,,
19980209-M-San_Jose-F-Pete_Sampras-Andre_Agassi,1,S-XC,8,0,0,0,0,1,7,,,,,,,,,,
19980209-M-San_Jose-F-Pete_Sampras-Andre_Agassi,1,S-DTM,1,0,0,0,0,0,1,,,,,,,,,,
19980209-M-San_Jose-F-Pete_Sampras-Andre_Agassi,1,S-DTL,2,1,1,0,0,1,1,,,,,,,,,,
19980209-M-San_Jose-F-Pete_Sampras-Andre_Agassi,2,F-XC,15,8,4,4,0,12,3,,,,,,,,,,
19980209-M-San_Jose-F-Pete_Sampras-Andre_Agassi,2,F-DTM,7,1,0,0,1,4,3,,,,,,,,,,
19980209-M-San_Jose-F-Pete_Sampras-Andre_Agassi,2,F-DTL,7,2,1,0,1,6,1,,,,,,,,,,
19980209-M-San_Jose-F-Pete_Sampras-Andre_Agassi,2,F-IO,9,5,3,1,1,8,1,,,,,,,,,,
19980209-M-San_Jose-F-Pete_Sampras-Andre_Agassi,2,B-XC,27,7,2,3,2,21,6,,,,,,,,,,
19980209-M-San_Jose-F-Pete_Sampras-Andre_Agassi,2,B-DTM,12,2,0,1,1,8,4,,,,,,,,,,
19980209-M-San_Jose-F-Pete_Sampras-Andre_Agassi,2,B-DTL,9,5,3,1,1,8,1,,,,,,,,,,
19980209-M-San_Jose-F-Pete_Sampras-Andre_Agassi,2,B-IO,2,2,2,0,0,2,0,,,,,,,,,,
19980209-M-San_Jose-F-Pete_Sampras-Andre_Agassi,2,S-XC,2,1,0,1,0,1,1,,,,,,,,,,
19980209-M-San_Jose-F-Pete_Sampras-Andre_Agassi,2,S-DTM,1,0,0,0,0,1,0,,,,,,,,,,
19980223-M-Philadelphia-F-Pete_Sampras-Thomas_Enqvist,1,F-XC,14,6,6,0,0,10,4,,,,,,,,,,
19980223-M-Philadelphia-F-Pete_Sampras-Thomas_Enqvist,1,F-DTM,13,1,0,0,1,6,7,,,,,,,,,,
19980223-M-Philadelphia-F-Pete_Sampras-Thomas_Enqvist,1,F-DTL,6,1,0,0,1,4,2,,,,,,,,,,
19980223-M-Philadelphia-F-Pete_Sampras-Thomas_Enqvist,1,F-IO,11,2,1,0,1,10,1,,,,,,,,,,
19980223-M-Philadelphia-F-Pete_Sampras-Thomas_Enqvist,1,F-II,6,2,1,1,0,5,1,,,,,,,,,,
19980223-M-Philadelphia-F-Pete_Sampras-Thomas_Enqvist,1,B-XC,16,1,0,0,1,10,6,,,,,,,,,,
19980223-M-Philadelphia-F-Pete_Sampras-Thomas_Enqvist,1,B-DTM,12,2,0,0,2,3,9,,,,,,,,,,
19980223-M-Philadelphia-F-Pete_Sampras-Thomas_Enqvist,1,B-DTL,7,5,2,1,2,5,2,,,,,,,,,,
19980223-M-Philadelphia-F-Pete_Sampras-Thomas_Enqvist,1,B-IO,4,1,1,0,0,3,1,,,,,,,,,,
19980223-M-Philadelphia-F-Pete_Sampras-Thomas_Enqvist,1,S-XC,5,0,0,0,0,4,1,,,,,,,,,,
19980223-M-Philadelphia-F-Pete_Sampras-Thomas_Enqvist,1,S-DTM,1,0,0,0,0,0,1,,,,,,,,,,
19980223-M-Philadelphia-F-Pete_Sampras-Thomas_Enqvist,1,S-DTL,2,2,0,2,0,2,0,,,,,,,,,,
19980223-M-Philadelphia-F-Pete_Sampras-Thomas_Enqvist,1,S-IO,1,0,0,0,0,0,1,,,,,,,,,,
19980223-M-Philadelphia-F-Pete_Sampras-Thomas_Enqvist,2,F-XC,19,8,2,4,2,10,9,,,,,,,,,,
19980223-M-Philadelphia-F-Pete_Sampras-Thomas_Enqvist,2,F-DTM,7,3,0,0,3,2,5,,,,,,,,,,
19980223-M-Philadelphia-F-Pete_Sampras-Thomas_Enqvist,2,F-DTL,3,0,0,0,0,1,2,,,,,,,,,,
19980223-M-Philadelphia-F-Pete_Sampras-Thomas_Enqvist,2,F-IO,19,5,3,2,0,10,9,,,,,,,,,,
19980223-M-Philadelphia-F-Pete_Sampras-Thomas_Enqvist,2,F-II,1,1,0,1,0,1,0,,,,,,,,,,
19980223-M-Philadelphia-F-Pete_Sampras-Thomas_Enqvist,2,B-XC,31,5,1,1,3,9,22,,,,,,,,,,
19980223-M-Philadelphia-F-Pete_Sampras-Thomas_Enqvist,2,B-DTM,6,0,0,0,0,3,3,,,,,,,,,,
19980223-M-Philadelphia-F-Pete_Sampras-Thomas_Enqvist,2,B-DTL,8,5,1,1,3,4,4,,,,,,,,,,
19980223-M-Philadelphia-F-Pete_Sampras-Thomas_Enqvist,2,B-IO,7,2,0,0,2,3,4,,,,,,,,,,
19980223-M-Philadelphia-F-Pete_Sampras-Thomas_Enqvist,2,S-XC,6,1,0,0,1,3,3,,,,,,,,,,
19980223-M-Philadelphia-F-Pete_Sampras-Thomas_Enqvist,2,S-DTM,3,1,0,0,1,1,2,,,,,,,,,,
19980223-M-Philadelphia-F-Pete_Sampras-Thomas_Enqvist,2,S-DTL,3,2,0,1,1,1,2,,,,,,,,,,
19980705-M-Wimbledon-F-Goran_Ivanisevic-Pete_Sampras,1,F-XC,9,4,3,1,0,6,3,,,,,,,,,,
19980705-M-Wimbledon-F-Goran_Ivanisevic-Pete_Sampras,1,F-DTM,2,0,0,0,0,0,2,,,,,,,,,,
19980705-M-Wimbledon-F-Goran_Ivanisevic-Pete_Sampras,1,F-DTL,4,2,2,0,0,2,2,,,,,,,,,,
19980705-M-Wimbledon-F-Goran_Ivanisevic-Pete_Sampras,1,F-IO,2,2,0,2,0,2,0,,,,,,,,,,
19980705-M-Wimbledon-F-Goran_Ivanisevic-Pete_Sampras,1,F-II,1,1,1,0,0,1,0,,,,,,,,,,
19980705-M-Wimbledon-F-Goran_Ivanisevic-Pete_Sampras,1,B-XC,7,7,5,0,2,5,2,,,,,,,,,,
19980705-M-Wimbledon-F-Goran_Ivanisevic-Pete_Sampras,1,B-DTM,2,1,0,0,1,1,1,,,,,,,,,,
19980705-M-Wimbledon-F-Goran_Ivanisevic-Pete_Sampras,1,B-DTL,8,4,1,0,3,1,7,,,,,,,,,,
19980705-M-Wimbledon-F-Goran_Ivanisevic-Pete_Sampras,1,B-IO,3,3,0,0,3,0,3,,,,,,,,,,
19980705-M-Wimbledon-F-Goran_Ivanisevic-Pete_Sampras,1,S-XC,2,1,1,0,0,1,1,,,,,,,,,,
19980705-M-Wimbledon-F-Goran_Ivanisevic-Pete_Sampras,1,S-DTL,3,1,0,0,1,0,3,,,,,,,,,,
19980705-M-Wimbledon-F-Goran_Ivanisevic-Pete_Sampras,1,S-IO,1,0,0,0,0,0,1,,,,,,,,,,
19980705-M-Wimbledon-F-Goran_Ivanisevic-Pete_Sampras,2,F-XC,6,4,1,2,1,4,2,,,,,,,,,,
19980705-M-Wimbledon-F-Goran_Ivanisevic-Pete_Sampras,2,F-DTL,1,1,1,0,0,1,0,,,,,,,,,,
19980705-M-Wimbledon-F-Goran_Ivanisevic-Pete_Sampras,2,F-IO,5,4,4,0,0,4,1,,,,,,,,,,
19980705-M-Wimbledon-F-Goran_Ivanisevic-Pete_Sampras,2,B-XC,6,5,3,1,1,4,2,,,,,,,,,,
19980705-M-Wimbledon-F-Goran_Ivanisevic-Pete_Sampras,2,B-DTM,2,1,0,0,1,0,2,,,,,,,,,,
19980705-M-Wimbledon-F-Goran_Ivanisevic-Pete_Sampras,2,B-DTL,7,5,3,1,1,5,2,,,,,,,,,,
19980705-M-Wimbledon-F-Goran_Ivanisevic-Pete_Sampras,2,B-IO,2,1,0,0,1,0,2,,,,,,,,,,
19980705-M-Wimbledon-F-Goran_Ivanisevic-Pete_Sampras,2,S-DTL,1,0,0,0,0,0,1,,,,,,,,,,
19980810-M-Cincinnati_Masters-SF-Yevgeny_Kafelnikov-Patrick_Rafter,1,F-XC,9,5,0,2,3,3,6,,,,,,,,,,
19980810-M-Cincinnati_Masters-SF-Yevgeny_Kafelnikov-Patrick_Rafter,1,F-DTM,5,0,0,0,0,2,3,,,,,,,,,,
19980810-M-Cincinnati_Masters-SF-Yevgeny_Kafelnikov-Patrick_Rafter,1,F-DTL,5,3,0,2,1,3,2,,,,,,,,,,
19980810-M-Cincinnati_Masters-SF-Yevgeny_Kafelnikov-Patrick_Rafter,1,F-IO,15,0,0,0,0,8,7,,,,,,,,,,
19980810-M-Cincinnati_Masters-SF-Yevgeny_Kafelnikov-Patrick_Rafter,1,B-XC,29,7,1,1,5,11,18,,,,,,,,,,
19980810-M-Cincinnati_Masters-SF-Yevgeny_Kafelnikov-Patrick_Rafter,1,B-DTM,6,0,0,0,0,1,5,,,,,,,,,,
19980810-M-Cincinnati_Masters-SF-Yevgeny_Kafelnikov-Patrick_Rafter,1,B-DTL,4,4,0,0,4,0,4,,,,,,,,,,
19980810-M-Cincinnati_Masters-SF-Yevgeny_Kafelnikov-Patrick_Rafter,1,B-IO,2,1,0,0,1,1,1,,,,,,,,,,
19980810-M-Cincinnati_Masters-SF-Yevgeny_Kafelnikov-Patrick_Rafter,1,S-XC,8,2,0,0,2,1,7,,,,,,,,,,
19980810-M-Cincinnati_Masters-SF-Yevgeny_Kafelnikov-Patrick_Rafter,1,S-DTM,1,0,0,0,0,1,0,,,,,,,,,,
19980810-M-Cincinnati_Masters-SF-Yevgeny_Kafelnikov-Patrick_Rafter,1,S-DTL,2,0,0,0,0,1,1,,,,,,,,,,
19980810-M-Cincinnati_Masters-SF-Yevgeny_Kafelnikov-Patrick_Rafter,2,F-XC,10,4,3,0,1,5,5,,,,,,,,,,
19980810-M-Cincinnati_Masters-SF-Yevgeny_Kafelnikov-Patrick_Rafter,2,F-DTM,4,0,0,0,0,1,3,,,,,,,,,,
19980810-M-Cincinnati_Masters-SF-Yevgeny_Kafelnikov-Patrick_Rafter,2,F-DTL,4,2,0,2,0,3,1,,,,,,,,,,
19980810-M-Cincinnati_Masters-SF-Yevgeny_Kafelnikov-Patrick_Rafter,2,F-IO,3,2,0,0,2,1,2,,,,,,,,,,
19980810-M-Cincinnati_Masters-SF-Yevgeny_Kafelnikov-Patrick_Rafter,2,B-XC,10,1,0,0,1,6,4,,,,,,,,,,
19980810-M-Cincinnati_Masters-SF-Yevgeny_Kafelnikov-Patrick_Rafter,2,B-DTM,2,0,0,0,0,0,2,,,,,,,,,,
19980810-M-Cincinnati_Masters-SF-Yevgeny_Kafelnikov-Patrick_Rafter,2,B-DTL,4,2,2,0,0,2,2,,,,,,,,,,
19980810-M-Cincinnati_Masters-SF-Yevgeny_Kafelnikov-Patrick_Rafter,2,S-XC,21,1,0,0,1,11,10,,,,,,,,,,
19980810-M-Cincinnati_Masters-SF-Yevgeny_Kafelnikov-Patrick_Rafter,2,S-DTM,5,0,0,0,0,4,1,,,,,,,,,,
19980810-M-Cincinnati_Masters-SF-Yevgeny_Kafelnikov-Patrick_Rafter,2,S-DTL,5,2,1,1,0,5,0,,,,,,,,,,
19980810-M-Cincinnati_Masters-SF-Yevgeny_Kafelnikov-Patrick_Rafter,2,S-IO,1,0,0,0,0,1,0,,,,,,,,,,
19980817-M-New_Haven-R32-Pete_Sampras-Lleyton_Hewitt,1,F-XC,15,6,0,1,5,7,8,,,,,,,,,,
19980817-M-New_Haven-R32-Pete_Sampras-Lleyton_Hewitt,1,F-DTM,4,1,0,0,1,1,3,,,,,,,,,,
19980817-M-New_Haven-R32-Pete_Sampras-Lleyton_Hewitt,1,F-DTL,7,3,1,1,1,2,5,,,,,,,,,,
19980817-M-New_Haven-R32-Pete_Sampras-Lleyton_Hewitt,1,F-IO,13,8,1,3,4,7,6,,,,,,,,,,
19980817-M-New_Haven-R32-Pete_Sampras-Lleyton_Hewitt,1,F-II,6,4,1,1,2,3,3,,,,,,,,,,
19980817-M-New_Haven-R32-Pete_Sampras-Lleyton_Hewitt,1,B-XC,34,5,0,0,5,22,12,,,,,,,,,,
19980817-M-New_Haven-R32-Pete_Sampras-Lleyton_Hewitt,1,B-DTM,4,1,0,0,1,1,3,,,,,,,,,,
19980817-M-New_Haven-R32-Pete_Sampras-Lleyton_Hewitt,1,B-DTL,3,3,3,0,0,3,0,,,,,,,,,,
19980817-M-New_Haven-R32-Pete_Sampras-Lleyton_Hewitt,1,S-XC,8,1,0,0,1,6,2,,,,,,,,,,
19980817-M-New_Haven-R32-Pete_Sampras-Lleyton_Hewitt,1,S-DTM,2,0,0,0,0,1,1,,,,,,,,,,
19980817-M-New_Haven-R32-Pete_Sampras-Lleyton_Hewitt,2,F-XC,15,4,0,1,3,9,6,,,,,,,,,,
19980817-M-New_Haven-R32-Pete_Sampras-Lleyton_Hewitt,2,F-DTM,10,1,0,0,1,4,6,,,,,,,,,,
19980817-M-New_Haven-R32-Pete_Sampras-Lleyton_Hewitt,2,F-DTL,5,3,1,1,1,2,3,,,,,,,,,,
19980817-M-New_Haven-R32-Pete_Sampras-Lleyton_Hewitt,2,F-IO,7,1,0,0,1,3,4,,,,,,,,,,
19980817-M-New_Haven-R32-Pete_Sampras-Lleyton_Hewitt,2,F-II,2,1,0,0,1,0,2,,,,,,,,,,
19980817-M-New_Haven-R32-Pete_Sampras-Lleyton_Hewitt,2,B-XC,43,5,1,0,4,13,30,,,,,,,,,,
19980817-M-New_Haven-R32-Pete_Sampras-Lleyton_Hewitt,2,B-DTM,12,1,0,1,0,7,5,,,,,,,,,,
19980817-M-New_Haven-R32-Pete_Sampras-Lleyton_Hewitt,2,B-DTL,5,3,1,1,1,3,2,,,,,,,,,,
19980817-M-New_Haven-R32-Pete_Sampras-Lleyton_Hewitt,2,B-IO,2,2,1,0,1,1,1,,,,,,,,,,
19980817-M-New_Haven-R32-Pete_Sampras-Lleyton_Hewitt,2,S-XC,3,1,0,0,1,1,2,,,,,,,,,,
19981005-M-Basel-R32-Andre_Agassi-Roger_Federer,1,F-XC,24,6,0,1,5,13,11,,,,,,,,,,
19981005-M-Basel-R32-Andre_Agassi-Roger_Federer,1,F-DTM,3,0,0,0,0,1,2,,,,,,,,,,
19981005-M-Basel-R32-Andre_Agassi-Roger_Federer,1,F-DTL,9,4,1,0,3,4,5,,,,,,,,,,
19981005-M-Basel-R32-Andre_Agassi-Roger_Federer,1,F-IO,8,4,1,2,1,6,2,,,,,,,,,,
19981005-M-Basel-R32-Andre_Agassi-Roger_Federer,1,F-II,1,1,0,1,0,1,0,,,,,,,,,,
19981005-M-Basel-R32-Andre_Agassi-Roger_Federer,1,B-XC,41,6,1,2,3,22,19,,,,,,,,,,
19981005-M-Basel-R32-Andre_Agassi-Roger_Federer,1,B-DTM,6,1,0,0,1,3,3,,,,,,,,,,
19981005-M-Basel-R32-Andre_Agassi-Roger_Federer,1,B-DTL,7,1,1,0,0,3,4,,,,,,,,,,
19981005-M-Basel-R32-Andre_Agassi-Roger_Federer,1,B-IO,1,0,0,0,0,1,0,,,,,,,,,,
19981005-M-Basel-R32-Andre_Agassi-Roger_Federer,1,S-XC,8,1,0,0,1,6,2,,,,,,,,,,
19981005-M-Basel-R32-Andre_Agassi-Roger_Federer,2,F-XC,25,6,1,1,4,10,15,,,,,,,,,,
19981005-M-Basel-R32-Andre_Agassi-Roger_Federer,2,F-DTM,6,1,0,0,1,2,4,,,,,,,,,,
19981005-M-Basel-R32-Andre_Agassi-Roger_Federer,2,F-DTL,13,4,1,0,3,6,7,,,,,,,,,,
19981005-M-Basel-R32-Andre_Agassi-Roger_Federer,2,F-IO,11,2,1,1,0,5,6,,,,,,,,,,
19981005-M-Basel-R32-Andre_Agassi-Roger_Federer,2,F-II,6,5,2,0,3,3,3,,,,,,,,,,
19981005-M-Basel-R32-Andre_Agassi-Roger_Federer,2,B-XC,22,4,1,1,2,11,11,,,,,,,,,,
19981005-M-Basel-R32-Andre_Agassi-Roger_Federer,2,B-DTM,10,2,0,0,2,2,8,,,,,,,,,,
19981005-M-Basel-R32-Andre_Agassi-Roger_Federer,2,B-DTL,7,3,0,0,3,2,5,,,,,,,,,,
19981005-M-Basel-R32-Andre_Agassi-Roger_Federer,2,B-IO,1,0,0,0,0,1,0,,,,,,,,,,
19981005-M-Basel-R32-Andre_Agassi-Roger_Federer,2,S-XC,13,2,0,1,1,5,8,,,,,,,,,,
19981005-M-Basel-R32-Andre_Agassi-Roger_Federer,2,S-DTM,3,0,0,0,0,0,3,,,,,,,,,,
19981005-M-Basel-R32-Andre_Agassi-Roger_Federer,2,S-DTL,5,1,0,0,1,1,4,,,,,,,,,,
19981102-M-Paris_Masters-R32-Todd_Woodbridge-Marcelo_Rios,1,F-XC,23,8,1,3,4,8,15,,,,,,,,,,
19981102-M-Paris_Masters-R32-Todd_Woodbridge-Marcelo_Rios,1,F-DTM,3,1,0,0,1,1,2,,,,,,,,,,
19981102-M-Paris_Masters-R32-Todd_Woodbridge-Marcelo_Rios,1,F-DTL,6,1,0,0,1,1,5,,,,,,,,,,
19981102-M-Paris_Masters-R32-Todd_Woodbridge-Marcelo_Rios,1,F-IO,12,4,2,1,1,6,6,,,,,,,,,,
19981102-M-Paris_Masters-R32-Todd_Woodbridge-Marcelo_Rios,1,F-II,1,1,1,0,0,1,0,,,,,,,,,,
19981102-M-Paris_Masters-R32-Todd_Woodbridge-Marcelo_Rios,1,B-XC,9,3,0,2,1,5,4,,,,,,,,,,
19981102-M-Paris_Masters-R32-Todd_Woodbridge-Marcelo_Rios,1,B-DTM,2,0,0,0,0,1,1,,,,,,,,,,
19981102-M-Paris_Masters-R32-Todd_Woodbridge-Marcelo_Rios,1,B-DTL,2,0,0,0,0,2,0,,,,,,,,,,
19981102-M-Paris_Masters-R32-Todd_Woodbridge-Marcelo_Rios,1,S-XC,18,3,0,1,2,7,11,,,,,,,,,,
19981102-M-Paris_Masters-R32-Todd_Woodbridge-Marcelo_Rios,1,S-DTM,19,3,0,2,1,8,11,,,,,,,,,,
19981102-M-Paris_Masters-R32-Todd_Woodbridge-Marcelo_Rios,1,S-DTL,16,4,0,1,3,4,12,,,,,,,,,,
19981102-M-Paris_Masters-R32-Todd_Woodbridge-Marcelo_Rios,1,S-IO,12,2,0,0,2,10,2,,,,,,,,,,
19981102-M-Paris_Masters-R32-Todd_Woodbridge-Marcelo_Rios,2,F-XC,32,2,2,0,0,19,13,,,,,,,,,,
19981102-M-Paris_Masters-R32-Todd_Woodbridge-Marcelo_Rios,2,F-DTM,9,2,0,2,0,5,4,,,,,,,,,,
19981102-M-Paris_Masters-R32-Todd_Woodbridge-Marcelo_Rios,2,F-DTL,5,1,1,0,0,4,1,,,,,,,,,,
19981102-M-Paris_Masters-R32-Todd_Woodbridge-Marcelo_Rios,2,F-IO,7,2,2,0,0,6,1,,,,,,,,,,
19981102-M-Paris_Masters-R32-Todd_Woodbridge-Marcelo_Rios,2,F-II,2,0,0,0,0,1,1,,,,,,,,,,
19981102-M-Paris_Masters-R32-Todd_Woodbridge-Marcelo_Rios,2,B-XC,14,6,1,3,2,10,4,,,,,,,,,,
19981102-M-Paris_Masters-R32-Todd_Woodbridge-Marcelo_Rios,2,B-DTM,26,2,0,0,2,12,14,,,,,,,,,,
19981102-M-Paris_Masters-R32-Todd_Woodbridge-Marcelo_Rios,2,B-DTL,8,1,0,0,1,2,6,,,,,,,,,,
19981102-M-Paris_Masters-R32-Todd_Woodbridge-Marcelo_Rios,2,B-IO,6,2,0,2,0,5,1,,,,,,,,,,
19981102-M-Paris_Masters-R32-Todd_Woodbridge-Marcelo_Rios,2,S-DTM,1,0,0,0,0,1,0,,,,,,,,,,
19981102-M-Paris_Masters-R32-Todd_Woodbridge-Marcelo_Rios,2,S-DTL,1,0,0,0,0,0,1,,,,,,,,,,
19981102-M-Paris_Masters-R32-Todd_Woodbridge-Marcelo_Rios,2,S-IO,1,1,0,0,1,0,1,,,,,,,,,,
19981123-M-Tour_Finals-RR-Pete_Sampras-Carlos_Moya,1,F-XC,9,4,3,0,1,5,4,,,,,,,,,,
19981123-M-Tour_Finals-RR-Pete_Sampras-Carlos_Moya,1,F-DTM,1,1,0,0,1,0,1,,,,,,,,,,
19981123-M-Tour_Finals-RR-Pete_Sampras-Carlos_Moya,1,F-DTL,3,1,1,0,0,1,2,,,,,,,,,,
19981123-M-Tour_Finals-RR-Pete_Sampras-Carlos_Moya,1,F-IO,1,1,0,0,1,0,1,,,,,,,,,,
19981123-M-Tour_Finals-RR-Pete_Sampras-Carlos_Moya,1,F-II,1,1,0,0,1,0,1,,,,,,,,,,
19981123-M-Tour_Finals-RR-Pete_Sampras-Carlos_Moya,1,B-XC,6,4,1,1,2,3,3,,,,,,,,,,
19981123-M-Tour_Finals-RR-Pete_Sampras-Carlos_Moya,1,B-DTM,1,1,0,0,1,0,1,,,,,,,,,,
19981123-M-Tour_Finals-RR-Pete_Sampras-Carlos_Moya,1,B-DTL,2,0,0,0,0,1,1,,,,,,,,,,
19981123-M-Tour_Finals-RR-Pete_Sampras-Carlos_Moya,1,S-XC,1,0,0,0,0,1,0,,,,,,,,,,
19981123-M-Tour_Finals-RR-Pete_Sampras-Carlos_Moya,1,S-DTM,1,0,0,0,0,0,1,,,,,,,,,,
19981123-M-Tour_Finals-RR-Pete_Sampras-Carlos_Moya,2,F-XC,4,1,0,0,1,2,2,,,,,,,,,,
19981123-M-Tour_Finals-RR-Pete_Sampras-Carlos_Moya,2,F-DTM,3,1,0,0,1,0,3,,,,,,,,,,
19981123-M-Tour_Finals-RR-Pete_Sampras-Carlos_Moya,2,F-DTL,2,2,1,1,0,2,0,,,,,,,,,,
19981123-M-Tour_Finals-RR-Pete_Sampras-Carlos_Moya,2,F-IO,6,2,1,0,1,3,3,,,,,,,,,,
19981123-M-Tour_Finals-RR-Pete_Sampras-Carlos_Moya,2,F-II,1,0,0,0,0,0,1,,,,,,,,,,
19981123-M-Tour_Finals-RR-Pete_Sampras-Carlos_Moya,2,B-XC,6,3,1,1,1,4,2,,,,,,,,,,
19981123-M-Tour_Finals-RR-Pete_Sampras-Carlos_Moya,2,B-DTM,2,1,0,0,1,0,2,,,,,,,,,,
19981123-M-Tour_Finals-RR-Pete_Sampras-Carlos_Moya,2,B-DTL,3,1,1,0,0,3,0,,,,,,,,,,
19981123-M-Tour_Finals-RR-Pete_Sampras-Carlos_Moya,2,B-IO,2,1,1,0,0,2,0,,,,,,,,,,
19981123-M-Tour_Finals-RR-Pete_Sampras-Carlos_Moya,2,S-XC,1,0,0,0,0,0,1,,,,,,,,,,
19981123-M-Tour_Finals-RR-Pete_Sampras-Carlos_Moya,2,S-DTM,1,1,0,0,1,0,1,,,,,,,,,,
19981123-M-Tour_Finals-RR-Pete_Sampras-Karol_Kucera,1,F-XC,14,8,0,4,4,7,7,,,,,,,,,,
19981123-M-Tour_Finals-RR-Pete_Sampras-Karol_Kucera,1,F-DTM,6,1,0,0,1,2,4,,,,,,,,,,
19981123-M-Tour_Finals-RR-Pete_Sampras-Karol_Kucera,1,F-DTL,3,1,1,0,0,3,0,,,,,,,,,,
19981123-M-Tour_Finals-RR-Pete_Sampras-Karol_Kucera,1,F-IO,2,1,1,0,0,1,1,,,,,,,,,,
19981123-M-Tour_Finals-RR-Pete_Sampras-Karol_Kucera,1,B-XC,16,3,1,1,1,11,5,,,,,,,,,,
19981123-M-Tour_Finals-RR-Pete_Sampras-Karol_Kucera,1,B-DTM,7,0,0,0,0,6,1,,,,,,,,,,
19981123-M-Tour_Finals-RR-Pete_Sampras-Karol_Kucera,1,B-DTL,6,5,3,0,2,3,3,,,,,,,,,,
19981123-M-Tour_Finals-RR-Pete_Sampras-Karol_Kucera,1,B-IO,1,1,1,0,0,1,0,,,,,,,,,,
19981123-M-Tour_Finals-RR-Pete_Sampras-Karol_Kucera,1,S-XC,9,0,0,0,0,7,2,,,,,,,,,,
19981123-M-Tour_Finals-RR-Pete_Sampras-Karol_Kucera,2,F-XC,14,6,3,1,2,8,6,,,,,,,,,,
19981123-M-Tour_Finals-RR-Pete_Sampras-Karol_Kucera,2,F-DTM,4,1,1,0,0,3,1,,,,,,,,,,
19981123-M-Tour_Finals-RR-Pete_Sampras-Karol_Kucera,2,F-DTL,3,2,0,1,1,1,2,,,,,,,,,,
19981123-M-Tour_Finals-RR-Pete_Sampras-Karol_Kucera,2,F-IO,10,3,0,0,3,1,9,,,,,,,,,,
19981123-M-Tour_Finals-RR-Pete_Sampras-Karol_Kucera,2,B-XC,25,4,1,1,2,8,17,,,,,,,,,,
19981123-M-Tour_Finals-RR-Pete_Sampras-Karol_Kucera,2,B-DTM,9,0,0,0,0,5,4,,,,,,,,,,
19981123-M-Tour_Finals-RR-Pete_Sampras-Karol_Kucera,2,B-DTL,8,3,2,0,1,3,5,,,,,,,,,,
19981123-M-Tour_Finals-RR-Pete_Sampras-Karol_Kucera,2,S-XC,2,0,0,0,0,1,1,,,,,,,,,,
19981123-M-Tour_Finals-RR-Pete_Sampras-Karol_Kucera,2,S-DTM,3,1,0,0,1,0,3,,,,,,,,,,
19981123-M-Tour_Finals-RR-Pete_Sampras-Karol_Kucera,2,S-DTL,1,0,0,0,0,1,0,,,,,,,,,,
19990508-M-Hamburg_Masters-SF-Marcelo_Rios-Carlos_Moya,1,F-XC,73,11,2,5,4,43,30,,,,,,,,,,
19990508-M-Hamburg_Masters-SF-Marcelo_Rios-Carlos_Moya,1,F-DTM,11,1,0,0,1,8,3,,,,,,,,,,
19990508-M-Hamburg_Masters-SF-Marcelo_Rios-Carlos_Moya,1,F-DTL,6,3,0,2,1,4,2,,,,,,,,,,
19990508-M-Hamburg_Masters-SF-Marcelo_Rios-Carlos_Moya,1,F-IO,20,8,1,2,5,10,10,,,,,,,,,,
19990508-M-Hamburg_Masters-SF-Marcelo_Rios-Carlos_Moya,1,F-II,3,0,0,0,0,2,1,,,,,,,,,,
19990508-M-Hamburg_Masters-SF-Marcelo_Rios-Carlos_Moya,1,B-XC,83,21,1,6,14,43,40,,,,,,,,,,
19990508-M-Hamburg_Masters-SF-Marcelo_Rios-Carlos_Moya,1,B-DTM,38,2,0,1,1,25,13,,,,,,,,,,
19990508-M-Hamburg_Masters-SF-Marcelo_Rios-Carlos_Moya,1,B-DTL,37,4,0,1,3,26,11,,,,,,,,,,
19990508-M-Hamburg_Masters-SF-Marcelo_Rios-Carlos_Moya,1,B-IO,9,2,1,0,1,4,5,,,,,,,,,,
19990508-M-Hamburg_Masters-SF-Marcelo_Rios-Carlos_Moya,1,S-XC,4,0,0,0,0,2,2,,,,,,,,,,
19990508-M-Hamburg_Masters-SF-Marcelo_Rios-Carlos_Moya,1,S-DTM,2,0,0,0,0,1,1,,,,,,,,,,
19990508-M-Hamburg_Masters-SF-Marcelo_Rios-Carlos_Moya,1,S-DTL,3,0,0,0,0,2,1,,,,,,,,,,
19990508-M-Hamburg_Masters-SF-Marcelo_Rios-Carlos_Moya,2,F-XC,79,11,2,2,7,28,51,,,,,,,,,,
19990508-M-Hamburg_Masters-SF-Marcelo_Rios-Carlos_Moya,2,F-DTM,23,1,0,0,1,13,10,,,,,,,,,,
19990508-M-Hamburg_Masters-SF-Marcelo_Rios-Carlos_Moya,2,F-DTL,11,5,2,1,2,6,5,,,,,,,,,,
19990508-M-Hamburg_Masters-SF-Marcelo_Rios-Carlos_Moya,2,F-IO,30,9,2,3,4,14,16,,,,,,,,,,
19990508-M-Hamburg_Masters-SF-Marcelo_Rios-Carlos_Moya,2,F-II,21,4,0,0,4,10,11,,,,,,,,,,
19990508-M-Hamburg_Masters-SF-Marcelo_Rios-Carlos_Moya,2,B-XC,30,4,0,1,3,12,18,,,,,,,,,,
19990508-M-Hamburg_Masters-SF-Marcelo_Rios-Carlos_Moya,2,B-DTM,33,3,0,1,2,14,19,,,,,,,,,,
19990508-M-Hamburg_Masters-SF-Marcelo_Rios-Carlos_Moya,2,B-DTL,31,3,0,1,2,8,23,,,,,,,,,,
19990508-M-Hamburg_Masters-SF-Marcelo_Rios-Carlos_Moya,2,B-IO,6,2,0,0,2,1,5,,,,,,,,,,
19990508-M-Hamburg_Masters-SF-Marcelo_Rios-Carlos_Moya,2,S-XC,4,1,0,0,1,2,2,,,,,,,,,,
19990508-M-Hamburg_Masters-SF-Marcelo_Rios-Carlos_Moya,2,S-DTM,6,0,0,0,0,4,2,,,,,,,,,,
19990508-M-Hamburg_Masters-SF-Marcelo_Rios-Carlos_Moya,2,S-DTL,12,1,0,0,1,6,6,,,,,,,,,,
19990704-M-Wimbledon-F-Pete_Sampras-Andre_Agassi,1,F-XC,5,2,1,1,0,3,2,,,,,,,,,,
19990704-M-Wimbledon-F-Pete_Sampras-Andre_Agassi,1,F-DTM,5,1,1,0,0,3,2,,,,,,,,,,
19990704-M-Wimbledon-F-Pete_Sampras-Andre_Agassi,1,F-DTL,4,3,2,0,1,2,2,,,,,,,,,,
19990704-M-Wimbledon-F-Pete_Sampras-Andre_Agassi,1,F-IO,1,1,1,0,0,1,0,,,,,,,,,,
19990704-M-Wimbledon-F-Pete_Sampras-Andre_Agassi,1,B-XC,6,4,2,2,0,5,1,,,,,,,,,,
19990704-M-Wimbledon-F-Pete_Sampras-Andre_Agassi,1,B-DTM,4,0,0,0,0,3,1,,,,,,,,,,
19990704-M-Wimbledon-F-Pete_Sampras-Andre_Agassi,1,B-DTL,7,3,2,0,1,4,3,,,,,,,,,,
19990704-M-Wimbledon-F-Pete_Sampras-Andre_Agassi,1,S-XC,4,0,0,0,0,3,1,,,,,,,,,,
19990704-M-Wimbledon-F-Pete_Sampras-Andre_Agassi,1,S-DTL,6,1,0,1,0,5,1,,,,,,,,,,
19990704-M-Wimbledon-F-Pete_Sampras-Andre_Agassi,2,F-XC,17,11,5,3,3,11,6,,,,,,,,,,
19990704-M-Wimbledon-F-Pete_Sampras-Andre_Agassi,2,F-DTM,3,0,0,0,0,1,2,,,,,,,,,,
19990704-M-Wimbledon-F-Pete_Sampras-Andre_Agassi,2,F-DTL,9,4,1,3,0,4,5,,,,,,,,,,
19990704-M-Wimbledon-F-Pete_Sampras-Andre_Agassi,2,F-IO,5,2,1,1,0,3,2,,,,,,,,,,
19990704-M-Wimbledon-F-Pete_Sampras-Andre_Agassi,2,B-XC,26,8,2,3,3,11,15,,,,,,,,,,
19990704-M-Wimbledon-F-Pete_Sampras-Andre_Agassi,2,B-DTM,4,0,0,0,0,1,3,,,,,,,,,,
19990704-M-Wimbledon-F-Pete_Sampras-Andre_Agassi,2,B-DTL,7,4,1,2,1,4,3,,,,,,,,,,
19990704-M-Wimbledon-F-Pete_Sampras-Andre_Agassi,2,B-IO,7,6,2,1,3,4,3,,,,,,,,,,
19990704-M-Wimbledon-F-Pete_Sampras-Andre_Agassi,2,S-DTL,3,0,0,0,0,1,2,,,,,,,,,,
19990912-M-US_Open-F-Todd_Martin-Andre_Agassi,1,F-XC,31,6,2,2,2,17,14,,,,,,,,,,
19990912-M-US_Open-F-Todd_Martin-Andre_Agassi,1,F-DTM,25,4,0,0,4,8,17,,,,,,,,,,
19990912-M-US_Open-F-Todd_Martin-Andre_Agassi,1,F-DTL,12,8,3,1,4,7,5,,,,,,,,,,
19990912-M-US_Open-F-Todd_Martin-Andre_Agassi,1,F-IO,12,5,2,0,3,6,6,,,,,,,,,,
19990912-M-US_Open-F-Todd_Martin-Andre_Agassi,1,F-II,2,2,0,0,2,0,2,,,,,,,,,,
19990912-M-US_Open-F-Todd_Martin-Andre_Agassi,1,B-XC,29,6,4,1,1,14,15,,,,,,,,,,
19990912-M-US_Open-F-Todd_Martin-Andre_Agassi,1,B-DTM,23,2,0,0,2,7,16,,,,,,,,,,
19990912-M-US_Open-F-Todd_Martin-Andre_Agassi,1,B-DTL,14,10,5,1,4,10,4,,,,,,,,,,
19990912-M-US_Open-F-Todd_Martin-Andre_Agassi,1,B-IO,9,5,2,1,2,6,3,,,,,,,,,,
19990912-M-US_Open-F-Todd_Martin-Andre_Agassi,1,B-II,1,1,0,1,0,1,0,,,,,,,,,,
19990912-M-US_Open-F-Todd_Martin-Andre_Agassi,1,S-XC,24,1,0,1,0,11,13,,,,,,,,,,
19990912-M-US_Open-F-Todd_Martin-Andre_Agassi,1,S-DTM,15,3,2,0,1,5,10,,,,,,,,,,
19990912-M-US_Open-F-Todd_Martin-Andre_Agassi,1,S-DTL,1,0,0,0,0,1,0,,,,,,,,,,
19990912-M-US_Open-F-Todd_Martin-Andre_Agassi,1,S-IO,1,0,0,0,0,0,1,,,,,,,,,,
19990912-M-US_Open-F-Todd_Martin-Andre_Agassi,2,F-XC,52,14,9,4,1,33,19,,,,,,,,,,
19990912-M-US_Open-F-Todd_Martin-Andre_Agassi,2,F-DTM,31,4,0,1,3,15,16,,,,,,,,,,
19990912-M-US_Open-F-Todd_Martin-Andre_Agassi,2,F-DTL,11,8,2,4,2,7,4,,,,,,,,,,
19990912-M-US_Open-F-Todd_Martin-Andre_Agassi,2,F-IO,18,5,2,1,2,11,7,,,,,,,,,,
19990912-M-US_Open-F-Todd_Martin-Andre_Agassi,2,F-II,4,3,0,1,2,2,2,,,,,,,,,,
19990912-M-US_Open-F-Todd_Martin-Andre_Agassi,2,B-XC,62,12,3,4,5,36,26,,,,,,,,,,
19990912-M-US_Open-F-Todd_Martin-Andre_Agassi,2,B-DTM,23,2,0,1,1,12,11,,,,,,,,,,
19990912-M-US_Open-F-Todd_Martin-Andre_Agassi,2,B-DTL,9,5,4,1,0,6,3,,,,,,,,,,
19990912-M-US_Open-F-Todd_Martin-Andre_Agassi,2,B-IO,7,3,1,1,1,3,4,,,,,,,,,,
19990912-M-US_Open-F-Todd_Martin-Andre_Agassi,2,S-XC,6,1,0,1,0,5,1,,,,,,,,,,
19990912-M-US_Open-F-Todd_Martin-Andre_Agassi,2,S-DTM,6,0,0,0,0,2,4,,,,,,,,,,
19990912-M-US_Open-F-Todd_Martin-Andre_Agassi,2,S-DTL,3,3,1,2,0,3,0,,,,,,,,,,
19991122-M-Tour_Finals-RR-Pete_Sampras-Andre_Agassi,1,F-XC,5,4,1,0,3,1,4,,,,,,,,,,
19991122-M-Tour_Finals-RR-Pete_Sampras-Andre_Agassi,1,F-DTM,2,1,0,0,1,1,1,,,,,,,,,,
19991122-M-Tour_Finals-RR-Pete_Sampras-Andre_Agassi,1,F-DTL,1,0,0,0,0,0,1,,,,,,,,,,
19991122-M-Tour_Finals-RR-Pete_Sampras-Andre_Agassi,1,F-IO,4,0,0,0,0,0,4,,,,,,,,,,
19991122-M-Tour_Finals-RR-Pete_Sampras-Andre_Agassi,1,B-XC,11,3,1,0,2,5,6,,,,,,,,,,
19991122-M-Tour_Finals-RR-Pete_Sampras-Andre_Agassi,1,B-DTM,6,0,0,0,0,0,6,,,,,,,,,,
19991122-M-Tour_Finals-RR-Pete_Sampras-Andre_Agassi,1,B-DTL,3,2,1,0,1,1,2,,,,,,,,,,
19991122-M-Tour_Finals-RR-Pete_Sampras-Andre_Agassi,1,S-XC,3,1,0,0,1,1,2,,,,,,,,,,
19991122-M-Tour_Finals-RR-Pete_Sampras-Andre_Agassi,1,S-DTM,2,1,0,0,1,0,2,,,,,,,,,,
19991122-M-Tour_Finals-RR-Pete_Sampras-Andre_Agassi,2,F-XC,8,4,2,2,0,8,0,,,,,,,,,,
19991122-M-Tour_Finals-RR-Pete_Sampras-Andre_Agassi,2,F-DTM,4,0,0,0,0,3,1,,,,,,,,,,
19991122-M-Tour_Finals-RR-Pete_Sampras-Andre_Agassi,2,F-DTL,1,1,0,1,0,1,0,,,,,,,,,,
19991122-M-Tour_Finals-RR-Pete_Sampras-Andre_Agassi,2,F-IO,6,0,0,0,0,4,2,,,,,,,,,,
19991122-M-Tour_Finals-RR-Pete_Sampras-Andre_Agassi,2,B-XC,19,4,1,2,1,13,6,,,,,,,,,,
19991122-M-Tour_Finals-RR-Pete_Sampras-Andre_Agassi,2,B-DTM,6,1,0,0,1,5,1,,,,,,,,,,
19991122-M-Tour_Finals-RR-Pete_Sampras-Andre_Agassi,2,B-DTL,6,5,3,1,1,4,2,,,,,,,,,,
19991122-M-Tour_Finals-RR-Pete_Sampras-Andre_Agassi,2,B-IO,3,2,2,0,0,2,1,,,,,,,,,,
19991122-M-Tour_Finals-RR-Pete_Sampras-Andre_Agassi,2,S-XC,2,0,0,0,0,2,0,,,,,,,,,,
19991122-M-Tour_Finals-RR-Pete_Sampras-Andre_Agassi,2,S-DTM,1,0,0,0,0,1,0,,,,,,,,,,
20000612-M-Queens_Club-QF-Bob_Bryan-Pete_Sampras,1,F-XC,8,0,0,0,0,5,3,,,,,,,,,,
20000612-M-Queens_Club-QF-Bob_Bryan-Pete_Sampras,1,F-DTM,8,2,0,2,0,3,5,,,,,,,,,,
20000612-M-Queens_Club-QF-Bob_Bryan-Pete_Sampras,1,F-DTL,2,1,0,0,1,1,1,,,,,,,,,,
20000612-M-Queens_Club-QF-Bob_Bryan-Pete_Sampras,1,F-IO,2,1,0,0,1,1,1,,,,,,,,,,
20000612-M-Queens_Club-QF-Bob_Bryan-Pete_Sampras,1,B-DTM,1,0,0,0,0,0,1,,,,,,,,,,
20000612-M-Queens_Club-QF-Bob_Bryan-Pete_Sampras,1,B-DTL,1,0,0,0,0,0,1,,,,,,,,,,
20000612-M-Queens_Club-QF-Bob_Bryan-Pete_Sampras,1,B-IO,1,0,0,0,0,0,1,,,,,,,,,,
20000612-M-Queens_Club-QF-Bob_Bryan-Pete_Sampras,1,S-DTL,2,0,0,0,0,0,2,,,,,,,,,,
20000612-M-Queens_Club-QF-Bob_Bryan-Pete_Sampras,1,S-IO,2,1,0,1,0,2,0,,,,,,,,,,
20000612-M-Queens_Club-QF-Bob_Bryan-Pete_Sampras,2,F-XC,7,5,3,1,1,5,2,,,,,,,,,,
20000612-M-Queens_Club-QF-Bob_Bryan-Pete_Sampras,2,F-DTM,1,0,0,0,0,0,1,,,,,,,,,,
20000612-M-Queens_Club-QF-Bob_Bryan-Pete_Sampras,2,F-IO,1,1,1,0,0,1,0,,,,,,,,,,
20000612-M-Queens_Club-QF-Bob_Bryan-Pete_Sampras,2,F-II,1,0,0,0,0,1,0,,,,,,,,,,
20000612-M-Queens_Club-QF-Bob_Bryan-Pete_Sampras,2,B-XC,5,3,0,0,3,0,5,,,,,,,,,,
20000612-M-Queens_Club-QF-Bob_Bryan-Pete_Sampras,2,B-DTM,3,1,1,0,0,2,1,,,,,,,,,,
20000612-M-Queens_Club-QF-Bob_Bryan-Pete_Sampras,2,B-DTL,1,1,1,0,0,1,0,,,,,,,,,,
20000612-M-Queens_Club-QF-Bob_Bryan-Pete_Sampras,2,B-IO,2,1,1,0,0,1,1,,,,,,,,,,
20000612-M-Queens_Club-QF-Bob_Bryan-Pete_Sampras,2,S-XC,4,1,0,1,0,3,1,,,,,,,,,,
20000612-M-Queens_Club-QF-Bob_Bryan-Pete_Sampras,2,S-DTM,3,0,0,0,0,1,2,,,,,,,,,,
20000612-M-Queens_Club-QF-Bob_Bryan-Pete_Sampras,2,S-IO,1,0,0,0,0,1,0,,,,,,,,,,
20000910-M-US_Open-F-Pete_Sampras-Marat_Safin,1,F-XC,24,8,4,0,4,12,12,,,,,,,,,,
20000910-M-US_Open-F-Pete_Sampras-Marat_Safin,1,F-DTM,6,0,0,0,0,3,3,,,,,,,,,,
20000910-M-US_Open-F-Pete_Sampras-Marat_Safin,1,F-IO,4,1,0,0,1,1,3,,,,,,,,,,
20000910-M-US_Open-F-Pete_Sampras-Marat_Safin,1,F-II,6,4,2,1,1,3,3,,,,,,,,,,
20000910-M-US_Open-F-Pete_Sampras-Marat_Safin,1,B-XC,19,5,0,0,5,6,13,,,,,,,,,,
20000910-M-US_Open-F-Pete_Sampras-Marat_Safin,1,B-DTM,12,1,0,0,1,5,7,,,,,,,,,,
20000910-M-US_Open-F-Pete_Sampras-Marat_Safin,1,B-DTL,4,2,1,0,1,2,2,,,,,,,,,,
20000910-M-US_Open-F-Pete_Sampras-Marat_Safin,1,B-IO,3,2,0,0,2,1,2,,,,,,,,,,
20000910-M-US_Open-F-Pete_Sampras-Marat_Safin,1,S-XC,11,0,0,0,0,3,8,,,,,,,,,,
20000910-M-US_Open-F-Pete_Sampras-Marat_Safin,1,S-DTM,9,0,0,0,0,3,6,,,,,,,,,,
20000910-M-US_Open-F-Pete_Sampras-Marat_Safin,1,S-DTL,4,1,0,0,1,0,4,,,,,,,,,,
20000910-M-US_Open-F-Pete_Sampras-Marat_Safin,1,S-IO,1,0,0,0,0,0,1,,,,,,,,,,
20000910-M-US_Open-F-Pete_Sampras-Marat_Safin,2,F-XC,26,11,4,2,5,15,11,,,,,,,,,,
20000910-M-US_Open-F-Pete_Sampras-Marat_Safin,2,F-DTM,18,0,0,0,0,9,9,,,,,,,,,,
20000910-M-US_Open-F-Pete_Sampras-Marat_Safin,2,F-DTL,14,5,4,1,0,11,3,,,,,,,,,,
20000910-M-US_Open-F-Pete_Sampras-Marat_Safin,2,F-IO,9,0,0,0,0,5,4,,,,,,,,,,
20000910-M-US_Open-F-Pete_Sampras-Marat_Safin,2,B-XC,54,9,5,1,3,35,19,,,,,,,,,,
20000910-M-US_Open-F-Pete_Sampras-Marat_Safin,2,B-DTM,15,0,0,0,0,8,7,,,,,,,,,,
20000910-M-US_Open-F-Pete_Sampras-Marat_Safin,2,B-DTL,5,4,2,1,1,4,1,,,,,,,,,,
20000910-M-US_Open-F-Pete_Sampras-Marat_Safin,2,B-IO,1,1,0,1,0,1,0,,,,,,,,,,
20000910-M-US_Open-F-Pete_Sampras-Marat_Safin,2,S-XC,6,1,1,0,0,3,3,,,,,,,,,,
20000910-M-US_Open-F-Pete_Sampras-Marat_Safin,2,S-DTM,1,0,0,0,0,0,1,,,,,,,,,,
20001127-M-Tour_Finals-SF-Marat_Safin-Andre_Agassi,1,F-XC,39,6,3,2,1,17,22,,,,,,,,,,
20001127-M-Tour_Finals-SF-Marat_Safin-Andre_Agassi,1,F-DTM,21,4,0,1,3,12,9,,,,,,,,,,
20001127-M-Tour_Finals-SF-Marat_Safin-Andre_Agassi,1,F-DTL,10,5,1,0,4,2,8,,,,,,,,,,
20001127-M-Tour_Finals-SF-Marat_Safin-Andre_Agassi,1,F-IO,7,3,0,0,3,2,5,,,,,,,,,,
20001127-M-Tour_Finals-SF-Marat_Safin-Andre_Agassi,1,F-II,1,0,0,0,0,0,1,,,,,,,,,,
20001127-M-Tour_Finals-SF-Marat_Safin-Andre_Agassi,1,B-XC,60,6,1,1,4,26,34,,,,,,,,,,
20001127-M-Tour_Finals-SF-Marat_Safin-Andre_Agassi,1,B-DTM,20,2,0,1,1,9,11,,,,,,,,,,
20001127-M-Tour_Finals-SF-Marat_Safin-Andre_Agassi,1,B-DTL,23,10,7,0,3,13,10,,,,,,,,,,
20001127-M-Tour_Finals-SF-Marat_Safin-Andre_Agassi,1,B-IO,1,0,0,0,0,1,0,,,,,,,,,,
20001127-M-Tour_Finals-SF-Marat_Safin-Andre_Agassi,1,S-XC,7,2,0,2,0,3,4,,,,,,,,,,
20001127-M-Tour_Finals-SF-Marat_Safin-Andre_Agassi,1,S-DTM,4,0,0,0,0,1,3,,,,,,,,,,
20001127-M-Tour_Finals-SF-Marat_Safin-Andre_Agassi,1,S-DTL,1,0,0,0,0,0,1,,,,,,,,,,
20001127-M-Tour_Finals-SF-Marat_Safin-Andre_Agassi,2,F-XC,48,10,2,5,3,30,18,,,,,,,,,,
20001127-M-Tour_Finals-SF-Marat_Safin-Andre_Agassi,2,F-DTM,19,1,0,0,1,10,9,,,,,,,,,,
20001127-M-Tour_Finals-SF-Marat_Safin-Andre_Agassi,2,F-DTL,11,3,1,1,1,7,4,,,,,,,,,,
20001127-M-Tour_Finals-SF-Marat_Safin-Andre_Agassi,2,F-IO,11,5,2,3,0,6,5,,,,,,,,,,
20001127-M-Tour_Finals-SF-Marat_Safin-Andre_Agassi,2,F-II,1,1,0,0,1,0,1,,,,,,,,,,
20001127-M-Tour_Finals-SF-Marat_Safin-Andre_Agassi,2,B-XC,72,8,2,3,3,43,29,,,,,,,,,,
20001127-M-Tour_Finals-SF-Marat_Safin-Andre_Agassi,2,B-DTM,15,0,0,0,0,11,4,,,,,,,,,,
20001127-M-Tour_Finals-SF-Marat_Safin-Andre_Agassi,2,B-DTL,7,3,3,0,0,6,1,,,,,,,,,,
20001127-M-Tour_Finals-SF-Marat_Safin-Andre_Agassi,2,B-IO,3,1,0,0,1,1,2,,,,,,,,,,
20001127-M-Tour_Finals-SF-Marat_Safin-Andre_Agassi,2,S-XC,6,1,0,1,0,5,1,,,,,,,,,,
20001127-M-Tour_Finals-SF-Marat_Safin-Andre_Agassi,2,S-DTM,1,0,0,0,0,0,1,,,,,,,,,,
20001127-M-Tour_Finals-SF-Marat_Safin-Andre_Agassi,2,S-DTL,1,1,0,1,0,1,0,,,,,,,,,,
20010312-M-Indian_Wells-QF-Nicolas_Lapentti-Andre_Agassi,1,F-XC,22,4,2,1,1,9,13,,,,,,,,,,
20010312-M-Indian_Wells-QF-Nicolas_Lapentti-Andre_Agassi,1,F-DTM,10,1,0,1,0,4,6,,,,,,,,,,
20010312-M-Indian_Wells-QF-Nicolas_Lapentti-Andre_Agassi,1,F-DTL,8,2,0,0,2,1,7,,,,,,,,,,
20010312-M-Indian_Wells-QF-Nicolas_Lapentti-Andre_Agassi,1,F-IO,18,3,0,1,2,7,11,,,,,,,,,,
20010312-M-Indian_Wells-QF-Nicolas_Lapentti-Andre_Agassi,1,F-II,5,2,1,0,1,1,4,,,,,,,,,,
20010312-M-Indian_Wells-QF-Nicolas_Lapentti-Andre_Agassi,1,B-XC,13,1,0,0,1,5,8,,,,,,,,,,
20010312-M-Indian_Wells-QF-Nicolas_Lapentti-Andre_Agassi,1,B-DTM,26,4,0,2,2,10,16,,,,,,,,,,
20010312-M-Indian_Wells-QF-Nicolas_Lapentti-Andre_Agassi,1,B-DTL,10,5,1,1,3,4,6,,,,,,,,,,
20010312-M-Indian_Wells-QF-Nicolas_Lapentti-Andre_Agassi,1,B-IO,1,1,0,0,1,0,1,,,,,,,,,,
20010312-M-Indian_Wells-QF-Nicolas_Lapentti-Andre_Agassi,1,S-XC,11,0,0,0,0,5,6,,,,,,,,,,
20010312-M-Indian_Wells-QF-Nicolas_Lapentti-Andre_Agassi,1,S-DTM,11,1,0,0,1,3,8,,,,,,,,,,
20010312-M-Indian_Wells-QF-Nicolas_Lapentti-Andre_Agassi,1,S-IO,1,0,0,0,0,0,1,,,,,,,,,,
20010312-M-Indian_Wells-QF-Nicolas_Lapentti-Andre_Agassi,2,F-XC,23,6,0,5,1,18,5,,,,,,,,,,
20010312-M-Indian_Wells-QF-Nicolas_Lapentti-Andre_Agassi,2,F-DTM,22,4,0,1,3,11,11,,,,,,,,,,
20010312-M-Indian_Wells-QF-Nicolas_Lapentti-Andre_Agassi,2,F-DTL,8,2,2,0,0,5,3,,,,,,,,,,
20010312-M-Indian_Wells-QF-Nicolas_Lapentti-Andre_Agassi,2,F-IO,18,6,2,1,3,10,8,,,,,,,,,,
20010312-M-Indian_Wells-QF-Nicolas_Lapentti-Andre_Agassi,2,F-II,1,0,0,0,0,1,0,,,,,,,,,,
20010312-M-Indian_Wells-QF-Nicolas_Lapentti-Andre_Agassi,2,B-XC,40,4,1,3,0,27,13,,,,,,,,,,
20010312-M-Indian_Wells-QF-Nicolas_Lapentti-Andre_Agassi,2,B-DTM,9,1,0,0,1,5,4,,,,,,,,,,
20010312-M-Indian_Wells-QF-Nicolas_Lapentti-Andre_Agassi,2,B-DTL,4,2,1,1,0,4,0,,,,,,,,,,
20010312-M-Indian_Wells-QF-Nicolas_Lapentti-Andre_Agassi,2,B-IO,2,1,0,1,0,2,0,,,,,,,,,,
20010312-M-Indian_Wells-QF-Nicolas_Lapentti-Andre_Agassi,2,S-XC,2,0,0,0,0,2,0,,,,,,,,,,
20010312-M-Indian_Wells-QF-Nicolas_Lapentti-Andre_Agassi,2,S-DTM,1,0,0,0,0,0,1,,,,,,,,,,
20010319-M-Miami_Masters-R32-Pete_Sampras-Andy_Roddick,1,F-XC,8,6,2,1,3,5,3,,,,,,,,,,
20010319-M-Miami_Masters-R32-Pete_Sampras-Andy_Roddick,1,F-DTM,2,0,0,0,0,1,1,,,,,,,,,,
20010319-M-Miami_Masters-R32-Pete_Sampras-Andy_Roddick,1,F-DTL,3,1,0,0,1,1,2,,,,,,,,,,
20010319-M-Miami_Masters-R32-Pete_Sampras-Andy_Roddick,1,F-IO,8,2,0,0,2,1,7,,,,,,,,,,
20010319-M-Miami_Masters-R32-Pete_Sampras-Andy_Roddick,1,F-II,1,1,0,0,1,0,1,,,,,,,,,,
20010319-M-Miami_Masters-R32-Pete_Sampras-Andy_Roddick,1,B-XC,10,3,1,0,2,2,8,,,,,,,,,,
20010319-M-Miami_Masters-R32-Pete_Sampras-Andy_Roddick,1,B-DTM,1,0,0,0,0,1,0,,,,,,,,,,
20010319-M-Miami_Masters-R32-Pete_Sampras-Andy_Roddick,1,B-DTL,6,6,1,0,5,1,5,,,,,,,,,,
20010319-M-Miami_Masters-R32-Pete_Sampras-Andy_Roddick,1,S-XC,4,2,0,1,1,1,3,,,,,,,,,,
20010319-M-Miami_Masters-R32-Pete_Sampras-Andy_Roddick,1,S-DTM,2,0,0,0,0,0,2,,,,,,,,,,
20010319-M-Miami_Masters-R32-Pete_Sampras-Andy_Roddick,2,F-XC,8,3,1,1,1,4,4,,,,,,,,,,
20010319-M-Miami_Masters-R32-Pete_Sampras-Andy_Roddick,2,F-DTM,3,0,0,0,0,1,2,,,,,,,,,,
20010319-M-Miami_Masters-R32-Pete_Sampras-Andy_Roddick,2,F-DTL,2,2,1,0,1,1,1,,,,,,,,,,
20010319-M-Miami_Masters-R32-Pete_Sampras-Andy_Roddick,2,F-IO,11,5,5,0,0,8,3,,,,,,,,,,
20010319-M-Miami_Masters-R32-Pete_Sampras-Andy_Roddick,2,F-II,2,1,1,0,0,2,0,,,,,,,,,,
20010319-M-Miami_Masters-R32-Pete_Sampras-Andy_Roddick,2,B-XC,18,5,1,3,1,13,5,,,,,,,,,,
20010319-M-Miami_Masters-R32-Pete_Sampras-Andy_Roddick,2,B-DTM,8,1,0,1,0,6,2,,,,,,,,,,
20010319-M-Miami_Masters-R32-Pete_Sampras-Andy_Roddick,2,B-DTL,2,2,1,0,1,1,1,,,,,,,,,,
20010319-M-Miami_Masters-R32-Pete_Sampras-Andy_Roddick,2,B-IO,4,2,0,0,2,2,2,,,,,,,,,,
20010319-M-Miami_Masters-R32-Pete_Sampras-Andy_Roddick,2,S-XC,4,1,0,1,0,4,0,,,,,,,,,,
20010319-M-Miami_Masters-R32-Pete_Sampras-Andy_Roddick,2,S-DTM,2,0,0,0,0,1,1,,,,,,,,,,
20010319-M-Miami_Masters-R32-Pete_Sampras-Andy_Roddick,2,S-DTL,1,0,0,0,0,0,1,,,,,,,,,,
20010611-M-Halle-QF-Patrick_Rafter-Roger_Federer,1,F-XC,3,2,1,1,0,2,1,,,,,,,,,,
20010611-M-Halle-QF-Patrick_Rafter-Roger_Federer,1,F-DTL,2,1,1,0,0,1,1,,,,,,,,,,
20010611-M-Halle-QF-Patrick_Rafter-Roger_Federer,1,F-IO,5,3,3,0,0,4,1,,,,,,,,,,
20010611-M-Halle-QF-Patrick_Rafter-Roger_Federer,1,B-XC,6,3,2,1,0,4,2,,,,,,,,,,
20010611-M-Halle-QF-Patrick_Rafter-Roger_Federer,1,B-DTL,3,2,2,0,0,2,1,,,,,,,,,,
20010611-M-Halle-QF-Patrick_Rafter-Roger_Federer,1,B-IO,1,1,0,0,1,0,1,,,,,,,,,,
20010611-M-Halle-QF-Patrick_Rafter-Roger_Federer,1,S-DTL,1,0,0,0,0,0,1,,,,,,,,,,
20010611-M-Halle-QF-Patrick_Rafter-Roger_Federer,2,F-XC,3,2,1,1,0,2,1,,,,,,,,,,
20010611-M-Halle-QF-Patrick_Rafter-Roger_Federer,2,F-DTL,2,0,0,0,0,1,1,,,,,,,,,,
20010611-M-Halle-QF-Patrick_Rafter-Roger_Federer,2,F-IO,3,2,2,0,0,3,0,,,,,,,,,,
20010611-M-Halle-QF-Patrick_Rafter-Roger_Federer,2,F-II,1,0,0,0,0,0,1,,,,,,,,,,
20010611-M-Halle-QF-Patrick_Rafter-Roger_Federer,2,B-XC,2,0,0,0,0,0,2,,,,,,,,,,
20010611-M-Halle-QF-Patrick_Rafter-Roger_Federer,2,B-DTL,2,1,1,0,0,1,1,,,,,,,,,,
20010702-M-Wimbledon-R16-Roger_Federer-Pete_Sampras,1,F-XC,14,8,5,1,2,7,7,,,,,,,,,,
20010702-M-Wimbledon-R16-Roger_Federer-Pete_Sampras,1,F-DTM,6,1,0,1,0,4,2,,,,,,,,,,
20010702-M-Wimbledon-R16-Roger_Federer-Pete_Sampras,1,F-DTL,8,7,4,1,2,5,3,,,,,,,,,,
20010702-M-Wimbledon-R16-Roger_Federer-Pete_Sampras,1,F-IO,15,3,2,0,1,7,8,,,,,,,,,,
20010702-M-Wimbledon-R16-Roger_Federer-Pete_Sampras,1,F-II,2,2,1,1,0,2,0,,,,,,,,,,
20010702-M-Wimbledon-R16-Roger_Federer-Pete_Sampras,1,B-XC,14,5,2,1,2,8,6,,,,,,,,,,
20010702-M-Wimbledon-R16-Roger_Federer-Pete_Sampras,1,B-DTM,7,4,0,2,2,4,3,,,,,,,,,,
20010702-M-Wimbledon-R16-Roger_Federer-Pete_Sampras,1,B-DTL,3,3,0,0,3,0,3,,,,,,,,,,
20010702-M-Wimbledon-R16-Roger_Federer-Pete_Sampras,1,B-IO,3,3,1,0,2,1,2,,,,,,,,,,
20010702-M-Wimbledon-R16-Roger_Federer-Pete_Sampras,1,S-XC,2,0,0,0,0,2,0,,,,,,,,,,
20010702-M-Wimbledon-R16-Roger_Federer-Pete_Sampras,1,S-DTM,1,0,0,0,0,0,1,,,,,,,,,,
20010702-M-Wimbledon-R16-Roger_Federer-Pete_Sampras,1,S-DTL,7,2,1,1,0,5,2,,,,,,,,,,
20010702-M-Wimbledon-R16-Roger_Federer-Pete_Sampras,1,S-IO,1,0,0,0,0,0,1,,,,,,,,,,
20010702-M-Wimbledon-R16-Roger_Federer-Pete_Sampras,2,F-XC,12,8,2,4,2,7,5,,,,,,,,,,
20010702-M-Wimbledon-R16-Roger_Federer-Pete_Sampras,2,F-DTM,2,0,0,0,0,1,1,,,,,,,,,,
20010702-M-Wimbledon-R16-Roger_Federer-Pete_Sampras,2,F-DTL,5,3,0,2,1,3,2,,,,,,,,,,
20010702-M-Wimbledon-R16-Roger_Federer-Pete_Sampras,2,F-IO,8,6,4,0,2,6,2,,,,,,,,,,
20010702-M-Wimbledon-R16-Roger_Federer-Pete_Sampras,2,B-XC,5,1,0,0,1,3,2,,,,,,,,,,
20010702-M-Wimbledon-R16-Roger_Federer-Pete_Sampras,2,B-DTM,6,1,0,1,0,5,1,,,,,,,,,,
20010702-M-Wimbledon-R16-Roger_Federer-Pete_Sampras,2,B-DTL,11,9,4,0,5,5,6,,,,,,,,,,
20010702-M-Wimbledon-R16-Roger_Federer-Pete_Sampras,2,B-IO,1,1,0,0,1,0,1,,,,,,,,,,
20010702-M-Wimbledon-R16-Roger_Federer-Pete_Sampras,2,S-XC,8,2,1,0,1,4,4,,,,,,,,,,
20010702-M-Wimbledon-R16-Roger_Federer-Pete_Sampras,2,S-DTM,1,1,0,0,1,0,1,,,,,,,,,,
20010702-M-Wimbledon-R16-Roger_Federer-Pete_Sampras,2,S-DTL,3,1,0,0,1,1,2,,,,,,,,,,
20010702-M-Wimbledon-R16-Roger_Federer-Pete_Sampras,2,S-IO,2,0,0,0,0,0,2,,,,,,,,,,
20010709-M-Wimbledon-F-Goran_Ivanisevic-Patrick_Rafter,1,F-XC,14,9,4,4,1,11,3,,,,,,,,,,
20010709-M-Wimbledon-F-Goran_Ivanisevic-Patrick_Rafter,1,F-DTM,2,1,0,0,1,1,1,,,,,,,,,,
20010709-M-Wimbledon-F-Goran_Ivanisevic-Patrick_Rafter,1,F-DTL,1,1,1,0,0,1,0,,,,,,,,,,
20010709-M-Wimbledon-F-Goran_Ivanisevic-Patrick_Rafter,1,F-IO,1,1,1,0,0,1,0,,,,,,,,,,
20010709-M-Wimbledon-F-Goran_Ivanisevic-Patrick_Rafter,1,F-II,1,0,0,0,0,0,1,,,,,,,,,,
20010709-M-Wimbledon-F-Goran_Ivanisevic-Patrick_Rafter,1,B-XC,7,6,3,1,2,4,3,,,,,,,,,,
20010709-M-Wimbledon-F-Goran_Ivanisevic-Patrick_Rafter,1,B-DTM,2,0,0,0,0,0,2,,,,,,,,,,
20010709-M-Wimbledon-F-Goran_Ivanisevic-Patrick_Rafter,1,B-DTL,5,4,1,2,1,3,2,,,,,,,,,,
20010709-M-Wimbledon-F-Goran_Ivanisevic-Patrick_Rafter,1,B-IO,4,4,0,1,3,1,3,,,,,,,,,,
20010709-M-Wimbledon-F-Goran_Ivanisevic-Patrick_Rafter,1,B-II,1,0,0,0,0,1,0,,,,,,,,,,
20010709-M-Wimbledon-F-Goran_Ivanisevic-Patrick_Rafter,1,S-XC,1,0,0,0,0,0,1,,,,,,,,,,
20010709-M-Wimbledon-F-Goran_Ivanisevic-Patrick_Rafter,1,S-DTM,1,0,0,0,0,0,1,,,,,,,,,,
20010709-M-Wimbledon-F-Goran_Ivanisevic-Patrick_Rafter,1,S-DTL,3,1,0,0,1,0,3,,,,,,,,,,
20010709-M-Wimbledon-F-Goran_Ivanisevic-Patrick_Rafter,2,F-XC,4,3,1,2,0,3,1,,,,,,,,,,
20010709-M-Wimbledon-F-Goran_Ivanisevic-Patrick_Rafter,2,F-DTM,1,1,0,0,1,0,1,,,,,,,,,,
20010709-M-Wimbledon-F-Goran_Ivanisevic-Patrick_Rafter,2,F-DTL,3,3,3,0,0,3,0,,,,,,,,,,
20010709-M-Wimbledon-F-Goran_Ivanisevic-Patrick_Rafter,2,F-IO,1,1,1,0,0,1,0,,,,,,,,,,
20010709-M-Wimbledon-F-Goran_Ivanisevic-Patrick_Rafter,2,F-II,1,1,1,0,0,1,0,,,,,,,,,,
20010709-M-Wimbledon-F-Goran_Ivanisevic-Patrick_Rafter,2,B-XC,3,1,0,0,1,1,2,,,,,,,,,,
20010709-M-Wimbledon-F-Goran_Ivanisevic-Patrick_Rafter,2,B-DTM,2,2,1,0,1,1,1,,,,,,,,,,
20010709-M-Wimbledon-F-Goran_Ivanisevic-Patrick_Rafter,2,B-DTL,2,0,0,0,0,1,1,,,,,,,,,,
20010709-M-Wimbledon-F-Goran_Ivanisevic-Patrick_Rafter,2,B-IO,4,1,1,0,0,2,2,,,,,,,,,,
20010709-M-Wimbledon-F-Goran_Ivanisevic-Patrick_Rafter,2,S-XC,2,2,1,1,0,2,0,,,,,,,,,,
20010709-M-Wimbledon-F-Goran_Ivanisevic-Patrick_Rafter,2,S-DTL,3,2,0,0,2,1,2,,,,,,,,,,
20010909-M-US_Open-F-Pete_Sampras-Lleyton_Hewitt,1,F-XC,17,6,1,1,4,6,11,,,,,,,,,,
20010909-M-US_Open-F-Pete_Sampras-Lleyton_Hewitt,1,F-DTM,13,2,0,0,2,2,11,,,,,,,,,,
20010909-M-US_Open-F-Pete_Sampras-Lleyton_Hewitt,1,F-DTL,7,3,0,0,3,2,5,,,,,,,,,,
20010909-M-US_Open-F-Pete_Sampras-Lleyton_Hewitt,1,F-IO,6,2,1,1,0,2,4,,,,,,,,,,
20010909-M-US_Open-F-Pete_Sampras-Lleyton_Hewitt,1,F-II,4,2,0,1,1,1,3,,,,,,,,,,
20010909-M-US_Open-F-Pete_Sampras-Lleyton_Hewitt,1,B-XC,12,1,1,0,0,5,7,,,,,,,,,,
20010909-M-US_Open-F-Pete_Sampras-Lleyton_Hewitt,1,B-DTM,9,0,0,0,0,2,7,,,,,,,,,,
20010909-M-US_Open-F-Pete_Sampras-Lleyton_Hewitt,1,B-DTL,5,4,1,1,2,2,3,,,,,,,,,,
20010909-M-US_Open-F-Pete_Sampras-Lleyton_Hewitt,1,S-XC,16,2,0,0,2,6,10,,,,,,,,,,
20010909-M-US_Open-F-Pete_Sampras-Lleyton_Hewitt,1,S-DTM,4,0,0,0,0,3,1,,,,,,,,,,
20010909-M-US_Open-F-Pete_Sampras-Lleyton_Hewitt,1,S-DTL,2,2,0,1,1,1,1,,,,,,,,,,
20010909-M-US_Open-F-Pete_Sampras-Lleyton_Hewitt,2,F-XC,27,6,3,2,1,20,7,,,,,,,,,,
20010909-M-US_Open-F-Pete_Sampras-Lleyton_Hewitt,2,F-DTM,10,1,0,1,0,5,5,,,,,,,,,,
20010909-M-US_Open-F-Pete_Sampras-Lleyton_Hewitt,2,F-DTL,7,3,2,0,1,5,2,,,,,,,,,,
20010909-M-US_Open-F-Pete_Sampras-Lleyton_Hewitt,2,F-IO,25,7,4,2,1,13,12,,,,,,,,,,
20010909-M-US_Open-F-Pete_Sampras-Lleyton_Hewitt,2,F-II,3,0,0,0,0,3,0,,,,,,,,,,
20010909-M-US_Open-F-Pete_Sampras-Lleyton_Hewitt,2,B-XC,38,10,6,1,3,30,8,,,,,,,,,,
20010909-M-US_Open-F-Pete_Sampras-Lleyton_Hewitt,2,B-DTM,12,1,0,1,0,6,6,,,,,,,,,,
20010909-M-US_Open-F-Pete_Sampras-Lleyton_Hewitt,2,B-DTL,2,2,2,0,0,2,0,,,,,,,,,,
20010909-M-US_Open-F-Pete_Sampras-Lleyton_Hewitt,2,B-IO,5,3,0,0,3,2,3,,,,,,,,,,
20010909-M-US_Open-F-Pete_Sampras-Lleyton_Hewitt,2,S-XC,1,1,0,1,0,1,0,,,,,,,,,,
20010909-M-US_Open-F-Pete_Sampras-Lleyton_Hewitt,2,S-DTM,6,1,0,0,1,2,4,,,,,,,,,,
20011112-M-Masters_Cup-RR-Patrick_Rafter-Andre_Agassi,1,F-XC,15,3,3,0,0,9,6,,,,,,,,,,
20011112-M-Masters_Cup-RR-Patrick_Rafter-Andre_Agassi,1,F-DTM,5,1,0,0,1,2,3,,,,,,,,,,
20011112-M-Masters_Cup-RR-Patrick_Rafter-Andre_Agassi,1,F-DTL,4,0,0,0,0,2,2,,,,,,,,,,
20011112-M-Masters_Cup-RR-Patrick_Rafter-Andre_Agassi,1,F-IO,2,2,1,0,1,1,1,,,,,,,,,,
20011112-M-Masters_Cup-RR-Patrick_Rafter-Andre_Agassi,1,F-II,1,1,0,0,1,0,1,,,,,,,,,,
20011112-M-Masters_Cup-RR-Patrick_Rafter-Andre_Agassi,1,B-XC,7,0,0,0,0,5,2,,,,,,,,,,
20011112-M-Masters_Cup-RR-Patrick_Rafter-Andre_Agassi,1,B-DTM,3,0,0,0,0,2,1,,,,,,,,,,
20011112-M-Masters_Cup-RR-Patrick_Rafter-Andre_Agassi,1,B-DTL,1,0,0,0,0,0,1,,,,,,,,,,
20011112-M-Masters_Cup-RR-Patrick_Rafter-Andre_Agassi,1,S-XC,17,1,0,0,1,11,6,,,,,,,,,,
20011112-M-Masters_Cup-RR-Patrick_Rafter-Andre_Agassi,1,S-DTM,3,0,0,0,0,1,2,,,,,,,,,,
20011112-M-Masters_Cup-RR-Patrick_Rafter-Andre_Agassi,2,F-XC,24,12,6,3,3,14,10,,,,,,,,,,
20011112-M-Masters_Cup-RR-Patrick_Rafter-Andre_Agassi,2,F-DTM,4,1,0,1,0,4,0,,,,,,,,,,
20011112-M-Masters_Cup-RR-Patrick_Rafter-Andre_Agassi,2,F-DTL,6,5,3,1,1,4,2,,,,,,,,,,
20011112-M-Masters_Cup-RR-Patrick_Rafter-Andre_Agassi,2,F-IO,12,4,1,2,1,7,5,,,,,,,,,,
20011112-M-Masters_Cup-RR-Patrick_Rafter-Andre_Agassi,2,F-II,7,2,0,1,1,4,3,,,,,,,,,,
20011112-M-Masters_Cup-RR-Patrick_Rafter-Andre_Agassi,2,B-XC,28,8,1,3,4,11,17,,,,,,,,,,
20011112-M-Masters_Cup-RR-Patrick_Rafter-Andre_Agassi,2,B-DTM,7,0,0,0,0,2,5,,,,,,,,,,
20011112-M-Masters_Cup-RR-Patrick_Rafter-Andre_Agassi,2,B-DTL,19,12,8,2,2,12,7,,,,,,,,,,
20011112-M-Masters_Cup-RR-Patrick_Rafter-Andre_Agassi,2,B-IO,2,1,0,0,1,1,1,,,,,,,,,,
20011112-M-Masters_Cup-RR-Patrick_Rafter-Andre_Agassi,2,S-XC,1,0,0,0,0,1,0,,,,,,,,,,
20011112-M-Masters_Cup-RR-Patrick_Rafter-Andre_Agassi,2,S-DTM,1,0,0,0,0,0,1,,,,,,,,,,
20020428-M-Houston-SF-Pete_Sampras-Andre_Agassi,1,F-XC,16,5,2,1,2,12,4,,,,,,,,,,
20020428-M-Houston-SF-Pete_Sampras-Andre_Agassi,1,F-DTM,4,1,1,0,0,1,3,,,,,,,,,,
20020428-M-Houston-SF-Pete_Sampras-Andre_Agassi,1,F-DTL,3,1,1,0,0,2,1,,,,,,,,,,
20020428-M-Houston-SF-Pete_Sampras-Andre_Agassi,1,F-IO,7,4,2,1,1,4,3,,,,,,,,,,
20020428-M-Houston-SF-Pete_Sampras-Andre_Agassi,1,F-II,4,3,0,1,2,2,2,,,,,,,,,,
20020428-M-Houston-SF-Pete_Sampras-Andre_Agassi,1,B-XC,22,5,1,1,3,12,10,,,,,,,,,,
20020428-M-Houston-SF-Pete_Sampras-Andre_Agassi,1,B-DTM,7,0,0,0,0,5,2,,,,,,,,,,
20020428-M-Houston-SF-Pete_Sampras-Andre_Agassi,1,B-DTL,3,1,0,0,1,1,2,,,,,,,,,,
20020428-M-Houston-SF-Pete_Sampras-Andre_Agassi,1,B-IO,1,0,0,0,0,1,0,,,,,,,,,,
20020428-M-Houston-SF-Pete_Sampras-Andre_Agassi,1,S-XC,11,1,0,0,1,5,6,,,,,,,,,,
20020428-M-Houston-SF-Pete_Sampras-Andre_Agassi,1,S-DTM,1,0,0,0,0,0,1,,,,,,,,,,
20020428-M-Houston-SF-Pete_Sampras-Andre_Agassi,1,S-DTL,2,1,0,0,1,0,2,,,,,,,,,,
20020428-M-Houston-SF-Pete_Sampras-Andre_Agassi,2,F-XC,17,8,2,2,4,9,8,,,,,,,,,,
20020428-M-Houston-SF-Pete_Sampras-Andre_Agassi,2,F-DTM,7,2,0,0,2,1,6,,,,,,,,,,
20020428-M-Houston-SF-Pete_Sampras-Andre_Agassi,2,F-DTL,8,2,1,0,1,2,6,,,,,,,,,,
20020428-M-Houston-SF-Pete_Sampras-Andre_Agassi,2,F-IO,10,2,1,1,0,5,5,,,,,,,,,,
20020428-M-Houston-SF-Pete_Sampras-Andre_Agassi,2,F-II,1,1,1,0,0,1,0,,,,,,,,,,
20020428-M-Houston-SF-Pete_Sampras-Andre_Agassi,2,B-XC,32,5,1,2,2,16,16,,,,,,,,,,
20020428-M-Houston-SF-Pete_Sampras-Andre_Agassi,2,B-DTM,5,0,0,0,0,0,5,,,,,,,,,,
20020428-M-Houston-SF-Pete_Sampras-Andre_Agassi,2,B-DTL,7,4,1,1,2,4,3,,,,,,,,,,
20020428-M-Houston-SF-Pete_Sampras-Andre_Agassi,2,B-IO,2,1,0,0,1,0,2,,,,,,,,,,
20020428-M-Houston-SF-Pete_Sampras-Andre_Agassi,2,S-XC,3,0,0,0,0,3,0,,,,,,,,,,
20020428-M-Houston-SF-Pete_Sampras-Andre_Agassi,2,S-DTM,1,1,0,0,1,0,1,,,,,,,,,,
20020428-M-Houston-SF-Pete_Sampras-Andre_Agassi,2,S-DTL,1,1,0,0,1,0,1,,,,,,,,,,
20020707-M-Wimbledon-F-David_Nalbandian-Lleyton_Hewitt,1,F-XC,90,11,0,0,11,41,49,,,,,,,,,,
20020707-M-Wimbledon-F-David_Nalbandian-Lleyton_Hewitt,1,F-DTM,30,4,1,1,2,10,20,,,,,,,,,,
20020707-M-Wimbledon-F-David_Nalbandian-Lleyton_Hewitt,1,F-DTL,7,0,0,0,0,2,5,,,,,,,,,,
20020707-M-Wimbledon-F-David_Nalbandian-Lleyton_Hewitt,1,F-IO,18,2,0,0,2,8,10,,,,,,,,,,
20020707-M-Wimbledon-F-David_Nalbandian-Lleyton_Hewitt,1,F-II,3,1,1,0,0,3,0,,,,,,,,,,
20020707-M-Wimbledon-F-David_Nalbandian-Lleyton_Hewitt,1,B-XC,109,12,2,3,7,56,53,,,,,,,,,,
20020707-M-Wimbledon-F-David_Nalbandian-Lleyton_Hewitt,1,B-DTM,45,7,0,2,5,17,28,,,,,,,,,,
20020707-M-Wimbledon-F-David_Nalbandian-Lleyton_Hewitt,1,B-DTL,22,4,2,0,2,12,10,,,,,,,,,,
20020707-M-Wimbledon-F-David_Nalbandian-Lleyton_Hewitt,1,B-IO,6,2,0,2,0,4,2,,,,,,,,,,
20020707-M-Wimbledon-F-David_Nalbandian-Lleyton_Hewitt,1,S-XC,16,2,0,0,2,6,10,,,,,,,,,,
20020707-M-Wimbledon-F-David_Nalbandian-Lleyton_Hewitt,1,S-DTM,11,1,0,0,1,3,8,,,,,,,,,,
20020707-M-Wimbledon-F-David_Nalbandian-Lleyton_Hewitt,1,S-DTL,3,1,0,0,1,2,1,,,,,,,,,,
20020707-M-Wimbledon-F-David_Nalbandian-Lleyton_Hewitt,2,F-XC,79,13,1,2,10,40,39,,,,,,,,,,
20020707-M-Wimbledon-F-David_Nalbandian-Lleyton_Hewitt,2,F-DTM,49,4,1,0,3,20,29,,,,,,,,,,
20020707-M-Wimbledon-F-David_Nalbandian-Lleyton_Hewitt,2,F-DTL,28,8,4,3,1,18,10,,,,,,,,,,
20020707-M-Wimbledon-F-David_Nalbandian-Lleyton_Hewitt,2,F-IO,49,9,5,2,2,27,22,,,,,,,,,,
20020707-M-Wimbledon-F-David_Nalbandian-Lleyton_Hewitt,2,F-II,1,0,0,0,0,1,0,,,,,,,,,,
20020707-M-Wimbledon-F-David_Nalbandian-Lleyton_Hewitt,2,B-XC,90,10,1,2,7,46,44,,,,,,,,,,
20020707-M-Wimbledon-F-David_Nalbandian-Lleyton_Hewitt,2,B-DTM,32,3,0,0,3,17,15,,,,,,,,,,
20020707-M-Wimbledon-F-David_Nalbandian-Lleyton_Hewitt,2,B-DTL,5,4,2,1,1,3,2,,,,,,,,,,
20020707-M-Wimbledon-F-David_Nalbandian-Lleyton_Hewitt,2,B-IO,2,1,0,0,1,1,1,,,,,,,,,,
20020707-M-Wimbledon-F-David_Nalbandian-Lleyton_Hewitt,2,S-XC,14,1,1,0,0,4,10,,,,,,,,,,
20020707-M-Wimbledon-F-David_Nalbandian-Lleyton_Hewitt,2,S-DTM,8,0,0,0,0,6,2,,,,,,,,,,
20020707-M-Wimbledon-F-David_Nalbandian-Lleyton_Hewitt,2,S-DTL,1,0,0,0,0,1,0,,,,,,,,,,
20020908-M-US_Open-F-Pete_Sampras-Andre_Agassi,1,F-XC,27,8,2,2,4,16,11,,,,,,,,,,
20020908-M-US_Open-F-Pete_Sampras-Andre_Agassi,1,F-DTM,5,0,0,0,0,2,3,,,,,,,,,,
20020908-M-US_Open-F-Pete_Sampras-Andre_Agassi,1,F-DTL,3,1,0,1,0,3,0,,,,,,,,,,
20020908-M-US_Open-F-Pete_Sampras-Andre_Agassi,1,F-IO,12,5,3,1,1,9,3,,,,,,,,,,
20020908-M-US_Open-F-Pete_Sampras-Andre_Agassi,1,F-II,2,1,0,0,1,1,1,,,,,,,,,,
20020908-M-US_Open-F-Pete_Sampras-Andre_Agassi,1,B-XC,28,12,3,2,7,13,15,,,,,,,,,,
20020908-M-US_Open-F-Pete_Sampras-Andre_Agassi,1,B-DTM,7,0,0,0,0,5,2,,,,,,,,,,
20020908-M-US_Open-F-Pete_Sampras-Andre_Agassi,1,B-DTL,6,6,1,0,5,1,5,,,,,,,,,,
20020908-M-US_Open-F-Pete_Sampras-Andre_Agassi,1,B-IO,2,1,0,0,1,0,2,,,,,,,,,,
20020908-M-US_Open-F-Pete_Sampras-Andre_Agassi,1,S-XC,14,0,0,0,0,6,8,,,,,,,,,,
20020908-M-US_Open-F-Pete_Sampras-Andre_Agassi,1,S-DTM,6,2,0,0,2,1,5,,,,,,,,,,
20020908-M-US_Open-F-Pete_Sampras-Andre_Agassi,1,S-DTL,2,1,1,0,0,2,0,,,,,,,,,,
20020908-M-US_Open-F-Pete_Sampras-Andre_Agassi,2,F-XC,32,18,9,5,4,20,12,,,,,,,,,,
20020908-M-US_Open-F-Pete_Sampras-Andre_Agassi,2,F-DTM,18,1,0,0,1,5,13,,,,,,,,,,
20020908-M-US_Open-F-Pete_Sampras-Andre_Agassi,2,F-DTL,13,3,1,1,1,7,6,,,,,,,,,,
20020908-M-US_Open-F-Pete_Sampras-Andre_Agassi,2,F-IO,10,4,1,1,2,7,3,,,,,,,,,,
20020908-M-US_Open-F-Pete_Sampras-Andre_Agassi,2,F-II,1,1,0,1,0,1,0,,,,,,,,,,
20020908-M-US_Open-F-Pete_Sampras-Andre_Agassi,2,B-XC,52,11,1,4,6,30,22,,,,,,,,,,
20020908-M-US_Open-F-Pete_Sampras-Andre_Agassi,2,B-DTM,15,2,0,1,1,6,9,,,,,,,,,,
20020908-M-US_Open-F-Pete_Sampras-Andre_Agassi,2,B-DTL,11,6,1,4,1,6,5,,,,,,,,,,
20020908-M-US_Open-F-Pete_Sampras-Andre_Agassi,2,B-IO,5,0,0,0,0,2,3,,,,,,,,,,
20020908-M-US_Open-F-Pete_Sampras-Andre_Agassi,2,S-XC,3,0,0,0,0,0,3,,,,,,,,,,
20020908-M-US_Open-F-Pete_Sampras-Andre_Agassi,2,S-DTM,2,0,0,0,0,0,2,,,,,,,,,,
20020908-M-US_Open-F-Pete_Sampras-Andre_Agassi,2,S-DTL,2,1,0,1,0,1,1,,,,,,,,,,
20021111-M-Masters_Cup-RR-Andre_Agassi-Jiri_Novak,1,F-XC,57,12,2,4,6,35,22,,,,,,,,,,
20021111-M-Masters_Cup-RR-Andre_Agassi-Jiri_Novak,1,F-DTM,21,4,0,1,3,8,13,,,,,,,,,,
20021111-M-Masters_Cup-RR-Andre_Agassi-Jiri_Novak,1,F-DTL,16,5,2,2,1,10,6,,,,,,,,,,
20021111-M-Masters_Cup-RR-Andre_Agassi-Jiri_Novak,1,F-IO,6,0,0,0,0,3,3,,,,,,,,,,
20021111-M-Masters_Cup-RR-Andre_Agassi-Jiri_Novak,1,F-II,3,2,1,1,0,3,0,,,,,,,,,,
20021111-M-Masters_Cup-RR-Andre_Agassi-Jiri_Novak,1,B-XC,38,4,1,0,3,22,16,,,,,,,,,,
20021111-M-Masters_Cup-RR-Andre_Agassi-Jiri_Novak,1,B-DTM,12,2,0,1,1,8,4,,,,,,,,,,
20021111-M-Masters_Cup-RR-Andre_Agassi-Jiri_Novak,1,B-DTL,7,2,2,0,0,3,4,,,,,,,,,,
20021111-M-Masters_Cup-RR-Andre_Agassi-Jiri_Novak,1,B-IO,3,2,0,0,2,1,2,,,,,,,,,,
20021111-M-Masters_Cup-RR-Andre_Agassi-Jiri_Novak,1,S-XC,9,0,0,0,0,3,6,,,,,,,,,,
20021111-M-Masters_Cup-RR-Andre_Agassi-Jiri_Novak,1,S-DTM,4,0,0,0,0,2,2,,,,,,,,,,
20021111-M-Masters_Cup-RR-Andre_Agassi-Jiri_Novak,2,F-XC,42,4,2,1,1,19,23,,,,,,,,,,
20021111-M-Masters_Cup-RR-Andre_Agassi-Jiri_Novak,2,F-DTM,18,0,0,0,0,8,10,,,,,,,,,,
20021111-M-Masters_Cup-RR-Andre_Agassi-Jiri_Novak,2,F-DTL,13,4,2,0,2,7,6,,,,,,,,,,
20021111-M-Masters_Cup-RR-Andre_Agassi-Jiri_Novak,2,F-IO,15,7,2,2,3,9,6,,,,,,,,,,
20021111-M-Masters_Cup-RR-Andre_Agassi-Jiri_Novak,2,B-XC,23,1,0,1,0,10,13,,,,,,,,,,
20021111-M-Masters_Cup-RR-Andre_Agassi-Jiri_Novak,2,B-DTM,30,1,0,0,1,9,21,,,,,,,,,,
20021111-M-Masters_Cup-RR-Andre_Agassi-Jiri_Novak,2,B-DTL,19,9,6,2,1,13,6,,,,,,,,,,
20021111-M-Masters_Cup-RR-Andre_Agassi-Jiri_Novak,2,B-IO,6,1,0,1,0,3,3,,,,,,,,,,
20021111-M-Masters_Cup-RR-Andre_Agassi-Jiri_Novak,2,S-XC,4,0,0,0,0,0,4,,,,,,,,,,
20021111-M-Masters_Cup-RR-Andre_Agassi-Jiri_Novak,2,S-DTM,4,2,0,0,2,1,3,,,,,,,,,,
20021111-M-Masters_Cup-RR-Andre_Agassi-Jiri_Novak,2,S-DTL,2,0,0,0,0,1,1,,,,,,,,,,
20030126-M-Australian_Open-F-Rainer_Schuettler-Andre_Agassi,1,F-XC,30,4,1,1,2,9,21,,,,,,,,,,
20030126-M-Australian_Open-F-Rainer_Schuettler-Andre_Agassi,1,F-DTM,29,2,0,0,2,13,16,,,,,,,,,,
20030126-M-Australian_Open-F-Rainer_Schuettler-Andre_Agassi,1,F-DTL,20,6,3,1,2,9,11,,,,,,,,,,
20030126-M-Australian_Open-F-Rainer_Schuettler-Andre_Agassi,1,F-IO,11,3,0,1,2,3,8,,,,,,,,,,
20030126-M-Australian_Open-F-Rainer_Schuettler-Andre_Agassi,1,F-II,4,1,0,0,1,2,2,,,,,,,,,,
20030126-M-Australian_Open-F-Rainer_Schuettler-Andre_Agassi,1,B-XC,54,9,1,1,7,22,32,,,,,,,,,,
20030126-M-Australian_Open-F-Rainer_Schuettler-Andre_Agassi,1,B-DTM,25,2,0,1,1,12,13,,,,,,,,,,
20030126-M-Australian_Open-F-Rainer_Schuettler-Andre_Agassi,1,B-DTL,14,8,1,2,5,5,9,,,,,,,,,,
20030126-M-Australian_Open-F-Rainer_Schuettler-Andre_Agassi,1,B-IO,1,0,0,0,0,0,1,,,,,,,,,,
20030126-M-Australian_Open-F-Rainer_Schuettler-Andre_Agassi,1,S-XC,26,1,0,1,0,10,16,,,,,,,,,,
20030126-M-Australian_Open-F-Rainer_Schuettler-Andre_Agassi,1,S-DTM,6,1,0,0,1,2,4,,,,,,,,,,
20030126-M-Australian_Open-F-Rainer_Schuettler-Andre_Agassi,1,S-DTL,2,0,0,0,0,0,2,,,,,,,,,,
20030126-M-Australian_Open-F-Rainer_Schuettler-Andre_Agassi,2,F-XC,50,8,5,0,3,34,16,,,,,,,,,,
20030126-M-Australian_Open-F-Rainer_Schuettler-Andre_Agassi,2,F-DTM,9,0,0,0,0,3,6,,,,,,,,,,
20030126-M-Australian_Open-F-Rainer_Schuettler-Andre_Agassi,2,F-DTL,12,2,1,1,0,9,3,,,,,,,,,,
20030126-M-Australian_Open-F-Rainer_Schuettler-Andre_Agassi,2,F-IO,20,1,0,1,0,12,8,,,,,,,,,,
20030126-M-Australian_Open-F-Rainer_Schuettler-Andre_Agassi,2,F-II,6,2,0,2,0,3,3,,,,,,,,,,
20030126-M-Australian_Open-F-Rainer_Schuettler-Andre_Agassi,2,B-XC,83,10,2,2,6,49,34,,,,,,,,,,
20030126-M-Australian_Open-F-Rainer_Schuettler-Andre_Agassi,2,B-DTM,16,2,1,0,1,8,8,,,,,,,,,,
20030126-M-Australian_Open-F-Rainer_Schuettler-Andre_Agassi,2,B-DTL,10,3,2,0,1,8,2,,,,,,,,,,
20030126-M-Australian_Open-F-Rainer_Schuettler-Andre_Agassi,2,B-IO,3,2,1,1,0,2,1,,,,,,,,,,
20030126-M-Australian_Open-F-Rainer_Schuettler-Andre_Agassi,2,S-XC,7,1,1,0,0,5,2,,,,,,,,,,
20030126-M-Australian_Open-F-Rainer_Schuettler-Andre_Agassi,2,S-DTM,1,0,0,0,0,0,1,,,,,,,,,,
20030126-M-Australian_Open-F-Rainer_Schuettler-Andre_Agassi,2,S-DTL,3,0,0,0,0,1,2,,,,,,,,,,
20030505-M-Rome_Masters-R64-David_Ferrer-Andre_Agassi,1,F-XC,48,11,1,4,6,27,21,,,,,,,,,,
20030505-M-Rome_Masters-R64-David_Ferrer-Andre_Agassi,1,F-DTM,19,3,0,1,2,7,12,,,,,,,,,,
20030505-M-Rome_Masters-R64-David_Ferrer-Andre_Agassi,1,F-DTL,14,3,1,0,2,11,3,,,,,,,,,,
20030505-M-Rome_Masters-R64-David_Ferrer-Andre_Agassi,1,F-IO,30,8,3,0,5,17,13,,,,,,,,,,
20030505-M-Rome_Masters-R64-David_Ferrer-Andre_Agassi,1,F-II,2,0,0,0,0,2,0,,,,,,,,,,
20030505-M-Rome_Masters-R64-David_Ferrer-Andre_Agassi,1,B-XC,46,9,0,1,8,17,29,,,,,,,,,,
20030505-M-Rome_Masters-R64-David_Ferrer-Andre_Agassi,1,B-DTM,34,6,0,0,6,10,24,,,,,,,,,,
20030505-M-Rome_Masters-R64-David_Ferrer-Andre_Agassi,1,B-DTL,15,11,5,0,6,8,7,,,,,,,,,,
20030505-M-Rome_Masters-R64-David_Ferrer-Andre_Agassi,1,B-IO,4,2,1,0,1,2,2,,,,,,,,,,
20030505-M-Rome_Masters-R64-David_Ferrer-Andre_Agassi,1,S-XC,1,0,0,0,0,0,1,,,,,,,,,,
20030505-M-Rome_Masters-R64-David_Ferrer-Andre_Agassi,1,S-DTM,6,0,0,0,0,2,4,,,,,,,,,,
20030505-M-Rome_Masters-R64-David_Ferrer-Andre_Agassi,2,F-XC,51,13,1,6,6,25,26,,,,,,,,,,
20030505-M-Rome_Masters-R64-David_Ferrer-Andre_Agassi,2,F-DTM,6,0,0,0,0,2,4,,,,,,,,,,
20030505-M-Rome_Masters-R64-David_Ferrer-Andre_Agassi,2,F-DTL,19,8,1,3,4,11,8,,,,,,,,,,
20030505-M-Rome_Masters-R64-David_Ferrer-Andre_Agassi,2,F-IO,23,9,4,0,5,12,11,,,,,,,,,,
20030505-M-Rome_Masters-R64-David_Ferrer-Andre_Agassi,2,B-XC,63,14,1,0,13,31,32,,,,,,,,,,
20030505-M-Rome_Masters-R64-David_Ferrer-Andre_Agassi,2,B-DTM,17,0,0,0,0,11,6,,,,,,,,,,
20030505-M-Rome_Masters-R64-David_Ferrer-Andre_Agassi,2,B-DTL,17,8,1,2,5,6,11,,,,,,,,,,
20030505-M-Rome_Masters-R64-David_Ferrer-Andre_Agassi,2,B-IO,3,0,0,0,0,3,0,,,,,,,,,,
20030505-M-Rome_Masters-R64-David_Ferrer-Andre_Agassi,2,S-XC,5,1,0,0,1,3,2,,,,,,,,,,
20030505-M-Rome_Masters-R64-David_Ferrer-Andre_Agassi,2,S-DTM,2,0,0,0,0,0,2,,,,,,,,,,
20030804-M-Canada_Masters-R16-Roger_Federer-Tommy_Robredo,1,F-XC,22,10,5,3,2,16,6,,,,,,,,,,
20030804-M-Canada_Masters-R16-Roger_Federer-Tommy_Robredo,1,F-DTM,9,1,0,0,1,5,4,,,,,,,,,,
20030804-M-Canada_Masters-R16-Roger_Federer-Tommy_Robredo,1,F-DTL,5,0,0,0,0,4,1,,,,,,,,,,
20030804-M-Canada_Masters-R16-Roger_Federer-Tommy_Robredo,1,F-IO,13,2,2,0,0,11,2,,,,,,,,,,
20030804-M-Canada_Masters-R16-Roger_Federer-Tommy_Robredo,1,F-II,2,1,0,1,0,1,1,,,,,,,,,,
20030804-M-Canada_Masters-R16-Roger_Federer-Tommy_Robredo,1,B-XC,10,2,1,0,1,9,1,,,,,,,,,,
20030804-M-Canada_Masters-R16-Roger_Federer-Tommy_Robredo,1,B-DTM,5,0,0,0,0,4,1,,,,,,,,,,
20030804-M-Canada_Masters-R16-Roger_Federer-Tommy_Robredo,1,B-DTL,5,2,1,1,0,4,1,,,,,,,,,,
20030804-M-Canada_Masters-R16-Roger_Federer-Tommy_Robredo,1,B-IO,1,0,0,0,0,1,0,,,,,,,,,,
20030804-M-Canada_Masters-R16-Roger_Federer-Tommy_Robredo,1,S-XC,7,0,0,0,0,4,3,,,,,,,,,,
20030804-M-Canada_Masters-R16-Roger_Federer-Tommy_Robredo,1,S-DTM,3,1,0,0,1,1,2,,,,,,,,,,
20030804-M-Canada_Masters-R16-Roger_Federer-Tommy_Robredo,1,S-DTL,3,2,0,2,0,2,1,,,,,,,,,,
20030804-M-Canada_Masters-R16-Roger_Federer-Tommy_Robredo,1,S-IO,1,0,0,0,0,1,0,,,,,,,,,,
20030804-M-Canada_Masters-R16-Roger_Federer-Tommy_Robredo,2,F-XC,14,6,2,1,3,7,7,,,,,,,,,,
20030804-M-Canada_Masters-R16-Roger_Federer-Tommy_Robredo,2,F-DTM,10,0,0,0,0,3,7,,,,,,,,,,
20030804-M-Canada_Masters-R16-Roger_Federer-Tommy_Robredo,2,F-DTL,6,2,1,0,1,1,5,,,,,,,,,,
20030804-M-Canada_Masters-R16-Roger_Federer-Tommy_Robredo,2,F-IO,22,6,1,3,2,10,12,,,,,,,,,,
20030804-M-Canada_Masters-R16-Roger_Federer-Tommy_Robredo,2,F-II,6,2,1,1,0,3,3,,,,,,,,,,
20030804-M-Canada_Masters-R16-Roger_Federer-Tommy_Robredo,2,B-XC,6,1,0,0,1,0,6,,,,,,,,,,
20030804-M-Canada_Masters-R16-Roger_Federer-Tommy_Robredo,2,B-DTM,6,1,0,0,1,1,5,,,,,,,,,,
20030804-M-Canada_Masters-R16-Roger_Federer-Tommy_Robredo,2,B-DTL,8,5,0,1,4,2,6,,,,,,,,,,
20030804-M-Canada_Masters-R16-Roger_Federer-Tommy_Robredo,2,S-XC,5,0,0,0,0,0,5,,,,,,,,,,
20030804-M-Canada_Masters-R16-Roger_Federer-Tommy_Robredo,2,S-DTM,2,0,0,0,0,0,2,,,,,,,,,,
20030804-M-Canada_Masters-R16-Roger_Federer-Tommy_Robredo,2,S-DTL,1,0,0,0,0,0,1,,,,,,,,,,
20030804-M-Canada_Masters-R16-Roger_Federer-Tommy_Robredo,2,S-IO,1,1,0,0,1,0,1,,,,,,,,,,
20030907-M-US_Open-F-Andy_Roddick-Juan_Carlos_Ferrero,1,F-XC,38,14,4,7,3,27,11,,,,,,,,,,
20030907-M-US_Open-F-Andy_Roddick-Juan_Carlos_Ferrero,1,F-DTM,18,1,0,0,1,5,13,,,,,,,,,,
20030907-M-US_Open-F-Andy_Roddick-Juan_Carlos_Ferrero,1,F-DTL,3,1,0,0,1,1,2,,,,,,,,,,
20030907-M-US_Open-F-Andy_Roddick-Juan_Carlos_Ferrero,1,F-IO,18,4,2,1,1,13,5,,,,,,,,,,
20030907-M-US_Open-F-Andy_Roddick-Juan_Carlos_Ferrero,1,F-II,3,3,1,0,2,1,2,,,,,,,,,,
20030907-M-US_Open-F-Andy_Roddick-Juan_Carlos_Ferrero,1,B-XC,32,2,0,2,0,25,7,,,,,,,,,,
20030907-M-US_Open-F-Andy_Roddick-Juan_Carlos_Ferrero,1,B-DTM,20,4,0,0,4,7,13,,,,,,,,,,
20030907-M-US_Open-F-Andy_Roddick-Juan_Carlos_Ferrero,1,B-DTL,6,6,2,3,1,5,1,,,,,,,,,,
20030907-M-US_Open-F-Andy_Roddick-Juan_Carlos_Ferrero,1,B-IO,5,2,1,1,0,5,0,,,,,,,,,,
20030907-M-US_Open-F-Andy_Roddick-Juan_Carlos_Ferrero,1,S-XC,12,0,0,0,0,7,5,,,,,,,,,,
20030907-M-US_Open-F-Andy_Roddick-Juan_Carlos_Ferrero,1,S-DTM,3,0,0,0,0,2,1,,,,,,,,,,
20030907-M-US_Open-F-Andy_Roddick-Juan_Carlos_Ferrero,1,S-DTL,1,1,0,1,0,1,0,,,,,,,,,,
20030907-M-US_Open-F-Andy_Roddick-Juan_Carlos_Ferrero,2,F-XC,26,9,5,3,1,17,9,,,,,,,,,,
20030907-M-US_Open-F-Andy_Roddick-Juan_Carlos_Ferrero,2,F-DTM,26,1,0,0,1,9,17,,,,,,,,,,
20030907-M-US_Open-F-Andy_Roddick-Juan_Carlos_Ferrero,2,F-DTL,13,2,0,0,2,2,11,,,,,,,,,,
20030907-M-US_Open-F-Andy_Roddick-Juan_Carlos_Ferrero,2,F-IO,26,7,3,1,3,13,13,,,,,,,,,,
20030907-M-US_Open-F-Andy_Roddick-Juan_Carlos_Ferrero,2,F-II,8,2,0,0,2,4,4,,,,,,,,,,
20030907-M-US_Open-F-Andy_Roddick-Juan_Carlos_Ferrero,2,B-XC,42,12,4,2,6,14,28,,,,,,,,,,
20030907-M-US_Open-F-Andy_Roddick-Juan_Carlos_Ferrero,2,B-DTM,32,3,0,0,3,11,21,,,,,,,,,,
20030907-M-US_Open-F-Andy_Roddick-Juan_Carlos_Ferrero,2,B-DTL,9,3,1,1,1,4,5,,,,,,,,,,
20030907-M-US_Open-F-Andy_Roddick-Juan_Carlos_Ferrero,2,B-IO,1,1,1,0,0,1,0,,,,,,,,,,
20030907-M-US_Open-F-Andy_Roddick-Juan_Carlos_Ferrero,2,S-XC,1,0,0,0,0,1,0,,,,,,,,,,
20030907-M-US_Open-F-Andy_Roddick-Juan_Carlos_Ferrero,2,S-DTL,1,0,0,0,0,1,0,,,,,,,,,,
20031110-M-Masters_Cup-RR-Roger_Federer-Juan_Carlos_Ferrero,1,F-XC,19,6,6,0,0,17,2,,,,,,,,,,
20031110-M-Masters_Cup-RR-Roger_Federer-Juan_Carlos_Ferrero,1,F-DTM,12,1,0,1,0,8,4,,,,,,,,,,
20031110-M-Masters_Cup-RR-Roger_Federer-Juan_Carlos_Ferrero,1,F-DTL,4,2,2,0,0,4,0,,,,,,,,,,
20031110-M-Masters_Cup-RR-Roger_Federer-Juan_Carlos_Ferrero,1,F-IO,6,4,3,0,1,4,2,,,,,,,,,,
20031110-M-Masters_Cup-RR-Roger_Federer-Juan_Carlos_Ferrero,1,F-II,1,0,0,0,0,1,0,,,,,,,,,,
20031110-M-Masters_Cup-RR-Roger_Federer-Juan_Carlos_Ferrero,1,B-XC,15,2,1,0,1,11,4,,,,,,,,,,
20031110-M-Masters_Cup-RR-Roger_Federer-Juan_Carlos_Ferrero,1,B-DTM,11,1,0,0,1,7,4,,,,,,,,,,
20031110-M-Masters_Cup-RR-Roger_Federer-Juan_Carlos_Ferrero,1,B-DTL,3,3,0,1,2,1,2,,,,,,,,,,
20031110-M-Masters_Cup-RR-Roger_Federer-Juan_Carlos_Ferrero,1,S-XC,11,2,0,0,2,6,5,,,,,,,,,,
20031110-M-Masters_Cup-RR-Roger_Federer-Juan_Carlos_Ferrero,1,S-DTM,1,0,0,0,0,0,1,,,,,,,,,,
20031110-M-Masters_Cup-RR-Roger_Federer-Juan_Carlos_Ferrero,1,S-DTL,1,0,0,0,0,1,0,,,,,,,,,,
20031110-M-Masters_Cup-RR-Roger_Federer-Juan_Carlos_Ferrero,2,F-XC,15,6,1,2,3,3,12,,,,,,,,,,
20031110-M-Masters_Cup-RR-Roger_Federer-Juan_Carlos_Ferrero,2,F-DTM,13,3,0,0,3,3,10,,,,,,,,,,
20031110-M-Masters_Cup-RR-Roger_Federer-Juan_Carlos_Ferrero,2,F-DTL,2,1,0,0,1,0,2,,,,,,,,,,
20031110-M-Masters_Cup-RR-Roger_Federer-Juan_Carlos_Ferrero,2,F-IO,8,3,1,0,2,4,4,,,,,,,,,,
20031110-M-Masters_Cup-RR-Roger_Federer-Juan_Carlos_Ferrero,2,F-II,1,0,0,0,0,0,1,,,,,,,,,,
20031110-M-Masters_Cup-RR-Roger_Federer-Juan_Carlos_Ferrero,2,B-XC,32,7,0,2,5,12,20,,,,,,,,,,
20031110-M-Masters_Cup-RR-Roger_Federer-Juan_Carlos_Ferrero,2,B-DTM,7,0,0,0,0,2,5,,,,,,,,,,
20031110-M-Masters_Cup-RR-Roger_Federer-Juan_Carlos_Ferrero,2,B-DTL,9,4,2,0,2,2,7,,,,,,,,,,
20031110-M-Masters_Cup-RR-Roger_Federer-Juan_Carlos_Ferrero,2,B-IO,2,0,0,0,0,0,2,,,,,,,,,,
20031110-M-Masters_Cup-RR-Roger_Federer-Juan_Carlos_Ferrero,2,S-XC,2,0,0,0,0,1,1,,,,,,,,,,
20031110-M-Masters_Cup-RR-Roger_Federer-Juan_Carlos_Ferrero,2,S-DTM,1,0,0,0,0,0,1,,,,,,,,,,
20040201-M-Australian_Open-F-Roger_Federer-Marat_Safin,1,F-XC,54,17,9,3,5,33,21,,,,,,,,,,
20040201-M-Australian_Open-F-Roger_Federer-Marat_Safin,1,F-DTM,18,1,0,0,1,10,8,,,,,,,,,,
20040201-M-Australian_Open-F-Roger_Federer-Marat_Safin,1,F-DTL,36,12,5,1,6,17,19,,,,,,,,,,
20040201-M-Australian_Open-F-Roger_Federer-Marat_Safin,1,F-IO,31,7,2,1,4,16,15,,,,,,,,,,
20040201-M-Australian_Open-F-Roger_Federer-Marat_Safin,1,F-II,11,4,1,1,2,7,4,,,,,,,,,,
20040201-M-Australian_Open-F-Roger_Federer-Marat_Safin,1,B-XC,40,7,2,0,5,17,23,,,,,,,,,,
20040201-M-Australian_Open-F-Roger_Federer-Marat_Safin,1,B-DTM,38,1,0,0,1,18,20,,,,,,,,,,
20040201-M-Australian_Open-F-Roger_Federer-Marat_Safin,1,B-DTL,26,9,2,0,7,11,15,,,,,,,,,,
20040201-M-Australian_Open-F-Roger_Federer-Marat_Safin,1,B-IO,1,1,0,0,1,0,1,,,,,,,,,,
20040201-M-Australian_Open-F-Roger_Federer-Marat_Safin,1,S-XC,29,0,0,0,0,12,17,,,,,,,,,,
20040201-M-Australian_Open-F-Roger_Federer-Marat_Safin,1,S-DTM,12,0,0,0,0,5,7,,,,,,,,,,
20040201-M-Australian_Open-F-Roger_Federer-Marat_Safin,1,S-DTL,4,0,0,0,0,3,1,,,,,,,,,,
20040201-M-Australian_Open-F-Roger_Federer-Marat_Safin,1,S-IO,1,0,0,0,0,0,1,,,,,,,,,,
20040201-M-Australian_Open-F-Roger_Federer-Marat_Safin,2,F-XC,64,10,2,2,6,29,35,,,,,,,,,,
20040201-M-Australian_Open-F-Roger_Federer-Marat_Safin,2,F-DTM,22,3,0,0,3,9,13,,,,,,,,,,
20040201-M-Australian_Open-F-Roger_Federer-Marat_Safin,2,F-DTL,22,10,1,4,5,12,10,,,,,,,,,,
20040201-M-Australian_Open-F-Roger_Federer-Marat_Safin,2,F-IO,32,6,1,3,2,14,18,,,,,,,,,,
20040201-M-Australian_Open-F-Roger_Federer-Marat_Safin,2,B-XC,122,19,1,5,13,66,56,,,,,,,,,,
20040201-M-Australian_Open-F-Roger_Federer-Marat_Safin,2,B-DTM,14,1,0,0,1,9,5,,,,,,,,,,
20040201-M-Australian_Open-F-Roger_Federer-Marat_Safin,2,B-DTL,15,8,0,2,6,6,9,,,,,,,,,,
20040201-M-Australian_Open-F-Roger_Federer-Marat_Safin,2,B-IO,4,1,0,0,1,3,1,,,,,,,,,,
20040201-M-Australian_Open-F-Roger_Federer-Marat_Safin,2,S-XC,8,1,0,0,1,3,5,,,,,,,,,,
20040201-M-Australian_Open-F-Roger_Federer-Marat_Safin,2,S-DTM,2,0,0,0,0,1,1,,,,,,,,,,
20040201-M-Australian_Open-F-Roger_Federer-Marat_Safin,2,S-DTL,5,1,0,0,1,3,2,,,,,,,,,,
20040606-M-Roland_Garros-F-Gaston_Gaudio-Guillermo_Coria,1,F-XC,178,27,9,8,10,97,81,,,,,,,,,,
20040606-M-Roland_Garros-F-Gaston_Gaudio-Guillermo_Coria,1,F-DTM,126,7,0,1,6,60,66,,,,,,,,,,
20040606-M-Roland_Garros-F-Gaston_Gaudio-Guillermo_Coria,1,F-DTL,33,4,0,1,3,13,20,,,,,,,,,,
20040606-M-Roland_Garros-F-Gaston_Gaudio-Guillermo_Coria,1,F-IO,68,13,3,3,7,36,32,,,,,,,,,,
20040606-M-Roland_Garros-F-Gaston_Gaudio-Guillermo_Coria,1,F-II,5,1,0,0,1,1,4,,,,,,,,,,
20040606-M-Roland_Garros-F-Gaston_Gaudio-Guillermo_Coria,1,B-XC,77,11,3,2,6,43,34,,,,,,,,,,
20040606-M-Roland_Garros-F-Gaston_Gaudio-Guillermo_Coria,1,B-DTM,90,11,1,1,9,42,48,,,,,,,,,,
20040606-M-Roland_Garros-F-Gaston_Gaudio-Guillermo_Coria,1,B-DTL,13,4,0,0,4,3,10,,,,,,,,,,
20040606-M-Roland_Garros-F-Gaston_Gaudio-Guillermo_Coria,1,B-IO,7,4,1,0,3,3,4,,,,,,,,,,
20040606-M-Roland_Garros-F-Gaston_Gaudio-Guillermo_Coria,1,S-XC,23,1,0,0,1,11,12,,,,,,,,,,
20040606-M-Roland_Garros-F-Gaston_Gaudio-Guillermo_Coria,1,S-DTM,24,0,0,0,0,12,12,,,,,,,,,,
20040606-M-Roland_Garros-F-Gaston_Gaudio-Guillermo_Coria,1,S-DTL,1,0,0,0,0,0,1,,,,,,,,,,
20040606-M-Roland_Garros-F-Gaston_Gaudio-Guillermo_Coria,2,F-XC,141,21,7,2,12,71,70,,,,,,,,,,
20040606-M-Roland_Garros-F-Gaston_Gaudio-Guillermo_Coria,2,F-DTM,138,14,1,1,12,72,66,,,,,,,,,,
20040606-M-Roland_Garros-F-Gaston_Gaudio-Guillermo_Coria,2,F-DTL,41,15,4,2,9,20,21,,,,,,,,,,
20040606-M-Roland_Garros-F-Gaston_Gaudio-Guillermo_Coria,2,F-IO,51,9,3,2,4,25,26,,,,,,,,,,
20040606-M-Roland_Garros-F-Gaston_Gaudio-Guillermo_Coria,2,F-II,17,4,0,2,2,9,8,,,,,,,,,,
20040606-M-Roland_Garros-F-Gaston_Gaudio-Guillermo_Coria,2,B-XC,64,8,4,2,2,36,28,,,,,,,,,,
20040606-M-Roland_Garros-F-Gaston_Gaudio-Guillermo_Coria,2,B-DTM,132,6,0,0,6,63,69,,,,,,,,,,
20040606-M-Roland_Garros-F-Gaston_Gaudio-Guillermo_Coria,2,B-DTL,33,9,2,1,6,11,22,,,,,,,,,,
20040606-M-Roland_Garros-F-Gaston_Gaudio-Guillermo_Coria,2,B-IO,18,3,0,1,2,8,10,,,,,,,,,,
20040606-M-Roland_Garros-F-Gaston_Gaudio-Guillermo_Coria,2,S-XC,2,0,0,0,0,1,1,,,,,,,,,,
20040606-M-Roland_Garros-F-Gaston_Gaudio-Guillermo_Coria,2,S-DTM,16,2,0,0,2,4,12,,,,,,,,,,
20040606-M-Roland_Garros-F-Gaston_Gaudio-Guillermo_Coria,2,S-DTL,1,0,0,0,0,1,0,,,,,,,,,,
20040606-M-Roland_Garros-F-Gaston_Gaudio-Guillermo_Coria,2,S-IO,1,0,0,0,0,1,0,,,,,,,,,,
20040704-M-Wimbledon-F-Roger_Federer-Andy_Roddick,1,F-XC,43,18,7,4,7,24,19,,,,,,,,,,
20040704-M-Wimbledon-F-Roger_Federer-Andy_Roddick,1,F-DTM,22,4,0,1,3,14,8,,,,,,,,,,
20040704-M-Wimbledon-F-Roger_Federer-Andy_Roddick,1,F-DTL,8,3,2,1,0,4,4,,,,,,,,,,
20040704-M-Wimbledon-F-Roger_Federer-Andy_Roddick,1,F-IO,34,10,5,5,0,28,6,,,,,,,,,,
20040704-M-Wimbledon-F-Roger_Federer-Andy_Roddick,1,F-II,6,5,2,1,2,3,3,,,,,,,,,,
20040704-M-Wimbledon-F-Roger_Federer-Andy_Roddick,1,B-XC,40,15,6,3,6,23,17,,,,,,,,,,
20040704-M-Wimbledon-F-Roger_Federer-Andy_Roddick,1,B-DTM,26,2,1,0,1,10,16,,,,,,,,,,
20040704-M-Wimbledon-F-Roger_Federer-Andy_Roddick,1,B-DTL,15,3,1,1,1,9,6,,,,,,,,,,
20040704-M-Wimbledon-F-Roger_Federer-Andy_Roddick,1,B-IO,2,2,0,1,1,1,1,,,,,,,,,,
20040704-M-Wimbledon-F-Roger_Federer-Andy_Roddick,1,S-XC,10,0,0,0,0,3,7,,,,,,,,,,
20040704-M-Wimbledon-F-Roger_Federer-Andy_Roddick,1,S-DTM,8,1,0,0,1,4,4,,,,,,,,,,
20040704-M-Wimbledon-F-Roger_Federer-Andy_Roddick,1,S-DTL,1,1,0,1,0,1,0,,,,,,,,,,
20040704-M-Wimbledon-F-Roger_Federer-Andy_Roddick,2,F-XC,44,18,5,4,9,24,20,,,,,,,,,,
20040704-M-Wimbledon-F-Roger_Federer-Andy_Roddick,2,F-DTM,27,7,1,0,6,7,20,,,,,,,,,,
20040704-M-Wimbledon-F-Roger_Federer-Andy_Roddick,2,F-DTL,15,9,1,5,3,11,4,,,,,,,,,,
20040704-M-Wimbledon-F-Roger_Federer-Andy_Roddick,2,F-IO,44,10,4,3,3,24,20,,,,,,,,,,
20040704-M-Wimbledon-F-Roger_Federer-Andy_Roddick,2,F-II,8,5,3,1,1,4,4,,,,,,,,,,
20040704-M-Wimbledon-F-Roger_Federer-Andy_Roddick,2,B-XC,48,12,2,2,8,20,28,,,,,,,,,,
20040704-M-Wimbledon-F-Roger_Federer-Andy_Roddick,2,B-DTM,12,1,0,1,0,5,7,,,,,,,,,,
20040704-M-Wimbledon-F-Roger_Federer-Andy_Roddick,2,B-DTL,8,5,4,1,0,6,2,,,,,,,,,,
20040704-M-Wimbledon-F-Roger_Federer-Andy_Roddick,2,B-IO,4,1,1,0,0,3,1,,,,,,,,,,
20040704-M-Wimbledon-F-Roger_Federer-Andy_Roddick,2,S-XC,9,2,0,1,1,4,5,,,,,,,,,,
20040704-M-Wimbledon-F-Roger_Federer-Andy_Roddick,2,S-DTM,6,1,0,1,0,3,3,,,,,,,,,,
20040704-M-Wimbledon-F-Roger_Federer-Andy_Roddick,2,S-DTL,1,0,0,0,0,0,1,,,,,,,,,,
20040704-M-Wimbledon-F-Roger_Federer-Andy_Roddick,2,S-II,1,0,0,0,0,0,1,,,,,,,,,,
20040726-M-Canada_Masters-R32-Andy_Roddick-Feliciano_Lopez,1,F-XC,16,1,0,0,1,5,11,,,,,,,,,,
20040726-M-Canada_Masters-R32-Andy_Roddick-Feliciano_Lopez,1,F-DTM,9,0,0,0,0,6,3,,,,,,,,,,
20040726-M-Canada_Masters-R32-Andy_Roddick-Feliciano_Lopez,1,F-DTL,2,1,1,0,0,1,1,,,,,,,,,,
20040726-M-Canada_Masters-R32-Andy_Roddick-Feliciano_Lopez,1,F-IO,14,7,2,2,3,5,9,,,,,,,,,,
20040726-M-Canada_Masters-R32-Andy_Roddick-Feliciano_Lopez,1,F-II,1,0,0,0,0,0,1,,,,,,,,,,
20040726-M-Canada_Masters-R32-Andy_Roddick-Feliciano_Lopez,1,B-XC,9,6,1,2,3,3,6,,,,,,,,,,
20040726-M-Canada_Masters-R32-Andy_Roddick-Feliciano_Lopez,1,B-DTM,23,4,0,0,4,10,13,,,,,,,,,,
20040726-M-Canada_Masters-R32-Andy_Roddick-Feliciano_Lopez,1,B-DTL,4,2,1,1,0,2,2,,,,,,,,,,
20040726-M-Canada_Masters-R32-Andy_Roddick-Feliciano_Lopez,1,B-IO,3,3,0,1,2,1,2,,,,,,,,,,
20040726-M-Canada_Masters-R32-Andy_Roddick-Feliciano_Lopez,1,S-XC,4,1,0,1,0,3,1,,,,,,,,,,
20040726-M-Canada_Masters-R32-Andy_Roddick-Feliciano_Lopez,1,S-DTM,2,0,0,0,0,2,0,,,,,,,,,,
20040726-M-Canada_Masters-R32-Andy_Roddick-Feliciano_Lopez,1,S-DTL,4,1,0,0,1,1,3,,,,,,,,,,
20040726-M-Canada_Masters-R32-Andy_Roddick-Feliciano_Lopez,1,S-IO,3,1,0,0,1,0,3,,,,,,,,,,
20040726-M-Canada_Masters-R32-Andy_Roddick-Feliciano_Lopez,2,F-XC,29,3,2,0,1,18,11,,,,,,,,,,
20040726-M-Canada_Masters-R32-Andy_Roddick-Feliciano_Lopez,2,F-DTM,17,1,0,0,1,9,8,,,,,,,,,,
20040726-M-Canada_Masters-R32-Andy_Roddick-Feliciano_Lopez,2,F-DTL,7,5,2,1,2,4,3,,,,,,,,,,
20040726-M-Canada_Masters-R32-Andy_Roddick-Feliciano_Lopez,2,F-IO,20,11,1,3,7,10,10,,,,,,,,,,
20040726-M-Canada_Masters-R32-Andy_Roddick-Feliciano_Lopez,2,B-XC,5,4,1,0,3,1,4,,,,,,,,,,
20040726-M-Canada_Masters-R32-Andy_Roddick-Feliciano_Lopez,2,B-DTM,10,2,0,1,1,8,2,,,,,,,,,,
20040726-M-Canada_Masters-R32-Andy_Roddick-Feliciano_Lopez,2,B-IO,2,0,0,0,0,1,1,,,,,,,,,,
20040726-M-Canada_Masters-R32-Andy_Roddick-Feliciano_Lopez,2,S-XC,3,1,0,0,1,2,1,,,,,,,,,,
20040726-M-Canada_Masters-R32-Andy_Roddick-Feliciano_Lopez,2,S-DTM,3,1,0,0,1,1,2,,,,,,,,,,
20040726-M-Canada_Masters-R32-Andy_Roddick-Feliciano_Lopez,2,S-DTL,6,1,1,0,0,4,2,,,,,,,,,,
20040726-M-Canada_Masters-R32-Andy_Roddick-Feliciano_Lopez,2,S-IO,3,1,0,0,1,1,2,,,,,,,,,,
20041025-M-St_Petersburg-F-Karol_Beck-Mikhail_Youzhny,1,F-XC,24,5,1,2,2,11,13,,,,,,,,,,
20041025-M-St_Petersburg-F-Karol_Beck-Mikhail_Youzhny,1,F-DTM,18,3,0,0,3,6,12,,,,,,,,,,
20041025-M-St_Petersburg-F-Karol_Beck-Mikhail_Youzhny,1,F-DTL,7,5,0,2,3,3,4,,,,,,,,,,
20041025-M-St_Petersburg-F-Karol_Beck-Mikhail_Youzhny,1,F-IO,20,6,0,2,4,5,15,,,,,,,,,,
20041025-M-St_Petersburg-F-Karol_Beck-Mikhail_Youzhny,1,F-II,5,1,0,0,1,1,4,,,,,,,,,,
20041025-M-St_Petersburg-F-Karol_Beck-Mikhail_Youzhny,1,B-XC,32,4,0,1,3,12,20,,,,,,,,,,
20041025-M-St_Petersburg-F-Karol_Beck-Mikhail_Youzhny,1,B-DTM,12,3,0,1,2,7,5,,,,,,,,,,
20041025-M-St_Petersburg-F-Karol_Beck-Mikhail_Youzhny,1,B-DTL,5,2,0,0,2,2,3,,,,,,,,,,
20041025-M-St_Petersburg-F-Karol_Beck-Mikhail_Youzhny,1,B-IO,2,1,1,0,0,2,0,,,,,,,,,,
20041025-M-St_Petersburg-F-Karol_Beck-Mikhail_Youzhny,1,S-XC,15,0,0,0,0,2,13,,,,,,,,,,
20041025-M-St_Petersburg-F-Karol_Beck-Mikhail_Youzhny,1,S-DTM,2,1,0,0,1,0,2,,,,,,,,,,
20041025-M-St_Petersburg-F-Karol_Beck-Mikhail_Youzhny,1,S-DTL,3,1,0,0,1,1,2,,,,,,,,,,
20041025-M-St_Petersburg-F-Karol_Beck-Mikhail_Youzhny,1,S-IO,2,2,0,0,2,0,2,,,,,,,,,,
20041025-M-St_Petersburg-F-Karol_Beck-Mikhail_Youzhny,2,F-XC,13,1,0,0,1,7,6,,,,,,,,,,
20041025-M-St_Petersburg-F-Karol_Beck-Mikhail_Youzhny,2,F-DTM,14,1,0,1,0,9,5,,,,,,,,,,
20041025-M-St_Petersburg-F-Karol_Beck-Mikhail_Youzhny,2,F-DTL,17,7,2,3,2,9,8,,,,,,,,,,
20041025-M-St_Petersburg-F-Karol_Beck-Mikhail_Youzhny,2,F-IO,7,3,2,0,1,5,2,,,,,,,,,,
20041025-M-St_Petersburg-F-Karol_Beck-Mikhail_Youzhny,2,B-XC,17,4,2,1,1,10,7,,,,,,,,,,
20041025-M-St_Petersburg-F-Karol_Beck-Mikhail_Youzhny,2,B-DTM,14,0,0,0,0,8,6,,,,,,,,,,
20041025-M-St_Petersburg-F-Karol_Beck-Mikhail_Youzhny,2,B-DTL,5,3,0,1,2,2,3,,,,,,,,,,
20041025-M-St_Petersburg-F-Karol_Beck-Mikhail_Youzhny,2,B-IO,2,1,1,0,0,2,0,,,,,,,,,,
20041025-M-St_Petersburg-F-Karol_Beck-Mikhail_Youzhny,2,S-XC,28,1,1,0,0,25,3,,,,,,,,,,
20041025-M-St_Petersburg-F-Karol_Beck-Mikhail_Youzhny,2,S-DTM,16,1,0,0,1,11,5,,,,,,,,,,
20041025-M-St_Petersburg-F-Karol_Beck-Mikhail_Youzhny,2,S-DTL,3,0,0,0,0,1,2,,,,,,,,,,
20041025-M-St_Petersburg-F-Karol_Beck-Mikhail_Youzhny,2,S-IO,1,0,0,0,0,1,0,,,,,,,,,,
20041115-M-Masters_Cup-F-Roger_Federer-Lleyton_Hewitt,1,F-XC,35,10,4,3,3,17,18,,,,,,,,,,
20041115-M-Masters_Cup-F-Roger_Federer-Lleyton_Hewitt,1,F-DTM,10,0,0,0,0,3,7,,,,,,,,,,
20041115-M-Masters_Cup-F-Roger_Federer-Lleyton_Hewitt,1,F-DTL,8,3,2,1,0,7,1,,,,,,,,,,
20041115-M-Masters_Cup-F-Roger_Federer-Lleyton_Hewitt,1,F-IO,7,3,0,2,1,5,2,,,,,,,,,,
20041115-M-Masters_Cup-F-Roger_Federer-Lleyton_Hewitt,1,F-II,3,2,0,2,0,2,1,,,,,,,,,,
20041115-M-Masters_Cup-F-Roger_Federer-Lleyton_Hewitt,1,B-XC,40,5,0,2,3,19,21,,,,,,,,,,
20041115-M-Masters_Cup-F-Roger_Federer-Lleyton_Hewitt,1,B-DTM,18,1,0,0,1,6,12,,,,,,,,,,
20041115-M-Masters_Cup-F-Roger_Federer-Lleyton_Hewitt,1,B-DTL,9,5,2,3,0,6,3,,,,,,,,,,
20041115-M-Masters_Cup-F-Roger_Federer-Lleyton_Hewitt,1,B-IO,4,1,0,0,1,3,1,,,,,,,,,,
20041115-M-Masters_Cup-F-Roger_Federer-Lleyton_Hewitt,1,S-XC,17,1,0,0,1,9,8,,,,,,,,,,
20041115-M-Masters_Cup-F-Roger_Federer-Lleyton_Hewitt,1,S-DTM,4,0,0,0,0,2,2,,,,,,,,,,
20041115-M-Masters_Cup-F-Roger_Federer-Lleyton_Hewitt,1,S-DTL,2,0,0,0,0,1,1,,,,,,,,,,
20041115-M-Masters_Cup-F-Roger_Federer-Lleyton_Hewitt,1,S-IO,2,1,0,0,1,0,2,,,,,,,,,,
20041115-M-Masters_Cup-F-Roger_Federer-Lleyton_Hewitt,2,F-XC,36,9,1,5,3,20,16,,,,,,,,,,
20041115-M-Masters_Cup-F-Roger_Federer-Lleyton_Hewitt,2,F-DTM,14,0,0,0,0,10,4,,,,,,,,,,
20041115-M-Masters_Cup-F-Roger_Federer-Lleyton_Hewitt,2,F-DTL,9,0,0,0,0,4,5,,,,,,,,,,
20041115-M-Masters_Cup-F-Roger_Federer-Lleyton_Hewitt,2,F-IO,22,4,2,1,1,11,11,,,,,,,,,,
20041115-M-Masters_Cup-F-Roger_Federer-Lleyton_Hewitt,2,F-II,1,0,0,0,0,0,1,,,,,,,,,,
20041115-M-Masters_Cup-F-Roger_Federer-Lleyton_Hewitt,2,B-XC,41,3,0,3,0,20,21,,,,,,,,,,
20041115-M-Masters_Cup-F-Roger_Federer-Lleyton_Hewitt,2,B-DTM,14,1,0,0,1,7,7,,,,,,,,,,
20041115-M-Masters_Cup-F-Roger_Federer-Lleyton_Hewitt,2,B-DTL,5,4,1,0,3,2,3,,,,,,,,,,
20041115-M-Masters_Cup-F-Roger_Federer-Lleyton_Hewitt,2,B-IO,2,1,0,0,1,1,1,,,,,,,,,,
20041115-M-Masters_Cup-F-Roger_Federer-Lleyton_Hewitt,2,S-XC,11,0,0,0,0,7,4,,,,,,,,,,
20041115-M-Masters_Cup-F-Roger_Federer-Lleyton_Hewitt,2,S-DTM,2,0,0,0,0,1,1,,,,,,,,,,
20041115-M-Masters_Cup-F-Roger_Federer-Lleyton_Hewitt,2,S-DTL,3,0,0,0,0,0,3,,,,,,,,,,
20041115-M-Masters_Cup-F-Roger_Federer-Lleyton_Hewitt,2,S-IO,1,0,0,0,0,0,1,,,,,,,,,,
20050221-M-Dubai-SF-Roger_Federer-Andre_Agassi,1,F-XC,22,11,5,3,3,13,9,,,,,,,,,,
20050221-M-Dubai-SF-Roger_Federer-Andre_Agassi,1,F-DTM,3,0,0,0,0,2,1,,,,,,,,,,
20050221-M-Dubai-SF-Roger_Federer-Andre_Agassi,1,F-DTL,4,2,2,0,0,3,1,,,,,,,,,,
20050221-M-Dubai-SF-Roger_Federer-Andre_Agassi,1,F-IO,8,4,1,0,3,5,3,,,,,,,,,,
20050221-M-Dubai-SF-Roger_Federer-Andre_Agassi,1,B-XC,18,3,0,0,3,9,9,,,,,,,,,,
20050221-M-Dubai-SF-Roger_Federer-Andre_Agassi,1,B-DTM,20,2,0,0,2,9,11,,,,,,,,,,
20050221-M-Dubai-SF-Roger_Federer-Andre_Agassi,1,B-DTL,5,5,2,1,2,3,2,,,,,,,,,,
20050221-M-Dubai-SF-Roger_Federer-Andre_Agassi,1,S-XC,11,0,0,0,0,4,7,,,,,,,,,,
20050221-M-Dubai-SF-Roger_Federer-Andre_Agassi,1,S-DTM,3,0,0,0,0,2,1,,,,,,,,,,
20050221-M-Dubai-SF-Roger_Federer-Andre_Agassi,1,S-DTL,2,0,0,0,0,1,1,,,,,,,,,,
20050221-M-Dubai-SF-Roger_Federer-Andre_Agassi,2,F-XC,10,3,0,1,2,4,6,,,,,,,,,,
20050221-M-Dubai-SF-Roger_Federer-Andre_Agassi,2,F-DTM,8,0,0,0,0,4,4,,,,,,,,,,
20050221-M-Dubai-SF-Roger_Federer-Andre_Agassi,2,F-DTL,7,2,0,0,2,3,4,,,,,,,,,,
20050221-M-Dubai-SF-Roger_Federer-Andre_Agassi,2,F-IO,19,5,0,1,4,9,10,,,,,,,,,,
20050221-M-Dubai-SF-Roger_Federer-Andre_Agassi,2,F-II,2,1,1,0,0,1,1,,,,,,,,,,
20050221-M-Dubai-SF-Roger_Federer-Andre_Agassi,2,B-XC,28,3,0,0,3,12,16,,,,,,,,,,
20050221-M-Dubai-SF-Roger_Federer-Andre_Agassi,2,B-DTM,13,4,0,1,3,6,7,,,,,,,,,,
20050221-M-Dubai-SF-Roger_Federer-Andre_Agassi,2,B-DTL,2,1,0,1,0,2,0,,,,,,,,,,
20050221-M-Dubai-SF-Roger_Federer-Andre_Agassi,2,S-DTM,2,0,0,0,0,1,1,,,,,,,,,,
20050221-M-Dubai-SF-Roger_Federer-Andre_Agassi,2,S-DTL,2,0,0,0,0,1,1,,,,,,,,,,
20050318-M-Indian_Wells_Masters-SF-Roger_Federer-Guillermo_Canas,1,F-XC,37,10,2,5,3,23,14,,,,,,,,,,
20050318-M-Indian_Wells_Masters-SF-Roger_Federer-Guillermo_Canas,1,F-DTM,22,2,0,0,2,7,15,,,,,,,,,,
20050318-M-Indian_Wells_Masters-SF-Roger_Federer-Guillermo_Canas,1,F-DTL,14,6,2,1,3,5,9,,,,,,,,,,
20050318-M-Indian_Wells_Masters-SF-Roger_Federer-Guillermo_Canas,1,F-IO,24,8,4,3,1,15,9,,,,,,,,,,
20050318-M-Indian_Wells_Masters-SF-Roger_Federer-Guillermo_Canas,1,F-II,3,1,1,0,0,1,2,,,,,,,,,,
20050318-M-Indian_Wells_Masters-SF-Roger_Federer-Guillermo_Canas,1,B-XC,34,5,2,1,2,16,18,,,,,,,,,,
20050318-M-Indian_Wells_Masters-SF-Roger_Federer-Guillermo_Canas,1,B-DTM,12,1,0,0,1,6,6,,,,,,,,,,
20050318-M-Indian_Wells_Masters-SF-Roger_Federer-Guillermo_Canas,1,B-DTL,7,3,2,0,1,3,4,,,,,,,,,,
20050318-M-Indian_Wells_Masters-SF-Roger_Federer-Guillermo_Canas,1,B-IO,1,0,0,0,0,1,0,,,,,,,,,,
20050318-M-Indian_Wells_Masters-SF-Roger_Federer-Guillermo_Canas,1,S-XC,4,0,0,0,0,2,2,,,,,,,,,,
20050318-M-Indian_Wells_Masters-SF-Roger_Federer-Guillermo_Canas,1,S-DTM,3,1,0,0,1,0,3,,,,,,,,,,
20050318-M-Indian_Wells_Masters-SF-Roger_Federer-Guillermo_Canas,1,S-DTL,1,0,0,0,0,0,1,,,,,,,,,,
20050318-M-Indian_Wells_Masters-SF-Roger_Federer-Guillermo_Canas,2,F-XC,32,4,2,1,1,17,15,,,,,,,,,,
20050318-M-Indian_Wells_Masters-SF-Roger_Federer-Guillermo_Canas,2,F-DTM,12,1,0,0,1,4,8,,,,,,,,,,
20050318-M-Indian_Wells_Masters-SF-Roger_Federer-Guillermo_Canas,2,F-DTL,9,2,1,0,1,6,3,,,,,,,,,,
20050318-M-Indian_Wells_Masters-SF-Roger_Federer-Guillermo_Canas,2,F-IO,32,5,1,2,2,18,14,,,,,,,,,,
20050318-M-Indian_Wells_Masters-SF-Roger_Federer-Guillermo_Canas,2,F-II,9,2,1,0,1,6,3,,,,,,,,,,
20050318-M-Indian_Wells_Masters-SF-Roger_Federer-Guillermo_Canas,2,B-XC,32,9,2,2,5,18,14,,,,,,,,,,
20050318-M-Indian_Wells_Masters-SF-Roger_Federer-Guillermo_Canas,2,B-DTM,19,1,0,0,1,9,10,,,,,,,,,,
20050318-M-Indian_Wells_Masters-SF-Roger_Federer-Guillermo_Canas,2,B-DTL,4,1,0,0,1,3,1,,,,,,,,,,
20050318-M-Indian_Wells_Masters-SF-Roger_Federer-Guillermo_Canas,2,S-XC,6,1,0,0,1,0,6,,,,,,,,,,
20050318-M-Indian_Wells_Masters-SF-Roger_Federer-Guillermo_Canas,2,S-DTM,1,0,0,0,0,0,1,,,,,,,,,,
20050703-M-Wimbledon-F-Roger_Federer-Andy_Roddick,1,F-XC,28,12,6,3,3,19,9,,,,,,,,,,
20050703-M-Wimbledon-F-Roger_Federer-Andy_Roddick,1,F-DTM,20,2,1,0,1,11,9,,,,,,,,,,
20050703-M-Wimbledon-F-Roger_Federer-Andy_Roddick,1,F-DTL,5,3,2,1,0,4,1,,,,,,,,,,
20050703-M-Wimbledon-F-Roger_Federer-Andy_Roddick,1,F-IO,19,5,3,2,0,14,5,,,,,,,,,,
20050703-M-Wimbledon-F-Roger_Federer-Andy_Roddick,1,F-II,5,4,3,1,0,4,1,,,,,,,,,,
20050703-M-Wimbledon-F-Roger_Federer-Andy_Roddick,1,B-XC,36,10,5,0,5,20,16,,,,,,,,,,
20050703-M-Wimbledon-F-Roger_Federer-Andy_Roddick,1,B-DTM,20,5,1,2,2,10,10,,,,,,,,,,
20050703-M-Wimbledon-F-Roger_Federer-Andy_Roddick,1,B-DTL,13,8,4,1,3,9,4,,,,,,,,,,
20050703-M-Wimbledon-F-Roger_Federer-Andy_Roddick,1,B-IO,2,1,0,0,1,0,2,,,,,,,,,,
20050703-M-Wimbledon-F-Roger_Federer-Andy_Roddick,1,S-XC,9,2,0,1,1,4,5,,,,,,,,,,
20050703-M-Wimbledon-F-Roger_Federer-Andy_Roddick,1,S-DTM,3,0,0,0,0,3,0,,,,,,,,,,
20050703-M-Wimbledon-F-Roger_Federer-Andy_Roddick,1,S-DTL,4,1,0,0,1,2,2,,,,,,,,,,
20050703-M-Wimbledon-F-Roger_Federer-Andy_Roddick,2,F-XC,25,10,0,2,8,8,17,,,,,,,,,,
20050703-M-Wimbledon-F-Roger_Federer-Andy_Roddick,2,F-DTM,15,0,0,0,0,7,8,,,,,,,,,,
20050703-M-Wimbledon-F-Roger_Federer-Andy_Roddick,2,F-DTL,14,5,0,3,2,6,8,,,,,,,,,,
20050703-M-Wimbledon-F-Roger_Federer-Andy_Roddick,2,F-IO,33,6,2,3,1,16,17,,,,,,,,,,
20050703-M-Wimbledon-F-Roger_Federer-Andy_Roddick,2,F-II,6,1,1,0,0,4,2,,,,,,,,,,
20050703-M-Wimbledon-F-Roger_Federer-Andy_Roddick,2,B-XC,29,3,0,1,2,12,17,,,,,,,,,,
20050703-M-Wimbledon-F-Roger_Federer-Andy_Roddick,2,B-DTM,16,2,0,1,1,8,8,,,,,,,,,,
20050703-M-Wimbledon-F-Roger_Federer-Andy_Roddick,2,B-DTL,8,3,1,0,2,3,5,,,,,,,,,,
20050703-M-Wimbledon-F-Roger_Federer-Andy_Roddick,2,S-XC,3,0,0,0,0,1,2,,,,,,,,,,
20050703-M-Wimbledon-F-Roger_Federer-Andy_Roddick,2,S-DTM,4,0,0,0,0,2,2,,,,,,,,,,
20050703-M-Wimbledon-F-Roger_Federer-Andy_Roddick,2,S-DTL,3,1,1,0,0,1,2,,,,,,,,,,
20050703-M-Wimbledon-F-Roger_Federer-Andy_Roddick,2,S-IO,1,0,0,0,0,0,1,,,,,,,,,,
20050911-M-US_Open-F-Roger_Federer-Andre_Agassi,1,F-XC,57,22,8,10,4,31,26,,,,,,,,,,
20050911-M-US_Open-F-Roger_Federer-Andre_Agassi,1,F-DTM,27,4,2,0,2,11,16,,,,,,,,,,
20050911-M-US_Open-F-Roger_Federer-Andre_Agassi,1,F-DTL,19,6,6,0,0,13,6,,,,,,,,,,
20050911-M-US_Open-F-Roger_Federer-Andre_Agassi,1,F-IO,24,16,5,5,5,13,11,,,,,,,,,,
20050911-M-US_Open-F-Roger_Federer-Andre_Agassi,1,F-II,5,3,2,0,1,3,2,,,,,,,,,,
20050911-M-US_Open-F-Roger_Federer-Andre_Agassi,1,B-XC,35,6,3,1,2,17,18,,,,,,,,,,
20050911-M-US_Open-F-Roger_Federer-Andre_Agassi,1,B-DTM,49,7,0,0,7,21,28,,,,,,,,,,
20050911-M-US_Open-F-Roger_Federer-Andre_Agassi,1,B-DTL,10,7,4,1,2,7,3,,,,,,,,,,
20050911-M-US_Open-F-Roger_Federer-Andre_Agassi,1,B-IO,4,3,1,0,2,2,2,,,,,,,,,,
20050911-M-US_Open-F-Roger_Federer-Andre_Agassi,1,S-XC,23,1,0,0,1,13,10,,,,,,,,,,
20050911-M-US_Open-F-Roger_Federer-Andre_Agassi,1,S-DTM,13,1,0,0,1,6,7,,,,,,,,,,
20050911-M-US_Open-F-Roger_Federer-Andre_Agassi,1,S-DTL,3,1,0,0,1,0,3,,,,,,,,,,
20050911-M-US_Open-F-Roger_Federer-Andre_Agassi,1,S-IO,1,0,0,0,0,1,0,,,,,,,,,,
20050911-M-US_Open-F-Roger_Federer-Andre_Agassi,2,F-XC,56,17,4,10,3,36,20,,,,,,,,,,
20050911-M-US_Open-F-Roger_Federer-Andre_Agassi,2,F-DTM,32,2,0,0,2,17,15,,,,,,,,,,
20050911-M-US_Open-F-Roger_Federer-Andre_Agassi,2,F-DTL,15,4,1,1,2,7,8,,,,,,,,,,
20050911-M-US_Open-F-Roger_Federer-Andre_Agassi,2,F-IO,35,5,2,0,3,20,15,,,,,,,,,,
20050911-M-US_Open-F-Roger_Federer-Andre_Agassi,2,F-II,6,4,2,0,2,3,3,,,,,,,,,,
20050911-M-US_Open-F-Roger_Federer-Andre_Agassi,2,B-XC,82,17,2,6,9,41,41,,,,,,,,,,
20050911-M-US_Open-F-Roger_Federer-Andre_Agassi,2,B-DTM,27,7,0,2,5,9,18,,,,,,,,,,
20050911-M-US_Open-F-Roger_Federer-Andre_Agassi,2,B-DTL,8,3,2,1,0,6,2,,,,,,,,,,
20050911-M-US_Open-F-Roger_Federer-Andre_Agassi,2,B-IO,6,2,0,1,1,1,5,,,,,,,,,,
20050911-M-US_Open-F-Roger_Federer-Andre_Agassi,2,S-XC,10,0,0,0,0,8,2,,,,,,,,,,
20050911-M-US_Open-F-Roger_Federer-Andre_Agassi,2,S-DTM,3,0,0,0,0,2,1,,,,,,,,,,
20050911-M-US_Open-F-Roger_Federer-Andre_Agassi,2,S-DTL,4,1,1,0,0,2,2,,,,,,,,,,
20060123-M-Australian_Open-QF-David_Nalbandian-Fabrice_Santoro,1,F-XC,55,14,6,2,6,38,17,,,,,,,,,,
20060123-M-Australian_Open-QF-David_Nalbandian-Fabrice_Santoro,1,F-DTM,9,1,1,0,0,6,3,,,,,,,,,,
20060123-M-Australian_Open-QF-David_Nalbandian-Fabrice_Santoro,1,F-DTL,26,8,4,3,1,17,9,,,,,,,,,,
20060123-M-Australian_Open-QF-David_Nalbandian-Fabrice_Santoro,1,F-IO,20,7,4,1,2,12,8,,,,,,,,,,
20060123-M-Australian_Open-QF-David_Nalbandian-Fabrice_Santoro,1,F-II,2,1,1,0,0,2,0,,,,,,,,,,
20060123-M-Australian_Open-QF-David_Nalbandian-Fabrice_Santoro,1,B-XC,61,9,2,6,1,37,24,,,,,,,,,,
20060123-M-Australian_Open-QF-David_Nalbandian-Fabrice_Santoro,1,B-DTM,22,2,2,0,0,13,9,,,,,,,,,,
20060123-M-Australian_Open-QF-David_Nalbandian-Fabrice_Santoro,1,B-DTL,24,10,4,5,1,16,8,,,,,,,,,,
20060123-M-Australian_Open-QF-David_Nalbandian-Fabrice_Santoro,1,B-IO,14,5,4,0,1,12,2,,,,,,,,,,
20060123-M-Australian_Open-QF-David_Nalbandian-Fabrice_Santoro,1,B-II,1,0,0,0,0,0,1,,,,,,,,,,
20060123-M-Australian_Open-QF-David_Nalbandian-Fabrice_Santoro,1,S-XC,7,2,0,1,1,2,5,,,,,,,,,,
20060123-M-Australian_Open-QF-David_Nalbandian-Fabrice_Santoro,1,S-DTM,1,0,0,0,0,0,1,,,,,,,,,,
20060123-M-Australian_Open-QF-David_Nalbandian-Fabrice_Santoro,1,S-DTL,3,0,0,0,0,2,1,,,,,,,,,,
20060123-M-Australian_Open-QF-David_Nalbandian-Fabrice_Santoro,1,S-IO,1,1,0,1,0,1,0,,,,,,,,,,
20060123-M-Australian_Open-QF-David_Nalbandian-Fabrice_Santoro,2,F-XC,5,1,1,0,0,1,4,,,,,,,,,,
20060123-M-Australian_Open-QF-David_Nalbandian-Fabrice_Santoro,2,F-DTM,3,0,0,0,0,0,3,,,,,,,,,,
20060123-M-Australian_Open-QF-David_Nalbandian-Fabrice_Santoro,2,F-DTL,1,0,0,0,0,1,0,,,,,,,,,,
20060123-M-Australian_Open-QF-David_Nalbandian-Fabrice_Santoro,2,F-IO,1,1,0,1,0,1,0,,,,,,,,,,
20060123-M-Australian_Open-QF-David_Nalbandian-Fabrice_Santoro,2,B-XC,65,6,0,3,3,31,34,,,,,,,,,,
20060123-M-Australian_Open-QF-David_Nalbandian-Fabrice_Santoro,2,B-DTM,34,1,0,0,1,7,27,,,,,,,,,,
20060123-M-Australian_Open-QF-David_Nalbandian-Fabrice_Santoro,2,B-DTL,13,4,1,2,1,6,7,,,,,,,,,,
20060123-M-Australian_Open-QF-David_Nalbandian-Fabrice_Santoro,2,B-IO,4,0,0,0,0,0,4,,,,,,,,,,
20060123-M-Australian_Open-QF-David_Nalbandian-Fabrice_Santoro,2,B-II,1,0,0,0,0,0,1,,,,,,,,,,
20060123-M-Australian_Open-QF-David_Nalbandian-Fabrice_Santoro,2,S-XC,3,1,1,0,0,1,2,,,,,,,,,,
20060611-M-Roland_Garros-F-Roger_Federer-Rafael_Nadal,1,F-XC,95,10,1,4,5,47,48,,,,,,,,,,
20060611-M-Roland_Garros-F-Roger_Federer-Rafael_Nadal,1,F-DTM,42,6,0,3,3,19,23,,,,,,,,,,
20060611-M-Roland_Garros-F-Roger_Federer-Rafael_Nadal,1,F-DTL,11,6,3,2,1,8,3,,,,,,,,,,
20060611-M-Roland_Garros-F-Roger_Federer-Rafael_Nadal,1,F-IO,53,22,7,6,9,31,22,,,,,,,,,,
20060611-M-Roland_Garros-F-Roger_Federer-Rafael_Nadal,1,F-II,11,2,0,1,1,6,5,,,,,,,,,,
20060611-M-Roland_Garros-F-Roger_Federer-Rafael_Nadal,1,B-XC,41,16,2,1,13,19,22,,,,,,,,,,
20060611-M-Roland_Garros-F-Roger_Federer-Rafael_Nadal,1,B-DTM,66,10,0,0,10,19,47,,,,,,,,,,
20060611-M-Roland_Garros-F-Roger_Federer-Rafael_Nadal,1,B-DTL,26,8,0,1,7,9,17,,,,,,,,,,
20060611-M-Roland_Garros-F-Roger_Federer-Rafael_Nadal,1,B-IO,11,2,1,0,1,5,6,,,,,,,,,,
20060611-M-Roland_Garros-F-Roger_Federer-Rafael_Nadal,1,S-XC,9,3,1,1,1,6,3,,,,,,,,,,
20060611-M-Roland_Garros-F-Roger_Federer-Rafael_Nadal,1,S-DTM,15,0,0,0,0,4,11,,,,,,,,,,
20060611-M-Roland_Garros-F-Roger_Federer-Rafael_Nadal,1,S-DTL,4,0,0,0,0,2,2,,,,,,,,,,
20060611-M-Roland_Garros-F-Roger_Federer-Rafael_Nadal,1,S-IO,2,0,0,0,0,0,2,,,,,,,,,,
20060611-M-Roland_Garros-F-Roger_Federer-Rafael_Nadal,2,F-XC,97,13,5,3,5,56,41,,,,,,,,,,
20060611-M-Roland_Garros-F-Roger_Federer-Rafael_Nadal,2,F-DTM,49,2,0,1,1,26,23,,,,,,,,,,
20060611-M-Roland_Garros-F-Roger_Federer-Rafael_Nadal,2,F-DTL,16,10,3,1,6,6,10,,,,,,,,,,
20060611-M-Roland_Garros-F-Roger_Federer-Rafael_Nadal,2,F-IO,34,15,6,3,6,21,13,,,,,,,,,,
20060611-M-Roland_Garros-F-Roger_Federer-Rafael_Nadal,2,F-II,20,2,1,1,0,16,4,,,,,,,,,,
20060611-M-Roland_Garros-F-Roger_Federer-Rafael_Nadal,2,B-XC,46,9,0,2,7,23,23,,,,,,,,,,
20060611-M-Roland_Garros-F-Roger_Federer-Rafael_Nadal,2,B-DTM,65,4,0,2,2,32,33,,,,,,,,,,
20060611-M-Roland_Garros-F-Roger_Federer-Rafael_Nadal,2,B-DTL,25,4,1,1,2,16,9,,,,,,,,,,
20060611-M-Roland_Garros-F-Roger_Federer-Rafael_Nadal,2,B-IO,11,1,1,0,0,6,5,,,,,,,,,,
20060611-M-Roland_Garros-F-Roger_Federer-Rafael_Nadal,2,S-XC,3,2,0,1,1,1,2,,,,,,,,,,
20060611-M-Roland_Garros-F-Roger_Federer-Rafael_Nadal,2,S-DTM,6,0,0,0,0,2,4,,,,,,,,,,
20060611-M-Roland_Garros-F-Roger_Federer-Rafael_Nadal,2,S-DTL,2,0,0,0,0,0,2,,,,,,,,,,
20060611-M-Roland_Garros-F-Roger_Federer-Rafael_Nadal,2,S-IO,1,0,0,0,0,1,0,,,,,,,,,,
20060627-M-Wimbledon-R128-Roger_Federer-Richard_Gasquet,1,F-XC,22,7,3,3,1,14,8,,,,,,,,,,
20060627-M-Wimbledon-R128-Roger_Federer-Richard_Gasquet,1,F-DTM,11,4,2,0,2,5,6,,,,,,,,,,
20060627-M-Wimbledon-R128-Roger_Federer-Richard_Gasquet,1,F-DTL,6,5,2,0,3,3,3,,,,,,,,,,
20060627-M-Wimbledon-R128-Roger_Federer-Richard_Gasquet,1,F-IO,32,15,4,6,5,22,10,,,,,,,,,,
20060627-M-Wimbledon-R128-Roger_Federer-Richard_Gasquet,1,F-II,2,1,1,0,0,2,0,,,,,,,,,,
20060627-M-Wimbledon-R128-Roger_Federer-Richard_Gasquet,1,B-XC,23,3,0,1,2,14,9,,,,,,,,,,
20060627-M-Wimbledon-R128-Roger_Federer-Richard_Gasquet,1,B-DTM,21,2,0,0,2,9,12,,,,,,,,,,
20060627-M-Wimbledon-R128-Roger_Federer-Richard_Gasquet,1,B-DTL,10,6,5,0,1,8,2,,,,,,,,,,
20060627-M-Wimbledon-R128-Roger_Federer-Richard_Gasquet,1,B-IO,2,1,1,0,0,1,1,,,,,,,,,,
20060627-M-Wimbledon-R128-Roger_Federer-Richard_Gasquet,1,S-XC,9,0,0,0,0,8,1,,,,,,,,,,
20060627-M-Wimbledon-R128-Roger_Federer-Richard_Gasquet,1,S-DTM,6,0,0,0,0,3,3,,,,,,,,,,
20060627-M-Wimbledon-R128-Roger_Federer-Richard_Gasquet,1,S-DTL,1,1,0,0,1,0,1,,,,,,,,,,
20060627-M-Wimbledon-R128-Roger_Federer-Richard_Gasquet,2,F-XC,19,3,0,1,2,14,5,,,,,,,,,,
20060627-M-Wimbledon-R128-Roger_Federer-Richard_Gasquet,2,F-DTM,20,2,0,0,2,8,12,,,,,,,,,,
20060627-M-Wimbledon-R128-Roger_Federer-Richard_Gasquet,2,F-DTL,8,3,0,2,1,3,5,,,,,,,,,,
20060627-M-Wimbledon-R128-Roger_Federer-Richard_Gasquet,2,F-IO,14,3,0,1,2,3,11,,,,,,,,,,
20060627-M-Wimbledon-R128-Roger_Federer-Richard_Gasquet,2,F-II,1,0,0,0,0,0,1,,,,,,,,,,
20060627-M-Wimbledon-R128-Roger_Federer-Richard_Gasquet,2,B-XC,38,7,0,3,4,14,24,,,,,,,,,,
20060627-M-Wimbledon-R128-Roger_Federer-Richard_Gasquet,2,B-DTM,19,1,0,0,1,9,10,,,,,,,,,,
20060627-M-Wimbledon-R128-Roger_Federer-Richard_Gasquet,2,B-DTL,9,4,2,0,2,3,6,,,,,,,,,,
20060627-M-Wimbledon-R128-Roger_Federer-Richard_Gasquet,2,B-IO,2,0,0,0,0,2,0,,,,,,,,,,
20060627-M-Wimbledon-R128-Roger_Federer-Richard_Gasquet,2,S-XC,7,2,0,0,2,1,6,,,,,,,,,,
20060627-M-Wimbledon-R128-Roger_Federer-Richard_Gasquet,2,S-DTM,3,0,0,0,0,0,3,,,,,,,,,,
20060627-M-Wimbledon-R128-Roger_Federer-Richard_Gasquet,2,S-DTL,1,0,0,0,0,0,1,,,,,,,,,,
20060709-M-Wimbledon-F-Roger_Federer-Rafael_Nadal,1,F-XC,67,13,5,2,6,36,31,,,,,,,,,,
20060709-M-Wimbledon-F-Roger_Federer-Rafael_Nadal,1,F-DTM,21,1,0,1,0,14,7,,,,,,,,,,
20060709-M-Wimbledon-F-Roger_Federer-Rafael_Nadal,1,F-DTL,15,9,3,4,2,10,5,,,,,,,,,,
20060709-M-Wimbledon-F-Roger_Federer-Rafael_Nadal,1,F-IO,34,16,4,5,7,18,16,,,,,,,,,,
20060709-M-Wimbledon-F-Roger_Federer-Rafael_Nadal,1,F-II,12,2,0,0,2,6,6,,,,,,,,,,
20060709-M-Wimbledon-F-Roger_Federer-Rafael_Nadal,1,B-XC,29,7,2,3,2,13,16,,,,,,,,,,
20060709-M-Wimbledon-F-Roger_Federer-Rafael_Nadal,1,B-DTM,27,2,0,0,2,13,14,,,,,,,,,,
20060709-M-Wimbledon-F-Roger_Federer-Rafael_Nadal,1,B-DTL,25,8,1,1,6,9,16,,,,,,,,,,
20060709-M-Wimbledon-F-Roger_Federer-Rafael_Nadal,1,B-IO,1,1,0,0,1,0,1,,,,,,,,,,
20060709-M-Wimbledon-F-Roger_Federer-Rafael_Nadal,1,S-XC,11,1,0,0,1,5,6,,,,,,,,,,
20060709-M-Wimbledon-F-Roger_Federer-Rafael_Nadal,1,S-DTM,16,0,0,0,0,6,10,,,,,,,,,,
20060709-M-Wimbledon-F-Roger_Federer-Rafael_Nadal,1,S-DTL,13,1,0,0,1,9,4,,,,,,,,,,
20060709-M-Wimbledon-F-Roger_Federer-Rafael_Nadal,1,S-IO,1,0,0,0,0,1,0,,,,,,,,,,
20060709-M-Wimbledon-F-Roger_Federer-Rafael_Nadal,2,F-XC,99,14,5,3,6,59,40,,,,,,,,,,
20060709-M-Wimbledon-F-Roger_Federer-Rafael_Nadal,2,F-DTM,28,2,0,0,2,11,17,,,,,,,,,,
20060709-M-Wimbledon-F-Roger_Federer-Rafael_Nadal,2,F-DTL,16,9,4,1,4,8,8,,,,,,,,,,
20060709-M-Wimbledon-F-Roger_Federer-Rafael_Nadal,2,F-IO,22,8,1,3,4,11,11,,,,,,,,,,
20060709-M-Wimbledon-F-Roger_Federer-Rafael_Nadal,2,F-II,9,4,3,0,1,5,4,,,,,,,,,,
20060709-M-Wimbledon-F-Roger_Federer-Rafael_Nadal,2,B-XC,55,18,7,4,7,30,25,,,,,,,,,,
20060709-M-Wimbledon-F-Roger_Federer-Rafael_Nadal,2,B-DTM,23,3,0,0,3,8,15,,,,,,,,,,
20060709-M-Wimbledon-F-Roger_Federer-Rafael_Nadal,2,B-DTL,26,6,3,0,3,12,14,,,,,,,,,,
20060709-M-Wimbledon-F-Roger_Federer-Rafael_Nadal,2,B-IO,3,1,0,0,1,1,2,,,,,,,,,,
20060709-M-Wimbledon-F-Roger_Federer-Rafael_Nadal,2,S-DTM,2,0,0,0,0,1,1,,,,,,,,,,
20060709-M-Wimbledon-F-Roger_Federer-Rafael_Nadal,2,S-DTL,7,1,0,0,1,1,6,,,,,,,,,,
20060709-M-Wimbledon-F-Roger_Federer-Rafael_Nadal,2,S-IO,3,0,0,0,0,1,2,,,,,,,,,,
20060826-M-US_Open-F-Roger_Federer-Andy_Roddick,1,F-XC,62,19,9,5,5,45,17,,,,,,,,,,
20060826-M-US_Open-F-Roger_Federer-Andy_Roddick,1,F-DTM,16,0,0,0,0,12,4,,,,,,,,,,
20060826-M-US_Open-F-Roger_Federer-Andy_Roddick,1,F-DTL,26,5,3,1,1,17,9,,,,,,,,,,
20060826-M-US_Open-F-Roger_Federer-Andy_Roddick,1,F-IO,39,13,7,4,2,25,14,,,,,,,,,,
20060826-M-US_Open-F-Roger_Federer-Andy_Roddick,1,F-II,14,4,2,1,1,7,7,,,,,,,,,,
20060826-M-US_Open-F-Roger_Federer-Andy_Roddick,1,B-XC,72,20,6,6,8,39,33,,,,,,,,,,
20060826-M-US_Open-F-Roger_Federer-Andy_Roddick,1,B-DTM,24,1,0,0,1,14,10,,,,,,,,,,
20060826-M-US_Open-F-Roger_Federer-Andy_Roddick,1,B-DTL,25,8,4,1,3,14,11,,,,,,,,,,
20060826-M-US_Open-F-Roger_Federer-Andy_Roddick,1,B-IO,3,0,0,0,0,3,0,,,,,,,,,,
20060826-M-US_Open-F-Roger_Federer-Andy_Roddick,1,S-XC,23,5,0,1,4,13,10,,,,,,,,,,
20060826-M-US_Open-F-Roger_Federer-Andy_Roddick,1,S-DTM,3,0,0,0,0,2,1,,,,,,,,,,
20060826-M-US_Open-F-Roger_Federer-Andy_Roddick,1,S-DTL,5,0,0,0,0,5,0,,,,,,,,,,
20060826-M-US_Open-F-Roger_Federer-Andy_Roddick,2,F-XC,52,11,2,4,5,19,33,,,,,,,,,,
20060826-M-US_Open-F-Roger_Federer-Andy_Roddick,2,F-DTM,26,1,0,0,1,5,21,,,,,,,,,,
20060826-M-US_Open-F-Roger_Federer-Andy_Roddick,2,F-DTL,29,2,0,2,0,11,18,,,,,,,,,,
20060826-M-US_Open-F-Roger_Federer-Andy_Roddick,2,F-IO,50,7,1,4,2,26,24,,,,,,,,,,
20060826-M-US_Open-F-Roger_Federer-Andy_Roddick,2,F-II,13,7,0,3,4,8,5,,,,,,,,,,
20060826-M-US_Open-F-Roger_Federer-Andy_Roddick,2,B-XC,70,10,2,2,6,28,42,,,,,,,,,,
20060826-M-US_Open-F-Roger_Federer-Andy_Roddick,2,B-DTM,18,1,0,1,0,10,8,,,,,,,,,,
20060826-M-US_Open-F-Roger_Federer-Andy_Roddick,2,B-DTL,14,4,1,2,1,8,6,,,,,,,,,,
20060826-M-US_Open-F-Roger_Federer-Andy_Roddick,2,B-IO,2,1,0,0,1,0,2,,,,,,,,,,
20060826-M-US_Open-F-Roger_Federer-Andy_Roddick,2,S-XC,15,2,0,0,2,6,9,,,,,,,,,,
20060826-M-US_Open-F-Roger_Federer-Andy_Roddick,2,S-DTM,2,0,0,0,0,0,2,,,,,,,,,,
20060826-M-US_Open-F-Roger_Federer-Andy_Roddick,2,S-DTL,1,1,0,0,1,0,1,,,,,,,,,,
20070314-M-Indian_Wells_Masters-F-Novak_Djokovic-Rafael_Nadal,1,F-XC,56,4,0,1,3,21,35,,,,,,,,,,
20070314-M-Indian_Wells_Masters-F-Novak_Djokovic-Rafael_Nadal,1,F-DTM,17,0,0,0,0,3,14,,,,,,,,,,
20070314-M-Indian_Wells_Masters-F-Novak_Djokovic-Rafael_Nadal,1,F-DTL,10,9,2,2,5,4,6,,,,,,,,,,
20070314-M-Indian_Wells_Masters-F-Novak_Djokovic-Rafael_Nadal,1,F-IO,35,11,6,2,3,18,17,,,,,,,,,,
20070314-M-Indian_Wells_Masters-F-Novak_Djokovic-Rafael_Nadal,1,F-II,1,0,0,0,0,1,0,,,,,,,,,,
20070314-M-Indian_Wells_Masters-F-Novak_Djokovic-Rafael_Nadal,1,B-XC,26,4,0,0,4,6,20,,,,,,,,,,
20070314-M-Indian_Wells_Masters-F-Novak_Djokovic-Rafael_Nadal,1,B-DTM,12,2,0,0,2,2,10,,,,,,,,,,
20070314-M-Indian_Wells_Masters-F-Novak_Djokovic-Rafael_Nadal,1,B-DTL,11,2,0,0,2,4,7,,,,,,,,,,
20070314-M-Indian_Wells_Masters-F-Novak_Djokovic-Rafael_Nadal,1,B-IO,3,1,0,0,1,1,2,,,,,,,,,,
20070314-M-Indian_Wells_Masters-F-Novak_Djokovic-Rafael_Nadal,1,S-DTM,4,0,0,0,0,1,3,,,,,,,,,,
20070314-M-Indian_Wells_Masters-F-Novak_Djokovic-Rafael_Nadal,2,F-XC,46,7,2,3,2,34,12,,,,,,,,,,
20070314-M-Indian_Wells_Masters-F-Novak_Djokovic-Rafael_Nadal,2,F-DTM,15,0,0,0,0,10,5,,,,,,,,,,
20070314-M-Indian_Wells_Masters-F-Novak_Djokovic-Rafael_Nadal,2,F-DTL,17,6,1,2,3,9,8,,,,,,,,,,
20070314-M-Indian_Wells_Masters-F-Novak_Djokovic-Rafael_Nadal,2,F-IO,30,11,5,6,0,21,9,,,,,,,,,,
20070314-M-Indian_Wells_Masters-F-Novak_Djokovic-Rafael_Nadal,2,F-II,7,4,0,1,3,4,3,,,,,,,,,,
20070314-M-Indian_Wells_Masters-F-Novak_Djokovic-Rafael_Nadal,2,B-XC,26,6,2,1,3,20,6,,,,,,,,,,
20070314-M-Indian_Wells_Masters-F-Novak_Djokovic-Rafael_Nadal,2,B-DTM,15,0,0,0,0,11,4,,,,,,,,,,
20070314-M-Indian_Wells_Masters-F-Novak_Djokovic-Rafael_Nadal,2,B-DTL,7,3,0,0,3,3,4,,,,,,,,,,
20070314-M-Indian_Wells_Masters-F-Novak_Djokovic-Rafael_Nadal,2,B-IO,3,0,0,0,0,3,0,,,,,,,,,,
20070314-M-Indian_Wells_Masters-F-Novak_Djokovic-Rafael_Nadal,2,S-XC,3,0,0,0,0,2,1,,,,,,,,,,
20070314-M-Indian_Wells_Masters-F-Novak_Djokovic-Rafael_Nadal,2,S-DTM,8,0,0,0,0,2,6,,,,,,,,,,
20070314-M-Indian_Wells_Masters-F-Novak_Djokovic-Rafael_Nadal,2,S-DTL,8,0,0,0,0,4,4,,,,,,,,,,
20070314-M-Indian_Wells_Masters-F-Novak_Djokovic-Rafael_Nadal,2,S-IO,1,0,0,0,0,1,0,,,,,,,,,,
20070610-M-Roland_Garros-F-Roger_Federer-Rafael_Nadal,1,F-XC,85,18,3,5,10,40,45,,,,,,,,,,
20070610-M-Roland_Garros-F-Roger_Federer-Rafael_Nadal,1,F-DTM,26,3,0,2,1,14,12,,,,,,,,,,
20070610-M-Roland_Garros-F-Roger_Federer-Rafael_Nadal,1,F-DTL,19,9,2,1,6,8,11,,,,,,,,,,
20070610-M-Roland_Garros-F-Roger_Federer-Rafael_Nadal,1,F-IO,40,19,6,3,10,21,19,,,,,,,,,,
20070610-M-Roland_Garros-F-Roger_Federer-Rafael_Nadal,1,F-II,14,4,1,1,2,6,8,,,,,,,,,,
20070610-M-Roland_Garros-F-Roger_Federer-Rafael_Nadal,1,B-XC,72,15,5,3,7,36,36,,,,,,,,,,
20070610-M-Roland_Garros-F-Roger_Federer-Rafael_Nadal,1,B-DTM,60,3,0,1,2,20,40,,,,,,,,,,
20070610-M-Roland_Garros-F-Roger_Federer-Rafael_Nadal,1,B-DTL,79,12,2,2,8,31,48,,,,,,,,,,
20070610-M-Roland_Garros-F-Roger_Federer-Rafael_Nadal,1,B-IO,2,1,0,0,1,0,2,,,,,,,,,,
20070610-M-Roland_Garros-F-Roger_Federer-Rafael_Nadal,1,S-XC,3,1,1,0,0,1,2,,,,,,,,,,
20070610-M-Roland_Garros-F-Roger_Federer-Rafael_Nadal,1,S-DTM,2,0,0,0,0,0,2,,,,,,,,,,
20070610-M-Roland_Garros-F-Roger_Federer-Rafael_Nadal,1,S-DTL,7,0,0,0,0,5,2,,,,,,,,,,
20070610-M-Roland_Garros-F-Roger_Federer-Rafael_Nadal,1,S-IO,2,0,0,0,0,2,0,,,,,,,,,,
20070610-M-Roland_Garros-F-Roger_Federer-Rafael_Nadal,2,F-XC,141,13,1,6,6,76,65,,,,,,,,,,
20070610-M-Roland_Garros-F-Roger_Federer-Rafael_Nadal,2,F-DTM,19,1,0,0,1,8,11,,,,,,,,,,
20070610-M-Roland_Garros-F-Roger_Federer-Rafael_Nadal,2,F-DTL,26,10,3,6,1,17,9,,,,,,,,,,
20070610-M-Roland_Garros-F-Roger_Federer-Rafael_Nadal,2,F-IO,52,15,9,2,4,35,17,,,,,,,,,,
20070610-M-Roland_Garros-F-Roger_Federer-Rafael_Nadal,2,F-II,26,2,1,0,1,19,7,,,,,,,,,,
20070610-M-Roland_Garros-F-Roger_Federer-Rafael_Nadal,2,B-XC,47,17,6,2,9,21,26,,,,,,,,,,
20070610-M-Roland_Garros-F-Roger_Federer-Rafael_Nadal,2,B-DTM,38,2,0,0,2,23,15,,,,,,,,,,
20070610-M-Roland_Garros-F-Roger_Federer-Rafael_Nadal,2,B-DTL,62,5,0,2,3,38,24,,,,,,,,,,
20070610-M-Roland_Garros-F-Roger_Federer-Rafael_Nadal,2,B-IO,8,2,1,1,0,6,2,,,,,,,,,,
20070610-M-Roland_Garros-F-Roger_Federer-Rafael_Nadal,2,S-XC,1,0,0,0,0,1,0,,,,,,,,,,
20070610-M-Roland_Garros-F-Roger_Federer-Rafael_Nadal,2,S-DTM,1,0,0,0,0,0,1,,,,,,,,,,
20070610-M-Roland_Garros-F-Roger_Federer-Rafael_Nadal,2,S-DTL,6,1,0,0,1,1,5,,,,,,,,,,
20070708-M-Wimbledon-F-Roger_Federer-Rafael_Nadal,1,F-XC,73,19,5,7,7,38,35,,,,,,,,,,
20070708-M-Wimbledon-F-Roger_Federer-Rafael_Nadal,1,F-DTM,22,2,0,1,1,14,8,,,,,,,,,,
20070708-M-Wimbledon-F-Roger_Federer-Rafael_Nadal,1,F-DTL,27,16,5,1,10,11,16,,,,,,,,,,
20070708-M-Wimbledon-F-Roger_Federer-Rafael_Nadal,1,F-IO,32,15,5,4,6,17,15,,,,,,,,,,
20070708-M-Wimbledon-F-Roger_Federer-Rafael_Nadal,1,F-II,16,3,2,0,1,7,9,,,,,,,,,,
20070708-M-Wimbledon-F-Roger_Federer-Rafael_Nadal,1,B-XC,55,19,3,3,13,25,30,,,,,,,,,,
20070708-M-Wimbledon-F-Roger_Federer-Rafael_Nadal,1,B-DTM,30,3,0,0,3,11,19,,,,,,,,,,
20070708-M-Wimbledon-F-Roger_Federer-Rafael_Nadal,1,B-DTL,51,11,4,1,6,28,23,,,,,,,,,,
20070708-M-Wimbledon-F-Roger_Federer-Rafael_Nadal,1,B-IO,3,1,0,1,0,2,1,,,,,,,,,,
20070708-M-Wimbledon-F-Roger_Federer-Rafael_Nadal,1,S-XC,17,2,0,1,1,7,10,,,,,,,,,,
20070708-M-Wimbledon-F-Roger_Federer-Rafael_Nadal,1,S-DTM,5,0,0,0,0,0,5,,,,,,,,,,
20070708-M-Wimbledon-F-Roger_Federer-Rafael_Nadal,1,S-DTL,17,2,0,0,2,5,12,,,,,,,,,,
20070708-M-Wimbledon-F-Roger_Federer-Rafael_Nadal,1,S-IO,1,0,0,0,0,0,1,,,,,,,,,,
20070708-M-Wimbledon-F-Roger_Federer-Rafael_Nadal,2,F-XC,139,27,11,7,9,86,53,,,,,,,,,,
20070708-M-Wimbledon-F-Roger_Federer-Rafael_Nadal,2,F-DTM,15,1,0,0,1,9,6,,,,,,,,,,
20070708-M-Wimbledon-F-Roger_Federer-Rafael_Nadal,2,F-DTL,26,12,4,3,5,10,16,,,,,,,,,,
20070708-M-Wimbledon-F-Roger_Federer-Rafael_Nadal,2,F-IO,39,17,8,1,8,24,15,,,,,,,,,,
20070708-M-Wimbledon-F-Roger_Federer-Rafael_Nadal,2,F-II,9,3,1,1,1,6,3,,,,,,,,,,
20070708-M-Wimbledon-F-Roger_Federer-Rafael_Nadal,2,B-XC,57,19,5,4,10,28,29,,,,,,,,,,
20070708-M-Wimbledon-F-Roger_Federer-Rafael_Nadal,2,B-DTM,16,0,0,0,0,6,10,,,,,,,,,,
20070708-M-Wimbledon-F-Roger_Federer-Rafael_Nadal,2,B-DTL,38,7,4,0,3,21,17,,,,,,,,,,
20070708-M-Wimbledon-F-Roger_Federer-Rafael_Nadal,2,B-IO,5,1,1,0,0,2,3,,,,,,,,,,
20070708-M-Wimbledon-F-Roger_Federer-Rafael_Nadal,2,B-II,1,0,0,0,0,0,1,,,,,,,,,,
20070708-M-Wimbledon-F-Roger_Federer-Rafael_Nadal,2,S-XC,5,1,0,1,0,4,1,,,,,,,,,,
20070708-M-Wimbledon-F-Roger_Federer-Rafael_Nadal,2,S-DTM,7,1,0,0,1,3,4,,,,,,,,,,
20070708-M-Wimbledon-F-Roger_Federer-Rafael_Nadal,2,S-DTL,15,0,0,0,0,7,8,,,,,,,,,,
20070708-M-Wimbledon-F-Roger_Federer-Rafael_Nadal,2,S-IO,1,1,0,0,1,0,1,,,,,,,,,,
20070708-M-Wimbledon-F-Roger_Federer-Rafael_Nadal,2,S-II,1,0,0,0,0,0,1,,,,,,,,,,
20070909-M-US_Open-F-Roger_Federer-Novak_Djokovic,1,F-XC,47,17,2,3,12,20,27,,,,,,,,,,
20070909-M-US_Open-F-Roger_Federer-Novak_Djokovic,1,F-DTM,34,4,2,0,2,20,14,,,,,,,,,,
20070909-M-US_Open-F-Roger_Federer-Novak_Djokovic,1,F-DTL,18,6,1,1,4,9,9,,,,,,,,,,
20070909-M-US_Open-F-Roger_Federer-Novak_Djokovic,1,F-IO,25,8,6,1,1,15,10,,,,,,,,,,
20070909-M-US_Open-F-Roger_Federer-Novak_Djokovic,1,F-II,5,2,0,1,1,3,2,,,,,,,,,,
20070909-M-US_Open-F-Roger_Federer-Novak_Djokovic,1,B-XC,40,10,0,5,5,22,18,,,,,,,,,,
20070909-M-US_Open-F-Roger_Federer-Novak_Djokovic,1,B-DTM,29,2,0,0,2,15,14,,,,,,,,,,
20070909-M-US_Open-F-Roger_Federer-Novak_Djokovic,1,B-DTL,18,7,4,1,2,10,8,,,,,,,,,,
20070909-M-US_Open-F-Roger_Federer-Novak_Djokovic,1,B-IO,3,1,0,0,1,2,1,,,,,,,,,,
20070909-M-US_Open-F-Roger_Federer-Novak_Djokovic,1,S-XC,19,1,0,1,0,14,5,,,,,,,,,,
20070909-M-US_Open-F-Roger_Federer-Novak_Djokovic,1,S-DTM,7,0,0,0,0,4,3,,,,,,,,,,
20070909-M-US_Open-F-Roger_Federer-Novak_Djokovic,1,S-DTL,1,0,0,0,0,1,0,,,,,,,,,,
20070909-M-US_Open-F-Roger_Federer-Novak_Djokovic,1,S-II,1,0,0,0,0,1,0,,,,,,,,,,
20070909-M-US_Open-F-Roger_Federer-Novak_Djokovic,2,F-XC,42,13,6,3,4,25,17,,,,,,,,,,
20070909-M-US_Open-F-Roger_Federer-Novak_Djokovic,2,F-DTM,22,0,0,0,0,11,11,,,,,,,,,,
20070909-M-US_Open-F-Roger_Federer-Novak_Djokovic,2,F-DTL,8,2,1,1,0,5,3,,,,,,,,,,
20070909-M-US_Open-F-Roger_Federer-Novak_Djokovic,2,F-IO,31,9,1,3,5,15,16,,,,,,,,,,
20070909-M-US_Open-F-Roger_Federer-Novak_Djokovic,2,F-II,2,1,0,0,1,1,1,,,,,,,,,,
20070909-M-US_Open-F-Roger_Federer-Novak_Djokovic,2,B-XC,67,12,2,3,7,28,39,,,,,,,,,,
20070909-M-US_Open-F-Roger_Federer-Novak_Djokovic,2,B-DTM,30,4,0,1,3,12,18,,,,,,,,,,
20070909-M-US_Open-F-Roger_Federer-Novak_Djokovic,2,B-DTL,14,8,2,2,4,8,6,,,,,,,,,,
20070909-M-US_Open-F-Roger_Federer-Novak_Djokovic,2,B-IO,11,3,1,0,2,5,6,,,,,,,,,,
20070909-M-US_Open-F-Roger_Federer-Novak_Djokovic,2,S-XC,3,0,0,0,0,3,0,,,,,,,,,,
20070909-M-US_Open-F-Roger_Federer-Novak_Djokovic,2,S-DTM,7,0,0,0,0,3,4,,,,,,,,,,
20070909-M-US_Open-F-Roger_Federer-Novak_Djokovic,2,S-DTL,1,0,0,0,0,0,1,,,,,,,,,,
20071022-M-Basel-R16-Roger_Federer-Juan_Martin_Del_Potro,1,F-XC,29,4,1,1,2,17,12,,,,,,,,,,
20071022-M-Basel-R16-Roger_Federer-Juan_Martin_Del_Potro,1,F-DTM,6,1,0,0,1,4,2,,,,,,,,,,
20071022-M-Basel-R16-Roger_Federer-Juan_Martin_Del_Potro,1,F-DTL,15,5,1,0,4,9,6,,,,,,,,,,
20071022-M-Basel-R16-Roger_Federer-Juan_Martin_Del_Potro,1,F-IO,18,7,4,1,2,14,4,,,,,,,,,,
20071022-M-Basel-R16-Roger_Federer-Juan_Martin_Del_Potro,1,F-II,6,1,1,0,0,4,2,,,,,,,,,,
20071022-M-Basel-R16-Roger_Federer-Juan_Martin_Del_Potro,1,B-XC,13,6,4,0,2,9,4,,,,,,,,,,
20071022-M-Basel-R16-Roger_Federer-Juan_Martin_Del_Potro,1,B-DTM,12,1,0,1,0,10,2,,,,,,,,,,
20071022-M-Basel-R16-Roger_Federer-Juan_Martin_Del_Potro,1,B-DTL,10,3,2,0,1,8,2,,,,,,,,,,
20071022-M-Basel-R16-Roger_Federer-Juan_Martin_Del_Potro,1,B-IO,1,0,0,0,0,0,1,,,,,,,,,,
20071022-M-Basel-R16-Roger_Federer-Juan_Martin_Del_Potro,1,S-XC,14,0,0,0,0,12,2,,,,,,,,,,
20071022-M-Basel-R16-Roger_Federer-Juan_Martin_Del_Potro,1,S-DTL,2,0,0,0,0,1,1,,,,,,,,,,
20071022-M-Basel-R16-Roger_Federer-Juan_Martin_Del_Potro,2,F-XC,32,13,3,4,6,15,17,,,,,,,,,,
20071022-M-Basel-R16-Roger_Federer-Juan_Martin_Del_Potro,2,F-DTM,7,0,0,0,0,3,4,,,,,,,,,,
20071022-M-Basel-R16-Roger_Federer-Juan_Martin_Del_Potro,2,F-DTL,10,0,0,0,0,3,7,,,,,,,,,,
20071022-M-Basel-R16-Roger_Federer-Juan_Martin_Del_Potro,2,F-IO,11,1,0,0,1,2,9,,,,,,,,,,
20071022-M-Basel-R16-Roger_Federer-Juan_Martin_Del_Potro,2,F-II,3,0,0,0,0,1,2,,,,,,,,,,
20071022-M-Basel-R16-Roger_Federer-Juan_Martin_Del_Potro,2,B-XC,29,4,0,0,4,5,24,,,,,,,,,,
20071022-M-Basel-R16-Roger_Federer-Juan_Martin_Del_Potro,2,B-DTM,9,0,0,0,0,2,7,,,,,,,,,,
20071022-M-Basel-R16-Roger_Federer-Juan_Martin_Del_Potro,2,B-DTL,5,2,0,1,1,2,3,,,,,,,,,,
20071022-M-Basel-R16-Roger_Federer-Juan_Martin_Del_Potro,2,S-XC,8,1,0,0,1,0,8,,,,,,,,,,
20071022-M-Basel-R16-Roger_Federer-Juan_Martin_Del_Potro,2,S-DTM,2,0,0,0,0,0,2,,,,,,,,,,
20071022-M-Basel-R16-Roger_Federer-Juan_Martin_Del_Potro,2,S-DTL,2,0,0,0,0,1,1,,,,,,,,,,
20071028-M-Basel-F-Roger_Federer-Jarkko_Nieminen,1,F-XC,35,5,1,3,1,22,13,,,,,,,,,,
20071028-M-Basel-F-Roger_Federer-Jarkko_Nieminen,1,F-DTM,10,2,0,0,2,3,7,,,,,,,,,,
20071028-M-Basel-F-Roger_Federer-Jarkko_Nieminen,1,F-DTL,9,4,1,1,2,5,4,,,,,,,,,,
20071028-M-Basel-F-Roger_Federer-Jarkko_Nieminen,1,F-IO,13,5,2,0,3,7,6,,,,,,,,,,
20071028-M-Basel-F-Roger_Federer-Jarkko_Nieminen,1,F-II,2,0,0,0,0,1,1,,,,,,,,,,
20071028-M-Basel-F-Roger_Federer-Jarkko_Nieminen,1,B-XC,20,2,0,0,2,12,8,,,,,,,,,,
20071028-M-Basel-F-Roger_Federer-Jarkko_Nieminen,1,B-DTM,9,2,0,0,2,5,4,,,,,,,,,,
20071028-M-Basel-F-Roger_Federer-Jarkko_Nieminen,1,B-DTL,9,2,0,0,2,2,7,,,,,,,,,,
20071028-M-Basel-F-Roger_Federer-Jarkko_Nieminen,1,S-XC,4,0,0,0,0,2,2,,,,,,,,,,
20071028-M-Basel-F-Roger_Federer-Jarkko_Nieminen,1,S-DTM,12,1,0,0,1,6,6,,,,,,,,,,
20071028-M-Basel-F-Roger_Federer-Jarkko_Nieminen,1,S-DTL,9,3,0,0,3,5,4,,,,,,,,,,
20071028-M-Basel-F-Roger_Federer-Jarkko_Nieminen,1,S-IO,1,0,0,0,0,0,1,,,,,,,,,,
20071028-M-Basel-F-Roger_Federer-Jarkko_Nieminen,2,F-XC,31,4,0,1,3,16,15,,,,,,,,,,
20071028-M-Basel-F-Roger_Federer-Jarkko_Nieminen,2,F-DTM,10,1,0,0,1,5,5,,,,,,,,,,
20071028-M-Basel-F-Roger_Federer-Jarkko_Nieminen,2,F-DTL,19,8,3,0,5,6,13,,,,,,,,,,
20071028-M-Basel-F-Roger_Federer-Jarkko_Nieminen,2,F-IO,5,1,0,0,1,2,3,,,,,,,,,,
20071028-M-Basel-F-Roger_Federer-Jarkko_Nieminen,2,B-XC,22,3,0,0,3,8,14,,,,,,,,,,
20071028-M-Basel-F-Roger_Federer-Jarkko_Nieminen,2,B-DTM,8,0,0,0,0,2,6,,,,,,,,,,
20071028-M-Basel-F-Roger_Federer-Jarkko_Nieminen,2,B-DTL,13,6,2,1,3,8,5,,,,,,,,,,
20071028-M-Basel-F-Roger_Federer-Jarkko_Nieminen,2,B-IO,9,2,1,0,1,5,4,,,,,,,,,,
20071028-M-Basel-F-Roger_Federer-Jarkko_Nieminen,2,S-DTM,3,0,0,0,0,2,1,,,,,,,,,,
20071028-M-Basel-F-Roger_Federer-Jarkko_Nieminen,2,S-DTL,11,0,0,0,0,3,8,,,,,,,,,,
20071028-M-Basel-F-Roger_Federer-Jarkko_Nieminen,2,S-IO,5,0,0,0,0,2,3,,,,,,,,,,
20071028-M-Paris_Masters-F-Rafael_Nadal-David_Nalbandian,1,F-XC,38,5,1,1,3,14,24,,,,,,,,,,
20071028-M-Paris_Masters-F-Rafael_Nadal-David_Nalbandian,1,F-DTM,13,0,0,0,0,8,5,,,,,,,,,,
20071028-M-Paris_Masters-F-Rafael_Nadal-David_Nalbandian,1,F-DTL,11,1,0,1,0,3,8,,,,,,,,,,
20071028-M-Paris_Masters-F-Rafael_Nadal-David_Nalbandian,1,F-IO,10,5,1,3,1,8,2,,,,,,,,,,
20071028-M-Paris_Masters-F-Rafael_Nadal-David_Nalbandian,1,F-II,2,0,0,0,0,1,1,,,,,,,,,,
20071028-M-Paris_Masters-F-Rafael_Nadal-David_Nalbandian,1,B-XC,26,4,1,0,3,11,15,,,,,,,,,,
20071028-M-Paris_Masters-F-Rafael_Nadal-David_Nalbandian,1,B-DTM,13,1,0,0,1,6,7,,,,,,,,,,
20071028-M-Paris_Masters-F-Rafael_Nadal-David_Nalbandian,1,B-DTL,10,2,0,1,1,5,5,,,,,,,,,,
20071028-M-Paris_Masters-F-Rafael_Nadal-David_Nalbandian,1,B-IO,6,1,0,0,1,4,2,,,,,,,,,,
20071028-M-Paris_Masters-F-Rafael_Nadal-David_Nalbandian,1,S-XC,1,0,0,0,0,1,0,,,,,,,,,,
20071028-M-Paris_Masters-F-Rafael_Nadal-David_Nalbandian,1,S-DTM,3,0,0,0,0,2,1,,,,,,,,,,
20071028-M-Paris_Masters-F-Rafael_Nadal-David_Nalbandian,1,S-DTL,1,0,0,0,0,1,0,,,,,,,,,,
20071028-M-Paris_Masters-F-Rafael_Nadal-David_Nalbandian,1,S-IO,1,0,0,0,0,0,1,,,,,,,,,,
20071028-M-Paris_Masters-F-Rafael_Nadal-David_Nalbandian,2,F-XC,39,5,1,3,1,21,18,,,,,,,,,,
20071028-M-Paris_Masters-F-Rafael_Nadal-David_Nalbandian,2,F-DTM,12,0,0,0,0,5,7,,,,,,,,,,
20071028-M-Paris_Masters-F-Rafael_Nadal-David_Nalbandian,2,F-DTL,10,5,3,1,1,8,2,,,,,,,,,,
20071028-M-Paris_Masters-F-Rafael_Nadal-David_Nalbandian,2,F-IO,14,9,7,1,1,11,3,,,,,,,,,,
20071028-M-Paris_Masters-F-Rafael_Nadal-David_Nalbandian,2,B-XC,40,10,1,5,4,26,14,,,,,,,,,,
20071028-M-Paris_Masters-F-Rafael_Nadal-David_Nalbandian,2,B-DTM,13,2,1,0,1,6,7,,,,,,,,,,
20071028-M-Paris_Masters-F-Rafael_Nadal-David_Nalbandian,2,B-DTL,8,4,1,2,1,4,4,,,,,,,,,,
20071028-M-Paris_Masters-F-Rafael_Nadal-David_Nalbandian,2,B-IO,5,4,0,1,3,1,4,,,,,,,,,,
20071028-M-Paris_Masters-F-Rafael_Nadal-David_Nalbandian,2,S-DTM,1,0,0,0,0,0,1,,,,,,,,,,
20071028-M-Paris_Masters-F-Rafael_Nadal-David_Nalbandian,2,S-DTL,1,0,0,0,0,1,0,,,,,,,,,,
20071112-M-Masters_Cup-RR-Novak_Djokovic-Richard_Gasquet,1,F-XC,24,5,0,2,3,10,14,,,,,,,,,,
20071112-M-Masters_Cup-RR-Novak_Djokovic-Richard_Gasquet,1,F-DTM,22,3,0,1,2,8,14,,,,,,,,,,
20071112-M-Masters_Cup-RR-Novak_Djokovic-Richard_Gasquet,1,F-DTL,11,1,1,0,0,4,7,,,,,,,,,,
20071112-M-Masters_Cup-RR-Novak_Djokovic-Richard_Gasquet,1,F-IO,23,4,1,0,3,12,11,,,,,,,,,,
20071112-M-Masters_Cup-RR-Novak_Djokovic-Richard_Gasquet,1,F-II,4,3,1,1,1,3,1,,,,,,,,,,
20071112-M-Masters_Cup-RR-Novak_Djokovic-Richard_Gasquet,1,B-XC,44,2,1,0,1,15,29,,,,,,,,,,
20071112-M-Masters_Cup-RR-Novak_Djokovic-Richard_Gasquet,1,B-DTM,22,3,0,1,2,4,18,,,,,,,,,,
20071112-M-Masters_Cup-RR-Novak_Djokovic-Richard_Gasquet,1,B-DTL,12,6,2,3,1,9,3,,,,,,,,,,
20071112-M-Masters_Cup-RR-Novak_Djokovic-Richard_Gasquet,1,B-IO,5,3,1,0,2,1,4,,,,,,,,,,
20071112-M-Masters_Cup-RR-Novak_Djokovic-Richard_Gasquet,1,S-XC,3,0,0,0,0,2,1,,,,,,,,,,
20071112-M-Masters_Cup-RR-Novak_Djokovic-Richard_Gasquet,1,S-DTM,1,0,0,0,0,1,0,,,,,,,,,,
20071112-M-Masters_Cup-RR-Novak_Djokovic-Richard_Gasquet,1,S-DTL,2,1,0,1,0,1,1,,,,,,,,,,
20071112-M-Masters_Cup-RR-Novak_Djokovic-Richard_Gasquet,1,S-IO,2,1,0,0,1,0,2,,,,,,,,,,
20071112-M-Masters_Cup-RR-Novak_Djokovic-Richard_Gasquet,2,F-XC,34,9,5,2,2,21,13,,,,,,,,,,
20071112-M-Masters_Cup-RR-Novak_Djokovic-Richard_Gasquet,2,F-DTM,22,0,0,0,0,11,11,,,,,,,,,,
20071112-M-Masters_Cup-RR-Novak_Djokovic-Richard_Gasquet,2,F-DTL,7,3,2,1,0,5,2,,,,,,,,,,
20071112-M-Masters_Cup-RR-Novak_Djokovic-Richard_Gasquet,2,F-IO,10,2,0,0,2,5,5,,,,,,,,,,
20071112-M-Masters_Cup-RR-Novak_Djokovic-Richard_Gasquet,2,F-II,1,1,1,0,0,1,0,,,,,,,,,,
20071112-M-Masters_Cup-RR-Novak_Djokovic-Richard_Gasquet,2,B-XC,44,6,3,2,1,25,19,,,,,,,,,,
20071112-M-Masters_Cup-RR-Novak_Djokovic-Richard_Gasquet,2,B-DTM,16,1,0,0,1,11,5,,,,,,,,,,
20071112-M-Masters_Cup-RR-Novak_Djokovic-Richard_Gasquet,2,B-DTL,11,7,3,0,4,7,4,,,,,,,,,,
20071112-M-Masters_Cup-RR-Novak_Djokovic-Richard_Gasquet,2,B-IO,3,1,0,1,0,2,1,,,,,,,,,,
20071112-M-Masters_Cup-RR-Novak_Djokovic-Richard_Gasquet,2,S-XC,20,1,0,1,0,9,11,,,,,,,,,,
20071112-M-Masters_Cup-RR-Novak_Djokovic-Richard_Gasquet,2,S-DTM,7,0,0,0,0,5,2,,,,,,,,,,
20071112-M-Masters_Cup-SF-Roger_Federer-Rafael_Nadal,1,F-XC,19,4,2,2,0,11,8,,,,,,,,,,
20071112-M-Masters_Cup-SF-Roger_Federer-Rafael_Nadal,1,F-DTM,10,3,0,0,3,2,8,,,,,,,,,,
20071112-M-Masters_Cup-SF-Roger_Federer-Rafael_Nadal,1,F-DTL,7,4,2,1,1,5,2,,,,,,,,,,
20071112-M-Masters_Cup-SF-Roger_Federer-Rafael_Nadal,1,F-IO,13,6,2,2,2,5,8,,,,,,,,,,
20071112-M-Masters_Cup-SF-Roger_Federer-Rafael_Nadal,1,F-II,3,2,0,1,1,2,1,,,,,,,,,,
20071112-M-Masters_Cup-SF-Roger_Federer-Rafael_Nadal,1,B-XC,23,5,1,2,2,13,10,,,,,,,,,,
20071112-M-Masters_Cup-SF-Roger_Federer-Rafael_Nadal,1,B-DTM,10,0,0,0,0,6,4,,,,,,,,,,
20071112-M-Masters_Cup-SF-Roger_Federer-Rafael_Nadal,1,B-DTL,7,1,0,0,1,1,6,,,,,,,,,,
20071112-M-Masters_Cup-SF-Roger_Federer-Rafael_Nadal,1,B-IO,2,0,0,0,0,0,2,,,,,,,,,,
20071112-M-Masters_Cup-SF-Roger_Federer-Rafael_Nadal,1,S-XC,4,1,1,0,0,2,2,,,,,,,,,,
20071112-M-Masters_Cup-SF-Roger_Federer-Rafael_Nadal,1,S-DTM,3,0,0,0,0,2,1,,,,,,,,,,
20071112-M-Masters_Cup-SF-Roger_Federer-Rafael_Nadal,1,S-DTL,5,2,0,0,2,0,5,,,,,,,,,,
20071112-M-Masters_Cup-SF-Roger_Federer-Rafael_Nadal,1,S-IO,1,0,0,0,0,0,1,,,,,,,,,,
20071112-M-Masters_Cup-SF-Roger_Federer-Rafael_Nadal,2,F-XC,46,2,1,0,1,26,20,,,,,,,,,,
20071112-M-Masters_Cup-SF-Roger_Federer-Rafael_Nadal,2,F-DTM,9,0,0,0,0,3,6,,,,,,,,,,
20071112-M-Masters_Cup-SF-Roger_Federer-Rafael_Nadal,2,F-DTL,4,3,2,0,1,3,1,,,,,,,,,,
20071112-M-Masters_Cup-SF-Roger_Federer-Rafael_Nadal,2,F-IO,5,1,0,0,1,1,4,,,,,,,,,,
20071112-M-Masters_Cup-SF-Roger_Federer-Rafael_Nadal,2,B-XC,14,3,2,0,1,8,6,,,,,,,,,,
20071112-M-Masters_Cup-SF-Roger_Federer-Rafael_Nadal,2,B-DTM,13,2,0,1,1,8,5,,,,,,,,,,
20071112-M-Masters_Cup-SF-Roger_Federer-Rafael_Nadal,2,B-DTL,7,1,1,0,0,5,2,,,,,,,,,,
20071112-M-Masters_Cup-SF-Roger_Federer-Rafael_Nadal,2,B-IO,5,1,0,0,1,2,3,,,,,,,,,,
20071112-M-Masters_Cup-SF-Roger_Federer-Rafael_Nadal,2,S-XC,2,0,0,0,0,1,1,,,,,,,,,,
20071112-M-Masters_Cup-SF-Roger_Federer-Rafael_Nadal,2,S-DTM,2,0,0,0,0,1,1,,,,,,,,,,
20071112-M-Masters_Cup-SF-Roger_Federer-Rafael_Nadal,2,S-DTL,1,0,0,0,0,0,1,,,,,,,,,,
20080608-M-Roland_Garros-F-Roger_Federer-Rafael_Nadal,1,F-XC,64,10,2,0,8,29,35,,,,,,,,,,
20080608-M-Roland_Garros-F-Roger_Federer-Rafael_Nadal,1,F-DTM,39,3,0,0,3,13,26,,,,,,,,,,
20080608-M-Roland_Garros-F-Roger_Federer-Rafael_Nadal,1,F-DTL,14,7,0,0,7,3,11,,,,,,,,,,
20080608-M-Roland_Garros-F-Roger_Federer-Rafael_Nadal,1,F-IO,26,12,2,4,6,13,13,,,,,,,,,,
20080608-M-Roland_Garros-F-Roger_Federer-Rafael_Nadal,1,F-II,11,5,2,2,1,8,3,,,,,,,,,,
20080608-M-Roland_Garros-F-Roger_Federer-Rafael_Nadal,1,B-XC,24,7,1,2,4,7,17,,,,,,,,,,
20080608-M-Roland_Garros-F-Roger_Federer-Rafael_Nadal,1,B-DTM,45,3,0,0,3,13,32,,,,,,,,,,
20080608-M-Roland_Garros-F-Roger_Federer-Rafael_Nadal,1,B-DTL,22,7,1,0,6,4,18,,,,,,,,,,
20080608-M-Roland_Garros-F-Roger_Federer-Rafael_Nadal,1,B-IO,3,1,0,0,1,0,3,,,,,,,,,,
20080608-M-Roland_Garros-F-Roger_Federer-Rafael_Nadal,1,S-XC,4,0,0,0,0,1,3,,,,,,,,,,
20080608-M-Roland_Garros-F-Roger_Federer-Rafael_Nadal,1,S-DTM,4,0,0,0,0,2,2,,,,,,,,,,
20080608-M-Roland_Garros-F-Roger_Federer-Rafael_Nadal,1,S-DTL,3,1,0,0,1,2,1,,,,,,,,,,
20080608-M-Roland_Garros-F-Roger_Federer-Rafael_Nadal,1,S-IO,1,0,0,0,0,1,0,,,,,,,,,,
20080608-M-Roland_Garros-F-Roger_Federer-Rafael_Nadal,2,F-XC,81,7,2,3,2,56,25,,,,,,,,,,
20080608-M-Roland_Garros-F-Roger_Federer-Rafael_Nadal,2,F-DTM,24,0,0,0,0,12,12,,,,,,,,,,
20080608-M-Roland_Garros-F-Roger_Federer-Rafael_Nadal,2,F-DTL,9,2,1,1,0,7,2,,,,,,,,,,
20080608-M-Roland_Garros-F-Roger_Federer-Rafael_Nadal,2,F-IO,19,10,3,3,4,11,8,,,,,,,,,,
20080608-M-Roland_Garros-F-Roger_Federer-Rafael_Nadal,2,F-II,3,0,0,0,0,1,2,,,,,,,,,,
20080608-M-Roland_Garros-F-Roger_Federer-Rafael_Nadal,2,B-XC,45,12,6,2,4,27,18,,,,,,,,,,
20080608-M-Roland_Garros-F-Roger_Federer-Rafael_Nadal,2,B-DTM,43,5,0,1,4,22,21,,,,,,,,,,
20080608-M-Roland_Garros-F-Roger_Federer-Rafael_Nadal,2,B-DTL,20,7,4,3,0,16,4,,,,,,,,,,
20080608-M-Roland_Garros-F-Roger_Federer-Rafael_Nadal,2,B-IO,7,1,1,0,0,5,2,,,,,,,,,,
20080608-M-Roland_Garros-F-Roger_Federer-Rafael_Nadal,2,S-XC,2,0,0,0,0,2,0,,,,,,,,,,
20080608-M-Roland_Garros-F-Roger_Federer-Rafael_Nadal,2,S-DTM,4,0,0,0,0,3,1,,,,,,,,,,
20080608-M-Roland_Garros-F-Roger_Federer-Rafael_Nadal,2,S-DTL,1,0,0,0,0,1,0,,,,,,,,,,
20080614-M-Queens_Club-SF-Andy_Roddick-Rafael_Nadal,1,F-XC,27,4,0,1,3,15,12,,,,,,,,,,
20080614-M-Queens_Club-SF-Andy_Roddick-Rafael_Nadal,1,F-DTM,18,1,0,0,1,8,10,,,,,,,,,,
20080614-M-Queens_Club-SF-Andy_Roddick-Rafael_Nadal,1,F-DTL,6,1,0,0,1,0,6,,,,,,,,,,
20080614-M-Queens_Club-SF-Andy_Roddick-Rafael_Nadal,1,F-IO,15,9,3,2,4,7,8,,,,,,,,,,
20080614-M-Queens_Club-SF-Andy_Roddick-Rafael_Nadal,1,F-II,1,0,0,0,0,1,0,,,,,,,,,,
20080614-M-Queens_Club-SF-Andy_Roddick-Rafael_Nadal,1,B-XC,28,5,1,0,4,14,14,,,,,,,,,,
20080614-M-Queens_Club-SF-Andy_Roddick-Rafael_Nadal,1,B-DTM,29,0,0,0,0,15,14,,,,,,,,,,
20080614-M-Queens_Club-SF-Andy_Roddick-Rafael_Nadal,1,B-DTL,4,1,0,0,1,1,3,,,,,,,,,,
20080614-M-Queens_Club-SF-Andy_Roddick-Rafael_Nadal,1,B-IO,1,0,0,0,0,0,1,,,,,,,,,,
20080614-M-Queens_Club-SF-Andy_Roddick-Rafael_Nadal,1,S-XC,1,0,0,0,0,0,1,,,,,,,,,,
20080614-M-Queens_Club-SF-Andy_Roddick-Rafael_Nadal,1,S-DTM,4,0,0,0,0,1,3,,,,,,,,,,
20080614-M-Queens_Club-SF-Andy_Roddick-Rafael_Nadal,1,S-DTL,4,1,0,0,1,1,3,,,,,,,,,,
20080614-M-Queens_Club-SF-Andy_Roddick-Rafael_Nadal,1,S-IO,1,0,0,0,0,0,1,,,,,,,,,,
20080614-M-Queens_Club-SF-Andy_Roddick-Rafael_Nadal,2,F-XC,52,15,9,0,6,31,21,,,,,,,,,,
20080614-M-Queens_Club-SF-Andy_Roddick-Rafael_Nadal,2,F-DTM,14,2,0,1,1,9,5,,,,,,,,,,
20080614-M-Queens_Club-SF-Andy_Roddick-Rafael_Nadal,2,F-DTL,17,7,5,0,2,11,6,,,,,,,,,,
20080614-M-Queens_Club-SF-Andy_Roddick-Rafael_Nadal,2,F-IO,25,10,4,2,4,16,9,,,,,,,,,,
20080614-M-Queens_Club-SF-Andy_Roddick-Rafael_Nadal,2,F-II,1,0,0,0,0,1,0,,,,,,,,,,
20080614-M-Queens_Club-SF-Andy_Roddick-Rafael_Nadal,2,B-XC,10,4,1,0,3,4,6,,,,,,,,,,
20080614-M-Queens_Club-SF-Andy_Roddick-Rafael_Nadal,2,B-DTM,6,0,0,0,0,2,4,,,,,,,,,,
20080614-M-Queens_Club-SF-Andy_Roddick-Rafael_Nadal,2,B-DTL,9,3,1,0,2,5,4,,,,,,,,,,
20080614-M-Queens_Club-SF-Andy_Roddick-Rafael_Nadal,2,B-IO,5,1,0,1,0,2,3,,,,,,,,,,
20080614-M-Queens_Club-SF-Andy_Roddick-Rafael_Nadal,2,S-XC,3,0,0,0,0,3,0,,,,,,,,,,
20080614-M-Queens_Club-SF-Andy_Roddick-Rafael_Nadal,2,S-DTM,4,0,0,0,0,1,3,,,,,,,,,,
20080614-M-Queens_Club-SF-Andy_Roddick-Rafael_Nadal,2,S-DTL,6,2,0,0,2,2,4,,,,,,,,,,
20080614-M-Queens_Club-SF-Andy_Roddick-Rafael_Nadal,2,S-IO,5,0,0,0,0,1,4,,,,,,,,,,
20080706-M-Wimbledon-F-Roger_Federer-Rafael_Nadal,1,F-XC,100,31,8,7,16,52,48,,,,,,,,,,
20080706-M-Wimbledon-F-Roger_Federer-Rafael_Nadal,1,F-DTM,29,5,0,0,5,11,18,,,,,,,,,,
20080706-M-Wimbledon-F-Roger_Federer-Rafael_Nadal,1,F-DTL,34,15,5,4,6,18,16,,,,,,,,,,
20080706-M-Wimbledon-F-Roger_Federer-Rafael_Nadal,1,F-IO,71,30,16,11,3,46,25,,,,,,,,,,
20080706-M-Wimbledon-F-Roger_Federer-Rafael_Nadal,1,F-II,34,8,4,0,4,16,18,,,,,,,,,,
20080706-M-Wimbledon-F-Roger_Federer-Rafael_Nadal,1,B-XC,75,10,2,3,5,31,44,,,,,,,,,,
20080706-M-Wimbledon-F-Roger_Federer-Rafael_Nadal,1,B-DTM,47,3,0,0,3,16,31,,,,,,,,,,
20080706-M-Wimbledon-F-Roger_Federer-Rafael_Nadal,1,B-DTL,52,15,3,1,11,19,33,,,,,,,,,,
20080706-M-Wimbledon-F-Roger_Federer-Rafael_Nadal,1,B-IO,2,1,1,0,0,1,1,,,,,,,,,,
20080706-M-Wimbledon-F-Roger_Federer-Rafael_Nadal,1,S-XC,14,2,0,1,1,5,9,,,,,,,,,,
20080706-M-Wimbledon-F-Roger_Federer-Rafael_Nadal,1,S-DTM,9,1,0,1,0,2,7,,,,,,,,,,
20080706-M-Wimbledon-F-Roger_Federer-Rafael_Nadal,1,S-DTL,18,1,0,1,0,8,10,,,,,,,,,,
20080706-M-Wimbledon-F-Roger_Federer-Rafael_Nadal,2,F-XC,192,31,6,17,8,127,65,,,,,,,,,,
20080706-M-Wimbledon-F-Roger_Federer-Rafael_Nadal,2,F-DTM,21,2,0,0,2,8,13,,,,,,,,,,
20080706-M-Wimbledon-F-Roger_Federer-Rafael_Nadal,2,F-DTL,34,10,4,3,3,21,13,,,,,,,,,,
20080706-M-Wimbledon-F-Roger_Federer-Rafael_Nadal,2,F-IO,44,17,10,1,6,28,16,,,,,,,,,,
20080706-M-Wimbledon-F-Roger_Federer-Rafael_Nadal,2,F-II,31,3,1,1,1,15,16,,,,,,,,,,
20080706-M-Wimbledon-F-Roger_Federer-Rafael_Nadal,2,B-XC,61,21,7,4,10,32,29,,,,,,,,,,
20080706-M-Wimbledon-F-Roger_Federer-Rafael_Nadal,2,B-DTM,37,1,0,1,0,19,18,,,,,,,,,,
20080706-M-Wimbledon-F-Roger_Federer-Rafael_Nadal,2,B-DTL,45,9,3,2,4,26,19,,,,,,,,,,
20080706-M-Wimbledon-F-Roger_Federer-Rafael_Nadal,2,B-IO,8,1,0,1,0,3,5,,,,,,,,,,
20080706-M-Wimbledon-F-Roger_Federer-Rafael_Nadal,2,B-II,6,1,0,1,0,3,3,,,,,,,,,,
20080706-M-Wimbledon-F-Roger_Federer-Rafael_Nadal,2,S-XC,3,1,1,0,0,2,1,,,,,,,,,,
20080706-M-Wimbledon-F-Roger_Federer-Rafael_Nadal,2,S-DTM,10,1,0,0,1,2,8,,,,,,,,,,
20080706-M-Wimbledon-F-Roger_Federer-Rafael_Nadal,2,S-DTL,14,1,1,0,0,8,6,,,,,,,,,,
20080706-M-Wimbledon-F-Roger_Federer-Rafael_Nadal,2,S-IO,5,1,0,1,0,2,3,,,,,,,,,,
20080727-M-Canada_Masters-F-Nicolas_Kiefer-Rafael_Nadal,1,F-XC,40,10,2,1,7,15,25,,,,,,,,,,
20080727-M-Canada_Masters-F-Nicolas_Kiefer-Rafael_Nadal,1,F-DTM,14,2,0,0,2,1,13,,,,,,,,,,
20080727-M-Canada_Masters-F-Nicolas_Kiefer-Rafael_Nadal,1,F-DTL,15,9,2,1,6,5,10,,,,,,,,,,
20080727-M-Canada_Masters-F-Nicolas_Kiefer-Rafael_Nadal,1,F-IO,11,2,0,0,2,2,9,,,,,,,,,,
20080727-M-Canada_Masters-F-Nicolas_Kiefer-Rafael_Nadal,1,F-II,1,1,0,0,1,0,1,,,,,,,,,,
20080727-M-Canada_Masters-F-Nicolas_Kiefer-Rafael_Nadal,1,B-XC,26,5,0,1,4,3,23,,,,,,,,,,
20080727-M-Canada_Masters-F-Nicolas_Kiefer-Rafael_Nadal,1,B-DTM,8,0,0,0,0,1,7,,,,,,,,,,
20080727-M-Canada_Masters-F-Nicolas_Kiefer-Rafael_Nadal,1,B-DTL,5,1,0,0,1,1,4,,,,,,,,,,
20080727-M-Canada_Masters-F-Nicolas_Kiefer-Rafael_Nadal,1,B-IO,1,0,0,0,0,0,1,,,,,,,,,,
20080727-M-Canada_Masters-F-Nicolas_Kiefer-Rafael_Nadal,1,S-DTM,5,0,0,0,0,0,5,,,,,,,,,,
20080727-M-Canada_Masters-F-Nicolas_Kiefer-Rafael_Nadal,1,S-DTL,1,0,0,0,0,0,1,,,,,,,,,,
20080727-M-Canada_Masters-F-Nicolas_Kiefer-Rafael_Nadal,2,F-XC,46,7,2,4,1,41,5,,,,,,,,,,
20080727-M-Canada_Masters-F-Nicolas_Kiefer-Rafael_Nadal,2,F-DTM,21,5,0,0,5,13,8,,,,,,,,,,
20080727-M-Canada_Masters-F-Nicolas_Kiefer-Rafael_Nadal,2,F-DTL,9,1,1,0,0,6,3,,,,,,,,,,
20080727-M-Canada_Masters-F-Nicolas_Kiefer-Rafael_Nadal,2,F-IO,17,3,3,0,0,15,2,,,,,,,,,,
20080727-M-Canada_Masters-F-Nicolas_Kiefer-Rafael_Nadal,2,F-II,2,1,0,0,1,1,1,,,,,,,,,,
20080727-M-Canada_Masters-F-Nicolas_Kiefer-Rafael_Nadal,2,B-XC,15,1,0,0,1,11,4,,,,,,,,,,
20080727-M-Canada_Masters-F-Nicolas_Kiefer-Rafael_Nadal,2,B-DTM,9,1,0,0,1,6,3,,,,,,,,,,
20080727-M-Canada_Masters-F-Nicolas_Kiefer-Rafael_Nadal,2,B-DTL,9,5,0,2,3,4,5,,,,,,,,,,
20080727-M-Canada_Masters-F-Nicolas_Kiefer-Rafael_Nadal,2,B-IO,2,0,0,0,0,2,0,,,,,,,,,,
20080727-M-Canada_Masters-F-Nicolas_Kiefer-Rafael_Nadal,2,S-XC,1,0,0,0,0,0,1,,,,,,,,,,
20080727-M-Canada_Masters-F-Nicolas_Kiefer-Rafael_Nadal,2,S-DTM,1,0,0,0,0,0,1,,,,,,,,,,
20080727-M-Canada_Masters-F-Nicolas_Kiefer-Rafael_Nadal,2,S-DTL,1,1,0,0,1,0,1,,,,,,,,,,
20080727-M-Canada_Masters-F-Nicolas_Kiefer-Rafael_Nadal,2,S-IO,1,0,0,0,0,1,0,,,,,,,,,,
20080802-M-Cincinnati_Masters-SF-Novak_Djokovic-Rafael_Nadal,1,F-XC,41,2,1,0,1,27,14,,,,,,,,,,
20080802-M-Cincinnati_Masters-SF-Novak_Djokovic-Rafael_Nadal,1,F-DTM,12,4,0,3,1,7,5,,,,,,,,,,
20080802-M-Cincinnati_Masters-SF-Novak_Djokovic-Rafael_Nadal,1,F-DTL,13,6,1,5,0,12,1,,,,,,,,,,
20080802-M-Cincinnati_Masters-SF-Novak_Djokovic-Rafael_Nadal,1,F-IO,24,12,5,4,3,16,8,,,,,,,,,,
20080802-M-Cincinnati_Masters-SF-Novak_Djokovic-Rafael_Nadal,1,B-XC,23,7,1,1,5,11,12,,,,,,,,,,
20080802-M-Cincinnati_Masters-SF-Novak_Djokovic-Rafael_Nadal,1,B-DTM,14,2,0,1,1,9,5,,,,,,,,,,
20080802-M-Cincinnati_Masters-SF-Novak_Djokovic-Rafael_Nadal,1,B-DTL,14,4,1,0,3,8,6,,,,,,,,,,
20080802-M-Cincinnati_Masters-SF-Novak_Djokovic-Rafael_Nadal,1,B-IO,3,0,0,0,0,1,2,,,,,,,,,,
20080802-M-Cincinnati_Masters-SF-Novak_Djokovic-Rafael_Nadal,1,S-XC,1,0,0,0,0,0,1,,,,,,,,,,
20080802-M-Cincinnati_Masters-SF-Novak_Djokovic-Rafael_Nadal,1,S-DTM,1,0,0,0,0,0,1,,,,,,,,,,
20080802-M-Cincinnati_Masters-SF-Novak_Djokovic-Rafael_Nadal,1,S-DTL,1,0,0,0,0,0,1,,,,,,,,,,
20080802-M-Cincinnati_Masters-SF-Novak_Djokovic-Rafael_Nadal,2,F-XC,41,9,2,6,1,22,19,,,,,,,,,,
20080802-M-Cincinnati_Masters-SF-Novak_Djokovic-Rafael_Nadal,2,F-DTM,14,2,0,0,2,4,10,,,,,,,,,,
20080802-M-Cincinnati_Masters-SF-Novak_Djokovic-Rafael_Nadal,2,F-DTL,9,3,2,1,0,5,4,,,,,,,,,,
20080802-M-Cincinnati_Masters-SF-Novak_Djokovic-Rafael_Nadal,2,F-IO,6,2,0,1,1,2,4,,,,,,,,,,
20080802-M-Cincinnati_Masters-SF-Novak_Djokovic-Rafael_Nadal,2,F-II,2,0,0,0,0,1,1,,,,,,,,,,
20080802-M-Cincinnati_Masters-SF-Novak_Djokovic-Rafael_Nadal,2,B-XC,32,5,1,2,2,11,21,,,,,,,,,,
20080802-M-Cincinnati_Masters-SF-Novak_Djokovic-Rafael_Nadal,2,B-DTM,13,1,0,0,1,5,8,,,,,,,,,,
20080802-M-Cincinnati_Masters-SF-Novak_Djokovic-Rafael_Nadal,2,B-DTL,7,1,0,0,1,1,6,,,,,,,,,,
20080802-M-Cincinnati_Masters-SF-Novak_Djokovic-Rafael_Nadal,2,B-IO,2,1,0,0,1,0,2,,,,,,,,,,
20080802-M-Cincinnati_Masters-SF-Novak_Djokovic-Rafael_Nadal,2,S-XC,4,0,0,0,0,1,3,,,,,,,,,,
20080802-M-Cincinnati_Masters-SF-Novak_Djokovic-Rafael_Nadal,2,S-DTM,8,0,0,0,0,5,3,,,,,,,,,,
20080802-M-Cincinnati_Masters-SF-Novak_Djokovic-Rafael_Nadal,2,S-DTL,1,0,0,0,0,1,0,,,,,,,,,,
20080817-M-Olympics-F-Rafael_Nadal-Fernando_Gonzalez,1,F-XC,64,13,6,6,1,54,10,,,,,,,,,,
20080817-M-Olympics-F-Rafael_Nadal-Fernando_Gonzalez,1,F-DTM,19,2,1,0,1,11,8,,,,,,,,,,
20080817-M-Olympics-F-Rafael_Nadal-Fernando_Gonzalez,1,F-DTL,20,8,7,0,1,15,5,,,,,,,,,,
20080817-M-Olympics-F-Rafael_Nadal-Fernando_Gonzalez,1,F-IO,35,13,6,5,2,30,5,,,,,,,,,,
20080817-M-Olympics-F-Rafael_Nadal-Fernando_Gonzalez,1,F-II,14,5,1,4,0,12,2,,,,,,,,,,
20080817-M-Olympics-F-Rafael_Nadal-Fernando_Gonzalez,1,B-XC,31,8,4,3,1,25,6,,,,,,,,,,
20080817-M-Olympics-F-Rafael_Nadal-Fernando_Gonzalez,1,B-DTM,22,1,0,0,1,10,12,,,,,,,,,,
20080817-M-Olympics-F-Rafael_Nadal-Fernando_Gonzalez,1,B-DTL,18,6,3,0,3,12,6,,,,,,,,,,
20080817-M-Olympics-F-Rafael_Nadal-Fernando_Gonzalez,1,B-IO,3,0,0,0,0,3,0,,,,,,,,,,
20080817-M-Olympics-F-Rafael_Nadal-Fernando_Gonzalez,1,S-XC,1,0,0,0,0,0,1,,,,,,,,,,
20080817-M-Olympics-F-Rafael_Nadal-Fernando_Gonzalez,1,S-DTM,10,1,0,0,1,6,4,,,,,,,,,,
20080817-M-Olympics-F-Rafael_Nadal-Fernando_Gonzalez,1,S-DTL,5,1,0,0,1,3,2,,,,,,,,,,
20080817-M-Olympics-F-Rafael_Nadal-Fernando_Gonzalez,1,S-IO,2,1,1,0,0,2,0,,,,,,,,,,
20080817-M-Olympics-F-Rafael_Nadal-Fernando_Gonzalez,2,F-XC,67,7,1,2,4,27,40,,,,,,,,,,
20080817-M-Olympics-F-Rafael_Nadal-Fernando_Gonzalez,2,F-DTM,31,5,0,0,5,8,23,,,,,,,,,,
20080817-M-Olympics-F-Rafael_Nadal-Fernando_Gonzalez,2,F-DTL,8,5,1,1,3,4,4,,,,,,,,,,
20080817-M-Olympics-F-Rafael_Nadal-Fernando_Gonzalez,2,F-IO,46,22,9,6,7,19,27,,,,,,,,,,
20080817-M-Olympics-F-Rafael_Nadal-Fernando_Gonzalez,2,F-II,13,6,2,1,3,7,6,,,,,,,,,,
20080817-M-Olympics-F-Rafael_Nadal-Fernando_Gonzalez,2,B-XC,13,4,1,0,3,5,8,,,,,,,,,,
20080817-M-Olympics-F-Rafael_Nadal-Fernando_Gonzalez,2,B-DTM,7,2,0,0,2,1,6,,,,,,,,,,
20080817-M-Olympics-F-Rafael_Nadal-Fernando_Gonzalez,2,B-DTL,8,1,1,0,0,1,7,,,,,,,,,,
20080817-M-Olympics-F-Rafael_Nadal-Fernando_Gonzalez,2,B-IO,1,0,0,0,0,0,1,,,,,,,,,,
20080817-M-Olympics-F-Rafael_Nadal-Fernando_Gonzalez,2,S-XC,13,0,0,0,0,1,12,,,,,,,,,,
20080817-M-Olympics-F-Rafael_Nadal-Fernando_Gonzalez,2,S-DTM,16,1,0,0,1,2,14,,,,,,,,,,
20080817-M-Olympics-F-Rafael_Nadal-Fernando_Gonzalez,2,S-DTL,11,2,0,0,2,2,9,,,,,,,,,,
20080817-M-Olympics-F-Rafael_Nadal-Fernando_Gonzalez,2,S-IO,2,0,0,0,0,0,2,,,,,,,,,,
20080908-M-US_Open-F-Roger_Federer-Andy_Murray,1,F-XC,48,9,2,1,6,26,22,,,,,,,,,,
20080908-M-US_Open-F-Roger_Federer-Andy_Murray,1,F-DTM,33,2,0,1,1,17,16,,,,,,,,,,
20080908-M-US_Open-F-Roger_Federer-Andy_Murray,1,F-DTL,15,12,3,5,4,10,5,,,,,,,,,,
20080908-M-US_Open-F-Roger_Federer-Andy_Murray,1,F-IO,34,13,6,5,2,26,8,,,,,,,,,,
20080908-M-US_Open-F-Roger_Federer-Andy_Murray,1,F-II,11,3,0,2,1,8,3,,,,,,,,,,
20080908-M-US_Open-F-Roger_Federer-Andy_Murray,1,B-XC,29,7,2,2,3,17,12,,,,,,,,,,
20080908-M-US_Open-F-Roger_Federer-Andy_Murray,1,B-DTM,33,5,1,0,4,20,13,,,,,,,,,,
20080908-M-US_Open-F-Roger_Federer-Andy_Murray,1,B-DTL,14,1,0,0,1,9,5,,,,,,,,,,
20080908-M-US_Open-F-Roger_Federer-Andy_Murray,1,B-IO,3,0,0,0,0,1,2,,,,,,,,,,
20080908-M-US_Open-F-Roger_Federer-Andy_Murray,1,S-XC,15,0,0,0,0,9,6,,,,,,,,,,
20080908-M-US_Open-F-Roger_Federer-Andy_Murray,1,S-DTM,8,0,0,0,0,5,3,,,,,,,,,,
20080908-M-US_Open-F-Roger_Federer-Andy_Murray,1,S-DTL,3,0,0,0,0,2,1,,,,,,,,,,
20080908-M-US_Open-F-Roger_Federer-Andy_Murray,1,S-IO,1,0,0,0,0,1,0,,,,,,,,,,
20080908-M-US_Open-F-Roger_Federer-Andy_Murray,2,F-XC,41,9,3,2,4,15,26,,,,,,,,,,
20080908-M-US_Open-F-Roger_Federer-Andy_Murray,2,F-DTM,41,2,0,0,2,16,25,,,,,,,,,,
20080908-M-US_Open-F-Roger_Federer-Andy_Murray,2,F-DTL,20,3,0,2,1,11,9,,,,,,,,,,
20080908-M-US_Open-F-Roger_Federer-Andy_Murray,2,F-IO,35,7,1,3,3,14,21,,,,,,,,,,
20080908-M-US_Open-F-Roger_Federer-Andy_Murray,2,F-II,2,1,0,0,1,0,2,,,,,,,,,,
20080908-M-US_Open-F-Roger_Federer-Andy_Murray,2,B-XC,36,4,2,1,1,13,23,,,,,,,,,,
20080908-M-US_Open-F-Roger_Federer-Andy_Murray,2,B-DTM,31,4,0,2,2,10,21,,,,,,,,,,
20080908-M-US_Open-F-Roger_Federer-Andy_Murray,2,B-DTL,10,5,2,0,3,3,7,,,,,,,,,,
20080908-M-US_Open-F-Roger_Federer-Andy_Murray,2,B-IO,6,5,0,5,0,5,1,,,,,,,,,,
20080908-M-US_Open-F-Roger_Federer-Andy_Murray,2,S-XC,11,0,0,0,0,6,5,,,,,,,,,,
20080908-M-US_Open-F-Roger_Federer-Andy_Murray,2,S-DTM,4,2,0,1,1,1,3,,,,,,,,,,
20080908-M-US_Open-F-Roger_Federer-Andy_Murray,2,S-DTL,6,0,0,0,0,5,1,,,,,,,,,,
20080908-M-US_Open-F-Roger_Federer-Andy_Murray,2,S-IO,1,0,0,0,0,1,0,,,,,,,,,,
20090130-M-Australian_Open-SF-Fernando_Verdasco-Rafael_Nadal,1,F-XC,91,23,9,5,9,55,36,,,,,,,,,,
20090130-M-Australian_Open-SF-Fernando_Verdasco-Rafael_Nadal,1,F-DTM,72,12,0,5,7,39,33,,,,,,,,,,
20090130-M-Australian_Open-SF-Fernando_Verdasco-Rafael_Nadal,1,F-DTL,26,10,5,1,4,18,8,,,,,,,,,,
20090130-M-Australian_Open-SF-Fernando_Verdasco-Rafael_Nadal,1,F-IO,78,23,13,1,9,42,36,,,,,,,,,,
20090130-M-Australian_Open-SF-Fernando_Verdasco-Rafael_Nadal,1,F-II,7,3,1,1,1,5,2,,,,,,,,,,
20090130-M-Australian_Open-SF-Fernando_Verdasco-Rafael_Nadal,1,B-XC,96,18,6,3,9,48,48,,,,,,,,,,
20090130-M-Australian_Open-SF-Fernando_Verdasco-Rafael_Nadal,1,B-DTM,55,4,0,1,3,21,34,,,,,,,,,,
20090130-M-Australian_Open-SF-Fernando_Verdasco-Rafael_Nadal,1,B-DTL,36,12,5,1,6,16,20,,,,,,,,,,
20090130-M-Australian_Open-SF-Fernando_Verdasco-Rafael_Nadal,1,B-IO,18,7,2,1,4,8,10,,,,,,,,,,
20090130-M-Australian_Open-SF-Fernando_Verdasco-Rafael_Nadal,1,B-II,1,0,0,0,0,0,1,,,,,,,,,,
20090130-M-Australian_Open-SF-Fernando_Verdasco-Rafael_Nadal,1,S-XC,16,3,0,0,3,6,10,,,,,,,,,,
20090130-M-Australian_Open-SF-Fernando_Verdasco-Rafael_Nadal,1,S-DTM,13,2,0,0,2,7,6,,,,,,,,,,
20090130-M-Australian_Open-SF-Fernando_Verdasco-Rafael_Nadal,1,S-DTL,6,2,0,0,2,2,4,,,,,,,,,,
20090130-M-Australian_Open-SF-Fernando_Verdasco-Rafael_Nadal,1,S-IO,3,1,0,0,1,0,3,,,,,,,,,,
20090130-M-Australian_Open-SF-Fernando_Verdasco-Rafael_Nadal,2,F-XC,96,25,9,12,4,53,43,,,,,,,,,,
20090130-M-Australian_Open-SF-Fernando_Verdasco-Rafael_Nadal,2,F-DTM,79,3,0,0,3,38,41,,,,,,,,,,
20090130-M-Australian_Open-SF-Fernando_Verdasco-Rafael_Nadal,2,F-DTL,37,11,3,3,5,21,16,,,,,,,,,,
20090130-M-Australian_Open-SF-Fernando_Verdasco-Rafael_Nadal,2,F-IO,61,16,8,4,4,36,25,,,,,,,,,,
20090130-M-Australian_Open-SF-Fernando_Verdasco-Rafael_Nadal,2,F-II,8,5,2,2,1,5,3,,,,,,,,,,
20090130-M-Australian_Open-SF-Fernando_Verdasco-Rafael_Nadal,2,B-XC,50,7,1,2,4,29,21,,,,,,,,,,
20090130-M-Australian_Open-SF-Fernando_Verdasco-Rafael_Nadal,2,B-DTM,45,2,0,1,1,21,24,,,,,,,,,,
20090130-M-Australian_Open-SF-Fernando_Verdasco-Rafael_Nadal,2,B-DTL,16,7,3,2,2,10,6,,,,,,,,,,
20090130-M-Australian_Open-SF-Fernando_Verdasco-Rafael_Nadal,2,B-IO,4,0,0,0,0,3,1,,,,,,,,,,
20090130-M-Australian_Open-SF-Fernando_Verdasco-Rafael_Nadal,2,B-II,1,0,0,0,0,1,0,,,,,,,,,,
20090130-M-Australian_Open-SF-Fernando_Verdasco-Rafael_Nadal,2,S-XC,51,2,0,1,1,20,31,,,,,,,,,,
20090130-M-Australian_Open-SF-Fernando_Verdasco-Rafael_Nadal,2,S-DTM,49,0,0,0,0,23,26,,,,,,,,,,
20090130-M-Australian_Open-SF-Fernando_Verdasco-Rafael_Nadal,2,S-DTL,10,1,0,0,1,3,7,,,,,,,,,,
20090130-M-Australian_Open-SF-Fernando_Verdasco-Rafael_Nadal,2,S-IO,3,0,0,0,0,2,1,,,,,,,,,,
20090130-M-Australian_Open-SF-Fernando_Verdasco-Rafael_Nadal,2,S-II,2,0,0,0,0,0,2,,,,,,,,,,
20090201-M-Australian_Open-F-Roger_Federer-Rafael_Nadal,1,F-XC,114,27,10,5,12,61,53,,,,,,,,,,
20090201-M-Australian_Open-F-Roger_Federer-Rafael_Nadal,1,F-DTM,56,8,1,2,5,24,32,,,,,,,,,,
20090201-M-Australian_Open-F-Roger_Federer-Rafael_Nadal,1,F-DTL,27,10,4,1,5,13,14,,,,,,,,,,
20090201-M-Australian_Open-F-Roger_Federer-Rafael_Nadal,1,F-IO,51,18,10,3,5,32,19,,,,,,,,,,
20090201-M-Australian_Open-F-Roger_Federer-Rafael_Nadal,1,F-II,15,4,1,1,2,6,9,,,,,,,,,,
20090201-M-Australian_Open-F-Roger_Federer-Rafael_Nadal,1,B-XC,105,22,4,5,13,56,49,,,,,,,,,,
20090201-M-Australian_Open-F-Roger_Federer-Rafael_Nadal,1,B-DTM,84,4,0,0,4,37,47,,,,,,,,,,
20090201-M-Australian_Open-F-Roger_Federer-Rafael_Nadal,1,B-DTL,41,12,2,2,8,17,24,,,,,,,,,,
20090201-M-Australian_Open-F-Roger_Federer-Rafael_Nadal,1,B-IO,10,1,1,0,0,4,6,,,,,,,,,,
20090201-M-Australian_Open-F-Roger_Federer-Rafael_Nadal,1,S-XC,11,1,1,0,0,5,6,,,,,,,,,,
20090201-M-Australian_Open-F-Roger_Federer-Rafael_Nadal,1,S-DTM,14,1,0,0,1,5,9,,,,,,,,,,
20090201-M-Australian_Open-F-Roger_Federer-Rafael_Nadal,1,S-DTL,17,3,1,1,1,10,7,,,,,,,,,,
20090201-M-Australian_Open-F-Roger_Federer-Rafael_Nadal,1,S-IO,1,0,0,0,0,1,0,,,,,,,,,,
20090201-M-Australian_Open-F-Roger_Federer-Rafael_Nadal,1,S-II,2,1,0,1,0,1,1,,,,,,,,,,
20090201-M-Australian_Open-F-Roger_Federer-Rafael_Nadal,2,F-XC,202,28,9,11,8,110,92,,,,,,,,,,
20090201-M-Australian_Open-F-Roger_Federer-Rafael_Nadal,2,F-DTM,37,4,0,1,3,19,18,,,,,,,,,,
20090201-M-Australian_Open-F-Roger_Federer-Rafael_Nadal,2,F-DTL,33,15,6,2,7,17,16,,,,,,,,,,
20090201-M-Australian_Open-F-Roger_Federer-Rafael_Nadal,2,F-IO,38,9,7,0,2,21,17,,,,,,,,,,
20090201-M-Australian_Open-F-Roger_Federer-Rafael_Nadal,2,F-II,9,1,0,0,1,3,6,,,,,,,,,,
20090201-M-Australian_Open-F-Roger_Federer-Rafael_Nadal,2,B-XC,91,28,8,9,11,49,42,,,,,,,,,,
20090201-M-Australian_Open-F-Roger_Federer-Rafael_Nadal,2,B-DTM,71,5,0,2,3,37,34,,,,,,,,,,
20090201-M-Australian_Open-F-Roger_Federer-Rafael_Nadal,2,B-DTL,37,9,3,1,5,19,18,,,,,,,,,,
20090201-M-Australian_Open-F-Roger_Federer-Rafael_Nadal,2,B-IO,20,2,1,0,1,10,10,,,,,,,,,,
20090201-M-Australian_Open-F-Roger_Federer-Rafael_Nadal,2,S-XC,8,1,0,1,0,5,3,,,,,,,,,,
20090201-M-Australian_Open-F-Roger_Federer-Rafael_Nadal,2,S-DTM,12,0,0,0,0,5,7,,,,,,,,,,
20090201-M-Australian_Open-F-Roger_Federer-Rafael_Nadal,2,S-DTL,13,2,0,0,2,4,9,,,,,,,,,,
20090201-M-Australian_Open-F-Roger_Federer-Rafael_Nadal,2,S-IO,2,0,0,0,0,0,2,,,,,,,,,,
20090405-M-Miami_Masters-F-Novak_Djokovic-Andy_Murray,1,F-XC,34,7,0,1,6,15,19,,,,,,,,,,
20090405-M-Miami_Masters-F-Novak_Djokovic-Andy_Murray,1,F-DTM,14,1,0,0,1,8,6,,,,,,,,,,
20090405-M-Miami_Masters-F-Novak_Djokovic-Andy_Murray,1,F-DTL,18,5,1,2,2,10,8,,,,,,,,,,
20090405-M-Miami_Masters-F-Novak_Djokovic-Andy_Murray,1,F-IO,25,7,3,2,2,17,8,,,,,,,,,,
20090405-M-Miami_Masters-F-Novak_Djokovic-Andy_Murray,1,F-II,3,1,0,0,1,1,2,,,,,,,,,,
20090405-M-Miami_Masters-F-Novak_Djokovic-Andy_Murray,1,B-XC,42,3,0,0,3,18,24,,,,,,,,,,
20090405-M-Miami_Masters-F-Novak_Djokovic-Andy_Murray,1,B-DTM,17,0,0,0,0,10,7,,,,,,,,,,
20090405-M-Miami_Masters-F-Novak_Djokovic-Andy_Murray,1,B-DTL,15,7,1,0,6,3,12,,,,,,,,,,
20090405-M-Miami_Masters-F-Novak_Djokovic-Andy_Murray,1,B-IO,7,3,0,1,2,3,4,,,,,,,,,,
20090405-M-Miami_Masters-F-Novak_Djokovic-Andy_Murray,1,S-XC,17,1,0,0,1,4,13,,,,,,,,,,
20090405-M-Miami_Masters-F-Novak_Djokovic-Andy_Murray,1,S-DTM,6,1,0,0,1,1,5,,,,,,,,,,
20090405-M-Miami_Masters-F-Novak_Djokovic-Andy_Murray,1,S-DTL,2,1,0,0,1,0,2,,,,,,,,,,
20090405-M-Miami_Masters-F-Novak_Djokovic-Andy_Murray,1,S-IO,1,0,0,0,0,0,1,,,,,,,,,,
20090405-M-Miami_Masters-F-Novak_Djokovic-Andy_Murray,2,F-XC,37,7,5,1,1,23,14,,,,,,,,,,
20090405-M-Miami_Masters-F-Novak_Djokovic-Andy_Murray,2,F-DTM,19,2,0,1,1,8,11,,,,,,,,,,
20090405-M-Miami_Masters-F-Novak_Djokovic-Andy_Murray,2,F-DTL,13,3,2,1,0,9,4,,,,,,,,,,
20090405-M-Miami_Masters-F-Novak_Djokovic-Andy_Murray,2,F-IO,15,2,1,0,1,6,9,,,,,,,,,,
20090405-M-Miami_Masters-F-Novak_Djokovic-Andy_Murray,2,F-II,3,2,1,0,1,1,2,,,,,,,,,,
20090405-M-Miami_Masters-F-Novak_Djokovic-Andy_Murray,2,B-XC,48,11,3,2,6,31,17,,,,,,,,,,
20090405-M-Miami_Masters-F-Novak_Djokovic-Andy_Murray,2,B-DTM,24,2,0,1,1,12,12,,,,,,,,,,
20090405-M-Miami_Masters-F-Novak_Djokovic-Andy_Murray,2,B-DTL,9,6,0,3,3,6,3,,,,,,,,,,
20090405-M-Miami_Masters-F-Novak_Djokovic-Andy_Murray,2,B-IO,6,2,1,0,1,1,5,,,,,,,,,,
20090405-M-Miami_Masters-F-Novak_Djokovic-Andy_Murray,2,S-XC,23,3,0,0,3,11,12,,,,,,,,,,
20090405-M-Miami_Masters-F-Novak_Djokovic-Andy_Murray,2,S-DTM,10,1,0,0,1,1,9,,,,,,,,,,
20090405-M-Miami_Masters-F-Novak_Djokovic-Andy_Murray,2,S-DTL,3,0,0,0,0,1,2,,,,,,,,,,
20090405-M-Miami_Masters-F-Novak_Djokovic-Andy_Murray,2,S-IO,3,0,0,0,0,2,1,,,,,,,,,,
20090503-M-Rome_Masters-SF-Novak_Djokovic-Roger_Federer,1,F-XC,47,16,7,3,6,27,20,,,,,,,,,,
20090503-M-Rome_Masters-SF-Novak_Djokovic-Roger_Federer,1,F-DTM,44,4,1,1,2,25,19,,,,,,,,,,
20090503-M-Rome_Masters-SF-Novak_Djokovic-Roger_Federer,1,F-DTL,13,3,1,1,1,8,5,,,,,,,,,,
20090503-M-Rome_Masters-SF-Novak_Djokovic-Roger_Federer,1,F-IO,38,12,7,3,2,24,14,,,,,,,,,,
20090503-M-Rome_Masters-SF-Novak_Djokovic-Roger_Federer,1,F-II,6,2,1,0,1,5,1,,,,,,,,,,
20090503-M-Rome_Masters-SF-Novak_Djokovic-Roger_Federer,1,B-XC,61,7,2,2,3,39,22,,,,,,,,,,
20090503-M-Rome_Masters-SF-Novak_Djokovic-Roger_Federer,1,B-DTM,35,3,0,0,3,20,15,,,,,,,,,,
20090503-M-Rome_Masters-SF-Novak_Djokovic-Roger_Federer,1,B-DTL,11,7,0,1,6,5,6,,,,,,,,,,
20090503-M-Rome_Masters-SF-Novak_Djokovic-Roger_Federer,1,B-IO,5,2,0,2,0,3,2,,,,,,,,,,
20090503-M-Rome_Masters-SF-Novak_Djokovic-Roger_Federer,1,S-XC,6,0,0,0,0,3,3,,,,,,,,,,
20090503-M-Rome_Masters-SF-Novak_Djokovic-Roger_Federer,1,S-DTM,1,0,0,0,0,1,0,,,,,,,,,,
20090503-M-Rome_Masters-SF-Novak_Djokovic-Roger_Federer,1,S-IO,1,0,0,0,0,1,0,,,,,,,,,,
20090503-M-Rome_Masters-SF-Novak_Djokovic-Roger_Federer,2,F-XC,44,12,1,4,7,20,24,,,,,,,,,,
20090503-M-Rome_Masters-SF-Novak_Djokovic-Roger_Federer,2,F-DTM,37,3,1,0,2,15,22,,,,,,,,,,
20090503-M-Rome_Masters-SF-Novak_Djokovic-Roger_Federer,2,F-DTL,11,3,1,0,2,3,8,,,,,,,,,,
20090503-M-Rome_Masters-SF-Novak_Djokovic-Roger_Federer,2,F-IO,43,18,7,3,8,22,21,,,,,,,,,,
20090503-M-Rome_Masters-SF-Novak_Djokovic-Roger_Federer,2,F-II,5,1,0,1,0,3,2,,,,,,,,,,
20090503-M-Rome_Masters-SF-Novak_Djokovic-Roger_Federer,2,B-XC,32,3,0,0,3,9,23,,,,,,,,,,
20090503-M-Rome_Masters-SF-Novak_Djokovic-Roger_Federer,2,B-DTM,41,5,1,0,4,15,26,,,,,,,,,,
20090503-M-Rome_Masters-SF-Novak_Djokovic-Roger_Federer,2,B-DTL,11,4,1,1,2,6,5,,,,,,,,,,
20090503-M-Rome_Masters-SF-Novak_Djokovic-Roger_Federer,2,B-IO,2,1,0,0,1,1,1,,,,,,,,,,
20090503-M-Rome_Masters-SF-Novak_Djokovic-Roger_Federer,2,S-XC,15,2,0,0,2,7,8,,,,,,,,,,
20090503-M-Rome_Masters-SF-Novak_Djokovic-Roger_Federer,2,S-DTM,8,0,0,0,0,2,6,,,,,,,,,,
20090503-M-Rome_Masters-SF-Novak_Djokovic-Roger_Federer,2,S-DTL,2,0,0,0,0,2,0,,,,,,,,,,
20090607-M-Roland_Garros-F-Robin_Soderling-Roger_Federer,1,F-XC,31,9,4,4,1,15,16,,,,,,,,,,
20090607-M-Roland_Garros-F-Robin_Soderling-Roger_Federer,1,F-DTM,31,4,0,3,1,13,18,,,,,,,,,,
20090607-M-Roland_Garros-F-Robin_Soderling-Roger_Federer,1,F-DTL,15,6,1,1,4,7,8,,,,,,,,,,
20090607-M-Roland_Garros-F-Robin_Soderling-Roger_Federer,1,F-IO,30,8,4,3,1,21,9,,,,,,,,,,
20090607-M-Roland_Garros-F-Robin_Soderling-Roger_Federer,1,F-II,4,2,0,1,1,1,3,,,,,,,,,,
20090607-M-Roland_Garros-F-Robin_Soderling-Roger_Federer,1,B-XC,43,4,1,2,1,24,19,,,,,,,,,,
20090607-M-Roland_Garros-F-Robin_Soderling-Roger_Federer,1,B-DTM,23,1,0,0,1,6,17,,,,,,,,,,
20090607-M-Roland_Garros-F-Robin_Soderling-Roger_Federer,1,B-DTL,8,5,2,2,1,6,2,,,,,,,,,,
20090607-M-Roland_Garros-F-Robin_Soderling-Roger_Federer,1,B-IO,4,0,0,0,0,1,3,,,,,,,,,,
20090607-M-Roland_Garros-F-Robin_Soderling-Roger_Federer,1,B-II,1,1,1,0,0,1,0,,,,,,,,,,
20090607-M-Roland_Garros-F-Robin_Soderling-Roger_Federer,1,S-XC,2,0,0,0,0,1,1,,,,,,,,,,
20090607-M-Roland_Garros-F-Robin_Soderling-Roger_Federer,1,S-DTM,2,0,0,0,0,1,1,,,,,,,,,,
20090607-M-Roland_Garros-F-Robin_Soderling-Roger_Federer,1,S-IO,1,1,0,1,0,1,0,,,,,,,,,,
20090607-M-Roland_Garros-F-Robin_Soderling-Roger_Federer,2,F-XC,44,19,7,11,1,34,10,,,,,,,,,,
20090607-M-Roland_Garros-F-Robin_Soderling-Roger_Federer,2,F-DTM,28,4,1,3,0,17,11,,,,,,,,,,
20090607-M-Roland_Garros-F-Robin_Soderling-Roger_Federer,2,F-DTL,7,3,3,0,0,6,1,,,,,,,,,,
20090607-M-Roland_Garros-F-Robin_Soderling-Roger_Federer,2,F-IO,25,4,0,3,1,12,13,,,,,,,,,,
20090607-M-Roland_Garros-F-Robin_Soderling-Roger_Federer,2,F-II,6,3,1,2,0,6,0,,,,,,,,,,
20090607-M-Roland_Garros-F-Robin_Soderling-Roger_Federer,2,B-XC,27,5,1,3,1,16,11,,,,,,,,,,
20090607-M-Roland_Garros-F-Robin_Soderling-Roger_Federer,2,B-DTM,18,2,0,1,1,5,13,,,,,,,,,,
20090607-M-Roland_Garros-F-Robin_Soderling-Roger_Federer,2,B-DTL,11,4,2,0,2,6,5,,,,,,,,,,
20090607-M-Roland_Garros-F-Robin_Soderling-Roger_Federer,2,B-IO,1,1,1,0,0,1,0,,,,,,,,,,
20090607-M-Roland_Garros-F-Robin_Soderling-Roger_Federer,2,S-XC,6,0,0,0,0,3,3,,,,,,,,,,
20090607-M-Roland_Garros-F-Robin_Soderling-Roger_Federer,2,S-DTM,8,1,0,0,1,2,6,,,,,,,,,,
20090607-M-Roland_Garros-F-Robin_Soderling-Roger_Federer,2,S-DTL,3,0,0,0,0,2,1,,,,,,,,,,
20090607-M-Roland_Garros-F-Robin_Soderling-Roger_Federer,2,S-II,1,0,0,0,0,0,1,,,,,,,,,,
20090705-M-Wimbledon-F-Andy_Roddick-Roger_Federer,1,F-XC,75,23,7,8,8,35,40,,,,,,,,,,
20090705-M-Wimbledon-F-Andy_Roddick-Roger_Federer,1,F-DTM,30,6,3,0,3,13,17,,,,,,,,,,
20090705-M-Wimbledon-F-Andy_Roddick-Roger_Federer,1,F-DTL,25,4,1,2,1,9,16,,,,,,,,,,
20090705-M-Wimbledon-F-Andy_Roddick-Roger_Federer,1,F-IO,59,15,8,3,4,36,23,,,,,,,,,,
20090705-M-Wimbledon-F-Andy_Roddick-Roger_Federer,1,F-II,4,0,0,0,0,2,2,,,,,,,,,,
20090705-M-Wimbledon-F-Andy_Roddick-Roger_Federer,1,B-XC,78,12,1,3,8,36,42,,,,,,,,,,
20090705-M-Wimbledon-F-Andy_Roddick-Roger_Federer,1,B-DTM,44,4,0,0,4,12,32,,,,,,,,,,
20090705-M-Wimbledon-F-Andy_Roddick-Roger_Federer,1,B-DTL,27,14,5,4,5,15,12,,,,,,,,,,
20090705-M-Wimbledon-F-Andy_Roddick-Roger_Federer,1,B-IO,9,3,1,0,2,3,6,,,,,,,,,,
20090705-M-Wimbledon-F-Andy_Roddick-Roger_Federer,1,S-XC,12,2,0,1,1,9,3,,,,,,,,,,
20090705-M-Wimbledon-F-Andy_Roddick-Roger_Federer,1,S-DTM,7,2,0,1,1,3,4,,,,,,,,,,
20090705-M-Wimbledon-F-Andy_Roddick-Roger_Federer,1,S-DTL,7,2,0,0,2,2,5,,,,,,,,,,
20090705-M-Wimbledon-F-Andy_Roddick-Roger_Federer,1,S-IO,3,2,0,0,2,0,3,,,,,,,,,,
20090705-M-Wimbledon-F-Andy_Roddick-Roger_Federer,2,F-XC,77,29,15,5,9,53,24,,,,,,,,,,
20090705-M-Wimbledon-F-Andy_Roddick-Roger_Federer,2,F-DTM,49,9,0,3,6,31,18,,,,,,,,,,
20090705-M-Wimbledon-F-Andy_Roddick-Roger_Federer,2,F-DTL,32,13,6,2,5,21,11,,,,,,,,,,
20090705-M-Wimbledon-F-Andy_Roddick-Roger_Federer,2,F-IO,46,21,13,5,3,28,18,,,,,,,,,,
20090705-M-Wimbledon-F-Andy_Roddick-Roger_Federer,2,F-II,7,2,0,1,1,2,5,,,,,,,,,,
20090705-M-Wimbledon-F-Andy_Roddick-Roger_Federer,2,B-XC,41,12,3,5,4,23,18,,,,,,,,,,
20090705-M-Wimbledon-F-Andy_Roddick-Roger_Federer,2,B-DTM,31,3,0,1,2,17,14,,,,,,,,,,
20090705-M-Wimbledon-F-Andy_Roddick-Roger_Federer,2,B-DTL,19,8,2,1,5,7,12,,,,,,,,,,
20090705-M-Wimbledon-F-Andy_Roddick-Roger_Federer,2,S-XC,47,8,1,2,5,24,23,,,,,,,,,,
20090705-M-Wimbledon-F-Andy_Roddick-Roger_Federer,2,S-DTM,16,2,0,0,2,9,7,,,,,,,,,,
20090705-M-Wimbledon-F-Andy_Roddick-Roger_Federer,2,S-DTL,6,1,0,1,0,3,3,,,,,,,,,,
20091110-M-Paris_Masters-R32-Marat_Safin-Juan_Martin_Del_Potro,1,F-XC,25,10,2,1,7,12,13,,,,,,,,,,
20091110-M-Paris_Masters-R32-Marat_Safin-Juan_Martin_Del_Potro,1,F-DTM,37,13,0,1,12,10,27,,,,,,,,,,
20091110-M-Paris_Masters-R32-Marat_Safin-Juan_Martin_Del_Potro,1,F-DTL,8,6,2,2,2,6,2,,,,,,,,,,
20091110-M-Paris_Masters-R32-Marat_Safin-Juan_Martin_Del_Potro,1,F-IO,11,7,2,1,4,5,6,,,,,,,,,,
20091110-M-Paris_Masters-R32-Marat_Safin-Juan_Martin_Del_Potro,1,B-XC,34,6,2,2,2,17,17,,,,,,,,,,
20091110-M-Paris_Masters-R32-Marat_Safin-Juan_Martin_Del_Potro,1,B-DTM,28,4,0,0,4,9,19,,,,,,,,,,
20091110-M-Paris_Masters-R32-Marat_Safin-Juan_Martin_Del_Potro,1,B-DTL,10,5,3,1,1,7,3,,,,,,,,,,
20091110-M-Paris_Masters-R32-Marat_Safin-Juan_Martin_Del_Potro,1,B-IO,5,0,0,0,0,4,1,,,,,,,,,,
20091110-M-Paris_Masters-R32-Marat_Safin-Juan_Martin_Del_Potro,1,S-DTM,1,0,0,0,0,1,0,,,,,,,,,,
20091110-M-Paris_Masters-R32-Marat_Safin-Juan_Martin_Del_Potro,1,S-DTL,1,0,0,0,0,0,1,,,,,,,,,,
20091110-M-Paris_Masters-R32-Marat_Safin-Juan_Martin_Del_Potro,1,S-IO,1,1,0,0,1,0,1,,,,,,,,,,
20091110-M-Paris_Masters-R32-Marat_Safin-Juan_Martin_Del_Potro,2,F-XC,32,14,6,3,5,14,18,,,,,,,,,,
20091110-M-Paris_Masters-R32-Marat_Safin-Juan_Martin_Del_Potro,2,F-DTM,38,2,0,0,2,22,16,,,,,,,,,,
20091110-M-Paris_Masters-R32-Marat_Safin-Juan_Martin_Del_Potro,2,F-DTL,3,0,0,0,0,1,2,,,,,,,,,,
20091110-M-Paris_Masters-R32-Marat_Safin-Juan_Martin_Del_Potro,2,F-IO,19,6,2,2,2,14,5,,,,,,,,,,
20091110-M-Paris_Masters-R32-Marat_Safin-Juan_Martin_Del_Potro,2,B-XC,25,1,0,0,1,13,12,,,,,,,,,,
20091110-M-Paris_Masters-R32-Marat_Safin-Juan_Martin_Del_Potro,2,B-DTM,21,2,0,1,1,14,7,,,,,,,,,,
20091110-M-Paris_Masters-R32-Marat_Safin-Juan_Martin_Del_Potro,2,B-DTL,5,2,0,2,0,4,1,,,,,,,,,,
20091110-M-Paris_Masters-R32-Marat_Safin-Juan_Martin_Del_Potro,2,B-IO,2,0,0,0,0,1,1,,,,,,,,,,
20091110-M-Paris_Masters-R32-Marat_Safin-Juan_Martin_Del_Potro,2,S-XC,3,0,0,0,0,0,3,,,,,,,,,,
20091110-M-Paris_Masters-R32-Marat_Safin-Juan_Martin_Del_Potro,2,S-DTL,1,1,0,1,0,1,0,,,,,,,,,,
20091122-M-London-RR-Robin_Soderling-Novak_Djokovic,1,F-XC,46,7,3,1,3,28,18,,,,,,,,,,
20091122-M-London-RR-Robin_Soderling-Novak_Djokovic,1,F-DTM,9,0,0,0,0,4,5,,,,,,,,,,
20091122-M-London-RR-Robin_Soderling-Novak_Djokovic,1,F-DTL,27,8,2,1,5,15,12,,,,,,,,,,
20091122-M-London-RR-Robin_Soderling-Novak_Djokovic,1,F-IO,26,5,2,0,3,13,13,,,,,,,,,,
20091122-M-London-RR-Robin_Soderling-Novak_Djokovic,1,F-II,8,0,0,0,0,4,4,,,,,,,,,,
20091122-M-London-RR-Robin_Soderling-Novak_Djokovic,1,B-XC,47,5,0,1,4,22,25,,,,,,,,,,
20091122-M-London-RR-Robin_Soderling-Novak_Djokovic,1,B-DTM,9,0,0,0,0,4,5,,,,,,,,,,
20091122-M-London-RR-Robin_Soderling-Novak_Djokovic,1,B-DTL,14,5,2,0,3,9,5,,,,,,,,,,
20091122-M-London-RR-Robin_Soderling-Novak_Djokovic,1,B-IO,2,1,0,1,0,2,0,,,,,,,,,,
20091122-M-London-RR-Robin_Soderling-Novak_Djokovic,1,S-XC,3,1,0,0,1,1,2,,,,,,,,,,
20091122-M-London-RR-Robin_Soderling-Novak_Djokovic,2,F-XC,43,9,0,1,8,14,29,,,,,,,,,,
20091122-M-London-RR-Robin_Soderling-Novak_Djokovic,2,F-DTM,10,1,0,0,1,2,8,,,,,,,,,,
20091122-M-London-RR-Robin_Soderling-Novak_Djokovic,2,F-DTL,10,1,0,0,1,2,8,,,,,,,,,,
20091122-M-London-RR-Robin_Soderling-Novak_Djokovic,2,F-IO,16,5,2,0,3,8,8,,,,,,,,,,
20091122-M-London-RR-Robin_Soderling-Novak_Djokovic,2,F-II,1,0,0,0,0,0,1,,,,,,,,,,
20091122-M-London-RR-Robin_Soderling-Novak_Djokovic,2,B-XC,37,7,1,1,5,18,19,,,,,,,,,,
20091122-M-London-RR-Robin_Soderling-Novak_Djokovic,2,B-DTM,19,1,0,0,1,7,12,,,,,,,,,,
20091122-M-London-RR-Robin_Soderling-Novak_Djokovic,2,B-DTL,8,3,3,0,0,7,1,,,,,,,,,,
20091122-M-London-RR-Robin_Soderling-Novak_Djokovic,2,B-IO,5,1,0,0,1,3,2,,,,,,,,,,
20091122-M-London-RR-Robin_Soderling-Novak_Djokovic,2,S-XC,21,2,0,0,2,13,8,,,,,,,,,,
20091122-M-London-RR-Robin_Soderling-Novak_Djokovic,2,S-DTM,6,0,0,0,0,4,2,,,,,,,,,,
20091122-M-London-RR-Robin_Soderling-Novak_Djokovic,2,S-DTL,1,0,0,0,0,1,0,,,,,,,,,,
20091123-M-Tour_Finals-RR-Robin_Soderling-Rafael_Nadal,1,F-XC,68,7,3,2,2,40,28,,,,,,,,,,
20091123-M-Tour_Finals-RR-Robin_Soderling-Rafael_Nadal,1,F-DTM,12,0,0,0,0,5,7,,,,,,,,,,
20091123-M-Tour_Finals-RR-Robin_Soderling-Rafael_Nadal,1,F-DTL,12,7,1,3,3,6,6,,,,,,,,,,
20091123-M-Tour_Finals-RR-Robin_Soderling-Rafael_Nadal,1,F-IO,25,10,5,2,3,15,10,,,,,,,,,,
20091123-M-Tour_Finals-RR-Robin_Soderling-Rafael_Nadal,1,F-II,7,2,0,1,1,2,5,,,,,,,,,,
20091123-M-Tour_Finals-RR-Robin_Soderling-Rafael_Nadal,1,B-XC,51,14,1,4,9,17,34,,,,,,,,,,
20091123-M-Tour_Finals-RR-Robin_Soderling-Rafael_Nadal,1,B-DTM,15,0,0,0,0,7,8,,,,,,,,,,
20091123-M-Tour_Finals-RR-Robin_Soderling-Rafael_Nadal,1,B-DTL,21,6,3,1,2,9,12,,,,,,,,,,
20091123-M-Tour_Finals-RR-Robin_Soderling-Rafael_Nadal,1,B-IO,4,2,0,1,1,2,2,,,,,,,,,,
20091123-M-Tour_Finals-RR-Robin_Soderling-Rafael_Nadal,1,S-IO,1,0,0,0,0,1,0,,,,,,,,,,
20091123-M-Tour_Finals-RR-Robin_Soderling-Rafael_Nadal,2,F-XC,59,6,3,2,1,32,27,,,,,,,,,,
20091123-M-Tour_Finals-RR-Robin_Soderling-Rafael_Nadal,2,F-DTM,17,2,0,0,2,12,5,,,,,,,,,,
20091123-M-Tour_Finals-RR-Robin_Soderling-Rafael_Nadal,2,F-DTL,14,5,4,1,0,9,5,,,,,,,,,,
20091123-M-Tour_Finals-RR-Robin_Soderling-Rafael_Nadal,2,F-IO,14,5,2,0,3,7,7,,,,,,,,,,
20091123-M-Tour_Finals-RR-Robin_Soderling-Rafael_Nadal,2,F-II,5,2,0,2,0,3,2,,,,,,,,,,
20091123-M-Tour_Finals-RR-Robin_Soderling-Rafael_Nadal,2,B-XC,41,11,2,4,5,20,21,,,,,,,,,,
20091123-M-Tour_Finals-RR-Robin_Soderling-Rafael_Nadal,2,B-DTM,15,0,0,0,0,6,9,,,,,,,,,,
20091123-M-Tour_Finals-RR-Robin_Soderling-Rafael_Nadal,2,B-DTL,6,1,0,0,1,3,3,,,,,,,,,,
20091123-M-Tour_Finals-RR-Robin_Soderling-Rafael_Nadal,2,B-IO,4,1,0,0,1,3,1,,,,,,,,,,
20091123-M-Tour_Finals-RR-Robin_Soderling-Rafael_Nadal,2,S-XC,5,0,0,0,0,1,4,,,,,,,,,,
20091123-M-Tour_Finals-RR-Robin_Soderling-Rafael_Nadal,2,S-DTM,12,0,0,0,0,5,7,,,,,,,,,,
20091123-M-Tour_Finals-RR-Robin_Soderling-Rafael_Nadal,2,S-DTL,20,1,0,0,1,12,8,,,,,,,,,,
20091123-M-Tour_Finals-RR-Robin_Soderling-Rafael_Nadal,2,S-IO,3,0,0,0,0,2,1,,,,,,,,,,
20091127-M-Tour_Finals-SF-Robin_Soderling-Juan_Martin_Del_Potro,1,F-XC,47,11,3,3,5,22,25,,,,,,,,,,
20091127-M-Tour_Finals-SF-Robin_Soderling-Juan_Martin_Del_Potro,1,F-DTM,17,1,0,0,1,8,9,,,,,,,,,,
20091127-M-Tour_Finals-SF-Robin_Soderling-Juan_Martin_Del_Potro,1,F-DTL,14,5,2,0,3,5,9,,,,,,,,,,
20091127-M-Tour_Finals-SF-Robin_Soderling-Juan_Martin_Del_Potro,1,F-IO,50,18,4,3,11,22,28,,,,,,,,,,
20091127-M-Tour_Finals-SF-Robin_Soderling-Juan_Martin_Del_Potro,1,F-II,4,2,0,2,0,3,1,,,,,,,,,,
20091127-M-Tour_Finals-SF-Robin_Soderling-Juan_Martin_Del_Potro,1,B-XC,30,6,0,0,6,7,23,,,,,,,,,,
20091127-M-Tour_Finals-SF-Robin_Soderling-Juan_Martin_Del_Potro,1,B-DTM,26,2,0,0,2,8,18,,,,,,,,,,
20091127-M-Tour_Finals-SF-Robin_Soderling-Juan_Martin_Del_Potro,1,B-DTL,12,5,1,0,4,1,11,,,,,,,,,,
20091127-M-Tour_Finals-SF-Robin_Soderling-Juan_Martin_Del_Potro,1,B-IO,6,3,0,2,1,3,3,,,,,,,,,,
20091127-M-Tour_Finals-SF-Robin_Soderling-Juan_Martin_Del_Potro,1,S-XC,1,1,0,0,1,0,1,,,,,,,,,,
20091127-M-Tour_Finals-SF-Robin_Soderling-Juan_Martin_Del_Potro,2,F-XC,42,21,6,2,13,25,17,,,,,,,,,,
20091127-M-Tour_Finals-SF-Robin_Soderling-Juan_Martin_Del_Potro,2,F-DTM,35,1,0,0,1,23,12,,,,,,,,,,
20091127-M-Tour_Finals-SF-Robin_Soderling-Juan_Martin_Del_Potro,2,F-DTL,13,1,0,0,1,10,3,,,,,,,,,,
20091127-M-Tour_Finals-SF-Robin_Soderling-Juan_Martin_Del_Potro,2,F-IO,18,5,0,1,4,10,8,,,,,,,,,,
20091127-M-Tour_Finals-SF-Robin_Soderling-Juan_Martin_Del_Potro,2,F-II,1,1,0,0,1,0,1,,,,,,,,,,
20091127-M-Tour_Finals-SF-Robin_Soderling-Juan_Martin_Del_Potro,2,B-XC,35,7,1,3,3,25,10,,,,,,,,,,
20091127-M-Tour_Finals-SF-Robin_Soderling-Juan_Martin_Del_Potro,2,B-DTM,31,0,0,0,0,20,11,,,,,,,,,,
20091127-M-Tour_Finals-SF-Robin_Soderling-Juan_Martin_Del_Potro,2,B-DTL,12,9,6,1,2,9,3,,,,,,,,,,
20091127-M-Tour_Finals-SF-Robin_Soderling-Juan_Martin_Del_Potro,2,B-IO,5,2,0,0,2,1,4,,,,,,,,,,
20091127-M-Tour_Finals-SF-Robin_Soderling-Juan_Martin_Del_Potro,2,S-XC,3,0,0,0,0,2,1,,,,,,,,,,
20091127-M-Tour_Finals-SF-Robin_Soderling-Juan_Martin_Del_Potro,2,S-DTM,4,0,0,0,0,0,4,,,,,,,,,,
20100126-M-Australian_Open-QF-Andy_Murray-Rafael_Nadal,1,F-XC,124,14,3,5,6,55,69,,,,,,,,,,
20100126-M-Australian_Open-QF-Andy_Murray-Rafael_Nadal,1,F-DTM,9,2,0,0,2,3,6,,,,,,,,,,
20100126-M-Australian_Open-QF-Andy_Murray-Rafael_Nadal,1,F-DTL,21,8,4,1,3,10,11,,,,,,,,,,
20100126-M-Australian_Open-QF-Andy_Murray-Rafael_Nadal,1,F-IO,9,0,0,0,0,3,6,,,,,,,,,,
20100126-M-Australian_Open-QF-Andy_Murray-Rafael_Nadal,1,F-II,1,1,1,0,0,1,0,,,,,,,,,,
20100126-M-Australian_Open-QF-Andy_Murray-Rafael_Nadal,1,B-XC,63,13,3,3,7,26,37,,,,,,,,,,
20100126-M-Australian_Open-QF-Andy_Murray-Rafael_Nadal,1,B-DTM,17,0,0,0,0,6,11,,,,,,,,,,
20100126-M-Australian_Open-QF-Andy_Murray-Rafael_Nadal,1,B-DTL,20,6,1,2,3,11,9,,,,,,,,,,
20100126-M-Australian_Open-QF-Andy_Murray-Rafael_Nadal,1,B-IO,2,1,0,0,1,1,1,,,,,,,,,,
20100126-M-Australian_Open-QF-Andy_Murray-Rafael_Nadal,1,S-XC,9,0,0,0,0,6,3,,,,,,,,,,
20100126-M-Australian_Open-QF-Andy_Murray-Rafael_Nadal,1,S-DTM,7,1,0,0,1,4,3,,,,,,,,,,
20100126-M-Australian_Open-QF-Andy_Murray-Rafael_Nadal,1,S-DTL,9,0,0,0,0,5,4,,,,,,,,,,
20100126-M-Australian_Open-QF-Andy_Murray-Rafael_Nadal,1,S-IO,1,0,0,0,0,1,0,,,,,,,,,,
20100126-M-Australian_Open-QF-Andy_Murray-Rafael_Nadal,2,F-XC,69,7,3,0,4,34,35,,,,,,,,,,
20100126-M-Australian_Open-QF-Andy_Murray-Rafael_Nadal,2,F-DTM,17,0,0,0,0,13,4,,,,,,,,,,
20100126-M-Australian_Open-QF-Andy_Murray-Rafael_Nadal,2,F-DTL,38,5,2,2,1,23,15,,,,,,,,,,
20100126-M-Australian_Open-QF-Andy_Murray-Rafael_Nadal,2,F-IO,36,9,4,4,1,24,12,,,,,,,,,,
20100126-M-Australian_Open-QF-Andy_Murray-Rafael_Nadal,2,F-II,12,2,0,0,2,7,5,,,,,,,,,,
20100126-M-Australian_Open-QF-Andy_Murray-Rafael_Nadal,2,B-XC,49,12,1,0,11,21,28,,,,,,,,,,
20100126-M-Australian_Open-QF-Andy_Murray-Rafael_Nadal,2,B-DTM,12,2,0,1,1,6,6,,,,,,,,,,
20100126-M-Australian_Open-QF-Andy_Murray-Rafael_Nadal,2,B-DTL,20,4,2,1,1,11,9,,,,,,,,,,
20100126-M-Australian_Open-QF-Andy_Murray-Rafael_Nadal,2,S-XC,21,1,0,1,0,12,9,,,,,,,,,,
20100126-M-Australian_Open-QF-Andy_Murray-Rafael_Nadal,2,S-DTM,7,1,0,0,1,0,7,,,,,,,,,,
20100126-M-Australian_Open-QF-Andy_Murray-Rafael_Nadal,2,S-DTL,15,0,0,0,0,10,5,,,,,,,,,,
20100126-M-Australian_Open-QF-Andy_Murray-Rafael_Nadal,2,S-IO,2,1,0,0,1,0,2,,,,,,,,,,
20100131-M-Australian_Open-F-Roger_Federer-Andy_Murray,1,F-XC,61,22,7,5,10,35,26,,,,,,,,,,
20100131-M-Australian_Open-F-Roger_Federer-Andy_Murray,1,F-DTM,45,3,0,0,3,22,23,,,,,,,,,,
20100131-M-Australian_Open-F-Roger_Federer-Andy_Murray,1,F-DTL,11,2,0,1,1,6,5,,,,,,,,,,
20100131-M-Australian_Open-F-Roger_Federer-Andy_Murray,1,F-IO,51,15,9,2,4,34,17,,,,,,,,,,
20100131-M-Australian_Open-F-Roger_Federer-Andy_Murray,1,F-II,4,1,1,0,0,2,2,,,,,,,,,,
20100131-M-Australian_Open-F-Roger_Federer-Andy_Murray,1,B-XC,63,9,3,3,3,37,26,,,,,,,,,,
20100131-M-Australian_Open-F-Roger_Federer-Andy_Murray,1,B-DTM,97,12,0,0,12,47,50,,,,,,,,,,
20100131-M-Australian_Open-F-Roger_Federer-Andy_Murray,1,B-DTL,8,3,1,0,2,4,4,,,,,,,,,,
20100131-M-Australian_Open-F-Roger_Federer-Andy_Murray,1,B-IO,4,0,0,0,0,2,2,,,,,,,,,,
20100131-M-Australian_Open-F-Roger_Federer-Andy_Murray,1,B-II,1,0,0,0,0,1,0,,,,,,,,,,
20100131-M-Australian_Open-F-Roger_Federer-Andy_Murray,1,S-XC,29,2,0,0,2,12,17,,,,,,,,,,
20100131-M-Australian_Open-F-Roger_Federer-Andy_Murray,1,S-DTM,40,3,1,0,2,18,22,,,,,,,,,,
20100131-M-Australian_Open-F-Roger_Federer-Andy_Murray,1,S-DTL,2,0,0,0,0,0,2,,,,,,,,,,
20100131-M-Australian_Open-F-Roger_Federer-Andy_Murray,1,S-IO,2,0,0,0,0,1,1,,,,,,,,,,
20100131-M-Australian_Open-F-Roger_Federer-Andy_Murray,2,F-XC,71,25,7,6,12,36,35,,,,,,,,,,
20100131-M-Australian_Open-F-Roger_Federer-Andy_Murray,2,F-DTM,60,2,0,0,2,31,29,,,,,,,,,,
20100131-M-Australian_Open-F-Roger_Federer-Andy_Murray,2,F-DTL,18,4,0,0,4,8,10,,,,,,,,,,
20100131-M-Australian_Open-F-Roger_Federer-Andy_Murray,2,F-IO,35,4,1,2,1,21,14,,,,,,,,,,
20100131-M-Australian_Open-F-Roger_Federer-Andy_Murray,2,F-II,3,1,0,0,1,0,3,,,,,,,,,,
20100131-M-Australian_Open-F-Roger_Federer-Andy_Murray,2,B-XC,94,7,1,1,5,48,46,,,,,,,,,,
20100131-M-Australian_Open-F-Roger_Federer-Andy_Murray,2,B-DTM,82,2,0,0,2,33,49,,,,,,,,,,
20100131-M-Australian_Open-F-Roger_Federer-Andy_Murray,2,B-DTL,15,9,5,1,3,10,5,,,,,,,,,,
20100131-M-Australian_Open-F-Roger_Federer-Andy_Murray,2,B-IO,4,2,0,1,1,2,2,,,,,,,,,,
20100131-M-Australian_Open-F-Roger_Federer-Andy_Murray,2,S-XC,14,3,0,1,2,7,7,,,,,,,,,,
20100131-M-Australian_Open-F-Roger_Federer-Andy_Murray,2,S-DTM,15,0,0,0,0,5,10,,,,,,,,,,
20100131-M-Australian_Open-F-Roger_Federer-Andy_Murray,2,S-DTL,2,0,0,0,0,1,1,,,,,,,,,,
20100131-M-Australian_Open-F-Roger_Federer-Andy_Murray,2,S-IO,1,0,0,0,0,0,1,,,,,,,,,,
20100415-M-Monte_Carlo_Masters-R16-Rafael_Nadal-Michael_Berrer,1,F-XC,34,7,4,2,1,26,8,,,,,,,,,,
20100415-M-Monte_Carlo_Masters-R16-Rafael_Nadal-Michael_Berrer,1,F-DTM,1,0,0,0,0,0,1,,,,,,,,,,
20100415-M-Monte_Carlo_Masters-R16-Rafael_Nadal-Michael_Berrer,1,F-DTL,18,12,10,1,1,17,1,,,,,,,,,,
20100415-M-Monte_Carlo_Masters-R16-Rafael_Nadal-Michael_Berrer,1,F-IO,31,5,3,0,2,24,7,,,,,,,,,,
20100415-M-Monte_Carlo_Masters-R16-Rafael_Nadal-Michael_Berrer,1,F-II,12,7,4,2,1,11,1,,,,,,,,,,
20100415-M-Monte_Carlo_Masters-R16-Rafael_Nadal-Michael_Berrer,1,B-XC,22,4,2,0,2,16,6,,,,,,,,,,
20100415-M-Monte_Carlo_Masters-R16-Rafael_Nadal-Michael_Berrer,1,B-DTM,5,0,0,0,0,3,2,,,,,,,,,,
20100415-M-Monte_Carlo_Masters-R16-Rafael_Nadal-Michael_Berrer,1,B-DTL,2,0,0,0,0,2,0,,,,,,,,,,
20100415-M-Monte_Carlo_Masters-R16-Rafael_Nadal-Michael_Berrer,1,B-IO,1,0,0,0,0,1,0,,,,,,,,,,
20100415-M-Monte_Carlo_Masters-R16-Rafael_Nadal-Michael_Berrer,1,S-XC,1,0,0,0,0,1,0,,,,,,,,,,
20100415-M-Monte_Carlo_Masters-R16-Rafael_Nadal-Michael_Berrer,1,S-DTM,1,1,0,1,0,1,0,,,,,,,,,,
20100415-M-Monte_Carlo_Masters-R16-Rafael_Nadal-Michael_Berrer,2,F-XC,21,4,1,1,2,4,17,,,,,,,,,,
20100415-M-Monte_Carlo_Masters-R16-Rafael_Nadal-Michael_Berrer,2,F-DTM,10,1,0,0,1,0,10,,,,,,,,,,
20100415-M-Monte_Carlo_Masters-R16-Rafael_Nadal-Michael_Berrer,2,F-DTL,9,1,0,0,1,3,6,,,,,,,,,,
20100415-M-Monte_Carlo_Masters-R16-Rafael_Nadal-Michael_Berrer,2,F-IO,10,1,1,0,0,2,8,,,,,,,,,,
20100415-M-Monte_Carlo_Masters-R16-Rafael_Nadal-Michael_Berrer,2,F-II,1,0,0,0,0,1,0,,,,,,,,,,
20100415-M-Monte_Carlo_Masters-R16-Rafael_Nadal-Michael_Berrer,2,B-XC,21,3,0,0,3,2,19,,,,,,,,,,
20100415-M-Monte_Carlo_Masters-R16-Rafael_Nadal-Michael_Berrer,2,B-DTM,13,1,0,0,1,4,9,,,,,,,,,,
20100415-M-Monte_Carlo_Masters-R16-Rafael_Nadal-Michael_Berrer,2,B-DTL,4,0,0,0,0,0,4,,,,,,,,,,
20100415-M-Monte_Carlo_Masters-R16-Rafael_Nadal-Michael_Berrer,2,S-XC,12,2,0,0,2,4,8,,,,,,,,,,
20100415-M-Monte_Carlo_Masters-R16-Rafael_Nadal-Michael_Berrer,2,S-DTM,5,1,0,0,1,2,3,,,,,,,,,,
20100415-M-Monte_Carlo_Masters-R16-Rafael_Nadal-Michael_Berrer,2,S-DTL,4,0,0,0,0,0,4,,,,,,,,,,
20100418-M-Monte_Carlo_Masters-F-Fernando_Verdasco-Rafael_Nadal,1,F-XC,56,12,4,3,5,20,36,,,,,,,,,,
20100418-M-Monte_Carlo_Masters-F-Fernando_Verdasco-Rafael_Nadal,1,F-DTM,2,0,0,0,0,0,2,,,,,,,,,,
20100418-M-Monte_Carlo_Masters-F-Fernando_Verdasco-Rafael_Nadal,1,F-DTL,33,9,1,0,8,13,20,,,,,,,,,,
20100418-M-Monte_Carlo_Masters-F-Fernando_Verdasco-Rafael_Nadal,1,F-IO,11,2,0,1,1,4,7,,,,,,,,,,
20100418-M-Monte_Carlo_Masters-F-Fernando_Verdasco-Rafael_Nadal,1,F-II,4,2,1,0,1,3,1,,,,,,,,,,
20100418-M-Monte_Carlo_Masters-F-Fernando_Verdasco-Rafael_Nadal,1,B-XC,51,8,3,0,5,18,33,,,,,,,,,,
20100418-M-Monte_Carlo_Masters-F-Fernando_Verdasco-Rafael_Nadal,1,B-DTM,5,1,0,1,0,2,3,,,,,,,,,,
20100418-M-Monte_Carlo_Masters-F-Fernando_Verdasco-Rafael_Nadal,1,B-DTL,33,8,1,0,7,6,27,,,,,,,,,,
20100418-M-Monte_Carlo_Masters-F-Fernando_Verdasco-Rafael_Nadal,1,B-IO,7,0,0,0,0,2,5,,,,,,,,,,
20100418-M-Monte_Carlo_Masters-F-Fernando_Verdasco-Rafael_Nadal,1,B-II,5,0,0,0,0,0,5,,,,,,,,,,
20100418-M-Monte_Carlo_Masters-F-Fernando_Verdasco-Rafael_Nadal,1,S-DTL,2,0,0,0,0,0,2,,,,,,,,,,
20100418-M-Monte_Carlo_Masters-F-Fernando_Verdasco-Rafael_Nadal,2,F-XC,51,7,3,3,1,32,19,,,,,,,,,,
20100418-M-Monte_Carlo_Masters-F-Fernando_Verdasco-Rafael_Nadal,2,F-DTM,4,1,0,0,1,3,1,,,,,,,,,,
20100418-M-Monte_Carlo_Masters-F-Fernando_Verdasco-Rafael_Nadal,2,F-DTL,46,4,2,2,0,35,11,,,,,,,,,,
20100418-M-Monte_Carlo_Masters-F-Fernando_Verdasco-Rafael_Nadal,2,F-IO,11,0,0,0,0,10,1,,,,,,,,,,
20100418-M-Monte_Carlo_Masters-F-Fernando_Verdasco-Rafael_Nadal,2,F-II,12,5,3,0,2,9,3,,,,,,,,,,
20100418-M-Monte_Carlo_Masters-F-Fernando_Verdasco-Rafael_Nadal,2,B-XC,36,5,1,1,3,22,14,,,,,,,,,,
20100418-M-Monte_Carlo_Masters-F-Fernando_Verdasco-Rafael_Nadal,2,B-DTM,3,0,0,0,0,2,1,,,,,,,,,,
20100418-M-Monte_Carlo_Masters-F-Fernando_Verdasco-Rafael_Nadal,2,B-DTL,29,6,2,1,3,16,13,,,,,,,,,,
20100418-M-Monte_Carlo_Masters-F-Fernando_Verdasco-Rafael_Nadal,2,B-IO,7,1,1,0,0,6,1,,,,,,,,,,
20100418-M-Monte_Carlo_Masters-F-Fernando_Verdasco-Rafael_Nadal,2,B-II,2,0,0,0,0,1,1,,,,,,,,,,
20100418-M-Monte_Carlo_Masters-F-Fernando_Verdasco-Rafael_Nadal,2,S-XC,1,0,0,0,0,0,1,,,,,,,,,,
20100418-M-Monte_Carlo_Masters-F-Fernando_Verdasco-Rafael_Nadal,2,S-DTL,3,0,0,0,0,1,2,,,,,,,,,,
20100512-M-Madrid_Masters-R16-John_Isner-Rafael_Nadal,1,F-XC,26,7,1,2,4,11,15,,,,,,,,,,
20100512-M-Madrid_Masters-R16-John_Isner-Rafael_Nadal,1,F-DTM,6,1,0,0,1,1,5,,,,,,,,,,
20100512-M-Madrid_Masters-R16-John_Isner-Rafael_Nadal,1,F-DTL,7,5,1,0,4,2,5,,,,,,,,,,
20100512-M-Madrid_Masters-R16-John_Isner-Rafael_Nadal,1,F-IO,12,7,1,1,5,4,8,,,,,,,,,,
20100512-M-Madrid_Masters-R16-John_Isner-Rafael_Nadal,1,F-II,7,1,0,1,0,3,4,,,,,,,,,,
20100512-M-Madrid_Masters-R16-John_Isner-Rafael_Nadal,1,B-XC,6,4,0,2,2,3,3,,,,,,,,,,
20100512-M-Madrid_Masters-R16-John_Isner-Rafael_Nadal,1,B-DTM,11,0,0,0,0,6,5,,,,,,,,,,
20100512-M-Madrid_Masters-R16-John_Isner-Rafael_Nadal,1,B-DTL,11,4,0,1,3,3,8,,,,,,,,,,
20100512-M-Madrid_Masters-R16-John_Isner-Rafael_Nadal,1,S-XC,1,0,0,0,0,1,0,,,,,,,,,,
20100512-M-Madrid_Masters-R16-John_Isner-Rafael_Nadal,1,S-DTM,2,0,0,0,0,1,1,,,,,,,,,,
20100512-M-Madrid_Masters-R16-John_Isner-Rafael_Nadal,1,S-DTL,1,1,0,0,1,0,1,,,,,,,,,,
20100512-M-Madrid_Masters-R16-John_Isner-Rafael_Nadal,2,F-XC,21,9,6,3,0,17,4,,,,,,,,,,
20100512-M-Madrid_Masters-R16-John_Isner-Rafael_Nadal,2,F-DTM,5,0,0,0,0,4,1,,,,,,,,,,
20100512-M-Madrid_Masters-R16-John_Isner-Rafael_Nadal,2,F-DTL,5,0,0,0,0,2,3,,,,,,,,,,
20100512-M-Madrid_Masters-R16-John_Isner-Rafael_Nadal,2,F-IO,32,12,5,3,4,20,12,,,,,,,,,,
20100512-M-Madrid_Masters-R16-John_Isner-Rafael_Nadal,2,F-II,3,3,3,0,0,3,0,,,,,,,,,,
20100512-M-Madrid_Masters-R16-John_Isner-Rafael_Nadal,2,B-XC,2,0,0,0,0,1,1,,,,,,,,,,
20100512-M-Madrid_Masters-R16-John_Isner-Rafael_Nadal,2,B-DTM,5,1,0,0,1,2,3,,,,,,,,,,
20100512-M-Madrid_Masters-R16-John_Isner-Rafael_Nadal,2,B-IO,15,3,1,0,2,11,4,,,,,,,,,,
20100512-M-Madrid_Masters-R16-John_Isner-Rafael_Nadal,2,B-II,9,3,1,0,2,4,5,,,,,,,,,,
20100512-M-Madrid_Masters-R16-John_Isner-Rafael_Nadal,2,S-DTM,1,0,0,0,0,1,0,,,,,,,,,,
20100512-M-Madrid_Masters-R16-John_Isner-Rafael_Nadal,2,S-IO,2,0,0,0,0,1,1,,,,,,,,,,
20100512-M-Madrid_Masters-R16-John_Isner-Rafael_Nadal,2,S-II,1,0,0,0,0,1,0,,,,,,,,,,
20100606-M-Roland_Garros-F-Robin_Soderling-Rafael_Nadal,1,F-XC,66,17,3,6,8,28,38,,,,,,,,,,
20100606-M-Roland_Garros-F-Robin_Soderling-Rafael_Nadal,1,F-DTM,35,2,0,0,2,12,23,,,,,,,,,,
20100606-M-Roland_Garros-F-Robin_Soderling-Rafael_Nadal,1,F-DTL,19,7,0,1,6,8,11,,,,,,,,,,
20100606-M-Roland_Garros-F-Robin_Soderling-Rafael_Nadal,1,F-IO,42,20,7,4,9,22,20,,,,,,,,,,
20100606-M-Roland_Garros-F-Robin_Soderling-Rafael_Nadal,1,F-II,11,6,4,0,2,7,4,,,,,,,,,,
20100606-M-Roland_Garros-F-Robin_Soderling-Rafael_Nadal,1,B-XC,40,9,2,4,3,17,23,,,,,,,,,,
20100606-M-Roland_Garros-F-Robin_Soderling-Rafael_Nadal,1,B-DTM,12,1,0,0,1,2,10,,,,,,,,,,
20100606-M-Roland_Garros-F-Robin_Soderling-Rafael_Nadal,1,B-DTL,44,13,3,1,9,15,29,,,,,,,,,,
20100606-M-Roland_Garros-F-Robin_Soderling-Rafael_Nadal,1,B-IO,6,1,0,0,1,3,3,,,,,,,,,,
20100606-M-Roland_Garros-F-Robin_Soderling-Rafael_Nadal,1,S-XC,1,0,0,0,0,0,1,,,,,,,,,,
20100606-M-Roland_Garros-F-Robin_Soderling-Rafael_Nadal,1,S-DTL,3,2,0,0,2,0,3,,,,,,,,,,
20100606-M-Roland_Garros-F-Robin_Soderling-Rafael_Nadal,2,F-XC,79,14,4,5,5,52,27,,,,,,,,,,
20100606-M-Roland_Garros-F-Robin_Soderling-Rafael_Nadal,2,F-DTM,18,0,0,0,0,13,5,,,,,,,,,,
20100606-M-Roland_Garros-F-Robin_Soderling-Rafael_Nadal,2,F-DTL,27,6,3,0,3,14,13,,,,,,,,,,
20100606-M-Roland_Garros-F-Robin_Soderling-Rafael_Nadal,2,F-IO,19,7,6,0,1,14,5,,,,,,,,,,
20100606-M-Roland_Garros-F-Robin_Soderling-Rafael_Nadal,2,F-II,5,2,0,0,2,3,2,,,,,,,,,,
20100606-M-Roland_Garros-F-Robin_Soderling-Rafael_Nadal,2,B-XC,45,7,4,1,2,31,14,,,,,,,,,,
20100606-M-Roland_Garros-F-Robin_Soderling-Rafael_Nadal,2,B-DTM,22,1,0,0,1,13,9,,,,,,,,,,
20100606-M-Roland_Garros-F-Robin_Soderling-Rafael_Nadal,2,B-DTL,13,1,0,0,1,10,3,,,,,,,,,,
20100606-M-Roland_Garros-F-Robin_Soderling-Rafael_Nadal,2,B-IO,6,0,0,0,0,4,2,,,,,,,,,,
20100606-M-Roland_Garros-F-Robin_Soderling-Rafael_Nadal,2,S-XC,4,0,0,0,0,3,1,,,,,,,,,,
20100606-M-Roland_Garros-F-Robin_Soderling-Rafael_Nadal,2,S-DTM,10,0,0,0,0,2,8,,,,,,,,,,
20100606-M-Roland_Garros-F-Robin_Soderling-Rafael_Nadal,2,S-DTL,5,0,0,0,0,2,3,,,,,,,,,,
20100606-M-Roland_Garros-F-Robin_Soderling-Rafael_Nadal,2,S-IO,1,0,0,0,0,1,0,,,,,,,,,,
20100704-M-Wimbledon-F-Tomas_Berdych-Rafael_Nadal,1,F-XC,38,11,4,2,5,17,21,,,,,,,,,,
20100704-M-Wimbledon-F-Tomas_Berdych-Rafael_Nadal,1,F-DTM,15,1,0,1,0,10,5,,,,,,,,,,
20100704-M-Wimbledon-F-Tomas_Berdych-Rafael_Nadal,1,F-DTL,8,5,1,1,3,4,4,,,,,,,,,,
20100704-M-Wimbledon-F-Tomas_Berdych-Rafael_Nadal,1,F-IO,29,14,3,4,7,14,15,,,,,,,,,,
20100704-M-Wimbledon-F-Tomas_Berdych-Rafael_Nadal,1,F-II,4,0,0,0,0,2,2,,,,,,,,,,
20100704-M-Wimbledon-F-Tomas_Berdych-Rafael_Nadal,1,B-XC,26,5,0,2,3,14,12,,,,,,,,,,
20100704-M-Wimbledon-F-Tomas_Berdych-Rafael_Nadal,1,B-DTM,24,0,0,0,0,14,10,,,,,,,,,,
20100704-M-Wimbledon-F-Tomas_Berdych-Rafael_Nadal,1,B-DTL,10,2,0,1,1,4,6,,,,,,,,,,
20100704-M-Wimbledon-F-Tomas_Berdych-Rafael_Nadal,1,B-IO,2,0,0,0,0,1,1,,,,,,,,,,
20100704-M-Wimbledon-F-Tomas_Berdych-Rafael_Nadal,1,S-XC,13,0,0,0,0,5,8,,,,,,,,,,
20100704-M-Wimbledon-F-Tomas_Berdych-Rafael_Nadal,1,S-DTM,6,0,0,0,0,2,4,,,,,,,,,,
20100704-M-Wimbledon-F-Tomas_Berdych-Rafael_Nadal,1,S-DTL,3,0,0,0,0,2,1,,,,,,,,,,
20100704-M-Wimbledon-F-Tomas_Berdych-Rafael_Nadal,1,S-IO,3,0,0,0,0,1,2,,,,,,,,,,
20100704-M-Wimbledon-F-Tomas_Berdych-Rafael_Nadal,2,F-XC,59,19,9,7,3,35,24,,,,,,,,,,
20100704-M-Wimbledon-F-Tomas_Berdych-Rafael_Nadal,2,F-DTM,24,2,0,0,2,9,15,,,,,,,,,,
20100704-M-Wimbledon-F-Tomas_Berdych-Rafael_Nadal,2,F-DTL,23,9,2,4,3,14,9,,,,,,,,,,
20100704-M-Wimbledon-F-Tomas_Berdych-Rafael_Nadal,2,F-IO,24,12,8,1,3,18,6,,,,,,,,,,
20100704-M-Wimbledon-F-Tomas_Berdych-Rafael_Nadal,2,F-II,8,1,0,0,1,5,3,,,,,,,,,,
20100704-M-Wimbledon-F-Tomas_Berdych-Rafael_Nadal,2,B-XC,12,5,1,1,3,5,7,,,,,,,,,,
20100704-M-Wimbledon-F-Tomas_Berdych-Rafael_Nadal,2,B-DTM,7,1,0,0,1,2,5,,,,,,,,,,
20100704-M-Wimbledon-F-Tomas_Berdych-Rafael_Nadal,2,B-DTL,6,2,1,0,1,2,4,,,,,,,,,,
20100704-M-Wimbledon-F-Tomas_Berdych-Rafael_Nadal,2,B-IO,3,3,0,1,2,1,2,,,,,,,,,,
20100704-M-Wimbledon-F-Tomas_Berdych-Rafael_Nadal,2,S-XC,7,0,0,0,0,5,2,,,,,,,,,,
20100704-M-Wimbledon-F-Tomas_Berdych-Rafael_Nadal,2,S-DTM,18,1,0,0,1,8,10,,,,,,,,,,
20100704-M-Wimbledon-F-Tomas_Berdych-Rafael_Nadal,2,S-DTL,12,1,0,0,1,7,5,,,,,,,,,,
20100704-M-Wimbledon-F-Tomas_Berdych-Rafael_Nadal,2,S-IO,1,0,0,0,0,0,1,,,,,,,,,,
20100912-M-US_Open-F-Novak_Djokovic-Rafael_Nadal,1,F-XC,127,19,3,6,10,49,78,,,,,,,,,,
20100912-M-US_Open-F-Novak_Djokovic-Rafael_Nadal,1,F-DTM,24,3,0,1,2,7,17,,,,,,,,,,
20100912-M-US_Open-F-Novak_Djokovic-Rafael_Nadal,1,F-DTL,21,6,2,2,2,13,8,,,,,,,,,,
20100912-M-US_Open-F-Novak_Djokovic-Rafael_Nadal,1,F-IO,78,29,12,6,11,38,40,,,,,,,,,,
20100912-M-US_Open-F-Novak_Djokovic-Rafael_Nadal,1,F-II,11,4,3,1,0,8,3,,,,,,,,,,
20100912-M-US_Open-F-Novak_Djokovic-Rafael_Nadal,1,B-XC,79,15,3,3,9,33,46,,,,,,,,,,
20100912-M-US_Open-F-Novak_Djokovic-Rafael_Nadal,1,B-DTM,61,4,0,0,4,30,31,,,,,,,,,,
20100912-M-US_Open-F-Novak_Djokovic-Rafael_Nadal,1,B-DTL,65,15,4,6,5,35,30,,,,,,,,,,
20100912-M-US_Open-F-Novak_Djokovic-Rafael_Nadal,1,B-IO,12,2,0,0,2,5,7,,,,,,,,,,
20100912-M-US_Open-F-Novak_Djokovic-Rafael_Nadal,1,S-XC,1,0,0,0,0,1,0,,,,,,,,,,
20100912-M-US_Open-F-Novak_Djokovic-Rafael_Nadal,1,S-DTM,3,0,0,0,0,1,2,,,,,,,,,,
20100912-M-US_Open-F-Novak_Djokovic-Rafael_Nadal,1,S-DTL,5,0,0,0,0,3,2,,,,,,,,,,
20100912-M-US_Open-F-Novak_Djokovic-Rafael_Nadal,2,F-XC,144,13,5,4,4,75,69,,,,,,,,,,
20100912-M-US_Open-F-Novak_Djokovic-Rafael_Nadal,2,F-DTM,36,0,0,0,0,27,9,,,,,,,,,,
20100912-M-US_Open-F-Novak_Djokovic-Rafael_Nadal,2,F-DTL,26,10,5,2,3,18,8,,,,,,,,,,
20100912-M-US_Open-F-Novak_Djokovic-Rafael_Nadal,2,F-IO,44,15,7,5,3,26,18,,,,,,,,,,
20100912-M-US_Open-F-Novak_Djokovic-Rafael_Nadal,2,F-II,23,2,1,0,1,14,9,,,,,,,,,,
20100912-M-US_Open-F-Novak_Djokovic-Rafael_Nadal,2,B-XC,62,16,5,2,9,35,27,,,,,,,,,,
20100912-M-US_Open-F-Novak_Djokovic-Rafael_Nadal,2,B-DTM,35,4,0,0,4,18,17,,,,,,,,,,
20100912-M-US_Open-F-Novak_Djokovic-Rafael_Nadal,2,B-DTL,36,10,3,2,5,18,18,,,,,,,,,,
20100912-M-US_Open-F-Novak_Djokovic-Rafael_Nadal,2,B-IO,3,0,0,0,0,3,0,,,,,,,,,,
20100912-M-US_Open-F-Novak_Djokovic-Rafael_Nadal,2,S-XC,9,0,0,0,0,7,2,,,,,,,,,,
20100912-M-US_Open-F-Novak_Djokovic-Rafael_Nadal,2,S-DTM,20,1,1,0,0,9,11,,,,,,,,,,
20100912-M-US_Open-F-Novak_Djokovic-Rafael_Nadal,2,S-DTL,22,3,1,0,2,13,9,,,,,,,,,,
20100912-M-US_Open-F-Novak_Djokovic-Rafael_Nadal,2,S-IO,3,0,0,0,0,1,2,,,,,,,,,,
20101010-M-Shanghai_Masters-QF-Robin_Soderling-Roger_Federer,1,F-XC,19,5,1,1,3,7,12,,,,,,,,,,
20101010-M-Shanghai_Masters-QF-Robin_Soderling-Roger_Federer,1,F-DTM,4,0,0,0,0,0,4,,,,,,,,,,
20101010-M-Shanghai_Masters-QF-Robin_Soderling-Roger_Federer,1,F-DTL,9,3,0,0,3,1,8,,,,,,,,,,
20101010-M-Shanghai_Masters-QF-Robin_Soderling-Roger_Federer,1,F-IO,24,6,1,1,4,8,16,,,,,,,,,,
20101010-M-Shanghai_Masters-QF-Robin_Soderling-Roger_Federer,1,B-XC,24,4,0,0,4,8,16,,,,,,,,,,
20101010-M-Shanghai_Masters-QF-Robin_Soderling-Roger_Federer,1,B-DTM,3,0,0,0,0,1,2,,,,,,,,,,
20101010-M-Shanghai_Masters-QF-Robin_Soderling-Roger_Federer,1,B-DTL,7,4,0,0,4,0,7,,,,,,,,,,
20101010-M-Shanghai_Masters-QF-Robin_Soderling-Roger_Federer,1,B-IO,2,0,0,0,0,0,2,,,,,,,,,,
20101010-M-Shanghai_Masters-QF-Robin_Soderling-Roger_Federer,1,S-XC,2,1,0,0,1,1,1,,,,,,,,,,
20101010-M-Shanghai_Masters-QF-Robin_Soderling-Roger_Federer,1,S-DTM,1,0,0,0,0,0,1,,,,,,,,,,
20101010-M-Shanghai_Masters-QF-Robin_Soderling-Roger_Federer,1,S-DTL,1,1,0,0,1,0,1,,,,,,,,,,
20101010-M-Shanghai_Masters-QF-Robin_Soderling-Roger_Federer,2,F-XC,19,4,2,0,2,13,6,,,,,,,,,,
20101010-M-Shanghai_Masters-QF-Robin_Soderling-Roger_Federer,2,F-DTM,2,1,0,1,0,1,1,,,,,,,,,,
20101010-M-Shanghai_Masters-QF-Robin_Soderling-Roger_Federer,2,F-DTL,5,0,0,0,0,5,0,,,,,,,,,,
20101010-M-Shanghai_Masters-QF-Robin_Soderling-Roger_Federer,2,F-IO,15,3,1,0,2,11,4,,,,,,,,,,
20101010-M-Shanghai_Masters-QF-Robin_Soderling-Roger_Federer,2,F-II,3,2,1,0,1,2,1,,,,,,,,,,
20101010-M-Shanghai_Masters-QF-Robin_Soderling-Roger_Federer,2,B-XC,12,2,0,0,2,6,6,,,,,,,,,,
20101010-M-Shanghai_Masters-QF-Robin_Soderling-Roger_Federer,2,B-DTM,7,1,0,0,1,4,3,,,,,,,,,,
20101010-M-Shanghai_Masters-QF-Robin_Soderling-Roger_Federer,2,B-DTL,7,5,2,0,3,3,4,,,,,,,,,,
20101010-M-Shanghai_Masters-QF-Robin_Soderling-Roger_Federer,2,B-IO,1,0,0,0,0,1,0,,,,,,,,,,
20101010-M-Shanghai_Masters-QF-Robin_Soderling-Roger_Federer,2,S-XC,9,0,0,0,0,5,4,,,,,,,,,,
20101010-M-Shanghai_Masters-QF-Robin_Soderling-Roger_Federer,2,S-DTM,4,0,0,0,0,4,0,,,,,,,,,,
20101010-M-Shanghai_Masters-QF-Robin_Soderling-Roger_Federer,2,S-DTL,1,0,0,0,0,1,0,,,,,,,,,,
20110102-M-Brisbane-R16-Robin_Soderling-Michael_Berrer,1,F-XC,37,11,4,3,4,20,17,,,,,,,,,,
20110102-M-Brisbane-R16-Robin_Soderling-Michael_Berrer,1,F-DTM,8,1,0,0,1,2,6,,,,,,,,,,
20110102-M-Brisbane-R16-Robin_Soderling-Michael_Berrer,1,F-DTL,13,6,1,2,3,8,5,,,,,,,,,,
20110102-M-Brisbane-R16-Robin_Soderling-Michael_Berrer,1,F-IO,24,5,2,1,2,13,11,,,,,,,,,,
20110102-M-Brisbane-R16-Robin_Soderling-Michael_Berrer,1,F-II,7,2,0,0,2,4,3,,,,,,,,,,
20110102-M-Brisbane-R16-Robin_Soderling-Michael_Berrer,1,B-XC,20,5,1,0,4,7,13,,,,,,,,,,
20110102-M-Brisbane-R16-Robin_Soderling-Michael_Berrer,1,B-DTM,6,0,0,0,0,2,4,,,,,,,,,,
20110102-M-Brisbane-R16-Robin_Soderling-Michael_Berrer,1,B-DTL,26,7,4,0,3,16,10,,,,,,,,,,
20110102-M-Brisbane-R16-Robin_Soderling-Michael_Berrer,1,B-IO,6,0,0,0,0,3,3,,,,,,,,,,
20110102-M-Brisbane-R16-Robin_Soderling-Michael_Berrer,1,S-DTM,2,1,0,0,1,0,2,,,,,,,,,,
20110102-M-Brisbane-R16-Robin_Soderling-Michael_Berrer,1,S-DTL,2,0,0,0,0,0,2,,,,,,,,,,
20110102-M-Brisbane-R16-Robin_Soderling-Michael_Berrer,2,F-XC,44,10,1,2,7,27,17,,,,,,,,,,
20110102-M-Brisbane-R16-Robin_Soderling-Michael_Berrer,2,F-DTM,6,0,0,0,0,3,3,,,,,,,,,,
20110102-M-Brisbane-R16-Robin_Soderling-Michael_Berrer,2,F-DTL,12,6,0,3,3,6,6,,,,,,,,,,
20110102-M-Brisbane-R16-Robin_Soderling-Michael_Berrer,2,F-IO,8,1,1,0,0,6,2,,,,,,,,,,
20110102-M-Brisbane-R16-Robin_Soderling-Michael_Berrer,2,B-XC,9,5,2,1,2,6,3,,,,,,,,,,
20110102-M-Brisbane-R16-Robin_Soderling-Michael_Berrer,2,B-DTM,14,3,0,0,3,4,10,,,,,,,,,,
20110102-M-Brisbane-R16-Robin_Soderling-Michael_Berrer,2,B-DTL,10,1,0,0,1,2,8,,,,,,,,,,
20110102-M-Brisbane-R16-Robin_Soderling-Michael_Berrer,2,B-IO,3,1,0,0,1,2,1,,,,,,,,,,
20110102-M-Brisbane-R16-Robin_Soderling-Michael_Berrer,2,S-XC,15,2,1,0,1,8,7,,,,,,,,,,
20110102-M-Brisbane-R16-Robin_Soderling-Michael_Berrer,2,S-DTM,9,1,0,0,1,4,5,,,,,,,,,,
20110102-M-Brisbane-R16-Robin_Soderling-Michael_Berrer,2,S-DTL,7,0,0,0,0,3,4,,,,,,,,,,
20110102-M-Brisbane-R16-Robin_Soderling-Michael_Berrer,2,S-IO,2,1,0,0,1,0,2,,,,,,,,,,
20110102-M-Brisbane-R16-Robin_Soderling-Michael_Berrer,2,S-II,1,0,0,0,0,1,0,,,,,,,,,,
20110118-M-Australian_Open-R128-David_Nalbandian-Lleyton_Hewitt,1,F-XC,122,24,5,8,11,61,61,,,,,,,,,,
20110118-M-Australian_Open-R128-David_Nalbandian-Lleyton_Hewitt,1,F-DTM,65,4,0,1,3,34,31,,,,,,,,,,
20110118-M-Australian_Open-R128-David_Nalbandian-Lleyton_Hewitt,1,F-DTL,48,17,4,2,11,20,28,,,,,,,,,,
20110118-M-Australian_Open-R128-David_Nalbandian-Lleyton_Hewitt,1,F-IO,71,18,8,3,7,42,29,,,,,,,,,,
20110118-M-Australian_Open-R128-David_Nalbandian-Lleyton_Hewitt,1,F-II,6,2,0,1,1,3,3,,,,,,,,,,
20110118-M-Australian_Open-R128-David_Nalbandian-Lleyton_Hewitt,1,B-XC,161,34,8,14,12,95,66,,,,,,,,,,
20110118-M-Australian_Open-R128-David_Nalbandian-Lleyton_Hewitt,1,B-DTM,45,1,0,0,1,26,19,,,,,,,,,,
20110118-M-Australian_Open-R128-David_Nalbandian-Lleyton_Hewitt,1,B-DTL,80,25,8,3,14,42,38,,,,,,,,,,
20110118-M-Australian_Open-R128-David_Nalbandian-Lleyton_Hewitt,1,B-IO,19,3,1,1,1,11,8,,,,,,,,,,
20110118-M-Australian_Open-R128-David_Nalbandian-Lleyton_Hewitt,1,S-XC,41,5,0,1,4,19,22,,,,,,,,,,
20110118-M-Australian_Open-R128-David_Nalbandian-Lleyton_Hewitt,1,S-DTM,17,1,0,0,1,12,5,,,,,,,,,,
20110118-M-Australian_Open-R128-David_Nalbandian-Lleyton_Hewitt,1,S-DTL,11,2,1,0,1,6,5,,,,,,,,,,
20110118-M-Australian_Open-R128-David_Nalbandian-Lleyton_Hewitt,1,S-IO,3,1,1,0,0,1,2,,,,,,,,,,
20110118-M-Australian_Open-R128-David_Nalbandian-Lleyton_Hewitt,2,F-XC,132,25,5,7,13,71,61,,,,,,,,,,
20110118-M-Australian_Open-R128-David_Nalbandian-Lleyton_Hewitt,2,F-DTM,82,3,0,1,2,39,43,,,,,,,,,,
20110118-M-Australian_Open-R128-David_Nalbandian-Lleyton_Hewitt,2,F-DTL,63,13,5,3,5,28,35,,,,,,,,,,
20110118-M-Australian_Open-R128-David_Nalbandian-Lleyton_Hewitt,2,F-IO,40,11,7,2,2,20,20,,,,,,,,,,
20110118-M-Australian_Open-R128-David_Nalbandian-Lleyton_Hewitt,2,F-II,1,1,1,0,0,1,0,,,,,,,,,,
20110118-M-Australian_Open-R128-David_Nalbandian-Lleyton_Hewitt,2,B-XC,170,15,3,3,9,80,90,,,,,,,,,,
20110118-M-Australian_Open-R128-David_Nalbandian-Lleyton_Hewitt,2,B-DTM,88,1,0,0,1,37,51,,,,,,,,,,
20110118-M-Australian_Open-R128-David_Nalbandian-Lleyton_Hewitt,2,B-DTL,26,16,2,3,11,9,17,,,,,,,,,,
20110118-M-Australian_Open-R128-David_Nalbandian-Lleyton_Hewitt,2,B-IO,15,4,0,2,2,6,9,,,,,,,,,,
20110118-M-Australian_Open-R128-David_Nalbandian-Lleyton_Hewitt,2,S-XC,27,4,1,2,1,15,12,,,,,,,,,,
20110118-M-Australian_Open-R128-David_Nalbandian-Lleyton_Hewitt,2,S-DTM,9,0,0,0,0,4,5,,,,,,,,,,
20110118-M-Australian_Open-R128-David_Nalbandian-Lleyton_Hewitt,2,S-DTL,11,1,0,1,0,6,5,,,,,,,,,,
20110130-M-Australian_Open-F-Novak_Djokovic-Andy_Murray,1,F-XC,65,9,2,4,3,41,24,,,,,,,,,,
20110130-M-Australian_Open-F-Novak_Djokovic-Andy_Murray,1,F-DTM,48,1,0,0,1,31,17,,,,,,,,,,
20110130-M-Australian_Open-F-Novak_Djokovic-Andy_Murray,1,F-DTL,42,9,2,2,5,28,14,,,,,,,,,,
20110130-M-Australian_Open-F-Novak_Djokovic-Andy_Murray,1,F-IO,44,12,5,3,4,29,15,,,,,,,,,,
20110130-M-Australian_Open-F-Novak_Djokovic-Andy_Murray,1,F-II,11,4,1,3,0,9,2,,,,,,,,,,
20110130-M-Australian_Open-F-Novak_Djokovic-Andy_Murray,1,B-XC,74,7,2,2,3,48,26,,,,,,,,,,
20110130-M-Australian_Open-F-Novak_Djokovic-Andy_Murray,1,B-DTM,48,4,0,3,1,31,17,,,,,,,,,,
20110130-M-Australian_Open-F-Novak_Djokovic-Andy_Murray,1,B-DTL,37,10,2,3,5,22,15,,,,,,,,,,
20110130-M-Australian_Open-F-Novak_Djokovic-Andy_Murray,1,B-IO,9,1,0,0,1,4,5,,,,,,,,,,
20110130-M-Australian_Open-F-Novak_Djokovic-Andy_Murray,1,S-XC,14,1,0,1,0,8,6,,,,,,,,,,
20110130-M-Australian_Open-F-Novak_Djokovic-Andy_Murray,1,S-DTM,11,0,0,0,0,10,1,,,,,,,,,,
20110130-M-Australian_Open-F-Novak_Djokovic-Andy_Murray,1,S-DTL,9,1,0,1,0,8,1,,,,,,,,,,
20110130-M-Australian_Open-F-Novak_Djokovic-Andy_Murray,1,S-IO,1,0,0,0,0,0,1,,,,,,,,,,
20110130-M-Australian_Open-F-Novak_Djokovic-Andy_Murray,2,F-XC,113,16,1,7,8,43,70,,,,,,,,,,
20110130-M-Australian_Open-F-Novak_Djokovic-Andy_Murray,2,F-DTM,27,1,0,0,1,10,17,,,,,,,,,,
20110130-M-Australian_Open-F-Novak_Djokovic-Andy_Murray,2,F-DTL,27,5,3,0,2,12,15,,,,,,,,,,
20110130-M-Australian_Open-F-Novak_Djokovic-Andy_Murray,2,F-IO,40,7,3,1,3,14,26,,,,,,,,,,
20110130-M-Australian_Open-F-Novak_Djokovic-Andy_Murray,2,F-II,2,0,0,0,0,0,2,,,,,,,,,,
20110130-M-Australian_Open-F-Novak_Djokovic-Andy_Murray,2,B-XC,90,7,1,0,6,32,58,,,,,,,,,,
20110130-M-Australian_Open-F-Novak_Djokovic-Andy_Murray,2,B-DTM,47,3,0,0,3,14,33,,,,,,,,,,
20110130-M-Australian_Open-F-Novak_Djokovic-Andy_Murray,2,B-DTL,15,8,1,1,6,6,9,,,,,,,,,,
20110130-M-Australian_Open-F-Novak_Djokovic-Andy_Murray,2,B-IO,14,2,0,0,2,5,9,,,,,,,,,,
20110130-M-Australian_Open-F-Novak_Djokovic-Andy_Murray,2,S-XC,36,4,0,0,4,10,26,,,,,,,,,,
20110130-M-Australian_Open-F-Novak_Djokovic-Andy_Murray,2,S-DTM,12,1,0,0,1,4,8,,,,,,,,,,
20110130-M-Australian_Open-F-Novak_Djokovic-Andy_Murray,2,S-DTL,2,0,0,0,0,0,2,,,,,,,,,,
20110130-M-Australian_Open-F-Novak_Djokovic-Andy_Murray,2,S-IO,1,0,0,0,0,0,1,,,,,,,,,,
20110221-M-Dubai-F-Roger_Federer-Novak_Djokovic,1,F-XC,23,5,2,0,3,4,19,,,,,,,,,,
20110221-M-Dubai-F-Roger_Federer-Novak_Djokovic,1,F-DTM,16,4,0,1,3,7,9,,,,,,,,,,
20110221-M-Dubai-F-Roger_Federer-Novak_Djokovic,1,F-DTL,5,5,1,2,2,3,2,,,,,,,,,,
20110221-M-Dubai-F-Roger_Federer-Novak_Djokovic,1,F-IO,30,9,3,0,6,8,22,,,,,,,,,,
20110221-M-Dubai-F-Roger_Federer-Novak_Djokovic,1,F-II,3,2,2,0,0,3,0,,,,,,,,,,
20110221-M-Dubai-F-Roger_Federer-Novak_Djokovic,1,B-XC,24,7,0,1,6,6,18,,,,,,,,,,
20110221-M-Dubai-F-Roger_Federer-Novak_Djokovic,1,B-DTM,16,3,0,0,3,3,13,,,,,,,,,,
20110221-M-Dubai-F-Roger_Federer-Novak_Djokovic,1,B-DTL,9,3,2,0,1,2,7,,,,,,,,,,
20110221-M-Dubai-F-Roger_Federer-Novak_Djokovic,1,S-XC,8,0,0,0,0,1,7,,,,,,,,,,
20110221-M-Dubai-F-Roger_Federer-Novak_Djokovic,1,S-DTM,2,0,0,0,0,2,0,,,,,,,,,,
20110221-M-Dubai-F-Roger_Federer-Novak_Djokovic,1,S-DTL,1,0,0,0,0,0,1,,,,,,,,,,
20110221-M-Dubai-F-Roger_Federer-Novak_Djokovic,2,F-XC,24,8,2,4,2,19,5,,,,,,,,,,
20110221-M-Dubai-F-Roger_Federer-Novak_Djokovic,2,F-DTM,15,0,0,0,0,12,3,,,,,,,,,,
20110221-M-Dubai-F-Roger_Federer-Novak_Djokovic,2,F-DTL,5,0,0,0,0,4,1,,,,,,,,,,
20110221-M-Dubai-F-Roger_Federer-Novak_Djokovic,2,F-IO,22,3,0,2,1,16,6,,,,,,,,,,
20110221-M-Dubai-F-Roger_Federer-Novak_Djokovic,2,F-II,3,1,1,0,0,2,1,,,,,,,,,,
20110221-M-Dubai-F-Roger_Federer-Novak_Djokovic,2,B-XC,26,5,0,3,2,19,7,,,,,,,,,,
20110221-M-Dubai-F-Roger_Federer-Novak_Djokovic,2,B-DTM,22,3,0,0,3,12,10,,,,,,,,,,
20110221-M-Dubai-F-Roger_Federer-Novak_Djokovic,2,B-DTL,3,2,1,1,0,2,1,,,,,,,,,,
20110221-M-Dubai-F-Roger_Federer-Novak_Djokovic,2,B-IO,1,0,0,0,0,0,1,,,,,,,,,,
20110221-M-Dubai-F-Roger_Federer-Novak_Djokovic,2,S-XC,2,0,0,0,0,2,0,,,,,,,,,,
20110221-M-Dubai-F-Roger_Federer-Novak_Djokovic,2,S-DTM,1,0,0,0,0,0,1,,,,,,,,,,
20110310-M-Indian_Wells_Masters-QF-Richard_Gasquet-Novak_Djokovic,1,F-XC,40,4,2,0,2,16,24,,,,,,,,,,
20110310-M-Indian_Wells_Masters-QF-Richard_Gasquet-Novak_Djokovic,1,F-DTM,43,1,0,0,1,17,26,,,,,,,,,,
20110310-M-Indian_Wells_Masters-QF-Richard_Gasquet-Novak_Djokovic,1,F-DTL,18,5,1,1,3,6,12,,,,,,,,,,
20110310-M-Indian_Wells_Masters-QF-Richard_Gasquet-Novak_Djokovic,1,F-IO,16,2,0,1,1,10,6,,,,,,,,,,
20110310-M-Indian_Wells_Masters-QF-Richard_Gasquet-Novak_Djokovic,1,B-XC,61,5,2,1,2,32,29,,,,,,,,,,
20110310-M-Indian_Wells_Masters-QF-Richard_Gasquet-Novak_Djokovic,1,B-DTM,24,3,0,0,3,10,14,,,,,,,,,,
20110310-M-Indian_Wells_Masters-QF-Richard_Gasquet-Novak_Djokovic,1,B-DTL,9,6,1,4,1,7,2,,,,,,,,,,
20110310-M-Indian_Wells_Masters-QF-Richard_Gasquet-Novak_Djokovic,1,B-IO,6,4,1,0,3,3,3,,,,,,,,,,
20110310-M-Indian_Wells_Masters-QF-Richard_Gasquet-Novak_Djokovic,1,S-XC,21,1,0,0,1,8,13,,,,,,,,,,
20110310-M-Indian_Wells_Masters-QF-Richard_Gasquet-Novak_Djokovic,1,S-DTM,6,0,0,0,0,2,4,,,,,,,,,,
20110310-M-Indian_Wells_Masters-QF-Richard_Gasquet-Novak_Djokovic,1,S-DTL,1,0,0,0,0,0,1,,,,,,,,,,
20110310-M-Indian_Wells_Masters-QF-Richard_Gasquet-Novak_Djokovic,2,F-XC,51,14,7,2,5,33,18,,,,,,,,,,
20110310-M-Indian_Wells_Masters-QF-Richard_Gasquet-Novak_Djokovic,2,F-DTM,16,1,0,0,1,7,9,,,,,,,,,,
20110310-M-Indian_Wells_Masters-QF-Richard_Gasquet-Novak_Djokovic,2,F-DTL,13,3,3,0,0,9,4,,,,,,,,,,
20110310-M-Indian_Wells_Masters-QF-Richard_Gasquet-Novak_Djokovic,2,F-IO,43,14,5,3,6,22,21,,,,,,,,,,
20110310-M-Indian_Wells_Masters-QF-Richard_Gasquet-Novak_Djokovic,2,F-II,8,4,1,1,2,6,2,,,,,,,,,,
20110310-M-Indian_Wells_Masters-QF-Richard_Gasquet-Novak_Djokovic,2,B-XC,48,7,3,1,3,26,22,,,,,,,,,,
20110310-M-Indian_Wells_Masters-QF-Richard_Gasquet-Novak_Djokovic,2,B-DTM,32,4,0,0,4,14,18,,,,,,,,,,
20110310-M-Indian_Wells_Masters-QF-Richard_Gasquet-Novak_Djokovic,2,B-DTL,25,4,0,0,4,11,14,,,,,,,,,,
20110310-M-Indian_Wells_Masters-QF-Richard_Gasquet-Novak_Djokovic,2,B-IO,8,2,1,0,1,6,2,,,,,,,,,,
20110310-M-Indian_Wells_Masters-QF-Richard_Gasquet-Novak_Djokovic,2,S-XC,3,0,0,0,0,0,3,,,,,,,,,,
20110310-M-Indian_Wells_Masters-QF-Richard_Gasquet-Novak_Djokovic,2,S-DTM,3,0,0,0,0,1,2,,,,,,,,,,
20110310-M-Indian_Wells_Masters-QF-Richard_Gasquet-Novak_Djokovic,2,S-DTL,2,0,0,0,0,0,2,,,,,,,,,,
20110310-M-Indian_Wells_Masters-QF-Richard_Gasquet-Novak_Djokovic,2,S-IO,1,0,0,0,0,1,0,,,,,,,,,,
20110316-M-Indian_Wells_Masters-QF-Roger_Federer-Stanislas_Wawrinka,1,F-XC,18,6,2,3,1,12,6,,,,,,,,,,
20110316-M-Indian_Wells_Masters-QF-Roger_Federer-Stanislas_Wawrinka,1,F-DTM,7,1,0,0,1,2,5,,,,,,,,,,
20110316-M-Indian_Wells_Masters-QF-Roger_Federer-Stanislas_Wawrinka,1,F-DTL,6,2,1,0,1,4,2,,,,,,,,,,
20110316-M-Indian_Wells_Masters-QF-Roger_Federer-Stanislas_Wawrinka,1,F-IO,16,2,0,1,1,13,3,,,,,,,,,,
20110316-M-Indian_Wells_Masters-QF-Roger_Federer-Stanislas_Wawrinka,1,F-II,5,1,1,0,0,3,2,,,,,,,,,,
20110316-M-Indian_Wells_Masters-QF-Roger_Federer-Stanislas_Wawrinka,1,B-XC,19,3,0,1,2,8,11,,,,,,,,,,
20110316-M-Indian_Wells_Masters-QF-Roger_Federer-Stanislas_Wawrinka,1,B-DTM,13,0,0,0,0,9,4,,,,,,,,,,
20110316-M-Indian_Wells_Masters-QF-Roger_Federer-Stanislas_Wawrinka,1,B-DTL,9,3,0,2,1,6,3,,,,,,,,,,
20110316-M-Indian_Wells_Masters-QF-Roger_Federer-Stanislas_Wawrinka,1,S-XC,3,0,0,0,0,0,3,,,,,,,,,,
20110316-M-Indian_Wells_Masters-QF-Roger_Federer-Stanislas_Wawrinka,1,S-DTM,5,0,0,0,0,0,5,,,,,,,,,,
20110316-M-Indian_Wells_Masters-QF-Roger_Federer-Stanislas_Wawrinka,1,S-DTL,2,0,0,0,0,1,1,,,,,,,,,,
20110316-M-Indian_Wells_Masters-QF-Roger_Federer-Stanislas_Wawrinka,1,S-IO,1,0,0,0,0,1,0,,,,,,,,,,
20110316-M-Indian_Wells_Masters-QF-Roger_Federer-Stanislas_Wawrinka,2,F-XC,27,8,1,3,4,14,13,,,,,,,,,,
20110316-M-Indian_Wells_Masters-QF-Roger_Federer-Stanislas_Wawrinka,2,F-DTM,9,3,0,0,3,2,7,,,,,,,,,,
20110316-M-Indian_Wells_Masters-QF-Roger_Federer-Stanislas_Wawrinka,2,F-DTL,7,3,1,1,1,5,2,,,,,,,,,,
20110316-M-Indian_Wells_Masters-QF-Roger_Federer-Stanislas_Wawrinka,2,F-IO,18,4,2,1,1,12,6,,,,,,,,,,
20110316-M-Indian_Wells_Masters-QF-Roger_Federer-Stanislas_Wawrinka,2,F-II,4,2,1,0,1,2,2,,,,,,,,,,
20110316-M-Indian_Wells_Masters-QF-Roger_Federer-Stanislas_Wawrinka,2,B-XC,33,10,3,1,6,15,18,,,,,,,,,,
20110316-M-Indian_Wells_Masters-QF-Roger_Federer-Stanislas_Wawrinka,2,B-DTM,6,0,0,0,0,1,5,,,,,,,,,,
20110316-M-Indian_Wells_Masters-QF-Roger_Federer-Stanislas_Wawrinka,2,B-DTL,8,5,0,2,3,3,5,,,,,,,,,,
20110316-M-Indian_Wells_Masters-QF-Roger_Federer-Stanislas_Wawrinka,2,B-IO,2,0,0,0,0,1,1,,,,,,,,,,
20110316-M-Indian_Wells_Masters-QF-Roger_Federer-Stanislas_Wawrinka,2,S-XC,5,0,0,0,0,2,3,,,,,,,,,,
20110316-M-Indian_Wells_Masters-QF-Roger_Federer-Stanislas_Wawrinka,2,S-DTM,3,0,0,0,0,0,3,,,,,,,,,,
20110316-M-Indian_Wells_Masters-QF-Roger_Federer-Stanislas_Wawrinka,2,S-DTL,1,1,0,1,0,1,0,,,,,,,,,,
20110319-M-Indian_Wells_Masters-F-Novak_Djokovic-Rafael_Nadal,1,F-XC,112,14,4,8,2,71,41,,,,,,,,,,
20110319-M-Indian_Wells_Masters-F-Novak_Djokovic-Rafael_Nadal,1,F-DTM,22,1,0,0,1,7,15,,,,,,,,,,
20110319-M-Indian_Wells_Masters-F-Novak_Djokovic-Rafael_Nadal,1,F-DTL,14,6,3,2,1,11,3,,,,,,,,,,
20110319-M-Indian_Wells_Masters-F-Novak_Djokovic-Rafael_Nadal,1,F-IO,32,6,3,2,1,16,16,,,,,,,,,,
20110319-M-Indian_Wells_Masters-F-Novak_Djokovic-Rafael_Nadal,1,F-II,5,1,0,1,0,3,2,,,,,,,,,,
20110319-M-Indian_Wells_Masters-F-Novak_Djokovic-Rafael_Nadal,1,B-XC,58,12,2,1,9,26,32,,,,,,,,,,
20110319-M-Indian_Wells_Masters-F-Novak_Djokovic-Rafael_Nadal,1,B-DTM,39,3,0,0,3,23,16,,,,,,,,,,
20110319-M-Indian_Wells_Masters-F-Novak_Djokovic-Rafael_Nadal,1,B-DTL,36,7,2,2,3,22,14,,,,,,,,,,
20110319-M-Indian_Wells_Masters-F-Novak_Djokovic-Rafael_Nadal,1,B-IO,14,2,0,0,2,8,6,,,,,,,,,,
20110319-M-Indian_Wells_Masters-F-Novak_Djokovic-Rafael_Nadal,1,S-DTM,3,0,0,0,0,0,3,,,,,,,,,,
20110319-M-Indian_Wells_Masters-F-Novak_Djokovic-Rafael_Nadal,1,S-DTL,5,0,0,0,0,3,2,,,,,,,,,,
20110319-M-Indian_Wells_Masters-F-Novak_Djokovic-Rafael_Nadal,2,F-XC,95,6,1,2,3,46,49,,,,,,,,,,
20110319-M-Indian_Wells_Masters-F-Novak_Djokovic-Rafael_Nadal,2,F-DTM,33,4,0,1,3,18,15,,,,,,,,,,
20110319-M-Indian_Wells_Masters-F-Novak_Djokovic-Rafael_Nadal,2,F-DTL,17,4,1,0,3,8,9,,,,,,,,,,
20110319-M-Indian_Wells_Masters-F-Novak_Djokovic-Rafael_Nadal,2,F-IO,24,4,2,1,1,12,12,,,,,,,,,,
20110319-M-Indian_Wells_Masters-F-Novak_Djokovic-Rafael_Nadal,2,F-II,10,3,0,1,2,5,5,,,,,,,,,,
20110319-M-Indian_Wells_Masters-F-Novak_Djokovic-Rafael_Nadal,2,B-XC,51,4,0,0,4,18,33,,,,,,,,,,
20110319-M-Indian_Wells_Masters-F-Novak_Djokovic-Rafael_Nadal,2,B-DTM,38,5,0,1,4,13,25,,,,,,,,,,
20110319-M-Indian_Wells_Masters-F-Novak_Djokovic-Rafael_Nadal,2,B-DTL,25,7,2,1,4,11,14,,,,,,,,,,
20110319-M-Indian_Wells_Masters-F-Novak_Djokovic-Rafael_Nadal,2,B-IO,3,1,0,1,0,2,1,,,,,,,,,,
20110319-M-Indian_Wells_Masters-F-Novak_Djokovic-Rafael_Nadal,2,S-XC,3,0,0,0,0,0,3,,,,,,,,,,
20110319-M-Indian_Wells_Masters-F-Novak_Djokovic-Rafael_Nadal,2,S-DTM,14,1,0,0,1,3,11,,,,,,,,,,
20110319-M-Indian_Wells_Masters-F-Novak_Djokovic-Rafael_Nadal,2,S-DTL,8,0,0,0,0,5,3,,,,,,,,,,
20110319-M-Indian_Wells_Masters-F-Novak_Djokovic-Rafael_Nadal,2,S-IO,2,0,0,0,0,1,1,,,,,,,,,,
20110401-M-Miami_Masters-SF-Roger_Federer-Rafael_Nadal,1,F-XC,38,12,1,2,9,11,27,,,,,,,,,,
20110401-M-Miami_Masters-SF-Roger_Federer-Rafael_Nadal,1,F-DTM,12,1,0,0,1,2,10,,,,,,,,,,
20110401-M-Miami_Masters-SF-Roger_Federer-Rafael_Nadal,1,F-DTL,9,5,1,1,3,4,5,,,,,,,,,,
20110401-M-Miami_Masters-SF-Roger_Federer-Rafael_Nadal,1,F-IO,21,10,5,1,4,7,14,,,,,,,,,,
20110401-M-Miami_Masters-SF-Roger_Federer-Rafael_Nadal,1,F-II,15,2,0,0,2,5,10,,,,,,,,,,
20110401-M-Miami_Masters-SF-Roger_Federer-Rafael_Nadal,1,B-XC,19,5,2,2,1,4,15,,,,,,,,,,
20110401-M-Miami_Masters-SF-Roger_Federer-Rafael_Nadal,1,B-DTM,16,4,0,0,4,3,13,,,,,,,,,,
20110401-M-Miami_Masters-SF-Roger_Federer-Rafael_Nadal,1,B-DTL,10,2,0,0,2,3,7,,,,,,,,,,
20110401-M-Miami_Masters-SF-Roger_Federer-Rafael_Nadal,1,B-IO,2,0,0,0,0,2,0,,,,,,,,,,
20110401-M-Miami_Masters-SF-Roger_Federer-Rafael_Nadal,1,S-XC,1,0,0,0,0,0,1,,,,,,,,,,
20110401-M-Miami_Masters-SF-Roger_Federer-Rafael_Nadal,1,S-DTM,5,0,0,0,0,1,4,,,,,,,,,,
20110401-M-Miami_Masters-SF-Roger_Federer-Rafael_Nadal,1,S-DTL,2,1,0,0,1,1,1,,,,,,,,,,
20110401-M-Miami_Masters-SF-Roger_Federer-Rafael_Nadal,2,F-XC,42,5,0,3,2,37,5,,,,,,,,,,
20110401-M-Miami_Masters-SF-Roger_Federer-Rafael_Nadal,2,F-DTM,11,1,0,0,1,7,4,,,,,,,,,,
20110401-M-Miami_Masters-SF-Roger_Federer-Rafael_Nadal,2,F-DTL,9,2,2,0,0,7,2,,,,,,,,,,
20110401-M-Miami_Masters-SF-Roger_Federer-Rafael_Nadal,2,F-IO,16,5,4,1,0,13,3,,,,,,,,,,
20110401-M-Miami_Masters-SF-Roger_Federer-Rafael_Nadal,2,F-II,6,1,1,0,0,5,1,,,,,,,,,,
20110401-M-Miami_Masters-SF-Roger_Federer-Rafael_Nadal,2,B-XC,18,4,1,1,2,12,6,,,,,,,,,,
20110401-M-Miami_Masters-SF-Roger_Federer-Rafael_Nadal,2,B-DTM,11,0,0,0,0,11,0,,,,,,,,,,
20110401-M-Miami_Masters-SF-Roger_Federer-Rafael_Nadal,2,B-DTL,15,3,0,0,3,6,9,,,,,,,,,,
20110401-M-Miami_Masters-SF-Roger_Federer-Rafael_Nadal,2,B-IO,4,1,1,0,0,4,0,,,,,,,,,,
20110401-M-Miami_Masters-SF-Roger_Federer-Rafael_Nadal,2,S-XC,4,0,0,0,0,1,3,,,,,,,,,,
20110401-M-Miami_Masters-SF-Roger_Federer-Rafael_Nadal,2,S-DTM,2,0,0,0,0,2,0,,,,,,,,,,
20110401-M-Miami_Masters-SF-Roger_Federer-Rafael_Nadal,2,S-DTL,5,1,0,0,1,1,4,,,,,,,,,,
20110424-M-Barcelona-F-David_Ferrer-Rafael_Nadal,1,F-XC,79,7,1,3,3,52,27,,,,,,,,,,
20110424-M-Barcelona-F-David_Ferrer-Rafael_Nadal,1,F-DTM,24,1,0,0,1,10,14,,,,,,,,,,
20110424-M-Barcelona-F-David_Ferrer-Rafael_Nadal,1,F-DTL,12,3,1,0,2,4,8,,,,,,,,,,
20110424-M-Barcelona-F-David_Ferrer-Rafael_Nadal,1,F-IO,36,13,2,5,6,25,11,,,,,,,,,,
20110424-M-Barcelona-F-David_Ferrer-Rafael_Nadal,1,F-II,21,2,0,1,1,12,9,,,,,,,,,,
20110424-M-Barcelona-F-David_Ferrer-Rafael_Nadal,1,B-XC,58,12,2,3,7,30,28,,,,,,,,,,
20110424-M-Barcelona-F-David_Ferrer-Rafael_Nadal,1,B-DTM,25,3,0,0,3,9,16,,,,,,,,,,
20110424-M-Barcelona-F-David_Ferrer-Rafael_Nadal,1,B-DTL,25,6,2,1,3,11,14,,,,,,,,,,
20110424-M-Barcelona-F-David_Ferrer-Rafael_Nadal,1,B-IO,1,0,0,0,0,0,1,,,,,,,,,,
20110424-M-Barcelona-F-David_Ferrer-Rafael_Nadal,1,S-DTM,1,0,0,0,0,0,1,,,,,,,,,,
20110424-M-Barcelona-F-David_Ferrer-Rafael_Nadal,1,S-DTL,4,0,0,0,0,0,4,,,,,,,,,,
20110424-M-Barcelona-F-David_Ferrer-Rafael_Nadal,2,F-XC,79,10,3,3,4,37,42,,,,,,,,,,
20110424-M-Barcelona-F-David_Ferrer-Rafael_Nadal,2,F-DTM,19,0,0,0,0,6,13,,,,,,,,,,
20110424-M-Barcelona-F-David_Ferrer-Rafael_Nadal,2,F-DTL,24,7,6,1,0,14,10,,,,,,,,,,
20110424-M-Barcelona-F-David_Ferrer-Rafael_Nadal,2,F-IO,19,5,2,3,0,14,5,,,,,,,,,,
20110424-M-Barcelona-F-David_Ferrer-Rafael_Nadal,2,F-II,18,3,0,3,0,10,8,,,,,,,,,,
20110424-M-Barcelona-F-David_Ferrer-Rafael_Nadal,2,B-XC,52,10,1,1,8,17,35,,,,,,,,,,
20110424-M-Barcelona-F-David_Ferrer-Rafael_Nadal,2,B-DTM,19,1,0,1,0,9,10,,,,,,,,,,
20110424-M-Barcelona-F-David_Ferrer-Rafael_Nadal,2,B-DTL,35,7,1,1,5,15,20,,,,,,,,,,
20110424-M-Barcelona-F-David_Ferrer-Rafael_Nadal,2,B-IO,3,0,0,0,0,0,3,,,,,,,,,,
20110424-M-Barcelona-F-David_Ferrer-Rafael_Nadal,2,S-XC,3,0,0,0,0,2,1,,,,,,,,,,
20110424-M-Barcelona-F-David_Ferrer-Rafael_Nadal,2,S-DTM,3,1,0,0,1,1,2,,,,,,,,,,
20110424-M-Barcelona-F-David_Ferrer-Rafael_Nadal,2,S-DTL,8,0,0,0,0,5,3,,,,,,,,,,
20110424-M-Barcelona-F-David_Ferrer-Rafael_Nadal,2,S-IO,2,0,0,0,0,1,1,,,,,,,,,,
20110508-M-Rome_Masters-F-Novak_Djokovic-Rafael_Nadal,1,F-XC,131,17,5,8,4,71,60,,,,,,,,,,
20110508-M-Rome_Masters-F-Novak_Djokovic-Rafael_Nadal,1,F-DTM,27,4,0,1,3,14,13,,,,,,,,,,
20110508-M-Rome_Masters-F-Novak_Djokovic-Rafael_Nadal,1,F-DTL,18,6,3,2,1,10,8,,,,,,,,,,
20110508-M-Rome_Masters-F-Novak_Djokovic-Rafael_Nadal,1,F-IO,45,16,6,7,3,33,12,,,,,,,,,,
20110508-M-Rome_Masters-F-Novak_Djokovic-Rafael_Nadal,1,F-II,3,0,0,0,0,3,0,,,,,,,,,,
20110508-M-Rome_Masters-F-Novak_Djokovic-Rafael_Nadal,1,B-XC,72,12,4,3,5,41,31,,,,,,,,,,
20110508-M-Rome_Masters-F-Novak_Djokovic-Rafael_Nadal,1,B-DTM,44,4,0,0,4,20,24,,,,,,,,,,
20110508-M-Rome_Masters-F-Novak_Djokovic-Rafael_Nadal,1,B-DTL,30,5,0,2,3,13,17,,,,,,,,,,
20110508-M-Rome_Masters-F-Novak_Djokovic-Rafael_Nadal,1,B-IO,9,0,0,0,0,4,5,,,,,,,,,,
20110508-M-Rome_Masters-F-Novak_Djokovic-Rafael_Nadal,1,S-DTM,2,0,0,0,0,0,2,,,,,,,,,,
20110508-M-Rome_Masters-F-Novak_Djokovic-Rafael_Nadal,1,S-DTL,1,0,0,0,0,0,1,,,,,,,,,,
20110508-M-Rome_Masters-F-Novak_Djokovic-Rafael_Nadal,2,F-XC,90,11,3,5,3,45,45,,,,,,,,,,
20110508-M-Rome_Masters-F-Novak_Djokovic-Rafael_Nadal,2,F-DTM,48,2,1,0,1,27,21,,,,,,,,,,
20110508-M-Rome_Masters-F-Novak_Djokovic-Rafael_Nadal,2,F-DTL,30,4,0,1,3,10,20,,,,,,,,,,
20110508-M-Rome_Masters-F-Novak_Djokovic-Rafael_Nadal,2,F-IO,24,5,2,2,1,14,10,,,,,,,,,,
20110508-M-Rome_Masters-F-Novak_Djokovic-Rafael_Nadal,2,F-II,11,2,0,2,0,7,4,,,,,,,,,,
20110508-M-Rome_Masters-F-Novak_Djokovic-Rafael_Nadal,2,B-XC,71,3,0,1,2,30,41,,,,,,,,,,
20110508-M-Rome_Masters-F-Novak_Djokovic-Rafael_Nadal,2,B-DTM,59,1,0,0,1,27,32,,,,,,,,,,
20110508-M-Rome_Masters-F-Novak_Djokovic-Rafael_Nadal,2,B-DTL,27,1,1,0,0,13,14,,,,,,,,,,
20110508-M-Rome_Masters-F-Novak_Djokovic-Rafael_Nadal,2,B-IO,6,2,0,1,1,3,3,,,,,,,,,,
20110508-M-Rome_Masters-F-Novak_Djokovic-Rafael_Nadal,2,S-XC,3,0,0,0,0,3,0,,,,,,,,,,
20110508-M-Rome_Masters-F-Novak_Djokovic-Rafael_Nadal,2,S-DTM,5,0,0,0,0,3,2,,,,,,,,,,
20110508-M-Rome_Masters-F-Novak_Djokovic-Rafael_Nadal,2,S-DTL,4,1,0,0,1,2,2,,,,,,,,,,
20110603-M-Roland_Garros-SF-Novak_Djokovic-Roger_Federer,1,F-XC,107,31,12,12,7,60,47,,,,,,,,,,
20110603-M-Roland_Garros-SF-Novak_Djokovic-Roger_Federer,1,F-DTM,75,10,1,2,7,36,39,,,,,,,,,,
20110603-M-Roland_Garros-SF-Novak_Djokovic-Roger_Federer,1,F-DTL,22,5,1,0,4,9,13,,,,,,,,,,
20110603-M-Roland_Garros-SF-Novak_Djokovic-Roger_Federer,1,F-IO,92,23,8,6,9,63,29,,,,,,,,,,
20110603-M-Roland_Garros-SF-Novak_Djokovic-Roger_Federer,1,F-II,4,1,1,0,0,2,2,,,,,,,,,,
20110603-M-Roland_Garros-SF-Novak_Djokovic-Roger_Federer,1,B-XC,100,19,4,2,13,56,44,,,,,,,,,,
20110603-M-Roland_Garros-SF-Novak_Djokovic-Roger_Federer,1,B-DTM,75,5,1,3,1,44,31,,,,,,,,,,
20110603-M-Roland_Garros-SF-Novak_Djokovic-Roger_Federer,1,B-DTL,9,2,1,0,1,2,7,,,,,,,,,,
20110603-M-Roland_Garros-SF-Novak_Djokovic-Roger_Federer,1,B-IO,8,4,2,1,1,4,4,,,,,,,,,,
20110603-M-Roland_Garros-SF-Novak_Djokovic-Roger_Federer,1,S-XC,5,0,0,0,0,2,3,,,,,,,,,,
20110603-M-Roland_Garros-SF-Novak_Djokovic-Roger_Federer,1,S-DTM,8,0,0,0,0,3,5,,,,,,,,,,
20110603-M-Roland_Garros-SF-Novak_Djokovic-Roger_Federer,1,S-DTL,1,1,0,0,1,0,1,,,,,,,,,,
20110603-M-Roland_Garros-SF-Novak_Djokovic-Roger_Federer,1,S-II,1,0,0,0,0,1,0,,,,,,,,,,
20110603-M-Roland_Garros-SF-Novak_Djokovic-Roger_Federer,2,F-XC,83,19,7,7,5,49,34,,,,,,,,,,
20110603-M-Roland_Garros-SF-Novak_Djokovic-Roger_Federer,2,F-DTM,80,7,0,0,7,27,53,,,,,,,,,,
20110603-M-Roland_Garros-SF-Novak_Djokovic-Roger_Federer,2,F-DTL,15,6,3,3,0,9,6,,,,,,,,,,
20110603-M-Roland_Garros-SF-Novak_Djokovic-Roger_Federer,2,F-IO,37,10,4,2,4,23,14,,,,,,,,,,
20110603-M-Roland_Garros-SF-Novak_Djokovic-Roger_Federer,2,F-II,8,3,1,1,1,4,4,,,,,,,,,,
20110603-M-Roland_Garros-SF-Novak_Djokovic-Roger_Federer,2,B-XC,51,16,2,4,10,26,25,,,,,,,,,,
20110603-M-Roland_Garros-SF-Novak_Djokovic-Roger_Federer,2,B-DTM,101,7,0,0,7,31,70,,,,,,,,,,
20110603-M-Roland_Garros-SF-Novak_Djokovic-Roger_Federer,2,B-DTL,22,10,5,1,4,11,11,,,,,,,,,,
20110603-M-Roland_Garros-SF-Novak_Djokovic-Roger_Federer,2,B-IO,8,1,1,0,0,6,2,,,,,,,,,,
20110603-M-Roland_Garros-SF-Novak_Djokovic-Roger_Federer,2,S-XC,27,1,0,0,1,7,20,,,,,,,,,,
20110603-M-Roland_Garros-SF-Novak_Djokovic-Roger_Federer,2,S-DTM,25,1,0,0,1,9,16,,,,,,,,,,
20110603-M-Roland_Garros-SF-Novak_Djokovic-Roger_Federer,2,S-DTL,4,0,0,0,0,2,2,,,,,,,,,,
20110603-M-Roland_Garros-SF-Novak_Djokovic-Roger_Federer,2,S-II,1,0,0,0,0,1,0,,,,,,,,,,
20110605-M-Roland_Garros-F-Roger_Federer-Rafael_Nadal,1,F-XC,94,20,5,6,9,47,47,,,,,,,,,,
20110605-M-Roland_Garros-F-Roger_Federer-Rafael_Nadal,1,F-DTM,39,3,0,1,2,18,21,,,,,,,,,,
20110605-M-Roland_Garros-F-Roger_Federer-Rafael_Nadal,1,F-DTL,16,3,0,1,2,8,8,,,,,,,,,,
20110605-M-Roland_Garros-F-Roger_Federer-Rafael_Nadal,1,F-IO,54,12,6,0,6,29,25,,,,,,,,,,
20110605-M-Roland_Garros-F-Roger_Federer-Rafael_Nadal,1,F-II,8,3,0,1,2,2,6,,,,,,,,,,
20110605-M-Roland_Garros-F-Roger_Federer-Rafael_Nadal,1,B-XC,61,14,1,3,10,29,32,,,,,,,,,,
20110605-M-Roland_Garros-F-Roger_Federer-Rafael_Nadal,1,B-DTM,54,4,0,0,4,19,35,,,,,,,,,,
20110605-M-Roland_Garros-F-Roger_Federer-Rafael_Nadal,1,B-DTL,30,9,3,1,5,14,16,,,,,,,,,,
20110605-M-Roland_Garros-F-Roger_Federer-Rafael_Nadal,1,B-IO,7,4,0,1,3,2,5,,,,,,,,,,
20110605-M-Roland_Garros-F-Roger_Federer-Rafael_Nadal,1,S-XC,8,0,0,0,0,1,7,,,,,,,,,,
20110605-M-Roland_Garros-F-Roger_Federer-Rafael_Nadal,1,S-DTM,11,1,0,0,1,5,6,,,,,,,,,,
20110605-M-Roland_Garros-F-Roger_Federer-Rafael_Nadal,1,S-DTL,10,0,0,0,0,7,3,,,,,,,,,,
20110605-M-Roland_Garros-F-Roger_Federer-Rafael_Nadal,1,S-IO,2,0,0,0,0,0,2,,,,,,,,,,
20110605-M-Roland_Garros-F-Roger_Federer-Rafael_Nadal,2,F-XC,150,21,2,8,11,78,72,,,,,,,,,,
20110605-M-Roland_Garros-F-Roger_Federer-Rafael_Nadal,2,F-DTM,39,2,0,1,1,22,17,,,,,,,,,,
20110605-M-Roland_Garros-F-Roger_Federer-Rafael_Nadal,2,F-DTL,22,14,5,6,3,16,6,,,,,,,,,,
20110605-M-Roland_Garros-F-Roger_Federer-Rafael_Nadal,2,F-IO,30,14,9,4,1,21,9,,,,,,,,,,
20110605-M-Roland_Garros-F-Roger_Federer-Rafael_Nadal,2,F-II,7,2,1,0,1,4,3,,,,,,,,,,
20110605-M-Roland_Garros-F-Roger_Federer-Rafael_Nadal,2,B-XC,55,17,8,2,7,28,27,,,,,,,,,,
20110605-M-Roland_Garros-F-Roger_Federer-Rafael_Nadal,2,B-DTM,75,2,0,0,2,35,40,,,,,,,,,,
20110605-M-Roland_Garros-F-Roger_Federer-Rafael_Nadal,2,B-DTL,24,3,0,2,1,15,9,,,,,,,,,,
20110605-M-Roland_Garros-F-Roger_Federer-Rafael_Nadal,2,B-IO,10,2,1,0,1,4,6,,,,,,,,,,
20110605-M-Roland_Garros-F-Roger_Federer-Rafael_Nadal,2,S-DTM,7,2,0,1,1,4,3,,,,,,,,,,
20110605-M-Roland_Garros-F-Roger_Federer-Rafael_Nadal,2,S-DTL,3,0,0,0,0,2,1,,,,,,,,,,
20110606-M-Queens_Club-SF-Andy_Murray-Andy_Roddick,1,F-XC,18,9,7,1,1,13,5,,,,,,,,,,
20110606-M-Queens_Club-SF-Andy_Murray-Andy_Roddick,1,F-DTM,10,2,0,0,2,4,6,,,,,,,,,,
20110606-M-Queens_Club-SF-Andy_Murray-Andy_Roddick,1,F-DTL,6,4,1,0,3,3,3,,,,,,,,,,
20110606-M-Queens_Club-SF-Andy_Murray-Andy_Roddick,1,F-IO,6,2,0,0,2,2,4,,,,,,,,,,
20110606-M-Queens_Club-SF-Andy_Murray-Andy_Roddick,1,F-II,1,1,1,0,0,1,0,,,,,,,,,,
20110606-M-Queens_Club-SF-Andy_Murray-Andy_Roddick,1,B-XC,17,2,1,0,1,11,6,,,,,,,,,,
20110606-M-Queens_Club-SF-Andy_Murray-Andy_Roddick,1,B-DTM,5,0,0,0,0,3,2,,,,,,,,,,
20110606-M-Queens_Club-SF-Andy_Murray-Andy_Roddick,1,B-DTL,4,2,2,0,0,2,2,,,,,,,,,,
20110606-M-Queens_Club-SF-Andy_Murray-Andy_Roddick,1,B-IO,3,1,1,0,0,2,1,,,,,,,,,,
20110606-M-Queens_Club-SF-Andy_Murray-Andy_Roddick,1,S-XC,29,0,0,0,0,23,6,,,,,,,,,,
20110606-M-Queens_Club-SF-Andy_Murray-Andy_Roddick,1,S-DTM,10,0,0,0,0,8,2,,,,,,,,,,
20110606-M-Queens_Club-SF-Andy_Murray-Andy_Roddick,1,S-DTL,5,0,0,0,0,3,2,,,,,,,,,,
20110606-M-Queens_Club-SF-Andy_Murray-Andy_Roddick,1,S-IO,6,1,0,0,1,5,1,,,,,,,,,,
20110606-M-Queens_Club-SF-Andy_Murray-Andy_Roddick,2,F-XC,20,3,0,0,3,5,15,,,,,,,,,,
20110606-M-Queens_Club-SF-Andy_Murray-Andy_Roddick,2,F-DTM,5,1,0,0,1,1,4,,,,,,,,,,
20110606-M-Queens_Club-SF-Andy_Murray-Andy_Roddick,2,F-DTL,7,1,0,1,0,6,1,,,,,,,,,,
20110606-M-Queens_Club-SF-Andy_Murray-Andy_Roddick,2,F-IO,31,5,2,1,2,9,22,,,,,,,,,,
20110606-M-Queens_Club-SF-Andy_Murray-Andy_Roddick,2,F-II,5,1,0,0,1,1,4,,,,,,,,,,
20110606-M-Queens_Club-SF-Andy_Murray-Andy_Roddick,2,B-XC,6,0,0,0,0,4,2,,,,,,,,,,
20110606-M-Queens_Club-SF-Andy_Murray-Andy_Roddick,2,B-DTM,5,1,0,0,1,1,4,,,,,,,,,,
20110606-M-Queens_Club-SF-Andy_Murray-Andy_Roddick,2,B-DTL,1,0,0,0,0,1,0,,,,,,,,,,
20110606-M-Queens_Club-SF-Andy_Murray-Andy_Roddick,2,B-IO,1,1,0,0,1,0,1,,,,,,,,,,
20110606-M-Queens_Club-SF-Andy_Murray-Andy_Roddick,2,S-XC,15,0,0,0,0,2,13,,,,,,,,,,
20110606-M-Queens_Club-SF-Andy_Murray-Andy_Roddick,2,S-DTM,10,0,0,0,0,3,7,,,,,,,,,,
20110606-M-Queens_Club-SF-Andy_Murray-Andy_Roddick,2,S-DTL,8,1,0,0,1,2,6,,,,,,,,,,
20110606-M-Queens_Club-SF-Andy_Murray-Andy_Roddick,2,S-IO,4,0,0,0,0,3,1,,,,,,,,,,
20110703-M-Wimbledon-F-Novak_Djokovic-Rafael_Nadal,1,F-XC,86,12,2,7,3,55,31,,,,,,,,,,
20110703-M-Wimbledon-F-Novak_Djokovic-Rafael_Nadal,1,F-DTM,19,0,0,0,0,11,8,,,,,,,,,,
20110703-M-Wimbledon-F-Novak_Djokovic-Rafael_Nadal,1,F-DTL,23,8,2,1,5,10,13,,,,,,,,,,
20110703-M-Wimbledon-F-Novak_Djokovic-Rafael_Nadal,1,F-IO,29,9,4,3,2,17,12,,,,,,,,,,
20110703-M-Wimbledon-F-Novak_Djokovic-Rafael_Nadal,1,F-II,6,2,0,2,0,5,1,,,,,,,,,,
20110703-M-Wimbledon-F-Novak_Djokovic-Rafael_Nadal,1,B-XC,33,2,1,1,0,19,14,,,,,,,,,,
20110703-M-Wimbledon-F-Novak_Djokovic-Rafael_Nadal,1,B-DTM,18,0,0,0,0,12,6,,,,,,,,,,
20110703-M-Wimbledon-F-Novak_Djokovic-Rafael_Nadal,1,B-DTL,20,2,0,1,1,11,9,,,,,,,,,,
20110703-M-Wimbledon-F-Novak_Djokovic-Rafael_Nadal,1,B-IO,5,1,0,0,1,4,1,,,,,,,,,,
20110703-M-Wimbledon-F-Novak_Djokovic-Rafael_Nadal,1,S-XC,2,1,1,0,0,1,1,,,,,,,,,,
20110703-M-Wimbledon-F-Novak_Djokovic-Rafael_Nadal,1,S-DTM,2,0,0,0,0,1,1,,,,,,,,,,
20110703-M-Wimbledon-F-Novak_Djokovic-Rafael_Nadal,1,S-DTL,2,0,0,0,0,0,2,,,,,,,,,,
20110703-M-Wimbledon-F-Novak_Djokovic-Rafael_Nadal,2,F-XC,59,13,1,7,5,31,28,,,,,,,,,,
20110703-M-Wimbledon-F-Novak_Djokovic-Rafael_Nadal,2,F-DTM,21,2,0,0,2,8,13,,,,,,,,,,
20110703-M-Wimbledon-F-Novak_Djokovic-Rafael_Nadal,2,F-DTL,22,8,4,2,2,12,10,,,,,,,,,,
20110703-M-Wimbledon-F-Novak_Djokovic-Rafael_Nadal,2,F-IO,32,7,2,2,3,12,20,,,,,,,,,,
20110703-M-Wimbledon-F-Novak_Djokovic-Rafael_Nadal,2,F-II,10,5,2,1,2,5,5,,,,,,,,,,
20110703-M-Wimbledon-F-Novak_Djokovic-Rafael_Nadal,2,B-XC,51,12,2,6,4,20,31,,,,,,,,,,
20110703-M-Wimbledon-F-Novak_Djokovic-Rafael_Nadal,2,B-DTM,19,5,0,1,4,7,12,,,,,,,,,,
20110703-M-Wimbledon-F-Novak_Djokovic-Rafael_Nadal,2,B-DTL,9,4,2,2,0,4,5,,,,,,,,,,
20110703-M-Wimbledon-F-Novak_Djokovic-Rafael_Nadal,2,B-IO,1,0,0,0,0,0,1,,,,,,,,,,
20110703-M-Wimbledon-F-Novak_Djokovic-Rafael_Nadal,2,S-XC,4,0,0,0,0,2,2,,,,,,,,,,
20110703-M-Wimbledon-F-Novak_Djokovic-Rafael_Nadal,2,S-DTM,19,1,0,0,1,6,13,,,,,,,,,,
20110703-M-Wimbledon-F-Novak_Djokovic-Rafael_Nadal,2,S-DTL,13,1,0,1,0,4,9,,,,,,,,,,
20110703-M-Wimbledon-F-Novak_Djokovic-Rafael_Nadal,2,S-IO,2,0,0,0,0,1,1,,,,,,,,,,
20110717-M-Bastad-F-David_Ferrer-Robin_Soderling,1,F-XC,32,4,1,0,3,8,24,,,,,,,,,,
20110717-M-Bastad-F-David_Ferrer-Robin_Soderling,1,F-DTM,17,0,0,0,0,5,12,,,,,,,,,,
20110717-M-Bastad-F-David_Ferrer-Robin_Soderling,1,F-DTL,12,1,0,0,1,4,8,,,,,,,,,,
20110717-M-Bastad-F-David_Ferrer-Robin_Soderling,1,F-IO,23,4,1,1,2,6,17,,,,,,,,,,
20110717-M-Bastad-F-David_Ferrer-Robin_Soderling,1,F-II,2,2,0,1,1,1,1,,,,,,,,,,
20110717-M-Bastad-F-David_Ferrer-Robin_Soderling,1,B-XC,49,6,1,1,4,14,35,,,,,,,,,,
20110717-M-Bastad-F-David_Ferrer-Robin_Soderling,1,B-DTM,34,0,0,0,0,9,25,,,,,,,,,,
20110717-M-Bastad-F-David_Ferrer-Robin_Soderling,1,B-DTL,3,1,1,0,0,1,2,,,,,,,,,,
20110717-M-Bastad-F-David_Ferrer-Robin_Soderling,1,S-XC,2,0,0,0,0,1,1,,,,,,,,,,
20110717-M-Bastad-F-David_Ferrer-Robin_Soderling,1,S-DTM,2,0,0,0,0,1,1,,,,,,,,,,
20110717-M-Bastad-F-David_Ferrer-Robin_Soderling,1,S-DTL,1,0,0,0,0,0,1,,,,,,,,,,
20110717-M-Bastad-F-David_Ferrer-Robin_Soderling,2,F-XC,27,11,5,4,2,21,6,,,,,,,,,,
20110717-M-Bastad-F-David_Ferrer-Robin_Soderling,2,F-DTM,11,0,0,0,0,7,4,,,,,,,,,,
20110717-M-Bastad-F-David_Ferrer-Robin_Soderling,2,F-DTL,9,2,2,0,0,7,2,,,,,,,,,,
20110717-M-Bastad-F-David_Ferrer-Robin_Soderling,2,F-IO,31,7,3,1,3,21,10,,,,,,,,,,
20110717-M-Bastad-F-David_Ferrer-Robin_Soderling,2,F-II,2,1,0,0,1,1,1,,,,,,,,,,
20110717-M-Bastad-F-David_Ferrer-Robin_Soderling,2,B-XC,37,6,1,0,5,25,12,,,,,,,,,,
20110717-M-Bastad-F-David_Ferrer-Robin_Soderling,2,B-DTM,21,1,0,0,1,17,4,,,,,,,,,,
20110717-M-Bastad-F-David_Ferrer-Robin_Soderling,2,B-DTL,27,11,5,0,6,18,9,,,,,,,,,,
20110717-M-Bastad-F-David_Ferrer-Robin_Soderling,2,B-IO,6,2,1,0,1,5,1,,,,,,,,,,
20110717-M-Bastad-F-David_Ferrer-Robin_Soderling,2,S-XC,4,0,0,0,0,3,1,,,,,,,,,,
20110717-M-Bastad-F-David_Ferrer-Robin_Soderling,2,S-DTM,3,0,0,0,0,2,1,,,,,,,,,,
20111008-M-Tokyo-SF-David_Ferrer-Andy_Murray,1,F-XC,68,7,1,0,6,18,50,,,,,,,,,,
20111008-M-Tokyo-SF-David_Ferrer-Andy_Murray,1,F-DTM,15,0,0,0,0,2,13,,,,,,,,,,
20111008-M-Tokyo-SF-David_Ferrer-Andy_Murray,1,F-DTL,16,1,0,0,1,4,12,,,,,,,,,,
20111008-M-Tokyo-SF-David_Ferrer-Andy_Murray,1,F-IO,36,6,1,3,2,16,20,,,,,,,,,,
20111008-M-Tokyo-SF-David_Ferrer-Andy_Murray,1,F-II,10,2,0,0,2,1,9,,,,,,,,,,
20111008-M-Tokyo-SF-David_Ferrer-Andy_Murray,1,B-XC,51,3,0,0,3,11,40,,,,,,,,,,
20111008-M-Tokyo-SF-David_Ferrer-Andy_Murray,1,B-DTM,21,3,0,0,3,4,17,,,,,,,,,,
20111008-M-Tokyo-SF-David_Ferrer-Andy_Murray,1,B-DTL,4,1,1,0,0,2,2,,,,,,,,,,
20111008-M-Tokyo-SF-David_Ferrer-Andy_Murray,1,S-XC,1,0,0,0,0,0,1,,,,,,,,,,
20111008-M-Tokyo-SF-David_Ferrer-Andy_Murray,1,S-DTM,5,0,0,0,0,0,5,,,,,,,,,,
20111008-M-Tokyo-SF-David_Ferrer-Andy_Murray,1,S-IO,1,0,0,0,0,0,1,,,,,,,,,,
20111008-M-Tokyo-SF-David_Ferrer-Andy_Murray,2,F-XC,50,6,3,1,2,37,13,,,,,,,,,,
20111008-M-Tokyo-SF-David_Ferrer-Andy_Murray,2,F-DTM,14,1,0,0,1,8,6,,,,,,,,,,
20111008-M-Tokyo-SF-David_Ferrer-Andy_Murray,2,F-DTL,23,6,1,2,3,17,6,,,,,,,,,,
20111008-M-Tokyo-SF-David_Ferrer-Andy_Murray,2,F-IO,14,3,3,0,0,11,3,,,,,,,,,,
20111008-M-Tokyo-SF-David_Ferrer-Andy_Murray,2,F-II,1,0,0,0,0,0,1,,,,,,,,,,
20111008-M-Tokyo-SF-David_Ferrer-Andy_Murray,2,B-XC,50,6,0,2,4,41,9,,,,,,,,,,
20111008-M-Tokyo-SF-David_Ferrer-Andy_Murray,2,B-DTM,20,1,0,0,1,15,5,,,,,,,,,,
20111008-M-Tokyo-SF-David_Ferrer-Andy_Murray,2,B-DTL,12,7,3,1,3,8,4,,,,,,,,,,
20111008-M-Tokyo-SF-David_Ferrer-Andy_Murray,2,B-IO,4,1,1,0,0,4,0,,,,,,,,,,
20111008-M-Tokyo-SF-David_Ferrer-Andy_Murray,2,S-XC,16,1,0,0,1,9,7,,,,,,,,,,
20111008-M-Tokyo-SF-David_Ferrer-Andy_Murray,2,S-DTM,9,0,0,0,0,5,4,,,,,,,,,,
20111008-M-Tokyo-SF-David_Ferrer-Andy_Murray,2,S-DTL,8,1,0,0,1,5,3,,,,,,,,,,
20111008-M-Tokyo-SF-David_Ferrer-Andy_Murray,2,S-IO,2,0,0,0,0,2,0,,,,,,,,,,
20111009-M-Shanghai_Masters-R32-David_Ferrer-Milos_Raonic,1,F-XC,33,12,2,4,6,17,16,,,,,,,,,,
20111009-M-Shanghai_Masters-R32-David_Ferrer-Milos_Raonic,1,F-DTM,9,0,0,0,0,4,5,,,,,,,,,,
20111009-M-Shanghai_Masters-R32-David_Ferrer-Milos_Raonic,1,F-DTL,9,2,0,0,2,2,7,,,,,,,,,,
20111009-M-Shanghai_Masters-R32-David_Ferrer-Milos_Raonic,1,F-IO,28,3,1,0,2,19,9,,,,,,,,,,
20111009-M-Shanghai_Masters-R32-David_Ferrer-Milos_Raonic,1,F-II,3,2,1,0,1,2,1,,,,,,,,,,
20111009-M-Shanghai_Masters-R32-David_Ferrer-Milos_Raonic,1,B-XC,41,5,0,0,5,26,15,,,,,,,,,,
20111009-M-Shanghai_Masters-R32-David_Ferrer-Milos_Raonic,1,B-DTM,18,2,0,0,2,12,6,,,,,,,,,,
20111009-M-Shanghai_Masters-R32-David_Ferrer-Milos_Raonic,1,B-DTL,1,0,0,0,0,1,0,,,,,,,,,,
20111009-M-Shanghai_Masters-R32-David_Ferrer-Milos_Raonic,1,S-XC,1,0,0,0,0,0,1,,,,,,,,,,
20111009-M-Shanghai_Masters-R32-David_Ferrer-Milos_Raonic,1,S-DTM,1,0,0,0,0,0,1,,,,,,,,,,
20111009-M-Shanghai_Masters-R32-David_Ferrer-Milos_Raonic,1,S-DTL,2,0,0,0,0,1,1,,,,,,,,,,
20111009-M-Shanghai_Masters-R32-David_Ferrer-Milos_Raonic,2,F-XC,31,15,5,5,5,18,13,,,,,,,,,,
20111009-M-Shanghai_Masters-R32-David_Ferrer-Milos_Raonic,2,F-DTM,7,1,1,0,0,4,3,,,,,,,,,,
20111009-M-Shanghai_Masters-R32-David_Ferrer-Milos_Raonic,2,F-DTL,11,4,2,0,2,3,8,,,,,,,,,,
20111009-M-Shanghai_Masters-R32-David_Ferrer-Milos_Raonic,2,F-IO,44,16,5,0,11,17,27,,,,,,,,,,
20111009-M-Shanghai_Masters-R32-David_Ferrer-Milos_Raonic,2,F-II,7,2,0,0,2,1,6,,,,,,,,,,
20111009-M-Shanghai_Masters-R32-David_Ferrer-Milos_Raonic,2,B-XC,22,2,0,0,2,6,16,,,,,,,,,,
20111009-M-Shanghai_Masters-R32-David_Ferrer-Milos_Raonic,2,B-DTM,15,5,0,0,5,5,10,,,,,,,,,,
20111009-M-Shanghai_Masters-R32-David_Ferrer-Milos_Raonic,2,B-DTL,7,2,1,0,1,5,2,,,,,,,,,,
20111009-M-Shanghai_Masters-R32-David_Ferrer-Milos_Raonic,2,B-IO,2,1,0,0,1,1,1,,,,,,,,,,
20111009-M-Shanghai_Masters-R32-David_Ferrer-Milos_Raonic,2,S-XC,7,1,0,0,1,0,7,,,,,,,,,,
20111009-M-Shanghai_Masters-R32-David_Ferrer-Milos_Raonic,2,S-DTM,3,1,0,0,1,0,3,,,,,,,,,,
20111009-M-Shanghai_Masters-R32-David_Ferrer-Milos_Raonic,2,S-DTL,4,1,0,0,1,2,2,,,,,,,,,,
20111021-M-Stockholm-QF-Grigor_Dimitrov-Milos_Raonic,1,F-XC,34,10,1,4,5,19,15,,,,,,,,,,
20111021-M-Stockholm-QF-Grigor_Dimitrov-Milos_Raonic,1,F-DTM,13,1,0,0,1,8,5,,,,,,,,,,
20111021-M-Stockholm-QF-Grigor_Dimitrov-Milos_Raonic,1,F-DTL,6,2,0,1,1,3,3,,,,,,,,,,
20111021-M-Stockholm-QF-Grigor_Dimitrov-Milos_Raonic,1,F-IO,12,4,1,2,1,7,5,,,,,,,,,,
20111021-M-Stockholm-QF-Grigor_Dimitrov-Milos_Raonic,1,F-II,3,2,0,1,1,2,1,,,,,,,,,,
20111021-M-Stockholm-QF-Grigor_Dimitrov-Milos_Raonic,1,B-XC,20,2,0,0,2,9,11,,,,,,,,,,
20111021-M-Stockholm-QF-Grigor_Dimitrov-Milos_Raonic,1,B-DTM,15,3,0,1,2,7,8,,,,,,,,,,
20111021-M-Stockholm-QF-Grigor_Dimitrov-Milos_Raonic,1,B-DTL,5,2,0,1,1,2,3,,,,,,,,,,
20111021-M-Stockholm-QF-Grigor_Dimitrov-Milos_Raonic,1,B-IO,1,0,0,0,0,1,0,,,,,,,,,,
20111021-M-Stockholm-QF-Grigor_Dimitrov-Milos_Raonic,1,S-XC,9,0,0,0,0,3,6,,,,,,,,,,
20111021-M-Stockholm-QF-Grigor_Dimitrov-Milos_Raonic,2,F-XC,15,6,2,2,2,9,6,,,,,,,,,,
20111021-M-Stockholm-QF-Grigor_Dimitrov-Milos_Raonic,2,F-DTM,13,0,0,0,0,2,11,,,,,,,,,,
20111021-M-Stockholm-QF-Grigor_Dimitrov-Milos_Raonic,2,F-DTL,15,3,2,0,1,8,7,,,,,,,,,,
20111021-M-Stockholm-QF-Grigor_Dimitrov-Milos_Raonic,2,F-IO,22,5,0,1,4,11,11,,,,,,,,,,
20111021-M-Stockholm-QF-Grigor_Dimitrov-Milos_Raonic,2,F-II,5,4,1,2,1,4,1,,,,,,,,,,
20111021-M-Stockholm-QF-Grigor_Dimitrov-Milos_Raonic,2,B-XC,2,0,0,0,0,1,1,,,,,,,,,,
20111021-M-Stockholm-QF-Grigor_Dimitrov-Milos_Raonic,2,B-DTM,11,2,0,0,2,8,3,,,,,,,,,,
20111021-M-Stockholm-QF-Grigor_Dimitrov-Milos_Raonic,2,B-DTL,4,3,0,0,3,1,3,,,,,,,,,,
20111021-M-Stockholm-QF-Grigor_Dimitrov-Milos_Raonic,2,B-IO,2,2,1,0,1,1,1,,,,,,,,,,
20111021-M-Stockholm-QF-Grigor_Dimitrov-Milos_Raonic,2,S-XC,13,1,0,1,0,7,6,,,,,,,,,,
20111021-M-Stockholm-QF-Grigor_Dimitrov-Milos_Raonic,2,S-DTM,5,0,0,0,0,2,3,,,,,,,,,,
20111021-M-Stockholm-QF-Grigor_Dimitrov-Milos_Raonic,2,S-DTL,2,0,0,0,0,2,0,,,,,,,,,,
20111021-M-Stockholm-QF-Grigor_Dimitrov-Milos_Raonic,2,S-IO,2,0,0,0,0,0,2,,,,,,,,,,
20111122-M-Tour_Finals-RR-Roger_Federer-Rafael_Nadal,1,F-XC,38,11,5,2,4,29,9,,,,,,,,,,
20111122-M-Tour_Finals-RR-Roger_Federer-Rafael_Nadal,1,F-DTM,16,0,0,0,0,9,7,,,,,,,,,,
20111122-M-Tour_Finals-RR-Roger_Federer-Rafael_Nadal,1,F-DTL,7,4,4,0,0,7,0,,,,,,,,,,
20111122-M-Tour_Finals-RR-Roger_Federer-Rafael_Nadal,1,F-IO,11,7,6,1,0,10,1,,,,,,,,,,
20111122-M-Tour_Finals-RR-Roger_Federer-Rafael_Nadal,1,F-II,4,1,0,1,0,4,0,,,,,,,,,,
20111122-M-Tour_Finals-RR-Roger_Federer-Rafael_Nadal,1,B-XC,18,7,2,1,4,10,8,,,,,,,,,,
20111122-M-Tour_Finals-RR-Roger_Federer-Rafael_Nadal,1,B-DTM,14,1,0,0,1,11,3,,,,,,,,,,
20111122-M-Tour_Finals-RR-Roger_Federer-Rafael_Nadal,1,B-DTL,7,1,1,0,0,6,1,,,,,,,,,,
20111122-M-Tour_Finals-RR-Roger_Federer-Rafael_Nadal,1,B-IO,4,0,0,0,0,4,0,,,,,,,,,,
20111122-M-Tour_Finals-RR-Roger_Federer-Rafael_Nadal,1,S-XC,3,0,0,0,0,3,0,,,,,,,,,,
20111122-M-Tour_Finals-RR-Roger_Federer-Rafael_Nadal,1,S-DTM,1,0,0,0,0,0,1,,,,,,,,,,
20111122-M-Tour_Finals-RR-Roger_Federer-Rafael_Nadal,1,S-DTL,9,0,0,0,0,7,2,,,,,,,,,,
20111122-M-Tour_Finals-RR-Roger_Federer-Rafael_Nadal,2,F-XC,27,2,0,1,1,11,16,,,,,,,,,,
20111122-M-Tour_Finals-RR-Roger_Federer-Rafael_Nadal,2,F-DTM,23,3,0,0,3,6,17,,,,,,,,,,
20111122-M-Tour_Finals-RR-Roger_Federer-Rafael_Nadal,2,F-DTL,6,2,0,1,1,4,2,,,,,,,,,,
20111122-M-Tour_Finals-RR-Roger_Federer-Rafael_Nadal,2,F-IO,15,4,2,0,2,3,12,,,,,,,,,,
20111122-M-Tour_Finals-RR-Roger_Federer-Rafael_Nadal,2,F-II,2,0,0,0,0,0,2,,,,,,,,,,
20111122-M-Tour_Finals-RR-Roger_Federer-Rafael_Nadal,2,B-XC,14,4,0,0,4,1,13,,,,,,,,,,
20111122-M-Tour_Finals-RR-Roger_Federer-Rafael_Nadal,2,B-DTM,22,1,0,0,1,4,18,,,,,,,,,,
20111122-M-Tour_Finals-RR-Roger_Federer-Rafael_Nadal,2,B-DTL,12,3,1,0,2,3,9,,,,,,,,,,
20111122-M-Tour_Finals-RR-Roger_Federer-Rafael_Nadal,2,B-IO,2,0,0,0,0,1,1,,,,,,,,,,
20111122-M-Tour_Finals-RR-Roger_Federer-Rafael_Nadal,2,S-XC,1,0,0,0,0,1,0,,,,,,,,,,
20111122-M-Tour_Finals-RR-Roger_Federer-Rafael_Nadal,2,S-DTM,2,0,0,0,0,0,2,,,,,,,,,,
20111122-M-Tour_Finals-RR-Roger_Federer-Rafael_Nadal,2,S-DTL,3,0,0,0,0,0,3,,,,,,,,,,
20111125-M-Tour_Finals-SF-David_Ferrer-Roger_Federer,1,F-XC,24,6,1,3,2,11,13,,,,,,,,,,
20111125-M-Tour_Finals-SF-David_Ferrer-Roger_Federer,1,F-DTM,21,0,0,0,0,10,11,,,,,,,,,,
20111125-M-Tour_Finals-SF-David_Ferrer-Roger_Federer,1,F-DTL,11,2,0,1,1,4,7,,,,,,,,,,
20111125-M-Tour_Finals-SF-David_Ferrer-Roger_Federer,1,F-IO,66,7,0,3,4,41,25,,,,,,,,,,
20111125-M-Tour_Finals-SF-David_Ferrer-Roger_Federer,1,F-II,6,3,1,1,1,3,3,,,,,,,,,,
20111125-M-Tour_Finals-SF-David_Ferrer-Roger_Federer,1,B-XC,33,2,0,0,2,17,16,,,,,,,,,,
20111125-M-Tour_Finals-SF-David_Ferrer-Roger_Federer,1,B-DTM,16,3,0,0,3,7,9,,,,,,,,,,
20111125-M-Tour_Finals-SF-David_Ferrer-Roger_Federer,1,B-DTL,3,1,1,0,0,2,1,,,,,,,,,,
20111125-M-Tour_Finals-SF-David_Ferrer-Roger_Federer,1,S-XC,3,0,0,0,0,3,0,,,,,,,,,,
20111125-M-Tour_Finals-SF-David_Ferrer-Roger_Federer,1,S-DTM,4,1,0,0,1,2,2,,,,,,,,,,
20111125-M-Tour_Finals-SF-David_Ferrer-Roger_Federer,1,S-DTL,3,0,0,0,0,1,2,,,,,,,,,,
20111125-M-Tour_Finals-SF-David_Ferrer-Roger_Federer,1,S-IO,1,0,0,0,0,1,0,,,,,,,,,,
20111125-M-Tour_Finals-SF-David_Ferrer-Roger_Federer,2,F-XC,30,8,2,3,3,19,11,,,,,,,,,,
20111125-M-Tour_Finals-SF-David_Ferrer-Roger_Federer,2,F-DTM,17,3,0,0,3,6,11,,,,,,,,,,
20111125-M-Tour_Finals-SF-David_Ferrer-Roger_Federer,2,F-DTL,8,2,0,2,0,5,3,,,,,,,,,,
20111125-M-Tour_Finals-SF-David_Ferrer-Roger_Federer,2,F-IO,22,8,0,2,6,10,12,,,,,,,,,,
20111125-M-Tour_Finals-SF-David_Ferrer-Roger_Federer,2,F-II,6,3,1,2,0,4,2,,,,,,,,,,
20111125-M-Tour_Finals-SF-David_Ferrer-Roger_Federer,2,B-XC,27,6,0,1,5,15,12,,,,,,,,,,
20111125-M-Tour_Finals-SF-David_Ferrer-Roger_Federer,2,B-DTM,29,5,0,1,4,13,16,,,,,,,,,,
20111125-M-Tour_Finals-SF-David_Ferrer-Roger_Federer,2,B-DTL,8,5,0,2,3,5,3,,,,,,,,,,
20111125-M-Tour_Finals-SF-David_Ferrer-Roger_Federer,2,B-IO,2,2,0,1,1,1,1,,,,,,,,,,
20111125-M-Tour_Finals-SF-David_Ferrer-Roger_Federer,2,S-XC,23,0,0,0,0,4,19,,,,,,,,,,
20111125-M-Tour_Finals-SF-David_Ferrer-Roger_Federer,2,S-DTM,7,1,0,0,1,2,5,,,,,,,,,,
20111125-M-Tour_Finals-SF-David_Ferrer-Roger_Federer,2,S-DTL,4,1,0,1,0,3,1,,,,,,,,,,
20120108-M-Chennai-F-Milos_Raonic-Janko_Tipsarevic,1,F-XC,30,15,5,3,7,16,14,,,,,,,,,,
20120108-M-Chennai-F-Milos_Raonic-Janko_Tipsarevic,1,F-DTM,20,4,0,1,3,9,11,,,,,,,,,,
20120108-M-Chennai-F-Milos_Raonic-Janko_Tipsarevic,1,F-DTL,17,5,1,3,1,10,7,,,,,,,,,,
20120108-M-Chennai-F-Milos_Raonic-Janko_Tipsarevic,1,F-IO,56,15,6,2,7,29,27,,,,,,,,,,
20120108-M-Chennai-F-Milos_Raonic-Janko_Tipsarevic,1,F-II,19,10,6,2,2,15,4,,,,,,,,,,
20120108-M-Chennai-F-Milos_Raonic-Janko_Tipsarevic,1,B-XC,38,5,1,0,4,16,22,,,,,,,,,,
20120108-M-Chennai-F-Milos_Raonic-Janko_Tipsarevic,1,B-DTM,17,1,0,0,1,11,6,,,,,,,,,,
20120108-M-Chennai-F-Milos_Raonic-Janko_Tipsarevic,1,B-DTL,11,9,2,0,7,3,8,,,,,,,,,,
20120108-M-Chennai-F-Milos_Raonic-Janko_Tipsarevic,1,B-IO,2,1,1,0,0,1,1,,,,,,,,,,
20120108-M-Chennai-F-Milos_Raonic-Janko_Tipsarevic,1,B-II,1,0,0,0,0,0,1,,,,,,,,,,
20120108-M-Chennai-F-Milos_Raonic-Janko_Tipsarevic,1,S-XC,18,3,0,0,3,5,13,,,,,,,,,,
20120108-M-Chennai-F-Milos_Raonic-Janko_Tipsarevic,1,S-DTM,2,2,0,0,2,0,2,,,,,,,,,,
20120108-M-Chennai-F-Milos_Raonic-Janko_Tipsarevic,1,S-DTL,2,0,0,0,0,0,2,,,,,,,,,,
20120108-M-Chennai-F-Milos_Raonic-Janko_Tipsarevic,2,F-XC,27,7,0,2,5,12,15,,,,,,,,,,
20120108-M-Chennai-F-Milos_Raonic-Janko_Tipsarevic,2,F-DTM,21,1,0,0,1,11,10,,,,,,,,,,
20120108-M-Chennai-F-Milos_Raonic-Janko_Tipsarevic,2,F-DTL,19,6,3,1,2,11,8,,,,,,,,,,
20120108-M-Chennai-F-Milos_Raonic-Janko_Tipsarevic,2,F-IO,35,4,2,1,1,20,15,,,,,,,,,,
20120108-M-Chennai-F-Milos_Raonic-Janko_Tipsarevic,2,F-II,6,3,1,2,0,5,1,,,,,,,,,,
20120108-M-Chennai-F-Milos_Raonic-Janko_Tipsarevic,2,B-XC,72,8,3,3,2,39,33,,,,,,,,,,
20120108-M-Chennai-F-Milos_Raonic-Janko_Tipsarevic,2,B-DTM,25,2,0,0,2,10,15,,,,,,,,,,
20120108-M-Chennai-F-Milos_Raonic-Janko_Tipsarevic,2,B-DTL,20,8,4,2,2,10,10,,,,,,,,,,
20120108-M-Chennai-F-Milos_Raonic-Janko_Tipsarevic,2,B-IO,2,0,0,0,0,1,1,,,,,,,,,,
20120108-M-Chennai-F-Milos_Raonic-Janko_Tipsarevic,2,S-XC,7,0,0,0,0,6,1,,,,,,,,,,
20120108-M-Chennai-F-Milos_Raonic-Janko_Tipsarevic,2,S-DTM,6,0,0,0,0,2,4,,,,,,,,,,
20120108-M-Chennai-F-Milos_Raonic-Janko_Tipsarevic,2,S-DTL,2,1,0,0,1,1,1,,,,,,,,,,
20120124-M-Australian_Open-QF-David_Ferrer-Novak_Djokovic,1,F-XC,123,20,3,6,11,56,67,,,,,,,,,,
20120124-M-Australian_Open-QF-David_Ferrer-Novak_Djokovic,1,F-DTM,45,2,0,0,2,16,29,,,,,,,,,,
20120124-M-Australian_Open-QF-David_Ferrer-Novak_Djokovic,1,F-DTL,42,9,2,3,4,14,28,,,,,,,,,,
20120124-M-Australian_Open-QF-David_Ferrer-Novak_Djokovic,1,F-IO,76,13,3,2,8,37,39,,,,,,,,,,
20120124-M-Australian_Open-QF-David_Ferrer-Novak_Djokovic,1,F-II,13,1,0,1,0,5,8,,,,,,,,,,
20120124-M-Australian_Open-QF-David_Ferrer-Novak_Djokovic,1,B-XC,136,8,1,0,7,61,75,,,,,,,,,,
20120124-M-Australian_Open-QF-David_Ferrer-Novak_Djokovic,1,B-DTM,53,1,0,0,1,22,31,,,,,,,,,,
20120124-M-Australian_Open-QF-David_Ferrer-Novak_Djokovic,1,B-DTL,13,7,1,4,2,10,3,,,,,,,,,,
20120124-M-Australian_Open-QF-David_Ferrer-Novak_Djokovic,1,B-IO,3,0,0,0,0,3,0,,,,,,,,,,
20120124-M-Australian_Open-QF-David_Ferrer-Novak_Djokovic,1,S-XC,11,0,0,0,0,4,7,,,,,,,,,,
20120124-M-Australian_Open-QF-David_Ferrer-Novak_Djokovic,1,S-DTM,10,0,0,0,0,1,9,,,,,,,,,,
20120124-M-Australian_Open-QF-David_Ferrer-Novak_Djokovic,1,S-DTL,4,0,0,0,0,2,2,,,,,,,,,,
20120124-M-Australian_Open-QF-David_Ferrer-Novak_Djokovic,2,F-XC,93,16,6,6,4,59,34,,,,,,,,,,
20120124-M-Australian_Open-QF-David_Ferrer-Novak_Djokovic,2,F-DTM,39,1,0,0,1,19,20,,,,,,,,,,
20120124-M-Australian_Open-QF-David_Ferrer-Novak_Djokovic,2,F-DTL,38,13,6,3,4,21,17,,,,,,,,,,
20120124-M-Australian_Open-QF-David_Ferrer-Novak_Djokovic,2,F-IO,55,13,4,5,4,37,18,,,,,,,,,,
20120124-M-Australian_Open-QF-David_Ferrer-Novak_Djokovic,2,F-II,14,5,1,1,3,10,4,,,,,,,,,,
20120124-M-Australian_Open-QF-David_Ferrer-Novak_Djokovic,2,B-XC,148,9,2,2,5,81,67,,,,,,,,,,
20120124-M-Australian_Open-QF-David_Ferrer-Novak_Djokovic,2,B-DTM,68,5,0,0,5,32,36,,,,,,,,,,
20120124-M-Australian_Open-QF-David_Ferrer-Novak_Djokovic,2,B-DTL,43,11,7,1,3,27,16,,,,,,,,,,
20120124-M-Australian_Open-QF-David_Ferrer-Novak_Djokovic,2,B-IO,9,1,0,0,1,4,5,,,,,,,,,,
20120124-M-Australian_Open-QF-David_Ferrer-Novak_Djokovic,2,S-XC,13,2,2,0,0,9,4,,,,,,,,,,
20120124-M-Australian_Open-QF-David_Ferrer-Novak_Djokovic,2,S-DTM,4,0,0,0,0,3,1,,,,,,,,,,
20120124-M-Australian_Open-QF-David_Ferrer-Novak_Djokovic,2,S-DTL,2,0,0,0,0,0,2,,,,,,,,,,
20120125-M-Australian_Open-QF-Andy_Murray-Kei_Nishikori,1,F-XC,63,17,5,9,3,40,23,,,,,,,,,,
20120125-M-Australian_Open-QF-Andy_Murray-Kei_Nishikori,1,F-DTM,11,0,0,0,0,6,5,,,,,,,,,,
20120125-M-Australian_Open-QF-Andy_Murray-Kei_Nishikori,1,F-DTL,15,5,0,1,4,7,8,,,,,,,,,,
20120125-M-Australian_Open-QF-Andy_Murray-Kei_Nishikori,1,F-IO,22,6,2,4,0,16,6,,,,,,,,,,
20120125-M-Australian_Open-QF-Andy_Murray-Kei_Nishikori,1,F-II,3,1,0,1,0,2,1,,,,,,,,,,
20120125-M-Australian_Open-QF-Andy_Murray-Kei_Nishikori,1,B-XC,76,11,3,4,4,56,20,,,,,,,,,,
20120125-M-Australian_Open-QF-Andy_Murray-Kei_Nishikori,1,B-DTM,16,1,0,0,1,10,6,,,,,,,,,,
20120125-M-Australian_Open-QF-Andy_Murray-Kei_Nishikori,1,B-DTL,13,3,0,0,3,4,9,,,,,,,,,,
20120125-M-Australian_Open-QF-Andy_Murray-Kei_Nishikori,1,B-IO,4,3,0,3,0,4,0,,,,,,,,,,
20120125-M-Australian_Open-QF-Andy_Murray-Kei_Nishikori,1,S-XC,23,0,0,0,0,18,5,,,,,,,,,,
20120125-M-Australian_Open-QF-Andy_Murray-Kei_Nishikori,1,S-DTM,22,0,0,0,0,12,10,,,,,,,,,,
20120125-M-Australian_Open-QF-Andy_Murray-Kei_Nishikori,1,S-DTL,11,2,1,0,1,9,2,,,,,,,,,,
20120125-M-Australian_Open-QF-Andy_Murray-Kei_Nishikori,2,F-XC,52,12,4,4,4,27,25,,,,,,,,,,
20120125-M-Australian_Open-QF-Andy_Murray-Kei_Nishikori,2,F-DTM,18,0,0,0,0,10,8,,,,,,,,,,
20120125-M-Australian_Open-QF-Andy_Murray-Kei_Nishikori,2,F-DTL,28,6,0,2,4,9,19,,,,,,,,,,
20120125-M-Australian_Open-QF-Andy_Murray-Kei_Nishikori,2,F-IO,25,4,2,0,2,12,13,,,,,,,,,,
20120125-M-Australian_Open-QF-Andy_Murray-Kei_Nishikori,2,F-II,1,0,0,0,0,1,0,,,,,,,,,,
20120125-M-Australian_Open-QF-Andy_Murray-Kei_Nishikori,2,B-XC,97,17,4,2,11,27,70,,,,,,,,,,
20120125-M-Australian_Open-QF-Andy_Murray-Kei_Nishikori,2,B-DTM,29,1,0,0,1,6,23,,,,,,,,,,
20120125-M-Australian_Open-QF-Andy_Murray-Kei_Nishikori,2,B-DTL,15,2,0,0,2,4,11,,,,,,,,,,
20120125-M-Australian_Open-QF-Andy_Murray-Kei_Nishikori,2,B-IO,4,3,2,1,0,3,1,,,,,,,,,,
20120125-M-Australian_Open-QF-Andy_Murray-Kei_Nishikori,2,S-XC,11,0,0,0,0,3,8,,,,,,,,,,
20120125-M-Australian_Open-QF-Andy_Murray-Kei_Nishikori,2,S-DTM,11,0,0,0,0,1,10,,,,,,,,,,
20120125-M-Australian_Open-QF-Andy_Murray-Kei_Nishikori,2,S-DTL,2,0,0,0,0,1,1,,,,,,,,,,
20120127-M-Australian_Open-SF-Novak_Djokovic-Andy_Murray,1,F-XC,148,16,2,6,8,70,78,,,,,,,,,,
20120127-M-Australian_Open-SF-Novak_Djokovic-Andy_Murray,1,F-DTM,68,4,0,0,4,33,35,,,,,,,,,,
20120127-M-Australian_Open-SF-Novak_Djokovic-Andy_Murray,1,F-DTL,59,14,4,3,7,20,39,,,,,,,,,,
20120127-M-Australian_Open-SF-Novak_Djokovic-Andy_Murray,1,F-IO,71,10,7,0,3,41,30,,,,,,,,,,
20120127-M-Australian_Open-SF-Novak_Djokovic-Andy_Murray,1,F-II,19,8,2,4,2,9,10,,,,,,,,,,
20120127-M-Australian_Open-SF-Novak_Djokovic-Andy_Murray,1,B-XC,163,16,3,6,7,80,83,,,,,,,,,,
20120127-M-Australian_Open-SF-Novak_Djokovic-Andy_Murray,1,B-DTM,121,1,0,0,1,55,66,,,,,,,,,,
20120127-M-Australian_Open-SF-Novak_Djokovic-Andy_Murray,1,B-DTL,63,15,3,2,10,28,35,,,,,,,,,,
20120127-M-Australian_Open-SF-Novak_Djokovic-Andy_Murray,1,B-IO,18,6,1,2,3,10,8,,,,,,,,,,
20120127-M-Australian_Open-SF-Novak_Djokovic-Andy_Murray,1,S-XC,19,1,0,0,1,12,7,,,,,,,,,,
20120127-M-Australian_Open-SF-Novak_Djokovic-Andy_Murray,1,S-DTM,29,2,0,1,1,11,18,,,,,,,,,,
20120127-M-Australian_Open-SF-Novak_Djokovic-Andy_Murray,1,S-DTL,7,2,0,1,1,2,5,,,,,,,,,,
20120127-M-Australian_Open-SF-Novak_Djokovic-Andy_Murray,2,F-XC,218,38,15,4,19,125,93,,,,,,,,,,
20120127-M-Australian_Open-SF-Novak_Djokovic-Andy_Murray,2,F-DTM,56,3,0,0,3,29,27,,,,,,,,,,
20120127-M-Australian_Open-SF-Novak_Djokovic-Andy_Murray,2,F-DTL,50,9,2,3,4,20,30,,,,,,,,,,
20120127-M-Australian_Open-SF-Novak_Djokovic-Andy_Murray,2,F-IO,76,14,3,3,8,43,33,,,,,,,,,,
20120127-M-Australian_Open-SF-Novak_Djokovic-Andy_Murray,2,F-II,3,0,0,0,0,1,2,,,,,,,,,,
20120127-M-Australian_Open-SF-Novak_Djokovic-Andy_Murray,2,B-XC,190,17,1,3,13,100,90,,,,,,,,,,
20120127-M-Australian_Open-SF-Novak_Djokovic-Andy_Murray,2,B-DTM,51,6,0,0,6,21,30,,,,,,,,,,
20120127-M-Australian_Open-SF-Novak_Djokovic-Andy_Murray,2,B-DTL,28,10,1,4,5,16,12,,,,,,,,,,
20120127-M-Australian_Open-SF-Novak_Djokovic-Andy_Murray,2,B-IO,12,5,2,0,3,6,6,,,,,,,,,,
20120127-M-Australian_Open-SF-Novak_Djokovic-Andy_Murray,2,S-XC,68,2,0,0,2,32,36,,,,,,,,,,
20120127-M-Australian_Open-SF-Novak_Djokovic-Andy_Murray,2,S-DTM,18,2,0,0,2,6,12,,,,,,,,,,
20120127-M-Australian_Open-SF-Novak_Djokovic-Andy_Murray,2,S-DTL,9,2,0,1,1,4,5,,,,,,,,,,
20120127-M-Australian_Open-SF-Novak_Djokovic-Andy_Murray,2,S-IO,4,1,0,0,1,3,1,,,,,,,,,,
20120127-M-Australian_Open-SF-Roger_Federer-Rafael_Nadal,1,F-XC,119,25,1,9,15,66,53,,,,,,,,,,
20120127-M-Australian_Open-SF-Roger_Federer-Rafael_Nadal,1,F-DTM,22,1,1,0,0,12,10,,,,,,,,,,
20120127-M-Australian_Open-SF-Roger_Federer-Rafael_Nadal,1,F-DTL,33,14,5,1,8,11,22,,,,,,,,,,
20120127-M-Australian_Open-SF-Roger_Federer-Rafael_Nadal,1,F-IO,33,13,6,5,2,21,12,,,,,,,,,,
20120127-M-Australian_Open-SF-Roger_Federer-Rafael_Nadal,1,F-II,15,2,0,1,1,11,4,,,,,,,,,,
20120127-M-Australian_Open-SF-Roger_Federer-Rafael_Nadal,1,B-XC,60,16,1,5,10,30,30,,,,,,,,,,
20120127-M-Australian_Open-SF-Roger_Federer-Rafael_Nadal,1,B-DTM,48,3,0,0,3,17,31,,,,,,,,,,
20120127-M-Australian_Open-SF-Roger_Federer-Rafael_Nadal,1,B-DTL,33,7,2,2,3,17,16,,,,,,,,,,
20120127-M-Australian_Open-SF-Roger_Federer-Rafael_Nadal,1,B-IO,10,3,0,1,2,5,5,,,,,,,,,,
20120127-M-Australian_Open-SF-Roger_Federer-Rafael_Nadal,1,S-XC,10,0,0,0,0,4,6,,,,,,,,,,
20120127-M-Australian_Open-SF-Roger_Federer-Rafael_Nadal,1,S-DTM,6,1,0,0,1,2,4,,,,,,,,,,
20120127-M-Australian_Open-SF-Roger_Federer-Rafael_Nadal,1,S-DTL,6,1,0,1,0,3,3,,,,,,,,,,
20120127-M-Australian_Open-SF-Roger_Federer-Rafael_Nadal,2,F-XC,124,18,8,5,5,74,50,,,,,,,,,,
20120127-M-Australian_Open-SF-Roger_Federer-Rafael_Nadal,2,F-DTM,21,2,0,0,2,13,8,,,,,,,,,,
20120127-M-Australian_Open-SF-Roger_Federer-Rafael_Nadal,2,F-DTL,28,9,4,3,2,16,12,,,,,,,,,,
20120127-M-Australian_Open-SF-Roger_Federer-Rafael_Nadal,2,F-IO,46,19,7,6,6,31,15,,,,,,,,,,
20120127-M-Australian_Open-SF-Roger_Federer-Rafael_Nadal,2,F-II,10,1,0,1,0,7,3,,,,,,,,,,
20120127-M-Australian_Open-SF-Roger_Federer-Rafael_Nadal,2,B-XC,83,13,2,6,5,38,45,,,,,,,,,,
20120127-M-Australian_Open-SF-Roger_Federer-Rafael_Nadal,2,B-DTM,31,2,1,0,1,13,18,,,,,,,,,,
20120127-M-Australian_Open-SF-Roger_Federer-Rafael_Nadal,2,B-DTL,27,4,1,1,2,8,19,,,,,,,,,,
20120127-M-Australian_Open-SF-Roger_Federer-Rafael_Nadal,2,B-IO,11,1,0,0,1,5,6,,,,,,,,,,
20120127-M-Australian_Open-SF-Roger_Federer-Rafael_Nadal,2,S-XC,4,0,0,0,0,1,3,,,,,,,,,,
20120127-M-Australian_Open-SF-Roger_Federer-Rafael_Nadal,2,S-DTM,10,0,0,0,0,4,6,,,,,,,,,,
20120127-M-Australian_Open-SF-Roger_Federer-Rafael_Nadal,2,S-DTL,16,0,0,0,0,4,12,,,,,,,,,,
20120127-M-Australian_Open-SF-Roger_Federer-Rafael_Nadal,2,S-IO,2,0,0,0,0,0,2,,,,,,,,,,
20120129-M-Australian_Open-F-Novak_Djokovic-Rafael_Nadal,1,F-XC,171,23,8,4,11,81,90,,,,,,,,,,
20120129-M-Australian_Open-F-Novak_Djokovic-Rafael_Nadal,1,F-DTM,97,2,0,1,1,52,45,,,,,,,,,,
20120129-M-Australian_Open-F-Novak_Djokovic-Rafael_Nadal,1,F-DTL,34,15,5,4,6,21,13,,,,,,,,,,
20120129-M-Australian_Open-F-Novak_Djokovic-Rafael_Nadal,1,F-IO,98,33,10,10,13,57,41,,,,,,,,,,
20120129-M-Australian_Open-F-Novak_Djokovic-Rafael_Nadal,1,F-II,8,1,1,0,0,5,3,,,,,,,,,,
20120129-M-Australian_Open-F-Novak_Djokovic-Rafael_Nadal,1,B-XC,105,17,1,7,9,51,54,,,,,,,,,,
20120129-M-Australian_Open-F-Novak_Djokovic-Rafael_Nadal,1,B-DTM,93,9,0,2,7,48,45,,,,,,,,,,
20120129-M-Australian_Open-F-Novak_Djokovic-Rafael_Nadal,1,B-DTL,52,11,5,1,5,32,20,,,,,,,,,,
20120129-M-Australian_Open-F-Novak_Djokovic-Rafael_Nadal,1,B-IO,34,4,1,1,2,15,19,,,,,,,,,,
20120129-M-Australian_Open-F-Novak_Djokovic-Rafael_Nadal,1,S-XC,1,0,0,0,0,1,0,,,,,,,,,,
20120129-M-Australian_Open-F-Novak_Djokovic-Rafael_Nadal,1,S-DTM,3,0,0,0,0,0,3,,,,,,,,,,
20120129-M-Australian_Open-F-Novak_Djokovic-Rafael_Nadal,1,S-DTL,3,0,0,0,0,2,1,,,,,,,,,,
20120129-M-Australian_Open-F-Novak_Djokovic-Rafael_Nadal,1,S-IO,1,0,0,0,0,0,1,,,,,,,,,,
20120129-M-Australian_Open-F-Novak_Djokovic-Rafael_Nadal,2,F-XC,105,17,2,4,11,43,62,,,,,,,,,,
20120129-M-Australian_Open-F-Novak_Djokovic-Rafael_Nadal,2,F-DTM,121,5,0,1,4,62,59,,,,,,,,,,
20120129-M-Australian_Open-F-Novak_Djokovic-Rafael_Nadal,2,F-DTL,40,14,3,5,6,21,19,,,,,,,,,,
20120129-M-Australian_Open-F-Novak_Djokovic-Rafael_Nadal,2,F-IO,83,29,15,6,8,50,33,,,,,,,,,,
20120129-M-Australian_Open-F-Novak_Djokovic-Rafael_Nadal,2,F-II,4,1,0,0,1,2,2,,,,,,,,,,
20120129-M-Australian_Open-F-Novak_Djokovic-Rafael_Nadal,2,B-XC,89,12,1,2,9,48,41,,,,,,,,,,
20120129-M-Australian_Open-F-Novak_Djokovic-Rafael_Nadal,2,B-DTM,86,6,0,0,6,39,47,,,,,,,,,,
20120129-M-Australian_Open-F-Novak_Djokovic-Rafael_Nadal,2,B-DTL,35,9,3,3,3,18,17,,,,,,,,,,
20120129-M-Australian_Open-F-Novak_Djokovic-Rafael_Nadal,2,B-IO,17,1,0,1,0,9,8,,,,,,,,,,
20120129-M-Australian_Open-F-Novak_Djokovic-Rafael_Nadal,2,B-II,1,1,0,0,1,0,1,,,,,,,,,,
20120129-M-Australian_Open-F-Novak_Djokovic-Rafael_Nadal,2,S-XC,3,1,0,0,1,1,2,,,,,,,,,,
20120129-M-Australian_Open-F-Novak_Djokovic-Rafael_Nadal,2,S-DTM,65,3,0,0,3,26,39,,,,,,,,,,
20120129-M-Australian_Open-F-Novak_Djokovic-Rafael_Nadal,2,S-DTL,37,0,0,0,0,19,18,,,,,,,,,,
20120129-M-Australian_Open-F-Novak_Djokovic-Rafael_Nadal,2,S-IO,10,1,0,1,0,4,6,,,,,,,,,,
20120129-M-Australian_Open-F-Novak_Djokovic-Rafael_Nadal,2,S-II,2,0,0,0,0,1,1,,,,,,,,,,
20120210-M-Davis_Cup_World_Group_R1-RR-Julien_Benneteau-Milos_Raonic,1,F-XC,30,9,4,0,5,17,13,,,,,,,,,,
20120210-M-Davis_Cup_World_Group_R1-RR-Julien_Benneteau-Milos_Raonic,1,F-DTM,8,1,0,0,1,4,4,,,,,,,,,,
20120210-M-Davis_Cup_World_Group_R1-RR-Julien_Benneteau-Milos_Raonic,1,F-DTL,6,2,1,0,1,4,2,,,,,,,,,,
20120210-M-Davis_Cup_World_Group_R1-RR-Julien_Benneteau-Milos_Raonic,1,F-IO,25,6,1,3,2,16,9,,,,,,,,,,
20120210-M-Davis_Cup_World_Group_R1-RR-Julien_Benneteau-Milos_Raonic,1,F-II,3,1,1,0,0,1,2,,,,,,,,,,
20120210-M-Davis_Cup_World_Group_R1-RR-Julien_Benneteau-Milos_Raonic,1,B-XC,55,9,3,0,6,28,27,,,,,,,,,,
20120210-M-Davis_Cup_World_Group_R1-RR-Julien_Benneteau-Milos_Raonic,1,B-DTM,18,0,0,0,0,7,11,,,,,,,,,,
20120210-M-Davis_Cup_World_Group_R1-RR-Julien_Benneteau-Milos_Raonic,1,B-DTL,16,9,2,1,6,6,10,,,,,,,,,,
20120210-M-Davis_Cup_World_Group_R1-RR-Julien_Benneteau-Milos_Raonic,1,B-IO,4,1,1,0,0,1,3,,,,,,,,,,
20120210-M-Davis_Cup_World_Group_R1-RR-Julien_Benneteau-Milos_Raonic,1,B-II,1,1,0,0,1,0,1,,,,,,,,,,
20120210-M-Davis_Cup_World_Group_R1-RR-Julien_Benneteau-Milos_Raonic,1,S-XC,3,1,0,0,1,0,3,,,,,,,,,,
20120210-M-Davis_Cup_World_Group_R1-RR-Julien_Benneteau-Milos_Raonic,1,S-DTM,1,0,0,0,0,0,1,,,,,,,,,,
20120210-M-Davis_Cup_World_Group_R1-RR-Julien_Benneteau-Milos_Raonic,1,S-DTL,4,1,0,0,1,2,2,,,,,,,,,,
20120210-M-Davis_Cup_World_Group_R1-RR-Julien_Benneteau-Milos_Raonic,2,F-XC,26,10,4,0,6,13,13,,,,,,,,,,
20120210-M-Davis_Cup_World_Group_R1-RR-Julien_Benneteau-Milos_Raonic,2,F-DTM,9,1,0,0,1,4,5,,,,,,,,,,
20120210-M-Davis_Cup_World_Group_R1-RR-Julien_Benneteau-Milos_Raonic,2,F-DTL,22,5,1,1,3,14,8,,,,,,,,,,
20120210-M-Davis_Cup_World_Group_R1-RR-Julien_Benneteau-Milos_Raonic,2,F-IO,45,9,4,3,2,32,13,,,,,,,,,,
20120210-M-Davis_Cup_World_Group_R1-RR-Julien_Benneteau-Milos_Raonic,2,F-II,19,8,5,0,3,10,9,,,,,,,,,,
20120210-M-Davis_Cup_World_Group_R1-RR-Julien_Benneteau-Milos_Raonic,2,B-XC,23,5,0,1,4,8,15,,,,,,,,,,
20120210-M-Davis_Cup_World_Group_R1-RR-Julien_Benneteau-Milos_Raonic,2,B-DTM,9,0,0,0,0,3,6,,,,,,,,,,
20120210-M-Davis_Cup_World_Group_R1-RR-Julien_Benneteau-Milos_Raonic,2,B-DTL,11,5,2,0,3,5,6,,,,,,,,,,
20120210-M-Davis_Cup_World_Group_R1-RR-Julien_Benneteau-Milos_Raonic,2,B-IO,1,0,0,0,0,1,0,,,,,,,,,,
20120210-M-Davis_Cup_World_Group_R1-RR-Julien_Benneteau-Milos_Raonic,2,B-II,1,0,0,0,0,0,1,,,,,,,,,,
20120210-M-Davis_Cup_World_Group_R1-RR-Julien_Benneteau-Milos_Raonic,2,S-XC,8,1,0,0,1,1,7,,,,,,,,,,
20120210-M-Davis_Cup_World_Group_R1-RR-Julien_Benneteau-Milos_Raonic,2,S-DTM,1,0,0,0,0,1,0,,,,,,,,,,
20120210-M-Davis_Cup_World_Group_R1-RR-Julien_Benneteau-Milos_Raonic,2,S-DTL,1,1,0,0,1,0,1,,,,,,,,,,
20120210-M-Davis_Cup_World_Group_R1-RR-Julien_Benneteau-Milos_Raonic,2,S-IO,1,0,0,0,0,1,0,,,,,,,,,,
20120219-M-Rotterdam-F-Roger_Federer-Juan_Martin_Del_Potro,1,F-XC,30,4,3,0,1,18,12,,,,,,,,,,
20120219-M-Rotterdam-F-Roger_Federer-Juan_Martin_Del_Potro,1,F-DTM,22,4,1,0,3,12,10,,,,,,,,,,
20120219-M-Rotterdam-F-Roger_Federer-Juan_Martin_Del_Potro,1,F-DTL,9,3,0,2,1,6,3,,,,,,,,,,
20120219-M-Rotterdam-F-Roger_Federer-Juan_Martin_Del_Potro,1,F-IO,36,11,4,2,5,19,17,,,,,,,,,,
20120219-M-Rotterdam-F-Roger_Federer-Juan_Martin_Del_Potro,1,F-II,5,2,1,0,1,4,1,,,,,,,,,,
20120219-M-Rotterdam-F-Roger_Federer-Juan_Martin_Del_Potro,1,B-XC,31,4,3,0,1,19,12,,,,,,,,,,
20120219-M-Rotterdam-F-Roger_Federer-Juan_Martin_Del_Potro,1,B-DTM,25,1,0,0,1,17,8,,,,,,,,,,
20120219-M-Rotterdam-F-Roger_Federer-Juan_Martin_Del_Potro,1,B-DTL,10,2,0,0,2,4,6,,,,,,,,,,
20120219-M-Rotterdam-F-Roger_Federer-Juan_Martin_Del_Potro,1,B-IO,4,2,1,0,1,2,2,,,,,,,,,,
20120219-M-Rotterdam-F-Roger_Federer-Juan_Martin_Del_Potro,1,S-XC,9,0,0,0,0,5,4,,,,,,,,,,
20120219-M-Rotterdam-F-Roger_Federer-Juan_Martin_Del_Potro,1,S-DTM,13,0,0,0,0,8,5,,,,,,,,,,
20120219-M-Rotterdam-F-Roger_Federer-Juan_Martin_Del_Potro,1,S-DTL,9,0,0,0,0,6,3,,,,,,,,,,
20120219-M-Rotterdam-F-Roger_Federer-Juan_Martin_Del_Potro,1,S-IO,1,0,0,0,0,1,0,,,,,,,,,,
20120219-M-Rotterdam-F-Roger_Federer-Juan_Martin_Del_Potro,2,F-XC,33,11,2,3,6,16,17,,,,,,,,,,
20120219-M-Rotterdam-F-Roger_Federer-Juan_Martin_Del_Potro,2,F-DTM,25,5,0,2,3,10,15,,,,,,,,,,
20120219-M-Rotterdam-F-Roger_Federer-Juan_Martin_Del_Potro,2,F-DTL,19,4,1,0,3,6,13,,,,,,,,,,
20120219-M-Rotterdam-F-Roger_Federer-Juan_Martin_Del_Potro,2,F-IO,19,1,0,1,0,8,11,,,,,,,,,,
20120219-M-Rotterdam-F-Roger_Federer-Juan_Martin_Del_Potro,2,B-XC,51,5,0,2,3,21,30,,,,,,,,,,
20120219-M-Rotterdam-F-Roger_Federer-Juan_Martin_Del_Potro,2,B-DTM,28,2,0,0,2,6,22,,,,,,,,,,
20120219-M-Rotterdam-F-Roger_Federer-Juan_Martin_Del_Potro,2,B-DTL,6,1,1,0,0,3,3,,,,,,,,,,
20120219-M-Rotterdam-F-Roger_Federer-Juan_Martin_Del_Potro,2,B-IO,1,0,0,0,0,0,1,,,,,,,,,,
20120219-M-Rotterdam-F-Roger_Federer-Juan_Martin_Del_Potro,2,S-XC,11,2,0,1,1,6,5,,,,,,,,,,
20120219-M-Rotterdam-F-Roger_Federer-Juan_Martin_Del_Potro,2,S-DTM,2,0,0,0,0,1,1,,,,,,,,,,
20120219-M-Rotterdam-F-Roger_Federer-Juan_Martin_Del_Potro,2,S-DTL,2,0,0,0,0,2,0,,,,,,,,,,
20120225-M-Buenos_Aires-SF-David_Ferrer-David_Nalbandian,1,F-XC,29,4,1,3,0,18,11,,,,,,,,,,
20120225-M-Buenos_Aires-SF-David_Ferrer-David_Nalbandian,1,F-DTM,5,0,0,0,0,3,2,,,,,,,,,,
20120225-M-Buenos_Aires-SF-David_Ferrer-David_Nalbandian,1,F-DTL,9,4,1,1,2,5,4,,,,,,,,,,
20120225-M-Buenos_Aires-SF-David_Ferrer-David_Nalbandian,1,F-IO,23,6,2,2,2,16,7,,,,,,,,,,
20120225-M-Buenos_Aires-SF-David_Ferrer-David_Nalbandian,1,F-II,6,0,0,0,0,2,4,,,,,,,,,,
20120225-M-Buenos_Aires-SF-David_Ferrer-David_Nalbandian,1,B-XC,30,2,0,0,2,19,11,,,,,,,,,,
20120225-M-Buenos_Aires-SF-David_Ferrer-David_Nalbandian,1,B-DTM,10,0,0,0,0,7,3,,,,,,,,,,
20120225-M-Buenos_Aires-SF-David_Ferrer-David_Nalbandian,1,B-DTL,6,3,1,1,1,4,2,,,,,,,,,,
20120225-M-Buenos_Aires-SF-David_Ferrer-David_Nalbandian,1,S-XC,2,0,0,0,0,1,1,,,,,,,,,,
20120225-M-Buenos_Aires-SF-David_Ferrer-David_Nalbandian,1,S-DTM,1,0,0,0,0,0,1,,,,,,,,,,
20120225-M-Buenos_Aires-SF-David_Ferrer-David_Nalbandian,1,S-DTL,1,1,1,0,0,1,0,,,,,,,,,,
20120225-M-Buenos_Aires-SF-David_Ferrer-David_Nalbandian,2,F-XC,19,6,1,2,3,12,7,,,,,,,,,,
20120225-M-Buenos_Aires-SF-David_Ferrer-David_Nalbandian,2,F-DTM,14,0,0,0,0,5,9,,,,,,,,,,
20120225-M-Buenos_Aires-SF-David_Ferrer-David_Nalbandian,2,F-DTL,6,0,0,0,0,1,5,,,,,,,,,,
20120225-M-Buenos_Aires-SF-David_Ferrer-David_Nalbandian,2,F-IO,7,1,0,1,0,4,3,,,,,,,,,,
20120225-M-Buenos_Aires-SF-David_Ferrer-David_Nalbandian,2,F-II,1,1,0,0,1,0,1,,,,,,,,,,
20120225-M-Buenos_Aires-SF-David_Ferrer-David_Nalbandian,2,B-XC,44,8,1,1,6,20,24,,,,,,,,,,
20120225-M-Buenos_Aires-SF-David_Ferrer-David_Nalbandian,2,B-DTM,16,0,0,0,0,8,8,,,,,,,,,,
20120225-M-Buenos_Aires-SF-David_Ferrer-David_Nalbandian,2,B-DTL,8,4,1,0,3,1,7,,,,,,,,,,
20120225-M-Buenos_Aires-SF-David_Ferrer-David_Nalbandian,2,B-IO,2,0,0,0,0,0,2,,,,,,,,,,
20120225-M-Buenos_Aires-SF-David_Ferrer-David_Nalbandian,2,S-XC,6,3,0,0,3,1,5,,,,,,,,,,
20120225-M-Buenos_Aires-SF-David_Ferrer-David_Nalbandian,2,S-DTM,1,0,0,0,0,0,1,,,,,,,,,,
20120225-M-Buenos_Aires-SF-David_Ferrer-David_Nalbandian,2,S-DTL,1,0,0,0,0,0,1,,,,,,,,,,
20120227-M-Dubai-SF-Andy_Murray-Novak_Djokovic,1,F-XC,24,6,2,1,3,17,7,,,,,,,,,,
20120227-M-Dubai-SF-Andy_Murray-Novak_Djokovic,1,F-DTM,29,2,0,0,2,20,9,,,,,,,,,,
20120227-M-Dubai-SF-Andy_Murray-Novak_Djokovic,1,F-DTL,8,2,1,0,1,2,6,,,,,,,,,,
20120227-M-Dubai-SF-Andy_Murray-Novak_Djokovic,1,F-IO,14,4,2,2,0,12,2,,,,,,,,,,
20120227-M-Dubai-SF-Andy_Murray-Novak_Djokovic,1,B-XC,26,5,2,2,1,20,6,,,,,,,,,,
20120227-M-Dubai-SF-Andy_Murray-Novak_Djokovic,1,B-DTM,20,2,0,1,1,13,7,,,,,,,,,,
20120227-M-Dubai-SF-Andy_Murray-Novak_Djokovic,1,B-DTL,3,2,0,0,2,1,2,,,,,,,,,,
20120227-M-Dubai-SF-Andy_Murray-Novak_Djokovic,1,B-IO,4,1,0,0,1,1,3,,,,,,,,,,
20120227-M-Dubai-SF-Andy_Murray-Novak_Djokovic,1,S-XC,5,0,0,0,0,3,2,,,,,,,,,,
20120227-M-Dubai-SF-Andy_Murray-Novak_Djokovic,1,S-DTM,13,0,0,0,0,5,8,,,,,,,,,,
20120227-M-Dubai-SF-Andy_Murray-Novak_Djokovic,1,S-DTL,1,0,0,0,0,1,0,,,,,,,,,,
20120227-M-Dubai-SF-Andy_Murray-Novak_Djokovic,1,S-IO,1,0,0,0,0,1,0,,,,,,,,,,
20120227-M-Dubai-SF-Andy_Murray-Novak_Djokovic,2,F-XC,26,6,2,0,4,11,15,,,,,,,,,,
20120227-M-Dubai-SF-Andy_Murray-Novak_Djokovic,2,F-DTM,11,2,0,0,2,1,10,,,,,,,,,,
20120227-M-Dubai-SF-Andy_Murray-Novak_Djokovic,2,F-DTL,3,0,0,0,0,1,2,,,,,,,,,,
20120227-M-Dubai-SF-Andy_Murray-Novak_Djokovic,2,F-IO,24,8,2,1,5,11,13,,,,,,,,,,
20120227-M-Dubai-SF-Andy_Murray-Novak_Djokovic,2,F-II,1,0,0,0,0,0,1,,,,,,,,,,
20120227-M-Dubai-SF-Andy_Murray-Novak_Djokovic,2,B-XC,21,2,0,0,2,6,15,,,,,,,,,,
20120227-M-Dubai-SF-Andy_Murray-Novak_Djokovic,2,B-DTM,26,2,0,1,1,7,19,,,,,,,,,,
20120227-M-Dubai-SF-Andy_Murray-Novak_Djokovic,2,B-DTL,10,3,0,0,3,2,8,,,,,,,,,,
20120227-M-Dubai-SF-Andy_Murray-Novak_Djokovic,2,B-IO,9,3,0,1,2,5,4,,,,,,,,,,
20120227-M-Dubai-SF-Andy_Murray-Novak_Djokovic,2,S-XC,3,0,0,0,0,1,2,,,,,,,,,,
20120227-M-Dubai-SF-Andy_Murray-Novak_Djokovic,2,S-DTM,6,0,0,0,0,1,5,,,,,,,,,,
20120227-M-Dubai-SF-Andy_Murray-Novak_Djokovic,2,S-DTL,2,2,0,1,1,1,1,,,,,,,,,,
20120227-M-Dubai-SF-Andy_Murray-Novak_Djokovic,2,S-IO,2,0,0,0,0,1,1,,,,,,,,,,
20120303-M-Dubai-F-Andy_Murray-Roger_Federer,1,F-XC,17,5,2,1,2,10,7,,,,,,,,,,
20120303-M-Dubai-F-Andy_Murray-Roger_Federer,1,F-DTM,27,3,0,1,2,14,13,,,,,,,,,,
20120303-M-Dubai-F-Andy_Murray-Roger_Federer,1,F-DTL,5,2,0,0,2,1,4,,,,,,,,,,
20120303-M-Dubai-F-Andy_Murray-Roger_Federer,1,F-IO,18,2,1,1,0,8,10,,,,,,,,,,
20120303-M-Dubai-F-Andy_Murray-Roger_Federer,1,B-XC,27,11,2,1,8,10,17,,,,,,,,,,
20120303-M-Dubai-F-Andy_Murray-Roger_Federer,1,B-DTM,41,5,0,2,3,17,24,,,,,,,,,,
20120303-M-Dubai-F-Andy_Murray-Roger_Federer,1,B-DTL,7,5,2,1,2,5,2,,,,,,,,,,
20120303-M-Dubai-F-Andy_Murray-Roger_Federer,1,B-IO,3,1,0,0,1,1,2,,,,,,,,,,
20120303-M-Dubai-F-Andy_Murray-Roger_Federer,1,S-XC,6,0,0,0,0,2,4,,,,,,,,,,
20120303-M-Dubai-F-Andy_Murray-Roger_Federer,1,S-DTM,3,0,0,0,0,0,3,,,,,,,,,,
20120303-M-Dubai-F-Andy_Murray-Roger_Federer,1,S-DTL,4,0,0,0,0,2,2,,,,,,,,,,
20120303-M-Dubai-F-Andy_Murray-Roger_Federer,2,F-XC,25,12,4,3,5,17,8,,,,,,,,,,
20120303-M-Dubai-F-Andy_Murray-Roger_Federer,2,F-DTM,30,1,0,0,1,14,16,,,,,,,,,,
20120303-M-Dubai-F-Andy_Murray-Roger_Federer,2,F-DTL,10,3,1,0,2,5,5,,,,,,,,,,
20120303-M-Dubai-F-Andy_Murray-Roger_Federer,2,F-IO,33,12,4,5,2,25,8,,,,,,,,,,
20120303-M-Dubai-F-Andy_Murray-Roger_Federer,2,F-II,1,0,0,0,0,0,1,,,,,,,,,,
20120303-M-Dubai-F-Andy_Murray-Roger_Federer,2,B-XC,11,2,1,1,0,6,5,,,,,,,,,,
20120303-M-Dubai-F-Andy_Murray-Roger_Federer,2,B-DTM,19,2,0,0,2,13,6,,,,,,,,,,
20120303-M-Dubai-F-Andy_Murray-Roger_Federer,2,B-DTL,4,2,1,0,1,2,2,,,,,,,,,,
20120303-M-Dubai-F-Andy_Murray-Roger_Federer,2,B-IO,2,2,0,1,1,1,1,,,,,,,,,,
20120303-M-Dubai-F-Andy_Murray-Roger_Federer,2,S-XC,9,0,0,0,0,4,5,,,,,,,,,,
20120303-M-Dubai-F-Andy_Murray-Roger_Federer,2,S-DTM,8,2,0,0,2,3,5,,,,,,,,,,
20120316-M-Indian_Wells_Masters-SF-Roger_Federer-Rafael_Nadal,1,F-XC,54,12,1,9,2,42,12,,,,,,,,,,
20120316-M-Indian_Wells_Masters-SF-Roger_Federer-Rafael_Nadal,1,F-DTM,35,2,0,1,1,17,18,,,,,,,,,,
20120316-M-Indian_Wells_Masters-SF-Roger_Federer-Rafael_Nadal,1,F-DTL,4,2,2,0,0,4,0,,,,,,,,,,
20120316-M-Indian_Wells_Masters-SF-Roger_Federer-Rafael_Nadal,1,F-IO,15,4,2,1,1,11,4,,,,,,,,,,
20120316-M-Indian_Wells_Masters-SF-Roger_Federer-Rafael_Nadal,1,F-II,5,2,1,0,1,4,1,,,,,,,,,,
20120316-M-Indian_Wells_Masters-SF-Roger_Federer-Rafael_Nadal,1,B-XC,25,3,2,0,1,8,17,,,,,,,,,,
20120316-M-Indian_Wells_Masters-SF-Roger_Federer-Rafael_Nadal,1,B-DTM,31,1,0,0,1,11,20,,,,,,,,,,
20120316-M-Indian_Wells_Masters-SF-Roger_Federer-Rafael_Nadal,1,B-DTL,16,2,0,0,2,7,9,,,,,,,,,,
20120316-M-Indian_Wells_Masters-SF-Roger_Federer-Rafael_Nadal,1,B-IO,3,0,0,0,0,3,0,,,,,,,,,,
20120316-M-Indian_Wells_Masters-SF-Roger_Federer-Rafael_Nadal,1,S-XC,1,0,0,0,0,0,1,,,,,,,,,,
20120316-M-Indian_Wells_Masters-SF-Roger_Federer-Rafael_Nadal,1,S-DTM,1,0,0,0,0,0,1,,,,,,,,,,
20120316-M-Indian_Wells_Masters-SF-Roger_Federer-Rafael_Nadal,1,S-DTL,1,1,0,1,0,1,0,,,,,,,,,,
20120316-M-Indian_Wells_Masters-SF-Roger_Federer-Rafael_Nadal,2,F-XC,57,4,1,2,1,37,20,,,,,,,,,,
20120316-M-Indian_Wells_Masters-SF-Roger_Federer-Rafael_Nadal,2,F-DTM,31,0,0,0,0,18,13,,,,,,,,,,
20120316-M-Indian_Wells_Masters-SF-Roger_Federer-Rafael_Nadal,2,F-DTL,3,0,0,0,0,2,1,,,,,,,,,,
20120316-M-Indian_Wells_Masters-SF-Roger_Federer-Rafael_Nadal,2,F-IO,18,6,3,1,2,9,9,,,,,,,,,,
20120316-M-Indian_Wells_Masters-SF-Roger_Federer-Rafael_Nadal,2,F-II,2,0,0,0,0,0,2,,,,,,,,,,
20120316-M-Indian_Wells_Masters-SF-Roger_Federer-Rafael_Nadal,2,B-XC,19,3,1,1,1,6,13,,,,,,,,,,
20120316-M-Indian_Wells_Masters-SF-Roger_Federer-Rafael_Nadal,2,B-DTM,36,0,0,0,0,8,28,,,,,,,,,,
20120316-M-Indian_Wells_Masters-SF-Roger_Federer-Rafael_Nadal,2,B-DTL,19,1,0,0,1,11,8,,,,,,,,,,
20120316-M-Indian_Wells_Masters-SF-Roger_Federer-Rafael_Nadal,2,B-IO,6,0,0,0,0,3,3,,,,,,,,,,
20120316-M-Indian_Wells_Masters-SF-Roger_Federer-Rafael_Nadal,2,S-DTM,3,0,0,0,0,0,3,,,,,,,,,,
20120316-M-Indian_Wells_Masters-SF-Roger_Federer-Rafael_Nadal,2,S-DTL,3,0,0,0,0,0,3,,,,,,,,,,
20120316-M-Indian_Wells_Masters-SF-Roger_Federer-Rafael_Nadal,2,S-IO,1,0,0,0,0,1,0,,,,,,,,,,
20120327-M-Miami_Masters-QF-David_Ferrer-Novak_Djokovic,1,F-XC,64,12,3,1,8,32,32,,,,,,,,,,
20120327-M-Miami_Masters-QF-David_Ferrer-Novak_Djokovic,1,F-DTM,37,1,0,0,1,23,14,,,,,,,,,,
20120327-M-Miami_Masters-QF-David_Ferrer-Novak_Djokovic,1,F-DTL,20,4,1,0,3,7,13,,,,,,,,,,
20120327-M-Miami_Masters-QF-David_Ferrer-Novak_Djokovic,1,F-IO,47,2,0,1,1,27,20,,,,,,,,,,
20120327-M-Miami_Masters-QF-David_Ferrer-Novak_Djokovic,1,F-II,9,4,1,1,2,4,5,,,,,,,,,,
20120327-M-Miami_Masters-QF-David_Ferrer-Novak_Djokovic,1,B-XC,37,0,0,0,0,20,17,,,,,,,,,,
20120327-M-Miami_Masters-QF-David_Ferrer-Novak_Djokovic,1,B-DTM,36,3,0,1,2,18,18,,,,,,,,,,
20120327-M-Miami_Masters-QF-David_Ferrer-Novak_Djokovic,1,B-DTL,15,3,0,1,2,5,10,,,,,,,,,,
20120327-M-Miami_Masters-QF-David_Ferrer-Novak_Djokovic,1,S-XC,4,0,0,0,0,2,2,,,,,,,,,,
20120327-M-Miami_Masters-QF-David_Ferrer-Novak_Djokovic,1,S-DTM,6,0,0,0,0,3,3,,,,,,,,,,
20120327-M-Miami_Masters-QF-David_Ferrer-Novak_Djokovic,1,S-DTL,1,0,0,0,0,0,1,,,,,,,,,,
20120327-M-Miami_Masters-QF-David_Ferrer-Novak_Djokovic,2,F-XC,64,9,3,2,4,32,32,,,,,,,,,,
20120327-M-Miami_Masters-QF-David_Ferrer-Novak_Djokovic,2,F-DTM,29,5,0,0,5,10,19,,,,,,,,,,
20120327-M-Miami_Masters-QF-David_Ferrer-Novak_Djokovic,2,F-DTL,10,2,0,2,0,8,2,,,,,,,,,,
20120327-M-Miami_Masters-QF-David_Ferrer-Novak_Djokovic,2,F-IO,31,7,2,3,2,19,12,,,,,,,,,,
20120327-M-Miami_Masters-QF-David_Ferrer-Novak_Djokovic,2,F-II,1,0,0,0,0,1,0,,,,,,,,,,
20120327-M-Miami_Masters-QF-David_Ferrer-Novak_Djokovic,2,B-XC,71,7,1,4,2,36,35,,,,,,,,,,
20120327-M-Miami_Masters-QF-David_Ferrer-Novak_Djokovic,2,B-DTM,42,2,0,0,2,12,30,,,,,,,,,,
20120327-M-Miami_Masters-QF-David_Ferrer-Novak_Djokovic,2,B-DTL,17,5,1,1,3,8,9,,,,,,,,,,
20120327-M-Miami_Masters-QF-David_Ferrer-Novak_Djokovic,2,B-IO,9,2,0,0,2,4,5,,,,,,,,,,
20120327-M-Miami_Masters-QF-David_Ferrer-Novak_Djokovic,2,S-XC,6,1,0,0,1,2,4,,,,,,,,,,
20120327-M-Miami_Masters-QF-David_Ferrer-Novak_Djokovic,2,S-DTM,3,0,0,0,0,3,0,,,,,,,,,,
20120327-M-Miami_Masters-QF-David_Ferrer-Novak_Djokovic,2,S-DTL,2,1,0,0,1,1,1,,,,,,,,,,
20120406-M-Davis_Cup_World_Group_QF-RR-Ivo_Karlovic-Juan_Martin_Del_Potro,1,F-XC,30,12,0,3,9,12,18,,,,,,,,,,
20120406-M-Davis_Cup_World_Group_QF-RR-Ivo_Karlovic-Juan_Martin_Del_Potro,1,F-DTM,6,0,0,0,0,4,2,,,,,,,,,,
20120406-M-Davis_Cup_World_Group_QF-RR-Ivo_Karlovic-Juan_Martin_Del_Potro,1,F-DTL,10,1,0,0,1,5,5,,,,,,,,,,
20120406-M-Davis_Cup_World_Group_QF-RR-Ivo_Karlovic-Juan_Martin_Del_Potro,1,F-IO,31,12,3,3,6,16,15,,,,,,,,,,
20120406-M-Davis_Cup_World_Group_QF-RR-Ivo_Karlovic-Juan_Martin_Del_Potro,1,F-II,5,4,2,2,0,5,0,,,,,,,,,,
20120406-M-Davis_Cup_World_Group_QF-RR-Ivo_Karlovic-Juan_Martin_Del_Potro,1,B-DTL,1,0,0,0,0,0,1,,,,,,,,,,
20120406-M-Davis_Cup_World_Group_QF-RR-Ivo_Karlovic-Juan_Martin_Del_Potro,1,S-XC,21,2,0,0,2,10,11,,,,,,,,,,
20120406-M-Davis_Cup_World_Group_QF-RR-Ivo_Karlovic-Juan_Martin_Del_Potro,1,S-DTM,6,1,0,0,1,2,4,,,,,,,,,,
20120406-M-Davis_Cup_World_Group_QF-RR-Ivo_Karlovic-Juan_Martin_Del_Potro,1,S-DTL,5,2,0,0,2,0,5,,,,,,,,,,
20120406-M-Davis_Cup_World_Group_QF-RR-Ivo_Karlovic-Juan_Martin_Del_Potro,1,S-IO,3,0,0,0,0,2,1,,,,,,,,,,
20120406-M-Davis_Cup_World_Group_QF-RR-Ivo_Karlovic-Juan_Martin_Del_Potro,2,F-XC,26,9,3,5,1,16,10,,,,,,,,,,
20120406-M-Davis_Cup_World_Group_QF-RR-Ivo_Karlovic-Juan_Martin_Del_Potro,2,F-DTM,15,1,1,0,0,7,8,,,,,,,,,,
20120406-M-Davis_Cup_World_Group_QF-RR-Ivo_Karlovic-Juan_Martin_Del_Potro,2,F-DTL,8,6,5,0,1,6,2,,,,,,,,,,
20120406-M-Davis_Cup_World_Group_QF-RR-Ivo_Karlovic-Juan_Martin_Del_Potro,2,F-IO,24,7,2,3,2,17,7,,,,,,,,,,
20120406-M-Davis_Cup_World_Group_QF-RR-Ivo_Karlovic-Juan_Martin_Del_Potro,2,F-II,4,3,0,1,2,1,3,,,,,,,,,,
20120406-M-Davis_Cup_World_Group_QF-RR-Ivo_Karlovic-Juan_Martin_Del_Potro,2,B-XC,19,2,0,0,2,8,11,,,,,,,,,,
20120406-M-Davis_Cup_World_Group_QF-RR-Ivo_Karlovic-Juan_Martin_Del_Potro,2,B-DTM,13,0,0,0,0,8,5,,,,,,,,,,
20120406-M-Davis_Cup_World_Group_QF-RR-Ivo_Karlovic-Juan_Martin_Del_Potro,2,B-DTL,6,3,0,1,2,1,5,,,,,,,,,,
20120406-M-Davis_Cup_World_Group_QF-RR-Ivo_Karlovic-Juan_Martin_Del_Potro,2,B-IO,2,1,0,0,1,1,1,,,,,,,,,,
20120406-M-Davis_Cup_World_Group_QF-RR-Ivo_Karlovic-Juan_Martin_Del_Potro,2,S-XC,4,1,0,1,0,2,2,,,,,,,,,,
20120406-M-Davis_Cup_World_Group_QF-RR-Ivo_Karlovic-Juan_Martin_Del_Potro,2,S-DTM,5,0,0,0,0,2,3,,,,,,,,,,
20120406-M-Davis_Cup_World_Group_QF-RR-Ivo_Karlovic-Juan_Martin_Del_Potro,2,S-DTL,4,0,0,0,0,2,2,,,,,,,,,,
20120422-M-Monte_Carlo_Masters-F-Novak_Djokovic-Rafael_Nadal,1,F-XC,36,7,1,1,5,17,19,,,,,,,,,,
20120422-M-Monte_Carlo_Masters-F-Novak_Djokovic-Rafael_Nadal,1,F-DTM,25,0,0,0,0,10,15,,,,,,,,,,
20120422-M-Monte_Carlo_Masters-F-Novak_Djokovic-Rafael_Nadal,1,F-DTL,3,2,0,1,1,2,1,,,,,,,,,,
20120422-M-Monte_Carlo_Masters-F-Novak_Djokovic-Rafael_Nadal,1,F-IO,38,11,2,2,7,24,14,,,,,,,,,,
20120422-M-Monte_Carlo_Masters-F-Novak_Djokovic-Rafael_Nadal,1,F-II,4,1,1,0,0,2,2,,,,,,,,,,
20120422-M-Monte_Carlo_Masters-F-Novak_Djokovic-Rafael_Nadal,1,B-XC,27,6,1,2,3,10,17,,,,,,,,,,
20120422-M-Monte_Carlo_Masters-F-Novak_Djokovic-Rafael_Nadal,1,B-DTM,41,4,0,2,2,20,21,,,,,,,,,,
20120422-M-Monte_Carlo_Masters-F-Novak_Djokovic-Rafael_Nadal,1,B-DTL,16,4,0,2,2,7,9,,,,,,,,,,
20120422-M-Monte_Carlo_Masters-F-Novak_Djokovic-Rafael_Nadal,1,B-IO,8,1,0,0,1,6,2,,,,,,,,,,
20120422-M-Monte_Carlo_Masters-F-Novak_Djokovic-Rafael_Nadal,1,S-DTL,1,0,0,0,0,1,0,,,,,,,,,,
20120422-M-Monte_Carlo_Masters-F-Novak_Djokovic-Rafael_Nadal,2,F-XC,44,3,1,0,2,23,21,,,,,,,,,,
20120422-M-Monte_Carlo_Masters-F-Novak_Djokovic-Rafael_Nadal,2,F-DTM,32,2,1,1,0,17,15,,,,,,,,,,
20120422-M-Monte_Carlo_Masters-F-Novak_Djokovic-Rafael_Nadal,2,F-DTL,8,1,0,1,0,4,4,,,,,,,,,,
20120422-M-Monte_Carlo_Masters-F-Novak_Djokovic-Rafael_Nadal,2,F-IO,24,8,4,2,2,18,6,,,,,,,,,,
20120422-M-Monte_Carlo_Masters-F-Novak_Djokovic-Rafael_Nadal,2,F-II,3,1,0,1,0,2,1,,,,,,,,,,
20120422-M-Monte_Carlo_Masters-F-Novak_Djokovic-Rafael_Nadal,2,B-XC,15,3,1,0,2,5,10,,,,,,,,,,
20120422-M-Monte_Carlo_Masters-F-Novak_Djokovic-Rafael_Nadal,2,B-DTM,34,0,0,0,0,14,20,,,,,,,,,,
20120422-M-Monte_Carlo_Masters-F-Novak_Djokovic-Rafael_Nadal,2,B-DTL,7,2,1,0,1,5,2,,,,,,,,,,
20120422-M-Monte_Carlo_Masters-F-Novak_Djokovic-Rafael_Nadal,2,B-IO,7,1,0,0,1,4,3,,,,,,,,,,
20120422-M-Monte_Carlo_Masters-F-Novak_Djokovic-Rafael_Nadal,2,S-XC,1,0,0,0,0,0,1,,,,,,,,,,
20120422-M-Monte_Carlo_Masters-F-Novak_Djokovic-Rafael_Nadal,2,S-DTM,5,0,0,0,0,2,3,,,,,,,,,,
20120422-M-Monte_Carlo_Masters-F-Novak_Djokovic-Rafael_Nadal,2,S-DTL,1,0,0,0,0,0,1,,,,,,,,,,
20120422-M-Monte_Carlo_Masters-F-Novak_Djokovic-Rafael_Nadal,2,S-IO,2,0,0,0,0,1,1,,,,,,,,,,
20120516-M-Rome_Masters-R32-Roger_Federer-Carlos_Berlocq,1,F-XC,29,8,3,2,3,17,12,,,,,,,,,,
20120516-M-Rome_Masters-R32-Roger_Federer-Carlos_Berlocq,1,F-DTM,20,3,0,1,2,12,8,,,,,,,,,,
20120516-M-Rome_Masters-R32-Roger_Federer-Carlos_Berlocq,1,F-DTL,5,1,0,0,1,2,3,,,,,,,,,,
20120516-M-Rome_Masters-R32-Roger_Federer-Carlos_Berlocq,1,F-IO,34,14,5,5,4,27,7,,,,,,,,,,
20120516-M-Rome_Masters-R32-Roger_Federer-Carlos_Berlocq,1,F-II,5,3,1,1,1,4,1,,,,,,,,,,
20120516-M-Rome_Masters-R32-Roger_Federer-Carlos_Berlocq,1,B-XC,17,3,0,1,2,11,6,,,,,,,,,,
20120516-M-Rome_Masters-R32-Roger_Federer-Carlos_Berlocq,1,B-DTM,13,1,0,0,1,6,7,,,,,,,,,,
20120516-M-Rome_Masters-R32-Roger_Federer-Carlos_Berlocq,1,B-DTL,5,1,0,1,0,4,1,,,,,,,,,,
20120516-M-Rome_Masters-R32-Roger_Federer-Carlos_Berlocq,1,B-IO,1,1,0,1,0,1,0,,,,,,,,,,
20120516-M-Rome_Masters-R32-Roger_Federer-Carlos_Berlocq,1,S-XC,2,0,0,0,0,1,1,,,,,,,,,,
20120516-M-Rome_Masters-R32-Roger_Federer-Carlos_Berlocq,1,S-DTM,3,1,0,0,1,1,2,,,,,,,,,,
20120516-M-Rome_Masters-R32-Roger_Federer-Carlos_Berlocq,2,F-XC,15,4,1,2,1,9,6,,,,,,,,,,
20120516-M-Rome_Masters-R32-Roger_Federer-Carlos_Berlocq,2,F-DTM,21,1,0,0,1,7,14,,,,,,,,,,
20120516-M-Rome_Masters-R32-Roger_Federer-Carlos_Berlocq,2,F-DTL,11,1,1,0,0,6,5,,,,,,,,,,
20120516-M-Rome_Masters-R32-Roger_Federer-Carlos_Berlocq,2,F-IO,18,3,2,0,1,8,10,,,,,,,,,,
20120516-M-Rome_Masters-R32-Roger_Federer-Carlos_Berlocq,2,B-XC,9,2,0,0,2,3,6,,,,,,,,,,
20120516-M-Rome_Masters-R32-Roger_Federer-Carlos_Berlocq,2,B-DTM,30,3,0,0,3,9,21,,,,,,,,,,
20120516-M-Rome_Masters-R32-Roger_Federer-Carlos_Berlocq,2,B-DTL,4,2,0,0,2,1,3,,,,,,,,,,
20120516-M-Rome_Masters-R32-Roger_Federer-Carlos_Berlocq,2,B-IO,3,3,3,0,0,3,0,,,,,,,,,,
20120516-M-Rome_Masters-R32-Roger_Federer-Carlos_Berlocq,2,S-DTM,11,0,0,0,0,3,8,,,,,,,,,,
20120516-M-Rome_Masters-R32-Roger_Federer-Carlos_Berlocq,2,S-DTL,1,0,0,0,0,0,1,,,,,,,,,,
20120519-M-Rome_Masters-F-Novak_Djokovic-Rafael_Nadal,1,F-XC,81,8,0,5,3,38,43,,,,,,,,,,
20120519-M-Rome_Masters-F-Novak_Djokovic-Rafael_Nadal,1,F-DTM,18,1,0,0,1,9,9,,,,,,,,,,
20120519-M-Rome_Masters-F-Novak_Djokovic-Rafael_Nadal,1,F-DTL,17,7,2,1,4,6,11,,,,,,,,,,
20120519-M-Rome_Masters-F-Novak_Djokovic-Rafael_Nadal,1,F-IO,44,13,6,3,4,27,17,,,,,,,,,,
20120519-M-Rome_Masters-F-Novak_Djokovic-Rafael_Nadal,1,F-II,11,6,2,1,3,8,3,,,,,,,,,,
20120519-M-Rome_Masters-F-Novak_Djokovic-Rafael_Nadal,1,B-XC,67,12,2,2,8,21,46,,,,,,,,,,
20120519-M-Rome_Masters-F-Novak_Djokovic-Rafael_Nadal,1,B-DTM,42,5,0,1,4,15,27,,,,,,,,,,
20120519-M-Rome_Masters-F-Novak_Djokovic-Rafael_Nadal,1,B-DTL,41,5,0,0,5,19,22,,,,,,,,,,
20120519-M-Rome_Masters-F-Novak_Djokovic-Rafael_Nadal,1,B-IO,2,1,0,1,0,2,0,,,,,,,,,,
20120519-M-Rome_Masters-F-Novak_Djokovic-Rafael_Nadal,1,S-DTM,1,0,0,0,0,0,1,,,,,,,,,,
20120519-M-Rome_Masters-F-Novak_Djokovic-Rafael_Nadal,1,S-DTL,2,0,0,0,0,0,2,,,,,,,,,,
20120519-M-Rome_Masters-F-Novak_Djokovic-Rafael_Nadal,2,F-XC,111,7,3,2,2,70,41,,,,,,,,,,
20120519-M-Rome_Masters-F-Novak_Djokovic-Rafael_Nadal,2,F-DTM,24,2,0,0,2,13,11,,,,,,,,,,
20120519-M-Rome_Masters-F-Novak_Djokovic-Rafael_Nadal,2,F-DTL,16,6,0,2,4,8,8,,,,,,,,,,
20120519-M-Rome_Masters-F-Novak_Djokovic-Rafael_Nadal,2,F-IO,42,10,3,3,4,26,16,,,,,,,,,,
20120519-M-Rome_Masters-F-Novak_Djokovic-Rafael_Nadal,2,F-II,14,3,0,2,1,11,3,,,,,,,,,,
20120519-M-Rome_Masters-F-Novak_Djokovic-Rafael_Nadal,2,B-XC,37,5,1,0,4,18,19,,,,,,,,,,
20120519-M-Rome_Masters-F-Novak_Djokovic-Rafael_Nadal,2,B-DTM,29,1,0,0,1,6,23,,,,,,,,,,
20120519-M-Rome_Masters-F-Novak_Djokovic-Rafael_Nadal,2,B-DTL,20,0,0,0,0,11,9,,,,,,,,,,
20120519-M-Rome_Masters-F-Novak_Djokovic-Rafael_Nadal,2,B-IO,6,0,0,0,0,6,0,,,,,,,,,,
20120519-M-Rome_Masters-F-Novak_Djokovic-Rafael_Nadal,2,S-XC,3,1,1,0,0,3,0,,,,,,,,,,
20120519-M-Rome_Masters-F-Novak_Djokovic-Rafael_Nadal,2,S-DTM,11,1,0,1,0,5,6,,,,,,,,,,
20120519-M-Rome_Masters-F-Novak_Djokovic-Rafael_Nadal,2,S-DTL,13,1,0,1,0,7,6,,,,,,,,,,
20120519-M-Rome_Masters-F-Novak_Djokovic-Rafael_Nadal,2,S-IO,1,0,0,0,0,0,1,,,,,,,,,,
20120519-M-Rome_Masters-SF-Roger_Federer-Novak_Djokovic,1,F-XC,38,12,3,3,6,16,22,,,,,,,,,,
20120519-M-Rome_Masters-SF-Roger_Federer-Novak_Djokovic,1,F-DTM,25,6,0,1,5,8,17,,,,,,,,,,
20120519-M-Rome_Masters-SF-Roger_Federer-Novak_Djokovic,1,F-DTL,5,2,0,0,2,0,5,,,,,,,,,,
20120519-M-Rome_Masters-SF-Roger_Federer-Novak_Djokovic,1,F-IO,26,11,7,1,3,17,9,,,,,,,,,,
20120519-M-Rome_Masters-SF-Roger_Federer-Novak_Djokovic,1,F-II,3,0,0,0,0,1,2,,,,,,,,,,
20120519-M-Rome_Masters-SF-Roger_Federer-Novak_Djokovic,1,B-XC,42,9,0,3,6,12,30,,,,,,,,,,
20120519-M-Rome_Masters-SF-Roger_Federer-Novak_Djokovic,1,B-DTM,34,5,0,0,5,14,20,,,,,,,,,,
20120519-M-Rome_Masters-SF-Roger_Federer-Novak_Djokovic,1,B-DTL,9,6,1,1,4,4,5,,,,,,,,,,
20120519-M-Rome_Masters-SF-Roger_Federer-Novak_Djokovic,1,B-IO,5,3,1,0,2,2,3,,,,,,,,,,
20120519-M-Rome_Masters-SF-Roger_Federer-Novak_Djokovic,1,S-XC,15,0,0,0,0,4,11,,,,,,,,,,
20120519-M-Rome_Masters-SF-Roger_Federer-Novak_Djokovic,1,S-DTM,3,0,0,0,0,2,1,,,,,,,,,,
20120519-M-Rome_Masters-SF-Roger_Federer-Novak_Djokovic,1,S-DTL,3,0,0,0,0,0,3,,,,,,,,,,
20120519-M-Rome_Masters-SF-Roger_Federer-Novak_Djokovic,2,F-XC,36,7,3,2,2,26,10,,,,,,,,,,
20120519-M-Rome_Masters-SF-Roger_Federer-Novak_Djokovic,2,F-DTM,27,0,0,0,0,16,11,,,,,,,,,,
20120519-M-Rome_Masters-SF-Roger_Federer-Novak_Djokovic,2,F-DTL,6,2,1,0,1,5,1,,,,,,,,,,
20120519-M-Rome_Masters-SF-Roger_Federer-Novak_Djokovic,2,F-IO,24,5,2,1,2,18,6,,,,,,,,,,
20120519-M-Rome_Masters-SF-Roger_Federer-Novak_Djokovic,2,F-II,6,3,2,1,0,5,1,,,,,,,,,,
20120519-M-Rome_Masters-SF-Roger_Federer-Novak_Djokovic,2,B-XC,52,2,0,1,1,36,16,,,,,,,,,,
20120519-M-Rome_Masters-SF-Roger_Federer-Novak_Djokovic,2,B-DTM,28,2,0,0,2,14,14,,,,,,,,,,
20120519-M-Rome_Masters-SF-Roger_Federer-Novak_Djokovic,2,B-DTL,9,7,3,2,2,6,3,,,,,,,,,,
20120519-M-Rome_Masters-SF-Roger_Federer-Novak_Djokovic,2,B-IO,5,2,0,0,2,2,3,,,,,,,,,,
20120519-M-Rome_Masters-SF-Roger_Federer-Novak_Djokovic,2,S-XC,1,0,0,0,0,0,1,,,,,,,,,,
20120519-M-Rome_Masters-SF-Roger_Federer-Novak_Djokovic,2,S-DTM,1,0,0,0,0,0,1,,,,,,,,,,
20120519-M-Rome_Masters-SF-Roger_Federer-Novak_Djokovic,2,S-DTL,2,1,0,1,0,1,1,,,,,,,,,,
20120608-M-Roland_Garros-F-Novak_Djokovic-Rafael_Nadal,1,F-XC,154,19,4,2,13,79,75,,,,,,,,,,
20120608-M-Roland_Garros-F-Novak_Djokovic-Rafael_Nadal,1,F-DTM,30,0,0,0,0,14,16,,,,,,,,,,
20120608-M-Roland_Garros-F-Novak_Djokovic-Rafael_Nadal,1,F-DTL,33,7,1,2,4,14,19,,,,,,,,,,
20120608-M-Roland_Garros-F-Novak_Djokovic-Rafael_Nadal,1,F-IO,67,24,9,8,7,36,31,,,,,,,,,,
20120608-M-Roland_Garros-F-Novak_Djokovic-Rafael_Nadal,1,F-II,10,2,0,1,1,7,3,,,,,,,,,,
20120608-M-Roland_Garros-F-Novak_Djokovic-Rafael_Nadal,1,B-XC,111,20,3,0,17,44,67,,,,,,,,,,
20120608-M-Roland_Garros-F-Novak_Djokovic-Rafael_Nadal,1,B-DTM,51,4,0,1,3,21,30,,,,,,,,,,
20120608-M-Roland_Garros-F-Novak_Djokovic-Rafael_Nadal,1,B-DTL,89,15,3,4,8,46,43,,,,,,,,,,
20120608-M-Roland_Garros-F-Novak_Djokovic-Rafael_Nadal,1,B-IO,16,2,0,1,1,10,6,,,,,,,,,,
20120608-M-Roland_Garros-F-Novak_Djokovic-Rafael_Nadal,1,B-II,1,0,0,0,0,1,0,,,,,,,,,,
20120608-M-Roland_Garros-F-Novak_Djokovic-Rafael_Nadal,1,S-XC,1,0,0,0,0,0,1,,,,,,,,,,
20120608-M-Roland_Garros-F-Novak_Djokovic-Rafael_Nadal,1,S-DTM,3,0,0,0,0,1,2,,,,,,,,,,
20120608-M-Roland_Garros-F-Novak_Djokovic-Rafael_Nadal,1,S-DTL,7,1,0,0,1,1,6,,,,,,,,,,
20120608-M-Roland_Garros-F-Novak_Djokovic-Rafael_Nadal,2,F-XC,159,17,6,5,6,95,64,,,,,,,,,,
20120608-M-Roland_Garros-F-Novak_Djokovic-Rafael_Nadal,2,F-DTM,30,3,0,0,3,13,17,,,,,,,,,,
20120608-M-Roland_Garros-F-Novak_Djokovic-Rafael_Nadal,2,F-DTL,54,14,4,3,7,30,24,,,,,,,,,,
20120608-M-Roland_Garros-F-Novak_Djokovic-Rafael_Nadal,2,F-IO,53,10,5,1,4,26,27,,,,,,,,,,
20120608-M-Roland_Garros-F-Novak_Djokovic-Rafael_Nadal,2,F-II,22,3,3,0,0,13,9,,,,,,,,,,
20120608-M-Roland_Garros-F-Novak_Djokovic-Rafael_Nadal,2,B-XC,86,10,2,1,7,43,43,,,,,,,,,,
20120608-M-Roland_Garros-F-Novak_Djokovic-Rafael_Nadal,2,B-DTM,57,2,0,0,2,25,32,,,,,,,,,,
20120608-M-Roland_Garros-F-Novak_Djokovic-Rafael_Nadal,2,B-DTL,56,3,0,0,3,25,31,,,,,,,,,,
20120608-M-Roland_Garros-F-Novak_Djokovic-Rafael_Nadal,2,B-IO,10,0,0,0,0,5,5,,,,,,,,,,
20120608-M-Roland_Garros-F-Novak_Djokovic-Rafael_Nadal,2,B-II,2,0,0,0,0,1,1,,,,,,,,,,
20120608-M-Roland_Garros-F-Novak_Djokovic-Rafael_Nadal,2,S-XC,1,0,0,0,0,1,0,,,,,,,,,,
20120608-M-Roland_Garros-F-Novak_Djokovic-Rafael_Nadal,2,S-DTM,10,0,0,0,0,4,6,,,,,,,,,,
20120608-M-Roland_Garros-F-Novak_Djokovic-Rafael_Nadal,2,S-DTL,11,0,0,0,0,6,5,,,,,,,,,,
20120608-M-Roland_Garros-F-Novak_Djokovic-Rafael_Nadal,2,S-IO,5,0,0,0,0,2,3,,,,,,,,,,
20120608-M-Roland_Garros-F-Novak_Djokovic-Rafael_Nadal,2,S-II,1,0,0,0,0,0,1,,,,,,,,,,
20120706-M-Wimbledon-SF-Roger_Federer-Novak_Djokovic,1,F-XC,53,17,4,7,6,30,23,,,,,,,,,,
20120706-M-Wimbledon-SF-Roger_Federer-Novak_Djokovic,1,F-DTM,36,3,1,0,2,14,22,,,,,,,,,,
20120706-M-Wimbledon-SF-Roger_Federer-Novak_Djokovic,1,F-DTL,17,6,2,0,4,6,11,,,,,,,,,,
20120706-M-Wimbledon-SF-Roger_Federer-Novak_Djokovic,1,F-IO,27,12,2,4,6,17,10,,,,,,,,,,
20120706-M-Wimbledon-SF-Roger_Federer-Novak_Djokovic,1,F-II,2,0,0,0,0,1,1,,,,,,,,,,
20120706-M-Wimbledon-SF-Roger_Federer-Novak_Djokovic,1,B-XC,30,6,3,3,0,20,10,,,,,,,,,,
20120706-M-Wimbledon-SF-Roger_Federer-Novak_Djokovic,1,B-DTM,20,2,0,1,1,8,12,,,,,,,,,,
20120706-M-Wimbledon-SF-Roger_Federer-Novak_Djokovic,1,B-DTL,5,2,0,1,1,3,2,,,,,,,,,,
20120706-M-Wimbledon-SF-Roger_Federer-Novak_Djokovic,1,B-IO,2,1,1,0,0,2,0,,,,,,,,,,
20120706-M-Wimbledon-SF-Roger_Federer-Novak_Djokovic,1,S-XC,20,2,0,1,1,8,12,,,,,,,,,,
20120706-M-Wimbledon-SF-Roger_Federer-Novak_Djokovic,1,S-DTM,8,1,0,0,1,3,5,,,,,,,,,,
20120706-M-Wimbledon-SF-Roger_Federer-Novak_Djokovic,1,S-DTL,4,0,0,0,0,1,3,,,,,,,,,,
20120706-M-Wimbledon-SF-Roger_Federer-Novak_Djokovic,1,S-II,1,0,0,0,0,1,0,,,,,,,,,,
20120706-M-Wimbledon-SF-Roger_Federer-Novak_Djokovic,2,F-XC,47,13,5,5,3,29,18,,,,,,,,,,
20120706-M-Wimbledon-SF-Roger_Federer-Novak_Djokovic,2,F-DTM,25,2,0,0,2,14,11,,,,,,,,,,
20120706-M-Wimbledon-SF-Roger_Federer-Novak_Djokovic,2,F-DTL,9,3,0,1,2,5,4,,,,,,,,,,
20120706-M-Wimbledon-SF-Roger_Federer-Novak_Djokovic,2,F-IO,26,7,3,1,3,15,11,,,,,,,,,,
20120706-M-Wimbledon-SF-Roger_Federer-Novak_Djokovic,2,F-II,4,1,0,0,1,3,1,,,,,,,,,,
20120706-M-Wimbledon-SF-Roger_Federer-Novak_Djokovic,2,B-XC,48,8,2,3,3,22,26,,,,,,,,,,
20120706-M-Wimbledon-SF-Roger_Federer-Novak_Djokovic,2,B-DTM,35,6,0,1,5,11,24,,,,,,,,,,
20120706-M-Wimbledon-SF-Roger_Federer-Novak_Djokovic,2,B-DTL,26,13,2,6,5,14,12,,,,,,,,,,
20120706-M-Wimbledon-SF-Roger_Federer-Novak_Djokovic,2,B-IO,16,8,2,3,3,11,5,,,,,,,,,,
20120706-M-Wimbledon-SF-Roger_Federer-Novak_Djokovic,2,S-XC,4,0,0,0,0,1,3,,,,,,,,,,
20120706-M-Wimbledon-SF-Roger_Federer-Novak_Djokovic,2,S-DTM,5,0,0,0,0,2,3,,,,,,,,,,
20120706-M-Wimbledon-SF-Roger_Federer-Novak_Djokovic,2,S-II,1,0,0,0,0,1,0,,,,,,,,,,
20120725-M-Olympics-R32-Roger_Federer-Julien_Benneteau,1,F-XC,17,8,2,3,3,8,9,,,,,,,,,,
20120725-M-Olympics-R32-Roger_Federer-Julien_Benneteau,1,F-DTM,10,2,1,0,1,5,5,,,,,,,,,,
20120725-M-Olympics-R32-Roger_Federer-Julien_Benneteau,1,F-DTL,3,1,0,0,1,0,3,,,,,,,,,,
20120725-M-Olympics-R32-Roger_Federer-Julien_Benneteau,1,F-IO,12,4,3,1,0,9,3,,,,,,,,,,
20120725-M-Olympics-R32-Roger_Federer-Julien_Benneteau,1,F-II,1,1,0,0,1,0,1,,,,,,,,,,
20120725-M-Olympics-R32-Roger_Federer-Julien_Benneteau,1,B-XC,14,3,1,2,0,5,9,,,,,,,,,,
20120725-M-Olympics-R32-Roger_Federer-Julien_Benneteau,1,B-DTM,13,1,0,0,1,5,8,,,,,,,,,,
20120725-M-Olympics-R32-Roger_Federer-Julien_Benneteau,1,B-DTL,3,3,2,0,1,2,1,,,,,,,,,,
20120725-M-Olympics-R32-Roger_Federer-Julien_Benneteau,1,S-XC,8,0,0,0,0,5,3,,,,,,,,,,
20120725-M-Olympics-R32-Roger_Federer-Julien_Benneteau,1,S-DTM,3,0,0,0,0,1,2,,,,,,,,,,
20120725-M-Olympics-R32-Roger_Federer-Julien_Benneteau,2,F-XC,13,6,2,3,1,10,3,,,,,,,,,,
20120725-M-Olympics-R32-Roger_Federer-Julien_Benneteau,2,F-DTM,5,1,0,0,1,3,2,,,,,,,,,,
20120725-M-Olympics-R32-Roger_Federer-Julien_Benneteau,2,F-DTL,1,1,0,0,1,0,1,,,,,,,,,,
20120725-M-Olympics-R32-Roger_Federer-Julien_Benneteau,2,F-IO,22,8,4,0,4,11,11,,,,,,,,,,
20120725-M-Olympics-R32-Roger_Federer-Julien_Benneteau,2,F-II,4,1,0,1,0,3,1,,,,,,,,,,
20120725-M-Olympics-R32-Roger_Federer-Julien_Benneteau,2,B-XC,21,2,1,1,0,11,10,,,,,,,,,,
20120725-M-Olympics-R32-Roger_Federer-Julien_Benneteau,2,B-DTM,8,0,0,0,0,3,5,,,,,,,,,,
20120725-M-Olympics-R32-Roger_Federer-Julien_Benneteau,2,B-DTL,1,1,0,0,1,0,1,,,,,,,,,,
20120725-M-Olympics-R32-Roger_Federer-Julien_Benneteau,2,B-IO,2,2,0,0,2,0,2,,,,,,,,,,
20120725-M-Olympics-R32-Roger_Federer-Julien_Benneteau,2,S-XC,5,1,0,0,1,1,4,,,,,,,,,,
20120725-M-Olympics-R32-Roger_Federer-Julien_Benneteau,2,S-DTL,1,1,0,1,0,1,0,,,,,,,,,,
20120725-M-Olympics-R32-Roger_Federer-Julien_Benneteau,2,S-IO,1,0,0,0,0,0,1,,,,,,,,,,
20120731-M-Olympics-R32-Jarkko_Nieminen-Andy_Murray,1,F-XC,24,5,2,0,3,14,10,,,,,,,,,,
20120731-M-Olympics-R32-Jarkko_Nieminen-Andy_Murray,1,F-DTM,15,2,0,1,1,6,9,,,,,,,,,,
20120731-M-Olympics-R32-Jarkko_Nieminen-Andy_Murray,1,F-DTL,11,6,1,1,4,3,8,,,,,,,,,,
20120731-M-Olympics-R32-Jarkko_Nieminen-Andy_Murray,1,F-IO,12,2,0,2,0,7,5,,,,,,,,,,
20120731-M-Olympics-R32-Jarkko_Nieminen-Andy_Murray,1,F-II,1,0,0,0,0,1,0,,,,,,,,,,
20120731-M-Olympics-R32-Jarkko_Nieminen-Andy_Murray,1,B-XC,18,3,0,0,3,6,12,,,,,,,,,,
20120731-M-Olympics-R32-Jarkko_Nieminen-Andy_Murray,1,B-DTM,13,1,0,0,1,3,10,,,,,,,,,,
20120731-M-Olympics-R32-Jarkko_Nieminen-Andy_Murray,1,B-DTL,5,2,0,0,2,0,5,,,,,,,,,,
20120731-M-Olympics-R32-Jarkko_Nieminen-Andy_Murray,1,B-IO,5,1,0,0,1,2,3,,,,,,,,,,
20120731-M-Olympics-R32-Jarkko_Nieminen-Andy_Murray,1,S-XC,2,1,0,0,1,0,2,,,,,,,,,,
20120731-M-Olympics-R32-Jarkko_Nieminen-Andy_Murray,1,S-DTM,1,0,0,0,0,0,1,,,,,,,,,,
20120731-M-Olympics-R32-Jarkko_Nieminen-Andy_Murray,1,S-DTL,7,0,0,0,0,3,4,,,,,,,,,,
20120731-M-Olympics-R32-Jarkko_Nieminen-Andy_Murray,1,S-IO,1,0,0,0,0,0,1,,,,,,,,,,
20120731-M-Olympics-R32-Jarkko_Nieminen-Andy_Murray,2,F-XC,26,6,2,2,2,20,6,,,,,,,,,,
20120731-M-Olympics-R32-Jarkko_Nieminen-Andy_Murray,2,F-DTM,17,4,1,0,3,9,8,,,,,,,,,,
20120731-M-Olympics-R32-Jarkko_Nieminen-Andy_Murray,2,F-DTL,7,2,0,1,1,4,3,,,,,,,,,,
20120731-M-Olympics-R32-Jarkko_Nieminen-Andy_Murray,2,F-IO,12,7,2,2,3,8,4,,,,,,,,,,
20120731-M-Olympics-R32-Jarkko_Nieminen-Andy_Murray,2,F-II,1,1,1,0,0,1,0,,,,,,,,,,
20120731-M-Olympics-R32-Jarkko_Nieminen-Andy_Murray,2,B-XC,14,9,4,1,4,9,5,,,,,,,,,,
20120731-M-Olympics-R32-Jarkko_Nieminen-Andy_Murray,2,B-DTM,4,0,0,0,0,3,1,,,,,,,,,,
20120731-M-Olympics-R32-Jarkko_Nieminen-Andy_Murray,2,B-DTL,4,1,0,0,1,2,2,,,,,,,,,,
20120731-M-Olympics-R32-Jarkko_Nieminen-Andy_Murray,2,B-IO,4,0,0,0,0,3,1,,,,,,,,,,
20120731-M-Olympics-R32-Jarkko_Nieminen-Andy_Murray,2,S-XC,6,0,0,0,0,3,3,,,,,,,,,,
20120731-M-Olympics-R32-Jarkko_Nieminen-Andy_Murray,2,S-DTM,5,0,0,0,0,3,2,,,,,,,,,,
20120731-M-Olympics-R32-Jarkko_Nieminen-Andy_Murray,2,S-DTL,4,2,0,0,2,1,3,,,,,,,,,,
20120731-M-Olympics-R32-Jarkko_Nieminen-Andy_Murray,2,S-IO,4,0,0,0,0,2,2,,,,,,,,,,
20120731-M-Olympics-R32-Novak_Djokovic-Andy_Roddick,1,F-XC,12,4,2,1,1,8,4,,,,,,,,,,
20120731-M-Olympics-R32-Novak_Djokovic-Andy_Roddick,1,F-DTM,9,2,0,0,2,2,7,,,,,,,,,,
20120731-M-Olympics-R32-Novak_Djokovic-Andy_Roddick,1,F-DTL,9,3,2,1,0,6,3,,,,,,,,,,
20120731-M-Olympics-R32-Novak_Djokovic-Andy_Roddick,1,F-IO,12,4,3,0,1,5,7,,,,,,,,,,
20120731-M-Olympics-R32-Novak_Djokovic-Andy_Roddick,1,F-II,2,2,2,0,0,2,0,,,,,,,,,,
20120731-M-Olympics-R32-Novak_Djokovic-Andy_Roddick,1,B-XC,8,2,1,1,0,5,3,,,,,,,,,,
20120731-M-Olympics-R32-Novak_Djokovic-Andy_Roddick,1,B-DTM,8,1,0,0,1,6,2,,,,,,,,,,
20120731-M-Olympics-R32-Novak_Djokovic-Andy_Roddick,1,B-DTL,9,3,2,0,1,6,3,,,,,,,,,,
20120731-M-Olympics-R32-Novak_Djokovic-Andy_Roddick,1,B-IO,3,1,0,0,1,1,2,,,,,,,,,,
20120731-M-Olympics-R32-Novak_Djokovic-Andy_Roddick,1,S-XC,7,0,0,0,0,2,5,,,,,,,,,,
20120731-M-Olympics-R32-Novak_Djokovic-Andy_Roddick,1,S-DTM,1,0,0,0,0,0,1,,,,,,,,,,
20120731-M-Olympics-R32-Novak_Djokovic-Andy_Roddick,1,S-DTL,4,1,0,0,1,2,2,,,,,,,,,,
20120731-M-Olympics-R32-Novak_Djokovic-Andy_Roddick,2,F-XC,15,4,1,2,1,6,9,,,,,,,,,,
20120731-M-Olympics-R32-Novak_Djokovic-Andy_Roddick,2,F-DTM,13,2,0,0,2,5,8,,,,,,,,,,
20120731-M-Olympics-R32-Novak_Djokovic-Andy_Roddick,2,F-DTL,4,0,0,0,0,2,2,,,,,,,,,,
20120731-M-Olympics-R32-Novak_Djokovic-Andy_Roddick,2,F-IO,15,5,3,1,1,7,8,,,,,,,,,,
20120731-M-Olympics-R32-Novak_Djokovic-Andy_Roddick,2,F-II,1,1,1,0,0,1,0,,,,,,,,,,
20120731-M-Olympics-R32-Novak_Djokovic-Andy_Roddick,2,B-XC,13,1,1,0,0,6,7,,,,,,,,,,
20120731-M-Olympics-R32-Novak_Djokovic-Andy_Roddick,2,B-DTM,6,1,0,0,1,4,2,,,,,,,,,,
20120731-M-Olympics-R32-Novak_Djokovic-Andy_Roddick,2,B-DTL,2,1,0,1,0,2,0,,,,,,,,,,
20120731-M-Olympics-R32-Novak_Djokovic-Andy_Roddick,2,B-IO,3,1,0,0,1,0,3,,,,,,,,,,
20120731-M-Olympics-R32-Novak_Djokovic-Andy_Roddick,2,S-XC,8,1,0,0,1,3,5,,,,,,,,,,
20120731-M-Olympics-R32-Novak_Djokovic-Andy_Roddick,2,S-DTM,3,0,0,0,0,3,0,,,,,,,,,,
20120731-M-Olympics-R32-Novak_Djokovic-Andy_Roddick,2,S-DTL,4,0,0,0,0,3,1,,,,,,,,,,
20120731-M-Olympics-R32-Novak_Djokovic-Andy_Roddick,2,S-IO,2,0,0,0,0,1,1,,,,,,,,,,
20120802-M-Olympics-QF-Novak_Djokovic-Jo_Wilfried_Tsonga,1,F-XC,23,11,6,3,2,17,6,,,,,,,,,,
20120802-M-Olympics-QF-Novak_Djokovic-Jo_Wilfried_Tsonga,1,F-DTM,10,1,0,1,0,3,7,,,,,,,,,,
20120802-M-Olympics-QF-Novak_Djokovic-Jo_Wilfried_Tsonga,1,F-DTL,12,4,1,0,3,6,6,,,,,,,,,,
20120802-M-Olympics-QF-Novak_Djokovic-Jo_Wilfried_Tsonga,1,F-IO,12,3,0,0,3,7,5,,,,,,,,,,
20120802-M-Olympics-QF-Novak_Djokovic-Jo_Wilfried_Tsonga,1,F-II,2,2,0,1,1,1,1,,,,,,,,,,
20120802-M-Olympics-QF-Novak_Djokovic-Jo_Wilfried_Tsonga,1,B-XC,12,3,1,1,1,5,7,,,,,,,,,,
20120802-M-Olympics-QF-Novak_Djokovic-Jo_Wilfried_Tsonga,1,B-DTM,7,0,0,0,0,6,1,,,,,,,,,,
20120802-M-Olympics-QF-Novak_Djokovic-Jo_Wilfried_Tsonga,1,B-DTL,10,5,1,2,2,7,3,,,,,,,,,,
20120802-M-Olympics-QF-Novak_Djokovic-Jo_Wilfried_Tsonga,1,B-IO,4,2,1,0,1,2,2,,,,,,,,,,
20120802-M-Olympics-QF-Novak_Djokovic-Jo_Wilfried_Tsonga,1,S-XC,3,1,0,0,1,0,3,,,,,,,,,,
20120802-M-Olympics-QF-Novak_Djokovic-Jo_Wilfried_Tsonga,1,S-DTM,2,0,0,0,0,0,2,,,,,,,,,,
20120802-M-Olympics-QF-Novak_Djokovic-Jo_Wilfried_Tsonga,2,F-XC,23,7,1,1,5,9,14,,,,,,,,,,
20120802-M-Olympics-QF-Novak_Djokovic-Jo_Wilfried_Tsonga,2,F-DTM,9,2,0,0,2,1,8,,,,,,,,,,
20120802-M-Olympics-QF-Novak_Djokovic-Jo_Wilfried_Tsonga,2,F-DTL,9,3,0,0,3,3,6,,,,,,,,,,
20120802-M-Olympics-QF-Novak_Djokovic-Jo_Wilfried_Tsonga,2,F-IO,15,5,0,1,4,5,10,,,,,,,,,,
20120802-M-Olympics-QF-Novak_Djokovic-Jo_Wilfried_Tsonga,2,F-II,2,1,0,0,1,1,1,,,,,,,,,,
20120802-M-Olympics-QF-Novak_Djokovic-Jo_Wilfried_Tsonga,2,B-XC,7,2,1,0,1,2,5,,,,,,,,,,
20120802-M-Olympics-QF-Novak_Djokovic-Jo_Wilfried_Tsonga,2,B-DTM,9,2,0,1,1,2,7,,,,,,,,,,
20120802-M-Olympics-QF-Novak_Djokovic-Jo_Wilfried_Tsonga,2,B-DTL,5,3,0,1,2,2,3,,,,,,,,,,
20120802-M-Olympics-QF-Novak_Djokovic-Jo_Wilfried_Tsonga,2,S-XC,4,2,0,1,1,2,2,,,,,,,,,,
20120802-M-Olympics-QF-Novak_Djokovic-Jo_Wilfried_Tsonga,2,S-DTM,3,1,0,0,1,1,2,,,,,,,,,,
20120802-M-Olympics-QF-Novak_Djokovic-Jo_Wilfried_Tsonga,2,S-DTL,5,0,0,0,0,4,1,,,,,,,,,,
20120802-M-Olympics-QF-Novak_Djokovic-Jo_Wilfried_Tsonga,2,S-IO,1,0,0,0,0,1,0,,,,,,,,,,
20120803-M-Olympics-SF-Andy_Murray-Novak_Djokovic,1,F-XC,46,11,4,4,3,28,18,,,,,,,,,,
20120803-M-Olympics-SF-Andy_Murray-Novak_Djokovic,1,F-DTM,36,5,0,1,4,17,19,,,,,,,,,,
20120803-M-Olympics-SF-Andy_Murray-Novak_Djokovic,1,F-DTL,16,4,1,2,1,10,6,,,,,,,,,,
20120803-M-Olympics-SF-Andy_Murray-Novak_Djokovic,1,F-IO,29,5,3,1,1,17,12,,,,,,,,,,
20120803-M-Olympics-SF-Andy_Murray-Novak_Djokovic,1,B-XC,28,6,0,2,4,16,12,,,,,,,,,,
20120803-M-Olympics-SF-Andy_Murray-Novak_Djokovic,1,B-DTM,41,3,0,2,1,24,17,,,,,,,,,,
20120803-M-Olympics-SF-Andy_Murray-Novak_Djokovic,1,B-DTL,8,1,0,0,1,4,4,,,,,,,,,,
20120803-M-Olympics-SF-Andy_Murray-Novak_Djokovic,1,B-IO,6,1,0,1,0,4,2,,,,,,,,,,
20120803-M-Olympics-SF-Andy_Murray-Novak_Djokovic,1,S-XC,7,0,0,0,0,6,1,,,,,,,,,,
20120803-M-Olympics-SF-Andy_Murray-Novak_Djokovic,1,S-DTM,16,0,0,0,0,8,8,,,,,,,,,,
20120803-M-Olympics-SF-Andy_Murray-Novak_Djokovic,1,S-DTL,2,1,0,1,0,1,1,,,,,,,,,,
20120803-M-Olympics-SF-Andy_Murray-Novak_Djokovic,1,S-IO,3,0,0,0,0,2,1,,,,,,,,,,
20120803-M-Olympics-SF-Andy_Murray-Novak_Djokovic,2,F-XC,41,8,4,2,2,18,23,,,,,,,,,,
20120803-M-Olympics-SF-Andy_Murray-Novak_Djokovic,2,F-DTM,43,2,0,1,1,16,27,,,,,,,,,,
20120803-M-Olympics-SF-Andy_Murray-Novak_Djokovic,2,F-DTL,15,4,2,0,2,9,6,,,,,,,,,,
20120803-M-Olympics-SF-Andy_Murray-Novak_Djokovic,2,F-IO,26,7,2,3,2,18,8,,,,,,,,,,
20120803-M-Olympics-SF-Andy_Murray-Novak_Djokovic,2,B-XC,30,5,0,3,2,12,18,,,,,,,,,,
20120803-M-Olympics-SF-Andy_Murray-Novak_Djokovic,2,B-DTM,44,2,0,1,1,15,29,,,,,,,,,,
20120803-M-Olympics-SF-Andy_Murray-Novak_Djokovic,2,B-DTL,10,3,0,1,2,4,6,,,,,,,,,,
20120803-M-Olympics-SF-Andy_Murray-Novak_Djokovic,2,B-IO,10,4,3,0,1,6,4,,,,,,,,,,
20120803-M-Olympics-SF-Andy_Murray-Novak_Djokovic,2,S-XC,4,0,0,0,0,0,4,,,,,,,,,,
20120803-M-Olympics-SF-Andy_Murray-Novak_Djokovic,2,S-DTM,4,0,0,0,0,3,1,,,,,,,,,,
20120803-M-Olympics-SF-Andy_Murray-Novak_Djokovic,2,S-DTL,4,0,0,0,0,0,4,,,,,,,,,,
20120804-M-Olympics-F-Andy_Murray-Roger_Federer,1,F-XC,43,18,4,10,4,30,13,,,,,,,,,,
20120804-M-Olympics-F-Andy_Murray-Roger_Federer,1,F-DTM,16,2,0,1,1,6,10,,,,,,,,,,
20120804-M-Olympics-F-Andy_Murray-Roger_Federer,1,F-DTL,16,4,3,0,1,11,5,,,,,,,,,,
20120804-M-Olympics-F-Andy_Murray-Roger_Federer,1,F-IO,17,2,0,1,1,10,7,,,,,,,,,,
20120804-M-Olympics-F-Andy_Murray-Roger_Federer,1,F-II,2,1,1,0,0,2,0,,,,,,,,,,
20120804-M-Olympics-F-Andy_Murray-Roger_Federer,1,B-XC,51,11,3,4,4,39,12,,,,,,,,,,
20120804-M-Olympics-F-Andy_Murray-Roger_Federer,1,B-DTM,24,3,0,0,3,9,15,,,,,,,,,,
20120804-M-Olympics-F-Andy_Murray-Roger_Federer,1,B-DTL,15,9,3,2,4,9,6,,,,,,,,,,
20120804-M-Olympics-F-Andy_Murray-Roger_Federer,1,B-IO,4,3,2,1,0,4,0,,,,,,,,,,
20120804-M-Olympics-F-Andy_Murray-Roger_Federer,1,S-XC,14,0,0,0,0,5,9,,,,,,,,,,
20120804-M-Olympics-F-Andy_Murray-Roger_Federer,1,S-DTM,4,1,0,0,1,2,2,,,,,,,,,,
20120804-M-Olympics-F-Andy_Murray-Roger_Federer,1,S-DTL,4,1,0,0,1,3,1,,,,,,,,,,
20120804-M-Olympics-F-Andy_Murray-Roger_Federer,2,F-XC,34,3,0,1,2,15,19,,,,,,,,,,
20120804-M-Olympics-F-Andy_Murray-Roger_Federer,2,F-DTM,19,0,0,0,0,9,10,,,,,,,,,,
20120804-M-Olympics-F-Andy_Murray-Roger_Federer,2,F-DTL,9,5,1,1,3,3,6,,,,,,,,,,
20120804-M-Olympics-F-Andy_Murray-Roger_Federer,2,F-IO,33,11,4,2,5,16,17,,,,,,,,,,
20120804-M-Olympics-F-Andy_Murray-Roger_Federer,2,F-II,10,4,1,2,1,4,6,,,,,,,,,,
20120804-M-Olympics-F-Andy_Murray-Roger_Federer,2,B-XC,34,5,0,0,5,11,23,,,,,,,,,,
20120804-M-Olympics-F-Andy_Murray-Roger_Federer,2,B-DTM,22,4,0,0,4,6,16,,,,,,,,,,
20120804-M-Olympics-F-Andy_Murray-Roger_Federer,2,B-DTL,11,2,1,0,1,5,6,,,,,,,,,,
20120804-M-Olympics-F-Andy_Murray-Roger_Federer,2,B-IO,1,0,0,0,0,1,0,,,,,,,,,,
20120804-M-Olympics-F-Andy_Murray-Roger_Federer,2,S-XC,13,0,0,0,0,4,9,,,,,,,,,,
20120804-M-Olympics-F-Andy_Murray-Roger_Federer,2,S-DTM,3,1,0,0,1,0,3,,,,,,,,,,
20120806-M-Finland_F1-SF-Andres_Artunedo-Vladimir_Ivanov,1,F-XC,23,4,1,1,2,3,20,,,,,,,,,,
20120806-M-Finland_F1-SF-Andres_Artunedo-Vladimir_Ivanov,1,F-DTM,18,3,0,0,3,3,15,,,,,,,,,,
20120806-M-Finland_F1-SF-Andres_Artunedo-Vladimir_Ivanov,1,F-DTL,2,0,0,0,0,0,2,,,,,,,,,,
20120806-M-Finland_F1-SF-Andres_Artunedo-Vladimir_Ivanov,1,F-IO,2,1,0,0,1,1,1,,,,,,,,,,
20120806-M-Finland_F1-SF-Andres_Artunedo-Vladimir_Ivanov,1,B-XC,46,7,1,1,5,13,33,,,,,,,,,,
20120806-M-Finland_F1-SF-Andres_Artunedo-Vladimir_Ivanov,1,B-DTM,24,4,0,0,4,3,21,,,,,,,,,,
20120806-M-Finland_F1-SF-Andres_Artunedo-Vladimir_Ivanov,1,B-DTL,1,0,0,0,0,0,1,,,,,,,,,,
20120806-M-Finland_F1-SF-Andres_Artunedo-Vladimir_Ivanov,1,S-XC,3,0,0,0,0,0,3,,,,,,,,,,
20120806-M-Finland_F1-SF-Andres_Artunedo-Vladimir_Ivanov,1,S-DTM,3,0,0,0,0,1,2,,,,,,,,,,
20120806-M-Finland_F1-SF-Andres_Artunedo-Vladimir_Ivanov,2,F-XC,25,5,2,3,0,23,2,,,,,,,,,,
20120806-M-Finland_F1-SF-Andres_Artunedo-Vladimir_Ivanov,2,F-DTM,16,2,0,0,2,13,3,,,,,,,,,,
20120806-M-Finland_F1-SF-Andres_Artunedo-Vladimir_Ivanov,2,F-DTL,6,1,0,0,1,5,1,,,,,,,,,,
20120806-M-Finland_F1-SF-Andres_Artunedo-Vladimir_Ivanov,2,F-IO,12,2,0,1,1,10,2,,,,,,,,,,
20120806-M-Finland_F1-SF-Andres_Artunedo-Vladimir_Ivanov,2,F-II,2,1,0,1,0,2,0,,,,,,,,,,
20120806-M-Finland_F1-SF-Andres_Artunedo-Vladimir_Ivanov,2,B-XC,35,3,1,1,1,28,7,,,,,,,,,,
20120806-M-Finland_F1-SF-Andres_Artunedo-Vladimir_Ivanov,2,B-DTM,11,0,0,0,0,8,3,,,,,,,,,,
20120806-M-Finland_F1-SF-Andres_Artunedo-Vladimir_Ivanov,2,B-DTL,2,2,1,0,1,1,1,,,,,,,,,,
20120806-M-Finland_F1-SF-Andres_Artunedo-Vladimir_Ivanov,2,S-XC,1,0,0,0,0,0,1,,,,,,,,,,
20120806-M-Finland_F1-SF-Andres_Artunedo-Vladimir_Ivanov,2,S-DTM,2,0,0,0,0,1,1,,,,,,,,,,
20120806-M-Finland_F1-SF-Andres_Artunedo-Vladimir_Ivanov,2,S-DTL,1,1,0,0,1,0,1,,,,,,,,,,
20120818-M-Cincinnati_Masters-F-Novak_Djokovic-Roger_Federer,1,F-XC,29,11,5,4,2,16,13,,,,,,,,,,
20120818-M-Cincinnati_Masters-F-Novak_Djokovic-Roger_Federer,1,F-DTM,21,3,0,0,3,5,16,,,,,,,,,,
20120818-M-Cincinnati_Masters-F-Novak_Djokovic-Roger_Federer,1,F-DTL,6,3,2,0,1,3,3,,,,,,,,,,
20120818-M-Cincinnati_Masters-F-Novak_Djokovic-Roger_Federer,1,F-IO,12,3,0,0,3,5,7,,,,,,,,,,
20120818-M-Cincinnati_Masters-F-Novak_Djokovic-Roger_Federer,1,F-II,2,1,0,1,0,1,1,,,,,,,,,,
20120818-M-Cincinnati_Masters-F-Novak_Djokovic-Roger_Federer,1,B-XC,31,5,1,1,3,15,16,,,,,,,,,,
20120818-M-Cincinnati_Masters-F-Novak_Djokovic-Roger_Federer,1,B-DTM,27,3,0,1,2,14,13,,,,,,,,,,
20120818-M-Cincinnati_Masters-F-Novak_Djokovic-Roger_Federer,1,B-DTL,5,1,1,0,0,3,2,,,,,,,,,,
20120818-M-Cincinnati_Masters-F-Novak_Djokovic-Roger_Federer,1,B-IO,4,2,0,0,2,0,4,,,,,,,,,,
20120818-M-Cincinnati_Masters-F-Novak_Djokovic-Roger_Federer,1,S-XC,1,0,0,0,0,0,1,,,,,,,,,,
20120818-M-Cincinnati_Masters-F-Novak_Djokovic-Roger_Federer,1,S-DTM,5,0,0,0,0,1,4,,,,,,,,,,
20120818-M-Cincinnati_Masters-F-Novak_Djokovic-Roger_Federer,1,S-DTL,1,1,0,0,1,0,1,,,,,,,,,,
20120818-M-Cincinnati_Masters-F-Novak_Djokovic-Roger_Federer,2,F-XC,41,12,5,3,4,27,14,,,,,,,,,,
20120818-M-Cincinnati_Masters-F-Novak_Djokovic-Roger_Federer,2,F-DTM,15,1,0,0,1,12,3,,,,,,,,,,
20120818-M-Cincinnati_Masters-F-Novak_Djokovic-Roger_Federer,2,F-DTL,11,2,2,0,0,7,4,,,,,,,,,,
20120818-M-Cincinnati_Masters-F-Novak_Djokovic-Roger_Federer,2,F-IO,24,10,3,3,4,13,11,,,,,,,,,,
20120818-M-Cincinnati_Masters-F-Novak_Djokovic-Roger_Federer,2,F-II,1,0,0,0,0,1,0,,,,,,,,,,
20120818-M-Cincinnati_Masters-F-Novak_Djokovic-Roger_Federer,2,B-XC,18,3,1,0,2,10,8,,,,,,,,,,
20120818-M-Cincinnati_Masters-F-Novak_Djokovic-Roger_Federer,2,B-DTM,12,0,0,0,0,7,5,,,,,,,,,,
20120818-M-Cincinnati_Masters-F-Novak_Djokovic-Roger_Federer,2,B-DTL,5,1,0,0,1,2,3,,,,,,,,,,
20120818-M-Cincinnati_Masters-F-Novak_Djokovic-Roger_Federer,2,S-XC,9,2,0,0,2,4,5,,,,,,,,,,
20120818-M-Cincinnati_Masters-F-Novak_Djokovic-Roger_Federer,2,S-IO,1,1,0,1,0,1,0,,,,,,,,,,
20120820-M-Finland_F3-SF-Markus_Eriksson-Alexandre_Penaud,1,F-XC,60,17,4,6,7,38,22,,,,,,,,,,
20120820-M-Finland_F3-SF-Markus_Eriksson-Alexandre_Penaud,1,F-DTM,30,1,0,0,1,18,12,,,,,,,,,,
20120820-M-Finland_F3-SF-Markus_Eriksson-Alexandre_Penaud,1,F-DTL,9,3,0,2,1,6,3,,,,,,,,,,
20120820-M-Finland_F3-SF-Markus_Eriksson-Alexandre_Penaud,1,F-IO,47,16,5,5,6,31,16,,,,,,,,,,
20120820-M-Finland_F3-SF-Markus_Eriksson-Alexandre_Penaud,1,F-II,3,1,1,0,0,3,0,,,,,,,,,,
20120820-M-Finland_F3-SF-Markus_Eriksson-Alexandre_Penaud,1,B-XC,32,2,1,0,1,18,14,,,,,,,,,,
20120820-M-Finland_F3-SF-Markus_Eriksson-Alexandre_Penaud,1,B-DTM,39,4,0,0,4,22,17,,,,,,,,,,
20120820-M-Finland_F3-SF-Markus_Eriksson-Alexandre_Penaud,1,B-DTL,14,5,0,2,3,8,6,,,,,,,,,,
20120820-M-Finland_F3-SF-Markus_Eriksson-Alexandre_Penaud,1,B-IO,4,1,0,0,1,2,2,,,,,,,,,,
20120820-M-Finland_F3-SF-Markus_Eriksson-Alexandre_Penaud,1,S-XC,3,0,0,0,0,2,1,,,,,,,,,,
20120820-M-Finland_F3-SF-Markus_Eriksson-Alexandre_Penaud,1,S-DTM,7,1,0,0,1,2,5,,,,,,,,,,
20120820-M-Finland_F3-SF-Markus_Eriksson-Alexandre_Penaud,1,S-DTL,2,0,0,0,0,0,2,,,,,,,,,,
20120820-M-Finland_F3-SF-Markus_Eriksson-Alexandre_Penaud,2,F-XC,32,8,2,1,5,13,19,,,,,,,,,,
20120820-M-Finland_F3-SF-Markus_Eriksson-Alexandre_Penaud,2,F-DTM,34,3,0,0,3,10,24,,,,,,,,,,
20120820-M-Finland_F3-SF-Markus_Eriksson-Alexandre_Penaud,2,F-DTL,14,4,1,1,2,5,9,,,,,,,,,,
20120820-M-Finland_F3-SF-Markus_Eriksson-Alexandre_Penaud,2,F-IO,31,9,3,1,5,14,17,,,,,,,,,,
20120820-M-Finland_F3-SF-Markus_Eriksson-Alexandre_Penaud,2,F-II,2,0,0,0,0,0,2,,,,,,,,,,
20120820-M-Finland_F3-SF-Markus_Eriksson-Alexandre_Penaud,2,B-XC,32,2,0,0,2,16,16,,,,,,,,,,
20120820-M-Finland_F3-SF-Markus_Eriksson-Alexandre_Penaud,2,B-DTM,35,2,0,0,2,13,22,,,,,,,,,,
20120820-M-Finland_F3-SF-Markus_Eriksson-Alexandre_Penaud,2,B-DTL,7,4,4,0,0,6,1,,,,,,,,,,
20120820-M-Finland_F3-SF-Markus_Eriksson-Alexandre_Penaud,2,B-IO,5,3,1,0,2,3,2,,,,,,,,,,
20120820-M-Finland_F3-SF-Markus_Eriksson-Alexandre_Penaud,2,S-XC,9,1,0,0,1,2,7,,,,,,,,,,
20120820-M-Finland_F3-SF-Markus_Eriksson-Alexandre_Penaud,2,S-DTM,18,0,0,0,0,4,14,,,,,,,,,,
20120820-M-Finland_F3-SF-Markus_Eriksson-Alexandre_Penaud,2,S-DTL,4,0,0,0,0,1,3,,,,,,,,,,
20120820-M-Finland_F3-SF-Vladimir_Ivanov-Alexander_Vasilenko,1,F-XC,23,12,5,1,6,13,10,,,,,,,,,,
20120820-M-Finland_F3-SF-Vladimir_Ivanov-Alexander_Vasilenko,1,F-DTM,21,1,0,1,0,14,7,,,,,,,,,,
20120820-M-Finland_F3-SF-Vladimir_Ivanov-Alexander_Vasilenko,1,F-DTL,5,4,3,1,0,4,1,,,,,,,,,,
20120820-M-Finland_F3-SF-Vladimir_Ivanov-Alexander_Vasilenko,1,F-IO,17,8,5,2,1,12,5,,,,,,,,,,
20120820-M-Finland_F3-SF-Vladimir_Ivanov-Alexander_Vasilenko,1,F-II,4,3,3,0,0,3,1,,,,,,,,,,
20120820-M-Finland_F3-SF-Vladimir_Ivanov-Alexander_Vasilenko,1,B-XC,29,4,0,1,3,11,18,,,,,,,,,,
20120820-M-Finland_F3-SF-Vladimir_Ivanov-Alexander_Vasilenko,1,B-DTM,19,1,0,0,1,12,7,,,,,,,,,,
20120820-M-Finland_F3-SF-Vladimir_Ivanov-Alexander_Vasilenko,1,B-DTL,3,1,1,0,0,1,2,,,,,,,,,,
20120820-M-Finland_F3-SF-Vladimir_Ivanov-Alexander_Vasilenko,1,B-IO,3,3,0,1,2,1,2,,,,,,,,,,
20120820-M-Finland_F3-SF-Vladimir_Ivanov-Alexander_Vasilenko,1,S-XC,4,1,0,0,1,3,1,,,,,,,,,,
20120820-M-Finland_F3-SF-Vladimir_Ivanov-Alexander_Vasilenko,1,S-DTM,3,1,0,0,1,1,2,,,,,,,,,,
20120820-M-Finland_F3-SF-Vladimir_Ivanov-Alexander_Vasilenko,2,F-XC,16,1,0,0,1,4,12,,,,,,,,,,
20120820-M-Finland_F3-SF-Vladimir_Ivanov-Alexander_Vasilenko,2,F-DTM,17,4,0,1,3,6,11,,,,,,,,,,
20120820-M-Finland_F3-SF-Vladimir_Ivanov-Alexander_Vasilenko,2,F-DTL,3,2,2,0,0,3,0,,,,,,,,,,
20120820-M-Finland_F3-SF-Vladimir_Ivanov-Alexander_Vasilenko,2,F-IO,19,3,1,0,2,8,11,,,,,,,,,,
20120820-M-Finland_F3-SF-Vladimir_Ivanov-Alexander_Vasilenko,2,F-II,1,0,0,0,0,0,1,,,,,,,,,,
20120820-M-Finland_F3-SF-Vladimir_Ivanov-Alexander_Vasilenko,2,B-XC,29,4,1,1,2,14,15,,,,,,,,,,
20120820-M-Finland_F3-SF-Vladimir_Ivanov-Alexander_Vasilenko,2,B-DTM,26,0,0,0,0,12,14,,,,,,,,,,
20120820-M-Finland_F3-SF-Vladimir_Ivanov-Alexander_Vasilenko,2,B-DTL,7,4,1,1,2,4,3,,,,,,,,,,
20120820-M-Finland_F3-SF-Vladimir_Ivanov-Alexander_Vasilenko,2,S-XC,6,1,0,0,1,2,4,,,,,,,,,,
20120820-M-Finland_F3-SF-Vladimir_Ivanov-Alexander_Vasilenko,2,S-DTM,1,0,0,0,0,1,0,,,,,,,,,,
20120820-M-Finland_F3-SF-Vladimir_Ivanov-Alexander_Vasilenko,2,S-DTL,3,0,0,0,0,0,3,,,,,,,,,,
20120829-M-US_Open-R64-Ivan_Dodig-Andy_Murray,1,F-XC,55,8,0,1,7,23,32,,,,,,,,,,
20120829-M-US_Open-R64-Ivan_Dodig-Andy_Murray,1,F-DTM,30,4,0,1,3,11,19,,,,,,,,,,
20120829-M-US_Open-R64-Ivan_Dodig-Andy_Murray,1,F-DTL,23,4,1,2,1,13,10,,,,,,,,,,
20120829-M-US_Open-R64-Ivan_Dodig-Andy_Murray,1,F-IO,21,2,0,0,2,12,9,,,,,,,,,,
20120829-M-US_Open-R64-Ivan_Dodig-Andy_Murray,1,F-II,2,0,0,0,0,0,2,,,,,,,,,,
20120829-M-US_Open-R64-Ivan_Dodig-Andy_Murray,1,B-XC,39,4,0,1,3,13,26,,,,,,,,,,
20120829-M-US_Open-R64-Ivan_Dodig-Andy_Murray,1,B-DTM,23,3,0,0,3,10,13,,,,,,,,,,
20120829-M-US_Open-R64-Ivan_Dodig-Andy_Murray,1,B-DTL,12,3,2,0,1,6,6,,,,,,,,,,
20120829-M-US_Open-R64-Ivan_Dodig-Andy_Murray,1,B-IO,4,1,1,0,0,2,2,,,,,,,,,,
20120829-M-US_Open-R64-Ivan_Dodig-Andy_Murray,1,S-XC,24,0,0,0,0,8,16,,,,,,,,,,
20120829-M-US_Open-R64-Ivan_Dodig-Andy_Murray,1,S-DTM,16,0,0,0,0,8,8,,,,,,,,,,
20120829-M-US_Open-R64-Ivan_Dodig-Andy_Murray,1,S-DTL,5,1,0,1,0,4,1,,,,,,,,,,
20120829-M-US_Open-R64-Ivan_Dodig-Andy_Murray,2,F-XC,73,19,4,3,12,38,35,,,,,,,,,,
20120829-M-US_Open-R64-Ivan_Dodig-Andy_Murray,2,F-DTM,14,1,0,1,0,12,2,,,,,,,,,,
20120829-M-US_Open-R64-Ivan_Dodig-Andy_Murray,2,F-DTL,27,4,2,1,1,13,14,,,,,,,,,,
20120829-M-US_Open-R64-Ivan_Dodig-Andy_Murray,2,F-IO,29,9,5,2,2,21,8,,,,,,,,,,
20120829-M-US_Open-R64-Ivan_Dodig-Andy_Murray,2,F-II,6,0,0,0,0,5,1,,,,,,,,,,
20120829-M-US_Open-R64-Ivan_Dodig-Andy_Murray,2,B-XC,35,1,0,0,1,18,17,,,,,,,,,,
20120829-M-US_Open-R64-Ivan_Dodig-Andy_Murray,2,B-DTM,22,1,0,0,1,11,11,,,,,,,,,,
20120829-M-US_Open-R64-Ivan_Dodig-Andy_Murray,2,B-DTL,19,5,2,1,2,12,7,,,,,,,,,,
20120829-M-US_Open-R64-Ivan_Dodig-Andy_Murray,2,B-IO,5,0,0,0,0,2,3,,,,,,,,,,
20120829-M-US_Open-R64-Ivan_Dodig-Andy_Murray,2,S-XC,23,0,0,0,0,13,10,,,,,,,,,,
20120829-M-US_Open-R64-Ivan_Dodig-Andy_Murray,2,S-DTM,6,0,0,0,0,3,3,,,,,,,,,,
20120829-M-US_Open-R64-Ivan_Dodig-Andy_Murray,2,S-DTL,5,2,1,0,1,4,1,,,,,,,,,,
20120829-M-US_Open-R64-Ivan_Dodig-Andy_Murray,2,S-IO,2,0,0,0,0,0,2,,,,,,,,,,
20120904-M-US_Open-QF-Novak_Djokovic-Juan_Martin_Del_Potro,1,F-XC,75,17,9,5,3,43,32,,,,,,,,,,
20120904-M-US_Open-QF-Novak_Djokovic-Juan_Martin_Del_Potro,1,F-DTM,26,1,0,0,1,15,11,,,,,,,,,,
20120904-M-US_Open-QF-Novak_Djokovic-Juan_Martin_Del_Potro,1,F-DTL,27,6,0,3,3,15,12,,,,,,,,,,
20120904-M-US_Open-QF-Novak_Djokovic-Juan_Martin_Del_Potro,1,F-IO,37,9,6,2,1,26,11,,,,,,,,,,
20120904-M-US_Open-QF-Novak_Djokovic-Juan_Martin_Del_Potro,1,F-II,9,2,1,1,0,6,3,,,,,,,,,,
20120904-M-US_Open-QF-Novak_Djokovic-Juan_Martin_Del_Potro,1,B-XC,95,4,0,1,3,59,36,,,,,,,,,,
20120904-M-US_Open-QF-Novak_Djokovic-Juan_Martin_Del_Potro,1,B-DTM,34,2,0,0,2,19,15,,,,,,,,,,
20120904-M-US_Open-QF-Novak_Djokovic-Juan_Martin_Del_Potro,1,B-DTL,46,19,11,1,7,30,16,,,,,,,,,,
20120904-M-US_Open-QF-Novak_Djokovic-Juan_Martin_Del_Potro,1,B-IO,7,1,0,0,1,4,3,,,,,,,,,,
20120904-M-US_Open-QF-Novak_Djokovic-Juan_Martin_Del_Potro,1,S-XC,11,0,0,0,0,6,5,,,,,,,,,,
20120904-M-US_Open-QF-Novak_Djokovic-Juan_Martin_Del_Potro,1,S-DTM,5,0,0,0,0,2,3,,,,,,,,,,
20120904-M-US_Open-QF-Novak_Djokovic-Juan_Martin_Del_Potro,1,S-DTL,3,1,0,0,1,1,2,,,,,,,,,,
20120904-M-US_Open-QF-Novak_Djokovic-Juan_Martin_Del_Potro,2,F-XC,96,20,5,4,11,42,54,,,,,,,,,,
20120904-M-US_Open-QF-Novak_Djokovic-Juan_Martin_Del_Potro,2,F-DTM,40,4,1,0,3,10,30,,,,,,,,,,
20120904-M-US_Open-QF-Novak_Djokovic-Juan_Martin_Del_Potro,2,F-DTL,19,3,2,0,1,11,8,,,,,,,,,,
20120904-M-US_Open-QF-Novak_Djokovic-Juan_Martin_Del_Potro,2,F-IO,33,5,1,3,1,15,18,,,,,,,,,,
20120904-M-US_Open-QF-Novak_Djokovic-Juan_Martin_Del_Potro,2,F-II,10,2,0,1,1,5,5,,,,,,,,,,
20120904-M-US_Open-QF-Novak_Djokovic-Juan_Martin_Del_Potro,2,B-XC,122,13,1,5,7,47,75,,,,,,,,,,
20120904-M-US_Open-QF-Novak_Djokovic-Juan_Martin_Del_Potro,2,B-DTM,36,3,0,1,2,14,22,,,,,,,,,,
20120904-M-US_Open-QF-Novak_Djokovic-Juan_Martin_Del_Potro,2,B-DTL,7,5,0,2,3,3,4,,,,,,,,,,
20120904-M-US_Open-QF-Novak_Djokovic-Juan_Martin_Del_Potro,2,B-IO,2,0,0,0,0,1,1,,,,,,,,,,
20120904-M-US_Open-QF-Novak_Djokovic-Juan_Martin_Del_Potro,2,S-XC,17,1,0,0,1,9,8,,,,,,,,,,
20120904-M-US_Open-QF-Novak_Djokovic-Juan_Martin_Del_Potro,2,S-DTM,5,0,0,0,0,3,2,,,,,,,,,,
20120904-M-US_Open-QF-Novak_Djokovic-Juan_Martin_Del_Potro,2,S-DTL,2,0,0,0,0,1,1,,,,,,,,,,
20120909-M-US_Open-F-Novak_Djokovic-Andy_Murray,1,F-XC,132,19,3,4,12,77,55,,,,,,,,,,
20120909-M-US_Open-F-Novak_Djokovic-Andy_Murray,1,F-DTM,111,4,0,0,4,61,50,,,,,,,,,,
20120909-M-US_Open-F-Novak_Djokovic-Andy_Murray,1,F-DTL,32,7,1,2,4,16,16,,,,,,,,,,
20120909-M-US_Open-F-Novak_Djokovic-Andy_Murray,1,F-IO,116,21,4,5,12,61,55,,,,,,,,,,
20120909-M-US_Open-F-Novak_Djokovic-Andy_Murray,1,F-II,4,2,0,1,1,3,1,,,,,,,,,,
20120909-M-US_Open-F-Novak_Djokovic-Andy_Murray,1,B-XC,123,17,1,3,13,59,64,,,,,,,,,,
20120909-M-US_Open-F-Novak_Djokovic-Andy_Murray,1,B-DTM,106,2,0,0,2,49,57,,,,,,,,,,
20120909-M-US_Open-F-Novak_Djokovic-Andy_Murray,1,B-DTL,31,6,1,1,4,14,17,,,,,,,,,,
20120909-M-US_Open-F-Novak_Djokovic-Andy_Murray,1,B-IO,42,8,0,0,8,19,23,,,,,,,,,,
20120909-M-US_Open-F-Novak_Djokovic-Andy_Murray,1,B-II,1,0,0,0,0,1,0,,,,,,,,,,
20120909-M-US_Open-F-Novak_Djokovic-Andy_Murray,1,S-XC,33,3,0,0,3,13,20,,,,,,,,,,
20120909-M-US_Open-F-Novak_Djokovic-Andy_Murray,1,S-DTM,41,1,0,0,1,16,25,,,,,,,,,,
20120909-M-US_Open-F-Novak_Djokovic-Andy_Murray,1,S-DTL,13,0,0,0,0,4,9,,,,,,,,,,
20120909-M-US_Open-F-Novak_Djokovic-Andy_Murray,1,S-IO,6,1,0,1,0,3,3,,,,,,,,,,
20120909-M-US_Open-F-Novak_Djokovic-Andy_Murray,2,F-XC,161,25,5,6,14,64,97,,,,,,,,,,
20120909-M-US_Open-F-Novak_Djokovic-Andy_Murray,2,F-DTM,83,5,0,0,5,37,46,,,,,,,,,,
20120909-M-US_Open-F-Novak_Djokovic-Andy_Murray,2,F-DTL,61,8,2,1,5,31,30,,,,,,,,,,
20120909-M-US_Open-F-Novak_Djokovic-Andy_Murray,2,F-IO,83,16,2,5,9,45,38,,,,,,,,,,
20120909-M-US_Open-F-Novak_Djokovic-Andy_Murray,2,F-II,2,0,0,0,0,1,1,,,,,,,,,,
20120909-M-US_Open-F-Novak_Djokovic-Andy_Murray,2,B-XC,124,13,2,4,7,73,51,,,,,,,,,,
20120909-M-US_Open-F-Novak_Djokovic-Andy_Murray,2,B-DTM,106,1,0,0,1,55,51,,,,,,,,,,
20120909-M-US_Open-F-Novak_Djokovic-Andy_Murray,2,B-DTL,32,10,3,2,5,13,19,,,,,,,,,,
20120909-M-US_Open-F-Novak_Djokovic-Andy_Murray,2,B-IO,14,4,1,1,2,7,7,,,,,,,,,,
20120909-M-US_Open-F-Novak_Djokovic-Andy_Murray,2,S-XC,36,6,0,0,6,20,16,,,,,,,,,,
20120909-M-US_Open-F-Novak_Djokovic-Andy_Murray,2,S-DTM,57,2,0,0,2,23,34,,,,,,,,,,
20120909-M-US_Open-F-Novak_Djokovic-Andy_Murray,2,S-DTL,8,3,0,1,2,2,6,,,,,,,,,,
20120909-M-US_Open-F-Novak_Djokovic-Andy_Murray,2,S-IO,4,1,0,1,0,3,1,,,,,,,,,,
20121008-M-Shanghai_Masters-R32-Novak_Djokovic-Grigor_Dimitrov,1,F-XC,26,7,1,3,3,16,10,,,,,,,,,,
20121008-M-Shanghai_Masters-R32-Novak_Djokovic-Grigor_Dimitrov,1,F-DTM,10,2,0,0,2,5,5,,,,,,,,,,
20121008-M-Shanghai_Masters-R32-Novak_Djokovic-Grigor_Dimitrov,1,F-DTL,8,2,1,0,1,6,2,,,,,,,,,,
20121008-M-Shanghai_Masters-R32-Novak_Djokovic-Grigor_Dimitrov,1,F-IO,11,5,3,0,2,7,4,,,,,,,,,,
20121008-M-Shanghai_Masters-R32-Novak_Djokovic-Grigor_Dimitrov,1,F-II,2,2,1,1,0,2,0,,,,,,,,,,
20121008-M-Shanghai_Masters-R32-Novak_Djokovic-Grigor_Dimitrov,1,B-XC,22,0,0,0,0,17,5,,,,,,,,,,
20121008-M-Shanghai_Masters-R32-Novak_Djokovic-Grigor_Dimitrov,1,B-DTM,10,1,0,0,1,7,3,,,,,,,,,,
20121008-M-Shanghai_Masters-R32-Novak_Djokovic-Grigor_Dimitrov,1,B-DTL,9,5,1,1,3,3,6,,,,,,,,,,
20121008-M-Shanghai_Masters-R32-Novak_Djokovic-Grigor_Dimitrov,1,B-IO,4,2,0,1,1,3,1,,,,,,,,,,
20121008-M-Shanghai_Masters-R32-Novak_Djokovic-Grigor_Dimitrov,1,S-XC,7,1,0,0,1,3,4,,,,,,,,,,
20121008-M-Shanghai_Masters-R32-Novak_Djokovic-Grigor_Dimitrov,1,S-DTM,1,0,0,0,0,1,0,,,,,,,,,,
20121008-M-Shanghai_Masters-R32-Novak_Djokovic-Grigor_Dimitrov,2,F-XC,26,3,2,0,1,14,12,,,,,,,,,,
20121008-M-Shanghai_Masters-R32-Novak_Djokovic-Grigor_Dimitrov,2,F-DTM,12,1,0,0,1,5,7,,,,,,,,,,
20121008-M-Shanghai_Masters-R32-Novak_Djokovic-Grigor_Dimitrov,2,F-DTL,11,6,1,2,3,5,6,,,,,,,,,,
20121008-M-Shanghai_Masters-R32-Novak_Djokovic-Grigor_Dimitrov,2,F-IO,14,5,0,1,4,6,8,,,,,,,,,,
20121008-M-Shanghai_Masters-R32-Novak_Djokovic-Grigor_Dimitrov,2,F-II,4,1,0,0,1,3,1,,,,,,,,,,
20121008-M-Shanghai_Masters-R32-Novak_Djokovic-Grigor_Dimitrov,2,B-XC,16,1,0,0,1,3,13,,,,,,,,,,
20121008-M-Shanghai_Masters-R32-Novak_Djokovic-Grigor_Dimitrov,2,B-DTM,11,3,0,0,3,3,8,,,,,,,,,,
20121008-M-Shanghai_Masters-R32-Novak_Djokovic-Grigor_Dimitrov,2,B-DTL,2,1,0,0,1,1,1,,,,,,,,,,
20121008-M-Shanghai_Masters-R32-Novak_Djokovic-Grigor_Dimitrov,2,S-XC,5,0,0,0,0,2,3,,,,,,,,,,
20121008-M-Shanghai_Masters-R32-Novak_Djokovic-Grigor_Dimitrov,2,S-DTM,9,0,0,0,0,3,6,,,,,,,,,,
20121008-M-Shanghai_Masters-R32-Novak_Djokovic-Grigor_Dimitrov,2,S-DTL,6,1,0,0,1,0,6,,,,,,,,,,
20121011-M-Shanghai_Masters-R16-Alexandr_Dolgopolov-Andy_Murray,1,F-XC,30,11,0,2,9,11,19,,,,,,,,,,
20121011-M-Shanghai_Masters-R16-Alexandr_Dolgopolov-Andy_Murray,1,F-DTM,10,0,0,0,0,2,8,,,,,,,,,,
20121011-M-Shanghai_Masters-R16-Alexandr_Dolgopolov-Andy_Murray,1,F-DTL,8,3,0,0,3,2,6,,,,,,,,,,
20121011-M-Shanghai_Masters-R16-Alexandr_Dolgopolov-Andy_Murray,1,F-IO,9,2,1,0,1,2,7,,,,,,,,,,
20121011-M-Shanghai_Masters-R16-Alexandr_Dolgopolov-Andy_Murray,1,B-XC,32,9,1,0,8,11,21,,,,,,,,,,
20121011-M-Shanghai_Masters-R16-Alexandr_Dolgopolov-Andy_Murray,1,B-DTM,26,1,0,0,1,7,19,,,,,,,,,,
20121011-M-Shanghai_Masters-R16-Alexandr_Dolgopolov-Andy_Murray,1,B-DTL,4,2,1,1,0,2,2,,,,,,,,,,
20121011-M-Shanghai_Masters-R16-Alexandr_Dolgopolov-Andy_Murray,1,B-IO,5,2,0,0,2,2,3,,,,,,,,,,
20121011-M-Shanghai_Masters-R16-Alexandr_Dolgopolov-Andy_Murray,1,S-XC,1,1,0,0,1,0,1,,,,,,,,,,
20121011-M-Shanghai_Masters-R16-Alexandr_Dolgopolov-Andy_Murray,1,S-DTM,3,1,0,0,1,1,2,,,,,,,,,,
20121011-M-Shanghai_Masters-R16-Alexandr_Dolgopolov-Andy_Murray,2,F-XC,24,6,2,2,2,17,7,,,,,,,,,,
20121011-M-Shanghai_Masters-R16-Alexandr_Dolgopolov-Andy_Murray,2,F-DTM,15,2,0,0,2,12,3,,,,,,,,,,
20121011-M-Shanghai_Masters-R16-Alexandr_Dolgopolov-Andy_Murray,2,F-DTL,9,2,0,0,2,4,5,,,,,,,,,,
20121011-M-Shanghai_Masters-R16-Alexandr_Dolgopolov-Andy_Murray,2,F-IO,9,1,0,1,0,7,2,,,,,,,,,,
20121011-M-Shanghai_Masters-R16-Alexandr_Dolgopolov-Andy_Murray,2,B-XC,9,0,0,0,0,5,4,,,,,,,,,,
20121011-M-Shanghai_Masters-R16-Alexandr_Dolgopolov-Andy_Murray,2,B-DTM,16,2,0,0,2,6,10,,,,,,,,,,
20121011-M-Shanghai_Masters-R16-Alexandr_Dolgopolov-Andy_Murray,2,B-DTL,2,0,0,0,0,2,0,,,,,,,,,,
20121011-M-Shanghai_Masters-R16-Alexandr_Dolgopolov-Andy_Murray,2,B-IO,4,1,0,0,1,3,1,,,,,,,,,,
20121011-M-Shanghai_Masters-R16-Alexandr_Dolgopolov-Andy_Murray,2,S-XC,21,1,0,0,1,14,7,,,,,,,,,,
20121011-M-Shanghai_Masters-R16-Alexandr_Dolgopolov-Andy_Murray,2,S-DTM,8,0,0,0,0,5,3,,,,,,,,,,
20121011-M-Shanghai_Masters-R16-Alexandr_Dolgopolov-Andy_Murray,2,S-DTL,2,0,0,0,0,2,0,,,,,,,,,,
20121011-M-Shanghai_Masters-R16-Alexandr_Dolgopolov-Andy_Murray,2,S-IO,2,1,0,0,1,1,1,,,,,,,,,,
20121029-M-Paris_Masters-F-David_Ferrer-Jerzy_Janowicz,1,F-XC,26,10,4,3,3,15,11,,,,,,,,,,
20121029-M-Paris_Masters-F-David_Ferrer-Jerzy_Janowicz,1,F-DTM,13,0,0,0,0,8,5,,,,,,,,,,
20121029-M-Paris_Masters-F-David_Ferrer-Jerzy_Janowicz,1,F-DTL,8,1,0,1,0,3,5,,,,,,,,,,
20121029-M-Paris_Masters-F-David_Ferrer-Jerzy_Janowicz,1,F-IO,28,2,1,1,0,23,5,,,,,,,,,,
20121029-M-Paris_Masters-F-David_Ferrer-Jerzy_Janowicz,1,F-II,4,0,0,0,0,2,2,,,,,,,,,,
20121029-M-Paris_Masters-F-David_Ferrer-Jerzy_Janowicz,1,B-XC,21,0,0,0,0,14,7,,,,,,,,,,
20121029-M-Paris_Masters-F-David_Ferrer-Jerzy_Janowicz,1,B-DTM,13,3,0,0,3,4,9,,,,,,,,,,
20121029-M-Paris_Masters-F-David_Ferrer-Jerzy_Janowicz,1,B-DTL,1,1,0,0,1,0,1,,,,,,,,,,
20121029-M-Paris_Masters-F-David_Ferrer-Jerzy_Janowicz,1,S-XC,4,0,0,0,0,3,1,,,,,,,,,,
20121029-M-Paris_Masters-F-David_Ferrer-Jerzy_Janowicz,1,S-DTM,5,0,0,0,0,2,3,,,,,,,,,,
20121029-M-Paris_Masters-F-David_Ferrer-Jerzy_Janowicz,1,S-DTL,2,2,1,0,1,1,1,,,,,,,,,,
20121029-M-Paris_Masters-F-David_Ferrer-Jerzy_Janowicz,2,F-XC,32,17,2,5,10,16,16,,,,,,,,,,
20121029-M-Paris_Masters-F-David_Ferrer-Jerzy_Janowicz,2,F-DTM,4,1,0,0,1,1,3,,,,,,,,,,
20121029-M-Paris_Masters-F-David_Ferrer-Jerzy_Janowicz,2,F-DTL,4,3,1,0,2,1,3,,,,,,,,,,
20121029-M-Paris_Masters-F-David_Ferrer-Jerzy_Janowicz,2,F-IO,15,3,2,0,1,9,6,,,,,,,,,,
20121029-M-Paris_Masters-F-David_Ferrer-Jerzy_Janowicz,2,F-II,3,2,1,0,1,1,2,,,,,,,,,,
20121029-M-Paris_Masters-F-David_Ferrer-Jerzy_Janowicz,2,B-XC,21,5,1,1,3,8,13,,,,,,,,,,
20121029-M-Paris_Masters-F-David_Ferrer-Jerzy_Janowicz,2,B-DTM,8,2,0,0,2,3,5,,,,,,,,,,
20121029-M-Paris_Masters-F-David_Ferrer-Jerzy_Janowicz,2,B-DTL,6,3,0,1,2,2,4,,,,,,,,,,
20121029-M-Paris_Masters-F-David_Ferrer-Jerzy_Janowicz,2,B-IO,1,0,0,0,0,0,1,,,,,,,,,,
20121029-M-Paris_Masters-F-David_Ferrer-Jerzy_Janowicz,2,S-XC,13,2,0,0,2,3,10,,,,,,,,,,
20121029-M-Paris_Masters-F-David_Ferrer-Jerzy_Janowicz,2,S-DTM,6,0,0,0,0,1,5,,,,,,,,,,
20121029-M-Paris_Masters-F-David_Ferrer-Jerzy_Janowicz,2,S-DTL,1,0,0,0,0,0,1,,,,,,,,,,
20121029-M-Paris_Masters-R16-Michael_Llodra-Juan_Martin_Del_Potro,1,F-XC,7,2,1,0,1,6,1,,,,,,,,,,
20121029-M-Paris_Masters-R16-Michael_Llodra-Juan_Martin_Del_Potro,1,F-DTM,8,0,0,0,0,6,2,,,,,,,,,,
20121029-M-Paris_Masters-R16-Michael_Llodra-Juan_Martin_Del_Potro,1,F-DTL,4,3,0,1,2,1,3,,,,,,,,,,
20121029-M-Paris_Masters-R16-Michael_Llodra-Juan_Martin_Del_Potro,1,F-IO,2,1,1,0,0,2,0,,,,,,,,,,
20121029-M-Paris_Masters-R16-Michael_Llodra-Juan_Martin_Del_Potro,1,B-XC,6,3,1,1,1,4,2,,,,,,,,,,
20121029-M-Paris_Masters-R16-Michael_Llodra-Juan_Martin_Del_Potro,1,B-DTM,3,0,0,0,0,2,1,,,,,,,,,,
20121029-M-Paris_Masters-R16-Michael_Llodra-Juan_Martin_Del_Potro,1,B-DTL,2,1,0,0,1,0,2,,,,,,,,,,
20121029-M-Paris_Masters-R16-Michael_Llodra-Juan_Martin_Del_Potro,1,B-IO,1,0,0,0,0,0,1,,,,,,,,,,
20121029-M-Paris_Masters-R16-Michael_Llodra-Juan_Martin_Del_Potro,1,S-XC,2,0,0,0,0,1,1,,,,,,,,,,
20121029-M-Paris_Masters-R16-Michael_Llodra-Juan_Martin_Del_Potro,1,S-DTM,3,0,0,0,0,3,0,,,,,,,,,,
20121029-M-Paris_Masters-R16-Michael_Llodra-Juan_Martin_Del_Potro,1,S-DTL,10,2,0,0,2,6,4,,,,,,,,,,
20121029-M-Paris_Masters-R16-Michael_Llodra-Juan_Martin_Del_Potro,2,F-XC,23,4,2,0,2,9,14,,,,,,,,,,
20121029-M-Paris_Masters-R16-Michael_Llodra-Juan_Martin_Del_Potro,2,F-DTM,11,2,0,1,1,1,10,,,,,,,,,,
20121029-M-Paris_Masters-R16-Michael_Llodra-Juan_Martin_Del_Potro,2,F-DTL,5,2,0,1,1,2,3,,,,,,,,,,
20121029-M-Paris_Masters-R16-Michael_Llodra-Juan_Martin_Del_Potro,2,F-IO,12,3,1,1,1,6,6,,,,,,,,,,
20121029-M-Paris_Masters-R16-Michael_Llodra-Juan_Martin_Del_Potro,2,B-XC,9,4,1,0,3,1,8,,,,,,,,,,
20121029-M-Paris_Masters-R16-Michael_Llodra-Juan_Martin_Del_Potro,2,B-DTM,6,4,0,1,3,2,4,,,,,,,,,,
20121029-M-Paris_Masters-R16-Michael_Llodra-Juan_Martin_Del_Potro,2,B-DTL,6,4,1,1,2,3,3,,,,,,,,,,
20121029-M-Paris_Masters-R16-Michael_Llodra-Juan_Martin_Del_Potro,2,B-IO,1,0,0,0,0,1,0,,,,,,,,,,
20121029-M-Paris_Masters-R16-Michael_Llodra-Juan_Martin_Del_Potro,2,S-XC,2,0,0,0,0,0,2,,,,,,,,,,
20121029-M-Paris_Masters-R16-Michael_Llodra-Juan_Martin_Del_Potro,2,S-DTL,3,0,0,0,0,2,1,,,,,,,,,,
20121029-M-Paris_Masters-R16-Michael_Llodra-Juan_Martin_Del_Potro,2,S-IO,1,0,0,0,0,0,1,,,,,,,,,,
20121102-M-Paris_Masters-QF-David_Ferrer-Jo_Wilfried_Tsonga,1,F-XC,20,5,1,1,3,12,8,,,,,,,,,,
20121102-M-Paris_Masters-QF-David_Ferrer-Jo_Wilfried_Tsonga,1,F-DTM,10,2,0,0,2,6,4,,,,,,,,,,
20121102-M-Paris_Masters-QF-David_Ferrer-Jo_Wilfried_Tsonga,1,F-DTL,7,1,1,0,0,5,2,,,,,,,,,,
20121102-M-Paris_Masters-QF-David_Ferrer-Jo_Wilfried_Tsonga,1,F-IO,36,5,2,1,2,23,13,,,,,,,,,,
20121102-M-Paris_Masters-QF-David_Ferrer-Jo_Wilfried_Tsonga,1,F-II,10,6,3,1,2,4,6,,,,,,,,,,
20121102-M-Paris_Masters-QF-David_Ferrer-Jo_Wilfried_Tsonga,1,B-XC,22,2,0,0,2,8,14,,,,,,,,,,
20121102-M-Paris_Masters-QF-David_Ferrer-Jo_Wilfried_Tsonga,1,B-DTM,12,0,0,0,0,6,6,,,,,,,,,,
20121102-M-Paris_Masters-QF-David_Ferrer-Jo_Wilfried_Tsonga,1,B-DTL,5,1,0,1,0,2,3,,,,,,,,,,
20121102-M-Paris_Masters-QF-David_Ferrer-Jo_Wilfried_Tsonga,1,B-II,1,0,0,0,0,0,1,,,,,,,,,,
20121102-M-Paris_Masters-QF-David_Ferrer-Jo_Wilfried_Tsonga,1,S-XC,3,0,0,0,0,0,3,,,,,,,,,,
20121102-M-Paris_Masters-QF-David_Ferrer-Jo_Wilfried_Tsonga,2,F-XC,17,6,1,2,3,8,9,,,,,,,,,,
20121102-M-Paris_Masters-QF-David_Ferrer-Jo_Wilfried_Tsonga,2,F-DTM,7,0,0,0,0,5,2,,,,,,,,,,
20121102-M-Paris_Masters-QF-David_Ferrer-Jo_Wilfried_Tsonga,2,F-DTL,4,1,0,1,0,3,1,,,,,,,,,,
20121102-M-Paris_Masters-QF-David_Ferrer-Jo_Wilfried_Tsonga,2,F-IO,13,3,2,0,1,8,5,,,,,,,,,,
20121102-M-Paris_Masters-QF-David_Ferrer-Jo_Wilfried_Tsonga,2,F-II,3,3,0,0,3,0,3,,,,,,,,,,
20121102-M-Paris_Masters-QF-David_Ferrer-Jo_Wilfried_Tsonga,2,B-XC,34,8,1,1,6,17,17,,,,,,,,,,
20121102-M-Paris_Masters-QF-David_Ferrer-Jo_Wilfried_Tsonga,2,B-DTM,20,1,0,0,1,5,15,,,,,,,,,,
20121102-M-Paris_Masters-QF-David_Ferrer-Jo_Wilfried_Tsonga,2,B-DTL,16,6,1,2,3,8,8,,,,,,,,,,
20121102-M-Paris_Masters-QF-David_Ferrer-Jo_Wilfried_Tsonga,2,B-II,1,1,0,0,1,0,1,,,,,,,,,,
20121102-M-Paris_Masters-QF-David_Ferrer-Jo_Wilfried_Tsonga,2,S-XC,4,1,0,0,1,3,1,,,,,,,,,,
20121102-M-Paris_Masters-QF-David_Ferrer-Jo_Wilfried_Tsonga,2,S-DTM,2,1,0,0,1,0,2,,,,,,,,,,
20121102-M-Paris_Masters-QF-David_Ferrer-Jo_Wilfried_Tsonga,2,S-DTL,2,1,1,0,0,2,0,,,,,,,,,,
20121102-M-Paris_Masters-QF-David_Ferrer-Jo_Wilfried_Tsonga,2,S-II,1,1,1,0,0,1,0,,,,,,,,,,
20121112-M-Tour_Finals-F-Roger_Federer-Novak_Djokovic,1,F-XC,58,19,4,6,9,30,28,,,,,,,,,,
20121112-M-Tour_Finals-F-Roger_Federer-Novak_Djokovic,1,F-DTM,51,5,0,2,3,22,29,,,,,,,,,,
20121112-M-Tour_Finals-F-Roger_Federer-Novak_Djokovic,1,F-DTL,16,6,0,4,2,10,6,,,,,,,,,,
20121112-M-Tour_Finals-F-Roger_Federer-Novak_Djokovic,1,F-IO,48,10,2,4,4,26,22,,,,,,,,,,
20121112-M-Tour_Finals-F-Roger_Federer-Novak_Djokovic,1,F-II,4,4,3,0,1,3,1,,,,,,,,,,
20121112-M-Tour_Finals-F-Roger_Federer-Novak_Djokovic,1,B-XC,55,2,0,2,0,34,21,,,,,,,,,,
20121112-M-Tour_Finals-F-Roger_Federer-Novak_Djokovic,1,B-DTM,36,4,0,0,4,15,21,,,,,,,,,,
20121112-M-Tour_Finals-F-Roger_Federer-Novak_Djokovic,1,B-DTL,18,4,2,2,0,12,6,,,,,,,,,,
20121112-M-Tour_Finals-F-Roger_Federer-Novak_Djokovic,1,B-IO,2,2,1,0,1,1,1,,,,,,,,,,
20121112-M-Tour_Finals-F-Roger_Federer-Novak_Djokovic,1,S-XC,24,2,0,0,2,7,17,,,,,,,,,,
20121112-M-Tour_Finals-F-Roger_Federer-Novak_Djokovic,1,S-DTM,9,0,0,0,0,4,5,,,,,,,,,,
20121112-M-Tour_Finals-F-Roger_Federer-Novak_Djokovic,1,S-DTL,2,1,0,0,1,0,2,,,,,,,,,,
20121112-M-Tour_Finals-F-Roger_Federer-Novak_Djokovic,1,S-IO,1,0,0,0,0,0,1,,,,,,,,,,
20121112-M-Tour_Finals-F-Roger_Federer-Novak_Djokovic,2,F-XC,62,15,3,9,3,34,28,,,,,,,,,,
20121112-M-Tour_Finals-F-Roger_Federer-Novak_Djokovic,2,F-DTM,37,0,0,0,0,20,17,,,,,,,,,,
20121112-M-Tour_Finals-F-Roger_Federer-Novak_Djokovic,2,F-DTL,13,3,1,1,1,6,7,,,,,,,,,,
20121112-M-Tour_Finals-F-Roger_Federer-Novak_Djokovic,2,F-IO,24,8,3,2,3,13,11,,,,,,,,,,
20121112-M-Tour_Finals-F-Roger_Federer-Novak_Djokovic,2,F-II,2,1,0,1,0,1,1,,,,,,,,,,
20121112-M-Tour_Finals-F-Roger_Federer-Novak_Djokovic,2,B-XC,99,11,0,5,6,50,49,,,,,,,,,,
20121112-M-Tour_Finals-F-Roger_Federer-Novak_Djokovic,2,B-DTM,56,3,0,0,3,24,32,,,,,,,,,,
20121112-M-Tour_Finals-F-Roger_Federer-Novak_Djokovic,2,B-DTL,19,8,1,4,3,8,11,,,,,,,,,,
20121112-M-Tour_Finals-F-Roger_Federer-Novak_Djokovic,2,B-IO,15,7,2,3,2,10,5,,,,,,,,,,
20121112-M-Tour_Finals-F-Roger_Federer-Novak_Djokovic,2,B-II,1,0,0,0,0,1,0,,,,,,,,,,
20121112-M-Tour_Finals-F-Roger_Federer-Novak_Djokovic,2,S-XC,1,0,0,0,0,0,1,,,,,,,,,,
20121112-M-Tour_Finals-F-Roger_Federer-Novak_Djokovic,2,S-DTM,3,0,0,0,0,1,2,,,,,,,,,,
20121112-M-Tour_Finals-F-Roger_Federer-Novak_Djokovic,2,S-DTL,2,1,0,1,0,2,0,,,,,,,,,,
20130102-M-Brisbane-R16-Jarkko_Nieminen-Alexandr_Dolgopolov,1,F-XC,12,2,1,1,0,9,3,,,,,,,,,,
20130102-M-Brisbane-R16-Jarkko_Nieminen-Alexandr_Dolgopolov,1,F-DTM,9,1,0,0,1,3,6,,,,,,,,,,
20130102-M-Brisbane-R16-Jarkko_Nieminen-Alexandr_Dolgopolov,1,F-DTL,3,0,0,0,0,0,3,,,,,,,,,,
20130102-M-Brisbane-R16-Jarkko_Nieminen-Alexandr_Dolgopolov,1,F-IO,9,4,1,0,3,5,4,,,,,,,,,,
20130102-M-Brisbane-R16-Jarkko_Nieminen-Alexandr_Dolgopolov,1,F-II,3,2,1,0,1,1,2,,,,,,,,,,
20130102-M-Brisbane-R16-Jarkko_Nieminen-Alexandr_Dolgopolov,1,B-XC,51,8,0,3,5,15,36,,,,,,,,,,
20130102-M-Brisbane-R16-Jarkko_Nieminen-Alexandr_Dolgopolov,1,B-DTM,19,1,0,0,1,11,8,,,,,,,,,,
20130102-M-Brisbane-R16-Jarkko_Nieminen-Alexandr_Dolgopolov,1,B-DTL,18,4,1,1,2,9,9,,,,,,,,,,
20130102-M-Brisbane-R16-Jarkko_Nieminen-Alexandr_Dolgopolov,1,B-IO,3,0,0,0,0,1,2,,,,,,,,,,
20130102-M-Brisbane-R16-Jarkko_Nieminen-Alexandr_Dolgopolov,1,S-XC,6,1,0,1,0,2,4,,,,,,,,,,
20130102-M-Brisbane-R16-Jarkko_Nieminen-Alexandr_Dolgopolov,1,S-DTL,1,0,0,0,0,1,0,,,,,,,,,,
20130102-M-Brisbane-R16-Jarkko_Nieminen-Alexandr_Dolgopolov,2,F-XC,60,7,1,3,3,35,25,,,,,,,,,,
20130102-M-Brisbane-R16-Jarkko_Nieminen-Alexandr_Dolgopolov,2,F-DTM,11,1,0,0,1,8,3,,,,,,,,,,
20130102-M-Brisbane-R16-Jarkko_Nieminen-Alexandr_Dolgopolov,2,F-DTL,11,9,8,0,1,10,1,,,,,,,,,,
20130102-M-Brisbane-R16-Jarkko_Nieminen-Alexandr_Dolgopolov,2,F-IO,7,5,2,0,3,3,4,,,,,,,,,,
20130102-M-Brisbane-R16-Jarkko_Nieminen-Alexandr_Dolgopolov,2,B-XC,9,2,1,0,1,4,5,,,,,,,,,,
20130102-M-Brisbane-R16-Jarkko_Nieminen-Alexandr_Dolgopolov,2,B-DTM,5,0,0,0,0,3,2,,,,,,,,,,
20130102-M-Brisbane-R16-Jarkko_Nieminen-Alexandr_Dolgopolov,2,B-DTL,12,1,0,0,1,7,5,,,,,,,,,,
20130102-M-Brisbane-R16-Jarkko_Nieminen-Alexandr_Dolgopolov,2,B-IO,4,0,0,0,0,2,2,,,,,,,,,,
20130102-M-Brisbane-R16-Jarkko_Nieminen-Alexandr_Dolgopolov,2,S-DTM,1,0,0,0,0,0,1,,,,,,,,,,
20130102-M-Brisbane-R16-Jarkko_Nieminen-Alexandr_Dolgopolov,2,S-DTL,6,0,0,0,0,3,3,,,,,,,,,,
20130108-M-Sydney-R32-Bernard_Tomic-Marinko_Matosevic,1,F-XC,26,10,4,1,5,15,11,,,,,,,,,,
20130108-M-Sydney-R32-Bernard_Tomic-Marinko_Matosevic,1,F-DTM,13,2,0,1,1,10,3,,,,,,,,,,
20130108-M-Sydney-R32-Bernard_Tomic-Marinko_Matosevic,1,F-DTL,7,3,2,0,1,3,4,,,,,,,,,,
20130108-M-Sydney-R32-Bernard_Tomic-Marinko_Matosevic,1,F-IO,16,6,4,1,1,11,5,,,,,,,,,,
20130108-M-Sydney-R32-Bernard_Tomic-Marinko_Matosevic,1,F-II,1,1,1,0,0,1,0,,,,,,,,,,
20130108-M-Sydney-R32-Bernard_Tomic-Marinko_Matosevic,1,B-XC,19,1,1,0,0,12,7,,,,,,,,,,
20130108-M-Sydney-R32-Bernard_Tomic-Marinko_Matosevic,1,B-DTM,8,1,0,0,1,3,5,,,,,,,,,,
20130108-M-Sydney-R32-Bernard_Tomic-Marinko_Matosevic,1,B-DTL,6,3,1,0,2,3,3,,,,,,,,,,
20130108-M-Sydney-R32-Bernard_Tomic-Marinko_Matosevic,1,B-IO,3,2,0,0,2,1,2,,,,,,,,,,
20130108-M-Sydney-R32-Bernard_Tomic-Marinko_Matosevic,1,S-XC,15,2,1,0,1,10,5,,,,,,,,,,
20130108-M-Sydney-R32-Bernard_Tomic-Marinko_Matosevic,1,S-DTM,10,0,0,0,0,5,5,,,,,,,,,,
20130108-M-Sydney-R32-Bernard_Tomic-Marinko_Matosevic,1,S-DTL,1,1,0,0,1,0,1,,,,,,,,,,
20130108-M-Sydney-R32-Bernard_Tomic-Marinko_Matosevic,1,S-IO,1,1,0,0,1,0,1,,,,,,,,,,
20130108-M-Sydney-R32-Bernard_Tomic-Marinko_Matosevic,2,F-XC,21,8,2,1,5,12,9,,,,,,,,,,
20130108-M-Sydney-R32-Bernard_Tomic-Marinko_Matosevic,2,F-DTM,18,1,0,0,1,6,12,,,,,,,,,,
20130108-M-Sydney-R32-Bernard_Tomic-Marinko_Matosevic,2,F-DTL,1,0,0,0,0,1,0,,,,,,,,,,
20130108-M-Sydney-R32-Bernard_Tomic-Marinko_Matosevic,2,F-IO,14,5,2,3,0,7,7,,,,,,,,,,
20130108-M-Sydney-R32-Bernard_Tomic-Marinko_Matosevic,2,F-II,1,0,0,0,0,0,1,,,,,,,,,,
20130108-M-Sydney-R32-Bernard_Tomic-Marinko_Matosevic,2,B-XC,29,4,1,1,2,12,17,,,,,,,,,,
20130108-M-Sydney-R32-Bernard_Tomic-Marinko_Matosevic,2,B-DTM,26,3,0,0,3,9,17,,,,,,,,,,
20130108-M-Sydney-R32-Bernard_Tomic-Marinko_Matosevic,2,B-DTL,4,3,1,1,1,3,1,,,,,,,,,,
20130108-M-Sydney-R32-Bernard_Tomic-Marinko_Matosevic,2,B-IO,3,1,0,0,1,1,2,,,,,,,,,,
20130108-M-Sydney-R32-Bernard_Tomic-Marinko_Matosevic,2,S-XC,6,1,0,0,1,3,3,,,,,,,,,,
20130108-M-Sydney-R32-Bernard_Tomic-Marinko_Matosevic,2,S-DTM,3,0,0,0,0,2,1,,,,,,,,,,
20130108-M-Sydney-R32-Bernard_Tomic-Marinko_Matosevic,2,S-DTL,2,2,0,0,2,0,2,,,,,,,,,,
20130109-M-Sydney-R16-Bernard_Tomic-Florian_Mayer,1,F-XC,13,4,3,0,1,10,3,,,,,,,,,,
20130109-M-Sydney-R16-Bernard_Tomic-Florian_Mayer,1,F-DTM,15,0,0,0,0,12,3,,,,,,,,,,
20130109-M-Sydney-R16-Bernard_Tomic-Florian_Mayer,1,F-DTL,11,3,2,0,1,9,2,,,,,,,,,,
20130109-M-Sydney-R16-Bernard_Tomic-Florian_Mayer,1,F-IO,16,9,5,3,1,13,3,,,,,,,,,,
20130109-M-Sydney-R16-Bernard_Tomic-Florian_Mayer,1,F-II,1,1,1,0,0,1,0,,,,,,,,,,
20130109-M-Sydney-R16-Bernard_Tomic-Florian_Mayer,1,B-XC,11,2,0,1,1,6,5,,,,,,,,,,
20130109-M-Sydney-R16-Bernard_Tomic-Florian_Mayer,1,B-DTM,10,2,0,0,2,6,4,,,,,,,,,,
20130109-M-Sydney-R16-Bernard_Tomic-Florian_Mayer,1,B-DTL,7,4,2,0,2,3,4,,,,,,,,,,
20130109-M-Sydney-R16-Bernard_Tomic-Florian_Mayer,1,B-IO,5,5,5,0,0,5,0,,,,,,,,,,
20130109-M-Sydney-R16-Bernard_Tomic-Florian_Mayer,1,S-XC,11,1,0,0,1,9,2,,,,,,,,,,
20130109-M-Sydney-R16-Bernard_Tomic-Florian_Mayer,1,S-DTM,24,2,0,1,1,17,7,,,,,,,,,,
20130109-M-Sydney-R16-Bernard_Tomic-Florian_Mayer,1,S-DTL,9,0,0,0,0,6,3,,,,,,,,,,
20130109-M-Sydney-R16-Bernard_Tomic-Florian_Mayer,1,S-IO,5,0,0,0,0,4,1,,,,,,,,,,
20130109-M-Sydney-R16-Bernard_Tomic-Florian_Mayer,1,S-II,1,0,0,0,0,1,0,,,,,,,,,,
20130109-M-Sydney-R16-Bernard_Tomic-Florian_Mayer,2,F-XC,24,11,3,2,6,8,16,,,,,,,,,,
20130109-M-Sydney-R16-Bernard_Tomic-Florian_Mayer,2,F-DTM,15,0,0,0,0,4,11,,,,,,,,,,
20130109-M-Sydney-R16-Bernard_Tomic-Florian_Mayer,2,F-DTL,12,3,2,0,1,5,7,,,,,,,,,,
20130109-M-Sydney-R16-Bernard_Tomic-Florian_Mayer,2,F-IO,9,4,0,0,4,1,8,,,,,,,,,,
20130109-M-Sydney-R16-Bernard_Tomic-Florian_Mayer,2,B-XC,27,5,1,3,1,11,16,,,,,,,,,,
20130109-M-Sydney-R16-Bernard_Tomic-Florian_Mayer,2,B-DTM,15,3,0,1,2,3,12,,,,,,,,,,
20130109-M-Sydney-R16-Bernard_Tomic-Florian_Mayer,2,B-DTL,5,2,1,0,1,1,4,,,,,,,,,,
20130109-M-Sydney-R16-Bernard_Tomic-Florian_Mayer,2,B-IO,6,3,0,2,1,3,3,,,,,,,,,,
20130109-M-Sydney-R16-Bernard_Tomic-Florian_Mayer,2,S-XC,11,0,0,0,0,1,10,,,,,,,,,,
20130109-M-Sydney-R16-Bernard_Tomic-Florian_Mayer,2,S-DTM,10,0,0,0,0,4,6,,,,,,,,,,
20130109-M-Sydney-R16-Bernard_Tomic-Florian_Mayer,2,S-DTL,1,0,0,0,0,0,1,,,,,,,,,,
20130109-M-Sydney-R16-Bernard_Tomic-Florian_Mayer,2,S-IO,1,0,0,0,0,0,1,,,,,,,,,,
20130112-M-Sydney-F-Bernard_Tomic-Kevin_Anderson,1,F-XC,36,11,6,2,3,23,13,,,,,,,,,,
20130112-M-Sydney-F-Bernard_Tomic-Kevin_Anderson,1,F-DTM,24,4,0,0,4,9,15,,,,,,,,,,
20130112-M-Sydney-F-Bernard_Tomic-Kevin_Anderson,1,F-DTL,24,9,4,2,3,14,10,,,,,,,,,,
20130112-M-Sydney-F-Bernard_Tomic-Kevin_Anderson,1,F-IO,19,8,5,1,2,13,6,,,,,,,,,,
20130112-M-Sydney-F-Bernard_Tomic-Kevin_Anderson,1,B-XC,17,2,0,1,1,11,6,,,,,,,,,,
20130112-M-Sydney-F-Bernard_Tomic-Kevin_Anderson,1,B-DTM,22,4,0,0,4,9,13,,,,,,,,,,
20130112-M-Sydney-F-Bernard_Tomic-Kevin_Anderson,1,B-DTL,14,9,2,3,4,9,5,,,,,,,,,,
20130112-M-Sydney-F-Bernard_Tomic-Kevin_Anderson,1,B-IO,3,1,1,0,0,2,1,,,,,,,,,,
20130112-M-Sydney-F-Bernard_Tomic-Kevin_Anderson,1,S-XC,32,1,0,0,1,23,9,,,,,,,,,,
20130112-M-Sydney-F-Bernard_Tomic-Kevin_Anderson,1,S-DTM,35,3,1,0,2,18,17,,,,,,,,,,
20130112-M-Sydney-F-Bernard_Tomic-Kevin_Anderson,1,S-DTL,11,0,0,0,0,9,2,,,,,,,,,,
20130112-M-Sydney-F-Bernard_Tomic-Kevin_Anderson,1,S-IO,1,0,0,0,0,0,1,,,,,,,,,,
20130112-M-Sydney-F-Bernard_Tomic-Kevin_Anderson,2,F-XC,56,8,2,3,3,30,26,,,,,,,,,,
20130112-M-Sydney-F-Bernard_Tomic-Kevin_Anderson,2,F-DTM,14,2,0,0,2,3,11,,,,,,,,,,
20130112-M-Sydney-F-Bernard_Tomic-Kevin_Anderson,2,F-DTL,13,3,1,1,1,6,7,,,,,,,,,,
20130112-M-Sydney-F-Bernard_Tomic-Kevin_Anderson,2,F-IO,37,11,4,2,5,19,18,,,,,,,,,,
20130112-M-Sydney-F-Bernard_Tomic-Kevin_Anderson,2,F-II,5,1,0,1,0,2,3,,,,,,,,,,
20130112-M-Sydney-F-Bernard_Tomic-Kevin_Anderson,2,B-XC,32,3,1,0,2,16,16,,,,,,,,,,
20130112-M-Sydney-F-Bernard_Tomic-Kevin_Anderson,2,B-DTM,22,2,0,0,2,8,14,,,,,,,,,,
20130112-M-Sydney-F-Bernard_Tomic-Kevin_Anderson,2,B-DTL,7,3,2,0,1,4,3,,,,,,,,,,
20130112-M-Sydney-F-Bernard_Tomic-Kevin_Anderson,2,B-IO,1,0,0,0,0,1,0,,,,,,,,,,
20130112-M-Sydney-F-Bernard_Tomic-Kevin_Anderson,2,B-II,1,1,1,0,0,1,0,,,,,,,,,,
20130112-M-Sydney-F-Bernard_Tomic-Kevin_Anderson,2,S-XC,23,1,0,0,1,7,16,,,,,,,,,,
20130112-M-Sydney-F-Bernard_Tomic-Kevin_Anderson,2,S-DTM,10,2,0,0,2,2,8,,,,,,,,,,
20130112-M-Sydney-F-Bernard_Tomic-Kevin_Anderson,2,S-DTL,2,0,0,0,0,0,2,,,,,,,,,,
20130117-M-Davis_Cup_World_Group_F-RR-Novak_Djokovic-Tomas_Berdych,1,F-XC,50,16,4,9,3,36,14,,,,,,,,,,
20130117-M-Davis_Cup_World_Group_F-RR-Novak_Djokovic-Tomas_Berdych,1,F-DTM,46,2,0,0,2,22,24,,,,,,,,,,
20130117-M-Davis_Cup_World_Group_F-RR-Novak_Djokovic-Tomas_Berdych,1,F-DTL,10,1,0,0,1,6,4,,,,,,,,,,
20130117-M-Davis_Cup_World_Group_F-RR-Novak_Djokovic-Tomas_Berdych,1,F-IO,30,8,3,2,3,22,8,,,,,,,,,,
20130117-M-Davis_Cup_World_Group_F-RR-Novak_Djokovic-Tomas_Berdych,1,F-II,1,0,0,0,0,1,0,,,,,,,,,,
20130117-M-Davis_Cup_World_Group_F-RR-Novak_Djokovic-Tomas_Berdych,1,B-XC,53,2,1,0,1,36,17,,,,,,,,,,
20130117-M-Davis_Cup_World_Group_F-RR-Novak_Djokovic-Tomas_Berdych,1,B-DTM,42,1,0,0,1,30,12,,,,,,,,,,
20130117-M-Davis_Cup_World_Group_F-RR-Novak_Djokovic-Tomas_Berdych,1,B-DTL,11,5,0,3,2,8,3,,,,,,,,,,
20130117-M-Davis_Cup_World_Group_F-RR-Novak_Djokovic-Tomas_Berdych,1,B-IO,5,2,0,1,1,3,2,,,,,,,,,,
20130117-M-Davis_Cup_World_Group_F-RR-Novak_Djokovic-Tomas_Berdych,1,B-II,1,0,0,0,0,1,0,,,,,,,,,,
20130117-M-Davis_Cup_World_Group_F-RR-Novak_Djokovic-Tomas_Berdych,1,S-XC,9,0,0,0,0,2,7,,,,,,,,,,
20130117-M-Davis_Cup_World_Group_F-RR-Novak_Djokovic-Tomas_Berdych,1,S-DTM,10,1,0,0,1,4,6,,,,,,,,,,
20130117-M-Davis_Cup_World_Group_F-RR-Novak_Djokovic-Tomas_Berdych,2,F-XC,60,14,5,4,5,28,32,,,,,,,,,,
20130117-M-Davis_Cup_World_Group_F-RR-Novak_Djokovic-Tomas_Berdych,2,F-DTM,29,4,1,0,3,8,21,,,,,,,,,,
20130117-M-Davis_Cup_World_Group_F-RR-Novak_Djokovic-Tomas_Berdych,2,F-DTL,12,5,2,1,2,7,5,,,,,,,,,,
20130117-M-Davis_Cup_World_Group_F-RR-Novak_Djokovic-Tomas_Berdych,2,F-IO,32,10,3,3,4,14,18,,,,,,,,,,
20130117-M-Davis_Cup_World_Group_F-RR-Novak_Djokovic-Tomas_Berdych,2,F-II,3,1,0,0,1,1,2,,,,,,,,,,
20130117-M-Davis_Cup_World_Group_F-RR-Novak_Djokovic-Tomas_Berdych,2,B-XC,37,5,3,0,2,13,24,,,,,,,,,,
20130117-M-Davis_Cup_World_Group_F-RR-Novak_Djokovic-Tomas_Berdych,2,B-DTM,48,7,0,0,7,21,27,,,,,,,,,,
20130117-M-Davis_Cup_World_Group_F-RR-Novak_Djokovic-Tomas_Berdych,2,B-DTL,10,6,1,1,4,3,7,,,,,,,,,,
20130117-M-Davis_Cup_World_Group_F-RR-Novak_Djokovic-Tomas_Berdych,2,B-IO,10,4,1,1,2,3,7,,,,,,,,,,
20130117-M-Davis_Cup_World_Group_F-RR-Novak_Djokovic-Tomas_Berdych,2,S-XC,29,4,0,0,4,9,20,,,,,,,,,,
20130117-M-Davis_Cup_World_Group_F-RR-Novak_Djokovic-Tomas_Berdych,2,S-DTM,13,0,0,0,0,6,7,,,,,,,,,,
20130117-M-Davis_Cup_World_Group_F-RR-Novak_Djokovic-Tomas_Berdych,2,S-DTL,7,3,1,0,2,2,5,,,,,,,,,,
20130117-M-Davis_Cup_World_Group_F-RR-Novak_Djokovic-Tomas_Berdych,2,S-IO,1,0,0,0,0,0,1,,,,,,,,,,
20130120-M-Australian_Open-R16-Novak_Djokovic-Stanislas_Wawrinka,1,F-XC,144,26,8,10,8,82,62,,,,,,,,,,
20130120-M-Australian_Open-R16-Novak_Djokovic-Stanislas_Wawrinka,1,F-DTM,66,3,0,1,2,28,38,,,,,,,,,,
20130120-M-Australian_Open-R16-Novak_Djokovic-Stanislas_Wawrinka,1,F-DTL,60,18,5,4,9,34,26,,,,,,,,,,
20130120-M-Australian_Open-R16-Novak_Djokovic-Stanislas_Wawrinka,1,F-IO,65,14,2,6,6,41,24,,,,,,,,,,
20130120-M-Australian_Open-R16-Novak_Djokovic-Stanislas_Wawrinka,1,F-II,20,3,1,2,0,12,8,,,,,,,,,,
20130120-M-Australian_Open-R16-Novak_Djokovic-Stanislas_Wawrinka,1,B-XC,120,23,5,12,6,70,50,,,,,,,,,,
20130120-M-Australian_Open-R16-Novak_Djokovic-Stanislas_Wawrinka,1,B-DTM,72,3,0,0,3,30,42,,,,,,,,,,
20130120-M-Australian_Open-R16-Novak_Djokovic-Stanislas_Wawrinka,1,B-DTL,47,19,4,4,11,23,24,,,,,,,,,,
20130120-M-Australian_Open-R16-Novak_Djokovic-Stanislas_Wawrinka,1,B-IO,23,4,0,1,3,12,11,,,,,,,,,,
20130120-M-Australian_Open-R16-Novak_Djokovic-Stanislas_Wawrinka,1,S-XC,11,1,0,0,1,5,6,,,,,,,,,,
20130120-M-Australian_Open-R16-Novak_Djokovic-Stanislas_Wawrinka,1,S-DTM,7,1,0,1,0,4,3,,,,,,,,,,
20130120-M-Australian_Open-R16-Novak_Djokovic-Stanislas_Wawrinka,1,S-DTL,8,0,0,0,0,2,6,,,,,,,,,,
20130120-M-Australian_Open-R16-Novak_Djokovic-Stanislas_Wawrinka,1,S-IO,1,0,0,0,0,1,0,,,,,,,,,,
20130120-M-Australian_Open-R16-Novak_Djokovic-Stanislas_Wawrinka,2,F-XC,179,29,7,10,12,92,87,,,,,,,,,,
20130120-M-Australian_Open-R16-Novak_Djokovic-Stanislas_Wawrinka,2,F-DTM,81,8,0,3,5,40,41,,,,,,,,,,
20130120-M-Australian_Open-R16-Novak_Djokovic-Stanislas_Wawrinka,2,F-DTL,31,9,3,2,4,15,16,,,,,,,,,,
20130120-M-Australian_Open-R16-Novak_Djokovic-Stanislas_Wawrinka,2,F-IO,50,19,7,5,7,31,19,,,,,,,,,,
20130120-M-Australian_Open-R16-Novak_Djokovic-Stanislas_Wawrinka,2,F-II,8,3,1,1,1,5,3,,,,,,,,,,
20130120-M-Australian_Open-R16-Novak_Djokovic-Stanislas_Wawrinka,2,B-XC,121,26,6,9,11,58,63,,,,,,,,,,
20130120-M-Australian_Open-R16-Novak_Djokovic-Stanislas_Wawrinka,2,B-DTM,70,10,0,0,10,30,40,,,,,,,,,,
20130120-M-Australian_Open-R16-Novak_Djokovic-Stanislas_Wawrinka,2,B-DTL,35,18,7,1,10,16,19,,,,,,,,,,
20130120-M-Australian_Open-R16-Novak_Djokovic-Stanislas_Wawrinka,2,B-IO,17,8,4,1,3,13,4,,,,,,,,,,
20130120-M-Australian_Open-R16-Novak_Djokovic-Stanislas_Wawrinka,2,B-II,1,1,1,0,0,1,0,,,,,,,,,,
20130120-M-Australian_Open-R16-Novak_Djokovic-Stanislas_Wawrinka,2,S-XC,56,3,0,1,2,19,37,,,,,,,,,,
20130120-M-Australian_Open-R16-Novak_Djokovic-Stanislas_Wawrinka,2,S-DTM,12,1,0,0,1,3,9,,,,,,,,,,
20130120-M-Australian_Open-R16-Novak_Djokovic-Stanislas_Wawrinka,2,S-DTL,3,0,0,0,0,1,2,,,,,,,,,,
20130120-M-Australian_Open-R16-Novak_Djokovic-Stanislas_Wawrinka,2,S-IO,1,1,0,0,1,0,1,,,,,,,,,,
20130125-M-Australian_Open-SF-David_Ferrer-Novak_Djokovic,1,F-XC,58,7,1,1,5,13,45,,,,,,,,,,
20130125-M-Australian_Open-SF-David_Ferrer-Novak_Djokovic,1,F-DTM,31,2,0,0,2,8,23,,,,,,,,,,
20130125-M-Australian_Open-SF-David_Ferrer-Novak_Djokovic,1,F-DTL,10,4,1,1,2,3,7,,,,,,,,,,
20130125-M-Australian_Open-SF-David_Ferrer-Novak_Djokovic,1,F-IO,29,8,3,2,3,14,15,,,,,,,,,,
20130125-M-Australian_Open-SF-David_Ferrer-Novak_Djokovic,1,F-II,8,1,0,0,1,1,7,,,,,,,,,,
20130125-M-Australian_Open-SF-David_Ferrer-Novak_Djokovic,1,B-XC,45,5,1,2,2,14,31,,,,,,,,,,
20130125-M-Australian_Open-SF-David_Ferrer-Novak_Djokovic,1,B-DTM,39,1,0,0,1,13,26,,,,,,,,,,
20130125-M-Australian_Open-SF-David_Ferrer-Novak_Djokovic,1,B-DTL,7,3,1,0,2,2,5,,,,,,,,,,
20130125-M-Australian_Open-SF-David_Ferrer-Novak_Djokovic,1,B-IO,1,1,0,0,1,0,1,,,,,,,,,,
20130125-M-Australian_Open-SF-David_Ferrer-Novak_Djokovic,1,S-XC,4,0,0,0,0,0,4,,,,,,,,,,
20130125-M-Australian_Open-SF-David_Ferrer-Novak_Djokovic,1,S-DTM,9,0,0,0,0,1,8,,,,,,,,,,
20130125-M-Australian_Open-SF-David_Ferrer-Novak_Djokovic,1,S-DTL,1,0,0,0,0,0,1,,,,,,,,,,
20130125-M-Australian_Open-SF-David_Ferrer-Novak_Djokovic,2,F-XC,36,5,2,2,1,31,5,,,,,,,,,,
20130125-M-Australian_Open-SF-David_Ferrer-Novak_Djokovic,2,F-DTM,17,1,0,0,1,12,5,,,,,,,,,,
20130125-M-Australian_Open-SF-David_Ferrer-Novak_Djokovic,2,F-DTL,24,10,3,5,2,18,6,,,,,,,,,,
20130125-M-Australian_Open-SF-David_Ferrer-Novak_Djokovic,2,F-IO,26,6,2,0,4,15,11,,,,,,,,,,
20130125-M-Australian_Open-SF-David_Ferrer-Novak_Djokovic,2,B-XC,45,2,1,1,0,38,7,,,,,,,,,,
20130125-M-Australian_Open-SF-David_Ferrer-Novak_Djokovic,2,B-DTM,21,3,0,1,2,13,8,,,,,,,,,,
20130125-M-Australian_Open-SF-David_Ferrer-Novak_Djokovic,2,B-DTL,22,6,4,1,1,16,6,,,,,,,,,,
20130125-M-Australian_Open-SF-David_Ferrer-Novak_Djokovic,2,B-IO,12,5,2,1,2,9,3,,,,,,,,,,
20130125-M-Australian_Open-SF-David_Ferrer-Novak_Djokovic,2,S-XC,11,0,0,0,0,9,2,,,,,,,,,,
20130125-M-Australian_Open-SF-David_Ferrer-Novak_Djokovic,2,S-DTM,1,0,0,0,0,0,1,,,,,,,,,,
20130125-M-Australian_Open-SF-David_Ferrer-Novak_Djokovic,2,S-DTL,2,0,0,0,0,2,0,,,,,,,,,,
20130125-M-Australian_Open-SF-David_Ferrer-Novak_Djokovic,2,S-IO,1,0,0,0,0,0,1,,,,,,,,,,
20130127-M-Australian_Open-F-Novak_Djokovic-Andy_Murray,1,F-XC,107,20,4,3,13,59,48,,,,,,,,,,
20130127-M-Australian_Open-F-Novak_Djokovic-Andy_Murray,1,F-DTM,46,4,0,0,4,17,29,,,,,,,,,,
20130127-M-Australian_Open-F-Novak_Djokovic-Andy_Murray,1,F-DTL,48,8,2,4,2,32,16,,,,,,,,,,
20130127-M-Australian_Open-F-Novak_Djokovic-Andy_Murray,1,F-IO,67,16,4,5,7,34,33,,,,,,,,,,
20130127-M-Australian_Open-F-Novak_Djokovic-Andy_Murray,1,F-II,9,4,2,1,1,6,3,,,,,,,,,,
20130127-M-Australian_Open-F-Novak_Djokovic-Andy_Murray,1,B-XC,127,15,4,2,9,80,47,,,,,,,,,,
20130127-M-Australian_Open-F-Novak_Djokovic-Andy_Murray,1,B-DTM,66,3,0,0,3,37,29,,,,,,,,,,
20130127-M-Australian_Open-F-Novak_Djokovic-Andy_Murray,1,B-DTL,53,14,3,2,9,26,27,,,,,,,,,,
20130127-M-Australian_Open-F-Novak_Djokovic-Andy_Murray,1,B-IO,29,4,2,0,2,12,17,,,,,,,,,,
20130127-M-Australian_Open-F-Novak_Djokovic-Andy_Murray,1,S-XC,28,1,0,0,1,18,10,,,,,,,,,,
20130127-M-Australian_Open-F-Novak_Djokovic-Andy_Murray,1,S-DTM,11,1,0,0,1,7,4,,,,,,,,,,
20130127-M-Australian_Open-F-Novak_Djokovic-Andy_Murray,1,S-DTL,2,0,0,0,0,1,1,,,,,,,,,,
20130127-M-Australian_Open-F-Novak_Djokovic-Andy_Murray,1,S-IO,2,0,0,0,0,2,0,,,,,,,,,,
20130127-M-Australian_Open-F-Novak_Djokovic-Andy_Murray,2,F-XC,122,18,8,1,9,63,59,,,,,,,,,,
20130127-M-Australian_Open-F-Novak_Djokovic-Andy_Murray,2,F-DTM,45,1,0,0,1,23,22,,,,,,,,,,
20130127-M-Australian_Open-F-Novak_Djokovic-Andy_Murray,2,F-DTL,45,5,1,1,3,19,26,,,,,,,,,,
20130127-M-Australian_Open-F-Novak_Djokovic-Andy_Murray,2,F-IO,49,10,1,4,5,30,19,,,,,,,,,,
20130127-M-Australian_Open-F-Novak_Djokovic-Andy_Murray,2,F-II,6,3,1,1,1,4,2,,,,,,,,,,
20130127-M-Australian_Open-F-Novak_Djokovic-Andy_Murray,2,B-XC,123,13,1,2,10,49,74,,,,,,,,,,
20130127-M-Australian_Open-F-Novak_Djokovic-Andy_Murray,2,B-DTM,70,0,0,0,0,36,34,,,,,,,,,,
20130127-M-Australian_Open-F-Novak_Djokovic-Andy_Murray,2,B-DTL,34,6,2,0,4,14,20,,,,,,,,,,
20130127-M-Australian_Open-F-Novak_Djokovic-Andy_Murray,2,B-IO,17,4,0,0,4,5,12,,,,,,,,,,
20130127-M-Australian_Open-F-Novak_Djokovic-Andy_Murray,2,S-XC,38,1,0,0,1,13,25,,,,,,,,,,
20130127-M-Australian_Open-F-Novak_Djokovic-Andy_Murray,2,S-DTM,22,1,0,0,1,6,16,,,,,,,,,,
20130127-M-Australian_Open-F-Novak_Djokovic-Andy_Murray,2,S-DTL,11,1,0,1,0,3,8,,,,,,,,,,
20130127-M-Australian_Open-F-Novak_Djokovic-Andy_Murray,2,S-IO,1,1,0,0,1,0,1,,,,,,,,,,
20130225-M-Acapulco-F-David_Ferrer-Rafael_Nadal,1,F-XC,44,2,0,0,2,17,27,,,,,,,,,,
20130225-M-Acapulco-F-David_Ferrer-Rafael_Nadal,1,F-DTM,15,1,0,0,1,4,11,,,,,,,,,,
20130225-M-Acapulco-F-David_Ferrer-Rafael_Nadal,1,F-DTL,9,5,2,1,2,3,6,,,,,,,,,,
20130225-M-Acapulco-F-David_Ferrer-Rafael_Nadal,1,F-IO,21,7,0,2,5,5,16,,,,,,,,,,
20130225-M-Acapulco-F-David_Ferrer-Rafael_Nadal,1,F-II,9,2,1,1,0,4,5,,,,,,,,,,
20130225-M-Acapulco-F-David_Ferrer-Rafael_Nadal,1,B-XC,16,4,1,0,3,3,13,,,,,,,,,,
20130225-M-Acapulco-F-David_Ferrer-Rafael_Nadal,1,B-DTM,13,1,0,0,1,4,9,,,,,,,,,,
20130225-M-Acapulco-F-David_Ferrer-Rafael_Nadal,1,B-DTL,21,5,0,0,5,6,15,,,,,,,,,,
20130225-M-Acapulco-F-David_Ferrer-Rafael_Nadal,1,B-IO,3,0,0,0,0,2,1,,,,,,,,,,
20130225-M-Acapulco-F-David_Ferrer-Rafael_Nadal,1,S-DTM,1,0,0,0,0,0,1,,,,,,,,,,
20130225-M-Acapulco-F-David_Ferrer-Rafael_Nadal,1,S-DTL,2,0,0,0,0,0,2,,,,,,,,,,
20130225-M-Acapulco-F-David_Ferrer-Rafael_Nadal,2,F-XC,37,9,4,5,0,31,6,,,,,,,,,,
20130225-M-Acapulco-F-David_Ferrer-Rafael_Nadal,2,F-DTM,7,2,1,0,1,3,4,,,,,,,,,,
20130225-M-Acapulco-F-David_Ferrer-Rafael_Nadal,2,F-DTL,6,2,1,0,1,4,2,,,,,,,,,,
20130225-M-Acapulco-F-David_Ferrer-Rafael_Nadal,2,F-IO,10,4,2,1,1,9,1,,,,,,,,,,
20130225-M-Acapulco-F-David_Ferrer-Rafael_Nadal,2,F-II,10,2,0,2,0,9,1,,,,,,,,,,
20130225-M-Acapulco-F-David_Ferrer-Rafael_Nadal,2,B-XC,38,7,4,0,3,19,19,,,,,,,,,,
20130225-M-Acapulco-F-David_Ferrer-Rafael_Nadal,2,B-DTM,12,0,0,0,0,9,3,,,,,,,,,,
20130225-M-Acapulco-F-David_Ferrer-Rafael_Nadal,2,B-DTL,22,5,3,1,1,16,6,,,,,,,,,,
20130225-M-Acapulco-F-David_Ferrer-Rafael_Nadal,2,B-IO,4,0,0,0,0,3,1,,,,,,,,,,
20130225-M-Acapulco-F-David_Ferrer-Rafael_Nadal,2,S-DTM,3,0,0,0,0,1,2,,,,,,,,,,
20130225-M-Acapulco-F-David_Ferrer-Rafael_Nadal,2,S-DTL,7,1,0,0,1,5,2,,,,,,,,,,
20130302-M-Dubai-F-Novak_Djokovic-Tomas_Berdych,1,F-XC,41,5,3,1,1,21,20,,,,,,,,,,
20130302-M-Dubai-F-Novak_Djokovic-Tomas_Berdych,1,F-DTM,13,3,0,0,3,5,8,,,,,,,,,,
20130302-M-Dubai-F-Novak_Djokovic-Tomas_Berdych,1,F-DTL,21,4,0,0,4,7,14,,,,,,,,,,
20130302-M-Dubai-F-Novak_Djokovic-Tomas_Berdych,1,F-IO,27,5,1,2,2,17,10,,,,,,,,,,
20130302-M-Dubai-F-Novak_Djokovic-Tomas_Berdych,1,F-II,3,2,2,0,0,2,1,,,,,,,,,,
20130302-M-Dubai-F-Novak_Djokovic-Tomas_Berdych,1,B-XC,37,4,1,0,3,18,19,,,,,,,,,,
20130302-M-Dubai-F-Novak_Djokovic-Tomas_Berdych,1,B-DTM,11,1,0,0,1,7,4,,,,,,,,,,
20130302-M-Dubai-F-Novak_Djokovic-Tomas_Berdych,1,B-DTL,14,4,0,1,3,3,11,,,,,,,,,,
20130302-M-Dubai-F-Novak_Djokovic-Tomas_Berdych,1,B-IO,5,2,0,0,2,1,4,,,,,,,,,,
20130302-M-Dubai-F-Novak_Djokovic-Tomas_Berdych,1,S-XC,5,0,0,0,0,0,5,,,,,,,,,,
20130302-M-Dubai-F-Novak_Djokovic-Tomas_Berdych,1,S-DTM,3,0,0,0,0,2,1,,,,,,,,,,
20130302-M-Dubai-F-Novak_Djokovic-Tomas_Berdych,2,F-XC,44,11,2,2,7,26,18,,,,,,,,,,
20130302-M-Dubai-F-Novak_Djokovic-Tomas_Berdych,2,F-DTM,20,1,0,0,1,7,13,,,,,,,,,,
20130302-M-Dubai-F-Novak_Djokovic-Tomas_Berdych,2,F-DTL,13,5,0,0,5,7,6,,,,,,,,,,
20130302-M-Dubai-F-Novak_Djokovic-Tomas_Berdych,2,F-IO,23,5,3,0,2,12,11,,,,,,,,,,
20130302-M-Dubai-F-Novak_Djokovic-Tomas_Berdych,2,F-II,6,2,1,0,1,3,3,,,,,,,,,,
20130302-M-Dubai-F-Novak_Djokovic-Tomas_Berdych,2,B-XC,41,6,0,1,5,21,20,,,,,,,,,,
20130302-M-Dubai-F-Novak_Djokovic-Tomas_Berdych,2,B-DTM,14,2,0,0,2,4,10,,,,,,,,,,
20130302-M-Dubai-F-Novak_Djokovic-Tomas_Berdych,2,B-DTL,19,5,1,1,3,11,8,,,,,,,,,,
20130302-M-Dubai-F-Novak_Djokovic-Tomas_Berdych,2,B-IO,3,2,1,0,1,2,1,,,,,,,,,,
20130302-M-Dubai-F-Novak_Djokovic-Tomas_Berdych,2,B-II,2,0,0,0,0,2,0,,,,,,,,,,
20130302-M-Dubai-F-Novak_Djokovic-Tomas_Berdych,2,S-XC,3,0,0,0,0,2,1,,,,,,,,,,
20130302-M-Dubai-F-Novak_Djokovic-Tomas_Berdych,2,S-DTM,1,0,0,0,0,0,1,,,,,,,,,,
20130302-M-Dubai-F-Novak_Djokovic-Tomas_Berdych,2,S-DTL,2,1,0,0,1,0,2,,,,,,,,,,
20130307-M-Indian_Wells_Masters-R32-Richard_Gasquet-Jerzy_Janowicz,1,F-XC,11,1,1,0,0,7,4,,,,,,,,,,
20130307-M-Indian_Wells_Masters-R32-Richard_Gasquet-Jerzy_Janowicz,1,F-DTM,10,2,1,0,1,7,3,,,,,,,,,,
20130307-M-Indian_Wells_Masters-R32-Richard_Gasquet-Jerzy_Janowicz,1,F-DTL,5,1,1,0,0,4,1,,,,,,,,,,
20130307-M-Indian_Wells_Masters-R32-Richard_Gasquet-Jerzy_Janowicz,1,F-IO,8,4,1,3,0,7,1,,,,,,,,,,
20130307-M-Indian_Wells_Masters-R32-Richard_Gasquet-Jerzy_Janowicz,1,B-XC,26,4,1,2,1,19,7,,,,,,,,,,
20130307-M-Indian_Wells_Masters-R32-Richard_Gasquet-Jerzy_Janowicz,1,B-DTM,12,1,0,0,1,8,4,,,,,,,,,,
20130307-M-Indian_Wells_Masters-R32-Richard_Gasquet-Jerzy_Janowicz,1,B-DTL,5,2,2,0,0,4,1,,,,,,,,,,
20130307-M-Indian_Wells_Masters-R32-Richard_Gasquet-Jerzy_Janowicz,1,B-IO,2,1,0,1,0,2,0,,,,,,,,,,
20130307-M-Indian_Wells_Masters-R32-Richard_Gasquet-Jerzy_Janowicz,1,S-XC,7,0,0,0,0,5,2,,,,,,,,,,
20130307-M-Indian_Wells_Masters-R32-Richard_Gasquet-Jerzy_Janowicz,1,S-DTM,2,0,0,0,0,2,0,,,,,,,,,,
20130307-M-Indian_Wells_Masters-R32-Richard_Gasquet-Jerzy_Janowicz,2,F-XC,26,14,4,4,6,12,14,,,,,,,,,,
20130307-M-Indian_Wells_Masters-R32-Richard_Gasquet-Jerzy_Janowicz,2,F-DTM,7,0,0,0,0,0,7,,,,,,,,,,
20130307-M-Indian_Wells_Masters-R32-Richard_Gasquet-Jerzy_Janowicz,2,F-DTL,2,2,0,1,1,1,1,,,,,,,,,,
20130307-M-Indian_Wells_Masters-R32-Richard_Gasquet-Jerzy_Janowicz,2,F-IO,14,7,2,1,4,4,10,,,,,,,,,,
20130307-M-Indian_Wells_Masters-R32-Richard_Gasquet-Jerzy_Janowicz,2,F-II,3,2,0,0,2,1,2,,,,,,,,,,
20130307-M-Indian_Wells_Masters-R32-Richard_Gasquet-Jerzy_Janowicz,2,B-XC,16,5,1,2,2,7,9,,,,,,,,,,
20130307-M-Indian_Wells_Masters-R32-Richard_Gasquet-Jerzy_Janowicz,2,B-DTM,16,0,0,0,0,4,12,,,,,,,,,,
20130307-M-Indian_Wells_Masters-R32-Richard_Gasquet-Jerzy_Janowicz,2,B-DTL,2,2,1,0,1,1,1,,,,,,,,,,
20130307-M-Indian_Wells_Masters-R32-Richard_Gasquet-Jerzy_Janowicz,2,B-IO,4,2,0,0,2,0,4,,,,,,,,,,
20130307-M-Indian_Wells_Masters-R32-Richard_Gasquet-Jerzy_Janowicz,2,S-XC,5,0,0,0,0,1,4,,,,,,,,,,
20130307-M-Indian_Wells_Masters-R32-Richard_Gasquet-Jerzy_Janowicz,2,S-DTM,4,1,0,0,1,3,1,,,,,,,,,,
20130314-M-Indian_Wells-R16-Tommy_Haas-Juan_Martin_Del_Potro,1,F-XC,53,15,0,4,11,17,36,,,,,,,,,,
20130314-M-Indian_Wells-R16-Tommy_Haas-Juan_Martin_Del_Potro,1,F-DTM,22,2,0,0,2,7,15,,,,,,,,,,
20130314-M-Indian_Wells-R16-Tommy_Haas-Juan_Martin_Del_Potro,1,F-DTL,19,5,1,0,4,5,14,,,,,,,,,,
20130314-M-Indian_Wells-R16-Tommy_Haas-Juan_Martin_Del_Potro,1,F-IO,25,4,2,0,2,11,14,,,,,,,,,,
20130314-M-Indian_Wells-R16-Tommy_Haas-Juan_Martin_Del_Potro,1,F-II,3,1,1,0,0,1,2,,,,,,,,,,
20130314-M-Indian_Wells-R16-Tommy_Haas-Juan_Martin_Del_Potro,1,B-XC,22,2,0,1,1,5,17,,,,,,,,,,
20130314-M-Indian_Wells-R16-Tommy_Haas-Juan_Martin_Del_Potro,1,B-DTM,19,0,0,0,0,9,10,,,,,,,,,,
20130314-M-Indian_Wells-R16-Tommy_Haas-Juan_Martin_Del_Potro,1,B-DTL,7,4,0,0,4,2,5,,,,,,,,,,
20130314-M-Indian_Wells-R16-Tommy_Haas-Juan_Martin_Del_Potro,1,B-IO,8,5,1,1,3,3,5,,,,,,,,,,
20130314-M-Indian_Wells-R16-Tommy_Haas-Juan_Martin_Del_Potro,1,S-XC,11,0,0,0,0,5,6,,,,,,,,,,
20130314-M-Indian_Wells-R16-Tommy_Haas-Juan_Martin_Del_Potro,1,S-DTM,9,1,0,0,1,5,4,,,,,,,,,,
20130314-M-Indian_Wells-R16-Tommy_Haas-Juan_Martin_Del_Potro,1,S-IO,1,0,0,0,0,0,1,,,,,,,,,,
20130314-M-Indian_Wells-R16-Tommy_Haas-Juan_Martin_Del_Potro,2,F-XC,51,6,2,1,3,37,14,,,,,,,,,,
20130314-M-Indian_Wells-R16-Tommy_Haas-Juan_Martin_Del_Potro,2,F-DTM,30,3,0,0,3,18,12,,,,,,,,,,
20130314-M-Indian_Wells-R16-Tommy_Haas-Juan_Martin_Del_Potro,2,F-DTL,6,1,0,1,0,4,2,,,,,,,,,,
20130314-M-Indian_Wells-R16-Tommy_Haas-Juan_Martin_Del_Potro,2,F-IO,31,5,1,0,4,15,16,,,,,,,,,,
20130314-M-Indian_Wells-R16-Tommy_Haas-Juan_Martin_Del_Potro,2,F-II,1,1,1,0,0,1,0,,,,,,,,,,
20130314-M-Indian_Wells-R16-Tommy_Haas-Juan_Martin_Del_Potro,2,B-XC,23,2,1,1,0,16,7,,,,,,,,,,
20130314-M-Indian_Wells-R16-Tommy_Haas-Juan_Martin_Del_Potro,2,B-DTM,31,1,0,0,1,19,12,,,,,,,,,,
20130314-M-Indian_Wells-R16-Tommy_Haas-Juan_Martin_Del_Potro,2,S-XC,9,1,0,0,1,4,5,,,,,,,,,,
20130314-M-Indian_Wells-R16-Tommy_Haas-Juan_Martin_Del_Potro,2,S-DTM,4,0,0,0,0,3,1,,,,,,,,,,
20130317-M-Indian_Wells_Masters-F-Rafael_Nadal-Juan_Martin_Del_Potro,1,F-XC,138,17,8,1,8,96,42,,,,,,,,,,
20130317-M-Indian_Wells_Masters-F-Rafael_Nadal-Juan_Martin_Del_Potro,1,F-DTM,26,2,0,0,2,12,14,,,,,,,,,,
20130317-M-Indian_Wells_Masters-F-Rafael_Nadal-Juan_Martin_Del_Potro,1,F-DTL,25,10,7,1,2,19,6,,,,,,,,,,
20130317-M-Indian_Wells_Masters-F-Rafael_Nadal-Juan_Martin_Del_Potro,1,F-IO,36,16,8,2,6,20,16,,,,,,,,,,
20130317-M-Indian_Wells_Masters-F-Rafael_Nadal-Juan_Martin_Del_Potro,1,F-II,14,1,1,0,0,9,5,,,,,,,,,,
20130317-M-Indian_Wells_Masters-F-Rafael_Nadal-Juan_Martin_Del_Potro,1,B-XC,39,7,3,1,3,29,10,,,,,,,,,,
20130317-M-Indian_Wells_Masters-F-Rafael_Nadal-Juan_Martin_Del_Potro,1,B-DTM,18,1,0,0,1,10,8,,,,,,,,,,
20130317-M-Indian_Wells_Masters-F-Rafael_Nadal-Juan_Martin_Del_Potro,1,B-DTL,31,2,0,0,2,18,13,,,,,,,,,,
20130317-M-Indian_Wells_Masters-F-Rafael_Nadal-Juan_Martin_Del_Potro,1,B-IO,2,0,0,0,0,2,0,,,,,,,,,,
20130317-M-Indian_Wells_Masters-F-Rafael_Nadal-Juan_Martin_Del_Potro,1,S-XC,1,0,0,0,0,0,1,,,,,,,,,,
20130317-M-Indian_Wells_Masters-F-Rafael_Nadal-Juan_Martin_Del_Potro,1,S-DTM,8,0,0,0,0,6,2,,,,,,,,,,
20130317-M-Indian_Wells_Masters-F-Rafael_Nadal-Juan_Martin_Del_Potro,1,S-DTL,9,0,0,0,0,7,2,,,,,,,,,,
20130317-M-Indian_Wells_Masters-F-Rafael_Nadal-Juan_Martin_Del_Potro,1,S-IO,1,0,0,0,0,1,0,,,,,,,,,,
20130317-M-Indian_Wells_Masters-F-Rafael_Nadal-Juan_Martin_Del_Potro,2,F-XC,72,18,6,5,7,34,38,,,,,,,,,,
20130317-M-Indian_Wells_Masters-F-Rafael_Nadal-Juan_Martin_Del_Potro,2,F-DTM,30,2,0,0,2,9,21,,,,,,,,,,
20130317-M-Indian_Wells_Masters-F-Rafael_Nadal-Juan_Martin_Del_Potro,2,F-DTL,23,10,4,1,5,13,10,,,,,,,,,,
20130317-M-Indian_Wells_Masters-F-Rafael_Nadal-Juan_Martin_Del_Potro,2,F-IO,48,17,7,5,5,26,22,,,,,,,,,,
20130317-M-Indian_Wells_Masters-F-Rafael_Nadal-Juan_Martin_Del_Potro,2,F-II,19,3,1,0,2,6,13,,,,,,,,,,
20130317-M-Indian_Wells_Masters-F-Rafael_Nadal-Juan_Martin_Del_Potro,2,B-XC,58,8,0,1,7,14,44,,,,,,,,,,
20130317-M-Indian_Wells_Masters-F-Rafael_Nadal-Juan_Martin_Del_Potro,2,B-DTM,41,6,0,0,6,13,28,,,,,,,,,,
20130317-M-Indian_Wells_Masters-F-Rafael_Nadal-Juan_Martin_Del_Potro,2,B-DTL,35,3,0,0,3,10,25,,,,,,,,,,
20130317-M-Indian_Wells_Masters-F-Rafael_Nadal-Juan_Martin_Del_Potro,2,B-IO,6,1,0,1,0,3,3,,,,,,,,,,
20130317-M-Indian_Wells_Masters-F-Rafael_Nadal-Juan_Martin_Del_Potro,2,S-XC,7,0,0,0,0,2,5,,,,,,,,,,
20130317-M-Indian_Wells_Masters-F-Rafael_Nadal-Juan_Martin_Del_Potro,2,S-DTM,10,0,0,0,0,3,7,,,,,,,,,,
20130317-M-Indian_Wells_Masters-F-Rafael_Nadal-Juan_Martin_Del_Potro,2,S-DTL,4,0,0,0,0,0,4,,,,,,,,,,
20130317-M-Indian_Wells_Masters-F-Rafael_Nadal-Juan_Martin_Del_Potro,2,S-IO,2,0,0,0,0,0,2,,,,,,,,,,
20130323-M-Miami_Masters-R64-Bernard_Tomic-Andy_Murray,1,F-XC,19,12,3,2,7,9,10,,,,,,,,,,
20130323-M-Miami_Masters-R64-Bernard_Tomic-Andy_Murray,1,F-DTM,9,1,0,0,1,3,6,,,,,,,,,,
20130323-M-Miami_Masters-R64-Bernard_Tomic-Andy_Murray,1,F-DTL,11,4,1,1,2,4,7,,,,,,,,,,
20130323-M-Miami_Masters-R64-Bernard_Tomic-Andy_Murray,1,F-IO,20,8,2,0,6,7,13,,,,,,,,,,
20130323-M-Miami_Masters-R64-Bernard_Tomic-Andy_Murray,1,F-II,1,0,0,0,0,1,0,,,,,,,,,,
20130323-M-Miami_Masters-R64-Bernard_Tomic-Andy_Murray,1,B-XC,12,4,0,1,3,6,6,,,,,,,,,,
20130323-M-Miami_Masters-R64-Bernard_Tomic-Andy_Murray,1,B-DTM,14,3,0,0,3,8,6,,,,,,,,,,
20130323-M-Miami_Masters-R64-Bernard_Tomic-Andy_Murray,1,B-DTL,6,3,1,0,2,2,4,,,,,,,,,,
20130323-M-Miami_Masters-R64-Bernard_Tomic-Andy_Murray,1,B-IO,4,3,2,0,1,3,1,,,,,,,,,,
20130323-M-Miami_Masters-R64-Bernard_Tomic-Andy_Murray,1,S-XC,10,0,0,0,0,2,8,,,,,,,,,,
20130323-M-Miami_Masters-R64-Bernard_Tomic-Andy_Murray,1,S-DTM,12,2,0,0,2,5,7,,,,,,,,,,
20130323-M-Miami_Masters-R64-Bernard_Tomic-Andy_Murray,1,S-DTL,2,1,0,0,1,1,1,,,,,,,,,,
20130323-M-Miami_Masters-R64-Bernard_Tomic-Andy_Murray,1,S-IO,4,2,0,1,1,2,2,,,,,,,,,,
20130323-M-Miami_Masters-R64-Bernard_Tomic-Andy_Murray,2,F-XC,17,3,2,0,1,11,6,,,,,,,,,,
20130323-M-Miami_Masters-R64-Bernard_Tomic-Andy_Murray,2,F-DTM,15,0,0,0,0,8,7,,,,,,,,,,
20130323-M-Miami_Masters-R64-Bernard_Tomic-Andy_Murray,2,F-DTL,4,1,0,0,1,1,3,,,,,,,,,,
20130323-M-Miami_Masters-R64-Bernard_Tomic-Andy_Murray,2,F-IO,7,0,0,0,0,4,3,,,,,,,,,,
20130323-M-Miami_Masters-R64-Bernard_Tomic-Andy_Murray,2,B-XC,16,4,2,0,2,10,6,,,,,,,,,,
20130323-M-Miami_Masters-R64-Bernard_Tomic-Andy_Murray,2,B-DTM,17,1,0,0,1,10,7,,,,,,,,,,
20130323-M-Miami_Masters-R64-Bernard_Tomic-Andy_Murray,2,B-DTL,4,1,0,0,1,3,1,,,,,,,,,,
20130323-M-Miami_Masters-R64-Bernard_Tomic-Andy_Murray,2,B-IO,2,1,0,0,1,1,1,,,,,,,,,,
20130323-M-Miami_Masters-R64-Bernard_Tomic-Andy_Murray,2,S-XC,9,0,0,0,0,6,3,,,,,,,,,,
20130323-M-Miami_Masters-R64-Bernard_Tomic-Andy_Murray,2,S-DTM,11,0,0,0,0,5,6,,,,,,,,,,
20130323-M-Miami_Masters-R64-Bernard_Tomic-Andy_Murray,2,S-DTL,1,1,0,0,1,0,1,,,,,,,,,,
20130323-M-Miami_Masters-R64-Bernard_Tomic-Andy_Murray,2,S-IO,2,0,0,0,0,1,1,,,,,,,,,,
20130323-M-Miami_Masters-R64-Bernard_Tomic-Andy_Murray,2,S-II,1,0,0,0,0,0,1,,,,,,,,,,
20130327-M-Miami_Masters-R16-Novak_Djokovic-Tommy_Haas,1,F-XC,83,12,2,2,8,40,43,,,,,,,,,,
20130327-M-Miami_Masters-R16-Novak_Djokovic-Tommy_Haas,1,F-DTM,40,5,0,0,5,20,20,,,,,,,,,,
20130327-M-Miami_Masters-R16-Novak_Djokovic-Tommy_Haas,1,F-DTL,19,7,1,2,4,7,12,,,,,,,,,,
20130327-M-Miami_Masters-R16-Novak_Djokovic-Tommy_Haas,1,F-IO,28,4,0,1,3,11,17,,,,,,,,,,
20130327-M-Miami_Masters-R16-Novak_Djokovic-Tommy_Haas,1,F-II,3,1,0,1,0,1,2,,,,,,,,,,
20130327-M-Miami_Masters-R16-Novak_Djokovic-Tommy_Haas,1,B-XC,26,2,0,0,2,9,17,,,,,,,,,,
20130327-M-Miami_Masters-R16-Novak_Djokovic-Tommy_Haas,1,B-DTM,27,2,0,0,2,9,18,,,,,,,,,,
20130327-M-Miami_Masters-R16-Novak_Djokovic-Tommy_Haas,1,B-DTL,4,0,0,0,0,2,2,,,,,,,,,,
20130327-M-Miami_Masters-R16-Novak_Djokovic-Tommy_Haas,1,B-IO,9,2,0,0,2,5,4,,,,,,,,,,
20130327-M-Miami_Masters-R16-Novak_Djokovic-Tommy_Haas,1,S-XC,3,1,0,0,1,1,2,,,,,,,,,,
20130327-M-Miami_Masters-R16-Novak_Djokovic-Tommy_Haas,1,S-DTM,11,0,0,0,0,7,4,,,,,,,,,,
20130327-M-Miami_Masters-R16-Novak_Djokovic-Tommy_Haas,1,S-DTL,1,1,0,0,1,0,1,,,,,,,,,,
20130327-M-Miami_Masters-R16-Novak_Djokovic-Tommy_Haas,1,S-IO,1,0,0,0,0,0,1,,,,,,,,,,
20130327-M-Miami_Masters-R16-Novak_Djokovic-Tommy_Haas,2,F-XC,75,4,1,0,3,43,32,,,,,,,,,,
20130327-M-Miami_Masters-R16-Novak_Djokovic-Tommy_Haas,2,F-DTM,36,4,0,0,4,18,18,,,,,,,,,,
20130327-M-Miami_Masters-R16-Novak_Djokovic-Tommy_Haas,2,F-DTL,15,6,3,1,2,8,7,,,,,,,,,,
20130327-M-Miami_Masters-R16-Novak_Djokovic-Tommy_Haas,2,F-IO,9,3,2,1,0,8,1,,,,,,,,,,
20130327-M-Miami_Masters-R16-Novak_Djokovic-Tommy_Haas,2,F-II,1,0,0,0,0,0,1,,,,,,,,,,
20130327-M-Miami_Masters-R16-Novak_Djokovic-Tommy_Haas,2,B-XC,20,4,0,2,2,11,9,,,,,,,,,,
20130327-M-Miami_Masters-R16-Novak_Djokovic-Tommy_Haas,2,B-DTM,24,1,0,0,1,12,12,,,,,,,,,,
20130327-M-Miami_Masters-R16-Novak_Djokovic-Tommy_Haas,2,B-DTL,6,2,0,0,2,2,4,,,,,,,,,,
20130327-M-Miami_Masters-R16-Novak_Djokovic-Tommy_Haas,2,B-IO,4,2,1,1,0,3,1,,,,,,,,,,
20130327-M-Miami_Masters-R16-Novak_Djokovic-Tommy_Haas,2,B-II,1,0,0,0,0,0,1,,,,,,,,,,
20130327-M-Miami_Masters-R16-Novak_Djokovic-Tommy_Haas,2,S-XC,18,3,0,0,3,12,6,,,,,,,,,,
20130327-M-Miami_Masters-R16-Novak_Djokovic-Tommy_Haas,2,S-DTM,24,1,0,0,1,12,12,,,,,,,,,,
20130327-M-Miami_Masters-R16-Novak_Djokovic-Tommy_Haas,2,S-DTL,1,1,0,1,0,1,0,,,,,,,,,,
20130327-M-Miami_Masters-R16-Novak_Djokovic-Tommy_Haas,2,S-IO,7,1,0,1,0,2,5,,,,,,,,,,
20130414-M-Monte_Carlo_Masters-F-Novak_Djokovic-Rafael_Nadal,1,F-XC,90,8,3,4,1,54,36,,,,,,,,,,
20130414-M-Monte_Carlo_Masters-F-Novak_Djokovic-Rafael_Nadal,1,F-DTM,29,2,0,0,2,15,14,,,,,,,,,,
20130414-M-Monte_Carlo_Masters-F-Novak_Djokovic-Rafael_Nadal,1,F-DTL,11,4,3,1,0,9,2,,,,,,,,,,
20130414-M-Monte_Carlo_Masters-F-Novak_Djokovic-Rafael_Nadal,1,F-IO,25,6,4,0,2,13,12,,,,,,,,,,
20130414-M-Monte_Carlo_Masters-F-Novak_Djokovic-Rafael_Nadal,1,F-II,6,1,0,0,1,2,4,,,,,,,,,,
20130414-M-Monte_Carlo_Masters-F-Novak_Djokovic-Rafael_Nadal,1,B-XC,52,13,5,6,2,35,17,,,,,,,,,,
20130414-M-Monte_Carlo_Masters-F-Novak_Djokovic-Rafael_Nadal,1,B-DTM,48,0,0,0,0,30,18,,,,,,,,,,
20130414-M-Monte_Carlo_Masters-F-Novak_Djokovic-Rafael_Nadal,1,B-DTL,20,7,2,1,4,10,10,,,,,,,,,,
20130414-M-Monte_Carlo_Masters-F-Novak_Djokovic-Rafael_Nadal,1,B-IO,8,0,0,0,0,4,4,,,,,,,,,,
20130414-M-Monte_Carlo_Masters-F-Novak_Djokovic-Rafael_Nadal,1,S-XC,1,0,0,0,0,1,0,,,,,,,,,,
20130414-M-Monte_Carlo_Masters-F-Novak_Djokovic-Rafael_Nadal,1,S-DTM,2,0,0,0,0,0,2,,,,,,,,,,
20130414-M-Monte_Carlo_Masters-F-Novak_Djokovic-Rafael_Nadal,1,S-DTL,2,0,0,0,0,1,1,,,,,,,,,,
20130414-M-Monte_Carlo_Masters-F-Novak_Djokovic-Rafael_Nadal,1,S-II,1,1,0,0,1,0,1,,,,,,,,,,
20130414-M-Monte_Carlo_Masters-F-Novak_Djokovic-Rafael_Nadal,2,F-XC,71,8,3,4,1,33,38,,,,,,,,,,
20130414-M-Monte_Carlo_Masters-F-Novak_Djokovic-Rafael_Nadal,2,F-DTM,29,2,0,0,2,8,21,,,,,,,,,,
20130414-M-Monte_Carlo_Masters-F-Novak_Djokovic-Rafael_Nadal,2,F-DTL,18,5,3,1,1,12,6,,,,,,,,,,
20130414-M-Monte_Carlo_Masters-F-Novak_Djokovic-Rafael_Nadal,2,F-IO,32,10,2,5,3,15,17,,,,,,,,,,
20130414-M-Monte_Carlo_Masters-F-Novak_Djokovic-Rafael_Nadal,2,F-II,6,2,1,0,1,3,3,,,,,,,,,,
20130414-M-Monte_Carlo_Masters-F-Novak_Djokovic-Rafael_Nadal,2,B-XC,49,7,1,1,5,20,29,,,,,,,,,,
20130414-M-Monte_Carlo_Masters-F-Novak_Djokovic-Rafael_Nadal,2,B-DTM,33,3,0,0,3,11,22,,,,,,,,,,
20130414-M-Monte_Carlo_Masters-F-Novak_Djokovic-Rafael_Nadal,2,B-DTL,18,4,0,2,2,7,11,,,,,,,,,,
20130414-M-Monte_Carlo_Masters-F-Novak_Djokovic-Rafael_Nadal,2,B-IO,8,0,0,0,0,3,5,,,,,,,,,,
20130414-M-Monte_Carlo_Masters-F-Novak_Djokovic-Rafael_Nadal,2,B-II,1,0,0,0,0,1,0,,,,,,,,,,
20130414-M-Monte_Carlo_Masters-F-Novak_Djokovic-Rafael_Nadal,2,S-XC,4,0,0,0,0,0,4,,,,,,,,,,
20130414-M-Monte_Carlo_Masters-F-Novak_Djokovic-Rafael_Nadal,2,S-DTM,10,2,0,0,2,4,6,,,,,,,,,,
20130414-M-Monte_Carlo_Masters-F-Novak_Djokovic-Rafael_Nadal,2,S-DTL,15,1,0,0,1,6,9,,,,,,,,,,
20130414-M-Monte_Carlo_Masters-F-Novak_Djokovic-Rafael_Nadal,2,S-IO,3,0,0,0,0,2,1,,,,,,,,,,
20130417-M-Monte_Carlo_Masters-R16-Andy_Murray-Stanislas_Wawrinka,1,F-XC,38,10,2,2,6,19,19,,,,,,,,,,
20130417-M-Monte_Carlo_Masters-R16-Andy_Murray-Stanislas_Wawrinka,1,F-DTM,10,0,0,0,0,4,6,,,,,,,,,,
20130417-M-Monte_Carlo_Masters-R16-Andy_Murray-Stanislas_Wawrinka,1,F-DTL,18,5,1,0,4,8,10,,,,,,,,,,
20130417-M-Monte_Carlo_Masters-R16-Andy_Murray-Stanislas_Wawrinka,1,F-IO,24,2,1,0,1,12,12,,,,,,,,,,
20130417-M-Monte_Carlo_Masters-R16-Andy_Murray-Stanislas_Wawrinka,1,F-II,4,3,0,1,2,1,3,,,,,,,,,,
20130417-M-Monte_Carlo_Masters-R16-Andy_Murray-Stanislas_Wawrinka,1,B-XC,28,1,0,0,1,11,17,,,,,,,,,,
20130417-M-Monte_Carlo_Masters-R16-Andy_Murray-Stanislas_Wawrinka,1,B-DTM,9,0,0,0,0,3,6,,,,,,,,,,
20130417-M-Monte_Carlo_Masters-R16-Andy_Murray-Stanislas_Wawrinka,1,B-DTL,5,1,1,0,0,2,3,,,,,,,,,,
20130417-M-Monte_Carlo_Masters-R16-Andy_Murray-Stanislas_Wawrinka,1,S-XC,7,1,0,0,1,1,6,,,,,,,,,,
20130417-M-Monte_Carlo_Masters-R16-Andy_Murray-Stanislas_Wawrinka,1,S-DTM,5,0,0,0,0,3,2,,,,,,,,,,
20130417-M-Monte_Carlo_Masters-R16-Andy_Murray-Stanislas_Wawrinka,1,S-DTL,1,0,0,0,0,0,1,,,,,,,,,,
20130417-M-Monte_Carlo_Masters-R16-Andy_Murray-Stanislas_Wawrinka,2,F-XC,29,0,0,0,0,16,13,,,,,,,,,,
20130417-M-Monte_Carlo_Masters-R16-Andy_Murray-Stanislas_Wawrinka,2,F-DTM,8,3,1,0,2,2,6,,,,,,,,,,
20130417-M-Monte_Carlo_Masters-R16-Andy_Murray-Stanislas_Wawrinka,2,F-DTL,11,2,1,0,1,7,4,,,,,,,,,,
20130417-M-Monte_Carlo_Masters-R16-Andy_Murray-Stanislas_Wawrinka,2,F-IO,11,6,4,0,2,7,4,,,,,,,,,,
20130417-M-Monte_Carlo_Masters-R16-Andy_Murray-Stanislas_Wawrinka,2,F-II,3,2,1,1,0,2,1,,,,,,,,,,
20130417-M-Monte_Carlo_Masters-R16-Andy_Murray-Stanislas_Wawrinka,2,B-XC,45,7,2,1,4,27,18,,,,,,,,,,
20130417-M-Monte_Carlo_Masters-R16-Andy_Murray-Stanislas_Wawrinka,2,B-DTM,7,0,0,0,0,3,4,,,,,,,,,,
20130417-M-Monte_Carlo_Masters-R16-Andy_Murray-Stanislas_Wawrinka,2,B-DTL,11,3,1,0,2,6,5,,,,,,,,,,
20130417-M-Monte_Carlo_Masters-R16-Andy_Murray-Stanislas_Wawrinka,2,B-IO,3,0,0,0,0,2,1,,,,,,,,,,
20130417-M-Monte_Carlo_Masters-R16-Andy_Murray-Stanislas_Wawrinka,2,S-XC,5,0,0,0,0,4,1,,,,,,,,,,
20130417-M-Monte_Carlo_Masters-R16-Andy_Murray-Stanislas_Wawrinka,2,S-DTM,5,0,0,0,0,0,5,,,,,,,,,,
20130417-M-Monte_Carlo_Masters-R16-Andy_Murray-Stanislas_Wawrinka,2,S-DTL,4,1,1,0,0,3,1,,,,,,,,,,
20130419-M-Monte_Carlo_Masters-QF-Richard_Gasquet-Fabio_Fognini,1,F-XC,26,6,1,2,3,10,16,,,,,,,,,,
20130419-M-Monte_Carlo_Masters-QF-Richard_Gasquet-Fabio_Fognini,1,F-DTM,13,0,0,0,0,4,9,,,,,,,,,,
20130419-M-Monte_Carlo_Masters-QF-Richard_Gasquet-Fabio_Fognini,1,F-DTL,13,1,0,0,1,11,2,,,,,,,,,,
20130419-M-Monte_Carlo_Masters-QF-Richard_Gasquet-Fabio_Fognini,1,F-IO,19,5,1,3,1,11,8,,,,,,,,,,
20130419-M-Monte_Carlo_Masters-QF-Richard_Gasquet-Fabio_Fognini,1,B-XC,63,6,1,1,4,27,36,,,,,,,,,,
20130419-M-Monte_Carlo_Masters-QF-Richard_Gasquet-Fabio_Fognini,1,B-DTM,23,1,0,0,1,9,14,,,,,,,,,,
20130419-M-Monte_Carlo_Masters-QF-Richard_Gasquet-Fabio_Fognini,1,B-DTL,9,6,0,3,3,4,5,,,,,,,,,,
20130419-M-Monte_Carlo_Masters-QF-Richard_Gasquet-Fabio_Fognini,1,B-IO,8,4,2,1,1,6,2,,,,,,,,,,
20130419-M-Monte_Carlo_Masters-QF-Richard_Gasquet-Fabio_Fognini,1,B-II,1,1,0,1,0,1,0,,,,,,,,,,
20130419-M-Monte_Carlo_Masters-QF-Richard_Gasquet-Fabio_Fognini,1,S-XC,8,2,0,1,1,3,5,,,,,,,,,,
20130419-M-Monte_Carlo_Masters-QF-Richard_Gasquet-Fabio_Fognini,1,S-DTM,6,0,0,0,0,2,4,,,,,,,,,,
20130419-M-Monte_Carlo_Masters-QF-Richard_Gasquet-Fabio_Fognini,1,S-DTL,1,0,0,0,0,0,1,,,,,,,,,,
20130419-M-Monte_Carlo_Masters-QF-Richard_Gasquet-Fabio_Fognini,2,F-XC,34,10,5,3,2,19,15,,,,,,,,,,
20130419-M-Monte_Carlo_Masters-QF-Richard_Gasquet-Fabio_Fognini,2,F-DTM,11,1,0,0,1,6,5,,,,,,,,,,
20130419-M-Monte_Carlo_Masters-QF-Richard_Gasquet-Fabio_Fognini,2,F-DTL,14,3,2,1,0,11,3,,,,,,,,,,
20130419-M-Monte_Carlo_Masters-QF-Richard_Gasquet-Fabio_Fognini,2,F-IO,31,5,2,1,2,21,10,,,,,,,,,,
20130419-M-Monte_Carlo_Masters-QF-Richard_Gasquet-Fabio_Fognini,2,F-II,5,2,2,0,0,3,2,,,,,,,,,,
20130419-M-Monte_Carlo_Masters-QF-Richard_Gasquet-Fabio_Fognini,2,B-XC,33,9,1,1,7,14,19,,,,,,,,,,
20130419-M-Monte_Carlo_Masters-QF-Richard_Gasquet-Fabio_Fognini,2,B-DTM,35,3,0,0,3,18,17,,,,,,,,,,
20130419-M-Monte_Carlo_Masters-QF-Richard_Gasquet-Fabio_Fognini,2,B-DTL,19,11,3,1,7,9,10,,,,,,,,,,
20130419-M-Monte_Carlo_Masters-QF-Richard_Gasquet-Fabio_Fognini,2,B-IO,4,3,1,0,2,1,3,,,,,,,,,,
20130419-M-Monte_Carlo_Masters-QF-Richard_Gasquet-Fabio_Fognini,2,B-II,1,0,0,0,0,1,0,,,,,,,,,,
20130419-M-Monte_Carlo_Masters-QF-Richard_Gasquet-Fabio_Fognini,2,S-XC,3,0,0,0,0,1,2,,,,,,,,,,
20130419-M-Monte_Carlo_Masters-QF-Richard_Gasquet-Fabio_Fognini,2,S-DTM,1,0,0,0,0,1,0,,,,,,,,,,
20130419-M-Monte_Carlo_Masters-QF-Richard_Gasquet-Fabio_Fognini,2,S-DTL,1,1,1,0,0,1,0,,,,,,,,,,
20130419-M-Monte_Carlo_Masters-SF-Novak_Djokovic-Fabio_Fognini,1,F-XC,18,2,1,1,0,12,6,,,,,,,,,,
20130419-M-Monte_Carlo_Masters-SF-Novak_Djokovic-Fabio_Fognini,1,F-DTM,9,1,0,0,1,3,6,,,,,,,,,,
20130419-M-Monte_Carlo_Masters-SF-Novak_Djokovic-Fabio_Fognini,1,F-DTL,7,2,0,2,0,5,2,,,,,,,,,,
20130419-M-Monte_Carlo_Masters-SF-Novak_Djokovic-Fabio_Fognini,1,F-IO,8,1,1,0,0,7,1,,,,,,,,,,
20130419-M-Monte_Carlo_Masters-SF-Novak_Djokovic-Fabio_Fognini,1,F-II,3,0,0,0,0,1,2,,,,,,,,,,
20130419-M-Monte_Carlo_Masters-SF-Novak_Djokovic-Fabio_Fognini,1,B-XC,24,2,0,2,0,17,7,,,,,,,,,,
20130419-M-Monte_Carlo_Masters-SF-Novak_Djokovic-Fabio_Fognini,1,B-DTM,11,0,0,0,0,5,6,,,,,,,,,,
20130419-M-Monte_Carlo_Masters-SF-Novak_Djokovic-Fabio_Fognini,1,B-DTL,12,6,1,3,2,8,4,,,,,,,,,,
20130419-M-Monte_Carlo_Masters-SF-Novak_Djokovic-Fabio_Fognini,1,B-IO,1,0,0,0,0,1,0,,,,,,,,,,
20130419-M-Monte_Carlo_Masters-SF-Novak_Djokovic-Fabio_Fognini,1,S-XC,3,0,0,0,0,0,3,,,,,,,,,,
20130419-M-Monte_Carlo_Masters-SF-Novak_Djokovic-Fabio_Fognini,1,S-DTM,1,0,0,0,0,1,0,,,,,,,,,,
20130419-M-Monte_Carlo_Masters-SF-Novak_Djokovic-Fabio_Fognini,1,S-DTL,2,1,0,1,0,1,1,,,,,,,,,,
20130419-M-Monte_Carlo_Masters-SF-Novak_Djokovic-Fabio_Fognini,2,F-XC,21,7,2,1,4,10,11,,,,,,,,,,
20130419-M-Monte_Carlo_Masters-SF-Novak_Djokovic-Fabio_Fognini,2,F-DTM,10,1,0,1,0,4,6,,,,,,,,,,
20130419-M-Monte_Carlo_Masters-SF-Novak_Djokovic-Fabio_Fognini,2,F-DTL,15,2,0,1,1,6,9,,,,,,,,,,
20130419-M-Monte_Carlo_Masters-SF-Novak_Djokovic-Fabio_Fognini,2,F-IO,12,3,1,2,0,10,2,,,,,,,,,,
20130419-M-Monte_Carlo_Masters-SF-Novak_Djokovic-Fabio_Fognini,2,F-II,1,1,1,0,0,1,0,,,,,,,,,,
20130419-M-Monte_Carlo_Masters-SF-Novak_Djokovic-Fabio_Fognini,2,B-XC,24,6,0,0,6,6,18,,,,,,,,,,
20130419-M-Monte_Carlo_Masters-SF-Novak_Djokovic-Fabio_Fognini,2,B-DTM,2,0,0,0,0,1,1,,,,,,,,,,
20130419-M-Monte_Carlo_Masters-SF-Novak_Djokovic-Fabio_Fognini,2,B-DTL,6,2,0,1,1,4,2,,,,,,,,,,
20130419-M-Monte_Carlo_Masters-SF-Novak_Djokovic-Fabio_Fognini,2,B-IO,1,1,0,0,1,0,1,,,,,,,,,,
20130419-M-Monte_Carlo_Masters-SF-Novak_Djokovic-Fabio_Fognini,2,S-XC,10,0,0,0,0,1,9,,,,,,,,,,
20130419-M-Monte_Carlo_Masters-SF-Novak_Djokovic-Fabio_Fognini,2,S-DTM,3,1,0,0,1,0,3,,,,,,,,,,
20130419-M-Monte_Carlo_Masters-SF-Novak_Djokovic-Fabio_Fognini,2,S-DTL,2,0,0,0,0,0,2,,,,,,,,,,
20130509-M-Madrid_Masters-R16-Grigor_Dimitrov-Stanislas_Wawrinka,1,F-XC,53,6,2,2,2,21,32,,,,,,,,,,
20130509-M-Madrid_Masters-R16-Grigor_Dimitrov-Stanislas_Wawrinka,1,F-DTM,17,0,0,0,0,7,10,,,,,,,,,,
20130509-M-Madrid_Masters-R16-Grigor_Dimitrov-Stanislas_Wawrinka,1,F-DTL,10,6,1,2,3,6,4,,,,,,,,,,
20130509-M-Madrid_Masters-R16-Grigor_Dimitrov-Stanislas_Wawrinka,1,F-IO,22,12,5,3,4,13,9,,,,,,,,,,
20130509-M-Madrid_Masters-R16-Grigor_Dimitrov-Stanislas_Wawrinka,1,F-II,11,4,1,1,2,4,7,,,,,,,,,,
20130509-M-Madrid_Masters-R16-Grigor_Dimitrov-Stanislas_Wawrinka,1,B-XC,47,6,1,2,3,26,21,,,,,,,,,,
20130509-M-Madrid_Masters-R16-Grigor_Dimitrov-Stanislas_Wawrinka,1,B-DTM,23,5,0,2,3,9,14,,,,,,,,,,
20130509-M-Madrid_Masters-R16-Grigor_Dimitrov-Stanislas_Wawrinka,1,B-DTL,15,3,1,1,1,5,10,,,,,,,,,,
20130509-M-Madrid_Masters-R16-Grigor_Dimitrov-Stanislas_Wawrinka,1,S-XC,12,1,0,0,1,4,8,,,,,,,,,,
20130509-M-Madrid_Masters-R16-Grigor_Dimitrov-Stanislas_Wawrinka,1,S-DTM,9,0,0,0,0,1,8,,,,,,,,,,
20130509-M-Madrid_Masters-R16-Grigor_Dimitrov-Stanislas_Wawrinka,1,S-DTL,10,1,1,0,0,6,4,,,,,,,,,,
20130509-M-Madrid_Masters-R16-Grigor_Dimitrov-Stanislas_Wawrinka,1,S-IO,1,0,0,0,0,1,0,,,,,,,,,,
20130509-M-Madrid_Masters-R16-Grigor_Dimitrov-Stanislas_Wawrinka,2,F-XC,41,9,2,3,4,23,18,,,,,,,,,,
20130509-M-Madrid_Masters-R16-Grigor_Dimitrov-Stanislas_Wawrinka,2,F-DTM,23,2,0,1,1,16,7,,,,,,,,,,
20130509-M-Madrid_Masters-R16-Grigor_Dimitrov-Stanislas_Wawrinka,2,F-DTL,42,9,1,3,5,24,18,,,,,,,,,,
20130509-M-Madrid_Masters-R16-Grigor_Dimitrov-Stanislas_Wawrinka,2,F-IO,32,9,6,1,2,24,8,,,,,,,,,,
20130509-M-Madrid_Masters-R16-Grigor_Dimitrov-Stanislas_Wawrinka,2,F-II,4,1,1,0,0,3,1,,,,,,,,,,
20130509-M-Madrid_Masters-R16-Grigor_Dimitrov-Stanislas_Wawrinka,2,B-XC,61,10,1,5,4,26,35,,,,,,,,,,
20130509-M-Madrid_Masters-R16-Grigor_Dimitrov-Stanislas_Wawrinka,2,B-DTM,14,1,0,0,1,8,6,,,,,,,,,,
20130509-M-Madrid_Masters-R16-Grigor_Dimitrov-Stanislas_Wawrinka,2,B-DTL,5,1,0,1,0,4,1,,,,,,,,,,
20130509-M-Madrid_Masters-R16-Grigor_Dimitrov-Stanislas_Wawrinka,2,B-IO,3,2,0,0,2,1,2,,,,,,,,,,
20130509-M-Madrid_Masters-R16-Grigor_Dimitrov-Stanislas_Wawrinka,2,S-XC,9,2,0,0,2,3,6,,,,,,,,,,
20130509-M-Madrid_Masters-R16-Grigor_Dimitrov-Stanislas_Wawrinka,2,S-DTM,1,0,0,0,0,1,0,,,,,,,,,,
20130509-M-Madrid_Masters-R16-Grigor_Dimitrov-Stanislas_Wawrinka,2,S-DTL,1,1,0,1,0,1,0,,,,,,,,,,
20130512-M-Madrid_Masters-F-Stanislas_Wawrinka-Rafael_Nadal,1,F-XC,31,3,0,0,3,14,17,,,,,,,,,,
20130512-M-Madrid_Masters-F-Stanislas_Wawrinka-Rafael_Nadal,1,F-DTM,19,2,0,0,2,10,9,,,,,,,,,,
20130512-M-Madrid_Masters-F-Stanislas_Wawrinka-Rafael_Nadal,1,F-IO,16,7,5,0,2,9,7,,,,,,,,,,
20130512-M-Madrid_Masters-F-Stanislas_Wawrinka-Rafael_Nadal,1,F-II,4,2,2,0,0,4,0,,,,,,,,,,
20130512-M-Madrid_Masters-F-Stanislas_Wawrinka-Rafael_Nadal,1,B-XC,20,6,1,1,4,5,15,,,,,,,,,,
20130512-M-Madrid_Masters-F-Stanislas_Wawrinka-Rafael_Nadal,1,B-DTM,22,2,0,0,2,8,14,,,,,,,,,,
20130512-M-Madrid_Masters-F-Stanislas_Wawrinka-Rafael_Nadal,1,B-DTL,11,2,0,0,2,2,9,,,,,,,,,,
20130512-M-Madrid_Masters-F-Stanislas_Wawrinka-Rafael_Nadal,1,B-IO,3,0,0,0,0,1,2,,,,,,,,,,
20130512-M-Madrid_Masters-F-Stanislas_Wawrinka-Rafael_Nadal,1,S-XC,2,0,0,0,0,0,2,,,,,,,,,,
20130512-M-Madrid_Masters-F-Stanislas_Wawrinka-Rafael_Nadal,1,S-DTM,3,0,0,0,0,0,3,,,,,,,,,,
20130512-M-Madrid_Masters-F-Stanislas_Wawrinka-Rafael_Nadal,1,S-DTL,4,0,0,0,0,0,4,,,,,,,,,,
20130512-M-Madrid_Masters-F-Stanislas_Wawrinka-Rafael_Nadal,2,F-XC,43,9,3,3,3,32,11,,,,,,,,,,
20130512-M-Madrid_Masters-F-Stanislas_Wawrinka-Rafael_Nadal,2,F-DTM,15,1,0,0,1,10,5,,,,,,,,,,
20130512-M-Madrid_Masters-F-Stanislas_Wawrinka-Rafael_Nadal,2,F-DTL,3,3,1,1,1,2,1,,,,,,,,,,
20130512-M-Madrid_Masters-F-Stanislas_Wawrinka-Rafael_Nadal,2,F-IO,14,8,4,1,3,8,6,,,,,,,,,,
20130512-M-Madrid_Masters-F-Stanislas_Wawrinka-Rafael_Nadal,2,F-II,6,3,1,1,1,5,1,,,,,,,,,,
20130512-M-Madrid_Masters-F-Stanislas_Wawrinka-Rafael_Nadal,2,B-XC,20,7,2,2,3,11,9,,,,,,,,,,
20130512-M-Madrid_Masters-F-Stanislas_Wawrinka-Rafael_Nadal,2,B-DTM,13,0,0,0,0,4,9,,,,,,,,,,
20130512-M-Madrid_Masters-F-Stanislas_Wawrinka-Rafael_Nadal,2,B-DTL,10,0,0,0,0,8,2,,,,,,,,,,
20130512-M-Madrid_Masters-F-Stanislas_Wawrinka-Rafael_Nadal,2,B-IO,4,0,0,0,0,2,2,,,,,,,,,,
20130512-M-Madrid_Masters-F-Stanislas_Wawrinka-Rafael_Nadal,2,S-DTM,1,0,0,0,0,1,0,,,,,,,,,,
20130512-M-Madrid_Masters-F-Stanislas_Wawrinka-Rafael_Nadal,2,S-DTL,4,1,0,1,0,3,1,,,,,,,,,,
20130512-M-Madrid_Masters-F-Stanislas_Wawrinka-Rafael_Nadal,2,S-IO,1,1,0,0,1,0,1,,,,,,,,,,
20130514-M-Rome_Masters-R32-Juan_Martin_Del_Potro-Andrey_Kuznetsov,1,F-XC,28,7,5,1,1,18,10,,,,,,,,,,
20130514-M-Rome_Masters-R32-Juan_Martin_Del_Potro-Andrey_Kuznetsov,1,F-DTM,14,1,1,0,0,7,7,,,,,,,,,,
20130514-M-Rome_Masters-R32-Juan_Martin_Del_Potro-Andrey_Kuznetsov,1,F-DTL,9,3,1,0,2,4,5,,,,,,,,,,
20130514-M-Rome_Masters-R32-Juan_Martin_Del_Potro-Andrey_Kuznetsov,1,F-IO,23,6,3,1,2,15,8,,,,,,,,,,
20130514-M-Rome_Masters-R32-Juan_Martin_Del_Potro-Andrey_Kuznetsov,1,F-II,5,1,1,0,0,4,1,,,,,,,,,,
20130514-M-Rome_Masters-R32-Juan_Martin_Del_Potro-Andrey_Kuznetsov,1,B-XC,34,2,0,1,1,15,19,,,,,,,,,,
20130514-M-Rome_Masters-R32-Juan_Martin_Del_Potro-Andrey_Kuznetsov,1,B-DTM,14,2,0,0,2,7,7,,,,,,,,,,
20130514-M-Rome_Masters-R32-Juan_Martin_Del_Potro-Andrey_Kuznetsov,1,B-DTL,5,2,0,0,2,1,4,,,,,,,,,,
20130514-M-Rome_Masters-R32-Juan_Martin_Del_Potro-Andrey_Kuznetsov,1,B-IO,5,2,2,0,0,4,1,,,,,,,,,,
20130514-M-Rome_Masters-R32-Juan_Martin_Del_Potro-Andrey_Kuznetsov,1,S-XC,4,0,0,0,0,3,1,,,,,,,,,,
20130514-M-Rome_Masters-R32-Juan_Martin_Del_Potro-Andrey_Kuznetsov,1,S-DTM,7,1,0,0,1,2,5,,,,,,,,,,
20130514-M-Rome_Masters-R32-Juan_Martin_Del_Potro-Andrey_Kuznetsov,2,F-XC,34,7,1,1,5,17,17,,,,,,,,,,
20130514-M-Rome_Masters-R32-Juan_Martin_Del_Potro-Andrey_Kuznetsov,2,F-DTM,13,3,0,0,3,4,9,,,,,,,,,,
20130514-M-Rome_Masters-R32-Juan_Martin_Del_Potro-Andrey_Kuznetsov,2,F-DTL,11,3,2,0,1,5,6,,,,,,,,,,
20130514-M-Rome_Masters-R32-Juan_Martin_Del_Potro-Andrey_Kuznetsov,2,F-IO,21,8,2,2,4,14,7,,,,,,,,,,
20130514-M-Rome_Masters-R32-Juan_Martin_Del_Potro-Andrey_Kuznetsov,2,F-II,7,2,0,0,2,3,4,,,,,,,,,,
20130514-M-Rome_Masters-R32-Juan_Martin_Del_Potro-Andrey_Kuznetsov,2,B-XC,42,5,2,0,3,19,23,,,,,,,,,,
20130514-M-Rome_Masters-R32-Juan_Martin_Del_Potro-Andrey_Kuznetsov,2,B-DTM,11,1,0,0,1,6,5,,,,,,,,,,
20130514-M-Rome_Masters-R32-Juan_Martin_Del_Potro-Andrey_Kuznetsov,2,B-DTL,13,7,2,1,4,8,5,,,,,,,,,,
20130514-M-Rome_Masters-R32-Juan_Martin_Del_Potro-Andrey_Kuznetsov,2,B-IO,1,0,0,0,0,0,1,,,,,,,,,,
20130514-M-Rome_Masters-R32-Juan_Martin_Del_Potro-Andrey_Kuznetsov,2,S-XC,4,0,0,0,0,1,3,,,,,,,,,,
20130514-M-Rome_Masters-R32-Juan_Martin_Del_Potro-Andrey_Kuznetsov,2,S-DTM,4,1,0,0,1,0,4,,,,,,,,,,
20130518-M-Rome_Masters-SF-Roger_Federer-Benoit_Paire,1,F-XC,27,12,5,2,5,16,11,,,,,,,,,,
20130518-M-Rome_Masters-SF-Roger_Federer-Benoit_Paire,1,F-DTM,21,3,1,0,2,6,15,,,,,,,,,,
20130518-M-Rome_Masters-SF-Roger_Federer-Benoit_Paire,1,F-DTL,6,3,0,1,2,2,4,,,,,,,,,,
20130518-M-Rome_Masters-SF-Roger_Federer-Benoit_Paire,1,F-IO,29,8,1,3,4,19,10,,,,,,,,,,
20130518-M-Rome_Masters-SF-Roger_Federer-Benoit_Paire,1,F-II,4,2,1,0,1,2,2,,,,,,,,,,
20130518-M-Rome_Masters-SF-Roger_Federer-Benoit_Paire,1,B-XC,14,4,0,1,3,6,8,,,,,,,,,,
20130518-M-Rome_Masters-SF-Roger_Federer-Benoit_Paire,1,B-DTM,28,2,0,0,2,12,16,,,,,,,,,,
20130518-M-Rome_Masters-SF-Roger_Federer-Benoit_Paire,1,B-DTL,3,2,1,0,1,2,1,,,,,,,,,,
20130518-M-Rome_Masters-SF-Roger_Federer-Benoit_Paire,1,B-IO,2,0,0,0,0,0,2,,,,,,,,,,
20130518-M-Rome_Masters-SF-Roger_Federer-Benoit_Paire,1,S-XC,7,2,0,1,1,3,4,,,,,,,,,,
20130518-M-Rome_Masters-SF-Roger_Federer-Benoit_Paire,1,S-DTM,5,0,0,0,0,1,4,,,,,,,,,,
20130518-M-Rome_Masters-SF-Roger_Federer-Benoit_Paire,1,S-DTL,5,2,0,2,0,3,2,,,,,,,,,,
20130518-M-Rome_Masters-SF-Roger_Federer-Benoit_Paire,1,S-IO,1,0,0,0,0,0,1,,,,,,,,,,
20130518-M-Rome_Masters-SF-Roger_Federer-Benoit_Paire,2,F-XC,19,6,3,1,2,15,4,,,,,,,,,,
20130518-M-Rome_Masters-SF-Roger_Federer-Benoit_Paire,2,F-DTM,22,2,0,0,2,11,11,,,,,,,,,,
20130518-M-Rome_Masters-SF-Roger_Federer-Benoit_Paire,2,F-DTL,8,0,0,0,0,4,4,,,,,,,,,,
20130518-M-Rome_Masters-SF-Roger_Federer-Benoit_Paire,2,F-IO,9,3,2,0,1,6,3,,,,,,,,,,
20130518-M-Rome_Masters-SF-Roger_Federer-Benoit_Paire,2,B-XC,42,12,5,0,7,23,19,,,,,,,,,,
20130518-M-Rome_Masters-SF-Roger_Federer-Benoit_Paire,2,B-DTM,19,0,0,0,0,12,7,,,,,,,,,,
20130518-M-Rome_Masters-SF-Roger_Federer-Benoit_Paire,2,B-DTL,13,7,3,0,4,5,8,,,,,,,,,,
20130518-M-Rome_Masters-SF-Roger_Federer-Benoit_Paire,2,B-IO,4,2,1,0,1,3,1,,,,,,,,,,
20130518-M-Rome_Masters-SF-Roger_Federer-Benoit_Paire,2,S-DTM,2,0,0,0,0,0,2,,,,,,,,,,
20130609-M-Roland_Garros-F-David_Ferrer-Rafael_Nadal,1,F-XC,105,11,1,1,9,48,57,,,,,,,,,,
20130609-M-Roland_Garros-F-David_Ferrer-Rafael_Nadal,1,F-DTM,20,0,0,0,0,6,14,,,,,,,,,,
20130609-M-Roland_Garros-F-David_Ferrer-Rafael_Nadal,1,F-DTL,16,3,2,0,1,12,4,,,,,,,,,,
20130609-M-Roland_Garros-F-David_Ferrer-Rafael_Nadal,1,F-IO,42,17,6,4,7,24,18,,,,,,,,,,
20130609-M-Roland_Garros-F-David_Ferrer-Rafael_Nadal,1,F-II,20,3,1,2,0,13,7,,,,,,,,,,
20130609-M-Roland_Garros-F-David_Ferrer-Rafael_Nadal,1,B-XC,55,11,3,0,8,20,35,,,,,,,,,,
20130609-M-Roland_Garros-F-David_Ferrer-Rafael_Nadal,1,B-DTM,21,2,0,0,2,7,14,,,,,,,,,,
20130609-M-Roland_Garros-F-David_Ferrer-Rafael_Nadal,1,B-DTL,36,9,3,1,5,19,17,,,,,,,,,,
20130609-M-Roland_Garros-F-David_Ferrer-Rafael_Nadal,1,B-IO,4,0,0,0,0,2,2,,,,,,,,,,
20130609-M-Roland_Garros-F-David_Ferrer-Rafael_Nadal,1,S-DTM,5,0,0,0,0,2,3,,,,,,,,,,
20130609-M-Roland_Garros-F-David_Ferrer-Rafael_Nadal,1,S-DTL,4,2,0,0,2,0,4,,,,,,,,,,
20130609-M-Roland_Garros-F-David_Ferrer-Rafael_Nadal,1,S-IO,1,0,0,0,0,0,1,,,,,,,,,,
20130609-M-Roland_Garros-F-David_Ferrer-Rafael_Nadal,2,F-XC,86,8,2,2,4,46,40,,,,,,,,,,
20130609-M-Roland_Garros-F-David_Ferrer-Rafael_Nadal,2,F-DTM,17,0,0,0,0,5,12,,,,,,,,,,
20130609-M-Roland_Garros-F-David_Ferrer-Rafael_Nadal,2,F-DTL,21,10,5,1,4,13,8,,,,,,,,,,
20130609-M-Roland_Garros-F-David_Ferrer-Rafael_Nadal,2,F-IO,32,16,11,3,2,26,6,,,,,,,,,,
20130609-M-Roland_Garros-F-David_Ferrer-Rafael_Nadal,2,F-II,22,5,1,2,2,11,11,,,,,,,,,,
20130609-M-Roland_Garros-F-David_Ferrer-Rafael_Nadal,2,B-XC,63,14,3,0,11,27,36,,,,,,,,,,
20130609-M-Roland_Garros-F-David_Ferrer-Rafael_Nadal,2,B-DTM,24,0,0,0,0,13,11,,,,,,,,,,
20130609-M-Roland_Garros-F-David_Ferrer-Rafael_Nadal,2,B-DTL,42,8,1,2,5,22,20,,,,,,,,,,
20130609-M-Roland_Garros-F-David_Ferrer-Rafael_Nadal,2,B-IO,2,0,0,0,0,2,0,,,,,,,,,,
20130609-M-Roland_Garros-F-David_Ferrer-Rafael_Nadal,2,S-XC,2,1,0,0,1,1,1,,,,,,,,,,
20130609-M-Roland_Garros-F-David_Ferrer-Rafael_Nadal,2,S-DTM,8,0,0,0,0,2,6,,,,,,,,,,
20130609-M-Roland_Garros-F-David_Ferrer-Rafael_Nadal,2,S-DTL,6,1,0,0,1,3,3,,,,,,,,,,
20130609-M-Roland_Garros-F-David_Ferrer-Rafael_Nadal,2,S-IO,2,0,0,0,0,1,1,,,,,,,,,,
20130612-M-Halle-R16-Gael_Monfils-Jan_Hernych,1,F-XC,38,14,6,4,3,24,14,,,,,,,,,,
20130612-M-Halle-R16-Gael_Monfils-Jan_Hernych,1,F-DTM,20,2,0,0,2,11,9,,,,,,,,,,
20130612-M-Halle-R16-Gael_Monfils-Jan_Hernych,1,F-DTL,9,5,1,2,2,3,6,,,,,,,,,,
20130612-M-Halle-R16-Gael_Monfils-Jan_Hernych,1,F-IO,13,3,1,0,2,9,4,,,,,,,,,,
20130612-M-Halle-R16-Gael_Monfils-Jan_Hernych,1,F-II,3,1,1,0,0,3,0,,,,,,,,,,
20130612-M-Halle-R16-Gael_Monfils-Jan_Hernych,1,B-XC,41,7,2,4,1,24,17,,,,,,,,,,
20130612-M-Halle-R16-Gael_Monfils-Jan_Hernych,1,B-DTM,26,3,0,2,1,9,17,,,,,,,,,,
20130612-M-Halle-R16-Gael_Monfils-Jan_Hernych,1,B-DTL,7,2,2,0,0,5,2,,,,,,,,,,
20130612-M-Halle-R16-Gael_Monfils-Jan_Hernych,1,B-IO,7,4,2,1,1,4,3,,,,,,,,,,
20130612-M-Halle-R16-Gael_Monfils-Jan_Hernych,1,S-XC,14,0,0,0,0,14,0,,,,,,,,,,
20130612-M-Halle-R16-Gael_Monfils-Jan_Hernych,1,S-DTM,6,1,0,0,1,3,3,,,,,,,,,,
20130612-M-Halle-R16-Gael_Monfils-Jan_Hernych,1,S-DTL,2,0,0,0,0,1,1,,,,,,,,,,
20130612-M-Halle-R16-Gael_Monfils-Jan_Hernych,2,F-XC,28,4,1,1,2,12,16,,,,,,,,,,
20130612-M-Halle-R16-Gael_Monfils-Jan_Hernych,2,F-DTM,16,0,0,0,0,6,10,,,,,,,,,,
20130612-M-Halle-R16-Gael_Monfils-Jan_Hernych,2,F-DTL,16,5,1,2,2,8,8,,,,,,,,,,
20130612-M-Halle-R16-Gael_Monfils-Jan_Hernych,2,F-IO,18,5,0,2,3,7,11,,,,,,,,,,
20130612-M-Halle-R16-Gael_Monfils-Jan_Hernych,2,B-XC,43,5,0,2,3,17,26,,,,,,,,,,
20130612-M-Halle-R16-Gael_Monfils-Jan_Hernych,2,B-DTM,16,0,0,0,0,7,9,,,,,,,,,,
20130612-M-Halle-R16-Gael_Monfils-Jan_Hernych,2,B-DTL,9,2,0,0,2,4,5,,,,,,,,,,
20130612-M-Halle-R16-Gael_Monfils-Jan_Hernych,2,B-IO,4,0,0,0,0,3,1,,,,,,,,,,
20130612-M-Halle-R16-Gael_Monfils-Jan_Hernych,2,S-XC,10,0,0,0,0,2,8,,,,,,,,,,
20130612-M-Halle-R16-Gael_Monfils-Jan_Hernych,2,S-DTM,4,0,0,0,0,1,3,,,,,,,,,,
20130612-M-Halle-R16-Gael_Monfils-Jan_Hernych,2,S-DTL,2,0,0,0,0,1,1,,,,,,,,,,
20130703-M-Wimbledon-QF-David_Ferrer-Juan_Martin_Del_Potro,1,F-XC,51,10,2,4,4,34,17,,,,,,,,,,
20130703-M-Wimbledon-QF-David_Ferrer-Juan_Martin_Del_Potro,1,F-DTM,24,2,0,1,1,12,12,,,,,,,,,,
20130703-M-Wimbledon-QF-David_Ferrer-Juan_Martin_Del_Potro,1,F-DTL,26,8,2,0,6,17,9,,,,,,,,,,
20130703-M-Wimbledon-QF-David_Ferrer-Juan_Martin_Del_Potro,1,F-IO,70,14,4,4,6,37,33,,,,,,,,,,
20130703-M-Wimbledon-QF-David_Ferrer-Juan_Martin_Del_Potro,1,F-II,10,4,1,0,3,4,6,,,,,,,,,,
20130703-M-Wimbledon-QF-David_Ferrer-Juan_Martin_Del_Potro,1,B-XC,45,4,0,0,3,11,34,,,,,,,,,,
20130703-M-Wimbledon-QF-David_Ferrer-Juan_Martin_Del_Potro,1,B-DTM,56,6,1,0,5,29,27,,,,,,,,,,
20130703-M-Wimbledon-QF-David_Ferrer-Juan_Martin_Del_Potro,1,B-DTL,17,9,5,0,4,9,8,,,,,,,,,,
20130703-M-Wimbledon-QF-David_Ferrer-Juan_Martin_Del_Potro,1,B-IO,3,2,2,0,0,2,1,,,,,,,,,,
20130703-M-Wimbledon-QF-David_Ferrer-Juan_Martin_Del_Potro,1,B-II,1,0,0,0,0,1,0,,,,,,,,,,
20130703-M-Wimbledon-QF-David_Ferrer-Juan_Martin_Del_Potro,1,S-XC,3,1,0,0,1,1,2,,,,,,,,,,
20130703-M-Wimbledon-QF-David_Ferrer-Juan_Martin_Del_Potro,1,S-DTM,4,1,0,0,1,1,3,,,,,,,,,,
20130703-M-Wimbledon-QF-David_Ferrer-Juan_Martin_Del_Potro,2,F-XC,57,21,13,1,7,25,32,,,,,,,,,,
20130703-M-Wimbledon-QF-David_Ferrer-Juan_Martin_Del_Potro,2,F-DTM,30,2,0,1,1,15,15,,,,,,,,,,
20130703-M-Wimbledon-QF-David_Ferrer-Juan_Martin_Del_Potro,2,F-DTL,16,4,2,1,1,9,7,,,,,,,,,,
20130703-M-Wimbledon-QF-David_Ferrer-Juan_Martin_Del_Potro,2,F-IO,31,10,5,2,3,21,10,,,,,,,,,,
20130703-M-Wimbledon-QF-David_Ferrer-Juan_Martin_Del_Potro,2,F-II,3,1,0,1,0,2,1,,,,,,,,,,
20130703-M-Wimbledon-QF-David_Ferrer-Juan_Martin_Del_Potro,2,B-XC,68,1,0,1,0,38,30,,,,,,,,,,
20130703-M-Wimbledon-QF-David_Ferrer-Juan_Martin_Del_Potro,2,B-DTM,43,3,0,0,3,15,28,,,,,,,,,,
20130703-M-Wimbledon-QF-David_Ferrer-Juan_Martin_Del_Potro,2,B-DTL,12,3,2,1,0,8,4,,,,,,,,,,
20130703-M-Wimbledon-QF-David_Ferrer-Juan_Martin_Del_Potro,2,B-IO,9,3,1,1,1,4,5,,,,,,,,,,
20130703-M-Wimbledon-QF-David_Ferrer-Juan_Martin_Del_Potro,2,S-XC,17,1,0,0,1,12,5,,,,,,,,,,
20130703-M-Wimbledon-QF-David_Ferrer-Juan_Martin_Del_Potro,2,S-DTM,6,0,0,0,0,3,3,,,,,,,,,,
20130703-M-Wimbledon-QF-David_Ferrer-Juan_Martin_Del_Potro,2,S-DTL,2,0,0,0,0,0,2,,,,,,,,,,
20130707-M-Wimbledon-F-Novak_Djokovic-Andy_Murray,1,F-XC,91,14,5,6,3,50,41,,,,,,,,,,
20130707-M-Wimbledon-F-Novak_Djokovic-Andy_Murray,1,F-DTM,42,4,0,0,4,17,25,,,,,,,,,,
20130707-M-Wimbledon-F-Novak_Djokovic-Andy_Murray,1,F-DTL,46,9,1,1,7,24,22,,,,,,,,,,
20130707-M-Wimbledon-F-Novak_Djokovic-Andy_Murray,1,F-IO,54,8,1,2,5,31,23,,,,,,,,,,
20130707-M-Wimbledon-F-Novak_Djokovic-Andy_Murray,1,F-II,2,0,0,0,0,1,1,,,,,,,,,,
20130707-M-Wimbledon-F-Novak_Djokovic-Andy_Murray,1,B-XC,80,11,3,1,7,41,39,,,,,,,,,,
20130707-M-Wimbledon-F-Novak_Djokovic-Andy_Murray,1,B-DTM,36,2,0,1,1,24,12,,,,,,,,,,
20130707-M-Wimbledon-F-Novak_Djokovic-Andy_Murray,1,B-DTL,38,9,1,3,5,17,21,,,,,,,,,,
20130707-M-Wimbledon-F-Novak_Djokovic-Andy_Murray,1,B-IO,22,3,0,1,2,15,7,,,,,,,,,,
20130707-M-Wimbledon-F-Novak_Djokovic-Andy_Murray,1,S-XC,14,3,0,2,1,7,7,,,,,,,,,,
20130707-M-Wimbledon-F-Novak_Djokovic-Andy_Murray,1,S-DTM,11,1,0,0,1,8,3,,,,,,,,,,
20130707-M-Wimbledon-F-Novak_Djokovic-Andy_Murray,1,S-DTL,1,0,0,0,0,0,1,,,,,,,,,,
20130707-M-Wimbledon-F-Novak_Djokovic-Andy_Murray,2,F-XC,106,11,5,1,5,53,53,,,,,,,,,,
20130707-M-Wimbledon-F-Novak_Djokovic-Andy_Murray,2,F-DTM,37,2,0,1,1,18,19,,,,,,,,,,
20130707-M-Wimbledon-F-Novak_Djokovic-Andy_Murray,2,F-DTL,41,9,4,3,2,23,18,,,,,,,,,,
20130707-M-Wimbledon-F-Novak_Djokovic-Andy_Murray,2,F-IO,26,8,1,2,5,15,11,,,,,,,,,,
20130707-M-Wimbledon-F-Novak_Djokovic-Andy_Murray,2,F-II,1,1,1,0,0,1,0,,,,,,,,,,
20130707-M-Wimbledon-F-Novak_Djokovic-Andy_Murray,2,B-XC,82,12,5,3,4,42,40,,,,,,,,,,
20130707-M-Wimbledon-F-Novak_Djokovic-Andy_Murray,2,B-DTM,52,1,0,0,1,21,31,,,,,,,,,,
20130707-M-Wimbledon-F-Novak_Djokovic-Andy_Murray,2,B-DTL,27,7,4,1,2,13,14,,,,,,,,,,
20130707-M-Wimbledon-F-Novak_Djokovic-Andy_Murray,2,B-IO,13,2,0,0,2,8,5,,,,,,,,,,
20130707-M-Wimbledon-F-Novak_Djokovic-Andy_Murray,2,S-XC,23,0,0,0,0,10,13,,,,,,,,,,
20130707-M-Wimbledon-F-Novak_Djokovic-Andy_Murray,2,S-DTM,27,0,0,0,0,7,20,,,,,,,,,,
20130707-M-Wimbledon-F-Novak_Djokovic-Andy_Murray,2,S-DTL,7,1,0,0,1,2,5,,,,,,,,,,
20130707-M-Wimbledon-F-Novak_Djokovic-Andy_Murray,2,S-IO,3,1,0,0,1,1,2,,,,,,,,,,
20130724-M-Lexington_CH-R16-James_Ward-Mitchell_Krueger,1,F-XC,5,2,1,0,1,3,2,,,,,,,,,,
20130724-M-Lexington_CH-R16-James_Ward-Mitchell_Krueger,1,F-DTM,15,3,0,1,2,11,4,,,,,,,,,,
20130724-M-Lexington_CH-R16-James_Ward-Mitchell_Krueger,1,F-IO,37,14,3,4,7,27,10,,,,,,,,,,
20130724-M-Lexington_CH-R16-James_Ward-Mitchell_Krueger,1,F-II,5,2,1,0,1,2,3,,,,,,,,,,
20130724-M-Lexington_CH-R16-James_Ward-Mitchell_Krueger,1,B-XC,1,1,1,0,0,1,0,,,,,,,,,,
20130724-M-Lexington_CH-R16-James_Ward-Mitchell_Krueger,1,B-DTM,11,1,0,0,1,8,3,,,,,,,,,,
20130724-M-Lexington_CH-R16-James_Ward-Mitchell_Krueger,1,B-IO,18,7,2,2,3,11,7,,,,,,,,,,
20130724-M-Lexington_CH-R16-James_Ward-Mitchell_Krueger,1,B-II,3,2,1,1,0,2,1,,,,,,,,,,
20130724-M-Lexington_CH-R16-James_Ward-Mitchell_Krueger,1,S-XC,3,0,0,0,0,3,0,,,,,,,,,,
20130724-M-Lexington_CH-R16-James_Ward-Mitchell_Krueger,1,S-IO,1,1,0,1,0,1,0,,,,,,,,,,
20130724-M-Lexington_CH-R16-James_Ward-Mitchell_Krueger,2,F-XC,7,3,1,1,1,5,2,,,,,,,,,,
20130724-M-Lexington_CH-R16-James_Ward-Mitchell_Krueger,2,F-DTM,23,2,0,0,2,2,21,,,,,,,,,,
20130724-M-Lexington_CH-R16-James_Ward-Mitchell_Krueger,2,F-DTL,2,1,0,1,0,2,0,,,,,,,,,,
20130724-M-Lexington_CH-R16-James_Ward-Mitchell_Krueger,2,F-IO,21,7,0,0,7,3,18,,,,,,,,,,
20130724-M-Lexington_CH-R16-James_Ward-Mitchell_Krueger,2,F-II,9,4,0,0,4,0,9,,,,,,,,,,
20130724-M-Lexington_CH-R16-James_Ward-Mitchell_Krueger,2,B-XC,4,2,1,0,1,2,2,,,,,,,,,,
20130724-M-Lexington_CH-R16-James_Ward-Mitchell_Krueger,2,B-DTM,15,0,0,0,0,2,13,,,,,,,,,,
20130724-M-Lexington_CH-R16-James_Ward-Mitchell_Krueger,2,B-IO,6,3,0,1,2,2,4,,,,,,,,,,
20130724-M-Lexington_CH-R16-James_Ward-Mitchell_Krueger,2,B-II,1,0,0,0,0,1,0,,,,,,,,,,
20130724-M-Lexington_CH-R16-James_Ward-Mitchell_Krueger,2,S-XC,1,0,0,0,0,0,1,,,,,,,,,,
20130724-M-Lexington_CH-R16-James_Ward-Mitchell_Krueger,2,S-DTM,3,0,0,0,0,2,1,,,,,,,,,,
20130724-M-Lexington_CH-R16-James_Ward-Mitchell_Krueger,2,S-II,3,0,0,0,0,1,2,,,,,,,,,,
20130728-M-Atlanta-F-Kevin_Anderson-John_Isner,1,F-XC,34,8,5,2,1,28,6,,,,,,,,,,
20130728-M-Atlanta-F-Kevin_Anderson-John_Isner,1,F-DTM,15,0,0,0,0,11,4,,,,,,,,,,
20130728-M-Atlanta-F-Kevin_Anderson-John_Isner,1,F-DTL,5,1,1,0,0,4,1,,,,,,,,,,
20130728-M-Atlanta-F-Kevin_Anderson-John_Isner,1,F-IO,30,8,1,2,5,18,12,,,,,,,,,,
20130728-M-Atlanta-F-Kevin_Anderson-John_Isner,1,F-II,4,4,1,0,3,1,3,,,,,,,,,,
20130728-M-Atlanta-F-Kevin_Anderson-John_Isner,1,B-XC,37,8,2,2,4,20,17,,,,,,,,,,
20130728-M-Atlanta-F-Kevin_Anderson-John_Isner,1,B-DTM,18,3,0,1,2,9,9,,,,,,,,,,
20130728-M-Atlanta-F-Kevin_Anderson-John_Isner,1,B-DTL,4,2,1,0,1,2,2,,,,,,,,,,
20130728-M-Atlanta-F-Kevin_Anderson-John_Isner,1,B-IO,4,3,2,0,1,3,1,,,,,,,,,,
20130728-M-Atlanta-F-Kevin_Anderson-John_Isner,1,S-XC,7,1,0,1,0,5,2,,,,,,,,,,
20130728-M-Atlanta-F-Kevin_Anderson-John_Isner,1,S-DTM,1,0,0,0,0,1,0,,,,,,,,,,
20130728-M-Atlanta-F-Kevin_Anderson-John_Isner,1,S-DTL,1,0,0,0,0,0,1,,,,,,,,,,
20130728-M-Atlanta-F-Kevin_Anderson-John_Isner,1,S-IO,1,0,0,0,0,0,1,,,,,,,,,,
20130728-M-Atlanta-F-Kevin_Anderson-John_Isner,2,F-XC,28,12,6,1,5,10,18,,,,,,,,,,
20130728-M-Atlanta-F-Kevin_Anderson-John_Isner,2,F-DTM,15,4,0,0,4,2,13,,,,,,,,,,
20130728-M-Atlanta-F-Kevin_Anderson-John_Isner,2,F-DTL,14,7,2,1,4,7,7,,,,,,,,,,
20130728-M-Atlanta-F-Kevin_Anderson-John_Isner,2,F-IO,37,17,1,5,11,16,21,,,,,,,,,,
20130728-M-Atlanta-F-Kevin_Anderson-John_Isner,2,F-II,3,3,1,0,2,1,2,,,,,,,,,,
20130728-M-Atlanta-F-Kevin_Anderson-John_Isner,2,B-XC,14,1,1,0,0,5,9,,,,,,,,,,
20130728-M-Atlanta-F-Kevin_Anderson-John_Isner,2,B-DTM,22,5,0,1,4,8,14,,,,,,,,,,
20130728-M-Atlanta-F-Kevin_Anderson-John_Isner,2,B-DTL,7,5,2,0,3,2,5,,,,,,,,,,
20130728-M-Atlanta-F-Kevin_Anderson-John_Isner,2,B-IO,1,1,0,0,1,0,1,,,,,,,,,,
20130728-M-Atlanta-F-Kevin_Anderson-John_Isner,2,S-XC,18,1,0,0,1,6,12,,,,,,,,,,
20130728-M-Atlanta-F-Kevin_Anderson-John_Isner,2,S-DTM,6,0,0,0,0,2,4,,,,,,,,,,
20130728-M-Atlanta-F-Kevin_Anderson-John_Isner,2,S-DTL,4,1,0,1,0,1,3,,,,,,,,,,
20130729-M-Washington-R16-Bernard_Tomic-Juan_Martin_Del_Potro,1,F-XC,16,7,3,1,3,6,10,,,,,,,,,,
20130729-M-Washington-R16-Bernard_Tomic-Juan_Martin_Del_Potro,1,F-DTM,16,2,0,0,2,4,12,,,,,,,,,,
20130729-M-Washington-R16-Bernard_Tomic-Juan_Martin_Del_Potro,1,F-DTL,14,6,0,1,5,3,11,,,,,,,,,,
20130729-M-Washington-R16-Bernard_Tomic-Juan_Martin_Del_Potro,1,F-IO,19,3,1,1,1,8,11,,,,,,,,,,
20130729-M-Washington-R16-Bernard_Tomic-Juan_Martin_Del_Potro,1,F-II,1,1,1,0,0,1,0,,,,,,,,,,
20130729-M-Washington-R16-Bernard_Tomic-Juan_Martin_Del_Potro,1,B-XC,23,7,0,0,7,7,16,,,,,,,,,,
20130729-M-Washington-R16-Bernard_Tomic-Juan_Martin_Del_Potro,1,B-DTM,14,1,0,0,1,5,9,,,,,,,,,,
20130729-M-Washington-R16-Bernard_Tomic-Juan_Martin_Del_Potro,1,B-DTL,8,6,1,0,5,3,5,,,,,,,,,,
20130729-M-Washington-R16-Bernard_Tomic-Juan_Martin_Del_Potro,1,B-IO,9,3,0,0,3,2,7,,,,,,,,,,
20130729-M-Washington-R16-Bernard_Tomic-Juan_Martin_Del_Potro,1,S-XC,8,0,0,0,0,3,5,,,,,,,,,,
20130729-M-Washington-R16-Bernard_Tomic-Juan_Martin_Del_Potro,1,S-DTM,9,0,0,0,0,3,6,,,,,,,,,,
20130729-M-Washington-R16-Bernard_Tomic-Juan_Martin_Del_Potro,1,S-DTL,3,0,0,0,0,1,2,,,,,,,,,,
20130729-M-Washington-R16-Bernard_Tomic-Juan_Martin_Del_Potro,1,S-IO,1,0,0,0,0,1,0,,,,,,,,,,
20130729-M-Washington-R16-Bernard_Tomic-Juan_Martin_Del_Potro,2,F-XC,37,11,3,3,5,25,12,,,,,,,,,,
20130729-M-Washington-R16-Bernard_Tomic-Juan_Martin_Del_Potro,2,F-DTM,15,1,0,0,1,9,6,,,,,,,,,,
20130729-M-Washington-R16-Bernard_Tomic-Juan_Martin_Del_Potro,2,F-DTL,4,0,0,0,0,3,1,,,,,,,,,,
20130729-M-Washington-R16-Bernard_Tomic-Juan_Martin_Del_Potro,2,F-IO,26,5,1,2,2,14,12,,,,,,,,,,
20130729-M-Washington-R16-Bernard_Tomic-Juan_Martin_Del_Potro,2,F-II,2,1,0,1,0,2,0,,,,,,,,,,
20130729-M-Washington-R16-Bernard_Tomic-Juan_Martin_Del_Potro,2,B-XC,17,5,0,1,4,12,5,,,,,,,,,,
20130729-M-Washington-R16-Bernard_Tomic-Juan_Martin_Del_Potro,2,B-DTM,21,0,0,0,0,15,6,,,,,,,,,,
20130729-M-Washington-R16-Bernard_Tomic-Juan_Martin_Del_Potro,2,B-DTL,1,1,1,0,0,1,0,,,,,,,,,,
20130729-M-Washington-R16-Bernard_Tomic-Juan_Martin_Del_Potro,2,B-IO,2,1,1,0,0,2,0,,,,,,,,,,
20130729-M-Washington-R16-Bernard_Tomic-Juan_Martin_Del_Potro,2,S-XC,10,0,0,0,0,6,4,,,,,,,,,,
20130729-M-Washington-R16-Bernard_Tomic-Juan_Martin_Del_Potro,2,S-DTM,2,0,0,0,0,2,0,,,,,,,,,,
20130805-M-Canada_Masters-R64-Peter_Polansky-Kei_Nishikori,1,F-XC,56,8,1,3,4,27,29,,,,,,,,,,
20130805-M-Canada_Masters-R64-Peter_Polansky-Kei_Nishikori,1,F-DTM,32,2,0,0,2,16,16,,,,,,,,,,
20130805-M-Canada_Masters-R64-Peter_Polansky-Kei_Nishikori,1,F-DTL,17,7,3,0,4,7,10,,,,,,,,,,
20130805-M-Canada_Masters-R64-Peter_Polansky-Kei_Nishikori,1,F-IO,23,5,1,3,1,11,12,,,,,,,,,,
20130805-M-Canada_Masters-R64-Peter_Polansky-Kei_Nishikori,1,F-II,8,3,0,0,3,4,4,,,,,,,,,,
20130805-M-Canada_Masters-R64-Peter_Polansky-Kei_Nishikori,1,B-XC,49,3,0,0,3,22,27,,,,,,,,,,
20130805-M-Canada_Masters-R64-Peter_Polansky-Kei_Nishikori,1,B-DTM,44,5,0,0,5,19,25,,,,,,,,,,
20130805-M-Canada_Masters-R64-Peter_Polansky-Kei_Nishikori,1,B-DTL,21,8,2,1,5,10,11,,,,,,,,,,
20130805-M-Canada_Masters-R64-Peter_Polansky-Kei_Nishikori,1,B-IO,2,0,0,0,0,0,2,,,,,,,,,,
20130805-M-Canada_Masters-R64-Peter_Polansky-Kei_Nishikori,1,B-II,1,0,0,0,0,1,0,,,,,,,,,,
20130805-M-Canada_Masters-R64-Peter_Polansky-Kei_Nishikori,1,S-XC,9,0,0,0,0,4,5,,,,,,,,,,
20130805-M-Canada_Masters-R64-Peter_Polansky-Kei_Nishikori,1,S-DTM,11,1,0,0,1,6,5,,,,,,,,,,
20130805-M-Canada_Masters-R64-Peter_Polansky-Kei_Nishikori,1,S-DTL,2,0,0,0,0,1,1,,,,,,,,,,
20130805-M-Canada_Masters-R64-Peter_Polansky-Kei_Nishikori,2,F-XC,75,19,3,6,10,38,37,,,,,,,,,,
20130805-M-Canada_Masters-R64-Peter_Polansky-Kei_Nishikori,2,F-DTM,27,2,0,0,2,13,14,,,,,,,,,,
20130805-M-Canada_Masters-R64-Peter_Polansky-Kei_Nishikori,2,F-DTL,13,6,2,1,3,8,5,,,,,,,,,,
20130805-M-Canada_Masters-R64-Peter_Polansky-Kei_Nishikori,2,F-IO,39,10,4,1,5,22,17,,,,,,,,,,
20130805-M-Canada_Masters-R64-Peter_Polansky-Kei_Nishikori,2,F-II,5,4,0,4,0,5,0,,,,,,,,,,
20130805-M-Canada_Masters-R64-Peter_Polansky-Kei_Nishikori,2,B-XC,70,7,1,0,6,35,35,,,,,,,,,,
20130805-M-Canada_Masters-R64-Peter_Polansky-Kei_Nishikori,2,B-DTM,21,1,0,0,1,10,11,,,,,,,,,,
20130805-M-Canada_Masters-R64-Peter_Polansky-Kei_Nishikori,2,B-DTL,10,5,3,0,2,6,4,,,,,,,,,,
20130805-M-Canada_Masters-R64-Peter_Polansky-Kei_Nishikori,2,B-IO,7,4,1,1,2,2,5,,,,,,,,,,
20130805-M-Canada_Masters-R64-Peter_Polansky-Kei_Nishikori,2,S-XC,10,0,0,0,0,2,8,,,,,,,,,,
20130805-M-Canada_Masters-R64-Peter_Polansky-Kei_Nishikori,2,S-DTM,5,0,0,0,0,3,2,,,,,,,,,,
20130806-M-Canada_Masters-R64-Vasek_Pospisil-John_Isner,1,F-XC,46,17,6,0,11,23,23,,,,,,,,,,
20130806-M-Canada_Masters-R64-Vasek_Pospisil-John_Isner,1,F-DTM,29,4,0,0,4,11,18,,,,,,,,,,
20130806-M-Canada_Masters-R64-Vasek_Pospisil-John_Isner,1,F-DTL,1,0,0,0,0,1,0,,,,,,,,,,
20130806-M-Canada_Masters-R64-Vasek_Pospisil-John_Isner,1,F-IO,28,11,5,2,4,15,13,,,,,,,,,,
20130806-M-Canada_Masters-R64-Vasek_Pospisil-John_Isner,1,F-II,7,3,0,0,3,2,5,,,,,,,,,,
20130806-M-Canada_Masters-R64-Vasek_Pospisil-John_Isner,1,B-XC,20,3,2,0,1,6,14,,,,,,,,,,
20130806-M-Canada_Masters-R64-Vasek_Pospisil-John_Isner,1,B-DTM,31,3,0,0,3,10,21,,,,,,,,,,
20130806-M-Canada_Masters-R64-Vasek_Pospisil-John_Isner,1,B-DTL,2,2,0,2,0,2,0,,,,,,,,,,
20130806-M-Canada_Masters-R64-Vasek_Pospisil-John_Isner,1,B-IO,2,1,1,0,0,2,0,,,,,,,,,,
20130806-M-Canada_Masters-R64-Vasek_Pospisil-John_Isner,1,S-XC,2,1,0,0,1,0,2,,,,,,,,,,
20130806-M-Canada_Masters-R64-Vasek_Pospisil-John_Isner,1,S-DTM,1,0,0,0,0,0,1,,,,,,,,,,
20130806-M-Canada_Masters-R64-Vasek_Pospisil-John_Isner,1,S-IO,1,0,0,0,0,1,0,,,,,,,,,,
20130806-M-Canada_Masters-R64-Vasek_Pospisil-John_Isner,1,S-II,1,0,0,0,0,1,0,,,,,,,,,,
20130806-M-Canada_Masters-R64-Vasek_Pospisil-John_Isner,2,F-XC,20,8,3,1,4,10,10,,,,,,,,,,
20130806-M-Canada_Masters-R64-Vasek_Pospisil-John_Isner,2,F-DTM,39,1,0,1,0,22,17,,,,,,,,,,
20130806-M-Canada_Masters-R64-Vasek_Pospisil-John_Isner,2,F-DTL,15,4,0,0,4,8,7,,,,,,,,,,
20130806-M-Canada_Masters-R64-Vasek_Pospisil-John_Isner,2,F-IO,36,14,3,3,8,19,17,,,,,,,,,,
20130806-M-Canada_Masters-R64-Vasek_Pospisil-John_Isner,2,F-II,3,1,0,1,0,2,1,,,,,,,,,,
20130806-M-Canada_Masters-R64-Vasek_Pospisil-John_Isner,2,B-XC,8,1,1,0,0,8,0,,,,,,,,,,
20130806-M-Canada_Masters-R64-Vasek_Pospisil-John_Isner,2,B-DTM,19,2,0,0,2,8,11,,,,,,,,,,
20130806-M-Canada_Masters-R64-Vasek_Pospisil-John_Isner,2,B-DTL,3,1,0,1,0,2,1,,,,,,,,,,
20130806-M-Canada_Masters-R64-Vasek_Pospisil-John_Isner,2,B-IO,3,1,0,0,1,0,3,,,,,,,,,,
20130806-M-Canada_Masters-R64-Vasek_Pospisil-John_Isner,2,S-XC,3,0,0,0,0,2,1,,,,,,,,,,
20130806-M-Canada_Masters-R64-Vasek_Pospisil-John_Isner,2,S-DTM,4,0,0,0,0,4,0,,,,,,,,,,
20130808-M-Canada_Masters-R16-Ernests_Gulbis-Andy_Murray,1,F-XC,27,8,0,3,5,13,14,,,,,,,,,,
20130808-M-Canada_Masters-R16-Ernests_Gulbis-Andy_Murray,1,F-DTM,19,2,0,0,2,9,10,,,,,,,,,,
20130808-M-Canada_Masters-R16-Ernests_Gulbis-Andy_Murray,1,F-DTL,9,4,3,0,1,3,6,,,,,,,,,,
20130808-M-Canada_Masters-R16-Ernests_Gulbis-Andy_Murray,1,F-IO,9,4,2,1,1,6,3,,,,,,,,,,
20130808-M-Canada_Masters-R16-Ernests_Gulbis-Andy_Murray,1,B-XC,32,1,0,0,1,19,13,,,,,,,,,,
20130808-M-Canada_Masters-R16-Ernests_Gulbis-Andy_Murray,1,B-DTM,21,2,0,1,1,12,9,,,,,,,,,,
20130808-M-Canada_Masters-R16-Ernests_Gulbis-Andy_Murray,1,B-DTL,9,4,1,1,2,6,3,,,,,,,,,,
20130808-M-Canada_Masters-R16-Ernests_Gulbis-Andy_Murray,1,B-IO,6,2,0,1,1,4,2,,,,,,,,,,
20130808-M-Canada_Masters-R16-Ernests_Gulbis-Andy_Murray,1,S-XC,4,0,0,0,0,2,2,,,,,,,,,,
20130808-M-Canada_Masters-R16-Ernests_Gulbis-Andy_Murray,1,S-DTM,4,0,0,0,0,2,2,,,,,,,,,,
20130808-M-Canada_Masters-R16-Ernests_Gulbis-Andy_Murray,1,S-DTL,1,1,0,1,0,1,0,,,,,,,,,,
20130808-M-Canada_Masters-R16-Ernests_Gulbis-Andy_Murray,2,F-XC,34,5,1,2,2,17,17,,,,,,,,,,
20130808-M-Canada_Masters-R16-Ernests_Gulbis-Andy_Murray,2,F-DTM,12,1,0,0,1,4,8,,,,,,,,,,
20130808-M-Canada_Masters-R16-Ernests_Gulbis-Andy_Murray,2,F-DTL,9,0,0,0,0,3,6,,,,,,,,,,
20130808-M-Canada_Masters-R16-Ernests_Gulbis-Andy_Murray,2,F-IO,23,4,1,0,3,8,15,,,,,,,,,,
20130808-M-Canada_Masters-R16-Ernests_Gulbis-Andy_Murray,2,F-II,1,0,0,0,0,1,0,,,,,,,,,,
20130808-M-Canada_Masters-R16-Ernests_Gulbis-Andy_Murray,2,B-XC,18,2,1,1,0,10,8,,,,,,,,,,
20130808-M-Canada_Masters-R16-Ernests_Gulbis-Andy_Murray,2,B-DTM,17,1,0,0,1,9,8,,,,,,,,,,
20130808-M-Canada_Masters-R16-Ernests_Gulbis-Andy_Murray,2,B-DTL,4,1,0,1,0,2,2,,,,,,,,,,
20130808-M-Canada_Masters-R16-Ernests_Gulbis-Andy_Murray,2,B-IO,7,1,0,0,1,3,4,,,,,,,,,,
20130808-M-Canada_Masters-R16-Ernests_Gulbis-Andy_Murray,2,S-XC,2,0,0,0,0,0,2,,,,,,,,,,
20130808-M-Canada_Masters-R16-Ernests_Gulbis-Andy_Murray,2,S-DTM,8,0,0,0,0,2,6,,,,,,,,,,
20130808-M-Canada_Masters-R16-Ernests_Gulbis-Andy_Murray,2,S-DTL,2,0,0,0,0,0,2,,,,,,,,,,
20130808-M-Canada_Masters-R16-Ernests_Gulbis-Andy_Murray,2,S-IO,2,1,0,1,0,2,0,,,,,,,,,,
20130913-M-Davis_Cup_World_Group_PO-RR-Sergiy_Stakhovsky-Rafael_Nadal,1,F-XC,20,3,0,0,3,3,17,,,,,,,,,,
20130913-M-Davis_Cup_World_Group_PO-RR-Sergiy_Stakhovsky-Rafael_Nadal,1,F-DTM,9,0,0,0,0,2,7,,,,,,,,,,
20130913-M-Davis_Cup_World_Group_PO-RR-Sergiy_Stakhovsky-Rafael_Nadal,1,F-DTL,6,1,0,0,1,3,3,,,,,,,,,,
20130913-M-Davis_Cup_World_Group_PO-RR-Sergiy_Stakhovsky-Rafael_Nadal,1,F-IO,8,3,1,1,1,4,4,,,,,,,,,,
20130913-M-Davis_Cup_World_Group_PO-RR-Sergiy_Stakhovsky-Rafael_Nadal,1,F-II,1,1,0,0,1,0,1,,,,,,,,,,
20130913-M-Davis_Cup_World_Group_PO-RR-Sergiy_Stakhovsky-Rafael_Nadal,1,B-XC,11,6,0,2,4,3,8,,,,,,,,,,
20130913-M-Davis_Cup_World_Group_PO-RR-Sergiy_Stakhovsky-Rafael_Nadal,1,B-DTM,12,2,0,0,2,2,10,,,,,,,,,,
20130913-M-Davis_Cup_World_Group_PO-RR-Sergiy_Stakhovsky-Rafael_Nadal,1,B-DTL,21,4,0,0,4,5,16,,,,,,,,,,
20130913-M-Davis_Cup_World_Group_PO-RR-Sergiy_Stakhovsky-Rafael_Nadal,1,B-IO,1,1,1,0,0,1,0,,,,,,,,,,
20130913-M-Davis_Cup_World_Group_PO-RR-Sergiy_Stakhovsky-Rafael_Nadal,1,S-XC,4,1,0,1,0,1,3,,,,,,,,,,
20130913-M-Davis_Cup_World_Group_PO-RR-Sergiy_Stakhovsky-Rafael_Nadal,1,S-DTM,3,1,0,0,1,0,3,,,,,,,,,,
20130913-M-Davis_Cup_World_Group_PO-RR-Sergiy_Stakhovsky-Rafael_Nadal,1,S-DTL,4,0,0,0,0,2,2,,,,,,,,,,
20130913-M-Davis_Cup_World_Group_PO-RR-Sergiy_Stakhovsky-Rafael_Nadal,2,F-XC,37,11,3,5,3,28,9,,,,,,,,,,
20130913-M-Davis_Cup_World_Group_PO-RR-Sergiy_Stakhovsky-Rafael_Nadal,2,F-DTM,8,0,0,0,0,6,2,,,,,,,,,,
20130913-M-Davis_Cup_World_Group_PO-RR-Sergiy_Stakhovsky-Rafael_Nadal,2,F-DTL,5,4,4,0,0,4,1,,,,,,,,,,
20130913-M-Davis_Cup_World_Group_PO-RR-Sergiy_Stakhovsky-Rafael_Nadal,2,F-IO,20,10,7,1,2,16,4,,,,,,,,,,
20130913-M-Davis_Cup_World_Group_PO-RR-Sergiy_Stakhovsky-Rafael_Nadal,2,F-II,7,2,0,1,1,4,3,,,,,,,,,,
20130913-M-Davis_Cup_World_Group_PO-RR-Sergiy_Stakhovsky-Rafael_Nadal,2,B-XC,15,1,0,1,0,11,4,,,,,,,,,,
20130913-M-Davis_Cup_World_Group_PO-RR-Sergiy_Stakhovsky-Rafael_Nadal,2,B-DTM,5,0,0,0,0,4,1,,,,,,,,,,
20130913-M-Davis_Cup_World_Group_PO-RR-Sergiy_Stakhovsky-Rafael_Nadal,2,B-DTL,17,4,3,1,0,13,4,,,,,,,,,,
20130913-M-Davis_Cup_World_Group_PO-RR-Sergiy_Stakhovsky-Rafael_Nadal,2,B-IO,5,0,0,0,0,3,2,,,,,,,,,,
20130913-M-Davis_Cup_World_Group_PO-RR-Sergiy_Stakhovsky-Rafael_Nadal,2,S-XC,2,2,1,0,1,1,1,,,,,,,,,,
20130913-M-Davis_Cup_World_Group_PO-RR-Sergiy_Stakhovsky-Rafael_Nadal,2,S-DTM,2,0,0,0,0,1,1,,,,,,,,,,
20130913-M-Davis_Cup_World_Group_PO-RR-Sergiy_Stakhovsky-Rafael_Nadal,2,S-DTL,2,0,0,0,0,1,1,,,,,,,,,,
20130913-M-Davis_Cup_World_Group_PO-RR-Sergiy_Stakhovsky-Rafael_Nadal,2,S-IO,1,0,0,0,0,0,1,,,,,,,,,,
20131005-M-Beijing-F-Novak_Djokovic-Rafael_Nadal,1,F-XC,47,6,2,3,1,31,16,,,,,,,,,,
20131005-M-Beijing-F-Novak_Djokovic-Rafael_Nadal,1,F-DTM,11,0,0,0,0,6,5,,,,,,,,,,
20131005-M-Beijing-F-Novak_Djokovic-Rafael_Nadal,1,F-DTL,10,4,1,1,2,5,5,,,,,,,,,,
20131005-M-Beijing-F-Novak_Djokovic-Rafael_Nadal,1,F-IO,29,11,5,2,4,23,6,,,,,,,,,,
20131005-M-Beijing-F-Novak_Djokovic-Rafael_Nadal,1,F-II,3,1,1,0,0,2,1,,,,,,,,,,
20131005-M-Beijing-F-Novak_Djokovic-Rafael_Nadal,1,B-XC,24,5,1,1,3,16,8,,,,,,,,,,
20131005-M-Beijing-F-Novak_Djokovic-Rafael_Nadal,1,B-DTM,16,0,0,0,0,13,3,,,,,,,,,,
20131005-M-Beijing-F-Novak_Djokovic-Rafael_Nadal,1,B-DTL,20,2,1,0,1,12,8,,,,,,,,,,
20131005-M-Beijing-F-Novak_Djokovic-Rafael_Nadal,1,B-IO,5,0,0,0,0,2,3,,,,,,,,,,
20131005-M-Beijing-F-Novak_Djokovic-Rafael_Nadal,1,S-XC,1,0,0,0,0,0,1,,,,,,,,,,
20131005-M-Beijing-F-Novak_Djokovic-Rafael_Nadal,1,S-DTL,1,0,0,0,0,0,1,,,,,,,,,,
20131005-M-Beijing-F-Novak_Djokovic-Rafael_Nadal,2,F-XC,43,4,0,2,2,15,28,,,,,,,,,,
20131005-M-Beijing-F-Novak_Djokovic-Rafael_Nadal,2,F-DTM,17,4,0,0,4,7,10,,,,,,,,,,
20131005-M-Beijing-F-Novak_Djokovic-Rafael_Nadal,2,F-DTL,10,4,0,0,4,0,10,,,,,,,,,,
20131005-M-Beijing-F-Novak_Djokovic-Rafael_Nadal,2,F-IO,18,3,3,0,0,11,7,,,,,,,,,,
20131005-M-Beijing-F-Novak_Djokovic-Rafael_Nadal,2,F-II,2,1,0,0,1,0,2,,,,,,,,,,
20131005-M-Beijing-F-Novak_Djokovic-Rafael_Nadal,2,B-XC,23,3,0,0,3,8,15,,,,,,,,,,
20131005-M-Beijing-F-Novak_Djokovic-Rafael_Nadal,2,B-DTM,28,5,0,0,5,11,17,,,,,,,,,,
20131005-M-Beijing-F-Novak_Djokovic-Rafael_Nadal,2,B-DTL,8,1,1,0,0,4,4,,,,,,,,,,
20131005-M-Beijing-F-Novak_Djokovic-Rafael_Nadal,2,B-IO,1,0,0,0,0,0,1,,,,,,,,,,
20131005-M-Beijing-F-Novak_Djokovic-Rafael_Nadal,2,S-XC,4,0,0,0,0,2,2,,,,,,,,,,
20131005-M-Beijing-F-Novak_Djokovic-Rafael_Nadal,2,S-DTM,8,0,0,0,0,1,7,,,,,,,,,,
20131005-M-Beijing-F-Novak_Djokovic-Rafael_Nadal,2,S-DTL,8,1,0,0,1,3,5,,,,,,,,,,
20131005-M-Beijing-F-Novak_Djokovic-Rafael_Nadal,2,S-IO,3,0,0,0,0,1,2,,,,,,,,,,
20131005-M-Tokyo-SF-Nicolas_Almagro-Juan_Martin_Del_Potro,1,F-XC,35,7,2,3,2,19,16,,,,,,,,,,
20131005-M-Tokyo-SF-Nicolas_Almagro-Juan_Martin_Del_Potro,1,F-DTM,13,2,0,0,2,4,9,,,,,,,,,,
20131005-M-Tokyo-SF-Nicolas_Almagro-Juan_Martin_Del_Potro,1,F-DTL,16,7,2,2,3,11,5,,,,,,,,,,
20131005-M-Tokyo-SF-Nicolas_Almagro-Juan_Martin_Del_Potro,1,F-IO,27,13,8,2,3,19,8,,,,,,,,,,
20131005-M-Tokyo-SF-Nicolas_Almagro-Juan_Martin_Del_Potro,1,F-II,3,1,1,0,0,2,1,,,,,,,,,,
20131005-M-Tokyo-SF-Nicolas_Almagro-Juan_Martin_Del_Potro,1,B-XC,31,8,3,1,4,12,19,,,,,,,,,,
20131005-M-Tokyo-SF-Nicolas_Almagro-Juan_Martin_Del_Potro,1,B-DTM,38,4,0,1,3,13,25,,,,,,,,,,
20131005-M-Tokyo-SF-Nicolas_Almagro-Juan_Martin_Del_Potro,1,B-DTL,6,3,1,0,2,2,4,,,,,,,,,,
20131005-M-Tokyo-SF-Nicolas_Almagro-Juan_Martin_Del_Potro,1,B-IO,3,1,1,0,0,2,1,,,,,,,,,,
20131005-M-Tokyo-SF-Nicolas_Almagro-Juan_Martin_Del_Potro,1,B-II,4,2,1,0,0,2,2,,,,,,,,,,
20131005-M-Tokyo-SF-Nicolas_Almagro-Juan_Martin_Del_Potro,1,S-XC,2,0,0,0,0,1,1,,,,,,,,,,
20131005-M-Tokyo-SF-Nicolas_Almagro-Juan_Martin_Del_Potro,1,S-DTM,8,2,0,0,2,3,5,,,,,,,,,,
20131005-M-Tokyo-SF-Nicolas_Almagro-Juan_Martin_Del_Potro,1,S-DTL,1,0,0,0,0,0,1,,,,,,,,,,
20131005-M-Tokyo-SF-Nicolas_Almagro-Juan_Martin_Del_Potro,2,F-XC,35,13,4,4,4,19,16,,,,,,,,,,
20131005-M-Tokyo-SF-Nicolas_Almagro-Juan_Martin_Del_Potro,2,F-DTM,19,1,0,0,1,9,10,,,,,,,,,,
20131005-M-Tokyo-SF-Nicolas_Almagro-Juan_Martin_Del_Potro,2,F-DTL,9,3,3,0,0,7,2,,,,,,,,,,
20131005-M-Tokyo-SF-Nicolas_Almagro-Juan_Martin_Del_Potro,2,F-IO,26,10,7,2,1,18,8,,,,,,,,,,
20131005-M-Tokyo-SF-Nicolas_Almagro-Juan_Martin_Del_Potro,2,F-II,5,3,2,1,0,3,2,,,,,,,,,,
20131005-M-Tokyo-SF-Nicolas_Almagro-Juan_Martin_Del_Potro,2,B-XC,25,3,1,2,0,18,7,,,,,,,,,,
20131005-M-Tokyo-SF-Nicolas_Almagro-Juan_Martin_Del_Potro,2,B-DTM,38,2,0,0,2,21,17,,,,,,,,,,
20131005-M-Tokyo-SF-Nicolas_Almagro-Juan_Martin_Del_Potro,2,B-DTL,4,2,1,1,0,4,0,,,,,,,,,,
20131005-M-Tokyo-SF-Nicolas_Almagro-Juan_Martin_Del_Potro,2,B-IO,3,0,0,0,0,3,0,,,,,,,,,,
20131005-M-Tokyo-SF-Nicolas_Almagro-Juan_Martin_Del_Potro,2,S-XC,6,0,0,0,0,1,5,,,,,,,,,,
20131005-M-Tokyo-SF-Nicolas_Almagro-Juan_Martin_Del_Potro,2,S-DTM,9,0,0,0,0,3,6,,,,,,,,,,
20131005-M-Tokyo-SF-Nicolas_Almagro-Juan_Martin_Del_Potro,2,S-II,1,0,0,0,0,1,0,,,,,,,,,,
20131006-M-Tokyo-F-Juan_Martin_Del_Potro-Milos_Raonic,1,F-XC,26,8,4,3,1,15,11,,,,,,,,,,
20131006-M-Tokyo-F-Juan_Martin_Del_Potro-Milos_Raonic,1,F-DTM,8,1,0,0,1,4,4,,,,,,,,,,
20131006-M-Tokyo-F-Juan_Martin_Del_Potro-Milos_Raonic,1,F-DTL,7,2,2,0,0,5,2,,,,,,,,,,
20131006-M-Tokyo-F-Juan_Martin_Del_Potro-Milos_Raonic,1,F-IO,22,6,4,2,0,12,10,,,,,,,,,,
20131006-M-Tokyo-F-Juan_Martin_Del_Potro-Milos_Raonic,1,F-II,6,3,0,2,1,5,1,,,,,,,,,,
20131006-M-Tokyo-F-Juan_Martin_Del_Potro-Milos_Raonic,1,B-XC,20,1,0,0,1,16,4,,,,,,,,,,
20131006-M-Tokyo-F-Juan_Martin_Del_Potro-Milos_Raonic,1,B-DTM,14,0,0,0,0,7,7,,,,,,,,,,
20131006-M-Tokyo-F-Juan_Martin_Del_Potro-Milos_Raonic,1,B-DTL,5,3,2,1,0,3,2,,,,,,,,,,
20131006-M-Tokyo-F-Juan_Martin_Del_Potro-Milos_Raonic,1,B-IO,2,1,1,0,0,2,0,,,,,,,,,,
20131006-M-Tokyo-F-Juan_Martin_Del_Potro-Milos_Raonic,1,B-II,1,0,0,0,0,0,1,,,,,,,,,,
20131006-M-Tokyo-F-Juan_Martin_Del_Potro-Milos_Raonic,1,S-XC,7,1,0,0,1,3,4,,,,,,,,,,
20131006-M-Tokyo-F-Juan_Martin_Del_Potro-Milos_Raonic,1,S-DTM,1,0,0,0,0,1,0,,,,,,,,,,
20131006-M-Tokyo-F-Juan_Martin_Del_Potro-Milos_Raonic,1,S-DTL,1,1,0,0,1,0,1,,,,,,,,,,
20131006-M-Tokyo-F-Juan_Martin_Del_Potro-Milos_Raonic,2,F-XC,21,6,1,1,4,10,11,,,,,,,,,,
20131006-M-Tokyo-F-Juan_Martin_Del_Potro-Milos_Raonic,2,F-DTM,4,0,0,0,0,0,4,,,,,,,,,,
20131006-M-Tokyo-F-Juan_Martin_Del_Potro-Milos_Raonic,2,F-DTL,11,4,1,2,1,8,3,,,,,,,,,,
20131006-M-Tokyo-F-Juan_Martin_Del_Potro-Milos_Raonic,2,F-IO,30,12,2,5,5,12,18,,,,,,,,,,
20131006-M-Tokyo-F-Juan_Martin_Del_Potro-Milos_Raonic,2,F-II,4,3,2,0,1,2,2,,,,,,,,,,
20131006-M-Tokyo-F-Juan_Martin_Del_Potro-Milos_Raonic,2,B-XC,7,3,2,0,1,3,4,,,,,,,,,,
20131006-M-Tokyo-F-Juan_Martin_Del_Potro-Milos_Raonic,2,B-DTM,7,1,0,1,0,3,4,,,,,,,,,,
20131006-M-Tokyo-F-Juan_Martin_Del_Potro-Milos_Raonic,2,B-DTL,7,7,3,1,3,4,3,,,,,,,,,,
20131006-M-Tokyo-F-Juan_Martin_Del_Potro-Milos_Raonic,2,B-IO,1,0,0,0,0,1,0,,,,,,,,,,
20131006-M-Tokyo-F-Juan_Martin_Del_Potro-Milos_Raonic,2,S-XC,14,0,0,0,0,9,5,,,,,,,,,,
20131006-M-Tokyo-F-Juan_Martin_Del_Potro-Milos_Raonic,2,S-DTM,5,2,0,0,2,1,4,,,,,,,,,,
20131006-M-Tokyo-F-Juan_Martin_Del_Potro-Milos_Raonic,2,S-DTL,4,1,0,1,0,3,1,,,,,,,,,,
20131006-M-Tokyo-F-Juan_Martin_Del_Potro-Milos_Raonic,2,S-IO,1,1,0,1,0,1,0,,,,,,,,,,
20131007-M-Shanghai_Masters-R32-Marcel_Granollers-Novak_Djokovic,1,F-XC,38,10,3,1,6,14,24,,,,,,,,,,
20131007-M-Shanghai_Masters-R32-Marcel_Granollers-Novak_Djokovic,1,F-DTM,13,0,0,0,0,6,7,,,,,,,,,,
20131007-M-Shanghai_Masters-R32-Marcel_Granollers-Novak_Djokovic,1,F-DTL,11,4,1,0,3,3,8,,,,,,,,,,
20131007-M-Shanghai_Masters-R32-Marcel_Granollers-Novak_Djokovic,1,F-IO,4,0,0,0,0,1,3,,,,,,,,,,
20131007-M-Shanghai_Masters-R32-Marcel_Granollers-Novak_Djokovic,1,B-XC,21,3,1,0,2,10,11,,,,,,,,,,
20131007-M-Shanghai_Masters-R32-Marcel_Granollers-Novak_Djokovic,1,B-DTM,20,1,0,0,1,8,12,,,,,,,,,,
20131007-M-Shanghai_Masters-R32-Marcel_Granollers-Novak_Djokovic,1,B-DTL,4,3,1,2,0,4,0,,,,,,,,,,
20131007-M-Shanghai_Masters-R32-Marcel_Granollers-Novak_Djokovic,1,S-XC,12,1,0,0,1,5,7,,,,,,,,,,
20131007-M-Shanghai_Masters-R32-Marcel_Granollers-Novak_Djokovic,1,S-DTM,12,1,0,0,1,4,8,,,,,,,,,,
20131007-M-Shanghai_Masters-R32-Marcel_Granollers-Novak_Djokovic,1,S-DTL,1,0,0,0,0,0,1,,,,,,,,,,
20131007-M-Shanghai_Masters-R32-Marcel_Granollers-Novak_Djokovic,1,S-IO,1,0,0,0,0,0,1,,,,,,,,,,
20131007-M-Shanghai_Masters-R32-Marcel_Granollers-Novak_Djokovic,2,F-XC,24,3,0,2,1,17,7,,,,,,,,,,
20131007-M-Shanghai_Masters-R32-Marcel_Granollers-Novak_Djokovic,2,F-DTM,12,1,0,0,1,9,3,,,,,,,,,,
20131007-M-Shanghai_Masters-R32-Marcel_Granollers-Novak_Djokovic,2,F-DTL,15,3,1,0,2,7,8,,,,,,,,,,
20131007-M-Shanghai_Masters-R32-Marcel_Granollers-Novak_Djokovic,2,F-IO,18,6,3,1,2,8,10,,,,,,,,,,
20131007-M-Shanghai_Masters-R32-Marcel_Granollers-Novak_Djokovic,2,F-II,5,2,0,0,2,0,5,,,,,,,,,,
20131007-M-Shanghai_Masters-R32-Marcel_Granollers-Novak_Djokovic,2,B-XC,18,4,3,1,0,12,6,,,,,,,,,,
20131007-M-Shanghai_Masters-R32-Marcel_Granollers-Novak_Djokovic,2,B-DTM,9,0,0,0,0,4,5,,,,,,,,,,
20131007-M-Shanghai_Masters-R32-Marcel_Granollers-Novak_Djokovic,2,B-DTL,7,1,0,0,1,4,3,,,,,,,,,,
20131007-M-Shanghai_Masters-R32-Marcel_Granollers-Novak_Djokovic,2,B-IO,3,0,0,0,0,2,1,,,,,,,,,,
20131007-M-Shanghai_Masters-R32-Marcel_Granollers-Novak_Djokovic,2,S-XC,10,2,1,0,1,8,2,,,,,,,,,,
20131007-M-Shanghai_Masters-R32-Marcel_Granollers-Novak_Djokovic,2,S-DTM,4,0,0,0,0,3,1,,,,,,,,,,
20131007-M-Shanghai_Masters-R32-Marcel_Granollers-Novak_Djokovic,2,S-DTL,7,0,0,0,0,6,1,,,,,,,,,,
20131007-M-Shanghai_Masters-R32-Marcel_Granollers-Novak_Djokovic,2,S-IO,3,0,0,0,0,2,1,,,,,,,,,,
20131007-M-Shanghai_Masters-R32-Rafael_Nadal-Alexandr_Dolgopolov,1,F-XC,15,1,0,1,0,9,6,,,,,,,,,,
20131007-M-Shanghai_Masters-R32-Rafael_Nadal-Alexandr_Dolgopolov,1,F-DTM,11,1,0,0,1,5,6,,,,,,,,,,
20131007-M-Shanghai_Masters-R32-Rafael_Nadal-Alexandr_Dolgopolov,1,F-DTL,6,3,2,1,0,5,1,,,,,,,,,,
20131007-M-Shanghai_Masters-R32-Rafael_Nadal-Alexandr_Dolgopolov,1,F-IO,9,4,2,1,1,4,5,,,,,,,,,,
20131007-M-Shanghai_Masters-R32-Rafael_Nadal-Alexandr_Dolgopolov,1,F-II,1,1,0,1,0,1,0,,,,,,,,,,
20131007-M-Shanghai_Masters-R32-Rafael_Nadal-Alexandr_Dolgopolov,1,B-XC,11,1,0,0,1,5,6,,,,,,,,,,
20131007-M-Shanghai_Masters-R32-Rafael_Nadal-Alexandr_Dolgopolov,1,B-DTM,11,1,0,0,1,7,4,,,,,,,,,,
20131007-M-Shanghai_Masters-R32-Rafael_Nadal-Alexandr_Dolgopolov,1,B-DTL,1,0,0,0,0,0,1,,,,,,,,,,
20131007-M-Shanghai_Masters-R32-Rafael_Nadal-Alexandr_Dolgopolov,1,S-XC,2,0,0,0,0,0,2,,,,,,,,,,
20131007-M-Shanghai_Masters-R32-Rafael_Nadal-Alexandr_Dolgopolov,1,S-DTM,3,0,0,0,0,3,0,,,,,,,,,,
20131007-M-Shanghai_Masters-R32-Rafael_Nadal-Alexandr_Dolgopolov,1,S-DTL,2,0,0,0,0,2,0,,,,,,,,,,
20131007-M-Shanghai_Masters-R32-Rafael_Nadal-Alexandr_Dolgopolov,2,F-XC,28,3,0,2,1,13,15,,,,,,,,,,
20131007-M-Shanghai_Masters-R32-Rafael_Nadal-Alexandr_Dolgopolov,2,F-DTM,8,5,1,1,3,4,4,,,,,,,,,,
20131007-M-Shanghai_Masters-R32-Rafael_Nadal-Alexandr_Dolgopolov,2,F-DTL,7,2,1,0,1,5,2,,,,,,,,,,
20131007-M-Shanghai_Masters-R32-Rafael_Nadal-Alexandr_Dolgopolov,2,F-IO,8,4,3,0,1,4,4,,,,,,,,,,
20131007-M-Shanghai_Masters-R32-Rafael_Nadal-Alexandr_Dolgopolov,2,F-II,1,1,1,0,0,1,0,,,,,,,,,,
20131007-M-Shanghai_Masters-R32-Rafael_Nadal-Alexandr_Dolgopolov,2,B-XC,19,10,3,1,6,8,11,,,,,,,,,,
20131007-M-Shanghai_Masters-R32-Rafael_Nadal-Alexandr_Dolgopolov,2,B-DTM,6,2,0,0,2,3,3,,,,,,,,,,
20131007-M-Shanghai_Masters-R32-Rafael_Nadal-Alexandr_Dolgopolov,2,B-DTL,1,1,0,0,1,0,1,,,,,,,,,,
20131007-M-Shanghai_Masters-R32-Rafael_Nadal-Alexandr_Dolgopolov,2,B-IO,2,2,0,0,2,0,2,,,,,,,,,,
20131007-M-Shanghai_Masters-R32-Rafael_Nadal-Alexandr_Dolgopolov,2,S-DTM,1,0,0,0,0,0,1,,,,,,,,,,
20131007-M-Shanghai_Masters-R32-Rafael_Nadal-Alexandr_Dolgopolov,2,S-DTL,1,1,0,0,1,0,1,,,,,,,,,,
20131007-M-Shanghai_Masters-R32-Roger_Federer-Andreas_Seppi,1,F-XC,31,10,3,4,3,19,12,,,,,,,,,,
20131007-M-Shanghai_Masters-R32-Roger_Federer-Andreas_Seppi,1,F-DTM,10,0,0,0,0,7,3,,,,,,,,,,
20131007-M-Shanghai_Masters-R32-Roger_Federer-Andreas_Seppi,1,F-DTL,9,3,1,1,1,4,5,,,,,,,,,,
20131007-M-Shanghai_Masters-R32-Roger_Federer-Andreas_Seppi,1,F-IO,19,7,1,3,3,11,8,,,,,,,,,,
20131007-M-Shanghai_Masters-R32-Roger_Federer-Andreas_Seppi,1,B-XC,10,2,0,1,1,7,3,,,,,,,,,,
20131007-M-Shanghai_Masters-R32-Roger_Federer-Andreas_Seppi,1,B-DTM,18,2,0,0,2,10,8,,,,,,,,,,
20131007-M-Shanghai_Masters-R32-Roger_Federer-Andreas_Seppi,1,B-DTL,4,3,0,2,1,3,1,,,,,,,,,,
20131007-M-Shanghai_Masters-R32-Roger_Federer-Andreas_Seppi,1,B-IO,1,0,0,0,0,1,0,,,,,,,,,,
20131007-M-Shanghai_Masters-R32-Roger_Federer-Andreas_Seppi,1,S-XC,16,3,0,0,3,10,6,,,,,,,,,,
20131007-M-Shanghai_Masters-R32-Roger_Federer-Andreas_Seppi,1,S-DTM,4,0,0,0,0,3,1,,,,,,,,,,
20131007-M-Shanghai_Masters-R32-Roger_Federer-Andreas_Seppi,1,S-DTL,2,0,0,0,0,2,0,,,,,,,,,,
20131007-M-Shanghai_Masters-R32-Roger_Federer-Andreas_Seppi,1,S-IO,1,0,0,0,0,0,1,,,,,,,,,,
20131007-M-Shanghai_Masters-R32-Roger_Federer-Andreas_Seppi,2,F-XC,26,8,0,2,6,9,17,,,,,,,,,,
20131007-M-Shanghai_Masters-R32-Roger_Federer-Andreas_Seppi,2,F-DTM,11,1,0,1,0,6,5,,,,,,,,,,
20131007-M-Shanghai_Masters-R32-Roger_Federer-Andreas_Seppi,2,F-DTL,8,2,0,0,2,2,6,,,,,,,,,,
20131007-M-Shanghai_Masters-R32-Roger_Federer-Andreas_Seppi,2,F-IO,23,7,4,0,3,10,13,,,,,,,,,,
20131007-M-Shanghai_Masters-R32-Roger_Federer-Andreas_Seppi,2,F-II,1,0,0,0,0,0,1,,,,,,,,,,
20131007-M-Shanghai_Masters-R32-Roger_Federer-Andreas_Seppi,2,B-XC,19,4,2,1,1,10,9,,,,,,,,,,
20131007-M-Shanghai_Masters-R32-Roger_Federer-Andreas_Seppi,2,B-DTM,24,1,0,0,1,4,20,,,,,,,,,,
20131007-M-Shanghai_Masters-R32-Roger_Federer-Andreas_Seppi,2,B-DTL,3,2,1,0,1,1,2,,,,,,,,,,
20131007-M-Shanghai_Masters-R32-Roger_Federer-Andreas_Seppi,2,S-XC,4,1,0,0,1,1,3,,,,,,,,,,
20131007-M-Shanghai_Masters-R32-Roger_Federer-Andreas_Seppi,2,S-DTM,4,0,0,0,0,3,1,,,,,,,,,,
20131007-M-Shanghai_Masters-R32-Roger_Federer-Andreas_Seppi,2,S-DTL,2,2,0,0,2,0,2,,,,,,,,,,
20131010-M-Shanghai_Masters-R16-Roger_Federer-Gael_Monfils,1,F-XC,36,12,4,5,3,21,15,,,,,,,,,,
20131010-M-Shanghai_Masters-R16-Roger_Federer-Gael_Monfils,1,F-DTM,11,1,0,0,1,2,9,,,,,,,,,,
20131010-M-Shanghai_Masters-R16-Roger_Federer-Gael_Monfils,1,F-DTL,6,2,0,2,0,3,3,,,,,,,,,,
20131010-M-Shanghai_Masters-R16-Roger_Federer-Gael_Monfils,1,F-IO,63,27,14,6,7,38,25,,,,,,,,,,
20131010-M-Shanghai_Masters-R16-Roger_Federer-Gael_Monfils,1,F-II,8,3,1,0,2,5,3,,,,,,,,,,
20131010-M-Shanghai_Masters-R16-Roger_Federer-Gael_Monfils,1,B-DTM,21,2,0,0,2,11,10,,,,,,,,,,
20131010-M-Shanghai_Masters-R16-Roger_Federer-Gael_Monfils,1,B-IO,39,6,0,0,6,17,22,,,,,,,,,,
20131010-M-Shanghai_Masters-R16-Roger_Federer-Gael_Monfils,1,B-II,11,5,1,1,3,7,4,,,,,,,,,,
20131010-M-Shanghai_Masters-R16-Roger_Federer-Gael_Monfils,1,S-DTM,1,0,0,0,0,1,0,,,,,,,,,,
20131010-M-Shanghai_Masters-R16-Roger_Federer-Gael_Monfils,1,S-IO,22,2,0,1,1,13,9,,,,,,,,,,
20131010-M-Shanghai_Masters-R16-Roger_Federer-Gael_Monfils,1,S-II,5,1,0,0,1,1,4,,,,,,,,,,
20131010-M-Shanghai_Masters-R16-Roger_Federer-Gael_Monfils,2,F-XC,36,4,1,2,1,21,15,,,,,,,,,,
20131010-M-Shanghai_Masters-R16-Roger_Federer-Gael_Monfils,2,F-DTM,19,4,0,0,4,10,9,,,,,,,,,,
20131010-M-Shanghai_Masters-R16-Roger_Federer-Gael_Monfils,2,F-DTL,3,1,1,0,0,1,2,,,,,,,,,,
20131010-M-Shanghai_Masters-R16-Roger_Federer-Gael_Monfils,2,F-IO,35,14,8,3,3,21,14,,,,,,,,,,
20131010-M-Shanghai_Masters-R16-Roger_Federer-Gael_Monfils,2,F-II,13,2,0,0,2,4,9,,,,,,,,,,
20131010-M-Shanghai_Masters-R16-Roger_Federer-Gael_Monfils,2,B-XC,3,3,2,1,0,3,0,,,,,,,,,,
20131010-M-Shanghai_Masters-R16-Roger_Federer-Gael_Monfils,2,B-DTM,25,2,0,1,1,9,16,,,,,,,,,,
20131010-M-Shanghai_Masters-R16-Roger_Federer-Gael_Monfils,2,B-IO,54,4,1,1,2,29,25,,,,,,,,,,
20131010-M-Shanghai_Masters-R16-Roger_Federer-Gael_Monfils,2,B-II,14,7,2,3,2,8,6,,,,,,,,,,
20131010-M-Shanghai_Masters-R16-Roger_Federer-Gael_Monfils,2,S-DTM,3,0,0,0,0,1,2,,,,,,,,,,
20131010-M-Shanghai_Masters-R16-Roger_Federer-Gael_Monfils,2,S-IO,2,0,0,0,0,0,2,,,,,,,,,,
20131011-M-Shanghai_Masters-QF-Nicolas_Almagro-Juan_Martin_Del_Potro,1,F-XC,25,9,3,2,4,11,14,,,,,,,,,,
20131011-M-Shanghai_Masters-QF-Nicolas_Almagro-Juan_Martin_Del_Potro,1,F-DTM,7,2,0,0,2,1,6,,,,,,,,,,
20131011-M-Shanghai_Masters-QF-Nicolas_Almagro-Juan_Martin_Del_Potro,1,F-DTL,8,5,1,1,3,3,5,,,,,,,,,,
20131011-M-Shanghai_Masters-QF-Nicolas_Almagro-Juan_Martin_Del_Potro,1,F-IO,19,7,3,2,2,14,5,,,,,,,,,,
20131011-M-Shanghai_Masters-QF-Nicolas_Almagro-Juan_Martin_Del_Potro,1,F-II,2,1,1,0,0,1,1,,,,,,,,,,
20131011-M-Shanghai_Masters-QF-Nicolas_Almagro-Juan_Martin_Del_Potro,1,B-XC,23,4,1,1,2,11,12,,,,,,,,,,
20131011-M-Shanghai_Masters-QF-Nicolas_Almagro-Juan_Martin_Del_Potro,1,B-DTM,18,3,0,0,3,9,9,,,,,,,,,,
20131011-M-Shanghai_Masters-QF-Nicolas_Almagro-Juan_Martin_Del_Potro,1,B-DTL,4,2,1,0,1,1,3,,,,,,,,,,
20131011-M-Shanghai_Masters-QF-Nicolas_Almagro-Juan_Martin_Del_Potro,1,S-XC,3,1,0,0,1,1,2,,,,,,,,,,
20131011-M-Shanghai_Masters-QF-Nicolas_Almagro-Juan_Martin_Del_Potro,1,S-DTM,4,2,0,0,2,0,4,,,,,,,,,,
20131011-M-Shanghai_Masters-QF-Nicolas_Almagro-Juan_Martin_Del_Potro,1,S-IO,1,0,0,0,0,1,0,,,,,,,,,,
20131011-M-Shanghai_Masters-QF-Nicolas_Almagro-Juan_Martin_Del_Potro,2,F-XC,23,9,6,3,0,18,5,,,,,,,,,,
20131011-M-Shanghai_Masters-QF-Nicolas_Almagro-Juan_Martin_Del_Potro,2,F-DTM,9,2,0,1,1,3,6,,,,,,,,,,
20131011-M-Shanghai_Masters-QF-Nicolas_Almagro-Juan_Martin_Del_Potro,2,F-DTL,6,2,2,0,0,4,2,,,,,,,,,,
20131011-M-Shanghai_Masters-QF-Nicolas_Almagro-Juan_Martin_Del_Potro,2,F-IO,15,3,3,0,0,9,6,,,,,,,,,,
20131011-M-Shanghai_Masters-QF-Nicolas_Almagro-Juan_Martin_Del_Potro,2,F-II,1,0,0,0,0,1,0,,,,,,,,,,
20131011-M-Shanghai_Masters-QF-Nicolas_Almagro-Juan_Martin_Del_Potro,2,B-XC,14,3,0,1,2,9,5,,,,,,,,,,
20131011-M-Shanghai_Masters-QF-Nicolas_Almagro-Juan_Martin_Del_Potro,2,B-DTM,20,1,0,0,1,6,14,,,,,,,,,,
20131011-M-Shanghai_Masters-QF-Nicolas_Almagro-Juan_Martin_Del_Potro,2,B-DTL,2,2,1,0,1,1,1,,,,,,,,,,
20131011-M-Shanghai_Masters-QF-Nicolas_Almagro-Juan_Martin_Del_Potro,2,B-IO,1,1,1,0,0,1,0,,,,,,,,,,
20131011-M-Shanghai_Masters-QF-Nicolas_Almagro-Juan_Martin_Del_Potro,2,B-II,1,0,0,0,0,1,0,,,,,,,,,,
20131011-M-Shanghai_Masters-QF-Nicolas_Almagro-Juan_Martin_Del_Potro,2,S-XC,6,0,0,0,0,3,3,,,,,,,,,,
20131011-M-Shanghai_Masters-QF-Nicolas_Almagro-Juan_Martin_Del_Potro,2,S-DTM,5,0,0,0,0,4,1,,,,,,,,,,
20131012-M-Shanghai_Masters-SF-Rafael_Nadal-Juan_Martin_Del_Potro,1,F-XC,47,4,1,1,2,23,24,,,,,,,,,,
20131012-M-Shanghai_Masters-SF-Rafael_Nadal-Juan_Martin_Del_Potro,1,F-DTM,20,2,0,0,2,9,11,,,,,,,,,,
20131012-M-Shanghai_Masters-SF-Rafael_Nadal-Juan_Martin_Del_Potro,1,F-DTL,19,7,0,2,5,6,13,,,,,,,,,,
20131012-M-Shanghai_Masters-SF-Rafael_Nadal-Juan_Martin_Del_Potro,1,F-IO,25,7,5,1,1,18,7,,,,,,,,,,
20131012-M-Shanghai_Masters-SF-Rafael_Nadal-Juan_Martin_Del_Potro,1,F-II,3,1,1,0,0,2,1,,,,,,,,,,
20131012-M-Shanghai_Masters-SF-Rafael_Nadal-Juan_Martin_Del_Potro,1,B-XC,32,6,1,1,4,13,19,,,,,,,,,,
20131012-M-Shanghai_Masters-SF-Rafael_Nadal-Juan_Martin_Del_Potro,1,B-DTM,37,1,0,0,1,20,17,,,,,,,,,,
20131012-M-Shanghai_Masters-SF-Rafael_Nadal-Juan_Martin_Del_Potro,1,B-DTL,10,5,2,0,3,6,4,,,,,,,,,,
20131012-M-Shanghai_Masters-SF-Rafael_Nadal-Juan_Martin_Del_Potro,1,B-IO,7,1,0,0,1,3,4,,,,,,,,,,
20131012-M-Shanghai_Masters-SF-Rafael_Nadal-Juan_Martin_Del_Potro,1,S-XC,3,0,0,0,0,2,1,,,,,,,,,,
20131012-M-Shanghai_Masters-SF-Rafael_Nadal-Juan_Martin_Del_Potro,1,S-DTM,15,2,0,0,2,4,11,,,,,,,,,,
20131012-M-Shanghai_Masters-SF-Rafael_Nadal-Juan_Martin_Del_Potro,1,S-DTL,10,0,0,0,0,1,9,,,,,,,,,,
20131012-M-Shanghai_Masters-SF-Rafael_Nadal-Juan_Martin_Del_Potro,1,S-IO,1,0,0,0,0,0,1,,,,,,,,,,
20131012-M-Shanghai_Masters-SF-Rafael_Nadal-Juan_Martin_Del_Potro,2,F-XC,67,12,4,1,7,34,33,,,,,,,,,,
20131012-M-Shanghai_Masters-SF-Rafael_Nadal-Juan_Martin_Del_Potro,2,F-DTM,22,4,1,0,3,8,14,,,,,,,,,,
20131012-M-Shanghai_Masters-SF-Rafael_Nadal-Juan_Martin_Del_Potro,2,F-DTL,16,11,4,2,5,9,7,,,,,,,,,,
20131012-M-Shanghai_Masters-SF-Rafael_Nadal-Juan_Martin_Del_Potro,2,F-IO,38,12,6,2,4,26,12,,,,,,,,,,
20131012-M-Shanghai_Masters-SF-Rafael_Nadal-Juan_Martin_Del_Potro,2,F-II,10,1,0,0,1,6,4,,,,,,,,,,
20131012-M-Shanghai_Masters-SF-Rafael_Nadal-Juan_Martin_Del_Potro,2,B-XC,43,9,1,1,7,22,21,,,,,,,,,,
20131012-M-Shanghai_Masters-SF-Rafael_Nadal-Juan_Martin_Del_Potro,2,B-DTM,12,2,0,1,1,6,6,,,,,,,,,,
20131012-M-Shanghai_Masters-SF-Rafael_Nadal-Juan_Martin_Del_Potro,2,B-DTL,12,2,0,0,2,8,4,,,,,,,,,,
20131012-M-Shanghai_Masters-SF-Rafael_Nadal-Juan_Martin_Del_Potro,2,B-IO,12,3,1,0,2,6,6,,,,,,,,,,
20131012-M-Shanghai_Masters-SF-Rafael_Nadal-Juan_Martin_Del_Potro,2,S-XC,2,0,0,0,0,0,2,,,,,,,,,,
20131012-M-Shanghai_Masters-SF-Rafael_Nadal-Juan_Martin_Del_Potro,2,S-DTM,1,0,0,0,0,0,1,,,,,,,,,,
20131012-M-Shanghai_Masters-SF-Rafael_Nadal-Juan_Martin_Del_Potro,2,S-IO,1,0,0,0,0,1,0,,,,,,,,,,
20131013-M-Shanghai_Masters-F-Novak_Djokovic-Juan_Martin_Del_Potro,1,F-XC,40,13,6,3,4,27,13,,,,,,,,,,
20131013-M-Shanghai_Masters-F-Novak_Djokovic-Juan_Martin_Del_Potro,1,F-DTM,44,3,0,0,3,16,28,,,,,,,,,,
20131013-M-Shanghai_Masters-F-Novak_Djokovic-Juan_Martin_Del_Potro,1,F-DTL,18,5,1,0,4,7,11,,,,,,,,,,
20131013-M-Shanghai_Masters-F-Novak_Djokovic-Juan_Martin_Del_Potro,1,F-IO,47,15,5,5,5,31,16,,,,,,,,,,
20131013-M-Shanghai_Masters-F-Novak_Djokovic-Juan_Martin_Del_Potro,1,F-II,1,0,0,0,0,0,1,,,,,,,,,,
20131013-M-Shanghai_Masters-F-Novak_Djokovic-Juan_Martin_Del_Potro,1,B-XC,35,2,1,0,1,20,15,,,,,,,,,,
20131013-M-Shanghai_Masters-F-Novak_Djokovic-Juan_Martin_Del_Potro,1,B-DTM,66,3,1,0,2,36,30,,,,,,,,,,
20131013-M-Shanghai_Masters-F-Novak_Djokovic-Juan_Martin_Del_Potro,1,B-DTL,12,8,3,2,3,8,4,,,,,,,,,,
20131013-M-Shanghai_Masters-F-Novak_Djokovic-Juan_Martin_Del_Potro,1,B-IO,11,6,4,1,1,8,3,,,,,,,,,,
20131013-M-Shanghai_Masters-F-Novak_Djokovic-Juan_Martin_Del_Potro,1,S-XC,13,1,1,0,0,7,6,,,,,,,,,,
20131013-M-Shanghai_Masters-F-Novak_Djokovic-Juan_Martin_Del_Potro,1,S-DTM,9,0,0,0,0,6,3,,,,,,,,,,
20131013-M-Shanghai_Masters-F-Novak_Djokovic-Juan_Martin_Del_Potro,1,S-DTL,1,0,0,0,0,0,1,,,,,,,,,,
20131013-M-Shanghai_Masters-F-Novak_Djokovic-Juan_Martin_Del_Potro,1,S-IO,3,2,0,2,0,3,0,,,,,,,,,,
20131013-M-Shanghai_Masters-F-Novak_Djokovic-Juan_Martin_Del_Potro,2,F-XC,58,13,7,2,4,31,27,,,,,,,,,,
20131013-M-Shanghai_Masters-F-Novak_Djokovic-Juan_Martin_Del_Potro,2,F-DTM,46,2,0,0,2,19,27,,,,,,,,,,
20131013-M-Shanghai_Masters-F-Novak_Djokovic-Juan_Martin_Del_Potro,2,F-DTL,9,5,2,1,2,3,6,,,,,,,,,,
20131013-M-Shanghai_Masters-F-Novak_Djokovic-Juan_Martin_Del_Potro,2,F-IO,48,15,5,5,5,27,21,,,,,,,,,,
20131013-M-Shanghai_Masters-F-Novak_Djokovic-Juan_Martin_Del_Potro,2,F-II,2,0,0,0,0,2,0,,,,,,,,,,
20131013-M-Shanghai_Masters-F-Novak_Djokovic-Juan_Martin_Del_Potro,2,B-XC,44,6,1,1,4,25,19,,,,,,,,,,
20131013-M-Shanghai_Masters-F-Novak_Djokovic-Juan_Martin_Del_Potro,2,B-DTM,69,2,0,0,2,28,41,,,,,,,,,,
20131013-M-Shanghai_Masters-F-Novak_Djokovic-Juan_Martin_Del_Potro,2,B-DTL,6,2,0,2,0,3,3,,,,,,,,,,
20131013-M-Shanghai_Masters-F-Novak_Djokovic-Juan_Martin_Del_Potro,2,B-IO,6,2,1,0,1,4,2,,,,,,,,,,
20131013-M-Shanghai_Masters-F-Novak_Djokovic-Juan_Martin_Del_Potro,2,S-XC,8,0,0,0,0,3,5,,,,,,,,,,
20131013-M-Shanghai_Masters-F-Novak_Djokovic-Juan_Martin_Del_Potro,2,S-DTM,17,0,0,0,0,2,15,,,,,,,,,,
20131013-M-Shanghai_Masters-F-Novak_Djokovic-Juan_Martin_Del_Potro,2,S-DTL,2,0,0,0,0,0,2,,,,,,,,,,
20131025-M-Basel-QF-Grigor_Dimitrov-Roger_Federer,1,F-XC,30,7,2,1,4,10,20,,,,,,,,,,
20131025-M-Basel-QF-Grigor_Dimitrov-Roger_Federer,1,F-DTM,13,2,0,0,2,3,10,,,,,,,,,,
20131025-M-Basel-QF-Grigor_Dimitrov-Roger_Federer,1,F-DTL,3,0,0,0,0,2,1,,,,,,,,,,
20131025-M-Basel-QF-Grigor_Dimitrov-Roger_Federer,1,F-IO,26,12,3,3,6,16,10,,,,,,,,,,
20131025-M-Basel-QF-Grigor_Dimitrov-Roger_Federer,1,F-II,6,3,1,0,2,3,3,,,,,,,,,,
20131025-M-Basel-QF-Grigor_Dimitrov-Roger_Federer,1,B-XC,29,5,0,0,5,5,24,,,,,,,,,,
20131025-M-Basel-QF-Grigor_Dimitrov-Roger_Federer,1,B-DTM,7,1,0,0,1,2,5,,,,,,,,,,
20131025-M-Basel-QF-Grigor_Dimitrov-Roger_Federer,1,B-DTL,1,1,0,0,1,0,1,,,,,,,,,,
20131025-M-Basel-QF-Grigor_Dimitrov-Roger_Federer,1,B-II,1,0,0,0,0,0,1,,,,,,,,,,
20131025-M-Basel-QF-Grigor_Dimitrov-Roger_Federer,1,S-XC,15,4,0,0,4,3,12,,,,,,,,,,
20131025-M-Basel-QF-Grigor_Dimitrov-Roger_Federer,1,S-DTM,4,0,0,0,0,1,3,,,,,,,,,,
20131025-M-Basel-QF-Grigor_Dimitrov-Roger_Federer,1,S-DTL,3,0,0,0,0,2,1,,,,,,,,,,
20131025-M-Basel-QF-Grigor_Dimitrov-Roger_Federer,2,F-XC,29,14,6,3,5,20,9,,,,,,,,,,
20131025-M-Basel-QF-Grigor_Dimitrov-Roger_Federer,2,F-DTM,9,0,0,0,0,9,0,,,,,,,,,,
20131025-M-Basel-QF-Grigor_Dimitrov-Roger_Federer,2,F-DTL,13,5,1,1,3,8,5,,,,,,,,,,
20131025-M-Basel-QF-Grigor_Dimitrov-Roger_Federer,2,F-IO,30,8,3,3,2,24,6,,,,,,,,,,
20131025-M-Basel-QF-Grigor_Dimitrov-Roger_Federer,2,F-II,6,2,1,0,1,4,2,,,,,,,,,,
20131025-M-Basel-QF-Grigor_Dimitrov-Roger_Federer,2,B-XC,28,5,0,1,4,19,9,,,,,,,,,,
20131025-M-Basel-QF-Grigor_Dimitrov-Roger_Federer,2,B-DTM,7,2,0,0,2,2,5,,,,,,,,,,
20131025-M-Basel-QF-Grigor_Dimitrov-Roger_Federer,2,B-DTL,4,1,0,0,1,3,1,,,,,,,,,,
20131025-M-Basel-QF-Grigor_Dimitrov-Roger_Federer,2,B-IO,1,0,0,0,0,0,1,,,,,,,,,,
20131025-M-Basel-QF-Grigor_Dimitrov-Roger_Federer,2,S-XC,6,0,0,0,0,2,4,,,,,,,,,,
20131025-M-Basel-QF-Grigor_Dimitrov-Roger_Federer,2,S-DTM,1,0,0,0,0,0,1,,,,,,,,,,
20131027-M-Basel-F-Juan_Martin_Del_Potro-Roger_Federer,1,F-XC,43,10,6,1,3,30,13,,,,,,,,,,
20131027-M-Basel-F-Juan_Martin_Del_Potro-Roger_Federer,1,F-DTM,24,1,0,0,1,11,13,,,,,,,,,,
20131027-M-Basel-F-Juan_Martin_Del_Potro-Roger_Federer,1,F-DTL,11,3,0,0,3,7,4,,,,,,,,,,
20131027-M-Basel-F-Juan_Martin_Del_Potro-Roger_Federer,1,F-IO,44,5,2,0,3,29,15,,,,,,,,,,
20131027-M-Basel-F-Juan_Martin_Del_Potro-Roger_Federer,1,F-II,5,1,1,0,0,2,3,,,,,,,,,,
20131027-M-Basel-F-Juan_Martin_Del_Potro-Roger_Federer,1,B-XC,35,3,0,0,3,20,15,,,,,,,,,,
20131027-M-Basel-F-Juan_Martin_Del_Potro-Roger_Federer,1,B-DTM,34,3,0,0,3,25,9,,,,,,,,,,
20131027-M-Basel-F-Juan_Martin_Del_Potro-Roger_Federer,1,B-DTL,8,4,3,0,1,4,4,,,,,,,,,,
20131027-M-Basel-F-Juan_Martin_Del_Potro-Roger_Federer,1,B-IO,10,4,3,1,0,8,2,,,,,,,,,,
20131027-M-Basel-F-Juan_Martin_Del_Potro-Roger_Federer,1,S-XC,14,2,0,1,1,10,4,,,,,,,,,,
20131027-M-Basel-F-Juan_Martin_Del_Potro-Roger_Federer,1,S-DTM,6,0,0,0,0,3,3,,,,,,,,,,
20131027-M-Basel-F-Juan_Martin_Del_Potro-Roger_Federer,1,S-DTL,3,0,0,0,0,0,3,,,,,,,,,,
20131027-M-Basel-F-Juan_Martin_Del_Potro-Roger_Federer,1,S-IO,1,0,0,0,0,1,0,,,,,,,,,,
20131027-M-Basel-F-Juan_Martin_Del_Potro-Roger_Federer,2,F-XC,39,8,3,0,5,18,21,,,,,,,,,,
20131027-M-Basel-F-Juan_Martin_Del_Potro-Roger_Federer,2,F-DTM,39,5,0,0,5,8,31,,,,,,,,,,
20131027-M-Basel-F-Juan_Martin_Del_Potro-Roger_Federer,2,F-DTL,12,5,3,0,2,7,5,,,,,,,,,,
20131027-M-Basel-F-Juan_Martin_Del_Potro-Roger_Federer,2,F-IO,32,16,9,2,5,17,15,,,,,,,,,,
20131027-M-Basel-F-Juan_Martin_Del_Potro-Roger_Federer,2,F-II,5,2,1,0,1,2,3,,,,,,,,,,
20131027-M-Basel-F-Juan_Martin_Del_Potro-Roger_Federer,2,B-XC,28,4,1,0,3,16,12,,,,,,,,,,
20131027-M-Basel-F-Juan_Martin_Del_Potro-Roger_Federer,2,B-DTM,27,3,0,0,2,9,18,,,,,,,,,,
20131027-M-Basel-F-Juan_Martin_Del_Potro-Roger_Federer,2,B-DTL,7,5,5,0,0,5,2,,,,,,,,,,
20131027-M-Basel-F-Juan_Martin_Del_Potro-Roger_Federer,2,B-IO,4,0,0,0,0,2,2,,,,,,,,,,
20131027-M-Basel-F-Juan_Martin_Del_Potro-Roger_Federer,2,S-XC,22,4,0,0,4,4,18,,,,,,,,,,
20131027-M-Basel-F-Juan_Martin_Del_Potro-Roger_Federer,2,S-DTM,24,0,0,0,0,6,18,,,,,,,,,,
20131027-M-Basel-F-Juan_Martin_Del_Potro-Roger_Federer,2,S-DTL,5,2,0,0,2,0,5,,,,,,,,,,
20131027-M-Basel-F-Juan_Martin_Del_Potro-Roger_Federer,2,S-II,1,1,1,0,0,1,0,,,,,,,,,,
20131028-M-Paris_Masters-QF-Richard_Gasquet-Rafael_Nadal,1,F-XC,29,4,1,2,1,10,19,,,,,,,,,,
20131028-M-Paris_Masters-QF-Richard_Gasquet-Rafael_Nadal,1,F-DTM,7,1,0,0,1,0,7,,,,,,,,,,
20131028-M-Paris_Masters-QF-Richard_Gasquet-Rafael_Nadal,1,F-DTL,4,3,0,2,1,2,2,,,,,,,,,,
20131028-M-Paris_Masters-QF-Richard_Gasquet-Rafael_Nadal,1,F-IO,5,4,1,1,2,2,3,,,,,,,,,,
20131028-M-Paris_Masters-QF-Richard_Gasquet-Rafael_Nadal,1,B-XC,19,3,0,1,2,7,12,,,,,,,,,,
20131028-M-Paris_Masters-QF-Richard_Gasquet-Rafael_Nadal,1,B-DTM,25,2,1,0,1,7,18,,,,,,,,,,
20131028-M-Paris_Masters-QF-Richard_Gasquet-Rafael_Nadal,1,B-DTL,2,2,1,0,1,1,1,,,,,,,,,,
20131028-M-Paris_Masters-QF-Richard_Gasquet-Rafael_Nadal,1,B-IO,4,1,0,1,0,3,1,,,,,,,,,,
20131028-M-Paris_Masters-QF-Richard_Gasquet-Rafael_Nadal,1,S-XC,3,0,0,0,0,2,1,,,,,,,,,,
20131028-M-Paris_Masters-QF-Richard_Gasquet-Rafael_Nadal,1,S-DTM,3,0,0,0,0,1,2,,,,,,,,,,
20131028-M-Paris_Masters-QF-Richard_Gasquet-Rafael_Nadal,1,S-IO,1,0,0,0,0,0,1,,,,,,,,,,
20131028-M-Paris_Masters-QF-Richard_Gasquet-Rafael_Nadal,2,F-XC,27,5,0,4,1,17,10,,,,,,,,,,
20131028-M-Paris_Masters-QF-Richard_Gasquet-Rafael_Nadal,2,F-DTM,18,0,0,0,0,13,5,,,,,,,,,,
20131028-M-Paris_Masters-QF-Richard_Gasquet-Rafael_Nadal,2,F-DTL,5,4,3,0,1,4,1,,,,,,,,,,
20131028-M-Paris_Masters-QF-Richard_Gasquet-Rafael_Nadal,2,F-IO,17,6,4,1,1,12,5,,,,,,,,,,
20131028-M-Paris_Masters-QF-Richard_Gasquet-Rafael_Nadal,2,F-II,3,1,0,1,0,2,1,,,,,,,,,,
20131028-M-Paris_Masters-QF-Richard_Gasquet-Rafael_Nadal,2,B-XC,15,6,3,1,2,11,4,,,,,,,,,,
20131028-M-Paris_Masters-QF-Richard_Gasquet-Rafael_Nadal,2,B-DTM,9,1,0,1,0,6,3,,,,,,,,,,
20131028-M-Paris_Masters-QF-Richard_Gasquet-Rafael_Nadal,2,B-DTL,6,1,0,0,1,2,4,,,,,,,,,,
20131028-M-Paris_Masters-QF-Richard_Gasquet-Rafael_Nadal,2,B-IO,2,1,0,1,0,2,0,,,,,,,,,,
20131028-M-Paris_Masters-QF-Richard_Gasquet-Rafael_Nadal,2,S-DTL,1,0,0,0,0,0,1,,,,,,,,,,
20131101-M-Paris_Masters-QF-Roger_Federer-Juan_Martin_Del_Potro,1,F-XC,33,9,4,2,3,21,12,,,,,,,,,,
20131101-M-Paris_Masters-QF-Roger_Federer-Juan_Martin_Del_Potro,1,F-DTM,26,0,0,0,0,14,12,,,,,,,,,,
20131101-M-Paris_Masters-QF-Roger_Federer-Juan_Martin_Del_Potro,1,F-DTL,12,5,3,1,1,10,2,,,,,,,,,,
20131101-M-Paris_Masters-QF-Roger_Federer-Juan_Martin_Del_Potro,1,F-IO,18,6,3,1,2,14,4,,,,,,,,,,
20131101-M-Paris_Masters-QF-Roger_Federer-Juan_Martin_Del_Potro,1,F-II,5,3,0,3,0,4,1,,,,,,,,,,
20131101-M-Paris_Masters-QF-Roger_Federer-Juan_Martin_Del_Potro,1,B-XC,38,4,0,1,3,20,18,,,,,,,,,,
20131101-M-Paris_Masters-QF-Roger_Federer-Juan_Martin_Del_Potro,1,B-DTM,25,3,0,1,2,14,11,,,,,,,,,,
20131101-M-Paris_Masters-QF-Roger_Federer-Juan_Martin_Del_Potro,1,B-DTL,17,6,3,1,2,11,6,,,,,,,,,,
20131101-M-Paris_Masters-QF-Roger_Federer-Juan_Martin_Del_Potro,1,B-IO,3,1,0,1,0,2,1,,,,,,,,,,
20131101-M-Paris_Masters-QF-Roger_Federer-Juan_Martin_Del_Potro,1,B-II,1,0,0,0,0,1,0,,,,,,,,,,
20131101-M-Paris_Masters-QF-Roger_Federer-Juan_Martin_Del_Potro,1,S-XC,12,0,0,0,0,6,6,,,,,,,,,,
20131101-M-Paris_Masters-QF-Roger_Federer-Juan_Martin_Del_Potro,1,S-DTM,6,0,0,0,0,5,1,,,,,,,,,,
20131101-M-Paris_Masters-QF-Roger_Federer-Juan_Martin_Del_Potro,1,S-DTL,6,0,0,0,0,4,2,,,,,,,,,,
20131101-M-Paris_Masters-QF-Roger_Federer-Juan_Martin_Del_Potro,2,F-XC,38,16,2,6,8,15,23,,,,,,,,,,
20131101-M-Paris_Masters-QF-Roger_Federer-Juan_Martin_Del_Potro,2,F-DTM,24,2,0,2,0,13,11,,,,,,,,,,
20131101-M-Paris_Masters-QF-Roger_Federer-Juan_Martin_Del_Potro,2,F-DTL,19,5,0,1,4,8,11,,,,,,,,,,
20131101-M-Paris_Masters-QF-Roger_Federer-Juan_Martin_Del_Potro,2,F-IO,35,8,1,1,6,11,24,,,,,,,,,,
20131101-M-Paris_Masters-QF-Roger_Federer-Juan_Martin_Del_Potro,2,F-II,5,5,3,1,1,4,1,,,,,,,,,,
20131101-M-Paris_Masters-QF-Roger_Federer-Juan_Martin_Del_Potro,2,B-XC,44,4,0,2,2,21,23,,,,,,,,,,
20131101-M-Paris_Masters-QF-Roger_Federer-Juan_Martin_Del_Potro,2,B-DTM,18,2,0,0,2,6,12,,,,,,,,,,
20131101-M-Paris_Masters-QF-Roger_Federer-Juan_Martin_Del_Potro,2,B-DTL,8,2,0,0,2,2,6,,,,,,,,,,
20131101-M-Paris_Masters-QF-Roger_Federer-Juan_Martin_Del_Potro,2,B-IO,4,1,1,0,0,2,2,,,,,,,,,,
20131101-M-Paris_Masters-QF-Roger_Federer-Juan_Martin_Del_Potro,2,S-XC,12,1,0,0,1,3,9,,,,,,,,,,
20131101-M-Paris_Masters-QF-Roger_Federer-Juan_Martin_Del_Potro,2,S-DTM,5,0,0,0,0,1,4,,,,,,,,,,
20131102-M-Paris_Masters-SF-David_Ferrer-Rafael_Nadal,1,F-XC,70,5,0,2,3,37,33,,,,,,,,,,
20131102-M-Paris_Masters-SF-David_Ferrer-Rafael_Nadal,1,F-DTM,25,2,2,0,0,14,11,,,,,,,,,,
20131102-M-Paris_Masters-SF-David_Ferrer-Rafael_Nadal,1,F-DTL,7,2,2,0,0,5,2,,,,,,,,,,
20131102-M-Paris_Masters-SF-David_Ferrer-Rafael_Nadal,1,F-IO,30,15,11,1,3,23,7,,,,,,,,,,
20131102-M-Paris_Masters-SF-David_Ferrer-Rafael_Nadal,1,F-II,10,3,1,2,0,9,1,,,,,,,,,,
20131102-M-Paris_Masters-SF-David_Ferrer-Rafael_Nadal,1,B-XC,20,3,0,1,2,11,9,,,,,,,,,,
20131102-M-Paris_Masters-SF-David_Ferrer-Rafael_Nadal,1,B-DTM,18,1,0,0,1,9,9,,,,,,,,,,
20131102-M-Paris_Masters-SF-David_Ferrer-Rafael_Nadal,1,B-DTL,26,5,1,0,4,14,12,,,,,,,,,,
20131102-M-Paris_Masters-SF-David_Ferrer-Rafael_Nadal,1,B-IO,3,0,0,0,0,2,1,,,,,,,,,,
20131102-M-Paris_Masters-SF-David_Ferrer-Rafael_Nadal,1,S-DTL,2,0,0,0,0,1,1,,,,,,,,,,
20131102-M-Paris_Masters-SF-David_Ferrer-Rafael_Nadal,2,F-XC,48,9,2,1,6,21,27,,,,,,,,,,
20131102-M-Paris_Masters-SF-David_Ferrer-Rafael_Nadal,2,F-DTM,15,3,0,0,3,1,14,,,,,,,,,,
20131102-M-Paris_Masters-SF-David_Ferrer-Rafael_Nadal,2,F-DTL,9,3,1,1,1,4,5,,,,,,,,,,
20131102-M-Paris_Masters-SF-David_Ferrer-Rafael_Nadal,2,F-IO,28,12,5,4,3,17,11,,,,,,,,,,
20131102-M-Paris_Masters-SF-David_Ferrer-Rafael_Nadal,2,F-II,5,4,1,0,3,1,4,,,,,,,,,,
20131102-M-Paris_Masters-SF-David_Ferrer-Rafael_Nadal,2,B-XC,28,6,0,2,4,17,11,,,,,,,,,,
20131102-M-Paris_Masters-SF-David_Ferrer-Rafael_Nadal,2,B-DTM,25,1,0,0,1,12,13,,,,,,,,,,
20131102-M-Paris_Masters-SF-David_Ferrer-Rafael_Nadal,2,B-DTL,19,6,3,0,3,9,10,,,,,,,,,,
20131102-M-Paris_Masters-SF-David_Ferrer-Rafael_Nadal,2,B-IO,5,2,1,1,0,3,2,,,,,,,,,,
20131102-M-Paris_Masters-SF-David_Ferrer-Rafael_Nadal,2,S-XC,9,0,0,0,0,3,6,,,,,,,,,,
20131102-M-Paris_Masters-SF-David_Ferrer-Rafael_Nadal,2,S-DTM,6,0,0,0,0,2,4,,,,,,,,,,
20131102-M-Paris_Masters-SF-David_Ferrer-Rafael_Nadal,2,S-DTL,11,0,0,0,0,0,11,,,,,,,,,,
20131102-M-Paris_Masters-SF-David_Ferrer-Rafael_Nadal,2,S-IO,1,1,0,0,1,0,1,,,,,,,,,,
20131103-M-Paris_Masters-F-Novak_Djokovic-David_Ferrer,1,F-XC,55,14,5,4,5,35,20,,,,,,,,,,
20131103-M-Paris_Masters-F-Novak_Djokovic-David_Ferrer,1,F-DTM,33,1,0,0,1,17,16,,,,,,,,,,
20131103-M-Paris_Masters-F-Novak_Djokovic-David_Ferrer,1,F-DTL,20,6,2,2,2,14,6,,,,,,,,,,
20131103-M-Paris_Masters-F-Novak_Djokovic-David_Ferrer,1,F-IO,32,7,4,2,1,24,8,,,,,,,,,,
20131103-M-Paris_Masters-F-Novak_Djokovic-David_Ferrer,1,F-II,3,1,0,1,0,3,0,,,,,,,,,,
20131103-M-Paris_Masters-F-Novak_Djokovic-David_Ferrer,1,B-XC,78,11,3,3,5,45,33,,,,,,,,,,
20131103-M-Paris_Masters-F-Novak_Djokovic-David_Ferrer,1,B-DTM,58,4,0,1,3,31,27,,,,,,,,,,
20131103-M-Paris_Masters-F-Novak_Djokovic-David_Ferrer,1,B-DTL,31,5,2,0,3,16,15,,,,,,,,,,
20131103-M-Paris_Masters-F-Novak_Djokovic-David_Ferrer,1,B-IO,8,2,1,0,1,5,3,,,,,,,,,,
20131103-M-Paris_Masters-F-Novak_Djokovic-David_Ferrer,1,B-II,1,0,0,0,0,0,1,,,,,,,,,,
20131103-M-Paris_Masters-F-Novak_Djokovic-David_Ferrer,1,S-XC,7,1,0,0,1,3,4,,,,,,,,,,
20131103-M-Paris_Masters-F-Novak_Djokovic-David_Ferrer,1,S-DTM,11,0,0,0,0,5,6,,,,,,,,,,
20131103-M-Paris_Masters-F-Novak_Djokovic-David_Ferrer,1,S-IO,2,0,0,0,0,1,1,,,,,,,,,,
20131103-M-Paris_Masters-F-Novak_Djokovic-David_Ferrer,2,F-XC,66,10,2,3,5,31,35,,,,,,,,,,
20131103-M-Paris_Masters-F-Novak_Djokovic-David_Ferrer,2,F-DTM,41,2,0,0,2,13,28,,,,,,,,,,
20131103-M-Paris_Masters-F-Novak_Djokovic-David_Ferrer,2,F-DTL,20,5,1,1,3,7,13,,,,,,,,,,
20131103-M-Paris_Masters-F-Novak_Djokovic-David_Ferrer,2,F-IO,48,3,1,0,2,30,18,,,,,,,,,,
20131103-M-Paris_Masters-F-Novak_Djokovic-David_Ferrer,2,F-II,6,1,0,1,0,2,4,,,,,,,,,,
20131103-M-Paris_Masters-F-Novak_Djokovic-David_Ferrer,2,B-XC,69,2,0,1,1,28,41,,,,,,,,,,
20131103-M-Paris_Masters-F-Novak_Djokovic-David_Ferrer,2,B-DTM,67,5,0,0,5,19,48,,,,,,,,,,
20131103-M-Paris_Masters-F-Novak_Djokovic-David_Ferrer,2,B-DTL,15,9,3,1,5,7,8,,,,,,,,,,
20131103-M-Paris_Masters-F-Novak_Djokovic-David_Ferrer,2,B-IO,2,1,0,0,1,1,1,,,,,,,,,,
20131103-M-Paris_Masters-F-Novak_Djokovic-David_Ferrer,2,S-XC,4,0,0,0,0,0,4,,,,,,,,,,
20131103-M-Paris_Masters-F-Novak_Djokovic-David_Ferrer,2,S-DTM,2,0,0,0,0,1,1,,,,,,,,,,
20131103-M-Paris_Masters-F-Novak_Djokovic-David_Ferrer,2,S-DTL,1,0,0,0,0,0,1,,,,,,,,,,
20131230-M-Brisbane-R32-Grigor_Dimitrov-Robin_Haase,1,F-XC,18,5,3,1,1,15,3,,,,,,,,,,
20131230-M-Brisbane-R32-Grigor_Dimitrov-Robin_Haase,1,F-DTM,12,0,0,0,0,7,5,,,,,,,,,,
20131230-M-Brisbane-R32-Grigor_Dimitrov-Robin_Haase,1,F-DTL,4,3,1,1,1,3,1,,,,,,,,,,
20131230-M-Brisbane-R32-Grigor_Dimitrov-Robin_Haase,1,F-IO,17,3,2,1,0,16,1,,,,,,,,,,
20131230-M-Brisbane-R32-Grigor_Dimitrov-Robin_Haase,1,F-II,1,1,1,0,0,1,0,,,,,,,,,,
20131230-M-Brisbane-R32-Grigor_Dimitrov-Robin_Haase,1,B-XC,7,2,1,0,1,5,2,,,,,,,,,,
20131230-M-Brisbane-R32-Grigor_Dimitrov-Robin_Haase,1,B-DTM,5,1,0,0,1,2,3,,,,,,,,,,
20131230-M-Brisbane-R32-Grigor_Dimitrov-Robin_Haase,1,B-DTL,2,2,1,1,0,2,0,,,,,,,,,,
20131230-M-Brisbane-R32-Grigor_Dimitrov-Robin_Haase,1,S-XC,9,0,0,0,0,9,0,,,,,,,,,,
20131230-M-Brisbane-R32-Grigor_Dimitrov-Robin_Haase,1,S-DTM,7,0,0,0,0,3,4,,,,,,,,,,
20131230-M-Brisbane-R32-Grigor_Dimitrov-Robin_Haase,1,S-DTL,1,0,0,0,0,0,1,,,,,,,,,,
20131230-M-Brisbane-R32-Grigor_Dimitrov-Robin_Haase,2,F-XC,16,8,4,2,2,7,9,,,,,,,,,,
20131230-M-Brisbane-R32-Grigor_Dimitrov-Robin_Haase,2,F-DTM,8,1,0,0,1,4,4,,,,,,,,,,
20131230-M-Brisbane-R32-Grigor_Dimitrov-Robin_Haase,2,F-DTL,8,3,1,0,2,3,5,,,,,,,,,,
20131230-M-Brisbane-R32-Grigor_Dimitrov-Robin_Haase,2,F-IO,30,12,5,2,5,13,17,,,,,,,,,,
20131230-M-Brisbane-R32-Grigor_Dimitrov-Robin_Haase,2,F-II,2,0,0,0,0,0,2,,,,,,,,,,
20131230-M-Brisbane-R32-Grigor_Dimitrov-Robin_Haase,2,B-XC,10,3,0,0,3,1,9,,,,,,,,,,
20131230-M-Brisbane-R32-Grigor_Dimitrov-Robin_Haase,2,B-DTM,12,0,0,0,0,1,11,,,,,,,,,,
20131230-M-Brisbane-R32-Grigor_Dimitrov-Robin_Haase,2,B-DTL,3,3,1,0,2,1,2,,,,,,,,,,
20131230-M-Brisbane-R32-Grigor_Dimitrov-Robin_Haase,2,B-IO,1,0,0,0,0,1,0,,,,,,,,,,
20131230-M-Brisbane-R32-Grigor_Dimitrov-Robin_Haase,2,S-XC,2,0,0,0,0,0,2,,,,,,,,,,
20131230-M-Brisbane-R32-Grigor_Dimitrov-Robin_Haase,2,S-DTM,2,0,0,0,0,0,2,,,,,,,,,,
20131230-M-Brisbane-R32-Grigor_Dimitrov-Robin_Haase,2,S-DTL,1,0,0,0,0,0,1,,,,,,,,,,
20131231-M-Doha-R32-Rafael_Nadal-Lukas_Rosol,1,F-XC,21,11,4,3,4,8,13,,,,,,,,,,
20131231-M-Doha-R32-Rafael_Nadal-Lukas_Rosol,1,F-DTM,26,2,0,0,2,15,11,,,,,,,,,,
20131231-M-Doha-R32-Rafael_Nadal-Lukas_Rosol,1,F-DTL,4,0,0,0,0,2,2,,,,,,,,,,
20131231-M-Doha-R32-Rafael_Nadal-Lukas_Rosol,1,F-IO,52,6,2,1,3,37,15,,,,,,,,,,
20131231-M-Doha-R32-Rafael_Nadal-Lukas_Rosol,1,F-II,5,5,1,1,3,2,3,,,,,,,,,,
20131231-M-Doha-R32-Rafael_Nadal-Lukas_Rosol,1,B-XC,2,1,0,0,1,0,2,,,,,,,,,,
20131231-M-Doha-R32-Rafael_Nadal-Lukas_Rosol,1,B-DTM,17,1,0,0,1,11,6,,,,,,,,,,
20131231-M-Doha-R32-Rafael_Nadal-Lukas_Rosol,1,B-DTL,1,0,0,0,0,1,0,,,,,,,,,,
20131231-M-Doha-R32-Rafael_Nadal-Lukas_Rosol,1,B-IO,23,6,0,3,3,12,11,,,,,,,,,,
20131231-M-Doha-R32-Rafael_Nadal-Lukas_Rosol,1,B-II,11,2,2,0,0,6,5,,,,,,,,,,
20131231-M-Doha-R32-Rafael_Nadal-Lukas_Rosol,1,S-XC,3,0,0,0,0,2,1,,,,,,,,,,
20131231-M-Doha-R32-Rafael_Nadal-Lukas_Rosol,1,S-DTM,17,1,0,1,0,9,8,,,,,,,,,,
20131231-M-Doha-R32-Rafael_Nadal-Lukas_Rosol,1,S-IO,3,0,0,0,0,3,0,,,,,,,,,,
20131231-M-Doha-R32-Rafael_Nadal-Lukas_Rosol,1,S-II,4,1,0,0,1,2,2,,,,,,,,,,
20131231-M-Doha-R32-Rafael_Nadal-Lukas_Rosol,2,F-XC,51,13,5,2,6,25,26,,,,,,,,,,
20131231-M-Doha-R32-Rafael_Nadal-Lukas_Rosol,2,F-DTM,30,7,1,0,6,11,19,,,,,,,,,,
20131231-M-Doha-R32-Rafael_Nadal-Lukas_Rosol,2,F-DTL,13,8,4,1,3,7,6,,,,,,,,,,
20131231-M-Doha-R32-Rafael_Nadal-Lukas_Rosol,2,F-IO,34,19,9,3,7,18,16,,,,,,,,,,
20131231-M-Doha-R32-Rafael_Nadal-Lukas_Rosol,2,F-II,10,5,1,0,4,3,7,,,,,,,,,,
20131231-M-Doha-R32-Rafael_Nadal-Lukas_Rosol,2,B-XC,27,13,2,2,9,11,16,,,,,,,,,,
20131231-M-Doha-R32-Rafael_Nadal-Lukas_Rosol,2,B-DTM,23,2,0,1,1,10,13,,,,,,,,,,
20131231-M-Doha-R32-Rafael_Nadal-Lukas_Rosol,2,B-DTL,7,1,0,0,1,2,5,,,,,,,,,,
20131231-M-Doha-R32-Rafael_Nadal-Lukas_Rosol,2,B-IO,1,0,0,0,0,0,1,,,,,,,,,,
20131231-M-Doha-R32-Rafael_Nadal-Lukas_Rosol,2,B-II,1,0,0,0,0,0,1,,,,,,,,,,
20131231-M-Doha-R32-Rafael_Nadal-Lukas_Rosol,2,S-DTM,2,1,0,0,1,0,2,,,,,,,,,,
20131231-M-Doha-R32-Rafael_Nadal-Lukas_Rosol,2,S-DTL,2,0,0,0,0,0,2,,,,,,,,,,
20140101-M-Brisbane-R16-Marin_Cilic-Grigor_Dimitrov,1,F-XC,21,8,3,0,5,10,11,,,,,,,,,,
20140101-M-Brisbane-R16-Marin_Cilic-Grigor_Dimitrov,1,F-DTM,17,0,0,0,0,6,11,,,,,,,,,,
20140101-M-Brisbane-R16-Marin_Cilic-Grigor_Dimitrov,1,F-DTL,8,2,0,1,1,4,4,,,,,,,,,,
20140101-M-Brisbane-R16-Marin_Cilic-Grigor_Dimitrov,1,F-IO,38,13,3,5,5,21,17,,,,,,,,,,
20140101-M-Brisbane-R16-Marin_Cilic-Grigor_Dimitrov,1,F-II,1,1,0,1,0,1,0,,,,,,,,,,
20140101-M-Brisbane-R16-Marin_Cilic-Grigor_Dimitrov,1,B-XC,27,2,0,0,2,8,19,,,,,,,,,,
20140101-M-Brisbane-R16-Marin_Cilic-Grigor_Dimitrov,1,B-DTM,18,6,0,0,6,6,12,,,,,,,,,,
20140101-M-Brisbane-R16-Marin_Cilic-Grigor_Dimitrov,1,B-DTL,5,5,1,0,4,1,4,,,,,,,,,,
20140101-M-Brisbane-R16-Marin_Cilic-Grigor_Dimitrov,1,B-IO,1,1,0,1,0,1,0,,,,,,,,,,
20140101-M-Brisbane-R16-Marin_Cilic-Grigor_Dimitrov,1,S-XC,6,0,0,0,0,5,1,,,,,,,,,,
20140101-M-Brisbane-R16-Marin_Cilic-Grigor_Dimitrov,1,S-DTM,2,0,0,0,0,0,2,,,,,,,,,,
20140101-M-Brisbane-R16-Marin_Cilic-Grigor_Dimitrov,2,F-XC,23,7,5,0,2,17,6,,,,,,,,,,
20140101-M-Brisbane-R16-Marin_Cilic-Grigor_Dimitrov,2,F-DTM,23,3,0,0,3,8,15,,,,,,,,,,
20140101-M-Brisbane-R16-Marin_Cilic-Grigor_Dimitrov,2,F-DTL,4,2,0,1,1,2,2,,,,,,,,,,
20140101-M-Brisbane-R16-Marin_Cilic-Grigor_Dimitrov,2,F-IO,24,4,1,1,2,15,9,,,,,,,,,,
20140101-M-Brisbane-R16-Marin_Cilic-Grigor_Dimitrov,2,F-II,3,2,2,0,0,2,1,,,,,,,,,,
20140101-M-Brisbane-R16-Marin_Cilic-Grigor_Dimitrov,2,B-XC,18,4,0,2,2,11,7,,,,,,,,,,
20140101-M-Brisbane-R16-Marin_Cilic-Grigor_Dimitrov,2,B-DTM,19,2,0,0,2,11,8,,,,,,,,,,
20140101-M-Brisbane-R16-Marin_Cilic-Grigor_Dimitrov,2,S-XC,22,6,1,0,5,12,10,,,,,,,,,,
20140101-M-Brisbane-R16-Marin_Cilic-Grigor_Dimitrov,2,S-DTM,7,2,0,0,2,2,5,,,,,,,,,,
20140101-M-Brisbane-R16-Marin_Cilic-Grigor_Dimitrov,2,S-DTL,4,0,0,0,0,2,2,,,,,,,,,,
20140101-M-Brisbane-R16-Marin_Cilic-Grigor_Dimitrov,2,S-IO,1,1,0,0,1,0,1,,,,,,,,,,
20140101-M-Doha-R16-Rafael_Nadal-Tobias_Kamke,1,F-XC,101,24,11,5,8,62,39,,,,,,,,,,
20140101-M-Doha-R16-Rafael_Nadal-Tobias_Kamke,1,F-DTM,36,4,0,1,3,16,20,,,,,,,,,,
20140101-M-Doha-R16-Rafael_Nadal-Tobias_Kamke,1,F-DTL,15,5,2,2,1,8,7,,,,,,,,,,
20140101-M-Doha-R16-Rafael_Nadal-Tobias_Kamke,1,F-IO,40,12,6,3,3,22,18,,,,,,,,,,
20140101-M-Doha-R16-Rafael_Nadal-Tobias_Kamke,1,F-II,9,2,1,0,1,7,2,,,,,,,,,,
20140101-M-Doha-R16-Rafael_Nadal-Tobias_Kamke,1,B-XC,38,5,1,0,4,24,14,,,,,,,,,,
20140101-M-Doha-R16-Rafael_Nadal-Tobias_Kamke,1,B-DTM,28,1,0,0,1,13,15,,,,,,,,,,
20140101-M-Doha-R16-Rafael_Nadal-Tobias_Kamke,1,B-DTL,15,3,0,1,2,8,7,,,,,,,,,,
20140101-M-Doha-R16-Rafael_Nadal-Tobias_Kamke,1,B-IO,2,1,0,0,1,1,1,,,,,,,,,,
20140101-M-Doha-R16-Rafael_Nadal-Tobias_Kamke,1,S-XC,5,0,0,0,0,3,2,,,,,,,,,,
20140101-M-Doha-R16-Rafael_Nadal-Tobias_Kamke,1,S-DTM,10,0,0,0,0,3,7,,,,,,,,,,
20140101-M-Doha-R16-Rafael_Nadal-Tobias_Kamke,1,S-DTL,3,0,0,0,0,1,2,,,,,,,,,,
20140101-M-Doha-R16-Rafael_Nadal-Tobias_Kamke,2,F-XC,73,12,2,4,6,35,38,,,,,,,,,,
20140101-M-Doha-R16-Rafael_Nadal-Tobias_Kamke,2,F-DTM,54,1,0,0,1,21,33,,,,,,,,,,
20140101-M-Doha-R16-Rafael_Nadal-Tobias_Kamke,2,F-DTL,13,5,2,1,2,6,7,,,,,,,,,,
20140101-M-Doha-R16-Rafael_Nadal-Tobias_Kamke,2,F-IO,31,16,4,6,6,18,13,,,,,,,,,,
20140101-M-Doha-R16-Rafael_Nadal-Tobias_Kamke,2,F-II,4,3,1,1,1,3,1,,,,,,,,,,
20140101-M-Doha-R16-Rafael_Nadal-Tobias_Kamke,2,B-XC,53,11,5,2,4,27,26,,,,,,,,,,
20140101-M-Doha-R16-Rafael_Nadal-Tobias_Kamke,2,B-DTM,36,0,0,0,0,22,14,,,,,,,,,,
20140101-M-Doha-R16-Rafael_Nadal-Tobias_Kamke,2,B-DTL,19,7,2,0,5,7,12,,,,,,,,,,
20140101-M-Doha-R16-Rafael_Nadal-Tobias_Kamke,2,B-IO,2,1,0,0,1,0,2,,,,,,,,,,
20140101-M-Doha-R16-Rafael_Nadal-Tobias_Kamke,2,S-XC,5,0,0,0,0,2,3,,,,,,,,,,
20140101-M-Doha-R16-Rafael_Nadal-Tobias_Kamke,2,S-DTM,6,1,0,0,1,1,5,,,,,,,,,,
20140101-M-Doha-R16-Rafael_Nadal-Tobias_Kamke,2,S-DTL,7,0,0,0,0,1,6,,,,,,,,,,
20140102-M-Brisbane-QF-Roger_Federer-Marinko_Matosevic,1,F-XC,16,8,5,2,1,10,6,,,,,,,,,,
20140102-M-Brisbane-QF-Roger_Federer-Marinko_Matosevic,1,F-DTM,21,5,1,1,3,13,8,,,,,,,,,,
20140102-M-Brisbane-QF-Roger_Federer-Marinko_Matosevic,1,F-DTL,2,0,0,0,0,2,0,,,,,,,,,,
20140102-M-Brisbane-QF-Roger_Federer-Marinko_Matosevic,1,F-IO,7,3,1,1,1,6,1,,,,,,,,,,
20140102-M-Brisbane-QF-Roger_Federer-Marinko_Matosevic,1,B-XC,8,1,1,0,0,8,0,,,,,,,,,,
20140102-M-Brisbane-QF-Roger_Federer-Marinko_Matosevic,1,B-DTM,13,1,0,0,1,6,7,,,,,,,,,,
20140102-M-Brisbane-QF-Roger_Federer-Marinko_Matosevic,1,B-DTL,1,1,0,1,0,1,0,,,,,,,,,,
20140102-M-Brisbane-QF-Roger_Federer-Marinko_Matosevic,1,B-IO,1,0,0,0,0,0,1,,,,,,,,,,
20140102-M-Brisbane-QF-Roger_Federer-Marinko_Matosevic,1,S-XC,6,0,0,0,0,6,0,,,,,,,,,,
20140102-M-Brisbane-QF-Roger_Federer-Marinko_Matosevic,1,S-DTM,5,0,0,0,0,3,2,,,,,,,,,,
20140102-M-Brisbane-QF-Roger_Federer-Marinko_Matosevic,2,F-XC,10,2,0,1,1,6,4,,,,,,,,,,
20140102-M-Brisbane-QF-Roger_Federer-Marinko_Matosevic,2,F-DTM,14,1,0,0,1,4,10,,,,,,,,,,
20140102-M-Brisbane-QF-Roger_Federer-Marinko_Matosevic,2,F-DTL,4,0,0,0,0,2,2,,,,,,,,,,
20140102-M-Brisbane-QF-Roger_Federer-Marinko_Matosevic,2,F-IO,7,2,1,0,1,2,5,,,,,,,,,,
20140102-M-Brisbane-QF-Roger_Federer-Marinko_Matosevic,2,B-XC,20,9,0,4,5,7,13,,,,,,,,,,
20140102-M-Brisbane-QF-Roger_Federer-Marinko_Matosevic,2,B-DTM,21,7,1,1,5,5,16,,,,,,,,,,
20140102-M-Brisbane-QF-Roger_Federer-Marinko_Matosevic,2,B-DTL,1,1,0,0,1,0,1,,,,,,,,,,
20140102-M-Brisbane-QF-Roger_Federer-Marinko_Matosevic,2,B-IO,5,2,0,1,1,1,4,,,,,,,,,,
20140102-M-Brisbane-QF-Roger_Federer-Marinko_Matosevic,2,S-XC,1,1,0,0,1,0,1,,,,,,,,,,
20140102-M-Brisbane-QF-Roger_Federer-Marinko_Matosevic,2,S-DTM,4,0,0,0,0,1,3,,,,,,,,,,
20140102-M-Brisbane-R16-Lleyton_Hewitt-Feliciano_Lopez,1,F-XC,69,9,0,1,8,29,40,,,,,,,,,,
20140102-M-Brisbane-R16-Lleyton_Hewitt-Feliciano_Lopez,1,F-DTM,18,0,0,0,0,7,11,,,,,,,,,,
20140102-M-Brisbane-R16-Lleyton_Hewitt-Feliciano_Lopez,1,F-DTL,6,3,2,1,0,5,1,,,,,,,,,,
20140102-M-Brisbane-R16-Lleyton_Hewitt-Feliciano_Lopez,1,F-IO,31,8,2,4,2,22,9,,,,,,,,,,
20140102-M-Brisbane-R16-Lleyton_Hewitt-Feliciano_Lopez,1,F-II,3,1,1,0,0,2,1,,,,,,,,,,
20140102-M-Brisbane-R16-Lleyton_Hewitt-Feliciano_Lopez,1,B-XC,22,3,1,1,1,10,12,,,,,,,,,,
20140102-M-Brisbane-R16-Lleyton_Hewitt-Feliciano_Lopez,1,B-DTM,22,1,0,0,1,13,9,,,,,,,,,,
20140102-M-Brisbane-R16-Lleyton_Hewitt-Feliciano_Lopez,1,B-DTL,18,3,0,1,2,8,10,,,,,,,,,,
20140102-M-Brisbane-R16-Lleyton_Hewitt-Feliciano_Lopez,1,B-IO,3,0,0,0,0,0,3,,,,,,,,,,
20140102-M-Brisbane-R16-Lleyton_Hewitt-Feliciano_Lopez,1,S-XC,9,0,0,0,0,2,7,,,,,,,,,,
20140102-M-Brisbane-R16-Lleyton_Hewitt-Feliciano_Lopez,1,S-DTM,5,0,0,0,0,3,2,,,,,,,,,,
20140102-M-Brisbane-R16-Lleyton_Hewitt-Feliciano_Lopez,1,S-DTL,11,1,0,1,0,4,7,,,,,,,,,,
20140102-M-Brisbane-R16-Lleyton_Hewitt-Feliciano_Lopez,1,S-IO,4,0,0,0,0,4,0,,,,,,,,,,
20140102-M-Brisbane-R16-Lleyton_Hewitt-Feliciano_Lopez,2,F-XC,52,6,1,2,3,24,28,,,,,,,,,,
20140102-M-Brisbane-R16-Lleyton_Hewitt-Feliciano_Lopez,2,F-DTM,17,2,0,0,2,6,11,,,,,,,,,,
20140102-M-Brisbane-R16-Lleyton_Hewitt-Feliciano_Lopez,2,F-DTL,11,5,2,2,1,8,3,,,,,,,,,,
20140102-M-Brisbane-R16-Lleyton_Hewitt-Feliciano_Lopez,2,F-IO,10,4,1,1,2,5,5,,,,,,,,,,
20140102-M-Brisbane-R16-Lleyton_Hewitt-Feliciano_Lopez,2,B-XC,13,4,1,0,3,7,6,,,,,,,,,,
20140102-M-Brisbane-R16-Lleyton_Hewitt-Feliciano_Lopez,2,B-DTM,9,0,0,0,0,5,4,,,,,,,,,,
20140102-M-Brisbane-R16-Lleyton_Hewitt-Feliciano_Lopez,2,B-DTL,2,2,1,0,1,1,1,,,,,,,,,,
20140102-M-Brisbane-R16-Lleyton_Hewitt-Feliciano_Lopez,2,B-IO,2,1,1,0,0,2,0,,,,,,,,,,
20140102-M-Brisbane-R16-Lleyton_Hewitt-Feliciano_Lopez,2,B-II,1,1,0,0,1,0,1,,,,,,,,,,
20140102-M-Brisbane-R16-Lleyton_Hewitt-Feliciano_Lopez,2,S-XC,30,2,0,1,1,17,13,,,,,,,,,,
20140102-M-Brisbane-R16-Lleyton_Hewitt-Feliciano_Lopez,2,S-DTM,20,2,0,0,2,9,11,,,,,,,,,,
20140102-M-Brisbane-R16-Lleyton_Hewitt-Feliciano_Lopez,2,S-DTL,27,1,0,0,1,17,10,,,,,,,,,,
20140102-M-Brisbane-R16-Lleyton_Hewitt-Feliciano_Lopez,2,S-IO,10,0,0,0,0,6,4,,,,,,,,,,
20140102-M-Doha-QF-Ernests_Gulbis-Rafael_Nadal,1,F-XC,36,7,2,1,4,20,16,,,,,,,,,,
20140102-M-Doha-QF-Ernests_Gulbis-Rafael_Nadal,1,F-DTM,29,4,0,0,4,16,13,,,,,,,,,,
20140102-M-Doha-QF-Ernests_Gulbis-Rafael_Nadal,1,F-DTL,12,5,2,1,2,9,3,,,,,,,,,,
20140102-M-Doha-QF-Ernests_Gulbis-Rafael_Nadal,1,F-IO,18,11,7,2,2,12,6,,,,,,,,,,
20140102-M-Doha-QF-Ernests_Gulbis-Rafael_Nadal,1,B-XC,35,12,6,0,6,22,13,,,,,,,,,,
20140102-M-Doha-QF-Ernests_Gulbis-Rafael_Nadal,1,B-DTM,33,5,0,2,3,15,18,,,,,,,,,,
20140102-M-Doha-QF-Ernests_Gulbis-Rafael_Nadal,1,B-DTL,18,4,0,1,3,12,6,,,,,,,,,,
20140102-M-Doha-QF-Ernests_Gulbis-Rafael_Nadal,1,B-IO,14,5,1,1,3,8,6,,,,,,,,,,
20140102-M-Doha-QF-Ernests_Gulbis-Rafael_Nadal,1,S-DTM,4,0,0,0,0,2,2,,,,,,,,,,
20140102-M-Doha-QF-Ernests_Gulbis-Rafael_Nadal,1,S-DTL,2,0,0,0,0,1,1,,,,,,,,,,
20140102-M-Doha-QF-Ernests_Gulbis-Rafael_Nadal,1,S-IO,2,0,0,0,0,2,0,,,,,,,,,,
20140102-M-Doha-QF-Ernests_Gulbis-Rafael_Nadal,2,F-XC,53,7,1,4,2,26,27,,,,,,,,,,
20140102-M-Doha-QF-Ernests_Gulbis-Rafael_Nadal,2,F-DTM,32,2,0,0,2,12,20,,,,,,,,,,
20140102-M-Doha-QF-Ernests_Gulbis-Rafael_Nadal,2,F-DTL,9,3,1,1,1,3,6,,,,,,,,,,
20140102-M-Doha-QF-Ernests_Gulbis-Rafael_Nadal,2,F-IO,32,6,2,2,2,20,12,,,,,,,,,,
20140102-M-Doha-QF-Ernests_Gulbis-Rafael_Nadal,2,F-II,6,0,0,0,0,1,5,,,,,,,,,,
20140102-M-Doha-QF-Ernests_Gulbis-Rafael_Nadal,2,B-XC,17,4,2,1,1,10,7,,,,,,,,,,
20140102-M-Doha-QF-Ernests_Gulbis-Rafael_Nadal,2,B-DTM,19,0,0,0,0,5,14,,,,,,,,,,
20140102-M-Doha-QF-Ernests_Gulbis-Rafael_Nadal,2,B-DTL,8,2,1,0,1,5,3,,,,,,,,,,
20140102-M-Doha-QF-Ernests_Gulbis-Rafael_Nadal,2,B-IO,5,0,0,0,0,1,4,,,,,,,,,,
20140102-M-Doha-QF-Ernests_Gulbis-Rafael_Nadal,2,S-XC,6,0,0,0,0,0,6,,,,,,,,,,
20140102-M-Doha-QF-Ernests_Gulbis-Rafael_Nadal,2,S-DTM,15,1,0,1,0,5,10,,,,,,,,,,
20140102-M-Doha-QF-Ernests_Gulbis-Rafael_Nadal,2,S-DTL,3,2,0,0,2,0,3,,,,,,,,,,
20140103-M-Chennai-QF-Aljaz_Bedene-Stanislas_Wawrinka,1,F-XC,19,4,2,0,2,7,12,,,,,,,,,,
20140103-M-Chennai-QF-Aljaz_Bedene-Stanislas_Wawrinka,1,F-DTM,17,4,0,0,4,5,12,,,,,,,,,,
20140103-M-Chennai-QF-Aljaz_Bedene-Stanislas_Wawrinka,1,F-DTL,6,4,2,1,1,5,1,,,,,,,,,,
20140103-M-Chennai-QF-Aljaz_Bedene-Stanislas_Wawrinka,1,F-IO,16,6,0,0,6,5,11,,,,,,,,,,
20140103-M-Chennai-QF-Aljaz_Bedene-Stanislas_Wawrinka,1,F-II,2,1,1,0,0,1,1,,,,,,,,,,
20140103-M-Chennai-QF-Aljaz_Bedene-Stanislas_Wawrinka,1,B-XC,14,0,0,0,0,5,9,,,,,,,,,,
20140103-M-Chennai-QF-Aljaz_Bedene-Stanislas_Wawrinka,1,B-DTM,16,2,0,1,1,6,10,,,,,,,,,,
20140103-M-Chennai-QF-Aljaz_Bedene-Stanislas_Wawrinka,1,B-DTL,1,0,0,0,0,1,0,,,,,,,,,,
20140103-M-Chennai-QF-Aljaz_Bedene-Stanislas_Wawrinka,1,S-XC,4,0,0,0,0,1,3,,,,,,,,,,
20140103-M-Chennai-QF-Aljaz_Bedene-Stanislas_Wawrinka,1,S-DTM,5,1,0,0,1,2,3,,,,,,,,,,
20140103-M-Chennai-QF-Aljaz_Bedene-Stanislas_Wawrinka,1,S-DTL,1,0,0,0,0,0,1,,,,,,,,,,
20140103-M-Chennai-QF-Aljaz_Bedene-Stanislas_Wawrinka,1,S-IO,1,0,0,0,0,0,1,,,,,,,,,,
20140103-M-Chennai-QF-Aljaz_Bedene-Stanislas_Wawrinka,1,S-II,1,0,0,0,0,0,1,,,,,,,,,,
20140103-M-Chennai-QF-Aljaz_Bedene-Stanislas_Wawrinka,2,F-XC,23,7,2,2,3,13,10,,,,,,,,,,
20140103-M-Chennai-QF-Aljaz_Bedene-Stanislas_Wawrinka,2,F-DTM,6,0,0,0,0,5,1,,,,,,,,,,
20140103-M-Chennai-QF-Aljaz_Bedene-Stanislas_Wawrinka,2,F-DTL,6,1,0,0,1,5,1,,,,,,,,,,
20140103-M-Chennai-QF-Aljaz_Bedene-Stanislas_Wawrinka,2,F-IO,15,3,0,2,1,9,6,,,,,,,,,,
20140103-M-Chennai-QF-Aljaz_Bedene-Stanislas_Wawrinka,2,B-XC,18,3,1,0,2,9,9,,,,,,,,,,
20140103-M-Chennai-QF-Aljaz_Bedene-Stanislas_Wawrinka,2,B-DTM,11,1,1,0,0,8,3,,,,,,,,,,
20140103-M-Chennai-QF-Aljaz_Bedene-Stanislas_Wawrinka,2,B-DTL,11,7,5,1,1,9,2,,,,,,,,,,
20140103-M-Chennai-QF-Aljaz_Bedene-Stanislas_Wawrinka,2,B-IO,5,3,1,0,2,2,3,,,,,,,,,,
20140103-M-Chennai-QF-Aljaz_Bedene-Stanislas_Wawrinka,2,B-II,1,0,0,0,0,1,0,,,,,,,,,,
20140103-M-Chennai-QF-Aljaz_Bedene-Stanislas_Wawrinka,2,S-XC,6,0,0,0,0,4,2,,,,,,,,,,
20140103-M-Chennai-QF-Aljaz_Bedene-Stanislas_Wawrinka,2,S-DTM,3,0,0,0,0,1,2,,,,,,,,,,
20140103-M-Chennai-QF-Aljaz_Bedene-Stanislas_Wawrinka,2,S-DTL,1,1,0,0,1,0,1,,,,,,,,,,
20140103-M-Doha-SF-Peter_Gojowczyk-Rafael_Nadal,1,F-XC,102,16,1,7,8,39,63,,,,,,,,,,
20140103-M-Doha-SF-Peter_Gojowczyk-Rafael_Nadal,1,F-DTM,30,2,0,0,2,10,20,,,,,,,,,,
20140103-M-Doha-SF-Peter_Gojowczyk-Rafael_Nadal,1,F-DTL,11,6,4,0,2,7,4,,,,,,,,,,
20140103-M-Doha-SF-Peter_Gojowczyk-Rafael_Nadal,1,F-IO,30,9,3,2,4,16,14,,,,,,,,,,
20140103-M-Doha-SF-Peter_Gojowczyk-Rafael_Nadal,1,F-II,3,1,0,1,0,1,2,,,,,,,,,,
20140103-M-Doha-SF-Peter_Gojowczyk-Rafael_Nadal,1,B-XC,29,8,1,1,6,13,16,,,,,,,,,,
20140103-M-Doha-SF-Peter_Gojowczyk-Rafael_Nadal,1,B-DTM,28,1,0,0,1,6,22,,,,,,,,,,
20140103-M-Doha-SF-Peter_Gojowczyk-Rafael_Nadal,1,B-DTL,28,7,2,0,5,12,16,,,,,,,,,,
20140103-M-Doha-SF-Peter_Gojowczyk-Rafael_Nadal,1,B-IO,6,0,0,0,0,6,0,,,,,,,,,,
20140103-M-Doha-SF-Peter_Gojowczyk-Rafael_Nadal,1,S-DTM,1,0,0,0,0,1,0,,,,,,,,,,
20140103-M-Doha-SF-Peter_Gojowczyk-Rafael_Nadal,1,S-DTL,1,0,0,0,0,0,1,,,,,,,,,,
20140103-M-Doha-SF-Peter_Gojowczyk-Rafael_Nadal,1,S-IO,1,0,0,0,0,0,1,,,,,,,,,,
20140103-M-Doha-SF-Peter_Gojowczyk-Rafael_Nadal,2,F-XC,47,6,1,2,3,25,22,,,,,,,,,,
20140103-M-Doha-SF-Peter_Gojowczyk-Rafael_Nadal,2,F-DTM,26,2,0,0,2,13,13,,,,,,,,,,
20140103-M-Doha-SF-Peter_Gojowczyk-Rafael_Nadal,2,F-DTL,23,10,3,1,6,11,12,,,,,,,,,,
20140103-M-Doha-SF-Peter_Gojowczyk-Rafael_Nadal,2,F-IO,22,11,7,1,3,16,6,,,,,,,,,,
20140103-M-Doha-SF-Peter_Gojowczyk-Rafael_Nadal,2,F-II,5,1,1,0,0,5,0,,,,,,,,,,
20140103-M-Doha-SF-Peter_Gojowczyk-Rafael_Nadal,2,B-XC,51,10,1,3,6,30,21,,,,,,,,,,
20140103-M-Doha-SF-Peter_Gojowczyk-Rafael_Nadal,2,B-DTM,24,1,0,0,1,19,5,,,,,,,,,,
20140103-M-Doha-SF-Peter_Gojowczyk-Rafael_Nadal,2,B-DTL,13,2,0,0,2,7,6,,,,,,,,,,
20140103-M-Doha-SF-Peter_Gojowczyk-Rafael_Nadal,2,S-XC,9,0,0,0,0,5,4,,,,,,,,,,
20140103-M-Doha-SF-Peter_Gojowczyk-Rafael_Nadal,2,S-DTM,24,1,0,0,1,12,12,,,,,,,,,,
20140103-M-Doha-SF-Peter_Gojowczyk-Rafael_Nadal,2,S-DTL,10,1,0,1,0,6,4,,,,,,,,,,
20140103-M-Doha-SF-Peter_Gojowczyk-Rafael_Nadal,2,S-IO,3,0,0,0,0,2,1,,,,,,,,,,
20140103-M-Sao_Paulo_CH-QF-Gastao_Elias-Facundo_Arguello,1,F-XC,3,1,1,0,0,3,0,,,,,,,,,,
20140103-M-Sao_Paulo_CH-QF-Gastao_Elias-Facundo_Arguello,1,F-DTM,2,0,0,0,0,2,0,,,,,,,,,,
20140103-M-Sao_Paulo_CH-QF-Gastao_Elias-Facundo_Arguello,1,F-IO,5,2,2,0,0,5,0,,,,,,,,,,
20140103-M-Sao_Paulo_CH-QF-Gastao_Elias-Facundo_Arguello,1,F-II,1,1,1,0,0,1,0,,,,,,,,,,
20140103-M-Sao_Paulo_CH-QF-Gastao_Elias-Facundo_Arguello,1,B-DTM,1,0,0,0,0,1,0,,,,,,,,,,
20140103-M-Sao_Paulo_CH-QF-Gastao_Elias-Facundo_Arguello,1,B-DTL,1,1,0,0,1,0,1,,,,,,,,,,
20140103-M-Sao_Paulo_CH-QF-Gastao_Elias-Facundo_Arguello,2,F-XC,2,0,0,0,0,0,2,,,,,,,,,,
20140103-M-Sao_Paulo_CH-QF-Gastao_Elias-Facundo_Arguello,2,F-DTM,2,1,0,0,1,0,2,,,,,,,,,,
20140103-M-Sao_Paulo_CH-QF-Gastao_Elias-Facundo_Arguello,2,F-DTL,1,0,0,0,0,0,1,,,,,,,,,,
20140103-M-Sao_Paulo_CH-QF-Gastao_Elias-Facundo_Arguello,2,F-IO,2,2,2,0,0,2,0,,,,,,,,,,
20140103-M-Sao_Paulo_CH-QF-Gastao_Elias-Facundo_Arguello,2,B-DTM,1,0,0,0,0,0,1,,,,,,,,,,
20140103-M-Sao_Paulo_CH-QF-Gastao_Elias-Facundo_Arguello,2,S-XC,2,0,0,0,0,0,2,,,,,,,,,,
20140103-M-Sao_Paulo_CH-QF-Gastao_Elias-Facundo_Arguello,2,S-DTM,1,1,0,0,1,0,1,,,,,,,,,,
20140104-M-Chennai-SF-Edouard_Roger_Vasselin-Marcel_Granollers,1,F-XC,73,11,2,3,6,38,35,,,,,,,,,,
20140104-M-Chennai-SF-Edouard_Roger_Vasselin-Marcel_Granollers,1,F-DTM,32,5,0,1,4,18,14,,,,,,,,,,
20140104-M-Chennai-SF-Edouard_Roger_Vasselin-Marcel_Granollers,1,F-DTL,16,6,3,0,3,7,9,,,,,,,,,,
20140104-M-Chennai-SF-Edouard_Roger_Vasselin-Marcel_Granollers,1,F-IO,41,13,1,4,8,17,24,,,,,,,,,,
20140104-M-Chennai-SF-Edouard_Roger_Vasselin-Marcel_Granollers,1,B-XC,30,6,1,2,3,16,14,,,,,,,,,,
20140104-M-Chennai-SF-Edouard_Roger_Vasselin-Marcel_Granollers,1,B-DTM,25,3,0,0,3,10,15,,,,,,,,,,
20140104-M-Chennai-SF-Edouard_Roger_Vasselin-Marcel_Granollers,1,B-DTL,7,4,3,0,1,4,3,,,,,,,,,,
20140104-M-Chennai-SF-Edouard_Roger_Vasselin-Marcel_Granollers,1,B-IO,10,4,3,1,0,6,4,,,,,,,,,,
20140104-M-Chennai-SF-Edouard_Roger_Vasselin-Marcel_Granollers,1,B-II,2,1,0,1,0,2,0,,,,,,,,,,
20140104-M-Chennai-SF-Edouard_Roger_Vasselin-Marcel_Granollers,1,S-XC,14,1,0,0,1,8,6,,,,,,,,,,
20140104-M-Chennai-SF-Edouard_Roger_Vasselin-Marcel_Granollers,1,S-DTM,6,0,0,0,0,4,2,,,,,,,,,,
20140104-M-Chennai-SF-Edouard_Roger_Vasselin-Marcel_Granollers,1,S-DTL,3,0,0,0,0,3,0,,,,,,,,,,
20140104-M-Chennai-SF-Edouard_Roger_Vasselin-Marcel_Granollers,1,S-IO,1,0,0,0,0,0,1,,,,,,,,,,
20140104-M-Chennai-SF-Edouard_Roger_Vasselin-Marcel_Granollers,2,F-XC,61,8,4,0,4,28,33,,,,,,,,,,
20140104-M-Chennai-SF-Edouard_Roger_Vasselin-Marcel_Granollers,2,F-DTM,39,5,0,1,4,19,20,,,,,,,,,,
20140104-M-Chennai-SF-Edouard_Roger_Vasselin-Marcel_Granollers,2,F-DTL,13,5,0,1,4,5,8,,,,,,,,,,
20140104-M-Chennai-SF-Edouard_Roger_Vasselin-Marcel_Granollers,2,F-IO,14,5,2,0,3,5,9,,,,,,,,,,
20140104-M-Chennai-SF-Edouard_Roger_Vasselin-Marcel_Granollers,2,F-II,1,1,0,0,1,0,1,,,,,,,,,,
20140104-M-Chennai-SF-Edouard_Roger_Vasselin-Marcel_Granollers,2,B-XC,27,6,2,1,3,11,16,,,,,,,,,,
20140104-M-Chennai-SF-Edouard_Roger_Vasselin-Marcel_Granollers,2,B-DTM,42,0,0,0,0,27,15,,,,,,,,,,
20140104-M-Chennai-SF-Edouard_Roger_Vasselin-Marcel_Granollers,2,B-DTL,3,0,0,0,0,1,2,,,,,,,,,,
20140104-M-Chennai-SF-Edouard_Roger_Vasselin-Marcel_Granollers,2,B-IO,2,2,1,0,1,1,1,,,,,,,,,,
20140104-M-Chennai-SF-Edouard_Roger_Vasselin-Marcel_Granollers,2,B-II,1,0,0,0,0,1,0,,,,,,,,,,
20140104-M-Chennai-SF-Edouard_Roger_Vasselin-Marcel_Granollers,2,S-XC,9,1,0,1,0,3,6,,,,,,,,,,
20140104-M-Chennai-SF-Edouard_Roger_Vasselin-Marcel_Granollers,2,S-DTM,26,1,0,0,1,12,14,,,,,,,,,,
20140104-M-Chennai-SF-Edouard_Roger_Vasselin-Marcel_Granollers,2,S-DTL,14,2,0,0,2,3,11,,,,,,,,,,
20140104-M-Chennai-SF-Edouard_Roger_Vasselin-Marcel_Granollers,2,S-IO,2,0,0,0,0,0,2,,,,,,,,,,
20140104-M-Doha-F-Rafael_Nadal-Gael_Monfils,1,F-XC,83,18,4,7,7,55,28,,,,,,,,,,
20140104-M-Doha-F-Rafael_Nadal-Gael_Monfils,1,F-DTM,25,4,0,1,3,16,9,,,,,,,,,,
20140104-M-Doha-F-Rafael_Nadal-Gael_Monfils,1,F-DTL,20,4,1,2,1,15,5,,,,,,,,,,
20140104-M-Doha-F-Rafael_Nadal-Gael_Monfils,1,F-IO,31,12,6,4,2,20,11,,,,,,,,,,
20140104-M-Doha-F-Rafael_Nadal-Gael_Monfils,1,F-II,1,1,0,1,0,1,0,,,,,,,,,,
20140104-M-Doha-F-Rafael_Nadal-Gael_Monfils,1,B-XC,44,5,1,2,2,33,11,,,,,,,,,,
20140104-M-Doha-F-Rafael_Nadal-Gael_Monfils,1,B-DTM,21,1,0,0,1,14,7,,,,,,,,,,
20140104-M-Doha-F-Rafael_Nadal-Gael_Monfils,1,B-DTL,11,5,0,3,2,7,4,,,,,,,,,,
20140104-M-Doha-F-Rafael_Nadal-Gael_Monfils,1,B-IO,4,1,0,1,0,4,0,,,,,,,,,,
20140104-M-Doha-F-Rafael_Nadal-Gael_Monfils,1,S-XC,3,0,0,0,0,1,2,,,,,,,,,,
20140104-M-Doha-F-Rafael_Nadal-Gael_Monfils,1,S-DTM,10,0,0,0,0,7,3,,,,,,,,,,
20140104-M-Doha-F-Rafael_Nadal-Gael_Monfils,1,S-DTL,1,0,0,0,0,0,1,,,,,,,,,,
20140104-M-Doha-F-Rafael_Nadal-Gael_Monfils,1,S-IO,2,1,0,1,0,2,0,,,,,,,,,,
20140104-M-Doha-F-Rafael_Nadal-Gael_Monfils,2,F-XC,75,18,5,0,13,22,53,,,,,,,,,,
20140104-M-Doha-F-Rafael_Nadal-Gael_Monfils,2,F-DTM,43,3,1,0,2,11,32,,,,,,,,,,
20140104-M-Doha-F-Rafael_Nadal-Gael_Monfils,2,F-DTL,10,2,1,1,0,6,4,,,,,,,,,,
20140104-M-Doha-F-Rafael_Nadal-Gael_Monfils,2,F-IO,27,10,3,2,5,15,12,,,,,,,,,,
20140104-M-Doha-F-Rafael_Nadal-Gael_Monfils,2,F-II,3,1,1,0,0,2,1,,,,,,,,,,
20140104-M-Doha-F-Rafael_Nadal-Gael_Monfils,2,B-XC,37,9,5,1,3,13,24,,,,,,,,,,
20140104-M-Doha-F-Rafael_Nadal-Gael_Monfils,2,B-DTM,34,6,0,0,6,11,23,,,,,,,,,,
20140104-M-Doha-F-Rafael_Nadal-Gael_Monfils,2,B-DTL,11,0,0,0,0,5,6,,,,,,,,,,
20140104-M-Doha-F-Rafael_Nadal-Gael_Monfils,2,B-IO,2,0,0,0,0,1,1,,,,,,,,,,
20140104-M-Doha-F-Rafael_Nadal-Gael_Monfils,2,S-DTM,3,0,0,0,0,0,3,,,,,,,,,,
20140104-M-Doha-F-Rafael_Nadal-Gael_Monfils,2,S-DTL,3,0,0,0,0,0,3,,,,,,,,,,
20140104-M-Doha-F-Rafael_Nadal-Gael_Monfils,2,S-IO,1,0,0,0,0,1,0,,,,,,,,,,
20140105-M-Sao_Paulo_CH-F-Alejandro_Gonzalez-Joao_Souza,1,F-XC,29,9,3,2,4,19,10,,,,,,,,,,
20140105-M-Sao_Paulo_CH-F-Alejandro_Gonzalez-Joao_Souza,1,F-DTM,25,9,0,1,8,7,18,,,,,,,,,,
20140105-M-Sao_Paulo_CH-F-Alejandro_Gonzalez-Joao_Souza,1,F-DTL,4,1,0,1,0,2,2,,,,,,,,,,
20140105-M-Sao_Paulo_CH-F-Alejandro_Gonzalez-Joao_Souza,1,F-IO,15,5,0,2,3,9,6,,,,,,,,,,
20140105-M-Sao_Paulo_CH-F-Alejandro_Gonzalez-Joao_Souza,1,F-II,3,1,1,0,0,1,2,,,,,,,,,,
20140105-M-Sao_Paulo_CH-F-Alejandro_Gonzalez-Joao_Souza,1,B-XC,19,2,0,0,2,8,11,,,,,,,,,,
20140105-M-Sao_Paulo_CH-F-Alejandro_Gonzalez-Joao_Souza,1,B-DTM,27,2,0,0,2,12,15,,,,,,,,,,
20140105-M-Sao_Paulo_CH-F-Alejandro_Gonzalez-Joao_Souza,1,B-DTL,5,2,0,0,2,1,4,,,,,,,,,,
20140105-M-Sao_Paulo_CH-F-Alejandro_Gonzalez-Joao_Souza,1,B-IO,7,2,1,0,1,2,5,,,,,,,,,,
20140105-M-Sao_Paulo_CH-F-Alejandro_Gonzalez-Joao_Souza,1,B-II,1,0,0,0,0,1,0,,,,,,,,,,
20140105-M-Sao_Paulo_CH-F-Alejandro_Gonzalez-Joao_Souza,1,S-XC,1,0,0,0,0,1,0,,,,,,,,,,
20140105-M-Sao_Paulo_CH-F-Alejandro_Gonzalez-Joao_Souza,2,F-XC,25,9,4,0,5,15,10,,,,,,,,,,
20140105-M-Sao_Paulo_CH-F-Alejandro_Gonzalez-Joao_Souza,2,F-DTM,31,2,0,0,2,14,17,,,,,,,,,,
20140105-M-Sao_Paulo_CH-F-Alejandro_Gonzalez-Joao_Souza,2,F-DTL,9,0,0,0,0,6,3,,,,,,,,,,
20140105-M-Sao_Paulo_CH-F-Alejandro_Gonzalez-Joao_Souza,2,F-IO,17,9,5,1,3,13,4,,,,,,,,,,
20140105-M-Sao_Paulo_CH-F-Alejandro_Gonzalez-Joao_Souza,2,F-II,2,1,0,1,0,1,1,,,,,,,,,,
20140105-M-Sao_Paulo_CH-F-Alejandro_Gonzalez-Joao_Souza,2,B-XC,15,3,0,0,3,6,9,,,,,,,,,,
20140105-M-Sao_Paulo_CH-F-Alejandro_Gonzalez-Joao_Souza,2,B-DTM,20,1,0,0,1,8,12,,,,,,,,,,
20140105-M-Sao_Paulo_CH-F-Alejandro_Gonzalez-Joao_Souza,2,B-DTL,7,1,1,0,0,6,1,,,,,,,,,,
20140105-M-Sao_Paulo_CH-F-Alejandro_Gonzalez-Joao_Souza,2,B-IO,3,1,0,0,1,0,3,,,,,,,,,,
20140105-M-Sao_Paulo_CH-F-Alejandro_Gonzalez-Joao_Souza,2,B-II,1,0,0,0,0,1,0,,,,,,,,,,
20140105-M-Sao_Paulo_CH-F-Alejandro_Gonzalez-Joao_Souza,2,S-XC,1,0,0,0,0,1,0,,,,,,,,,,
20140105-M-Sao_Paulo_CH-F-Alejandro_Gonzalez-Joao_Souza,2,S-DTM,2,0,0,0,0,1,1,,,,,,,,,,
20140106-M-Sydney-R32-Bernard_Tomic-Marcel_Granollers,1,F-XC,38,10,6,2,2,23,15,,,,,,,,,,
20140106-M-Sydney-R32-Bernard_Tomic-Marcel_Granollers,1,F-DTM,27,4,0,0,4,12,15,,,,,,,,,,
20140106-M-Sydney-R32-Bernard_Tomic-Marcel_Granollers,1,F-DTL,26,7,3,1,3,17,9,,,,,,,,,,
20140106-M-Sydney-R32-Bernard_Tomic-Marcel_Granollers,1,F-IO,28,7,2,4,1,19,9,,,,,,,,,,
20140106-M-Sydney-R32-Bernard_Tomic-Marcel_Granollers,1,F-II,7,4,2,1,1,5,2,,,,,,,,,,
20140106-M-Sydney-R32-Bernard_Tomic-Marcel_Granollers,1,B-XC,8,2,1,1,0,6,2,,,,,,,,,,
20140106-M-Sydney-R32-Bernard_Tomic-Marcel_Granollers,1,B-DTM,11,0,0,0,0,6,5,,,,,,,,,,
20140106-M-Sydney-R32-Bernard_Tomic-Marcel_Granollers,1,B-DTL,5,4,1,1,2,2,3,,,,,,,,,,
20140106-M-Sydney-R32-Bernard_Tomic-Marcel_Granollers,1,B-IO,1,0,0,0,0,1,0,,,,,,,,,,
20140106-M-Sydney-R32-Bernard_Tomic-Marcel_Granollers,1,S-XC,14,1,0,0,1,7,7,,,,,,,,,,
20140106-M-Sydney-R32-Bernard_Tomic-Marcel_Granollers,1,S-DTM,8,1,0,1,0,6,2,,,,,,,,,,
20140106-M-Sydney-R32-Bernard_Tomic-Marcel_Granollers,1,S-DTL,6,1,0,1,0,4,2,,,,,,,,,,
20140106-M-Sydney-R32-Bernard_Tomic-Marcel_Granollers,1,S-IO,7,2,0,2,0,6,1,,,,,,,,,,
20140106-M-Sydney-R32-Bernard_Tomic-Marcel_Granollers,2,F-XC,33,2,0,0,2,13,20,,,,,,,,,,
20140106-M-Sydney-R32-Bernard_Tomic-Marcel_Granollers,2,F-DTM,25,1,1,0,0,10,15,,,,,,,,,,
20140106-M-Sydney-R32-Bernard_Tomic-Marcel_Granollers,2,F-DTL,3,1,1,0,0,2,1,,,,,,,,,,
20140106-M-Sydney-R32-Bernard_Tomic-Marcel_Granollers,2,F-IO,7,1,0,1,0,4,3,,,,,,,,,,
20140106-M-Sydney-R32-Bernard_Tomic-Marcel_Granollers,2,B-XC,24,3,0,1,2,14,10,,,,,,,,,,
20140106-M-Sydney-R32-Bernard_Tomic-Marcel_Granollers,2,B-DTM,18,2,1,0,1,5,13,,,,,,,,,,
20140106-M-Sydney-R32-Bernard_Tomic-Marcel_Granollers,2,B-DTL,1,0,0,0,0,1,0,,,,,,,,,,
20140106-M-Sydney-R32-Bernard_Tomic-Marcel_Granollers,2,S-XC,22,0,0,0,0,5,17,,,,,,,,,,
20140106-M-Sydney-R32-Bernard_Tomic-Marcel_Granollers,2,S-DTM,14,0,0,0,0,5,9,,,,,,,,,,
20140106-M-Sydney-R32-Bernard_Tomic-Marcel_Granollers,2,S-DTL,8,0,0,0,0,2,6,,,,,,,,,,
20140106-M-Sydney-R32-Bernard_Tomic-Marcel_Granollers,2,S-IO,5,1,0,0,1,3,2,,,,,,,,,,
20140106-M-Sydney-R32-Matthew_Ebden-Julien_Benneteau,1,F-XC,23,9,1,4,4,10,13,,,,,,,,,,
20140106-M-Sydney-R32-Matthew_Ebden-Julien_Benneteau,1,F-DTM,7,1,0,0,1,4,3,,,,,,,,,,
20140106-M-Sydney-R32-Matthew_Ebden-Julien_Benneteau,1,F-DTL,5,2,2,0,0,2,3,,,,,,,,,,
20140106-M-Sydney-R32-Matthew_Ebden-Julien_Benneteau,1,F-IO,14,5,1,1,3,5,9,,,,,,,,,,
20140106-M-Sydney-R32-Matthew_Ebden-Julien_Benneteau,1,B-XC,14,5,0,1,4,4,10,,,,,,,,,,
20140106-M-Sydney-R32-Matthew_Ebden-Julien_Benneteau,1,B-DTM,7,0,0,0,0,4,3,,,,,,,,,,
20140106-M-Sydney-R32-Matthew_Ebden-Julien_Benneteau,1,B-DTL,4,2,1,0,1,2,2,,,,,,,,,,
20140106-M-Sydney-R32-Matthew_Ebden-Julien_Benneteau,1,B-IO,1,1,0,0,1,0,1,,,,,,,,,,
20140106-M-Sydney-R32-Matthew_Ebden-Julien_Benneteau,1,S-XC,3,0,0,0,0,0,3,,,,,,,,,,
20140106-M-Sydney-R32-Matthew_Ebden-Julien_Benneteau,1,S-DTM,2,1,0,0,1,0,2,,,,,,,,,,
20140106-M-Sydney-R32-Matthew_Ebden-Julien_Benneteau,1,S-IO,1,1,0,1,0,1,0,,,,,,,,,,
20140106-M-Sydney-R32-Matthew_Ebden-Julien_Benneteau,2,F-XC,19,13,6,3,4,14,5,,,,,,,,,,
20140106-M-Sydney-R32-Matthew_Ebden-Julien_Benneteau,2,F-DTM,9,1,1,0,0,6,3,,,,,,,,,,
20140106-M-Sydney-R32-Matthew_Ebden-Julien_Benneteau,2,F-DTL,2,0,0,0,0,2,0,,,,,,,,,,
20140106-M-Sydney-R32-Matthew_Ebden-Julien_Benneteau,2,F-IO,10,2,2,0,0,5,5,,,,,,,,,,
20140106-M-Sydney-R32-Matthew_Ebden-Julien_Benneteau,2,F-II,1,1,1,0,0,1,0,,,,,,,,,,
20140106-M-Sydney-R32-Matthew_Ebden-Julien_Benneteau,2,B-XC,13,3,1,1,1,10,3,,,,,,,,,,
20140106-M-Sydney-R32-Matthew_Ebden-Julien_Benneteau,2,B-DTM,12,1,1,0,0,8,4,,,,,,,,,,
20140106-M-Sydney-R32-Matthew_Ebden-Julien_Benneteau,2,B-DTL,4,2,1,0,1,1,3,,,,,,,,,,
20140106-M-Sydney-R32-Matthew_Ebden-Julien_Benneteau,2,S-XC,2,0,0,0,0,1,1,,,,,,,,,,
20140106-M-Sydney-R32-Matthew_Ebden-Julien_Benneteau,2,S-DTM,2,0,0,0,0,2,0,,,,,,,,,,
20140107-M-Auckland-R32-Jose_Rubin_Statham-Lukas_Lacko,1,F-XC,12,3,1,1,1,4,8,,,,,,,,,,
20140107-M-Auckland-R32-Jose_Rubin_Statham-Lukas_Lacko,1,F-DTM,33,5,0,0,5,12,21,,,,,,,,,,
20140107-M-Auckland-R32-Jose_Rubin_Statham-Lukas_Lacko,1,F-DTL,11,1,0,0,1,8,3,,,,,,,,,,
20140107-M-Auckland-R32-Jose_Rubin_Statham-Lukas_Lacko,1,F-IO,33,3,0,0,3,17,16,,,,,,,,,,
20140107-M-Auckland-R32-Jose_Rubin_Statham-Lukas_Lacko,1,F-II,1,1,0,0,1,0,1,,,,,,,,,,
20140107-M-Auckland-R32-Jose_Rubin_Statham-Lukas_Lacko,1,B-XC,44,7,0,0,7,16,28,,,,,,,,,,
20140107-M-Auckland-R32-Jose_Rubin_Statham-Lukas_Lacko,1,B-DTM,34,1,0,0,1,13,21,,,,,,,,,,
20140107-M-Auckland-R32-Jose_Rubin_Statham-Lukas_Lacko,1,B-DTL,6,3,2,0,1,3,3,,,,,,,,,,
20140107-M-Auckland-R32-Jose_Rubin_Statham-Lukas_Lacko,1,B-IO,7,3,2,0,1,5,2,,,,,,,,,,
20140107-M-Auckland-R32-Jose_Rubin_Statham-Lukas_Lacko,1,B-II,1,0,0,0,0,0,1,,,,,,,,,,
20140107-M-Auckland-R32-Jose_Rubin_Statham-Lukas_Lacko,1,S-XC,3,0,0,0,0,2,1,,,,,,,,,,
20140107-M-Auckland-R32-Jose_Rubin_Statham-Lukas_Lacko,1,S-DTM,5,0,0,0,0,0,5,,,,,,,,,,
20140107-M-Auckland-R32-Jose_Rubin_Statham-Lukas_Lacko,1,S-IO,1,0,0,0,0,1,0,,,,,,,,,,
20140107-M-Auckland-R32-Jose_Rubin_Statham-Lukas_Lacko,2,F-XC,47,12,5,2,5,30,17,,,,,,,,,,
20140107-M-Auckland-R32-Jose_Rubin_Statham-Lukas_Lacko,2,F-DTM,32,4,2,0,2,19,13,,,,,,,,,,
20140107-M-Auckland-R32-Jose_Rubin_Statham-Lukas_Lacko,2,F-DTL,6,3,3,0,0,6,0,,,,,,,,,,
20140107-M-Auckland-R32-Jose_Rubin_Statham-Lukas_Lacko,2,F-IO,16,7,3,1,3,8,8,,,,,,,,,,
20140107-M-Auckland-R32-Jose_Rubin_Statham-Lukas_Lacko,2,F-II,4,1,0,0,1,2,2,,,,,,,,,,
20140107-M-Auckland-R32-Jose_Rubin_Statham-Lukas_Lacko,2,B-XC,58,6,2,0,4,32,26,,,,,,,,,,
20140107-M-Auckland-R32-Jose_Rubin_Statham-Lukas_Lacko,2,B-DTM,19,3,0,1,2,6,13,,,,,,,,,,
20140107-M-Auckland-R32-Jose_Rubin_Statham-Lukas_Lacko,2,B-DTL,10,7,1,0,6,2,8,,,,,,,,,,
20140107-M-Auckland-R32-Jose_Rubin_Statham-Lukas_Lacko,2,B-IO,2,1,1,0,0,1,1,,,,,,,,,,
20140107-M-Auckland-R32-Jose_Rubin_Statham-Lukas_Lacko,2,S-XC,5,0,0,0,0,3,2,,,,,,,,,,
20140107-M-Auckland-R32-Jose_Rubin_Statham-Lukas_Lacko,2,S-DTM,2,0,0,0,0,2,0,,,,,,,,,,
20140107-M-Auckland-R32-Michal_Przysiezny-Benoit_Paire,1,F-XC,10,2,1,0,1,6,4,,,,,,,,,,
20140107-M-Auckland-R32-Michal_Przysiezny-Benoit_Paire,1,F-DTM,18,7,0,0,7,2,16,,,,,,,,,,
20140107-M-Auckland-R32-Michal_Przysiezny-Benoit_Paire,1,F-DTL,1,0,0,0,0,1,0,,,,,,,,,,
20140107-M-Auckland-R32-Michal_Przysiezny-Benoit_Paire,1,F-IO,8,2,0,0,2,4,4,,,,,,,,,,
20140107-M-Auckland-R32-Michal_Przysiezny-Benoit_Paire,1,F-II,2,2,0,0,2,0,2,,,,,,,,,,
20140107-M-Auckland-R32-Michal_Przysiezny-Benoit_Paire,1,B-XC,5,2,0,0,2,2,3,,,,,,,,,,
20140107-M-Auckland-R32-Michal_Przysiezny-Benoit_Paire,1,B-DTM,7,2,0,0,2,1,6,,,,,,,,,,
20140107-M-Auckland-R32-Michal_Przysiezny-Benoit_Paire,1,B-DTL,3,3,1,0,2,1,2,,,,,,,,,,
20140107-M-Auckland-R32-Michal_Przysiezny-Benoit_Paire,1,B-IO,2,1,0,0,1,1,1,,,,,,,,,,
20140107-M-Auckland-R32-Michal_Przysiezny-Benoit_Paire,1,S-XC,2,1,0,0,1,1,1,,,,,,,,,,
20140107-M-Auckland-R32-Michal_Przysiezny-Benoit_Paire,1,S-DTM,2,0,0,0,0,0,2,,,,,,,,,,
20140107-M-Auckland-R32-Michal_Przysiezny-Benoit_Paire,1,S-DTL,3,1,0,0,1,1,2,,,,,,,,,,
20140107-M-Auckland-R32-Michal_Przysiezny-Benoit_Paire,1,S-IO,1,0,0,0,0,0,1,,,,,,,,,,
20140107-M-Auckland-R32-Michal_Przysiezny-Benoit_Paire,2,F-XC,9,3,1,0,2,6,3,,,,,,,,,,
20140107-M-Auckland-R32-Michal_Przysiezny-Benoit_Paire,2,F-DTM,9,1,0,0,1,6,3,,,,,,,,,,
20140107-M-Auckland-R32-Michal_Przysiezny-Benoit_Paire,2,F-DTL,2,2,1,0,1,1,1,,,,,,,,,,
20140107-M-Auckland-R32-Michal_Przysiezny-Benoit_Paire,2,F-IO,6,4,3,0,1,5,1,,,,,,,,,,
20140107-M-Auckland-R32-Michal_Przysiezny-Benoit_Paire,2,B-XC,11,1,0,0,1,8,3,,,,,,,,,,
20140107-M-Auckland-R32-Michal_Przysiezny-Benoit_Paire,2,B-DTM,4,0,0,0,0,3,1,,,,,,,,,,
20140107-M-Auckland-R32-Michal_Przysiezny-Benoit_Paire,2,B-DTL,2,2,0,0,2,0,2,,,,,,,,,,
20140107-M-Auckland-R32-Michal_Przysiezny-Benoit_Paire,2,B-IO,2,1,1,0,0,2,0,,,,,,,,,,
20140107-M-Auckland-R32-Michal_Przysiezny-Benoit_Paire,2,S-XC,1,0,0,0,0,0,1,,,,,,,,,,
20140107-M-Auckland-R32-Michal_Przysiezny-Benoit_Paire,2,S-DTM,1,1,0,0,1,0,1,,,,,,,,,,
20140107-M-Auckland-R32-Michal_Przysiezny-Benoit_Paire,2,S-II,1,0,0,0,0,1,0,,,,,,,,,,
20140109-M-Auckland-QF-Roberto_Bautista_Agut-Jack_Sock,1,F-XC,34,7,2,0,5,21,13,,,,,,,,,,
20140109-M-Auckland-QF-Roberto_Bautista_Agut-Jack_Sock,1,F-DTM,12,1,0,1,0,11,1,,,,,,,,,,
20140109-M-Auckland-QF-Roberto_Bautista_Agut-Jack_Sock,1,F-DTL,16,6,3,2,1,11,5,,,,,,,,,,
20140109-M-Auckland-QF-Roberto_Bautista_Agut-Jack_Sock,1,F-IO,40,4,1,1,2,31,9,,,,,,,,,,
20140109-M-Auckland-QF-Roberto_Bautista_Agut-Jack_Sock,1,F-II,3,2,1,0,1,2,1,,,,,,,,,,
20140109-M-Auckland-QF-Roberto_Bautista_Agut-Jack_Sock,1,B-XC,11,0,0,0,0,6,5,,,,,,,,,,
20140109-M-Auckland-QF-Roberto_Bautista_Agut-Jack_Sock,1,B-DTM,14,0,0,0,0,6,8,,,,,,,,,,
20140109-M-Auckland-QF-Roberto_Bautista_Agut-Jack_Sock,1,B-DTL,4,3,1,1,1,3,1,,,,,,,,,,
20140109-M-Auckland-QF-Roberto_Bautista_Agut-Jack_Sock,1,B-II,1,0,0,0,0,1,0,,,,,,,,,,
20140109-M-Auckland-QF-Roberto_Bautista_Agut-Jack_Sock,1,S-XC,3,1,0,0,1,0,3,,,,,,,,,,
20140109-M-Auckland-QF-Roberto_Bautista_Agut-Jack_Sock,1,S-DTM,3,0,0,0,0,3,0,,,,,,,,,,
20140109-M-Auckland-QF-Roberto_Bautista_Agut-Jack_Sock,1,S-DTL,1,0,0,0,0,1,0,,,,,,,,,,
20140109-M-Auckland-QF-Roberto_Bautista_Agut-Jack_Sock,2,F-XC,19,4,1,0,3,7,12,,,,,,,,,,
20140109-M-Auckland-QF-Roberto_Bautista_Agut-Jack_Sock,2,F-DTM,14,2,0,0,2,5,9,,,,,,,,,,
20140109-M-Auckland-QF-Roberto_Bautista_Agut-Jack_Sock,2,F-DTL,10,3,1,0,2,3,7,,,,,,,,,,
20140109-M-Auckland-QF-Roberto_Bautista_Agut-Jack_Sock,2,F-IO,26,11,3,0,8,11,15,,,,,,,,,,
20140109-M-Auckland-QF-Roberto_Bautista_Agut-Jack_Sock,2,F-II,3,1,0,0,1,0,3,,,,,,,,,,
20140109-M-Auckland-QF-Roberto_Bautista_Agut-Jack_Sock,2,B-XC,9,5,1,0,3,5,4,,,,,,,,,,
20140109-M-Auckland-QF-Roberto_Bautista_Agut-Jack_Sock,2,B-DTM,23,3,0,0,3,7,16,,,,,,,,,,
20140109-M-Auckland-QF-Roberto_Bautista_Agut-Jack_Sock,2,B-DTL,9,5,2,0,3,3,6,,,,,,,,,,
20140109-M-Auckland-QF-Roberto_Bautista_Agut-Jack_Sock,2,B-IO,2,0,0,0,0,0,2,,,,,,,,,,
20140109-M-Auckland-QF-Roberto_Bautista_Agut-Jack_Sock,2,S-XC,6,0,0,0,0,1,5,,,,,,,,,,
20140109-M-Auckland-QF-Roberto_Bautista_Agut-Jack_Sock,2,S-DTM,15,3,0,0,3,1,14,,,,,,,,,,
20140109-M-Auckland-QF-Roberto_Bautista_Agut-Jack_Sock,2,S-DTL,4,0,0,0,0,1,3,,,,,,,,,,
20140109-M-Auckland-QF-Roberto_Bautista_Agut-Jack_Sock,2,S-IO,2,0,0,0,0,2,0,,,,,,,,,,
20140109-M-Sydney-QF-Marinko_Matosevic-Sergiy_Stakhovsky,1,F-XC,27,10,1,3,6,11,16,,,,,,,,,,
20140109-M-Sydney-QF-Marinko_Matosevic-Sergiy_Stakhovsky,1,F-DTM,15,1,0,0,1,5,10,,,,,,,,,,
20140109-M-Sydney-QF-Marinko_Matosevic-Sergiy_Stakhovsky,1,F-DTL,7,4,0,0,4,3,4,,,,,,,,,,
20140109-M-Sydney-QF-Marinko_Matosevic-Sergiy_Stakhovsky,1,F-IO,17,7,1,2,4,8,9,,,,,,,,,,
20140109-M-Sydney-QF-Marinko_Matosevic-Sergiy_Stakhovsky,1,F-II,3,1,0,1,0,2,1,,,,,,,,,,
20140109-M-Sydney-QF-Marinko_Matosevic-Sergiy_Stakhovsky,1,B-XC,22,4,1,0,3,10,12,,,,,,,,,,
20140109-M-Sydney-QF-Marinko_Matosevic-Sergiy_Stakhovsky,1,B-DTM,19,1,0,0,1,7,12,,,,,,,,,,
20140109-M-Sydney-QF-Marinko_Matosevic-Sergiy_Stakhovsky,1,B-DTL,8,6,2,1,3,3,5,,,,,,,,,,
20140109-M-Sydney-QF-Marinko_Matosevic-Sergiy_Stakhovsky,1,B-IO,3,0,0,0,0,2,1,,,,,,,,,,
20140109-M-Sydney-QF-Marinko_Matosevic-Sergiy_Stakhovsky,1,S-XC,4,1,0,0,1,1,3,,,,,,,,,,
20140109-M-Sydney-QF-Marinko_Matosevic-Sergiy_Stakhovsky,1,S-DTM,6,0,0,0,0,0,6,,,,,,,,,,
20140109-M-Sydney-QF-Marinko_Matosevic-Sergiy_Stakhovsky,1,S-DTL,2,0,0,0,0,0,2,,,,,,,,,,
20140109-M-Sydney-QF-Marinko_Matosevic-Sergiy_Stakhovsky,1,S-IO,2,1,0,0,1,0,2,,,,,,,,,,
20140109-M-Sydney-QF-Marinko_Matosevic-Sergiy_Stakhovsky,1,S-II,1,0,0,0,0,1,0,,,,,,,,,,
20140109-M-Sydney-QF-Marinko_Matosevic-Sergiy_Stakhovsky,2,F-XC,15,4,1,0,3,9,6,,,,,,,,,,
20140109-M-Sydney-QF-Marinko_Matosevic-Sergiy_Stakhovsky,2,F-DTM,16,3,0,0,3,10,6,,,,,,,,,,
20140109-M-Sydney-QF-Marinko_Matosevic-Sergiy_Stakhovsky,2,F-DTL,10,4,1,1,2,6,4,,,,,,,,,,
20140109-M-Sydney-QF-Marinko_Matosevic-Sergiy_Stakhovsky,2,F-IO,14,5,1,0,4,7,7,,,,,,,,,,
20140109-M-Sydney-QF-Marinko_Matosevic-Sergiy_Stakhovsky,2,F-II,3,1,0,0,1,1,2,,,,,,,,,,
20140109-M-Sydney-QF-Marinko_Matosevic-Sergiy_Stakhovsky,2,B-XC,7,3,1,0,2,4,3,,,,,,,,,,
20140109-M-Sydney-QF-Marinko_Matosevic-Sergiy_Stakhovsky,2,B-DTM,12,1,0,0,1,8,4,,,,,,,,,,
20140109-M-Sydney-QF-Marinko_Matosevic-Sergiy_Stakhovsky,2,B-DTL,8,1,0,0,1,4,4,,,,,,,,,,
20140109-M-Sydney-QF-Marinko_Matosevic-Sergiy_Stakhovsky,2,B-IO,1,0,0,0,0,0,1,,,,,,,,,,
20140109-M-Sydney-QF-Marinko_Matosevic-Sergiy_Stakhovsky,2,S-XC,8,1,0,0,1,4,4,,,,,,,,,,
20140109-M-Sydney-QF-Marinko_Matosevic-Sergiy_Stakhovsky,2,S-DTM,12,4,0,0,4,7,5,,,,,,,,,,
20140109-M-Sydney-QF-Marinko_Matosevic-Sergiy_Stakhovsky,2,S-DTL,5,0,0,0,0,2,3,,,,,,,,,,
20140109-M-Sydney-QF-Marinko_Matosevic-Sergiy_Stakhovsky,2,S-IO,1,0,0,0,0,0,1,,,,,,,,,,
20140111-M-Sydney-F-Bernard_Tomic-Juan_Martin_Del_Potro,1,F-XC,26,4,0,1,3,11,15,,,,,,,,,,
20140111-M-Sydney-F-Bernard_Tomic-Juan_Martin_Del_Potro,1,F-DTM,8,2,0,1,1,5,3,,,,,,,,,,
20140111-M-Sydney-F-Bernard_Tomic-Juan_Martin_Del_Potro,1,F-DTL,8,1,1,0,0,2,6,,,,,,,,,,
20140111-M-Sydney-F-Bernard_Tomic-Juan_Martin_Del_Potro,1,F-IO,24,11,4,1,6,9,15,,,,,,,,,,
20140111-M-Sydney-F-Bernard_Tomic-Juan_Martin_Del_Potro,1,F-II,1,0,0,0,0,0,1,,,,,,,,,,
20140111-M-Sydney-F-Bernard_Tomic-Juan_Martin_Del_Potro,1,B-XC,10,0,0,0,0,6,4,,,,,,,,,,
20140111-M-Sydney-F-Bernard_Tomic-Juan_Martin_Del_Potro,1,B-DTM,14,2,0,0,2,2,12,,,,,,,,,,
20140111-M-Sydney-F-Bernard_Tomic-Juan_Martin_Del_Potro,1,B-DTL,11,7,1,1,5,3,8,,,,,,,,,,
20140111-M-Sydney-F-Bernard_Tomic-Juan_Martin_Del_Potro,1,B-IO,3,1,0,0,1,0,3,,,,,,,,,,
20140111-M-Sydney-F-Bernard_Tomic-Juan_Martin_Del_Potro,1,B-II,1,0,0,0,0,0,1,,,,,,,,,,
20140111-M-Sydney-F-Bernard_Tomic-Juan_Martin_Del_Potro,1,S-XC,13,0,0,0,0,4,9,,,,,,,,,,
20140111-M-Sydney-F-Bernard_Tomic-Juan_Martin_Del_Potro,1,S-DTM,8,0,0,0,0,4,4,,,,,,,,,,
20140111-M-Sydney-F-Bernard_Tomic-Juan_Martin_Del_Potro,1,S-DTL,2,0,0,0,0,1,1,,,,,,,,,,
20140111-M-Sydney-F-Bernard_Tomic-Juan_Martin_Del_Potro,1,S-IO,3,0,0,0,0,0,3,,,,,,,,,,
20140111-M-Sydney-F-Bernard_Tomic-Juan_Martin_Del_Potro,2,F-XC,34,10,3,5,2,25,9,,,,,,,,,,
20140111-M-Sydney-F-Bernard_Tomic-Juan_Martin_Del_Potro,2,F-DTM,11,2,0,0,2,5,6,,,,,,,,,,
20140111-M-Sydney-F-Bernard_Tomic-Juan_Martin_Del_Potro,2,F-DTL,8,5,3,2,0,8,0,,,,,,,,,,
20140111-M-Sydney-F-Bernard_Tomic-Juan_Martin_Del_Potro,2,F-IO,24,3,3,0,0,12,12,,,,,,,,,,
20140111-M-Sydney-F-Bernard_Tomic-Juan_Martin_Del_Potro,2,F-II,3,2,1,1,0,3,0,,,,,,,,,,
20140111-M-Sydney-F-Bernard_Tomic-Juan_Martin_Del_Potro,2,B-XC,8,0,0,0,0,8,0,,,,,,,,,,
20140111-M-Sydney-F-Bernard_Tomic-Juan_Martin_Del_Potro,2,B-DTM,13,1,0,0,1,7,6,,,,,,,,,,
20140111-M-Sydney-F-Bernard_Tomic-Juan_Martin_Del_Potro,2,S-XC,13,1,0,0,1,9,4,,,,,,,,,,
20140111-M-Sydney-F-Bernard_Tomic-Juan_Martin_Del_Potro,2,S-DTM,10,0,0,0,0,8,2,,,,,,,,,,
20140111-M-Sydney-F-Bernard_Tomic-Juan_Martin_Del_Potro,2,S-DTL,1,1,0,1,0,1,0,,,,,,,,,,
20140113-M-Australian_Open-R128-Bernard_Tomic-Rafael_Nadal,1,F-XC,8,4,2,1,1,5,3,,,,,,,,,,
20140113-M-Australian_Open-R128-Bernard_Tomic-Rafael_Nadal,1,F-DTM,12,0,0,0,0,1,11,,,,,,,,,,
20140113-M-Australian_Open-R128-Bernard_Tomic-Rafael_Nadal,1,F-DTL,2,1,1,0,0,1,1,,,,,,,,,,
20140113-M-Australian_Open-R128-Bernard_Tomic-Rafael_Nadal,1,F-IO,10,6,4,0,2,6,4,,,,,,,,,,
20140113-M-Australian_Open-R128-Bernard_Tomic-Rafael_Nadal,1,F-II,1,0,0,0,0,1,0,,,,,,,,,,
20140113-M-Australian_Open-R128-Bernard_Tomic-Rafael_Nadal,1,B-XC,3,0,0,0,0,0,3,,,,,,,,,,
20140113-M-Australian_Open-R128-Bernard_Tomic-Rafael_Nadal,1,B-DTM,7,0,0,0,0,1,6,,,,,,,,,,
20140113-M-Australian_Open-R128-Bernard_Tomic-Rafael_Nadal,1,B-DTL,4,1,1,0,0,4,0,,,,,,,,,,
20140113-M-Australian_Open-R128-Bernard_Tomic-Rafael_Nadal,1,B-IO,1,0,0,0,0,0,1,,,,,,,,,,
20140113-M-Australian_Open-R128-Bernard_Tomic-Rafael_Nadal,1,S-XC,1,1,0,0,1,0,1,,,,,,,,,,
20140113-M-Australian_Open-R128-Bernard_Tomic-Rafael_Nadal,1,S-DTM,4,0,0,0,0,0,4,,,,,,,,,,
20140113-M-Australian_Open-R128-Bernard_Tomic-Rafael_Nadal,1,S-DTL,1,0,0,0,0,0,1,,,,,,,,,,
20140113-M-Australian_Open-R128-Bernard_Tomic-Rafael_Nadal,2,F-XC,15,4,3,1,0,13,2,,,,,,,,,,
20140113-M-Australian_Open-R128-Bernard_Tomic-Rafael_Nadal,2,F-DTM,9,1,0,0,1,8,1,,,,,,,,,,
20140113-M-Australian_Open-R128-Bernard_Tomic-Rafael_Nadal,2,F-DTL,1,1,1,0,0,1,0,,,,,,,,,,
20140113-M-Australian_Open-R128-Bernard_Tomic-Rafael_Nadal,2,F-IO,9,2,1,1,0,7,2,,,,,,,,,,
20140113-M-Australian_Open-R128-Bernard_Tomic-Rafael_Nadal,2,F-II,1,0,0,0,0,0,1,,,,,,,,,,
20140113-M-Australian_Open-R128-Bernard_Tomic-Rafael_Nadal,2,B-XC,2,1,1,0,0,1,1,,,,,,,,,,
20140113-M-Australian_Open-R128-Bernard_Tomic-Rafael_Nadal,2,B-DTM,2,1,0,0,1,1,1,,,,,,,,,,
20140113-M-Australian_Open-R128-Bernard_Tomic-Rafael_Nadal,2,B-IO,1,0,0,0,0,1,0,,,,,,,,,,
20140113-M-Australian_Open-R128-Bernard_Tomic-Rafael_Nadal,2,S-XC,1,0,0,0,0,1,0,,,,,,,,,,
20140113-M-Australian_Open-R128-Bernard_Tomic-Rafael_Nadal,2,S-DTM,5,0,0,0,0,2,3,,,,,,,,,,
20140113-M-Australian_Open-R128-Bernard_Tomic-Rafael_Nadal,2,S-DTL,1,0,0,0,0,0,1,,,,,,,,,,
20140116-M-Australian_Open-R64-Thanasi_Kokkinakis-Rafael_Nadal,1,F-XC,28,7,1,2,4,11,17,,,,,,,,,,
20140116-M-Australian_Open-R64-Thanasi_Kokkinakis-Rafael_Nadal,1,F-DTM,26,3,0,0,3,7,19,,,,,,,,,,
20140116-M-Australian_Open-R64-Thanasi_Kokkinakis-Rafael_Nadal,1,F-DTL,13,6,4,1,1,8,5,,,,,,,,,,
20140116-M-Australian_Open-R64-Thanasi_Kokkinakis-Rafael_Nadal,1,F-IO,21,7,2,2,3,12,9,,,,,,,,,,
20140116-M-Australian_Open-R64-Thanasi_Kokkinakis-Rafael_Nadal,1,F-II,6,0,0,0,0,4,2,,,,,,,,,,
20140116-M-Australian_Open-R64-Thanasi_Kokkinakis-Rafael_Nadal,1,B-XC,18,3,1,0,2,6,12,,,,,,,,,,
20140116-M-Australian_Open-R64-Thanasi_Kokkinakis-Rafael_Nadal,1,B-DTM,17,2,0,0,2,5,12,,,,,,,,,,
20140116-M-Australian_Open-R64-Thanasi_Kokkinakis-Rafael_Nadal,1,B-DTL,6,3,0,0,3,2,4,,,,,,,,,,
20140116-M-Australian_Open-R64-Thanasi_Kokkinakis-Rafael_Nadal,1,B-IO,7,2,1,1,0,5,2,,,,,,,,,,
20140116-M-Australian_Open-R64-Thanasi_Kokkinakis-Rafael_Nadal,1,S-XC,1,0,0,0,0,0,1,,,,,,,,,,
20140116-M-Australian_Open-R64-Thanasi_Kokkinakis-Rafael_Nadal,1,S-DTM,1,0,0,0,0,0,1,,,,,,,,,,
20140116-M-Australian_Open-R64-Thanasi_Kokkinakis-Rafael_Nadal,2,F-XC,38,9,2,0,7,22,16,,,,,,,,,,
20140116-M-Australian_Open-R64-Thanasi_Kokkinakis-Rafael_Nadal,2,F-DTM,29,4,1,0,3,17,12,,,,,,,,,,
20140116-M-Australian_Open-R64-Thanasi_Kokkinakis-Rafael_Nadal,2,F-DTL,15,11,6,2,3,11,4,,,,,,,,,,
20140116-M-Australian_Open-R64-Thanasi_Kokkinakis-Rafael_Nadal,2,F-IO,19,11,9,1,1,16,3,,,,,,,,,,
20140116-M-Australian_Open-R64-Thanasi_Kokkinakis-Rafael_Nadal,2,F-II,3,0,0,0,0,3,0,,,,,,,,,,
20140116-M-Australian_Open-R64-Thanasi_Kokkinakis-Rafael_Nadal,2,B-XC,15,4,0,2,2,8,7,,,,,,,,,,
20140116-M-Australian_Open-R64-Thanasi_Kokkinakis-Rafael_Nadal,2,B-DTM,8,1,0,0,1,2,6,,,,,,,,,,
20140116-M-Australian_Open-R64-Thanasi_Kokkinakis-Rafael_Nadal,2,B-DTL,7,3,3,0,0,5,2,,,,,,,,,,
20140116-M-Australian_Open-R64-Thanasi_Kokkinakis-Rafael_Nadal,2,B-IO,2,0,0,0,0,1,1,,,,,,,,,,
20140116-M-Australian_Open-R64-Thanasi_Kokkinakis-Rafael_Nadal,2,S-XC,5,0,0,0,0,3,2,,,,,,,,,,
20140116-M-Australian_Open-R64-Thanasi_Kokkinakis-Rafael_Nadal,2,S-DTM,6,0,0,0,0,3,3,,,,,,,,,,
20140116-M-Australian_Open-R64-Thanasi_Kokkinakis-Rafael_Nadal,2,S-DTL,2,0,0,0,0,1,1,,,,,,,,,,
20140118-M-Australian_Open-R32-Gael_Monfils-Rafael_Nadal,1,F-XC,60,10,2,1,7,24,36,,,,,,,,,,
20140118-M-Australian_Open-R32-Gael_Monfils-Rafael_Nadal,1,F-DTM,50,8,0,1,7,17,33,,,,,,,,,,
20140118-M-Australian_Open-R32-Gael_Monfils-Rafael_Nadal,1,F-DTL,17,9,3,3,3,9,8,,,,,,,,,,
20140118-M-Australian_Open-R32-Gael_Monfils-Rafael_Nadal,1,F-IO,21,10,5,0,5,11,10,,,,,,,,,,
20140118-M-Australian_Open-R32-Gael_Monfils-Rafael_Nadal,1,F-II,9,2,2,0,0,5,4,,,,,,,,,,
20140118-M-Australian_Open-R32-Gael_Monfils-Rafael_Nadal,1,B-XC,50,10,2,1,7,17,33,,,,,,,,,,
20140118-M-Australian_Open-R32-Gael_Monfils-Rafael_Nadal,1,B-DTM,36,4,0,0,4,13,23,,,,,,,,,,
20140118-M-Australian_Open-R32-Gael_Monfils-Rafael_Nadal,1,B-DTL,22,8,1,2,5,9,13,,,,,,,,,,
20140118-M-Australian_Open-R32-Gael_Monfils-Rafael_Nadal,1,B-IO,9,3,3,0,0,4,5,,,,,,,,,,
20140118-M-Australian_Open-R32-Gael_Monfils-Rafael_Nadal,1,S-DTM,5,1,0,0,1,1,4,,,,,,,,,,
20140118-M-Australian_Open-R32-Gael_Monfils-Rafael_Nadal,1,S-DTL,1,0,0,0,0,0,1,,,,,,,,,,
20140118-M-Australian_Open-R32-Gael_Monfils-Rafael_Nadal,2,F-XC,72,6,1,4,1,44,28,,,,,,,,,,
20140118-M-Australian_Open-R32-Gael_Monfils-Rafael_Nadal,2,F-DTM,32,4,1,0,3,21,11,,,,,,,,,,
20140118-M-Australian_Open-R32-Gael_Monfils-Rafael_Nadal,2,F-DTL,18,6,3,0,3,11,7,,,,,,,,,,
20140118-M-Australian_Open-R32-Gael_Monfils-Rafael_Nadal,2,F-IO,45,13,3,7,3,32,13,,,,,,,,,,
20140118-M-Australian_Open-R32-Gael_Monfils-Rafael_Nadal,2,F-II,6,1,0,1,0,5,1,,,,,,,,,,
20140118-M-Australian_Open-R32-Gael_Monfils-Rafael_Nadal,2,B-XC,34,9,1,7,1,24,10,,,,,,,,,,
20140118-M-Australian_Open-R32-Gael_Monfils-Rafael_Nadal,2,B-DTM,27,4,0,0,4,11,16,,,,,,,,,,
20140118-M-Australian_Open-R32-Gael_Monfils-Rafael_Nadal,2,B-DTL,8,1,0,0,1,3,5,,,,,,,,,,
20140118-M-Australian_Open-R32-Gael_Monfils-Rafael_Nadal,2,B-IO,3,0,0,0,0,3,0,,,,,,,,,,
20140118-M-Australian_Open-R32-Gael_Monfils-Rafael_Nadal,2,B-II,1,1,1,0,0,1,0,,,,,,,,,,
20140118-M-Australian_Open-R32-Gael_Monfils-Rafael_Nadal,2,S-XC,3,1,0,0,1,0,3,,,,,,,,,,
20140118-M-Australian_Open-R32-Gael_Monfils-Rafael_Nadal,2,S-DTM,12,1,0,1,0,8,4,,,,,,,,,,
20140118-M-Australian_Open-R32-Gael_Monfils-Rafael_Nadal,2,S-DTL,7,0,0,0,0,5,2,,,,,,,,,,
20140120-M-Australian_Open-R16-Kei_Nishikori-Rafael_Nadal,1,F-XC,106,17,3,4,10,49,57,,,,,,,,,,
20140120-M-Australian_Open-R16-Kei_Nishikori-Rafael_Nadal,1,F-DTM,46,8,0,1,7,20,26,,,,,,,,,,
20140120-M-Australian_Open-R16-Kei_Nishikori-Rafael_Nadal,1,F-DTL,21,5,2,1,2,11,10,,,,,,,,,,
20140120-M-Australian_Open-R16-Kei_Nishikori-Rafael_Nadal,1,F-IO,44,15,7,2,6,23,21,,,,,,,,,,
20140120-M-Australian_Open-R16-Kei_Nishikori-Rafael_Nadal,1,F-II,4,2,0,0,2,2,2,,,,,,,,,,
20140120-M-Australian_Open-R16-Kei_Nishikori-Rafael_Nadal,1,B-XC,58,14,5,2,7,33,25,,,,,,,,,,
20140120-M-Australian_Open-R16-Kei_Nishikori-Rafael_Nadal,1,B-DTM,35,5,0,0,5,14,21,,,,,,,,,,
20140120-M-Australian_Open-R16-Kei_Nishikori-Rafael_Nadal,1,B-DTL,30,10,4,2,4,18,12,,,,,,,,,,
20140120-M-Australian_Open-R16-Kei_Nishikori-Rafael_Nadal,1,B-IO,8,3,1,1,1,4,4,,,,,,,,,,
20140120-M-Australian_Open-R16-Kei_Nishikori-Rafael_Nadal,1,S-XC,2,1,0,0,1,1,1,,,,,,,,,,
20140120-M-Australian_Open-R16-Kei_Nishikori-Rafael_Nadal,1,S-DTM,5,0,0,0,0,3,2,,,,,,,,,,
20140120-M-Australian_Open-R16-Kei_Nishikori-Rafael_Nadal,1,S-DTL,2,0,0,0,0,1,1,,,,,,,,,,
20140120-M-Australian_Open-R16-Kei_Nishikori-Rafael_Nadal,1,S-IO,2,0,0,0,0,1,1,,,,,,,,,,
20140120-M-Australian_Open-R16-Kei_Nishikori-Rafael_Nadal,2,F-XC,77,12,1,2,9,30,47,,,,,,,,,,
20140120-M-Australian_Open-R16-Kei_Nishikori-Rafael_Nadal,2,F-DTM,41,3,0,1,2,23,18,,,,,,,,,,
20140120-M-Australian_Open-R16-Kei_Nishikori-Rafael_Nadal,2,F-DTL,24,8,2,1,5,10,14,,,,,,,,,,
20140120-M-Australian_Open-R16-Kei_Nishikori-Rafael_Nadal,2,F-IO,38,16,6,7,3,28,10,,,,,,,,,,
20140120-M-Australian_Open-R16-Kei_Nishikori-Rafael_Nadal,2,F-II,4,1,0,1,0,3,1,,,,,,,,,,
20140120-M-Australian_Open-R16-Kei_Nishikori-Rafael_Nadal,2,B-XC,42,8,1,3,4,21,21,,,,,,,,,,
20140120-M-Australian_Open-R16-Kei_Nishikori-Rafael_Nadal,2,B-DTM,42,4,0,0,4,21,21,,,,,,,,,,
20140120-M-Australian_Open-R16-Kei_Nishikori-Rafael_Nadal,2,B-DTL,13,2,2,0,0,9,4,,,,,,,,,,
20140120-M-Australian_Open-R16-Kei_Nishikori-Rafael_Nadal,2,B-IO,2,0,0,0,0,2,0,,,,,,,,,,
20140120-M-Australian_Open-R16-Kei_Nishikori-Rafael_Nadal,2,S-XC,7,0,0,0,0,3,4,,,,,,,,,,
20140120-M-Australian_Open-R16-Kei_Nishikori-Rafael_Nadal,2,S-DTM,39,2,1,0,1,17,22,,,,,,,,,,
20140120-M-Australian_Open-R16-Kei_Nishikori-Rafael_Nadal,2,S-DTL,7,0,0,0,0,1,6,,,,,,,,,,
20140120-M-Australian_Open-R16-Kei_Nishikori-Rafael_Nadal,2,S-IO,2,0,0,0,0,0,2,,,,,,,,,,
20140122-M-Australian_Open-QF-Grigor_Dimitrov-Rafael_Nadal,1,F-XC,96,12,2,3,7,50,46,,,,,,,,,,
20140122-M-Australian_Open-QF-Grigor_Dimitrov-Rafael_Nadal,1,F-DTM,70,4,0,0,4,28,42,,,,,,,,,,
20140122-M-Australian_Open-QF-Grigor_Dimitrov-Rafael_Nadal,1,F-DTL,16,7,2,1,4,7,9,,,,,,,,,,
20140122-M-Australian_Open-QF-Grigor_Dimitrov-Rafael_Nadal,1,F-IO,57,28,10,6,12,31,26,,,,,,,,,,
20140122-M-Australian_Open-QF-Grigor_Dimitrov-Rafael_Nadal,1,F-II,22,4,1,1,2,12,10,,,,,,,,,,
20140122-M-Australian_Open-QF-Grigor_Dimitrov-Rafael_Nadal,1,B-XC,31,9,3,3,3,16,15,,,,,,,,,,
20140122-M-Australian_Open-QF-Grigor_Dimitrov-Rafael_Nadal,1,B-DTM,59,3,0,0,3,19,40,,,,,,,,,,
20140122-M-Australian_Open-QF-Grigor_Dimitrov-Rafael_Nadal,1,B-DTL,10,3,0,1,2,5,5,,,,,,,,,,
20140122-M-Australian_Open-QF-Grigor_Dimitrov-Rafael_Nadal,1,B-IO,4,0,0,0,0,1,3,,,,,,,,,,
20140122-M-Australian_Open-QF-Grigor_Dimitrov-Rafael_Nadal,1,S-XC,11,2,0,0,2,3,8,,,,,,,,,,
20140122-M-Australian_Open-QF-Grigor_Dimitrov-Rafael_Nadal,1,S-DTM,20,0,0,0,0,5,15,,,,,,,,,,
20140122-M-Australian_Open-QF-Grigor_Dimitrov-Rafael_Nadal,1,S-DTL,13,4,0,0,4,3,10,,,,,,,,,,
20140122-M-Australian_Open-QF-Grigor_Dimitrov-Rafael_Nadal,1,S-IO,3,0,0,0,0,2,1,,,,,,,,,,
20140122-M-Australian_Open-QF-Grigor_Dimitrov-Rafael_Nadal,1,S-II,1,0,0,0,0,0,1,,,,,,,,,,
20140122-M-Australian_Open-QF-Grigor_Dimitrov-Rafael_Nadal,2,F-XC,113,18,4,7,7,69,44,,,,,,,,,,
20140122-M-Australian_Open-QF-Grigor_Dimitrov-Rafael_Nadal,2,F-DTM,50,4,0,0,4,28,22,,,,,,,,,,
20140122-M-Australian_Open-QF-Grigor_Dimitrov-Rafael_Nadal,2,F-DTL,22,6,5,0,1,16,6,,,,,,,,,,
20140122-M-Australian_Open-QF-Grigor_Dimitrov-Rafael_Nadal,2,F-IO,73,29,8,10,11,48,25,,,,,,,,,,
20140122-M-Australian_Open-QF-Grigor_Dimitrov-Rafael_Nadal,2,F-II,13,1,0,0,1,7,6,,,,,,,,,,
20140122-M-Australian_Open-QF-Grigor_Dimitrov-Rafael_Nadal,2,B-XC,48,11,0,6,5,25,23,,,,,,,,,,
20140122-M-Australian_Open-QF-Grigor_Dimitrov-Rafael_Nadal,2,B-DTM,33,1,0,0,1,15,18,,,,,,,,,,
20140122-M-Australian_Open-QF-Grigor_Dimitrov-Rafael_Nadal,2,B-DTL,30,5,2,2,1,19,11,,,,,,,,,,
20140122-M-Australian_Open-QF-Grigor_Dimitrov-Rafael_Nadal,2,B-IO,11,2,1,0,1,8,3,,,,,,,,,,
20140122-M-Australian_Open-QF-Grigor_Dimitrov-Rafael_Nadal,2,S-XC,1,0,0,0,0,0,1,,,,,,,,,,
20140122-M-Australian_Open-QF-Grigor_Dimitrov-Rafael_Nadal,2,S-DTM,16,1,0,1,0,8,8,,,,,,,,,,
20140122-M-Australian_Open-QF-Grigor_Dimitrov-Rafael_Nadal,2,S-DTL,7,0,0,0,0,2,5,,,,,,,,,,
20140122-M-Australian_Open-QF-Grigor_Dimitrov-Rafael_Nadal,2,S-IO,2,0,0,0,0,2,0,,,,,,,,,,
20140122-M-Australian_Open-QF-Roger_Federer-Andy_Murray,1,F-XC,59,15,3,5,7,31,28,,,,,,,,,,
20140122-M-Australian_Open-QF-Roger_Federer-Andy_Murray,1,F-DTM,30,5,0,1,4,11,19,,,,,,,,,,
20140122-M-Australian_Open-QF-Roger_Federer-Andy_Murray,1,F-DTL,33,13,3,6,4,20,13,,,,,,,,,,
20140122-M-Australian_Open-QF-Roger_Federer-Andy_Murray,1,F-IO,37,8,4,2,2,21,16,,,,,,,,,,
20140122-M-Australian_Open-QF-Roger_Federer-Andy_Murray,1,F-II,18,4,1,3,0,12,6,,,,,,,,,,
20140122-M-Australian_Open-QF-Roger_Federer-Andy_Murray,1,B-XC,81,13,2,5,6,38,43,,,,,,,,,,
20140122-M-Australian_Open-QF-Roger_Federer-Andy_Murray,1,B-DTM,44,3,0,1,2,22,22,,,,,,,,,,
20140122-M-Australian_Open-QF-Roger_Federer-Andy_Murray,1,B-DTL,22,8,1,1,6,12,10,,,,,,,,,,
20140122-M-Australian_Open-QF-Roger_Federer-Andy_Murray,1,B-IO,3,0,0,0,0,1,2,,,,,,,,,,
20140122-M-Australian_Open-QF-Roger_Federer-Andy_Murray,1,S-XC,50,1,0,0,1,21,29,,,,,,,,,,
20140122-M-Australian_Open-QF-Roger_Federer-Andy_Murray,1,S-DTM,9,0,0,0,0,3,6,,,,,,,,,,
20140122-M-Australian_Open-QF-Roger_Federer-Andy_Murray,1,S-DTL,14,2,1,0,1,7,7,,,,,,,,,,
20140122-M-Australian_Open-QF-Roger_Federer-Andy_Murray,1,S-IO,1,0,0,0,0,1,0,,,,,,,,,,
20140122-M-Australian_Open-QF-Roger_Federer-Andy_Murray,2,F-XC,83,14,4,2,8,43,40,,,,,,,,,,
20140122-M-Australian_Open-QF-Roger_Federer-Andy_Murray,2,F-DTM,26,1,0,0,1,8,18,,,,,,,,,,
20140122-M-Australian_Open-QF-Roger_Federer-Andy_Murray,2,F-DTL,46,12,4,2,6,24,22,,,,,,,,,,
20140122-M-Australian_Open-QF-Roger_Federer-Andy_Murray,2,F-IO,70,19,6,6,7,38,32,,,,,,,,,,
20140122-M-Australian_Open-QF-Roger_Federer-Andy_Murray,2,F-II,8,3,0,2,1,4,4,,,,,,,,,,
20140122-M-Australian_Open-QF-Roger_Federer-Andy_Murray,2,B-XC,121,10,2,2,6,69,52,,,,,,,,,,
20140122-M-Australian_Open-QF-Roger_Federer-Andy_Murray,2,B-DTM,28,1,0,0,1,5,23,,,,,,,,,,
20140122-M-Australian_Open-QF-Roger_Federer-Andy_Murray,2,B-DTL,19,11,2,4,5,8,11,,,,,,,,,,
20140122-M-Australian_Open-QF-Roger_Federer-Andy_Murray,2,B-IO,5,1,0,0,1,1,4,,,,,,,,,,
20140122-M-Australian_Open-QF-Roger_Federer-Andy_Murray,2,S-XC,15,0,0,0,0,9,6,,,,,,,,,,
20140122-M-Australian_Open-QF-Roger_Federer-Andy_Murray,2,S-DTM,9,0,0,0,0,3,6,,,,,,,,,,
20140122-M-Australian_Open-QF-Roger_Federer-Andy_Murray,2,S-DTL,4,0,0,0,0,2,2,,,,,,,,,,
20140122-M-Australian_Open-QF-Roger_Federer-Andy_Murray,2,S-IO,1,1,0,0,1,0,1,,,,,,,,,,
20140126-M-Australian_Open-F-Stanislas_Wawrinka-Rafael_Nadal,1,F-XC,75,18,8,3,7,46,29,,,,,,,,,,
20140126-M-Australian_Open-F-Stanislas_Wawrinka-Rafael_Nadal,1,F-DTM,34,4,0,1,3,16,18,,,,,,,,,,
20140126-M-Australian_Open-F-Stanislas_Wawrinka-Rafael_Nadal,1,F-DTL,8,7,4,1,2,6,2,,,,,,,,,,
20140126-M-Australian_Open-F-Stanislas_Wawrinka-Rafael_Nadal,1,F-IO,25,9,3,1,5,12,13,,,,,,,,,,
20140126-M-Australian_Open-F-Stanislas_Wawrinka-Rafael_Nadal,1,F-II,9,5,4,1,0,8,1,,,,,,,,,,
20140126-M-Australian_Open-F-Stanislas_Wawrinka-Rafael_Nadal,1,B-XC,41,12,4,1,7,26,15,,,,,,,,,,
20140126-M-Australian_Open-F-Stanislas_Wawrinka-Rafael_Nadal,1,B-DTM,9,0,0,0,0,5,4,,,,,,,,,,
20140126-M-Australian_Open-F-Stanislas_Wawrinka-Rafael_Nadal,1,B-DTL,11,7,4,2,1,10,1,,,,,,,,,,
20140126-M-Australian_Open-F-Stanislas_Wawrinka-Rafael_Nadal,1,B-IO,5,1,0,0,1,2,3,,,,,,,,,,
20140126-M-Australian_Open-F-Stanislas_Wawrinka-Rafael_Nadal,1,S-XC,2,1,0,1,0,2,0,,,,,,,,,,
20140126-M-Australian_Open-F-Stanislas_Wawrinka-Rafael_Nadal,1,S-DTM,7,0,0,0,0,4,3,,,,,,,,,,
20140126-M-Australian_Open-F-Stanislas_Wawrinka-Rafael_Nadal,1,S-DTL,2,1,0,0,1,1,1,,,,,,,,,,
20140126-M-Australian_Open-F-Stanislas_Wawrinka-Rafael_Nadal,2,F-XC,55,10,4,3,3,23,32,,,,,,,,,,
20140126-M-Australian_Open-F-Stanislas_Wawrinka-Rafael_Nadal,2,F-DTM,32,2,0,0,2,10,22,,,,,,,,,,
20140126-M-Australian_Open-F-Stanislas_Wawrinka-Rafael_Nadal,2,F-DTL,10,5,0,3,2,5,5,,,,,,,,,,
20140126-M-Australian_Open-F-Stanislas_Wawrinka-Rafael_Nadal,2,F-IO,41,14,6,4,4,23,18,,,,,,,,,,
20140126-M-Australian_Open-F-Stanislas_Wawrinka-Rafael_Nadal,2,F-II,4,1,1,0,0,2,2,,,,,,,,,,
20140126-M-Australian_Open-F-Stanislas_Wawrinka-Rafael_Nadal,2,B-XC,31,6,2,1,3,13,18,,,,,,,,,,
20140126-M-Australian_Open-F-Stanislas_Wawrinka-Rafael_Nadal,2,B-DTM,28,2,0,0,2,16,12,,,,,,,,,,
20140126-M-Australian_Open-F-Stanislas_Wawrinka-Rafael_Nadal,2,B-DTL,14,3,0,0,3,4,10,,,,,,,,,,
20140126-M-Australian_Open-F-Stanislas_Wawrinka-Rafael_Nadal,2,B-IO,5,1,1,0,0,2,3,,,,,,,,,,
20140126-M-Australian_Open-F-Stanislas_Wawrinka-Rafael_Nadal,2,B-II,1,0,0,0,0,1,0,,,,,,,,,,
20140126-M-Australian_Open-F-Stanislas_Wawrinka-Rafael_Nadal,2,S-XC,3,1,0,0,1,0,3,,,,,,,,,,
20140126-M-Australian_Open-F-Stanislas_Wawrinka-Rafael_Nadal,2,S-DTM,11,1,0,0,1,4,7,,,,,,,,,,
20140126-M-Australian_Open-F-Stanislas_Wawrinka-Rafael_Nadal,2,S-DTL,3,0,0,0,0,0,3,,,,,,,,,,
20140201-M-Burnie_CH-F-Hiroki_Moriya-Matt_Reid,1,F-XC,32,8,1,2,5,16,16,,,,,,,,,,
20140201-M-Burnie_CH-F-Hiroki_Moriya-Matt_Reid,1,F-DTM,38,3,0,0,3,18,20,,,,,,,,,,
20140201-M-Burnie_CH-F-Hiroki_Moriya-Matt_Reid,1,F-DTL,6,3,1,1,1,5,1,,,,,,,,,,
20140201-M-Burnie_CH-F-Hiroki_Moriya-Matt_Reid,1,F-IO,16,7,1,0,6,5,11,,,,,,,,,,
20140201-M-Burnie_CH-F-Hiroki_Moriya-Matt_Reid,1,B-XC,38,8,5,0,3,23,15,,,,,,,,,,
20140201-M-Burnie_CH-F-Hiroki_Moriya-Matt_Reid,1,B-DTM,20,3,0,0,3,12,8,,,,,,,,,,
20140201-M-Burnie_CH-F-Hiroki_Moriya-Matt_Reid,1,B-DTL,3,1,0,0,1,1,2,,,,,,,,,,
20140201-M-Burnie_CH-F-Hiroki_Moriya-Matt_Reid,1,B-IO,6,3,0,0,3,1,5,,,,,,,,,,
20140201-M-Burnie_CH-F-Hiroki_Moriya-Matt_Reid,1,S-DTM,1,0,0,0,0,0,1,,,,,,,,,,
20140201-M-Burnie_CH-F-Hiroki_Moriya-Matt_Reid,1,S-IO,1,1,0,0,1,0,1,,,,,,,,,,
20140201-M-Burnie_CH-F-Hiroki_Moriya-Matt_Reid,2,F-XC,28,10,4,1,5,14,14,,,,,,,,,,
20140201-M-Burnie_CH-F-Hiroki_Moriya-Matt_Reid,2,F-DTM,38,4,0,0,4,20,18,,,,,,,,,,
20140201-M-Burnie_CH-F-Hiroki_Moriya-Matt_Reid,2,F-DTL,8,3,3,0,0,4,4,,,,,,,,,,
20140201-M-Burnie_CH-F-Hiroki_Moriya-Matt_Reid,2,F-IO,20,7,0,4,3,13,7,,,,,,,,,,
20140201-M-Burnie_CH-F-Hiroki_Moriya-Matt_Reid,2,F-II,2,1,1,0,0,2,0,,,,,,,,,,
20140201-M-Burnie_CH-F-Hiroki_Moriya-Matt_Reid,2,B-XC,9,1,0,0,1,3,6,,,,,,,,,,
20140201-M-Burnie_CH-F-Hiroki_Moriya-Matt_Reid,2,B-DTM,25,2,0,0,2,8,17,,,,,,,,,,
20140201-M-Burnie_CH-F-Hiroki_Moriya-Matt_Reid,2,B-DTL,7,1,0,0,1,4,3,,,,,,,,,,
20140201-M-Burnie_CH-F-Hiroki_Moriya-Matt_Reid,2,B-IO,3,1,0,0,1,2,1,,,,,,,,,,
20140201-M-Burnie_CH-F-Hiroki_Moriya-Matt_Reid,2,S-XC,2,0,0,0,0,1,1,,,,,,,,,,
20140201-M-Burnie_CH-F-Hiroki_Moriya-Matt_Reid,2,S-DTM,7,2,0,0,2,1,6,,,,,,,,,,
20140201-M-Burnie_CH-F-Hiroki_Moriya-Matt_Reid,2,S-DTL,1,0,0,0,0,0,1,,,,,,,,,,
20140201-M-Burnie_CH-F-Hiroki_Moriya-Matt_Reid,2,S-IO,3,0,0,0,0,2,1,,,,,,,,,,
20140210-M-Memphis-R32-Nick_Kyrgios-Tim_Smyczek,1,F-XC,75,20,5,4,11,32,43,,,,,,,,,,
20140210-M-Memphis-R32-Nick_Kyrgios-Tim_Smyczek,1,F-DTM,45,7,0,0,7,22,23,,,,,,,,,,
20140210-M-Memphis-R32-Nick_Kyrgios-Tim_Smyczek,1,F-DTL,20,7,3,1,3,9,11,,,,,,,,,,
20140210-M-Memphis-R32-Nick_Kyrgios-Tim_Smyczek,1,F-IO,44,15,4,2,9,17,27,,,,,,,,,,
20140210-M-Memphis-R32-Nick_Kyrgios-Tim_Smyczek,1,F-II,6,5,0,1,4,2,4,,,,,,,,,,
20140210-M-Memphis-R32-Nick_Kyrgios-Tim_Smyczek,1,B-XC,47,10,0,1,9,18,29,,,,,,,,,,
20140210-M-Memphis-R32-Nick_Kyrgios-Tim_Smyczek,1,B-DTM,39,6,0,1,5,20,19,,,,,,,,,,
20140210-M-Memphis-R32-Nick_Kyrgios-Tim_Smyczek,1,B-DTL,9,4,1,1,2,4,5,,,,,,,,,,
20140210-M-Memphis-R32-Nick_Kyrgios-Tim_Smyczek,1,B-IO,13,1,0,0,1,4,9,,,,,,,,,,
20140210-M-Memphis-R32-Nick_Kyrgios-Tim_Smyczek,1,B-II,1,0,0,0,0,1,0,,,,,,,,,,
20140210-M-Memphis-R32-Nick_Kyrgios-Tim_Smyczek,1,S-XC,1,1,1,0,0,1,0,,,,,,,,,,
20140210-M-Memphis-R32-Nick_Kyrgios-Tim_Smyczek,1,S-DTM,1,0,0,0,0,0,1,,,,,,,,,,
20140210-M-Memphis-R32-Nick_Kyrgios-Tim_Smyczek,1,S-II,1,0,0,0,0,0,1,,,,,,,,,,
20140210-M-Memphis-R32-Nick_Kyrgios-Tim_Smyczek,2,F-XC,64,19,7,0,12,37,27,,,,,,,,,,
20140210-M-Memphis-R32-Nick_Kyrgios-Tim_Smyczek,2,F-DTM,60,11,0,0,11,25,35,,,,,,,,,,
20140210-M-Memphis-R32-Nick_Kyrgios-Tim_Smyczek,2,F-DTL,10,4,2,0,2,6,4,,,,,,,,,,
20140210-M-Memphis-R32-Nick_Kyrgios-Tim_Smyczek,2,F-IO,29,8,4,1,3,13,16,,,,,,,,,,
20140210-M-Memphis-R32-Nick_Kyrgios-Tim_Smyczek,2,F-II,3,0,0,0,0,3,0,,,,,,,,,,
20140210-M-Memphis-R32-Nick_Kyrgios-Tim_Smyczek,2,B-XC,40,2,0,1,1,25,15,,,,,,,,,,
20140210-M-Memphis-R32-Nick_Kyrgios-Tim_Smyczek,2,B-DTM,39,5,0,1,4,21,18,,,,,,,,,,
20140210-M-Memphis-R32-Nick_Kyrgios-Tim_Smyczek,2,B-DTL,11,6,2,0,4,5,6,,,,,,,,,,
20140210-M-Memphis-R32-Nick_Kyrgios-Tim_Smyczek,2,B-IO,6,2,0,0,2,3,3,,,,,,,,,,
20140210-M-Memphis-R32-Nick_Kyrgios-Tim_Smyczek,2,S-XC,6,0,0,0,0,6,0,,,,,,,,,,
20140210-M-Memphis-R32-Nick_Kyrgios-Tim_Smyczek,2,S-DTM,15,2,0,0,2,8,7,,,,,,,,,,
20140210-M-Memphis-R32-Nick_Kyrgios-Tim_Smyczek,2,S-DTL,4,1,0,0,1,0,4,,,,,,,,,,
20140210-M-Memphis-R32-Nick_Kyrgios-Tim_Smyczek,2,S-IO,3,0,0,0,0,2,1,,,,,,,,,,
20140210-M-Rotterdam-R32-Tomas_Berdych-Andreas_Seppi,1,F-XC,28,10,6,3,1,22,6,,,,,,,,,,
20140210-M-Rotterdam-R32-Tomas_Berdych-Andreas_Seppi,1,F-DTM,20,3,0,0,3,15,5,,,,,,,,,,
20140210-M-Rotterdam-R32-Tomas_Berdych-Andreas_Seppi,1,F-DTL,13,4,1,2,1,8,5,,,,,,,,,,
20140210-M-Rotterdam-R32-Tomas_Berdych-Andreas_Seppi,1,F-IO,16,7,5,1,1,15,1,,,,,,,,,,
20140210-M-Rotterdam-R32-Tomas_Berdych-Andreas_Seppi,1,F-II,3,3,2,0,1,2,1,,,,,,,,,,
20140210-M-Rotterdam-R32-Tomas_Berdych-Andreas_Seppi,1,B-XC,25,6,1,0,5,15,10,,,,,,,,,,
20140210-M-Rotterdam-R32-Tomas_Berdych-Andreas_Seppi,1,B-DTM,9,1,0,0,1,3,6,,,,,,,,,,
20140210-M-Rotterdam-R32-Tomas_Berdych-Andreas_Seppi,1,B-DTL,5,1,0,1,0,3,2,,,,,,,,,,
20140210-M-Rotterdam-R32-Tomas_Berdych-Andreas_Seppi,1,B-IO,2,0,0,0,0,1,1,,,,,,,,,,
20140210-M-Rotterdam-R32-Tomas_Berdych-Andreas_Seppi,1,S-XC,7,0,0,0,0,3,4,,,,,,,,,,
20140210-M-Rotterdam-R32-Tomas_Berdych-Andreas_Seppi,1,S-DTM,5,1,0,0,1,0,5,,,,,,,,,,
20140210-M-Rotterdam-R32-Tomas_Berdych-Andreas_Seppi,2,F-XC,40,5,0,1,4,11,29,,,,,,,,,,
20140210-M-Rotterdam-R32-Tomas_Berdych-Andreas_Seppi,2,F-DTM,17,3,1,1,1,5,12,,,,,,,,,,
20140210-M-Rotterdam-R32-Tomas_Berdych-Andreas_Seppi,2,F-DTL,1,1,0,0,1,0,1,,,,,,,,,,
20140210-M-Rotterdam-R32-Tomas_Berdych-Andreas_Seppi,2,F-IO,15,3,1,1,1,11,4,,,,,,,,,,
20140210-M-Rotterdam-R32-Tomas_Berdych-Andreas_Seppi,2,F-II,2,1,0,1,0,1,1,,,,,,,,,,
20140210-M-Rotterdam-R32-Tomas_Berdych-Andreas_Seppi,2,B-XC,27,4,0,1,3,11,16,,,,,,,,,,
20140210-M-Rotterdam-R32-Tomas_Berdych-Andreas_Seppi,2,B-DTM,24,4,0,0,4,7,17,,,,,,,,,,
20140210-M-Rotterdam-R32-Tomas_Berdych-Andreas_Seppi,2,B-DTL,5,3,2,0,1,2,3,,,,,,,,,,
20140210-M-Rotterdam-R32-Tomas_Berdych-Andreas_Seppi,2,S-XC,4,0,0,0,0,1,3,,,,,,,,,,
20140210-M-Rotterdam-R32-Tomas_Berdych-Andreas_Seppi,2,S-DTM,2,0,0,0,0,0,2,,,,,,,,,,
20140218-M-Rio_de_Janeiro-R32-Rafael_Nadal-Daniel_Gimeno_Traver,1,F-XC,70,6,1,4,1,50,20,,,,,,,,,,
20140218-M-Rio_de_Janeiro-R32-Rafael_Nadal-Daniel_Gimeno_Traver,1,F-DTM,16,1,0,0,1,11,5,,,,,,,,,,
20140218-M-Rio_de_Janeiro-R32-Rafael_Nadal-Daniel_Gimeno_Traver,1,F-DTL,3,2,2,0,0,2,1,,,,,,,,,,
20140218-M-Rio_de_Janeiro-R32-Rafael_Nadal-Daniel_Gimeno_Traver,1,F-IO,19,6,2,2,2,15,4,,,,,,,,,,
20140218-M-Rio_de_Janeiro-R32-Rafael_Nadal-Daniel_Gimeno_Traver,1,F-II,4,1,0,1,0,4,0,,,,,,,,,,
20140218-M-Rio_de_Janeiro-R32-Rafael_Nadal-Daniel_Gimeno_Traver,1,B-XC,36,8,3,3,2,24,12,,,,,,,,,,
20140218-M-Rio_de_Janeiro-R32-Rafael_Nadal-Daniel_Gimeno_Traver,1,B-DTM,44,1,0,0,1,26,18,,,,,,,,,,
20140218-M-Rio_de_Janeiro-R32-Rafael_Nadal-Daniel_Gimeno_Traver,1,B-DTL,14,4,0,2,2,10,4,,,,,,,,,,
20140218-M-Rio_de_Janeiro-R32-Rafael_Nadal-Daniel_Gimeno_Traver,1,B-IO,7,0,0,0,0,3,4,,,,,,,,,,
20140218-M-Rio_de_Janeiro-R32-Rafael_Nadal-Daniel_Gimeno_Traver,1,S-XC,1,1,0,1,0,1,0,,,,,,,,,,
20140218-M-Rio_de_Janeiro-R32-Rafael_Nadal-Daniel_Gimeno_Traver,1,S-DTM,4,0,0,0,0,2,2,,,,,,,,,,
20140218-M-Rio_de_Janeiro-R32-Rafael_Nadal-Daniel_Gimeno_Traver,1,S-DTL,1,0,0,0,0,1,0,,,,,,,,,,
20140218-M-Rio_de_Janeiro-R32-Rafael_Nadal-Daniel_Gimeno_Traver,2,F-XC,62,13,2,4,7,22,40,,,,,,,,,,
20140218-M-Rio_de_Janeiro-R32-Rafael_Nadal-Daniel_Gimeno_Traver,2,F-DTM,41,4,0,1,3,18,23,,,,,,,,,,
20140218-M-Rio_de_Janeiro-R32-Rafael_Nadal-Daniel_Gimeno_Traver,2,F-DTL,4,3,1,1,1,3,1,,,,,,,,,,
20140218-M-Rio_de_Janeiro-R32-Rafael_Nadal-Daniel_Gimeno_Traver,2,F-IO,25,18,8,3,7,14,11,,,,,,,,,,
20140218-M-Rio_de_Janeiro-R32-Rafael_Nadal-Daniel_Gimeno_Traver,2,F-II,7,1,0,0,1,4,3,,,,,,,,,,
20140218-M-Rio_de_Janeiro-R32-Rafael_Nadal-Daniel_Gimeno_Traver,2,B-XC,30,11,1,5,5,12,18,,,,,,,,,,
20140218-M-Rio_de_Janeiro-R32-Rafael_Nadal-Daniel_Gimeno_Traver,2,B-DTM,36,6,0,0,6,7,29,,,,,,,,,,
20140218-M-Rio_de_Janeiro-R32-Rafael_Nadal-Daniel_Gimeno_Traver,2,B-DTL,15,3,1,0,2,5,10,,,,,,,,,,
20140218-M-Rio_de_Janeiro-R32-Rafael_Nadal-Daniel_Gimeno_Traver,2,B-IO,2,1,0,0,1,0,2,,,,,,,,,,
20140218-M-Rio_de_Janeiro-R32-Rafael_Nadal-Daniel_Gimeno_Traver,2,S-XC,1,0,0,0,0,0,1,,,,,,,,,,
20140218-M-Rio_de_Janeiro-R32-Rafael_Nadal-Daniel_Gimeno_Traver,2,S-DTM,8,0,0,0,0,2,6,,,,,,,,,,
20140218-M-Rio_de_Janeiro-R32-Rafael_Nadal-Daniel_Gimeno_Traver,2,S-DTL,2,0,0,0,0,0,2,,,,,,,,,,
20140220-M-Rio_de_Janeiro-R16-Albert_Montanes-Rafael_Nadal,1,F-XC,37,4,1,2,1,16,21,,,,,,,,,,
20140220-M-Rio_de_Janeiro-R16-Albert_Montanes-Rafael_Nadal,1,F-DTM,20,1,0,0,1,9,11,,,,,,,,,,
20140220-M-Rio_de_Janeiro-R16-Albert_Montanes-Rafael_Nadal,1,F-DTL,9,5,3,0,2,4,5,,,,,,,,,,
20140220-M-Rio_de_Janeiro-R16-Albert_Montanes-Rafael_Nadal,1,F-IO,22,8,3,2,3,12,10,,,,,,,,,,
20140220-M-Rio_de_Janeiro-R16-Albert_Montanes-Rafael_Nadal,1,F-II,18,6,2,2,2,8,10,,,,,,,,,,
20140220-M-Rio_de_Janeiro-R16-Albert_Montanes-Rafael_Nadal,1,B-XC,12,3,1,1,1,5,7,,,,,,,,,,
20140220-M-Rio_de_Janeiro-R16-Albert_Montanes-Rafael_Nadal,1,B-DTM,17,2,0,0,2,2,15,,,,,,,,,,
20140220-M-Rio_de_Janeiro-R16-Albert_Montanes-Rafael_Nadal,1,B-DTL,15,2,0,0,2,6,9,,,,,,,,,,
20140220-M-Rio_de_Janeiro-R16-Albert_Montanes-Rafael_Nadal,1,B-IO,4,1,0,1,0,3,1,,,,,,,,,,
20140220-M-Rio_de_Janeiro-R16-Albert_Montanes-Rafael_Nadal,1,S-DTM,1,0,0,0,0,0,1,,,,,,,,,,
20140220-M-Rio_de_Janeiro-R16-Albert_Montanes-Rafael_Nadal,1,S-DTL,4,1,0,0,1,1,3,,,,,,,,,,
20140220-M-Rio_de_Janeiro-R16-Albert_Montanes-Rafael_Nadal,2,F-XC,47,10,3,5,2,32,15,,,,,,,,,,
20140220-M-Rio_de_Janeiro-R16-Albert_Montanes-Rafael_Nadal,2,F-DTM,10,0,0,0,0,2,8,,,,,,,,,,
20140220-M-Rio_de_Janeiro-R16-Albert_Montanes-Rafael_Nadal,2,F-DTL,4,2,1,1,0,4,0,,,,,,,,,,
20140220-M-Rio_de_Janeiro-R16-Albert_Montanes-Rafael_Nadal,2,F-IO,19,13,8,2,3,14,5,,,,,,,,,,
20140220-M-Rio_de_Janeiro-R16-Albert_Montanes-Rafael_Nadal,2,F-II,6,3,0,2,1,3,3,,,,,,,,,,
20140220-M-Rio_de_Janeiro-R16-Albert_Montanes-Rafael_Nadal,2,B-XC,22,3,1,0,2,10,12,,,,,,,,,,
20140220-M-Rio_de_Janeiro-R16-Albert_Montanes-Rafael_Nadal,2,B-DTM,19,0,0,0,0,9,10,,,,,,,,,,
20140220-M-Rio_de_Janeiro-R16-Albert_Montanes-Rafael_Nadal,2,B-DTL,17,6,1,4,1,12,5,,,,,,,,,,
20140220-M-Rio_de_Janeiro-R16-Albert_Montanes-Rafael_Nadal,2,B-IO,4,0,0,0,0,3,1,,,,,,,,,,
20140220-M-Rio_de_Janeiro-R16-Albert_Montanes-Rafael_Nadal,2,S-XC,3,0,0,0,0,3,0,,,,,,,,,,
20140220-M-Rio_de_Janeiro-R16-Albert_Montanes-Rafael_Nadal,2,S-DTM,3,0,0,0,0,2,1,,,,,,,,,,
20140220-M-Rio_de_Janeiro-R16-Albert_Montanes-Rafael_Nadal,2,S-DTL,6,0,0,0,0,3,3,,,,,,,,,,
20140220-M-Rio_de_Janeiro-R16-Albert_Montanes-Rafael_Nadal,2,S-IO,2,0,0,0,0,0,2,,,,,,,,,,
20140221-M-Rio_de_Janeiro-QF-Rafael_Nadal-Joao_Sousa,1,F-XC,49,4,1,2,1,31,18,,,,,,,,,,
20140221-M-Rio_de_Janeiro-QF-Rafael_Nadal-Joao_Sousa,1,F-DTM,7,1,1,0,0,3,4,,,,,,,,,,
20140221-M-Rio_de_Janeiro-QF-Rafael_Nadal-Joao_Sousa,1,F-DTL,8,5,3,2,0,8,0,,,,,,,,,,
20140221-M-Rio_de_Janeiro-QF-Rafael_Nadal-Joao_Sousa,1,F-IO,20,13,7,3,3,16,4,,,,,,,,,,
20140221-M-Rio_de_Janeiro-QF-Rafael_Nadal-Joao_Sousa,1,F-II,4,0,0,0,0,4,0,,,,,,,,,,
20140221-M-Rio_de_Janeiro-QF-Rafael_Nadal-Joao_Sousa,1,B-XC,11,4,0,1,3,6,5,,,,,,,,,,
20140221-M-Rio_de_Janeiro-QF-Rafael_Nadal-Joao_Sousa,1,B-DTM,5,0,0,0,0,3,2,,,,,,,,,,
20140221-M-Rio_de_Janeiro-QF-Rafael_Nadal-Joao_Sousa,1,B-DTL,5,1,0,0,1,3,2,,,,,,,,,,
20140221-M-Rio_de_Janeiro-QF-Rafael_Nadal-Joao_Sousa,1,B-IO,2,0,0,0,0,2,0,,,,,,,,,,
20140221-M-Rio_de_Janeiro-QF-Rafael_Nadal-Joao_Sousa,1,S-XC,1,0,0,0,0,1,0,,,,,,,,,,
20140221-M-Rio_de_Janeiro-QF-Rafael_Nadal-Joao_Sousa,1,S-DTM,1,0,0,0,0,1,0,,,,,,,,,,
20140221-M-Rio_de_Janeiro-QF-Rafael_Nadal-Joao_Sousa,1,S-DTL,2,0,0,0,0,0,2,,,,,,,,,,
20140221-M-Rio_de_Janeiro-QF-Rafael_Nadal-Joao_Sousa,2,F-XC,19,6,0,4,2,9,10,,,,,,,,,,
20140221-M-Rio_de_Janeiro-QF-Rafael_Nadal-Joao_Sousa,2,F-DTM,10,1,0,0,1,3,7,,,,,,,,,,
20140221-M-Rio_de_Janeiro-QF-Rafael_Nadal-Joao_Sousa,2,F-DTL,7,3,1,1,1,3,4,,,,,,,,,,
20140221-M-Rio_de_Janeiro-QF-Rafael_Nadal-Joao_Sousa,2,F-IO,17,6,2,3,1,9,8,,,,,,,,,,
20140221-M-Rio_de_Janeiro-QF-Rafael_Nadal-Joao_Sousa,2,F-II,3,1,0,0,1,1,2,,,,,,,,,,
20140221-M-Rio_de_Janeiro-QF-Rafael_Nadal-Joao_Sousa,2,B-XC,19,6,0,0,6,5,14,,,,,,,,,,
20140221-M-Rio_de_Janeiro-QF-Rafael_Nadal-Joao_Sousa,2,B-DTM,22,1,0,0,1,5,17,,,,,,,,,,
20140221-M-Rio_de_Janeiro-QF-Rafael_Nadal-Joao_Sousa,2,B-DTL,11,6,0,2,4,5,6,,,,,,,,,,
20140221-M-Rio_de_Janeiro-QF-Rafael_Nadal-Joao_Sousa,2,B-IO,2,0,0,0,0,0,2,,,,,,,,,,
20140221-M-Rio_de_Janeiro-QF-Rafael_Nadal-Joao_Sousa,2,S-DTM,1,0,0,0,0,0,1,,,,,,,,,,
20140221-M-Rio_de_Janeiro-QF-Rafael_Nadal-Joao_Sousa,2,S-DTL,4,0,0,0,0,1,3,,,,,,,,,,
20140222-M-Rio_de_Janeiro-SF-Rafael_Nadal-Pablo_Andujar,1,F-XC,65,11,3,2,6,31,34,,,,,,,,,,
20140222-M-Rio_de_Janeiro-SF-Rafael_Nadal-Pablo_Andujar,1,F-DTM,22,4,1,2,1,9,13,,,,,,,,,,
20140222-M-Rio_de_Janeiro-SF-Rafael_Nadal-Pablo_Andujar,1,F-DTL,16,7,4,1,2,12,4,,,,,,,,,,
20140222-M-Rio_de_Janeiro-SF-Rafael_Nadal-Pablo_Andujar,1,F-IO,35,17,7,5,5,21,14,,,,,,,,,,
20140222-M-Rio_de_Janeiro-SF-Rafael_Nadal-Pablo_Andujar,1,F-II,11,3,1,2,0,7,4,,,,,,,,,,
20140222-M-Rio_de_Janeiro-SF-Rafael_Nadal-Pablo_Andujar,1,B-XC,21,7,2,1,4,11,10,,,,,,,,,,
20140222-M-Rio_de_Janeiro-SF-Rafael_Nadal-Pablo_Andujar,1,B-DTM,35,3,0,1,2,15,20,,,,,,,,,,
20140222-M-Rio_de_Janeiro-SF-Rafael_Nadal-Pablo_Andujar,1,B-DTL,9,1,1,0,0,2,7,,,,,,,,,,
20140222-M-Rio_de_Janeiro-SF-Rafael_Nadal-Pablo_Andujar,1,B-IO,8,2,0,1,1,4,4,,,,,,,,,,
20140222-M-Rio_de_Janeiro-SF-Rafael_Nadal-Pablo_Andujar,1,S-XC,4,2,1,0,1,2,2,,,,,,,,,,
20140222-M-Rio_de_Janeiro-SF-Rafael_Nadal-Pablo_Andujar,1,S-DTM,7,1,0,0,1,1,6,,,,,,,,,,
20140222-M-Rio_de_Janeiro-SF-Rafael_Nadal-Pablo_Andujar,1,S-DTL,1,0,0,0,0,0,1,,,,,,,,,,
20140222-M-Rio_de_Janeiro-SF-Rafael_Nadal-Pablo_Andujar,1,S-IO,2,0,0,0,0,0,2,,,,,,,,,,
20140222-M-Rio_de_Janeiro-SF-Rafael_Nadal-Pablo_Andujar,2,F-XC,37,11,3,3,5,22,15,,,,,,,,,,
20140222-M-Rio_de_Janeiro-SF-Rafael_Nadal-Pablo_Andujar,2,F-DTM,30,0,0,0,0,22,8,,,,,,,,,,
20140222-M-Rio_de_Janeiro-SF-Rafael_Nadal-Pablo_Andujar,2,F-DTL,13,5,1,2,2,5,8,,,,,,,,,,
20140222-M-Rio_de_Janeiro-SF-Rafael_Nadal-Pablo_Andujar,2,F-IO,46,27,11,6,10,27,19,,,,,,,,,,
20140222-M-Rio_de_Janeiro-SF-Rafael_Nadal-Pablo_Andujar,2,F-II,5,3,2,1,0,3,2,,,,,,,,,,
20140222-M-Rio_de_Janeiro-SF-Rafael_Nadal-Pablo_Andujar,2,B-XC,30,6,1,2,3,20,10,,,,,,,,,,
20140222-M-Rio_de_Janeiro-SF-Rafael_Nadal-Pablo_Andujar,2,B-DTM,37,2,0,0,2,16,21,,,,,,,,,,
20140222-M-Rio_de_Janeiro-SF-Rafael_Nadal-Pablo_Andujar,2,B-DTL,24,7,2,1,4,14,10,,,,,,,,,,
20140222-M-Rio_de_Janeiro-SF-Rafael_Nadal-Pablo_Andujar,2,B-IO,8,2,2,0,0,4,4,,,,,,,,,,
20140222-M-Rio_de_Janeiro-SF-Rafael_Nadal-Pablo_Andujar,2,S-XC,1,1,0,0,1,0,1,,,,,,,,,,
20140222-M-Rio_de_Janeiro-SF-Rafael_Nadal-Pablo_Andujar,2,S-DTM,1,0,0,0,0,1,0,,,,,,,,,,
20140222-M-Rio_de_Janeiro-SF-Rafael_Nadal-Pablo_Andujar,2,S-DTL,3,0,0,0,0,2,1,,,,,,,,,,
20140223-M-Rio_de_Janeiro-F-Rafael_Nadal-Alexandr_Dolgopolov,1,F-XC,30,7,3,4,0,20,10,,,,,,,,,,
20140223-M-Rio_de_Janeiro-F-Rafael_Nadal-Alexandr_Dolgopolov,1,F-DTM,13,0,0,0,0,7,6,,,,,,,,,,
20140223-M-Rio_de_Janeiro-F-Rafael_Nadal-Alexandr_Dolgopolov,1,F-DTL,12,3,1,1,1,8,4,,,,,,,,,,
20140223-M-Rio_de_Janeiro-F-Rafael_Nadal-Alexandr_Dolgopolov,1,F-IO,18,9,4,4,1,12,6,,,,,,,,,,
20140223-M-Rio_de_Janeiro-F-Rafael_Nadal-Alexandr_Dolgopolov,1,F-II,6,2,1,1,0,5,1,,,,,,,,,,
20140223-M-Rio_de_Janeiro-F-Rafael_Nadal-Alexandr_Dolgopolov,1,B-XC,18,4,0,3,1,12,6,,,,,,,,,,
20140223-M-Rio_de_Janeiro-F-Rafael_Nadal-Alexandr_Dolgopolov,1,B-DTM,5,0,0,0,0,3,2,,,,,,,,,,
20140223-M-Rio_de_Janeiro-F-Rafael_Nadal-Alexandr_Dolgopolov,1,B-DTL,15,4,1,3,0,9,6,,,,,,,,,,
20140223-M-Rio_de_Janeiro-F-Rafael_Nadal-Alexandr_Dolgopolov,1,B-IO,3,1,0,1,0,2,1,,,,,,,,,,
20140223-M-Rio_de_Janeiro-F-Rafael_Nadal-Alexandr_Dolgopolov,1,S-DTM,3,0,0,0,0,1,2,,,,,,,,,,
20140223-M-Rio_de_Janeiro-F-Rafael_Nadal-Alexandr_Dolgopolov,1,S-DTL,1,0,0,0,0,0,1,,,,,,,,,,
20140223-M-Rio_de_Janeiro-F-Rafael_Nadal-Alexandr_Dolgopolov,2,F-XC,38,9,5,3,1,18,20,,,,,,,,,,
20140223-M-Rio_de_Janeiro-F-Rafael_Nadal-Alexandr_Dolgopolov,2,F-DTM,12,1,0,0,1,5,7,,,,,,,,,,
20140223-M-Rio_de_Janeiro-F-Rafael_Nadal-Alexandr_Dolgopolov,2,F-DTL,7,7,3,2,2,5,2,,,,,,,,,,
20140223-M-Rio_de_Janeiro-F-Rafael_Nadal-Alexandr_Dolgopolov,2,F-IO,9,4,2,2,0,7,2,,,,,,,,,,
20140223-M-Rio_de_Janeiro-F-Rafael_Nadal-Alexandr_Dolgopolov,2,F-II,3,0,0,0,0,2,1,,,,,,,,,,
20140223-M-Rio_de_Janeiro-F-Rafael_Nadal-Alexandr_Dolgopolov,2,B-XC,26,8,3,4,1,13,13,,,,,,,,,,
20140223-M-Rio_de_Janeiro-F-Rafael_Nadal-Alexandr_Dolgopolov,2,B-DTM,10,2,0,0,2,2,8,,,,,,,,,,
20140223-M-Rio_de_Janeiro-F-Rafael_Nadal-Alexandr_Dolgopolov,2,B-DTL,12,3,0,1,2,4,8,,,,,,,,,,
20140223-M-Rio_de_Janeiro-F-Rafael_Nadal-Alexandr_Dolgopolov,2,B-IO,3,1,0,0,1,0,3,,,,,,,,,,
20140223-M-Rio_de_Janeiro-F-Rafael_Nadal-Alexandr_Dolgopolov,2,S-DTM,1,0,0,0,0,0,1,,,,,,,,,,
20140224-M-Cherbourg_CH-Q3-Rudy_Coco-Taro_Daniel,1,F-XC,34,14,6,2,6,18,16,,,,,,,,,,
20140224-M-Cherbourg_CH-Q3-Rudy_Coco-Taro_Daniel,1,F-DTM,18,5,0,0,5,7,11,,,,,,,,,,
20140224-M-Cherbourg_CH-Q3-Rudy_Coco-Taro_Daniel,1,F-DTL,8,4,0,2,2,4,4,,,,,,,,,,
20140224-M-Cherbourg_CH-Q3-Rudy_Coco-Taro_Daniel,1,F-IO,20,8,4,1,3,10,10,,,,,,,,,,
20140224-M-Cherbourg_CH-Q3-Rudy_Coco-Taro_Daniel,1,F-II,1,0,0,0,0,0,1,,,,,,,,,,
20140224-M-Cherbourg_CH-Q3-Rudy_Coco-Taro_Daniel,1,B-XC,36,10,2,0,8,14,22,,,,,,,,,,
20140224-M-Cherbourg_CH-Q3-Rudy_Coco-Taro_Daniel,1,B-DTM,15,1,0,0,1,5,10,,,,,,,,,,
20140224-M-Cherbourg_CH-Q3-Rudy_Coco-Taro_Daniel,1,B-DTL,8,6,0,1,5,2,6,,,,,,,,,,
20140224-M-Cherbourg_CH-Q3-Rudy_Coco-Taro_Daniel,1,B-IO,2,1,0,0,1,0,2,,,,,,,,,,
20140224-M-Cherbourg_CH-Q3-Rudy_Coco-Taro_Daniel,1,S-XC,2,1,0,0,1,0,2,,,,,,,,,,
20140224-M-Cherbourg_CH-Q3-Rudy_Coco-Taro_Daniel,1,S-DTM,1,0,0,0,0,0,1,,,,,,,,,,
20140224-M-Cherbourg_CH-Q3-Rudy_Coco-Taro_Daniel,1,S-DTL,1,0,0,0,0,0,1,,,,,,,,,,
20140224-M-Cherbourg_CH-Q3-Rudy_Coco-Taro_Daniel,2,F-XC,37,0,0,0,0,25,12,,,,,,,,,,
20140224-M-Cherbourg_CH-Q3-Rudy_Coco-Taro_Daniel,2,F-DTM,26,1,0,0,1,14,12,,,,,,,,,,
20140224-M-Cherbourg_CH-Q3-Rudy_Coco-Taro_Daniel,2,F-DTL,10,5,3,2,0,6,4,,,,,,,,,,
20140224-M-Cherbourg_CH-Q3-Rudy_Coco-Taro_Daniel,2,F-IO,11,5,3,1,1,6,5,,,,,,,,,,
20140224-M-Cherbourg_CH-Q3-Rudy_Coco-Taro_Daniel,2,B-XC,10,1,0,0,1,5,5,,,,,,,,,,
20140224-M-Cherbourg_CH-Q3-Rudy_Coco-Taro_Daniel,2,B-DTM,17,0,0,0,0,13,4,,,,,,,,,,
20140224-M-Cherbourg_CH-Q3-Rudy_Coco-Taro_Daniel,2,B-DTL,9,2,0,0,2,5,4,,,,,,,,,,
20140224-M-Cherbourg_CH-Q3-Rudy_Coco-Taro_Daniel,2,B-IO,4,0,0,0,0,3,1,,,,,,,,,,
20140224-M-Cherbourg_CH-Q3-Rudy_Coco-Taro_Daniel,2,S-XC,1,0,0,0,0,0,1,,,,,,,,,,
20140224-M-Cherbourg_CH-Q3-Rudy_Coco-Taro_Daniel,2,S-DTM,1,0,0,0,0,0,1,,,,,,,,,,
20140228-M-Dubai-SF-Novak_Djokovic-Roger_Federer,1,F-XC,22,9,2,2,5,8,14,,,,,,,,,,
20140228-M-Dubai-SF-Novak_Djokovic-Roger_Federer,1,F-DTM,32,2,0,0,2,18,14,,,,,,,,,,
20140228-M-Dubai-SF-Novak_Djokovic-Roger_Federer,1,F-DTL,7,0,0,0,0,3,4,,,,,,,,,,
20140228-M-Dubai-SF-Novak_Djokovic-Roger_Federer,1,F-IO,32,5,3,0,2,15,17,,,,,,,,,,
20140228-M-Dubai-SF-Novak_Djokovic-Roger_Federer,1,F-II,1,1,0,1,0,1,0,,,,,,,,,,
20140228-M-Dubai-SF-Novak_Djokovic-Roger_Federer,1,B-XC,48,11,6,1,3,23,25,,,,,,,,,,
20140228-M-Dubai-SF-Novak_Djokovic-Roger_Federer,1,B-DTM,35,3,0,1,2,16,19,,,,,,,,,,
20140228-M-Dubai-SF-Novak_Djokovic-Roger_Federer,1,B-DTL,9,1,1,0,0,6,3,,,,,,,,,,
20140228-M-Dubai-SF-Novak_Djokovic-Roger_Federer,1,B-IO,10,8,1,1,6,2,8,,,,,,,,,,
20140228-M-Dubai-SF-Novak_Djokovic-Roger_Federer,1,S-XC,3,0,0,0,0,3,0,,,,,,,,,,
20140228-M-Dubai-SF-Novak_Djokovic-Roger_Federer,1,S-DTM,1,0,0,0,0,0,1,,,,,,,,,,
20140228-M-Dubai-SF-Novak_Djokovic-Roger_Federer,2,F-XC,22,9,4,2,3,14,8,,,,,,,,,,
20140228-M-Dubai-SF-Novak_Djokovic-Roger_Federer,2,F-DTM,28,3,0,0,3,11,17,,,,,,,,,,
20140228-M-Dubai-SF-Novak_Djokovic-Roger_Federer,2,F-DTL,4,2,1,0,1,2,2,,,,,,,,,,
20140228-M-Dubai-SF-Novak_Djokovic-Roger_Federer,2,F-IO,24,5,1,2,2,13,11,,,,,,,,,,
20140228-M-Dubai-SF-Novak_Djokovic-Roger_Federer,2,F-II,2,0,0,0,0,0,2,,,,,,,,,,
20140228-M-Dubai-SF-Novak_Djokovic-Roger_Federer,2,B-XC,26,5,1,0,3,11,15,,,,,,,,,,
20140228-M-Dubai-SF-Novak_Djokovic-Roger_Federer,2,B-DTM,37,2,1,0,1,22,15,,,,,,,,,,
20140228-M-Dubai-SF-Novak_Djokovic-Roger_Federer,2,B-DTL,12,2,1,1,0,9,3,,,,,,,,,,
20140228-M-Dubai-SF-Novak_Djokovic-Roger_Federer,2,B-IO,4,0,0,0,0,1,3,,,,,,,,,,
20140228-M-Dubai-SF-Novak_Djokovic-Roger_Federer,2,S-XC,13,2,0,0,2,5,8,,,,,,,,,,
20140228-M-Dubai-SF-Novak_Djokovic-Roger_Federer,2,S-DTM,14,1,0,0,1,6,8,,,,,,,,,,
20140228-M-Dubai-SF-Novak_Djokovic-Roger_Federer,2,S-DTL,2,0,0,0,0,2,0,,,,,,,,,,
20140228-M-Dubai-SF-Novak_Djokovic-Roger_Federer,2,S-II,1,0,0,0,0,1,0,,,,,,,,,,
20140308-M-Indian_Wells_Masters-R64-Radek_Stepanek-Rafael_Nadal,1,F-XC,50,8,1,2,5,25,25,,,,,,,,,,
20140308-M-Indian_Wells_Masters-R64-Radek_Stepanek-Rafael_Nadal,1,F-DTM,39,5,0,0,5,15,24,,,,,,,,,,
20140308-M-Indian_Wells_Masters-R64-Radek_Stepanek-Rafael_Nadal,1,F-DTL,8,4,2,0,2,4,4,,,,,,,,,,
20140308-M-Indian_Wells_Masters-R64-Radek_Stepanek-Rafael_Nadal,1,F-IO,28,15,6,6,3,16,12,,,,,,,,,,
20140308-M-Indian_Wells_Masters-R64-Radek_Stepanek-Rafael_Nadal,1,F-II,1,1,1,0,0,1,0,,,,,,,,,,
20140308-M-Indian_Wells_Masters-R64-Radek_Stepanek-Rafael_Nadal,1,B-XC,11,3,0,1,2,3,8,,,,,,,,,,
20140308-M-Indian_Wells_Masters-R64-Radek_Stepanek-Rafael_Nadal,1,B-DTM,26,2,0,1,1,10,16,,,,,,,,,,
20140308-M-Indian_Wells_Masters-R64-Radek_Stepanek-Rafael_Nadal,1,B-DTL,13,7,2,0,5,4,9,,,,,,,,,,
20140308-M-Indian_Wells_Masters-R64-Radek_Stepanek-Rafael_Nadal,1,B-IO,9,3,0,0,3,1,8,,,,,,,,,,
20140308-M-Indian_Wells_Masters-R64-Radek_Stepanek-Rafael_Nadal,1,S-DTM,3,0,0,0,0,0,3,,,,,,,,,,
20140308-M-Indian_Wells_Masters-R64-Radek_Stepanek-Rafael_Nadal,1,S-DTL,8,1,0,0,1,2,6,,,,,,,,,,
20140308-M-Indian_Wells_Masters-R64-Radek_Stepanek-Rafael_Nadal,2,F-XC,44,11,4,4,3,30,14,,,,,,,,,,
20140308-M-Indian_Wells_Masters-R64-Radek_Stepanek-Rafael_Nadal,2,F-DTM,28,3,1,2,0,23,5,,,,,,,,,,
20140308-M-Indian_Wells_Masters-R64-Radek_Stepanek-Rafael_Nadal,2,F-DTL,7,4,3,1,0,6,1,,,,,,,,,,
20140308-M-Indian_Wells_Masters-R64-Radek_Stepanek-Rafael_Nadal,2,F-IO,43,13,2,6,5,28,15,,,,,,,,,,
20140308-M-Indian_Wells_Masters-R64-Radek_Stepanek-Rafael_Nadal,2,F-II,8,3,0,2,1,5,3,,,,,,,,,,
20140308-M-Indian_Wells_Masters-R64-Radek_Stepanek-Rafael_Nadal,2,B-XC,24,4,2,2,0,13,11,,,,,,,,,,
20140308-M-Indian_Wells_Masters-R64-Radek_Stepanek-Rafael_Nadal,2,B-DTM,28,2,0,1,1,13,15,,,,,,,,,,
20140308-M-Indian_Wells_Masters-R64-Radek_Stepanek-Rafael_Nadal,2,B-DTL,7,3,1,1,1,5,2,,,,,,,,,,
20140308-M-Indian_Wells_Masters-R64-Radek_Stepanek-Rafael_Nadal,2,S-XC,4,0,0,0,0,3,1,,,,,,,,,,
20140308-M-Indian_Wells_Masters-R64-Radek_Stepanek-Rafael_Nadal,2,S-DTM,7,0,0,0,0,1,6,,,,,,,,,,
20140308-M-Indian_Wells_Masters-R64-Radek_Stepanek-Rafael_Nadal,2,S-DTL,2,0,0,0,0,2,0,,,,,,,,,,
20140310-M-Indian_Wells_Masters-R32-Alexandr_Dolgopolov-Rafael_Nadal,1,F-XC,76,9,3,4,2,43,33,,,,,,,,,,
20140310-M-Indian_Wells_Masters-R32-Alexandr_Dolgopolov-Rafael_Nadal,1,F-DTM,20,1,0,0,1,11,9,,,,,,,,,,
20140310-M-Indian_Wells_Masters-R32-Alexandr_Dolgopolov-Rafael_Nadal,1,F-DTL,13,6,2,2,2,9,4,,,,,,,,,,
20140310-M-Indian_Wells_Masters-R32-Alexandr_Dolgopolov-Rafael_Nadal,1,F-IO,26,16,6,3,7,18,8,,,,,,,,,,
20140310-M-Indian_Wells_Masters-R32-Alexandr_Dolgopolov-Rafael_Nadal,1,F-II,9,2,1,1,0,6,3,,,,,,,,,,
20140310-M-Indian_Wells_Masters-R32-Alexandr_Dolgopolov-Rafael_Nadal,1,B-XC,43,19,3,1,15,18,25,,,,,,,,,,
20140310-M-Indian_Wells_Masters-R32-Alexandr_Dolgopolov-Rafael_Nadal,1,B-DTM,54,6,0,1,5,27,27,,,,,,,,,,
20140310-M-Indian_Wells_Masters-R32-Alexandr_Dolgopolov-Rafael_Nadal,1,B-DTL,23,6,1,0,5,9,14,,,,,,,,,,
20140310-M-Indian_Wells_Masters-R32-Alexandr_Dolgopolov-Rafael_Nadal,1,B-IO,7,1,0,0,1,5,2,,,,,,,,,,
20140310-M-Indian_Wells_Masters-R32-Alexandr_Dolgopolov-Rafael_Nadal,1,B-II,1,1,0,0,1,0,1,,,,,,,,,,
20140310-M-Indian_Wells_Masters-R32-Alexandr_Dolgopolov-Rafael_Nadal,1,S-XC,1,1,1,0,0,1,0,,,,,,,,,,
20140310-M-Indian_Wells_Masters-R32-Alexandr_Dolgopolov-Rafael_Nadal,1,S-DTL,1,0,0,0,0,1,0,,,,,,,,,,
20140310-M-Indian_Wells_Masters-R32-Alexandr_Dolgopolov-Rafael_Nadal,2,F-XC,73,7,2,3,2,43,30,,,,,,,,,,
20140310-M-Indian_Wells_Masters-R32-Alexandr_Dolgopolov-Rafael_Nadal,2,F-DTM,36,4,0,0,4,12,24,,,,,,,,,,
20140310-M-Indian_Wells_Masters-R32-Alexandr_Dolgopolov-Rafael_Nadal,2,F-DTL,10,1,1,0,0,4,6,,,,,,,,,,
20140310-M-Indian_Wells_Masters-R32-Alexandr_Dolgopolov-Rafael_Nadal,2,F-IO,40,15,6,4,5,22,18,,,,,,,,,,
20140310-M-Indian_Wells_Masters-R32-Alexandr_Dolgopolov-Rafael_Nadal,2,F-II,9,1,1,0,0,5,4,,,,,,,,,,
20140310-M-Indian_Wells_Masters-R32-Alexandr_Dolgopolov-Rafael_Nadal,2,B-XC,39,10,1,3,6,13,26,,,,,,,,,,
20140310-M-Indian_Wells_Masters-R32-Alexandr_Dolgopolov-Rafael_Nadal,2,B-DTM,24,2,0,0,2,11,13,,,,,,,,,,
20140310-M-Indian_Wells_Masters-R32-Alexandr_Dolgopolov-Rafael_Nadal,2,B-DTL,23,5,2,1,2,10,13,,,,,,,,,,
20140310-M-Indian_Wells_Masters-R32-Alexandr_Dolgopolov-Rafael_Nadal,2,B-IO,1,1,0,0,1,0,1,,,,,,,,,,
20140310-M-Indian_Wells_Masters-R32-Alexandr_Dolgopolov-Rafael_Nadal,2,S-XC,4,0,0,0,0,1,3,,,,,,,,,,
20140310-M-Indian_Wells_Masters-R32-Alexandr_Dolgopolov-Rafael_Nadal,2,S-DTM,6,0,0,0,0,3,3,,,,,,,,,,
20140310-M-Indian_Wells_Masters-R32-Alexandr_Dolgopolov-Rafael_Nadal,2,S-DTL,3,1,0,0,1,0,3,,,,,,,,,,
20140310-M-Indian_Wells_Masters-R32-Alexandr_Dolgopolov-Rafael_Nadal,2,S-IO,1,0,0,0,0,0,1,,,,,,,,,,
20140317-M-Rimouski_CH-R32-Izak_Van_Der_Merwe-Daniel_Cox,1,F-XC,21,5,0,2,3,14,7,,,,,,,,,,
20140317-M-Rimouski_CH-R32-Izak_Van_Der_Merwe-Daniel_Cox,1,F-DTM,12,5,0,0,5,5,7,,,,,,,,,,
20140317-M-Rimouski_CH-R32-Izak_Van_Der_Merwe-Daniel_Cox,1,F-DTL,5,1,0,0,1,4,1,,,,,,,,,,
20140317-M-Rimouski_CH-R32-Izak_Van_Der_Merwe-Daniel_Cox,1,F-IO,10,4,1,2,1,5,5,,,,,,,,,,
20140317-M-Rimouski_CH-R32-Izak_Van_Der_Merwe-Daniel_Cox,1,F-II,2,1,0,0,1,1,1,,,,,,,,,,
20140317-M-Rimouski_CH-R32-Izak_Van_Der_Merwe-Daniel_Cox,1,B-XC,19,8,0,1,7,6,13,,,,,,,,,,
20140317-M-Rimouski_CH-R32-Izak_Van_Der_Merwe-Daniel_Cox,1,B-DTM,9,4,0,0,4,2,7,,,,,,,,,,
20140317-M-Rimouski_CH-R32-Izak_Van_Der_Merwe-Daniel_Cox,1,B-DTL,10,6,2,0,4,5,5,,,,,,,,,,
20140317-M-Rimouski_CH-R32-Izak_Van_Der_Merwe-Daniel_Cox,1,S-XC,7,1,0,0,1,1,6,,,,,,,,,,
20140317-M-Rimouski_CH-R32-Izak_Van_Der_Merwe-Daniel_Cox,1,S-DTM,3,0,0,0,0,0,3,,,,,,,,,,
20140317-M-Rimouski_CH-R32-Izak_Van_Der_Merwe-Daniel_Cox,1,S-DTL,2,0,0,0,0,0,2,,,,,,,,,,
20140317-M-Rimouski_CH-R32-Izak_Van_Der_Merwe-Daniel_Cox,1,S-IO,1,0,0,0,0,1,0,,,,,,,,,,
20140317-M-Rimouski_CH-R32-Izak_Van_Der_Merwe-Daniel_Cox,2,F-XC,25,6,2,2,2,11,14,,,,,,,,,,
20140317-M-Rimouski_CH-R32-Izak_Van_Der_Merwe-Daniel_Cox,2,F-DTM,8,0,0,0,0,4,4,,,,,,,,,,
20140317-M-Rimouski_CH-R32-Izak_Van_Der_Merwe-Daniel_Cox,2,F-DTL,9,2,0,0,2,3,6,,,,,,,,,,
20140317-M-Rimouski_CH-R32-Izak_Van_Der_Merwe-Daniel_Cox,2,F-IO,18,3,2,0,1,13,5,,,,,,,,,,
20140317-M-Rimouski_CH-R32-Izak_Van_Der_Merwe-Daniel_Cox,2,F-II,2,1,1,0,0,2,0,,,,,,,,,,
20140317-M-Rimouski_CH-R32-Izak_Van_Der_Merwe-Daniel_Cox,2,B-XC,18,4,1,0,3,9,9,,,,,,,,,,
20140317-M-Rimouski_CH-R32-Izak_Van_Der_Merwe-Daniel_Cox,2,B-DTM,9,0,0,0,0,5,4,,,,,,,,,,
20140317-M-Rimouski_CH-R32-Izak_Van_Der_Merwe-Daniel_Cox,2,B-DTL,2,2,1,0,1,1,1,,,,,,,,,,
20140317-M-Rimouski_CH-R32-Izak_Van_Der_Merwe-Daniel_Cox,2,B-IO,1,1,0,0,1,0,1,,,,,,,,,,
20140317-M-Rimouski_CH-R32-Izak_Van_Der_Merwe-Daniel_Cox,2,S-XC,3,1,0,1,0,2,1,,,,,,,,,,
20140317-M-Rimouski_CH-R32-Izak_Van_Der_Merwe-Daniel_Cox,2,S-DTM,5,0,0,0,0,0,5,,,,,,,,,,
20140322-M-Miami_Masters-R64-Lleyton_Hewitt-Rafael_Nadal,1,F-XC,47,11,3,2,6,13,34,,,,,,,,,,
20140322-M-Miami_Masters-R64-Lleyton_Hewitt-Rafael_Nadal,1,F-DTM,28,2,0,1,1,10,18,,,,,,,,,,
20140322-M-Miami_Masters-R64-Lleyton_Hewitt-Rafael_Nadal,1,F-DTL,1,0,0,0,0,1,0,,,,,,,,,,
20140322-M-Miami_Masters-R64-Lleyton_Hewitt-Rafael_Nadal,1,F-IO,17,5,2,0,3,7,10,,,,,,,,,,
20140322-M-Miami_Masters-R64-Lleyton_Hewitt-Rafael_Nadal,1,F-II,7,1,0,1,0,3,4,,,,,,,,,,
20140322-M-Miami_Masters-R64-Lleyton_Hewitt-Rafael_Nadal,1,B-XC,22,8,1,1,6,4,18,,,,,,,,,,
20140322-M-Miami_Masters-R64-Lleyton_Hewitt-Rafael_Nadal,1,B-DTM,26,1,0,0,1,4,22,,,,,,,,,,
20140322-M-Miami_Masters-R64-Lleyton_Hewitt-Rafael_Nadal,1,B-DTL,15,5,0,0,5,1,14,,,,,,,,,,
20140322-M-Miami_Masters-R64-Lleyton_Hewitt-Rafael_Nadal,1,S-DTM,4,0,0,0,0,0,4,,,,,,,,,,
20140322-M-Miami_Masters-R64-Lleyton_Hewitt-Rafael_Nadal,1,S-DTL,3,0,0,0,0,0,3,,,,,,,,,,
20140322-M-Miami_Masters-R64-Lleyton_Hewitt-Rafael_Nadal,2,F-XC,22,8,6,1,1,17,5,,,,,,,,,,
20140322-M-Miami_Masters-R64-Lleyton_Hewitt-Rafael_Nadal,2,F-DTM,18,1,0,0,1,13,5,,,,,,,,,,
20140322-M-Miami_Masters-R64-Lleyton_Hewitt-Rafael_Nadal,2,F-DTL,4,1,0,1,0,4,0,,,,,,,,,,
20140322-M-Miami_Masters-R64-Lleyton_Hewitt-Rafael_Nadal,2,F-IO,60,5,1,3,1,50,10,,,,,,,,,,
20140322-M-Miami_Masters-R64-Lleyton_Hewitt-Rafael_Nadal,2,F-II,7,5,3,1,1,6,1,,,,,,,,,,
20140322-M-Miami_Masters-R64-Lleyton_Hewitt-Rafael_Nadal,2,B-XC,1,0,0,0,0,0,1,,,,,,,,,,
20140322-M-Miami_Masters-R64-Lleyton_Hewitt-Rafael_Nadal,2,B-DTM,14,2,0,2,0,11,3,,,,,,,,,,
20140322-M-Miami_Masters-R64-Lleyton_Hewitt-Rafael_Nadal,2,B-DTL,1,0,0,0,0,1,0,,,,,,,,,,
20140322-M-Miami_Masters-R64-Lleyton_Hewitt-Rafael_Nadal,2,B-IO,25,6,1,2,3,17,8,,,,,,,,,,
20140322-M-Miami_Masters-R64-Lleyton_Hewitt-Rafael_Nadal,2,B-II,10,2,0,0,2,8,2,,,,,,,,,,
20140322-M-Miami_Masters-R64-Lleyton_Hewitt-Rafael_Nadal,2,S-XC,1,0,0,0,0,0,1,,,,,,,,,,
20140322-M-Miami_Masters-R64-Lleyton_Hewitt-Rafael_Nadal,2,S-DTM,3,0,0,0,0,2,1,,,,,,,,,,
20140322-M-Miami_Masters-R64-Lleyton_Hewitt-Rafael_Nadal,2,S-II,4,0,0,0,0,4,0,,,,,,,,,,
20140324-M-Miami_Masters-R32-Denis_Istomin-Rafael_Nadal,1,F-XC,20,1,0,1,0,5,15,,,,,,,,,,
20140324-M-Miami_Masters-R32-Denis_Istomin-Rafael_Nadal,1,F-DTM,17,1,0,0,1,3,14,,,,,,,,,,
20140324-M-Miami_Masters-R32-Denis_Istomin-Rafael_Nadal,1,F-DTL,11,6,4,0,2,6,5,,,,,,,,,,
20140324-M-Miami_Masters-R32-Denis_Istomin-Rafael_Nadal,1,F-IO,13,6,1,0,5,4,9,,,,,,,,,,
20140324-M-Miami_Masters-R32-Denis_Istomin-Rafael_Nadal,1,F-II,1,1,1,0,0,1,0,,,,,,,,,,
20140324-M-Miami_Masters-R32-Denis_Istomin-Rafael_Nadal,1,B-XC,20,2,0,0,2,4,16,,,,,,,,,,
20140324-M-Miami_Masters-R32-Denis_Istomin-Rafael_Nadal,1,B-DTM,16,2,0,0,2,4,12,,,,,,,,,,
20140324-M-Miami_Masters-R32-Denis_Istomin-Rafael_Nadal,1,B-DTL,11,3,1,0,2,4,7,,,,,,,,,,
20140324-M-Miami_Masters-R32-Denis_Istomin-Rafael_Nadal,1,B-IO,5,2,0,1,1,1,4,,,,,,,,,,
20140324-M-Miami_Masters-R32-Denis_Istomin-Rafael_Nadal,1,S-XC,2,0,0,0,0,0,2,,,,,,,,,,
20140324-M-Miami_Masters-R32-Denis_Istomin-Rafael_Nadal,1,S-DTM,3,0,0,0,0,1,2,,,,,,,,,,
20140324-M-Miami_Masters-R32-Denis_Istomin-Rafael_Nadal,1,S-DTL,1,0,0,0,0,0,1,,,,,,,,,,
20140324-M-Miami_Masters-R32-Denis_Istomin-Rafael_Nadal,1,S-IO,1,0,0,0,0,0,1,,,,,,,,,,
20140324-M-Miami_Masters-R32-Denis_Istomin-Rafael_Nadal,2,F-XC,45,7,1,6,0,34,11,,,,,,,,,,
20140324-M-Miami_Masters-R32-Denis_Istomin-Rafael_Nadal,2,F-DTM,19,0,0,0,0,12,7,,,,,,,,,,
20140324-M-Miami_Masters-R32-Denis_Istomin-Rafael_Nadal,2,F-DTL,10,5,5,0,0,8,2,,,,,,,,,,
20140324-M-Miami_Masters-R32-Denis_Istomin-Rafael_Nadal,2,F-IO,21,12,3,6,3,16,5,,,,,,,,,,
20140324-M-Miami_Masters-R32-Denis_Istomin-Rafael_Nadal,2,F-II,2,0,0,0,0,2,0,,,,,,,,,,
20140324-M-Miami_Masters-R32-Denis_Istomin-Rafael_Nadal,2,B-XC,11,3,0,1,2,5,6,,,,,,,,,,
20140324-M-Miami_Masters-R32-Denis_Istomin-Rafael_Nadal,2,B-DTM,6,1,0,0,1,4,2,,,,,,,,,,
20140324-M-Miami_Masters-R32-Denis_Istomin-Rafael_Nadal,2,B-DTL,4,2,1,1,0,4,0,,,,,,,,,,
20140324-M-Miami_Masters-R32-Denis_Istomin-Rafael_Nadal,2,B-IO,1,1,0,1,0,1,0,,,,,,,,,,
20140324-M-Miami_Masters-R32-Denis_Istomin-Rafael_Nadal,2,S-XC,1,0,0,0,0,1,0,,,,,,,,,,
20140324-M-Miami_Masters-R32-Denis_Istomin-Rafael_Nadal,2,S-DTM,7,1,0,1,0,7,0,,,,,,,,,,
20140324-M-Miami_Masters-R32-Denis_Istomin-Rafael_Nadal,2,S-DTL,1,0,0,0,0,1,0,,,,,,,,,,
20140325-M-Miami_Masters-R16-Fabio_Fognini-Rafael_Nadal,1,F-XC,31,10,0,2,8,8,23,,,,,,,,,,
20140325-M-Miami_Masters-R16-Fabio_Fognini-Rafael_Nadal,1,F-DTM,13,3,0,0,3,4,9,,,,,,,,,,
20140325-M-Miami_Masters-R16-Fabio_Fognini-Rafael_Nadal,1,F-DTL,5,2,1,0,1,4,1,,,,,,,,,,
20140325-M-Miami_Masters-R16-Fabio_Fognini-Rafael_Nadal,1,F-IO,10,1,0,0,1,4,6,,,,,,,,,,
20140325-M-Miami_Masters-R16-Fabio_Fognini-Rafael_Nadal,1,F-II,4,2,0,1,1,1,3,,,,,,,,,,
20140325-M-Miami_Masters-R16-Fabio_Fognini-Rafael_Nadal,1,B-XC,26,9,1,1,7,8,18,,,,,,,,,,
20140325-M-Miami_Masters-R16-Fabio_Fognini-Rafael_Nadal,1,B-DTM,23,2,0,0,2,6,17,,,,,,,,,,
20140325-M-Miami_Masters-R16-Fabio_Fognini-Rafael_Nadal,1,B-DTL,6,2,0,0,2,0,6,,,,,,,,,,
20140325-M-Miami_Masters-R16-Fabio_Fognini-Rafael_Nadal,1,B-IO,3,1,0,0,1,0,3,,,,,,,,,,
20140325-M-Miami_Masters-R16-Fabio_Fognini-Rafael_Nadal,2,F-XC,38,6,2,2,2,28,10,,,,,,,,,,
20140325-M-Miami_Masters-R16-Fabio_Fognini-Rafael_Nadal,2,F-DTM,13,0,0,0,0,9,4,,,,,,,,,,
20140325-M-Miami_Masters-R16-Fabio_Fognini-Rafael_Nadal,2,F-DTL,7,1,0,0,1,4,3,,,,,,,,,,
20140325-M-Miami_Masters-R16-Fabio_Fognini-Rafael_Nadal,2,F-IO,9,2,2,0,0,5,4,,,,,,,,,,
20140325-M-Miami_Masters-R16-Fabio_Fognini-Rafael_Nadal,2,F-II,2,1,1,0,0,2,0,,,,,,,,,,
20140325-M-Miami_Masters-R16-Fabio_Fognini-Rafael_Nadal,2,B-XC,16,4,1,0,3,9,7,,,,,,,,,,
20140325-M-Miami_Masters-R16-Fabio_Fognini-Rafael_Nadal,2,B-DTM,8,1,0,0,1,5,3,,,,,,,,,,
20140325-M-Miami_Masters-R16-Fabio_Fognini-Rafael_Nadal,2,B-DTL,8,2,2,0,0,7,1,,,,,,,,,,
20140325-M-Miami_Masters-R16-Fabio_Fognini-Rafael_Nadal,2,B-IO,4,1,0,1,0,4,0,,,,,,,,,,
20140325-M-Miami_Masters-R16-Fabio_Fognini-Rafael_Nadal,2,B-II,2,0,0,0,0,0,2,,,,,,,,,,
20140325-M-Miami_Masters-R16-Fabio_Fognini-Rafael_Nadal,2,S-XC,2,0,0,0,0,2,0,,,,,,,,,,
20140325-M-Miami_Masters-R16-Fabio_Fognini-Rafael_Nadal,2,S-DTM,1,0,0,0,0,0,1,,,,,,,,,,
20140325-M-Miami_Masters-R16-Fabio_Fognini-Rafael_Nadal,2,S-DTL,2,0,0,0,0,2,0,,,,,,,,,,
20140325-M-Miami_Masters-R16-Fabio_Fognini-Rafael_Nadal,2,S-IO,1,1,0,0,1,0,1,,,,,,,,,,
20140327-M-Miami_Masters-QF-Milos_Raonic-Rafael_Nadal,1,F-XC,56,12,4,2,6,23,33,,,,,,,,,,
20140327-M-Miami_Masters-QF-Milos_Raonic-Rafael_Nadal,1,F-DTM,48,5,0,0,5,22,26,,,,,,,,,,
20140327-M-Miami_Masters-QF-Milos_Raonic-Rafael_Nadal,1,F-DTL,2,2,1,0,1,1,1,,,,,,,,,,
20140327-M-Miami_Masters-QF-Milos_Raonic-Rafael_Nadal,1,F-IO,43,22,4,8,10,20,23,,,,,,,,,,
20140327-M-Miami_Masters-QF-Milos_Raonic-Rafael_Nadal,1,F-II,8,4,0,0,4,2,6,,,,,,,,,,
20140327-M-Miami_Masters-QF-Milos_Raonic-Rafael_Nadal,1,B-XC,13,6,0,3,3,6,7,,,,,,,,,,
20140327-M-Miami_Masters-QF-Milos_Raonic-Rafael_Nadal,1,B-DTM,29,9,0,1,8,10,19,,,,,,,,,,
20140327-M-Miami_Masters-QF-Milos_Raonic-Rafael_Nadal,1,B-DTL,13,2,0,0,2,5,8,,,,,,,,,,
20140327-M-Miami_Masters-QF-Milos_Raonic-Rafael_Nadal,1,B-IO,2,1,0,0,1,0,2,,,,,,,,,,
20140327-M-Miami_Masters-QF-Milos_Raonic-Rafael_Nadal,1,S-XC,1,0,0,0,0,0,1,,,,,,,,,,
20140327-M-Miami_Masters-QF-Milos_Raonic-Rafael_Nadal,1,S-DTM,4,0,0,0,0,3,1,,,,,,,,,,
20140327-M-Miami_Masters-QF-Milos_Raonic-Rafael_Nadal,2,F-XC,51,10,3,6,1,38,13,,,,,,,,,,
20140327-M-Miami_Masters-QF-Milos_Raonic-Rafael_Nadal,2,F-DTM,35,2,0,0,2,16,19,,,,,,,,,,
20140327-M-Miami_Masters-QF-Milos_Raonic-Rafael_Nadal,2,F-DTL,12,5,3,0,2,8,4,,,,,,,,,,
20140327-M-Miami_Masters-QF-Milos_Raonic-Rafael_Nadal,2,F-IO,42,16,8,4,4,27,15,,,,,,,,,,
20140327-M-Miami_Masters-QF-Milos_Raonic-Rafael_Nadal,2,F-II,5,1,1,0,0,4,1,,,,,,,,,,
20140327-M-Miami_Masters-QF-Milos_Raonic-Rafael_Nadal,2,B-XC,23,9,0,3,6,14,9,,,,,,,,,,
20140327-M-Miami_Masters-QF-Milos_Raonic-Rafael_Nadal,2,B-DTM,24,1,0,0,1,14,10,,,,,,,,,,
20140327-M-Miami_Masters-QF-Milos_Raonic-Rafael_Nadal,2,B-DTL,10,2,1,0,1,6,4,,,,,,,,,,
20140327-M-Miami_Masters-QF-Milos_Raonic-Rafael_Nadal,2,B-IO,5,1,1,0,0,3,2,,,,,,,,,,
20140327-M-Miami_Masters-QF-Milos_Raonic-Rafael_Nadal,2,S-XC,3,0,0,0,0,1,2,,,,,,,,,,
20140327-M-Miami_Masters-QF-Milos_Raonic-Rafael_Nadal,2,S-DTM,8,0,0,0,0,1,7,,,,,,,,,,
20140327-M-Miami_Masters-QF-Milos_Raonic-Rafael_Nadal,2,S-DTL,5,0,0,0,0,3,2,,,,,,,,,,
20140327-M-Miami_Masters-QF-Milos_Raonic-Rafael_Nadal,2,S-IO,1,0,0,0,0,0,1,,,,,,,,,,
20140330-M-Miami_Masters-F-Novak_Djokovic-Rafael_Nadal,1,F-XC,39,6,4,1,1,30,9,,,,,,,,,,
20140330-M-Miami_Masters-F-Novak_Djokovic-Rafael_Nadal,1,F-DTM,23,2,0,0,2,10,13,,,,,,,,,,
20140330-M-Miami_Masters-F-Novak_Djokovic-Rafael_Nadal,1,F-DTL,4,2,1,0,1,3,1,,,,,,,,,,
20140330-M-Miami_Masters-F-Novak_Djokovic-Rafael_Nadal,1,F-IO,24,6,2,3,1,17,7,,,,,,,,,,
20140330-M-Miami_Masters-F-Novak_Djokovic-Rafael_Nadal,1,B-XC,30,8,5,3,0,23,7,,,,,,,,,,
20140330-M-Miami_Masters-F-Novak_Djokovic-Rafael_Nadal,1,B-DTM,30,4,0,0,4,15,15,,,,,,,,,,
20140330-M-Miami_Masters-F-Novak_Djokovic-Rafael_Nadal,1,B-DTL,14,1,0,1,0,11,3,,,,,,,,,,
20140330-M-Miami_Masters-F-Novak_Djokovic-Rafael_Nadal,1,B-IO,6,1,0,1,0,3,3,,,,,,,,,,
20140330-M-Miami_Masters-F-Novak_Djokovic-Rafael_Nadal,1,S-XC,2,2,0,2,0,2,0,,,,,,,,,,
20140330-M-Miami_Masters-F-Novak_Djokovic-Rafael_Nadal,2,F-XC,41,6,2,3,1,20,21,,,,,,,,,,
20140330-M-Miami_Masters-F-Novak_Djokovic-Rafael_Nadal,2,F-DTM,37,4,0,1,3,10,27,,,,,,,,,,
20140330-M-Miami_Masters-F-Novak_Djokovic-Rafael_Nadal,2,F-DTL,10,3,2,0,1,3,7,,,,,,,,,,
20140330-M-Miami_Masters-F-Novak_Djokovic-Rafael_Nadal,2,F-IO,26,7,5,1,1,17,9,,,,,,,,,,
20140330-M-Miami_Masters-F-Novak_Djokovic-Rafael_Nadal,2,F-II,3,1,0,0,1,0,3,,,,,,,,,,
20140330-M-Miami_Masters-F-Novak_Djokovic-Rafael_Nadal,2,B-XC,16,4,1,1,2,5,11,,,,,,,,,,
20140330-M-Miami_Masters-F-Novak_Djokovic-Rafael_Nadal,2,B-DTM,27,5,0,0,5,10,17,,,,,,,,,,
20140330-M-Miami_Masters-F-Novak_Djokovic-Rafael_Nadal,2,B-DTL,7,0,0,0,0,1,6,,,,,,,,,,
20140330-M-Miami_Masters-F-Novak_Djokovic-Rafael_Nadal,2,B-IO,1,0,0,0,0,0,1,,,,,,,,,,
20140330-M-Miami_Masters-F-Novak_Djokovic-Rafael_Nadal,2,B-II,1,0,0,0,0,0,1,,,,,,,,,,
20140330-M-Miami_Masters-F-Novak_Djokovic-Rafael_Nadal,2,S-XC,2,0,0,0,0,1,1,,,,,,,,,,
20140330-M-Miami_Masters-F-Novak_Djokovic-Rafael_Nadal,2,S-DTM,9,0,0,0,0,2,7,,,,,,,,,,
20140330-M-Miami_Masters-F-Novak_Djokovic-Rafael_Nadal,2,S-DTL,2,1,0,0,1,0,2,,,,,,,,,,
20140330-M-Miami_Masters-F-Novak_Djokovic-Rafael_Nadal,2,S-IO,1,0,0,0,0,0,1,,,,,,,,,,
20140409-M-Itajai-R32-Mohamed_Safwat-Eduardo_Russi,1,F-XC,12,5,2,2,1,7,5,,,,,,,,,,
20140409-M-Itajai-R32-Mohamed_Safwat-Eduardo_Russi,1,F-DTM,7,1,0,0,1,2,5,,,,,,,,,,
20140409-M-Itajai-R32-Mohamed_Safwat-Eduardo_Russi,1,F-DTL,2,2,0,1,1,1,1,,,,,,,,,,
20140409-M-Itajai-R32-Mohamed_Safwat-Eduardo_Russi,1,F-IO,14,4,2,0,2,8,6,,,,,,,,,,
20140409-M-Itajai-R32-Mohamed_Safwat-Eduardo_Russi,1,F-II,2,2,2,0,0,2,0,,,,,,,,,,
20140409-M-Itajai-R32-Mohamed_Safwat-Eduardo_Russi,1,B-XC,5,2,1,0,1,3,2,,,,,,,,,,
20140409-M-Itajai-R32-Mohamed_Safwat-Eduardo_Russi,1,B-DTM,3,0,0,0,0,1,2,,,,,,,,,,
20140409-M-Itajai-R32-Mohamed_Safwat-Eduardo_Russi,1,B-DTL,1,1,0,0,1,0,1,,,,,,,,,,
20140409-M-Itajai-R32-Mohamed_Safwat-Eduardo_Russi,1,S-XC,4,0,0,0,0,2,2,,,,,,,,,,
20140409-M-Itajai-R32-Mohamed_Safwat-Eduardo_Russi,2,F-XC,3,1,0,1,0,3,0,,,,,,,,,,
20140409-M-Itajai-R32-Mohamed_Safwat-Eduardo_Russi,2,F-DTM,5,2,0,0,2,2,3,,,,,,,,,,
20140409-M-Itajai-R32-Mohamed_Safwat-Eduardo_Russi,2,F-DTL,1,0,0,0,0,1,0,,,,,,,,,,
20140409-M-Itajai-R32-Mohamed_Safwat-Eduardo_Russi,2,F-IO,3,1,0,0,1,1,2,,,,,,,,,,
20140409-M-Itajai-R32-Mohamed_Safwat-Eduardo_Russi,2,F-II,2,2,0,0,2,0,2,,,,,,,,,,
20140409-M-Itajai-R32-Mohamed_Safwat-Eduardo_Russi,2,B-XC,7,2,0,0,2,3,4,,,,,,,,,,
20140409-M-Itajai-R32-Mohamed_Safwat-Eduardo_Russi,2,B-DTM,8,3,0,0,3,3,5,,,,,,,,,,
20140409-M-Itajai-R32-Mohamed_Safwat-Eduardo_Russi,2,B-DTL,1,1,1,0,0,1,0,,,,,,,,,,
20140409-M-Itajai-R32-Mohamed_Safwat-Eduardo_Russi,2,B-IO,3,2,2,0,0,3,0,,,,,,,,,,
20140409-M-Itajai-R32-Mohamed_Safwat-Eduardo_Russi,2,S-XC,2,0,0,0,0,1,1,,,,,,,,,,
20140409-M-Itajai-R32-Mohamed_Safwat-Eduardo_Russi,2,S-DTM,3,0,0,0,0,1,2,,,,,,,,,,
20140409-M-Itajai-R32-Mohamed_Safwat-Eduardo_Russi,2,S-DTL,1,1,0,0,1,0,1,,,,,,,,,,
20140414-M-Sao_Paulo_CH-R32-Horacio_Zeballos-Ricardo_Hocevar,1,F-XC,29,5,3,1,1,20,9,,,,,,,,,,
20140414-M-Sao_Paulo_CH-R32-Horacio_Zeballos-Ricardo_Hocevar,1,F-DTM,21,6,1,0,5,11,10,,,,,,,,,,
20140414-M-Sao_Paulo_CH-R32-Horacio_Zeballos-Ricardo_Hocevar,1,F-DTL,3,2,1,0,1,2,1,,,,,,,,,,
20140414-M-Sao_Paulo_CH-R32-Horacio_Zeballos-Ricardo_Hocevar,1,F-IO,13,8,3,3,2,7,6,,,,,,,,,,
20140414-M-Sao_Paulo_CH-R32-Horacio_Zeballos-Ricardo_Hocevar,1,F-II,3,0,0,0,0,0,3,,,,,,,,,,
20140414-M-Sao_Paulo_CH-R32-Horacio_Zeballos-Ricardo_Hocevar,1,B-XC,8,2,0,0,2,4,4,,,,,,,,,,
20140414-M-Sao_Paulo_CH-R32-Horacio_Zeballos-Ricardo_Hocevar,1,B-DTM,5,1,0,0,1,2,3,,,,,,,,,,
20140414-M-Sao_Paulo_CH-R32-Horacio_Zeballos-Ricardo_Hocevar,1,B-DTL,7,3,0,0,3,4,3,,,,,,,,,,
20140414-M-Sao_Paulo_CH-R32-Horacio_Zeballos-Ricardo_Hocevar,1,S-XC,2,0,0,0,0,1,1,,,,,,,,,,
20140414-M-Sao_Paulo_CH-R32-Horacio_Zeballos-Ricardo_Hocevar,1,S-DTM,2,1,0,1,0,2,0,,,,,,,,,,
20140414-M-Sao_Paulo_CH-R32-Horacio_Zeballos-Ricardo_Hocevar,1,S-DTL,2,1,0,0,1,0,2,,,,,,,,,,
20140414-M-Sao_Paulo_CH-R32-Horacio_Zeballos-Ricardo_Hocevar,2,F-XC,14,2,1,0,1,8,6,,,,,,,,,,
20140414-M-Sao_Paulo_CH-R32-Horacio_Zeballos-Ricardo_Hocevar,2,F-DTM,13,3,0,0,3,5,8,,,,,,,,,,
20140414-M-Sao_Paulo_CH-R32-Horacio_Zeballos-Ricardo_Hocevar,2,F-DTL,2,2,2,0,0,2,0,,,,,,,,,,
20140414-M-Sao_Paulo_CH-R32-Horacio_Zeballos-Ricardo_Hocevar,2,F-IO,11,4,0,1,3,3,8,,,,,,,,,,
20140414-M-Sao_Paulo_CH-R32-Horacio_Zeballos-Ricardo_Hocevar,2,F-II,2,1,0,0,1,0,2,,,,,,,,,,
20140414-M-Sao_Paulo_CH-R32-Horacio_Zeballos-Ricardo_Hocevar,2,B-XC,11,2,2,0,0,8,3,,,,,,,,,,
20140414-M-Sao_Paulo_CH-R32-Horacio_Zeballos-Ricardo_Hocevar,2,B-DTM,17,2,0,0,2,5,12,,,,,,,,,,
20140414-M-Sao_Paulo_CH-R32-Horacio_Zeballos-Ricardo_Hocevar,2,B-DTL,9,3,0,1,2,5,4,,,,,,,,,,
20140414-M-Sao_Paulo_CH-R32-Horacio_Zeballos-Ricardo_Hocevar,2,B-IO,3,0,0,0,0,2,1,,,,,,,,,,
20140414-M-Sao_Paulo_CH-R32-Horacio_Zeballos-Ricardo_Hocevar,2,S-XC,2,1,1,0,0,1,1,,,,,,,,,,
20140414-M-Sao_Paulo_CH-R32-Horacio_Zeballos-Ricardo_Hocevar,2,S-DTM,1,1,0,0,1,0,1,,,,,,,,,,
20140414-M-Sao_Paulo_CH-R32-Horacio_Zeballos-Ricardo_Hocevar,2,S-DTL,1,1,0,0,1,0,1,,,,,,,,,,
20140415-M-San_Luis_Potosi_CH-R32-Paolo_Lorenzi-Mauricio_Echazu,1,F-XC,17,2,0,1,1,11,6,,,,,,,,,,
20140415-M-San_Luis_Potosi_CH-R32-Paolo_Lorenzi-Mauricio_Echazu,1,F-DTM,23,2,0,0,2,17,6,,,,,,,,,,
20140415-M-San_Luis_Potosi_CH-R32-Paolo_Lorenzi-Mauricio_Echazu,1,F-DTL,7,0,0,0,0,5,2,,,,,,,,,,
20140415-M-San_Luis_Potosi_CH-R32-Paolo_Lorenzi-Mauricio_Echazu,1,F-IO,20,8,2,2,4,14,6,,,,,,,,,,
20140415-M-San_Luis_Potosi_CH-R32-Paolo_Lorenzi-Mauricio_Echazu,1,B-XC,22,3,0,0,3,14,8,,,,,,,,,,
20140415-M-San_Luis_Potosi_CH-R32-Paolo_Lorenzi-Mauricio_Echazu,1,B-DTM,22,2,0,0,2,10,12,,,,,,,,,,
20140415-M-San_Luis_Potosi_CH-R32-Paolo_Lorenzi-Mauricio_Echazu,1,B-DTL,7,3,0,0,3,4,3,,,,,,,,,,
20140415-M-San_Luis_Potosi_CH-R32-Paolo_Lorenzi-Mauricio_Echazu,1,B-IO,5,0,0,0,0,4,1,,,,,,,,,,
20140415-M-San_Luis_Potosi_CH-R32-Paolo_Lorenzi-Mauricio_Echazu,1,S-XC,5,0,0,0,0,3,2,,,,,,,,,,
20140415-M-San_Luis_Potosi_CH-R32-Paolo_Lorenzi-Mauricio_Echazu,1,S-DTM,4,0,0,0,0,3,1,,,,,,,,,,
20140415-M-San_Luis_Potosi_CH-R32-Paolo_Lorenzi-Mauricio_Echazu,1,S-DTL,1,0,0,0,0,0,1,,,,,,,,,,
20140415-M-San_Luis_Potosi_CH-R32-Paolo_Lorenzi-Mauricio_Echazu,2,F-XC,37,11,2,2,7,11,26,,,,,,,,,,
20140415-M-San_Luis_Potosi_CH-R32-Paolo_Lorenzi-Mauricio_Echazu,2,F-DTM,35,8,0,0,8,9,26,,,,,,,,,,
20140415-M-San_Luis_Potosi_CH-R32-Paolo_Lorenzi-Mauricio_Echazu,2,F-DTL,8,3,0,0,3,3,5,,,,,,,,,,
20140415-M-San_Luis_Potosi_CH-R32-Paolo_Lorenzi-Mauricio_Echazu,2,F-IO,28,8,4,0,4,13,15,,,,,,,,,,
20140415-M-San_Luis_Potosi_CH-R32-Paolo_Lorenzi-Mauricio_Echazu,2,F-II,1,1,0,1,0,1,0,,,,,,,,,,
20140415-M-San_Luis_Potosi_CH-R32-Paolo_Lorenzi-Mauricio_Echazu,2,B-XC,27,6,0,0,6,5,22,,,,,,,,,,
20140415-M-San_Luis_Potosi_CH-R32-Paolo_Lorenzi-Mauricio_Echazu,2,B-DTM,14,2,0,0,2,4,10,,,,,,,,,,
20140415-M-San_Luis_Potosi_CH-R32-Paolo_Lorenzi-Mauricio_Echazu,2,B-DTL,1,0,0,0,0,0,1,,,,,,,,,,
20140415-M-San_Luis_Potosi_CH-R32-Paolo_Lorenzi-Mauricio_Echazu,2,B-IO,3,2,1,0,1,2,1,,,,,,,,,,
20140415-M-San_Luis_Potosi_CH-R32-Paolo_Lorenzi-Mauricio_Echazu,2,S-DTM,1,0,0,0,0,0,1,,,,,,,,,,
20140416-M-Monte_Carlo_Masters-R32-Rafael_Nadal-Teymuraz_Gabashvili,1,F-XC,39,7,2,2,3,29,10,,,,,,,,,,
20140416-M-Monte_Carlo_Masters-R32-Rafael_Nadal-Teymuraz_Gabashvili,1,F-DTM,17,0,0,0,0,11,6,,,,,,,,,,
20140416-M-Monte_Carlo_Masters-R32-Rafael_Nadal-Teymuraz_Gabashvili,1,F-DTL,7,4,2,1,1,5,2,,,,,,,,,,
20140416-M-Monte_Carlo_Masters-R32-Rafael_Nadal-Teymuraz_Gabashvili,1,F-IO,18,10,7,2,1,13,5,,,,,,,,,,
20140416-M-Monte_Carlo_Masters-R32-Rafael_Nadal-Teymuraz_Gabashvili,1,F-II,4,0,0,0,0,3,1,,,,,,,,,,
20140416-M-Monte_Carlo_Masters-R32-Rafael_Nadal-Teymuraz_Gabashvili,1,B-XC,27,6,3,1,2,15,12,,,,,,,,,,
20140416-M-Monte_Carlo_Masters-R32-Rafael_Nadal-Teymuraz_Gabashvili,1,B-DTM,28,4,0,2,2,14,14,,,,,,,,,,
20140416-M-Monte_Carlo_Masters-R32-Rafael_Nadal-Teymuraz_Gabashvili,1,B-DTL,6,2,2,0,0,3,3,,,,,,,,,,
20140416-M-Monte_Carlo_Masters-R32-Rafael_Nadal-Teymuraz_Gabashvili,1,B-IO,2,0,0,0,0,1,1,,,,,,,,,,
20140416-M-Monte_Carlo_Masters-R32-Rafael_Nadal-Teymuraz_Gabashvili,1,B-II,2,1,1,0,0,2,0,,,,,,,,,,
20140416-M-Monte_Carlo_Masters-R32-Rafael_Nadal-Teymuraz_Gabashvili,1,S-DTM,4,0,0,0,0,1,3,,,,,,,,,,
20140416-M-Monte_Carlo_Masters-R32-Rafael_Nadal-Teymuraz_Gabashvili,1,S-DTL,3,1,0,0,1,1,2,,,,,,,,,,
20140416-M-Monte_Carlo_Masters-R32-Rafael_Nadal-Teymuraz_Gabashvili,2,F-XC,45,9,2,2,5,25,20,,,,,,,,,,
20140416-M-Monte_Carlo_Masters-R32-Rafael_Nadal-Teymuraz_Gabashvili,2,F-DTM,15,2,0,0,2,2,13,,,,,,,,,,
20140416-M-Monte_Carlo_Masters-R32-Rafael_Nadal-Teymuraz_Gabashvili,2,F-DTL,6,2,1,0,1,3,3,,,,,,,,,,
20140416-M-Monte_Carlo_Masters-R32-Rafael_Nadal-Teymuraz_Gabashvili,2,F-IO,23,10,5,1,4,10,13,,,,,,,,,,
20140416-M-Monte_Carlo_Masters-R32-Rafael_Nadal-Teymuraz_Gabashvili,2,F-II,3,1,1,0,0,2,1,,,,,,,,,,
20140416-M-Monte_Carlo_Masters-R32-Rafael_Nadal-Teymuraz_Gabashvili,2,B-XC,21,3,0,1,2,7,14,,,,,,,,,,
20140416-M-Monte_Carlo_Masters-R32-Rafael_Nadal-Teymuraz_Gabashvili,2,B-DTM,22,0,0,0,0,6,16,,,,,,,,,,
20140416-M-Monte_Carlo_Masters-R32-Rafael_Nadal-Teymuraz_Gabashvili,2,B-DTL,10,2,0,0,2,4,6,,,,,,,,,,
20140416-M-Monte_Carlo_Masters-R32-Rafael_Nadal-Teymuraz_Gabashvili,2,B-IO,8,0,0,0,0,2,6,,,,,,,,,,
20140416-M-Monte_Carlo_Masters-R32-Rafael_Nadal-Teymuraz_Gabashvili,2,S-XC,1,0,0,0,0,0,1,,,,,,,,,,
20140416-M-Monte_Carlo_Masters-R32-Rafael_Nadal-Teymuraz_Gabashvili,2,S-DTM,2,0,0,0,0,0,2,,,,,,,,,,
20140417-M-Monte_Carlo_Masters-R16-Andreas_Seppi-Rafael_Nadal,1,F-XC,41,4,0,0,4,16,25,,,,,,,,,,
20140417-M-Monte_Carlo_Masters-R16-Andreas_Seppi-Rafael_Nadal,1,F-DTM,21,2,0,0,2,7,14,,,,,,,,,,
20140417-M-Monte_Carlo_Masters-R16-Andreas_Seppi-Rafael_Nadal,1,F-DTL,8,4,1,0,3,3,5,,,,,,,,,,
20140417-M-Monte_Carlo_Masters-R16-Andreas_Seppi-Rafael_Nadal,1,F-IO,13,4,0,3,1,7,6,,,,,,,,,,
20140417-M-Monte_Carlo_Masters-R16-Andreas_Seppi-Rafael_Nadal,1,F-II,3,2,1,0,1,1,2,,,,,,,,,,
20140417-M-Monte_Carlo_Masters-R16-Andreas_Seppi-Rafael_Nadal,1,B-XC,31,5,1,0,4,13,18,,,,,,,,,,
20140417-M-Monte_Carlo_Masters-R16-Andreas_Seppi-Rafael_Nadal,1,B-DTM,21,1,0,0,1,7,14,,,,,,,,,,
20140417-M-Monte_Carlo_Masters-R16-Andreas_Seppi-Rafael_Nadal,1,B-DTL,8,0,0,0,0,2,6,,,,,,,,,,
20140417-M-Monte_Carlo_Masters-R16-Andreas_Seppi-Rafael_Nadal,1,B-IO,2,1,0,0,1,1,1,,,,,,,,,,
20140417-M-Monte_Carlo_Masters-R16-Andreas_Seppi-Rafael_Nadal,1,S-XC,5,2,0,0,2,0,5,,,,,,,,,,
20140417-M-Monte_Carlo_Masters-R16-Andreas_Seppi-Rafael_Nadal,1,S-DTM,5,0,0,0,0,2,3,,,,,,,,,,
20140417-M-Monte_Carlo_Masters-R16-Andreas_Seppi-Rafael_Nadal,2,F-XC,60,12,5,3,4,39,21,,,,,,,,,,
20140417-M-Monte_Carlo_Masters-R16-Andreas_Seppi-Rafael_Nadal,2,F-DTM,10,1,0,0,1,4,6,,,,,,,,,,
20140417-M-Monte_Carlo_Masters-R16-Andreas_Seppi-Rafael_Nadal,2,F-DTL,18,10,4,3,3,14,4,,,,,,,,,,
20140417-M-Monte_Carlo_Masters-R16-Andreas_Seppi-Rafael_Nadal,2,F-IO,23,9,4,4,1,22,1,,,,,,,,,,
20140417-M-Monte_Carlo_Masters-R16-Andreas_Seppi-Rafael_Nadal,2,F-II,6,2,1,1,0,6,0,,,,,,,,,,
20140417-M-Monte_Carlo_Masters-R16-Andreas_Seppi-Rafael_Nadal,2,B-XC,18,2,0,1,1,10,8,,,,,,,,,,
20140417-M-Monte_Carlo_Masters-R16-Andreas_Seppi-Rafael_Nadal,2,B-DTM,15,1,0,0,1,5,10,,,,,,,,,,
20140417-M-Monte_Carlo_Masters-R16-Andreas_Seppi-Rafael_Nadal,2,B-DTL,9,1,0,0,1,5,4,,,,,,,,,,
20140417-M-Monte_Carlo_Masters-R16-Andreas_Seppi-Rafael_Nadal,2,B-IO,6,4,0,0,4,1,5,,,,,,,,,,
20140417-M-Monte_Carlo_Masters-R16-Andreas_Seppi-Rafael_Nadal,2,S-XC,2,0,0,0,0,1,1,,,,,,,,,,
20140417-M-Monte_Carlo_Masters-R16-Andreas_Seppi-Rafael_Nadal,2,S-DTM,2,0,0,0,0,0,2,,,,,,,,,,
20140417-M-Monte_Carlo_Masters-R16-Andreas_Seppi-Rafael_Nadal,2,S-DTL,3,1,0,0,1,1,2,,,,,,,,,,
20140418-M-Monte_Carlo_Masters-QF-David_Ferrer-Rafael_Nadal,1,F-XC,140,11,1,2,8,66,74,,,,,,,,,,
20140418-M-Monte_Carlo_Masters-QF-David_Ferrer-Rafael_Nadal,1,F-DTM,31,2,0,1,1,13,18,,,,,,,,,,
20140418-M-Monte_Carlo_Masters-QF-David_Ferrer-Rafael_Nadal,1,F-DTL,10,6,1,2,3,6,4,,,,,,,,,,
20140418-M-Monte_Carlo_Masters-QF-David_Ferrer-Rafael_Nadal,1,F-IO,24,13,7,2,4,14,10,,,,,,,,,,
20140418-M-Monte_Carlo_Masters-QF-David_Ferrer-Rafael_Nadal,1,F-II,13,3,3,0,0,10,3,,,,,,,,,,
20140418-M-Monte_Carlo_Masters-QF-David_Ferrer-Rafael_Nadal,1,B-XC,32,7,2,3,2,15,17,,,,,,,,,,
20140418-M-Monte_Carlo_Masters-QF-David_Ferrer-Rafael_Nadal,1,B-DTM,32,2,0,0,2,12,20,,,,,,,,,,
20140418-M-Monte_Carlo_Masters-QF-David_Ferrer-Rafael_Nadal,1,B-DTL,52,7,0,1,6,23,29,,,,,,,,,,
20140418-M-Monte_Carlo_Masters-QF-David_Ferrer-Rafael_Nadal,1,B-IO,10,0,0,0,0,7,3,,,,,,,,,,
20140418-M-Monte_Carlo_Masters-QF-David_Ferrer-Rafael_Nadal,1,S-DTM,1,0,0,0,0,0,1,,,,,,,,,,
20140418-M-Monte_Carlo_Masters-QF-David_Ferrer-Rafael_Nadal,1,S-DTL,1,0,0,0,0,0,1,,,,,,,,,,
20140418-M-Monte_Carlo_Masters-QF-David_Ferrer-Rafael_Nadal,2,F-XC,46,5,0,3,2,24,22,,,,,,,,,,
20140418-M-Monte_Carlo_Masters-QF-David_Ferrer-Rafael_Nadal,2,F-DTM,18,3,0,0,3,8,10,,,,,,,,,,
20140418-M-Monte_Carlo_Masters-QF-David_Ferrer-Rafael_Nadal,2,F-DTL,14,7,2,2,3,8,6,,,,,,,,,,
20140418-M-Monte_Carlo_Masters-QF-David_Ferrer-Rafael_Nadal,2,F-IO,40,10,5,2,3,26,14,,,,,,,,,,
20140418-M-Monte_Carlo_Masters-QF-David_Ferrer-Rafael_Nadal,2,F-II,27,9,4,2,3,17,10,,,,,,,,,,
20140418-M-Monte_Carlo_Masters-QF-David_Ferrer-Rafael_Nadal,2,B-XC,68,13,2,4,7,30,38,,,,,,,,,,
20140418-M-Monte_Carlo_Masters-QF-David_Ferrer-Rafael_Nadal,2,B-DTM,43,4,0,0,4,21,22,,,,,,,,,,
20140418-M-Monte_Carlo_Masters-QF-David_Ferrer-Rafael_Nadal,2,B-DTL,67,16,2,3,11,34,33,,,,,,,,,,
20140418-M-Monte_Carlo_Masters-QF-David_Ferrer-Rafael_Nadal,2,B-IO,9,1,0,0,1,6,3,,,,,,,,,,
20140418-M-Monte_Carlo_Masters-QF-David_Ferrer-Rafael_Nadal,2,B-II,1,0,0,0,0,0,1,,,,,,,,,,
20140418-M-Monte_Carlo_Masters-QF-David_Ferrer-Rafael_Nadal,2,S-XC,4,0,0,0,0,1,3,,,,,,,,,,
20140418-M-Monte_Carlo_Masters-QF-David_Ferrer-Rafael_Nadal,2,S-DTM,5,0,0,0,0,1,4,,,,,,,,,,
20140418-M-Monte_Carlo_Masters-QF-David_Ferrer-Rafael_Nadal,2,S-DTL,2,0,0,0,0,1,1,,,,,,,,,,
20140423-M-Barcelona-R32-Albert_Ramos-Rafael_Nadal,1,F-XC,63,17,7,2,8,32,31,,,,,,,,,,
20140423-M-Barcelona-R32-Albert_Ramos-Rafael_Nadal,1,F-DTM,38,3,0,1,2,17,21,,,,,,,,,,
20140423-M-Barcelona-R32-Albert_Ramos-Rafael_Nadal,1,F-DTL,10,2,0,0,2,3,7,,,,,,,,,,
20140423-M-Barcelona-R32-Albert_Ramos-Rafael_Nadal,1,F-IO,37,11,4,1,6,17,20,,,,,,,,,,
20140423-M-Barcelona-R32-Albert_Ramos-Rafael_Nadal,1,F-II,2,1,0,0,1,0,2,,,,,,,,,,
20140423-M-Barcelona-R32-Albert_Ramos-Rafael_Nadal,1,B-XC,70,8,0,0,8,26,44,,,,,,,,,,
20140423-M-Barcelona-R32-Albert_Ramos-Rafael_Nadal,1,B-DTM,38,2,0,0,2,14,24,,,,,,,,,,
20140423-M-Barcelona-R32-Albert_Ramos-Rafael_Nadal,1,B-DTL,10,3,2,0,1,4,6,,,,,,,,,,
20140423-M-Barcelona-R32-Albert_Ramos-Rafael_Nadal,1,B-IO,2,0,0,0,0,1,1,,,,,,,,,,
20140423-M-Barcelona-R32-Albert_Ramos-Rafael_Nadal,1,S-XC,5,0,0,0,0,3,2,,,,,,,,,,
20140423-M-Barcelona-R32-Albert_Ramos-Rafael_Nadal,1,S-DTM,5,0,0,0,0,0,5,,,,,,,,,,
20140423-M-Barcelona-R32-Albert_Ramos-Rafael_Nadal,1,S-DTL,1,0,0,0,0,1,0,,,,,,,,,,
20140423-M-Barcelona-R32-Albert_Ramos-Rafael_Nadal,2,F-XC,56,12,3,5,4,33,23,,,,,,,,,,
20140423-M-Barcelona-R32-Albert_Ramos-Rafael_Nadal,2,F-DTM,36,4,0,0,4,22,14,,,,,,,,,,
20140423-M-Barcelona-R32-Albert_Ramos-Rafael_Nadal,2,F-DTL,19,5,1,1,3,10,9,,,,,,,,,,
20140423-M-Barcelona-R32-Albert_Ramos-Rafael_Nadal,2,F-IO,70,10,2,4,4,47,23,,,,,,,,,,
20140423-M-Barcelona-R32-Albert_Ramos-Rafael_Nadal,2,F-II,14,8,3,2,3,10,4,,,,,,,,,,
20140423-M-Barcelona-R32-Albert_Ramos-Rafael_Nadal,2,B-XC,44,2,0,0,2,24,20,,,,,,,,,,
20140423-M-Barcelona-R32-Albert_Ramos-Rafael_Nadal,2,B-DTM,22,2,0,0,2,12,10,,,,,,,,,,
20140423-M-Barcelona-R32-Albert_Ramos-Rafael_Nadal,2,B-DTL,10,4,1,1,2,4,6,,,,,,,,,,
20140423-M-Barcelona-R32-Albert_Ramos-Rafael_Nadal,2,B-IO,6,0,0,0,0,3,3,,,,,,,,,,
20140423-M-Barcelona-R32-Albert_Ramos-Rafael_Nadal,2,S-XC,5,2,0,1,1,1,4,,,,,,,,,,
20140423-M-Barcelona-R32-Albert_Ramos-Rafael_Nadal,2,S-DTM,2,0,0,0,0,0,2,,,,,,,,,,
20140423-M-Barcelona-R32-Albert_Ramos-Rafael_Nadal,2,S-DTL,1,0,0,0,0,0,1,,,,,,,,,,
20140424-M-Barcelona-R16-Ivan_Dodig-Rafael_Nadal,1,F-XC,44,3,1,1,1,21,23,,,,,,,,,,
20140424-M-Barcelona-R16-Ivan_Dodig-Rafael_Nadal,1,F-DTM,20,4,0,0,4,4,16,,,,,,,,,,
20140424-M-Barcelona-R16-Ivan_Dodig-Rafael_Nadal,1,F-DTL,15,6,1,3,2,7,8,,,,,,,,,,
20140424-M-Barcelona-R16-Ivan_Dodig-Rafael_Nadal,1,F-IO,6,3,0,0,3,0,6,,,,,,,,,,
20140424-M-Barcelona-R16-Ivan_Dodig-Rafael_Nadal,1,F-II,3,0,0,0,0,1,2,,,,,,,,,,
20140424-M-Barcelona-R16-Ivan_Dodig-Rafael_Nadal,1,B-XC,28,3,0,1,2,10,18,,,,,,,,,,
20140424-M-Barcelona-R16-Ivan_Dodig-Rafael_Nadal,1,B-DTM,34,1,0,0,1,6,28,,,,,,,,,,
20140424-M-Barcelona-R16-Ivan_Dodig-Rafael_Nadal,1,B-DTL,11,3,0,0,3,2,9,,,,,,,,,,
20140424-M-Barcelona-R16-Ivan_Dodig-Rafael_Nadal,1,B-IO,2,0,0,0,0,1,1,,,,,,,,,,
20140424-M-Barcelona-R16-Ivan_Dodig-Rafael_Nadal,1,S-DTM,9,1,0,0,1,3,6,,,,,,,,,,
20140424-M-Barcelona-R16-Ivan_Dodig-Rafael_Nadal,1,S-DTL,3,0,0,0,0,0,3,,,,,,,,,,
20140424-M-Barcelona-R16-Ivan_Dodig-Rafael_Nadal,2,F-XC,74,11,2,3,6,56,18,,,,,,,,,,
20140424-M-Barcelona-R16-Ivan_Dodig-Rafael_Nadal,2,F-DTM,18,0,0,0,0,10,8,,,,,,,,,,
20140424-M-Barcelona-R16-Ivan_Dodig-Rafael_Nadal,2,F-DTL,8,5,2,2,1,7,1,,,,,,,,,,
20140424-M-Barcelona-R16-Ivan_Dodig-Rafael_Nadal,2,F-IO,35,14,3,10,1,26,9,,,,,,,,,,
20140424-M-Barcelona-R16-Ivan_Dodig-Rafael_Nadal,2,F-II,8,2,1,0,1,4,4,,,,,,,,,,
20140424-M-Barcelona-R16-Ivan_Dodig-Rafael_Nadal,2,B-XC,26,6,0,3,3,15,11,,,,,,,,,,
20140424-M-Barcelona-R16-Ivan_Dodig-Rafael_Nadal,2,B-DTM,14,2,0,0,2,8,6,,,,,,,,,,
20140424-M-Barcelona-R16-Ivan_Dodig-Rafael_Nadal,2,B-DTL,8,2,1,1,0,7,1,,,,,,,,,,
20140424-M-Barcelona-R16-Ivan_Dodig-Rafael_Nadal,2,B-IO,1,0,0,0,0,0,1,,,,,,,,,,
20140424-M-Barcelona-R16-Ivan_Dodig-Rafael_Nadal,2,S-XC,2,1,0,0,1,1,1,,,,,,,,,,
20140424-M-Barcelona-R16-Ivan_Dodig-Rafael_Nadal,2,S-DTM,1,0,0,0,0,1,0,,,,,,,,,,
20140425-M-Barcelona-QF-Nicolas_Almagro-Rafael_Nadal,1,F-XC,133,18,4,6,8,70,63,,,,,,,,,,
20140425-M-Barcelona-QF-Nicolas_Almagro-Rafael_Nadal,1,F-DTM,31,2,0,2,0,13,18,,,,,,,,,,
20140425-M-Barcelona-QF-Nicolas_Almagro-Rafael_Nadal,1,F-DTL,31,22,6,1,15,13,18,,,,,,,,,,
20140425-M-Barcelona-QF-Nicolas_Almagro-Rafael_Nadal,1,F-IO,22,12,4,4,4,15,7,,,,,,,,,,
20140425-M-Barcelona-QF-Nicolas_Almagro-Rafael_Nadal,1,F-II,7,1,1,0,0,5,2,,,,,,,,,,
20140425-M-Barcelona-QF-Nicolas_Almagro-Rafael_Nadal,1,B-XC,56,21,9,4,8,31,25,,,,,,,,,,
20140425-M-Barcelona-QF-Nicolas_Almagro-Rafael_Nadal,1,B-DTM,39,3,0,1,2,16,23,,,,,,,,,,
20140425-M-Barcelona-QF-Nicolas_Almagro-Rafael_Nadal,1,B-DTL,23,8,2,0,6,11,12,,,,,,,,,,
20140425-M-Barcelona-QF-Nicolas_Almagro-Rafael_Nadal,1,B-IO,12,4,1,2,1,7,5,,,,,,,,,,
20140425-M-Barcelona-QF-Nicolas_Almagro-Rafael_Nadal,1,S-XC,1,0,0,0,0,1,0,,,,,,,,,,
20140425-M-Barcelona-QF-Nicolas_Almagro-Rafael_Nadal,1,S-DTM,6,0,0,0,0,1,5,,,,,,,,,,
20140425-M-Barcelona-QF-Nicolas_Almagro-Rafael_Nadal,1,S-DTL,2,1,0,0,1,0,2,,,,,,,,,,
20140425-M-Barcelona-QF-Nicolas_Almagro-Rafael_Nadal,2,F-XC,67,7,1,0,6,32,35,,,,,,,,,,
20140425-M-Barcelona-QF-Nicolas_Almagro-Rafael_Nadal,2,F-DTM,24,3,0,0,3,11,13,,,,,,,,,,
20140425-M-Barcelona-QF-Nicolas_Almagro-Rafael_Nadal,2,F-DTL,16,3,3,0,0,11,5,,,,,,,,,,
20140425-M-Barcelona-QF-Nicolas_Almagro-Rafael_Nadal,2,F-IO,45,12,6,3,3,27,18,,,,,,,,,,
20140425-M-Barcelona-QF-Nicolas_Almagro-Rafael_Nadal,2,F-II,11,4,2,1,1,6,5,,,,,,,,,,
20140425-M-Barcelona-QF-Nicolas_Almagro-Rafael_Nadal,2,B-XC,71,10,4,3,3,37,34,,,,,,,,,,
20140425-M-Barcelona-QF-Nicolas_Almagro-Rafael_Nadal,2,B-DTM,42,1,0,0,1,18,24,,,,,,,,,,
20140425-M-Barcelona-QF-Nicolas_Almagro-Rafael_Nadal,2,B-DTL,31,5,2,1,2,17,14,,,,,,,,,,
20140425-M-Barcelona-QF-Nicolas_Almagro-Rafael_Nadal,2,B-IO,5,0,0,0,0,4,1,,,,,,,,,,
20140425-M-Barcelona-QF-Nicolas_Almagro-Rafael_Nadal,2,B-II,1,0,0,0,0,1,0,,,,,,,,,,
20140425-M-Barcelona-QF-Nicolas_Almagro-Rafael_Nadal,2,S-XC,2,0,0,0,0,1,1,,,,,,,,,,
20140425-M-Barcelona-QF-Nicolas_Almagro-Rafael_Nadal,2,S-DTM,11,1,0,1,0,3,8,,,,,,,,,,
20140425-M-Barcelona-QF-Nicolas_Almagro-Rafael_Nadal,2,S-DTL,3,1,0,1,0,2,1,,,,,,,,,,
20140425-M-Barcelona-QF-Nicolas_Almagro-Rafael_Nadal,2,S-IO,1,0,0,0,0,1,0,,,,,,,,,,
20140429-M-Cali_CH-R32-Mathias_Bourgue-Gonzalo_Lama,1,F-XC,35,15,5,3,7,18,17,,,,,,,,,,
20140429-M-Cali_CH-R32-Mathias_Bourgue-Gonzalo_Lama,1,F-DTM,8,0,0,0,0,4,4,,,,,,,,,,
20140429-M-Cali_CH-R32-Mathias_Bourgue-Gonzalo_Lama,1,F-DTL,6,4,1,0,3,2,4,,,,,,,,,,
20140429-M-Cali_CH-R32-Mathias_Bourgue-Gonzalo_Lama,1,F-IO,8,4,1,1,2,6,2,,,,,,,,,,
20140429-M-Cali_CH-R32-Mathias_Bourgue-Gonzalo_Lama,1,F-II,3,2,1,1,0,2,1,,,,,,,,,,
20140429-M-Cali_CH-R32-Mathias_Bourgue-Gonzalo_Lama,1,B-XC,26,6,2,1,3,13,13,,,,,,,,,,
20140429-M-Cali_CH-R32-Mathias_Bourgue-Gonzalo_Lama,1,B-DTM,20,1,0,0,1,7,13,,,,,,,,,,
20140429-M-Cali_CH-R32-Mathias_Bourgue-Gonzalo_Lama,1,B-DTL,6,1,0,0,1,2,4,,,,,,,,,,
20140429-M-Cali_CH-R32-Mathias_Bourgue-Gonzalo_Lama,1,B-IO,6,4,1,1,2,2,4,,,,,,,,,,
20140429-M-Cali_CH-R32-Mathias_Bourgue-Gonzalo_Lama,1,S-XC,3,2,0,0,2,0,3,,,,,,,,,,
20140429-M-Cali_CH-R32-Mathias_Bourgue-Gonzalo_Lama,1,S-DTM,3,0,0,0,0,1,2,,,,,,,,,,
20140429-M-Cali_CH-R32-Mathias_Bourgue-Gonzalo_Lama,2,F-XC,32,9,2,3,4,20,12,,,,,,,,,,
20140429-M-Cali_CH-R32-Mathias_Bourgue-Gonzalo_Lama,2,F-DTM,16,0,0,0,0,12,4,,,,,,,,,,
20140429-M-Cali_CH-R32-Mathias_Bourgue-Gonzalo_Lama,2,F-DTL,16,2,0,2,0,10,6,,,,,,,,,,
20140429-M-Cali_CH-R32-Mathias_Bourgue-Gonzalo_Lama,2,F-IO,25,7,2,2,3,13,12,,,,,,,,,,
20140429-M-Cali_CH-R32-Mathias_Bourgue-Gonzalo_Lama,2,F-II,2,2,0,2,0,2,0,,,,,,,,,,
20140429-M-Cali_CH-R32-Mathias_Bourgue-Gonzalo_Lama,2,B-XC,6,0,0,0,0,3,3,,,,,,,,,,
20140429-M-Cali_CH-R32-Mathias_Bourgue-Gonzalo_Lama,2,B-DTM,10,0,0,0,0,6,4,,,,,,,,,,
20140429-M-Cali_CH-R32-Mathias_Bourgue-Gonzalo_Lama,2,B-DTL,2,1,0,1,0,2,0,,,,,,,,,,
20140429-M-Cali_CH-R32-Mathias_Bourgue-Gonzalo_Lama,2,S-XC,3,0,0,0,0,2,1,,,,,,,,,,
20140429-M-Cali_CH-R32-Mathias_Bourgue-Gonzalo_Lama,2,S-DTM,3,1,0,0,1,1,2,,,,,,,,,,
20140429-M-Cali_CH-R32-Mathias_Bourgue-Gonzalo_Lama,2,S-DTL,1,0,0,0,0,0,1,,,,,,,,,,
20140507-M-Madrid_Masters-R32-Rafael_Nadal-Juan_Monaco,1,F-XC,60,11,4,2,5,43,17,,,,,,,,,,
20140507-M-Madrid_Masters-R32-Rafael_Nadal-Juan_Monaco,1,F-DTM,18,0,0,0,0,9,9,,,,,,,,,,
20140507-M-Madrid_Masters-R32-Rafael_Nadal-Juan_Monaco,1,F-DTL,13,8,4,1,3,6,7,,,,,,,,,,
20140507-M-Madrid_Masters-R32-Rafael_Nadal-Juan_Monaco,1,F-IO,16,7,2,4,1,11,5,,,,,,,,,,
20140507-M-Madrid_Masters-R32-Rafael_Nadal-Juan_Monaco,1,F-II,6,1,0,0,1,4,2,,,,,,,,,,
20140507-M-Madrid_Masters-R32-Rafael_Nadal-Juan_Monaco,1,B-XC,23,2,1,0,1,17,6,,,,,,,,,,
20140507-M-Madrid_Masters-R32-Rafael_Nadal-Juan_Monaco,1,B-DTM,21,1,0,0,1,11,10,,,,,,,,,,
20140507-M-Madrid_Masters-R32-Rafael_Nadal-Juan_Monaco,1,B-DTL,10,2,0,0,2,7,3,,,,,,,,,,
20140507-M-Madrid_Masters-R32-Rafael_Nadal-Juan_Monaco,1,B-IO,4,0,0,0,0,3,1,,,,,,,,,,
20140507-M-Madrid_Masters-R32-Rafael_Nadal-Juan_Monaco,1,S-IO,1,0,0,0,0,1,0,,,,,,,,,,
20140507-M-Madrid_Masters-R32-Rafael_Nadal-Juan_Monaco,2,F-XC,45,5,1,0,4,19,26,,,,,,,,,,
20140507-M-Madrid_Masters-R32-Rafael_Nadal-Juan_Monaco,2,F-DTM,23,1,0,0,1,6,17,,,,,,,,,,
20140507-M-Madrid_Masters-R32-Rafael_Nadal-Juan_Monaco,2,F-DTL,1,1,1,0,0,1,0,,,,,,,,,,
20140507-M-Madrid_Masters-R32-Rafael_Nadal-Juan_Monaco,2,F-IO,7,1,1,0,0,2,5,,,,,,,,,,
20140507-M-Madrid_Masters-R32-Rafael_Nadal-Juan_Monaco,2,F-II,2,1,0,0,1,0,2,,,,,,,,,,
20140507-M-Madrid_Masters-R32-Rafael_Nadal-Juan_Monaco,2,B-XC,38,7,1,2,4,14,24,,,,,,,,,,
20140507-M-Madrid_Masters-R32-Rafael_Nadal-Juan_Monaco,2,B-DTM,31,2,0,0,2,11,20,,,,,,,,,,
20140507-M-Madrid_Masters-R32-Rafael_Nadal-Juan_Monaco,2,B-DTL,7,4,1,0,3,1,6,,,,,,,,,,
20140507-M-Madrid_Masters-R32-Rafael_Nadal-Juan_Monaco,2,B-IO,4,0,0,0,0,0,4,,,,,,,,,,
20140507-M-Madrid_Masters-R32-Rafael_Nadal-Juan_Monaco,2,S-XC,3,1,0,0,1,1,2,,,,,,,,,,
20140507-M-Madrid_Masters-R32-Rafael_Nadal-Juan_Monaco,2,S-DTM,2,1,0,0,1,0,2,,,,,,,,,,
20140507-M-Madrid_Masters-R32-Rafael_Nadal-Juan_Monaco,2,S-DTL,2,0,0,0,0,0,2,,,,,,,,,,
20140508-M-Madrid_Masters-R16-Jarkko_Nieminen-Rafael_Nadal,1,F-XC,12,3,1,2,0,7,5,,,,,,,,,,
20140508-M-Madrid_Masters-R16-Jarkko_Nieminen-Rafael_Nadal,1,F-DTM,17,2,0,0,2,5,12,,,,,,,,,,
20140508-M-Madrid_Masters-R16-Jarkko_Nieminen-Rafael_Nadal,1,F-DTL,15,4,3,0,1,8,7,,,,,,,,,,
20140508-M-Madrid_Masters-R16-Jarkko_Nieminen-Rafael_Nadal,1,F-IO,14,4,1,2,1,6,8,,,,,,,,,,
20140508-M-Madrid_Masters-R16-Jarkko_Nieminen-Rafael_Nadal,1,F-II,1,0,0,0,0,0,1,,,,,,,,,,
20140508-M-Madrid_Masters-R16-Jarkko_Nieminen-Rafael_Nadal,1,B-XC,42,6,1,2,3,17,25,,,,,,,,,,
20140508-M-Madrid_Masters-R16-Jarkko_Nieminen-Rafael_Nadal,1,B-DTM,35,6,0,2,4,8,27,,,,,,,,,,
20140508-M-Madrid_Masters-R16-Jarkko_Nieminen-Rafael_Nadal,1,B-DTL,11,5,1,1,3,3,8,,,,,,,,,,
20140508-M-Madrid_Masters-R16-Jarkko_Nieminen-Rafael_Nadal,1,B-IO,4,1,1,0,0,4,0,,,,,,,,,,
20140508-M-Madrid_Masters-R16-Jarkko_Nieminen-Rafael_Nadal,1,S-XC,2,0,0,0,0,1,1,,,,,,,,,,
20140508-M-Madrid_Masters-R16-Jarkko_Nieminen-Rafael_Nadal,1,S-DTM,3,1,0,0,1,0,3,,,,,,,,,,
20140508-M-Madrid_Masters-R16-Jarkko_Nieminen-Rafael_Nadal,2,F-XC,29,10,3,6,1,20,9,,,,,,,,,,
20140508-M-Madrid_Masters-R16-Jarkko_Nieminen-Rafael_Nadal,2,F-DTM,22,2,0,0,2,9,13,,,,,,,,,,
20140508-M-Madrid_Masters-R16-Jarkko_Nieminen-Rafael_Nadal,2,F-DTL,8,5,3,0,2,4,4,,,,,,,,,,
20140508-M-Madrid_Masters-R16-Jarkko_Nieminen-Rafael_Nadal,2,F-IO,40,8,2,4,2,32,8,,,,,,,,,,
20140508-M-Madrid_Masters-R16-Jarkko_Nieminen-Rafael_Nadal,2,F-II,9,4,2,2,0,7,2,,,,,,,,,,
20140508-M-Madrid_Masters-R16-Jarkko_Nieminen-Rafael_Nadal,2,B-XC,26,6,2,0,4,16,10,,,,,,,,,,
20140508-M-Madrid_Masters-R16-Jarkko_Nieminen-Rafael_Nadal,2,B-DTM,12,1,0,0,1,8,4,,,,,,,,,,
20140508-M-Madrid_Masters-R16-Jarkko_Nieminen-Rafael_Nadal,2,B-DTL,5,1,0,0,1,2,3,,,,,,,,,,
20140508-M-Madrid_Masters-R16-Jarkko_Nieminen-Rafael_Nadal,2,B-IO,2,1,1,0,0,2,0,,,,,,,,,,
20140508-M-Madrid_Masters-R16-Jarkko_Nieminen-Rafael_Nadal,2,S-XC,3,0,0,0,0,1,2,,,,,,,,,,
20140508-M-Madrid_Masters-R16-Jarkko_Nieminen-Rafael_Nadal,2,S-DTM,2,0,0,0,0,1,1,,,,,,,,,,
20140509-M-Madrid_Masters-QF-Tomas_Berdych-Rafael_Nadal,1,F-XC,52,8,3,3,2,33,19,,,,,,,,,,
20140509-M-Madrid_Masters-QF-Tomas_Berdych-Rafael_Nadal,1,F-DTM,17,1,0,0,1,5,12,,,,,,,,,,
20140509-M-Madrid_Masters-QF-Tomas_Berdych-Rafael_Nadal,1,F-DTL,4,2,0,0,2,1,3,,,,,,,,,,
20140509-M-Madrid_Masters-QF-Tomas_Berdych-Rafael_Nadal,1,F-IO,16,8,4,1,3,10,6,,,,,,,,,,
20140509-M-Madrid_Masters-QF-Tomas_Berdych-Rafael_Nadal,1,F-II,3,1,0,1,0,2,1,,,,,,,,,,
20140509-M-Madrid_Masters-QF-Tomas_Berdych-Rafael_Nadal,1,B-XC,24,4,1,1,2,7,17,,,,,,,,,,
20140509-M-Madrid_Masters-QF-Tomas_Berdych-Rafael_Nadal,1,B-DTM,18,1,0,1,0,10,8,,,,,,,,,,
20140509-M-Madrid_Masters-QF-Tomas_Berdych-Rafael_Nadal,1,B-DTL,11,3,0,1,2,4,7,,,,,,,,,,
20140509-M-Madrid_Masters-QF-Tomas_Berdych-Rafael_Nadal,1,B-IO,2,0,0,0,0,0,2,,,,,,,,,,
20140509-M-Madrid_Masters-QF-Tomas_Berdych-Rafael_Nadal,1,S-DTM,2,0,0,0,0,0,2,,,,,,,,,,
20140509-M-Madrid_Masters-QF-Tomas_Berdych-Rafael_Nadal,1,S-DTL,3,0,0,0,0,0,3,,,,,,,,,,
20140509-M-Madrid_Masters-QF-Tomas_Berdych-Rafael_Nadal,2,F-XC,44,8,3,3,2,30,14,,,,,,,,,,
20140509-M-Madrid_Masters-QF-Tomas_Berdych-Rafael_Nadal,2,F-DTM,21,2,0,2,0,11,10,,,,,,,,,,
20140509-M-Madrid_Masters-QF-Tomas_Berdych-Rafael_Nadal,2,F-DTL,8,4,4,0,0,5,3,,,,,,,,,,
20140509-M-Madrid_Masters-QF-Tomas_Berdych-Rafael_Nadal,2,F-IO,24,12,8,2,2,17,7,,,,,,,,,,
20140509-M-Madrid_Masters-QF-Tomas_Berdych-Rafael_Nadal,2,F-II,10,3,0,2,1,8,2,,,,,,,,,,
20140509-M-Madrid_Masters-QF-Tomas_Berdych-Rafael_Nadal,2,B-XC,24,9,2,2,5,10,14,,,,,,,,,,
20140509-M-Madrid_Masters-QF-Tomas_Berdych-Rafael_Nadal,2,B-DTM,11,0,0,0,0,4,7,,,,,,,,,,
20140509-M-Madrid_Masters-QF-Tomas_Berdych-Rafael_Nadal,2,B-DTL,8,1,0,0,1,2,6,,,,,,,,,,
20140509-M-Madrid_Masters-QF-Tomas_Berdych-Rafael_Nadal,2,B-IO,1,1,0,1,0,1,0,,,,,,,,,,
20140509-M-Madrid_Masters-QF-Tomas_Berdych-Rafael_Nadal,2,S-XC,3,0,0,0,0,2,1,,,,,,,,,,
20140509-M-Madrid_Masters-QF-Tomas_Berdych-Rafael_Nadal,2,S-DTM,6,0,0,0,0,3,3,,,,,,,,,,
20140509-M-Madrid_Masters-QF-Tomas_Berdych-Rafael_Nadal,2,S-DTL,3,1,0,1,0,1,2,,,,,,,,,,
20140509-M-Rome_CH-QF-Mate_Delic-Julian_Reister,1,F-XC,45,15,5,1,9,20,25,,,,,,,,,,
20140509-M-Rome_CH-QF-Mate_Delic-Julian_Reister,1,F-DTM,18,3,0,0,3,4,14,,,,,,,,,,
20140509-M-Rome_CH-QF-Mate_Delic-Julian_Reister,1,F-DTL,8,4,2,0,2,3,5,,,,,,,,,,
20140509-M-Rome_CH-QF-Mate_Delic-Julian_Reister,1,F-IO,14,4,1,0,3,9,5,,,,,,,,,,
20140509-M-Rome_CH-QF-Mate_Delic-Julian_Reister,1,F-II,5,2,0,0,2,0,5,,,,,,,,,,
20140509-M-Rome_CH-QF-Mate_Delic-Julian_Reister,1,B-XC,35,5,0,1,4,12,23,,,,,,,,,,
20140509-M-Rome_CH-QF-Mate_Delic-Julian_Reister,1,B-DTM,13,2,0,0,2,3,10,,,,,,,,,,
20140509-M-Rome_CH-QF-Mate_Delic-Julian_Reister,1,B-DTL,4,2,0,0,2,0,4,,,,,,,,,,
20140509-M-Rome_CH-QF-Mate_Delic-Julian_Reister,1,S-XC,3,0,0,0,0,0,3,,,,,,,,,,
20140509-M-Rome_CH-QF-Mate_Delic-Julian_Reister,1,S-DTM,2,0,0,0,0,0,2,,,,,,,,,,
20140509-M-Rome_CH-QF-Mate_Delic-Julian_Reister,1,S-DTL,1,0,0,0,0,0,1,,,,,,,,,,
20140509-M-Rome_CH-QF-Mate_Delic-Julian_Reister,1,S-IO,1,0,0,0,0,0,1,,,,,,,,,,
20140509-M-Rome_CH-QF-Mate_Delic-Julian_Reister,2,F-XC,28,9,3,3,3,20,8,,,,,,,,,,
20140509-M-Rome_CH-QF-Mate_Delic-Julian_Reister,2,F-DTM,19,0,0,0,0,11,8,,,,,,,,,,
20140509-M-Rome_CH-QF-Mate_Delic-Julian_Reister,2,F-DTL,10,1,1,0,0,8,2,,,,,,,,,,
20140509-M-Rome_CH-QF-Mate_Delic-Julian_Reister,2,F-IO,21,5,3,1,1,18,3,,,,,,,,,,
20140509-M-Rome_CH-QF-Mate_Delic-Julian_Reister,2,F-II,6,3,0,3,0,6,0,,,,,,,,,,
20140509-M-Rome_CH-QF-Mate_Delic-Julian_Reister,2,B-XC,17,1,0,0,1,9,8,,,,,,,,,,
20140509-M-Rome_CH-QF-Mate_Delic-Julian_Reister,2,B-DTM,14,2,0,0,2,5,9,,,,,,,,,,
20140509-M-Rome_CH-QF-Mate_Delic-Julian_Reister,2,B-DTL,2,1,1,0,0,1,1,,,,,,,,,,
20140509-M-Rome_CH-QF-Mate_Delic-Julian_Reister,2,S-XC,8,0,0,0,0,5,3,,,,,,,,,,
20140509-M-Rome_CH-QF-Mate_Delic-Julian_Reister,2,S-DTM,2,0,0,0,0,1,1,,,,,,,,,,
20140510-M-Madrid_Masters-SF-Roberto_Bautista_Agut-Rafael_Nadal,1,F-XC,49,8,1,4,3,26,23,,,,,,,,,,
20140510-M-Madrid_Masters-SF-Roberto_Bautista_Agut-Rafael_Nadal,1,F-DTM,19,2,0,1,1,6,13,,,,,,,,,,
20140510-M-Madrid_Masters-SF-Roberto_Bautista_Agut-Rafael_Nadal,1,F-DTL,11,4,2,1,1,8,3,,,,,,,,,,
20140510-M-Madrid_Masters-SF-Roberto_Bautista_Agut-Rafael_Nadal,1,F-IO,29,10,6,2,2,18,11,,,,,,,,,,
20140510-M-Madrid_Masters-SF-Roberto_Bautista_Agut-Rafael_Nadal,1,F-II,10,2,1,1,0,7,3,,,,,,,,,,
20140510-M-Madrid_Masters-SF-Roberto_Bautista_Agut-Rafael_Nadal,1,B-XC,37,8,0,3,5,15,22,,,,,,,,,,
20140510-M-Madrid_Masters-SF-Roberto_Bautista_Agut-Rafael_Nadal,1,B-DTM,21,2,0,0,2,6,15,,,,,,,,,,
20140510-M-Madrid_Masters-SF-Roberto_Bautista_Agut-Rafael_Nadal,1,B-DTL,13,4,0,0,4,4,9,,,,,,,,,,
20140510-M-Madrid_Masters-SF-Roberto_Bautista_Agut-Rafael_Nadal,1,B-IO,2,1,0,0,1,0,2,,,,,,,,,,
20140510-M-Madrid_Masters-SF-Roberto_Bautista_Agut-Rafael_Nadal,1,S-XC,2,0,0,0,0,1,1,,,,,,,,,,
20140510-M-Madrid_Masters-SF-Roberto_Bautista_Agut-Rafael_Nadal,1,S-DTM,3,0,0,0,0,3,0,,,,,,,,,,
20140510-M-Madrid_Masters-SF-Roberto_Bautista_Agut-Rafael_Nadal,2,F-XC,73,13,6,4,3,45,28,,,,,,,,,,
20140510-M-Madrid_Masters-SF-Roberto_Bautista_Agut-Rafael_Nadal,2,F-DTM,12,0,0,0,0,3,9,,,,,,,,,,
20140510-M-Madrid_Masters-SF-Roberto_Bautista_Agut-Rafael_Nadal,2,F-DTL,16,8,6,1,1,9,7,,,,,,,,,,
20140510-M-Madrid_Masters-SF-Roberto_Bautista_Agut-Rafael_Nadal,2,F-IO,21,11,1,6,4,12,9,,,,,,,,,,
20140510-M-Madrid_Masters-SF-Roberto_Bautista_Agut-Rafael_Nadal,2,F-II,6,0,0,0,0,3,3,,,,,,,,,,
20140510-M-Madrid_Masters-SF-Roberto_Bautista_Agut-Rafael_Nadal,2,B-XC,16,5,2,1,2,11,5,,,,,,,,,,
20140510-M-Madrid_Masters-SF-Roberto_Bautista_Agut-Rafael_Nadal,2,B-DTM,24,2,0,0,2,12,12,,,,,,,,,,
20140510-M-Madrid_Masters-SF-Roberto_Bautista_Agut-Rafael_Nadal,2,B-DTL,14,5,2,0,3,5,9,,,,,,,,,,
20140510-M-Madrid_Masters-SF-Roberto_Bautista_Agut-Rafael_Nadal,2,S-XC,1,0,0,0,0,1,0,,,,,,,,,,
20140510-M-Madrid_Masters-SF-Roberto_Bautista_Agut-Rafael_Nadal,2,S-DTM,7,0,0,0,0,4,3,,,,,,,,,,
20140510-M-Madrid_Masters-SF-Roberto_Bautista_Agut-Rafael_Nadal,2,S-DTL,1,0,0,0,0,0,1,,,,,,,,,,
20140511-M-Madrid_Masters-F-Rafael_Nadal-Kei_Nishikori,1,F-XC,34,6,1,1,4,14,20,,,,,,,,,,
20140511-M-Madrid_Masters-F-Rafael_Nadal-Kei_Nishikori,1,F-DTM,22,1,0,1,0,7,15,,,,,,,,,,
20140511-M-Madrid_Masters-F-Rafael_Nadal-Kei_Nishikori,1,F-DTL,10,4,1,3,0,7,3,,,,,,,,,,
20140511-M-Madrid_Masters-F-Rafael_Nadal-Kei_Nishikori,1,F-IO,15,5,1,3,1,8,7,,,,,,,,,,
20140511-M-Madrid_Masters-F-Rafael_Nadal-Kei_Nishikori,1,F-II,8,3,1,2,0,4,4,,,,,,,,,,
20140511-M-Madrid_Masters-F-Rafael_Nadal-Kei_Nishikori,1,B-XC,14,1,0,1,0,9,5,,,,,,,,,,
20140511-M-Madrid_Masters-F-Rafael_Nadal-Kei_Nishikori,1,B-DTM,20,2,0,0,2,9,11,,,,,,,,,,
20140511-M-Madrid_Masters-F-Rafael_Nadal-Kei_Nishikori,1,B-DTL,15,4,1,0,3,6,9,,,,,,,,,,
20140511-M-Madrid_Masters-F-Rafael_Nadal-Kei_Nishikori,1,B-IO,4,3,1,1,1,2,2,,,,,,,,,,
20140511-M-Madrid_Masters-F-Rafael_Nadal-Kei_Nishikori,1,S-DTM,8,0,0,0,0,5,3,,,,,,,,,,
20140511-M-Madrid_Masters-F-Rafael_Nadal-Kei_Nishikori,1,S-DTL,2,0,0,0,0,0,2,,,,,,,,,,
20140511-M-Madrid_Masters-F-Rafael_Nadal-Kei_Nishikori,1,S-IO,1,0,0,0,0,1,0,,,,,,,,,,
20140511-M-Madrid_Masters-F-Rafael_Nadal-Kei_Nishikori,2,F-XC,38,4,0,0,4,19,19,,,,,,,,,,
20140511-M-Madrid_Masters-F-Rafael_Nadal-Kei_Nishikori,2,F-DTM,21,1,0,1,0,11,10,,,,,,,,,,
20140511-M-Madrid_Masters-F-Rafael_Nadal-Kei_Nishikori,2,F-DTL,7,3,0,1,2,2,5,,,,,,,,,,
20140511-M-Madrid_Masters-F-Rafael_Nadal-Kei_Nishikori,2,F-IO,29,16,6,4,6,20,9,,,,,,,,,,
20140511-M-Madrid_Masters-F-Rafael_Nadal-Kei_Nishikori,2,F-II,3,2,0,1,1,2,1,,,,,,,,,,
20140511-M-Madrid_Masters-F-Rafael_Nadal-Kei_Nishikori,2,B-XC,28,5,2,1,2,16,12,,,,,,,,,,
20140511-M-Madrid_Masters-F-Rafael_Nadal-Kei_Nishikori,2,B-DTM,7,0,0,0,0,6,1,,,,,,,,,,
20140511-M-Madrid_Masters-F-Rafael_Nadal-Kei_Nishikori,2,B-DTL,17,5,2,1,2,11,6,,,,,,,,,,
20140511-M-Madrid_Masters-F-Rafael_Nadal-Kei_Nishikori,2,B-IO,7,2,1,0,1,4,3,,,,,,,,,,
20140511-M-Madrid_Masters-F-Rafael_Nadal-Kei_Nishikori,2,S-DTL,4,1,0,0,1,1,3,,,,,,,,,,
20140514-M-Rome_Masters-R32-Gilles_Simon-Rafael_Nadal,1,F-XC,135,20,5,3,12,61,74,,,,,,,,,,
20140514-M-Rome_Masters-R32-Gilles_Simon-Rafael_Nadal,1,F-DTM,66,5,0,2,3,30,36,,,,,,,,,,
20140514-M-Rome_Masters-R32-Gilles_Simon-Rafael_Nadal,1,F-DTL,42,22,9,3,10,21,21,,,,,,,,,,
20140514-M-Rome_Masters-R32-Gilles_Simon-Rafael_Nadal,1,F-IO,61,17,12,3,2,39,22,,,,,,,,,,
20140514-M-Rome_Masters-R32-Gilles_Simon-Rafael_Nadal,1,F-II,8,1,1,0,0,7,1,,,,,,,,,,
20140514-M-Rome_Masters-R32-Gilles_Simon-Rafael_Nadal,1,B-XC,102,24,6,8,10,48,54,,,,,,,,,,
20140514-M-Rome_Masters-R32-Gilles_Simon-Rafael_Nadal,1,B-DTM,106,6,0,0,6,46,60,,,,,,,,,,
20140514-M-Rome_Masters-R32-Gilles_Simon-Rafael_Nadal,1,B-DTL,54,10,2,2,6,21,33,,,,,,,,,,
20140514-M-Rome_Masters-R32-Gilles_Simon-Rafael_Nadal,1,B-IO,13,5,1,0,4,5,8,,,,,,,,,,
20140514-M-Rome_Masters-R32-Gilles_Simon-Rafael_Nadal,1,B-II,1,1,0,1,0,1,0,,,,,,,,,,
20140514-M-Rome_Masters-R32-Gilles_Simon-Rafael_Nadal,1,S-DTL,2,0,0,0,0,1,1,,,,,,,,,,
20140514-M-Rome_Masters-R32-Gilles_Simon-Rafael_Nadal,1,S-IO,1,0,0,0,0,0,1,,,,,,,,,,
20140514-M-Rome_Masters-R32-Gilles_Simon-Rafael_Nadal,2,F-XC,174,11,4,4,3,103,71,,,,,,,,,,
20140514-M-Rome_Masters-R32-Gilles_Simon-Rafael_Nadal,2,F-DTM,56,4,0,1,3,18,38,,,,,,,,,,
20140514-M-Rome_Masters-R32-Gilles_Simon-Rafael_Nadal,2,F-DTL,37,13,4,5,4,21,16,,,,,,,,,,
20140514-M-Rome_Masters-R32-Gilles_Simon-Rafael_Nadal,2,F-IO,90,20,12,3,5,55,35,,,,,,,,,,
20140514-M-Rome_Masters-R32-Gilles_Simon-Rafael_Nadal,2,F-II,20,3,0,2,1,11,9,,,,,,,,,,
20140514-M-Rome_Masters-R32-Gilles_Simon-Rafael_Nadal,2,B-XC,82,7,1,2,4,45,37,,,,,,,,,,
20140514-M-Rome_Masters-R32-Gilles_Simon-Rafael_Nadal,2,B-DTM,45,4,0,2,2,27,18,,,,,,,,,,
20140514-M-Rome_Masters-R32-Gilles_Simon-Rafael_Nadal,2,B-DTL,25,4,1,1,2,12,13,,,,,,,,,,
20140514-M-Rome_Masters-R32-Gilles_Simon-Rafael_Nadal,2,B-IO,9,0,0,0,0,4,5,,,,,,,,,,
20140514-M-Rome_Masters-R32-Gilles_Simon-Rafael_Nadal,2,S-XC,2,0,0,0,0,2,0,,,,,,,,,,
20140514-M-Rome_Masters-R32-Gilles_Simon-Rafael_Nadal,2,S-DTM,10,0,0,0,0,7,3,,,,,,,,,,
20140514-M-Rome_Masters-R32-Gilles_Simon-Rafael_Nadal,2,S-DTL,12,0,0,0,0,6,6,,,,,,,,,,
20140514-M-Rome_Masters-R32-Gilles_Simon-Rafael_Nadal,2,S-IO,4,0,0,0,0,2,2,,,,,,,,,,
20140514-M-Rome_Masters-R32-Roger_Federer-Jeremy_Chardy,1,F-XC,47,17,7,2,8,26,21,,,,,,,,,,
20140514-M-Rome_Masters-R32-Roger_Federer-Jeremy_Chardy,1,F-DTM,25,3,0,0,3,7,18,,,,,,,,,,
20140514-M-Rome_Masters-R32-Roger_Federer-Jeremy_Chardy,1,F-DTL,12,3,0,0,3,6,6,,,,,,,,,,
20140514-M-Rome_Masters-R32-Roger_Federer-Jeremy_Chardy,1,F-IO,34,10,2,2,6,16,18,,,,,,,,,,
20140514-M-Rome_Masters-R32-Roger_Federer-Jeremy_Chardy,1,F-II,5,3,2,0,0,2,3,,,,,,,,,,
20140514-M-Rome_Masters-R32-Roger_Federer-Jeremy_Chardy,1,B-XC,32,4,0,1,3,12,20,,,,,,,,,,
20140514-M-Rome_Masters-R32-Roger_Federer-Jeremy_Chardy,1,B-DTM,34,2,1,0,0,18,16,,,,,,,,,,
20140514-M-Rome_Masters-R32-Roger_Federer-Jeremy_Chardy,1,B-DTL,15,3,0,1,2,10,5,,,,,,,,,,
20140514-M-Rome_Masters-R32-Roger_Federer-Jeremy_Chardy,1,B-IO,3,2,1,0,1,1,2,,,,,,,,,,
20140514-M-Rome_Masters-R32-Roger_Federer-Jeremy_Chardy,1,B-II,1,1,1,0,0,1,0,,,,,,,,,,
20140514-M-Rome_Masters-R32-Roger_Federer-Jeremy_Chardy,1,S-XC,13,2,0,1,1,8,5,,,,,,,,,,
20140514-M-Rome_Masters-R32-Roger_Federer-Jeremy_Chardy,1,S-DTM,4,0,0,0,0,3,1,,,,,,,,,,
20140514-M-Rome_Masters-R32-Roger_Federer-Jeremy_Chardy,1,S-DTL,2,0,0,0,0,0,2,,,,,,,,,,
20140514-M-Rome_Masters-R32-Roger_Federer-Jeremy_Chardy,2,F-XC,37,14,3,5,6,20,17,,,,,,,,,,
20140514-M-Rome_Masters-R32-Roger_Federer-Jeremy_Chardy,2,F-DTM,20,5,0,3,2,10,10,,,,,,,,,,
20140514-M-Rome_Masters-R32-Roger_Federer-Jeremy_Chardy,2,F-DTL,21,2,0,1,1,7,14,,,,,,,,,,
20140514-M-Rome_Masters-R32-Roger_Federer-Jeremy_Chardy,2,F-IO,41,9,0,5,4,26,15,,,,,,,,,,
20140514-M-Rome_Masters-R32-Roger_Federer-Jeremy_Chardy,2,F-II,9,4,1,2,0,7,2,,,,,,,,,,
20140514-M-Rome_Masters-R32-Roger_Federer-Jeremy_Chardy,2,B-XC,26,2,1,1,0,12,14,,,,,,,,,,
20140514-M-Rome_Masters-R32-Roger_Federer-Jeremy_Chardy,2,B-DTM,30,1,0,0,1,12,18,,,,,,,,,,
20140514-M-Rome_Masters-R32-Roger_Federer-Jeremy_Chardy,2,B-DTL,8,4,0,2,2,5,3,,,,,,,,,,
20140514-M-Rome_Masters-R32-Roger_Federer-Jeremy_Chardy,2,B-IO,5,3,1,1,1,2,3,,,,,,,,,,
20140514-M-Rome_Masters-R32-Roger_Federer-Jeremy_Chardy,2,S-XC,18,1,0,0,1,8,10,,,,,,,,,,
20140514-M-Rome_Masters-R32-Roger_Federer-Jeremy_Chardy,2,S-DTM,5,0,0,0,0,5,0,,,,,,,,,,
20140514-M-Rome_Masters-R32-Roger_Federer-Jeremy_Chardy,2,S-IO,1,1,0,1,0,1,0,,,,,,,,,,
20140515-M-Busan_CH-R16-Amir_Weintraub-Daniel_Smethurst,1,F-XC,21,7,2,2,3,10,11,,,,,,,,,,
20140515-M-Busan_CH-R16-Amir_Weintraub-Daniel_Smethurst,1,F-DTM,12,3,0,0,3,4,8,,,,,,,,,,
20140515-M-Busan_CH-R16-Amir_Weintraub-Daniel_Smethurst,1,F-DTL,30,6,0,1,5,11,19,,,,,,,,,,
20140515-M-Busan_CH-R16-Amir_Weintraub-Daniel_Smethurst,1,F-IO,17,4,1,1,2,5,12,,,,,,,,,,
20140515-M-Busan_CH-R16-Amir_Weintraub-Daniel_Smethurst,1,B-XC,47,13,4,2,7,22,25,,,,,,,,,,
20140515-M-Busan_CH-R16-Amir_Weintraub-Daniel_Smethurst,1,B-DTM,18,3,0,0,3,8,10,,,,,,,,,,
20140515-M-Busan_CH-R16-Amir_Weintraub-Daniel_Smethurst,1,B-DTL,5,4,1,1,2,2,3,,,,,,,,,,
20140515-M-Busan_CH-R16-Amir_Weintraub-Daniel_Smethurst,1,B-IO,13,6,3,1,2,6,7,,,,,,,,,,
20140515-M-Busan_CH-R16-Amir_Weintraub-Daniel_Smethurst,1,S-XC,8,2,0,1,1,3,5,,,,,,,,,,
20140515-M-Busan_CH-R16-Amir_Weintraub-Daniel_Smethurst,1,S-DTM,6,0,0,0,0,1,5,,,,,,,,,,
20140515-M-Busan_CH-R16-Amir_Weintraub-Daniel_Smethurst,1,S-DTL,3,1,0,1,0,1,2,,,,,,,,,,
20140515-M-Busan_CH-R16-Amir_Weintraub-Daniel_Smethurst,2,F-XC,26,9,4,2,3,19,7,,,,,,,,,,
20140515-M-Busan_CH-R16-Amir_Weintraub-Daniel_Smethurst,2,F-DTM,17,4,1,0,3,8,9,,,,,,,,,,
20140515-M-Busan_CH-R16-Amir_Weintraub-Daniel_Smethurst,2,F-DTL,11,5,2,0,3,6,5,,,,,,,,,,
20140515-M-Busan_CH-R16-Amir_Weintraub-Daniel_Smethurst,2,F-IO,17,7,2,2,3,11,6,,,,,,,,,,
20140515-M-Busan_CH-R16-Amir_Weintraub-Daniel_Smethurst,2,F-II,6,1,0,0,1,3,3,,,,,,,,,,
20140515-M-Busan_CH-R16-Amir_Weintraub-Daniel_Smethurst,2,B-XC,6,1,0,0,1,1,5,,,,,,,,,,
20140515-M-Busan_CH-R16-Amir_Weintraub-Daniel_Smethurst,2,B-DTM,4,1,0,0,1,2,2,,,,,,,,,,
20140515-M-Busan_CH-R16-Amir_Weintraub-Daniel_Smethurst,2,B-DTL,2,1,0,0,1,1,1,,,,,,,,,,
20140515-M-Busan_CH-R16-Amir_Weintraub-Daniel_Smethurst,2,B-IO,1,1,1,0,0,1,0,,,,,,,,,,
20140515-M-Busan_CH-R16-Amir_Weintraub-Daniel_Smethurst,2,S-XC,25,3,0,0,3,14,11,,,,,,,,,,
20140515-M-Busan_CH-R16-Amir_Weintraub-Daniel_Smethurst,2,S-DTM,27,1,0,0,1,15,12,,,,,,,,,,
20140515-M-Busan_CH-R16-Amir_Weintraub-Daniel_Smethurst,2,S-DTL,13,1,0,0,1,8,5,,,,,,,,,,
20140515-M-Busan_CH-R16-Amir_Weintraub-Daniel_Smethurst,2,S-IO,4,0,0,0,0,3,1,,,,,,,,,,
20140515-M-Rome_Masters-R16-Mikhail_Youzhny-Rafael_Nadal,1,F-XC,55,9,2,2,5,27,28,,,,,,,,,,
20140515-M-Rome_Masters-R16-Mikhail_Youzhny-Rafael_Nadal,1,F-DTM,37,2,0,1,1,11,26,,,,,,,,,,
20140515-M-Rome_Masters-R16-Mikhail_Youzhny-Rafael_Nadal,1,F-DTL,15,9,2,4,3,8,7,,,,,,,,,,
20140515-M-Rome_Masters-R16-Mikhail_Youzhny-Rafael_Nadal,1,F-IO,38,11,3,5,3,25,13,,,,,,,,,,
20140515-M-Rome_Masters-R16-Mikhail_Youzhny-Rafael_Nadal,1,F-II,4,2,0,2,0,3,1,,,,,,,,,,
20140515-M-Rome_Masters-R16-Mikhail_Youzhny-Rafael_Nadal,1,B-XC,56,14,2,3,9,22,34,,,,,,,,,,
20140515-M-Rome_Masters-R16-Mikhail_Youzhny-Rafael_Nadal,1,B-DTM,49,7,0,1,6,18,31,,,,,,,,,,
20140515-M-Rome_Masters-R16-Mikhail_Youzhny-Rafael_Nadal,1,B-DTL,35,12,1,3,8,18,17,,,,,,,,,,
20140515-M-Rome_Masters-R16-Mikhail_Youzhny-Rafael_Nadal,1,B-IO,7,1,0,1,0,4,3,,,,,,,,,,
20140515-M-Rome_Masters-R16-Mikhail_Youzhny-Rafael_Nadal,1,S-XC,3,0,0,0,0,0,3,,,,,,,,,,
20140515-M-Rome_Masters-R16-Mikhail_Youzhny-Rafael_Nadal,1,S-DTM,8,0,0,0,0,3,5,,,,,,,,,,
20140515-M-Rome_Masters-R16-Mikhail_Youzhny-Rafael_Nadal,1,S-DTL,13,1,0,0,1,3,10,,,,,,,,,,
20140515-M-Rome_Masters-R16-Mikhail_Youzhny-Rafael_Nadal,1,S-IO,6,0,0,0,0,1,5,,,,,,,,,,
20140515-M-Rome_Masters-R16-Mikhail_Youzhny-Rafael_Nadal,2,F-XC,112,14,2,5,7,63,49,,,,,,,,,,
20140515-M-Rome_Masters-R16-Mikhail_Youzhny-Rafael_Nadal,2,F-DTM,24,0,0,0,0,13,11,,,,,,,,,,
20140515-M-Rome_Masters-R16-Mikhail_Youzhny-Rafael_Nadal,2,F-DTL,22,10,4,1,5,10,12,,,,,,,,,,
20140515-M-Rome_Masters-R16-Mikhail_Youzhny-Rafael_Nadal,2,F-IO,45,20,7,9,4,33,12,,,,,,,,,,
20140515-M-Rome_Masters-R16-Mikhail_Youzhny-Rafael_Nadal,2,F-II,15,3,2,0,1,10,5,,,,,,,,,,
20140515-M-Rome_Masters-R16-Mikhail_Youzhny-Rafael_Nadal,2,B-XC,22,3,0,0,3,10,12,,,,,,,,,,
20140515-M-Rome_Masters-R16-Mikhail_Youzhny-Rafael_Nadal,2,B-DTM,24,0,0,0,0,12,12,,,,,,,,,,
20140515-M-Rome_Masters-R16-Mikhail_Youzhny-Rafael_Nadal,2,B-DTL,8,2,1,0,1,5,3,,,,,,,,,,
20140515-M-Rome_Masters-R16-Mikhail_Youzhny-Rafael_Nadal,2,B-IO,6,1,0,1,0,5,1,,,,,,,,,,
20140515-M-Rome_Masters-R16-Mikhail_Youzhny-Rafael_Nadal,2,B-II,1,0,0,0,0,0,1,,,,,,,,,,
20140515-M-Rome_Masters-R16-Mikhail_Youzhny-Rafael_Nadal,2,S-XC,6,0,0,0,0,4,2,,,,,,,,,,
20140515-M-Rome_Masters-R16-Mikhail_Youzhny-Rafael_Nadal,2,S-DTM,23,1,0,1,0,13,10,,,,,,,,,,
20140515-M-Rome_Masters-R16-Mikhail_Youzhny-Rafael_Nadal,2,S-DTL,8,0,0,0,0,4,4,,,,,,,,,,
20140515-M-Rome_Masters-R16-Mikhail_Youzhny-Rafael_Nadal,2,S-IO,4,0,0,0,0,4,0,,,,,,,,,,
20140516-M-Rome_Masters-QF-Andy_Murray-Rafael_Nadal,1,F-XC,159,13,3,3,7,73,86,,,,,,,,,,
20140516-M-Rome_Masters-QF-Andy_Murray-Rafael_Nadal,1,F-DTM,40,2,0,1,1,15,25,,,,,,,,,,
20140516-M-Rome_Masters-QF-Andy_Murray-Rafael_Nadal,1,F-DTL,24,8,4,0,4,13,11,,,,,,,,,,
20140516-M-Rome_Masters-QF-Andy_Murray-Rafael_Nadal,1,F-IO,34,12,5,4,3,20,14,,,,,,,,,,
20140516-M-Rome_Masters-QF-Andy_Murray-Rafael_Nadal,1,F-II,6,2,1,0,1,3,3,,,,,,,,,,
20140516-M-Rome_Masters-QF-Andy_Murray-Rafael_Nadal,1,B-XC,48,13,2,4,7,24,24,,,,,,,,,,
20140516-M-Rome_Masters-QF-Andy_Murray-Rafael_Nadal,1,B-DTM,52,4,0,0,4,26,26,,,,,,,,,,
20140516-M-Rome_Masters-QF-Andy_Murray-Rafael_Nadal,1,B-DTL,28,10,4,1,5,14,14,,,,,,,,,,
20140516-M-Rome_Masters-QF-Andy_Murray-Rafael_Nadal,1,B-IO,4,2,1,0,1,2,2,,,,,,,,,,
20140516-M-Rome_Masters-QF-Andy_Murray-Rafael_Nadal,1,S-XC,5,0,0,0,0,4,1,,,,,,,,,,
20140516-M-Rome_Masters-QF-Andy_Murray-Rafael_Nadal,1,S-DTM,4,0,0,0,0,0,4,,,,,,,,,,
20140516-M-Rome_Masters-QF-Andy_Murray-Rafael_Nadal,1,S-DTL,7,0,0,0,0,2,5,,,,,,,,,,
20140516-M-Rome_Masters-QF-Andy_Murray-Rafael_Nadal,1,S-IO,3,0,0,0,0,2,1,,,,,,,,,,
20140516-M-Rome_Masters-QF-Andy_Murray-Rafael_Nadal,2,F-XC,89,7,1,2,4,46,43,,,,,,,,,,
20140516-M-Rome_Masters-QF-Andy_Murray-Rafael_Nadal,2,F-DTM,19,3,0,1,2,9,10,,,,,,,,,,
20140516-M-Rome_Masters-QF-Andy_Murray-Rafael_Nadal,2,F-DTL,32,8,1,3,4,14,18,,,,,,,,,,
20140516-M-Rome_Masters-QF-Andy_Murray-Rafael_Nadal,2,F-IO,65,10,1,5,4,38,27,,,,,,,,,,
20140516-M-Rome_Masters-QF-Andy_Murray-Rafael_Nadal,2,F-II,9,4,0,2,2,4,5,,,,,,,,,,
20140516-M-Rome_Masters-QF-Andy_Murray-Rafael_Nadal,2,B-XC,80,5,2,1,2,45,35,,,,,,,,,,
20140516-M-Rome_Masters-QF-Andy_Murray-Rafael_Nadal,2,B-DTM,48,3,0,0,3,26,22,,,,,,,,,,
20140516-M-Rome_Masters-QF-Andy_Murray-Rafael_Nadal,2,B-DTL,30,6,1,1,4,18,12,,,,,,,,,,
20140516-M-Rome_Masters-QF-Andy_Murray-Rafael_Nadal,2,B-IO,9,3,0,1,2,6,3,,,,,,,,,,
20140516-M-Rome_Masters-QF-Andy_Murray-Rafael_Nadal,2,S-XC,3,0,0,0,0,0,3,,,,,,,,,,
20140516-M-Rome_Masters-QF-Andy_Murray-Rafael_Nadal,2,S-DTM,11,0,0,0,0,4,7,,,,,,,,,,
20140516-M-Rome_Masters-QF-Andy_Murray-Rafael_Nadal,2,S-DTL,6,1,0,1,0,1,5,,,,,,,,,,
20140516-M-Rome_Masters-QF-Andy_Murray-Rafael_Nadal,2,S-IO,3,0,0,0,0,1,2,,,,,,,,,,
20140517-M-Rome_Masters-SF-Grigor_Dimitrov-Rafael_Nadal,1,F-XC,58,7,3,2,2,22,36,,,,,,,,,,
20140517-M-Rome_Masters-SF-Grigor_Dimitrov-Rafael_Nadal,1,F-DTM,20,3,0,0,3,8,12,,,,,,,,,,
20140517-M-Rome_Masters-SF-Grigor_Dimitrov-Rafael_Nadal,1,F-DTL,4,2,0,0,2,1,3,,,,,,,,,,
20140517-M-Rome_Masters-SF-Grigor_Dimitrov-Rafael_Nadal,1,F-IO,28,11,5,1,5,11,17,,,,,,,,,,
20140517-M-Rome_Masters-SF-Grigor_Dimitrov-Rafael_Nadal,1,F-II,6,1,0,0,1,2,4,,,,,,,,,,
20140517-M-Rome_Masters-SF-Grigor_Dimitrov-Rafael_Nadal,1,B-XC,21,3,0,2,1,9,12,,,,,,,,,,
20140517-M-Rome_Masters-SF-Grigor_Dimitrov-Rafael_Nadal,1,B-DTM,33,7,0,1,6,11,22,,,,,,,,,,
20140517-M-Rome_Masters-SF-Grigor_Dimitrov-Rafael_Nadal,1,B-DTL,11,1,1,0,0,2,9,,,,,,,,,,
20140517-M-Rome_Masters-SF-Grigor_Dimitrov-Rafael_Nadal,1,B-IO,2,0,0,0,0,1,1,,,,,,,,,,
20140517-M-Rome_Masters-SF-Grigor_Dimitrov-Rafael_Nadal,1,S-XC,8,3,0,0,3,1,7,,,,,,,,,,
20140517-M-Rome_Masters-SF-Grigor_Dimitrov-Rafael_Nadal,1,S-DTM,3,0,0,0,0,1,2,,,,,,,,,,
20140517-M-Rome_Masters-SF-Grigor_Dimitrov-Rafael_Nadal,1,S-DTL,2,1,0,0,1,0,2,,,,,,,,,,
20140517-M-Rome_Masters-SF-Grigor_Dimitrov-Rafael_Nadal,2,F-XC,66,6,1,1,4,39,27,,,,,,,,,,
20140517-M-Rome_Masters-SF-Grigor_Dimitrov-Rafael_Nadal,2,F-DTM,17,0,0,0,0,11,6,,,,,,,,,,
20140517-M-Rome_Masters-SF-Grigor_Dimitrov-Rafael_Nadal,2,F-DTL,10,4,1,2,1,7,3,,,,,,,,,,
20140517-M-Rome_Masters-SF-Grigor_Dimitrov-Rafael_Nadal,2,F-IO,18,7,3,3,1,14,4,,,,,,,,,,
20140517-M-Rome_Masters-SF-Grigor_Dimitrov-Rafael_Nadal,2,F-II,5,1,0,1,0,4,1,,,,,,,,,,
20140517-M-Rome_Masters-SF-Grigor_Dimitrov-Rafael_Nadal,2,B-XC,31,6,1,1,4,19,12,,,,,,,,,,
20140517-M-Rome_Masters-SF-Grigor_Dimitrov-Rafael_Nadal,2,B-DTM,21,0,0,0,0,14,7,,,,,,,,,,
20140517-M-Rome_Masters-SF-Grigor_Dimitrov-Rafael_Nadal,2,B-DTL,21,3,0,1,2,16,5,,,,,,,,,,
20140517-M-Rome_Masters-SF-Grigor_Dimitrov-Rafael_Nadal,2,B-IO,6,0,0,0,0,5,1,,,,,,,,,,
20140517-M-Rome_Masters-SF-Grigor_Dimitrov-Rafael_Nadal,2,S-XC,1,0,0,0,0,1,0,,,,,,,,,,
20140517-M-Rome_Masters-SF-Grigor_Dimitrov-Rafael_Nadal,2,S-DTM,1,1,0,0,1,0,1,,,,,,,,,,
20140518-M-Rome_Masters-F-Novak_Djokovic-Rafael_Nadal,1,F-XC,77,12,5,4,3,45,32,,,,,,,,,,
20140518-M-Rome_Masters-F-Novak_Djokovic-Rafael_Nadal,1,F-DTM,27,3,0,0,3,11,16,,,,,,,,,,
20140518-M-Rome_Masters-F-Novak_Djokovic-Rafael_Nadal,1,F-DTL,17,4,3,0,1,9,8,,,,,,,,,,
20140518-M-Rome_Masters-F-Novak_Djokovic-Rafael_Nadal,1,F-IO,42,16,8,4,4,25,17,,,,,,,,,,
20140518-M-Rome_Masters-F-Novak_Djokovic-Rafael_Nadal,1,F-II,3,1,1,0,0,2,1,,,,,,,,,,
20140518-M-Rome_Masters-F-Novak_Djokovic-Rafael_Nadal,1,B-XC,50,14,4,3,7,21,29,,,,,,,,,,
20140518-M-Rome_Masters-F-Novak_Djokovic-Rafael_Nadal,1,B-DTM,46,3,0,0,3,22,24,,,,,,,,,,
20140518-M-Rome_Masters-F-Novak_Djokovic-Rafael_Nadal,1,B-DTL,26,6,4,1,1,17,9,,,,,,,,,,
20140518-M-Rome_Masters-F-Novak_Djokovic-Rafael_Nadal,1,B-IO,10,1,0,0,1,6,4,,,,,,,,,,
20140518-M-Rome_Masters-F-Novak_Djokovic-Rafael_Nadal,1,S-XC,1,0,0,0,0,0,1,,,,,,,,,,
20140518-M-Rome_Masters-F-Novak_Djokovic-Rafael_Nadal,1,S-DTL,1,0,0,0,0,1,0,,,,,,,,,,
20140518-M-Rome_Masters-F-Novak_Djokovic-Rafael_Nadal,2,F-XC,82,8,2,4,2,43,39,,,,,,,,,,
20140518-M-Rome_Masters-F-Novak_Djokovic-Rafael_Nadal,2,F-DTM,40,1,0,0,1,17,23,,,,,,,,,,
20140518-M-Rome_Masters-F-Novak_Djokovic-Rafael_Nadal,2,F-DTL,16,5,1,3,1,11,5,,,,,,,,,,
20140518-M-Rome_Masters-F-Novak_Djokovic-Rafael_Nadal,2,F-IO,39,10,2,4,4,25,14,,,,,,,,,,
20140518-M-Rome_Masters-F-Novak_Djokovic-Rafael_Nadal,2,F-II,5,1,0,1,0,5,0,,,,,,,,,,
20140518-M-Rome_Masters-F-Novak_Djokovic-Rafael_Nadal,2,B-XC,37,8,2,2,4,16,21,,,,,,,,,,
20140518-M-Rome_Masters-F-Novak_Djokovic-Rafael_Nadal,2,B-DTM,43,3,0,0,3,14,29,,,,,,,,,,
20140518-M-Rome_Masters-F-Novak_Djokovic-Rafael_Nadal,2,B-DTL,22,1,0,0,1,10,12,,,,,,,,,,
20140518-M-Rome_Masters-F-Novak_Djokovic-Rafael_Nadal,2,B-IO,5,0,0,0,0,0,5,,,,,,,,,,
20140518-M-Rome_Masters-F-Novak_Djokovic-Rafael_Nadal,2,S-XC,2,1,1,0,0,2,0,,,,,,,,,,
20140518-M-Rome_Masters-F-Novak_Djokovic-Rafael_Nadal,2,S-DTM,5,0,0,0,0,3,2,,,,,,,,,,
20140518-M-Rome_Masters-F-Novak_Djokovic-Rafael_Nadal,2,S-DTL,11,3,0,1,2,5,6,,,,,,,,,,
20140524-M-Nice-F-Ernests_Gulbis-Federico_Delbonis,1,F-XC,38,6,1,2,3,21,17,,,,,,,,,,
20140524-M-Nice-F-Ernests_Gulbis-Federico_Delbonis,1,F-DTM,31,0,0,0,0,16,15,,,,,,,,,,
20140524-M-Nice-F-Ernests_Gulbis-Federico_Delbonis,1,F-DTL,7,1,0,0,1,4,3,,,,,,,,,,
20140524-M-Nice-F-Ernests_Gulbis-Federico_Delbonis,1,F-IO,18,8,5,1,2,8,10,,,,,,,,,,
20140524-M-Nice-F-Ernests_Gulbis-Federico_Delbonis,1,B-XC,28,11,4,3,4,15,13,,,,,,,,,,
20140524-M-Nice-F-Ernests_Gulbis-Federico_Delbonis,1,B-DTM,34,5,0,1,4,15,19,,,,,,,,,,
20140524-M-Nice-F-Ernests_Gulbis-Federico_Delbonis,1,B-DTL,19,3,1,0,2,8,11,,,,,,,,,,
20140524-M-Nice-F-Ernests_Gulbis-Federico_Delbonis,1,B-IO,15,2,1,0,1,10,5,,,,,,,,,,
20140524-M-Nice-F-Ernests_Gulbis-Federico_Delbonis,1,S-XC,1,0,0,0,0,1,0,,,,,,,,,,
20140524-M-Nice-F-Ernests_Gulbis-Federico_Delbonis,1,S-DTM,2,0,0,0,0,0,2,,,,,,,,,,
20140524-M-Nice-F-Ernests_Gulbis-Federico_Delbonis,1,S-DTL,2,0,0,0,0,0,2,,,,,,,,,,
20140524-M-Nice-F-Ernests_Gulbis-Federico_Delbonis,1,S-IO,1,0,0,0,0,1,0,,,,,,,,,,
20140524-M-Nice-F-Ernests_Gulbis-Federico_Delbonis,2,F-XC,38,6,3,2,1,23,15,,,,,,,,,,
20140524-M-Nice-F-Ernests_Gulbis-Federico_Delbonis,2,F-DTM,35,2,0,0,2,17,18,,,,,,,,,,
20140524-M-Nice-F-Ernests_Gulbis-Federico_Delbonis,2,F-DTL,9,0,0,0,0,5,4,,,,,,,,,,
20140524-M-Nice-F-Ernests_Gulbis-Federico_Delbonis,2,F-IO,22,6,2,3,1,11,11,,,,,,,,,,
20140524-M-Nice-F-Ernests_Gulbis-Federico_Delbonis,2,F-II,5,2,2,0,0,3,2,,,,,,,,,,
20140524-M-Nice-F-Ernests_Gulbis-Federico_Delbonis,2,B-XC,21,6,0,2,4,12,9,,,,,,,,,,
20140524-M-Nice-F-Ernests_Gulbis-Federico_Delbonis,2,B-DTM,40,2,0,0,2,19,21,,,,,,,,,,
20140524-M-Nice-F-Ernests_Gulbis-Federico_Delbonis,2,B-DTL,15,3,0,1,2,9,6,,,,,,,,,,
20140524-M-Nice-F-Ernests_Gulbis-Federico_Delbonis,2,B-IO,7,2,0,0,2,3,4,,,,,,,,,,
20140524-M-Nice-F-Ernests_Gulbis-Federico_Delbonis,2,S-XC,5,0,0,0,0,1,4,,,,,,,,,,
20140524-M-Nice-F-Ernests_Gulbis-Federico_Delbonis,2,S-DTM,8,0,0,0,0,3,5,,,,,,,,,,
20140524-M-Nice-F-Ernests_Gulbis-Federico_Delbonis,2,S-DTL,4,1,0,1,0,2,2,,,,,,,,,,
20140524-M-Nice-F-Ernests_Gulbis-Federico_Delbonis,2,S-IO,1,0,0,0,0,0,1,,,,,,,,,,
20140526-M-Roland_Garros-R128-Robby_Ginepri-Rafael_Nadal,1,F-XC,60,8,1,1,6,25,35,,,,,,,,,,
20140526-M-Roland_Garros-R128-Robby_Ginepri-Rafael_Nadal,1,F-DTM,29,1,0,1,0,10,19,,,,,,,,,,
20140526-M-Roland_Garros-R128-Robby_Ginepri-Rafael_Nadal,1,F-DTL,22,11,2,3,6,11,11,,,,,,,,,,
20140526-M-Roland_Garros-R128-Robby_Ginepri-Rafael_Nadal,1,F-IO,28,13,3,2,8,12,16,,,,,,,,,,
20140526-M-Roland_Garros-R128-Robby_Ginepri-Rafael_Nadal,1,F-II,13,4,2,0,2,6,7,,,,,,,,,,
20140526-M-Roland_Garros-R128-Robby_Ginepri-Rafael_Nadal,1,B-XC,32,4,0,1,3,16,16,,,,,,,,,,
20140526-M-Roland_Garros-R128-Robby_Ginepri-Rafael_Nadal,1,B-DTM,35,3,0,0,3,14,21,,,,,,,,,,
20140526-M-Roland_Garros-R128-Robby_Ginepri-Rafael_Nadal,1,B-DTL,20,4,1,0,3,5,15,,,,,,,,,,
20140526-M-Roland_Garros-R128-Robby_Ginepri-Rafael_Nadal,1,B-IO,8,3,1,1,1,7,1,,,,,,,,,,
20140526-M-Roland_Garros-R128-Robby_Ginepri-Rafael_Nadal,1,S-XC,1,0,0,0,0,0,1,,,,,,,,,,
20140526-M-Roland_Garros-R128-Robby_Ginepri-Rafael_Nadal,1,S-DTM,3,0,0,0,0,1,2,,,,,,,,,,
20140526-M-Roland_Garros-R128-Robby_Ginepri-Rafael_Nadal,1,S-DTL,4,1,0,0,1,0,4,,,,,,,,,,
20140526-M-Roland_Garros-R128-Robby_Ginepri-Rafael_Nadal,1,S-IO,1,0,0,0,0,0,1,,,,,,,,,,
20140526-M-Roland_Garros-R128-Robby_Ginepri-Rafael_Nadal,2,F-XC,67,11,4,4,3,43,24,,,,,,,,,,
20140526-M-Roland_Garros-R128-Robby_Ginepri-Rafael_Nadal,2,F-DTM,16,1,0,0,1,7,9,,,,,,,,,,
20140526-M-Roland_Garros-R128-Robby_Ginepri-Rafael_Nadal,2,F-DTL,18,9,3,3,3,11,7,,,,,,,,,,
20140526-M-Roland_Garros-R128-Robby_Ginepri-Rafael_Nadal,2,F-IO,27,9,5,1,3,17,10,,,,,,,,,,
20140526-M-Roland_Garros-R128-Robby_Ginepri-Rafael_Nadal,2,F-II,12,3,2,1,0,8,4,,,,,,,,,,
20140526-M-Roland_Garros-R128-Robby_Ginepri-Rafael_Nadal,2,B-XC,40,6,2,3,1,22,18,,,,,,,,,,
20140526-M-Roland_Garros-R128-Robby_Ginepri-Rafael_Nadal,2,B-DTM,25,3,0,0,3,13,12,,,,,,,,,,
20140526-M-Roland_Garros-R128-Robby_Ginepri-Rafael_Nadal,2,B-DTL,9,2,1,1,0,6,3,,,,,,,,,,
20140526-M-Roland_Garros-R128-Robby_Ginepri-Rafael_Nadal,2,B-IO,1,0,0,0,0,1,0,,,,,,,,,,
20140526-M-Roland_Garros-R128-Robby_Ginepri-Rafael_Nadal,2,S-XC,3,0,0,0,0,3,0,,,,,,,,,,
20140526-M-Roland_Garros-R128-Robby_Ginepri-Rafael_Nadal,2,S-DTM,11,0,0,0,0,6,5,,,,,,,,,,
20140526-M-Roland_Garros-R128-Robby_Ginepri-Rafael_Nadal,2,S-DTL,3,0,0,0,0,2,1,,,,,,,,,,
20140526-M-Roland_Garros-R128-Robby_Ginepri-Rafael_Nadal,2,S-IO,1,0,0,0,0,1,0,,,,,,,,,,
20140531-M-Roland_Garros-R32-Leonardo_Mayer-Rafael_Nadal,1,F-XC,72,13,4,4,5,31,41,,,,,,,,,,
20140531-M-Roland_Garros-R32-Leonardo_Mayer-Rafael_Nadal,1,F-DTM,23,0,0,0,0,7,16,,,,,,,,,,
20140531-M-Roland_Garros-R32-Leonardo_Mayer-Rafael_Nadal,1,F-DTL,7,3,0,0,3,0,7,,,,,,,,,,
20140531-M-Roland_Garros-R32-Leonardo_Mayer-Rafael_Nadal,1,F-IO,25,14,3,3,8,9,16,,,,,,,,,,
20140531-M-Roland_Garros-R32-Leonardo_Mayer-Rafael_Nadal,1,F-II,11,4,2,1,1,5,6,,,,,,,,,,
20140531-M-Roland_Garros-R32-Leonardo_Mayer-Rafael_Nadal,1,B-XC,33,14,1,6,7,11,22,,,,,,,,,,
20140531-M-Roland_Garros-R32-Leonardo_Mayer-Rafael_Nadal,1,B-DTM,27,3,0,0,3,6,21,,,,,,,,,,
20140531-M-Roland_Garros-R32-Leonardo_Mayer-Rafael_Nadal,1,B-DTL,7,4,1,2,1,5,2,,,,,,,,,,
20140531-M-Roland_Garros-R32-Leonardo_Mayer-Rafael_Nadal,1,B-IO,7,3,2,0,1,3,4,,,,,,,,,,
20140531-M-Roland_Garros-R32-Leonardo_Mayer-Rafael_Nadal,1,S-DTM,4,1,0,0,1,0,4,,,,,,,,,,
20140531-M-Roland_Garros-R32-Leonardo_Mayer-Rafael_Nadal,1,S-DTL,4,0,0,0,0,1,3,,,,,,,,,,
20140531-M-Roland_Garros-R32-Leonardo_Mayer-Rafael_Nadal,2,F-XC,64,10,3,7,0,52,12,,,,,,,,,,
20140531-M-Roland_Garros-R32-Leonardo_Mayer-Rafael_Nadal,2,F-DTM,16,1,0,0,1,11,5,,,,,,,,,,
20140531-M-Roland_Garros-R32-Leonardo_Mayer-Rafael_Nadal,2,F-DTL,16,8,6,0,2,9,7,,,,,,,,,,
20140531-M-Roland_Garros-R32-Leonardo_Mayer-Rafael_Nadal,2,F-IO,27,12,5,5,2,22,5,,,,,,,,,,
20140531-M-Roland_Garros-R32-Leonardo_Mayer-Rafael_Nadal,2,F-II,5,1,1,0,0,4,1,,,,,,,,,,
20140531-M-Roland_Garros-R32-Leonardo_Mayer-Rafael_Nadal,2,B-XC,39,11,5,4,2,25,14,,,,,,,,,,
20140531-M-Roland_Garros-R32-Leonardo_Mayer-Rafael_Nadal,2,B-DTM,28,1,0,1,0,18,10,,,,,,,,,,
20140531-M-Roland_Garros-R32-Leonardo_Mayer-Rafael_Nadal,2,B-DTL,9,2,0,1,1,4,5,,,,,,,,,,
20140531-M-Roland_Garros-R32-Leonardo_Mayer-Rafael_Nadal,2,B-IO,5,1,1,0,0,2,3,,,,,,,,,,
20140531-M-Roland_Garros-R32-Leonardo_Mayer-Rafael_Nadal,2,S-XC,2,0,0,0,0,0,2,,,,,,,,,,
20140531-M-Roland_Garros-R32-Leonardo_Mayer-Rafael_Nadal,2,S-DTM,5,1,0,0,1,3,2,,,,,,,,,,
20140531-M-Roland_Garros-R32-Leonardo_Mayer-Rafael_Nadal,2,S-DTL,6,2,0,1,1,2,4,,,,,,,,,,
20140601-M-Roland_Garros-R16-Rafael_Nadal-Dusan_Lajovic,1,F-XC,57,9,1,7,1,50,7,,,,,,,,,,
20140601-M-Roland_Garros-R16-Rafael_Nadal-Dusan_Lajovic,1,F-DTM,24,2,1,1,0,19,5,,,,,,,,,,
20140601-M-Roland_Garros-R16-Rafael_Nadal-Dusan_Lajovic,1,F-DTL,9,5,2,3,0,8,1,,,,,,,,,,
20140601-M-Roland_Garros-R16-Rafael_Nadal-Dusan_Lajovic,1,F-IO,24,10,6,2,2,19,5,,,,,,,,,,
20140601-M-Roland_Garros-R16-Rafael_Nadal-Dusan_Lajovic,1,F-II,8,1,0,1,0,6,2,,,,,,,,,,
20140601-M-Roland_Garros-R16-Rafael_Nadal-Dusan_Lajovic,1,B-XC,35,8,1,2,5,27,8,,,,,,,,,,
20140601-M-Roland_Garros-R16-Rafael_Nadal-Dusan_Lajovic,1,B-DTM,30,2,0,0,2,21,9,,,,,,,,,,
20140601-M-Roland_Garros-R16-Rafael_Nadal-Dusan_Lajovic,1,B-DTL,15,2,0,2,0,14,1,,,,,,,,,,
20140601-M-Roland_Garros-R16-Rafael_Nadal-Dusan_Lajovic,1,B-IO,6,2,0,1,1,3,3,,,,,,,,,,
20140601-M-Roland_Garros-R16-Rafael_Nadal-Dusan_Lajovic,1,S-DTM,3,0,0,0,0,1,2,,,,,,,,,,
20140601-M-Roland_Garros-R16-Rafael_Nadal-Dusan_Lajovic,1,S-DTL,2,0,0,0,0,1,1,,,,,,,,,,
20140601-M-Roland_Garros-R16-Rafael_Nadal-Dusan_Lajovic,1,S-IO,1,1,0,0,1,0,1,,,,,,,,,,
20140601-M-Roland_Garros-R16-Rafael_Nadal-Dusan_Lajovic,2,F-XC,63,7,1,1,5,14,49,,,,,,,,,,
20140601-M-Roland_Garros-R16-Rafael_Nadal-Dusan_Lajovic,2,F-DTM,22,0,0,0,0,2,20,,,,,,,,,,
20140601-M-Roland_Garros-R16-Rafael_Nadal-Dusan_Lajovic,2,F-DTL,5,2,0,1,1,1,4,,,,,,,,,,
20140601-M-Roland_Garros-R16-Rafael_Nadal-Dusan_Lajovic,2,F-IO,11,2,0,0,2,2,9,,,,,,,,,,
20140601-M-Roland_Garros-R16-Rafael_Nadal-Dusan_Lajovic,2,F-II,4,2,0,0,2,1,3,,,,,,,,,,
20140601-M-Roland_Garros-R16-Rafael_Nadal-Dusan_Lajovic,2,B-XC,24,6,1,2,3,7,17,,,,,,,,,,
20140601-M-Roland_Garros-R16-Rafael_Nadal-Dusan_Lajovic,2,B-DTM,45,6,0,0,6,7,38,,,,,,,,,,
20140601-M-Roland_Garros-R16-Rafael_Nadal-Dusan_Lajovic,2,B-DTL,20,5,1,0,4,2,18,,,,,,,,,,
20140601-M-Roland_Garros-R16-Rafael_Nadal-Dusan_Lajovic,2,B-IO,8,1,0,0,1,2,6,,,,,,,,,,
20140601-M-Roland_Garros-R16-Rafael_Nadal-Dusan_Lajovic,2,B-II,1,0,0,0,0,1,0,,,,,,,,,,
20140601-M-Roland_Garros-R16-Rafael_Nadal-Dusan_Lajovic,2,S-XC,2,0,0,0,0,0,2,,,,,,,,,,
20140601-M-Roland_Garros-R16-Rafael_Nadal-Dusan_Lajovic,2,S-DTM,2,0,0,0,0,0,2,,,,,,,,,,
20140601-M-Roland_Garros-R16-Rafael_Nadal-Dusan_Lajovic,2,S-DTL,1,0,0,0,0,0,1,,,,,,,,,,
20140601-M-Roland_Garros-R16-Rafael_Nadal-Dusan_Lajovic,2,S-IO,1,0,0,0,0,0,1,,,,,,,,,,
20140604-M-Roland_Garros-QF-David_Ferrer-Rafael_Nadal,1,F-XC,123,17,3,3,11,55,68,,,,,,,,,,
20140604-M-Roland_Garros-QF-David_Ferrer-Rafael_Nadal,1,F-DTM,38,4,0,0,4,14,24,,,,,,,,,,
20140604-M-Roland_Garros-QF-David_Ferrer-Rafael_Nadal,1,F-DTL,10,4,0,2,2,6,4,,,,,,,,,,
20140604-M-Roland_Garros-QF-David_Ferrer-Rafael_Nadal,1,F-IO,39,26,10,4,12,20,19,,,,,,,,,,
20140604-M-Roland_Garros-QF-David_Ferrer-Rafael_Nadal,1,F-II,18,6,2,0,4,10,8,,,,,,,,,,
20140604-M-Roland_Garros-QF-David_Ferrer-Rafael_Nadal,1,B-XC,29,3,0,1,2,14,15,,,,,,,,,,
20140604-M-Roland_Garros-QF-David_Ferrer-Rafael_Nadal,1,B-DTM,43,3,0,0,3,17,26,,,,,,,,,,
20140604-M-Roland_Garros-QF-David_Ferrer-Rafael_Nadal,1,B-DTL,36,10,1,1,8,16,20,,,,,,,,,,
20140604-M-Roland_Garros-QF-David_Ferrer-Rafael_Nadal,1,B-IO,8,2,0,1,1,5,3,,,,,,,,,,
20140604-M-Roland_Garros-QF-David_Ferrer-Rafael_Nadal,1,S-DTM,2,0,0,0,0,0,2,,,,,,,,,,
20140604-M-Roland_Garros-QF-David_Ferrer-Rafael_Nadal,2,F-XC,73,7,2,4,1,47,26,,,,,,,,,,
20140604-M-Roland_Garros-QF-David_Ferrer-Rafael_Nadal,2,F-DTM,36,2,0,0,2,15,21,,,,,,,,,,
20140604-M-Roland_Garros-QF-David_Ferrer-Rafael_Nadal,2,F-DTL,10,3,1,1,1,4,6,,,,,,,,,,
20140604-M-Roland_Garros-QF-David_Ferrer-Rafael_Nadal,2,F-IO,41,18,7,8,3,27,14,,,,,,,,,,
20140604-M-Roland_Garros-QF-David_Ferrer-Rafael_Nadal,2,F-II,18,3,2,0,1,8,10,,,,,,,,,,
20140604-M-Roland_Garros-QF-David_Ferrer-Rafael_Nadal,2,B-XC,56,13,2,3,8,26,30,,,,,,,,,,
20140604-M-Roland_Garros-QF-David_Ferrer-Rafael_Nadal,2,B-DTM,52,5,0,2,3,29,23,,,,,,,,,,
20140604-M-Roland_Garros-QF-David_Ferrer-Rafael_Nadal,2,B-DTL,35,6,2,1,3,19,16,,,,,,,,,,
20140604-M-Roland_Garros-QF-David_Ferrer-Rafael_Nadal,2,B-IO,3,1,0,0,1,1,2,,,,,,,,,,
20140604-M-Roland_Garros-QF-David_Ferrer-Rafael_Nadal,2,S-XC,4,0,0,0,0,2,2,,,,,,,,,,
20140604-M-Roland_Garros-QF-David_Ferrer-Rafael_Nadal,2,S-DTM,3,0,0,0,0,1,2,,,,,,,,,,
20140604-M-Roland_Garros-QF-David_Ferrer-Rafael_Nadal,2,S-DTL,6,0,0,0,0,2,4,,,,,,,,,,
20140606-M-Roland_Garros-SF-Rafael_Nadal-Andy_Murray,1,F-XC,39,6,2,4,0,27,12,,,,,,,,,,
20140606-M-Roland_Garros-SF-Rafael_Nadal-Andy_Murray,1,F-DTM,16,2,0,0,2,6,10,,,,,,,,,,
20140606-M-Roland_Garros-SF-Rafael_Nadal-Andy_Murray,1,F-DTL,11,5,3,2,0,8,3,,,,,,,,,,
20140606-M-Roland_Garros-SF-Rafael_Nadal-Andy_Murray,1,F-IO,39,21,12,6,3,31,8,,,,,,,,,,
20140606-M-Roland_Garros-SF-Rafael_Nadal-Andy_Murray,1,F-II,9,2,0,2,0,7,2,,,,,,,,,,
20140606-M-Roland_Garros-SF-Rafael_Nadal-Andy_Murray,1,B-XC,23,0,0,0,0,14,9,,,,,,,,,,
20140606-M-Roland_Garros-SF-Rafael_Nadal-Andy_Murray,1,B-DTM,23,3,0,0,3,9,14,,,,,,,,,,
20140606-M-Roland_Garros-SF-Rafael_Nadal-Andy_Murray,1,B-DTL,9,1,0,0,1,5,4,,,,,,,,,,
20140606-M-Roland_Garros-SF-Rafael_Nadal-Andy_Murray,1,B-IO,1,0,0,0,0,1,0,,,,,,,,,,
20140606-M-Roland_Garros-SF-Rafael_Nadal-Andy_Murray,1,S-XC,2,0,0,0,0,1,1,,,,,,,,,,
20140606-M-Roland_Garros-SF-Rafael_Nadal-Andy_Murray,1,S-DTM,1,0,0,0,0,0,1,,,,,,,,,,
20140606-M-Roland_Garros-SF-Rafael_Nadal-Andy_Murray,1,S-DTL,4,1,1,0,0,2,2,,,,,,,,,,
20140606-M-Roland_Garros-SF-Rafael_Nadal-Andy_Murray,1,S-IO,1,1,0,1,0,1,0,,,,,,,,,,
20140606-M-Roland_Garros-SF-Rafael_Nadal-Andy_Murray,2,F-XC,59,7,1,2,4,31,28,,,,,,,,,,
20140606-M-Roland_Garros-SF-Rafael_Nadal-Andy_Murray,2,F-DTM,19,2,0,1,1,6,13,,,,,,,,,,
20140606-M-Roland_Garros-SF-Rafael_Nadal-Andy_Murray,2,F-DTL,11,7,2,0,5,5,6,,,,,,,,,,
20140606-M-Roland_Garros-SF-Rafael_Nadal-Andy_Murray,2,F-IO,16,7,3,1,3,9,7,,,,,,,,,,
20140606-M-Roland_Garros-SF-Rafael_Nadal-Andy_Murray,2,F-II,1,1,0,1,0,1,0,,,,,,,,,,
20140606-M-Roland_Garros-SF-Rafael_Nadal-Andy_Murray,2,B-XC,16,6,0,3,3,6,10,,,,,,,,,,
20140606-M-Roland_Garros-SF-Rafael_Nadal-Andy_Murray,2,B-DTM,29,1,0,0,1,9,20,,,,,,,,,,
20140606-M-Roland_Garros-SF-Rafael_Nadal-Andy_Murray,2,B-DTL,14,4,1,0,3,5,9,,,,,,,,,,
20140606-M-Roland_Garros-SF-Rafael_Nadal-Andy_Murray,2,B-IO,7,1,0,0,1,2,5,,,,,,,,,,
20140606-M-Roland_Garros-SF-Rafael_Nadal-Andy_Murray,2,B-II,1,0,0,0,0,0,1,,,,,,,,,,
20140606-M-Roland_Garros-SF-Rafael_Nadal-Andy_Murray,2,S-XC,2,0,0,0,0,1,1,,,,,,,,,,
20140606-M-Roland_Garros-SF-Rafael_Nadal-Andy_Murray,2,S-DTM,2,0,0,0,0,1,1,,,,,,,,,,
20140606-M-Roland_Garros-SF-Rafael_Nadal-Andy_Murray,2,S-DTL,1,0,0,0,0,1,0,,,,,,,,,,
20140608-M-Roland_Garros-F-Novak_Djokovic-Rafael_Nadal,1,F-XC,80,11,5,3,3,45,35,,,,,,,,,,
20140608-M-Roland_Garros-F-Novak_Djokovic-Rafael_Nadal,1,F-DTM,27,1,0,0,1,12,15,,,,,,,,,,
20140608-M-Roland_Garros-F-Novak_Djokovic-Rafael_Nadal,1,F-DTL,17,10,5,2,3,10,7,,,,,,,,,,
20140608-M-Roland_Garros-F-Novak_Djokovic-Rafael_Nadal,1,F-IO,59,16,6,4,6,37,22,,,,,,,,,,
20140608-M-Roland_Garros-F-Novak_Djokovic-Rafael_Nadal,1,F-II,3,1,0,0,1,0,3,,,,,,,,,,
20140608-M-Roland_Garros-F-Novak_Djokovic-Rafael_Nadal,1,B-XC,69,19,5,4,10,34,35,,,,,,,,,,
20140608-M-Roland_Garros-F-Novak_Djokovic-Rafael_Nadal,1,B-DTM,43,3,0,1,2,25,18,,,,,,,,,,
20140608-M-Roland_Garros-F-Novak_Djokovic-Rafael_Nadal,1,B-DTL,45,11,2,1,8,18,27,,,,,,,,,,
20140608-M-Roland_Garros-F-Novak_Djokovic-Rafael_Nadal,1,B-IO,12,2,0,1,1,7,5,,,,,,,,,,
20140608-M-Roland_Garros-F-Novak_Djokovic-Rafael_Nadal,1,S-XC,1,0,0,0,0,0,1,,,,,,,,,,
20140608-M-Roland_Garros-F-Novak_Djokovic-Rafael_Nadal,1,S-DTM,1,0,0,0,0,1,0,,,,,,,,,,
20140608-M-Roland_Garros-F-Novak_Djokovic-Rafael_Nadal,2,F-XC,108,14,3,8,3,54,54,,,,,,,,,,
20140608-M-Roland_Garros-F-Novak_Djokovic-Rafael_Nadal,2,F-DTM,27,1,0,0,1,11,16,,,,,,,,,,
20140608-M-Roland_Garros-F-Novak_Djokovic-Rafael_Nadal,2,F-DTL,34,17,10,3,4,24,10,,,,,,,,,,
20140608-M-Roland_Garros-F-Novak_Djokovic-Rafael_Nadal,2,F-IO,44,21,12,1,8,26,18,,,,,,,,,,
20140608-M-Roland_Garros-F-Novak_Djokovic-Rafael_Nadal,2,F-II,8,3,1,1,1,4,4,,,,,,,,,,
20140608-M-Roland_Garros-F-Novak_Djokovic-Rafael_Nadal,2,B-XC,58,15,3,5,7,30,28,,,,,,,,,,
20140608-M-Roland_Garros-F-Novak_Djokovic-Rafael_Nadal,2,B-DTM,35,2,0,0,2,10,25,,,,,,,,,,
20140608-M-Roland_Garros-F-Novak_Djokovic-Rafael_Nadal,2,B-DTL,23,6,2,1,3,12,11,,,,,,,,,,
20140608-M-Roland_Garros-F-Novak_Djokovic-Rafael_Nadal,2,B-IO,6,4,1,1,2,4,2,,,,,,,,,,
20140608-M-Roland_Garros-F-Novak_Djokovic-Rafael_Nadal,2,S-XC,3,0,0,0,0,2,1,,,,,,,,,,
20140608-M-Roland_Garros-F-Novak_Djokovic-Rafael_Nadal,2,S-DTM,5,0,0,0,0,3,2,,,,,,,,,,
20140608-M-Roland_Garros-F-Novak_Djokovic-Rafael_Nadal,2,S-DTL,11,1,0,1,0,7,4,,,,,,,,,,
20140608-M-Roland_Garros-F-Novak_Djokovic-Rafael_Nadal,2,S-II,1,0,0,0,0,0,1,,,,,,,,,,
20140609-M-Prague_CH-R32-Steven_Diez-Renzo_Olivo,1,F-XC,30,10,3,2,5,13,17,,,,,,,,,,
20140609-M-Prague_CH-R32-Steven_Diez-Renzo_Olivo,1,F-DTM,23,1,0,0,1,13,10,,,,,,,,,,
20140609-M-Prague_CH-R32-Steven_Diez-Renzo_Olivo,1,F-DTL,12,6,1,2,3,5,7,,,,,,,,,,
20140609-M-Prague_CH-R32-Steven_Diez-Renzo_Olivo,1,F-IO,37,9,1,4,4,21,16,,,,,,,,,,
20140609-M-Prague_CH-R32-Steven_Diez-Renzo_Olivo,1,F-II,3,2,2,0,0,2,1,,,,,,,,,,
20140609-M-Prague_CH-R32-Steven_Diez-Renzo_Olivo,1,B-XC,83,10,1,3,6,51,32,,,,,,,,,,
20140609-M-Prague_CH-R32-Steven_Diez-Renzo_Olivo,1,B-DTM,19,2,0,0,2,9,10,,,,,,,,,,
20140609-M-Prague_CH-R32-Steven_Diez-Renzo_Olivo,1,B-DTL,12,4,1,2,1,9,3,,,,,,,,,,
20140609-M-Prague_CH-R32-Steven_Diez-Renzo_Olivo,1,B-IO,5,2,1,0,1,3,2,,,,,,,,,,
20140609-M-Prague_CH-R32-Steven_Diez-Renzo_Olivo,1,B-II,1,0,0,0,0,0,1,,,,,,,,,,
20140609-M-Prague_CH-R32-Steven_Diez-Renzo_Olivo,1,S-XC,2,1,0,1,0,2,0,,,,,,,,,,
20140609-M-Prague_CH-R32-Steven_Diez-Renzo_Olivo,1,S-DTM,1,0,0,0,0,1,0,,,,,,,,,,
20140609-M-Prague_CH-R32-Steven_Diez-Renzo_Olivo,1,S-DTL,1,0,0,0,0,0,1,,,,,,,,,,
20140609-M-Prague_CH-R32-Steven_Diez-Renzo_Olivo,2,F-XC,28,3,1,1,1,16,12,,,,,,,,,,
20140609-M-Prague_CH-R32-Steven_Diez-Renzo_Olivo,2,F-DTM,25,1,0,0,1,12,13,,,,,,,,,,
20140609-M-Prague_CH-R32-Steven_Diez-Renzo_Olivo,2,F-DTL,13,3,0,1,2,7,6,,,,,,,,,,
20140609-M-Prague_CH-R32-Steven_Diez-Renzo_Olivo,2,F-IO,51,14,1,2,11,14,37,,,,,,,,,,
20140609-M-Prague_CH-R32-Steven_Diez-Renzo_Olivo,2,F-II,10,3,0,0,3,5,5,,,,,,,,,,
20140609-M-Prague_CH-R32-Steven_Diez-Renzo_Olivo,2,B-XC,46,9,0,1,8,17,29,,,,,,,,,,
20140609-M-Prague_CH-R32-Steven_Diez-Renzo_Olivo,2,B-DTM,23,2,0,0,2,8,15,,,,,,,,,,
20140609-M-Prague_CH-R32-Steven_Diez-Renzo_Olivo,2,B-DTL,3,3,1,1,1,2,1,,,,,,,,,,
20140609-M-Prague_CH-R32-Steven_Diez-Renzo_Olivo,2,S-XC,12,1,0,0,1,4,8,,,,,,,,,,
20140609-M-Prague_CH-R32-Steven_Diez-Renzo_Olivo,2,S-DTM,5,0,0,0,0,3,2,,,,,,,,,,
20140609-M-Prague_CH-R32-Steven_Diez-Renzo_Olivo,2,S-DTL,3,1,0,0,1,0,3,,,,,,,,,,
20140609-M-Queens_Club-R32-Grigor_Dimitrov-James_Ward,1,F-XC,23,8,4,2,2,17,6,,,,,,,,,,
20140609-M-Queens_Club-R32-Grigor_Dimitrov-James_Ward,1,F-DTM,11,1,1,0,0,6,5,,,,,,,,,,
20140609-M-Queens_Club-R32-Grigor_Dimitrov-James_Ward,1,F-DTL,7,2,2,0,0,6,1,,,,,,,,,,
20140609-M-Queens_Club-R32-Grigor_Dimitrov-James_Ward,1,F-IO,23,10,3,1,6,14,9,,,,,,,,,,
20140609-M-Queens_Club-R32-Grigor_Dimitrov-James_Ward,1,B-XC,9,2,0,1,1,4,5,,,,,,,,,,
20140609-M-Queens_Club-R32-Grigor_Dimitrov-James_Ward,1,B-DTM,4,1,0,0,1,1,3,,,,,,,,,,
20140609-M-Queens_Club-R32-Grigor_Dimitrov-James_Ward,1,B-DTL,1,0,0,0,0,1,0,,,,,,,,,,
20140609-M-Queens_Club-R32-Grigor_Dimitrov-James_Ward,1,S-XC,8,0,0,0,0,2,6,,,,,,,,,,
20140609-M-Queens_Club-R32-Grigor_Dimitrov-James_Ward,1,S-DTM,5,1,0,0,1,2,3,,,,,,,,,,
20140609-M-Queens_Club-R32-Grigor_Dimitrov-James_Ward,1,S-DTL,1,0,0,0,0,1,0,,,,,,,,,,
20140609-M-Queens_Club-R32-Grigor_Dimitrov-James_Ward,1,S-IO,1,0,0,0,0,0,1,,,,,,,,,,
20140609-M-Queens_Club-R32-Grigor_Dimitrov-James_Ward,2,F-XC,21,5,2,1,2,8,13,,,,,,,,,,
20140609-M-Queens_Club-R32-Grigor_Dimitrov-James_Ward,2,F-DTM,14,4,0,0,4,5,9,,,,,,,,,,
20140609-M-Queens_Club-R32-Grigor_Dimitrov-James_Ward,2,F-DTL,3,1,1,0,0,2,1,,,,,,,,,,
20140609-M-Queens_Club-R32-Grigor_Dimitrov-James_Ward,2,F-IO,3,2,0,2,0,3,0,,,,,,,,,,
20140609-M-Queens_Club-R32-Grigor_Dimitrov-James_Ward,2,B-XC,23,3,0,1,2,15,8,,,,,,,,,,
20140609-M-Queens_Club-R32-Grigor_Dimitrov-James_Ward,2,B-DTM,17,2,0,2,0,8,9,,,,,,,,,,
20140609-M-Queens_Club-R32-Grigor_Dimitrov-James_Ward,2,B-DTL,4,1,0,0,1,1,3,,,,,,,,,,
20140609-M-Queens_Club-R32-Grigor_Dimitrov-James_Ward,2,S-XC,4,3,0,2,1,2,2,,,,,,,,,,
20140609-M-Queens_Club-R32-Grigor_Dimitrov-James_Ward,2,S-DTM,4,0,0,0,0,2,2,,,,,,,,,,
20140609-M-Queens_Club-R32-Grigor_Dimitrov-James_Ward,2,S-DTL,2,0,0,0,0,0,2,,,,,,,,,,
20140612-M-Halle-R16-Dustin_Brown-Rafael_Nadal,1,F-XC,2,1,0,1,0,2,0,,,,,,,,,,
20140612-M-Halle-R16-Dustin_Brown-Rafael_Nadal,1,F-DTM,1,1,0,1,0,1,0,,,,,,,,,,
20140612-M-Halle-R16-Dustin_Brown-Rafael_Nadal,1,F-DTL,1,1,0,0,1,0,1,,,,,,,,,,
20140612-M-Halle-R16-Dustin_Brown-Rafael_Nadal,1,F-IO,1,1,1,0,0,1,0,,,,,,,,,,
20140612-M-Halle-R16-Dustin_Brown-Rafael_Nadal,1,B-XC,1,1,0,0,1,0,1,,,,,,,,,,
20140612-M-Halle-R16-Dustin_Brown-Rafael_Nadal,1,B-DTM,1,1,0,1,0,1,0,,,,,,,,,,
20140612-M-Halle-R16-Dustin_Brown-Rafael_Nadal,1,B-DTL,1,0,0,0,0,1,0,,,,,,,,,,
20140612-M-Halle-R16-Dustin_Brown-Rafael_Nadal,2,F-XC,5,2,0,2,0,2,3,,,,,,,,,,
20140612-M-Halle-R16-Dustin_Brown-Rafael_Nadal,2,F-DTM,4,1,1,0,0,1,3,,,,,,,,,,
20140612-M-Halle-R16-Dustin_Brown-Rafael_Nadal,2,F-DTL,3,2,2,0,0,2,1,,,,,,,,,,
20140612-M-Halle-R16-Dustin_Brown-Rafael_Nadal,2,F-IO,3,2,0,1,1,2,1,,,,,,,,,,
20140612-M-Halle-R16-Dustin_Brown-Rafael_Nadal,2,F-II,2,1,0,1,0,1,1,,,,,,,,,,
20140612-M-Halle-R16-Dustin_Brown-Rafael_Nadal,2,B-XC,3,2,2,0,0,3,0,,,,,,,,,,
20140612-M-Halle-R16-Dustin_Brown-Rafael_Nadal,2,B-DTM,6,0,0,0,0,0,6,,,,,,,,,,
20140612-M-Halle-R16-Dustin_Brown-Rafael_Nadal,2,S-DTL,2,1,0,0,1,0,2,,,,,,,,,,
20140614-M-Queens_Club-SF-Stanislas_Wawrinka-Grigor_Dimitrov,1,F-XC,24,9,3,2,4,15,9,,,,,,,,,,
20140614-M-Queens_Club-SF-Stanislas_Wawrinka-Grigor_Dimitrov,1,F-DTM,8,0,0,0,0,3,5,,,,,,,,,,
20140614-M-Queens_Club-SF-Stanislas_Wawrinka-Grigor_Dimitrov,1,F-DTL,4,0,0,0,0,2,2,,,,,,,,,,
20140614-M-Queens_Club-SF-Stanislas_Wawrinka-Grigor_Dimitrov,1,F-IO,13,6,1,2,3,5,8,,,,,,,,,,
20140614-M-Queens_Club-SF-Stanislas_Wawrinka-Grigor_Dimitrov,1,F-II,1,0,0,0,0,1,0,,,,,,,,,,
20140614-M-Queens_Club-SF-Stanislas_Wawrinka-Grigor_Dimitrov,1,B-XC,22,4,2,0,2,11,11,,,,,,,,,,
20140614-M-Queens_Club-SF-Stanislas_Wawrinka-Grigor_Dimitrov,1,B-DTM,3,0,0,0,0,3,0,,,,,,,,,,
20140614-M-Queens_Club-SF-Stanislas_Wawrinka-Grigor_Dimitrov,1,B-DTL,7,3,1,0,2,3,4,,,,,,,,,,
20140614-M-Queens_Club-SF-Stanislas_Wawrinka-Grigor_Dimitrov,1,B-IO,1,0,0,0,0,1,0,,,,,,,,,,
20140614-M-Queens_Club-SF-Stanislas_Wawrinka-Grigor_Dimitrov,1,S-XC,6,1,0,0,1,5,1,,,,,,,,,,
20140614-M-Queens_Club-SF-Stanislas_Wawrinka-Grigor_Dimitrov,1,S-DTM,2,0,0,0,0,0,2,,,,,,,,,,
20140614-M-Queens_Club-SF-Stanislas_Wawrinka-Grigor_Dimitrov,2,F-XC,19,7,1,3,3,10,9,,,,,,,,,,
20140614-M-Queens_Club-SF-Stanislas_Wawrinka-Grigor_Dimitrov,2,F-DTM,10,1,0,1,0,3,7,,,,,,,,,,
20140614-M-Queens_Club-SF-Stanislas_Wawrinka-Grigor_Dimitrov,2,F-DTL,7,1,1,0,0,3,4,,,,,,,,,,
20140614-M-Queens_Club-SF-Stanislas_Wawrinka-Grigor_Dimitrov,2,F-IO,10,6,3,2,1,8,2,,,,,,,,,,
20140614-M-Queens_Club-SF-Stanislas_Wawrinka-Grigor_Dimitrov,2,F-II,2,0,0,0,0,1,1,,,,,,,,,,
20140614-M-Queens_Club-SF-Stanislas_Wawrinka-Grigor_Dimitrov,2,B-XC,10,3,0,2,1,7,3,,,,,,,,,,
20140614-M-Queens_Club-SF-Stanislas_Wawrinka-Grigor_Dimitrov,2,B-DTM,10,2,0,0,2,3,7,,,,,,,,,,
20140614-M-Queens_Club-SF-Stanislas_Wawrinka-Grigor_Dimitrov,2,B-DTL,6,2,2,0,0,4,2,,,,,,,,,,
20140614-M-Queens_Club-SF-Stanislas_Wawrinka-Grigor_Dimitrov,2,S-XC,8,1,0,1,0,4,4,,,,,,,,,,
20140614-M-Queens_Club-SF-Stanislas_Wawrinka-Grigor_Dimitrov,2,S-DTM,7,1,0,0,1,3,4,,,,,,,,,,
20140614-M-Queens_Club-SF-Stanislas_Wawrinka-Grigor_Dimitrov,2,S-DTL,1,1,0,1,0,1,0,,,,,,,,,,
20140616-M-Eastbourne-R32-Ivo_Karlovic-Jeremy_Chardy,1,F-XC,5,1,0,1,0,4,1,,,,,,,,,,
20140616-M-Eastbourne-R32-Ivo_Karlovic-Jeremy_Chardy,1,F-DTM,2,0,0,0,0,0,2,,,,,,,,,,
20140616-M-Eastbourne-R32-Ivo_Karlovic-Jeremy_Chardy,1,F-DTL,4,2,0,0,2,2,2,,,,,,,,,,
20140616-M-Eastbourne-R32-Ivo_Karlovic-Jeremy_Chardy,1,F-IO,2,0,0,0,0,1,1,,,,,,,,,,
20140616-M-Eastbourne-R32-Ivo_Karlovic-Jeremy_Chardy,1,B-DTM,1,0,0,0,0,0,1,,,,,,,,,,
20140616-M-Eastbourne-R32-Ivo_Karlovic-Jeremy_Chardy,1,B-DTL,1,1,0,0,1,0,1,,,,,,,,,,
20140616-M-Eastbourne-R32-Ivo_Karlovic-Jeremy_Chardy,1,S-XC,5,1,1,0,0,5,0,,,,,,,,,,
20140616-M-Eastbourne-R32-Ivo_Karlovic-Jeremy_Chardy,1,S-DTM,5,0,0,0,0,2,3,,,,,,,,,,
20140616-M-Eastbourne-R32-Ivo_Karlovic-Jeremy_Chardy,1,S-DTL,3,0,0,0,0,1,2,,,,,,,,,,
20140616-M-Eastbourne-R32-Ivo_Karlovic-Jeremy_Chardy,2,F-XC,9,3,0,1,2,5,4,,,,,,,,,,
20140616-M-Eastbourne-R32-Ivo_Karlovic-Jeremy_Chardy,2,F-DTM,5,0,0,0,0,3,2,,,,,,,,,,
20140616-M-Eastbourne-R32-Ivo_Karlovic-Jeremy_Chardy,2,F-DTL,5,0,0,0,0,2,3,,,,,,,,,,
20140616-M-Eastbourne-R32-Ivo_Karlovic-Jeremy_Chardy,2,F-IO,10,5,2,1,2,7,3,,,,,,,,,,
20140616-M-Eastbourne-R32-Ivo_Karlovic-Jeremy_Chardy,2,F-II,6,2,1,1,0,3,3,,,,,,,,,,
20140616-M-Eastbourne-R32-Ivo_Karlovic-Jeremy_Chardy,2,B-XC,1,0,0,0,0,0,1,,,,,,,,,,
20140616-M-Eastbourne-R32-Ivo_Karlovic-Jeremy_Chardy,2,B-DTL,1,0,0,0,0,0,1,,,,,,,,,,
20140616-M-Eastbourne-R32-Ivo_Karlovic-Jeremy_Chardy,2,B-IO,1,1,0,1,0,1,0,,,,,,,,,,
20140616-M-Eastbourne-R32-Ivo_Karlovic-Jeremy_Chardy,2,S-XC,4,1,0,0,1,1,3,,,,,,,,,,
20140616-M-Eastbourne-R32-Ivo_Karlovic-Jeremy_Chardy,2,S-DTM,2,0,0,0,0,1,1,,,,,,,,,,
20140616-M-Eastbourne-R32-Ivo_Karlovic-Jeremy_Chardy,2,S-IO,1,1,0,1,0,1,0,,,,,,,,,,
20140625-M-Wimbledon-R64-Tomas_Berdych-Bernard_Tomic,1,F-XC,58,24,17,4,3,45,13,,,,,,,,,,
20140625-M-Wimbledon-R64-Tomas_Berdych-Bernard_Tomic,1,F-DTM,20,1,0,0,1,15,5,,,,,,,,,,
20140625-M-Wimbledon-R64-Tomas_Berdych-Bernard_Tomic,1,F-DTL,16,3,2,0,1,9,7,,,,,,,,,,
20140625-M-Wimbledon-R64-Tomas_Berdych-Bernard_Tomic,1,F-IO,36,15,7,5,3,29,7,,,,,,,,,,
20140625-M-Wimbledon-R64-Tomas_Berdych-Bernard_Tomic,1,F-II,4,2,2,0,0,4,0,,,,,,,,,,
20140625-M-Wimbledon-R64-Tomas_Berdych-Bernard_Tomic,1,B-XC,31,3,1,0,2,21,10,,,,,,,,,,
20140625-M-Wimbledon-R64-Tomas_Berdych-Bernard_Tomic,1,B-DTM,21,3,0,1,2,12,9,,,,,,,,,,
20140625-M-Wimbledon-R64-Tomas_Berdych-Bernard_Tomic,1,B-DTL,15,3,1,0,2,9,6,,,,,,,,,,
20140625-M-Wimbledon-R64-Tomas_Berdych-Bernard_Tomic,1,B-II,1,0,0,0,0,0,1,,,,,,,,,,
20140625-M-Wimbledon-R64-Tomas_Berdych-Bernard_Tomic,1,S-XC,11,3,0,0,3,4,7,,,,,,,,,,
20140625-M-Wimbledon-R64-Tomas_Berdych-Bernard_Tomic,1,S-DTM,3,1,0,0,1,0,3,,,,,,,,,,
20140625-M-Wimbledon-R64-Tomas_Berdych-Bernard_Tomic,1,S-DTL,5,2,0,1,1,2,3,,,,,,,,,,
20140625-M-Wimbledon-R64-Tomas_Berdych-Bernard_Tomic,1,S-IO,1,0,0,0,0,0,1,,,,,,,,,,
20140625-M-Wimbledon-R64-Tomas_Berdych-Bernard_Tomic,1,S-II,2,0,0,0,0,0,2,,,,,,,,,,
20140625-M-Wimbledon-R64-Tomas_Berdych-Bernard_Tomic,2,F-XC,48,15,7,3,5,23,25,,,,,,,,,,
20140625-M-Wimbledon-R64-Tomas_Berdych-Bernard_Tomic,2,F-DTM,13,1,0,0,1,4,9,,,,,,,,,,
20140625-M-Wimbledon-R64-Tomas_Berdych-Bernard_Tomic,2,F-DTL,22,5,2,1,2,7,15,,,,,,,,,,
20140625-M-Wimbledon-R64-Tomas_Berdych-Bernard_Tomic,2,F-IO,34,10,1,7,2,20,14,,,,,,,,,,
20140625-M-Wimbledon-R64-Tomas_Berdych-Bernard_Tomic,2,F-II,3,0,0,0,0,1,2,,,,,,,,,,
20140625-M-Wimbledon-R64-Tomas_Berdych-Bernard_Tomic,2,B-XC,23,6,2,2,2,11,12,,,,,,,,,,
20140625-M-Wimbledon-R64-Tomas_Berdych-Bernard_Tomic,2,B-DTM,15,1,0,0,1,7,8,,,,,,,,,,
20140625-M-Wimbledon-R64-Tomas_Berdych-Bernard_Tomic,2,B-DTL,16,7,1,3,3,6,10,,,,,,,,,,
20140625-M-Wimbledon-R64-Tomas_Berdych-Bernard_Tomic,2,B-IO,6,2,0,1,1,3,3,,,,,,,,,,
20140625-M-Wimbledon-R64-Tomas_Berdych-Bernard_Tomic,2,B-II,1,0,0,0,0,1,0,,,,,,,,,,
20140625-M-Wimbledon-R64-Tomas_Berdych-Bernard_Tomic,2,S-XC,19,3,0,1,2,5,14,,,,,,,,,,
20140625-M-Wimbledon-R64-Tomas_Berdych-Bernard_Tomic,2,S-DTM,18,1,0,0,1,3,15,,,,,,,,,,
20140625-M-Wimbledon-R64-Tomas_Berdych-Bernard_Tomic,2,S-DTL,8,3,1,0,2,2,6,,,,,,,,,,
20140625-M-Wimbledon-R64-Tomas_Berdych-Bernard_Tomic,2,S-IO,2,1,0,0,1,0,2,,,,,,,,,,
20140626-M-Wimbledon-R64-Rafael_Nadal-Lukas_Rosol,1,F-XC,47,16,9,2,5,32,15,,,,,,,,,,
20140626-M-Wimbledon-R64-Rafael_Nadal-Lukas_Rosol,1,F-DTM,25,2,1,0,1,15,10,,,,,,,,,,
20140626-M-Wimbledon-R64-Rafael_Nadal-Lukas_Rosol,1,F-DTL,7,4,4,0,0,5,2,,,,,,,,,,
20140626-M-Wimbledon-R64-Rafael_Nadal-Lukas_Rosol,1,F-IO,24,12,7,4,1,19,5,,,,,,,,,,
20140626-M-Wimbledon-R64-Rafael_Nadal-Lukas_Rosol,1,F-II,9,6,4,1,1,8,1,,,,,,,,,,
20140626-M-Wimbledon-R64-Rafael_Nadal-Lukas_Rosol,1,B-XC,29,5,1,3,1,15,14,,,,,,,,,,
20140626-M-Wimbledon-R64-Rafael_Nadal-Lukas_Rosol,1,B-DTM,8,0,0,0,0,7,1,,,,,,,,,,
20140626-M-Wimbledon-R64-Rafael_Nadal-Lukas_Rosol,1,B-DTL,4,1,1,0,0,2,2,,,,,,,,,,
20140626-M-Wimbledon-R64-Rafael_Nadal-Lukas_Rosol,1,B-IO,2,0,0,0,0,1,1,,,,,,,,,,
20140626-M-Wimbledon-R64-Rafael_Nadal-Lukas_Rosol,1,S-XC,4,0,0,0,0,2,2,,,,,,,,,,
20140626-M-Wimbledon-R64-Rafael_Nadal-Lukas_Rosol,1,S-DTM,17,1,0,0,1,8,9,,,,,,,,,,
20140626-M-Wimbledon-R64-Rafael_Nadal-Lukas_Rosol,1,S-DTL,5,2,1,1,0,4,1,,,,,,,,,,
20140626-M-Wimbledon-R64-Rafael_Nadal-Lukas_Rosol,1,S-IO,1,0,0,0,0,1,0,,,,,,,,,,
20140626-M-Wimbledon-R64-Rafael_Nadal-Lukas_Rosol,2,F-XC,58,14,5,3,6,28,30,,,,,,,,,,
20140626-M-Wimbledon-R64-Rafael_Nadal-Lukas_Rosol,2,F-DTM,24,4,1,0,3,9,15,,,,,,,,,,
20140626-M-Wimbledon-R64-Rafael_Nadal-Lukas_Rosol,2,F-DTL,18,14,10,1,3,14,4,,,,,,,,,,
20140626-M-Wimbledon-R64-Rafael_Nadal-Lukas_Rosol,2,F-IO,32,19,7,5,7,20,12,,,,,,,,,,
20140626-M-Wimbledon-R64-Rafael_Nadal-Lukas_Rosol,2,F-II,3,3,2,0,1,2,1,,,,,,,,,,
20140626-M-Wimbledon-R64-Rafael_Nadal-Lukas_Rosol,2,B-XC,19,8,2,3,3,9,10,,,,,,,,,,
20140626-M-Wimbledon-R64-Rafael_Nadal-Lukas_Rosol,2,B-DTM,16,4,0,0,4,3,13,,,,,,,,,,
20140626-M-Wimbledon-R64-Rafael_Nadal-Lukas_Rosol,2,B-DTL,12,6,1,1,4,5,7,,,,,,,,,,
20140626-M-Wimbledon-R64-Rafael_Nadal-Lukas_Rosol,2,B-IO,2,0,0,0,0,0,2,,,,,,,,,,
20140626-M-Wimbledon-R64-Rafael_Nadal-Lukas_Rosol,2,S-DTM,5,0,0,0,0,1,4,,,,,,,,,,
20140626-M-Wimbledon-R64-Rafael_Nadal-Lukas_Rosol,2,S-DTL,4,1,0,1,0,1,3,,,,,,,,,,
20140626-M-Wimbledon-R64-Rafael_Nadal-Lukas_Rosol,2,S-IO,2,0,0,0,0,1,1,,,,,,,,,,
20140627-M-Wimbledon-R32-Grigor_Dimitrov-Alexandr_Dolgopolov,1,F-XC,50,6,0,2,4,28,22,,,,,,,,,,
20140627-M-Wimbledon-R32-Grigor_Dimitrov-Alexandr_Dolgopolov,1,F-DTM,28,6,3,2,1,21,7,,,,,,,,,,
20140627-M-Wimbledon-R32-Grigor_Dimitrov-Alexandr_Dolgopolov,1,F-DTL,15,8,4,1,3,8,7,,,,,,,,,,
20140627-M-Wimbledon-R32-Grigor_Dimitrov-Alexandr_Dolgopolov,1,F-IO,55,17,5,5,7,33,22,,,,,,,,,,
20140627-M-Wimbledon-R32-Grigor_Dimitrov-Alexandr_Dolgopolov,1,F-II,8,3,1,1,1,6,2,,,,,,,,,,
20140627-M-Wimbledon-R32-Grigor_Dimitrov-Alexandr_Dolgopolov,1,B-XC,41,8,0,2,6,26,15,,,,,,,,,,
20140627-M-Wimbledon-R32-Grigor_Dimitrov-Alexandr_Dolgopolov,1,B-DTM,32,2,1,0,1,19,13,,,,,,,,,,
20140627-M-Wimbledon-R32-Grigor_Dimitrov-Alexandr_Dolgopolov,1,B-DTL,7,6,3,2,1,6,1,,,,,,,,,,
20140627-M-Wimbledon-R32-Grigor_Dimitrov-Alexandr_Dolgopolov,1,S-XC,44,4,0,0,4,24,20,,,,,,,,,,
20140627-M-Wimbledon-R32-Grigor_Dimitrov-Alexandr_Dolgopolov,1,S-DTM,24,3,2,0,1,11,13,,,,,,,,,,
20140627-M-Wimbledon-R32-Grigor_Dimitrov-Alexandr_Dolgopolov,1,S-DTL,9,4,2,1,1,8,1,,,,,,,,,,
20140627-M-Wimbledon-R32-Grigor_Dimitrov-Alexandr_Dolgopolov,2,F-XC,46,17,4,3,10,17,29,,,,,,,,,,
20140627-M-Wimbledon-R32-Grigor_Dimitrov-Alexandr_Dolgopolov,2,F-DTM,28,1,0,0,1,7,21,,,,,,,,,,
20140627-M-Wimbledon-R32-Grigor_Dimitrov-Alexandr_Dolgopolov,2,F-DTL,23,6,3,1,2,13,10,,,,,,,,,,
20140627-M-Wimbledon-R32-Grigor_Dimitrov-Alexandr_Dolgopolov,2,F-IO,58,14,4,3,7,25,33,,,,,,,,,,
20140627-M-Wimbledon-R32-Grigor_Dimitrov-Alexandr_Dolgopolov,2,F-II,5,1,1,0,0,2,3,,,,,,,,,,
20140627-M-Wimbledon-R32-Grigor_Dimitrov-Alexandr_Dolgopolov,2,B-XC,105,13,2,3,8,41,64,,,,,,,,,,
20140627-M-Wimbledon-R32-Grigor_Dimitrov-Alexandr_Dolgopolov,2,B-DTM,36,3,0,0,3,12,24,,,,,,,,,,
20140627-M-Wimbledon-R32-Grigor_Dimitrov-Alexandr_Dolgopolov,2,B-DTL,12,7,1,4,2,8,4,,,,,,,,,,
20140627-M-Wimbledon-R32-Grigor_Dimitrov-Alexandr_Dolgopolov,2,B-IO,4,2,0,0,2,0,4,,,,,,,,,,
20140627-M-Wimbledon-R32-Grigor_Dimitrov-Alexandr_Dolgopolov,2,S-XC,2,1,1,0,0,1,1,,,,,,,,,,
20140627-M-Wimbledon-R32-Grigor_Dimitrov-Alexandr_Dolgopolov,2,S-DTM,2,0,0,0,0,2,0,,,,,,,,,,
20140627-M-Wimbledon-R32-Grigor_Dimitrov-Alexandr_Dolgopolov,2,S-DTL,9,2,0,1,1,5,4,,,,,,,,,,
20140627-M-Wimbledon-R32-Grigor_Dimitrov-Alexandr_Dolgopolov,2,S-IO,4,1,1,0,0,3,1,,,,,,,,,,
20140628-M-Padova_CH-SF-Nikola_Cacic-Maximo_Gonzalez,1,F-XC,24,8,2,2,4,14,10,,,,,,,,,,
20140628-M-Padova_CH-SF-Nikola_Cacic-Maximo_Gonzalez,1,F-DTM,6,2,0,0,2,0,6,,,,,,,,,,
20140628-M-Padova_CH-SF-Nikola_Cacic-Maximo_Gonzalez,1,F-DTL,9,2,0,0,2,5,4,,,,,,,,,,
20140628-M-Padova_CH-SF-Nikola_Cacic-Maximo_Gonzalez,1,F-IO,26,6,1,2,3,13,13,,,,,,,,,,
20140628-M-Padova_CH-SF-Nikola_Cacic-Maximo_Gonzalez,1,F-II,3,0,0,0,0,0,3,,,,,,,,,,
20140628-M-Padova_CH-SF-Nikola_Cacic-Maximo_Gonzalez,1,B-XC,25,5,0,1,4,5,20,,,,,,,,,,
20140628-M-Padova_CH-SF-Nikola_Cacic-Maximo_Gonzalez,1,B-DTM,13,3,0,0,3,2,11,,,,,,,,,,
20140628-M-Padova_CH-SF-Nikola_Cacic-Maximo_Gonzalez,1,B-DTL,9,3,0,1,2,7,2,,,,,,,,,,
20140628-M-Padova_CH-SF-Nikola_Cacic-Maximo_Gonzalez,1,B-IO,1,0,0,0,0,0,1,,,,,,,,,,
20140628-M-Padova_CH-SF-Nikola_Cacic-Maximo_Gonzalez,1,S-XC,3,1,0,0,1,0,3,,,,,,,,,,
20140628-M-Padova_CH-SF-Nikola_Cacic-Maximo_Gonzalez,1,S-DTM,4,2,0,0,2,0,4,,,,,,,,,,
20140628-M-Padova_CH-SF-Nikola_Cacic-Maximo_Gonzalez,1,S-DTL,4,3,1,0,2,1,3,,,,,,,,,,
20140628-M-Padova_CH-SF-Nikola_Cacic-Maximo_Gonzalez,2,F-XC,28,8,4,4,0,16,12,,,,,,,,,,
20140628-M-Padova_CH-SF-Nikola_Cacic-Maximo_Gonzalez,2,F-DTM,3,1,1,0,0,3,0,,,,,,,,,,
20140628-M-Padova_CH-SF-Nikola_Cacic-Maximo_Gonzalez,2,F-DTL,9,1,0,0,1,2,7,,,,,,,,,,
20140628-M-Padova_CH-SF-Nikola_Cacic-Maximo_Gonzalez,2,F-IO,21,2,1,0,1,19,2,,,,,,,,,,
20140628-M-Padova_CH-SF-Nikola_Cacic-Maximo_Gonzalez,2,F-II,3,1,0,1,0,2,1,,,,,,,,,,
20140628-M-Padova_CH-SF-Nikola_Cacic-Maximo_Gonzalez,2,B-XC,39,9,1,4,4,24,15,,,,,,,,,,
20140628-M-Padova_CH-SF-Nikola_Cacic-Maximo_Gonzalez,2,B-DTM,6,0,0,0,0,2,4,,,,,,,,,,
20140628-M-Padova_CH-SF-Nikola_Cacic-Maximo_Gonzalez,2,B-DTL,13,4,2,1,1,7,6,,,,,,,,,,
20140628-M-Padova_CH-SF-Nikola_Cacic-Maximo_Gonzalez,2,S-XC,5,1,1,0,0,3,2,,,,,,,,,,
20140628-M-Padova_CH-SF-Nikola_Cacic-Maximo_Gonzalez,2,S-DTM,2,0,0,0,0,0,2,,,,,,,,,,
20140628-M-Padova_CH-SF-Nikola_Cacic-Maximo_Gonzalez,2,S-DTL,1,0,0,0,0,0,1,,,,,,,,,,
20140628-M-Wimbledon-R32-Mikhail_Kukushkin-Rafael_Nadal,1,F-XC,59,14,3,5,6,23,36,,,,,,,,,,
20140628-M-Wimbledon-R32-Mikhail_Kukushkin-Rafael_Nadal,1,F-DTM,21,1,0,0,1,9,12,,,,,,,,,,
20140628-M-Wimbledon-R32-Mikhail_Kukushkin-Rafael_Nadal,1,F-DTL,20,10,5,2,3,10,10,,,,,,,,,,
20140628-M-Wimbledon-R32-Mikhail_Kukushkin-Rafael_Nadal,1,F-IO,46,16,4,2,10,21,25,,,,,,,,,,
20140628-M-Wimbledon-R32-Mikhail_Kukushkin-Rafael_Nadal,1,F-II,4,2,1,0,1,1,3,,,,,,,,,,
20140628-M-Wimbledon-R32-Mikhail_Kukushkin-Rafael_Nadal,1,B-XC,18,10,5,2,3,11,7,,,,,,,,,,
20140628-M-Wimbledon-R32-Mikhail_Kukushkin-Rafael_Nadal,1,B-DTM,32,1,0,0,1,13,19,,,,,,,,,,
20140628-M-Wimbledon-R32-Mikhail_Kukushkin-Rafael_Nadal,1,B-DTL,32,9,0,6,3,21,11,,,,,,,,,,
20140628-M-Wimbledon-R32-Mikhail_Kukushkin-Rafael_Nadal,1,B-IO,15,2,0,0,2,6,9,,,,,,,,,,
20140628-M-Wimbledon-R32-Mikhail_Kukushkin-Rafael_Nadal,1,S-XC,2,1,0,0,1,0,2,,,,,,,,,,
20140628-M-Wimbledon-R32-Mikhail_Kukushkin-Rafael_Nadal,1,S-DTM,2,0,0,0,0,0,2,,,,,,,,,,
20140628-M-Wimbledon-R32-Mikhail_Kukushkin-Rafael_Nadal,1,S-DTL,8,0,0,0,0,4,4,,,,,,,,,,
20140628-M-Wimbledon-R32-Mikhail_Kukushkin-Rafael_Nadal,1,S-IO,1,0,0,0,0,0,1,,,,,,,,,,
20140628-M-Wimbledon-R32-Mikhail_Kukushkin-Rafael_Nadal,2,F-XC,59,11,4,6,1,32,27,,,,,,,,,,
20140628-M-Wimbledon-R32-Mikhail_Kukushkin-Rafael_Nadal,2,F-DTM,21,2,0,0,2,8,13,,,,,,,,,,
20140628-M-Wimbledon-R32-Mikhail_Kukushkin-Rafael_Nadal,2,F-DTL,12,8,5,2,1,9,3,,,,,,,,,,
20140628-M-Wimbledon-R32-Mikhail_Kukushkin-Rafael_Nadal,2,F-IO,23,12,8,3,1,17,6,,,,,,,,,,
20140628-M-Wimbledon-R32-Mikhail_Kukushkin-Rafael_Nadal,2,F-II,6,2,1,1,0,4,2,,,,,,,,,,
20140628-M-Wimbledon-R32-Mikhail_Kukushkin-Rafael_Nadal,2,B-XC,26,9,2,4,3,15,11,,,,,,,,,,
20140628-M-Wimbledon-R32-Mikhail_Kukushkin-Rafael_Nadal,2,B-DTM,25,2,0,1,1,20,5,,,,,,,,,,
20140628-M-Wimbledon-R32-Mikhail_Kukushkin-Rafael_Nadal,2,B-DTL,8,4,1,2,1,6,2,,,,,,,,,,
20140628-M-Wimbledon-R32-Mikhail_Kukushkin-Rafael_Nadal,2,B-IO,4,2,0,1,1,3,1,,,,,,,,,,
20140628-M-Wimbledon-R32-Mikhail_Kukushkin-Rafael_Nadal,2,S-XC,10,1,0,1,0,7,3,,,,,,,,,,
20140628-M-Wimbledon-R32-Mikhail_Kukushkin-Rafael_Nadal,2,S-DTM,31,2,0,1,1,16,15,,,,,,,,,,
20140628-M-Wimbledon-R32-Mikhail_Kukushkin-Rafael_Nadal,2,S-DTL,12,1,0,0,1,5,7,,,,,,,,,,
20140628-M-Wimbledon-R32-Mikhail_Kukushkin-Rafael_Nadal,2,S-IO,2,1,0,1,0,2,0,,,,,,,,,,
20140630-M-Winnetka_CH-F-Farrukh_Dustov-Denis_Kudla,1,F-XC,25,4,1,0,3,7,18,,,,,,,,,,
20140630-M-Winnetka_CH-F-Farrukh_Dustov-Denis_Kudla,1,F-DTM,15,5,0,1,4,5,10,,,,,,,,,,
20140630-M-Winnetka_CH-F-Farrukh_Dustov-Denis_Kudla,1,F-DTL,9,5,0,1,4,1,8,,,,,,,,,,
20140630-M-Winnetka_CH-F-Farrukh_Dustov-Denis_Kudla,1,F-IO,19,5,1,1,3,8,11,,,,,,,,,,
20140630-M-Winnetka_CH-F-Farrukh_Dustov-Denis_Kudla,1,F-II,1,0,0,0,0,1,0,,,,,,,,,,
20140630-M-Winnetka_CH-F-Farrukh_Dustov-Denis_Kudla,1,B-XC,15,3,0,1,2,5,10,,,,,,,,,,
20140630-M-Winnetka_CH-F-Farrukh_Dustov-Denis_Kudla,1,B-DTM,16,1,0,0,1,6,10,,,,,,,,,,
20140630-M-Winnetka_CH-F-Farrukh_Dustov-Denis_Kudla,1,B-DTL,10,5,1,1,3,5,5,,,,,,,,,,
20140630-M-Winnetka_CH-F-Farrukh_Dustov-Denis_Kudla,1,B-IO,3,1,1,0,0,2,1,,,,,,,,,,
20140630-M-Winnetka_CH-F-Farrukh_Dustov-Denis_Kudla,1,S-XC,23,4,0,0,4,7,16,,,,,,,,,,
20140630-M-Winnetka_CH-F-Farrukh_Dustov-Denis_Kudla,1,S-DTM,10,0,0,0,0,7,3,,,,,,,,,,
20140630-M-Winnetka_CH-F-Farrukh_Dustov-Denis_Kudla,1,S-DTL,2,0,0,0,0,2,0,,,,,,,,,,
20140630-M-Winnetka_CH-F-Farrukh_Dustov-Denis_Kudla,2,F-XC,24,5,0,3,2,16,8,,,,,,,,,,
20140630-M-Winnetka_CH-F-Farrukh_Dustov-Denis_Kudla,2,F-DTM,8,2,0,0,2,3,5,,,,,,,,,,
20140630-M-Winnetka_CH-F-Farrukh_Dustov-Denis_Kudla,2,F-DTL,13,3,0,1,2,8,5,,,,,,,,,,
20140630-M-Winnetka_CH-F-Farrukh_Dustov-Denis_Kudla,2,F-IO,24,7,2,2,3,15,9,,,,,,,,,,
20140630-M-Winnetka_CH-F-Farrukh_Dustov-Denis_Kudla,2,F-II,2,0,0,0,0,2,0,,,,,,,,,,
20140630-M-Winnetka_CH-F-Farrukh_Dustov-Denis_Kudla,2,B-XC,37,10,4,2,4,21,16,,,,,,,,,,
20140630-M-Winnetka_CH-F-Farrukh_Dustov-Denis_Kudla,2,B-DTM,14,1,0,0,1,8,6,,,,,,,,,,
20140630-M-Winnetka_CH-F-Farrukh_Dustov-Denis_Kudla,2,B-DTL,10,5,0,3,2,7,3,,,,,,,,,,
20140630-M-Winnetka_CH-F-Farrukh_Dustov-Denis_Kudla,2,B-IO,7,2,0,0,2,3,4,,,,,,,,,,
20140630-M-Winnetka_CH-F-Farrukh_Dustov-Denis_Kudla,2,S-XC,7,0,0,0,0,3,4,,,,,,,,,,
20140630-M-Winnetka_CH-F-Farrukh_Dustov-Denis_Kudla,2,S-DTM,1,0,0,0,0,1,0,,,,,,,,,,
20140630-M-Winnetka_CH-F-Farrukh_Dustov-Denis_Kudla,2,S-DTL,1,0,0,0,0,1,0,,,,,,,,,,
20140701-M-Wimbledon-R16-Nick_Kyrgios-Rafael_Nadal,1,F-XC,66,16,5,7,4,37,29,,,,,,,,,,
20140701-M-Wimbledon-R16-Nick_Kyrgios-Rafael_Nadal,1,F-DTM,23,4,0,0,4,6,17,,,,,,,,,,
20140701-M-Wimbledon-R16-Nick_Kyrgios-Rafael_Nadal,1,F-DTL,8,4,1,1,2,3,5,,,,,,,,,,
20140701-M-Wimbledon-R16-Nick_Kyrgios-Rafael_Nadal,1,F-IO,25,12,7,1,4,12,13,,,,,,,,,,
20140701-M-Wimbledon-R16-Nick_Kyrgios-Rafael_Nadal,1,F-II,4,1,0,0,1,1,3,,,,,,,,,,
20140701-M-Wimbledon-R16-Nick_Kyrgios-Rafael_Nadal,1,B-XC,58,16,4,7,5,30,28,,,,,,,,,,
20140701-M-Wimbledon-R16-Nick_Kyrgios-Rafael_Nadal,1,B-DTM,15,1,0,0,1,3,12,,,,,,,,,,
20140701-M-Wimbledon-R16-Nick_Kyrgios-Rafael_Nadal,1,B-DTL,16,7,3,0,4,5,11,,,,,,,,,,
20140701-M-Wimbledon-R16-Nick_Kyrgios-Rafael_Nadal,1,B-IO,9,4,1,1,2,4,5,,,,,,,,,,
20140701-M-Wimbledon-R16-Nick_Kyrgios-Rafael_Nadal,1,B-II,1,1,1,0,0,1,0,,,,,,,,,,
20140701-M-Wimbledon-R16-Nick_Kyrgios-Rafael_Nadal,1,S-XC,1,0,0,0,0,0,1,,,,,,,,,,
20140701-M-Wimbledon-R16-Nick_Kyrgios-Rafael_Nadal,1,S-DTM,2,0,0,0,0,0,2,,,,,,,,,,
20140701-M-Wimbledon-R16-Nick_Kyrgios-Rafael_Nadal,1,S-DTL,2,0,0,0,0,0,2,,,,,,,,,,
20140701-M-Wimbledon-R16-Nick_Kyrgios-Rafael_Nadal,1,S-IO,1,0,0,0,0,1,0,,,,,,,,,,
20140701-M-Wimbledon-R16-Nick_Kyrgios-Rafael_Nadal,1,S-II,1,0,0,0,0,1,0,,,,,,,,,,
20140701-M-Wimbledon-R16-Nick_Kyrgios-Rafael_Nadal,2,F-XC,67,11,6,4,1,46,21,,,,,,,,,,
20140701-M-Wimbledon-R16-Nick_Kyrgios-Rafael_Nadal,2,F-DTM,25,2,2,0,0,16,9,,,,,,,,,,
20140701-M-Wimbledon-R16-Nick_Kyrgios-Rafael_Nadal,2,F-DTL,24,18,8,5,5,17,7,,,,,,,,,,
20140701-M-Wimbledon-R16-Nick_Kyrgios-Rafael_Nadal,2,F-IO,29,12,6,3,3,19,10,,,,,,,,,,
20140701-M-Wimbledon-R16-Nick_Kyrgios-Rafael_Nadal,2,F-II,7,6,2,1,3,3,4,,,,,,,,,,
20140701-M-Wimbledon-R16-Nick_Kyrgios-Rafael_Nadal,2,B-XC,21,6,0,5,1,15,6,,,,,,,,,,
20140701-M-Wimbledon-R16-Nick_Kyrgios-Rafael_Nadal,2,B-DTM,18,1,0,0,1,11,7,,,,,,,,,,
20140701-M-Wimbledon-R16-Nick_Kyrgios-Rafael_Nadal,2,B-DTL,12,6,2,2,2,9,3,,,,,,,,,,
20140701-M-Wimbledon-R16-Nick_Kyrgios-Rafael_Nadal,2,B-IO,2,0,0,0,0,2,0,,,,,,,,,,
20140701-M-Wimbledon-R16-Nick_Kyrgios-Rafael_Nadal,2,S-XC,4,0,0,0,0,1,3,,,,,,,,,,
20140701-M-Wimbledon-R16-Nick_Kyrgios-Rafael_Nadal,2,S-DTM,15,0,0,0,0,9,6,,,,,,,,,,
20140701-M-Wimbledon-R16-Nick_Kyrgios-Rafael_Nadal,2,S-DTL,8,1,0,0,1,1,7,,,,,,,,,,
20140701-M-Wimbledon-R16-Nick_Kyrgios-Rafael_Nadal,2,S-IO,2,0,0,0,0,2,0,,,,,,,,,,
20140704-M-Wimbledon-SF-Milos_Raonic-Roger_Federer,1,F-XC,12,4,1,1,2,6,6,,,,,,,,,,
20140704-M-Wimbledon-SF-Milos_Raonic-Roger_Federer,1,F-DTM,13,2,0,0,2,3,10,,,,,,,,,,
20140704-M-Wimbledon-SF-Milos_Raonic-Roger_Federer,1,F-DTL,4,4,2,1,1,3,1,,,,,,,,,,
20140704-M-Wimbledon-SF-Milos_Raonic-Roger_Federer,1,F-IO,19,6,1,2,3,9,10,,,,,,,,,,
20140704-M-Wimbledon-SF-Milos_Raonic-Roger_Federer,1,F-II,6,4,1,2,1,3,3,,,,,,,,,,
20140704-M-Wimbledon-SF-Milos_Raonic-Roger_Federer,1,B-XC,7,2,2,0,0,4,3,,,,,,,,,,
20140704-M-Wimbledon-SF-Milos_Raonic-Roger_Federer,1,B-DTM,9,2,0,0,2,3,6,,,,,,,,,,
20140704-M-Wimbledon-SF-Milos_Raonic-Roger_Federer,1,B-DTL,2,2,0,0,2,0,2,,,,,,,,,,
20140704-M-Wimbledon-SF-Milos_Raonic-Roger_Federer,1,B-IO,1,1,0,0,1,0,1,,,,,,,,,,
20140704-M-Wimbledon-SF-Milos_Raonic-Roger_Federer,1,S-XC,3,0,0,0,0,1,2,,,,,,,,,,
20140704-M-Wimbledon-SF-Milos_Raonic-Roger_Federer,1,S-DTM,6,2,0,0,2,1,5,,,,,,,,,,
20140704-M-Wimbledon-SF-Milos_Raonic-Roger_Federer,1,S-DTL,5,2,0,0,2,1,4,,,,,,,,,,
20140704-M-Wimbledon-SF-Milos_Raonic-Roger_Federer,2,F-XC,9,7,4,0,3,4,5,,,,,,,,,,
20140704-M-Wimbledon-SF-Milos_Raonic-Roger_Federer,2,F-DTM,17,6,2,1,3,9,8,,,,,,,,,,
20140704-M-Wimbledon-SF-Milos_Raonic-Roger_Federer,2,F-DTL,4,3,2,0,1,3,1,,,,,,,,,,
20140704-M-Wimbledon-SF-Milos_Raonic-Roger_Federer,2,F-IO,11,3,2,1,0,9,2,,,,,,,,,,
20140704-M-Wimbledon-SF-Milos_Raonic-Roger_Federer,2,F-II,1,0,0,0,0,1,0,,,,,,,,,,
20140704-M-Wimbledon-SF-Milos_Raonic-Roger_Federer,2,B-XC,9,3,0,1,2,3,6,,,,,,,,,,
20140704-M-Wimbledon-SF-Milos_Raonic-Roger_Federer,2,B-DTM,14,4,1,2,1,9,5,,,,,,,,,,
20140704-M-Wimbledon-SF-Milos_Raonic-Roger_Federer,2,B-DTL,7,4,4,0,0,6,1,,,,,,,,,,
20140704-M-Wimbledon-SF-Milos_Raonic-Roger_Federer,2,S-XC,8,0,0,0,0,6,2,,,,,,,,,,
20140704-M-Wimbledon-SF-Milos_Raonic-Roger_Federer,2,S-DTM,6,3,0,0,3,1,5,,,,,,,,,,
20140704-M-Wimbledon-SF-Milos_Raonic-Roger_Federer,2,S-DTL,1,1,0,0,1,0,1,,,,,,,,,,
20140706-M-Wimbledon-F-Novak_Djokovic-Roger_Federer,1,F-XC,88,28,13,9,6,56,32,,,,,,,,,,
20140706-M-Wimbledon-F-Novak_Djokovic-Roger_Federer,1,F-DTM,31,4,0,2,2,16,15,,,,,,,,,,
20140706-M-Wimbledon-F-Novak_Djokovic-Roger_Federer,1,F-DTL,26,7,3,2,2,19,7,,,,,,,,,,
20140706-M-Wimbledon-F-Novak_Djokovic-Roger_Federer,1,F-IO,52,16,6,4,6,31,21,,,,,,,,,,
20140706-M-Wimbledon-F-Novak_Djokovic-Roger_Federer,1,F-II,7,3,0,1,2,1,6,,,,,,,,,,
20140706-M-Wimbledon-F-Novak_Djokovic-Roger_Federer,1,B-XC,123,19,5,7,7,63,60,,,,,,,,,,
20140706-M-Wimbledon-F-Novak_Djokovic-Roger_Federer,1,B-DTM,34,2,0,1,1,19,15,,,,,,,,,,
20140706-M-Wimbledon-F-Novak_Djokovic-Roger_Federer,1,B-DTL,45,22,8,5,9,23,22,,,,,,,,,,
20140706-M-Wimbledon-F-Novak_Djokovic-Roger_Federer,1,B-IO,20,3,0,2,1,15,5,,,,,,,,,,
20140706-M-Wimbledon-F-Novak_Djokovic-Roger_Federer,1,S-XC,11,0,0,0,0,7,4,,,,,,,,,,
20140706-M-Wimbledon-F-Novak_Djokovic-Roger_Federer,1,S-DTM,5,0,0,0,0,4,1,,,,,,,,,,
20140706-M-Wimbledon-F-Novak_Djokovic-Roger_Federer,1,S-DTL,2,0,0,0,0,1,1,,,,,,,,,,
20140706-M-Wimbledon-F-Novak_Djokovic-Roger_Federer,1,S-IO,1,0,0,0,0,1,0,,,,,,,,,,
20140706-M-Wimbledon-F-Novak_Djokovic-Roger_Federer,2,F-XC,72,27,8,9,10,33,39,,,,,,,,,,
20140706-M-Wimbledon-F-Novak_Djokovic-Roger_Federer,2,F-DTM,44,5,2,1,2,15,29,,,,,,,,,,
20140706-M-Wimbledon-F-Novak_Djokovic-Roger_Federer,2,F-DTL,38,4,1,2,1,21,17,,,,,,,,,,
20140706-M-Wimbledon-F-Novak_Djokovic-Roger_Federer,2,F-IO,44,13,4,6,3,26,18,,,,,,,,,,
20140706-M-Wimbledon-F-Novak_Djokovic-Roger_Federer,2,F-II,10,3,1,2,0,9,1,,,,,,,,,,
20140706-M-Wimbledon-F-Novak_Djokovic-Roger_Federer,2,B-XC,63,9,1,3,5,26,37,,,,,,,,,,
20140706-M-Wimbledon-F-Novak_Djokovic-Roger_Federer,2,B-DTM,45,2,0,0,2,13,32,,,,,,,,,,
20140706-M-Wimbledon-F-Novak_Djokovic-Roger_Federer,2,B-DTL,17,5,1,1,3,9,8,,,,,,,,,,
20140706-M-Wimbledon-F-Novak_Djokovic-Roger_Federer,2,B-IO,6,1,0,0,1,2,4,,,,,,,,,,
20140706-M-Wimbledon-F-Novak_Djokovic-Roger_Federer,2,S-XC,44,3,0,1,2,24,20,,,,,,,,,,
20140706-M-Wimbledon-F-Novak_Djokovic-Roger_Federer,2,S-DTM,15,0,0,0,0,7,8,,,,,,,,,,
20140706-M-Wimbledon-F-Novak_Djokovic-Roger_Federer,2,S-DTL,7,1,0,0,1,0,7,,,,,,,,,,
20140706-M-Wimbledon-F-Novak_Djokovic-Roger_Federer,2,S-IO,2,0,0,0,0,0,2,,,,,,,,,,
20140710-M-Stuttgart-R32-Jan_Lennard_Struff-Philipp_Kohlschreiber,1,F-XC,24,10,1,2,7,10,14,,,,,,,,,,
20140710-M-Stuttgart-R32-Jan_Lennard_Struff-Philipp_Kohlschreiber,1,F-DTM,18,5,2,0,3,7,11,,,,,,,,,,
20140710-M-Stuttgart-R32-Jan_Lennard_Struff-Philipp_Kohlschreiber,1,F-DTL,11,4,2,1,1,7,4,,,,,,,,,,
20140710-M-Stuttgart-R32-Jan_Lennard_Struff-Philipp_Kohlschreiber,1,F-IO,16,6,4,0,2,13,3,,,,,,,,,,
20140710-M-Stuttgart-R32-Jan_Lennard_Struff-Philipp_Kohlschreiber,1,F-II,3,2,1,1,0,2,1,,,,,,,,,,
20140710-M-Stuttgart-R32-Jan_Lennard_Struff-Philipp_Kohlschreiber,1,B-XC,34,10,1,0,9,15,19,,,,,,,,,,
20140710-M-Stuttgart-R32-Jan_Lennard_Struff-Philipp_Kohlschreiber,1,B-DTM,20,3,0,1,2,6,14,,,,,,,,,,
20140710-M-Stuttgart-R32-Jan_Lennard_Struff-Philipp_Kohlschreiber,1,B-DTL,7,5,2,0,3,2,5,,,,,,,,,,
20140710-M-Stuttgart-R32-Jan_Lennard_Struff-Philipp_Kohlschreiber,1,B-IO,2,0,0,0,0,1,1,,,,,,,,,,
20140710-M-Stuttgart-R32-Jan_Lennard_Struff-Philipp_Kohlschreiber,1,S-XC,3,0,0,0,0,2,1,,,,,,,,,,
20140710-M-Stuttgart-R32-Jan_Lennard_Struff-Philipp_Kohlschreiber,1,S-DTM,2,0,0,0,0,0,2,,,,,,,,,,
20140710-M-Stuttgart-R32-Jan_Lennard_Struff-Philipp_Kohlschreiber,1,S-DTL,4,0,0,0,0,0,4,,,,,,,,,,
20140710-M-Stuttgart-R32-Jan_Lennard_Struff-Philipp_Kohlschreiber,2,F-XC,25,11,5,2,4,15,10,,,,,,,,,,
20140710-M-Stuttgart-R32-Jan_Lennard_Struff-Philipp_Kohlschreiber,2,F-DTM,11,1,0,1,0,8,3,,,,,,,,,,
20140710-M-Stuttgart-R32-Jan_Lennard_Struff-Philipp_Kohlschreiber,2,F-DTL,10,3,2,0,1,6,4,,,,,,,,,,
20140710-M-Stuttgart-R32-Jan_Lennard_Struff-Philipp_Kohlschreiber,2,F-IO,17,3,1,1,1,14,3,,,,,,,,,,
20140710-M-Stuttgart-R32-Jan_Lennard_Struff-Philipp_Kohlschreiber,2,F-II,7,7,1,1,5,2,5,,,,,,,,,,
20140710-M-Stuttgart-R32-Jan_Lennard_Struff-Philipp_Kohlschreiber,2,B-XC,22,7,1,1,5,10,12,,,,,,,,,,
20140710-M-Stuttgart-R32-Jan_Lennard_Struff-Philipp_Kohlschreiber,2,B-DTM,11,1,0,0,1,3,8,,,,,,,,,,
20140710-M-Stuttgart-R32-Jan_Lennard_Struff-Philipp_Kohlschreiber,2,B-DTL,4,3,1,1,1,2,2,,,,,,,,,,
20140710-M-Stuttgart-R32-Jan_Lennard_Struff-Philipp_Kohlschreiber,2,B-IO,3,2,0,0,2,1,2,,,,,,,,,,
20140710-M-Stuttgart-R32-Jan_Lennard_Struff-Philipp_Kohlschreiber,2,S-XC,14,0,0,0,0,5,9,,,,,,,,,,
20140710-M-Stuttgart-R32-Jan_Lennard_Struff-Philipp_Kohlschreiber,2,S-DTM,3,0,0,0,0,1,2,,,,,,,,,,
20140714-M-Bogota-QF-Jimmy_Wang-Ivo_Karlovic,1,F-XC,17,11,4,3,4,10,7,,,,,,,,,,
20140714-M-Bogota-QF-Jimmy_Wang-Ivo_Karlovic,1,F-DTM,4,1,0,0,1,2,2,,,,,,,,,,
20140714-M-Bogota-QF-Jimmy_Wang-Ivo_Karlovic,1,F-DTL,6,1,0,1,0,4,2,,,,,,,,,,
20140714-M-Bogota-QF-Jimmy_Wang-Ivo_Karlovic,1,F-IO,20,3,0,1,2,10,10,,,,,,,,,,
20140714-M-Bogota-QF-Jimmy_Wang-Ivo_Karlovic,1,B-XC,11,3,3,0,0,8,3,,,,,,,,,,
20140714-M-Bogota-QF-Jimmy_Wang-Ivo_Karlovic,1,B-DTM,5,1,0,0,1,3,2,,,,,,,,,,
20140714-M-Bogota-QF-Jimmy_Wang-Ivo_Karlovic,1,B-DTL,1,1,1,0,0,1,0,,,,,,,,,,
20140714-M-Bogota-QF-Jimmy_Wang-Ivo_Karlovic,1,S-XC,3,0,0,0,0,3,0,,,,,,,,,,
20140714-M-Bogota-QF-Jimmy_Wang-Ivo_Karlovic,1,S-DTM,2,0,0,0,0,1,1,,,,,,,,,,
20140714-M-Bogota-QF-Jimmy_Wang-Ivo_Karlovic,2,F-XC,4,2,1,0,1,2,2,,,,,,,,,,
20140714-M-Bogota-QF-Jimmy_Wang-Ivo_Karlovic,2,F-DTM,4,2,0,0,2,0,4,,,,,,,,,,
20140714-M-Bogota-QF-Jimmy_Wang-Ivo_Karlovic,2,F-DTL,3,2,1,0,1,2,1,,,,,,,,,,
20140714-M-Bogota-QF-Jimmy_Wang-Ivo_Karlovic,2,F-IO,4,2,1,1,0,2,2,,,,,,,,,,
20140714-M-Bogota-QF-Jimmy_Wang-Ivo_Karlovic,2,F-II,3,3,2,1,0,3,0,,,,,,,,,,
20140714-M-Bogota-QF-Jimmy_Wang-Ivo_Karlovic,2,B-XC,4,3,1,0,2,1,3,,,,,,,,,,
20140714-M-Bogota-QF-Jimmy_Wang-Ivo_Karlovic,2,B-DTL,5,4,1,1,2,3,2,,,,,,,,,,
20140714-M-Bogota-QF-Jimmy_Wang-Ivo_Karlovic,2,B-II,1,0,0,0,0,0,1,,,,,,,,,,
20140714-M-Bogota-QF-Jimmy_Wang-Ivo_Karlovic,2,S-XC,3,1,1,0,0,2,1,,,,,,,,,,
20140714-M-Bogota-QF-Jimmy_Wang-Ivo_Karlovic,2,S-DTM,13,0,0,0,0,3,10,,,,,,,,,,
20140714-M-Bogota-QF-Jimmy_Wang-Ivo_Karlovic,2,S-DTL,7,4,1,0,3,2,5,,,,,,,,,,
20140719-M-Bogota-SF-Bernard_Tomic-Victor_Estrella,1,F-XC,62,24,4,10,10,40,22,,,,,,,,,,
20140719-M-Bogota-SF-Bernard_Tomic-Victor_Estrella,1,F-DTM,23,4,0,0,4,9,14,,,,,,,,,,
20140719-M-Bogota-SF-Bernard_Tomic-Victor_Estrella,1,F-DTL,18,6,2,0,4,6,12,,,,,,,,,,
20140719-M-Bogota-SF-Bernard_Tomic-Victor_Estrella,1,F-IO,47,10,2,0,8,20,27,,,,,,,,,,
20140719-M-Bogota-SF-Bernard_Tomic-Victor_Estrella,1,F-II,4,2,0,2,0,2,2,,,,,,,,,,
20140719-M-Bogota-SF-Bernard_Tomic-Victor_Estrella,1,B-XC,23,5,2,0,3,12,11,,,,,,,,,,
20140719-M-Bogota-SF-Bernard_Tomic-Victor_Estrella,1,B-DTM,23,2,0,0,2,9,14,,,,,,,,,,
20140719-M-Bogota-SF-Bernard_Tomic-Victor_Estrella,1,B-DTL,12,7,1,1,5,4,8,,,,,,,,,,
20140719-M-Bogota-SF-Bernard_Tomic-Victor_Estrella,1,B-IO,2,0,0,0,0,1,1,,,,,,,,,,
20140719-M-Bogota-SF-Bernard_Tomic-Victor_Estrella,1,S-XC,36,3,0,0,3,20,16,,,,,,,,,,
20140719-M-Bogota-SF-Bernard_Tomic-Victor_Estrella,1,S-DTM,17,2,0,0,2,3,14,,,,,,,,,,
20140719-M-Bogota-SF-Bernard_Tomic-Victor_Estrella,1,S-DTL,17,1,0,0,1,10,7,,,,,,,,,,
20140719-M-Bogota-SF-Bernard_Tomic-Victor_Estrella,1,S-IO,6,1,0,0,1,4,2,,,,,,,,,,
20140719-M-Bogota-SF-Bernard_Tomic-Victor_Estrella,2,F-XC,65,18,7,4,7,37,28,,,,,,,,,,
20140719-M-Bogota-SF-Bernard_Tomic-Victor_Estrella,2,F-DTM,40,5,0,0,5,16,24,,,,,,,,,,
20140719-M-Bogota-SF-Bernard_Tomic-Victor_Estrella,2,F-DTL,15,2,0,0,2,5,10,,,,,,,,,,
20140719-M-Bogota-SF-Bernard_Tomic-Victor_Estrella,2,F-IO,61,21,6,7,8,36,25,,,,,,,,,,
20140719-M-Bogota-SF-Bernard_Tomic-Victor_Estrella,2,F-II,3,2,2,0,0,2,1,,,,,,,,,,
20140719-M-Bogota-SF-Bernard_Tomic-Victor_Estrella,2,B-XC,3,2,0,1,1,2,1,,,,,,,,,,
20140719-M-Bogota-SF-Bernard_Tomic-Victor_Estrella,2,B-DTM,1,1,0,1,0,1,0,,,,,,,,,,
20140719-M-Bogota-SF-Bernard_Tomic-Victor_Estrella,2,B-DTL,2,0,0,0,0,1,1,,,,,,,,,,
20140719-M-Bogota-SF-Bernard_Tomic-Victor_Estrella,2,S-XC,51,2,0,0,2,27,24,,,,,,,,,,
20140719-M-Bogota-SF-Bernard_Tomic-Victor_Estrella,2,S-DTM,40,5,0,1,4,16,24,,,,,,,,,,
20140719-M-Bogota-SF-Bernard_Tomic-Victor_Estrella,2,S-DTL,9,2,0,0,2,3,6,,,,,,,,,,
20140719-M-Bogota-SF-Bernard_Tomic-Victor_Estrella,2,S-II,1,0,0,0,0,1,0,,,,,,,,,,
20140720-M-Bogota-F-Bernard_Tomic-Ivo_Karlovic,1,F-XC,21,10,5,0,5,10,11,,,,,,,,,,
20140720-M-Bogota-F-Bernard_Tomic-Ivo_Karlovic,1,F-DTM,9,2,1,0,1,6,3,,,,,,,,,,
20140720-M-Bogota-F-Bernard_Tomic-Ivo_Karlovic,1,F-DTL,12,5,3,1,1,5,7,,,,,,,,,,
20140720-M-Bogota-F-Bernard_Tomic-Ivo_Karlovic,1,F-IO,22,4,3,1,0,14,8,,,,,,,,,,
20140720-M-Bogota-F-Bernard_Tomic-Ivo_Karlovic,1,F-II,2,1,0,0,1,0,2,,,,,,,,,,
20140720-M-Bogota-F-Bernard_Tomic-Ivo_Karlovic,1,B-XC,5,3,1,2,0,4,1,,,,,,,,,,
20140720-M-Bogota-F-Bernard_Tomic-Ivo_Karlovic,1,B-DTM,8,0,0,0,0,3,5,,,,,,,,,,
20140720-M-Bogota-F-Bernard_Tomic-Ivo_Karlovic,1,B-DTL,8,5,0,3,2,6,2,,,,,,,,,,
20140720-M-Bogota-F-Bernard_Tomic-Ivo_Karlovic,1,B-IO,3,2,2,0,0,3,0,,,,,,,,,,
20140720-M-Bogota-F-Bernard_Tomic-Ivo_Karlovic,1,B-II,1,0,0,0,0,0,1,,,,,,,,,,
20140720-M-Bogota-F-Bernard_Tomic-Ivo_Karlovic,1,S-XC,2,1,0,1,0,2,0,,,,,,,,,,
20140720-M-Bogota-F-Bernard_Tomic-Ivo_Karlovic,1,S-DTM,2,0,0,0,0,0,2,,,,,,,,,,
20140720-M-Bogota-F-Bernard_Tomic-Ivo_Karlovic,1,S-DTL,2,0,0,0,0,0,2,,,,,,,,,,
20140720-M-Bogota-F-Bernard_Tomic-Ivo_Karlovic,2,F-XC,12,6,3,2,1,8,4,,,,,,,,,,
20140720-M-Bogota-F-Bernard_Tomic-Ivo_Karlovic,2,F-DTM,2,1,0,0,1,1,1,,,,,,,,,,
20140720-M-Bogota-F-Bernard_Tomic-Ivo_Karlovic,2,F-DTL,6,5,0,0,5,0,6,,,,,,,,,,
20140720-M-Bogota-F-Bernard_Tomic-Ivo_Karlovic,2,F-IO,8,5,3,0,2,4,4,,,,,,,,,,
20140720-M-Bogota-F-Bernard_Tomic-Ivo_Karlovic,2,F-II,1,0,0,0,0,0,1,,,,,,,,,,
20140720-M-Bogota-F-Bernard_Tomic-Ivo_Karlovic,2,S-XC,7,0,0,0,0,5,2,,,,,,,,,,
20140720-M-Bogota-F-Bernard_Tomic-Ivo_Karlovic,2,S-DTM,8,1,0,0,1,3,5,,,,,,,,,,
20140720-M-Bogota-F-Bernard_Tomic-Ivo_Karlovic,2,S-DTL,7,2,1,0,1,4,3,,,,,,,,,,
20140720-M-Bogota-F-Bernard_Tomic-Ivo_Karlovic,2,S-IO,1,0,0,0,0,1,0,,,,,,,,,,
20140721-M-Umag-R32-Ante_Pavic-Horacio_Zeballos,1,F-XC,16,6,0,0,6,5,11,,,,,,,,,,
20140721-M-Umag-R32-Ante_Pavic-Horacio_Zeballos,1,F-DTM,21,1,0,0,1,10,11,,,,,,,,,,
20140721-M-Umag-R32-Ante_Pavic-Horacio_Zeballos,1,F-DTL,5,3,1,0,2,2,3,,,,,,,,,,
20140721-M-Umag-R32-Ante_Pavic-Horacio_Zeballos,1,F-IO,17,4,1,0,3,5,12,,,,,,,,,,
20140721-M-Umag-R32-Ante_Pavic-Horacio_Zeballos,1,F-II,2,2,0,1,1,1,1,,,,,,,,,,
20140721-M-Umag-R32-Ante_Pavic-Horacio_Zeballos,1,B-XC,13,6,2,0,4,4,9,,,,,,,,,,
20140721-M-Umag-R32-Ante_Pavic-Horacio_Zeballos,1,B-DTM,15,3,0,0,3,2,13,,,,,,,,,,
20140721-M-Umag-R32-Ante_Pavic-Horacio_Zeballos,1,B-DTL,12,5,0,0,5,2,10,,,,,,,,,,
20140721-M-Umag-R32-Ante_Pavic-Horacio_Zeballos,1,B-IO,5,2,1,0,1,1,4,,,,,,,,,,
20140721-M-Umag-R32-Ante_Pavic-Horacio_Zeballos,1,S-XC,2,0,0,0,0,0,2,,,,,,,,,,
20140721-M-Umag-R32-Ante_Pavic-Horacio_Zeballos,1,S-DTM,2,0,0,0,0,1,1,,,,,,,,,,
20140721-M-Umag-R32-Ante_Pavic-Horacio_Zeballos,1,S-DTL,2,0,0,0,0,1,1,,,,,,,,,,
20140721-M-Umag-R32-Ante_Pavic-Horacio_Zeballos,2,F-XC,41,10,1,5,4,29,12,,,,,,,,,,
20140721-M-Umag-R32-Ante_Pavic-Horacio_Zeballos,2,F-DTM,7,0,0,0,0,7,0,,,,,,,,,,
20140721-M-Umag-R32-Ante_Pavic-Horacio_Zeballos,2,F-DTL,13,9,5,0,4,8,5,,,,,,,,,,
20140721-M-Umag-R32-Ante_Pavic-Horacio_Zeballos,2,F-IO,14,7,0,5,2,11,3,,,,,,,,,,
20140721-M-Umag-R32-Ante_Pavic-Horacio_Zeballos,2,B-XC,22,10,4,3,3,15,7,,,,,,,,,,
20140721-M-Umag-R32-Ante_Pavic-Horacio_Zeballos,2,B-DTM,9,0,0,0,0,4,5,,,,,,,,,,
20140721-M-Umag-R32-Ante_Pavic-Horacio_Zeballos,2,B-DTL,7,2,0,0,2,5,2,,,,,,,,,,
20140721-M-Umag-R32-Ante_Pavic-Horacio_Zeballos,2,B-IO,8,1,0,0,1,5,3,,,,,,,,,,
20140721-M-Umag-R32-Ante_Pavic-Horacio_Zeballos,2,S-DTM,2,1,0,0,1,0,2,,,,,,,,,,
20140721-M-Umag-R32-Ante_Pavic-Horacio_Zeballos,2,S-DTL,4,0,0,0,0,1,3,,,,,,,,,,
20140721-M-Umag-R32-Ante_Pavic-Horacio_Zeballos,2,S-IO,1,0,0,0,0,1,0,,,,,,,,,,
20140725-M-Atlanta-QF-John_Isner-Marinko_Matosevic,1,F-XC,20,12,3,2,7,8,12,,,,,,,,,,
20140725-M-Atlanta-QF-John_Isner-Marinko_Matosevic,1,F-DTM,6,2,0,0,2,2,4,,,,,,,,,,
20140725-M-Atlanta-QF-John_Isner-Marinko_Matosevic,1,F-DTL,6,1,0,0,1,2,4,,,,,,,,,,
20140725-M-Atlanta-QF-John_Isner-Marinko_Matosevic,1,F-IO,23,12,5,1,6,10,13,,,,,,,,,,
20140725-M-Atlanta-QF-John_Isner-Marinko_Matosevic,1,B-XC,3,2,1,1,0,2,1,,,,,,,,,,
20140725-M-Atlanta-QF-John_Isner-Marinko_Matosevic,1,B-DTM,8,2,0,0,2,1,7,,,,,,,,,,
20140725-M-Atlanta-QF-John_Isner-Marinko_Matosevic,1,B-DTL,9,3,2,1,0,5,4,,,,,,,,,,
20140725-M-Atlanta-QF-John_Isner-Marinko_Matosevic,1,B-IO,5,2,0,1,1,3,2,,,,,,,,,,
20140725-M-Atlanta-QF-John_Isner-Marinko_Matosevic,1,S-XC,4,0,0,0,0,2,2,,,,,,,,,,
20140725-M-Atlanta-QF-John_Isner-Marinko_Matosevic,1,S-DTM,8,0,0,0,0,0,8,,,,,,,,,,
20140725-M-Atlanta-QF-John_Isner-Marinko_Matosevic,1,S-DTL,1,0,0,0,0,0,1,,,,,,,,,,
20140725-M-Atlanta-QF-John_Isner-Marinko_Matosevic,2,F-XC,14,3,0,1,2,11,3,,,,,,,,,,
20140725-M-Atlanta-QF-John_Isner-Marinko_Matosevic,2,F-DTM,10,0,0,0,0,3,7,,,,,,,,,,
20140725-M-Atlanta-QF-John_Isner-Marinko_Matosevic,2,F-DTL,10,4,0,1,3,6,4,,,,,,,,,,
20140725-M-Atlanta-QF-John_Isner-Marinko_Matosevic,2,F-IO,10,2,1,0,1,7,3,,,,,,,,,,
20140725-M-Atlanta-QF-John_Isner-Marinko_Matosevic,2,F-II,1,1,0,0,1,0,1,,,,,,,,,,
20140725-M-Atlanta-QF-John_Isner-Marinko_Matosevic,2,B-XC,14,2,0,1,1,10,4,,,,,,,,,,
20140725-M-Atlanta-QF-John_Isner-Marinko_Matosevic,2,B-DTM,9,1,0,0,1,5,4,,,,,,,,,,
20140725-M-Atlanta-QF-John_Isner-Marinko_Matosevic,2,B-DTL,5,4,2,0,2,3,2,,,,,,,,,,
20140725-M-Atlanta-QF-John_Isner-Marinko_Matosevic,2,B-IO,3,1,0,0,1,2,1,,,,,,,,,,
20140725-M-Atlanta-QF-John_Isner-Marinko_Matosevic,2,S-XC,4,0,0,0,0,4,0,,,,,,,,,,
20140725-M-Atlanta-QF-John_Isner-Marinko_Matosevic,2,S-DTM,1,0,0,0,0,0,1,,,,,,,,,,
20140725-M-Atlanta-QF-John_Isner-Marinko_Matosevic,2,S-DTL,2,1,1,0,0,1,1,,,,,,,,,,
20140725-M-Atlanta-QF-John_Isner-Marinko_Matosevic,2,S-IO,1,0,0,0,0,1,0,,,,,,,,,,
20140727-M-Atlanta-F-John_Isner-Dudi_Sela,1,F-XC,18,11,4,1,6,9,9,,,,,,,,,,
20140727-M-Atlanta-F-John_Isner-Dudi_Sela,1,F-DTM,7,3,0,0,3,1,6,,,,,,,,,,
20140727-M-Atlanta-F-John_Isner-Dudi_Sela,1,F-DTL,5,1,1,0,0,3,2,,,,,,,,,,
20140727-M-Atlanta-F-John_Isner-Dudi_Sela,1,F-IO,18,12,4,1,7,9,9,,,,,,,,,,
20140727-M-Atlanta-F-John_Isner-Dudi_Sela,1,F-II,2,2,0,2,0,2,0,,,,,,,,,,
20140727-M-Atlanta-F-John_Isner-Dudi_Sela,1,B-DTM,3,1,0,0,1,1,2,,,,,,,,,,
20140727-M-Atlanta-F-John_Isner-Dudi_Sela,1,B-DTL,2,2,1,0,1,1,1,,,,,,,,,,
20140727-M-Atlanta-F-John_Isner-Dudi_Sela,1,B-IO,1,1,0,0,1,0,1,,,,,,,,,,
20140727-M-Atlanta-F-John_Isner-Dudi_Sela,1,S-XC,4,0,0,0,0,1,3,,,,,,,,,,
20140727-M-Atlanta-F-John_Isner-Dudi_Sela,1,S-DTM,7,1,0,0,1,2,5,,,,,,,,,,
20140727-M-Atlanta-F-John_Isner-Dudi_Sela,1,S-DTL,1,0,0,0,0,1,0,,,,,,,,,,
20140727-M-Atlanta-F-John_Isner-Dudi_Sela,2,F-XC,13,3,1,1,1,7,6,,,,,,,,,,
20140727-M-Atlanta-F-John_Isner-Dudi_Sela,2,F-DTM,10,1,0,1,0,9,1,,,,,,,,,,
20140727-M-Atlanta-F-John_Isner-Dudi_Sela,2,F-DTL,1,1,0,1,0,1,0,,,,,,,,,,
20140727-M-Atlanta-F-John_Isner-Dudi_Sela,2,F-IO,2,1,0,1,0,2,0,,,,,,,,,,
20140727-M-Atlanta-F-John_Isner-Dudi_Sela,2,B-XC,6,3,2,0,1,5,1,,,,,,,,,,
20140727-M-Atlanta-F-John_Isner-Dudi_Sela,2,B-DTM,12,2,0,1,1,6,6,,,,,,,,,,
20140727-M-Atlanta-F-John_Isner-Dudi_Sela,2,B-DTL,4,3,3,0,0,4,0,,,,,,,,,,
20140727-M-Atlanta-F-John_Isner-Dudi_Sela,2,B-IO,1,1,1,0,0,1,0,,,,,,,,,,
20140727-M-Atlanta-F-John_Isner-Dudi_Sela,2,S-XC,6,1,1,0,0,2,4,,,,,,,,,,
20140727-M-Atlanta-F-John_Isner-Dudi_Sela,2,S-DTM,6,0,0,0,0,3,3,,,,,,,,,,
20140727-M-Atlanta-F-John_Isner-Dudi_Sela,2,S-DTL,2,1,0,0,1,0,2,,,,,,,,,,
20140805-M-Canada_Masters-R32-Peter_Polansky-Roger_Federer,1,F-XC,26,10,1,2,7,12,14,,,,,,,,,,
20140805-M-Canada_Masters-R32-Peter_Polansky-Roger_Federer,1,F-DTM,12,0,0,0,0,5,7,,,,,,,,,,
20140805-M-Canada_Masters-R32-Peter_Polansky-Roger_Federer,1,F-DTL,4,0,0,0,0,1,3,,,,,,,,,,
20140805-M-Canada_Masters-R32-Peter_Polansky-Roger_Federer,1,F-IO,7,3,1,0,2,3,4,,,,,,,,,,
20140805-M-Canada_Masters-R32-Peter_Polansky-Roger_Federer,1,F-II,2,1,0,0,1,0,2,,,,,,,,,,
20140805-M-Canada_Masters-R32-Peter_Polansky-Roger_Federer,1,B-XC,13,2,0,0,2,7,6,,,,,,,,,,
20140805-M-Canada_Masters-R32-Peter_Polansky-Roger_Federer,1,B-DTM,23,1,0,0,1,7,16,,,,,,,,,,
20140805-M-Canada_Masters-R32-Peter_Polansky-Roger_Federer,1,B-DTL,5,2,0,0,2,0,5,,,,,,,,,,
20140805-M-Canada_Masters-R32-Peter_Polansky-Roger_Federer,1,B-IO,1,0,0,0,0,1,0,,,,,,,,,,
20140805-M-Canada_Masters-R32-Peter_Polansky-Roger_Federer,1,S-XC,1,0,0,0,0,1,0,,,,,,,,,,
20140805-M-Canada_Masters-R32-Peter_Polansky-Roger_Federer,2,F-XC,25,8,6,2,0,18,7,,,,,,,,,,
20140805-M-Canada_Masters-R32-Peter_Polansky-Roger_Federer,2,F-DTM,14,4,0,0,4,4,10,,,,,,,,,,
20140805-M-Canada_Masters-R32-Peter_Polansky-Roger_Federer,2,F-DTL,4,0,0,0,0,1,3,,,,,,,,,,
20140805-M-Canada_Masters-R32-Peter_Polansky-Roger_Federer,2,F-IO,15,3,2,0,1,12,3,,,,,,,,,,
20140805-M-Canada_Masters-R32-Peter_Polansky-Roger_Federer,2,F-II,1,1,0,0,1,0,1,,,,,,,,,,
20140805-M-Canada_Masters-R32-Peter_Polansky-Roger_Federer,2,B-XC,10,4,1,1,2,6,4,,,,,,,,,,
20140805-M-Canada_Masters-R32-Peter_Polansky-Roger_Federer,2,B-DTM,6,1,0,0,1,3,3,,,,,,,,,,
20140805-M-Canada_Masters-R32-Peter_Polansky-Roger_Federer,2,B-DTL,2,0,0,0,0,0,2,,,,,,,,,,
20140805-M-Canada_Masters-R32-Peter_Polansky-Roger_Federer,2,S-XC,3,1,0,0,1,1,2,,,,,,,,,,
20140805-M-Canada_Masters-R32-Peter_Polansky-Roger_Federer,2,S-DTM,2,0,0,0,0,1,1,,,,,,,,,,
20140805-M-Canada_Masters-R32-Peter_Polansky-Roger_Federer,2,S-IO,1,1,0,0,1,0,1,,,,,,,,,,
20140807-M-Canada_Masters-R16-Novak_Djokovic-Jo_Wilfried_Tsonga,1,F-XC,20,6,2,1,3,9,11,,,,,,,,,,
20140807-M-Canada_Masters-R16-Novak_Djokovic-Jo_Wilfried_Tsonga,1,F-DTM,8,0,0,0,0,4,4,,,,,,,,,,
20140807-M-Canada_Masters-R16-Novak_Djokovic-Jo_Wilfried_Tsonga,1,F-DTL,14,1,0,1,0,7,7,,,,,,,,,,
20140807-M-Canada_Masters-R16-Novak_Djokovic-Jo_Wilfried_Tsonga,1,F-IO,14,4,1,1,2,8,6,,,,,,,,,,
20140807-M-Canada_Masters-R16-Novak_Djokovic-Jo_Wilfried_Tsonga,1,F-II,1,0,0,0,0,1,0,,,,,,,,,,
20140807-M-Canada_Masters-R16-Novak_Djokovic-Jo_Wilfried_Tsonga,1,B-XC,19,5,0,0,5,4,15,,,,,,,,,,
20140807-M-Canada_Masters-R16-Novak_Djokovic-Jo_Wilfried_Tsonga,1,B-DTM,9,1,0,0,1,4,5,,,,,,,,,,
20140807-M-Canada_Masters-R16-Novak_Djokovic-Jo_Wilfried_Tsonga,1,B-DTL,5,2,1,1,0,3,2,,,,,,,,,,
20140807-M-Canada_Masters-R16-Novak_Djokovic-Jo_Wilfried_Tsonga,1,B-IO,6,0,0,0,0,3,3,,,,,,,,,,
20140807-M-Canada_Masters-R16-Novak_Djokovic-Jo_Wilfried_Tsonga,1,S-XC,2,1,0,0,1,1,1,,,,,,,,,,
20140807-M-Canada_Masters-R16-Novak_Djokovic-Jo_Wilfried_Tsonga,1,S-DTM,4,0,0,0,0,2,2,,,,,,,,,,
20140807-M-Canada_Masters-R16-Novak_Djokovic-Jo_Wilfried_Tsonga,1,S-DTL,2,1,0,0,1,1,1,,,,,,,,,,
20140807-M-Canada_Masters-R16-Novak_Djokovic-Jo_Wilfried_Tsonga,2,F-XC,19,6,2,2,2,11,8,,,,,,,,,,
20140807-M-Canada_Masters-R16-Novak_Djokovic-Jo_Wilfried_Tsonga,2,F-DTM,6,0,0,0,0,2,4,,,,,,,,,,
20140807-M-Canada_Masters-R16-Novak_Djokovic-Jo_Wilfried_Tsonga,2,F-DTL,6,3,0,1,2,4,2,,,,,,,,,,
20140807-M-Canada_Masters-R16-Novak_Djokovic-Jo_Wilfried_Tsonga,2,F-IO,17,5,2,1,2,10,7,,,,,,,,,,
20140807-M-Canada_Masters-R16-Novak_Djokovic-Jo_Wilfried_Tsonga,2,F-II,2,0,0,0,0,1,1,,,,,,,,,,
20140807-M-Canada_Masters-R16-Novak_Djokovic-Jo_Wilfried_Tsonga,2,B-XC,13,4,1,0,3,7,6,,,,,,,,,,
20140807-M-Canada_Masters-R16-Novak_Djokovic-Jo_Wilfried_Tsonga,2,B-DTM,14,2,0,0,2,6,8,,,,,,,,,,
20140807-M-Canada_Masters-R16-Novak_Djokovic-Jo_Wilfried_Tsonga,2,B-DTL,3,1,0,0,1,1,2,,,,,,,,,,
20140807-M-Canada_Masters-R16-Novak_Djokovic-Jo_Wilfried_Tsonga,2,S-XC,10,0,0,0,0,6,4,,,,,,,,,,
20140807-M-Canada_Masters-R16-Novak_Djokovic-Jo_Wilfried_Tsonga,2,S-DTM,6,2,0,0,2,2,4,,,,,,,,,,
20140807-M-Canada_Masters-R16-Novak_Djokovic-Jo_Wilfried_Tsonga,2,S-DTL,2,0,0,0,0,1,1,,,,,,,,,,
20140807-M-Canada_Masters-R16-Novak_Djokovic-Jo_Wilfried_Tsonga,2,S-IO,1,0,0,0,0,1,0,,,,,,,,,,
20140810-M-Canada_Masters-F-Jo_Wilfried_Tsonga-Roger_Federer,1,F-XC,17,6,3,2,1,13,4,,,,,,,,,,
20140810-M-Canada_Masters-F-Jo_Wilfried_Tsonga-Roger_Federer,1,F-DTM,11,1,0,0,1,7,4,,,,,,,,,,
20140810-M-Canada_Masters-F-Jo_Wilfried_Tsonga-Roger_Federer,1,F-DTL,6,3,1,1,1,5,1,,,,,,,,,,
20140810-M-Canada_Masters-F-Jo_Wilfried_Tsonga-Roger_Federer,1,F-IO,18,5,2,1,2,12,6,,,,,,,,,,
20140810-M-Canada_Masters-F-Jo_Wilfried_Tsonga-Roger_Federer,1,B-XC,18,2,1,0,1,4,14,,,,,,,,,,
20140810-M-Canada_Masters-F-Jo_Wilfried_Tsonga-Roger_Federer,1,B-DTM,16,3,0,2,1,12,4,,,,,,,,,,
20140810-M-Canada_Masters-F-Jo_Wilfried_Tsonga-Roger_Federer,1,B-DTL,14,4,1,1,2,7,7,,,,,,,,,,
20140810-M-Canada_Masters-F-Jo_Wilfried_Tsonga-Roger_Federer,1,B-IO,2,1,0,0,1,1,1,,,,,,,,,,
20140810-M-Canada_Masters-F-Jo_Wilfried_Tsonga-Roger_Federer,1,S-XC,3,0,0,0,0,2,1,,,,,,,,,,
20140810-M-Canada_Masters-F-Jo_Wilfried_Tsonga-Roger_Federer,1,S-DTM,4,0,0,0,0,1,3,,,,,,,,,,
20140810-M-Canada_Masters-F-Jo_Wilfried_Tsonga-Roger_Federer,1,S-DTL,3,1,0,1,0,1,2,,,,,,,,,,
20140810-M-Canada_Masters-F-Jo_Wilfried_Tsonga-Roger_Federer,2,F-XC,32,17,4,4,9,13,19,,,,,,,,,,
20140810-M-Canada_Masters-F-Jo_Wilfried_Tsonga-Roger_Federer,2,F-DTM,16,4,1,1,2,3,13,,,,,,,,,,
20140810-M-Canada_Masters-F-Jo_Wilfried_Tsonga-Roger_Federer,2,F-DTL,5,2,0,0,2,2,3,,,,,,,,,,
20140810-M-Canada_Masters-F-Jo_Wilfried_Tsonga-Roger_Federer,2,F-IO,28,9,3,2,4,15,13,,,,,,,,,,
20140810-M-Canada_Masters-F-Jo_Wilfried_Tsonga-Roger_Federer,2,F-II,2,2,1,1,0,2,0,,,,,,,,,,
20140810-M-Canada_Masters-F-Jo_Wilfried_Tsonga-Roger_Federer,2,B-XC,16,4,0,1,3,7,9,,,,,,,,,,
20140810-M-Canada_Masters-F-Jo_Wilfried_Tsonga-Roger_Federer,2,B-DTM,14,5,0,1,4,5,9,,,,,,,,,,
20140810-M-Canada_Masters-F-Jo_Wilfried_Tsonga-Roger_Federer,2,B-DTL,6,5,0,1,4,2,4,,,,,,,,,,
20140810-M-Canada_Masters-F-Jo_Wilfried_Tsonga-Roger_Federer,2,B-IO,2,2,0,0,2,0,2,,,,,,,,,,
20140810-M-Canada_Masters-F-Jo_Wilfried_Tsonga-Roger_Federer,2,S-XC,2,0,0,0,0,1,1,,,,,,,,,,
20140810-M-Canada_Masters-F-Jo_Wilfried_Tsonga-Roger_Federer,2,S-DTM,2,0,0,0,0,0,2,,,,,,,,,,
20140902-M-Shanghai_CH-R32-John_Millman-Ze_Zhang,1,F-XC,38,5,1,3,1,24,14,,,,,,,,,,
20140902-M-Shanghai_CH-R32-John_Millman-Ze_Zhang,1,F-DTM,12,0,0,0,0,4,8,,,,,,,,,,
20140902-M-Shanghai_CH-R32-John_Millman-Ze_Zhang,1,F-DTL,6,3,2,0,1,4,2,,,,,,,,,,
20140902-M-Shanghai_CH-R32-John_Millman-Ze_Zhang,1,F-IO,9,5,1,1,3,4,5,,,,,,,,,,
20140902-M-Shanghai_CH-R32-John_Millman-Ze_Zhang,1,F-II,2,1,1,0,0,2,0,,,,,,,,,,
20140902-M-Shanghai_CH-R32-John_Millman-Ze_Zhang,1,B-XC,34,5,2,0,3,20,14,,,,,,,,,,
20140902-M-Shanghai_CH-R32-John_Millman-Ze_Zhang,1,B-DTM,17,1,0,0,1,9,8,,,,,,,,,,
20140902-M-Shanghai_CH-R32-John_Millman-Ze_Zhang,1,B-DTL,11,2,1,1,0,8,3,,,,,,,,,,
20140902-M-Shanghai_CH-R32-John_Millman-Ze_Zhang,1,B-IO,1,0,0,0,0,1,0,,,,,,,,,,
20140902-M-Shanghai_CH-R32-John_Millman-Ze_Zhang,1,S-XC,2,0,0,0,0,0,2,,,,,,,,,,
20140902-M-Shanghai_CH-R32-John_Millman-Ze_Zhang,1,S-DTM,2,0,0,0,0,1,1,,,,,,,,,,
20140902-M-Shanghai_CH-R32-John_Millman-Ze_Zhang,2,F-XC,37,10,2,1,7,14,23,,,,,,,,,,
20140902-M-Shanghai_CH-R32-John_Millman-Ze_Zhang,2,F-DTM,15,3,0,1,2,6,9,,,,,,,,,,
20140902-M-Shanghai_CH-R32-John_Millman-Ze_Zhang,2,F-DTL,13,4,1,0,3,4,9,,,,,,,,,,
20140902-M-Shanghai_CH-R32-John_Millman-Ze_Zhang,2,F-IO,22,8,4,1,3,14,8,,,,,,,,,,
20140902-M-Shanghai_CH-R32-John_Millman-Ze_Zhang,2,F-II,3,2,0,0,2,0,3,,,,,,,,,,
20140902-M-Shanghai_CH-R32-John_Millman-Ze_Zhang,2,B-XC,20,2,1,0,1,9,11,,,,,,,,,,
20140902-M-Shanghai_CH-R32-John_Millman-Ze_Zhang,2,B-DTM,17,3,0,0,3,4,13,,,,,,,,,,
20140902-M-Shanghai_CH-R32-John_Millman-Ze_Zhang,2,B-DTL,7,2,1,0,1,5,2,,,,,,,,,,
20140902-M-Shanghai_CH-R32-John_Millman-Ze_Zhang,2,B-IO,3,3,0,1,2,1,2,,,,,,,,,,
20140902-M-Shanghai_CH-R32-John_Millman-Ze_Zhang,2,S-XC,2,0,0,0,0,0,2,,,,,,,,,,
20140902-M-Shanghai_CH-R32-John_Millman-Ze_Zhang,2,S-DTM,1,0,0,0,0,1,0,,,,,,,,,,
20140908-M-USA_F24-QF-Jean_Yves_Aubone-Ty_Trombetta,1,F-XC,28,8,0,2,6,14,14,,,,,,,,,,
20140908-M-USA_F24-QF-Jean_Yves_Aubone-Ty_Trombetta,1,F-DTM,42,5,0,0,5,20,22,,,,,,,,,,
20140908-M-USA_F24-QF-Jean_Yves_Aubone-Ty_Trombetta,1,F-DTL,8,2,1,1,0,6,2,,,,,,,,,,
20140908-M-USA_F24-QF-Jean_Yves_Aubone-Ty_Trombetta,1,F-IO,20,2,2,0,0,10,10,,,,,,,,,,
20140908-M-USA_F24-QF-Jean_Yves_Aubone-Ty_Trombetta,1,F-II,2,1,0,1,0,1,1,,,,,,,,,,
20140908-M-USA_F24-QF-Jean_Yves_Aubone-Ty_Trombetta,1,B-XC,14,2,1,1,0,9,5,,,,,,,,,,
20140908-M-USA_F24-QF-Jean_Yves_Aubone-Ty_Trombetta,1,B-DTM,16,2,0,1,1,8,8,,,,,,,,,,
20140908-M-USA_F24-QF-Jean_Yves_Aubone-Ty_Trombetta,1,B-DTL,1,0,0,0,0,1,0,,,,,,,,,,
20140908-M-USA_F24-QF-Jean_Yves_Aubone-Ty_Trombetta,1,B-IO,1,0,0,0,0,1,0,,,,,,,,,,
20140908-M-USA_F24-QF-Jean_Yves_Aubone-Ty_Trombetta,1,S-XC,9,1,0,0,1,7,2,,,,,,,,,,
20140908-M-USA_F24-QF-Jean_Yves_Aubone-Ty_Trombetta,1,S-DTM,14,1,0,0,1,8,6,,,,,,,,,,
20140908-M-USA_F24-QF-Jean_Yves_Aubone-Ty_Trombetta,1,S-DTL,1,0,0,0,0,0,1,,,,,,,,,,
20140908-M-USA_F24-QF-Jean_Yves_Aubone-Ty_Trombetta,1,S-IO,2,0,0,0,0,2,0,,,,,,,,,,
20140908-M-USA_F24-QF-Jean_Yves_Aubone-Ty_Trombetta,2,F-XC,31,8,3,0,5,10,21,,,,,,,,,,
20140908-M-USA_F24-QF-Jean_Yves_Aubone-Ty_Trombetta,2,F-DTM,38,3,0,2,1,21,17,,,,,,,,,,
20140908-M-USA_F24-QF-Jean_Yves_Aubone-Ty_Trombetta,2,F-IO,20,6,2,2,2,9,11,,,,,,,,,,
20140908-M-USA_F24-QF-Jean_Yves_Aubone-Ty_Trombetta,2,F-II,1,0,0,0,0,0,1,,,,,,,,,,
20140908-M-USA_F24-QF-Jean_Yves_Aubone-Ty_Trombetta,2,B-XC,36,9,0,3,6,17,19,,,,,,,,,,
20140908-M-USA_F24-QF-Jean_Yves_Aubone-Ty_Trombetta,2,B-DTM,27,5,0,0,5,11,16,,,,,,,,,,
20140908-M-USA_F24-QF-Jean_Yves_Aubone-Ty_Trombetta,2,B-DTL,9,5,2,1,2,5,4,,,,,,,,,,
20140908-M-USA_F24-QF-Jean_Yves_Aubone-Ty_Trombetta,2,B-IO,5,3,1,0,2,3,2,,,,,,,,,,
20140908-M-USA_F24-QF-Jean_Yves_Aubone-Ty_Trombetta,2,S-DTM,2,0,0,0,0,1,1,,,,,,,,,,
20140914-M-Davis_Cup_World_Group_SF-RR-Roger_Federer-Fabio_Fognini,1,F-XC,31,11,1,5,5,20,11,,,,,,,,,,
20140914-M-Davis_Cup_World_Group_SF-RR-Roger_Federer-Fabio_Fognini,1,F-DTM,32,1,0,0,1,15,17,,,,,,,,,,
20140914-M-Davis_Cup_World_Group_SF-RR-Roger_Federer-Fabio_Fognini,1,F-DTL,5,4,3,0,1,3,2,,,,,,,,,,
20140914-M-Davis_Cup_World_Group_SF-RR-Roger_Federer-Fabio_Fognini,1,F-IO,29,11,4,1,6,13,16,,,,,,,,,,
20140914-M-Davis_Cup_World_Group_SF-RR-Roger_Federer-Fabio_Fognini,1,F-II,2,1,1,0,0,1,1,,,,,,,,,,
20140914-M-Davis_Cup_World_Group_SF-RR-Roger_Federer-Fabio_Fognini,1,B-XC,39,6,2,1,3,14,25,,,,,,,,,,
20140914-M-Davis_Cup_World_Group_SF-RR-Roger_Federer-Fabio_Fognini,1,B-DTM,38,8,0,0,8,11,27,,,,,,,,,,
20140914-M-Davis_Cup_World_Group_SF-RR-Roger_Federer-Fabio_Fognini,1,B-DTL,8,3,0,1,2,4,4,,,,,,,,,,
20140914-M-Davis_Cup_World_Group_SF-RR-Roger_Federer-Fabio_Fognini,1,B-IO,1,0,0,0,0,1,0,,,,,,,,,,
20140914-M-Davis_Cup_World_Group_SF-RR-Roger_Federer-Fabio_Fognini,1,S-XC,24,2,0,0,2,7,17,,,,,,,,,,
20140914-M-Davis_Cup_World_Group_SF-RR-Roger_Federer-Fabio_Fognini,1,S-DTM,12,2,0,0,2,3,9,,,,,,,,,,
20140914-M-Davis_Cup_World_Group_SF-RR-Roger_Federer-Fabio_Fognini,1,S-DTL,1,0,0,0,0,0,1,,,,,,,,,,
20140914-M-Davis_Cup_World_Group_SF-RR-Roger_Federer-Fabio_Fognini,1,S-IO,1,0,0,0,0,0,1,,,,,,,,,,
20140914-M-Davis_Cup_World_Group_SF-RR-Roger_Federer-Fabio_Fognini,2,F-XC,27,11,1,6,4,14,13,,,,,,,,,,
20140914-M-Davis_Cup_World_Group_SF-RR-Roger_Federer-Fabio_Fognini,2,F-DTM,30,3,0,0,3,12,18,,,,,,,,,,
20140914-M-Davis_Cup_World_Group_SF-RR-Roger_Federer-Fabio_Fognini,2,F-DTL,10,4,1,0,3,5,5,,,,,,,,,,
20140914-M-Davis_Cup_World_Group_SF-RR-Roger_Federer-Fabio_Fognini,2,F-IO,47,10,1,1,8,28,19,,,,,,,,,,
20140914-M-Davis_Cup_World_Group_SF-RR-Roger_Federer-Fabio_Fognini,2,F-II,2,2,0,1,1,1,1,,,,,,,,,,
20140914-M-Davis_Cup_World_Group_SF-RR-Roger_Federer-Fabio_Fognini,2,B-XC,52,6,1,2,3,39,13,,,,,,,,,,
20140914-M-Davis_Cup_World_Group_SF-RR-Roger_Federer-Fabio_Fognini,2,B-DTM,34,5,0,1,4,18,16,,,,,,,,,,
20140914-M-Davis_Cup_World_Group_SF-RR-Roger_Federer-Fabio_Fognini,2,B-DTL,9,5,2,0,3,6,3,,,,,,,,,,
20140914-M-Davis_Cup_World_Group_SF-RR-Roger_Federer-Fabio_Fognini,2,B-IO,4,3,1,1,1,2,2,,,,,,,,,,
20140914-M-Davis_Cup_World_Group_SF-RR-Roger_Federer-Fabio_Fognini,2,S-XC,2,0,0,0,0,0,2,,,,,,,,,,
20140914-M-Davis_Cup_World_Group_SF-RR-Roger_Federer-Fabio_Fognini,2,S-DTM,9,0,0,0,0,7,2,,,,,,,,,,
20140914-M-Davis_Cup_World_Group_SF-RR-Roger_Federer-Fabio_Fognini,2,S-II,1,1,1,0,0,1,0,,,,,,,,,,
20140915-M-USA_F25-SF-Tennys_Sandgren-Jarmere_Jenkins,1,F-XC,79,19,3,9,7,38,41,,,,,,,,,,
20140915-M-USA_F25-SF-Tennys_Sandgren-Jarmere_Jenkins,1,F-DTM,73,4,0,0,4,30,43,,,,,,,,,,
20140915-M-USA_F25-SF-Tennys_Sandgren-Jarmere_Jenkins,1,F-DTL,13,8,2,1,5,4,9,,,,,,,,,,
20140915-M-USA_F25-SF-Tennys_Sandgren-Jarmere_Jenkins,1,F-IO,49,10,1,4,5,28,21,,,,,,,,,,
20140915-M-USA_F25-SF-Tennys_Sandgren-Jarmere_Jenkins,1,B-XC,65,11,2,3,6,35,30,,,,,,,,,,
20140915-M-USA_F25-SF-Tennys_Sandgren-Jarmere_Jenkins,1,B-DTM,49,5,0,1,4,20,29,,,,,,,,,,
20140915-M-USA_F25-SF-Tennys_Sandgren-Jarmere_Jenkins,1,B-DTL,12,8,1,2,5,3,9,,,,,,,,,,
20140915-M-USA_F25-SF-Tennys_Sandgren-Jarmere_Jenkins,1,B-IO,9,4,3,1,0,7,2,,,,,,,,,,
20140915-M-USA_F25-SF-Tennys_Sandgren-Jarmere_Jenkins,1,S-XC,15,1,0,1,0,7,8,,,,,,,,,,
20140915-M-USA_F25-SF-Tennys_Sandgren-Jarmere_Jenkins,1,S-DTM,29,3,0,0,3,11,18,,,,,,,,,,
20140915-M-USA_F25-SF-Tennys_Sandgren-Jarmere_Jenkins,1,S-DTL,4,2,0,1,1,2,2,,,,,,,,,,
20140915-M-USA_F25-SF-Tennys_Sandgren-Jarmere_Jenkins,2,F-XC,73,21,5,4,12,44,29,,,,,,,,,,
20140915-M-USA_F25-SF-Tennys_Sandgren-Jarmere_Jenkins,2,F-DTM,61,5,0,1,4,32,29,,,,,,,,,,
20140915-M-USA_F25-SF-Tennys_Sandgren-Jarmere_Jenkins,2,F-DTL,27,14,4,6,4,18,9,,,,,,,,,,
20140915-M-USA_F25-SF-Tennys_Sandgren-Jarmere_Jenkins,2,F-IO,47,16,3,7,6,31,16,,,,,,,,,,
20140915-M-USA_F25-SF-Tennys_Sandgren-Jarmere_Jenkins,2,F-II,5,1,0,1,0,3,2,,,,,,,,,,
20140915-M-USA_F25-SF-Tennys_Sandgren-Jarmere_Jenkins,2,B-XC,47,4,0,1,3,25,22,,,,,,,,,,
20140915-M-USA_F25-SF-Tennys_Sandgren-Jarmere_Jenkins,2,B-DTM,60,2,0,0,2,30,30,,,,,,,,,,
20140915-M-USA_F25-SF-Tennys_Sandgren-Jarmere_Jenkins,2,B-DTL,9,7,1,2,4,3,6,,,,,,,,,,
20140915-M-USA_F25-SF-Tennys_Sandgren-Jarmere_Jenkins,2,B-IO,3,0,0,0,0,1,2,,,,,,,,,,
20140915-M-USA_F25-SF-Tennys_Sandgren-Jarmere_Jenkins,2,S-XC,22,4,0,0,4,11,11,,,,,,,,,,
20140915-M-USA_F25-SF-Tennys_Sandgren-Jarmere_Jenkins,2,S-DTM,16,0,0,0,0,5,11,,,,,,,,,,
20140915-M-USA_F25-SF-Tennys_Sandgren-Jarmere_Jenkins,2,S-DTL,6,4,0,0,4,1,5,,,,,,,,,,
20140915-M-USA_F25-SF-Tennys_Sandgren-Jarmere_Jenkins,2,S-IO,2,0,0,0,0,1,1,,,,,,,,,,
20140922-M-Shenzhen-R16-Somdev_Devvarman-Andy_Murray,1,F-XC,40,2,1,1,0,17,23,,,,,,,,,,
20140922-M-Shenzhen-R16-Somdev_Devvarman-Andy_Murray,1,F-DTM,24,3,0,0,3,7,17,,,,,,,,,,
20140922-M-Shenzhen-R16-Somdev_Devvarman-Andy_Murray,1,F-DTL,19,2,0,0,2,10,9,,,,,,,,,,
20140922-M-Shenzhen-R16-Somdev_Devvarman-Andy_Murray,1,F-IO,23,6,0,3,3,12,11,,,,,,,,,,
20140922-M-Shenzhen-R16-Somdev_Devvarman-Andy_Murray,1,F-II,1,0,0,0,0,1,0,,,,,,,,,,
20140922-M-Shenzhen-R16-Somdev_Devvarman-Andy_Murray,1,B-XC,25,2,1,0,1,16,9,,,,,,,,,,
20140922-M-Shenzhen-R16-Somdev_Devvarman-Andy_Murray,1,B-DTM,20,2,0,0,2,5,15,,,,,,,,,,
20140922-M-Shenzhen-R16-Somdev_Devvarman-Andy_Murray,1,B-DTL,8,3,0,0,3,3,5,,,,,,,,,,
20140922-M-Shenzhen-R16-Somdev_Devvarman-Andy_Murray,1,B-IO,3,0,0,0,0,0,3,,,,,,,,,,
20140922-M-Shenzhen-R16-Somdev_Devvarman-Andy_Murray,1,S-XC,14,1,0,0,1,5,9,,,,,,,,,,
20140922-M-Shenzhen-R16-Somdev_Devvarman-Andy_Murray,1,S-DTM,10,0,0,0,0,5,5,,,,,,,,,,
20140922-M-Shenzhen-R16-Somdev_Devvarman-Andy_Murray,1,S-IO,2,0,0,0,0,1,1,,,,,,,,,,
20140922-M-Shenzhen-R16-Somdev_Devvarman-Andy_Murray,2,F-XC,51,10,5,2,3,33,18,,,,,,,,,,
20140922-M-Shenzhen-R16-Somdev_Devvarman-Andy_Murray,2,F-DTM,6,1,0,0,1,2,4,,,,,,,,,,
20140922-M-Shenzhen-R16-Somdev_Devvarman-Andy_Murray,2,F-DTL,20,3,0,2,1,14,6,,,,,,,,,,
20140922-M-Shenzhen-R16-Somdev_Devvarman-Andy_Murray,2,F-IO,34,12,6,1,5,21,13,,,,,,,,,,
20140922-M-Shenzhen-R16-Somdev_Devvarman-Andy_Murray,2,F-II,5,2,2,0,0,5,0,,,,,,,,,,
20140922-M-Shenzhen-R16-Somdev_Devvarman-Andy_Murray,2,B-XC,27,5,0,0,5,12,15,,,,,,,,,,
20140922-M-Shenzhen-R16-Somdev_Devvarman-Andy_Murray,2,B-DTM,17,0,0,0,0,11,6,,,,,,,,,,
20140922-M-Shenzhen-R16-Somdev_Devvarman-Andy_Murray,2,B-DTL,15,3,1,1,1,9,6,,,,,,,,,,
20140922-M-Shenzhen-R16-Somdev_Devvarman-Andy_Murray,2,B-IO,6,2,1,0,1,3,3,,,,,,,,,,
20140922-M-Shenzhen-R16-Somdev_Devvarman-Andy_Murray,2,S-XC,3,1,0,0,1,1,2,,,,,,,,,,
20140922-M-Shenzhen-R16-Somdev_Devvarman-Andy_Murray,2,S-DTM,9,0,0,0,0,3,6,,,,,,,,,,
20140922-M-Shenzhen-R16-Somdev_Devvarman-Andy_Murray,2,S-DTL,2,1,0,0,1,0,2,,,,,,,,,,
20140928-M-Shenzhen-F-Andy_Murray-Tommy_Robredo,1,F-XC,40,13,6,1,6,22,18,,,,,,,,,,
20140928-M-Shenzhen-F-Andy_Murray-Tommy_Robredo,1,F-DTM,19,0,0,0,0,9,10,,,,,,,,,,
20140928-M-Shenzhen-F-Andy_Murray-Tommy_Robredo,1,F-DTL,28,7,4,0,3,12,16,,,,,,,,,,
20140928-M-Shenzhen-F-Andy_Murray-Tommy_Robredo,1,F-IO,51,10,4,4,2,29,22,,,,,,,,,,
20140928-M-Shenzhen-F-Andy_Murray-Tommy_Robredo,1,F-II,3,1,0,1,0,2,1,,,,,,,,,,
20140928-M-Shenzhen-F-Andy_Murray-Tommy_Robredo,1,B-XC,54,10,1,1,8,18,36,,,,,,,,,,
20140928-M-Shenzhen-F-Andy_Murray-Tommy_Robredo,1,B-DTM,23,7,1,0,6,8,15,,,,,,,,,,
20140928-M-Shenzhen-F-Andy_Murray-Tommy_Robredo,1,B-DTL,10,5,2,1,2,8,2,,,,,,,,,,
20140928-M-Shenzhen-F-Andy_Murray-Tommy_Robredo,1,B-IO,1,1,0,0,1,0,1,,,,,,,,,,
20140928-M-Shenzhen-F-Andy_Murray-Tommy_Robredo,1,S-XC,6,0,0,0,0,3,3,,,,,,,,,,
20140928-M-Shenzhen-F-Andy_Murray-Tommy_Robredo,1,S-DTM,5,0,0,0,0,2,3,,,,,,,,,,
20140928-M-Shenzhen-F-Andy_Murray-Tommy_Robredo,1,S-DTL,2,0,0,0,0,1,1,,,,,,,,,,
20140928-M-Shenzhen-F-Andy_Murray-Tommy_Robredo,1,S-IO,1,0,0,0,0,0,1,,,,,,,,,,
20140928-M-Shenzhen-F-Andy_Murray-Tommy_Robredo,2,F-XC,44,9,3,3,3,22,22,,,,,,,,,,
20140928-M-Shenzhen-F-Andy_Murray-Tommy_Robredo,2,F-DTM,22,1,1,0,0,9,13,,,,,,,,,,
20140928-M-Shenzhen-F-Andy_Murray-Tommy_Robredo,2,F-DTL,13,5,2,0,3,8,5,,,,,,,,,,
20140928-M-Shenzhen-F-Andy_Murray-Tommy_Robredo,2,F-IO,42,12,5,2,5,24,18,,,,,,,,,,
20140928-M-Shenzhen-F-Andy_Murray-Tommy_Robredo,2,F-II,15,6,3,2,1,13,2,,,,,,,,,,
20140928-M-Shenzhen-F-Andy_Murray-Tommy_Robredo,2,B-XC,32,6,1,2,3,21,11,,,,,,,,,,
20140928-M-Shenzhen-F-Andy_Murray-Tommy_Robredo,2,B-DTM,28,4,0,0,4,13,15,,,,,,,,,,
20140928-M-Shenzhen-F-Andy_Murray-Tommy_Robredo,2,B-DTL,10,3,2,0,1,5,5,,,,,,,,,,
20140928-M-Shenzhen-F-Andy_Murray-Tommy_Robredo,2,B-IO,1,0,0,0,0,0,1,,,,,,,,,,
20140928-M-Shenzhen-F-Andy_Murray-Tommy_Robredo,2,S-XC,23,2,0,0,2,10,13,,,,,,,,,,
20140928-M-Shenzhen-F-Andy_Murray-Tommy_Robredo,2,S-DTM,15,0,0,0,0,7,8,,,,,,,,,,
20140928-M-Shenzhen-F-Andy_Murray-Tommy_Robredo,2,S-DTL,9,1,1,0,0,6,3,,,,,,,,,,
20140929-M-Sacramento_CH-R16-Jared_Donaldson-Luca_Vanni,1,F-XC,57,12,5,2,5,28,29,,,,,,,,,,
20140929-M-Sacramento_CH-R16-Jared_Donaldson-Luca_Vanni,1,F-DTM,27,2,0,0,2,12,15,,,,,,,,,,
20140929-M-Sacramento_CH-R16-Jared_Donaldson-Luca_Vanni,1,F-DTL,9,0,0,0,0,1,8,,,,,,,,,,
20140929-M-Sacramento_CH-R16-Jared_Donaldson-Luca_Vanni,1,F-IO,24,6,1,0,5,8,16,,,,,,,,,,
20140929-M-Sacramento_CH-R16-Jared_Donaldson-Luca_Vanni,1,F-II,1,1,0,0,1,0,1,,,,,,,,,,
20140929-M-Sacramento_CH-R16-Jared_Donaldson-Luca_Vanni,1,B-XC,60,12,4,1,7,24,36,,,,,,,,,,
20140929-M-Sacramento_CH-R16-Jared_Donaldson-Luca_Vanni,1,B-DTM,24,2,0,0,2,7,17,,,,,,,,,,
20140929-M-Sacramento_CH-R16-Jared_Donaldson-Luca_Vanni,1,B-DTL,10,3,1,1,1,7,3,,,,,,,,,,
20140929-M-Sacramento_CH-R16-Jared_Donaldson-Luca_Vanni,1,B-IO,5,3,1,0,2,3,2,,,,,,,,,,
20140929-M-Sacramento_CH-R16-Jared_Donaldson-Luca_Vanni,1,S-XC,10,0,0,0,0,4,6,,,,,,,,,,
20140929-M-Sacramento_CH-R16-Jared_Donaldson-Luca_Vanni,1,S-DTM,5,0,0,0,0,4,1,,,,,,,,,,
20140929-M-Sacramento_CH-R16-Jared_Donaldson-Luca_Vanni,1,S-DTL,2,1,0,0,1,0,2,,,,,,,,,,
20140929-M-Sacramento_CH-R16-Jared_Donaldson-Luca_Vanni,1,S-IO,2,0,0,0,0,0,2,,,,,,,,,,
20140929-M-Sacramento_CH-R16-Jared_Donaldson-Luca_Vanni,2,F-XC,54,19,5,2,12,32,22,,,,,,,,,,
20140929-M-Sacramento_CH-R16-Jared_Donaldson-Luca_Vanni,2,F-DTM,18,3,0,0,3,7,11,,,,,,,,,,
20140929-M-Sacramento_CH-R16-Jared_Donaldson-Luca_Vanni,2,F-DTL,18,5,2,2,1,12,6,,,,,,,,,,
20140929-M-Sacramento_CH-R16-Jared_Donaldson-Luca_Vanni,2,F-IO,41,8,1,1,6,20,21,,,,,,,,,,
20140929-M-Sacramento_CH-R16-Jared_Donaldson-Luca_Vanni,2,F-II,6,2,0,1,1,4,2,,,,,,,,,,
20140929-M-Sacramento_CH-R16-Jared_Donaldson-Luca_Vanni,2,B-XC,13,3,1,0,2,5,8,,,,,,,,,,
20140929-M-Sacramento_CH-R16-Jared_Donaldson-Luca_Vanni,2,B-DTM,14,2,1,0,1,7,7,,,,,,,,,,
20140929-M-Sacramento_CH-R16-Jared_Donaldson-Luca_Vanni,2,B-DTL,9,2,0,1,1,4,5,,,,,,,,,,
20140929-M-Sacramento_CH-R16-Jared_Donaldson-Luca_Vanni,2,B-IO,2,1,0,0,1,1,1,,,,,,,,,,
20140929-M-Sacramento_CH-R16-Jared_Donaldson-Luca_Vanni,2,S-XC,26,0,0,0,0,20,6,,,,,,,,,,
20140929-M-Sacramento_CH-R16-Jared_Donaldson-Luca_Vanni,2,S-DTM,25,0,0,0,0,18,7,,,,,,,,,,
20140929-M-Sacramento_CH-R16-Jared_Donaldson-Luca_Vanni,2,S-DTL,1,0,0,0,0,0,1,,,,,,,,,,
20141104-M-Knoxville_CH-R32-Jared_Donaldson-Daniel_Nguyen,1,F-XC,54,6,4,0,2,40,14,,,,,,,,,,
20141104-M-Knoxville_CH-R32-Jared_Donaldson-Daniel_Nguyen,1,F-DTM,22,1,0,0,1,13,9,,,,,,,,,,
20141104-M-Knoxville_CH-R32-Jared_Donaldson-Daniel_Nguyen,1,F-DTL,27,9,5,1,3,17,10,,,,,,,,,,
20141104-M-Knoxville_CH-R32-Jared_Donaldson-Daniel_Nguyen,1,F-IO,26,9,5,1,3,16,10,,,,,,,,,,
20141104-M-Knoxville_CH-R32-Jared_Donaldson-Daniel_Nguyen,1,F-II,2,0,0,0,0,1,1,,,,,,,,,,
20141104-M-Knoxville_CH-R32-Jared_Donaldson-Daniel_Nguyen,1,B-XC,32,7,3,1,3,18,14,,,,,,,,,,
20141104-M-Knoxville_CH-R32-Jared_Donaldson-Daniel_Nguyen,1,B-DTM,14,0,0,0,0,12,2,,,,,,,,,,
20141104-M-Knoxville_CH-R32-Jared_Donaldson-Daniel_Nguyen,1,B-DTL,8,5,1,1,3,5,3,,,,,,,,,,
20141104-M-Knoxville_CH-R32-Jared_Donaldson-Daniel_Nguyen,1,B-IO,5,1,0,1,0,4,1,,,,,,,,,,
20141104-M-Knoxville_CH-R32-Jared_Donaldson-Daniel_Nguyen,1,S-XC,2,0,0,0,0,1,1,,,,,,,,,,
20141104-M-Knoxville_CH-R32-Jared_Donaldson-Daniel_Nguyen,1,S-DTM,4,0,0,0,0,0,4,,,,,,,,,,
20141104-M-Knoxville_CH-R32-Jared_Donaldson-Daniel_Nguyen,1,S-DTL,2,0,0,0,0,1,1,,,,,,,,,,
20141104-M-Knoxville_CH-R32-Jared_Donaldson-Daniel_Nguyen,2,F-XC,59,12,0,3,9,17,42,,,,,,,,,,
20141104-M-Knoxville_CH-R32-Jared_Donaldson-Daniel_Nguyen,2,F-DTM,33,4,0,0,4,8,25,,,,,,,,,,
20141104-M-Knoxville_CH-R32-Jared_Donaldson-Daniel_Nguyen,2,F-DTL,4,0,0,0,0,3,1,,,,,,,,,,
20141104-M-Knoxville_CH-R32-Jared_Donaldson-Daniel_Nguyen,2,F-IO,26,10,1,3,6,14,12,,,,,,,,,,
20141104-M-Knoxville_CH-R32-Jared_Donaldson-Daniel_Nguyen,2,F-II,2,0,0,0,0,1,1,,,,,,,,,,
20141104-M-Knoxville_CH-R32-Jared_Donaldson-Daniel_Nguyen,2,B-XC,20,6,1,1,4,10,10,,,,,,,,,,
20141104-M-Knoxville_CH-R32-Jared_Donaldson-Daniel_Nguyen,2,B-DTM,12,1,0,0,1,3,9,,,,,,,,,,
20141104-M-Knoxville_CH-R32-Jared_Donaldson-Daniel_Nguyen,2,B-DTL,4,3,0,1,2,1,3,,,,,,,,,,
20141104-M-Knoxville_CH-R32-Jared_Donaldson-Daniel_Nguyen,2,S-XC,14,2,0,0,2,6,8,,,,,,,,,,
20141104-M-Knoxville_CH-R32-Jared_Donaldson-Daniel_Nguyen,2,S-DTM,6,0,0,0,0,1,5,,,,,,,,,,
20141104-M-Knoxville_CH-R32-Jared_Donaldson-Daniel_Nguyen,2,S-DTL,2,0,0,0,0,0,2,,,,,,,,,,
20141104-M-Knoxville_CH-R32-Jared_Donaldson-Daniel_Nguyen,2,S-IO,2,0,0,0,0,1,1,,,,,,,,,,
20141111-M-Champaign_CH-R32-Jared_Donaldson-Alex_Kuznetsov,1,F-XC,23,8,3,3,2,15,8,,,,,,,,,,
20141111-M-Champaign_CH-R32-Jared_Donaldson-Alex_Kuznetsov,1,F-DTM,11,0,0,0,0,5,6,,,,,,,,,,
20141111-M-Champaign_CH-R32-Jared_Donaldson-Alex_Kuznetsov,1,F-DTL,8,2,0,1,1,5,3,,,,,,,,,,
20141111-M-Champaign_CH-R32-Jared_Donaldson-Alex_Kuznetsov,1,F-IO,9,2,2,0,0,9,0,,,,,,,,,,
20141111-M-Champaign_CH-R32-Jared_Donaldson-Alex_Kuznetsov,1,F-II,2,0,0,0,0,1,1,,,,,,,,,,
20141111-M-Champaign_CH-R32-Jared_Donaldson-Alex_Kuznetsov,1,B-XC,23,3,0,1,2,15,8,,,,,,,,,,
20141111-M-Champaign_CH-R32-Jared_Donaldson-Alex_Kuznetsov,1,B-DTM,14,2,0,0,2,5,9,,,,,,,,,,
20141111-M-Champaign_CH-R32-Jared_Donaldson-Alex_Kuznetsov,1,B-DTL,6,3,2,1,0,6,0,,,,,,,,,,
20141111-M-Champaign_CH-R32-Jared_Donaldson-Alex_Kuznetsov,1,B-IO,3,0,0,0,0,3,0,,,,,,,,,,
20141111-M-Champaign_CH-R32-Jared_Donaldson-Alex_Kuznetsov,1,S-DTM,1,0,0,0,0,0,1,,,,,,,,,,
20141111-M-Champaign_CH-R32-Jared_Donaldson-Alex_Kuznetsov,2,F-XC,31,13,2,0,11,12,19,,,,,,,,,,
20141111-M-Champaign_CH-R32-Jared_Donaldson-Alex_Kuznetsov,2,F-DTM,6,0,0,0,0,3,3,,,,,,,,,,
20141111-M-Champaign_CH-R32-Jared_Donaldson-Alex_Kuznetsov,2,F-DTL,9,3,1,0,2,5,4,,,,,,,,,,
20141111-M-Champaign_CH-R32-Jared_Donaldson-Alex_Kuznetsov,2,F-IO,15,7,2,0,5,6,9,,,,,,,,,,
20141111-M-Champaign_CH-R32-Jared_Donaldson-Alex_Kuznetsov,2,F-II,1,1,0,0,1,0,1,,,,,,,,,,
20141111-M-Champaign_CH-R32-Jared_Donaldson-Alex_Kuznetsov,2,B-XC,13,3,0,1,2,4,9,,,,,,,,,,
20141111-M-Champaign_CH-R32-Jared_Donaldson-Alex_Kuznetsov,2,B-DTM,11,1,0,0,1,3,8,,,,,,,,,,
20141111-M-Champaign_CH-R32-Jared_Donaldson-Alex_Kuznetsov,2,B-DTL,4,2,2,0,0,2,2,,,,,,,,,,
20141111-M-Champaign_CH-R32-Jared_Donaldson-Alex_Kuznetsov,2,B-IO,2,2,0,0,2,0,2,,,,,,,,,,
20141111-M-Champaign_CH-R32-Jared_Donaldson-Alex_Kuznetsov,2,S-XC,6,1,0,0,1,2,4,,,,,,,,,,
20141111-M-Champaign_CH-R32-Jared_Donaldson-Alex_Kuznetsov,2,S-DTM,3,0,0,0,0,1,2,,,,,,,,,,
20141111-M-Champaign_CH-R32-Jared_Donaldson-Alex_Kuznetsov,2,S-DTL,2,1,0,0,1,1,1,,,,,,,,,,
20141114-M-Tour_Finals-RR-Tomas_Berdych-Novak_Djokovic,1,F-XC,24,5,0,3,2,7,17,,,,,,,,,,
20141114-M-Tour_Finals-RR-Tomas_Berdych-Novak_Djokovic,1,F-DTM,4,0,0,0,0,1,3,,,,,,,,,,
20141114-M-Tour_Finals-RR-Tomas_Berdych-Novak_Djokovic,1,F-DTL,6,3,1,0,2,1,5,,,,,,,,,,
20141114-M-Tour_Finals-RR-Tomas_Berdych-Novak_Djokovic,1,F-IO,18,6,0,1,5,7,11,,,,,,,,,,
20141114-M-Tour_Finals-RR-Tomas_Berdych-Novak_Djokovic,1,F-II,3,0,0,0,0,0,3,,,,,,,,,,
20141114-M-Tour_Finals-RR-Tomas_Berdych-Novak_Djokovic,1,B-XC,26,5,2,1,2,9,17,,,,,,,,,,
20141114-M-Tour_Finals-RR-Tomas_Berdych-Novak_Djokovic,1,B-DTM,11,1,0,0,1,4,7,,,,,,,,,,
20141114-M-Tour_Finals-RR-Tomas_Berdych-Novak_Djokovic,1,B-DTL,11,2,0,0,2,2,9,,,,,,,,,,
20141114-M-Tour_Finals-RR-Tomas_Berdych-Novak_Djokovic,1,S-XC,6,0,0,0,0,2,4,,,,,,,,,,
20141114-M-Tour_Finals-RR-Tomas_Berdych-Novak_Djokovic,1,S-DTM,8,0,0,0,0,1,7,,,,,,,,,,
20141114-M-Tour_Finals-RR-Tomas_Berdych-Novak_Djokovic,2,F-XC,23,9,5,4,0,20,3,,,,,,,,,,
20141114-M-Tour_Finals-RR-Tomas_Berdych-Novak_Djokovic,2,F-DTM,11,0,0,0,0,8,3,,,,,,,,,,
20141114-M-Tour_Finals-RR-Tomas_Berdych-Novak_Djokovic,2,F-DTL,11,2,0,0,2,7,4,,,,,,,,,,
20141114-M-Tour_Finals-RR-Tomas_Berdych-Novak_Djokovic,2,F-IO,14,1,1,0,0,11,3,,,,,,,,,,
20141114-M-Tour_Finals-RR-Tomas_Berdych-Novak_Djokovic,2,F-II,1,1,1,0,0,1,0,,,,,,,,,,
20141114-M-Tour_Finals-RR-Tomas_Berdych-Novak_Djokovic,2,B-XC,25,6,1,3,2,19,6,,,,,,,,,,
20141114-M-Tour_Finals-RR-Tomas_Berdych-Novak_Djokovic,2,B-DTM,4,0,0,0,0,1,3,,,,,,,,,,
20141114-M-Tour_Finals-RR-Tomas_Berdych-Novak_Djokovic,2,B-DTL,8,4,1,1,2,6,2,,,,,,,,,,
20141114-M-Tour_Finals-RR-Tomas_Berdych-Novak_Djokovic,2,B-IO,6,3,2,0,1,5,1,,,,,,,,,,
20141114-M-Tour_Finals-RR-Tomas_Berdych-Novak_Djokovic,2,S-XC,6,0,0,0,0,4,2,,,,,,,,,,
20141114-M-Tour_Finals-RR-Tomas_Berdych-Novak_Djokovic,2,S-DTM,1,0,0,0,0,1,0,,,,,,,,,,
20141114-M-Tour_Finals-RR-Tomas_Berdych-Novak_Djokovic,2,S-DTL,1,1,0,1,0,1,0,,,,,,,,,,
20141117-M-Lima_CH-F-Jason_Kubler-Guido_Pella,1,F-XC,58,11,3,4,4,30,28,,,,,,,,,,
20141117-M-Lima_CH-F-Jason_Kubler-Guido_Pella,1,F-DTM,5,0,0,0,0,1,4,,,,,,,,,,
20141117-M-Lima_CH-F-Jason_Kubler-Guido_Pella,1,F-DTL,17,7,3,1,3,8,9,,,,,,,,,,
20141117-M-Lima_CH-F-Jason_Kubler-Guido_Pella,1,F-IO,19,9,2,2,5,9,10,,,,,,,,,,
20141117-M-Lima_CH-F-Jason_Kubler-Guido_Pella,1,F-II,6,4,1,0,3,2,4,,,,,,,,,,
20141117-M-Lima_CH-F-Jason_Kubler-Guido_Pella,1,B-XC,18,6,2,0,4,6,12,,,,,,,,,,
20141117-M-Lima_CH-F-Jason_Kubler-Guido_Pella,1,B-DTM,12,0,0,0,0,5,7,,,,,,,,,,
20141117-M-Lima_CH-F-Jason_Kubler-Guido_Pella,1,B-DTL,17,4,0,1,3,3,14,,,,,,,,,,
20141117-M-Lima_CH-F-Jason_Kubler-Guido_Pella,1,B-IO,11,1,0,1,0,6,5,,,,,,,,,,
20141117-M-Lima_CH-F-Jason_Kubler-Guido_Pella,1,S-XC,1,0,0,0,0,0,1,,,,,,,,,,
20141117-M-Lima_CH-F-Jason_Kubler-Guido_Pella,1,S-DTM,6,1,0,0,1,1,5,,,,,,,,,,
20141117-M-Lima_CH-F-Jason_Kubler-Guido_Pella,1,S-DTL,8,2,0,0,2,2,6,,,,,,,,,,
20141117-M-Lima_CH-F-Jason_Kubler-Guido_Pella,1,S-IO,1,0,0,0,0,1,0,,,,,,,,,,
20141117-M-Lima_CH-F-Jason_Kubler-Guido_Pella,2,F-XC,30,5,3,0,2,24,6,,,,,,,,,,
20141117-M-Lima_CH-F-Jason_Kubler-Guido_Pella,2,F-DTM,13,0,0,0,0,8,5,,,,,,,,,,
20141117-M-Lima_CH-F-Jason_Kubler-Guido_Pella,2,F-DTL,17,3,1,0,2,9,8,,,,,,,,,,
20141117-M-Lima_CH-F-Jason_Kubler-Guido_Pella,2,F-IO,19,4,2,1,1,15,4,,,,,,,,,,
20141117-M-Lima_CH-F-Jason_Kubler-Guido_Pella,2,F-II,10,4,1,1,2,6,4,,,,,,,,,,
20141117-M-Lima_CH-F-Jason_Kubler-Guido_Pella,2,B-XC,28,8,0,5,3,15,13,,,,,,,,,,
20141117-M-Lima_CH-F-Jason_Kubler-Guido_Pella,2,B-DTM,26,0,0,0,0,9,17,,,,,,,,,,
20141117-M-Lima_CH-F-Jason_Kubler-Guido_Pella,2,B-DTL,17,1,0,1,0,12,5,,,,,,,,,,
20141117-M-Lima_CH-F-Jason_Kubler-Guido_Pella,2,B-IO,5,2,0,1,1,3,2,,,,,,,,,,
20141117-M-Lima_CH-F-Jason_Kubler-Guido_Pella,2,B-II,2,2,0,0,2,0,2,,,,,,,,,,
20141117-M-Lima_CH-F-Jason_Kubler-Guido_Pella,2,S-XC,2,1,0,0,1,0,2,,,,,,,,,,
20141117-M-Lima_CH-F-Jason_Kubler-Guido_Pella,2,S-DTL,6,1,0,0,1,4,2,,,,,,,,,,
20141117-M-Lima_CH-F-Jason_Kubler-Guido_Pella,2,S-II,1,0,0,0,0,1,0,,,,,,,,,,
20141123-M-Davis_Cup_World_Group_F-RR-Richard_Gasquet-Roger_Federer,1,F-XC,24,8,4,0,4,11,13,,,,,,,,,,
20141123-M-Davis_Cup_World_Group_F-RR-Richard_Gasquet-Roger_Federer,1,F-DTM,31,1,0,0,1,13,18,,,,,,,,,,
20141123-M-Davis_Cup_World_Group_F-RR-Richard_Gasquet-Roger_Federer,1,F-IO,8,2,1,0,1,5,3,,,,,,,,,,
20141123-M-Davis_Cup_World_Group_F-RR-Richard_Gasquet-Roger_Federer,1,B-XC,82,4,2,1,1,49,33,,,,,,,,,,
20141123-M-Davis_Cup_World_Group_F-RR-Richard_Gasquet-Roger_Federer,1,B-DTM,35,4,1,0,3,16,19,,,,,,,,,,
20141123-M-Davis_Cup_World_Group_F-RR-Richard_Gasquet-Roger_Federer,1,B-DTL,7,5,2,0,3,4,3,,,,,,,,,,
20141123-M-Davis_Cup_World_Group_F-RR-Richard_Gasquet-Roger_Federer,1,B-IO,8,6,3,0,3,3,5,,,,,,,,,,
20141123-M-Davis_Cup_World_Group_F-RR-Richard_Gasquet-Roger_Federer,1,S-XC,5,0,0,0,0,2,3,,,,,,,,,,
20141123-M-Davis_Cup_World_Group_F-RR-Richard_Gasquet-Roger_Federer,1,S-DTM,3,0,0,0,0,1,2,,,,,,,,,,
20141123-M-Davis_Cup_World_Group_F-RR-Richard_Gasquet-Roger_Federer,1,S-DTL,1,0,0,0,0,1,0,,,,,,,,,,
20141123-M-Davis_Cup_World_Group_F-RR-Richard_Gasquet-Roger_Federer,2,F-XC,38,21,10,4,7,22,16,,,,,,,,,,
20141123-M-Davis_Cup_World_Group_F-RR-Richard_Gasquet-Roger_Federer,2,F-DTM,19,1,0,0,1,10,9,,,,,,,,,,
20141123-M-Davis_Cup_World_Group_F-RR-Richard_Gasquet-Roger_Federer,2,F-DTL,6,1,1,0,0,3,3,,,,,,,,,,
20141123-M-Davis_Cup_World_Group_F-RR-Richard_Gasquet-Roger_Federer,2,F-IO,31,10,3,3,4,15,16,,,,,,,,,,
20141123-M-Davis_Cup_World_Group_F-RR-Richard_Gasquet-Roger_Federer,2,F-II,5,3,3,0,0,5,0,,,,,,,,,,
20141123-M-Davis_Cup_World_Group_F-RR-Richard_Gasquet-Roger_Federer,2,B-XC,35,6,1,1,4,16,19,,,,,,,,,,
20141123-M-Davis_Cup_World_Group_F-RR-Richard_Gasquet-Roger_Federer,2,B-DTM,42,4,0,0,4,17,25,,,,,,,,,,
20141123-M-Davis_Cup_World_Group_F-RR-Richard_Gasquet-Roger_Federer,2,B-DTL,6,5,3,1,1,5,1,,,,,,,,,,
20141123-M-Davis_Cup_World_Group_F-RR-Richard_Gasquet-Roger_Federer,2,B-IO,4,1,0,0,1,1,3,,,,,,,,,,
20141123-M-Davis_Cup_World_Group_F-RR-Richard_Gasquet-Roger_Federer,2,S-XC,7,1,1,0,0,4,3,,,,,,,,,,
20141123-M-Davis_Cup_World_Group_F-RR-Richard_Gasquet-Roger_Federer,2,S-DTM,8,1,0,0,1,2,6,,,,,,,,,,
20141123-M-Davis_Cup_World_Group_F-RR-Richard_Gasquet-Roger_Federer,2,S-DTL,2,1,0,0,1,1,1,,,,,,,,,,
20150105-M-Doha-R32-Rafael_Nadal-Michael_Berrer,1,F-XC,41,9,4,2,3,26,15,,,,,,,,,,
20150105-M-Doha-R32-Rafael_Nadal-Michael_Berrer,1,F-DTM,43,6,1,1,4,22,21,,,,,,,,,,
20150105-M-Doha-R32-Rafael_Nadal-Michael_Berrer,1,F-DTL,20,11,6,0,5,9,11,,,,,,,,,,
20150105-M-Doha-R32-Rafael_Nadal-Michael_Berrer,1,F-IO,47,12,4,4,4,34,13,,,,,,,,,,
20150105-M-Doha-R32-Rafael_Nadal-Michael_Berrer,1,F-II,9,4,2,1,1,7,2,,,,,,,,,,
20150105-M-Doha-R32-Rafael_Nadal-Michael_Berrer,1,B-XC,13,2,1,1,0,8,5,,,,,,,,,,
20150105-M-Doha-R32-Rafael_Nadal-Michael_Berrer,1,B-DTM,37,5,0,0,5,17,20,,,,,,,,,,
20150105-M-Doha-R32-Rafael_Nadal-Michael_Berrer,1,B-DTL,8,2,0,0,2,3,5,,,,,,,,,,
20150105-M-Doha-R32-Rafael_Nadal-Michael_Berrer,1,B-IO,3,1,0,1,0,2,1,,,,,,,,,,
20150105-M-Doha-R32-Rafael_Nadal-Michael_Berrer,1,S-XC,3,1,0,0,1,2,1,,,,,,,,,,
20150105-M-Doha-R32-Rafael_Nadal-Michael_Berrer,1,S-DTM,1,0,0,0,0,0,1,,,,,,,,,,
20150105-M-Doha-R32-Rafael_Nadal-Michael_Berrer,1,S-IO,1,1,0,0,1,0,1,,,,,,,,,,
20150105-M-Doha-R32-Rafael_Nadal-Michael_Berrer,2,F-XC,43,17,4,2,11,20,23,,,,,,,,,,
20150105-M-Doha-R32-Rafael_Nadal-Michael_Berrer,2,F-DTM,43,4,0,1,3,20,23,,,,,,,,,,
20150105-M-Doha-R32-Rafael_Nadal-Michael_Berrer,2,F-DTL,2,2,0,1,1,1,1,,,,,,,,,,
20150105-M-Doha-R32-Rafael_Nadal-Michael_Berrer,2,F-IO,25,6,4,0,2,16,9,,,,,,,,,,
20150105-M-Doha-R32-Rafael_Nadal-Michael_Berrer,2,F-II,1,1,1,0,0,1,0,,,,,,,,,,
20150105-M-Doha-R32-Rafael_Nadal-Michael_Berrer,2,B-XC,19,1,0,0,1,7,12,,,,,,,,,,
20150105-M-Doha-R32-Rafael_Nadal-Michael_Berrer,2,B-DTM,31,3,0,1,2,15,16,,,,,,,,,,
20150105-M-Doha-R32-Rafael_Nadal-Michael_Berrer,2,B-DTL,3,1,0,0,1,0,3,,,,,,,,,,
20150105-M-Doha-R32-Rafael_Nadal-Michael_Berrer,2,S-XC,13,1,0,0,1,3,10,,,,,,,,,,
20150105-M-Doha-R32-Rafael_Nadal-Michael_Berrer,2,S-DTM,19,3,0,0,3,5,14,,,,,,,,,,
20150105-M-Doha-R32-Rafael_Nadal-Michael_Berrer,2,S-DTL,2,0,0,0,0,1,1,,,,,,,,,,
20150105-M-Doha-R32-Rafael_Nadal-Michael_Berrer,2,S-IO,2,0,0,0,0,1,1,,,,,,,,,,
20150106-M-Doha-R16-Tomas_Berdych-Blaz_Kavcic,1,F-XC,33,9,3,3,3,19,14,,,,,,,,,,
20150106-M-Doha-R16-Tomas_Berdych-Blaz_Kavcic,1,F-DTM,19,1,0,0,1,11,8,,,,,,,,,,
20150106-M-Doha-R16-Tomas_Berdych-Blaz_Kavcic,1,F-DTL,2,0,0,0,0,1,1,,,,,,,,,,
20150106-M-Doha-R16-Tomas_Berdych-Blaz_Kavcic,1,F-IO,17,6,2,1,3,7,10,,,,,,,,,,
20150106-M-Doha-R16-Tomas_Berdych-Blaz_Kavcic,1,B-XC,21,4,1,2,1,12,9,,,,,,,,,,
20150106-M-Doha-R16-Tomas_Berdych-Blaz_Kavcic,1,B-DTM,21,2,0,0,2,11,10,,,,,,,,,,
20150106-M-Doha-R16-Tomas_Berdych-Blaz_Kavcic,1,B-DTL,2,2,2,0,0,2,0,,,,,,,,,,
20150106-M-Doha-R16-Tomas_Berdych-Blaz_Kavcic,1,B-IO,5,2,1,0,1,2,3,,,,,,,,,,
20150106-M-Doha-R16-Tomas_Berdych-Blaz_Kavcic,1,S-XC,4,0,0,0,0,2,2,,,,,,,,,,
20150106-M-Doha-R16-Tomas_Berdych-Blaz_Kavcic,1,S-DTM,4,0,0,0,0,1,3,,,,,,,,,,
20150106-M-Doha-R16-Tomas_Berdych-Blaz_Kavcic,2,F-XC,19,4,2,1,1,8,11,,,,,,,,,,
20150106-M-Doha-R16-Tomas_Berdych-Blaz_Kavcic,2,F-DTM,33,0,0,0,0,15,18,,,,,,,,,,
20150106-M-Doha-R16-Tomas_Berdych-Blaz_Kavcic,2,F-DTL,4,1,1,0,0,3,1,,,,,,,,,,
20150106-M-Doha-R16-Tomas_Berdych-Blaz_Kavcic,2,F-IO,10,5,0,1,4,2,8,,,,,,,,,,
20150106-M-Doha-R16-Tomas_Berdych-Blaz_Kavcic,2,B-XC,12,1,0,0,1,5,7,,,,,,,,,,
20150106-M-Doha-R16-Tomas_Berdych-Blaz_Kavcic,2,B-DTM,24,3,0,1,2,14,10,,,,,,,,,,
20150106-M-Doha-R16-Tomas_Berdych-Blaz_Kavcic,2,B-DTL,2,0,0,0,0,1,1,,,,,,,,,,
20150106-M-Doha-R16-Tomas_Berdych-Blaz_Kavcic,2,B-IO,4,1,0,1,0,2,2,,,,,,,,,,
20150106-M-Doha-R16-Tomas_Berdych-Blaz_Kavcic,2,S-XC,1,0,0,0,0,0,1,,,,,,,,,,
20150106-M-Doha-R16-Tomas_Berdych-Blaz_Kavcic,2,S-DTM,10,0,0,0,0,7,3,,,,,,,,,,
20150106-M-Doha-R32-Novak_Djokovic-Dusan_Lajovic,1,F-XC,23,8,4,3,1,12,11,,,,,,,,,,
20150106-M-Doha-R32-Novak_Djokovic-Dusan_Lajovic,1,F-DTM,27,0,0,0,0,18,9,,,,,,,,,,
20150106-M-Doha-R32-Novak_Djokovic-Dusan_Lajovic,1,F-DTL,8,2,0,2,0,5,3,,,,,,,,,,
20150106-M-Doha-R32-Novak_Djokovic-Dusan_Lajovic,1,F-IO,24,9,4,2,3,19,5,,,,,,,,,,
20150106-M-Doha-R32-Novak_Djokovic-Dusan_Lajovic,1,F-II,2,1,0,0,1,1,1,,,,,,,,,,
20150106-M-Doha-R32-Novak_Djokovic-Dusan_Lajovic,1,B-XC,14,2,0,0,2,9,5,,,,,,,,,,
20150106-M-Doha-R32-Novak_Djokovic-Dusan_Lajovic,1,B-DTM,15,0,0,0,0,9,6,,,,,,,,,,
20150106-M-Doha-R32-Novak_Djokovic-Dusan_Lajovic,1,B-DTL,1,0,0,0,0,1,0,,,,,,,,,,
20150106-M-Doha-R32-Novak_Djokovic-Dusan_Lajovic,1,B-IO,8,4,0,0,4,4,4,,,,,,,,,,
20150106-M-Doha-R32-Novak_Djokovic-Dusan_Lajovic,1,S-DTM,1,0,0,0,0,1,0,,,,,,,,,,
20150106-M-Doha-R32-Novak_Djokovic-Dusan_Lajovic,1,S-DTL,1,0,0,0,0,0,1,,,,,,,,,,
20150106-M-Doha-R32-Novak_Djokovic-Dusan_Lajovic,2,F-XC,27,7,4,0,3,15,12,,,,,,,,,,
20150106-M-Doha-R32-Novak_Djokovic-Dusan_Lajovic,2,F-DTM,25,1,0,0,1,5,20,,,,,,,,,,
20150106-M-Doha-R32-Novak_Djokovic-Dusan_Lajovic,2,F-DTL,1,0,0,0,0,0,1,,,,,,,,,,
20150106-M-Doha-R32-Novak_Djokovic-Dusan_Lajovic,2,F-IO,5,0,0,0,0,2,3,,,,,,,,,,
20150106-M-Doha-R32-Novak_Djokovic-Dusan_Lajovic,2,F-II,1,0,0,0,0,1,0,,,,,,,,,,
20150106-M-Doha-R32-Novak_Djokovic-Dusan_Lajovic,2,B-XC,12,1,0,0,1,4,8,,,,,,,,,,
20150106-M-Doha-R32-Novak_Djokovic-Dusan_Lajovic,2,B-DTM,26,1,0,0,1,10,16,,,,,,,,,,
20150106-M-Doha-R32-Novak_Djokovic-Dusan_Lajovic,2,B-DTL,1,1,0,0,1,0,1,,,,,,,,,,
20150106-M-Doha-R32-Novak_Djokovic-Dusan_Lajovic,2,B-IO,5,2,1,0,1,2,3,,,,,,,,,,
20150106-M-Doha-R32-Novak_Djokovic-Dusan_Lajovic,2,S-XC,1,0,0,0,0,0,1,,,,,,,,,,
20150106-M-Doha-R32-Novak_Djokovic-Dusan_Lajovic,2,S-DTM,11,0,0,0,0,3,8,,,,,,,,,,
20150106-M-Doha-R32-Novak_Djokovic-Dusan_Lajovic,2,S-IO,1,0,0,0,0,0,1,,,,,,,,,,
20150109-M-Brisbane-QF-Bernard_Tomic-Kei_Nishikori,1,F-XC,21,12,3,3,6,11,10,,,,,,,,,,
20150109-M-Brisbane-QF-Bernard_Tomic-Kei_Nishikori,1,F-DTM,5,1,0,0,1,0,5,,,,,,,,,,
20150109-M-Brisbane-QF-Bernard_Tomic-Kei_Nishikori,1,F-DTL,2,0,0,0,0,2,0,,,,,,,,,,
20150109-M-Brisbane-QF-Bernard_Tomic-Kei_Nishikori,1,F-IO,15,4,2,1,1,7,8,,,,,,,,,,
20150109-M-Brisbane-QF-Bernard_Tomic-Kei_Nishikori,1,F-II,1,1,1,0,0,1,0,,,,,,,,,,
20150109-M-Brisbane-QF-Bernard_Tomic-Kei_Nishikori,1,B-XC,17,3,0,0,3,4,13,,,,,,,,,,
20150109-M-Brisbane-QF-Bernard_Tomic-Kei_Nishikori,1,B-DTM,12,2,0,0,2,3,9,,,,,,,,,,
20150109-M-Brisbane-QF-Bernard_Tomic-Kei_Nishikori,1,B-DTL,3,3,0,0,3,0,3,,,,,,,,,,
20150109-M-Brisbane-QF-Bernard_Tomic-Kei_Nishikori,1,B-IO,1,0,0,0,0,1,0,,,,,,,,,,
20150109-M-Brisbane-QF-Bernard_Tomic-Kei_Nishikori,1,S-XC,16,1,0,0,1,5,11,,,,,,,,,,
20150109-M-Brisbane-QF-Bernard_Tomic-Kei_Nishikori,1,S-DTM,12,2,0,0,2,2,10,,,,,,,,,,
20150109-M-Brisbane-QF-Bernard_Tomic-Kei_Nishikori,1,S-DTL,1,0,0,0,0,1,0,,,,,,,,,,
20150109-M-Brisbane-QF-Bernard_Tomic-Kei_Nishikori,2,F-XC,13,4,3,0,1,8,5,,,,,,,,,,
20150109-M-Brisbane-QF-Bernard_Tomic-Kei_Nishikori,2,F-DTM,3,1,0,0,1,1,2,,,,,,,,,,
20150109-M-Brisbane-QF-Bernard_Tomic-Kei_Nishikori,2,F-DTL,7,3,2,0,1,5,2,,,,,,,,,,
20150109-M-Brisbane-QF-Bernard_Tomic-Kei_Nishikori,2,F-IO,13,4,3,0,1,11,2,,,,,,,,,,
20150109-M-Brisbane-QF-Bernard_Tomic-Kei_Nishikori,2,F-II,3,2,0,1,1,1,2,,,,,,,,,,
20150109-M-Brisbane-QF-Bernard_Tomic-Kei_Nishikori,2,B-XC,35,7,3,1,3,24,11,,,,,,,,,,
20150109-M-Brisbane-QF-Bernard_Tomic-Kei_Nishikori,2,B-DTM,9,2,0,0,2,5,4,,,,,,,,,,
20150109-M-Brisbane-QF-Bernard_Tomic-Kei_Nishikori,2,B-DTL,4,3,2,1,0,4,0,,,,,,,,,,
20150109-M-Brisbane-QF-Bernard_Tomic-Kei_Nishikori,2,B-IO,1,0,0,0,0,1,0,,,,,,,,,,
20150109-M-Brisbane-QF-Bernard_Tomic-Kei_Nishikori,2,S-XC,1,0,0,0,0,0,1,,,,,,,,,,
20150109-M-Brisbane-QF-Bernard_Tomic-Kei_Nishikori,2,S-DTM,3,0,0,0,0,2,1,,,,,,,,,,
20150125-M-Australian_Open-R16-Bernard_Tomic-Tomas_Berdych,1,F-XC,60,15,5,3,7,28,32,,,,,,,,,,
20150125-M-Australian_Open-R16-Bernard_Tomic-Tomas_Berdych,1,F-DTM,46,6,1,0,5,16,30,,,,,,,,,,
20150125-M-Australian_Open-R16-Bernard_Tomic-Tomas_Berdych,1,F-DTL,24,9,2,2,5,10,14,,,,,,,,,,
20150125-M-Australian_Open-R16-Bernard_Tomic-Tomas_Berdych,1,F-IO,23,5,2,2,1,13,10,,,,,,,,,,
20150125-M-Australian_Open-R16-Bernard_Tomic-Tomas_Berdych,1,F-II,2,0,0,0,0,1,1,,,,,,,,,,
20150125-M-Australian_Open-R16-Bernard_Tomic-Tomas_Berdych,1,B-XC,29,3,2,1,0,14,15,,,,,,,,,,
20150125-M-Australian_Open-R16-Bernard_Tomic-Tomas_Berdych,1,B-DTM,27,4,0,0,4,9,18,,,,,,,,,,
20150125-M-Australian_Open-R16-Bernard_Tomic-Tomas_Berdych,1,B-DTL,11,4,1,0,3,7,4,,,,,,,,,,
20150125-M-Australian_Open-R16-Bernard_Tomic-Tomas_Berdych,1,B-IO,11,1,0,1,0,7,4,,,,,,,,,,
20150125-M-Australian_Open-R16-Bernard_Tomic-Tomas_Berdych,1,S-XC,13,0,0,0,0,6,7,,,,,,,,,,
20150125-M-Australian_Open-R16-Bernard_Tomic-Tomas_Berdych,1,S-DTM,20,1,0,0,1,7,13,,,,,,,,,,
20150125-M-Australian_Open-R16-Bernard_Tomic-Tomas_Berdych,1,S-DTL,8,1,1,0,0,4,4,,,,,,,,,,
20150125-M-Australian_Open-R16-Bernard_Tomic-Tomas_Berdych,1,S-IO,2,0,0,0,0,2,0,,,,,,,,,,
20150125-M-Australian_Open-R16-Bernard_Tomic-Tomas_Berdych,1,S-II,1,0,0,0,0,0,1,,,,,,,,,,
20150125-M-Australian_Open-R16-Bernard_Tomic-Tomas_Berdych,2,F-XC,74,18,8,2,8,44,30,,,,,,,,,,
20150125-M-Australian_Open-R16-Bernard_Tomic-Tomas_Berdych,2,F-DTM,29,5,0,0,5,8,21,,,,,,,,,,
20150125-M-Australian_Open-R16-Bernard_Tomic-Tomas_Berdych,2,F-DTL,16,2,0,1,1,11,5,,,,,,,,,,
20150125-M-Australian_Open-R16-Bernard_Tomic-Tomas_Berdych,2,F-IO,37,16,11,2,3,26,11,,,,,,,,,,
20150125-M-Australian_Open-R16-Bernard_Tomic-Tomas_Berdych,2,F-II,4,2,1,0,1,3,1,,,,,,,,,,
20150125-M-Australian_Open-R16-Bernard_Tomic-Tomas_Berdych,2,B-XC,39,6,3,0,3,21,18,,,,,,,,,,
20150125-M-Australian_Open-R16-Bernard_Tomic-Tomas_Berdych,2,B-DTM,20,2,0,0,2,11,9,,,,,,,,,,
20150125-M-Australian_Open-R16-Bernard_Tomic-Tomas_Berdych,2,B-DTL,13,2,1,0,1,9,4,,,,,,,,,,
20150125-M-Australian_Open-R16-Bernard_Tomic-Tomas_Berdych,2,B-IO,6,1,0,0,1,4,2,,,,,,,,,,
20150125-M-Australian_Open-R16-Bernard_Tomic-Tomas_Berdych,2,S-XC,9,0,0,0,0,4,5,,,,,,,,,,
20150125-M-Australian_Open-R16-Bernard_Tomic-Tomas_Berdych,2,S-DTM,7,0,0,0,0,3,4,,,,,,,,,,
20150125-M-Australian_Open-R16-Bernard_Tomic-Tomas_Berdych,2,S-DTL,5,1,0,0,1,4,1,,,,,,,,,,
20150127-M-Australian_Open-QF-Tomas_Berdych-Rafael_Nadal,1,F-XC,41,20,13,4,3,27,14,,,,,,,,,,
20150127-M-Australian_Open-QF-Tomas_Berdych-Rafael_Nadal,1,F-DTM,20,1,0,0,1,7,13,,,,,,,,,,
20150127-M-Australian_Open-QF-Tomas_Berdych-Rafael_Nadal,1,F-DTL,37,4,1,1,2,20,17,,,,,,,,,,
20150127-M-Australian_Open-QF-Tomas_Berdych-Rafael_Nadal,1,F-IO,40,12,4,2,6,21,19,,,,,,,,,,
20150127-M-Australian_Open-QF-Tomas_Berdych-Rafael_Nadal,1,F-II,9,4,4,0,0,4,5,,,,,,,,,,
20150127-M-Australian_Open-QF-Tomas_Berdych-Rafael_Nadal,1,B-XC,10,0,0,0,0,6,4,,,,,,,,,,
20150127-M-Australian_Open-QF-Tomas_Berdych-Rafael_Nadal,1,B-DTM,23,3,0,0,3,9,14,,,,,,,,,,
20150127-M-Australian_Open-QF-Tomas_Berdych-Rafael_Nadal,1,B-DTL,34,6,1,2,3,20,14,,,,,,,,,,
20150127-M-Australian_Open-QF-Tomas_Berdych-Rafael_Nadal,1,B-IO,9,3,2,1,0,6,3,,,,,,,,,,
20150127-M-Australian_Open-QF-Tomas_Berdych-Rafael_Nadal,1,S-DTM,3,0,0,0,0,1,2,,,,,,,,,,
20150127-M-Australian_Open-QF-Tomas_Berdych-Rafael_Nadal,1,S-IO,1,0,0,0,0,1,0,,,,,,,,,,
20150127-M-Australian_Open-QF-Tomas_Berdych-Rafael_Nadal,2,F-XC,25,5,3,2,0,16,9,,,,,,,,,,
20150127-M-Australian_Open-QF-Tomas_Berdych-Rafael_Nadal,2,F-DTM,23,3,0,0,3,9,14,,,,,,,,,,
20150127-M-Australian_Open-QF-Tomas_Berdych-Rafael_Nadal,2,F-DTL,2,1,1,0,0,2,0,,,,,,,,,,
20150127-M-Australian_Open-QF-Tomas_Berdych-Rafael_Nadal,2,F-IO,51,20,6,8,6,31,20,,,,,,,,,,
20150127-M-Australian_Open-QF-Tomas_Berdych-Rafael_Nadal,2,F-II,24,2,1,0,1,11,13,,,,,,,,,,
20150127-M-Australian_Open-QF-Tomas_Berdych-Rafael_Nadal,2,B-XC,5,2,0,0,2,3,2,,,,,,,,,,
20150127-M-Australian_Open-QF-Tomas_Berdych-Rafael_Nadal,2,B-DTM,21,2,0,1,1,8,13,,,,,,,,,,
20150127-M-Australian_Open-QF-Tomas_Berdych-Rafael_Nadal,2,B-DTL,1,0,0,0,0,0,1,,,,,,,,,,
20150127-M-Australian_Open-QF-Tomas_Berdych-Rafael_Nadal,2,B-IO,15,5,1,2,2,9,6,,,,,,,,,,
20150127-M-Australian_Open-QF-Tomas_Berdych-Rafael_Nadal,2,B-II,26,5,0,2,3,12,14,,,,,,,,,,
20150127-M-Australian_Open-QF-Tomas_Berdych-Rafael_Nadal,2,S-DTM,11,0,0,0,0,1,10,,,,,,,,,,
20150127-M-Australian_Open-QF-Tomas_Berdych-Rafael_Nadal,2,S-IO,11,0,0,0,0,4,7,,,,,,,,,,
20150127-M-Australian_Open-QF-Tomas_Berdych-Rafael_Nadal,2,S-II,2,0,0,0,0,2,0,,,,,,,,,,
20150201-M-Australian_Open-F-Novak_Djokovic-Andy_Murray,1,F-XC,95,12,5,4,3,53,42,,,,,,,,,,
20150201-M-Australian_Open-F-Novak_Djokovic-Andy_Murray,1,F-DTM,84,6,0,0,6,40,44,,,,,,,,,,
20150201-M-Australian_Open-F-Novak_Djokovic-Andy_Murray,1,F-DTL,36,11,4,3,4,19,17,,,,,,,,,,
20150201-M-Australian_Open-F-Novak_Djokovic-Andy_Murray,1,F-IO,78,19,7,3,9,45,33,,,,,,,,,,
20150201-M-Australian_Open-F-Novak_Djokovic-Andy_Murray,1,F-II,4,1,0,0,1,1,3,,,,,,,,,,
20150201-M-Australian_Open-F-Novak_Djokovic-Andy_Murray,1,B-XC,115,10,3,3,4,54,61,,,,,,,,,,
20150201-M-Australian_Open-F-Novak_Djokovic-Andy_Murray,1,B-DTM,109,4,0,0,4,54,55,,,,,,,,,,
20150201-M-Australian_Open-F-Novak_Djokovic-Andy_Murray,1,B-DTL,27,4,1,1,2,9,18,,,,,,,,,,
20150201-M-Australian_Open-F-Novak_Djokovic-Andy_Murray,1,B-IO,26,7,4,0,3,11,15,,,,,,,,,,
20150201-M-Australian_Open-F-Novak_Djokovic-Andy_Murray,1,S-XC,29,0,0,0,0,11,18,,,,,,,,,,
20150201-M-Australian_Open-F-Novak_Djokovic-Andy_Murray,1,S-DTM,26,0,0,0,0,5,21,,,,,,,,,,
20150201-M-Australian_Open-F-Novak_Djokovic-Andy_Murray,1,S-DTL,2,0,0,0,0,1,1,,,,,,,,,,
20150201-M-Australian_Open-F-Novak_Djokovic-Andy_Murray,1,S-IO,3,0,0,0,0,2,1,,,,,,,,,,
20150201-M-Australian_Open-F-Novak_Djokovic-Andy_Murray,2,F-XC,106,18,4,2,12,54,52,,,,,,,,,,
20150201-M-Australian_Open-F-Novak_Djokovic-Andy_Murray,2,F-DTM,73,4,0,0,4,34,39,,,,,,,,,,
20150201-M-Australian_Open-F-Novak_Djokovic-Andy_Murray,2,F-DTL,40,4,1,2,1,27,13,,,,,,,,,,
20150201-M-Australian_Open-F-Novak_Djokovic-Andy_Murray,2,F-IO,89,21,5,4,12,49,40,,,,,,,,,,
20150201-M-Australian_Open-F-Novak_Djokovic-Andy_Murray,2,B-XC,116,10,1,4,5,60,56,,,,,,,,,,
20150201-M-Australian_Open-F-Novak_Djokovic-Andy_Murray,2,B-DTM,87,2,0,0,2,41,46,,,,,,,,,,
20150201-M-Australian_Open-F-Novak_Djokovic-Andy_Murray,2,B-DTL,31,14,6,2,6,14,17,,,,,,,,,,
20150201-M-Australian_Open-F-Novak_Djokovic-Andy_Murray,2,B-IO,28,5,1,1,3,14,14,,,,,,,,,,
20150201-M-Australian_Open-F-Novak_Djokovic-Andy_Murray,2,S-XC,30,0,0,0,0,17,13,,,,,,,,,,
20150201-M-Australian_Open-F-Novak_Djokovic-Andy_Murray,2,S-DTM,27,0,0,0,0,14,13,,,,,,,,,,
20150201-M-Australian_Open-F-Novak_Djokovic-Andy_Murray,2,S-DTL,1,0,0,0,0,0,1,,,,,,,,,,
20150201-M-Australian_Open-F-Novak_Djokovic-Andy_Murray,2,S-IO,2,0,0,0,0,1,1,,,,,,,,,,
20150205-M-Zagreb-R16-Ivan_Dodig-Marcel_Granollers,1,F-XC,55,18,6,6,6,32,23,,,,,,,,,,
20150205-M-Zagreb-R16-Ivan_Dodig-Marcel_Granollers,1,F-DTM,17,2,0,0,2,8,9,,,,,,,,,,
20150205-M-Zagreb-R16-Ivan_Dodig-Marcel_Granollers,1,F-DTL,20,5,0,2,3,9,11,,,,,,,,,,
20150205-M-Zagreb-R16-Ivan_Dodig-Marcel_Granollers,1,F-IO,43,8,2,0,6,14,29,,,,,,,,,,
20150205-M-Zagreb-R16-Ivan_Dodig-Marcel_Granollers,1,F-II,5,1,0,0,1,2,3,,,,,,,,,,
20150205-M-Zagreb-R16-Ivan_Dodig-Marcel_Granollers,1,B-XC,40,9,1,1,7,16,24,,,,,,,,,,
20150205-M-Zagreb-R16-Ivan_Dodig-Marcel_Granollers,1,B-DTM,29,3,0,0,3,15,14,,,,,,,,,,
20150205-M-Zagreb-R16-Ivan_Dodig-Marcel_Granollers,1,B-DTL,10,7,2,0,5,3,7,,,,,,,,,,
20150205-M-Zagreb-R16-Ivan_Dodig-Marcel_Granollers,1,B-IO,2,0,0,0,0,1,1,,,,,,,,,,
20150205-M-Zagreb-R16-Ivan_Dodig-Marcel_Granollers,1,S-XC,13,0,0,0,0,4,9,,,,,,,,,,
20150205-M-Zagreb-R16-Ivan_Dodig-Marcel_Granollers,1,S-DTM,9,0,0,0,0,3,6,,,,,,,,,,
20150205-M-Zagreb-R16-Ivan_Dodig-Marcel_Granollers,1,S-DTL,4,1,0,0,1,2,2,,,,,,,,,,
20150205-M-Zagreb-R16-Ivan_Dodig-Marcel_Granollers,2,F-XC,47,9,2,4,3,27,20,,,,,,,,,,
20150205-M-Zagreb-R16-Ivan_Dodig-Marcel_Granollers,2,F-DTM,25,2,0,0,2,11,14,,,,,,,,,,
20150205-M-Zagreb-R16-Ivan_Dodig-Marcel_Granollers,2,F-DTL,9,1,1,0,0,7,2,,,,,,,,,,
20150205-M-Zagreb-R16-Ivan_Dodig-Marcel_Granollers,2,F-IO,17,2,0,1,1,11,6,,,,,,,,,,
20150205-M-Zagreb-R16-Ivan_Dodig-Marcel_Granollers,2,F-II,1,0,0,0,0,1,0,,,,,,,,,,
20150205-M-Zagreb-R16-Ivan_Dodig-Marcel_Granollers,2,B-XC,55,8,2,2,4,29,26,,,,,,,,,,
20150205-M-Zagreb-R16-Ivan_Dodig-Marcel_Granollers,2,B-DTM,47,3,0,0,3,25,22,,,,,,,,,,
20150205-M-Zagreb-R16-Ivan_Dodig-Marcel_Granollers,2,B-DTL,5,2,2,0,0,3,2,,,,,,,,,,
20150205-M-Zagreb-R16-Ivan_Dodig-Marcel_Granollers,2,B-IO,1,1,0,0,1,0,1,,,,,,,,,,
20150205-M-Zagreb-R16-Ivan_Dodig-Marcel_Granollers,2,S-XC,17,1,0,0,1,9,8,,,,,,,,,,
20150205-M-Zagreb-R16-Ivan_Dodig-Marcel_Granollers,2,S-DTM,17,0,0,0,0,9,8,,,,,,,,,,
20150205-M-Zagreb-R16-Ivan_Dodig-Marcel_Granollers,2,S-DTL,7,3,1,1,1,3,4,,,,,,,,,,
20150205-M-Zagreb-R16-Ivan_Dodig-Marcel_Granollers,2,S-IO,2,0,0,0,0,1,1,,,,,,,,,,
20150206-M-Montpellier-QF-Joao_Sousa-Philipp_Kohlschreiber,1,F-XC,24,7,3,3,1,14,10,,,,,,,,,,
20150206-M-Montpellier-QF-Joao_Sousa-Philipp_Kohlschreiber,1,F-DTM,17,1,0,0,1,8,9,,,,,,,,,,
20150206-M-Montpellier-QF-Joao_Sousa-Philipp_Kohlschreiber,1,F-DTL,22,4,1,3,0,12,10,,,,,,,,,,
20150206-M-Montpellier-QF-Joao_Sousa-Philipp_Kohlschreiber,1,F-IO,34,14,5,6,3,21,13,,,,,,,,,,
20150206-M-Montpellier-QF-Joao_Sousa-Philipp_Kohlschreiber,1,F-II,14,6,4,1,1,9,5,,,,,,,,,,
20150206-M-Montpellier-QF-Joao_Sousa-Philipp_Kohlschreiber,1,B-XC,27,5,2,2,1,13,14,,,,,,,,,,
20150206-M-Montpellier-QF-Joao_Sousa-Philipp_Kohlschreiber,1,B-DTM,23,2,0,0,2,6,17,,,,,,,,,,
20150206-M-Montpellier-QF-Joao_Sousa-Philipp_Kohlschreiber,1,B-DTL,4,1,0,0,1,2,2,,,,,,,,,,
20150206-M-Montpellier-QF-Joao_Sousa-Philipp_Kohlschreiber,1,B-IO,5,0,0,0,0,2,3,,,,,,,,,,
20150206-M-Montpellier-QF-Joao_Sousa-Philipp_Kohlschreiber,1,S-XC,5,0,0,0,0,2,3,,,,,,,,,,
20150206-M-Montpellier-QF-Joao_Sousa-Philipp_Kohlschreiber,1,S-DTM,4,0,0,0,0,1,3,,,,,,,,,,
20150206-M-Montpellier-QF-Joao_Sousa-Philipp_Kohlschreiber,1,S-DTL,4,0,0,0,0,1,3,,,,,,,,,,
20150206-M-Montpellier-QF-Joao_Sousa-Philipp_Kohlschreiber,1,S-IO,1,0,0,0,0,0,1,,,,,,,,,,
20150206-M-Montpellier-QF-Joao_Sousa-Philipp_Kohlschreiber,2,F-XC,37,7,3,2,2,18,19,,,,,,,,,,
20150206-M-Montpellier-QF-Joao_Sousa-Philipp_Kohlschreiber,2,F-DTM,16,1,0,0,1,8,8,,,,,,,,,,
20150206-M-Montpellier-QF-Joao_Sousa-Philipp_Kohlschreiber,2,F-DTL,14,4,2,1,1,8,6,,,,,,,,,,
20150206-M-Montpellier-QF-Joao_Sousa-Philipp_Kohlschreiber,2,F-IO,30,9,3,3,3,22,8,,,,,,,,,,
20150206-M-Montpellier-QF-Joao_Sousa-Philipp_Kohlschreiber,2,F-II,4,1,0,0,1,3,1,,,,,,,,,,
20150206-M-Montpellier-QF-Joao_Sousa-Philipp_Kohlschreiber,2,B-XC,45,10,2,2,6,24,21,,,,,,,,,,
20150206-M-Montpellier-QF-Joao_Sousa-Philipp_Kohlschreiber,2,B-DTM,7,1,0,0,1,3,4,,,,,,,,,,
20150206-M-Montpellier-QF-Joao_Sousa-Philipp_Kohlschreiber,2,B-DTL,10,4,3,1,0,9,1,,,,,,,,,,
20150206-M-Montpellier-QF-Joao_Sousa-Philipp_Kohlschreiber,2,B-IO,3,3,1,0,2,1,2,,,,,,,,,,
20150206-M-Montpellier-QF-Joao_Sousa-Philipp_Kohlschreiber,2,S-XC,10,0,0,0,0,2,8,,,,,,,,,,
20150206-M-Montpellier-QF-Joao_Sousa-Philipp_Kohlschreiber,2,S-DTM,1,0,0,0,0,0,1,,,,,,,,,,
20150206-M-Montpellier-QF-Joao_Sousa-Philipp_Kohlschreiber,2,S-DTL,3,1,0,1,0,1,2,,,,,,,,,,
20150209-M-Rotterdam-R32-Grigor_Dimitrov-Paul_Henri_Mathieu,1,F-XC,8,7,5,0,2,5,3,,,,,,,,,,
20150209-M-Rotterdam-R32-Grigor_Dimitrov-Paul_Henri_Mathieu,1,F-DTM,4,0,0,0,0,1,3,,,,,,,,,,
20150209-M-Rotterdam-R32-Grigor_Dimitrov-Paul_Henri_Mathieu,1,F-DTL,2,1,1,0,0,1,1,,,,,,,,,,
20150209-M-Rotterdam-R32-Grigor_Dimitrov-Paul_Henri_Mathieu,1,F-IO,1,1,1,0,0,1,0,,,,,,,,,,
20150209-M-Rotterdam-R32-Grigor_Dimitrov-Paul_Henri_Mathieu,1,B-XC,2,1,0,0,1,0,2,,,,,,,,,,
20150209-M-Rotterdam-R32-Grigor_Dimitrov-Paul_Henri_Mathieu,1,B-DTM,1,0,0,0,0,1,0,,,,,,,,,,
20150209-M-Rotterdam-R32-Grigor_Dimitrov-Paul_Henri_Mathieu,1,B-DTL,2,2,2,0,0,2,0,,,,,,,,,,
20150209-M-Rotterdam-R32-Grigor_Dimitrov-Paul_Henri_Mathieu,1,S-XC,1,0,0,0,0,0,1,,,,,,,,,,
20150209-M-Rotterdam-R32-Grigor_Dimitrov-Paul_Henri_Mathieu,2,F-XC,5,2,2,0,0,4,1,,,,,,,,,,
20150209-M-Rotterdam-R32-Grigor_Dimitrov-Paul_Henri_Mathieu,2,F-DTM,1,0,0,0,0,1,0,,,,,,,,,,
20150209-M-Rotterdam-R32-Grigor_Dimitrov-Paul_Henri_Mathieu,2,F-DTL,3,2,0,0,2,1,2,,,,,,,,,,
20150209-M-Rotterdam-R32-Grigor_Dimitrov-Paul_Henri_Mathieu,2,F-IO,4,2,2,0,0,3,1,,,,,,,,,,
20150209-M-Rotterdam-R32-Grigor_Dimitrov-Paul_Henri_Mathieu,2,F-II,2,2,1,0,1,1,1,,,,,,,,,,
20150209-M-Rotterdam-R32-Grigor_Dimitrov-Paul_Henri_Mathieu,2,B-DTM,4,1,1,0,0,1,3,,,,,,,,,,
20150209-M-Rotterdam-R32-Grigor_Dimitrov-Paul_Henri_Mathieu,2,B-DTL,4,4,4,0,0,4,0,,,,,,,,,,
20150209-M-Rotterdam-R32-Grigor_Dimitrov-Paul_Henri_Mathieu,2,B-IO,1,1,0,1,0,1,0,,,,,,,,,,
20150209-M-Rotterdam-R32-Grigor_Dimitrov-Paul_Henri_Mathieu,2,S-DTL,1,0,0,0,0,0,1,,,,,,,,,,
20150210-M-Rotterdam-R32-Andrey_Kuznetsov-Milos_Raonic,1,F-XC,35,16,8,3,5,20,15,,,,,,,,,,
20150210-M-Rotterdam-R32-Andrey_Kuznetsov-Milos_Raonic,1,F-DTM,17,7,0,0,7,3,14,,,,,,,,,,
20150210-M-Rotterdam-R32-Andrey_Kuznetsov-Milos_Raonic,1,F-DTL,6,2,1,0,1,2,4,,,,,,,,,,
20150210-M-Rotterdam-R32-Andrey_Kuznetsov-Milos_Raonic,1,F-IO,16,2,1,1,0,7,9,,,,,,,,,,
20150210-M-Rotterdam-R32-Andrey_Kuznetsov-Milos_Raonic,1,F-II,2,0,0,0,0,2,0,,,,,,,,,,
20150210-M-Rotterdam-R32-Andrey_Kuznetsov-Milos_Raonic,1,B-XC,22,4,0,2,2,9,13,,,,,,,,,,
20150210-M-Rotterdam-R32-Andrey_Kuznetsov-Milos_Raonic,1,B-DTM,9,3,0,2,1,4,5,,,,,,,,,,
20150210-M-Rotterdam-R32-Andrey_Kuznetsov-Milos_Raonic,1,B-DTL,8,7,4,0,3,4,4,,,,,,,,,,
20150210-M-Rotterdam-R32-Andrey_Kuznetsov-Milos_Raonic,1,B-IO,2,2,2,0,0,2,0,,,,,,,,,,
20150210-M-Rotterdam-R32-Andrey_Kuznetsov-Milos_Raonic,1,S-XC,1,0,0,0,0,1,0,,,,,,,,,,
20150210-M-Rotterdam-R32-Andrey_Kuznetsov-Milos_Raonic,1,S-DTM,4,1,0,0,1,0,4,,,,,,,,,,
20150210-M-Rotterdam-R32-Andrey_Kuznetsov-Milos_Raonic,1,S-DTL,1,0,0,0,0,0,1,,,,,,,,,,
20150210-M-Rotterdam-R32-Andrey_Kuznetsov-Milos_Raonic,2,F-XC,21,12,8,2,2,16,5,,,,,,,,,,
20150210-M-Rotterdam-R32-Andrey_Kuznetsov-Milos_Raonic,2,F-DTM,13,2,0,2,0,8,5,,,,,,,,,,
20150210-M-Rotterdam-R32-Andrey_Kuznetsov-Milos_Raonic,2,F-DTL,6,1,1,0,0,4,2,,,,,,,,,,
20150210-M-Rotterdam-R32-Andrey_Kuznetsov-Milos_Raonic,2,F-IO,20,7,3,0,4,11,9,,,,,,,,,,
20150210-M-Rotterdam-R32-Andrey_Kuznetsov-Milos_Raonic,2,F-II,2,1,1,0,0,2,0,,,,,,,,,,
20150210-M-Rotterdam-R32-Andrey_Kuznetsov-Milos_Raonic,2,B-XC,3,2,0,1,1,2,1,,,,,,,,,,
20150210-M-Rotterdam-R32-Andrey_Kuznetsov-Milos_Raonic,2,B-DTM,9,5,0,2,3,5,4,,,,,,,,,,
20150210-M-Rotterdam-R32-Andrey_Kuznetsov-Milos_Raonic,2,B-DTL,2,0,0,0,0,1,1,,,,,,,,,,
20150210-M-Rotterdam-R32-Andrey_Kuznetsov-Milos_Raonic,2,B-IO,1,0,0,0,0,1,0,,,,,,,,,,
20150210-M-Rotterdam-R32-Andrey_Kuznetsov-Milos_Raonic,2,S-XC,15,1,0,1,0,8,7,,,,,,,,,,
20150210-M-Rotterdam-R32-Andrey_Kuznetsov-Milos_Raonic,2,S-DTM,10,2,0,1,1,7,3,,,,,,,,,,
20150212-M-Rotterdam-R16-Milos_Raonic-Simone_Bolelli,1,F-XC,16,2,1,0,1,11,5,,,,,,,,,,
20150212-M-Rotterdam-R16-Milos_Raonic-Simone_Bolelli,1,F-DTM,11,0,0,0,0,6,5,,,,,,,,,,
20150212-M-Rotterdam-R16-Milos_Raonic-Simone_Bolelli,1,F-DTL,4,2,1,1,0,4,0,,,,,,,,,,
20150212-M-Rotterdam-R16-Milos_Raonic-Simone_Bolelli,1,F-IO,14,3,1,0,2,7,7,,,,,,,,,,
20150212-M-Rotterdam-R16-Milos_Raonic-Simone_Bolelli,1,F-II,3,1,0,0,1,1,2,,,,,,,,,,
20150212-M-Rotterdam-R16-Milos_Raonic-Simone_Bolelli,1,B-XC,4,1,0,1,0,2,2,,,,,,,,,,
20150212-M-Rotterdam-R16-Milos_Raonic-Simone_Bolelli,1,B-DTM,11,1,0,0,1,6,5,,,,,,,,,,
20150212-M-Rotterdam-R16-Milos_Raonic-Simone_Bolelli,1,B-DTL,3,3,2,0,1,2,1,,,,,,,,,,
20150212-M-Rotterdam-R16-Milos_Raonic-Simone_Bolelli,1,S-XC,15,1,0,0,1,9,6,,,,,,,,,,
20150212-M-Rotterdam-R16-Milos_Raonic-Simone_Bolelli,1,S-DTM,10,0,0,0,0,3,7,,,,,,,,,,
20150212-M-Rotterdam-R16-Milos_Raonic-Simone_Bolelli,1,S-DTL,3,1,1,0,0,2,1,,,,,,,,,,
20150212-M-Rotterdam-R16-Milos_Raonic-Simone_Bolelli,1,S-IO,1,1,1,0,0,1,0,,,,,,,,,,
20150212-M-Rotterdam-R16-Milos_Raonic-Simone_Bolelli,2,F-XC,40,14,4,4,6,18,22,,,,,,,,,,
20150212-M-Rotterdam-R16-Milos_Raonic-Simone_Bolelli,2,F-DTM,8,3,0,2,1,5,3,,,,,,,,,,
20150212-M-Rotterdam-R16-Milos_Raonic-Simone_Bolelli,2,F-DTL,5,0,0,0,0,1,4,,,,,,,,,,
20150212-M-Rotterdam-R16-Milos_Raonic-Simone_Bolelli,2,F-IO,34,15,6,2,7,16,18,,,,,,,,,,
20150212-M-Rotterdam-R16-Milos_Raonic-Simone_Bolelli,2,F-II,2,1,1,0,0,1,1,,,,,,,,,,
20150212-M-Rotterdam-R16-Milos_Raonic-Simone_Bolelli,2,B-XC,9,2,1,1,0,7,2,,,,,,,,,,
20150212-M-Rotterdam-R16-Milos_Raonic-Simone_Bolelli,2,B-DTM,10,3,0,0,3,4,6,,,,,,,,,,
20150212-M-Rotterdam-R16-Milos_Raonic-Simone_Bolelli,2,B-DTL,1,1,1,0,0,1,0,,,,,,,,,,
20150212-M-Rotterdam-R16-Milos_Raonic-Simone_Bolelli,2,S-XC,6,1,0,0,1,1,5,,,,,,,,,,
20150212-M-Rotterdam-R16-Milos_Raonic-Simone_Bolelli,2,S-DTM,3,0,0,0,0,2,1,,,,,,,,,,
20150212-M-Rotterdam-R16-Milos_Raonic-Simone_Bolelli,2,S-DTL,3,3,1,1,1,2,1,,,,,,,,,,
20150213-M-Sao_Paulo-QF-Santiago_Giraldo-Fabio_Fognini,1,F-XC,31,9,4,2,3,17,14,,,,,,,,,,
20150213-M-Sao_Paulo-QF-Santiago_Giraldo-Fabio_Fognini,1,F-DTM,39,7,0,0,7,20,19,,,,,,,,,,
20150213-M-Sao_Paulo-QF-Santiago_Giraldo-Fabio_Fognini,1,F-DTL,10,1,0,1,0,9,1,,,,,,,,,,
20150213-M-Sao_Paulo-QF-Santiago_Giraldo-Fabio_Fognini,1,F-IO,59,11,3,4,4,35,24,,,,,,,,,,
20150213-M-Sao_Paulo-QF-Santiago_Giraldo-Fabio_Fognini,1,F-II,7,4,0,3,1,5,2,,,,,,,,,,
20150213-M-Sao_Paulo-QF-Santiago_Giraldo-Fabio_Fognini,1,B-XC,77,10,0,4,6,49,28,,,,,,,,,,
20150213-M-Sao_Paulo-QF-Santiago_Giraldo-Fabio_Fognini,1,B-DTM,34,2,0,0,2,21,13,,,,,,,,,,
20150213-M-Sao_Paulo-QF-Santiago_Giraldo-Fabio_Fognini,1,B-DTL,11,7,3,0,4,7,4,,,,,,,,,,
20150213-M-Sao_Paulo-QF-Santiago_Giraldo-Fabio_Fognini,1,B-IO,3,1,0,0,1,2,1,,,,,,,,,,
20150213-M-Sao_Paulo-QF-Santiago_Giraldo-Fabio_Fognini,1,S-XC,1,1,1,0,0,1,0,,,,,,,,,,
20150213-M-Sao_Paulo-QF-Santiago_Giraldo-Fabio_Fognini,1,S-DTM,3,0,0,0,0,0,3,,,,,,,,,,
20150213-M-Sao_Paulo-QF-Santiago_Giraldo-Fabio_Fognini,2,F-XC,42,15,3,3,9,14,28,,,,,,,,,,
20150213-M-Sao_Paulo-QF-Santiago_Giraldo-Fabio_Fognini,2,F-DTM,23,2,0,0,2,12,11,,,,,,,,,,
20150213-M-Sao_Paulo-QF-Santiago_Giraldo-Fabio_Fognini,2,F-DTL,8,4,3,1,0,6,2,,,,,,,,,,
20150213-M-Sao_Paulo-QF-Santiago_Giraldo-Fabio_Fognini,2,F-IO,41,13,3,5,5,20,21,,,,,,,,,,
20150213-M-Sao_Paulo-QF-Santiago_Giraldo-Fabio_Fognini,2,F-II,3,1,0,1,0,3,0,,,,,,,,,,
20150213-M-Sao_Paulo-QF-Santiago_Giraldo-Fabio_Fognini,2,B-XC,94,9,1,0,8,34,60,,,,,,,,,,
20150213-M-Sao_Paulo-QF-Santiago_Giraldo-Fabio_Fognini,2,B-DTM,26,2,0,0,2,10,16,,,,,,,,,,
20150213-M-Sao_Paulo-QF-Santiago_Giraldo-Fabio_Fognini,2,B-DTL,13,3,1,0,2,4,9,,,,,,,,,,
20150213-M-Sao_Paulo-QF-Santiago_Giraldo-Fabio_Fognini,2,B-IO,3,1,0,0,1,1,2,,,,,,,,,,
20150213-M-Sao_Paulo-QF-Santiago_Giraldo-Fabio_Fognini,2,S-XC,9,1,0,0,1,1,8,,,,,,,,,,
20150213-M-Sao_Paulo-QF-Santiago_Giraldo-Fabio_Fognini,2,S-DTM,6,1,0,0,1,1,5,,,,,,,,,,
20150213-M-Sao_Paulo-QF-Santiago_Giraldo-Fabio_Fognini,2,S-DTL,1,0,0,0,0,0,1,,,,,,,,,,
20150215-M-Rotterdam-F-Stanislas_Wawrinka-Tomas_Berdych,1,F-XC,45,16,4,6,6,24,21,,,,,,,,,,
20150215-M-Rotterdam-F-Stanislas_Wawrinka-Tomas_Berdych,1,F-DTM,31,2,0,0,2,19,12,,,,,,,,,,
20150215-M-Rotterdam-F-Stanislas_Wawrinka-Tomas_Berdych,1,F-DTL,11,5,2,0,3,5,6,,,,,,,,,,
20150215-M-Rotterdam-F-Stanislas_Wawrinka-Tomas_Berdych,1,F-IO,15,7,5,1,1,9,6,,,,,,,,,,
20150215-M-Rotterdam-F-Stanislas_Wawrinka-Tomas_Berdych,1,B-XC,19,6,1,3,2,12,7,,,,,,,,,,
20150215-M-Rotterdam-F-Stanislas_Wawrinka-Tomas_Berdych,1,B-DTM,18,2,0,1,1,12,6,,,,,,,,,,
20150215-M-Rotterdam-F-Stanislas_Wawrinka-Tomas_Berdych,1,B-DTL,7,5,2,1,2,4,3,,,,,,,,,,
20150215-M-Rotterdam-F-Stanislas_Wawrinka-Tomas_Berdych,1,B-IO,7,3,0,0,3,3,4,,,,,,,,,,
20150215-M-Rotterdam-F-Stanislas_Wawrinka-Tomas_Berdych,1,S-XC,5,0,0,0,0,1,4,,,,,,,,,,
20150215-M-Rotterdam-F-Stanislas_Wawrinka-Tomas_Berdych,1,S-DTM,2,0,0,0,0,0,2,,,,,,,,,,
20150215-M-Rotterdam-F-Stanislas_Wawrinka-Tomas_Berdych,2,F-XC,49,6,1,2,3,24,25,,,,,,,,,,
20150215-M-Rotterdam-F-Stanislas_Wawrinka-Tomas_Berdych,2,F-DTM,23,7,0,0,7,6,17,,,,,,,,,,
20150215-M-Rotterdam-F-Stanislas_Wawrinka-Tomas_Berdych,2,F-DTL,2,1,1,0,0,2,0,,,,,,,,,,
20150215-M-Rotterdam-F-Stanislas_Wawrinka-Tomas_Berdych,2,F-IO,24,15,2,2,11,10,14,,,,,,,,,,
20150215-M-Rotterdam-F-Stanislas_Wawrinka-Tomas_Berdych,2,F-II,1,0,0,0,0,1,0,,,,,,,,,,
20150215-M-Rotterdam-F-Stanislas_Wawrinka-Tomas_Berdych,2,B-XC,10,2,0,0,2,4,6,,,,,,,,,,
20150215-M-Rotterdam-F-Stanislas_Wawrinka-Tomas_Berdych,2,B-DTM,18,0,0,0,0,3,15,,,,,,,,,,
20150215-M-Rotterdam-F-Stanislas_Wawrinka-Tomas_Berdych,2,B-DTL,10,3,2,0,1,5,5,,,,,,,,,,
20150215-M-Rotterdam-F-Stanislas_Wawrinka-Tomas_Berdych,2,B-IO,10,2,2,0,0,6,4,,,,,,,,,,
20150215-M-Rotterdam-F-Stanislas_Wawrinka-Tomas_Berdych,2,S-XC,6,0,0,0,0,3,3,,,,,,,,,,
20150215-M-Rotterdam-F-Stanislas_Wawrinka-Tomas_Berdych,2,S-DTM,2,0,0,0,0,2,0,,,,,,,,,,
20150215-M-Rotterdam-F-Stanislas_Wawrinka-Tomas_Berdych,2,S-DTL,3,0,0,0,0,2,1,,,,,,,,,,
20150217-M-Marseille-R32-Alexander_Zverev-Gael_Monfils,1,F-XC,37,5,1,1,3,19,18,,,,,,,,,,
20150217-M-Marseille-R32-Alexander_Zverev-Gael_Monfils,1,F-DTM,25,2,0,0,2,11,14,,,,,,,,,,
20150217-M-Marseille-R32-Alexander_Zverev-Gael_Monfils,1,F-DTL,10,1,1,0,0,5,5,,,,,,,,,,
20150217-M-Marseille-R32-Alexander_Zverev-Gael_Monfils,1,F-IO,15,5,1,1,3,7,8,,,,,,,,,,
20150217-M-Marseille-R32-Alexander_Zverev-Gael_Monfils,1,F-II,3,2,1,0,1,1,2,,,,,,,,,,
20150217-M-Marseille-R32-Alexander_Zverev-Gael_Monfils,1,B-XC,44,10,2,2,6,23,21,,,,,,,,,,
20150217-M-Marseille-R32-Alexander_Zverev-Gael_Monfils,1,B-DTM,30,1,0,0,1,11,19,,,,,,,,,,
20150217-M-Marseille-R32-Alexander_Zverev-Gael_Monfils,1,B-DTL,7,4,1,1,2,5,2,,,,,,,,,,
20150217-M-Marseille-R32-Alexander_Zverev-Gael_Monfils,1,B-IO,7,1,0,0,1,3,4,,,,,,,,,,
20150217-M-Marseille-R32-Alexander_Zverev-Gael_Monfils,1,S-XC,5,1,0,1,0,2,3,,,,,,,,,,
20150217-M-Marseille-R32-Alexander_Zverev-Gael_Monfils,1,S-DTM,2,0,0,0,0,2,0,,,,,,,,,,
20150217-M-Marseille-R32-Alexander_Zverev-Gael_Monfils,1,S-DTL,1,1,1,0,0,1,0,,,,,,,,,,
20150217-M-Marseille-R32-Alexander_Zverev-Gael_Monfils,1,S-IO,1,1,0,1,0,1,0,,,,,,,,,,
20150217-M-Marseille-R32-Alexander_Zverev-Gael_Monfils,2,F-XC,37,7,1,2,4,20,17,,,,,,,,,,
20150217-M-Marseille-R32-Alexander_Zverev-Gael_Monfils,2,F-DTM,24,2,0,1,1,11,13,,,,,,,,,,
20150217-M-Marseille-R32-Alexander_Zverev-Gael_Monfils,2,F-DTL,4,0,0,0,0,3,1,,,,,,,,,,
20150217-M-Marseille-R32-Alexander_Zverev-Gael_Monfils,2,F-IO,23,9,3,2,4,13,10,,,,,,,,,,
20150217-M-Marseille-R32-Alexander_Zverev-Gael_Monfils,2,F-II,2,0,0,0,0,1,1,,,,,,,,,,
20150217-M-Marseille-R32-Alexander_Zverev-Gael_Monfils,2,B-XC,39,9,0,2,7,20,19,,,,,,,,,,
20150217-M-Marseille-R32-Alexander_Zverev-Gael_Monfils,2,B-DTM,20,1,0,0,1,9,11,,,,,,,,,,
20150217-M-Marseille-R32-Alexander_Zverev-Gael_Monfils,2,B-DTL,11,6,1,2,3,3,8,,,,,,,,,,
20150217-M-Marseille-R32-Alexander_Zverev-Gael_Monfils,2,B-IO,6,0,0,0,0,5,1,,,,,,,,,,
20150217-M-Marseille-R32-Alexander_Zverev-Gael_Monfils,2,S-XC,4,0,0,0,0,1,3,,,,,,,,,,
20150217-M-Marseille-R32-Alexander_Zverev-Gael_Monfils,2,S-DTM,3,0,0,0,0,1,2,,,,,,,,,,
20150217-M-Marseille-R32-Alexander_Zverev-Gael_Monfils,2,S-DTL,1,1,1,0,0,1,0,,,,,,,,,,
20150218-M-Delray_Beach-R16-Thanasi_Kokkinakis-Ivo_Karlovic,1,F-XC,21,7,1,2,4,12,9,,,,,,,,,,
20150218-M-Delray_Beach-R16-Thanasi_Kokkinakis-Ivo_Karlovic,1,F-DTM,15,2,2,0,0,11,4,,,,,,,,,,
20150218-M-Delray_Beach-R16-Thanasi_Kokkinakis-Ivo_Karlovic,1,F-DTL,4,2,2,0,0,2,2,,,,,,,,,,
20150218-M-Delray_Beach-R16-Thanasi_Kokkinakis-Ivo_Karlovic,1,F-IO,19,11,9,0,2,15,4,,,,,,,,,,
20150218-M-Delray_Beach-R16-Thanasi_Kokkinakis-Ivo_Karlovic,1,F-II,3,2,1,0,1,2,1,,,,,,,,,,
20150218-M-Delray_Beach-R16-Thanasi_Kokkinakis-Ivo_Karlovic,1,B-DTM,7,1,0,1,0,4,3,,,,,,,,,,
20150218-M-Delray_Beach-R16-Thanasi_Kokkinakis-Ivo_Karlovic,1,B-IO,2,1,0,0,1,0,2,,,,,,,,,,
20150218-M-Delray_Beach-R16-Thanasi_Kokkinakis-Ivo_Karlovic,1,S-XC,1,0,0,0,0,0,1,,,,,,,,,,
20150218-M-Delray_Beach-R16-Thanasi_Kokkinakis-Ivo_Karlovic,1,S-DTM,2,0,0,0,0,1,1,,,,,,,,,,
20150218-M-Delray_Beach-R16-Thanasi_Kokkinakis-Ivo_Karlovic,1,S-DTL,1,0,0,0,0,0,1,,,,,,,,,,
20150218-M-Delray_Beach-R16-Thanasi_Kokkinakis-Ivo_Karlovic,2,F-XC,6,2,0,0,2,3,3,,,,,,,,,,
20150218-M-Delray_Beach-R16-Thanasi_Kokkinakis-Ivo_Karlovic,2,F-DTM,9,2,0,0,2,0,9,,,,,,,,,,
20150218-M-Delray_Beach-R16-Thanasi_Kokkinakis-Ivo_Karlovic,2,F-DTL,2,1,0,0,1,1,1,,,,,,,,,,
20150218-M-Delray_Beach-R16-Thanasi_Kokkinakis-Ivo_Karlovic,2,F-IO,5,3,2,0,1,2,3,,,,,,,,,,
20150218-M-Delray_Beach-R16-Thanasi_Kokkinakis-Ivo_Karlovic,2,F-II,1,0,0,0,0,1,0,,,,,,,,,,
20150218-M-Delray_Beach-R16-Thanasi_Kokkinakis-Ivo_Karlovic,2,S-XC,1,0,0,0,0,0,1,,,,,,,,,,
20150218-M-Delray_Beach-R16-Thanasi_Kokkinakis-Ivo_Karlovic,2,S-DTM,10,2,0,0,2,2,8,,,,,,,,,,
20150218-M-Delray_Beach-R16-Thanasi_Kokkinakis-Ivo_Karlovic,2,S-DTL,2,0,0,0,0,1,1,,,,,,,,,,
20150220-M-Delray_Beach-QF-Steve_Johnson-Ivo_Karlovic,1,F-XC,15,3,1,1,1,9,6,,,,,,,,,,
20150220-M-Delray_Beach-QF-Steve_Johnson-Ivo_Karlovic,1,F-DTM,8,1,0,0,1,5,3,,,,,,,,,,
20150220-M-Delray_Beach-QF-Steve_Johnson-Ivo_Karlovic,1,F-DTL,6,5,4,1,0,6,0,,,,,,,,,,
20150220-M-Delray_Beach-QF-Steve_Johnson-Ivo_Karlovic,1,F-IO,13,8,4,1,3,9,4,,,,,,,,,,
20150220-M-Delray_Beach-QF-Steve_Johnson-Ivo_Karlovic,1,F-II,2,1,1,0,0,2,0,,,,,,,,,,
20150220-M-Delray_Beach-QF-Steve_Johnson-Ivo_Karlovic,1,B-XC,4,3,2,0,1,3,1,,,,,,,,,,
20150220-M-Delray_Beach-QF-Steve_Johnson-Ivo_Karlovic,1,B-DTM,2,0,0,0,0,1,1,,,,,,,,,,
20150220-M-Delray_Beach-QF-Steve_Johnson-Ivo_Karlovic,1,B-DTL,2,0,0,0,0,0,2,,,,,,,,,,
20150220-M-Delray_Beach-QF-Steve_Johnson-Ivo_Karlovic,1,S-XC,6,0,0,0,0,3,3,,,,,,,,,,
20150220-M-Delray_Beach-QF-Steve_Johnson-Ivo_Karlovic,1,S-DTM,1,0,0,0,0,1,0,,,,,,,,,,
20150220-M-Delray_Beach-QF-Steve_Johnson-Ivo_Karlovic,1,S-DTL,1,0,0,0,0,0,1,,,,,,,,,,
20150220-M-Delray_Beach-QF-Steve_Johnson-Ivo_Karlovic,2,F-XC,9,5,1,1,3,4,5,,,,,,,,,,
20150220-M-Delray_Beach-QF-Steve_Johnson-Ivo_Karlovic,2,F-DTM,2,0,0,0,0,0,2,,,,,,,,,,
20150220-M-Delray_Beach-QF-Steve_Johnson-Ivo_Karlovic,2,F-DTL,4,1,0,0,1,3,1,,,,,,,,,,
20150220-M-Delray_Beach-QF-Steve_Johnson-Ivo_Karlovic,2,F-IO,4,2,0,0,2,1,3,,,,,,,,,,
20150220-M-Delray_Beach-QF-Steve_Johnson-Ivo_Karlovic,2,F-II,2,1,0,0,1,1,1,,,,,,,,,,
20150220-M-Delray_Beach-QF-Steve_Johnson-Ivo_Karlovic,2,S-XC,6,3,0,2,1,2,4,,,,,,,,,,
20150220-M-Delray_Beach-QF-Steve_Johnson-Ivo_Karlovic,2,S-DTM,5,0,0,0,0,0,5,,,,,,,,,,
20150220-M-Delray_Beach-QF-Steve_Johnson-Ivo_Karlovic,2,S-DTL,2,1,1,0,0,2,0,,,,,,,,,,
20150220-M-Delray_Beach-QF-Steve_Johnson-Ivo_Karlovic,2,S-IO,1,0,0,0,0,0,1,,,,,,,,,,
20150221-M-Marseille-SF-Roberto_Bautista_Agut-Gael_Monfils,1,F-XC,32,8,3,4,1,18,14,,,,,,,,,,
20150221-M-Marseille-SF-Roberto_Bautista_Agut-Gael_Monfils,1,F-DTM,7,0,0,0,0,2,5,,,,,,,,,,
20150221-M-Marseille-SF-Roberto_Bautista_Agut-Gael_Monfils,1,F-DTL,10,0,0,0,0,5,5,,,,,,,,,,
20150221-M-Marseille-SF-Roberto_Bautista_Agut-Gael_Monfils,1,F-IO,33,6,1,1,4,14,19,,,,,,,,,,
20150221-M-Marseille-SF-Roberto_Bautista_Agut-Gael_Monfils,1,F-II,6,3,0,2,1,2,4,,,,,,,,,,
20150221-M-Marseille-SF-Roberto_Bautista_Agut-Gael_Monfils,1,B-XC,23,5,0,1,4,3,20,,,,,,,,,,
20150221-M-Marseille-SF-Roberto_Bautista_Agut-Gael_Monfils,1,B-DTM,22,1,0,0,1,5,17,,,,,,,,,,
20150221-M-Marseille-SF-Roberto_Bautista_Agut-Gael_Monfils,1,B-DTL,6,0,0,0,0,1,5,,,,,,,,,,
20150221-M-Marseille-SF-Roberto_Bautista_Agut-Gael_Monfils,1,S-XC,5,1,0,0,1,2,3,,,,,,,,,,
20150221-M-Marseille-SF-Roberto_Bautista_Agut-Gael_Monfils,1,S-DTM,3,0,0,0,0,0,3,,,,,,,,,,
20150221-M-Marseille-SF-Roberto_Bautista_Agut-Gael_Monfils,1,S-DTL,3,0,0,0,0,1,2,,,,,,,,,,
20150221-M-Marseille-SF-Roberto_Bautista_Agut-Gael_Monfils,2,F-XC,23,6,5,0,1,18,5,,,,,,,,,,
20150221-M-Marseille-SF-Roberto_Bautista_Agut-Gael_Monfils,2,F-DTM,20,1,0,0,1,12,8,,,,,,,,,,
20150221-M-Marseille-SF-Roberto_Bautista_Agut-Gael_Monfils,2,F-DTL,5,1,0,0,1,2,3,,,,,,,,,,
20150221-M-Marseille-SF-Roberto_Bautista_Agut-Gael_Monfils,2,F-IO,12,3,1,1,1,11,1,,,,,,,,,,
20150221-M-Marseille-SF-Roberto_Bautista_Agut-Gael_Monfils,2,B-XC,40,3,0,1,2,29,11,,,,,,,,,,
20150221-M-Marseille-SF-Roberto_Bautista_Agut-Gael_Monfils,2,B-DTM,22,2,0,0,2,10,12,,,,,,,,,,
20150221-M-Marseille-SF-Roberto_Bautista_Agut-Gael_Monfils,2,B-DTL,4,1,0,1,0,4,0,,,,,,,,,,
20150221-M-Marseille-SF-Roberto_Bautista_Agut-Gael_Monfils,2,B-IO,1,0,0,0,0,0,1,,,,,,,,,,
20150221-M-Marseille-SF-Roberto_Bautista_Agut-Gael_Monfils,2,S-XC,2,0,0,0,0,1,1,,,,,,,,,,
20150221-M-Marseille-SF-Roberto_Bautista_Agut-Gael_Monfils,2,S-DTM,6,0,0,0,0,1,5,,,,,,,,,,
20150221-M-Marseille-SF-Roberto_Bautista_Agut-Gael_Monfils,2,S-DTL,1,0,0,0,0,0,1,,,,,,,,,,
20150221-M-Marseille-SF-Sergiy_Stakhovsky-Gilles_Simon,1,F-XC,27,14,4,2,8,13,14,,,,,,,,,,
20150221-M-Marseille-SF-Sergiy_Stakhovsky-Gilles_Simon,1,F-DTM,21,1,0,0,1,6,15,,,,,,,,,,
20150221-M-Marseille-SF-Sergiy_Stakhovsky-Gilles_Simon,1,F-DTL,12,5,1,0,4,4,8,,,,,,,,,,
20150221-M-Marseille-SF-Sergiy_Stakhovsky-Gilles_Simon,1,F-IO,8,2,0,1,1,5,3,,,,,,,,,,
20150221-M-Marseille-SF-Sergiy_Stakhovsky-Gilles_Simon,1,B-XC,24,4,3,0,1,12,12,,,,,,,,,,
20150221-M-Marseille-SF-Sergiy_Stakhovsky-Gilles_Simon,1,B-DTM,10,0,0,0,0,5,5,,,,,,,,,,
20150221-M-Marseille-SF-Sergiy_Stakhovsky-Gilles_Simon,1,B-DTL,5,2,0,0,2,3,2,,,,,,,,,,
20150221-M-Marseille-SF-Sergiy_Stakhovsky-Gilles_Simon,1,B-IO,3,1,0,1,0,2,1,,,,,,,,,,
20150221-M-Marseille-SF-Sergiy_Stakhovsky-Gilles_Simon,1,S-XC,27,3,0,1,2,10,17,,,,,,,,,,
20150221-M-Marseille-SF-Sergiy_Stakhovsky-Gilles_Simon,1,S-DTM,7,1,0,0,1,3,4,,,,,,,,,,
20150221-M-Marseille-SF-Sergiy_Stakhovsky-Gilles_Simon,1,S-DTL,6,0,0,0,0,2,4,,,,,,,,,,
20150221-M-Marseille-SF-Sergiy_Stakhovsky-Gilles_Simon,1,S-IO,2,0,0,0,0,1,1,,,,,,,,,,
20150221-M-Marseille-SF-Sergiy_Stakhovsky-Gilles_Simon,2,F-XC,33,7,3,0,4,19,14,,,,,,,,,,
20150221-M-Marseille-SF-Sergiy_Stakhovsky-Gilles_Simon,2,F-DTM,17,2,1,0,1,9,8,,,,,,,,,,
20150221-M-Marseille-SF-Sergiy_Stakhovsky-Gilles_Simon,2,F-DTL,10,4,2,1,1,6,4,,,,,,,,,,
20150221-M-Marseille-SF-Sergiy_Stakhovsky-Gilles_Simon,2,F-IO,22,7,3,3,1,18,4,,,,,,,,,,
20150221-M-Marseille-SF-Sergiy_Stakhovsky-Gilles_Simon,2,F-II,2,0,0,0,0,0,2,,,,,,,,,,
20150221-M-Marseille-SF-Sergiy_Stakhovsky-Gilles_Simon,2,B-XC,47,8,2,1,5,24,23,,,,,,,,,,
20150221-M-Marseille-SF-Sergiy_Stakhovsky-Gilles_Simon,2,B-DTM,26,1,0,0,1,13,13,,,,,,,,,,
20150221-M-Marseille-SF-Sergiy_Stakhovsky-Gilles_Simon,2,B-DTL,19,6,1,1,4,8,11,,,,,,,,,,
20150221-M-Marseille-SF-Sergiy_Stakhovsky-Gilles_Simon,2,B-IO,5,2,0,0,2,0,5,,,,,,,,,,
20150221-M-Marseille-SF-Sergiy_Stakhovsky-Gilles_Simon,2,S-XC,1,0,0,0,0,0,1,,,,,,,,,,
20150221-M-Marseille-SF-Sergiy_Stakhovsky-Gilles_Simon,2,S-DTM,2,0,0,0,0,0,2,,,,,,,,,,
20150221-M-Marseille-SF-Sergiy_Stakhovsky-Gilles_Simon,2,S-DTL,1,0,0,0,0,1,0,,,,,,,,,,
20150223-M-Buenos_Aires-QF-Rafael_Nadal-Federico_Delbonis,1,F-XC,13,4,2,1,1,9,4,,,,,,,,,,
20150223-M-Buenos_Aires-QF-Rafael_Nadal-Federico_Delbonis,1,F-DTM,46,4,0,1,3,29,17,,,,,,,,,,
20150223-M-Buenos_Aires-QF-Rafael_Nadal-Federico_Delbonis,1,F-DTL,5,0,0,0,0,2,3,,,,,,,,,,
20150223-M-Buenos_Aires-QF-Rafael_Nadal-Federico_Delbonis,1,F-IO,19,5,2,2,1,13,6,,,,,,,,,,
20150223-M-Buenos_Aires-QF-Rafael_Nadal-Federico_Delbonis,1,B-XC,16,3,0,2,1,15,1,,,,,,,,,,
20150223-M-Buenos_Aires-QF-Rafael_Nadal-Federico_Delbonis,1,B-DTM,36,5,2,1,2,26,10,,,,,,,,,,
20150223-M-Buenos_Aires-QF-Rafael_Nadal-Federico_Delbonis,1,B-DTL,4,0,0,0,0,2,2,,,,,,,,,,
20150223-M-Buenos_Aires-QF-Rafael_Nadal-Federico_Delbonis,1,B-IO,5,2,0,1,1,4,1,,,,,,,,,,
20150223-M-Buenos_Aires-QF-Rafael_Nadal-Federico_Delbonis,1,S-XC,3,0,0,0,0,3,0,,,,,,,,,,
20150223-M-Buenos_Aires-QF-Rafael_Nadal-Federico_Delbonis,1,S-DTM,6,0,0,0,0,3,3,,,,,,,,,,
20150223-M-Buenos_Aires-QF-Rafael_Nadal-Federico_Delbonis,1,S-DTL,1,1,1,0,0,1,0,,,,,,,,,,
20150223-M-Buenos_Aires-QF-Rafael_Nadal-Federico_Delbonis,2,F-XC,28,11,2,4,5,15,13,,,,,,,,,,
20150223-M-Buenos_Aires-QF-Rafael_Nadal-Federico_Delbonis,2,F-DTM,27,1,0,0,1,7,20,,,,,,,,,,
20150223-M-Buenos_Aires-QF-Rafael_Nadal-Federico_Delbonis,2,F-DTL,5,1,0,0,1,1,4,,,,,,,,,,
20150223-M-Buenos_Aires-QF-Rafael_Nadal-Federico_Delbonis,2,F-IO,19,4,2,0,2,5,14,,,,,,,,,,
20150223-M-Buenos_Aires-QF-Rafael_Nadal-Federico_Delbonis,2,F-II,3,1,0,0,1,1,2,,,,,,,,,,
20150223-M-Buenos_Aires-QF-Rafael_Nadal-Federico_Delbonis,2,B-XC,22,3,0,1,2,5,17,,,,,,,,,,
20150223-M-Buenos_Aires-QF-Rafael_Nadal-Federico_Delbonis,2,B-DTM,39,3,0,0,3,13,26,,,,,,,,,,
20150223-M-Buenos_Aires-QF-Rafael_Nadal-Federico_Delbonis,2,B-DTL,4,3,0,0,3,0,4,,,,,,,,,,
20150223-M-Buenos_Aires-QF-Rafael_Nadal-Federico_Delbonis,2,B-IO,12,7,1,0,6,3,9,,,,,,,,,,
20150223-M-Buenos_Aires-QF-Rafael_Nadal-Federico_Delbonis,2,S-XC,3,1,0,1,0,1,2,,,,,,,,,,
20150223-M-Buenos_Aires-QF-Rafael_Nadal-Federico_Delbonis,2,S-DTM,3,0,0,0,0,0,3,,,,,,,,,,
20150226-M-Dubai-QF-Andy_Murray-Borna_Coric,1,F-XC,51,12,2,0,10,19,32,,,,,,,,,,
20150226-M-Dubai-QF-Andy_Murray-Borna_Coric,1,F-DTM,31,5,0,0,5,13,18,,,,,,,,,,
20150226-M-Dubai-QF-Andy_Murray-Borna_Coric,1,F-DTL,10,2,1,0,1,5,5,,,,,,,,,,
20150226-M-Dubai-QF-Andy_Murray-Borna_Coric,1,F-IO,35,7,2,1,4,17,18,,,,,,,,,,
20150226-M-Dubai-QF-Andy_Murray-Borna_Coric,1,B-XC,54,15,1,1,13,21,33,,,,,,,,,,
20150226-M-Dubai-QF-Andy_Murray-Borna_Coric,1,B-DTM,34,2,0,0,2,11,23,,,,,,,,,,
20150226-M-Dubai-QF-Andy_Murray-Borna_Coric,1,B-DTL,5,2,0,0,2,2,3,,,,,,,,,,
20150226-M-Dubai-QF-Andy_Murray-Borna_Coric,1,B-IO,5,1,0,0,1,2,3,,,,,,,,,,
20150226-M-Dubai-QF-Andy_Murray-Borna_Coric,1,S-XC,12,1,0,0,1,8,4,,,,,,,,,,
20150226-M-Dubai-QF-Andy_Murray-Borna_Coric,1,S-DTM,10,1,0,0,1,3,7,,,,,,,,,,
20150226-M-Dubai-QF-Andy_Murray-Borna_Coric,1,S-IO,4,1,0,0,1,1,3,,,,,,,,,,
20150226-M-Dubai-QF-Andy_Murray-Borna_Coric,2,F-XC,37,2,0,2,0,24,13,,,,,,,,,,
20150226-M-Dubai-QF-Andy_Murray-Borna_Coric,2,F-DTM,41,1,0,0,1,23,18,,,,,,,,,,
20150226-M-Dubai-QF-Andy_Murray-Borna_Coric,2,F-DTL,8,1,1,0,0,5,3,,,,,,,,,,
20150226-M-Dubai-QF-Andy_Murray-Borna_Coric,2,F-IO,14,4,0,0,4,7,7,,,,,,,,,,
20150226-M-Dubai-QF-Andy_Murray-Borna_Coric,2,F-II,2,0,0,0,0,1,1,,,,,,,,,,
20150226-M-Dubai-QF-Andy_Murray-Borna_Coric,2,B-XC,55,5,2,0,3,34,21,,,,,,,,,,
20150226-M-Dubai-QF-Andy_Murray-Borna_Coric,2,B-DTM,42,2,0,0,2,22,20,,,,,,,,,,
20150226-M-Dubai-QF-Andy_Murray-Borna_Coric,2,B-IO,4,2,1,0,1,3,1,,,,,,,,,,
20150226-M-Dubai-QF-Andy_Murray-Borna_Coric,2,S-XC,13,0,0,0,0,4,9,,,,,,,,,,
20150226-M-Dubai-QF-Andy_Murray-Borna_Coric,2,S-DTM,10,0,0,0,0,7,3,,,,,,,,,,
20150226-M-Dubai-QF-Andy_Murray-Borna_Coric,2,S-DTL,1,0,0,0,0,1,0,,,,,,,,,,
20150226-M-Dubai-QF-Novak_Djokovic-Marsel_Ilhan,1,F-XC,18,7,3,3,1,15,3,,,,,,,,,,
20150226-M-Dubai-QF-Novak_Djokovic-Marsel_Ilhan,1,F-DTM,10,2,0,1,1,8,2,,,,,,,,,,
20150226-M-Dubai-QF-Novak_Djokovic-Marsel_Ilhan,1,F-DTL,5,2,0,0,2,3,2,,,,,,,,,,
20150226-M-Dubai-QF-Novak_Djokovic-Marsel_Ilhan,1,F-IO,12,4,0,2,2,9,3,,,,,,,,,,
20150226-M-Dubai-QF-Novak_Djokovic-Marsel_Ilhan,1,F-II,1,0,0,0,0,1,0,,,,,,,,,,
20150226-M-Dubai-QF-Novak_Djokovic-Marsel_Ilhan,1,B-XC,10,3,0,0,3,6,4,,,,,,,,,,
20150226-M-Dubai-QF-Novak_Djokovic-Marsel_Ilhan,1,B-DTM,10,0,0,0,0,7,3,,,,,,,,,,
20150226-M-Dubai-QF-Novak_Djokovic-Marsel_Ilhan,1,B-DTL,9,2,0,1,1,7,2,,,,,,,,,,
20150226-M-Dubai-QF-Novak_Djokovic-Marsel_Ilhan,1,B-IO,2,0,0,0,0,2,0,,,,,,,,,,
20150226-M-Dubai-QF-Novak_Djokovic-Marsel_Ilhan,1,S-XC,3,0,0,0,0,1,2,,,,,,,,,,
20150226-M-Dubai-QF-Novak_Djokovic-Marsel_Ilhan,2,F-XC,23,6,0,0,6,5,18,,,,,,,,,,
20150226-M-Dubai-QF-Novak_Djokovic-Marsel_Ilhan,2,F-DTM,12,1,0,0,1,4,8,,,,,,,,,,
20150226-M-Dubai-QF-Novak_Djokovic-Marsel_Ilhan,2,F-IO,31,13,0,4,9,8,23,,,,,,,,,,
20150226-M-Dubai-QF-Novak_Djokovic-Marsel_Ilhan,2,F-II,2,2,0,0,2,0,2,,,,,,,,,,
20150226-M-Dubai-QF-Novak_Djokovic-Marsel_Ilhan,2,B-XC,4,3,1,0,2,1,3,,,,,,,,,,
20150226-M-Dubai-QF-Novak_Djokovic-Marsel_Ilhan,2,B-DTM,7,3,0,0,3,1,6,,,,,,,,,,
20150226-M-Dubai-QF-Novak_Djokovic-Marsel_Ilhan,2,B-DTL,1,0,0,0,0,0,1,,,,,,,,,,
20150226-M-Dubai-QF-Novak_Djokovic-Marsel_Ilhan,2,S-XC,6,1,0,0,1,0,6,,,,,,,,,,
20150226-M-Dubai-QF-Novak_Djokovic-Marsel_Ilhan,2,S-DTM,4,0,0,0,0,1,3,,,,,,,,,,
20150227-M-Dubai-SF-Roger_Federer-Borna_Coric,1,F-XC,23,5,1,2,2,12,11,,,,,,,,,,
20150227-M-Dubai-SF-Roger_Federer-Borna_Coric,1,F-DTM,29,5,0,1,4,17,12,,,,,,,,,,
20150227-M-Dubai-SF-Roger_Federer-Borna_Coric,1,F-DTL,1,0,0,0,0,1,0,,,,,,,,,,
20150227-M-Dubai-SF-Roger_Federer-Borna_Coric,1,F-IO,16,5,1,0,4,11,5,,,,,,,,,,
20150227-M-Dubai-SF-Roger_Federer-Borna_Coric,1,F-II,2,1,0,0,1,0,2,,,,,,,,,,
20150227-M-Dubai-SF-Roger_Federer-Borna_Coric,1,B-XC,9,2,0,0,2,3,6,,,,,,,,,,
20150227-M-Dubai-SF-Roger_Federer-Borna_Coric,1,B-DTM,15,0,0,0,0,8,7,,,,,,,,,,
20150227-M-Dubai-SF-Roger_Federer-Borna_Coric,1,B-DTL,3,1,1,0,0,1,2,,,,,,,,,,
20150227-M-Dubai-SF-Roger_Federer-Borna_Coric,1,B-IO,1,1,0,0,1,0,1,,,,,,,,,,
20150227-M-Dubai-SF-Roger_Federer-Borna_Coric,1,S-XC,18,1,0,0,1,10,8,,,,,,,,,,
20150227-M-Dubai-SF-Roger_Federer-Borna_Coric,1,S-DTM,9,0,0,0,0,5,4,,,,,,,,,,
20150227-M-Dubai-SF-Roger_Federer-Borna_Coric,1,S-DTL,1,0,0,0,0,1,0,,,,,,,,,,
20150227-M-Dubai-SF-Roger_Federer-Borna_Coric,1,S-IO,2,0,0,0,0,0,2,,,,,,,,,,
20150227-M-Dubai-SF-Roger_Federer-Borna_Coric,2,F-XC,26,7,0,1,6,9,17,,,,,,,,,,
20150227-M-Dubai-SF-Roger_Federer-Borna_Coric,2,F-DTM,29,2,1,0,1,16,13,,,,,,,,,,
20150227-M-Dubai-SF-Roger_Federer-Borna_Coric,2,F-DTL,4,0,0,0,0,3,1,,,,,,,,,,
20150227-M-Dubai-SF-Roger_Federer-Borna_Coric,2,F-IO,23,3,0,1,2,11,12,,,,,,,,,,
20150227-M-Dubai-SF-Roger_Federer-Borna_Coric,2,F-II,2,1,0,1,0,1,1,,,,,,,,,,
20150227-M-Dubai-SF-Roger_Federer-Borna_Coric,2,B-XC,25,1,0,0,1,5,20,,,,,,,,,,
20150227-M-Dubai-SF-Roger_Federer-Borna_Coric,2,B-DTM,20,2,0,0,2,6,14,,,,,,,,,,
20150227-M-Dubai-SF-Roger_Federer-Borna_Coric,2,B-DTL,3,1,0,0,1,1,2,,,,,,,,,,
20150227-M-Dubai-SF-Roger_Federer-Borna_Coric,2,B-IO,2,2,0,0,2,0,2,,,,,,,,,,
20150227-M-Dubai-SF-Roger_Federer-Borna_Coric,2,B-II,1,0,0,0,0,1,0,,,,,,,,,,
20150227-M-Dubai-SF-Roger_Federer-Borna_Coric,2,S-XC,3,1,0,0,1,1,2,,,,,,,,,,
20150228-M-Dubai-F-Roger_Federer-Novak_Djokovic,1,F-XC,23,8,1,0,7,9,14,,,,,,,,,,
20150228-M-Dubai-F-Roger_Federer-Novak_Djokovic,1,F-DTM,25,5,1,2,2,14,11,,,,,,,,,,
20150228-M-Dubai-F-Roger_Federer-Novak_Djokovic,1,F-DTL,4,3,2,0,1,2,2,,,,,,,,,,
20150228-M-Dubai-F-Roger_Federer-Novak_Djokovic,1,F-IO,25,6,5,0,1,12,13,,,,,,,,,,
20150228-M-Dubai-F-Roger_Federer-Novak_Djokovic,1,F-II,4,3,2,0,1,3,1,,,,,,,,,,
20150228-M-Dubai-F-Roger_Federer-Novak_Djokovic,1,B-XC,15,3,0,0,3,7,8,,,,,,,,,,
20150228-M-Dubai-F-Roger_Federer-Novak_Djokovic,1,B-DTM,16,2,0,1,1,9,7,,,,,,,,,,
20150228-M-Dubai-F-Roger_Federer-Novak_Djokovic,1,B-DTL,9,6,3,0,3,4,5,,,,,,,,,,
20150228-M-Dubai-F-Roger_Federer-Novak_Djokovic,1,B-IO,1,1,0,0,1,0,1,,,,,,,,,,
20150228-M-Dubai-F-Roger_Federer-Novak_Djokovic,1,S-XC,7,1,0,0,1,4,3,,,,,,,,,,
20150228-M-Dubai-F-Roger_Federer-Novak_Djokovic,1,S-DTM,11,1,0,0,1,3,8,,,,,,,,,,
20150228-M-Dubai-F-Roger_Federer-Novak_Djokovic,1,S-IO,1,0,0,0,0,1,0,,,,,,,,,,
20150228-M-Dubai-F-Roger_Federer-Novak_Djokovic,2,F-XC,30,9,4,0,5,14,16,,,,,,,,,,
20150228-M-Dubai-F-Roger_Federer-Novak_Djokovic,2,F-DTM,19,1,1,0,0,12,7,,,,,,,,,,
20150228-M-Dubai-F-Roger_Federer-Novak_Djokovic,2,F-DTL,7,0,0,0,0,3,4,,,,,,,,,,
20150228-M-Dubai-F-Roger_Federer-Novak_Djokovic,2,F-IO,17,6,2,0,4,8,9,,,,,,,,,,
20150228-M-Dubai-F-Roger_Federer-Novak_Djokovic,2,F-II,3,2,2,0,0,3,0,,,,,,,,,,
20150228-M-Dubai-F-Roger_Federer-Novak_Djokovic,2,B-XC,32,7,1,3,3,16,16,,,,,,,,,,
20150228-M-Dubai-F-Roger_Federer-Novak_Djokovic,2,B-DTM,22,2,0,0,2,11,11,,,,,,,,,,
20150228-M-Dubai-F-Roger_Federer-Novak_Djokovic,2,B-DTL,2,1,1,0,0,2,0,,,,,,,,,,
20150228-M-Dubai-F-Roger_Federer-Novak_Djokovic,2,B-IO,9,3,2,1,0,6,3,,,,,,,,,,
20150228-M-Dubai-F-Roger_Federer-Novak_Djokovic,2,S-XC,4,0,0,0,0,1,3,,,,,,,,,,
20150228-M-Dubai-F-Roger_Federer-Novak_Djokovic,2,S-DTM,1,0,0,0,0,1,0,,,,,,,,,,
20150228-M-Dubai-F-Roger_Federer-Novak_Djokovic,2,S-DTL,1,0,0,0,0,0,1,,,,,,,,,,
20150312-M-Indian_Wells_Masters-R128-Andreas_Haider_Maurer-Borna_Coric,1,F-XC,32,7,0,0,7,9,23,,,,,,,,,,
20150312-M-Indian_Wells_Masters-R128-Andreas_Haider_Maurer-Borna_Coric,1,F-DTM,33,4,1,0,3,11,22,,,,,,,,,,
20150312-M-Indian_Wells_Masters-R128-Andreas_Haider_Maurer-Borna_Coric,1,F-DTL,10,5,1,1,3,3,7,,,,,,,,,,
20150312-M-Indian_Wells_Masters-R128-Andreas_Haider_Maurer-Borna_Coric,1,F-IO,26,5,1,2,2,10,16,,,,,,,,,,
20150312-M-Indian_Wells_Masters-R128-Andreas_Haider_Maurer-Borna_Coric,1,F-II,1,0,0,0,0,0,1,,,,,,,,,,
20150312-M-Indian_Wells_Masters-R128-Andreas_Haider_Maurer-Borna_Coric,1,B-XC,29,3,0,1,2,8,21,,,,,,,,,,
20150312-M-Indian_Wells_Masters-R128-Andreas_Haider_Maurer-Borna_Coric,1,B-DTM,31,3,0,0,3,12,19,,,,,,,,,,
20150312-M-Indian_Wells_Masters-R128-Andreas_Haider_Maurer-Borna_Coric,1,B-DTL,4,2,1,0,1,2,2,,,,,,,,,,
20150312-M-Indian_Wells_Masters-R128-Andreas_Haider_Maurer-Borna_Coric,1,B-IO,3,0,0,0,0,2,1,,,,,,,,,,
20150312-M-Indian_Wells_Masters-R128-Andreas_Haider_Maurer-Borna_Coric,1,S-XC,12,1,0,0,1,2,10,,,,,,,,,,
20150312-M-Indian_Wells_Masters-R128-Andreas_Haider_Maurer-Borna_Coric,1,S-DTM,6,1,0,0,1,0,6,,,,,,,,,,
20150312-M-Indian_Wells_Masters-R128-Andreas_Haider_Maurer-Borna_Coric,1,S-DTL,1,0,0,0,0,0,1,,,,,,,,,,
20150312-M-Indian_Wells_Masters-R128-Andreas_Haider_Maurer-Borna_Coric,1,S-IO,1,0,0,0,0,0,1,,,,,,,,,,
20150312-M-Indian_Wells_Masters-R128-Andreas_Haider_Maurer-Borna_Coric,2,F-XC,41,8,2,0,6,27,14,,,,,,,,,,
20150312-M-Indian_Wells_Masters-R128-Andreas_Haider_Maurer-Borna_Coric,2,F-DTM,32,1,0,0,1,21,11,,,,,,,,,,
20150312-M-Indian_Wells_Masters-R128-Andreas_Haider_Maurer-Borna_Coric,2,F-DTL,4,2,1,0,1,3,1,,,,,,,,,,
20150312-M-Indian_Wells_Masters-R128-Andreas_Haider_Maurer-Borna_Coric,2,F-IO,29,5,1,2,2,22,7,,,,,,,,,,
20150312-M-Indian_Wells_Masters-R128-Andreas_Haider_Maurer-Borna_Coric,2,F-II,3,0,0,0,0,3,0,,,,,,,,,,
20150312-M-Indian_Wells_Masters-R128-Andreas_Haider_Maurer-Borna_Coric,2,B-XC,34,5,1,1,3,21,13,,,,,,,,,,
20150312-M-Indian_Wells_Masters-R128-Andreas_Haider_Maurer-Borna_Coric,2,B-DTM,20,2,0,0,2,16,4,,,,,,,,,,
20150312-M-Indian_Wells_Masters-R128-Andreas_Haider_Maurer-Borna_Coric,2,B-DTL,6,2,0,2,0,4,2,,,,,,,,,,
20150312-M-Indian_Wells_Masters-R128-Andreas_Haider_Maurer-Borna_Coric,2,B-IO,2,0,0,0,0,1,1,,,,,,,,,,
20150312-M-Indian_Wells_Masters-R128-Andreas_Haider_Maurer-Borna_Coric,2,S-XC,8,1,0,1,0,6,2,,,,,,,,,,
20150312-M-Indian_Wells_Masters-R128-Andreas_Haider_Maurer-Borna_Coric,2,S-DTM,4,1,0,0,1,2,2,,,,,,,,,,
20150312-M-Indian_Wells_Masters-R128-Andreas_Haider_Maurer-Borna_Coric,2,S-DTL,2,0,0,0,0,2,0,,,,,,,,,,
20150312-M-Indian_Wells_Masters-R128-Andreas_Haider_Maurer-Borna_Coric,2,S-IO,1,0,0,0,0,0,1,,,,,,,,,,
20150313-M-Indian_Wells_Masters-R128-Sam_Querrey-Sergiy_Stakhovsky,1,F-XC,1,0,0,0,0,0,1,,,,,,,,,,
20150313-M-Indian_Wells_Masters-R128-Sam_Querrey-Sergiy_Stakhovsky,1,F-DTM,3,1,0,0,1,0,3,,,,,,,,,,
20150313-M-Indian_Wells_Masters-R128-Sam_Querrey-Sergiy_Stakhovsky,1,F-IO,1,0,0,0,0,0,1,,,,,,,,,,
20150313-M-Indian_Wells_Masters-R128-Sam_Querrey-Sergiy_Stakhovsky,1,B-DTM,2,1,0,0,1,0,2,,,,,,,,,,
20150313-M-Indian_Wells_Masters-R128-Sam_Querrey-Sergiy_Stakhovsky,2,F-XC,3,1,1,0,0,3,0,,,,,,,,,,
20150313-M-Indian_Wells_Masters-R128-Sam_Querrey-Sergiy_Stakhovsky,2,F-DTM,1,0,0,0,0,1,0,,,,,,,,,,
20150313-M-Indian_Wells_Masters-R128-Sam_Querrey-Sergiy_Stakhovsky,2,F-IO,1,0,0,0,0,1,0,,,,,,,,,,
20150313-M-Indian_Wells_Masters-R128-Sam_Querrey-Sergiy_Stakhovsky,2,B-XC,2,2,1,0,1,1,1,,,,,,,,,,
20150313-M-Indian_Wells_Masters-R128-Sam_Querrey-Sergiy_Stakhovsky,2,B-DTL,1,0,0,0,0,1,0,,,,,,,,,,
20150313-M-Indian_Wells_Masters-R128-Sam_Querrey-Sergiy_Stakhovsky,2,B-IO,1,0,0,0,0,1,0,,,,,,,,,,
20150313-M-Indian_Wells_Masters-R128-Sam_Querrey-Sergiy_Stakhovsky,2,S-XC,1,0,0,0,0,1,0,,,,,,,,,,
20150313-M-Indian_Wells_Masters-R128-Sam_Querrey-Sergiy_Stakhovsky,2,S-DTM,1,0,0,0,0,1,0,,,,,,,,,,
20150315-M-Indian_Wells_Masters-R64-Diego_Sebastian_Schwartzman-Roger_Federer,1,F-XC,10,2,1,0,1,7,3,,,,,,,,,,
20150315-M-Indian_Wells_Masters-R64-Diego_Sebastian_Schwartzman-Roger_Federer,1,F-DTM,13,1,0,0,1,2,11,,,,,,,,,,
20150315-M-Indian_Wells_Masters-R64-Diego_Sebastian_Schwartzman-Roger_Federer,1,F-DTL,5,1,1,0,0,2,3,,,,,,,,,,
20150315-M-Indian_Wells_Masters-R64-Diego_Sebastian_Schwartzman-Roger_Federer,1,F-IO,23,8,1,3,4,11,12,,,,,,,,,,
20150315-M-Indian_Wells_Masters-R64-Diego_Sebastian_Schwartzman-Roger_Federer,1,F-II,2,0,0,0,0,1,1,,,,,,,,,,
20150315-M-Indian_Wells_Masters-R64-Diego_Sebastian_Schwartzman-Roger_Federer,1,B-XC,32,6,0,0,6,20,12,,,,,,,,,,
20150315-M-Indian_Wells_Masters-R64-Diego_Sebastian_Schwartzman-Roger_Federer,1,B-DTM,15,1,0,0,1,6,9,,,,,,,,,,
20150315-M-Indian_Wells_Masters-R64-Diego_Sebastian_Schwartzman-Roger_Federer,1,B-DTL,1,1,1,0,0,1,0,,,,,,,,,,
20150315-M-Indian_Wells_Masters-R64-Diego_Sebastian_Schwartzman-Roger_Federer,1,B-IO,1,0,0,0,0,1,0,,,,,,,,,,
20150315-M-Indian_Wells_Masters-R64-Diego_Sebastian_Schwartzman-Roger_Federer,1,S-XC,2,0,0,0,0,2,0,,,,,,,,,,
20150315-M-Indian_Wells_Masters-R64-Diego_Sebastian_Schwartzman-Roger_Federer,2,F-XC,12,5,1,2,2,10,2,,,,,,,,,,
20150315-M-Indian_Wells_Masters-R64-Diego_Sebastian_Schwartzman-Roger_Federer,2,F-DTM,13,1,0,0,1,5,8,,,,,,,,,,
20150315-M-Indian_Wells_Masters-R64-Diego_Sebastian_Schwartzman-Roger_Federer,2,F-DTL,5,2,1,0,1,3,2,,,,,,,,,,
20150315-M-Indian_Wells_Masters-R64-Diego_Sebastian_Schwartzman-Roger_Federer,2,F-IO,13,5,0,3,2,8,5,,,,,,,,,,
20150315-M-Indian_Wells_Masters-R64-Diego_Sebastian_Schwartzman-Roger_Federer,2,F-II,3,1,0,0,1,0,3,,,,,,,,,,
20150315-M-Indian_Wells_Masters-R64-Diego_Sebastian_Schwartzman-Roger_Federer,2,B-XC,15,4,2,0,2,6,9,,,,,,,,,,
20150315-M-Indian_Wells_Masters-R64-Diego_Sebastian_Schwartzman-Roger_Federer,2,B-DTM,17,4,0,0,4,6,11,,,,,,,,,,
20150315-M-Indian_Wells_Masters-R64-Diego_Sebastian_Schwartzman-Roger_Federer,2,B-DTL,7,4,1,1,2,5,2,,,,,,,,,,
20150315-M-Indian_Wells_Masters-R64-Diego_Sebastian_Schwartzman-Roger_Federer,2,S-XC,9,0,0,0,0,5,4,,,,,,,,,,
20150315-M-Indian_Wells_Masters-R64-Diego_Sebastian_Schwartzman-Roger_Federer,2,S-DTL,1,1,0,0,1,0,1,,,,,,,,,,
20150316-M-Indian_Wells_Masters-R32-David_Ferrer-Bernard_Tomic,1,F-XC,63,11,4,2,5,35,28,,,,,,,,,,
20150316-M-Indian_Wells_Masters-R32-David_Ferrer-Bernard_Tomic,1,F-DTM,17,1,0,0,1,7,10,,,,,,,,,,
20150316-M-Indian_Wells_Masters-R32-David_Ferrer-Bernard_Tomic,1,F-DTL,22,2,0,0,2,11,11,,,,,,,,,,
20150316-M-Indian_Wells_Masters-R32-David_Ferrer-Bernard_Tomic,1,F-IO,75,10,2,3,5,41,34,,,,,,,,,,
20150316-M-Indian_Wells_Masters-R32-David_Ferrer-Bernard_Tomic,1,F-II,6,3,1,2,0,4,2,,,,,,,,,,
20150316-M-Indian_Wells_Masters-R32-David_Ferrer-Bernard_Tomic,1,B-XC,83,2,0,0,2,38,45,,,,,,,,,,
20150316-M-Indian_Wells_Masters-R32-David_Ferrer-Bernard_Tomic,1,B-DTM,21,1,0,0,1,12,9,,,,,,,,,,
20150316-M-Indian_Wells_Masters-R32-David_Ferrer-Bernard_Tomic,1,B-DTL,9,6,1,1,4,4,5,,,,,,,,,,
20150316-M-Indian_Wells_Masters-R32-David_Ferrer-Bernard_Tomic,1,B-IO,1,1,0,0,1,0,1,,,,,,,,,,
20150316-M-Indian_Wells_Masters-R32-David_Ferrer-Bernard_Tomic,1,S-XC,9,2,0,0,2,4,5,,,,,,,,,,
20150316-M-Indian_Wells_Masters-R32-David_Ferrer-Bernard_Tomic,1,S-DTM,5,1,0,0,1,3,2,,,,,,,,,,
20150316-M-Indian_Wells_Masters-R32-David_Ferrer-Bernard_Tomic,1,S-DTL,2,0,0,0,0,1,1,,,,,,,,,,
20150316-M-Indian_Wells_Masters-R32-David_Ferrer-Bernard_Tomic,2,F-XC,47,15,3,2,10,18,29,,,,,,,,,,
20150316-M-Indian_Wells_Masters-R32-David_Ferrer-Bernard_Tomic,2,F-DTM,21,4,0,2,2,10,11,,,,,,,,,,
20150316-M-Indian_Wells_Masters-R32-David_Ferrer-Bernard_Tomic,2,F-DTL,30,9,1,3,5,15,15,,,,,,,,,,
20150316-M-Indian_Wells_Masters-R32-David_Ferrer-Bernard_Tomic,2,F-IO,30,5,2,1,2,18,12,,,,,,,,,,
20150316-M-Indian_Wells_Masters-R32-David_Ferrer-Bernard_Tomic,2,F-II,4,2,1,0,1,3,1,,,,,,,,,,
20150316-M-Indian_Wells_Masters-R32-David_Ferrer-Bernard_Tomic,2,B-XC,76,4,1,0,3,42,34,,,,,,,,,,
20150316-M-Indian_Wells_Masters-R32-David_Ferrer-Bernard_Tomic,2,B-DTM,36,3,0,0,3,15,21,,,,,,,,,,
20150316-M-Indian_Wells_Masters-R32-David_Ferrer-Bernard_Tomic,2,B-DTL,27,10,1,3,6,16,11,,,,,,,,,,
20150316-M-Indian_Wells_Masters-R32-David_Ferrer-Bernard_Tomic,2,B-IO,2,0,0,0,0,1,1,,,,,,,,,,
20150316-M-Indian_Wells_Masters-R32-David_Ferrer-Bernard_Tomic,2,S-XC,28,0,0,0,0,11,17,,,,,,,,,,
20150316-M-Indian_Wells_Masters-R32-David_Ferrer-Bernard_Tomic,2,S-DTM,15,1,0,0,1,3,12,,,,,,,,,,
20150316-M-Indian_Wells_Masters-R32-David_Ferrer-Bernard_Tomic,2,S-DTL,10,2,0,0,2,5,5,,,,,,,,,,
20150316-M-Indian_Wells_Masters-R32-David_Ferrer-Bernard_Tomic,2,S-IO,2,0,0,0,0,0,2,,,,,,,,,,
20150316-M-Indian_Wells_Masters-R32-Feliciano_Lopez-Pablo_Cuevas,1,F-XC,64,7,0,2,5,37,27,,,,,,,,,,
20150316-M-Indian_Wells_Masters-R32-Feliciano_Lopez-Pablo_Cuevas,1,F-DTM,33,2,0,0,2,16,17,,,,,,,,,,
20150316-M-Indian_Wells_Masters-R32-Feliciano_Lopez-Pablo_Cuevas,1,F-DTL,7,5,1,2,2,4,3,,,,,,,,,,
20150316-M-Indian_Wells_Masters-R32-Feliciano_Lopez-Pablo_Cuevas,1,F-IO,21,4,2,1,1,9,12,,,,,,,,,,
20150316-M-Indian_Wells_Masters-R32-Feliciano_Lopez-Pablo_Cuevas,1,F-II,6,1,0,1,0,4,2,,,,,,,,,,
20150316-M-Indian_Wells_Masters-R32-Feliciano_Lopez-Pablo_Cuevas,1,B-XC,9,1,0,0,1,7,2,,,,,,,,,,
20150316-M-Indian_Wells_Masters-R32-Feliciano_Lopez-Pablo_Cuevas,1,B-DTM,11,0,0,0,0,8,3,,,,,,,,,,
20150316-M-Indian_Wells_Masters-R32-Feliciano_Lopez-Pablo_Cuevas,1,B-DTL,1,0,0,0,0,1,0,,,,,,,,,,
20150316-M-Indian_Wells_Masters-R32-Feliciano_Lopez-Pablo_Cuevas,1,B-IO,6,0,0,0,0,1,5,,,,,,,,,,
20150316-M-Indian_Wells_Masters-R32-Feliciano_Lopez-Pablo_Cuevas,1,S-XC,21,5,0,2,3,12,9,,,,,,,,,,
20150316-M-Indian_Wells_Masters-R32-Feliciano_Lopez-Pablo_Cuevas,1,S-DTM,13,1,0,0,1,8,5,,,,,,,,,,
20150316-M-Indian_Wells_Masters-R32-Feliciano_Lopez-Pablo_Cuevas,1,S-DTL,12,2,0,1,1,10,2,,,,,,,,,,
20150316-M-Indian_Wells_Masters-R32-Feliciano_Lopez-Pablo_Cuevas,1,S-IO,6,1,0,1,0,4,2,,,,,,,,,,
20150316-M-Indian_Wells_Masters-R32-Feliciano_Lopez-Pablo_Cuevas,2,F-XC,52,10,3,3,4,22,30,,,,,,,,,,
20150316-M-Indian_Wells_Masters-R32-Feliciano_Lopez-Pablo_Cuevas,2,F-DTM,34,1,0,0,1,12,22,,,,,,,,,,
20150316-M-Indian_Wells_Masters-R32-Feliciano_Lopez-Pablo_Cuevas,2,F-DTL,7,3,2,1,0,5,2,,,,,,,,,,
20150316-M-Indian_Wells_Masters-R32-Feliciano_Lopez-Pablo_Cuevas,2,F-IO,29,12,6,1,5,15,14,,,,,,,,,,
20150316-M-Indian_Wells_Masters-R32-Feliciano_Lopez-Pablo_Cuevas,2,F-II,6,1,1,0,0,2,4,,,,,,,,,,
20150316-M-Indian_Wells_Masters-R32-Feliciano_Lopez-Pablo_Cuevas,2,B-XC,41,9,2,1,6,18,23,,,,,,,,,,
20150316-M-Indian_Wells_Masters-R32-Feliciano_Lopez-Pablo_Cuevas,2,B-DTM,28,4,0,0,4,13,15,,,,,,,,,,
20150316-M-Indian_Wells_Masters-R32-Feliciano_Lopez-Pablo_Cuevas,2,B-DTL,5,1,0,0,1,0,5,,,,,,,,,,
20150316-M-Indian_Wells_Masters-R32-Feliciano_Lopez-Pablo_Cuevas,2,B-IO,2,0,0,0,0,0,2,,,,,,,,,,
20150316-M-Indian_Wells_Masters-R32-Feliciano_Lopez-Pablo_Cuevas,2,S-XC,7,2,1,1,0,4,3,,,,,,,,,,
20150316-M-Indian_Wells_Masters-R32-Feliciano_Lopez-Pablo_Cuevas,2,S-DTM,13,0,0,0,0,8,5,,,,,,,,,,
20150316-M-Indian_Wells_Masters-R32-Feliciano_Lopez-Pablo_Cuevas,2,S-DTL,6,3,0,0,3,1,5,,,,,,,,,,
20150316-M-Indian_Wells_Masters-R32-Feliciano_Lopez-Pablo_Cuevas,2,S-IO,2,1,1,0,0,2,0,,,,,,,,,,
20150318-M-Indian_Wells_Masters-R16-Milos_Raonic-Tommy_Robredo,1,F-XC,16,11,4,5,2,11,5,,,,,,,,,,
20150318-M-Indian_Wells_Masters-R16-Milos_Raonic-Tommy_Robredo,1,F-DTM,11,3,1,1,1,6,5,,,,,,,,,,
20150318-M-Indian_Wells_Masters-R16-Milos_Raonic-Tommy_Robredo,1,F-DTL,6,3,1,1,1,3,3,,,,,,,,,,
20150318-M-Indian_Wells_Masters-R16-Milos_Raonic-Tommy_Robredo,1,F-IO,30,8,6,0,2,18,12,,,,,,,,,,
20150318-M-Indian_Wells_Masters-R16-Milos_Raonic-Tommy_Robredo,1,F-II,9,9,5,1,3,6,3,,,,,,,,,,
20150318-M-Indian_Wells_Masters-R16-Milos_Raonic-Tommy_Robredo,1,B-XC,5,1,0,0,1,3,2,,,,,,,,,,
20150318-M-Indian_Wells_Masters-R16-Milos_Raonic-Tommy_Robredo,1,B-DTM,6,1,0,0,1,1,5,,,,,,,,,,
20150318-M-Indian_Wells_Masters-R16-Milos_Raonic-Tommy_Robredo,1,B-DTL,3,3,1,0,2,1,2,,,,,,,,,,
20150318-M-Indian_Wells_Masters-R16-Milos_Raonic-Tommy_Robredo,1,B-IO,1,0,0,0,0,1,0,,,,,,,,,,
20150318-M-Indian_Wells_Masters-R16-Milos_Raonic-Tommy_Robredo,1,S-XC,5,2,0,1,1,2,3,,,,,,,,,,
20150318-M-Indian_Wells_Masters-R16-Milos_Raonic-Tommy_Robredo,1,S-IO,1,0,0,0,0,0,1,,,,,,,,,,
20150318-M-Indian_Wells_Masters-R16-Milos_Raonic-Tommy_Robredo,2,F-XC,9,1,1,0,0,5,4,,,,,,,,,,
20150318-M-Indian_Wells_Masters-R16-Milos_Raonic-Tommy_Robredo,2,F-DTM,11,1,0,0,1,8,3,,,,,,,,,,
20150318-M-Indian_Wells_Masters-R16-Milos_Raonic-Tommy_Robredo,2,F-DTL,3,1,1,0,0,3,0,,,,,,,,,,
20150318-M-Indian_Wells_Masters-R16-Milos_Raonic-Tommy_Robredo,2,F-IO,14,4,1,1,2,6,8,,,,,,,,,,
20150318-M-Indian_Wells_Masters-R16-Milos_Raonic-Tommy_Robredo,2,F-II,3,0,0,0,0,1,2,,,,,,,,,,
20150318-M-Indian_Wells_Masters-R16-Milos_Raonic-Tommy_Robredo,2,B-XC,7,0,0,0,0,3,4,,,,,,,,,,
20150318-M-Indian_Wells_Masters-R16-Milos_Raonic-Tommy_Robredo,2,B-DTM,15,1,0,0,1,9,6,,,,,,,,,,
20150318-M-Indian_Wells_Masters-R16-Milos_Raonic-Tommy_Robredo,2,B-DTL,3,1,1,0,0,2,1,,,,,,,,,,
20150318-M-Indian_Wells_Masters-R16-Milos_Raonic-Tommy_Robredo,2,B-IO,3,1,0,0,1,0,3,,,,,,,,,,
20150318-M-Indian_Wells_Masters-R16-Milos_Raonic-Tommy_Robredo,2,S-XC,8,1,0,0,1,2,6,,,,,,,,,,
20150318-M-Indian_Wells_Masters-R16-Milos_Raonic-Tommy_Robredo,2,S-DTM,7,0,0,0,0,3,4,,,,,,,,,,
20150320-M-Indian_Wells_Masters-QF-Tomas_Berdych-Roger_Federer,1,F-XC,26,7,2,1,4,11,15,,,,,,,,,,
20150320-M-Indian_Wells_Masters-QF-Tomas_Berdych-Roger_Federer,1,F-DTM,4,0,0,0,0,0,4,,,,,,,,,,
20150320-M-Indian_Wells_Masters-QF-Tomas_Berdych-Roger_Federer,1,F-DTL,4,0,0,0,0,1,3,,,,,,,,,,
20150320-M-Indian_Wells_Masters-QF-Tomas_Berdych-Roger_Federer,1,F-IO,34,9,3,2,4,15,19,,,,,,,,,,
20150320-M-Indian_Wells_Masters-QF-Tomas_Berdych-Roger_Federer,1,F-II,2,1,1,0,0,1,1,,,,,,,,,,
20150320-M-Indian_Wells_Masters-QF-Tomas_Berdych-Roger_Federer,1,B-XC,17,4,0,1,3,4,13,,,,,,,,,,
20150320-M-Indian_Wells_Masters-QF-Tomas_Berdych-Roger_Federer,1,B-DTM,9,0,0,0,0,0,9,,,,,,,,,,
20150320-M-Indian_Wells_Masters-QF-Tomas_Berdych-Roger_Federer,1,B-DTL,5,2,0,0,2,0,5,,,,,,,,,,
20150320-M-Indian_Wells_Masters-QF-Tomas_Berdych-Roger_Federer,1,B-IO,2,1,0,0,1,0,2,,,,,,,,,,
20150320-M-Indian_Wells_Masters-QF-Tomas_Berdych-Roger_Federer,1,S-XC,5,0,0,0,0,2,3,,,,,,,,,,
20150320-M-Indian_Wells_Masters-QF-Tomas_Berdych-Roger_Federer,2,F-XC,19,10,4,3,3,14,5,,,,,,,,,,
20150320-M-Indian_Wells_Masters-QF-Tomas_Berdych-Roger_Federer,2,F-DTM,9,1,0,0,1,6,3,,,,,,,,,,
20150320-M-Indian_Wells_Masters-QF-Tomas_Berdych-Roger_Federer,2,F-DTL,7,3,1,0,2,4,3,,,,,,,,,,
20150320-M-Indian_Wells_Masters-QF-Tomas_Berdych-Roger_Federer,2,F-IO,17,3,2,1,0,17,0,,,,,,,,,,
20150320-M-Indian_Wells_Masters-QF-Tomas_Berdych-Roger_Federer,2,F-II,7,2,2,0,0,3,4,,,,,,,,,,
20150320-M-Indian_Wells_Masters-QF-Tomas_Berdych-Roger_Federer,2,B-XC,9,1,0,0,1,7,2,,,,,,,,,,
20150320-M-Indian_Wells_Masters-QF-Tomas_Berdych-Roger_Federer,2,B-DTM,14,0,0,0,0,12,2,,,,,,,,,,
20150320-M-Indian_Wells_Masters-QF-Tomas_Berdych-Roger_Federer,2,B-DTL,9,5,1,2,2,7,2,,,,,,,,,,
20150320-M-Indian_Wells_Masters-QF-Tomas_Berdych-Roger_Federer,2,S-XC,5,1,0,0,1,1,4,,,,,,,,,,
20150320-M-Indian_Wells_Masters-QF-Tomas_Berdych-Roger_Federer,2,S-DTM,4,0,0,0,0,2,2,,,,,,,,,,
20150320-M-Indian_Wells_Masters-QF-Tomas_Berdych-Roger_Federer,2,S-DTL,1,0,0,0,0,1,0,,,,,,,,,,
20150320-M-Indian_Wells_Masters-QF-Tomas_Berdych-Roger_Federer,2,S-IO,1,0,0,0,0,1,0,,,,,,,,,,
20150320-M-Indian_Wells_Masters-QF-Tomas_Berdych-Roger_Federer,2,S-II,1,0,0,0,0,1,0,,,,,,,,,,
20150321-M-Indian_Wells_Masters-QF-Milos_Raonic-Rafael_Nadal,1,F-XC,65,18,4,5,9,35,30,,,,,,,,,,
20150321-M-Indian_Wells_Masters-QF-Milos_Raonic-Rafael_Nadal,1,F-DTM,20,0,0,0,0,10,10,,,,,,,,,,
20150321-M-Indian_Wells_Masters-QF-Milos_Raonic-Rafael_Nadal,1,F-DTL,12,9,2,0,7,4,8,,,,,,,,,,
20150321-M-Indian_Wells_Masters-QF-Milos_Raonic-Rafael_Nadal,1,F-IO,47,22,8,4,10,25,22,,,,,,,,,,
20150321-M-Indian_Wells_Masters-QF-Milos_Raonic-Rafael_Nadal,1,F-II,14,5,0,1,4,5,9,,,,,,,,,,
20150321-M-Indian_Wells_Masters-QF-Milos_Raonic-Rafael_Nadal,1,B-XC,19,10,1,1,8,6,13,,,,,,,,,,
20150321-M-Indian_Wells_Masters-QF-Milos_Raonic-Rafael_Nadal,1,B-DTM,18,4,0,0,4,6,12,,,,,,,,,,
20150321-M-Indian_Wells_Masters-QF-Milos_Raonic-Rafael_Nadal,1,B-DTL,6,1,0,0,1,1,5,,,,,,,,,,
20150321-M-Indian_Wells_Masters-QF-Milos_Raonic-Rafael_Nadal,1,S-XC,6,2,0,1,1,2,4,,,,,,,,,,
20150321-M-Indian_Wells_Masters-QF-Milos_Raonic-Rafael_Nadal,1,S-DTM,1,1,0,0,1,0,1,,,,,,,,,,
20150321-M-Indian_Wells_Masters-QF-Milos_Raonic-Rafael_Nadal,2,F-XC,47,7,1,3,3,30,17,,,,,,,,,,
20150321-M-Indian_Wells_Masters-QF-Milos_Raonic-Rafael_Nadal,2,F-DTM,21,3,0,0,3,10,11,,,,,,,,,,
20150321-M-Indian_Wells_Masters-QF-Milos_Raonic-Rafael_Nadal,2,F-DTL,17,12,6,2,4,10,7,,,,,,,,,,
20150321-M-Indian_Wells_Masters-QF-Milos_Raonic-Rafael_Nadal,2,F-IO,27,10,4,2,4,19,8,,,,,,,,,,
20150321-M-Indian_Wells_Masters-QF-Milos_Raonic-Rafael_Nadal,2,F-II,3,0,0,0,0,2,1,,,,,,,,,,
20150321-M-Indian_Wells_Masters-QF-Milos_Raonic-Rafael_Nadal,2,B-XC,16,5,0,1,4,5,11,,,,,,,,,,
20150321-M-Indian_Wells_Masters-QF-Milos_Raonic-Rafael_Nadal,2,B-DTM,19,1,0,0,1,10,9,,,,,,,,,,
20150321-M-Indian_Wells_Masters-QF-Milos_Raonic-Rafael_Nadal,2,B-DTL,10,2,0,1,1,6,4,,,,,,,,,,
20150321-M-Indian_Wells_Masters-QF-Milos_Raonic-Rafael_Nadal,2,B-IO,5,0,0,0,0,3,2,,,,,,,,,,
20150321-M-Indian_Wells_Masters-QF-Milos_Raonic-Rafael_Nadal,2,S-XC,6,0,0,0,0,3,3,,,,,,,,,,
20150321-M-Indian_Wells_Masters-QF-Milos_Raonic-Rafael_Nadal,2,S-DTM,18,0,0,0,0,10,8,,,,,,,,,,
20150321-M-Indian_Wells_Masters-QF-Milos_Raonic-Rafael_Nadal,2,S-DTL,9,1,0,0,1,3,6,,,,,,,,,,
20150321-M-Indian_Wells_Masters-QF-Milos_Raonic-Rafael_Nadal,2,S-IO,3,0,0,0,0,1,2,,,,,,,,,,
20150321-M-Indian_Wells_Masters-SF-Milos_Raonic-Roger_Federer,1,F-XC,22,8,4,1,3,11,11,,,,,,,,,,
20150321-M-Indian_Wells_Masters-SF-Milos_Raonic-Roger_Federer,1,F-DTM,8,2,0,0,2,2,6,,,,,,,,,,
20150321-M-Indian_Wells_Masters-SF-Milos_Raonic-Roger_Federer,1,F-DTL,7,3,0,2,1,3,4,,,,,,,,,,
20150321-M-Indian_Wells_Masters-SF-Milos_Raonic-Roger_Federer,1,F-IO,41,10,3,1,6,17,24,,,,,,,,,,
20150321-M-Indian_Wells_Masters-SF-Milos_Raonic-Roger_Federer,1,F-II,8,5,0,0,5,2,6,,,,,,,,,,
20150321-M-Indian_Wells_Masters-SF-Milos_Raonic-Roger_Federer,1,B-XC,12,2,1,0,1,3,9,,,,,,,,,,
20150321-M-Indian_Wells_Masters-SF-Milos_Raonic-Roger_Federer,1,B-DTM,7,3,1,0,2,2,5,,,,,,,,,,
20150321-M-Indian_Wells_Masters-SF-Milos_Raonic-Roger_Federer,1,B-DTL,1,1,0,0,1,0,1,,,,,,,,,,
20150321-M-Indian_Wells_Masters-SF-Milos_Raonic-Roger_Federer,1,B-IO,1,1,0,1,0,1,0,,,,,,,,,,
20150321-M-Indian_Wells_Masters-SF-Milos_Raonic-Roger_Federer,1,S-XC,10,4,1,0,3,3,7,,,,,,,,,,
20150321-M-Indian_Wells_Masters-SF-Milos_Raonic-Roger_Federer,1,S-DTL,1,1,0,0,1,0,1,,,,,,,,,,
20150321-M-Indian_Wells_Masters-SF-Milos_Raonic-Roger_Federer,2,F-XC,21,7,0,1,6,10,11,,,,,,,,,,
20150321-M-Indian_Wells_Masters-SF-Milos_Raonic-Roger_Federer,2,F-DTM,18,2,1,0,1,12,6,,,,,,,,,,
20150321-M-Indian_Wells_Masters-SF-Milos_Raonic-Roger_Federer,2,F-DTL,6,3,1,0,2,3,3,,,,,,,,,,
20150321-M-Indian_Wells_Masters-SF-Milos_Raonic-Roger_Federer,2,F-IO,14,5,1,2,2,11,3,,,,,,,,,,
20150321-M-Indian_Wells_Masters-SF-Milos_Raonic-Roger_Federer,2,F-II,1,1,0,0,1,0,1,,,,,,,,,,
20150321-M-Indian_Wells_Masters-SF-Milos_Raonic-Roger_Federer,2,B-XC,17,4,2,2,0,13,4,,,,,,,,,,
20150321-M-Indian_Wells_Masters-SF-Milos_Raonic-Roger_Federer,2,B-DTM,9,0,0,0,0,5,4,,,,,,,,,,
20150321-M-Indian_Wells_Masters-SF-Milos_Raonic-Roger_Federer,2,B-DTL,5,4,3,0,1,3,2,,,,,,,,,,
20150321-M-Indian_Wells_Masters-SF-Milos_Raonic-Roger_Federer,2,S-XC,13,1,0,0,1,7,6,,,,,,,,,,
20150321-M-Indian_Wells_Masters-SF-Milos_Raonic-Roger_Federer,2,S-DTM,4,0,0,0,0,2,2,,,,,,,,,,
20150321-M-Indian_Wells_Masters-SF-Milos_Raonic-Roger_Federer,2,S-DTL,4,0,0,0,0,3,1,,,,,,,,,,
20150325-M-Miami_Masters-R128-Diego_Sebastian_Schwartzman-Dominic_Thiem,1,F-XC,36,7,1,2,4,21,15,,,,,,,,,,
20150325-M-Miami_Masters-R128-Diego_Sebastian_Schwartzman-Dominic_Thiem,1,F-DTM,30,3,0,0,3,13,17,,,,,,,,,,
20150325-M-Miami_Masters-R128-Diego_Sebastian_Schwartzman-Dominic_Thiem,1,F-DTL,11,5,1,2,2,7,4,,,,,,,,,,
20150325-M-Miami_Masters-R128-Diego_Sebastian_Schwartzman-Dominic_Thiem,1,F-IO,36,14,3,1,10,18,18,,,,,,,,,,
20150325-M-Miami_Masters-R128-Diego_Sebastian_Schwartzman-Dominic_Thiem,1,F-II,2,0,0,0,0,1,1,,,,,,,,,,
20150325-M-Miami_Masters-R128-Diego_Sebastian_Schwartzman-Dominic_Thiem,1,B-XC,44,4,0,2,2,26,18,,,,,,,,,,
20150325-M-Miami_Masters-R128-Diego_Sebastian_Schwartzman-Dominic_Thiem,1,B-DTM,34,7,0,1,6,16,18,,,,,,,,,,
20150325-M-Miami_Masters-R128-Diego_Sebastian_Schwartzman-Dominic_Thiem,1,B-DTL,7,3,2,0,1,2,5,,,,,,,,,,
20150325-M-Miami_Masters-R128-Diego_Sebastian_Schwartzman-Dominic_Thiem,1,B-IO,8,6,0,2,4,3,5,,,,,,,,,,
20150325-M-Miami_Masters-R128-Diego_Sebastian_Schwartzman-Dominic_Thiem,1,S-XC,3,0,0,0,0,1,2,,,,,,,,,,
20150325-M-Miami_Masters-R128-Diego_Sebastian_Schwartzman-Dominic_Thiem,1,S-DTM,5,0,0,0,0,1,4,,,,,,,,,,
20150325-M-Miami_Masters-R128-Diego_Sebastian_Schwartzman-Dominic_Thiem,1,S-IO,1,0,0,0,0,1,0,,,,,,,,,,
20150325-M-Miami_Masters-R128-Diego_Sebastian_Schwartzman-Dominic_Thiem,2,F-XC,39,15,4,1,10,19,20,,,,,,,,,,
20150325-M-Miami_Masters-R128-Diego_Sebastian_Schwartzman-Dominic_Thiem,2,F-DTM,23,3,0,2,1,13,10,,,,,,,,,,
20150325-M-Miami_Masters-R128-Diego_Sebastian_Schwartzman-Dominic_Thiem,2,F-DTL,10,6,1,0,5,4,6,,,,,,,,,,
20150325-M-Miami_Masters-R128-Diego_Sebastian_Schwartzman-Dominic_Thiem,2,F-IO,27,9,2,2,5,10,17,,,,,,,,,,
20150325-M-Miami_Masters-R128-Diego_Sebastian_Schwartzman-Dominic_Thiem,2,F-II,3,1,1,0,0,1,2,,,,,,,,,,
20150325-M-Miami_Masters-R128-Diego_Sebastian_Schwartzman-Dominic_Thiem,2,B-XC,21,3,0,1,2,11,10,,,,,,,,,,
20150325-M-Miami_Masters-R128-Diego_Sebastian_Schwartzman-Dominic_Thiem,2,B-DTM,18,2,0,0,2,9,9,,,,,,,,,,
20150325-M-Miami_Masters-R128-Diego_Sebastian_Schwartzman-Dominic_Thiem,2,B-DTL,3,3,3,0,0,3,0,,,,,,,,,,
20150325-M-Miami_Masters-R128-Diego_Sebastian_Schwartzman-Dominic_Thiem,2,B-IO,2,1,0,0,1,0,2,,,,,,,,,,
20150325-M-Miami_Masters-R128-Diego_Sebastian_Schwartzman-Dominic_Thiem,2,S-XC,32,6,0,0,6,12,20,,,,,,,,,,
20150325-M-Miami_Masters-R128-Diego_Sebastian_Schwartzman-Dominic_Thiem,2,S-DTM,18,0,0,0,0,7,11,,,,,,,,,,
20150325-M-Miami_Masters-R128-Diego_Sebastian_Schwartzman-Dominic_Thiem,2,S-DTL,4,1,0,0,1,1,3,,,,,,,,,,
20150325-M-Miami_Masters-R128-Diego_Sebastian_Schwartzman-Dominic_Thiem,2,S-IO,2,0,0,0,0,0,2,,,,,,,,,,
20150325-M-Miami_Masters-R64-Vasek_Pospisil-Juan_Martin_Del_Potro,1,F-XC,18,7,2,2,3,8,10,,,,,,,,,,
20150325-M-Miami_Masters-R64-Vasek_Pospisil-Juan_Martin_Del_Potro,1,F-DTM,9,0,0,0,0,3,6,,,,,,,,,,
20150325-M-Miami_Masters-R64-Vasek_Pospisil-Juan_Martin_Del_Potro,1,F-DTL,12,2,0,0,2,5,7,,,,,,,,,,
20150325-M-Miami_Masters-R64-Vasek_Pospisil-Juan_Martin_Del_Potro,1,F-IO,43,8,0,3,5,29,14,,,,,,,,,,
20150325-M-Miami_Masters-R64-Vasek_Pospisil-Juan_Martin_Del_Potro,1,F-II,14,10,5,2,3,9,5,,,,,,,,,,
20150325-M-Miami_Masters-R64-Vasek_Pospisil-Juan_Martin_Del_Potro,1,B-XC,8,1,0,0,1,4,4,,,,,,,,,,
20150325-M-Miami_Masters-R64-Vasek_Pospisil-Juan_Martin_Del_Potro,1,B-DTM,6,2,0,0,2,0,6,,,,,,,,,,
20150325-M-Miami_Masters-R64-Vasek_Pospisil-Juan_Martin_Del_Potro,1,B-DTL,1,0,0,0,0,0,1,,,,,,,,,,
20150325-M-Miami_Masters-R64-Vasek_Pospisil-Juan_Martin_Del_Potro,1,S-XC,14,1,1,0,0,6,8,,,,,,,,,,
20150325-M-Miami_Masters-R64-Vasek_Pospisil-Juan_Martin_Del_Potro,1,S-DTM,4,0,0,0,0,0,4,,,,,,,,,,
20150325-M-Miami_Masters-R64-Vasek_Pospisil-Juan_Martin_Del_Potro,1,S-DTL,4,0,0,0,0,2,2,,,,,,,,,,
20150325-M-Miami_Masters-R64-Vasek_Pospisil-Juan_Martin_Del_Potro,2,F-XC,26,9,3,3,3,19,7,,,,,,,,,,
20150325-M-Miami_Masters-R64-Vasek_Pospisil-Juan_Martin_Del_Potro,2,F-DTM,16,0,0,0,0,7,9,,,,,,,,,,
20150325-M-Miami_Masters-R64-Vasek_Pospisil-Juan_Martin_Del_Potro,2,F-DTL,6,2,0,0,2,3,3,,,,,,,,,,
20150325-M-Miami_Masters-R64-Vasek_Pospisil-Juan_Martin_Del_Potro,2,F-IO,35,7,1,3,3,24,11,,,,,,,,,,
20150325-M-Miami_Masters-R64-Vasek_Pospisil-Juan_Martin_Del_Potro,2,F-II,8,2,0,1,1,6,2,,,,,,,,,,
20150325-M-Miami_Masters-R64-Vasek_Pospisil-Juan_Martin_Del_Potro,2,B-XC,8,0,0,0,0,3,5,,,,,,,,,,
20150325-M-Miami_Masters-R64-Vasek_Pospisil-Juan_Martin_Del_Potro,2,B-DTM,6,0,0,0,0,0,6,,,,,,,,,,
20150325-M-Miami_Masters-R64-Vasek_Pospisil-Juan_Martin_Del_Potro,2,B-DTL,2,0,0,0,0,0,2,,,,,,,,,,
20150325-M-Miami_Masters-R64-Vasek_Pospisil-Juan_Martin_Del_Potro,2,S-XC,27,2,0,0,2,11,16,,,,,,,,,,
20150325-M-Miami_Masters-R64-Vasek_Pospisil-Juan_Martin_Del_Potro,2,S-DTM,3,0,0,0,0,0,3,,,,,,,,,,
20150325-M-Miami_Masters-R64-Vasek_Pospisil-Juan_Martin_Del_Potro,2,S-DTL,2,0,0,0,0,0,2,,,,,,,,,,
20150328-M-Miami_Masters-R64-Mikhail_Youzhny-Kei_Nishikori,1,F-XC,13,3,1,1,1,9,4,,,,,,,,,,
20150328-M-Miami_Masters-R64-Mikhail_Youzhny-Kei_Nishikori,1,F-DTM,14,3,0,0,3,3,11,,,,,,,,,,
20150328-M-Miami_Masters-R64-Mikhail_Youzhny-Kei_Nishikori,1,F-DTL,12,5,1,1,3,5,7,,,,,,,,,,
20150328-M-Miami_Masters-R64-Mikhail_Youzhny-Kei_Nishikori,1,F-IO,12,3,0,2,1,6,6,,,,,,,,,,
20150328-M-Miami_Masters-R64-Mikhail_Youzhny-Kei_Nishikori,1,B-XC,33,2,0,0,2,11,22,,,,,,,,,,
20150328-M-Miami_Masters-R64-Mikhail_Youzhny-Kei_Nishikori,1,B-DTM,12,4,0,0,4,1,11,,,,,,,,,,
20150328-M-Miami_Masters-R64-Mikhail_Youzhny-Kei_Nishikori,1,B-DTL,16,9,1,0,8,3,13,,,,,,,,,,
20150328-M-Miami_Masters-R64-Mikhail_Youzhny-Kei_Nishikori,1,B-IO,1,1,0,0,1,0,1,,,,,,,,,,
20150328-M-Miami_Masters-R64-Mikhail_Youzhny-Kei_Nishikori,1,S-XC,15,3,0,1,2,6,9,,,,,,,,,,
20150328-M-Miami_Masters-R64-Mikhail_Youzhny-Kei_Nishikori,1,S-DTM,6,1,0,0,1,2,4,,,,,,,,,,
20150328-M-Miami_Masters-R64-Mikhail_Youzhny-Kei_Nishikori,1,S-DTL,5,1,0,0,1,1,4,,,,,,,,,,
20150328-M-Miami_Masters-R64-Mikhail_Youzhny-Kei_Nishikori,2,F-XC,16,3,1,1,1,9,7,,,,,,,,,,
20150328-M-Miami_Masters-R64-Mikhail_Youzhny-Kei_Nishikori,2,F-DTM,12,2,0,0,2,5,7,,,,,,,,,,
20150328-M-Miami_Masters-R64-Mikhail_Youzhny-Kei_Nishikori,2,F-DTL,7,2,0,2,0,6,1,,,,,,,,,,
20150328-M-Miami_Masters-R64-Mikhail_Youzhny-Kei_Nishikori,2,F-IO,16,2,2,0,0,14,2,,,,,,,,,,
20150328-M-Miami_Masters-R64-Mikhail_Youzhny-Kei_Nishikori,2,F-II,1,1,0,1,0,1,0,,,,,,,,,,
20150328-M-Miami_Masters-R64-Mikhail_Youzhny-Kei_Nishikori,2,B-XC,50,9,3,1,5,32,18,,,,,,,,,,
20150328-M-Miami_Masters-R64-Mikhail_Youzhny-Kei_Nishikori,2,B-DTM,10,0,0,0,0,7,3,,,,,,,,,,
20150328-M-Miami_Masters-R64-Mikhail_Youzhny-Kei_Nishikori,2,B-DTL,4,2,0,1,1,2,2,,,,,,,,,,
20150328-M-Miami_Masters-R64-Mikhail_Youzhny-Kei_Nishikori,2,B-IO,2,0,0,0,0,1,1,,,,,,,,,,
20150328-M-Miami_Masters-R64-Mikhail_Youzhny-Kei_Nishikori,2,S-XC,8,3,0,0,3,3,5,,,,,,,,,,
20150328-M-Miami_Masters-R64-Mikhail_Youzhny-Kei_Nishikori,2,S-DTM,1,0,0,0,0,0,1,,,,,,,,,,
20150328-M-Miami_Masters-R64-Tim_Smyczek-Jo_Wilfried_Tsonga,1,F-XC,27,10,3,2,5,13,14,,,,,,,,,,
20150328-M-Miami_Masters-R64-Tim_Smyczek-Jo_Wilfried_Tsonga,1,F-DTM,34,2,0,1,1,20,14,,,,,,,,,,
20150328-M-Miami_Masters-R64-Tim_Smyczek-Jo_Wilfried_Tsonga,1,F-DTL,14,6,2,2,2,8,6,,,,,,,,,,
20150328-M-Miami_Masters-R64-Tim_Smyczek-Jo_Wilfried_Tsonga,1,F-IO,52,4,1,1,2,29,23,,,,,,,,,,
20150328-M-Miami_Masters-R64-Tim_Smyczek-Jo_Wilfried_Tsonga,1,F-II,3,3,1,0,2,1,2,,,,,,,,,,
20150328-M-Miami_Masters-R64-Tim_Smyczek-Jo_Wilfried_Tsonga,1,B-XC,44,8,1,1,6,18,26,,,,,,,,,,
20150328-M-Miami_Masters-R64-Tim_Smyczek-Jo_Wilfried_Tsonga,1,B-DTM,21,3,0,0,3,6,15,,,,,,,,,,
20150328-M-Miami_Masters-R64-Tim_Smyczek-Jo_Wilfried_Tsonga,1,B-DTL,8,5,1,1,3,4,4,,,,,,,,,,
20150328-M-Miami_Masters-R64-Tim_Smyczek-Jo_Wilfried_Tsonga,1,B-IO,6,4,0,1,3,2,4,,,,,,,,,,
20150328-M-Miami_Masters-R64-Tim_Smyczek-Jo_Wilfried_Tsonga,1,S-DTM,4,1,0,0,1,1,3,,,,,,,,,,
20150328-M-Miami_Masters-R64-Tim_Smyczek-Jo_Wilfried_Tsonga,1,S-DTL,1,1,1,0,0,1,0,,,,,,,,,,
20150328-M-Miami_Masters-R64-Tim_Smyczek-Jo_Wilfried_Tsonga,2,F-XC,36,10,3,1,6,20,16,,,,,,,,,,
20150328-M-Miami_Masters-R64-Tim_Smyczek-Jo_Wilfried_Tsonga,2,F-DTM,21,2,0,1,1,10,11,,,,,,,,,,
20150328-M-Miami_Masters-R64-Tim_Smyczek-Jo_Wilfried_Tsonga,2,F-DTL,6,2,1,1,0,4,2,,,,,,,,,,
20150328-M-Miami_Masters-R64-Tim_Smyczek-Jo_Wilfried_Tsonga,2,F-IO,25,4,0,1,3,18,7,,,,,,,,,,
20150328-M-Miami_Masters-R64-Tim_Smyczek-Jo_Wilfried_Tsonga,2,F-II,6,4,1,2,1,4,2,,,,,,,,,,
20150328-M-Miami_Masters-R64-Tim_Smyczek-Jo_Wilfried_Tsonga,2,B-XC,31,1,1,0,0,20,11,,,,,,,,,,
20150328-M-Miami_Masters-R64-Tim_Smyczek-Jo_Wilfried_Tsonga,2,B-DTM,18,0,0,0,0,6,12,,,,,,,,,,
20150328-M-Miami_Masters-R64-Tim_Smyczek-Jo_Wilfried_Tsonga,2,B-DTL,12,10,3,1,6,4,8,,,,,,,,,,
20150328-M-Miami_Masters-R64-Tim_Smyczek-Jo_Wilfried_Tsonga,2,B-IO,3,2,1,0,1,1,2,,,,,,,,,,
20150328-M-Miami_Masters-R64-Tim_Smyczek-Jo_Wilfried_Tsonga,2,S-XC,21,3,0,1,2,10,11,,,,,,,,,,
20150328-M-Miami_Masters-R64-Tim_Smyczek-Jo_Wilfried_Tsonga,2,S-DTM,16,3,0,1,2,10,6,,,,,,,,,,
20150328-M-Miami_Masters-R64-Tim_Smyczek-Jo_Wilfried_Tsonga,2,S-DTL,4,1,0,0,1,0,4,,,,,,,,,,
20150329-M-Miami_Masters-R32-Leonardo_Mayer-Kevin_Anderson,1,F-XC,28,9,3,1,5,17,11,,,,,,,,,,
20150329-M-Miami_Masters-R32-Leonardo_Mayer-Kevin_Anderson,1,F-DTM,14,2,0,0,2,8,6,,,,,,,,,,
20150329-M-Miami_Masters-R32-Leonardo_Mayer-Kevin_Anderson,1,F-DTL,6,3,1,0,2,3,3,,,,,,,,,,
20150329-M-Miami_Masters-R32-Leonardo_Mayer-Kevin_Anderson,1,F-IO,22,8,1,3,4,12,10,,,,,,,,,,
20150329-M-Miami_Masters-R32-Leonardo_Mayer-Kevin_Anderson,1,F-II,1,0,0,0,0,1,0,,,,,,,,,,
20150329-M-Miami_Masters-R32-Leonardo_Mayer-Kevin_Anderson,1,B-XC,26,3,0,0,3,13,13,,,,,,,,,,
20150329-M-Miami_Masters-R32-Leonardo_Mayer-Kevin_Anderson,1,B-DTM,13,2,0,0,2,8,5,,,,,,,,,,
20150329-M-Miami_Masters-R32-Leonardo_Mayer-Kevin_Anderson,1,B-DTL,4,3,2,0,1,3,1,,,,,,,,,,
20150329-M-Miami_Masters-R32-Leonardo_Mayer-Kevin_Anderson,1,S-XC,3,0,0,0,0,2,1,,,,,,,,,,
20150329-M-Miami_Masters-R32-Leonardo_Mayer-Kevin_Anderson,1,S-DTM,2,1,0,1,0,2,0,,,,,,,,,,
20150329-M-Miami_Masters-R32-Leonardo_Mayer-Kevin_Anderson,1,S-DTL,2,1,0,1,0,2,0,,,,,,,,,,
20150329-M-Miami_Masters-R32-Leonardo_Mayer-Kevin_Anderson,2,F-XC,26,13,2,5,6,12,14,,,,,,,,,,
20150329-M-Miami_Masters-R32-Leonardo_Mayer-Kevin_Anderson,2,F-DTM,9,0,0,0,0,3,6,,,,,,,,,,
20150329-M-Miami_Masters-R32-Leonardo_Mayer-Kevin_Anderson,2,F-DTL,5,2,0,0,2,1,4,,,,,,,,,,
20150329-M-Miami_Masters-R32-Leonardo_Mayer-Kevin_Anderson,2,F-IO,19,6,2,1,3,9,10,,,,,,,,,,
20150329-M-Miami_Masters-R32-Leonardo_Mayer-Kevin_Anderson,2,F-II,3,1,0,0,1,1,2,,,,,,,,,,
20150329-M-Miami_Masters-R32-Leonardo_Mayer-Kevin_Anderson,2,B-XC,25,1,0,0,1,13,12,,,,,,,,,,
20150329-M-Miami_Masters-R32-Leonardo_Mayer-Kevin_Anderson,2,B-DTM,13,2,0,1,1,6,7,,,,,,,,,,
20150329-M-Miami_Masters-R32-Leonardo_Mayer-Kevin_Anderson,2,B-DTL,4,2,1,0,1,1,3,,,,,,,,,,
20150329-M-Miami_Masters-R32-Leonardo_Mayer-Kevin_Anderson,2,B-IO,2,1,0,0,1,0,2,,,,,,,,,,
20150329-M-Miami_Masters-R32-Leonardo_Mayer-Kevin_Anderson,2,S-XC,5,0,0,0,0,2,3,,,,,,,,,,
20150329-M-Miami_Masters-R32-Leonardo_Mayer-Kevin_Anderson,2,S-DTM,3,0,0,0,0,0,3,,,,,,,,,,
20150329-M-Miami_Masters-R32-Leonardo_Mayer-Kevin_Anderson,2,S-DTL,2,0,0,0,0,0,2,,,,,,,,,,
20150330-M-Miami_Masters-R32-Viktor_Troicki-Kei_Nishikori,1,F-XC,10,2,0,0,2,4,6,,,,,,,,,,
20150330-M-Miami_Masters-R32-Viktor_Troicki-Kei_Nishikori,1,F-DTM,15,0,0,0,0,8,7,,,,,,,,,,
20150330-M-Miami_Masters-R32-Viktor_Troicki-Kei_Nishikori,1,F-DTL,6,0,0,0,0,1,5,,,,,,,,,,
20150330-M-Miami_Masters-R32-Viktor_Troicki-Kei_Nishikori,1,F-IO,4,1,0,0,1,2,2,,,,,,,,,,
20150330-M-Miami_Masters-R32-Viktor_Troicki-Kei_Nishikori,1,B-XC,44,9,0,1,8,11,33,,,,,,,,,,
20150330-M-Miami_Masters-R32-Viktor_Troicki-Kei_Nishikori,1,B-DTM,20,3,0,0,3,4,16,,,,,,,,,,
20150330-M-Miami_Masters-R32-Viktor_Troicki-Kei_Nishikori,1,B-DTL,13,8,0,1,7,2,11,,,,,,,,,,
20150330-M-Miami_Masters-R32-Viktor_Troicki-Kei_Nishikori,1,B-IO,5,2,0,0,2,1,4,,,,,,,,,,
20150330-M-Miami_Masters-R32-Viktor_Troicki-Kei_Nishikori,1,S-XC,2,0,0,0,0,0,2,,,,,,,,,,
20150330-M-Miami_Masters-R32-Viktor_Troicki-Kei_Nishikori,1,S-DTM,1,0,0,0,0,0,1,,,,,,,,,,
20150330-M-Miami_Masters-R32-Viktor_Troicki-Kei_Nishikori,1,S-DTL,2,1,0,0,1,0,2,,,,,,,,,,
20150330-M-Miami_Masters-R32-Viktor_Troicki-Kei_Nishikori,2,F-XC,22,6,0,1,5,11,11,,,,,,,,,,
20150330-M-Miami_Masters-R32-Viktor_Troicki-Kei_Nishikori,2,F-DTM,7,0,0,0,0,4,3,,,,,,,,,,
20150330-M-Miami_Masters-R32-Viktor_Troicki-Kei_Nishikori,2,F-DTL,9,2,1,0,1,7,2,,,,,,,,,,
20150330-M-Miami_Masters-R32-Viktor_Troicki-Kei_Nishikori,2,F-IO,16,2,0,0,2,12,4,,,,,,,,,,
20150330-M-Miami_Masters-R32-Viktor_Troicki-Kei_Nishikori,2,F-II,1,0,0,0,0,1,0,,,,,,,,,,
20150330-M-Miami_Masters-R32-Viktor_Troicki-Kei_Nishikori,2,B-XC,35,4,0,1,3,26,9,,,,,,,,,,
20150330-M-Miami_Masters-R32-Viktor_Troicki-Kei_Nishikori,2,B-DTM,7,0,0,0,0,5,2,,,,,,,,,,
20150330-M-Miami_Masters-R32-Viktor_Troicki-Kei_Nishikori,2,B-DTL,8,1,1,0,0,5,3,,,,,,,,,,
20150330-M-Miami_Masters-R32-Viktor_Troicki-Kei_Nishikori,2,B-IO,3,2,2,0,0,3,0,,,,,,,,,,
20150330-M-Miami_Masters-R32-Viktor_Troicki-Kei_Nishikori,2,S-XC,6,0,0,0,0,6,0,,,,,,,,,,
20150330-M-Miami_Masters-R32-Viktor_Troicki-Kei_Nishikori,2,S-DTL,1,0,0,0,0,0,1,,,,,,,,,,
20150331-M-San_Luis_Potosi_CH-R32-Giovanni_Lapentti-Chase_Buchanan,1,F-XC,30,8,2,3,3,19,11,,,,,,,,,,
20150331-M-San_Luis_Potosi_CH-R32-Giovanni_Lapentti-Chase_Buchanan,1,F-DTM,8,0,0,0,0,5,3,,,,,,,,,,
20150331-M-San_Luis_Potosi_CH-R32-Giovanni_Lapentti-Chase_Buchanan,1,F-DTL,11,2,0,1,1,7,4,,,,,,,,,,
20150331-M-San_Luis_Potosi_CH-R32-Giovanni_Lapentti-Chase_Buchanan,1,F-IO,27,10,1,6,3,15,12,,,,,,,,,,
20150331-M-San_Luis_Potosi_CH-R32-Giovanni_Lapentti-Chase_Buchanan,1,F-II,4,1,0,1,0,4,0,,,,,,,,,,
20150331-M-San_Luis_Potosi_CH-R32-Giovanni_Lapentti-Chase_Buchanan,1,B-XC,27,3,0,2,1,16,11,,,,,,,,,,
20150331-M-San_Luis_Potosi_CH-R32-Giovanni_Lapentti-Chase_Buchanan,1,B-DTM,13,1,0,0,1,4,9,,,,,,,,,,
20150331-M-San_Luis_Potosi_CH-R32-Giovanni_Lapentti-Chase_Buchanan,1,B-DTL,9,3,0,2,1,4,5,,,,,,,,,,
20150331-M-San_Luis_Potosi_CH-R32-Giovanni_Lapentti-Chase_Buchanan,1,B-IO,2,0,0,0,0,2,0,,,,,,,,,,
20150331-M-San_Luis_Potosi_CH-R32-Giovanni_Lapentti-Chase_Buchanan,1,S-XC,5,1,0,1,0,4,1,,,,,,,,,,
20150331-M-San_Luis_Potosi_CH-R32-Giovanni_Lapentti-Chase_Buchanan,1,S-DTM,1,0,0,0,0,0,1,,,,,,,,,,
20150331-M-San_Luis_Potosi_CH-R32-Giovanni_Lapentti-Chase_Buchanan,1,S-DTL,1,0,0,0,0,1,0,,,,,,,,,,
20150331-M-San_Luis_Potosi_CH-R32-Giovanni_Lapentti-Chase_Buchanan,1,S-IO,1,1,0,0,1,0,1,,,,,,,,,,
20150331-M-San_Luis_Potosi_CH-R32-Giovanni_Lapentti-Chase_Buchanan,1,S-II,1,0,0,0,0,0,1,,,,,,,,,,
20150331-M-San_Luis_Potosi_CH-R32-Giovanni_Lapentti-Chase_Buchanan,2,F-XC,25,9,1,1,7,7,18,,,,,,,,,,
20150331-M-San_Luis_Potosi_CH-R32-Giovanni_Lapentti-Chase_Buchanan,2,F-DTM,15,1,0,0,1,7,8,,,,,,,,,,
20150331-M-San_Luis_Potosi_CH-R32-Giovanni_Lapentti-Chase_Buchanan,2,F-DTL,5,2,1,0,1,1,4,,,,,,,,,,
20150331-M-San_Luis_Potosi_CH-R32-Giovanni_Lapentti-Chase_Buchanan,2,F-IO,12,3,2,0,1,8,4,,,,,,,,,,
20150331-M-San_Luis_Potosi_CH-R32-Giovanni_Lapentti-Chase_Buchanan,2,B-XC,24,7,1,3,3,12,12,,,,,,,,,,
20150331-M-San_Luis_Potosi_CH-R32-Giovanni_Lapentti-Chase_Buchanan,2,B-DTM,17,2,0,0,2,5,12,,,,,,,,,,
20150331-M-San_Luis_Potosi_CH-R32-Giovanni_Lapentti-Chase_Buchanan,2,B-DTL,11,3,1,0,2,6,5,,,,,,,,,,
20150331-M-San_Luis_Potosi_CH-R32-Giovanni_Lapentti-Chase_Buchanan,2,B-IO,2,0,0,0,0,2,0,,,,,,,,,,
20150331-M-San_Luis_Potosi_CH-R32-Giovanni_Lapentti-Chase_Buchanan,2,S-XC,16,1,0,0,1,4,12,,,,,,,,,,
20150331-M-San_Luis_Potosi_CH-R32-Giovanni_Lapentti-Chase_Buchanan,2,S-DTM,4,0,0,0,0,1,3,,,,,,,,,,
20150331-M-San_Luis_Potosi_CH-R32-Giovanni_Lapentti-Chase_Buchanan,2,S-DTL,2,0,0,0,0,0,2,,,,,,,,,,
20150401-M-Miami_Masters-QF-Dominic_Thiem-Andy_Murray,1,F-XC,35,10,3,0,7,20,15,,,,,,,,,,
20150401-M-Miami_Masters-QF-Dominic_Thiem-Andy_Murray,1,F-DTM,23,4,1,0,3,8,15,,,,,,,,,,
20150401-M-Miami_Masters-QF-Dominic_Thiem-Andy_Murray,1,F-DTL,9,4,1,1,2,6,3,,,,,,,,,,
20150401-M-Miami_Masters-QF-Dominic_Thiem-Andy_Murray,1,F-IO,31,10,4,3,3,15,16,,,,,,,,,,
20150401-M-Miami_Masters-QF-Dominic_Thiem-Andy_Murray,1,F-II,1,1,1,0,0,1,0,,,,,,,,,,
20150401-M-Miami_Masters-QF-Dominic_Thiem-Andy_Murray,1,B-XC,24,3,0,0,3,10,14,,,,,,,,,,
20150401-M-Miami_Masters-QF-Dominic_Thiem-Andy_Murray,1,B-DTM,19,3,1,0,2,9,10,,,,,,,,,,
20150401-M-Miami_Masters-QF-Dominic_Thiem-Andy_Murray,1,B-DTL,8,5,1,1,3,4,4,,,,,,,,,,
20150401-M-Miami_Masters-QF-Dominic_Thiem-Andy_Murray,1,B-IO,1,1,0,0,1,0,1,,,,,,,,,,
20150401-M-Miami_Masters-QF-Dominic_Thiem-Andy_Murray,1,S-XC,22,2,0,0,2,6,16,,,,,,,,,,
20150401-M-Miami_Masters-QF-Dominic_Thiem-Andy_Murray,1,S-DTM,9,0,0,0,0,3,6,,,,,,,,,,
20150401-M-Miami_Masters-QF-Dominic_Thiem-Andy_Murray,1,S-DTL,1,0,0,0,0,1,0,,,,,,,,,,
20150401-M-Miami_Masters-QF-Dominic_Thiem-Andy_Murray,1,S-IO,2,0,0,0,0,2,0,,,,,,,,,,
20150401-M-Miami_Masters-QF-Dominic_Thiem-Andy_Murray,2,F-XC,27,7,0,1,6,7,20,,,,,,,,,,
20150401-M-Miami_Masters-QF-Dominic_Thiem-Andy_Murray,2,F-DTM,25,4,0,0,4,11,14,,,,,,,,,,
20150401-M-Miami_Masters-QF-Dominic_Thiem-Andy_Murray,2,F-DTL,8,3,1,1,1,4,4,,,,,,,,,,
20150401-M-Miami_Masters-QF-Dominic_Thiem-Andy_Murray,2,F-IO,26,7,4,2,1,18,8,,,,,,,,,,
20150401-M-Miami_Masters-QF-Dominic_Thiem-Andy_Murray,2,F-II,5,2,0,1,1,4,1,,,,,,,,,,
20150401-M-Miami_Masters-QF-Dominic_Thiem-Andy_Murray,2,B-XC,33,1,1,0,0,19,14,,,,,,,,,,
20150401-M-Miami_Masters-QF-Dominic_Thiem-Andy_Murray,2,B-DTM,25,2,0,1,1,18,7,,,,,,,,,,
20150401-M-Miami_Masters-QF-Dominic_Thiem-Andy_Murray,2,B-DTL,6,4,0,1,3,3,3,,,,,,,,,,
20150401-M-Miami_Masters-QF-Dominic_Thiem-Andy_Murray,2,B-IO,8,4,1,0,3,4,4,,,,,,,,,,
20150401-M-Miami_Masters-QF-Dominic_Thiem-Andy_Murray,2,S-DTM,8,0,0,0,0,3,5,,,,,,,,,,
20150401-M-Miami_Masters-QF-Dominic_Thiem-Andy_Murray,2,S-DTL,1,0,0,0,0,0,1,,,,,,,,,,
20150405-M-Miami_Masters-F-Novak_Djokovic-Andy_Murray,1,F-XC,50,12,6,0,6,27,23,,,,,,,,,,
20150405-M-Miami_Masters-F-Novak_Djokovic-Andy_Murray,1,F-DTM,37,1,0,0,1,24,13,,,,,,,,,,
20150405-M-Miami_Masters-F-Novak_Djokovic-Andy_Murray,1,F-DTL,35,9,2,2,5,16,19,,,,,,,,,,
20150405-M-Miami_Masters-F-Novak_Djokovic-Andy_Murray,1,F-IO,19,5,3,2,0,14,5,,,,,,,,,,
20150405-M-Miami_Masters-F-Novak_Djokovic-Andy_Murray,1,F-II,4,3,1,2,0,3,1,,,,,,,,,,
20150405-M-Miami_Masters-F-Novak_Djokovic-Andy_Murray,1,B-XC,71,6,2,3,1,36,35,,,,,,,,,,
20150405-M-Miami_Masters-F-Novak_Djokovic-Andy_Murray,1,B-DTM,61,4,0,2,2,35,26,,,,,,,,,,
20150405-M-Miami_Masters-F-Novak_Djokovic-Andy_Murray,1,B-DTL,26,8,2,0,6,12,14,,,,,,,,,,
20150405-M-Miami_Masters-F-Novak_Djokovic-Andy_Murray,1,B-IO,9,2,0,0,2,3,6,,,,,,,,,,
20150405-M-Miami_Masters-F-Novak_Djokovic-Andy_Murray,1,S-XC,25,0,0,0,0,6,19,,,,,,,,,,
20150405-M-Miami_Masters-F-Novak_Djokovic-Andy_Murray,1,S-DTM,11,0,0,0,0,6,5,,,,,,,,,,
20150405-M-Miami_Masters-F-Novak_Djokovic-Andy_Murray,1,S-DTL,3,0,0,0,0,2,1,,,,,,,,,,
20150405-M-Miami_Masters-F-Novak_Djokovic-Andy_Murray,1,S-IO,3,0,0,0,0,2,1,,,,,,,,,,
20150405-M-Miami_Masters-F-Novak_Djokovic-Andy_Murray,2,F-XC,86,10,4,2,4,45,41,,,,,,,,,,
20150405-M-Miami_Masters-F-Novak_Djokovic-Andy_Murray,2,F-DTM,26,1,0,0,1,8,18,,,,,,,,,,
20150405-M-Miami_Masters-F-Novak_Djokovic-Andy_Murray,2,F-DTL,22,5,2,1,2,12,10,,,,,,,,,,
20150405-M-Miami_Masters-F-Novak_Djokovic-Andy_Murray,2,F-IO,36,5,0,1,4,13,23,,,,,,,,,,
20150405-M-Miami_Masters-F-Novak_Djokovic-Andy_Murray,2,F-II,2,0,0,0,0,1,1,,,,,,,,,,
20150405-M-Miami_Masters-F-Novak_Djokovic-Andy_Murray,2,B-XC,116,23,2,8,13,61,55,,,,,,,,,,
20150405-M-Miami_Masters-F-Novak_Djokovic-Andy_Murray,2,B-DTM,26,5,0,2,3,11,15,,,,,,,,,,
20150405-M-Miami_Masters-F-Novak_Djokovic-Andy_Murray,2,B-DTL,17,3,1,1,1,10,7,,,,,,,,,,
20150405-M-Miami_Masters-F-Novak_Djokovic-Andy_Murray,2,B-IO,15,6,1,0,5,4,11,,,,,,,,,,
20150405-M-Miami_Masters-F-Novak_Djokovic-Andy_Murray,2,S-XC,14,0,0,0,0,7,7,,,,,,,,,,
20150405-M-Miami_Masters-F-Novak_Djokovic-Andy_Murray,2,S-DTM,9,0,0,0,0,7,2,,,,,,,,,,
20150405-M-Miami_Masters-F-Novak_Djokovic-Andy_Murray,2,S-DTL,1,1,1,0,0,1,0,,,,,,,,,,
20150406-M-Casablanca-R32-Carlos_Berlocq-Pablo_Carreno_Busta,1,F-XC,71,14,6,4,4,42,29,,,,,,,,,,
20150406-M-Casablanca-R32-Carlos_Berlocq-Pablo_Carreno_Busta,1,F-DTM,38,0,0,0,0,17,21,,,,,,,,,,
20150406-M-Casablanca-R32-Carlos_Berlocq-Pablo_Carreno_Busta,1,F-DTL,35,6,2,3,1,17,18,,,,,,,,,,
20150406-M-Casablanca-R32-Carlos_Berlocq-Pablo_Carreno_Busta,1,F-IO,62,9,2,2,5,36,26,,,,,,,,,,
20150406-M-Casablanca-R32-Carlos_Berlocq-Pablo_Carreno_Busta,1,F-II,15,6,2,2,2,10,5,,,,,,,,,,
20150406-M-Casablanca-R32-Carlos_Berlocq-Pablo_Carreno_Busta,1,B-XC,87,6,0,1,5,39,48,,,,,,,,,,
20150406-M-Casablanca-R32-Carlos_Berlocq-Pablo_Carreno_Busta,1,B-DTM,37,0,0,0,0,15,22,,,,,,,,,,
20150406-M-Casablanca-R32-Carlos_Berlocq-Pablo_Carreno_Busta,1,B-DTL,28,13,7,2,4,19,9,,,,,,,,,,
20150406-M-Casablanca-R32-Carlos_Berlocq-Pablo_Carreno_Busta,1,B-IO,3,2,2,0,0,3,0,,,,,,,,,,
20150406-M-Casablanca-R32-Carlos_Berlocq-Pablo_Carreno_Busta,1,S-XC,11,0,0,0,0,8,3,,,,,,,,,,
20150406-M-Casablanca-R32-Carlos_Berlocq-Pablo_Carreno_Busta,1,S-DTM,10,0,0,0,0,3,7,,,,,,,,,,
20150406-M-Casablanca-R32-Carlos_Berlocq-Pablo_Carreno_Busta,1,S-DTL,2,0,0,0,0,2,0,,,,,,,,,,
20150406-M-Casablanca-R32-Carlos_Berlocq-Pablo_Carreno_Busta,2,F-XC,87,24,9,6,9,43,44,,,,,,,,,,
20150406-M-Casablanca-R32-Carlos_Berlocq-Pablo_Carreno_Busta,2,F-DTM,33,4,0,0,4,13,20,,,,,,,,,,
20150406-M-Casablanca-R32-Carlos_Berlocq-Pablo_Carreno_Busta,2,F-DTL,25,8,3,2,3,13,12,,,,,,,,,,
20150406-M-Casablanca-R32-Carlos_Berlocq-Pablo_Carreno_Busta,2,F-IO,67,19,11,1,7,35,32,,,,,,,,,,
20150406-M-Casablanca-R32-Carlos_Berlocq-Pablo_Carreno_Busta,2,F-II,11,7,6,1,0,8,3,,,,,,,,,,
20150406-M-Casablanca-R32-Carlos_Berlocq-Pablo_Carreno_Busta,2,B-XC,108,15,5,1,9,56,52,,,,,,,,,,
20150406-M-Casablanca-R32-Carlos_Berlocq-Pablo_Carreno_Busta,2,B-DTM,49,2,0,0,2,22,27,,,,,,,,,,
20150406-M-Casablanca-R32-Carlos_Berlocq-Pablo_Carreno_Busta,2,B-DTL,32,18,9,2,7,20,12,,,,,,,,,,
20150406-M-Casablanca-R32-Carlos_Berlocq-Pablo_Carreno_Busta,2,B-IO,5,3,2,0,1,4,1,,,,,,,,,,
20150406-M-Casablanca-R32-Carlos_Berlocq-Pablo_Carreno_Busta,2,S-XC,2,0,0,0,0,1,1,,,,,,,,,,
20150406-M-Casablanca-R32-Carlos_Berlocq-Pablo_Carreno_Busta,2,S-DTM,3,0,0,0,0,0,3,,,,,,,,,,
20150406-M-Casablanca-R32-Carlos_Berlocq-Pablo_Carreno_Busta,2,S-DTL,2,0,0,0,0,0,2,,,,,,,,,,
20150407-M-Casablanca-R32-Nicolas_Almagro-Taro_Daniel,1,F-XC,41,9,5,1,3,26,15,,,,,,,,,,
20150407-M-Casablanca-R32-Nicolas_Almagro-Taro_Daniel,1,F-DTM,10,1,0,0,1,2,8,,,,,,,,,,
20150407-M-Casablanca-R32-Nicolas_Almagro-Taro_Daniel,1,F-DTL,7,3,2,0,1,6,1,,,,,,,,,,
20150407-M-Casablanca-R32-Nicolas_Almagro-Taro_Daniel,1,F-IO,21,6,3,3,0,14,7,,,,,,,,,,
20150407-M-Casablanca-R32-Nicolas_Almagro-Taro_Daniel,1,F-II,3,2,0,1,1,1,2,,,,,,,,,,
20150407-M-Casablanca-R32-Nicolas_Almagro-Taro_Daniel,1,B-XC,37,4,2,1,1,25,12,,,,,,,,,,
20150407-M-Casablanca-R32-Nicolas_Almagro-Taro_Daniel,1,B-DTM,33,4,0,0,4,20,13,,,,,,,,,,
20150407-M-Casablanca-R32-Nicolas_Almagro-Taro_Daniel,1,B-DTL,6,4,1,0,3,2,4,,,,,,,,,,
20150407-M-Casablanca-R32-Nicolas_Almagro-Taro_Daniel,1,B-IO,3,0,0,0,0,2,1,,,,,,,,,,
20150407-M-Casablanca-R32-Nicolas_Almagro-Taro_Daniel,1,S-DTM,1,1,1,0,0,1,0,,,,,,,,,,
20150407-M-Casablanca-R32-Nicolas_Almagro-Taro_Daniel,2,F-XC,22,3,0,1,2,9,13,,,,,,,,,,
20150407-M-Casablanca-R32-Nicolas_Almagro-Taro_Daniel,2,F-DTM,33,0,0,0,0,12,21,,,,,,,,,,
20150407-M-Casablanca-R32-Nicolas_Almagro-Taro_Daniel,2,F-DTL,12,3,0,1,2,7,5,,,,,,,,,,
20150407-M-Casablanca-R32-Nicolas_Almagro-Taro_Daniel,2,F-IO,17,0,0,0,0,3,14,,,,,,,,,,
20150407-M-Casablanca-R32-Nicolas_Almagro-Taro_Daniel,2,F-II,2,1,1,0,0,2,0,,,,,,,,,,
20150407-M-Casablanca-R32-Nicolas_Almagro-Taro_Daniel,2,B-XC,36,7,1,1,5,14,22,,,,,,,,,,
20150407-M-Casablanca-R32-Nicolas_Almagro-Taro_Daniel,2,B-DTM,30,2,0,0,2,16,14,,,,,,,,,,
20150407-M-Casablanca-R32-Nicolas_Almagro-Taro_Daniel,2,B-DTL,5,3,0,1,2,1,4,,,,,,,,,,
20150407-M-Casablanca-R32-Nicolas_Almagro-Taro_Daniel,2,B-IO,2,0,0,0,0,0,2,,,,,,,,,,
20150407-M-Casablanca-R32-Nicolas_Almagro-Taro_Daniel,2,S-DTM,3,0,0,0,0,1,2,,,,,,,,,,
20150407-M-Casablanca-R32-Nicolas_Almagro-Taro_Daniel,2,S-DTL,3,1,0,1,0,2,1,,,,,,,,,,
20150408-M-Casablanca-R16-Carlos_Berlocq-Nicolas_Almagro,1,F-XC,40,4,0,3,1,24,16,,,,,,,,,,
20150408-M-Casablanca-R16-Carlos_Berlocq-Nicolas_Almagro,1,F-DTM,18,0,0,0,0,11,7,,,,,,,,,,
20150408-M-Casablanca-R16-Carlos_Berlocq-Nicolas_Almagro,1,F-DTL,15,4,1,0,3,6,9,,,,,,,,,,
20150408-M-Casablanca-R16-Carlos_Berlocq-Nicolas_Almagro,1,F-IO,36,10,3,1,6,21,15,,,,,,,,,,
20150408-M-Casablanca-R16-Carlos_Berlocq-Nicolas_Almagro,1,F-II,5,2,1,0,1,2,3,,,,,,,,,,
20150408-M-Casablanca-R16-Carlos_Berlocq-Nicolas_Almagro,1,B-XC,42,1,0,0,1,25,17,,,,,,,,,,
20150408-M-Casablanca-R16-Carlos_Berlocq-Nicolas_Almagro,1,B-DTM,11,0,0,0,0,7,4,,,,,,,,,,
20150408-M-Casablanca-R16-Carlos_Berlocq-Nicolas_Almagro,1,B-DTL,11,7,3,1,3,6,5,,,,,,,,,,
20150408-M-Casablanca-R16-Carlos_Berlocq-Nicolas_Almagro,1,B-IO,1,0,0,0,0,0,1,,,,,,,,,,
20150408-M-Casablanca-R16-Carlos_Berlocq-Nicolas_Almagro,1,S-XC,12,1,0,0,1,6,6,,,,,,,,,,
20150408-M-Casablanca-R16-Carlos_Berlocq-Nicolas_Almagro,1,S-DTM,4,0,0,0,0,0,4,,,,,,,,,,
20150408-M-Casablanca-R16-Carlos_Berlocq-Nicolas_Almagro,1,S-DTL,1,0,0,0,0,0,1,,,,,,,,,,
20150408-M-Casablanca-R16-Carlos_Berlocq-Nicolas_Almagro,2,F-XC,44,13,5,5,3,24,20,,,,,,,,,,
20150408-M-Casablanca-R16-Carlos_Berlocq-Nicolas_Almagro,2,F-DTM,21,1,0,0,1,9,12,,,,,,,,,,
20150408-M-Casablanca-R16-Carlos_Berlocq-Nicolas_Almagro,2,F-DTL,8,5,2,0,3,3,5,,,,,,,,,,
20150408-M-Casablanca-R16-Carlos_Berlocq-Nicolas_Almagro,2,F-IO,32,11,2,5,4,17,15,,,,,,,,,,
20150408-M-Casablanca-R16-Carlos_Berlocq-Nicolas_Almagro,2,F-II,9,6,1,3,2,4,5,,,,,,,,,,
20150408-M-Casablanca-R16-Carlos_Berlocq-Nicolas_Almagro,2,B-XC,64,11,4,1,6,31,33,,,,,,,,,,
20150408-M-Casablanca-R16-Carlos_Berlocq-Nicolas_Almagro,2,B-DTM,14,1,0,0,1,7,7,,,,,,,,,,
20150408-M-Casablanca-R16-Carlos_Berlocq-Nicolas_Almagro,2,B-DTL,5,3,3,0,0,4,1,,,,,,,,,,
20150408-M-Casablanca-R16-Carlos_Berlocq-Nicolas_Almagro,2,B-IO,1,0,0,0,0,0,1,,,,,,,,,,
20150408-M-Casablanca-R16-Carlos_Berlocq-Nicolas_Almagro,2,S-XC,2,1,0,0,1,0,2,,,,,,,,,,
20150408-M-Casablanca-R16-Carlos_Berlocq-Nicolas_Almagro,2,S-DTM,3,0,0,0,0,0,3,,,,,,,,,,
20150409-M-Casablanca-R16-Daniel_Gimeno_Traver-Mikhail_Kukushkin,1,F-XC,14,4,1,2,1,10,4,,,,,,,,,,
20150409-M-Casablanca-R16-Daniel_Gimeno_Traver-Mikhail_Kukushkin,1,F-DTM,7,0,0,0,0,5,2,,,,,,,,,,
20150409-M-Casablanca-R16-Daniel_Gimeno_Traver-Mikhail_Kukushkin,1,F-DTL,10,4,1,0,3,5,5,,,,,,,,,,
20150409-M-Casablanca-R16-Daniel_Gimeno_Traver-Mikhail_Kukushkin,1,F-IO,15,7,3,4,0,13,2,,,,,,,,,,
20150409-M-Casablanca-R16-Daniel_Gimeno_Traver-Mikhail_Kukushkin,1,F-II,2,0,0,0,0,2,0,,,,,,,,,,
20150409-M-Casablanca-R16-Daniel_Gimeno_Traver-Mikhail_Kukushkin,1,B-XC,5,2,0,1,1,4,1,,,,,,,,,,
20150409-M-Casablanca-R16-Daniel_Gimeno_Traver-Mikhail_Kukushkin,1,B-DTM,14,1,0,0,1,5,9,,,,,,,,,,
20150409-M-Casablanca-R16-Daniel_Gimeno_Traver-Mikhail_Kukushkin,1,B-DTL,4,1,0,0,1,2,2,,,,,,,,,,
20150409-M-Casablanca-R16-Daniel_Gimeno_Traver-Mikhail_Kukushkin,1,B-IO,2,0,0,0,0,1,1,,,,,,,,,,
20150409-M-Casablanca-R16-Daniel_Gimeno_Traver-Mikhail_Kukushkin,1,S-XC,20,0,0,0,0,8,12,,,,,,,,,,
20150409-M-Casablanca-R16-Daniel_Gimeno_Traver-Mikhail_Kukushkin,1,S-DTM,11,0,0,0,0,4,7,,,,,,,,,,
20150409-M-Casablanca-R16-Daniel_Gimeno_Traver-Mikhail_Kukushkin,1,S-DTL,2,1,0,0,1,0,2,,,,,,,,,,
20150409-M-Casablanca-R16-Daniel_Gimeno_Traver-Mikhail_Kukushkin,1,S-IO,1,0,0,0,0,0,1,,,,,,,,,,
20150409-M-Casablanca-R16-Daniel_Gimeno_Traver-Mikhail_Kukushkin,2,F-XC,16,4,1,1,2,8,8,,,,,,,,,,
20150409-M-Casablanca-R16-Daniel_Gimeno_Traver-Mikhail_Kukushkin,2,F-DTM,9,0,0,0,0,3,6,,,,,,,,,,
20150409-M-Casablanca-R16-Daniel_Gimeno_Traver-Mikhail_Kukushkin,2,F-DTL,8,3,0,0,3,1,7,,,,,,,,,,
20150409-M-Casablanca-R16-Daniel_Gimeno_Traver-Mikhail_Kukushkin,2,F-IO,34,8,1,2,5,23,11,,,,,,,,,,
20150409-M-Casablanca-R16-Daniel_Gimeno_Traver-Mikhail_Kukushkin,2,F-II,1,1,0,0,1,0,1,,,,,,,,,,
20150409-M-Casablanca-R16-Daniel_Gimeno_Traver-Mikhail_Kukushkin,2,B-XC,18,4,0,1,3,9,9,,,,,,,,,,
20150409-M-Casablanca-R16-Daniel_Gimeno_Traver-Mikhail_Kukushkin,2,B-DTM,10,0,0,0,0,4,6,,,,,,,,,,
20150409-M-Casablanca-R16-Daniel_Gimeno_Traver-Mikhail_Kukushkin,2,B-DTL,10,4,0,0,4,2,8,,,,,,,,,,
20150409-M-Casablanca-R16-Daniel_Gimeno_Traver-Mikhail_Kukushkin,2,B-IO,1,1,0,1,0,1,0,,,,,,,,,,
20150409-M-Casablanca-R16-Daniel_Gimeno_Traver-Mikhail_Kukushkin,2,S-XC,5,0,0,0,0,1,4,,,,,,,,,,
20150409-M-Casablanca-R16-Daniel_Gimeno_Traver-Mikhail_Kukushkin,2,S-DTM,1,0,0,0,0,0,1,,,,,,,,,,
20150409-M-Casablanca-R16-Daniel_Gimeno_Traver-Mikhail_Kukushkin,2,S-DTL,3,1,0,1,0,2,1,,,,,,,,,,
20150410-M-Casablanca-QF-Nicolas_Almagro-Martin_Klizan,1,F-XC,43,6,3,0,3,27,16,,,,,,,,,,
20150410-M-Casablanca-QF-Nicolas_Almagro-Martin_Klizan,1,F-DTM,14,2,0,0,2,5,9,,,,,,,,,,
20150410-M-Casablanca-QF-Nicolas_Almagro-Martin_Klizan,1,F-DTL,18,12,5,2,5,10,8,,,,,,,,,,
20150410-M-Casablanca-QF-Nicolas_Almagro-Martin_Klizan,1,F-IO,18,9,4,0,5,10,8,,,,,,,,,,
20150410-M-Casablanca-QF-Nicolas_Almagro-Martin_Klizan,1,F-II,4,3,1,0,2,2,2,,,,,,,,,,
20150410-M-Casablanca-QF-Nicolas_Almagro-Martin_Klizan,1,B-XC,32,9,3,0,6,13,19,,,,,,,,,,
20150410-M-Casablanca-QF-Nicolas_Almagro-Martin_Klizan,1,B-DTM,26,2,0,0,2,15,11,,,,,,,,,,
20150410-M-Casablanca-QF-Nicolas_Almagro-Martin_Klizan,1,B-DTL,13,3,1,0,2,7,6,,,,,,,,,,
20150410-M-Casablanca-QF-Nicolas_Almagro-Martin_Klizan,1,B-IO,2,1,0,0,1,0,2,,,,,,,,,,
20150410-M-Casablanca-QF-Nicolas_Almagro-Martin_Klizan,1,S-XC,1,0,0,0,0,0,1,,,,,,,,,,
20150410-M-Casablanca-QF-Nicolas_Almagro-Martin_Klizan,1,S-DTM,1,0,0,0,0,0,1,,,,,,,,,,
20150410-M-Casablanca-QF-Nicolas_Almagro-Martin_Klizan,1,S-DTL,2,0,0,0,0,1,1,,,,,,,,,,
20150410-M-Casablanca-QF-Nicolas_Almagro-Martin_Klizan,2,F-XC,61,10,4,2,4,38,23,,,,,,,,,,
20150410-M-Casablanca-QF-Nicolas_Almagro-Martin_Klizan,2,F-DTM,8,0,0,0,0,4,4,,,,,,,,,,
20150410-M-Casablanca-QF-Nicolas_Almagro-Martin_Klizan,2,F-DTL,6,5,2,2,1,4,2,,,,,,,,,,
20150410-M-Casablanca-QF-Nicolas_Almagro-Martin_Klizan,2,F-IO,13,5,1,1,3,9,4,,,,,,,,,,
20150410-M-Casablanca-QF-Nicolas_Almagro-Martin_Klizan,2,F-II,1,0,0,0,0,0,1,,,,,,,,,,
20150410-M-Casablanca-QF-Nicolas_Almagro-Martin_Klizan,2,B-XC,31,6,1,1,4,15,16,,,,,,,,,,
20150410-M-Casablanca-QF-Nicolas_Almagro-Martin_Klizan,2,B-DTM,11,1,0,0,1,2,9,,,,,,,,,,
20150410-M-Casablanca-QF-Nicolas_Almagro-Martin_Klizan,2,B-DTL,16,4,2,0,2,5,11,,,,,,,,,,
20150410-M-Casablanca-QF-Nicolas_Almagro-Martin_Klizan,2,B-IO,1,0,0,0,0,1,0,,,,,,,,,,
20150410-M-Casablanca-QF-Nicolas_Almagro-Martin_Klizan,2,S-XC,1,0,0,0,0,0,1,,,,,,,,,,
20150410-M-Casablanca-QF-Nicolas_Almagro-Martin_Klizan,2,S-DTM,5,0,0,0,0,3,2,,,,,,,,,,
20150410-M-Casablanca-QF-Nicolas_Almagro-Martin_Klizan,2,S-DTL,1,0,0,0,0,1,0,,,,,,,,,,
20150413-M-Monte_Carlo_Masters-R64-Borna_Coric-Alexandr_Dolgopolov,1,F-XC,51,9,0,4,5,30,21,,,,,,,,,,
20150413-M-Monte_Carlo_Masters-R64-Borna_Coric-Alexandr_Dolgopolov,1,F-DTM,11,1,0,1,0,5,6,,,,,,,,,,
20150413-M-Monte_Carlo_Masters-R64-Borna_Coric-Alexandr_Dolgopolov,1,F-DTL,28,11,4,4,3,18,10,,,,,,,,,,
20150413-M-Monte_Carlo_Masters-R64-Borna_Coric-Alexandr_Dolgopolov,1,F-IO,17,6,2,3,1,11,6,,,,,,,,,,
20150413-M-Monte_Carlo_Masters-R64-Borna_Coric-Alexandr_Dolgopolov,1,F-II,4,2,1,1,0,3,1,,,,,,,,,,
20150413-M-Monte_Carlo_Masters-R64-Borna_Coric-Alexandr_Dolgopolov,1,B-XC,41,3,1,0,2,20,21,,,,,,,,,,
20150413-M-Monte_Carlo_Masters-R64-Borna_Coric-Alexandr_Dolgopolov,1,B-DTM,16,0,0,0,0,5,11,,,,,,,,,,
20150413-M-Monte_Carlo_Masters-R64-Borna_Coric-Alexandr_Dolgopolov,1,B-DTL,7,2,1,1,0,5,2,,,,,,,,,,
20150413-M-Monte_Carlo_Masters-R64-Borna_Coric-Alexandr_Dolgopolov,1,B-IO,1,1,0,0,1,0,1,,,,,,,,,,
20150413-M-Monte_Carlo_Masters-R64-Borna_Coric-Alexandr_Dolgopolov,1,S-XC,7,1,0,0,1,4,3,,,,,,,,,,
20150413-M-Monte_Carlo_Masters-R64-Borna_Coric-Alexandr_Dolgopolov,1,S-DTM,6,0,0,0,0,2,4,,,,,,,,,,
20150413-M-Monte_Carlo_Masters-R64-Borna_Coric-Alexandr_Dolgopolov,1,S-DTL,5,1,0,1,0,1,4,,,,,,,,,,
20150413-M-Monte_Carlo_Masters-R64-Borna_Coric-Alexandr_Dolgopolov,1,S-IO,1,0,0,0,0,1,0,,,,,,,,,,
20150413-M-Monte_Carlo_Masters-R64-Borna_Coric-Alexandr_Dolgopolov,2,F-XC,59,14,4,4,6,28,31,,,,,,,,,,
20150413-M-Monte_Carlo_Masters-R64-Borna_Coric-Alexandr_Dolgopolov,2,F-DTM,7,0,0,0,0,2,5,,,,,,,,,,
20150413-M-Monte_Carlo_Masters-R64-Borna_Coric-Alexandr_Dolgopolov,2,F-DTL,22,12,5,2,5,12,10,,,,,,,,,,
20150413-M-Monte_Carlo_Masters-R64-Borna_Coric-Alexandr_Dolgopolov,2,F-IO,18,8,4,1,3,14,4,,,,,,,,,,
20150413-M-Monte_Carlo_Masters-R64-Borna_Coric-Alexandr_Dolgopolov,2,F-II,2,0,0,0,0,0,2,,,,,,,,,,
20150413-M-Monte_Carlo_Masters-R64-Borna_Coric-Alexandr_Dolgopolov,2,B-XC,36,7,2,1,4,16,20,,,,,,,,,,
20150413-M-Monte_Carlo_Masters-R64-Borna_Coric-Alexandr_Dolgopolov,2,B-DTM,23,1,0,0,1,9,14,,,,,,,,,,
20150413-M-Monte_Carlo_Masters-R64-Borna_Coric-Alexandr_Dolgopolov,2,B-DTL,13,9,5,1,3,10,3,,,,,,,,,,
20150413-M-Monte_Carlo_Masters-R64-Borna_Coric-Alexandr_Dolgopolov,2,B-IO,4,1,1,0,0,2,2,,,,,,,,,,
20150413-M-Monte_Carlo_Masters-R64-Borna_Coric-Alexandr_Dolgopolov,2,S-XC,4,0,0,0,0,1,3,,,,,,,,,,
20150413-M-Monte_Carlo_Masters-R64-Borna_Coric-Alexandr_Dolgopolov,2,S-DTM,4,0,0,0,0,2,2,,,,,,,,,,
20150413-M-Monte_Carlo_Masters-R64-Borna_Coric-Alexandr_Dolgopolov,2,S-DTL,5,1,0,1,0,2,3,,,,,,,,,,
20150413-M-Monte_Carlo_Masters-R64-Borna_Coric-Alexandr_Dolgopolov,2,S-IO,1,1,0,0,1,0,1,,,,,,,,,,
20150413-M-Monte_Carlo_Masters-R64-Mikhail_Kukushkin-Philipp_Kohlschreiber,1,F-XC,23,3,0,0,3,9,14,,,,,,,,,,
20150413-M-Monte_Carlo_Masters-R64-Mikhail_Kukushkin-Philipp_Kohlschreiber,1,F-DTM,24,1,0,0,1,11,13,,,,,,,,,,
20150413-M-Monte_Carlo_Masters-R64-Mikhail_Kukushkin-Philipp_Kohlschreiber,1,F-DTL,11,5,2,0,3,4,7,,,,,,,,,,
20150413-M-Monte_Carlo_Masters-R64-Mikhail_Kukushkin-Philipp_Kohlschreiber,1,F-IO,13,3,2,0,1,8,5,,,,,,,,,,
20150413-M-Monte_Carlo_Masters-R64-Mikhail_Kukushkin-Philipp_Kohlschreiber,1,F-II,2,2,1,1,0,2,0,,,,,,,,,,
20150413-M-Monte_Carlo_Masters-R64-Mikhail_Kukushkin-Philipp_Kohlschreiber,1,B-XC,31,6,1,1,4,14,17,,,,,,,,,,
20150413-M-Monte_Carlo_Masters-R64-Mikhail_Kukushkin-Philipp_Kohlschreiber,1,B-DTM,27,4,0,0,4,10,17,,,,,,,,,,
20150413-M-Monte_Carlo_Masters-R64-Mikhail_Kukushkin-Philipp_Kohlschreiber,1,B-DTL,13,6,1,1,4,7,6,,,,,,,,,,
20150413-M-Monte_Carlo_Masters-R64-Mikhail_Kukushkin-Philipp_Kohlschreiber,1,B-IO,6,2,0,0,2,3,3,,,,,,,,,,
20150413-M-Monte_Carlo_Masters-R64-Mikhail_Kukushkin-Philipp_Kohlschreiber,1,S-XC,4,0,0,0,0,3,1,,,,,,,,,,
20150413-M-Monte_Carlo_Masters-R64-Mikhail_Kukushkin-Philipp_Kohlschreiber,1,S-DTM,3,0,0,0,0,0,3,,,,,,,,,,
20150413-M-Monte_Carlo_Masters-R64-Mikhail_Kukushkin-Philipp_Kohlschreiber,1,S-DTL,2,0,0,0,0,1,1,,,,,,,,,,
20150413-M-Monte_Carlo_Masters-R64-Mikhail_Kukushkin-Philipp_Kohlschreiber,2,F-XC,28,7,2,3,2,18,10,,,,,,,,,,
20150413-M-Monte_Carlo_Masters-R64-Mikhail_Kukushkin-Philipp_Kohlschreiber,2,F-DTM,30,3,1,0,2,13,17,,,,,,,,,,
20150413-M-Monte_Carlo_Masters-R64-Mikhail_Kukushkin-Philipp_Kohlschreiber,2,F-DTL,5,1,0,0,1,2,3,,,,,,,,,,
20150413-M-Monte_Carlo_Masters-R64-Mikhail_Kukushkin-Philipp_Kohlschreiber,2,F-IO,27,7,0,2,5,16,11,,,,,,,,,,
20150413-M-Monte_Carlo_Masters-R64-Mikhail_Kukushkin-Philipp_Kohlschreiber,2,F-II,2,1,0,1,0,1,1,,,,,,,,,,
20150413-M-Monte_Carlo_Masters-R64-Mikhail_Kukushkin-Philipp_Kohlschreiber,2,B-XC,21,4,0,3,1,11,10,,,,,,,,,,
20150413-M-Monte_Carlo_Masters-R64-Mikhail_Kukushkin-Philipp_Kohlschreiber,2,B-DTM,10,1,0,0,1,4,6,,,,,,,,,,
20150413-M-Monte_Carlo_Masters-R64-Mikhail_Kukushkin-Philipp_Kohlschreiber,2,B-DTL,4,4,2,0,2,2,2,,,,,,,,,,
20150413-M-Monte_Carlo_Masters-R64-Mikhail_Kukushkin-Philipp_Kohlschreiber,2,B-IO,3,1,1,0,0,3,0,,,,,,,,,,
20150413-M-Monte_Carlo_Masters-R64-Mikhail_Kukushkin-Philipp_Kohlschreiber,2,S-XC,17,3,0,1,2,4,13,,,,,,,,,,
20150413-M-Monte_Carlo_Masters-R64-Mikhail_Kukushkin-Philipp_Kohlschreiber,2,S-DTM,3,0,0,0,0,3,0,,,,,,,,,,
20150413-M-Monte_Carlo_Masters-R64-Mikhail_Kukushkin-Philipp_Kohlschreiber,2,S-DTL,2,1,0,1,0,1,1,,,,,,,,,,
20150413-M-Monte_Carlo_Masters-R64-Mikhail_Kukushkin-Philipp_Kohlschreiber,2,S-IO,1,1,0,1,0,1,0,,,,,,,,,,
20150414-M-Monte_Carlo_Masters-R64-Dominic_Thiem-Lucas_Pouille,1,F-XC,42,16,5,2,9,23,19,,,,,,,,,,
20150414-M-Monte_Carlo_Masters-R64-Dominic_Thiem-Lucas_Pouille,1,F-DTM,10,1,0,0,1,4,6,,,,,,,,,,
20150414-M-Monte_Carlo_Masters-R64-Dominic_Thiem-Lucas_Pouille,1,F-DTL,8,3,1,1,1,4,4,,,,,,,,,,
20150414-M-Monte_Carlo_Masters-R64-Dominic_Thiem-Lucas_Pouille,1,F-IO,33,6,1,2,3,12,21,,,,,,,,,,
20150414-M-Monte_Carlo_Masters-R64-Dominic_Thiem-Lucas_Pouille,1,F-II,10,5,0,0,5,3,7,,,,,,,,,,
20150414-M-Monte_Carlo_Masters-R64-Dominic_Thiem-Lucas_Pouille,1,B-XC,29,4,0,0,4,13,16,,,,,,,,,,
20150414-M-Monte_Carlo_Masters-R64-Dominic_Thiem-Lucas_Pouille,1,B-DTM,11,1,0,1,0,5,6,,,,,,,,,,
20150414-M-Monte_Carlo_Masters-R64-Dominic_Thiem-Lucas_Pouille,1,B-DTL,8,6,2,0,4,3,5,,,,,,,,,,
20150414-M-Monte_Carlo_Masters-R64-Dominic_Thiem-Lucas_Pouille,1,S-XC,12,0,0,0,0,2,10,,,,,,,,,,
20150414-M-Monte_Carlo_Masters-R64-Dominic_Thiem-Lucas_Pouille,1,S-DTM,6,0,0,0,0,2,4,,,,,,,,,,
20150414-M-Monte_Carlo_Masters-R64-Dominic_Thiem-Lucas_Pouille,1,S-DTL,1,0,0,0,0,1,0,,,,,,,,,,
20150414-M-Monte_Carlo_Masters-R64-Dominic_Thiem-Lucas_Pouille,2,F-XC,30,8,3,2,3,15,15,,,,,,,,,,
20150414-M-Monte_Carlo_Masters-R64-Dominic_Thiem-Lucas_Pouille,2,F-DTM,14,2,0,0,2,4,10,,,,,,,,,,
20150414-M-Monte_Carlo_Masters-R64-Dominic_Thiem-Lucas_Pouille,2,F-DTL,14,2,0,1,1,9,5,,,,,,,,,,
20150414-M-Monte_Carlo_Masters-R64-Dominic_Thiem-Lucas_Pouille,2,F-IO,18,4,3,0,1,10,8,,,,,,,,,,
20150414-M-Monte_Carlo_Masters-R64-Dominic_Thiem-Lucas_Pouille,2,F-II,12,4,0,1,3,7,5,,,,,,,,,,
20150414-M-Monte_Carlo_Masters-R64-Dominic_Thiem-Lucas_Pouille,2,B-XC,46,8,1,2,5,31,15,,,,,,,,,,
20150414-M-Monte_Carlo_Masters-R64-Dominic_Thiem-Lucas_Pouille,2,B-DTM,16,2,0,0,2,8,8,,,,,,,,,,
20150414-M-Monte_Carlo_Masters-R64-Dominic_Thiem-Lucas_Pouille,2,B-DTL,8,2,1,0,1,3,5,,,,,,,,,,
20150414-M-Monte_Carlo_Masters-R64-Dominic_Thiem-Lucas_Pouille,2,B-IO,1,1,0,0,1,0,1,,,,,,,,,,
20150414-M-Monte_Carlo_Masters-R64-Dominic_Thiem-Lucas_Pouille,2,S-XC,6,0,0,0,0,5,1,,,,,,,,,,
20150414-M-Monte_Carlo_Masters-R64-Dominic_Thiem-Lucas_Pouille,2,S-DTL,1,0,0,0,0,0,1,,,,,,,,,,
20150414-M-Monte_Carlo_Masters-R64-Tommy_Robredo-Andreas_Seppi,1,F-XC,44,9,2,3,4,19,25,,,,,,,,,,
20150414-M-Monte_Carlo_Masters-R64-Tommy_Robredo-Andreas_Seppi,1,F-DTM,11,2,0,1,1,6,5,,,,,,,,,,
20150414-M-Monte_Carlo_Masters-R64-Tommy_Robredo-Andreas_Seppi,1,F-DTL,15,9,1,2,6,7,8,,,,,,,,,,
20150414-M-Monte_Carlo_Masters-R64-Tommy_Robredo-Andreas_Seppi,1,F-IO,53,16,4,2,10,25,28,,,,,,,,,,
20150414-M-Monte_Carlo_Masters-R64-Tommy_Robredo-Andreas_Seppi,1,F-II,18,10,5,4,1,13,5,,,,,,,,,,
20150414-M-Monte_Carlo_Masters-R64-Tommy_Robredo-Andreas_Seppi,1,B-XC,48,2,0,0,2,17,31,,,,,,,,,,
20150414-M-Monte_Carlo_Masters-R64-Tommy_Robredo-Andreas_Seppi,1,B-DTM,17,1,0,0,1,7,10,,,,,,,,,,
20150414-M-Monte_Carlo_Masters-R64-Tommy_Robredo-Andreas_Seppi,1,B-DTL,4,1,0,1,0,1,3,,,,,,,,,,
20150414-M-Monte_Carlo_Masters-R64-Tommy_Robredo-Andreas_Seppi,1,S-XC,8,0,0,0,0,5,3,,,,,,,,,,
20150414-M-Monte_Carlo_Masters-R64-Tommy_Robredo-Andreas_Seppi,1,S-DTM,6,1,0,0,1,3,3,,,,,,,,,,
20150414-M-Monte_Carlo_Masters-R64-Tommy_Robredo-Andreas_Seppi,1,S-DTL,1,0,0,0,0,1,0,,,,,,,,,,
20150414-M-Monte_Carlo_Masters-R64-Tommy_Robredo-Andreas_Seppi,2,F-XC,43,10,2,1,7,27,16,,,,,,,,,,
20150414-M-Monte_Carlo_Masters-R64-Tommy_Robredo-Andreas_Seppi,2,F-DTM,18,1,0,0,1,7,11,,,,,,,,,,
20150414-M-Monte_Carlo_Masters-R64-Tommy_Robredo-Andreas_Seppi,2,F-DTL,31,6,2,3,1,19,12,,,,,,,,,,
20150414-M-Monte_Carlo_Masters-R64-Tommy_Robredo-Andreas_Seppi,2,F-IO,39,5,4,0,1,22,17,,,,,,,,,,
20150414-M-Monte_Carlo_Masters-R64-Tommy_Robredo-Andreas_Seppi,2,F-II,6,4,3,0,1,5,1,,,,,,,,,,
20150414-M-Monte_Carlo_Masters-R64-Tommy_Robredo-Andreas_Seppi,2,B-XC,49,6,0,0,6,27,22,,,,,,,,,,
20150414-M-Monte_Carlo_Masters-R64-Tommy_Robredo-Andreas_Seppi,2,B-DTM,21,1,0,0,1,11,10,,,,,,,,,,
20150414-M-Monte_Carlo_Masters-R64-Tommy_Robredo-Andreas_Seppi,2,B-DTL,14,12,5,3,4,10,4,,,,,,,,,,
20150414-M-Monte_Carlo_Masters-R64-Tommy_Robredo-Andreas_Seppi,2,B-IO,2,2,2,0,0,2,0,,,,,,,,,,
20150414-M-Monte_Carlo_Masters-R64-Tommy_Robredo-Andreas_Seppi,2,S-XC,8,0,0,0,0,3,5,,,,,,,,,,
20150414-M-Monte_Carlo_Masters-R64-Tommy_Robredo-Andreas_Seppi,2,S-DTM,4,0,0,0,0,1,3,,,,,,,,,,
20150414-M-Monte_Carlo_Masters-R64-Tommy_Robredo-Andreas_Seppi,2,S-DTL,2,1,0,0,1,0,2,,,,,,,,,,
20150415-M-Monte_Carlo_Masters-R32-Jo_Wilfried_Tsonga-David_Goffin,1,F-XC,37,15,4,2,9,16,21,,,,,,,,,,
20150415-M-Monte_Carlo_Masters-R32-Jo_Wilfried_Tsonga-David_Goffin,1,F-DTM,17,3,0,0,3,7,10,,,,,,,,,,
20150415-M-Monte_Carlo_Masters-R32-Jo_Wilfried_Tsonga-David_Goffin,1,F-DTL,13,3,0,2,1,5,8,,,,,,,,,,
20150415-M-Monte_Carlo_Masters-R32-Jo_Wilfried_Tsonga-David_Goffin,1,F-IO,26,7,4,2,1,18,8,,,,,,,,,,
20150415-M-Monte_Carlo_Masters-R32-Jo_Wilfried_Tsonga-David_Goffin,1,F-II,7,6,4,2,0,6,1,,,,,,,,,,
20150415-M-Monte_Carlo_Masters-R32-Jo_Wilfried_Tsonga-David_Goffin,1,B-XC,46,7,0,1,6,15,31,,,,,,,,,,
20150415-M-Monte_Carlo_Masters-R32-Jo_Wilfried_Tsonga-David_Goffin,1,B-DTM,18,1,0,0,1,9,9,,,,,,,,,,
20150415-M-Monte_Carlo_Masters-R32-Jo_Wilfried_Tsonga-David_Goffin,1,B-DTL,9,7,2,1,4,4,5,,,,,,,,,,
20150415-M-Monte_Carlo_Masters-R32-Jo_Wilfried_Tsonga-David_Goffin,1,B-IO,2,0,0,0,0,1,1,,,,,,,,,,
20150415-M-Monte_Carlo_Masters-R32-Jo_Wilfried_Tsonga-David_Goffin,1,S-XC,5,0,0,0,0,1,4,,,,,,,,,,
20150415-M-Monte_Carlo_Masters-R32-Jo_Wilfried_Tsonga-David_Goffin,1,S-DTM,9,3,0,0,3,0,9,,,,,,,,,,
20150415-M-Monte_Carlo_Masters-R32-Jo_Wilfried_Tsonga-David_Goffin,2,F-XC,40,8,1,2,5,22,18,,,,,,,,,,
20150415-M-Monte_Carlo_Masters-R32-Jo_Wilfried_Tsonga-David_Goffin,2,F-DTM,15,1,0,0,1,9,6,,,,,,,,,,
20150415-M-Monte_Carlo_Masters-R32-Jo_Wilfried_Tsonga-David_Goffin,2,F-DTL,10,2,1,1,0,6,4,,,,,,,,,,
20150415-M-Monte_Carlo_Masters-R32-Jo_Wilfried_Tsonga-David_Goffin,2,F-IO,33,9,1,3,5,18,15,,,,,,,,,,
20150415-M-Monte_Carlo_Masters-R32-Jo_Wilfried_Tsonga-David_Goffin,2,F-II,10,2,1,0,1,9,1,,,,,,,,,,
20150415-M-Monte_Carlo_Masters-R32-Jo_Wilfried_Tsonga-David_Goffin,2,B-XC,45,3,0,1,2,27,18,,,,,,,,,,
20150415-M-Monte_Carlo_Masters-R32-Jo_Wilfried_Tsonga-David_Goffin,2,B-DTM,17,1,0,0,1,10,7,,,,,,,,,,
20150415-M-Monte_Carlo_Masters-R32-Jo_Wilfried_Tsonga-David_Goffin,2,B-DTL,8,2,1,0,1,6,2,,,,,,,,,,
20150415-M-Monte_Carlo_Masters-R32-Jo_Wilfried_Tsonga-David_Goffin,2,B-IO,1,0,0,0,0,0,1,,,,,,,,,,
20150415-M-Monte_Carlo_Masters-R32-Jo_Wilfried_Tsonga-David_Goffin,2,S-XC,3,0,0,0,0,2,1,,,,,,,,,,
20150415-M-Monte_Carlo_Masters-R32-Jo_Wilfried_Tsonga-David_Goffin,2,S-DTM,2,0,0,0,0,0,2,,,,,,,,,,
20150416-M-Monte_Carlo_Masters-R16-Roger_Federer-Gael_Monfils,1,F-XC,55,18,3,6,9,29,26,,,,,,,,,,
20150416-M-Monte_Carlo_Masters-R16-Roger_Federer-Gael_Monfils,1,F-DTM,28,2,0,0,2,11,17,,,,,,,,,,
20150416-M-Monte_Carlo_Masters-R16-Roger_Federer-Gael_Monfils,1,F-DTL,17,8,2,2,4,6,11,,,,,,,,,,
20150416-M-Monte_Carlo_Masters-R16-Roger_Federer-Gael_Monfils,1,F-IO,38,10,1,4,5,17,21,,,,,,,,,,
20150416-M-Monte_Carlo_Masters-R16-Roger_Federer-Gael_Monfils,1,F-II,7,3,0,1,2,4,3,,,,,,,,,,
20150416-M-Monte_Carlo_Masters-R16-Roger_Federer-Gael_Monfils,1,B-XC,46,7,1,0,6,20,26,,,,,,,,,,
20150416-M-Monte_Carlo_Masters-R16-Roger_Federer-Gael_Monfils,1,B-DTM,34,3,0,2,1,13,21,,,,,,,,,,
20150416-M-Monte_Carlo_Masters-R16-Roger_Federer-Gael_Monfils,1,B-DTL,14,7,1,3,3,6,8,,,,,,,,,,
20150416-M-Monte_Carlo_Masters-R16-Roger_Federer-Gael_Monfils,1,B-IO,2,1,0,0,1,0,2,,,,,,,,,,
20150416-M-Monte_Carlo_Masters-R16-Roger_Federer-Gael_Monfils,1,S-XC,9,0,0,0,0,3,6,,,,,,,,,,
20150416-M-Monte_Carlo_Masters-R16-Roger_Federer-Gael_Monfils,1,S-DTM,4,0,0,0,0,1,3,,,,,,,,,,
20150416-M-Monte_Carlo_Masters-R16-Roger_Federer-Gael_Monfils,1,S-DTL,2,1,0,0,1,0,2,,,,,,,,,,
20150416-M-Monte_Carlo_Masters-R16-Roger_Federer-Gael_Monfils,2,F-XC,41,11,2,4,5,25,16,,,,,,,,,,
20150416-M-Monte_Carlo_Masters-R16-Roger_Federer-Gael_Monfils,2,F-DTM,35,5,0,2,3,21,14,,,,,,,,,,
20150416-M-Monte_Carlo_Masters-R16-Roger_Federer-Gael_Monfils,2,F-DTL,13,4,1,0,3,8,5,,,,,,,,,,
20150416-M-Monte_Carlo_Masters-R16-Roger_Federer-Gael_Monfils,2,F-IO,31,4,2,1,1,17,14,,,,,,,,,,
20150416-M-Monte_Carlo_Masters-R16-Roger_Federer-Gael_Monfils,2,F-II,4,3,1,0,2,2,2,,,,,,,,,,
20150416-M-Monte_Carlo_Masters-R16-Roger_Federer-Gael_Monfils,2,B-XC,61,3,1,0,2,37,24,,,,,,,,,,
20150416-M-Monte_Carlo_Masters-R16-Roger_Federer-Gael_Monfils,2,B-DTM,30,4,0,0,4,16,14,,,,,,,,,,
20150416-M-Monte_Carlo_Masters-R16-Roger_Federer-Gael_Monfils,2,B-DTL,13,5,3,0,2,9,4,,,,,,,,,,
20150416-M-Monte_Carlo_Masters-R16-Roger_Federer-Gael_Monfils,2,B-IO,6,2,1,0,1,4,2,,,,,,,,,,
20150416-M-Monte_Carlo_Masters-R16-Roger_Federer-Gael_Monfils,2,S-XC,3,0,0,0,0,2,1,,,,,,,,,,
20150416-M-Monte_Carlo_Masters-R16-Roger_Federer-Gael_Monfils,2,S-DTM,3,0,0,0,0,0,3,,,,,,,,,,
20150416-M-Monte_Carlo_Masters-R16-Roger_Federer-Gael_Monfils,2,S-DTL,3,0,0,0,0,1,2,,,,,,,,,,
20150417-M-Monte_Carlo_Masters-QF-David_Ferrer-Rafael_Nadal,1,F-XC,161,16,4,2,10,59,102,,,,,,,,,,
20150417-M-Monte_Carlo_Masters-QF-David_Ferrer-Rafael_Nadal,1,F-DTM,18,1,0,0,1,8,10,,,,,,,,,,
20150417-M-Monte_Carlo_Masters-QF-David_Ferrer-Rafael_Nadal,1,F-DTL,30,9,2,4,3,19,11,,,,,,,,,,
20150417-M-Monte_Carlo_Masters-QF-David_Ferrer-Rafael_Nadal,1,F-IO,39,18,4,4,10,19,20,,,,,,,,,,
20150417-M-Monte_Carlo_Masters-QF-David_Ferrer-Rafael_Nadal,1,F-II,23,4,0,2,2,12,11,,,,,,,,,,
20150417-M-Monte_Carlo_Masters-QF-David_Ferrer-Rafael_Nadal,1,B-XC,67,9,2,2,5,29,38,,,,,,,,,,
20150417-M-Monte_Carlo_Masters-QF-David_Ferrer-Rafael_Nadal,1,B-DTM,19,0,0,0,0,7,12,,,,,,,,,,
20150417-M-Monte_Carlo_Masters-QF-David_Ferrer-Rafael_Nadal,1,B-DTL,60,13,2,6,5,28,32,,,,,,,,,,
20150417-M-Monte_Carlo_Masters-QF-David_Ferrer-Rafael_Nadal,1,S-DTM,2,0,0,0,0,0,2,,,,,,,,,,
20150417-M-Monte_Carlo_Masters-QF-David_Ferrer-Rafael_Nadal,1,S-DTL,2,0,0,0,0,2,0,,,,,,,,,,
20150417-M-Monte_Carlo_Masters-QF-David_Ferrer-Rafael_Nadal,1,S-IO,1,0,0,0,0,0,1,,,,,,,,,,
20150417-M-Monte_Carlo_Masters-QF-David_Ferrer-Rafael_Nadal,2,F-XC,93,9,4,3,2,49,44,,,,,,,,,,
20150417-M-Monte_Carlo_Masters-QF-David_Ferrer-Rafael_Nadal,2,F-DTM,18,0,0,0,0,10,8,,,,,,,,,,
20150417-M-Monte_Carlo_Masters-QF-David_Ferrer-Rafael_Nadal,2,F-DTL,33,12,2,6,4,19,14,,,,,,,,,,
20150417-M-Monte_Carlo_Masters-QF-David_Ferrer-Rafael_Nadal,2,F-IO,40,9,6,2,1,27,13,,,,,,,,,,
20150417-M-Monte_Carlo_Masters-QF-David_Ferrer-Rafael_Nadal,2,F-II,18,1,0,0,1,10,8,,,,,,,,,,
20150417-M-Monte_Carlo_Masters-QF-David_Ferrer-Rafael_Nadal,2,B-XC,86,12,1,4,7,50,36,,,,,,,,,,
20150417-M-Monte_Carlo_Masters-QF-David_Ferrer-Rafael_Nadal,2,B-DTM,24,1,0,0,1,16,8,,,,,,,,,,
20150417-M-Monte_Carlo_Masters-QF-David_Ferrer-Rafael_Nadal,2,B-DTL,65,10,2,3,5,37,28,,,,,,,,,,
20150417-M-Monte_Carlo_Masters-QF-David_Ferrer-Rafael_Nadal,2,B-IO,6,1,0,1,0,4,2,,,,,,,,,,
20150417-M-Monte_Carlo_Masters-QF-David_Ferrer-Rafael_Nadal,2,S-XC,6,1,0,0,1,4,2,,,,,,,,,,
20150417-M-Monte_Carlo_Masters-QF-David_Ferrer-Rafael_Nadal,2,S-DTM,4,0,0,0,0,3,1,,,,,,,,,,
20150417-M-Monte_Carlo_Masters-QF-David_Ferrer-Rafael_Nadal,2,S-DTL,6,0,0,0,0,4,2,,,,,,,,,,
20150417-M-Monte_Carlo_Masters-QF-Grigor_Dimitrov-Gael_Monfils,1,F-XC,43,5,2,1,2,24,19,,,,,,,,,,
20150417-M-Monte_Carlo_Masters-QF-Grigor_Dimitrov-Gael_Monfils,1,F-DTM,4,0,0,0,0,1,3,,,,,,,,,,
20150417-M-Monte_Carlo_Masters-QF-Grigor_Dimitrov-Gael_Monfils,1,F-DTL,6,2,0,0,2,2,4,,,,,,,,,,
20150417-M-Monte_Carlo_Masters-QF-Grigor_Dimitrov-Gael_Monfils,1,F-IO,20,7,0,2,5,6,14,,,,,,,,,,
20150417-M-Monte_Carlo_Masters-QF-Grigor_Dimitrov-Gael_Monfils,1,F-II,8,3,0,1,2,2,6,,,,,,,,,,
20150417-M-Monte_Carlo_Masters-QF-Grigor_Dimitrov-Gael_Monfils,1,B-XC,20,7,1,0,6,6,14,,,,,,,,,,
20150417-M-Monte_Carlo_Masters-QF-Grigor_Dimitrov-Gael_Monfils,1,B-DTM,13,1,0,0,1,7,6,,,,,,,,,,
20150417-M-Monte_Carlo_Masters-QF-Grigor_Dimitrov-Gael_Monfils,1,B-DTL,9,3,1,0,2,3,6,,,,,,,,,,
20150417-M-Monte_Carlo_Masters-QF-Grigor_Dimitrov-Gael_Monfils,1,B-IO,1,0,0,0,0,1,0,,,,,,,,,,
20150417-M-Monte_Carlo_Masters-QF-Grigor_Dimitrov-Gael_Monfils,1,B-II,1,0,0,0,0,1,0,,,,,,,,,,
20150417-M-Monte_Carlo_Masters-QF-Grigor_Dimitrov-Gael_Monfils,1,S-XC,15,0,0,0,0,8,7,,,,,,,,,,
20150417-M-Monte_Carlo_Masters-QF-Grigor_Dimitrov-Gael_Monfils,1,S-DTM,5,0,0,0,0,4,1,,,,,,,,,,
20150417-M-Monte_Carlo_Masters-QF-Grigor_Dimitrov-Gael_Monfils,1,S-DTL,3,0,0,0,0,0,3,,,,,,,,,,
20150417-M-Monte_Carlo_Masters-QF-Grigor_Dimitrov-Gael_Monfils,2,F-XC,46,11,1,4,6,26,20,,,,,,,,,,
20150417-M-Monte_Carlo_Masters-QF-Grigor_Dimitrov-Gael_Monfils,2,F-DTM,10,1,0,0,1,3,7,,,,,,,,,,
20150417-M-Monte_Carlo_Masters-QF-Grigor_Dimitrov-Gael_Monfils,2,F-DTL,20,5,2,0,3,8,12,,,,,,,,,,
20150417-M-Monte_Carlo_Masters-QF-Grigor_Dimitrov-Gael_Monfils,2,F-IO,26,3,1,1,1,13,13,,,,,,,,,,
20150417-M-Monte_Carlo_Masters-QF-Grigor_Dimitrov-Gael_Monfils,2,F-II,5,0,0,0,0,3,2,,,,,,,,,,
20150417-M-Monte_Carlo_Masters-QF-Grigor_Dimitrov-Gael_Monfils,2,B-XC,26,0,0,0,0,21,5,,,,,,,,,,
20150417-M-Monte_Carlo_Masters-QF-Grigor_Dimitrov-Gael_Monfils,2,B-DTM,11,0,0,0,0,4,7,,,,,,,,,,
20150417-M-Monte_Carlo_Masters-QF-Grigor_Dimitrov-Gael_Monfils,2,B-DTL,2,0,0,0,0,1,1,,,,,,,,,,
20150417-M-Monte_Carlo_Masters-QF-Grigor_Dimitrov-Gael_Monfils,2,S-XC,3,0,0,0,0,1,2,,,,,,,,,,
20150417-M-Monte_Carlo_Masters-QF-Grigor_Dimitrov-Gael_Monfils,2,S-DTM,1,0,0,0,0,0,1,,,,,,,,,,
20150417-M-Monte_Carlo_Masters-QF-Grigor_Dimitrov-Gael_Monfils,2,S-DTL,1,1,0,1,0,1,0,,,,,,,,,,
20150417-M-Monte_Carlo_Masters-QF-Milos_Raonic-Tomas_Berdych,1,F-XC,1,1,0,0,1,0,1,,,,,,,,,,
20150417-M-Monte_Carlo_Masters-QF-Milos_Raonic-Tomas_Berdych,1,F-DTM,1,0,0,0,0,0,1,,,,,,,,,,
20150417-M-Monte_Carlo_Masters-QF-Milos_Raonic-Tomas_Berdych,1,F-DTL,3,2,0,0,2,0,3,,,,,,,,,,
20150417-M-Monte_Carlo_Masters-QF-Milos_Raonic-Tomas_Berdych,1,F-IO,6,4,2,1,1,5,1,,,,,,,,,,
20150417-M-Monte_Carlo_Masters-QF-Milos_Raonic-Tomas_Berdych,1,F-II,1,0,0,0,0,0,1,,,,,,,,,,
20150417-M-Monte_Carlo_Masters-QF-Milos_Raonic-Tomas_Berdych,1,B-XC,4,1,0,1,0,3,1,,,,,,,,,,
20150417-M-Monte_Carlo_Masters-QF-Milos_Raonic-Tomas_Berdych,1,B-DTL,5,4,1,0,3,2,3,,,,,,,,,,
20150417-M-Monte_Carlo_Masters-QF-Milos_Raonic-Tomas_Berdych,1,S-XC,3,1,0,0,1,1,2,,,,,,,,,,
20150417-M-Monte_Carlo_Masters-QF-Milos_Raonic-Tomas_Berdych,1,S-DTM,3,0,0,0,0,2,1,,,,,,,,,,
20150417-M-Monte_Carlo_Masters-QF-Milos_Raonic-Tomas_Berdych,1,S-DTL,2,0,0,0,0,1,1,,,,,,,,,,
20150417-M-Monte_Carlo_Masters-QF-Milos_Raonic-Tomas_Berdych,2,F-XC,6,5,2,0,3,3,3,,,,,,,,,,
20150417-M-Monte_Carlo_Masters-QF-Milos_Raonic-Tomas_Berdych,2,F-DTM,1,0,0,0,0,0,1,,,,,,,,,,
20150417-M-Monte_Carlo_Masters-QF-Milos_Raonic-Tomas_Berdych,2,F-DTL,2,1,1,0,0,2,0,,,,,,,,,,
20150417-M-Monte_Carlo_Masters-QF-Milos_Raonic-Tomas_Berdych,2,F-IO,5,2,1,0,1,4,1,,,,,,,,,,
20150417-M-Monte_Carlo_Masters-QF-Milos_Raonic-Tomas_Berdych,2,F-II,2,0,0,0,0,2,0,,,,,,,,,,
20150417-M-Monte_Carlo_Masters-QF-Milos_Raonic-Tomas_Berdych,2,B-XC,10,3,2,0,1,4,6,,,,,,,,,,
20150417-M-Monte_Carlo_Masters-QF-Milos_Raonic-Tomas_Berdych,2,B-DTL,1,1,1,0,0,1,0,,,,,,,,,,
20150417-M-Monte_Carlo_Masters-QF-Milos_Raonic-Tomas_Berdych,2,S-DTM,1,0,0,0,0,0,1,,,,,,,,,,
20150417-M-Monte_Carlo_Masters-QF-Milos_Raonic-Tomas_Berdych,2,S-DTL,1,0,0,0,0,0,1,,,,,,,,,,
20150418-M-Monte_Carlo_Masters-SF-Novak_Djokovic-Rafael_Nadal,1,F-XC,45,4,0,3,1,17,28,,,,,,,,,,
20150418-M-Monte_Carlo_Masters-SF-Novak_Djokovic-Rafael_Nadal,1,F-DTM,21,0,0,0,0,10,11,,,,,,,,,,
20150418-M-Monte_Carlo_Masters-SF-Novak_Djokovic-Rafael_Nadal,1,F-DTL,17,5,4,0,1,11,6,,,,,,,,,,
20150418-M-Monte_Carlo_Masters-SF-Novak_Djokovic-Rafael_Nadal,1,F-IO,29,11,4,2,5,14,15,,,,,,,,,,
20150418-M-Monte_Carlo_Masters-SF-Novak_Djokovic-Rafael_Nadal,1,F-II,2,0,0,0,0,2,0,,,,,,,,,,
20150418-M-Monte_Carlo_Masters-SF-Novak_Djokovic-Rafael_Nadal,1,B-XC,37,8,0,1,7,16,21,,,,,,,,,,
20150418-M-Monte_Carlo_Masters-SF-Novak_Djokovic-Rafael_Nadal,1,B-DTM,28,3,0,1,2,12,16,,,,,,,,,,
20150418-M-Monte_Carlo_Masters-SF-Novak_Djokovic-Rafael_Nadal,1,B-DTL,38,5,1,3,1,20,18,,,,,,,,,,
20150418-M-Monte_Carlo_Masters-SF-Novak_Djokovic-Rafael_Nadal,1,B-IO,10,1,1,0,0,6,4,,,,,,,,,,
20150418-M-Monte_Carlo_Masters-SF-Novak_Djokovic-Rafael_Nadal,1,S-XC,2,1,1,0,0,1,1,,,,,,,,,,
20150418-M-Monte_Carlo_Masters-SF-Novak_Djokovic-Rafael_Nadal,1,S-DTM,1,0,0,0,0,1,0,,,,,,,,,,
20150418-M-Monte_Carlo_Masters-SF-Novak_Djokovic-Rafael_Nadal,1,S-DTL,2,1,1,0,0,2,0,,,,,,,,,,
20150418-M-Monte_Carlo_Masters-SF-Novak_Djokovic-Rafael_Nadal,1,S-IO,1,0,0,0,0,0,1,,,,,,,,,,
20150418-M-Monte_Carlo_Masters-SF-Novak_Djokovic-Rafael_Nadal,2,F-XC,62,4,0,1,3,30,32,,,,,,,,,,
20150418-M-Monte_Carlo_Masters-SF-Novak_Djokovic-Rafael_Nadal,2,F-DTM,27,1,0,0,1,18,9,,,,,,,,,,
20150418-M-Monte_Carlo_Masters-SF-Novak_Djokovic-Rafael_Nadal,2,F-DTL,13,7,2,2,3,5,8,,,,,,,,,,
20150418-M-Monte_Carlo_Masters-SF-Novak_Djokovic-Rafael_Nadal,2,F-IO,28,12,3,4,5,15,13,,,,,,,,,,
20150418-M-Monte_Carlo_Masters-SF-Novak_Djokovic-Rafael_Nadal,2,F-II,3,2,1,1,0,2,1,,,,,,,,,,
20150418-M-Monte_Carlo_Masters-SF-Novak_Djokovic-Rafael_Nadal,2,B-XC,26,4,3,0,1,19,7,,,,,,,,,,
20150418-M-Monte_Carlo_Masters-SF-Novak_Djokovic-Rafael_Nadal,2,B-DTM,28,0,0,0,0,14,14,,,,,,,,,,
20150418-M-Monte_Carlo_Masters-SF-Novak_Djokovic-Rafael_Nadal,2,B-DTL,16,4,0,1,3,9,7,,,,,,,,,,
20150418-M-Monte_Carlo_Masters-SF-Novak_Djokovic-Rafael_Nadal,2,B-IO,2,0,0,0,0,1,1,,,,,,,,,,
20150418-M-Monte_Carlo_Masters-SF-Novak_Djokovic-Rafael_Nadal,2,S-XC,5,0,0,0,0,3,2,,,,,,,,,,
20150418-M-Monte_Carlo_Masters-SF-Novak_Djokovic-Rafael_Nadal,2,S-DTM,10,0,0,0,0,7,3,,,,,,,,,,
20150418-M-Monte_Carlo_Masters-SF-Novak_Djokovic-Rafael_Nadal,2,S-DTL,11,0,0,0,0,4,7,,,,,,,,,,
20150418-M-Monte_Carlo_Masters-SF-Novak_Djokovic-Rafael_Nadal,2,S-IO,4,1,1,0,0,2,2,,,,,,,,,,
20150418-M-Monte_Carlo_Masters-SF-Tomas_Berdych-Gael_Monfils,1,F-XC,26,6,2,2,2,12,14,,,,,,,,,,
20150418-M-Monte_Carlo_Masters-SF-Tomas_Berdych-Gael_Monfils,1,F-DTM,10,0,0,0,0,5,5,,,,,,,,,,
20150418-M-Monte_Carlo_Masters-SF-Tomas_Berdych-Gael_Monfils,1,F-DTL,11,3,0,1,2,7,4,,,,,,,,,,
20150418-M-Monte_Carlo_Masters-SF-Tomas_Berdych-Gael_Monfils,1,F-IO,28,7,3,2,2,20,8,,,,,,,,,,
20150418-M-Monte_Carlo_Masters-SF-Tomas_Berdych-Gael_Monfils,1,F-II,5,3,1,0,2,2,3,,,,,,,,,,
20150418-M-Monte_Carlo_Masters-SF-Tomas_Berdych-Gael_Monfils,1,B-XC,48,3,1,0,2,22,26,,,,,,,,,,
20150418-M-Monte_Carlo_Masters-SF-Tomas_Berdych-Gael_Monfils,1,B-DTM,7,1,0,0,1,2,5,,,,,,,,,,
20150418-M-Monte_Carlo_Masters-SF-Tomas_Berdych-Gael_Monfils,1,B-DTL,11,4,2,0,2,7,4,,,,,,,,,,
20150418-M-Monte_Carlo_Masters-SF-Tomas_Berdych-Gael_Monfils,1,B-IO,1,0,0,0,0,1,0,,,,,,,,,,
20150418-M-Monte_Carlo_Masters-SF-Tomas_Berdych-Gael_Monfils,1,S-XC,8,0,0,0,0,3,5,,,,,,,,,,
20150418-M-Monte_Carlo_Masters-SF-Tomas_Berdych-Gael_Monfils,1,S-DTL,1,0,0,0,0,0,1,,,,,,,,,,
20150418-M-Monte_Carlo_Masters-SF-Tomas_Berdych-Gael_Monfils,2,F-XC,24,7,4,0,3,12,12,,,,,,,,,,
20150418-M-Monte_Carlo_Masters-SF-Tomas_Berdych-Gael_Monfils,2,F-DTM,4,0,0,0,0,0,4,,,,,,,,,,
20150418-M-Monte_Carlo_Masters-SF-Tomas_Berdych-Gael_Monfils,2,F-DTL,9,2,0,1,1,8,1,,,,,,,,,,
20150418-M-Monte_Carlo_Masters-SF-Tomas_Berdych-Gael_Monfils,2,F-IO,12,2,0,0,2,6,6,,,,,,,,,,
20150418-M-Monte_Carlo_Masters-SF-Tomas_Berdych-Gael_Monfils,2,F-II,1,1,0,0,1,0,1,,,,,,,,,,
20150418-M-Monte_Carlo_Masters-SF-Tomas_Berdych-Gael_Monfils,2,B-XC,42,5,1,0,4,23,19,,,,,,,,,,
20150418-M-Monte_Carlo_Masters-SF-Tomas_Berdych-Gael_Monfils,2,B-DTM,20,2,0,0,2,5,15,,,,,,,,,,
20150418-M-Monte_Carlo_Masters-SF-Tomas_Berdych-Gael_Monfils,2,B-DTL,5,3,0,0,3,1,4,,,,,,,,,,
20150418-M-Monte_Carlo_Masters-SF-Tomas_Berdych-Gael_Monfils,2,B-IO,1,1,1,0,0,1,0,,,,,,,,,,
20150418-M-Monte_Carlo_Masters-SF-Tomas_Berdych-Gael_Monfils,2,S-XC,15,1,0,0,1,8,7,,,,,,,,,,
20150418-M-Monte_Carlo_Masters-SF-Tomas_Berdych-Gael_Monfils,2,S-DTM,4,1,0,0,1,0,4,,,,,,,,,,
20150418-M-Monte_Carlo_Masters-SF-Tomas_Berdych-Gael_Monfils,2,S-DTL,5,3,3,0,0,4,1,,,,,,,,,,
20150418-M-Monte_Carlo_Masters-SF-Tomas_Berdych-Gael_Monfils,2,S-IO,1,0,0,0,0,1,0,,,,,,,,,,
20150420-M-Barcelona-R64-Pablo_Carreno_Busta-Teymuraz_Gabashvili,1,F-XC,35,9,1,4,4,17,18,,,,,,,,,,
20150420-M-Barcelona-R64-Pablo_Carreno_Busta-Teymuraz_Gabashvili,1,F-DTM,17,1,0,0,1,4,13,,,,,,,,,,
20150420-M-Barcelona-R64-Pablo_Carreno_Busta-Teymuraz_Gabashvili,1,F-DTL,12,4,2,1,1,7,5,,,,,,,,,,
20150420-M-Barcelona-R64-Pablo_Carreno_Busta-Teymuraz_Gabashvili,1,F-IO,23,2,1,0,1,11,12,,,,,,,,,,
20150420-M-Barcelona-R64-Pablo_Carreno_Busta-Teymuraz_Gabashvili,1,F-II,4,3,2,0,1,2,2,,,,,,,,,,
20150420-M-Barcelona-R64-Pablo_Carreno_Busta-Teymuraz_Gabashvili,1,B-XC,56,3,0,0,3,31,25,,,,,,,,,,
20150420-M-Barcelona-R64-Pablo_Carreno_Busta-Teymuraz_Gabashvili,1,B-DTM,11,2,0,1,1,6,5,,,,,,,,,,
20150420-M-Barcelona-R64-Pablo_Carreno_Busta-Teymuraz_Gabashvili,1,B-DTL,10,4,1,0,3,4,6,,,,,,,,,,
20150420-M-Barcelona-R64-Pablo_Carreno_Busta-Teymuraz_Gabashvili,1,B-IO,3,3,1,0,2,1,2,,,,,,,,,,
20150420-M-Barcelona-R64-Pablo_Carreno_Busta-Teymuraz_Gabashvili,1,S-XC,1,0,0,0,0,0,1,,,,,,,,,,
20150420-M-Barcelona-R64-Pablo_Carreno_Busta-Teymuraz_Gabashvili,1,S-DTM,4,0,0,0,0,1,3,,,,,,,,,,
20150420-M-Barcelona-R64-Pablo_Carreno_Busta-Teymuraz_Gabashvili,1,S-DTL,1,0,0,0,0,0,1,,,,,,,,,,
20150420-M-Barcelona-R64-Pablo_Carreno_Busta-Teymuraz_Gabashvili,2,F-XC,38,15,7,2,6,26,12,,,,,,,,,,
20150420-M-Barcelona-R64-Pablo_Carreno_Busta-Teymuraz_Gabashvili,2,F-DTM,7,1,0,1,0,5,2,,,,,,,,,,
20150420-M-Barcelona-R64-Pablo_Carreno_Busta-Teymuraz_Gabashvili,2,F-DTL,17,9,3,3,3,10,7,,,,,,,,,,
20150420-M-Barcelona-R64-Pablo_Carreno_Busta-Teymuraz_Gabashvili,2,F-IO,20,9,5,3,1,14,6,,,,,,,,,,
20150420-M-Barcelona-R64-Pablo_Carreno_Busta-Teymuraz_Gabashvili,2,F-II,3,2,0,1,1,2,1,,,,,,,,,,
20150420-M-Barcelona-R64-Pablo_Carreno_Busta-Teymuraz_Gabashvili,2,B-XC,62,11,2,1,8,28,34,,,,,,,,,,
20150420-M-Barcelona-R64-Pablo_Carreno_Busta-Teymuraz_Gabashvili,2,B-DTM,18,1,0,0,1,8,10,,,,,,,,,,
20150420-M-Barcelona-R64-Pablo_Carreno_Busta-Teymuraz_Gabashvili,2,B-DTL,18,2,2,0,0,10,8,,,,,,,,,,
20150420-M-Barcelona-R64-Pablo_Carreno_Busta-Teymuraz_Gabashvili,2,B-IO,3,2,1,0,1,2,1,,,,,,,,,,
20150420-M-Barcelona-R64-Pablo_Carreno_Busta-Teymuraz_Gabashvili,2,S-XC,2,0,0,0,0,2,0,,,,,,,,,,
20150420-M-Barcelona-R64-Pablo_Carreno_Busta-Teymuraz_Gabashvili,2,S-DTM,5,0,0,0,0,2,3,,,,,,,,,,
20150420-M-Barcelona-R64-Pablo_Carreno_Busta-Teymuraz_Gabashvili,2,S-DTL,1,1,0,1,0,1,0,,,,,,,,,,
20150420-M-Barcelona-R64-Pablo_Carreno_Busta-Teymuraz_Gabashvili,2,S-IO,1,0,0,0,0,0,1,,,,,,,,,,
20150421-M-Barcelona-R64-Fernando_Verdasco-Andrey_Rublev,1,F-XC,54,8,5,1,2,34,20,,,,,,,,,,
20150421-M-Barcelona-R64-Fernando_Verdasco-Andrey_Rublev,1,F-DTM,19,2,0,0,2,4,15,,,,,,,,,,
20150421-M-Barcelona-R64-Fernando_Verdasco-Andrey_Rublev,1,F-DTL,5,5,2,0,3,2,3,,,,,,,,,,
20150421-M-Barcelona-R64-Fernando_Verdasco-Andrey_Rublev,1,F-IO,32,22,11,3,8,18,14,,,,,,,,,,
20150421-M-Barcelona-R64-Fernando_Verdasco-Andrey_Rublev,1,F-II,4,1,0,0,1,0,4,,,,,,,,,,
20150421-M-Barcelona-R64-Fernando_Verdasco-Andrey_Rublev,1,B-XC,39,10,1,3,6,15,24,,,,,,,,,,
20150421-M-Barcelona-R64-Fernando_Verdasco-Andrey_Rublev,1,B-DTM,29,2,0,0,2,3,26,,,,,,,,,,
20150421-M-Barcelona-R64-Fernando_Verdasco-Andrey_Rublev,1,B-DTL,22,9,3,1,5,8,14,,,,,,,,,,
20150421-M-Barcelona-R64-Fernando_Verdasco-Andrey_Rublev,1,B-IO,5,1,0,0,1,1,4,,,,,,,,,,
20150421-M-Barcelona-R64-Fernando_Verdasco-Andrey_Rublev,1,S-XC,1,0,0,0,0,0,1,,,,,,,,,,
20150421-M-Barcelona-R64-Fernando_Verdasco-Andrey_Rublev,1,S-DTM,8,0,0,0,0,4,4,,,,,,,,,,
20150421-M-Barcelona-R64-Fernando_Verdasco-Andrey_Rublev,1,S-DTL,7,1,1,0,0,3,4,,,,,,,,,,
20150421-M-Barcelona-R64-Fernando_Verdasco-Andrey_Rublev,2,F-XC,52,7,3,3,1,38,14,,,,,,,,,,
20150421-M-Barcelona-R64-Fernando_Verdasco-Andrey_Rublev,2,F-DTM,24,0,0,0,0,14,10,,,,,,,,,,
20150421-M-Barcelona-R64-Fernando_Verdasco-Andrey_Rublev,2,F-DTL,12,10,5,3,2,9,3,,,,,,,,,,
20150421-M-Barcelona-R64-Fernando_Verdasco-Andrey_Rublev,2,F-IO,26,14,5,5,4,19,7,,,,,,,,,,
20150421-M-Barcelona-R64-Fernando_Verdasco-Andrey_Rublev,2,F-II,8,1,0,1,0,5,3,,,,,,,,,,
20150421-M-Barcelona-R64-Fernando_Verdasco-Andrey_Rublev,2,B-XC,25,7,4,2,1,18,7,,,,,,,,,,
20150421-M-Barcelona-R64-Fernando_Verdasco-Andrey_Rublev,2,B-DTM,25,1,0,0,1,15,10,,,,,,,,,,
20150421-M-Barcelona-R64-Fernando_Verdasco-Andrey_Rublev,2,B-DTL,36,9,0,2,7,19,17,,,,,,,,,,
20150421-M-Barcelona-R64-Fernando_Verdasco-Andrey_Rublev,2,B-IO,13,1,0,1,0,11,2,,,,,,,,,,
20150421-M-Barcelona-R64-Fernando_Verdasco-Andrey_Rublev,2,S-DTM,4,0,0,0,0,1,3,,,,,,,,,,
20150421-M-Barcelona-R64-Fernando_Verdasco-Andrey_Rublev,2,S-DTL,4,0,0,0,0,2,2,,,,,,,,,,
20150423-M-Barcelona-R16-Kei_Nishikori-Santiago_Giraldo,1,F-XC,30,10,4,3,3,19,11,,,,,,,,,,
20150423-M-Barcelona-R16-Kei_Nishikori-Santiago_Giraldo,1,F-DTM,16,0,0,0,0,8,8,,,,,,,,,,
20150423-M-Barcelona-R16-Kei_Nishikori-Santiago_Giraldo,1,F-DTL,10,0,0,0,0,7,3,,,,,,,,,,
20150423-M-Barcelona-R16-Kei_Nishikori-Santiago_Giraldo,1,F-IO,21,4,0,1,3,10,11,,,,,,,,,,
20150423-M-Barcelona-R16-Kei_Nishikori-Santiago_Giraldo,1,B-XC,73,13,1,4,8,48,25,,,,,,,,,,
20150423-M-Barcelona-R16-Kei_Nishikori-Santiago_Giraldo,1,B-DTM,16,0,0,0,0,10,6,,,,,,,,,,
20150423-M-Barcelona-R16-Kei_Nishikori-Santiago_Giraldo,1,B-DTL,11,5,3,1,1,7,4,,,,,,,,,,
20150423-M-Barcelona-R16-Kei_Nishikori-Santiago_Giraldo,1,B-IO,2,2,0,1,1,1,1,,,,,,,,,,
20150423-M-Barcelona-R16-Kei_Nishikori-Santiago_Giraldo,1,S-XC,8,0,0,0,0,4,4,,,,,,,,,,
20150423-M-Barcelona-R16-Kei_Nishikori-Santiago_Giraldo,1,S-DTM,3,0,0,0,0,1,2,,,,,,,,,,
20150423-M-Barcelona-R16-Kei_Nishikori-Santiago_Giraldo,1,S-DTL,1,0,0,0,0,1,0,,,,,,,,,,
20150423-M-Barcelona-R16-Kei_Nishikori-Santiago_Giraldo,2,F-XC,22,5,1,1,3,9,13,,,,,,,,,,
20150423-M-Barcelona-R16-Kei_Nishikori-Santiago_Giraldo,2,F-DTM,14,1,0,0,1,4,10,,,,,,,,,,
20150423-M-Barcelona-R16-Kei_Nishikori-Santiago_Giraldo,2,F-DTL,11,1,0,1,0,7,4,,,,,,,,,,
20150423-M-Barcelona-R16-Kei_Nishikori-Santiago_Giraldo,2,F-IO,28,8,1,2,5,10,18,,,,,,,,,,
20150423-M-Barcelona-R16-Kei_Nishikori-Santiago_Giraldo,2,F-II,6,3,0,1,2,2,4,,,,,,,,,,
20150423-M-Barcelona-R16-Kei_Nishikori-Santiago_Giraldo,2,B-XC,66,8,2,1,5,27,39,,,,,,,,,,
20150423-M-Barcelona-R16-Kei_Nishikori-Santiago_Giraldo,2,B-DTM,29,2,0,0,2,9,20,,,,,,,,,,
20150423-M-Barcelona-R16-Kei_Nishikori-Santiago_Giraldo,2,B-DTL,18,10,1,3,6,6,12,,,,,,,,,,
20150423-M-Barcelona-R16-Kei_Nishikori-Santiago_Giraldo,2,B-IO,1,1,1,0,0,1,0,,,,,,,,,,
20150423-M-Barcelona-R16-Kei_Nishikori-Santiago_Giraldo,2,S-XC,3,0,0,0,0,1,2,,,,,,,,,,
20150423-M-Barcelona-R16-Kei_Nishikori-Santiago_Giraldo,2,S-DTM,1,0,0,0,0,0,1,,,,,,,,,,
20150424-M-Barcelona-QF-Roberto_Bautista_Agut-Kei_Nishikori,1,F-XC,43,11,4,1,6,13,30,,,,,,,,,,
20150424-M-Barcelona-QF-Roberto_Bautista_Agut-Kei_Nishikori,1,F-DTM,8,0,0,0,0,0,8,,,,,,,,,,
20150424-M-Barcelona-QF-Roberto_Bautista_Agut-Kei_Nishikori,1,F-DTL,18,3,0,0,3,5,13,,,,,,,,,,
20150424-M-Barcelona-QF-Roberto_Bautista_Agut-Kei_Nishikori,1,F-IO,29,8,2,2,4,9,20,,,,,,,,,,
20150424-M-Barcelona-QF-Roberto_Bautista_Agut-Kei_Nishikori,1,F-II,12,7,2,2,3,5,7,,,,,,,,,,
20150424-M-Barcelona-QF-Roberto_Bautista_Agut-Kei_Nishikori,1,B-XC,42,5,0,0,5,9,33,,,,,,,,,,
20150424-M-Barcelona-QF-Roberto_Bautista_Agut-Kei_Nishikori,1,B-DTM,46,3,0,0,3,13,33,,,,,,,,,,
20150424-M-Barcelona-QF-Roberto_Bautista_Agut-Kei_Nishikori,1,B-DTL,9,2,0,1,1,2,7,,,,,,,,,,
20150424-M-Barcelona-QF-Roberto_Bautista_Agut-Kei_Nishikori,1,B-IO,3,0,0,0,0,1,2,,,,,,,,,,
20150424-M-Barcelona-QF-Roberto_Bautista_Agut-Kei_Nishikori,1,S-XC,14,0,0,0,0,2,12,,,,,,,,,,
20150424-M-Barcelona-QF-Roberto_Bautista_Agut-Kei_Nishikori,1,S-DTM,7,0,0,0,0,0,7,,,,,,,,,,
20150424-M-Barcelona-QF-Roberto_Bautista_Agut-Kei_Nishikori,1,S-DTL,5,0,0,0,0,2,3,,,,,,,,,,
20150424-M-Barcelona-QF-Roberto_Bautista_Agut-Kei_Nishikori,2,F-XC,46,12,2,7,3,39,7,,,,,,,,,,
20150424-M-Barcelona-QF-Roberto_Bautista_Agut-Kei_Nishikori,2,F-DTM,12,0,0,0,0,7,5,,,,,,,,,,
20150424-M-Barcelona-QF-Roberto_Bautista_Agut-Kei_Nishikori,2,F-DTL,23,4,0,0,4,16,7,,,,,,,,,,
20150424-M-Barcelona-QF-Roberto_Bautista_Agut-Kei_Nishikori,2,F-IO,37,11,4,3,4,28,9,,,,,,,,,,
20150424-M-Barcelona-QF-Roberto_Bautista_Agut-Kei_Nishikori,2,F-II,5,1,0,0,1,3,2,,,,,,,,,,
20150424-M-Barcelona-QF-Roberto_Bautista_Agut-Kei_Nishikori,2,B-XC,69,11,4,3,4,51,18,,,,,,,,,,
20150424-M-Barcelona-QF-Roberto_Bautista_Agut-Kei_Nishikori,2,B-DTM,13,1,0,0,1,11,2,,,,,,,,,,
20150424-M-Barcelona-QF-Roberto_Bautista_Agut-Kei_Nishikori,2,B-DTL,11,5,1,4,0,10,1,,,,,,,,,,
20150424-M-Barcelona-QF-Roberto_Bautista_Agut-Kei_Nishikori,2,B-IO,7,3,2,0,1,4,3,,,,,,,,,,
20150424-M-Barcelona-QF-Roberto_Bautista_Agut-Kei_Nishikori,2,S-XC,11,1,0,1,0,9,2,,,,,,,,,,
20150424-M-Barcelona-QF-Roberto_Bautista_Agut-Kei_Nishikori,2,S-DTM,3,0,0,0,0,2,1,,,,,,,,,,
20150424-M-Bucharest-QF-Lukas_Rosol-Guillermo_Garcia_Lopez,1,F-XC,35,8,5,2,1,21,14,,,,,,,,,,
20150424-M-Bucharest-QF-Lukas_Rosol-Guillermo_Garcia_Lopez,1,F-DTM,28,6,0,1,5,11,17,,,,,,,,,,
20150424-M-Bucharest-QF-Lukas_Rosol-Guillermo_Garcia_Lopez,1,F-DTL,19,6,1,2,3,11,8,,,,,,,,,,
20150424-M-Bucharest-QF-Lukas_Rosol-Guillermo_Garcia_Lopez,1,F-IO,34,12,2,5,5,23,11,,,,,,,,,,
20150424-M-Bucharest-QF-Lukas_Rosol-Guillermo_Garcia_Lopez,1,F-II,7,3,2,0,1,4,3,,,,,,,,,,
20150424-M-Bucharest-QF-Lukas_Rosol-Guillermo_Garcia_Lopez,1,B-XC,60,9,1,5,3,27,33,,,,,,,,,,
20150424-M-Bucharest-QF-Lukas_Rosol-Guillermo_Garcia_Lopez,1,B-DTM,23,2,0,1,1,11,12,,,,,,,,,,
20150424-M-Bucharest-QF-Lukas_Rosol-Guillermo_Garcia_Lopez,1,B-DTL,11,6,4,0,2,5,6,,,,,,,,,,
20150424-M-Bucharest-QF-Lukas_Rosol-Guillermo_Garcia_Lopez,1,B-IO,2,0,0,0,0,2,0,,,,,,,,,,
20150424-M-Bucharest-QF-Lukas_Rosol-Guillermo_Garcia_Lopez,1,S-XC,16,1,0,0,1,9,7,,,,,,,,,,
20150424-M-Bucharest-QF-Lukas_Rosol-Guillermo_Garcia_Lopez,1,S-DTM,2,0,0,0,0,0,2,,,,,,,,,,
20150424-M-Bucharest-QF-Lukas_Rosol-Guillermo_Garcia_Lopez,2,F-XC,30,7,3,4,0,16,14,,,,,,,,,,
20150424-M-Bucharest-QF-Lukas_Rosol-Guillermo_Garcia_Lopez,2,F-DTM,21,1,0,0,1,7,14,,,,,,,,,,
20150424-M-Bucharest-QF-Lukas_Rosol-Guillermo_Garcia_Lopez,2,F-DTL,22,5,1,2,2,12,10,,,,,,,,,,
20150424-M-Bucharest-QF-Lukas_Rosol-Guillermo_Garcia_Lopez,2,F-IO,33,9,4,4,1,25,8,,,,,,,,,,
20150424-M-Bucharest-QF-Lukas_Rosol-Guillermo_Garcia_Lopez,2,F-II,9,4,1,1,2,5,4,,,,,,,,,,
20150424-M-Bucharest-QF-Lukas_Rosol-Guillermo_Garcia_Lopez,2,B-XC,39,4,1,0,3,22,17,,,,,,,,,,
20150424-M-Bucharest-QF-Lukas_Rosol-Guillermo_Garcia_Lopez,2,B-DTM,40,3,0,0,3,18,22,,,,,,,,,,
20150424-M-Bucharest-QF-Lukas_Rosol-Guillermo_Garcia_Lopez,2,B-DTL,12,4,1,3,0,4,8,,,,,,,,,,
20150424-M-Bucharest-QF-Lukas_Rosol-Guillermo_Garcia_Lopez,2,B-IO,5,2,1,1,0,4,1,,,,,,,,,,
20150424-M-Bucharest-QF-Lukas_Rosol-Guillermo_Garcia_Lopez,2,S-XC,15,0,0,0,0,7,8,,,,,,,,,,
20150424-M-Bucharest-QF-Lukas_Rosol-Guillermo_Garcia_Lopez,2,S-DTM,8,0,0,0,0,1,7,,,,,,,,,,
20150424-M-Bucharest-QF-Lukas_Rosol-Guillermo_Garcia_Lopez,2,S-DTL,4,1,0,0,1,1,3,,,,,,,,,,
20150425-M-Bucharest-SF-Jiri_Vesely-Daniel_Gimeno_Traver,1,F-XC,45,3,2,0,1,26,19,,,,,,,,,,
20150425-M-Bucharest-SF-Jiri_Vesely-Daniel_Gimeno_Traver,1,F-DTM,18,1,1,0,0,10,8,,,,,,,,,,
20150425-M-Bucharest-SF-Jiri_Vesely-Daniel_Gimeno_Traver,1,F-DTL,10,4,1,2,1,5,5,,,,,,,,,,
20150425-M-Bucharest-SF-Jiri_Vesely-Daniel_Gimeno_Traver,1,F-IO,12,1,0,0,1,7,5,,,,,,,,,,
20150425-M-Bucharest-SF-Jiri_Vesely-Daniel_Gimeno_Traver,1,F-II,2,1,1,0,0,2,0,,,,,,,,,,
20150425-M-Bucharest-SF-Jiri_Vesely-Daniel_Gimeno_Traver,1,B-XC,64,8,2,1,5,34,30,,,,,,,,,,
20150425-M-Bucharest-SF-Jiri_Vesely-Daniel_Gimeno_Traver,1,B-DTM,39,2,0,0,2,17,22,,,,,,,,,,
20150425-M-Bucharest-SF-Jiri_Vesely-Daniel_Gimeno_Traver,1,B-DTL,19,7,3,1,3,10,9,,,,,,,,,,
20150425-M-Bucharest-SF-Jiri_Vesely-Daniel_Gimeno_Traver,1,B-IO,11,1,0,1,0,6,5,,,,,,,,,,
20150425-M-Bucharest-SF-Jiri_Vesely-Daniel_Gimeno_Traver,1,S-XC,1,0,0,0,0,0,1,,,,,,,,,,
20150425-M-Bucharest-SF-Jiri_Vesely-Daniel_Gimeno_Traver,1,S-DTM,4,0,0,0,0,2,2,,,,,,,,,,
20150425-M-Bucharest-SF-Jiri_Vesely-Daniel_Gimeno_Traver,1,S-DTL,3,0,0,0,0,2,1,,,,,,,,,,
20150425-M-Bucharest-SF-Jiri_Vesely-Daniel_Gimeno_Traver,2,F-XC,74,8,4,2,2,38,36,,,,,,,,,,
20150425-M-Bucharest-SF-Jiri_Vesely-Daniel_Gimeno_Traver,2,F-DTM,19,1,0,0,1,12,7,,,,,,,,,,
20150425-M-Bucharest-SF-Jiri_Vesely-Daniel_Gimeno_Traver,2,F-DTL,28,12,4,3,5,12,16,,,,,,,,,,
20150425-M-Bucharest-SF-Jiri_Vesely-Daniel_Gimeno_Traver,2,F-IO,19,10,5,1,4,8,11,,,,,,,,,,
20150425-M-Bucharest-SF-Jiri_Vesely-Daniel_Gimeno_Traver,2,F-II,8,2,0,1,1,3,5,,,,,,,,,,
20150425-M-Bucharest-SF-Jiri_Vesely-Daniel_Gimeno_Traver,2,B-XC,19,6,3,1,2,12,7,,,,,,,,,,
20150425-M-Bucharest-SF-Jiri_Vesely-Daniel_Gimeno_Traver,2,B-DTM,24,3,0,0,3,12,12,,,,,,,,,,
20150425-M-Bucharest-SF-Jiri_Vesely-Daniel_Gimeno_Traver,2,B-DTL,15,4,0,1,3,7,8,,,,,,,,,,
20150425-M-Bucharest-SF-Jiri_Vesely-Daniel_Gimeno_Traver,2,B-IO,8,1,0,0,1,2,6,,,,,,,,,,
20150425-M-Bucharest-SF-Jiri_Vesely-Daniel_Gimeno_Traver,2,S-XC,4,1,0,0,1,2,2,,,,,,,,,,
20150425-M-Bucharest-SF-Jiri_Vesely-Daniel_Gimeno_Traver,2,S-DTM,2,0,0,0,0,1,1,,,,,,,,,,
20150425-M-Bucharest-SF-Jiri_Vesely-Daniel_Gimeno_Traver,2,S-DTL,11,0,0,0,0,5,6,,,,,,,,,,
20150425-M-Bucharest-SF-Jiri_Vesely-Daniel_Gimeno_Traver,2,S-IO,3,1,0,0,1,0,3,,,,,,,,,,
20150426-M-Bucharest-F-Guillermo_Garcia_Lopez-Jiri_Vesely,1,F-XC,104,14,9,1,4,67,37,,,,,,,,,,
20150426-M-Bucharest-F-Guillermo_Garcia_Lopez-Jiri_Vesely,1,F-DTM,19,0,0,0,0,9,10,,,,,,,,,,
20150426-M-Bucharest-F-Guillermo_Garcia_Lopez-Jiri_Vesely,1,F-DTL,26,6,4,2,0,16,10,,,,,,,,,,
20150426-M-Bucharest-F-Guillermo_Garcia_Lopez-Jiri_Vesely,1,F-IO,24,7,4,2,1,17,7,,,,,,,,,,
20150426-M-Bucharest-F-Guillermo_Garcia_Lopez-Jiri_Vesely,1,F-II,8,1,0,1,0,7,1,,,,,,,,,,
20150426-M-Bucharest-F-Guillermo_Garcia_Lopez-Jiri_Vesely,1,B-XC,33,8,2,0,6,11,22,,,,,,,,,,
20150426-M-Bucharest-F-Guillermo_Garcia_Lopez-Jiri_Vesely,1,B-DTM,24,2,0,0,2,9,15,,,,,,,,,,
20150426-M-Bucharest-F-Guillermo_Garcia_Lopez-Jiri_Vesely,1,B-DTL,19,3,2,1,0,6,13,,,,,,,,,,
20150426-M-Bucharest-F-Guillermo_Garcia_Lopez-Jiri_Vesely,1,B-IO,5,2,0,1,1,4,1,,,,,,,,,,
20150426-M-Bucharest-F-Guillermo_Garcia_Lopez-Jiri_Vesely,1,S-XC,8,0,0,0,0,4,4,,,,,,,,,,
20150426-M-Bucharest-F-Guillermo_Garcia_Lopez-Jiri_Vesely,1,S-DTM,10,0,0,0,0,2,8,,,,,,,,,,
20150426-M-Bucharest-F-Guillermo_Garcia_Lopez-Jiri_Vesely,1,S-DTL,16,3,0,1,2,7,9,,,,,,,,,,
20150426-M-Bucharest-F-Guillermo_Garcia_Lopez-Jiri_Vesely,1,S-IO,3,1,0,0,1,1,2,,,,,,,,,,
20150426-M-Bucharest-F-Guillermo_Garcia_Lopez-Jiri_Vesely,2,F-XC,72,10,3,2,5,45,27,,,,,,,,,,
20150426-M-Bucharest-F-Guillermo_Garcia_Lopez-Jiri_Vesely,2,F-DTM,16,0,0,0,0,6,10,,,,,,,,,,
20150426-M-Bucharest-F-Guillermo_Garcia_Lopez-Jiri_Vesely,2,F-DTL,24,6,2,3,1,11,13,,,,,,,,,,
20150426-M-Bucharest-F-Guillermo_Garcia_Lopez-Jiri_Vesely,2,F-IO,25,6,1,1,4,15,10,,,,,,,,,,
20150426-M-Bucharest-F-Guillermo_Garcia_Lopez-Jiri_Vesely,2,F-II,2,1,1,0,0,2,0,,,,,,,,,,
20150426-M-Bucharest-F-Guillermo_Garcia_Lopez-Jiri_Vesely,2,B-XC,70,12,3,1,8,26,44,,,,,,,,,,
20150426-M-Bucharest-F-Guillermo_Garcia_Lopez-Jiri_Vesely,2,B-DTM,20,0,0,0,0,6,14,,,,,,,,,,
20150426-M-Bucharest-F-Guillermo_Garcia_Lopez-Jiri_Vesely,2,B-DTL,44,11,5,0,6,27,17,,,,,,,,,,
20150426-M-Bucharest-F-Guillermo_Garcia_Lopez-Jiri_Vesely,2,B-IO,7,2,1,0,1,6,1,,,,,,,,,,
20150426-M-Bucharest-F-Guillermo_Garcia_Lopez-Jiri_Vesely,2,S-XC,1,0,0,0,0,0,1,,,,,,,,,,
20150426-M-Bucharest-F-Guillermo_Garcia_Lopez-Jiri_Vesely,2,S-DTM,9,0,0,0,0,0,9,,,,,,,,,,
20150426-M-Bucharest-F-Guillermo_Garcia_Lopez-Jiri_Vesely,2,S-DTL,6,1,0,1,0,3,3,,,,,,,,,,
20150429-M-Istanbul-R16-Diego_Sebastian_Schwartzman-Jurgen_Melzer,1,F-XC,33,8,3,0,5,12,21,,,,,,,,,,
20150429-M-Istanbul-R16-Diego_Sebastian_Schwartzman-Jurgen_Melzer,1,F-DTM,26,3,0,0,3,16,10,,,,,,,,,,
20150429-M-Istanbul-R16-Diego_Sebastian_Schwartzman-Jurgen_Melzer,1,F-DTL,5,4,3,0,1,3,2,,,,,,,,,,
20150429-M-Istanbul-R16-Diego_Sebastian_Schwartzman-Jurgen_Melzer,1,F-IO,18,10,3,3,4,10,8,,,,,,,,,,
20150429-M-Istanbul-R16-Diego_Sebastian_Schwartzman-Jurgen_Melzer,1,F-II,1,1,1,0,0,1,0,,,,,,,,,,
20150429-M-Istanbul-R16-Diego_Sebastian_Schwartzman-Jurgen_Melzer,1,B-XC,9,2,1,0,1,8,1,,,,,,,,,,
20150429-M-Istanbul-R16-Diego_Sebastian_Schwartzman-Jurgen_Melzer,1,B-DTM,15,2,0,0,2,10,5,,,,,,,,,,
20150429-M-Istanbul-R16-Diego_Sebastian_Schwartzman-Jurgen_Melzer,1,B-DTL,4,2,1,0,1,2,2,,,,,,,,,,
20150429-M-Istanbul-R16-Diego_Sebastian_Schwartzman-Jurgen_Melzer,1,B-IO,4,3,3,0,0,3,1,,,,,,,,,,
20150429-M-Istanbul-R16-Diego_Sebastian_Schwartzman-Jurgen_Melzer,1,S-XC,2,0,0,0,0,1,1,,,,,,,,,,
20150429-M-Istanbul-R16-Diego_Sebastian_Schwartzman-Jurgen_Melzer,1,S-DTM,2,0,0,0,0,1,1,,,,,,,,,,
20150429-M-Istanbul-R16-Diego_Sebastian_Schwartzman-Jurgen_Melzer,2,F-XC,17,1,0,0,1,5,12,,,,,,,,,,
20150429-M-Istanbul-R16-Diego_Sebastian_Schwartzman-Jurgen_Melzer,2,F-DTM,18,1,0,0,1,3,15,,,,,,,,,,
20150429-M-Istanbul-R16-Diego_Sebastian_Schwartzman-Jurgen_Melzer,2,F-DTL,1,1,0,0,1,0,1,,,,,,,,,,
20150429-M-Istanbul-R16-Diego_Sebastian_Schwartzman-Jurgen_Melzer,2,F-IO,9,1,0,0,1,5,4,,,,,,,,,,
20150429-M-Istanbul-R16-Diego_Sebastian_Schwartzman-Jurgen_Melzer,2,B-XC,25,5,0,2,3,13,12,,,,,,,,,,
20150429-M-Istanbul-R16-Diego_Sebastian_Schwartzman-Jurgen_Melzer,2,B-DTM,24,3,0,0,3,11,13,,,,,,,,,,
20150429-M-Istanbul-R16-Diego_Sebastian_Schwartzman-Jurgen_Melzer,2,B-DTL,5,3,1,0,2,3,2,,,,,,,,,,
20150429-M-Istanbul-R16-Diego_Sebastian_Schwartzman-Jurgen_Melzer,2,B-IO,2,1,0,0,1,0,2,,,,,,,,,,
20150429-M-Istanbul-R16-Diego_Sebastian_Schwartzman-Jurgen_Melzer,2,S-IO,1,0,0,0,0,0,1,,,,,,,,,,
20150430-M-Istanbul-R16-Denis_Istomin-Thomaz_Bellucci,1,F-XC,35,6,2,1,3,19,16,,,,,,,,,,
20150430-M-Istanbul-R16-Denis_Istomin-Thomaz_Bellucci,1,F-DTM,14,0,0,0,0,7,7,,,,,,,,,,
20150430-M-Istanbul-R16-Denis_Istomin-Thomaz_Bellucci,1,F-DTL,12,5,2,0,3,8,4,,,,,,,,,,
20150430-M-Istanbul-R16-Denis_Istomin-Thomaz_Bellucci,1,F-IO,16,5,3,1,1,9,7,,,,,,,,,,
20150430-M-Istanbul-R16-Denis_Istomin-Thomaz_Bellucci,1,F-II,4,3,1,0,2,1,3,,,,,,,,,,
20150430-M-Istanbul-R16-Denis_Istomin-Thomaz_Bellucci,1,B-XC,39,13,5,1,7,21,18,,,,,,,,,,
20150430-M-Istanbul-R16-Denis_Istomin-Thomaz_Bellucci,1,B-DTM,22,2,0,0,2,11,11,,,,,,,,,,
20150430-M-Istanbul-R16-Denis_Istomin-Thomaz_Bellucci,1,B-DTL,20,3,1,0,2,11,9,,,,,,,,,,
20150430-M-Istanbul-R16-Denis_Istomin-Thomaz_Bellucci,1,B-IO,7,2,0,0,2,3,4,,,,,,,,,,
20150430-M-Istanbul-R16-Denis_Istomin-Thomaz_Bellucci,1,S-DTM,3,0,0,0,0,1,2,,,,,,,,,,
20150430-M-Istanbul-R16-Denis_Istomin-Thomaz_Bellucci,1,S-DTL,3,0,0,0,0,1,2,,,,,,,,,,
20150430-M-Istanbul-R16-Denis_Istomin-Thomaz_Bellucci,2,F-XC,56,9,1,3,5,28,28,,,,,,,,,,
20150430-M-Istanbul-R16-Denis_Istomin-Thomaz_Bellucci,2,F-DTM,21,5,1,1,3,11,10,,,,,,,,,,
20150430-M-Istanbul-R16-Denis_Istomin-Thomaz_Bellucci,2,F-DTL,8,2,1,0,1,5,3,,,,,,,,,,
20150430-M-Istanbul-R16-Denis_Istomin-Thomaz_Bellucci,2,F-IO,20,10,3,1,6,11,9,,,,,,,,,,
20150430-M-Istanbul-R16-Denis_Istomin-Thomaz_Bellucci,2,F-II,6,2,1,1,0,6,0,,,,,,,,,,
20150430-M-Istanbul-R16-Denis_Istomin-Thomaz_Bellucci,2,B-XC,39,9,1,5,3,18,21,,,,,,,,,,
20150430-M-Istanbul-R16-Denis_Istomin-Thomaz_Bellucci,2,B-DTM,12,0,0,0,0,7,5,,,,,,,,,,
20150430-M-Istanbul-R16-Denis_Istomin-Thomaz_Bellucci,2,B-DTL,8,2,0,2,0,4,4,,,,,,,,,,
20150430-M-Istanbul-R16-Denis_Istomin-Thomaz_Bellucci,2,B-IO,1,0,0,0,0,0,1,,,,,,,,,,
20150430-M-Istanbul-R16-Denis_Istomin-Thomaz_Bellucci,2,S-XC,1,1,0,0,1,0,1,,,,,,,,,,
20150430-M-Istanbul-R16-Denis_Istomin-Thomaz_Bellucci,2,S-DTM,2,0,0,0,0,0,2,,,,,,,,,,
20150430-M-Istanbul-R16-Denis_Istomin-Thomaz_Bellucci,2,S-DTL,3,0,0,0,0,1,2,,,,,,,,,,
20150430-M-Munich-R16-Fabio_Fognini-Dominic_Thiem,1,F-XC,28,10,2,3,5,17,11,,,,,,,,,,
20150430-M-Munich-R16-Fabio_Fognini-Dominic_Thiem,1,F-DTM,12,0,0,0,0,9,3,,,,,,,,,,
20150430-M-Munich-R16-Fabio_Fognini-Dominic_Thiem,1,F-DTL,3,1,0,1,0,1,2,,,,,,,,,,
20150430-M-Munich-R16-Fabio_Fognini-Dominic_Thiem,1,F-IO,30,6,0,1,5,10,20,,,,,,,,,,
20150430-M-Munich-R16-Fabio_Fognini-Dominic_Thiem,1,F-II,3,3,0,1,2,1,2,,,,,,,,,,
20150430-M-Munich-R16-Fabio_Fognini-Dominic_Thiem,1,B-XC,18,4,0,1,3,8,10,,,,,,,,,,
20150430-M-Munich-R16-Fabio_Fognini-Dominic_Thiem,1,B-DTM,8,0,0,0,0,6,2,,,,,,,,,,
20150430-M-Munich-R16-Fabio_Fognini-Dominic_Thiem,1,B-DTL,13,5,0,1,4,2,11,,,,,,,,,,
20150430-M-Munich-R16-Fabio_Fognini-Dominic_Thiem,1,B-IO,1,1,0,0,1,0,1,,,,,,,,,,
20150430-M-Munich-R16-Fabio_Fognini-Dominic_Thiem,1,S-DTM,1,0,0,0,0,1,0,,,,,,,,,,
20150430-M-Munich-R16-Fabio_Fognini-Dominic_Thiem,2,F-XC,22,6,1,3,2,8,14,,,,,,,,,,
20150430-M-Munich-R16-Fabio_Fognini-Dominic_Thiem,2,F-DTM,10,0,0,0,0,2,8,,,,,,,,,,
20150430-M-Munich-R16-Fabio_Fognini-Dominic_Thiem,2,F-DTL,9,4,1,2,1,5,4,,,,,,,,,,
20150430-M-Munich-R16-Fabio_Fognini-Dominic_Thiem,2,F-IO,26,11,3,2,6,12,14,,,,,,,,,,
20150430-M-Munich-R16-Fabio_Fognini-Dominic_Thiem,2,F-II,1,0,0,0,0,1,0,,,,,,,,,,
20150430-M-Munich-R16-Fabio_Fognini-Dominic_Thiem,2,B-XC,11,1,0,0,1,4,7,,,,,,,,,,
20150430-M-Munich-R16-Fabio_Fognini-Dominic_Thiem,2,B-DTM,9,0,0,0,0,4,5,,,,,,,,,,
20150430-M-Munich-R16-Fabio_Fognini-Dominic_Thiem,2,B-DTL,2,2,0,0,2,0,2,,,,,,,,,,
20150430-M-Munich-R16-Fabio_Fognini-Dominic_Thiem,2,B-II,1,1,1,0,0,1,0,,,,,,,,,,
20150430-M-Munich-R16-Fabio_Fognini-Dominic_Thiem,2,S-XC,14,2,0,1,1,10,4,,,,,,,,,,
20150430-M-Munich-R16-Fabio_Fognini-Dominic_Thiem,2,S-DTM,8,0,0,0,0,6,2,,,,,,,,,,
20150430-M-Munich-R16-Fabio_Fognini-Dominic_Thiem,2,S-DTL,1,0,0,0,0,1,0,,,,,,,,,,
20150501-M-Estoril-QF-Richard_Gasquet-Nicolas_Almagro,1,F-XC,29,9,3,4,2,20,9,,,,,,,,,,
20150501-M-Estoril-QF-Richard_Gasquet-Nicolas_Almagro,1,F-DTM,31,1,0,0,1,19,12,,,,,,,,,,
20150501-M-Estoril-QF-Richard_Gasquet-Nicolas_Almagro,1,F-DTL,6,1,1,0,0,3,3,,,,,,,,,,
20150501-M-Estoril-QF-Richard_Gasquet-Nicolas_Almagro,1,F-IO,15,3,0,2,1,9,6,,,,,,,,,,
20150501-M-Estoril-QF-Richard_Gasquet-Nicolas_Almagro,1,B-XC,60,6,2,1,3,40,20,,,,,,,,,,
20150501-M-Estoril-QF-Richard_Gasquet-Nicolas_Almagro,1,B-DTM,23,2,0,0,2,13,10,,,,,,,,,,
20150501-M-Estoril-QF-Richard_Gasquet-Nicolas_Almagro,1,B-DTL,5,2,1,1,0,3,2,,,,,,,,,,
20150501-M-Estoril-QF-Richard_Gasquet-Nicolas_Almagro,1,B-IO,2,1,1,0,0,1,1,,,,,,,,,,
20150501-M-Estoril-QF-Richard_Gasquet-Nicolas_Almagro,1,S-XC,5,1,0,1,0,4,1,,,,,,,,,,
20150501-M-Estoril-QF-Richard_Gasquet-Nicolas_Almagro,1,S-DTM,2,0,0,0,0,1,1,,,,,,,,,,
20150501-M-Estoril-QF-Richard_Gasquet-Nicolas_Almagro,2,F-XC,42,11,3,1,7,17,25,,,,,,,,,,
20150501-M-Estoril-QF-Richard_Gasquet-Nicolas_Almagro,2,F-DTM,11,0,0,0,0,4,7,,,,,,,,,,
20150501-M-Estoril-QF-Richard_Gasquet-Nicolas_Almagro,2,F-DTL,3,3,3,0,0,3,0,,,,,,,,,,
20150501-M-Estoril-QF-Richard_Gasquet-Nicolas_Almagro,2,F-IO,25,11,3,5,3,16,9,,,,,,,,,,
20150501-M-Estoril-QF-Richard_Gasquet-Nicolas_Almagro,2,F-II,5,2,0,1,1,2,3,,,,,,,,,,
20150501-M-Estoril-QF-Richard_Gasquet-Nicolas_Almagro,2,B-XC,56,5,1,2,2,20,36,,,,,,,,,,
20150501-M-Estoril-QF-Richard_Gasquet-Nicolas_Almagro,2,B-DTM,32,2,0,0,2,9,23,,,,,,,,,,
20150501-M-Estoril-QF-Richard_Gasquet-Nicolas_Almagro,2,B-DTL,12,8,3,1,4,5,7,,,,,,,,,,
20150501-M-Estoril-QF-Richard_Gasquet-Nicolas_Almagro,2,B-IO,4,3,0,1,2,2,2,,,,,,,,,,
20150501-M-Estoril-QF-Richard_Gasquet-Nicolas_Almagro,2,B-II,1,0,0,0,0,0,1,,,,,,,,,,
20150501-M-Estoril-QF-Richard_Gasquet-Nicolas_Almagro,2,S-XC,2,1,0,1,0,1,1,,,,,,,,,,
20150501-M-Estoril-QF-Richard_Gasquet-Nicolas_Almagro,2,S-DTL,1,1,0,0,1,0,1,,,,,,,,,,
20150502-M-Istanbul-SF-Grigor_Dimitrov-Pablo_Cuevas,1,F-XC,21,8,2,3,3,9,12,,,,,,,,,,
20150502-M-Istanbul-SF-Grigor_Dimitrov-Pablo_Cuevas,1,F-DTM,27,2,0,0,2,11,16,,,,,,,,,,
20150502-M-Istanbul-SF-Grigor_Dimitrov-Pablo_Cuevas,1,F-DTL,4,2,1,1,0,2,2,,,,,,,,,,
20150502-M-Istanbul-SF-Grigor_Dimitrov-Pablo_Cuevas,1,F-IO,27,9,4,1,4,13,14,,,,,,,,,,
20150502-M-Istanbul-SF-Grigor_Dimitrov-Pablo_Cuevas,1,F-II,8,3,1,0,2,5,3,,,,,,,,,,
20150502-M-Istanbul-SF-Grigor_Dimitrov-Pablo_Cuevas,1,B-XC,26,1,0,1,0,7,19,,,,,,,,,,
20150502-M-Istanbul-SF-Grigor_Dimitrov-Pablo_Cuevas,1,B-DTM,32,2,0,0,2,12,20,,,,,,,,,,
20150502-M-Istanbul-SF-Grigor_Dimitrov-Pablo_Cuevas,1,B-DTL,7,2,0,1,1,2,5,,,,,,,,,,
20150502-M-Istanbul-SF-Grigor_Dimitrov-Pablo_Cuevas,1,B-IO,2,1,1,0,0,2,0,,,,,,,,,,
20150502-M-Istanbul-SF-Grigor_Dimitrov-Pablo_Cuevas,1,S-XC,9,0,0,0,0,4,5,,,,,,,,,,
20150502-M-Istanbul-SF-Grigor_Dimitrov-Pablo_Cuevas,1,S-DTM,12,3,0,0,3,3,9,,,,,,,,,,
20150502-M-Istanbul-SF-Grigor_Dimitrov-Pablo_Cuevas,1,S-DTL,1,1,0,0,1,0,1,,,,,,,,,,
20150502-M-Istanbul-SF-Grigor_Dimitrov-Pablo_Cuevas,1,S-IO,1,1,0,0,1,0,1,,,,,,,,,,
20150502-M-Istanbul-SF-Grigor_Dimitrov-Pablo_Cuevas,2,F-XC,22,7,2,3,2,12,10,,,,,,,,,,
20150502-M-Istanbul-SF-Grigor_Dimitrov-Pablo_Cuevas,2,F-DTM,37,3,0,2,1,21,16,,,,,,,,,,
20150502-M-Istanbul-SF-Grigor_Dimitrov-Pablo_Cuevas,2,F-DTL,4,1,1,0,0,3,1,,,,,,,,,,
20150502-M-Istanbul-SF-Grigor_Dimitrov-Pablo_Cuevas,2,F-IO,34,10,2,3,5,17,17,,,,,,,,,,
20150502-M-Istanbul-SF-Grigor_Dimitrov-Pablo_Cuevas,2,F-II,3,1,0,1,0,2,1,,,,,,,,,,
20150502-M-Istanbul-SF-Grigor_Dimitrov-Pablo_Cuevas,2,B-XC,38,3,1,1,1,28,10,,,,,,,,,,
20150502-M-Istanbul-SF-Grigor_Dimitrov-Pablo_Cuevas,2,B-DTM,23,3,0,2,1,16,7,,,,,,,,,,
20150502-M-Istanbul-SF-Grigor_Dimitrov-Pablo_Cuevas,2,B-DTL,4,4,4,0,0,4,0,,,,,,,,,,
20150502-M-Istanbul-SF-Grigor_Dimitrov-Pablo_Cuevas,2,B-IO,1,1,0,1,0,1,0,,,,,,,,,,
20150502-M-Istanbul-SF-Grigor_Dimitrov-Pablo_Cuevas,2,B-II,1,0,0,0,0,1,0,,,,,,,,,,
20150502-M-Istanbul-SF-Grigor_Dimitrov-Pablo_Cuevas,2,S-XC,5,0,0,0,0,1,4,,,,,,,,,,
20150502-M-Istanbul-SF-Grigor_Dimitrov-Pablo_Cuevas,2,S-DTM,4,0,0,0,0,4,0,,,,,,,,,,
20150502-M-Istanbul-SF-Roger_Federer-Diego_Sebastian_Schwartzman,1,F-XC,35,8,5,2,1,21,14,,,,,,,,,,
20150502-M-Istanbul-SF-Roger_Federer-Diego_Sebastian_Schwartzman,1,F-DTM,29,5,0,3,2,10,19,,,,,,,,,,
20150502-M-Istanbul-SF-Roger_Federer-Diego_Sebastian_Schwartzman,1,F-DTL,9,2,0,1,1,3,6,,,,,,,,,,
20150502-M-Istanbul-SF-Roger_Federer-Diego_Sebastian_Schwartzman,1,F-IO,36,8,1,0,7,10,26,,,,,,,,,,
20150502-M-Istanbul-SF-Roger_Federer-Diego_Sebastian_Schwartzman,1,F-II,2,0,0,0,0,2,0,,,,,,,,,,
20150502-M-Istanbul-SF-Roger_Federer-Diego_Sebastian_Schwartzman,1,B-XC,36,8,1,2,5,13,23,,,,,,,,,,
20150502-M-Istanbul-SF-Roger_Federer-Diego_Sebastian_Schwartzman,1,B-DTM,32,5,0,2,3,10,22,,,,,,,,,,
20150502-M-Istanbul-SF-Roger_Federer-Diego_Sebastian_Schwartzman,1,B-DTL,13,4,2,0,2,5,8,,,,,,,,,,
20150502-M-Istanbul-SF-Roger_Federer-Diego_Sebastian_Schwartzman,1,B-IO,7,5,1,1,3,4,3,,,,,,,,,,
20150502-M-Istanbul-SF-Roger_Federer-Diego_Sebastian_Schwartzman,1,S-XC,17,0,0,0,0,5,12,,,,,,,,,,
20150502-M-Istanbul-SF-Roger_Federer-Diego_Sebastian_Schwartzman,1,S-DTM,5,0,0,0,0,0,5,,,,,,,,,,
20150502-M-Istanbul-SF-Roger_Federer-Diego_Sebastian_Schwartzman,1,S-DTL,4,0,0,0,0,3,1,,,,,,,,,,
20150502-M-Istanbul-SF-Roger_Federer-Diego_Sebastian_Schwartzman,2,F-XC,36,12,4,3,5,22,14,,,,,,,,,,
20150502-M-Istanbul-SF-Roger_Federer-Diego_Sebastian_Schwartzman,2,F-DTM,43,3,0,0,3,24,19,,,,,,,,,,
20150502-M-Istanbul-SF-Roger_Federer-Diego_Sebastian_Schwartzman,2,F-DTL,9,4,2,1,1,6,3,,,,,,,,,,
20150502-M-Istanbul-SF-Roger_Federer-Diego_Sebastian_Schwartzman,2,F-IO,34,11,2,5,4,22,12,,,,,,,,,,
20150502-M-Istanbul-SF-Roger_Federer-Diego_Sebastian_Schwartzman,2,F-II,2,1,1,0,0,1,1,,,,,,,,,,
20150502-M-Istanbul-SF-Roger_Federer-Diego_Sebastian_Schwartzman,2,B-XC,64,11,1,6,4,41,23,,,,,,,,,,
20150502-M-Istanbul-SF-Roger_Federer-Diego_Sebastian_Schwartzman,2,B-DTM,32,2,0,1,1,22,10,,,,,,,,,,
20150502-M-Istanbul-SF-Roger_Federer-Diego_Sebastian_Schwartzman,2,B-DTL,11,9,5,1,3,8,3,,,,,,,,,,
20150502-M-Istanbul-SF-Roger_Federer-Diego_Sebastian_Schwartzman,2,B-IO,6,4,2,2,0,5,1,,,,,,,,,,
20150502-M-Istanbul-SF-Roger_Federer-Diego_Sebastian_Schwartzman,2,B-II,1,0,0,0,0,1,0,,,,,,,,,,
20150502-M-Istanbul-SF-Roger_Federer-Diego_Sebastian_Schwartzman,2,S-XC,2,0,0,0,0,2,0,,,,,,,,,,
20150502-M-Istanbul-SF-Roger_Federer-Diego_Sebastian_Schwartzman,2,S-DTM,5,0,0,0,0,4,1,,,,,,,,,,
20150502-M-Istanbul-SF-Roger_Federer-Diego_Sebastian_Schwartzman,2,S-DTL,2,1,0,0,1,1,1,,,,,,,,,,
20150502-M-Munich-QF-Andy_Murray-Lukas_Rosol,1,F-XC,25,3,0,3,0,14,11,,,,,,,,,,
20150502-M-Munich-QF-Andy_Murray-Lukas_Rosol,1,F-DTM,31,1,0,0,1,18,13,,,,,,,,,,
20150502-M-Munich-QF-Andy_Murray-Lukas_Rosol,1,F-DTL,9,1,1,0,0,7,2,,,,,,,,,,
20150502-M-Munich-QF-Andy_Murray-Lukas_Rosol,1,F-IO,28,6,5,1,0,19,9,,,,,,,,,,
20150502-M-Munich-QF-Andy_Murray-Lukas_Rosol,1,F-II,1,0,0,0,0,1,0,,,,,,,,,,
20150502-M-Munich-QF-Andy_Murray-Lukas_Rosol,1,B-XC,39,4,1,1,2,18,21,,,,,,,,,,
20150502-M-Munich-QF-Andy_Murray-Lukas_Rosol,1,B-DTM,37,7,0,3,4,18,19,,,,,,,,,,
20150502-M-Munich-QF-Andy_Murray-Lukas_Rosol,1,B-DTL,8,3,1,1,1,5,3,,,,,,,,,,
20150502-M-Munich-QF-Andy_Murray-Lukas_Rosol,1,B-IO,4,4,1,2,1,3,1,,,,,,,,,,
20150502-M-Munich-QF-Andy_Murray-Lukas_Rosol,1,S-XC,10,0,0,0,0,4,6,,,,,,,,,,
20150502-M-Munich-QF-Andy_Murray-Lukas_Rosol,1,S-DTM,17,1,0,0,1,7,10,,,,,,,,,,
20150502-M-Munich-QF-Andy_Murray-Lukas_Rosol,1,S-DTL,2,0,0,0,0,2,0,,,,,,,,,,
20150502-M-Munich-QF-Andy_Murray-Lukas_Rosol,2,F-XC,46,7,2,0,5,19,27,,,,,,,,,,
20150502-M-Munich-QF-Andy_Murray-Lukas_Rosol,2,F-DTM,32,3,0,1,2,16,16,,,,,,,,,,
20150502-M-Munich-QF-Andy_Murray-Lukas_Rosol,2,F-DTL,11,4,3,1,0,6,5,,,,,,,,,,
20150502-M-Munich-QF-Andy_Murray-Lukas_Rosol,2,F-IO,37,11,3,3,5,23,14,,,,,,,,,,
20150502-M-Munich-QF-Andy_Murray-Lukas_Rosol,2,F-II,3,3,3,0,0,3,0,,,,,,,,,,
20150502-M-Munich-QF-Andy_Murray-Lukas_Rosol,2,B-XC,54,14,0,4,10,25,29,,,,,,,,,,
20150502-M-Munich-QF-Andy_Murray-Lukas_Rosol,2,B-DTM,33,2,0,1,1,15,18,,,,,,,,,,
20150502-M-Munich-QF-Andy_Murray-Lukas_Rosol,2,B-DTL,9,7,2,0,5,3,6,,,,,,,,,,
20150502-M-Munich-QF-Andy_Murray-Lukas_Rosol,2,B-IO,3,2,1,1,0,2,1,,,,,,,,,,
20150502-M-Munich-QF-Andy_Murray-Lukas_Rosol,2,S-XC,10,0,0,0,0,2,8,,,,,,,,,,
20150502-M-Munich-QF-Andy_Murray-Lukas_Rosol,2,S-DTM,5,1,0,0,1,0,5,,,,,,,,,,
20150502-M-Munich-QF-Philipp_Kohlschreiber-David_Goffin,1,F-XC,33,5,2,1,2,15,18,,,,,,,,,,
20150502-M-Munich-QF-Philipp_Kohlschreiber-David_Goffin,1,F-DTM,25,1,0,0,1,10,15,,,,,,,,,,
20150502-M-Munich-QF-Philipp_Kohlschreiber-David_Goffin,1,F-DTL,16,3,2,1,0,7,9,,,,,,,,,,
20150502-M-Munich-QF-Philipp_Kohlschreiber-David_Goffin,1,F-IO,30,8,1,3,4,16,14,,,,,,,,,,
20150502-M-Munich-QF-Philipp_Kohlschreiber-David_Goffin,1,F-II,7,5,1,2,2,5,2,,,,,,,,,,
20150502-M-Munich-QF-Philipp_Kohlschreiber-David_Goffin,1,B-XC,34,3,0,1,2,17,17,,,,,,,,,,
20150502-M-Munich-QF-Philipp_Kohlschreiber-David_Goffin,1,B-DTM,21,4,0,0,4,8,13,,,,,,,,,,
20150502-M-Munich-QF-Philipp_Kohlschreiber-David_Goffin,1,B-DTL,9,5,2,0,3,2,7,,,,,,,,,,
20150502-M-Munich-QF-Philipp_Kohlschreiber-David_Goffin,1,B-IO,4,3,2,1,0,3,1,,,,,,,,,,
20150502-M-Munich-QF-Philipp_Kohlschreiber-David_Goffin,1,S-XC,20,3,0,2,1,7,13,,,,,,,,,,
20150502-M-Munich-QF-Philipp_Kohlschreiber-David_Goffin,1,S-DTM,8,0,0,0,0,2,6,,,,,,,,,,
20150502-M-Munich-QF-Philipp_Kohlschreiber-David_Goffin,2,F-XC,33,6,3,2,1,22,11,,,,,,,,,,
20150502-M-Munich-QF-Philipp_Kohlschreiber-David_Goffin,2,F-DTM,25,5,0,2,3,14,11,,,,,,,,,,
20150502-M-Munich-QF-Philipp_Kohlschreiber-David_Goffin,2,F-DTL,17,6,2,1,3,9,8,,,,,,,,,,
20150502-M-Munich-QF-Philipp_Kohlschreiber-David_Goffin,2,F-IO,26,9,6,1,2,20,6,,,,,,,,,,
20150502-M-Munich-QF-Philipp_Kohlschreiber-David_Goffin,2,F-II,6,1,1,0,0,4,2,,,,,,,,,,
20150502-M-Munich-QF-Philipp_Kohlschreiber-David_Goffin,2,B-XC,55,4,0,0,4,32,23,,,,,,,,,,
20150502-M-Munich-QF-Philipp_Kohlschreiber-David_Goffin,2,B-DTM,25,0,0,0,0,8,17,,,,,,,,,,
20150502-M-Munich-QF-Philipp_Kohlschreiber-David_Goffin,2,B-DTL,14,6,1,2,3,7,7,,,,,,,,,,
20150502-M-Munich-QF-Philipp_Kohlschreiber-David_Goffin,2,B-IO,6,4,2,2,0,6,0,,,,,,,,,,
20150502-M-Munich-QF-Philipp_Kohlschreiber-David_Goffin,2,S-XC,2,0,0,0,0,2,0,,,,,,,,,,
20150502-M-Munich-QF-Philipp_Kohlschreiber-David_Goffin,2,S-DTM,2,0,0,0,0,1,1,,,,,,,,,,
20150503-M-Istanbul-F-Roger_Federer-Pablo_Cuevas,1,F-XC,22,12,4,7,1,16,6,,,,,,,,,,
20150503-M-Istanbul-F-Roger_Federer-Pablo_Cuevas,1,F-DTM,29,7,1,2,4,15,14,,,,,,,,,,
20150503-M-Istanbul-F-Roger_Federer-Pablo_Cuevas,1,F-DTL,5,2,0,1,1,1,4,,,,,,,,,,
20150503-M-Istanbul-F-Roger_Federer-Pablo_Cuevas,1,F-IO,26,8,1,5,2,19,7,,,,,,,,,,
20150503-M-Istanbul-F-Roger_Federer-Pablo_Cuevas,1,F-II,4,2,0,1,1,3,1,,,,,,,,,,
20150503-M-Istanbul-F-Roger_Federer-Pablo_Cuevas,1,B-XC,19,4,1,1,2,11,8,,,,,,,,,,
20150503-M-Istanbul-F-Roger_Federer-Pablo_Cuevas,1,B-DTM,46,5,0,3,2,22,24,,,,,,,,,,
20150503-M-Istanbul-F-Roger_Federer-Pablo_Cuevas,1,B-DTL,5,5,2,1,2,3,2,,,,,,,,,,
20150503-M-Istanbul-F-Roger_Federer-Pablo_Cuevas,1,S-XC,2,0,0,0,0,1,1,,,,,,,,,,
20150503-M-Istanbul-F-Roger_Federer-Pablo_Cuevas,1,S-DTM,7,1,0,1,0,5,2,,,,,,,,,,
20150503-M-Istanbul-F-Roger_Federer-Pablo_Cuevas,1,S-DTL,2,1,0,0,1,1,1,,,,,,,,,,
20150503-M-Istanbul-F-Roger_Federer-Pablo_Cuevas,2,F-XC,27,13,1,10,2,18,9,,,,,,,,,,
20150503-M-Istanbul-F-Roger_Federer-Pablo_Cuevas,2,F-DTM,37,8,0,5,3,18,19,,,,,,,,,,
20150503-M-Istanbul-F-Roger_Federer-Pablo_Cuevas,2,F-DTL,4,1,0,0,1,3,1,,,,,,,,,,
20150503-M-Istanbul-F-Roger_Federer-Pablo_Cuevas,2,F-IO,21,4,0,3,1,10,11,,,,,,,,,,
20150503-M-Istanbul-F-Roger_Federer-Pablo_Cuevas,2,F-II,5,2,1,1,0,4,1,,,,,,,,,,
20150503-M-Istanbul-F-Roger_Federer-Pablo_Cuevas,2,B-XC,42,6,3,1,2,20,22,,,,,,,,,,
20150503-M-Istanbul-F-Roger_Federer-Pablo_Cuevas,2,B-DTM,29,3,0,2,1,13,16,,,,,,,,,,
20150503-M-Istanbul-F-Roger_Federer-Pablo_Cuevas,2,B-DTL,1,0,0,0,0,0,1,,,,,,,,,,
20150503-M-Istanbul-F-Roger_Federer-Pablo_Cuevas,2,B-IO,2,1,0,0,1,0,2,,,,,,,,,,
20150503-M-Istanbul-F-Roger_Federer-Pablo_Cuevas,2,S-XC,4,0,0,0,0,0,4,,,,,,,,,,
20150503-M-Istanbul-F-Roger_Federer-Pablo_Cuevas,2,S-DTM,6,0,0,0,0,1,5,,,,,,,,,,
20150505-M-Madrid_Masters-R64-Fernando_Verdasco-Guillermo_Garcia_Lopez,1,F-XC,70,18,7,6,5,41,29,,,,,,,,,,
20150505-M-Madrid_Masters-R64-Fernando_Verdasco-Guillermo_Garcia_Lopez,1,F-DTM,22,2,0,0,2,9,13,,,,,,,,,,
20150505-M-Madrid_Masters-R64-Fernando_Verdasco-Guillermo_Garcia_Lopez,1,F-DTL,8,4,2,0,2,5,3,,,,,,,,,,
20150505-M-Madrid_Masters-R64-Fernando_Verdasco-Guillermo_Garcia_Lopez,1,F-IO,30,13,10,1,2,20,10,,,,,,,,,,
20150505-M-Madrid_Masters-R64-Fernando_Verdasco-Guillermo_Garcia_Lopez,1,F-II,11,6,3,1,2,7,4,,,,,,,,,,
20150505-M-Madrid_Masters-R64-Fernando_Verdasco-Guillermo_Garcia_Lopez,1,B-XC,43,13,5,2,6,21,22,,,,,,,,,,
20150505-M-Madrid_Masters-R64-Fernando_Verdasco-Guillermo_Garcia_Lopez,1,B-DTM,31,3,0,0,3,10,21,,,,,,,,,,
20150505-M-Madrid_Masters-R64-Fernando_Verdasco-Guillermo_Garcia_Lopez,1,B-DTL,20,5,0,0,5,10,10,,,,,,,,,,
20150505-M-Madrid_Masters-R64-Fernando_Verdasco-Guillermo_Garcia_Lopez,1,B-IO,6,0,0,0,0,3,3,,,,,,,,,,
20150505-M-Madrid_Masters-R64-Fernando_Verdasco-Guillermo_Garcia_Lopez,1,S-XC,1,0,0,0,0,0,1,,,,,,,,,,
20150505-M-Madrid_Masters-R64-Fernando_Verdasco-Guillermo_Garcia_Lopez,1,S-DTM,1,0,0,0,0,0,1,,,,,,,,,,
20150505-M-Madrid_Masters-R64-Fernando_Verdasco-Guillermo_Garcia_Lopez,1,S-DTL,1,0,0,0,0,0,1,,,,,,,,,,
20150505-M-Madrid_Masters-R64-Fernando_Verdasco-Guillermo_Garcia_Lopez,1,S-IO,1,0,0,0,0,0,1,,,,,,,,,,
20150505-M-Madrid_Masters-R64-Fernando_Verdasco-Guillermo_Garcia_Lopez,2,F-XC,58,5,2,1,2,34,24,,,,,,,,,,
20150505-M-Madrid_Masters-R64-Fernando_Verdasco-Guillermo_Garcia_Lopez,2,F-DTM,23,0,0,0,0,10,13,,,,,,,,,,
20150505-M-Madrid_Masters-R64-Fernando_Verdasco-Guillermo_Garcia_Lopez,2,F-DTL,10,5,2,1,2,5,5,,,,,,,,,,
20150505-M-Madrid_Masters-R64-Fernando_Verdasco-Guillermo_Garcia_Lopez,2,F-IO,22,8,4,4,0,18,4,,,,,,,,,,
20150505-M-Madrid_Masters-R64-Fernando_Verdasco-Guillermo_Garcia_Lopez,2,F-II,4,1,0,0,1,1,3,,,,,,,,,,
20150505-M-Madrid_Masters-R64-Fernando_Verdasco-Guillermo_Garcia_Lopez,2,B-XC,10,2,0,1,1,7,3,,,,,,,,,,
20150505-M-Madrid_Masters-R64-Fernando_Verdasco-Guillermo_Garcia_Lopez,2,B-DTM,37,1,0,0,1,17,20,,,,,,,,,,
20150505-M-Madrid_Masters-R64-Fernando_Verdasco-Guillermo_Garcia_Lopez,2,B-DTL,29,4,0,2,2,11,18,,,,,,,,,,
20150505-M-Madrid_Masters-R64-Fernando_Verdasco-Guillermo_Garcia_Lopez,2,B-IO,12,1,0,0,1,8,4,,,,,,,,,,
20150505-M-Madrid_Masters-R64-Fernando_Verdasco-Guillermo_Garcia_Lopez,2,S-XC,3,0,0,0,0,1,2,,,,,,,,,,
20150505-M-Madrid_Masters-R64-Fernando_Verdasco-Guillermo_Garcia_Lopez,2,S-DTM,10,0,0,0,0,4,6,,,,,,,,,,
20150505-M-Madrid_Masters-R64-Fernando_Verdasco-Guillermo_Garcia_Lopez,2,S-DTL,7,1,0,0,1,3,4,,,,,,,,,,
20150505-M-Madrid_Masters-R64-Fernando_Verdasco-Guillermo_Garcia_Lopez,2,S-IO,1,0,0,0,0,1,0,,,,,,,,,,
20150506-M-Madrid_Masters-R32-Leonardo_Mayer-Feliciano_Lopez,1,F-XC,49,14,1,8,5,27,22,,,,,,,,,,
20150506-M-Madrid_Masters-R32-Leonardo_Mayer-Feliciano_Lopez,1,F-DTM,11,1,0,1,0,9,2,,,,,,,,,,
20150506-M-Madrid_Masters-R32-Leonardo_Mayer-Feliciano_Lopez,1,F-DTL,11,5,1,3,1,8,3,,,,,,,,,,
20150506-M-Madrid_Masters-R32-Leonardo_Mayer-Feliciano_Lopez,1,F-IO,14,9,7,1,1,11,3,,,,,,,,,,
20150506-M-Madrid_Masters-R32-Leonardo_Mayer-Feliciano_Lopez,1,F-II,4,2,1,1,0,3,1,,,,,,,,,,
20150506-M-Madrid_Masters-R32-Leonardo_Mayer-Feliciano_Lopez,1,B-XC,32,9,1,0,8,10,22,,,,,,,,,,
20150506-M-Madrid_Masters-R32-Leonardo_Mayer-Feliciano_Lopez,1,B-DTM,11,0,0,0,0,5,6,,,,,,,,,,
20150506-M-Madrid_Masters-R32-Leonardo_Mayer-Feliciano_Lopez,1,B-DTL,5,4,3,0,1,4,1,,,,,,,,,,
20150506-M-Madrid_Masters-R32-Leonardo_Mayer-Feliciano_Lopez,1,S-XC,1,0,0,0,0,0,1,,,,,,,,,,
20150506-M-Madrid_Masters-R32-Leonardo_Mayer-Feliciano_Lopez,1,S-DTM,2,0,0,0,0,1,1,,,,,,,,,,
20150506-M-Madrid_Masters-R32-Leonardo_Mayer-Feliciano_Lopez,1,S-DTL,3,0,0,0,0,0,3,,,,,,,,,,
20150506-M-Madrid_Masters-R32-Leonardo_Mayer-Feliciano_Lopez,1,S-IO,1,0,0,0,0,1,0,,,,,,,,,,
20150506-M-Madrid_Masters-R32-Leonardo_Mayer-Feliciano_Lopez,2,F-XC,38,5,1,1,3,21,17,,,,,,,,,,
20150506-M-Madrid_Masters-R32-Leonardo_Mayer-Feliciano_Lopez,2,F-DTM,17,5,0,1,4,7,10,,,,,,,,,,
20150506-M-Madrid_Masters-R32-Leonardo_Mayer-Feliciano_Lopez,2,F-DTL,6,3,1,1,1,3,3,,,,,,,,,,
20150506-M-Madrid_Masters-R32-Leonardo_Mayer-Feliciano_Lopez,2,F-IO,14,7,3,2,2,9,5,,,,,,,,,,
20150506-M-Madrid_Masters-R32-Leonardo_Mayer-Feliciano_Lopez,2,B-XC,11,4,2,0,2,4,7,,,,,,,,,,
20150506-M-Madrid_Masters-R32-Leonardo_Mayer-Feliciano_Lopez,2,B-DTM,7,2,0,0,2,1,6,,,,,,,,,,
20150506-M-Madrid_Masters-R32-Leonardo_Mayer-Feliciano_Lopez,2,B-DTL,2,1,0,0,1,0,2,,,,,,,,,,
20150506-M-Madrid_Masters-R32-Leonardo_Mayer-Feliciano_Lopez,2,S-XC,13,2,0,1,1,6,7,,,,,,,,,,
20150506-M-Madrid_Masters-R32-Leonardo_Mayer-Feliciano_Lopez,2,S-DTM,10,0,0,0,0,4,6,,,,,,,,,,
20150506-M-Madrid_Masters-R32-Leonardo_Mayer-Feliciano_Lopez,2,S-DTL,7,2,0,1,1,5,2,,,,,,,,,,
20150506-M-Madrid_Masters-R32-Leonardo_Mayer-Feliciano_Lopez,2,S-IO,3,1,0,0,1,2,1,,,,,,,,,,
20150507-M-Madrid_Masters-R16-Grigor_Dimitrov-Stanislas_Wawrinka,1,F-XC,39,11,3,3,5,27,12,,,,,,,,,,
20150507-M-Madrid_Masters-R16-Grigor_Dimitrov-Stanislas_Wawrinka,1,F-DTM,24,2,0,1,1,8,16,,,,,,,,,,
20150507-M-Madrid_Masters-R16-Grigor_Dimitrov-Stanislas_Wawrinka,1,F-DTL,3,1,0,0,1,1,2,,,,,,,,,,
20150507-M-Madrid_Masters-R16-Grigor_Dimitrov-Stanislas_Wawrinka,1,F-IO,32,13,6,7,0,28,4,,,,,,,,,,
20150507-M-Madrid_Masters-R16-Grigor_Dimitrov-Stanislas_Wawrinka,1,F-II,5,1,1,0,0,3,2,,,,,,,,,,
20150507-M-Madrid_Masters-R16-Grigor_Dimitrov-Stanislas_Wawrinka,1,B-XC,18,2,0,1,1,10,8,,,,,,,,,,
20150507-M-Madrid_Masters-R16-Grigor_Dimitrov-Stanislas_Wawrinka,1,B-DTM,25,2,0,0,2,13,12,,,,,,,,,,
20150507-M-Madrid_Masters-R16-Grigor_Dimitrov-Stanislas_Wawrinka,1,B-DTL,4,1,1,0,0,1,3,,,,,,,,,,
20150507-M-Madrid_Masters-R16-Grigor_Dimitrov-Stanislas_Wawrinka,1,B-IO,2,1,0,0,1,1,1,,,,,,,,,,
20150507-M-Madrid_Masters-R16-Grigor_Dimitrov-Stanislas_Wawrinka,1,B-II,2,1,0,1,0,1,1,,,,,,,,,,
20150507-M-Madrid_Masters-R16-Grigor_Dimitrov-Stanislas_Wawrinka,1,S-XC,10,2,0,0,2,3,7,,,,,,,,,,
20150507-M-Madrid_Masters-R16-Grigor_Dimitrov-Stanislas_Wawrinka,1,S-DTM,8,1,0,0,1,2,6,,,,,,,,,,
20150507-M-Madrid_Masters-R16-Grigor_Dimitrov-Stanislas_Wawrinka,1,S-DTL,2,0,0,0,0,1,1,,,,,,,,,,
20150507-M-Madrid_Masters-R16-Grigor_Dimitrov-Stanislas_Wawrinka,1,S-IO,1,0,0,0,0,0,1,,,,,,,,,,
20150507-M-Madrid_Masters-R16-Grigor_Dimitrov-Stanislas_Wawrinka,2,F-XC,35,20,8,10,2,25,10,,,,,,,,,,
20150507-M-Madrid_Masters-R16-Grigor_Dimitrov-Stanislas_Wawrinka,2,F-DTM,38,9,0,2,7,12,26,,,,,,,,,,
20150507-M-Madrid_Masters-R16-Grigor_Dimitrov-Stanislas_Wawrinka,2,F-DTL,8,6,1,2,3,4,4,,,,,,,,,,
20150507-M-Madrid_Masters-R16-Grigor_Dimitrov-Stanislas_Wawrinka,2,F-IO,24,6,0,4,1,14,10,,,,,,,,,,
20150507-M-Madrid_Masters-R16-Grigor_Dimitrov-Stanislas_Wawrinka,2,F-II,3,2,1,1,0,3,0,,,,,,,,,,
20150507-M-Madrid_Masters-R16-Grigor_Dimitrov-Stanislas_Wawrinka,2,B-XC,35,9,5,3,1,20,15,,,,,,,,,,
20150507-M-Madrid_Masters-R16-Grigor_Dimitrov-Stanislas_Wawrinka,2,B-DTM,14,3,0,2,1,6,8,,,,,,,,,,
20150507-M-Madrid_Masters-R16-Grigor_Dimitrov-Stanislas_Wawrinka,2,B-DTL,5,2,0,0,2,1,4,,,,,,,,,,
20150507-M-Madrid_Masters-R16-Grigor_Dimitrov-Stanislas_Wawrinka,2,B-IO,3,1,1,0,0,2,1,,,,,,,,,,
20150507-M-Madrid_Masters-R16-Grigor_Dimitrov-Stanislas_Wawrinka,2,B-II,1,1,1,0,0,1,0,,,,,,,,,,
20150507-M-Madrid_Masters-R16-Grigor_Dimitrov-Stanislas_Wawrinka,2,S-XC,3,1,0,0,1,0,3,,,,,,,,,,
20150507-M-Madrid_Masters-R16-Grigor_Dimitrov-Stanislas_Wawrinka,2,S-DTM,5,1,0,0,1,2,3,,,,,,,,,,
20150507-M-Madrid_Masters-R16-Grigor_Dimitrov-Stanislas_Wawrinka,2,S-DTL,2,1,0,1,0,2,0,,,,,,,,,,
20150507-M-Madrid_Masters-R16-John_Isner-Nick_Kyrgios,1,F-XC,17,7,3,1,3,10,7,,,,,,,,,,
20150507-M-Madrid_Masters-R16-John_Isner-Nick_Kyrgios,1,F-DTM,11,2,1,0,1,6,5,,,,,,,,,,
20150507-M-Madrid_Masters-R16-John_Isner-Nick_Kyrgios,1,F-DTL,3,1,0,1,0,2,1,,,,,,,,,,
20150507-M-Madrid_Masters-R16-John_Isner-Nick_Kyrgios,1,F-IO,22,12,8,2,2,17,5,,,,,,,,,,
20150507-M-Madrid_Masters-R16-John_Isner-Nick_Kyrgios,1,F-II,1,1,0,1,0,1,0,,,,,,,,,,
20150507-M-Madrid_Masters-R16-John_Isner-Nick_Kyrgios,1,B-XC,7,3,0,1,2,5,2,,,,,,,,,,
20150507-M-Madrid_Masters-R16-John_Isner-Nick_Kyrgios,1,B-DTM,18,0,0,0,0,13,5,,,,,,,,,,
20150507-M-Madrid_Masters-R16-John_Isner-Nick_Kyrgios,1,B-DTL,2,1,1,0,0,1,1,,,,,,,,,,
20150507-M-Madrid_Masters-R16-John_Isner-Nick_Kyrgios,1,S-XC,9,2,0,0,2,4,5,,,,,,,,,,
20150507-M-Madrid_Masters-R16-John_Isner-Nick_Kyrgios,1,S-DTM,5,1,0,1,0,2,3,,,,,,,,,,
20150507-M-Madrid_Masters-R16-John_Isner-Nick_Kyrgios,2,F-XC,19,7,4,2,1,11,8,,,,,,,,,,
20150507-M-Madrid_Masters-R16-John_Isner-Nick_Kyrgios,2,F-DTM,16,1,0,1,0,6,10,,,,,,,,,,
20150507-M-Madrid_Masters-R16-John_Isner-Nick_Kyrgios,2,F-IO,16,6,1,3,2,10,6,,,,,,,,,,
20150507-M-Madrid_Masters-R16-John_Isner-Nick_Kyrgios,2,B-XC,24,5,1,3,1,10,14,,,,,,,,,,
20150507-M-Madrid_Masters-R16-John_Isner-Nick_Kyrgios,2,B-DTM,22,1,0,1,0,9,13,,,,,,,,,,
20150507-M-Madrid_Masters-R16-John_Isner-Nick_Kyrgios,2,B-IO,7,5,1,2,2,4,3,,,,,,,,,,
20150507-M-Madrid_Masters-R16-John_Isner-Nick_Kyrgios,2,S-XC,2,0,0,0,0,0,2,,,,,,,,,,
20150507-M-Madrid_Masters-R16-John_Isner-Nick_Kyrgios,2,S-DTM,3,1,0,1,0,1,2,,,,,,,,,,
20150507-M-Madrid_Masters-R16-John_Isner-Nick_Kyrgios,2,S-DTL,1,1,1,0,0,1,0,,,,,,,,,,
20150507-M-Madrid_Masters-R16-Tomas_Berdych-Jo_Wilfried_Tsonga,1,F-XC,28,7,3,0,4,16,12,,,,,,,,,,
20150507-M-Madrid_Masters-R16-Tomas_Berdych-Jo_Wilfried_Tsonga,1,F-DTM,24,5,1,2,2,14,10,,,,,,,,,,
20150507-M-Madrid_Masters-R16-Tomas_Berdych-Jo_Wilfried_Tsonga,1,F-DTL,3,2,0,1,1,2,1,,,,,,,,,,
20150507-M-Madrid_Masters-R16-Tomas_Berdych-Jo_Wilfried_Tsonga,1,F-IO,26,10,2,3,5,13,13,,,,,,,,,,
20150507-M-Madrid_Masters-R16-Tomas_Berdych-Jo_Wilfried_Tsonga,1,F-II,3,2,2,0,0,3,0,,,,,,,,,,
20150507-M-Madrid_Masters-R16-Tomas_Berdych-Jo_Wilfried_Tsonga,1,B-XC,26,3,0,2,1,16,10,,,,,,,,,,
20150507-M-Madrid_Masters-R16-Tomas_Berdych-Jo_Wilfried_Tsonga,1,B-DTM,18,1,0,0,1,10,8,,,,,,,,,,
20150507-M-Madrid_Masters-R16-Tomas_Berdych-Jo_Wilfried_Tsonga,1,B-DTL,4,1,0,1,0,2,2,,,,,,,,,,
20150507-M-Madrid_Masters-R16-Tomas_Berdych-Jo_Wilfried_Tsonga,1,S-XC,1,0,0,0,0,0,1,,,,,,,,,,
20150507-M-Madrid_Masters-R16-Tomas_Berdych-Jo_Wilfried_Tsonga,1,S-DTM,3,0,0,0,0,1,2,,,,,,,,,,
20150507-M-Madrid_Masters-R16-Tomas_Berdych-Jo_Wilfried_Tsonga,1,S-DTL,1,0,0,0,0,1,0,,,,,,,,,,
20150507-M-Madrid_Masters-R16-Tomas_Berdych-Jo_Wilfried_Tsonga,2,F-XC,24,7,3,1,3,14,10,,,,,,,,,,
20150507-M-Madrid_Masters-R16-Tomas_Berdych-Jo_Wilfried_Tsonga,2,F-DTM,20,3,0,1,2,8,12,,,,,,,,,,
20150507-M-Madrid_Masters-R16-Tomas_Berdych-Jo_Wilfried_Tsonga,2,F-DTL,2,2,0,1,1,1,1,,,,,,,,,,
20150507-M-Madrid_Masters-R16-Tomas_Berdych-Jo_Wilfried_Tsonga,2,F-IO,18,4,1,2,1,10,8,,,,,,,,,,
20150507-M-Madrid_Masters-R16-Tomas_Berdych-Jo_Wilfried_Tsonga,2,F-II,1,1,1,0,0,1,0,,,,,,,,,,
20150507-M-Madrid_Masters-R16-Tomas_Berdych-Jo_Wilfried_Tsonga,2,B-XC,21,5,1,0,4,10,11,,,,,,,,,,
20150507-M-Madrid_Masters-R16-Tomas_Berdych-Jo_Wilfried_Tsonga,2,B-DTM,27,3,0,0,3,8,19,,,,,,,,,,
20150507-M-Madrid_Masters-R16-Tomas_Berdych-Jo_Wilfried_Tsonga,2,B-DTL,8,4,2,1,1,6,2,,,,,,,,,,
20150507-M-Madrid_Masters-R16-Tomas_Berdych-Jo_Wilfried_Tsonga,2,B-IO,3,3,2,0,1,2,1,,,,,,,,,,
20150507-M-Madrid_Masters-R16-Tomas_Berdych-Jo_Wilfried_Tsonga,2,S-XC,2,0,0,0,0,1,1,,,,,,,,,,
20150507-M-Madrid_Masters-R16-Tomas_Berdych-Jo_Wilfried_Tsonga,2,S-DTM,3,0,0,0,0,1,2,,,,,,,,,,
20150509-M-Madrid_Masters-F-Andy_Murray-Rafael_Nadal,1,F-XC,70,7,3,1,3,42,28,,,,,,,,,,
20150509-M-Madrid_Masters-F-Andy_Murray-Rafael_Nadal,1,F-DTM,14,1,0,0,1,7,7,,,,,,,,,,
20150509-M-Madrid_Masters-F-Andy_Murray-Rafael_Nadal,1,F-DTL,14,7,1,3,3,6,8,,,,,,,,,,
20150509-M-Madrid_Masters-F-Andy_Murray-Rafael_Nadal,1,F-IO,15,4,1,1,2,9,6,,,,,,,,,,
20150509-M-Madrid_Masters-F-Andy_Murray-Rafael_Nadal,1,F-II,7,0,0,0,0,4,3,,,,,,,,,,
20150509-M-Madrid_Masters-F-Andy_Murray-Rafael_Nadal,1,B-XC,39,8,0,5,3,25,14,,,,,,,,,,
20150509-M-Madrid_Masters-F-Andy_Murray-Rafael_Nadal,1,B-DTM,21,1,0,0,1,11,10,,,,,,,,,,
20150509-M-Madrid_Masters-F-Andy_Murray-Rafael_Nadal,1,B-DTL,25,2,0,1,1,16,9,,,,,,,,,,
20150509-M-Madrid_Masters-F-Andy_Murray-Rafael_Nadal,1,B-IO,3,0,0,0,0,1,2,,,,,,,,,,
20150509-M-Madrid_Masters-F-Andy_Murray-Rafael_Nadal,1,S-XC,1,0,0,0,0,0,1,,,,,,,,,,
20150509-M-Madrid_Masters-F-Andy_Murray-Rafael_Nadal,1,S-DTL,2,0,0,0,0,0,2,,,,,,,,,,
20150509-M-Madrid_Masters-F-Andy_Murray-Rafael_Nadal,2,F-XC,53,6,0,1,5,22,31,,,,,,,,,,
20150509-M-Madrid_Masters-F-Andy_Murray-Rafael_Nadal,2,F-DTM,12,1,0,0,1,5,7,,,,,,,,,,
20150509-M-Madrid_Masters-F-Andy_Murray-Rafael_Nadal,2,F-DTL,12,3,1,0,2,7,5,,,,,,,,,,
20150509-M-Madrid_Masters-F-Andy_Murray-Rafael_Nadal,2,F-IO,18,4,3,0,1,12,6,,,,,,,,,,
20150509-M-Madrid_Masters-F-Andy_Murray-Rafael_Nadal,2,F-II,3,1,1,0,0,2,1,,,,,,,,,,
20150509-M-Madrid_Masters-F-Andy_Murray-Rafael_Nadal,2,B-XC,50,9,2,0,7,20,30,,,,,,,,,,
20150509-M-Madrid_Masters-F-Andy_Murray-Rafael_Nadal,2,B-DTM,14,0,0,0,0,6,8,,,,,,,,,,
20150509-M-Madrid_Masters-F-Andy_Murray-Rafael_Nadal,2,B-DTL,22,4,0,0,4,7,15,,,,,,,,,,
20150509-M-Madrid_Masters-F-Andy_Murray-Rafael_Nadal,2,B-IO,4,0,0,0,0,1,3,,,,,,,,,,
20150509-M-Madrid_Masters-F-Andy_Murray-Rafael_Nadal,2,S-XC,3,0,0,0,0,1,2,,,,,,,,,,
20150509-M-Madrid_Masters-F-Andy_Murray-Rafael_Nadal,2,S-DTM,2,0,0,0,0,0,2,,,,,,,,,,
20150509-M-Madrid_Masters-F-Andy_Murray-Rafael_Nadal,2,S-DTL,7,0,0,0,0,1,6,,,,,,,,,,
20150509-M-Madrid_Masters-SF-Kei_Nishikori-Andy_Murray,1,F-XC,35,8,2,2,4,20,15,,,,,,,,,,
20150509-M-Madrid_Masters-SF-Kei_Nishikori-Andy_Murray,1,F-DTM,21,2,0,0,2,14,7,,,,,,,,,,
20150509-M-Madrid_Masters-SF-Kei_Nishikori-Andy_Murray,1,F-DTL,7,3,1,0,2,4,3,,,,,,,,,,
20150509-M-Madrid_Masters-SF-Kei_Nishikori-Andy_Murray,1,F-IO,30,12,3,4,5,24,6,,,,,,,,,,
20150509-M-Madrid_Masters-SF-Kei_Nishikori-Andy_Murray,1,F-II,2,1,0,1,0,1,1,,,,,,,,,,
20150509-M-Madrid_Masters-SF-Kei_Nishikori-Andy_Murray,1,B-XC,48,5,0,4,1,29,19,,,,,,,,,,
20150509-M-Madrid_Masters-SF-Kei_Nishikori-Andy_Murray,1,B-DTM,19,4,1,1,2,12,7,,,,,,,,,,
20150509-M-Madrid_Masters-SF-Kei_Nishikori-Andy_Murray,1,B-DTL,6,3,1,0,2,3,3,,,,,,,,,,
20150509-M-Madrid_Masters-SF-Kei_Nishikori-Andy_Murray,1,B-IO,2,1,0,1,0,2,0,,,,,,,,,,
20150509-M-Madrid_Masters-SF-Kei_Nishikori-Andy_Murray,2,F-XC,20,4,3,0,1,9,11,,,,,,,,,,
20150509-M-Madrid_Masters-SF-Kei_Nishikori-Andy_Murray,2,F-DTM,21,3,0,2,1,10,11,,,,,,,,,,
20150509-M-Madrid_Masters-SF-Kei_Nishikori-Andy_Murray,2,F-DTL,3,1,0,1,0,1,2,,,,,,,,,,
20150509-M-Madrid_Masters-SF-Kei_Nishikori-Andy_Murray,2,F-IO,8,3,2,1,0,5,3,,,,,,,,,,
20150509-M-Madrid_Masters-SF-Kei_Nishikori-Andy_Murray,2,F-II,1,1,0,0,1,0,1,,,,,,,,,,
20150509-M-Madrid_Masters-SF-Kei_Nishikori-Andy_Murray,2,B-XC,45,3,1,1,1,20,25,,,,,,,,,,
20150509-M-Madrid_Masters-SF-Kei_Nishikori-Andy_Murray,2,B-DTM,29,2,0,0,2,5,24,,,,,,,,,,
20150509-M-Madrid_Masters-SF-Kei_Nishikori-Andy_Murray,2,B-DTL,5,3,2,0,1,3,2,,,,,,,,,,
20150509-M-Madrid_Masters-SF-Kei_Nishikori-Andy_Murray,2,B-IO,3,3,1,2,0,3,0,,,,,,,,,,
20150509-M-Madrid_Masters-SF-Kei_Nishikori-Andy_Murray,2,S-XC,4,0,0,0,0,0,4,,,,,,,,,,
20150509-M-Madrid_Masters-SF-Kei_Nishikori-Andy_Murray,2,S-DTM,8,0,0,0,0,1,7,,,,,,,,,,
20150509-M-Madrid_Masters-SF-Kei_Nishikori-Andy_Murray,2,S-DTL,1,0,0,0,0,0,1,,,,,,,,,,
20150511-M-Rome_Masters-R64-Jack_Sock-Gilles_Simon,1,F-XC,45,10,3,3,4,17,28,,,,,,,,,,
20150511-M-Rome_Masters-R64-Jack_Sock-Gilles_Simon,1,F-DTM,22,0,0,0,0,3,19,,,,,,,,,,
20150511-M-Rome_Masters-R64-Jack_Sock-Gilles_Simon,1,F-DTL,16,5,2,0,3,5,11,,,,,,,,,,
20150511-M-Rome_Masters-R64-Jack_Sock-Gilles_Simon,1,F-IO,49,19,6,4,9,19,30,,,,,,,,,,
20150511-M-Rome_Masters-R64-Jack_Sock-Gilles_Simon,1,F-II,13,6,2,1,3,5,8,,,,,,,,,,
20150511-M-Rome_Masters-R64-Jack_Sock-Gilles_Simon,1,B-XC,10,2,0,0,2,6,4,,,,,,,,,,
20150511-M-Rome_Masters-R64-Jack_Sock-Gilles_Simon,1,B-DTM,13,1,0,0,1,6,7,,,,,,,,,,
20150511-M-Rome_Masters-R64-Jack_Sock-Gilles_Simon,1,B-DTL,14,5,0,0,5,7,7,,,,,,,,,,
20150511-M-Rome_Masters-R64-Jack_Sock-Gilles_Simon,1,B-IO,3,0,0,0,0,0,3,,,,,,,,,,
20150511-M-Rome_Masters-R64-Jack_Sock-Gilles_Simon,1,S-XC,7,0,0,0,0,3,4,,,,,,,,,,
20150511-M-Rome_Masters-R64-Jack_Sock-Gilles_Simon,1,S-DTM,10,0,0,0,0,4,6,,,,,,,,,,
20150511-M-Rome_Masters-R64-Jack_Sock-Gilles_Simon,1,S-DTL,6,0,0,0,0,2,4,,,,,,,,,,
20150511-M-Rome_Masters-R64-Jack_Sock-Gilles_Simon,2,F-XC,58,11,4,1,6,36,22,,,,,,,,,,
20150511-M-Rome_Masters-R64-Jack_Sock-Gilles_Simon,2,F-DTM,20,1,0,0,1,13,7,,,,,,,,,,
20150511-M-Rome_Masters-R64-Jack_Sock-Gilles_Simon,2,F-DTL,29,8,4,1,3,15,14,,,,,,,,,,
20150511-M-Rome_Masters-R64-Jack_Sock-Gilles_Simon,2,F-IO,39,12,4,7,1,27,12,,,,,,,,,,
20150511-M-Rome_Masters-R64-Jack_Sock-Gilles_Simon,2,F-II,2,2,0,1,1,1,1,,,,,,,,,,
20150511-M-Rome_Masters-R64-Jack_Sock-Gilles_Simon,2,B-XC,42,4,3,0,1,30,12,,,,,,,,,,
20150511-M-Rome_Masters-R64-Jack_Sock-Gilles_Simon,2,B-DTM,18,0,0,0,0,8,10,,,,,,,,,,
20150511-M-Rome_Masters-R64-Jack_Sock-Gilles_Simon,2,B-DTL,16,6,1,0,5,8,8,,,,,,,,,,
20150511-M-Rome_Masters-R64-Jack_Sock-Gilles_Simon,2,B-IO,3,2,1,1,0,3,0,,,,,,,,,,
20150511-M-Rome_Masters-R64-Jack_Sock-Gilles_Simon,2,S-XC,2,0,0,0,0,2,0,,,,,,,,,,
20150511-M-Rome_Masters-R64-Jack_Sock-Gilles_Simon,2,S-DTM,1,0,0,0,0,1,0,,,,,,,,,,
20150511-M-Rome_Masters-R64-Jack_Sock-Gilles_Simon,2,S-DTL,1,0,0,0,0,0,1,,,,,,,,,,
20150511-M-Rome_Masters-R64-Steve_Johnson-Fabio_Fognini,1,F-XC,37,6,1,2,3,11,26,,,,,,,,,,
20150511-M-Rome_Masters-R64-Steve_Johnson-Fabio_Fognini,1,F-DTM,13,3,0,0,3,4,9,,,,,,,,,,
20150511-M-Rome_Masters-R64-Steve_Johnson-Fabio_Fognini,1,F-DTL,12,4,1,0,3,2,10,,,,,,,,,,
20150511-M-Rome_Masters-R64-Steve_Johnson-Fabio_Fognini,1,F-IO,33,9,3,3,3,15,18,,,,,,,,,,
20150511-M-Rome_Masters-R64-Steve_Johnson-Fabio_Fognini,1,F-II,8,2,1,1,0,4,4,,,,,,,,,,
20150511-M-Rome_Masters-R64-Steve_Johnson-Fabio_Fognini,1,B-XC,7,2,0,0,2,0,7,,,,,,,,,,
20150511-M-Rome_Masters-R64-Steve_Johnson-Fabio_Fognini,1,B-DTM,11,1,0,0,1,3,8,,,,,,,,,,
20150511-M-Rome_Masters-R64-Steve_Johnson-Fabio_Fognini,1,B-DTL,8,1,0,0,1,0,8,,,,,,,,,,
20150511-M-Rome_Masters-R64-Steve_Johnson-Fabio_Fognini,1,S-XC,27,1,0,0,1,3,24,,,,,,,,,,
20150511-M-Rome_Masters-R64-Steve_Johnson-Fabio_Fognini,1,S-DTM,13,1,0,0,1,3,10,,,,,,,,,,
20150511-M-Rome_Masters-R64-Steve_Johnson-Fabio_Fognini,1,S-DTL,5,0,0,0,0,1,4,,,,,,,,,,
20150511-M-Rome_Masters-R64-Steve_Johnson-Fabio_Fognini,1,S-IO,1,1,0,0,1,0,1,,,,,,,,,,
20150511-M-Rome_Masters-R64-Steve_Johnson-Fabio_Fognini,2,F-XC,42,13,2,5,6,31,11,,,,,,,,,,
20150511-M-Rome_Masters-R64-Steve_Johnson-Fabio_Fognini,2,F-DTM,11,2,1,0,1,9,2,,,,,,,,,,
20150511-M-Rome_Masters-R64-Steve_Johnson-Fabio_Fognini,2,F-DTL,21,5,3,1,1,19,2,,,,,,,,,,
20150511-M-Rome_Masters-R64-Steve_Johnson-Fabio_Fognini,2,F-IO,30,7,2,1,4,23,7,,,,,,,,,,
20150511-M-Rome_Masters-R64-Steve_Johnson-Fabio_Fognini,2,F-II,7,3,0,3,0,6,1,,,,,,,,,,
20150511-M-Rome_Masters-R64-Steve_Johnson-Fabio_Fognini,2,B-XC,31,6,1,3,2,23,8,,,,,,,,,,
20150511-M-Rome_Masters-R64-Steve_Johnson-Fabio_Fognini,2,B-DTM,12,1,0,1,0,9,3,,,,,,,,,,
20150511-M-Rome_Masters-R64-Steve_Johnson-Fabio_Fognini,2,B-DTL,15,7,2,1,4,10,5,,,,,,,,,,
20150511-M-Rome_Masters-R64-Steve_Johnson-Fabio_Fognini,2,S-XC,5,0,0,0,0,4,1,,,,,,,,,,
20150511-M-Rome_Masters-R64-Steve_Johnson-Fabio_Fognini,2,S-DTM,4,0,0,0,0,2,2,,,,,,,,,,
20150511-M-Rome_Masters-R64-Steve_Johnson-Fabio_Fognini,2,S-DTL,2,0,0,0,0,2,0,,,,,,,,,,
20150511-M-Rome_Masters-R64-Steve_Johnson-Fabio_Fognini,2,S-IO,2,1,0,0,1,1,1,,,,,,,,,,
20150512-M-Rome_Masters-R64-Marin_Cilic-Guillermo_Garcia_Lopez,1,F-XC,35,9,2,2,5,12,23,,,,,,,,,,
20150512-M-Rome_Masters-R64-Marin_Cilic-Guillermo_Garcia_Lopez,1,F-DTM,13,0,0,0,0,5,8,,,,,,,,,,
20150512-M-Rome_Masters-R64-Marin_Cilic-Guillermo_Garcia_Lopez,1,F-DTL,20,9,3,0,6,4,16,,,,,,,,,,
20150512-M-Rome_Masters-R64-Marin_Cilic-Guillermo_Garcia_Lopez,1,F-IO,31,6,3,1,2,21,10,,,,,,,,,,
20150512-M-Rome_Masters-R64-Marin_Cilic-Guillermo_Garcia_Lopez,1,F-II,3,1,1,0,0,1,2,,,,,,,,,,
20150512-M-Rome_Masters-R64-Marin_Cilic-Guillermo_Garcia_Lopez,1,B-XC,36,7,1,0,6,15,21,,,,,,,,,,
20150512-M-Rome_Masters-R64-Marin_Cilic-Guillermo_Garcia_Lopez,1,B-DTM,16,3,0,0,3,2,14,,,,,,,,,,
20150512-M-Rome_Masters-R64-Marin_Cilic-Guillermo_Garcia_Lopez,1,B-DTL,9,3,1,1,1,4,5,,,,,,,,,,
20150512-M-Rome_Masters-R64-Marin_Cilic-Guillermo_Garcia_Lopez,1,B-IO,4,1,1,0,0,2,2,,,,,,,,,,
20150512-M-Rome_Masters-R64-Marin_Cilic-Guillermo_Garcia_Lopez,1,S-XC,2,0,0,0,0,0,2,,,,,,,,,,
20150512-M-Rome_Masters-R64-Marin_Cilic-Guillermo_Garcia_Lopez,1,S-DTM,3,1,0,0,1,1,2,,,,,,,,,,
20150512-M-Rome_Masters-R64-Marin_Cilic-Guillermo_Garcia_Lopez,1,S-DTL,1,0,0,0,0,1,0,,,,,,,,,,
20150512-M-Rome_Masters-R64-Marin_Cilic-Guillermo_Garcia_Lopez,2,F-XC,32,5,3,0,2,25,7,,,,,,,,,,
20150512-M-Rome_Masters-R64-Marin_Cilic-Guillermo_Garcia_Lopez,2,F-DTM,16,0,0,0,0,7,9,,,,,,,,,,
20150512-M-Rome_Masters-R64-Marin_Cilic-Guillermo_Garcia_Lopez,2,F-DTL,7,2,2,0,0,4,3,,,,,,,,,,
20150512-M-Rome_Masters-R64-Marin_Cilic-Guillermo_Garcia_Lopez,2,F-IO,26,6,3,1,2,16,10,,,,,,,,,,
20150512-M-Rome_Masters-R64-Marin_Cilic-Guillermo_Garcia_Lopez,2,F-II,2,1,1,0,0,2,0,,,,,,,,,,
20150512-M-Rome_Masters-R64-Marin_Cilic-Guillermo_Garcia_Lopez,2,B-XC,31,2,1,1,0,21,10,,,,,,,,,,
20150512-M-Rome_Masters-R64-Marin_Cilic-Guillermo_Garcia_Lopez,2,B-DTM,24,1,0,0,1,12,12,,,,,,,,,,
20150512-M-Rome_Masters-R64-Marin_Cilic-Guillermo_Garcia_Lopez,2,B-DTL,4,2,2,0,0,3,1,,,,,,,,,,
20150512-M-Rome_Masters-R64-Marin_Cilic-Guillermo_Garcia_Lopez,2,B-IO,2,1,1,0,0,2,0,,,,,,,,,,
20150512-M-Rome_Masters-R64-Marin_Cilic-Guillermo_Garcia_Lopez,2,S-XC,5,1,0,0,1,0,5,,,,,,,,,,
20150512-M-Rome_Masters-R64-Marin_Cilic-Guillermo_Garcia_Lopez,2,S-DTM,1,0,0,0,0,0,1,,,,,,,,,,
20150512-M-Rome_Masters-R64-Marin_Cilic-Guillermo_Garcia_Lopez,2,S-DTL,3,2,0,1,1,1,2,,,,,,,,,,
20150512-M-Rome_Masters-R64-Marin_Cilic-Guillermo_Garcia_Lopez,2,S-II,1,0,0,0,0,1,0,,,,,,,,,,
20150513-M-Rome_Masters-R32-Jeremy_Chardy-Andy_Murray,1,F-XC,27,5,2,0,3,14,13,,,,,,,,,,
20150513-M-Rome_Masters-R32-Jeremy_Chardy-Andy_Murray,1,F-DTM,4,0,0,0,0,3,1,,,,,,,,,,
20150513-M-Rome_Masters-R32-Jeremy_Chardy-Andy_Murray,1,F-DTL,15,1,0,1,0,7,8,,,,,,,,,,
20150513-M-Rome_Masters-R32-Jeremy_Chardy-Andy_Murray,1,F-IO,34,10,4,3,3,23,11,,,,,,,,,,
20150513-M-Rome_Masters-R32-Jeremy_Chardy-Andy_Murray,1,F-II,12,8,3,2,3,7,5,,,,,,,,,,
20150513-M-Rome_Masters-R32-Jeremy_Chardy-Andy_Murray,1,B-XC,15,2,0,0,2,8,7,,,,,,,,,,
20150513-M-Rome_Masters-R32-Jeremy_Chardy-Andy_Murray,1,B-DTM,8,0,0,0,0,5,3,,,,,,,,,,
20150513-M-Rome_Masters-R32-Jeremy_Chardy-Andy_Murray,1,B-DTL,10,3,1,1,1,6,4,,,,,,,,,,
20150513-M-Rome_Masters-R32-Jeremy_Chardy-Andy_Murray,1,B-IO,1,0,0,0,0,1,0,,,,,,,,,,
20150513-M-Rome_Masters-R32-Jeremy_Chardy-Andy_Murray,1,S-XC,12,4,0,1,3,6,6,,,,,,,,,,
20150513-M-Rome_Masters-R32-Jeremy_Chardy-Andy_Murray,1,S-DTM,5,0,0,0,0,3,2,,,,,,,,,,
20150513-M-Rome_Masters-R32-Jeremy_Chardy-Andy_Murray,1,S-DTL,7,2,0,1,1,3,4,,,,,,,,,,
20150513-M-Rome_Masters-R32-Jeremy_Chardy-Andy_Murray,2,F-XC,25,6,4,1,1,15,10,,,,,,,,,,
20150513-M-Rome_Masters-R32-Jeremy_Chardy-Andy_Murray,2,F-DTM,7,0,0,0,0,2,5,,,,,,,,,,
20150513-M-Rome_Masters-R32-Jeremy_Chardy-Andy_Murray,2,F-DTL,14,1,1,0,0,9,5,,,,,,,,,,
20150513-M-Rome_Masters-R32-Jeremy_Chardy-Andy_Murray,2,F-IO,13,3,0,1,2,4,9,,,,,,,,,,
20150513-M-Rome_Masters-R32-Jeremy_Chardy-Andy_Murray,2,B-XC,35,6,4,2,0,20,15,,,,,,,,,,
20150513-M-Rome_Masters-R32-Jeremy_Chardy-Andy_Murray,2,B-DTM,16,1,0,0,1,6,10,,,,,,,,,,
20150513-M-Rome_Masters-R32-Jeremy_Chardy-Andy_Murray,2,B-DTL,8,4,1,2,1,4,4,,,,,,,,,,
20150513-M-Rome_Masters-R32-Jeremy_Chardy-Andy_Murray,2,B-IO,4,0,0,0,0,2,2,,,,,,,,,,
20150513-M-Rome_Masters-R32-Jeremy_Chardy-Andy_Murray,2,S-XC,13,1,0,0,1,2,11,,,,,,,,,,
20150513-M-Rome_Masters-R32-Jeremy_Chardy-Andy_Murray,2,S-DTM,1,0,0,0,0,1,0,,,,,,,,,,
20150513-M-Rome_Masters-R32-Jeremy_Chardy-Andy_Murray,2,S-DTL,4,1,0,0,1,2,2,,,,,,,,,,
20150514-M-Rome_Masters-R16-John_Isner-Rafael_Nadal,1,F-XC,13,3,0,1,2,4,9,,,,,,,,,,
20150514-M-Rome_Masters-R16-John_Isner-Rafael_Nadal,1,F-DTM,11,1,0,0,1,4,7,,,,,,,,,,
20150514-M-Rome_Masters-R16-John_Isner-Rafael_Nadal,1,F-DTL,4,3,0,0,3,0,4,,,,,,,,,,
20150514-M-Rome_Masters-R16-John_Isner-Rafael_Nadal,1,F-IO,17,8,4,1,3,8,9,,,,,,,,,,
20150514-M-Rome_Masters-R16-John_Isner-Rafael_Nadal,1,F-II,4,3,2,0,1,2,2,,,,,,,,,,
20150514-M-Rome_Masters-R16-John_Isner-Rafael_Nadal,1,B-XC,7,3,0,0,3,0,7,,,,,,,,,,
20150514-M-Rome_Masters-R16-John_Isner-Rafael_Nadal,1,B-DTM,21,3,0,0,3,1,20,,,,,,,,,,
20150514-M-Rome_Masters-R16-John_Isner-Rafael_Nadal,1,B-DTL,10,3,1,0,2,2,8,,,,,,,,,,
20150514-M-Rome_Masters-R16-John_Isner-Rafael_Nadal,1,S-XC,1,1,0,0,1,0,1,,,,,,,,,,
20150514-M-Rome_Masters-R16-John_Isner-Rafael_Nadal,1,S-DTM,4,1,0,0,1,0,4,,,,,,,,,,
20150514-M-Rome_Masters-R16-John_Isner-Rafael_Nadal,1,S-DTL,2,0,0,0,0,0,2,,,,,,,,,,
20150514-M-Rome_Masters-R16-John_Isner-Rafael_Nadal,2,F-XC,36,1,1,0,0,31,5,,,,,,,,,,
20150514-M-Rome_Masters-R16-John_Isner-Rafael_Nadal,2,F-DTM,10,0,0,0,0,7,3,,,,,,,,,,
20150514-M-Rome_Masters-R16-John_Isner-Rafael_Nadal,2,F-DTL,1,1,1,0,0,1,0,,,,,,,,,,
20150514-M-Rome_Masters-R16-John_Isner-Rafael_Nadal,2,F-IO,13,5,3,2,0,11,2,,,,,,,,,,
20150514-M-Rome_Masters-R16-John_Isner-Rafael_Nadal,2,F-II,1,0,0,0,0,0,1,,,,,,,,,,
20150514-M-Rome_Masters-R16-John_Isner-Rafael_Nadal,2,B-XC,9,2,2,0,0,9,0,,,,,,,,,,
20150514-M-Rome_Masters-R16-John_Isner-Rafael_Nadal,2,B-DTM,7,0,0,0,0,4,3,,,,,,,,,,
20150514-M-Rome_Masters-R16-John_Isner-Rafael_Nadal,2,B-DTL,9,2,2,0,0,7,2,,,,,,,,,,
20150514-M-Rome_Masters-R16-John_Isner-Rafael_Nadal,2,B-IO,3,0,0,0,0,3,0,,,,,,,,,,
20150514-M-Rome_Masters-R16-John_Isner-Rafael_Nadal,2,S-DTM,1,0,0,0,0,1,0,,,,,,,,,,
20150514-M-Rome_Masters-R16-Roger_Federer-Kevin_Anderson,1,F-XC,11,6,1,0,5,6,5,,,,,,,,,,
20150514-M-Rome_Masters-R16-Roger_Federer-Kevin_Anderson,1,F-DTM,16,4,1,2,1,12,4,,,,,,,,,,
20150514-M-Rome_Masters-R16-Roger_Federer-Kevin_Anderson,1,F-DTL,5,1,1,0,0,5,0,,,,,,,,,,
20150514-M-Rome_Masters-R16-Roger_Federer-Kevin_Anderson,1,F-IO,10,4,2,0,2,6,4,,,,,,,,,,
20150514-M-Rome_Masters-R16-Roger_Federer-Kevin_Anderson,1,F-II,1,0,0,0,0,1,0,,,,,,,,,,
20150514-M-Rome_Masters-R16-Roger_Federer-Kevin_Anderson,1,B-XC,17,4,1,0,3,10,7,,,,,,,,,,
20150514-M-Rome_Masters-R16-Roger_Federer-Kevin_Anderson,1,B-DTM,18,2,0,1,1,14,4,,,,,,,,,,
20150514-M-Rome_Masters-R16-Roger_Federer-Kevin_Anderson,1,B-DTL,8,7,5,1,1,7,1,,,,,,,,,,
20150514-M-Rome_Masters-R16-Roger_Federer-Kevin_Anderson,1,S-XC,8,1,0,1,0,4,4,,,,,,,,,,
20150514-M-Rome_Masters-R16-Roger_Federer-Kevin_Anderson,1,S-DTM,9,1,0,0,1,5,4,,,,,,,,,,
20150514-M-Rome_Masters-R16-Roger_Federer-Kevin_Anderson,1,S-DTL,3,1,0,0,1,0,3,,,,,,,,,,
20150514-M-Rome_Masters-R16-Roger_Federer-Kevin_Anderson,2,F-XC,18,4,1,0,3,3,15,,,,,,,,,,
20150514-M-Rome_Masters-R16-Roger_Federer-Kevin_Anderson,2,F-DTM,11,3,0,0,3,2,9,,,,,,,,,,
20150514-M-Rome_Masters-R16-Roger_Federer-Kevin_Anderson,2,F-DTL,3,1,0,1,0,2,1,,,,,,,,,,
20150514-M-Rome_Masters-R16-Roger_Federer-Kevin_Anderson,2,F-IO,22,12,3,1,8,8,14,,,,,,,,,,
20150514-M-Rome_Masters-R16-Roger_Federer-Kevin_Anderson,2,F-II,2,1,0,0,1,0,2,,,,,,,,,,
20150514-M-Rome_Masters-R16-Roger_Federer-Kevin_Anderson,2,B-XC,34,5,0,0,5,7,27,,,,,,,,,,
20150514-M-Rome_Masters-R16-Roger_Federer-Kevin_Anderson,2,B-DTM,11,0,0,0,0,4,7,,,,,,,,,,
20150514-M-Rome_Masters-R16-Roger_Federer-Kevin_Anderson,2,S-XC,4,0,0,0,0,1,3,,,,,,,,,,
20150514-M-Rome_Masters-R16-Roger_Federer-Kevin_Anderson,2,S-DTM,2,0,0,0,0,2,0,,,,,,,,,,
20150515-M-Rome_Masters-QF-Novak_Djokovic-Kei_Nishikori,1,F-XC,27,9,5,0,4,18,9,,,,,,,,,,
20150515-M-Rome_Masters-QF-Novak_Djokovic-Kei_Nishikori,1,F-DTM,22,3,0,1,2,8,14,,,,,,,,,,
20150515-M-Rome_Masters-QF-Novak_Djokovic-Kei_Nishikori,1,F-DTL,10,4,0,1,3,4,6,,,,,,,,,,
20150515-M-Rome_Masters-QF-Novak_Djokovic-Kei_Nishikori,1,F-IO,14,3,0,2,1,11,3,,,,,,,,,,
20150515-M-Rome_Masters-QF-Novak_Djokovic-Kei_Nishikori,1,F-II,4,2,1,0,1,3,1,,,,,,,,,,
20150515-M-Rome_Masters-QF-Novak_Djokovic-Kei_Nishikori,1,B-XC,30,4,1,0,3,15,15,,,,,,,,,,
20150515-M-Rome_Masters-QF-Novak_Djokovic-Kei_Nishikori,1,B-DTM,34,3,0,0,3,18,16,,,,,,,,,,
20150515-M-Rome_Masters-QF-Novak_Djokovic-Kei_Nishikori,1,B-DTL,8,1,0,0,1,5,3,,,,,,,,,,
20150515-M-Rome_Masters-QF-Novak_Djokovic-Kei_Nishikori,1,B-IO,5,2,0,1,1,4,1,,,,,,,,,,
20150515-M-Rome_Masters-QF-Novak_Djokovic-Kei_Nishikori,1,S-XC,7,0,0,0,0,3,4,,,,,,,,,,
20150515-M-Rome_Masters-QF-Novak_Djokovic-Kei_Nishikori,1,S-DTM,1,0,0,0,0,1,0,,,,,,,,,,
20150515-M-Rome_Masters-QF-Novak_Djokovic-Kei_Nishikori,2,F-XC,45,12,3,2,7,24,21,,,,,,,,,,
20150515-M-Rome_Masters-QF-Novak_Djokovic-Kei_Nishikori,2,F-DTM,17,1,0,0,1,5,12,,,,,,,,,,
20150515-M-Rome_Masters-QF-Novak_Djokovic-Kei_Nishikori,2,F-DTL,8,4,0,0,4,0,8,,,,,,,,,,
20150515-M-Rome_Masters-QF-Novak_Djokovic-Kei_Nishikori,2,F-IO,17,4,1,0,3,7,10,,,,,,,,,,
20150515-M-Rome_Masters-QF-Novak_Djokovic-Kei_Nishikori,2,F-II,1,0,0,0,0,1,0,,,,,,,,,,
20150515-M-Rome_Masters-QF-Novak_Djokovic-Kei_Nishikori,2,B-XC,37,9,1,1,7,19,18,,,,,,,,,,
20150515-M-Rome_Masters-QF-Novak_Djokovic-Kei_Nishikori,2,B-DTM,24,3,0,0,3,4,20,,,,,,,,,,
20150515-M-Rome_Masters-QF-Novak_Djokovic-Kei_Nishikori,2,B-DTL,8,3,1,1,1,6,2,,,,,,,,,,
20150515-M-Rome_Masters-QF-Novak_Djokovic-Kei_Nishikori,2,B-IO,6,1,0,1,0,5,1,,,,,,,,,,
20150515-M-Rome_Masters-QF-Novak_Djokovic-Kei_Nishikori,2,S-XC,6,0,0,0,0,2,4,,,,,,,,,,
20150515-M-Rome_Masters-QF-Novak_Djokovic-Kei_Nishikori,2,S-DTM,3,0,0,0,0,0,3,,,,,,,,,,
20150515-M-Rome_Masters-QF-Novak_Djokovic-Kei_Nishikori,2,S-DTL,1,0,0,0,0,0,1,,,,,,,,,,
20150515-M-Rome_Masters-QF-Roger_Federer-Tomas_Berdych,1,F-XC,15,7,5,2,0,12,3,,,,,,,,,,
20150515-M-Rome_Masters-QF-Roger_Federer-Tomas_Berdych,1,F-DTM,22,1,0,0,1,11,11,,,,,,,,,,
20150515-M-Rome_Masters-QF-Roger_Federer-Tomas_Berdych,1,F-DTL,4,0,0,0,0,1,3,,,,,,,,,,
20150515-M-Rome_Masters-QF-Roger_Federer-Tomas_Berdych,1,F-IO,8,5,1,2,2,6,2,,,,,,,,,,
20150515-M-Rome_Masters-QF-Roger_Federer-Tomas_Berdych,1,F-II,1,1,0,1,0,1,0,,,,,,,,,,
20150515-M-Rome_Masters-QF-Roger_Federer-Tomas_Berdych,1,B-XC,18,4,2,1,1,11,7,,,,,,,,,,
20150515-M-Rome_Masters-QF-Roger_Federer-Tomas_Berdych,1,B-DTM,18,1,0,1,0,8,10,,,,,,,,,,
20150515-M-Rome_Masters-QF-Roger_Federer-Tomas_Berdych,1,B-DTL,5,3,1,1,1,3,2,,,,,,,,,,
20150515-M-Rome_Masters-QF-Roger_Federer-Tomas_Berdych,1,B-IO,1,1,0,0,1,0,1,,,,,,,,,,
20150515-M-Rome_Masters-QF-Roger_Federer-Tomas_Berdych,1,B-II,1,1,0,1,0,1,0,,,,,,,,,,
20150515-M-Rome_Masters-QF-Roger_Federer-Tomas_Berdych,1,S-XC,10,2,0,1,1,6,4,,,,,,,,,,
20150515-M-Rome_Masters-QF-Roger_Federer-Tomas_Berdych,1,S-DTM,6,0,0,0,0,2,4,,,,,,,,,,
20150515-M-Rome_Masters-QF-Roger_Federer-Tomas_Berdych,1,S-DTL,2,1,0,0,1,0,2,,,,,,,,,,
20150515-M-Rome_Masters-QF-Roger_Federer-Tomas_Berdych,2,F-XC,14,4,1,3,0,9,5,,,,,,,,,,
20150515-M-Rome_Masters-QF-Roger_Federer-Tomas_Berdych,2,F-DTM,12,1,0,1,0,6,6,,,,,,,,,,
20150515-M-Rome_Masters-QF-Roger_Federer-Tomas_Berdych,2,F-DTL,3,2,0,2,0,3,0,,,,,,,,,,
20150515-M-Rome_Masters-QF-Roger_Federer-Tomas_Berdych,2,F-IO,27,5,2,0,3,16,11,,,,,,,,,,
20150515-M-Rome_Masters-QF-Roger_Federer-Tomas_Berdych,2,F-II,1,1,1,0,0,1,0,,,,,,,,,,
20150515-M-Rome_Masters-QF-Roger_Federer-Tomas_Berdych,2,B-XC,24,3,0,1,2,9,15,,,,,,,,,,
20150515-M-Rome_Masters-QF-Roger_Federer-Tomas_Berdych,2,B-DTM,15,2,0,1,1,5,10,,,,,,,,,,
20150515-M-Rome_Masters-QF-Roger_Federer-Tomas_Berdych,2,B-DTL,3,3,2,0,1,2,1,,,,,,,,,,
20150515-M-Rome_Masters-QF-Roger_Federer-Tomas_Berdych,2,B-IO,3,1,0,0,1,1,2,,,,,,,,,,
20150515-M-Rome_Masters-QF-Roger_Federer-Tomas_Berdych,2,S-XC,1,0,0,0,0,0,1,,,,,,,,,,
20150515-M-Rome_Masters-QF-Roger_Federer-Tomas_Berdych,2,S-DTL,1,1,0,0,1,0,1,,,,,,,,,,
20150521-M-Nice-QF-Leonardo_Mayer-Juan_Monaco,1,F-XC,52,15,4,2,9,25,27,,,,,,,,,,
20150521-M-Nice-QF-Leonardo_Mayer-Juan_Monaco,1,F-DTM,16,3,0,1,2,8,8,,,,,,,,,,
20150521-M-Nice-QF-Leonardo_Mayer-Juan_Monaco,1,F-DTL,6,4,0,0,4,0,6,,,,,,,,,,
20150521-M-Nice-QF-Leonardo_Mayer-Juan_Monaco,1,F-IO,23,7,3,2,2,12,11,,,,,,,,,,
20150521-M-Nice-QF-Leonardo_Mayer-Juan_Monaco,1,F-II,7,2,1,0,1,3,4,,,,,,,,,,
20150521-M-Nice-QF-Leonardo_Mayer-Juan_Monaco,1,B-XC,54,15,1,3,11,20,34,,,,,,,,,,
20150521-M-Nice-QF-Leonardo_Mayer-Juan_Monaco,1,B-DTM,28,4,0,0,4,10,18,,,,,,,,,,
20150521-M-Nice-QF-Leonardo_Mayer-Juan_Monaco,1,B-DTL,11,6,1,1,4,5,6,,,,,,,,,,
20150521-M-Nice-QF-Leonardo_Mayer-Juan_Monaco,1,B-IO,3,0,0,0,0,0,3,,,,,,,,,,
20150521-M-Nice-QF-Leonardo_Mayer-Juan_Monaco,1,S-XC,2,0,0,0,0,0,2,,,,,,,,,,
20150521-M-Nice-QF-Leonardo_Mayer-Juan_Monaco,1,S-DTM,6,0,0,0,0,4,2,,,,,,,,,,
20150521-M-Nice-QF-Leonardo_Mayer-Juan_Monaco,2,F-XC,19,1,1,0,0,16,3,,,,,,,,,,
20150521-M-Nice-QF-Leonardo_Mayer-Juan_Monaco,2,F-DTM,33,2,0,0,2,15,18,,,,,,,,,,
20150521-M-Nice-QF-Leonardo_Mayer-Juan_Monaco,2,F-DTL,19,4,1,0,3,13,6,,,,,,,,,,
20150521-M-Nice-QF-Leonardo_Mayer-Juan_Monaco,2,F-IO,17,2,0,0,2,8,9,,,,,,,,,,
20150521-M-Nice-QF-Leonardo_Mayer-Juan_Monaco,2,F-II,1,1,1,0,0,1,0,,,,,,,,,,
20150521-M-Nice-QF-Leonardo_Mayer-Juan_Monaco,2,B-XC,53,10,1,3,6,32,21,,,,,,,,,,
20150521-M-Nice-QF-Leonardo_Mayer-Juan_Monaco,2,B-DTM,38,5,1,0,4,18,20,,,,,,,,,,
20150521-M-Nice-QF-Leonardo_Mayer-Juan_Monaco,2,B-DTL,3,3,3,0,0,3,0,,,,,,,,,,
20150521-M-Nice-QF-Leonardo_Mayer-Juan_Monaco,2,S-XC,5,0,0,0,0,4,1,,,,,,,,,,
20150521-M-Nice-QF-Leonardo_Mayer-Juan_Monaco,2,S-DTM,2,0,0,0,0,1,1,,,,,,,,,,
20150521-M-Nice-QF-Leonardo_Mayer-Juan_Monaco,2,S-DTL,1,0,0,0,0,0,1,,,,,,,,,,
20150522-M-Scheveningen-R32-Aleksandr_Nedovyesov-Andrey_Golubev,1,F-XC,15,11,5,5,1,13,2,,,,,,,,,,
20150522-M-Scheveningen-R32-Aleksandr_Nedovyesov-Andrey_Golubev,1,F-DTM,25,1,0,1,0,11,14,,,,,,,,,,
20150522-M-Scheveningen-R32-Aleksandr_Nedovyesov-Andrey_Golubev,1,F-DTL,4,0,0,0,0,3,1,,,,,,,,,,
20150522-M-Scheveningen-R32-Aleksandr_Nedovyesov-Andrey_Golubev,1,F-IO,12,1,0,1,0,10,2,,,,,,,,,,
20150522-M-Scheveningen-R32-Aleksandr_Nedovyesov-Andrey_Golubev,1,F-II,1,0,0,0,0,0,1,,,,,,,,,,
20150522-M-Scheveningen-R32-Aleksandr_Nedovyesov-Andrey_Golubev,1,B-XC,17,3,1,1,1,9,8,,,,,,,,,,
20150522-M-Scheveningen-R32-Aleksandr_Nedovyesov-Andrey_Golubev,1,B-DTM,9,0,0,0,0,3,6,,,,,,,,,,
20150522-M-Scheveningen-R32-Aleksandr_Nedovyesov-Andrey_Golubev,1,B-DTL,3,0,0,0,0,3,0,,,,,,,,,,
20150522-M-Scheveningen-R32-Aleksandr_Nedovyesov-Andrey_Golubev,1,B-IO,2,1,1,0,0,2,0,,,,,,,,,,
20150522-M-Scheveningen-R32-Aleksandr_Nedovyesov-Andrey_Golubev,1,S-XC,10,1,1,0,0,6,4,,,,,,,,,,
20150522-M-Scheveningen-R32-Aleksandr_Nedovyesov-Andrey_Golubev,1,S-DTM,8,0,0,0,0,2,6,,,,,,,,,,
20150522-M-Scheveningen-R32-Aleksandr_Nedovyesov-Andrey_Golubev,1,S-DTL,2,0,0,0,0,2,0,,,,,,,,,,
20150522-M-Scheveningen-R32-Aleksandr_Nedovyesov-Andrey_Golubev,1,S-IO,1,0,0,0,0,0,1,,,,,,,,,,
20150522-M-Scheveningen-R32-Aleksandr_Nedovyesov-Andrey_Golubev,2,F-XC,25,9,9,0,0,20,5,,,,,,,,,,
20150522-M-Scheveningen-R32-Aleksandr_Nedovyesov-Andrey_Golubev,2,F-DTM,17,0,0,0,0,9,8,,,,,,,,,,
20150522-M-Scheveningen-R32-Aleksandr_Nedovyesov-Andrey_Golubev,2,F-DTL,3,2,1,0,0,2,1,,,,,,,,,,
20150522-M-Scheveningen-R32-Aleksandr_Nedovyesov-Andrey_Golubev,2,F-IO,26,3,2,1,0,18,8,,,,,,,,,,
20150522-M-Scheveningen-R32-Aleksandr_Nedovyesov-Andrey_Golubev,2,F-II,3,2,0,1,1,2,1,,,,,,,,,,
20150522-M-Scheveningen-R32-Aleksandr_Nedovyesov-Andrey_Golubev,2,B-XC,14,0,0,0,0,8,6,,,,,,,,,,
20150522-M-Scheveningen-R32-Aleksandr_Nedovyesov-Andrey_Golubev,2,B-DTM,5,0,0,0,0,2,3,,,,,,,,,,
20150522-M-Scheveningen-R32-Aleksandr_Nedovyesov-Andrey_Golubev,2,S-XC,10,1,0,0,1,3,7,,,,,,,,,,
20150522-M-Scheveningen-R32-Aleksandr_Nedovyesov-Andrey_Golubev,2,S-DTM,5,0,0,0,0,2,3,,,,,,,,,,
20150524-M-Nice-F-Leonardo_Mayer-Dominic_Thiem,1,F-XC,67,26,9,2,15,26,41,,,,,,,,,,
20150524-M-Nice-F-Leonardo_Mayer-Dominic_Thiem,1,F-DTM,18,4,0,0,4,3,15,,,,,,,,,,
20150524-M-Nice-F-Leonardo_Mayer-Dominic_Thiem,1,F-DTL,17,3,1,0,2,5,12,,,,,,,,,,
20150524-M-Nice-F-Leonardo_Mayer-Dominic_Thiem,1,F-IO,37,7,2,1,4,21,16,,,,,,,,,,
20150524-M-Nice-F-Leonardo_Mayer-Dominic_Thiem,1,F-II,9,5,2,2,1,6,3,,,,,,,,,,
20150524-M-Nice-F-Leonardo_Mayer-Dominic_Thiem,1,B-XC,41,10,3,2,5,17,24,,,,,,,,,,
20150524-M-Nice-F-Leonardo_Mayer-Dominic_Thiem,1,B-DTM,19,1,0,0,1,4,15,,,,,,,,,,
20150524-M-Nice-F-Leonardo_Mayer-Dominic_Thiem,1,B-DTL,9,6,2,1,3,3,6,,,,,,,,,,
20150524-M-Nice-F-Leonardo_Mayer-Dominic_Thiem,1,B-IO,1,0,0,0,0,1,0,,,,,,,,,,
20150524-M-Nice-F-Leonardo_Mayer-Dominic_Thiem,1,S-XC,4,0,0,0,0,1,3,,,,,,,,,,
20150524-M-Nice-F-Leonardo_Mayer-Dominic_Thiem,1,S-DTM,1,0,0,0,0,1,0,,,,,,,,,,
20150524-M-Nice-F-Leonardo_Mayer-Dominic_Thiem,2,F-XC,46,9,5,3,1,39,7,,,,,,,,,,
20150524-M-Nice-F-Leonardo_Mayer-Dominic_Thiem,2,F-DTM,21,3,0,1,2,12,9,,,,,,,,,,
20150524-M-Nice-F-Leonardo_Mayer-Dominic_Thiem,2,F-DTL,15,4,1,0,3,8,7,,,,,,,,,,
20150524-M-Nice-F-Leonardo_Mayer-Dominic_Thiem,2,F-IO,25,8,6,2,0,19,6,,,,,,,,,,
20150524-M-Nice-F-Leonardo_Mayer-Dominic_Thiem,2,F-II,10,4,4,0,0,9,1,,,,,,,,,,
20150524-M-Nice-F-Leonardo_Mayer-Dominic_Thiem,2,B-XC,32,8,1,1,6,19,13,,,,,,,,,,
20150524-M-Nice-F-Leonardo_Mayer-Dominic_Thiem,2,B-DTM,21,5,1,0,4,10,11,,,,,,,,,,
20150524-M-Nice-F-Leonardo_Mayer-Dominic_Thiem,2,B-DTL,11,6,3,0,3,8,3,,,,,,,,,,
20150524-M-Nice-F-Leonardo_Mayer-Dominic_Thiem,2,B-IO,3,3,1,0,2,1,2,,,,,,,,,,
20150524-M-Nice-F-Leonardo_Mayer-Dominic_Thiem,2,B-II,1,0,0,0,0,1,0,,,,,,,,,,
20150524-M-Nice-F-Leonardo_Mayer-Dominic_Thiem,2,S-XC,15,3,1,0,2,9,6,,,,,,,,,,
20150524-M-Nice-F-Leonardo_Mayer-Dominic_Thiem,2,S-DTM,8,0,0,0,0,4,4,,,,,,,,,,
20150524-M-Nice-F-Leonardo_Mayer-Dominic_Thiem,2,S-DTL,2,1,0,0,1,1,1,,,,,,,,,,
20150524-M-Roland_Garros-R128-Paul_Henri_Mathieu-Kei_Nishikori,1,F-XC,20,7,2,5,0,13,7,,,,,,,,,,
20150524-M-Roland_Garros-R128-Paul_Henri_Mathieu-Kei_Nishikori,1,F-DTM,21,2,0,1,1,10,11,,,,,,,,,,
20150524-M-Roland_Garros-R128-Paul_Henri_Mathieu-Kei_Nishikori,1,F-DTL,10,4,2,0,2,5,5,,,,,,,,,,
20150524-M-Roland_Garros-R128-Paul_Henri_Mathieu-Kei_Nishikori,1,F-IO,26,5,2,1,2,8,18,,,,,,,,,,
20150524-M-Roland_Garros-R128-Paul_Henri_Mathieu-Kei_Nishikori,1,F-II,4,2,0,1,1,2,2,,,,,,,,,,
20150524-M-Roland_Garros-R128-Paul_Henri_Mathieu-Kei_Nishikori,1,B-XC,40,11,2,2,7,17,23,,,,,,,,,,
20150524-M-Roland_Garros-R128-Paul_Henri_Mathieu-Kei_Nishikori,1,B-DTM,45,8,1,1,6,12,33,,,,,,,,,,
20150524-M-Roland_Garros-R128-Paul_Henri_Mathieu-Kei_Nishikori,1,B-DTL,21,12,4,1,7,7,14,,,,,,,,,,
20150524-M-Roland_Garros-R128-Paul_Henri_Mathieu-Kei_Nishikori,1,B-IO,10,7,3,1,3,7,3,,,,,,,,,,
20150524-M-Roland_Garros-R128-Paul_Henri_Mathieu-Kei_Nishikori,1,B-II,1,0,0,0,0,0,1,,,,,,,,,,
20150524-M-Roland_Garros-R128-Paul_Henri_Mathieu-Kei_Nishikori,1,S-XC,7,0,0,0,0,2,5,,,,,,,,,,
20150524-M-Roland_Garros-R128-Paul_Henri_Mathieu-Kei_Nishikori,1,S-DTM,2,0,0,0,0,1,1,,,,,,,,,,
20150524-M-Roland_Garros-R128-Paul_Henri_Mathieu-Kei_Nishikori,2,F-XC,27,7,3,2,2,13,14,,,,,,,,,,
20150524-M-Roland_Garros-R128-Paul_Henri_Mathieu-Kei_Nishikori,2,F-DTM,27,4,1,2,1,17,10,,,,,,,,,,
20150524-M-Roland_Garros-R128-Paul_Henri_Mathieu-Kei_Nishikori,2,F-DTL,4,2,1,1,0,4,0,,,,,,,,,,
20150524-M-Roland_Garros-R128-Paul_Henri_Mathieu-Kei_Nishikori,2,F-IO,20,10,3,2,5,12,8,,,,,,,,,,
20150524-M-Roland_Garros-R128-Paul_Henri_Mathieu-Kei_Nishikori,2,F-II,1,1,0,0,1,0,1,,,,,,,,,,
20150524-M-Roland_Garros-R128-Paul_Henri_Mathieu-Kei_Nishikori,2,B-XC,56,10,1,4,5,36,20,,,,,,,,,,
20150524-M-Roland_Garros-R128-Paul_Henri_Mathieu-Kei_Nishikori,2,B-DTM,35,3,0,0,3,19,16,,,,,,,,,,
20150524-M-Roland_Garros-R128-Paul_Henri_Mathieu-Kei_Nishikori,2,B-DTL,11,8,4,3,1,9,2,,,,,,,,,,
20150524-M-Roland_Garros-R128-Paul_Henri_Mathieu-Kei_Nishikori,2,B-IO,5,3,2,1,0,4,1,,,,,,,,,,
20150524-M-Roland_Garros-R128-Paul_Henri_Mathieu-Kei_Nishikori,2,S-XC,5,1,0,0,1,3,2,,,,,,,,,,
20150524-M-Roland_Garros-R128-Paul_Henri_Mathieu-Kei_Nishikori,2,S-DTM,5,0,0,0,0,2,3,,,,,,,,,,
20150524-M-Roland_Garros-R128-Paul_Henri_Mathieu-Kei_Nishikori,2,S-DTL,1,0,0,0,0,0,1,,,,,,,,,,
20150528-M-Roland_Garros-R64-Jeremy_Chardy-John_Isner,1,F-XC,32,18,10,6,2,23,9,,,,,,,,,,
20150528-M-Roland_Garros-R64-Jeremy_Chardy-John_Isner,1,F-DTM,11,1,0,1,0,7,4,,,,,,,,,,
20150528-M-Roland_Garros-R64-Jeremy_Chardy-John_Isner,1,F-DTL,8,5,1,2,2,6,2,,,,,,,,,,
20150528-M-Roland_Garros-R64-Jeremy_Chardy-John_Isner,1,F-IO,45,21,8,9,4,33,12,,,,,,,,,,
20150528-M-Roland_Garros-R64-Jeremy_Chardy-John_Isner,1,F-II,6,4,1,2,1,4,2,,,,,,,,,,
20150528-M-Roland_Garros-R64-Jeremy_Chardy-John_Isner,1,B-XC,17,2,0,0,2,10,7,,,,,,,,,,
20150528-M-Roland_Garros-R64-Jeremy_Chardy-John_Isner,1,B-DTM,5,1,0,1,0,2,3,,,,,,,,,,
20150528-M-Roland_Garros-R64-Jeremy_Chardy-John_Isner,1,B-DTL,11,6,3,1,2,8,3,,,,,,,,,,
20150528-M-Roland_Garros-R64-Jeremy_Chardy-John_Isner,1,B-IO,2,0,0,0,0,2,0,,,,,,,,,,
20150528-M-Roland_Garros-R64-Jeremy_Chardy-John_Isner,1,S-XC,7,1,0,0,1,3,4,,,,,,,,,,
20150528-M-Roland_Garros-R64-Jeremy_Chardy-John_Isner,1,S-DTM,4,0,0,0,0,2,2,,,,,,,,,,
20150528-M-Roland_Garros-R64-Jeremy_Chardy-John_Isner,1,S-DTL,1,0,0,0,0,1,0,,,,,,,,,,
20150528-M-Roland_Garros-R64-Jeremy_Chardy-John_Isner,2,F-XC,24,10,4,3,3,10,14,,,,,,,,,,
20150528-M-Roland_Garros-R64-Jeremy_Chardy-John_Isner,2,F-DTM,11,1,0,1,0,4,7,,,,,,,,,,
20150528-M-Roland_Garros-R64-Jeremy_Chardy-John_Isner,2,F-DTL,7,1,1,0,0,2,5,,,,,,,,,,
20150528-M-Roland_Garros-R64-Jeremy_Chardy-John_Isner,2,F-IO,26,12,5,3,4,15,11,,,,,,,,,,
20150528-M-Roland_Garros-R64-Jeremy_Chardy-John_Isner,2,F-II,6,3,1,0,2,2,4,,,,,,,,,,
20150528-M-Roland_Garros-R64-Jeremy_Chardy-John_Isner,2,B-XC,17,5,1,3,1,8,9,,,,,,,,,,
20150528-M-Roland_Garros-R64-Jeremy_Chardy-John_Isner,2,B-DTM,12,2,0,0,2,1,11,,,,,,,,,,
20150528-M-Roland_Garros-R64-Jeremy_Chardy-John_Isner,2,B-DTL,5,3,2,0,1,2,3,,,,,,,,,,
20150528-M-Roland_Garros-R64-Jeremy_Chardy-John_Isner,2,B-IO,1,0,0,0,0,0,1,,,,,,,,,,
20150528-M-Roland_Garros-R64-Jeremy_Chardy-John_Isner,2,S-XC,7,1,0,0,1,3,4,,,,,,,,,,
20150528-M-Roland_Garros-R64-Jeremy_Chardy-John_Isner,2,S-DTM,8,0,0,0,0,2,6,,,,,,,,,,
20150528-M-Roland_Garros-R64-Jeremy_Chardy-John_Isner,2,S-DTL,4,0,0,0,0,1,3,,,,,,,,,,
20150529-M-Roland_Garros-R32-Damir_Dzumhur-Roger_Federer,1,F-XC,10,1,0,1,0,3,7,,,,,,,,,,
20150529-M-Roland_Garros-R32-Damir_Dzumhur-Roger_Federer,1,F-DTM,14,1,1,0,0,7,7,,,,,,,,,,
20150529-M-Roland_Garros-R32-Damir_Dzumhur-Roger_Federer,1,F-DTL,19,6,2,2,2,10,9,,,,,,,,,,
20150529-M-Roland_Garros-R32-Damir_Dzumhur-Roger_Federer,1,F-IO,21,6,1,1,4,6,15,,,,,,,,,,
20150529-M-Roland_Garros-R32-Damir_Dzumhur-Roger_Federer,1,F-II,2,1,0,1,0,1,1,,,,,,,,,,
20150529-M-Roland_Garros-R32-Damir_Dzumhur-Roger_Federer,1,B-XC,25,2,0,0,2,13,12,,,,,,,,,,
20150529-M-Roland_Garros-R32-Damir_Dzumhur-Roger_Federer,1,B-DTM,29,2,0,0,2,10,19,,,,,,,,,,
20150529-M-Roland_Garros-R32-Damir_Dzumhur-Roger_Federer,1,B-DTL,13,8,1,2,5,6,7,,,,,,,,,,
20150529-M-Roland_Garros-R32-Damir_Dzumhur-Roger_Federer,1,B-IO,1,1,0,0,1,0,1,,,,,,,,,,
20150529-M-Roland_Garros-R32-Damir_Dzumhur-Roger_Federer,1,S-XC,10,1,0,0,1,5,5,,,,,,,,,,
20150529-M-Roland_Garros-R32-Damir_Dzumhur-Roger_Federer,1,S-DTM,4,0,0,0,0,0,4,,,,,,,,,,
20150529-M-Roland_Garros-R32-Damir_Dzumhur-Roger_Federer,1,S-DTL,3,1,0,1,0,1,2,,,,,,,,,,
20150529-M-Roland_Garros-R32-Damir_Dzumhur-Roger_Federer,1,S-IO,2,0,0,0,0,0,2,,,,,,,,,,
20150529-M-Roland_Garros-R32-Damir_Dzumhur-Roger_Federer,2,F-XC,33,14,2,6,6,19,14,,,,,,,,,,
20150529-M-Roland_Garros-R32-Damir_Dzumhur-Roger_Federer,2,F-DTM,19,5,2,2,1,11,8,,,,,,,,,,
20150529-M-Roland_Garros-R32-Damir_Dzumhur-Roger_Federer,2,F-DTL,10,5,4,0,1,7,3,,,,,,,,,,
20150529-M-Roland_Garros-R32-Damir_Dzumhur-Roger_Federer,2,F-IO,27,11,7,2,2,21,6,,,,,,,,,,
20150529-M-Roland_Garros-R32-Damir_Dzumhur-Roger_Federer,2,F-II,7,3,3,0,0,6,1,,,,,,,,,,
20150529-M-Roland_Garros-R32-Damir_Dzumhur-Roger_Federer,2,B-XC,22,2,1,1,0,17,5,,,,,,,,,,
20150529-M-Roland_Garros-R32-Damir_Dzumhur-Roger_Federer,2,B-DTM,15,3,0,2,1,11,4,,,,,,,,,,
20150529-M-Roland_Garros-R32-Damir_Dzumhur-Roger_Federer,2,B-DTL,12,4,3,0,1,7,5,,,,,,,,,,
20150529-M-Roland_Garros-R32-Damir_Dzumhur-Roger_Federer,2,B-IO,1,1,0,0,1,0,1,,,,,,,,,,
20150529-M-Roland_Garros-R32-Damir_Dzumhur-Roger_Federer,2,S-XC,11,0,0,0,0,4,7,,,,,,,,,,
20150529-M-Roland_Garros-R32-Damir_Dzumhur-Roger_Federer,2,S-DTM,7,0,0,0,0,3,4,,,,,,,,,,
20150529-M-Roland_Garros-R32-Damir_Dzumhur-Roger_Federer,2,S-DTL,2,0,0,0,0,0,2,,,,,,,,,,
20150530-M-Roland_Garros-R32-Nick_Kyrgios-Andy_Murray,1,F-XC,56,12,5,3,4,29,27,,,,,,,,,,
20150530-M-Roland_Garros-R32-Nick_Kyrgios-Andy_Murray,1,F-DTM,21,1,0,0,1,5,16,,,,,,,,,,
20150530-M-Roland_Garros-R32-Nick_Kyrgios-Andy_Murray,1,F-DTL,16,4,2,1,1,5,11,,,,,,,,,,
20150530-M-Roland_Garros-R32-Nick_Kyrgios-Andy_Murray,1,F-IO,34,11,6,2,3,16,18,,,,,,,,,,
20150530-M-Roland_Garros-R32-Nick_Kyrgios-Andy_Murray,1,F-II,10,6,2,0,4,5,5,,,,,,,,,,
20150530-M-Roland_Garros-R32-Nick_Kyrgios-Andy_Murray,1,B-XC,65,10,2,2,6,32,33,,,,,,,,,,
20150530-M-Roland_Garros-R32-Nick_Kyrgios-Andy_Murray,1,B-DTM,16,1,0,0,1,8,8,,,,,,,,,,
20150530-M-Roland_Garros-R32-Nick_Kyrgios-Andy_Murray,1,B-DTL,15,5,1,2,2,8,7,,,,,,,,,,
20150530-M-Roland_Garros-R32-Nick_Kyrgios-Andy_Murray,1,B-IO,1,0,0,0,0,1,0,,,,,,,,,,
20150530-M-Roland_Garros-R32-Nick_Kyrgios-Andy_Murray,1,S-XC,7,1,1,0,0,3,4,,,,,,,,,,
20150530-M-Roland_Garros-R32-Nick_Kyrgios-Andy_Murray,1,S-DTL,1,1,1,0,0,1,0,,,,,,,,,,
20150530-M-Roland_Garros-R32-Nick_Kyrgios-Andy_Murray,1,S-IO,1,0,0,0,0,0,1,,,,,,,,,,
20150530-M-Roland_Garros-R32-Nick_Kyrgios-Andy_Murray,2,F-XC,39,11,5,4,2,26,13,,,,,,,,,,
20150530-M-Roland_Garros-R32-Nick_Kyrgios-Andy_Murray,2,F-DTM,19,0,0,0,0,5,14,,,,,,,,,,
20150530-M-Roland_Garros-R32-Nick_Kyrgios-Andy_Murray,2,F-DTL,23,6,3,2,1,14,9,,,,,,,,,,
20150530-M-Roland_Garros-R32-Nick_Kyrgios-Andy_Murray,2,F-IO,23,10,5,2,3,13,10,,,,,,,,,,
20150530-M-Roland_Garros-R32-Nick_Kyrgios-Andy_Murray,2,F-II,5,1,0,0,1,2,3,,,,,,,,,,
20150530-M-Roland_Garros-R32-Nick_Kyrgios-Andy_Murray,2,B-XC,37,1,1,0,0,20,17,,,,,,,,,,
20150530-M-Roland_Garros-R32-Nick_Kyrgios-Andy_Murray,2,B-DTM,30,1,1,0,0,17,13,,,,,,,,,,
20150530-M-Roland_Garros-R32-Nick_Kyrgios-Andy_Murray,2,B-DTL,16,12,8,0,4,10,6,,,,,,,,,,
20150530-M-Roland_Garros-R32-Nick_Kyrgios-Andy_Murray,2,B-IO,9,2,0,0,2,6,3,,,,,,,,,,
20150530-M-Roland_Garros-R32-Nick_Kyrgios-Andy_Murray,2,S-XC,26,1,0,1,0,12,14,,,,,,,,,,
20150530-M-Roland_Garros-R32-Nick_Kyrgios-Andy_Murray,2,S-DTM,8,0,0,0,0,4,4,,,,,,,,,,
20150530-M-Roland_Garros-R32-Nick_Kyrgios-Andy_Murray,2,S-DTL,1,0,0,0,0,0,1,,,,,,,,,,
20150530-M-Roland_Garros-R32-Nick_Kyrgios-Andy_Murray,2,S-IO,1,0,0,0,0,0,1,,,,,,,,,,
20150531-M-Roland_Garros-R16-Roger_Federer-Gael_Monfils,1,F-XC,68,23,11,4,8,34,34,,,,,,,,,,
20150531-M-Roland_Garros-R16-Roger_Federer-Gael_Monfils,1,F-DTM,48,3,0,0,3,19,29,,,,,,,,,,
20150531-M-Roland_Garros-R16-Roger_Federer-Gael_Monfils,1,F-DTL,24,9,2,4,3,15,9,,,,,,,,,,
20150531-M-Roland_Garros-R16-Roger_Federer-Gael_Monfils,1,F-IO,44,9,3,1,5,21,23,,,,,,,,,,
20150531-M-Roland_Garros-R16-Roger_Federer-Gael_Monfils,1,F-II,10,3,2,0,1,5,5,,,,,,,,,,
20150531-M-Roland_Garros-R16-Roger_Federer-Gael_Monfils,1,B-XC,48,5,0,1,4,25,23,,,,,,,,,,
20150531-M-Roland_Garros-R16-Roger_Federer-Gael_Monfils,1,B-DTM,31,1,0,0,1,18,13,,,,,,,,,,
20150531-M-Roland_Garros-R16-Roger_Federer-Gael_Monfils,1,B-DTL,14,6,2,1,3,7,7,,,,,,,,,,
20150531-M-Roland_Garros-R16-Roger_Federer-Gael_Monfils,1,B-IO,2,2,1,1,0,2,0,,,,,,,,,,
20150531-M-Roland_Garros-R16-Roger_Federer-Gael_Monfils,1,S-XC,17,1,0,0,1,11,6,,,,,,,,,,
20150531-M-Roland_Garros-R16-Roger_Federer-Gael_Monfils,1,S-DTM,15,1,0,0,1,8,7,,,,,,,,,,
20150531-M-Roland_Garros-R16-Roger_Federer-Gael_Monfils,1,S-DTL,7,1,0,1,0,4,3,,,,,,,,,,
20150531-M-Roland_Garros-R16-Roger_Federer-Gael_Monfils,2,F-XC,64,19,5,4,10,37,27,,,,,,,,,,
20150531-M-Roland_Garros-R16-Roger_Federer-Gael_Monfils,2,F-DTM,35,1,0,0,1,18,17,,,,,,,,,,
20150531-M-Roland_Garros-R16-Roger_Federer-Gael_Monfils,2,F-DTL,13,2,2,0,0,5,8,,,,,,,,,,
20150531-M-Roland_Garros-R16-Roger_Federer-Gael_Monfils,2,F-IO,38,5,3,0,2,18,20,,,,,,,,,,
20150531-M-Roland_Garros-R16-Roger_Federer-Gael_Monfils,2,F-II,6,3,1,0,2,3,3,,,,,,,,,,
20150531-M-Roland_Garros-R16-Roger_Federer-Gael_Monfils,2,B-XC,87,7,1,3,3,48,39,,,,,,,,,,
20150531-M-Roland_Garros-R16-Roger_Federer-Gael_Monfils,2,B-DTM,51,1,0,1,0,24,27,,,,,,,,,,
20150531-M-Roland_Garros-R16-Roger_Federer-Gael_Monfils,2,B-DTL,7,4,1,0,3,3,4,,,,,,,,,,
20150531-M-Roland_Garros-R16-Roger_Federer-Gael_Monfils,2,B-IO,8,5,2,0,3,3,5,,,,,,,,,,
20150531-M-Roland_Garros-R16-Roger_Federer-Gael_Monfils,2,B-II,1,0,0,0,0,0,1,,,,,,,,,,
20150531-M-Roland_Garros-R16-Roger_Federer-Gael_Monfils,2,S-XC,5,0,0,0,0,1,4,,,,,,,,,,
20150531-M-Roland_Garros-R16-Roger_Federer-Gael_Monfils,2,S-DTM,2,0,0,0,0,0,2,,,,,,,,,,
20150531-M-Roland_Garros-R16-Roger_Federer-Gael_Monfils,2,S-DTL,3,0,0,0,0,0,3,,,,,,,,,,
20150531-M-Roland_Garros-R16-Roger_Federer-Gael_Monfils,2,S-IO,1,1,1,0,0,1,0,,,,,,,,,,
20150603-M-Roland_Garros-QF-Novak_Djokovic-Rafael_Nadal,1,F-XC,87,17,8,4,5,56,31,,,,,,,,,,
20150603-M-Roland_Garros-QF-Novak_Djokovic-Rafael_Nadal,1,F-DTM,17,0,0,0,0,8,9,,,,,,,,,,
20150603-M-Roland_Garros-QF-Novak_Djokovic-Rafael_Nadal,1,F-DTL,22,7,4,1,2,11,11,,,,,,,,,,
20150603-M-Roland_Garros-QF-Novak_Djokovic-Rafael_Nadal,1,F-IO,44,12,5,4,3,30,14,,,,,,,,,,
20150603-M-Roland_Garros-QF-Novak_Djokovic-Rafael_Nadal,1,F-II,3,1,0,0,1,0,3,,,,,,,,,,
20150603-M-Roland_Garros-QF-Novak_Djokovic-Rafael_Nadal,1,B-XC,57,10,2,2,6,30,27,,,,,,,,,,
20150603-M-Roland_Garros-QF-Novak_Djokovic-Rafael_Nadal,1,B-DTM,27,1,0,1,0,14,13,,,,,,,,,,
20150603-M-Roland_Garros-QF-Novak_Djokovic-Rafael_Nadal,1,B-DTL,39,15,4,1,10,21,18,,,,,,,,,,
20150603-M-Roland_Garros-QF-Novak_Djokovic-Rafael_Nadal,1,B-IO,8,1,0,0,1,5,3,,,,,,,,,,
20150603-M-Roland_Garros-QF-Novak_Djokovic-Rafael_Nadal,1,B-II,1,1,0,0,1,0,1,,,,,,,,,,
20150603-M-Roland_Garros-QF-Novak_Djokovic-Rafael_Nadal,1,S-XC,1,1,0,0,1,0,1,,,,,,,,,,
20150603-M-Roland_Garros-QF-Novak_Djokovic-Rafael_Nadal,1,S-DTL,2,0,0,0,0,1,1,,,,,,,,,,
20150603-M-Roland_Garros-QF-Novak_Djokovic-Rafael_Nadal,2,F-XC,77,6,3,2,1,39,38,,,,,,,,,,
20150603-M-Roland_Garros-QF-Novak_Djokovic-Rafael_Nadal,2,F-DTM,35,0,0,0,0,11,24,,,,,,,,,,
20150603-M-Roland_Garros-QF-Novak_Djokovic-Rafael_Nadal,2,F-DTL,25,6,0,2,4,14,11,,,,,,,,,,
20150603-M-Roland_Garros-QF-Novak_Djokovic-Rafael_Nadal,2,F-IO,35,7,0,0,7,14,21,,,,,,,,,,
20150603-M-Roland_Garros-QF-Novak_Djokovic-Rafael_Nadal,2,F-II,2,1,0,0,1,1,1,,,,,,,,,,
20150603-M-Roland_Garros-QF-Novak_Djokovic-Rafael_Nadal,2,B-XC,44,6,1,0,5,10,34,,,,,,,,,,
20150603-M-Roland_Garros-QF-Novak_Djokovic-Rafael_Nadal,2,B-DTM,26,0,0,0,0,14,12,,,,,,,,,,
20150603-M-Roland_Garros-QF-Novak_Djokovic-Rafael_Nadal,2,B-DTL,29,5,2,0,3,13,16,,,,,,,,,,
20150603-M-Roland_Garros-QF-Novak_Djokovic-Rafael_Nadal,2,B-IO,6,0,0,0,0,3,3,,,,,,,,,,
20150603-M-Roland_Garros-QF-Novak_Djokovic-Rafael_Nadal,2,B-II,1,0,0,0,0,0,1,,,,,,,,,,
20150603-M-Roland_Garros-QF-Novak_Djokovic-Rafael_Nadal,2,S-XC,3,0,0,0,0,1,2,,,,,,,,,,
20150603-M-Roland_Garros-QF-Novak_Djokovic-Rafael_Nadal,2,S-DTM,7,0,0,0,0,2,5,,,,,,,,,,
20150603-M-Roland_Garros-QF-Novak_Djokovic-Rafael_Nadal,2,S-DTL,4,0,0,0,0,1,3,,,,,,,,,,
20150603-M-Roland_Garros-QF-Novak_Djokovic-Rafael_Nadal,2,S-IO,1,0,0,0,0,0,1,,,,,,,,,,
20150607-M-Roland_Garros-F-Stanislas_Wawrinka-Novak_Djokovic,1,F-XC,109,22,9,5,8,61,48,,,,,,,,,,
20150607-M-Roland_Garros-F-Stanislas_Wawrinka-Novak_Djokovic,1,F-DTM,52,2,0,1,1,28,24,,,,,,,,,,
20150607-M-Roland_Garros-F-Stanislas_Wawrinka-Novak_Djokovic,1,F-DTL,32,12,5,1,6,16,16,,,,,,,,,,
20150607-M-Roland_Garros-F-Stanislas_Wawrinka-Novak_Djokovic,1,F-IO,43,15,9,1,5,29,14,,,,,,,,,,
20150607-M-Roland_Garros-F-Stanislas_Wawrinka-Novak_Djokovic,1,F-II,2,1,0,0,1,0,2,,,,,,,,,,
20150607-M-Roland_Garros-F-Stanislas_Wawrinka-Novak_Djokovic,1,B-XC,98,10,2,1,7,61,37,,,,,,,,,,
20150607-M-Roland_Garros-F-Stanislas_Wawrinka-Novak_Djokovic,1,B-DTM,52,4,0,0,4,29,23,,,,,,,,,,
20150607-M-Roland_Garros-F-Stanislas_Wawrinka-Novak_Djokovic,1,B-DTL,31,16,7,3,6,18,13,,,,,,,,,,
20150607-M-Roland_Garros-F-Stanislas_Wawrinka-Novak_Djokovic,1,B-IO,8,2,0,1,1,5,3,,,,,,,,,,
20150607-M-Roland_Garros-F-Stanislas_Wawrinka-Novak_Djokovic,1,S-XC,26,1,0,0,1,17,9,,,,,,,,,,
20150607-M-Roland_Garros-F-Stanislas_Wawrinka-Novak_Djokovic,1,S-DTM,11,2,0,0,2,5,6,,,,,,,,,,
20150607-M-Roland_Garros-F-Stanislas_Wawrinka-Novak_Djokovic,1,S-DTL,4,2,0,1,1,1,3,,,,,,,,,,
20150607-M-Roland_Garros-F-Stanislas_Wawrinka-Novak_Djokovic,1,S-IO,2,0,0,0,0,2,0,,,,,,,,,,
20150607-M-Roland_Garros-F-Stanislas_Wawrinka-Novak_Djokovic,2,F-XC,109,14,1,7,6,54,55,,,,,,,,,,
20150607-M-Roland_Garros-F-Stanislas_Wawrinka-Novak_Djokovic,2,F-DTM,61,2,0,1,1,26,35,,,,,,,,,,
20150607-M-Roland_Garros-F-Stanislas_Wawrinka-Novak_Djokovic,2,F-DTL,20,7,1,0,6,6,14,,,,,,,,,,
20150607-M-Roland_Garros-F-Stanislas_Wawrinka-Novak_Djokovic,2,F-IO,52,8,1,2,5,22,30,,,,,,,,,,
20150607-M-Roland_Garros-F-Stanislas_Wawrinka-Novak_Djokovic,2,F-II,9,2,1,0,1,4,5,,,,,,,,,,
20150607-M-Roland_Garros-F-Stanislas_Wawrinka-Novak_Djokovic,2,B-XC,111,11,1,4,6,50,61,,,,,,,,,,
20150607-M-Roland_Garros-F-Stanislas_Wawrinka-Novak_Djokovic,2,B-DTM,58,7,1,0,6,18,40,,,,,,,,,,
20150607-M-Roland_Garros-F-Stanislas_Wawrinka-Novak_Djokovic,2,B-DTL,17,6,3,0,3,9,8,,,,,,,,,,
20150607-M-Roland_Garros-F-Stanislas_Wawrinka-Novak_Djokovic,2,B-IO,6,1,1,0,0,3,3,,,,,,,,,,
20150607-M-Roland_Garros-F-Stanislas_Wawrinka-Novak_Djokovic,2,S-XC,8,0,0,0,0,2,6,,,,,,,,,,
20150607-M-Roland_Garros-F-Stanislas_Wawrinka-Novak_Djokovic,2,S-DTM,3,0,0,0,0,0,3,,,,,,,,,,
20150607-M-Roland_Garros-F-Stanislas_Wawrinka-Novak_Djokovic,2,S-DTL,2,0,0,0,0,1,1,,,,,,,,,,
20150608-M-Stuttgart-Q3-Dustin_Brown-Michael_Berrer,1,F-XC,10,4,2,0,2,4,6,,,,,,,,,,
20150608-M-Stuttgart-Q3-Dustin_Brown-Michael_Berrer,1,F-DTM,8,3,0,1,2,2,6,,,,,,,,,,
20150608-M-Stuttgart-Q3-Dustin_Brown-Michael_Berrer,1,F-DTL,1,0,0,0,0,0,1,,,,,,,,,,
20150608-M-Stuttgart-Q3-Dustin_Brown-Michael_Berrer,1,F-IO,1,0,0,0,0,1,0,,,,,,,,,,
20150608-M-Stuttgart-Q3-Dustin_Brown-Michael_Berrer,1,B-XC,4,2,0,0,2,2,2,,,,,,,,,,
20150608-M-Stuttgart-Q3-Dustin_Brown-Michael_Berrer,1,B-DTM,13,1,0,0,1,2,11,,,,,,,,,,
20150608-M-Stuttgart-Q3-Dustin_Brown-Michael_Berrer,1,B-DTL,8,3,1,0,2,1,7,,,,,,,,,,
20150608-M-Stuttgart-Q3-Dustin_Brown-Michael_Berrer,1,B-IO,3,1,1,0,0,2,1,,,,,,,,,,
20150608-M-Stuttgart-Q3-Dustin_Brown-Michael_Berrer,1,S-XC,1,1,0,0,1,0,1,,,,,,,,,,
20150608-M-Stuttgart-Q3-Dustin_Brown-Michael_Berrer,1,S-DTM,4,0,0,0,0,1,3,,,,,,,,,,
20150608-M-Stuttgart-Q3-Dustin_Brown-Michael_Berrer,1,S-DTL,1,0,0,0,0,0,1,,,,,,,,,,
20150608-M-Stuttgart-Q3-Dustin_Brown-Michael_Berrer,2,F-XC,26,7,6,0,1,20,6,,,,,,,,,,
20150608-M-Stuttgart-Q3-Dustin_Brown-Michael_Berrer,2,F-DTM,6,1,0,0,1,3,3,,,,,,,,,,
20150608-M-Stuttgart-Q3-Dustin_Brown-Michael_Berrer,2,F-DTL,2,0,0,0,0,0,2,,,,,,,,,,
20150608-M-Stuttgart-Q3-Dustin_Brown-Michael_Berrer,2,F-IO,5,1,0,0,1,2,3,,,,,,,,,,
20150608-M-Stuttgart-Q3-Dustin_Brown-Michael_Berrer,2,F-II,1,0,0,0,0,1,0,,,,,,,,,,
20150608-M-Stuttgart-Q3-Dustin_Brown-Michael_Berrer,2,B-XC,3,1,1,0,0,3,0,,,,,,,,,,
20150608-M-Stuttgart-Q3-Dustin_Brown-Michael_Berrer,2,B-DTM,9,0,0,0,0,4,5,,,,,,,,,,
20150608-M-Stuttgart-Q3-Dustin_Brown-Michael_Berrer,2,B-DTL,3,0,0,0,0,2,1,,,,,,,,,,
20150608-M-Stuttgart-Q3-Dustin_Brown-Michael_Berrer,2,B-IO,3,2,0,1,1,2,1,,,,,,,,,,
20150608-M-Stuttgart-Q3-Dustin_Brown-Michael_Berrer,2,S-XC,4,1,1,0,0,1,3,,,,,,,,,,
20150608-M-Stuttgart-Q3-Dustin_Brown-Michael_Berrer,2,S-DTM,7,0,0,0,0,5,2,,,,,,,,,,
20150608-M-Stuttgart-Q3-Dustin_Brown-Michael_Berrer,2,S-DTL,3,0,0,0,0,3,0,,,,,,,,,,
20150608-M-Stuttgart-Q3-Dustin_Brown-Michael_Berrer,2,S-IO,3,0,0,0,0,2,1,,,,,,,,,,
20150608-M-Stuttgart-R16-Andreas_Haider_Maurer-Gael_Monfils,1,F-XC,11,6,2,2,2,9,2,,,,,,,,,,
20150608-M-Stuttgart-R16-Andreas_Haider_Maurer-Gael_Monfils,1,F-DTM,8,2,1,0,1,7,1,,,,,,,,,,
20150608-M-Stuttgart-R16-Andreas_Haider_Maurer-Gael_Monfils,1,F-DTL,7,0,0,0,0,4,3,,,,,,,,,,
20150608-M-Stuttgart-R16-Andreas_Haider_Maurer-Gael_Monfils,1,F-IO,24,12,7,3,2,19,5,,,,,,,,,,
20150608-M-Stuttgart-R16-Andreas_Haider_Maurer-Gael_Monfils,1,B-XC,19,4,0,4,0,14,5,,,,,,,,,,
20150608-M-Stuttgart-R16-Andreas_Haider_Maurer-Gael_Monfils,1,B-DTM,18,2,0,1,1,10,8,,,,,,,,,,
20150608-M-Stuttgart-R16-Andreas_Haider_Maurer-Gael_Monfils,1,B-DTL,7,2,0,1,1,3,4,,,,,,,,,,
20150608-M-Stuttgart-R16-Andreas_Haider_Maurer-Gael_Monfils,1,B-IO,2,2,1,1,0,2,0,,,,,,,,,,
20150608-M-Stuttgart-R16-Andreas_Haider_Maurer-Gael_Monfils,1,S-XC,10,0,0,0,0,8,2,,,,,,,,,,
20150608-M-Stuttgart-R16-Andreas_Haider_Maurer-Gael_Monfils,1,S-DTM,5,0,0,0,0,5,0,,,,,,,,,,
20150608-M-Stuttgart-R16-Andreas_Haider_Maurer-Gael_Monfils,1,S-DTL,2,0,0,0,0,1,1,,,,,,,,,,
20150608-M-Stuttgart-R16-Andreas_Haider_Maurer-Gael_Monfils,2,F-XC,17,6,3,2,1,9,8,,,,,,,,,,
20150608-M-Stuttgart-R16-Andreas_Haider_Maurer-Gael_Monfils,2,F-DTM,6,1,0,0,1,2,4,,,,,,,,,,
20150608-M-Stuttgart-R16-Andreas_Haider_Maurer-Gael_Monfils,2,F-DTL,4,1,0,1,0,2,2,,,,,,,,,,
20150608-M-Stuttgart-R16-Andreas_Haider_Maurer-Gael_Monfils,2,F-IO,13,5,0,0,5,3,10,,,,,,,,,,
20150608-M-Stuttgart-R16-Andreas_Haider_Maurer-Gael_Monfils,2,F-II,3,1,1,0,0,2,1,,,,,,,,,,
20150608-M-Stuttgart-R16-Andreas_Haider_Maurer-Gael_Monfils,2,B-XC,21,4,0,2,2,8,13,,,,,,,,,,
20150608-M-Stuttgart-R16-Andreas_Haider_Maurer-Gael_Monfils,2,B-DTM,6,0,0,0,0,3,3,,,,,,,,,,
20150608-M-Stuttgart-R16-Andreas_Haider_Maurer-Gael_Monfils,2,B-DTL,11,2,1,1,0,5,6,,,,,,,,,,
20150608-M-Stuttgart-R16-Andreas_Haider_Maurer-Gael_Monfils,2,S-XC,13,1,0,1,0,1,12,,,,,,,,,,
20150608-M-Stuttgart-R16-Andreas_Haider_Maurer-Gael_Monfils,2,S-DTM,2,0,0,0,0,1,1,,,,,,,,,,
20150608-M-Stuttgart-R16-Andreas_Haider_Maurer-Gael_Monfils,2,S-DTL,3,1,1,0,0,2,1,,,,,,,,,,
20150609-M-Stuttgart-R32-Jan_Lennard_Struff-Bernard_Tomic,1,F-XC,23,9,1,4,4,10,13,,,,,,,,,,
20150609-M-Stuttgart-R32-Jan_Lennard_Struff-Bernard_Tomic,1,F-DTM,15,1,0,1,0,7,8,,,,,,,,,,
20150609-M-Stuttgart-R32-Jan_Lennard_Struff-Bernard_Tomic,1,F-DTL,3,2,0,0,2,0,3,,,,,,,,,,
20150609-M-Stuttgart-R32-Jan_Lennard_Struff-Bernard_Tomic,1,F-IO,20,7,2,1,4,9,11,,,,,,,,,,
20150609-M-Stuttgart-R32-Jan_Lennard_Struff-Bernard_Tomic,1,F-II,1,1,0,0,1,0,1,,,,,,,,,,
20150609-M-Stuttgart-R32-Jan_Lennard_Struff-Bernard_Tomic,1,B-XC,32,6,1,0,5,16,16,,,,,,,,,,
20150609-M-Stuttgart-R32-Jan_Lennard_Struff-Bernard_Tomic,1,B-DTM,18,1,0,0,1,4,14,,,,,,,,,,
20150609-M-Stuttgart-R32-Jan_Lennard_Struff-Bernard_Tomic,1,B-DTL,6,4,0,2,2,3,3,,,,,,,,,,
20150609-M-Stuttgart-R32-Jan_Lennard_Struff-Bernard_Tomic,1,B-IO,2,2,0,1,1,1,1,,,,,,,,,,
20150609-M-Stuttgart-R32-Jan_Lennard_Struff-Bernard_Tomic,1,S-XC,3,1,0,1,0,2,1,,,,,,,,,,
20150609-M-Stuttgart-R32-Jan_Lennard_Struff-Bernard_Tomic,1,S-DTM,1,0,0,0,0,0,1,,,,,,,,,,
20150609-M-Stuttgart-R32-Jan_Lennard_Struff-Bernard_Tomic,2,F-XC,16,7,1,3,3,11,5,,,,,,,,,,
20150609-M-Stuttgart-R32-Jan_Lennard_Struff-Bernard_Tomic,2,F-DTM,4,0,0,0,0,2,2,,,,,,,,,,
20150609-M-Stuttgart-R32-Jan_Lennard_Struff-Bernard_Tomic,2,F-DTL,15,6,4,1,1,11,4,,,,,,,,,,
20150609-M-Stuttgart-R32-Jan_Lennard_Struff-Bernard_Tomic,2,F-IO,12,2,1,1,0,6,6,,,,,,,,,,
20150609-M-Stuttgart-R32-Jan_Lennard_Struff-Bernard_Tomic,2,B-XC,22,4,2,2,0,16,6,,,,,,,,,,
20150609-M-Stuttgart-R32-Jan_Lennard_Struff-Bernard_Tomic,2,B-DTM,10,0,0,0,0,6,4,,,,,,,,,,
20150609-M-Stuttgart-R32-Jan_Lennard_Struff-Bernard_Tomic,2,B-DTL,9,4,1,0,3,3,6,,,,,,,,,,
20150609-M-Stuttgart-R32-Jan_Lennard_Struff-Bernard_Tomic,2,B-IO,6,2,0,0,2,1,5,,,,,,,,,,
20150609-M-Stuttgart-R32-Jan_Lennard_Struff-Bernard_Tomic,2,S-XC,9,4,0,3,1,6,3,,,,,,,,,,
20150609-M-Stuttgart-R32-Jan_Lennard_Struff-Bernard_Tomic,2,S-DTM,12,0,0,0,0,4,8,,,,,,,,,,
20150609-M-Stuttgart-R32-Jan_Lennard_Struff-Bernard_Tomic,2,S-DTL,1,0,0,0,0,1,0,,,,,,,,,,
20150609-M-Stuttgart-R32-Jan_Lennard_Struff-Bernard_Tomic,2,S-IO,1,1,0,1,0,1,0,,,,,,,,,,
20150610-M-Stuttgart-R16-Feliciano_Lopez-Samuel_Groth,1,F-XC,11,5,2,2,1,8,3,,,,,,,,,,
20150610-M-Stuttgart-R16-Feliciano_Lopez-Samuel_Groth,1,F-DTM,7,2,0,0,2,5,2,,,,,,,,,,
20150610-M-Stuttgart-R16-Feliciano_Lopez-Samuel_Groth,1,F-DTL,4,2,1,0,1,1,3,,,,,,,,,,
20150610-M-Stuttgart-R16-Feliciano_Lopez-Samuel_Groth,1,F-IO,3,1,1,0,0,2,1,,,,,,,,,,
20150610-M-Stuttgart-R16-Feliciano_Lopez-Samuel_Groth,1,B-XC,3,1,1,0,0,1,2,,,,,,,,,,
20150610-M-Stuttgart-R16-Feliciano_Lopez-Samuel_Groth,1,B-DTM,3,0,0,0,0,2,1,,,,,,,,,,
20150610-M-Stuttgart-R16-Feliciano_Lopez-Samuel_Groth,1,B-DTL,1,1,1,0,0,1,0,,,,,,,,,,
20150610-M-Stuttgart-R16-Feliciano_Lopez-Samuel_Groth,1,B-IO,3,2,0,1,1,1,2,,,,,,,,,,
20150610-M-Stuttgart-R16-Feliciano_Lopez-Samuel_Groth,1,S-XC,3,1,1,0,0,2,1,,,,,,,,,,
20150610-M-Stuttgart-R16-Feliciano_Lopez-Samuel_Groth,1,S-DTM,5,0,0,0,0,3,2,,,,,,,,,,
20150610-M-Stuttgart-R16-Feliciano_Lopez-Samuel_Groth,1,S-DTL,4,1,0,1,0,2,2,,,,,,,,,,
20150610-M-Stuttgart-R16-Feliciano_Lopez-Samuel_Groth,1,S-IO,7,3,0,3,0,5,2,,,,,,,,,,
20150610-M-Stuttgart-R16-Feliciano_Lopez-Samuel_Groth,2,F-XC,6,4,0,1,3,3,3,,,,,,,,,,
20150610-M-Stuttgart-R16-Feliciano_Lopez-Samuel_Groth,2,F-DTM,2,0,0,0,0,1,1,,,,,,,,,,
20150610-M-Stuttgart-R16-Feliciano_Lopez-Samuel_Groth,2,F-IO,3,2,0,0,2,0,3,,,,,,,,,,
20150610-M-Stuttgart-R16-Feliciano_Lopez-Samuel_Groth,2,B-XC,5,3,2,0,1,3,2,,,,,,,,,,
20150610-M-Stuttgart-R16-Feliciano_Lopez-Samuel_Groth,2,B-DTM,4,2,0,1,1,1,3,,,,,,,,,,
20150610-M-Stuttgart-R16-Feliciano_Lopez-Samuel_Groth,2,S-XC,2,0,0,0,0,1,1,,,,,,,,,,
20150610-M-Stuttgart-R16-Feliciano_Lopez-Samuel_Groth,2,S-DTM,6,3,0,2,1,3,3,,,,,,,,,,
20150610-M-Stuttgart-R16-Feliciano_Lopez-Samuel_Groth,2,S-DTL,2,0,0,0,0,0,2,,,,,,,,,,
20150610-M-Stuttgart-R16-Feliciano_Lopez-Samuel_Groth,2,S-IO,3,2,0,1,1,1,2,,,,,,,,,,
20150611-M-Stuttgart-R16-Bernard_Tomic-Tommy_Haas,1,F-XC,18,7,1,2,4,9,9,,,,,,,,,,
20150611-M-Stuttgart-R16-Bernard_Tomic-Tommy_Haas,1,F-DTM,5,0,0,0,0,3,2,,,,,,,,,,
20150611-M-Stuttgart-R16-Bernard_Tomic-Tommy_Haas,1,F-DTL,15,7,4,1,2,11,4,,,,,,,,,,
20150611-M-Stuttgart-R16-Bernard_Tomic-Tommy_Haas,1,F-IO,21,6,1,1,4,11,10,,,,,,,,,,
20150611-M-Stuttgart-R16-Bernard_Tomic-Tommy_Haas,1,B-XC,19,5,2,3,0,12,7,,,,,,,,,,
20150611-M-Stuttgart-R16-Bernard_Tomic-Tommy_Haas,1,B-DTM,3,0,0,0,0,2,1,,,,,,,,,,
20150611-M-Stuttgart-R16-Bernard_Tomic-Tommy_Haas,1,B-DTL,7,4,2,2,0,5,2,,,,,,,,,,
20150611-M-Stuttgart-R16-Bernard_Tomic-Tommy_Haas,1,B-IO,2,1,0,0,1,0,2,,,,,,,,,,
20150611-M-Stuttgart-R16-Bernard_Tomic-Tommy_Haas,1,S-XC,19,1,0,0,1,11,8,,,,,,,,,,
20150611-M-Stuttgart-R16-Bernard_Tomic-Tommy_Haas,1,S-DTM,2,0,0,0,0,0,2,,,,,,,,,,
20150611-M-Stuttgart-R16-Bernard_Tomic-Tommy_Haas,1,S-DTL,4,0,0,0,0,4,0,,,,,,,,,,
20150611-M-Stuttgart-R16-Bernard_Tomic-Tommy_Haas,1,S-IO,2,0,0,0,0,1,1,,,,,,,,,,
20150611-M-Stuttgart-R16-Bernard_Tomic-Tommy_Haas,2,F-XC,19,7,3,0,4,6,13,,,,,,,,,,
20150611-M-Stuttgart-R16-Bernard_Tomic-Tommy_Haas,2,F-DTM,10,1,0,0,1,5,5,,,,,,,,,,
20150611-M-Stuttgart-R16-Bernard_Tomic-Tommy_Haas,2,F-DTL,3,1,0,0,1,1,2,,,,,,,,,,
20150611-M-Stuttgart-R16-Bernard_Tomic-Tommy_Haas,2,F-IO,14,5,0,2,3,8,6,,,,,,,,,,
20150611-M-Stuttgart-R16-Bernard_Tomic-Tommy_Haas,2,F-II,4,2,1,0,1,2,2,,,,,,,,,,
20150611-M-Stuttgart-R16-Bernard_Tomic-Tommy_Haas,2,B-XC,15,2,1,0,1,5,10,,,,,,,,,,
20150611-M-Stuttgart-R16-Bernard_Tomic-Tommy_Haas,2,B-DTM,16,0,0,0,0,11,5,,,,,,,,,,
20150611-M-Stuttgart-R16-Bernard_Tomic-Tommy_Haas,2,B-DTL,5,3,1,0,2,1,4,,,,,,,,,,
20150611-M-Stuttgart-R16-Bernard_Tomic-Tommy_Haas,2,B-IO,1,0,0,0,0,1,0,,,,,,,,,,
20150611-M-Stuttgart-R16-Bernard_Tomic-Tommy_Haas,2,S-XC,13,0,0,0,0,3,10,,,,,,,,,,
20150611-M-Stuttgart-R16-Bernard_Tomic-Tommy_Haas,2,S-DTM,2,0,0,0,0,1,1,,,,,,,,,,
20150611-M-Stuttgart-R16-Bernard_Tomic-Tommy_Haas,2,S-DTL,2,1,0,0,1,0,2,,,,,,,,,,
20150611-M-Stuttgart-R16-Bernard_Tomic-Tommy_Haas,2,S-IO,1,0,0,0,0,0,1,,,,,,,,,,
20150611-M-s_Hertogenbosch-R16-Jurgen_Melzer-David_Goffin,1,F-XC,33,7,1,1,5,11,22,,,,,,,,,,
20150611-M-s_Hertogenbosch-R16-Jurgen_Melzer-David_Goffin,1,F-DTM,20,2,0,0,2,9,11,,,,,,,,,,
20150611-M-s_Hertogenbosch-R16-Jurgen_Melzer-David_Goffin,1,F-DTL,7,4,0,1,3,2,5,,,,,,,,,,
20150611-M-s_Hertogenbosch-R16-Jurgen_Melzer-David_Goffin,1,F-IO,7,3,0,0,3,2,5,,,,,,,,,,
20150611-M-s_Hertogenbosch-R16-Jurgen_Melzer-David_Goffin,1,B-XC,18,5,1,2,2,9,9,,,,,,,,,,
20150611-M-s_Hertogenbosch-R16-Jurgen_Melzer-David_Goffin,1,B-DTM,19,4,1,0,3,8,11,,,,,,,,,,
20150611-M-s_Hertogenbosch-R16-Jurgen_Melzer-David_Goffin,1,B-DTL,9,6,1,1,4,2,7,,,,,,,,,,
20150611-M-s_Hertogenbosch-R16-Jurgen_Melzer-David_Goffin,1,B-IO,5,2,0,0,2,1,4,,,,,,,,,,
20150611-M-s_Hertogenbosch-R16-Jurgen_Melzer-David_Goffin,1,S-XC,10,3,0,1,2,6,4,,,,,,,,,,
20150611-M-s_Hertogenbosch-R16-Jurgen_Melzer-David_Goffin,1,S-DTM,5,0,0,0,0,0,5,,,,,,,,,,
20150611-M-s_Hertogenbosch-R16-Jurgen_Melzer-David_Goffin,1,S-DTL,1,1,0,0,1,0,1,,,,,,,,,,
20150611-M-s_Hertogenbosch-R16-Jurgen_Melzer-David_Goffin,1,S-IO,2,0,0,0,0,2,0,,,,,,,,,,
20150611-M-s_Hertogenbosch-R16-Jurgen_Melzer-David_Goffin,2,F-XC,32,6,3,0,3,20,12,,,,,,,,,,
20150611-M-s_Hertogenbosch-R16-Jurgen_Melzer-David_Goffin,2,F-DTM,23,2,0,0,2,9,14,,,,,,,,,,
20150611-M-s_Hertogenbosch-R16-Jurgen_Melzer-David_Goffin,2,F-DTL,16,7,2,1,4,10,6,,,,,,,,,,
20150611-M-s_Hertogenbosch-R16-Jurgen_Melzer-David_Goffin,2,F-IO,18,3,0,1,2,11,7,,,,,,,,,,
20150611-M-s_Hertogenbosch-R16-Jurgen_Melzer-David_Goffin,2,F-II,4,1,0,0,1,3,1,,,,,,,,,,
20150611-M-s_Hertogenbosch-R16-Jurgen_Melzer-David_Goffin,2,B-XC,15,5,1,0,4,9,6,,,,,,,,,,
20150611-M-s_Hertogenbosch-R16-Jurgen_Melzer-David_Goffin,2,B-DTM,11,1,0,0,1,8,3,,,,,,,,,,
20150611-M-s_Hertogenbosch-R16-Jurgen_Melzer-David_Goffin,2,B-DTL,12,3,1,1,1,7,5,,,,,,,,,,
20150611-M-s_Hertogenbosch-R16-Jurgen_Melzer-David_Goffin,2,B-IO,5,2,1,0,1,2,3,,,,,,,,,,
20150611-M-s_Hertogenbosch-R16-Jurgen_Melzer-David_Goffin,2,S-DTM,1,0,0,0,0,1,0,,,,,,,,,,
20150611-M-s_Hertogenbosch-R16-Jurgen_Melzer-David_Goffin,2,S-DTL,1,0,0,0,0,0,1,,,,,,,,,,
20150611-M-s_Hertogenbosch-R16-Jurgen_Melzer-David_Goffin,2,S-IO,1,0,0,0,0,1,0,,,,,,,,,,
20150611-M-s_Hertogenbosch-R16-Roberto_Bautista_Agut-Nicolas_Mahut,1,F-XC,25,10,2,2,6,9,16,,,,,,,,,,
20150611-M-s_Hertogenbosch-R16-Roberto_Bautista_Agut-Nicolas_Mahut,1,F-DTM,13,2,0,0,2,7,6,,,,,,,,,,
20150611-M-s_Hertogenbosch-R16-Roberto_Bautista_Agut-Nicolas_Mahut,1,F-DTL,9,5,2,1,2,4,5,,,,,,,,,,
20150611-M-s_Hertogenbosch-R16-Roberto_Bautista_Agut-Nicolas_Mahut,1,F-IO,25,7,3,2,2,13,12,,,,,,,,,,
20150611-M-s_Hertogenbosch-R16-Roberto_Bautista_Agut-Nicolas_Mahut,1,F-II,4,2,0,1,1,2,2,,,,,,,,,,
20150611-M-s_Hertogenbosch-R16-Roberto_Bautista_Agut-Nicolas_Mahut,1,B-XC,10,1,0,0,1,4,6,,,,,,,,,,
20150611-M-s_Hertogenbosch-R16-Roberto_Bautista_Agut-Nicolas_Mahut,1,B-DTM,14,2,0,0,2,3,11,,,,,,,,,,
20150611-M-s_Hertogenbosch-R16-Roberto_Bautista_Agut-Nicolas_Mahut,1,B-DTL,5,2,2,0,0,2,3,,,,,,,,,,
20150611-M-s_Hertogenbosch-R16-Roberto_Bautista_Agut-Nicolas_Mahut,1,S-XC,4,1,0,1,0,3,1,,,,,,,,,,
20150611-M-s_Hertogenbosch-R16-Roberto_Bautista_Agut-Nicolas_Mahut,1,S-DTM,3,0,0,0,0,2,1,,,,,,,,,,
20150611-M-s_Hertogenbosch-R16-Roberto_Bautista_Agut-Nicolas_Mahut,2,F-XC,16,5,3,1,1,11,5,,,,,,,,,,
20150611-M-s_Hertogenbosch-R16-Roberto_Bautista_Agut-Nicolas_Mahut,2,F-DTM,11,2,0,0,2,5,6,,,,,,,,,,
20150611-M-s_Hertogenbosch-R16-Roberto_Bautista_Agut-Nicolas_Mahut,2,F-DTL,7,2,0,0,2,4,3,,,,,,,,,,
20150611-M-s_Hertogenbosch-R16-Roberto_Bautista_Agut-Nicolas_Mahut,2,F-IO,18,7,0,2,5,7,11,,,,,,,,,,
20150611-M-s_Hertogenbosch-R16-Roberto_Bautista_Agut-Nicolas_Mahut,2,B-XC,6,0,0,0,0,2,4,,,,,,,,,,
20150611-M-s_Hertogenbosch-R16-Roberto_Bautista_Agut-Nicolas_Mahut,2,B-DTM,4,0,0,0,0,2,2,,,,,,,,,,
20150611-M-s_Hertogenbosch-R16-Roberto_Bautista_Agut-Nicolas_Mahut,2,B-IO,2,0,0,0,0,1,1,,,,,,,,,,
20150611-M-s_Hertogenbosch-R16-Roberto_Bautista_Agut-Nicolas_Mahut,2,S-XC,16,1,0,0,1,9,7,,,,,,,,,,
20150611-M-s_Hertogenbosch-R16-Roberto_Bautista_Agut-Nicolas_Mahut,2,S-DTM,10,1,0,0,1,7,3,,,,,,,,,,
20150611-M-s_Hertogenbosch-R16-Roberto_Bautista_Agut-Nicolas_Mahut,2,S-DTL,7,1,0,1,0,5,2,,,,,,,,,,
20150611-M-s_Hertogenbosch-R16-Roberto_Bautista_Agut-Nicolas_Mahut,2,S-IO,2,1,0,0,1,1,1,,,,,,,,,,
20150613-M-s_Hertogenbosch-SF-Gilles_Muller-David_Goffin,1,F-XC,18,7,1,0,6,3,15,,,,,,,,,,
20150613-M-s_Hertogenbosch-SF-Gilles_Muller-David_Goffin,1,F-DTM,8,2,0,0,2,1,7,,,,,,,,,,
20150613-M-s_Hertogenbosch-SF-Gilles_Muller-David_Goffin,1,F-DTL,2,1,0,0,1,0,2,,,,,,,,,,
20150613-M-s_Hertogenbosch-SF-Gilles_Muller-David_Goffin,1,F-IO,8,4,1,1,2,4,4,,,,,,,,,,
20150613-M-s_Hertogenbosch-SF-Gilles_Muller-David_Goffin,1,B-XC,5,2,0,0,2,0,5,,,,,,,,,,
20150613-M-s_Hertogenbosch-SF-Gilles_Muller-David_Goffin,1,B-DTM,4,2,0,0,2,1,3,,,,,,,,,,
20150613-M-s_Hertogenbosch-SF-Gilles_Muller-David_Goffin,1,B-DTL,1,0,0,0,0,0,1,,,,,,,,,,
20150613-M-s_Hertogenbosch-SF-Gilles_Muller-David_Goffin,1,B-IO,4,0,0,0,0,1,3,,,,,,,,,,
20150613-M-s_Hertogenbosch-SF-Gilles_Muller-David_Goffin,1,S-XC,6,1,0,0,1,1,5,,,,,,,,,,
20150613-M-s_Hertogenbosch-SF-Gilles_Muller-David_Goffin,1,S-DTM,3,0,0,0,0,0,3,,,,,,,,,,
20150613-M-s_Hertogenbosch-SF-Gilles_Muller-David_Goffin,1,S-DTL,3,1,0,1,0,2,1,,,,,,,,,,
20150613-M-s_Hertogenbosch-SF-Gilles_Muller-David_Goffin,1,S-IO,1,0,0,0,0,0,1,,,,,,,,,,
20150613-M-s_Hertogenbosch-SF-Gilles_Muller-David_Goffin,2,F-XC,14,3,1,1,1,12,2,,,,,,,,,,
20150613-M-s_Hertogenbosch-SF-Gilles_Muller-David_Goffin,2,F-DTM,11,0,0,0,0,8,3,,,,,,,,,,
20150613-M-s_Hertogenbosch-SF-Gilles_Muller-David_Goffin,2,F-DTL,6,1,0,0,1,5,1,,,,,,,,,,
20150613-M-s_Hertogenbosch-SF-Gilles_Muller-David_Goffin,2,F-IO,6,2,2,0,0,6,0,,,,,,,,,,
20150613-M-s_Hertogenbosch-SF-Gilles_Muller-David_Goffin,2,B-XC,16,8,7,1,0,13,3,,,,,,,,,,
20150613-M-s_Hertogenbosch-SF-Gilles_Muller-David_Goffin,2,B-DTM,10,1,0,0,1,8,2,,,,,,,,,,
20150613-M-s_Hertogenbosch-SF-Gilles_Muller-David_Goffin,2,B-DTL,4,2,2,0,0,4,0,,,,,,,,,,
20150613-M-s_Hertogenbosch-SF-Gilles_Muller-David_Goffin,2,B-IO,4,2,1,1,0,3,1,,,,,,,,,,
20150613-M-s_Hertogenbosch-SF-Gilles_Muller-David_Goffin,2,S-DTM,1,0,0,0,0,0,1,,,,,,,,,,
20150615-M-Halle-R32-Andreas_Haider_Maurer-Dustin_Brown,1,F-XC,2,0,0,0,0,1,1,,,,,,,,,,
20150615-M-Halle-R32-Andreas_Haider_Maurer-Dustin_Brown,1,F-DTM,6,1,0,0,1,1,5,,,,,,,,,,
20150615-M-Halle-R32-Andreas_Haider_Maurer-Dustin_Brown,1,F-DTL,2,1,0,1,0,2,0,,,,,,,,,,
20150615-M-Halle-R32-Andreas_Haider_Maurer-Dustin_Brown,1,F-IO,12,3,1,0,2,5,7,,,,,,,,,,
20150615-M-Halle-R32-Andreas_Haider_Maurer-Dustin_Brown,1,B-XC,2,1,1,0,0,2,0,,,,,,,,,,
20150615-M-Halle-R32-Andreas_Haider_Maurer-Dustin_Brown,1,B-DTM,4,0,0,0,0,0,4,,,,,,,,,,
20150615-M-Halle-R32-Andreas_Haider_Maurer-Dustin_Brown,1,B-DTL,1,0,0,0,0,0,1,,,,,,,,,,
20150615-M-Halle-R32-Andreas_Haider_Maurer-Dustin_Brown,1,B-IO,1,0,0,0,0,0,1,,,,,,,,,,
20150615-M-Halle-R32-Andreas_Haider_Maurer-Dustin_Brown,1,S-XC,1,0,0,0,0,0,1,,,,,,,,,,
20150615-M-Halle-R32-Andreas_Haider_Maurer-Dustin_Brown,1,S-DTL,1,1,0,0,1,0,1,,,,,,,,,,
20150615-M-Halle-R32-Andreas_Haider_Maurer-Dustin_Brown,1,S-IO,1,0,0,0,0,0,1,,,,,,,,,,
20150615-M-Halle-R32-Andreas_Haider_Maurer-Dustin_Brown,2,F-XC,3,0,0,0,0,2,1,,,,,,,,,,
20150615-M-Halle-R32-Andreas_Haider_Maurer-Dustin_Brown,2,F-DTL,1,0,0,0,0,1,0,,,,,,,,,,
20150615-M-Halle-R32-Andreas_Haider_Maurer-Dustin_Brown,2,F-IO,1,0,0,0,0,1,0,,,,,,,,,,
20150615-M-Halle-R32-Andreas_Haider_Maurer-Dustin_Brown,2,F-II,1,0,0,0,0,0,1,,,,,,,,,,
20150615-M-Halle-R32-Andreas_Haider_Maurer-Dustin_Brown,2,B-XC,2,2,1,1,0,2,0,,,,,,,,,,
20150615-M-Halle-R32-Andreas_Haider_Maurer-Dustin_Brown,2,B-DTM,4,1,0,0,1,2,2,,,,,,,,,,
20150615-M-Halle-R32-Andreas_Haider_Maurer-Dustin_Brown,2,B-DTL,3,3,1,2,0,3,0,,,,,,,,,,
20150615-M-Halle-R32-Andreas_Haider_Maurer-Dustin_Brown,2,S-XC,4,1,0,1,0,4,0,,,,,,,,,,
20150615-M-Halle-R32-Andreas_Haider_Maurer-Dustin_Brown,2,S-DTM,3,1,0,0,1,1,2,,,,,,,,,,
20150615-M-Ilkey_CH-R32-Yuki_Bhambri-Cameron_Norrie,1,F-XC,8,3,1,1,1,5,3,,,,,,,,,,
20150615-M-Ilkey_CH-R32-Yuki_Bhambri-Cameron_Norrie,1,F-DTM,6,0,0,0,0,5,1,,,,,,,,,,
20150615-M-Ilkey_CH-R32-Yuki_Bhambri-Cameron_Norrie,1,F-DTL,2,1,1,0,0,2,0,,,,,,,,,,
20150615-M-Ilkey_CH-R32-Yuki_Bhambri-Cameron_Norrie,1,F-IO,11,5,3,1,1,8,3,,,,,,,,,,
20150615-M-Ilkey_CH-R32-Yuki_Bhambri-Cameron_Norrie,1,B-XC,2,1,1,0,0,2,0,,,,,,,,,,
20150615-M-Ilkey_CH-R32-Yuki_Bhambri-Cameron_Norrie,1,B-DTM,7,0,0,0,0,5,2,,,,,,,,,,
20150615-M-Ilkey_CH-R32-Yuki_Bhambri-Cameron_Norrie,1,S-XC,1,0,0,0,0,1,0,,,,,,,,,,
20150615-M-Ilkey_CH-R32-Yuki_Bhambri-Cameron_Norrie,2,F-XC,7,5,1,0,4,3,4,,,,,,,,,,
20150615-M-Ilkey_CH-R32-Yuki_Bhambri-Cameron_Norrie,2,F-DTM,9,1,0,0,1,1,8,,,,,,,,,,
20150615-M-Ilkey_CH-R32-Yuki_Bhambri-Cameron_Norrie,2,F-IO,8,5,1,0,4,3,5,,,,,,,,,,
20150615-M-Ilkey_CH-R32-Yuki_Bhambri-Cameron_Norrie,2,B-XC,5,2,0,2,0,2,3,,,,,,,,,,
20150615-M-Ilkey_CH-R32-Yuki_Bhambri-Cameron_Norrie,2,B-DTM,8,1,0,0,1,1,7,,,,,,,,,,
20150615-M-Ilkey_CH-R32-Yuki_Bhambri-Cameron_Norrie,2,B-IO,1,1,0,0,1,0,1,,,,,,,,,,
20150615-M-Ilkey_CH-R32-Yuki_Bhambri-Cameron_Norrie,2,S-DTL,1,0,0,0,0,1,0,,,,,,,,,,
20150615-M-Ilkley_CH-SF-Matthew_Ebden-Ivan_Dodig,1,F-XC,14,6,0,4,2,8,6,,,,,,,,,,
20150615-M-Ilkley_CH-SF-Matthew_Ebden-Ivan_Dodig,1,F-DTM,10,2,1,1,0,6,4,,,,,,,,,,
20150615-M-Ilkley_CH-SF-Matthew_Ebden-Ivan_Dodig,1,F-DTL,4,2,1,1,0,4,0,,,,,,,,,,
20150615-M-Ilkley_CH-SF-Matthew_Ebden-Ivan_Dodig,1,F-IO,12,6,1,5,0,9,3,,,,,,,,,,
20150615-M-Ilkley_CH-SF-Matthew_Ebden-Ivan_Dodig,1,F-II,2,0,0,0,0,2,0,,,,,,,,,,
20150615-M-Ilkley_CH-SF-Matthew_Ebden-Ivan_Dodig,1,B-XC,4,0,0,0,0,1,3,,,,,,,,,,
20150615-M-Ilkley_CH-SF-Matthew_Ebden-Ivan_Dodig,1,B-DTM,10,3,0,0,3,4,6,,,,,,,,,,
20150615-M-Ilkley_CH-SF-Matthew_Ebden-Ivan_Dodig,1,B-DTL,5,1,0,1,0,3,2,,,,,,,,,,
20150615-M-Ilkley_CH-SF-Matthew_Ebden-Ivan_Dodig,1,S-XC,6,1,1,0,0,5,1,,,,,,,,,,
20150615-M-Ilkley_CH-SF-Matthew_Ebden-Ivan_Dodig,1,S-DTM,8,2,0,0,2,4,4,,,,,,,,,,
20150615-M-Ilkley_CH-SF-Matthew_Ebden-Ivan_Dodig,1,S-DTL,5,2,0,2,0,4,1,,,,,,,,,,
20150615-M-Ilkley_CH-SF-Matthew_Ebden-Ivan_Dodig,2,F-XC,16,5,1,1,3,4,12,,,,,,,,,,
20150615-M-Ilkley_CH-SF-Matthew_Ebden-Ivan_Dodig,2,F-DTM,7,0,0,0,0,4,3,,,,,,,,,,
20150615-M-Ilkley_CH-SF-Matthew_Ebden-Ivan_Dodig,2,F-DTL,6,2,1,0,1,3,3,,,,,,,,,,
20150615-M-Ilkley_CH-SF-Matthew_Ebden-Ivan_Dodig,2,F-IO,12,4,0,1,3,6,6,,,,,,,,,,
20150615-M-Ilkley_CH-SF-Matthew_Ebden-Ivan_Dodig,2,F-II,1,1,0,1,0,1,0,,,,,,,,,,
20150615-M-Ilkley_CH-SF-Matthew_Ebden-Ivan_Dodig,2,B-XC,15,3,1,0,2,4,11,,,,,,,,,,
20150615-M-Ilkley_CH-SF-Matthew_Ebden-Ivan_Dodig,2,B-DTM,6,1,0,1,0,2,4,,,,,,,,,,
20150615-M-Ilkley_CH-SF-Matthew_Ebden-Ivan_Dodig,2,B-DTL,1,0,0,0,0,0,1,,,,,,,,,,
20150615-M-Ilkley_CH-SF-Matthew_Ebden-Ivan_Dodig,2,S-XC,5,0,0,0,0,2,3,,,,,,,,,,
20150615-M-Ilkley_CH-SF-Matthew_Ebden-Ivan_Dodig,2,S-DTM,4,0,0,0,0,0,4,,,,,,,,,,
20150617-M-Queens_Club-R16-Thanasi_Kokkinakis-Gilles_Simon,1,F-XC,26,8,2,1,5,11,15,,,,,,,,,,
20150617-M-Queens_Club-R16-Thanasi_Kokkinakis-Gilles_Simon,1,F-DTM,10,5,2,0,3,3,7,,,,,,,,,,
20150617-M-Queens_Club-R16-Thanasi_Kokkinakis-Gilles_Simon,1,F-DTL,10,3,1,0,2,1,9,,,,,,,,,,
20150617-M-Queens_Club-R16-Thanasi_Kokkinakis-Gilles_Simon,1,F-IO,16,3,1,0,2,3,13,,,,,,,,,,
20150617-M-Queens_Club-R16-Thanasi_Kokkinakis-Gilles_Simon,1,F-II,2,0,0,0,0,0,2,,,,,,,,,,
20150617-M-Queens_Club-R16-Thanasi_Kokkinakis-Gilles_Simon,1,B-XC,11,2,0,0,2,3,8,,,,,,,,,,
20150617-M-Queens_Club-R16-Thanasi_Kokkinakis-Gilles_Simon,1,B-DTM,12,1,1,0,0,4,8,,,,,,,,,,
20150617-M-Queens_Club-R16-Thanasi_Kokkinakis-Gilles_Simon,1,B-DTL,1,0,0,0,0,1,0,,,,,,,,,,
20150617-M-Queens_Club-R16-Thanasi_Kokkinakis-Gilles_Simon,1,B-IO,4,2,1,0,1,2,2,,,,,,,,,,
20150617-M-Queens_Club-R16-Thanasi_Kokkinakis-Gilles_Simon,1,S-XC,3,1,0,0,1,0,3,,,,,,,,,,
20150617-M-Queens_Club-R16-Thanasi_Kokkinakis-Gilles_Simon,1,S-DTM,1,1,0,0,1,0,1,,,,,,,,,,
20150617-M-Queens_Club-R16-Thanasi_Kokkinakis-Gilles_Simon,1,S-DTL,1,0,0,0,0,1,0,,,,,,,,,,
20150617-M-Queens_Club-R16-Thanasi_Kokkinakis-Gilles_Simon,2,F-XC,29,10,4,4,2,20,9,,,,,,,,,,
20150617-M-Queens_Club-R16-Thanasi_Kokkinakis-Gilles_Simon,2,F-DTM,10,1,0,0,1,6,4,,,,,,,,,,
20150617-M-Queens_Club-R16-Thanasi_Kokkinakis-Gilles_Simon,2,F-DTL,5,3,0,2,1,3,2,,,,,,,,,,
20150617-M-Queens_Club-R16-Thanasi_Kokkinakis-Gilles_Simon,2,F-IO,2,1,1,0,0,1,1,,,,,,,,,,
20150617-M-Queens_Club-R16-Thanasi_Kokkinakis-Gilles_Simon,2,F-II,1,0,0,0,0,1,0,,,,,,,,,,
20150617-M-Queens_Club-R16-Thanasi_Kokkinakis-Gilles_Simon,2,B-XC,24,7,1,4,2,20,4,,,,,,,,,,
20150617-M-Queens_Club-R16-Thanasi_Kokkinakis-Gilles_Simon,2,B-DTM,22,0,0,0,0,15,7,,,,,,,,,,
20150617-M-Queens_Club-R16-Thanasi_Kokkinakis-Gilles_Simon,2,B-DTL,7,4,2,0,2,5,2,,,,,,,,,,
20150617-M-Queens_Club-R16-Thanasi_Kokkinakis-Gilles_Simon,2,B-IO,2,0,0,0,0,2,0,,,,,,,,,,
20150618-M-Fergana_CH-R16-Ti_Chen-Laurynas_Grigelis,1,F-XC,24,5,2,1,2,9,15,,,,,,,,,,
20150618-M-Fergana_CH-R16-Ti_Chen-Laurynas_Grigelis,1,F-DTM,3,0,0,0,0,2,1,,,,,,,,,,
20150618-M-Fergana_CH-R16-Ti_Chen-Laurynas_Grigelis,1,F-DTL,4,1,1,0,0,1,3,,,,,,,,,,
20150618-M-Fergana_CH-R16-Ti_Chen-Laurynas_Grigelis,1,F-IO,17,3,2,1,0,9,8,,,,,,,,,,
20150618-M-Fergana_CH-R16-Ti_Chen-Laurynas_Grigelis,1,B-XC,19,4,1,2,1,9,10,,,,,,,,,,
20150618-M-Fergana_CH-R16-Ti_Chen-Laurynas_Grigelis,1,B-DTM,18,0,0,0,0,9,9,,,,,,,,,,
20150618-M-Fergana_CH-R16-Ti_Chen-Laurynas_Grigelis,1,B-DTL,3,1,0,1,0,2,1,,,,,,,,,,
20150618-M-Fergana_CH-R16-Ti_Chen-Laurynas_Grigelis,1,S-XC,3,0,0,0,0,0,3,,,,,,,,,,
20150618-M-Fergana_CH-R16-Ti_Chen-Laurynas_Grigelis,1,S-DTL,2,1,0,0,1,0,2,,,,,,,,,,
20150618-M-Fergana_CH-R16-Ti_Chen-Laurynas_Grigelis,2,F-XC,21,5,1,1,3,12,9,,,,,,,,,,
20150618-M-Fergana_CH-R16-Ti_Chen-Laurynas_Grigelis,2,F-DTM,8,1,0,0,1,3,5,,,,,,,,,,
20150618-M-Fergana_CH-R16-Ti_Chen-Laurynas_Grigelis,2,F-DTL,8,6,4,1,1,6,2,,,,,,,,,,
20150618-M-Fergana_CH-R16-Ti_Chen-Laurynas_Grigelis,2,F-IO,9,4,0,1,3,4,5,,,,,,,,,,
20150618-M-Fergana_CH-R16-Ti_Chen-Laurynas_Grigelis,2,B-XC,32,11,4,1,6,20,12,,,,,,,,,,
20150618-M-Fergana_CH-R16-Ti_Chen-Laurynas_Grigelis,2,B-DTM,10,1,0,0,1,4,6,,,,,,,,,,
20150618-M-Fergana_CH-R16-Ti_Chen-Laurynas_Grigelis,2,B-DTL,8,4,4,0,0,7,1,,,,,,,,,,
20150618-M-Fergana_CH-R16-Ti_Chen-Laurynas_Grigelis,2,B-IO,4,3,1,0,2,1,3,,,,,,,,,,
20150618-M-Fergana_CH-R16-Ti_Chen-Laurynas_Grigelis,2,S-XC,2,0,0,0,0,1,1,,,,,,,,,,
20150618-M-Fergana_CH-R16-Ti_Chen-Laurynas_Grigelis,2,S-DTM,1,1,0,0,1,0,1,,,,,,,,,,
20150618-M-Fergana_CH-R16-Ti_Chen-Laurynas_Grigelis,2,S-DTL,1,0,0,0,0,0,1,,,,,,,,,,
20150620-M-Halle-SF-Roger_Federer-Ivo_Karlovic,1,F-XC,8,5,3,1,1,6,2,,,,,,,,,,
20150620-M-Halle-SF-Roger_Federer-Ivo_Karlovic,1,F-DTM,9,2,1,1,0,7,2,,,,,,,,,,
20150620-M-Halle-SF-Roger_Federer-Ivo_Karlovic,1,F-DTL,3,1,0,0,1,2,1,,,,,,,,,,
20150620-M-Halle-SF-Roger_Federer-Ivo_Karlovic,1,F-IO,19,5,3,1,1,12,7,,,,,,,,,,
20150620-M-Halle-SF-Roger_Federer-Ivo_Karlovic,1,F-II,1,0,0,0,0,0,1,,,,,,,,,,
20150620-M-Halle-SF-Roger_Federer-Ivo_Karlovic,1,B-XC,3,2,1,0,1,2,1,,,,,,,,,,
20150620-M-Halle-SF-Roger_Federer-Ivo_Karlovic,1,B-DTM,6,3,1,0,2,2,4,,,,,,,,,,
20150620-M-Halle-SF-Roger_Federer-Ivo_Karlovic,1,S-XC,3,1,1,0,0,2,1,,,,,,,,,,
20150620-M-Halle-SF-Roger_Federer-Ivo_Karlovic,1,S-DTM,2,0,0,0,0,1,1,,,,,,,,,,
20150620-M-Halle-SF-Roger_Federer-Ivo_Karlovic,1,S-DTL,2,2,1,0,1,1,1,,,,,,,,,,
20150620-M-Halle-SF-Roger_Federer-Ivo_Karlovic,2,F-XC,6,3,2,1,0,4,2,,,,,,,,,,
20150620-M-Halle-SF-Roger_Federer-Ivo_Karlovic,2,F-DTL,3,3,1,1,1,2,1,,,,,,,,,,
20150620-M-Halle-SF-Roger_Federer-Ivo_Karlovic,2,F-IO,6,5,0,2,3,2,4,,,,,,,,,,
20150620-M-Halle-SF-Roger_Federer-Ivo_Karlovic,2,F-II,1,0,0,0,0,0,1,,,,,,,,,,
20150620-M-Halle-SF-Roger_Federer-Ivo_Karlovic,2,B-DTL,3,1,0,0,1,1,2,,,,,,,,,,
20150620-M-Halle-SF-Roger_Federer-Ivo_Karlovic,2,S-XC,3,0,0,0,0,2,1,,,,,,,,,,
20150620-M-Halle-SF-Roger_Federer-Ivo_Karlovic,2,S-DTM,3,2,0,1,1,2,1,,,,,,,,,,
20150620-M-Halle-SF-Roger_Federer-Ivo_Karlovic,2,S-DTL,6,4,1,0,3,3,3,,,,,,,,,,
20150620-M-Halle-SF-Roger_Federer-Ivo_Karlovic,2,S-IO,1,0,0,0,0,0,1,,,,,,,,,,
20150621-M-Halle-F-Andreas_Seppi-Roger_Federer,1,F-XC,26,5,2,1,2,11,15,,,,,,,,,,
20150621-M-Halle-F-Andreas_Seppi-Roger_Federer,1,F-DTM,16,2,1,0,1,9,7,,,,,,,,,,
20150621-M-Halle-F-Andreas_Seppi-Roger_Federer,1,F-DTL,12,3,1,2,0,8,4,,,,,,,,,,
20150621-M-Halle-F-Andreas_Seppi-Roger_Federer,1,F-IO,41,5,2,2,1,25,16,,,,,,,,,,
20150621-M-Halle-F-Andreas_Seppi-Roger_Federer,1,F-II,9,4,0,1,3,5,4,,,,,,,,,,
20150621-M-Halle-F-Andreas_Seppi-Roger_Federer,1,B-XC,33,5,1,0,4,14,19,,,,,,,,,,
20150621-M-Halle-F-Andreas_Seppi-Roger_Federer,1,B-DTM,30,6,0,3,3,17,13,,,,,,,,,,
20150621-M-Halle-F-Andreas_Seppi-Roger_Federer,1,B-DTL,7,3,1,0,2,5,2,,,,,,,,,,
20150621-M-Halle-F-Andreas_Seppi-Roger_Federer,1,B-IO,3,2,0,0,2,0,3,,,,,,,,,,
20150621-M-Halle-F-Andreas_Seppi-Roger_Federer,1,S-XC,10,2,1,0,1,3,7,,,,,,,,,,
20150621-M-Halle-F-Andreas_Seppi-Roger_Federer,1,S-DTM,10,1,0,0,1,2,8,,,,,,,,,,
20150621-M-Halle-F-Andreas_Seppi-Roger_Federer,1,S-DTL,1,1,0,0,1,0,1,,,,,,,,,,
20150621-M-Halle-F-Andreas_Seppi-Roger_Federer,1,S-IO,1,1,0,1,0,1,0,,,,,,,,,,
20150621-M-Halle-F-Andreas_Seppi-Roger_Federer,2,F-XC,25,6,0,1,5,10,15,,,,,,,,,,
20150621-M-Halle-F-Andreas_Seppi-Roger_Federer,2,F-DTM,23,4,0,1,3,8,15,,,,,,,,,,
20150621-M-Halle-F-Andreas_Seppi-Roger_Federer,2,F-DTL,11,3,0,2,1,8,3,,,,,,,,,,
20150621-M-Halle-F-Andreas_Seppi-Roger_Federer,2,F-IO,27,7,3,0,4,13,14,,,,,,,,,,
20150621-M-Halle-F-Andreas_Seppi-Roger_Federer,2,F-II,7,2,1,1,0,6,1,,,,,,,,,,
20150621-M-Halle-F-Andreas_Seppi-Roger_Federer,2,B-XC,28,4,2,1,1,15,13,,,,,,,,,,
20150621-M-Halle-F-Andreas_Seppi-Roger_Federer,2,B-DTM,17,4,0,1,3,8,9,,,,,,,,,,
20150621-M-Halle-F-Andreas_Seppi-Roger_Federer,2,B-DTL,6,5,1,3,1,4,2,,,,,,,,,,
20150621-M-Halle-F-Andreas_Seppi-Roger_Federer,2,B-IO,2,2,0,1,1,1,1,,,,,,,,,,
20150621-M-Halle-F-Andreas_Seppi-Roger_Federer,2,S-XC,29,2,0,0,2,15,14,,,,,,,,,,
20150621-M-Halle-F-Andreas_Seppi-Roger_Federer,2,S-DTM,6,0,0,0,0,3,3,,,,,,,,,,
20150621-M-Halle-F-Andreas_Seppi-Roger_Federer,2,S-DTL,3,0,0,0,0,1,2,,,,,,,,,,
20150621-M-Queens_Club-F-Andy_Murray-Kevin_Anderson,1,F-XC,17,7,4,1,2,14,3,,,,,,,,,,
20150621-M-Queens_Club-F-Andy_Murray-Kevin_Anderson,1,F-DTM,8,1,0,0,1,5,3,,,,,,,,,,
20150621-M-Queens_Club-F-Andy_Murray-Kevin_Anderson,1,F-DTL,2,0,0,0,0,0,2,,,,,,,,,,
20150621-M-Queens_Club-F-Andy_Murray-Kevin_Anderson,1,F-IO,4,1,0,0,1,3,1,,,,,,,,,,
20150621-M-Queens_Club-F-Andy_Murray-Kevin_Anderson,1,B-XC,10,4,3,0,1,9,1,,,,,,,,,,
20150621-M-Queens_Club-F-Andy_Murray-Kevin_Anderson,1,B-DTM,10,2,1,0,1,7,3,,,,,,,,,,
20150621-M-Queens_Club-F-Andy_Murray-Kevin_Anderson,1,B-DTL,2,1,1,0,0,2,0,,,,,,,,,,
20150621-M-Queens_Club-F-Andy_Murray-Kevin_Anderson,1,B-IO,1,1,1,0,0,1,0,,,,,,,,,,
20150621-M-Queens_Club-F-Andy_Murray-Kevin_Anderson,1,S-XC,9,0,0,0,0,6,3,,,,,,,,,,
20150621-M-Queens_Club-F-Andy_Murray-Kevin_Anderson,1,S-DTM,4,0,0,0,0,4,0,,,,,,,,,,
20150621-M-Queens_Club-F-Andy_Murray-Kevin_Anderson,1,S-IO,1,0,0,0,0,1,0,,,,,,,,,,
20150621-M-Queens_Club-F-Andy_Murray-Kevin_Anderson,2,F-XC,9,1,0,0,1,1,8,,,,,,,,,,
20150621-M-Queens_Club-F-Andy_Murray-Kevin_Anderson,2,F-DTM,7,2,0,0,2,0,7,,,,,,,,,,
20150621-M-Queens_Club-F-Andy_Murray-Kevin_Anderson,2,F-DTL,3,2,0,1,1,1,2,,,,,,,,,,
20150621-M-Queens_Club-F-Andy_Murray-Kevin_Anderson,2,F-IO,15,3,1,1,1,5,10,,,,,,,,,,
20150621-M-Queens_Club-F-Andy_Murray-Kevin_Anderson,2,F-II,1,1,1,0,0,1,0,,,,,,,,,,
20150621-M-Queens_Club-F-Andy_Murray-Kevin_Anderson,2,B-XC,12,3,0,1,2,2,10,,,,,,,,,,
20150621-M-Queens_Club-F-Andy_Murray-Kevin_Anderson,2,B-DTM,5,1,0,0,1,1,4,,,,,,,,,,
20150621-M-Queens_Club-F-Andy_Murray-Kevin_Anderson,2,B-DTL,3,2,1,0,1,1,2,,,,,,,,,,
20150621-M-Queens_Club-F-Andy_Murray-Kevin_Anderson,2,B-IO,2,1,0,0,1,0,2,,,,,,,,,,
20150621-M-Queens_Club-F-Andy_Murray-Kevin_Anderson,2,S-XC,2,1,1,0,0,1,1,,,,,,,,,,
20150621-M-Queens_Club-F-Andy_Murray-Kevin_Anderson,2,S-DTM,2,0,0,0,0,0,2,,,,,,,,,,
20150621-M-Queens_Club-F-Andy_Murray-Kevin_Anderson,2,S-DTL,3,1,0,0,1,1,2,,,,,,,,,,
20150621-M-Queens_Club-F-Andy_Murray-Kevin_Anderson,2,S-IO,1,0,0,0,0,0,1,,,,,,,,,,
20150624-M-Nottingham-R16-Marcos_Baghdatis-Alexander_Zverev,1,F-XC,20,6,3,2,1,18,2,,,,,,,,,,
20150624-M-Nottingham-R16-Marcos_Baghdatis-Alexander_Zverev,1,F-DTM,15,0,0,0,0,9,6,,,,,,,,,,
20150624-M-Nottingham-R16-Marcos_Baghdatis-Alexander_Zverev,1,F-DTL,3,0,0,0,0,2,1,,,,,,,,,,
20150624-M-Nottingham-R16-Marcos_Baghdatis-Alexander_Zverev,1,F-IO,8,2,0,2,0,6,2,,,,,,,,,,
20150624-M-Nottingham-R16-Marcos_Baghdatis-Alexander_Zverev,1,B-XC,11,2,0,1,1,7,4,,,,,,,,,,
20150624-M-Nottingham-R16-Marcos_Baghdatis-Alexander_Zverev,1,B-DTM,6,0,0,0,0,4,2,,,,,,,,,,
20150624-M-Nottingham-R16-Marcos_Baghdatis-Alexander_Zverev,1,B-DTL,5,3,2,1,0,5,0,,,,,,,,,,
20150624-M-Nottingham-R16-Marcos_Baghdatis-Alexander_Zverev,1,B-IO,4,1,1,0,0,3,1,,,,,,,,,,
20150624-M-Nottingham-R16-Marcos_Baghdatis-Alexander_Zverev,1,S-XC,6,0,0,0,0,2,4,,,,,,,,,,
20150624-M-Nottingham-R16-Marcos_Baghdatis-Alexander_Zverev,1,S-DTM,2,0,0,0,0,1,1,,,,,,,,,,
20150624-M-Nottingham-R16-Marcos_Baghdatis-Alexander_Zverev,1,S-DTL,5,1,1,0,0,4,1,,,,,,,,,,
20150624-M-Nottingham-R16-Marcos_Baghdatis-Alexander_Zverev,2,F-XC,24,6,2,0,4,5,19,,,,,,,,,,
20150624-M-Nottingham-R16-Marcos_Baghdatis-Alexander_Zverev,2,F-DTM,3,1,0,0,1,0,3,,,,,,,,,,
20150624-M-Nottingham-R16-Marcos_Baghdatis-Alexander_Zverev,2,F-DTL,6,2,0,0,2,0,6,,,,,,,,,,
20150624-M-Nottingham-R16-Marcos_Baghdatis-Alexander_Zverev,2,F-IO,10,7,2,1,4,6,4,,,,,,,,,,
20150624-M-Nottingham-R16-Marcos_Baghdatis-Alexander_Zverev,2,F-II,2,1,0,1,0,1,1,,,,,,,,,,
20150624-M-Nottingham-R16-Marcos_Baghdatis-Alexander_Zverev,2,B-XC,19,4,1,0,3,6,13,,,,,,,,,,
20150624-M-Nottingham-R16-Marcos_Baghdatis-Alexander_Zverev,2,B-DTM,14,0,0,0,0,4,10,,,,,,,,,,
20150624-M-Nottingham-R16-Marcos_Baghdatis-Alexander_Zverev,2,B-DTL,5,5,2,2,1,4,1,,,,,,,,,,
20150624-M-Nottingham-R16-Marcos_Baghdatis-Alexander_Zverev,2,B-IO,5,2,0,0,2,2,3,,,,,,,,,,
20150624-M-Nottingham-R16-Marcos_Baghdatis-Alexander_Zverev,2,B-II,1,1,0,1,0,1,0,,,,,,,,,,
20150624-M-Nottingham-R16-Marcos_Baghdatis-Alexander_Zverev,2,S-XC,3,1,0,0,1,1,2,,,,,,,,,,
20150624-M-Nottingham-R16-Marcos_Baghdatis-Alexander_Zverev,2,S-DTM,2,0,0,0,0,1,1,,,,,,,,,,
20150624-M-Nottingham-R16-Sam_Querrey-Pablo_Cuevas,1,F-XC,25,12,5,4,3,15,10,,,,,,,,,,
20150624-M-Nottingham-R16-Sam_Querrey-Pablo_Cuevas,1,F-DTM,5,0,0,0,0,2,3,,,,,,,,,,
20150624-M-Nottingham-R16-Sam_Querrey-Pablo_Cuevas,1,F-DTL,4,3,1,0,2,1,3,,,,,,,,,,
20150624-M-Nottingham-R16-Sam_Querrey-Pablo_Cuevas,1,F-IO,14,10,1,3,6,6,8,,,,,,,,,,
20150624-M-Nottingham-R16-Sam_Querrey-Pablo_Cuevas,1,F-II,5,3,0,2,1,3,2,,,,,,,,,,
20150624-M-Nottingham-R16-Sam_Querrey-Pablo_Cuevas,1,B-XC,21,5,2,0,3,12,9,,,,,,,,,,
20150624-M-Nottingham-R16-Sam_Querrey-Pablo_Cuevas,1,B-DTM,8,1,0,1,0,6,2,,,,,,,,,,
20150624-M-Nottingham-R16-Sam_Querrey-Pablo_Cuevas,1,B-DTL,5,3,2,1,0,4,1,,,,,,,,,,
20150624-M-Nottingham-R16-Sam_Querrey-Pablo_Cuevas,1,B-IO,1,1,1,0,0,1,0,,,,,,,,,,
20150624-M-Nottingham-R16-Sam_Querrey-Pablo_Cuevas,1,S-XC,3,0,0,0,0,0,3,,,,,,,,,,
20150624-M-Nottingham-R16-Sam_Querrey-Pablo_Cuevas,1,S-DTM,4,0,0,0,0,4,0,,,,,,,,,,
20150624-M-Nottingham-R16-Sam_Querrey-Pablo_Cuevas,1,S-DTL,2,1,0,0,1,1,1,,,,,,,,,,
20150624-M-Nottingham-R16-Sam_Querrey-Pablo_Cuevas,2,F-XC,19,7,3,1,3,10,9,,,,,,,,,,
20150624-M-Nottingham-R16-Sam_Querrey-Pablo_Cuevas,2,F-DTM,16,3,0,0,3,7,9,,,,,,,,,,
20150624-M-Nottingham-R16-Sam_Querrey-Pablo_Cuevas,2,F-DTL,11,6,3,1,2,7,4,,,,,,,,,,
20150624-M-Nottingham-R16-Sam_Querrey-Pablo_Cuevas,2,F-IO,30,6,2,2,2,15,15,,,,,,,,,,
20150624-M-Nottingham-R16-Sam_Querrey-Pablo_Cuevas,2,F-II,1,1,0,1,0,1,0,,,,,,,,,,
20150624-M-Nottingham-R16-Sam_Querrey-Pablo_Cuevas,2,B-XC,8,1,0,1,0,2,6,,,,,,,,,,
20150624-M-Nottingham-R16-Sam_Querrey-Pablo_Cuevas,2,B-DTM,4,2,0,0,2,1,3,,,,,,,,,,
20150624-M-Nottingham-R16-Sam_Querrey-Pablo_Cuevas,2,B-DTL,4,3,2,1,0,4,0,,,,,,,,,,
20150624-M-Nottingham-R16-Sam_Querrey-Pablo_Cuevas,2,S-XC,7,3,0,1,2,4,3,,,,,,,,,,
20150624-M-Nottingham-R16-Sam_Querrey-Pablo_Cuevas,2,S-DTM,1,0,0,0,0,0,1,,,,,,,,,,
20150625-M-Nottingham-QF-Denis_Istomin-Leonardo_Mayer,1,F-XC,34,7,4,3,0,22,12,,,,,,,,,,
20150625-M-Nottingham-QF-Denis_Istomin-Leonardo_Mayer,1,F-DTM,28,5,0,1,4,11,17,,,,,,,,,,
20150625-M-Nottingham-QF-Denis_Istomin-Leonardo_Mayer,1,F-DTL,7,6,3,2,1,5,2,,,,,,,,,,
20150625-M-Nottingham-QF-Denis_Istomin-Leonardo_Mayer,1,F-IO,25,7,3,3,1,17,8,,,,,,,,,,
20150625-M-Nottingham-QF-Denis_Istomin-Leonardo_Mayer,1,F-II,4,2,0,0,2,0,4,,,,,,,,,,
20150625-M-Nottingham-QF-Denis_Istomin-Leonardo_Mayer,1,B-XC,32,4,0,1,3,18,14,,,,,,,,,,
20150625-M-Nottingham-QF-Denis_Istomin-Leonardo_Mayer,1,B-DTM,35,1,0,0,1,16,19,,,,,,,,,,
20150625-M-Nottingham-QF-Denis_Istomin-Leonardo_Mayer,1,B-DTL,15,6,2,1,3,8,7,,,,,,,,,,
20150625-M-Nottingham-QF-Denis_Istomin-Leonardo_Mayer,1,B-IO,8,2,0,1,1,5,3,,,,,,,,,,
20150625-M-Nottingham-QF-Denis_Istomin-Leonardo_Mayer,1,S-XC,2,0,0,0,0,0,2,,,,,,,,,,
20150625-M-Nottingham-QF-Denis_Istomin-Leonardo_Mayer,1,S-DTM,3,0,0,0,0,1,2,,,,,,,,,,
20150625-M-Nottingham-QF-Denis_Istomin-Leonardo_Mayer,1,S-DTL,2,0,0,0,0,0,2,,,,,,,,,,
20150625-M-Nottingham-QF-Denis_Istomin-Leonardo_Mayer,2,F-XC,53,24,3,12,9,31,22,,,,,,,,,,
20150625-M-Nottingham-QF-Denis_Istomin-Leonardo_Mayer,2,F-DTM,27,4,0,0,4,5,22,,,,,,,,,,
20150625-M-Nottingham-QF-Denis_Istomin-Leonardo_Mayer,2,F-DTL,13,6,3,2,1,9,4,,,,,,,,,,
20150625-M-Nottingham-QF-Denis_Istomin-Leonardo_Mayer,2,F-IO,27,8,4,2,2,17,10,,,,,,,,,,
20150625-M-Nottingham-QF-Denis_Istomin-Leonardo_Mayer,2,F-II,4,3,0,1,2,2,2,,,,,,,,,,
20150625-M-Nottingham-QF-Denis_Istomin-Leonardo_Mayer,2,B-XC,33,6,1,2,3,19,14,,,,,,,,,,
20150625-M-Nottingham-QF-Denis_Istomin-Leonardo_Mayer,2,B-DTM,21,2,0,0,2,8,13,,,,,,,,,,
20150625-M-Nottingham-QF-Denis_Istomin-Leonardo_Mayer,2,B-DTL,2,2,0,0,2,0,2,,,,,,,,,,
20150625-M-Nottingham-QF-Denis_Istomin-Leonardo_Mayer,2,B-IO,2,2,0,0,2,0,2,,,,,,,,,,
20150625-M-Nottingham-QF-Denis_Istomin-Leonardo_Mayer,2,S-XC,6,0,0,0,0,2,4,,,,,,,,,,
20150625-M-Nottingham-QF-Denis_Istomin-Leonardo_Mayer,2,S-DTM,4,1,0,0,1,1,3,,,,,,,,,,
20150625-M-Nottingham-QF-Denis_Istomin-Leonardo_Mayer,2,S-DTL,4,1,1,0,0,2,2,,,,,,,,,,
20150625-M-Nottingham-QF-Denis_Istomin-Leonardo_Mayer,2,S-II,1,0,0,0,0,0,1,,,,,,,,,,
20150626-M-Nottingham-SF-Sam_Querrey-Alexandr_Dolgopolov,1,F-XC,28,16,3,5,8,15,13,,,,,,,,,,
20150626-M-Nottingham-SF-Sam_Querrey-Alexandr_Dolgopolov,1,F-DTM,6,1,0,1,0,2,4,,,,,,,,,,
20150626-M-Nottingham-SF-Sam_Querrey-Alexandr_Dolgopolov,1,F-DTL,5,4,2,1,1,4,1,,,,,,,,,,
20150626-M-Nottingham-SF-Sam_Querrey-Alexandr_Dolgopolov,1,F-IO,16,9,6,1,2,11,5,,,,,,,,,,
20150626-M-Nottingham-SF-Sam_Querrey-Alexandr_Dolgopolov,1,F-II,3,0,0,0,0,2,1,,,,,,,,,,
20150626-M-Nottingham-SF-Sam_Querrey-Alexandr_Dolgopolov,1,B-XC,40,8,2,1,5,20,20,,,,,,,,,,
20150626-M-Nottingham-SF-Sam_Querrey-Alexandr_Dolgopolov,1,B-DTM,7,2,0,0,2,3,4,,,,,,,,,,
20150626-M-Nottingham-SF-Sam_Querrey-Alexandr_Dolgopolov,1,B-DTL,10,2,0,0,2,3,7,,,,,,,,,,
20150626-M-Nottingham-SF-Sam_Querrey-Alexandr_Dolgopolov,1,B-IO,2,0,0,0,0,1,1,,,,,,,,,,
20150626-M-Nottingham-SF-Sam_Querrey-Alexandr_Dolgopolov,1,S-XC,8,1,0,0,1,4,4,,,,,,,,,,
20150626-M-Nottingham-SF-Sam_Querrey-Alexandr_Dolgopolov,1,S-DTM,7,0,0,0,0,2,5,,,,,,,,,,
20150626-M-Nottingham-SF-Sam_Querrey-Alexandr_Dolgopolov,1,S-DTL,2,1,0,0,1,1,1,,,,,,,,,,
20150626-M-Nottingham-SF-Sam_Querrey-Alexandr_Dolgopolov,2,F-XC,22,11,4,2,5,14,8,,,,,,,,,,
20150626-M-Nottingham-SF-Sam_Querrey-Alexandr_Dolgopolov,2,F-DTM,7,3,0,2,1,5,2,,,,,,,,,,
20150626-M-Nottingham-SF-Sam_Querrey-Alexandr_Dolgopolov,2,F-DTL,13,7,2,1,4,6,7,,,,,,,,,,
20150626-M-Nottingham-SF-Sam_Querrey-Alexandr_Dolgopolov,2,F-IO,19,10,3,1,6,9,10,,,,,,,,,,
20150626-M-Nottingham-SF-Sam_Querrey-Alexandr_Dolgopolov,2,B-XC,32,4,2,1,1,17,15,,,,,,,,,,
20150626-M-Nottingham-SF-Sam_Querrey-Alexandr_Dolgopolov,2,B-DTM,13,1,0,1,0,6,7,,,,,,,,,,
20150626-M-Nottingham-SF-Sam_Querrey-Alexandr_Dolgopolov,2,B-DTL,6,3,2,0,1,3,3,,,,,,,,,,
20150626-M-Nottingham-SF-Sam_Querrey-Alexandr_Dolgopolov,2,B-IO,1,1,1,0,0,1,0,,,,,,,,,,
20150626-M-Nottingham-SF-Sam_Querrey-Alexandr_Dolgopolov,2,S-XC,8,0,0,0,0,2,6,,,,,,,,,,
20150626-M-Nottingham-SF-Sam_Querrey-Alexandr_Dolgopolov,2,S-DTM,3,0,0,0,0,3,0,,,,,,,,,,
20150626-M-Nottingham-SF-Sam_Querrey-Alexandr_Dolgopolov,2,S-DTL,1,1,0,0,1,0,1,,,,,,,,,,
20150626-M-Nottingham-SF-Sam_Querrey-Alexandr_Dolgopolov,2,S-IO,1,0,0,0,0,0,1,,,,,,,,,,
20150630-M-Wimbledon-R128-Roger_Federer-Damir_Dzumhur,1,F-XC,10,2,0,1,1,8,2,,,,,,,,,,
20150630-M-Wimbledon-R128-Roger_Federer-Damir_Dzumhur,1,F-DTM,7,1,0,0,1,3,4,,,,,,,,,,
20150630-M-Wimbledon-R128-Roger_Federer-Damir_Dzumhur,1,F-DTL,6,3,1,2,0,4,2,,,,,,,,,,
20150630-M-Wimbledon-R128-Roger_Federer-Damir_Dzumhur,1,F-IO,15,5,2,1,2,9,6,,,,,,,,,,
20150630-M-Wimbledon-R128-Roger_Federer-Damir_Dzumhur,1,F-II,4,1,0,0,1,2,2,,,,,,,,,,
20150630-M-Wimbledon-R128-Roger_Federer-Damir_Dzumhur,1,B-XC,15,6,2,0,4,7,8,,,,,,,,,,
20150630-M-Wimbledon-R128-Roger_Federer-Damir_Dzumhur,1,B-DTM,9,0,0,0,0,5,4,,,,,,,,,,
20150630-M-Wimbledon-R128-Roger_Federer-Damir_Dzumhur,1,B-DTL,6,3,1,1,1,3,3,,,,,,,,,,
20150630-M-Wimbledon-R128-Roger_Federer-Damir_Dzumhur,1,B-IO,2,1,0,1,0,2,0,,,,,,,,,,
20150630-M-Wimbledon-R128-Roger_Federer-Damir_Dzumhur,1,S-XC,16,0,0,0,0,13,3,,,,,,,,,,
20150630-M-Wimbledon-R128-Roger_Federer-Damir_Dzumhur,1,S-DTM,1,1,1,0,0,1,0,,,,,,,,,,
20150630-M-Wimbledon-R128-Roger_Federer-Damir_Dzumhur,1,S-DTL,3,0,0,0,0,2,1,,,,,,,,,,
20150630-M-Wimbledon-R128-Roger_Federer-Damir_Dzumhur,1,S-IO,2,0,0,0,0,1,1,,,,,,,,,,
20150630-M-Wimbledon-R128-Roger_Federer-Damir_Dzumhur,2,F-XC,7,0,0,0,0,3,4,,,,,,,,,,
20150630-M-Wimbledon-R128-Roger_Federer-Damir_Dzumhur,2,F-DTM,8,2,0,0,2,3,5,,,,,,,,,,
20150630-M-Wimbledon-R128-Roger_Federer-Damir_Dzumhur,2,F-DTL,12,5,3,0,2,5,7,,,,,,,,,,
20150630-M-Wimbledon-R128-Roger_Federer-Damir_Dzumhur,2,F-IO,12,4,0,0,4,1,11,,,,,,,,,,
20150630-M-Wimbledon-R128-Roger_Federer-Damir_Dzumhur,2,B-XC,14,4,0,1,3,7,7,,,,,,,,,,
20150630-M-Wimbledon-R128-Roger_Federer-Damir_Dzumhur,2,B-DTM,19,3,0,1,2,7,12,,,,,,,,,,
20150630-M-Wimbledon-R128-Roger_Federer-Damir_Dzumhur,2,B-DTL,4,0,0,0,0,0,4,,,,,,,,,,
20150630-M-Wimbledon-R128-Roger_Federer-Damir_Dzumhur,2,B-IO,1,0,0,0,0,0,1,,,,,,,,,,
20150630-M-Wimbledon-R128-Roger_Federer-Damir_Dzumhur,2,S-XC,13,1,0,0,1,4,9,,,,,,,,,,
20150630-M-Wimbledon-R128-Roger_Federer-Damir_Dzumhur,2,S-DTM,6,2,0,0,2,2,4,,,,,,,,,,
20150630-M-Wimbledon-R128-Roger_Federer-Damir_Dzumhur,2,S-DTL,4,2,1,0,1,1,3,,,,,,,,,,
20150702-M-Wimbledon-R64-Dustin_Brown-Rafael_Nadal,1,F-XC,17,5,2,1,2,11,6,,,,,,,,,,
20150702-M-Wimbledon-R64-Dustin_Brown-Rafael_Nadal,1,F-DTM,4,3,0,0,3,0,4,,,,,,,,,,
20150702-M-Wimbledon-R64-Dustin_Brown-Rafael_Nadal,1,F-IO,2,1,0,0,1,1,1,,,,,,,,,,
20150702-M-Wimbledon-R64-Dustin_Brown-Rafael_Nadal,1,F-II,2,1,0,0,1,1,1,,,,,,,,,,
20150702-M-Wimbledon-R64-Dustin_Brown-Rafael_Nadal,1,B-XC,5,2,1,1,0,3,2,,,,,,,,,,
20150702-M-Wimbledon-R64-Dustin_Brown-Rafael_Nadal,1,B-DTM,5,0,0,0,0,0,5,,,,,,,,,,
20150702-M-Wimbledon-R64-Dustin_Brown-Rafael_Nadal,1,B-DTL,8,2,1,0,1,6,2,,,,,,,,,,
20150702-M-Wimbledon-R64-Dustin_Brown-Rafael_Nadal,1,B-IO,4,1,1,0,0,3,1,,,,,,,,,,
20150702-M-Wimbledon-R64-Dustin_Brown-Rafael_Nadal,1,S-DTM,3,0,0,0,0,0,3,,,,,,,,,,
20150702-M-Wimbledon-R64-Dustin_Brown-Rafael_Nadal,1,S-DTL,2,0,0,0,0,2,0,,,,,,,,,,
20150702-M-Wimbledon-R64-Dustin_Brown-Rafael_Nadal,2,F-XC,29,11,6,1,4,17,12,,,,,,,,,,
20150702-M-Wimbledon-R64-Dustin_Brown-Rafael_Nadal,2,F-DTM,5,0,0,0,0,3,2,,,,,,,,,,
20150702-M-Wimbledon-R64-Dustin_Brown-Rafael_Nadal,2,F-DTL,10,4,3,0,1,5,5,,,,,,,,,,
20150702-M-Wimbledon-R64-Dustin_Brown-Rafael_Nadal,2,F-IO,14,8,2,1,5,7,7,,,,,,,,,,
20150702-M-Wimbledon-R64-Dustin_Brown-Rafael_Nadal,2,F-II,4,1,0,0,1,1,3,,,,,,,,,,
20150702-M-Wimbledon-R64-Dustin_Brown-Rafael_Nadal,2,B-XC,17,5,4,1,0,7,10,,,,,,,,,,
20150702-M-Wimbledon-R64-Dustin_Brown-Rafael_Nadal,2,B-DTM,8,1,0,0,1,5,3,,,,,,,,,,
20150702-M-Wimbledon-R64-Dustin_Brown-Rafael_Nadal,2,B-DTL,8,3,2,0,1,4,4,,,,,,,,,,
20150702-M-Wimbledon-R64-Dustin_Brown-Rafael_Nadal,2,B-II,1,0,0,0,0,1,0,,,,,,,,,,
20150702-M-Wimbledon-R64-Dustin_Brown-Rafael_Nadal,2,S-XC,4,0,0,0,0,1,3,,,,,,,,,,
20150702-M-Wimbledon-R64-Dustin_Brown-Rafael_Nadal,2,S-DTM,8,0,0,0,0,1,7,,,,,,,,,,
20150702-M-Wimbledon-R64-Dustin_Brown-Rafael_Nadal,2,S-DTL,4,0,0,0,0,0,4,,,,,,,,,,
20150702-M-Wimbledon-R64-Dustin_Brown-Rafael_Nadal,2,S-IO,1,0,0,0,0,0,1,,,,,,,,,,
20150702-M-Wimbledon-R64-Sam_Querrey-Roger_Federer,1,F-XC,39,11,2,7,2,22,17,,,,,,,,,,
20150702-M-Wimbledon-R64-Sam_Querrey-Roger_Federer,1,F-DTM,16,3,1,1,1,10,6,,,,,,,,,,
20150702-M-Wimbledon-R64-Sam_Querrey-Roger_Federer,1,F-DTL,5,1,0,0,1,2,3,,,,,,,,,,
20150702-M-Wimbledon-R64-Sam_Querrey-Roger_Federer,1,F-IO,29,8,5,1,2,16,13,,,,,,,,,,
20150702-M-Wimbledon-R64-Sam_Querrey-Roger_Federer,1,F-II,5,1,0,1,0,2,3,,,,,,,,,,
20150702-M-Wimbledon-R64-Sam_Querrey-Roger_Federer,1,B-XC,24,7,2,3,2,13,11,,,,,,,,,,
20150702-M-Wimbledon-R64-Sam_Querrey-Roger_Federer,1,B-DTM,11,2,0,1,1,5,6,,,,,,,,,,
20150702-M-Wimbledon-R64-Sam_Querrey-Roger_Federer,1,B-DTL,3,2,1,1,0,2,1,,,,,,,,,,
20150702-M-Wimbledon-R64-Sam_Querrey-Roger_Federer,1,B-IO,2,0,0,0,0,0,2,,,,,,,,,,
20150702-M-Wimbledon-R64-Sam_Querrey-Roger_Federer,1,S-XC,3,0,0,0,0,1,2,,,,,,,,,,
20150702-M-Wimbledon-R64-Sam_Querrey-Roger_Federer,1,S-DTM,2,0,0,0,0,0,2,,,,,,,,,,
20150702-M-Wimbledon-R64-Sam_Querrey-Roger_Federer,2,F-XC,28,13,7,4,2,15,13,,,,,,,,,,
20150702-M-Wimbledon-R64-Sam_Querrey-Roger_Federer,2,F-DTM,28,2,1,1,0,18,10,,,,,,,,,,
20150702-M-Wimbledon-R64-Sam_Querrey-Roger_Federer,2,F-DTL,8,3,1,0,2,6,2,,,,,,,,,,
20150702-M-Wimbledon-R64-Sam_Querrey-Roger_Federer,2,F-IO,16,9,3,6,0,14,2,,,,,,,,,,
20150702-M-Wimbledon-R64-Sam_Querrey-Roger_Federer,2,F-II,2,2,1,0,1,1,1,,,,,,,,,,
20150702-M-Wimbledon-R64-Sam_Querrey-Roger_Federer,2,B-XC,11,4,2,1,1,6,5,,,,,,,,,,
20150702-M-Wimbledon-R64-Sam_Querrey-Roger_Federer,2,B-DTM,15,4,0,4,0,7,8,,,,,,,,,,
20150702-M-Wimbledon-R64-Sam_Querrey-Roger_Federer,2,B-DTL,9,2,1,1,0,6,3,,,,,,,,,,
20150702-M-Wimbledon-R64-Sam_Querrey-Roger_Federer,2,B-IO,1,1,1,0,0,1,0,,,,,,,,,,
20150702-M-Wimbledon-R64-Sam_Querrey-Roger_Federer,2,S-XC,15,2,0,1,1,6,9,,,,,,,,,,
20150702-M-Wimbledon-R64-Sam_Querrey-Roger_Federer,2,S-DTM,6,1,0,0,1,2,4,,,,,,,,,,
20150702-M-Wimbledon-R64-Sam_Querrey-Roger_Federer,2,S-DTL,6,1,0,1,0,3,3,,,,,,,,,,
20150704-M-Wimbledon-R32-Samuel_Groth-Roger_Federer,1,F-XC,7,3,1,2,0,3,4,,,,,,,,,,
20150704-M-Wimbledon-R32-Samuel_Groth-Roger_Federer,1,F-DTM,10,5,0,0,5,2,8,,,,,,,,,,
20150704-M-Wimbledon-R32-Samuel_Groth-Roger_Federer,1,F-DTL,3,1,1,0,0,2,1,,,,,,,,,,
20150704-M-Wimbledon-R32-Samuel_Groth-Roger_Federer,1,F-IO,1,1,0,0,1,0,1,,,,,,,,,,
20150704-M-Wimbledon-R32-Samuel_Groth-Roger_Federer,1,B-XC,15,3,2,1,0,4,11,,,,,,,,,,
20150704-M-Wimbledon-R32-Samuel_Groth-Roger_Federer,1,B-DTM,11,3,0,2,1,5,6,,,,,,,,,,
20150704-M-Wimbledon-R32-Samuel_Groth-Roger_Federer,1,B-DTL,2,2,0,1,1,1,1,,,,,,,,,,
20150704-M-Wimbledon-R32-Samuel_Groth-Roger_Federer,1,B-IO,1,0,0,0,0,0,1,,,,,,,,,,
20150704-M-Wimbledon-R32-Samuel_Groth-Roger_Federer,1,S-XC,4,3,1,1,1,3,1,,,,,,,,,,
20150704-M-Wimbledon-R32-Samuel_Groth-Roger_Federer,1,S-DTM,3,0,0,0,0,0,3,,,,,,,,,,
20150704-M-Wimbledon-R32-Samuel_Groth-Roger_Federer,1,S-IO,1,0,0,0,0,0,1,,,,,,,,,,
20150704-M-Wimbledon-R32-Samuel_Groth-Roger_Federer,2,F-XC,24,11,5,5,1,17,7,,,,,,,,,,
20150704-M-Wimbledon-R32-Samuel_Groth-Roger_Federer,2,F-DTM,18,2,1,0,1,12,6,,,,,,,,,,
20150704-M-Wimbledon-R32-Samuel_Groth-Roger_Federer,2,F-DTL,4,3,1,1,1,2,2,,,,,,,,,,
20150704-M-Wimbledon-R32-Samuel_Groth-Roger_Federer,2,F-IO,20,7,6,1,0,16,4,,,,,,,,,,
20150704-M-Wimbledon-R32-Samuel_Groth-Roger_Federer,2,F-II,3,2,0,1,1,2,1,,,,,,,,,,
20150704-M-Wimbledon-R32-Samuel_Groth-Roger_Federer,2,B-XC,18,9,5,4,0,16,2,,,,,,,,,,
20150704-M-Wimbledon-R32-Samuel_Groth-Roger_Federer,2,B-DTM,10,1,0,0,1,6,4,,,,,,,,,,
20150704-M-Wimbledon-R32-Samuel_Groth-Roger_Federer,2,B-DTL,10,4,1,2,1,9,1,,,,,,,,,,
20150704-M-Wimbledon-R32-Samuel_Groth-Roger_Federer,2,S-XC,6,1,0,1,0,3,3,,,,,,,,,,
20150704-M-Wimbledon-R32-Samuel_Groth-Roger_Federer,2,S-DTM,1,0,0,0,0,0,1,,,,,,,,,,
20150704-M-Wimbledon-R32-Samuel_Groth-Roger_Federer,2,S-DTL,2,1,1,0,0,1,1,,,,,,,,,,
20150704-M-Wimbledon-R32-Samuel_Groth-Roger_Federer,2,S-IO,1,0,0,0,0,0,1,,,,,,,,,,
20150706-M-Wimbledon-R16-Andy_Murray-Ivo_Karlovic,1,F-XC,35,12,7,1,4,23,12,,,,,,,,,,
20150706-M-Wimbledon-R16-Andy_Murray-Ivo_Karlovic,1,F-DTM,20,0,0,0,0,10,10,,,,,,,,,,
20150706-M-Wimbledon-R16-Andy_Murray-Ivo_Karlovic,1,F-DTL,15,6,4,2,0,10,5,,,,,,,,,,
20150706-M-Wimbledon-R16-Andy_Murray-Ivo_Karlovic,1,F-IO,21,6,3,3,0,17,4,,,,,,,,,,
20150706-M-Wimbledon-R16-Andy_Murray-Ivo_Karlovic,1,F-II,4,3,2,0,1,2,2,,,,,,,,,,
20150706-M-Wimbledon-R16-Andy_Murray-Ivo_Karlovic,1,B-XC,20,9,6,2,1,15,5,,,,,,,,,,
20150706-M-Wimbledon-R16-Andy_Murray-Ivo_Karlovic,1,B-DTM,11,0,0,0,0,6,5,,,,,,,,,,
20150706-M-Wimbledon-R16-Andy_Murray-Ivo_Karlovic,1,B-DTL,14,9,7,0,2,9,5,,,,,,,,,,
20150706-M-Wimbledon-R16-Andy_Murray-Ivo_Karlovic,1,B-IO,3,0,0,0,0,1,2,,,,,,,,,,
20150706-M-Wimbledon-R16-Andy_Murray-Ivo_Karlovic,1,S-XC,8,0,0,0,0,6,2,,,,,,,,,,
20150706-M-Wimbledon-R16-Andy_Murray-Ivo_Karlovic,1,S-DTM,5,1,0,0,1,0,5,,,,,,,,,,
20150706-M-Wimbledon-R16-Andy_Murray-Ivo_Karlovic,1,S-DTL,6,1,0,0,1,4,2,,,,,,,,,,
20150706-M-Wimbledon-R16-Andy_Murray-Ivo_Karlovic,1,S-IO,1,0,0,0,0,0,1,,,,,,,,,,
20150706-M-Wimbledon-R16-Andy_Murray-Ivo_Karlovic,2,F-XC,26,15,10,0,5,14,12,,,,,,,,,,
20150706-M-Wimbledon-R16-Andy_Murray-Ivo_Karlovic,2,F-DTM,12,5,0,0,5,6,6,,,,,,,,,,
20150706-M-Wimbledon-R16-Andy_Murray-Ivo_Karlovic,2,F-DTL,11,2,0,0,2,3,8,,,,,,,,,,
20150706-M-Wimbledon-R16-Andy_Murray-Ivo_Karlovic,2,F-IO,16,7,4,1,2,10,6,,,,,,,,,,
20150706-M-Wimbledon-R16-Andy_Murray-Ivo_Karlovic,2,F-II,3,1,0,0,1,1,2,,,,,,,,,,
20150706-M-Wimbledon-R16-Andy_Murray-Ivo_Karlovic,2,B-DTM,1,0,0,0,0,0,1,,,,,,,,,,
20150706-M-Wimbledon-R16-Andy_Murray-Ivo_Karlovic,2,B-DTL,3,3,0,0,3,0,3,,,,,,,,,,
20150706-M-Wimbledon-R16-Andy_Murray-Ivo_Karlovic,2,S-XC,12,0,0,0,0,5,7,,,,,,,,,,
20150706-M-Wimbledon-R16-Andy_Murray-Ivo_Karlovic,2,S-DTM,9,2,0,0,2,1,8,,,,,,,,,,
20150706-M-Wimbledon-R16-Andy_Murray-Ivo_Karlovic,2,S-DTL,10,2,0,0,2,2,8,,,,,,,,,,
20150706-M-Wimbledon-R16-Andy_Murray-Ivo_Karlovic,2,S-IO,4,2,0,1,1,2,2,,,,,,,,,,
20150708-M-Wimbledon-QF-Roger_Federer-Gilles_Simon,1,F-XC,32,8,2,2,4,12,20,,,,,,,,,,
20150708-M-Wimbledon-QF-Roger_Federer-Gilles_Simon,1,F-DTM,31,3,0,2,1,13,18,,,,,,,,,,
20150708-M-Wimbledon-QF-Roger_Federer-Gilles_Simon,1,F-DTL,12,7,3,2,2,6,6,,,,,,,,,,
20150708-M-Wimbledon-QF-Roger_Federer-Gilles_Simon,1,F-IO,24,6,2,2,2,14,10,,,,,,,,,,
20150708-M-Wimbledon-QF-Roger_Federer-Gilles_Simon,1,F-II,5,3,2,0,1,3,2,,,,,,,,,,
20150708-M-Wimbledon-QF-Roger_Federer-Gilles_Simon,1,B-XC,17,1,0,1,0,11,6,,,,,,,,,,
20150708-M-Wimbledon-QF-Roger_Federer-Gilles_Simon,1,B-DTM,21,3,0,0,3,7,14,,,,,,,,,,
20150708-M-Wimbledon-QF-Roger_Federer-Gilles_Simon,1,B-DTL,6,4,1,1,2,4,2,,,,,,,,,,
20150708-M-Wimbledon-QF-Roger_Federer-Gilles_Simon,1,B-IO,1,0,0,0,0,0,1,,,,,,,,,,
20150708-M-Wimbledon-QF-Roger_Federer-Gilles_Simon,1,S-XC,11,0,0,0,0,5,6,,,,,,,,,,
20150708-M-Wimbledon-QF-Roger_Federer-Gilles_Simon,1,S-DTM,11,0,0,0,0,4,7,,,,,,,,,,
20150708-M-Wimbledon-QF-Roger_Federer-Gilles_Simon,1,S-DTL,9,1,0,0,1,4,5,,,,,,,,,,
20150708-M-Wimbledon-QF-Roger_Federer-Gilles_Simon,2,F-XC,39,11,0,7,4,25,14,,,,,,,,,,
20150708-M-Wimbledon-QF-Roger_Federer-Gilles_Simon,2,F-DTM,22,3,1,1,1,14,8,,,,,,,,,,
20150708-M-Wimbledon-QF-Roger_Federer-Gilles_Simon,2,F-DTL,5,1,0,0,1,1,4,,,,,,,,,,
20150708-M-Wimbledon-QF-Roger_Federer-Gilles_Simon,2,F-IO,26,3,1,2,0,12,14,,,,,,,,,,
20150708-M-Wimbledon-QF-Roger_Federer-Gilles_Simon,2,F-II,1,0,0,0,0,1,0,,,,,,,,,,
20150708-M-Wimbledon-QF-Roger_Federer-Gilles_Simon,2,B-XC,54,10,2,2,6,28,26,,,,,,,,,,
20150708-M-Wimbledon-QF-Roger_Federer-Gilles_Simon,2,B-DTM,34,5,0,3,2,18,16,,,,,,,,,,
20150708-M-Wimbledon-QF-Roger_Federer-Gilles_Simon,2,B-DTL,13,6,4,1,1,9,4,,,,,,,,,,
20150708-M-Wimbledon-QF-Roger_Federer-Gilles_Simon,2,B-IO,5,1,0,0,1,1,4,,,,,,,,,,
20150708-M-Wimbledon-QF-Roger_Federer-Gilles_Simon,2,S-XC,1,1,1,0,0,1,0,,,,,,,,,,
20150709-M-Wimbledon-QF-Marin_Cilic-Novak_Djokovic,1,F-XC,42,17,5,3,9,21,21,,,,,,,,,,
20150709-M-Wimbledon-QF-Marin_Cilic-Novak_Djokovic,1,F-DTM,23,6,0,1,5,8,15,,,,,,,,,,
20150709-M-Wimbledon-QF-Marin_Cilic-Novak_Djokovic,1,F-DTL,18,4,2,0,2,7,11,,,,,,,,,,
20150709-M-Wimbledon-QF-Marin_Cilic-Novak_Djokovic,1,F-IO,22,1,0,1,0,13,9,,,,,,,,,,
20150709-M-Wimbledon-QF-Marin_Cilic-Novak_Djokovic,1,F-II,2,1,1,0,0,1,1,,,,,,,,,,
20150709-M-Wimbledon-QF-Marin_Cilic-Novak_Djokovic,1,B-XC,25,6,1,0,5,9,16,,,,,,,,,,
20150709-M-Wimbledon-QF-Marin_Cilic-Novak_Djokovic,1,B-DTM,29,4,0,0,4,13,16,,,,,,,,,,
20150709-M-Wimbledon-QF-Marin_Cilic-Novak_Djokovic,1,B-DTL,8,6,5,1,0,7,1,,,,,,,,,,
20150709-M-Wimbledon-QF-Marin_Cilic-Novak_Djokovic,1,B-IO,8,1,0,0,1,2,6,,,,,,,,,,
20150709-M-Wimbledon-QF-Marin_Cilic-Novak_Djokovic,1,S-XC,12,0,0,0,0,6,6,,,,,,,,,,
20150709-M-Wimbledon-QF-Marin_Cilic-Novak_Djokovic,1,S-DTM,10,2,0,0,2,5,5,,,,,,,,,,
20150709-M-Wimbledon-QF-Marin_Cilic-Novak_Djokovic,1,S-DTL,2,1,0,0,1,1,1,,,,,,,,,,
20150709-M-Wimbledon-QF-Marin_Cilic-Novak_Djokovic,1,S-IO,3,1,0,0,1,1,2,,,,,,,,,,
20150709-M-Wimbledon-QF-Marin_Cilic-Novak_Djokovic,2,F-XC,39,12,6,3,3,26,13,,,,,,,,,,
20150709-M-Wimbledon-QF-Marin_Cilic-Novak_Djokovic,2,F-DTM,27,3,0,1,2,14,13,,,,,,,,,,
20150709-M-Wimbledon-QF-Marin_Cilic-Novak_Djokovic,2,F-DTL,12,4,2,0,2,5,7,,,,,,,,,,
20150709-M-Wimbledon-QF-Marin_Cilic-Novak_Djokovic,2,F-IO,17,5,3,2,0,11,6,,,,,,,,,,
20150709-M-Wimbledon-QF-Marin_Cilic-Novak_Djokovic,2,F-II,2,0,0,0,0,1,1,,,,,,,,,,
20150709-M-Wimbledon-QF-Marin_Cilic-Novak_Djokovic,2,B-XC,29,5,2,0,3,16,13,,,,,,,,,,
20150709-M-Wimbledon-QF-Marin_Cilic-Novak_Djokovic,2,B-DTM,27,1,0,0,1,16,11,,,,,,,,,,
20150709-M-Wimbledon-QF-Marin_Cilic-Novak_Djokovic,2,B-DTL,8,4,2,1,1,6,2,,,,,,,,,,
20150709-M-Wimbledon-QF-Marin_Cilic-Novak_Djokovic,2,B-IO,12,4,0,1,3,7,5,,,,,,,,,,
20150709-M-Wimbledon-QF-Marin_Cilic-Novak_Djokovic,2,S-XC,12,3,0,2,1,7,5,,,,,,,,,,
20150709-M-Wimbledon-QF-Marin_Cilic-Novak_Djokovic,2,S-DTM,9,0,0,0,0,3,6,,,,,,,,,,
20150709-M-Wimbledon-QF-Marin_Cilic-Novak_Djokovic,2,S-IO,2,1,0,0,1,1,1,,,,,,,,,,
20150710-M-Wimbledon-SF-Novak_Djokovic-Richard_Gasquet,1,F-XC,47,17,9,4,4,30,17,,,,,,,,,,
20150710-M-Wimbledon-SF-Novak_Djokovic-Richard_Gasquet,1,F-DTM,26,1,0,0,1,17,9,,,,,,,,,,
20150710-M-Wimbledon-SF-Novak_Djokovic-Richard_Gasquet,1,F-DTL,17,7,2,2,3,8,9,,,,,,,,,,
20150710-M-Wimbledon-SF-Novak_Djokovic-Richard_Gasquet,1,F-IO,25,6,2,1,3,18,7,,,,,,,,,,
20150710-M-Wimbledon-SF-Novak_Djokovic-Richard_Gasquet,1,F-II,7,3,0,0,3,3,4,,,,,,,,,,
20150710-M-Wimbledon-SF-Novak_Djokovic-Richard_Gasquet,1,B-XC,57,13,4,2,7,32,25,,,,,,,,,,
20150710-M-Wimbledon-SF-Novak_Djokovic-Richard_Gasquet,1,B-DTM,39,4,0,1,3,14,25,,,,,,,,,,
20150710-M-Wimbledon-SF-Novak_Djokovic-Richard_Gasquet,1,B-DTL,19,10,5,2,3,12,7,,,,,,,,,,
20150710-M-Wimbledon-SF-Novak_Djokovic-Richard_Gasquet,1,B-IO,8,1,0,1,0,6,2,,,,,,,,,,
20150710-M-Wimbledon-SF-Novak_Djokovic-Richard_Gasquet,1,S-XC,4,2,1,0,1,1,3,,,,,,,,,,
20150710-M-Wimbledon-SF-Novak_Djokovic-Richard_Gasquet,1,S-DTM,3,1,0,1,0,2,1,,,,,,,,,,
20150710-M-Wimbledon-SF-Novak_Djokovic-Richard_Gasquet,1,S-IO,3,0,0,0,0,2,1,,,,,,,,,,
20150710-M-Wimbledon-SF-Novak_Djokovic-Richard_Gasquet,2,F-XC,51,11,2,2,7,24,27,,,,,,,,,,
20150710-M-Wimbledon-SF-Novak_Djokovic-Richard_Gasquet,2,F-DTM,32,3,0,0,3,12,20,,,,,,,,,,
20150710-M-Wimbledon-SF-Novak_Djokovic-Richard_Gasquet,2,F-DTL,14,4,2,1,1,10,4,,,,,,,,,,
20150710-M-Wimbledon-SF-Novak_Djokovic-Richard_Gasquet,2,F-IO,16,3,1,0,2,7,9,,,,,,,,,,
20150710-M-Wimbledon-SF-Novak_Djokovic-Richard_Gasquet,2,B-XC,41,7,2,2,3,21,20,,,,,,,,,,
20150710-M-Wimbledon-SF-Novak_Djokovic-Richard_Gasquet,2,B-DTM,27,4,3,0,1,7,20,,,,,,,,,,
20150710-M-Wimbledon-SF-Novak_Djokovic-Richard_Gasquet,2,B-DTL,16,9,6,0,3,10,6,,,,,,,,,,
20150710-M-Wimbledon-SF-Novak_Djokovic-Richard_Gasquet,2,B-IO,7,4,3,1,0,6,1,,,,,,,,,,
20150710-M-Wimbledon-SF-Novak_Djokovic-Richard_Gasquet,2,S-XC,32,3,0,0,3,15,17,,,,,,,,,,
20150710-M-Wimbledon-SF-Novak_Djokovic-Richard_Gasquet,2,S-DTM,10,0,0,0,0,4,6,,,,,,,,,,
20150710-M-Wimbledon-SF-Novak_Djokovic-Richard_Gasquet,2,S-DTL,1,0,0,0,0,1,0,,,,,,,,,,
20150710-M-Wimbledon-SF-Roger_Federer-Andy_Murray,1,F-XC,30,5,3,2,0,15,15,,,,,,,,,,
20150710-M-Wimbledon-SF-Roger_Federer-Andy_Murray,1,F-DTM,20,0,0,0,0,7,13,,,,,,,,,,
20150710-M-Wimbledon-SF-Roger_Federer-Andy_Murray,1,F-DTL,15,4,3,0,1,11,4,,,,,,,,,,
20150710-M-Wimbledon-SF-Roger_Federer-Andy_Murray,1,F-IO,21,8,3,1,4,11,10,,,,,,,,,,
20150710-M-Wimbledon-SF-Roger_Federer-Andy_Murray,1,F-II,11,6,4,2,0,7,4,,,,,,,,,,
20150710-M-Wimbledon-SF-Roger_Federer-Andy_Murray,1,B-XC,23,3,1,0,2,9,14,,,,,,,,,,
20150710-M-Wimbledon-SF-Roger_Federer-Andy_Murray,1,B-DTM,18,3,0,2,1,9,9,,,,,,,,,,
20150710-M-Wimbledon-SF-Roger_Federer-Andy_Murray,1,B-DTL,14,6,2,3,1,9,5,,,,,,,,,,
20150710-M-Wimbledon-SF-Roger_Federer-Andy_Murray,1,B-IO,1,0,0,0,0,1,0,,,,,,,,,,
20150710-M-Wimbledon-SF-Roger_Federer-Andy_Murray,1,S-XC,19,1,0,0,1,7,12,,,,,,,,,,
20150710-M-Wimbledon-SF-Roger_Federer-Andy_Murray,1,S-DTM,9,1,0,1,0,3,6,,,,,,,,,,
20150710-M-Wimbledon-SF-Roger_Federer-Andy_Murray,1,S-DTL,8,0,0,0,0,4,4,,,,,,,,,,
20150710-M-Wimbledon-SF-Roger_Federer-Andy_Murray,1,S-IO,2,0,0,0,0,0,2,,,,,,,,,,
20150710-M-Wimbledon-SF-Roger_Federer-Andy_Murray,1,S-II,1,0,0,0,0,1,0,,,,,,,,,,
20150710-M-Wimbledon-SF-Roger_Federer-Andy_Murray,2,F-XC,42,8,2,4,2,24,18,,,,,,,,,,
20150710-M-Wimbledon-SF-Roger_Federer-Andy_Murray,2,F-DTM,14,1,0,0,1,6,8,,,,,,,,,,
20150710-M-Wimbledon-SF-Roger_Federer-Andy_Murray,2,F-DTL,24,9,5,2,2,16,8,,,,,,,,,,
20150710-M-Wimbledon-SF-Roger_Federer-Andy_Murray,2,F-IO,33,11,4,3,4,20,13,,,,,,,,,,
20150710-M-Wimbledon-SF-Roger_Federer-Andy_Murray,2,F-II,1,1,0,0,1,0,1,,,,,,,,,,
20150710-M-Wimbledon-SF-Roger_Federer-Andy_Murray,2,B-XC,52,9,3,3,3,29,23,,,,,,,,,,
20150710-M-Wimbledon-SF-Roger_Federer-Andy_Murray,2,B-DTM,15,2,0,1,1,11,4,,,,,,,,,,
20150710-M-Wimbledon-SF-Roger_Federer-Andy_Murray,2,B-DTL,9,4,2,2,0,6,3,,,,,,,,,,
20150710-M-Wimbledon-SF-Roger_Federer-Andy_Murray,2,B-IO,4,2,1,1,0,2,2,,,,,,,,,,
20150710-M-Wimbledon-SF-Roger_Federer-Andy_Murray,2,B-II,1,0,0,0,0,1,0,,,,,,,,,,
20150710-M-Wimbledon-SF-Roger_Federer-Andy_Murray,2,S-XC,10,0,0,0,0,6,4,,,,,,,,,,
20150710-M-Wimbledon-SF-Roger_Federer-Andy_Murray,2,S-DTM,6,0,0,0,0,3,3,,,,,,,,,,
20150710-M-Wimbledon-SF-Roger_Federer-Andy_Murray,2,S-DTL,2,0,0,0,0,0,2,,,,,,,,,,
20150710-M-Wimbledon-SF-Roger_Federer-Andy_Murray,2,S-IO,1,0,0,0,0,0,1,,,,,,,,,,
20150712-M-Wimbledon-F-Roger_Federer-Novak_Djokovic,1,F-XC,42,7,1,2,4,19,23,,,,,,,,,,
20150712-M-Wimbledon-F-Roger_Federer-Novak_Djokovic,1,F-DTM,51,12,0,3,9,17,34,,,,,,,,,,
20150712-M-Wimbledon-F-Roger_Federer-Novak_Djokovic,1,F-DTL,17,9,3,2,4,9,8,,,,,,,,,,
20150712-M-Wimbledon-F-Roger_Federer-Novak_Djokovic,1,F-IO,48,17,9,3,5,27,21,,,,,,,,,,
20150712-M-Wimbledon-F-Roger_Federer-Novak_Djokovic,1,F-II,6,3,1,0,2,2,4,,,,,,,,,,
20150712-M-Wimbledon-F-Roger_Federer-Novak_Djokovic,1,B-XC,37,9,2,1,6,13,24,,,,,,,,,,
20150712-M-Wimbledon-F-Roger_Federer-Novak_Djokovic,1,B-DTM,31,6,0,2,4,11,20,,,,,,,,,,
20150712-M-Wimbledon-F-Roger_Federer-Novak_Djokovic,1,B-DTL,16,5,0,0,5,4,12,,,,,,,,,,
20150712-M-Wimbledon-F-Roger_Federer-Novak_Djokovic,1,B-IO,2,1,1,0,0,2,0,,,,,,,,,,
20150712-M-Wimbledon-F-Roger_Federer-Novak_Djokovic,1,S-XC,27,5,0,3,2,11,16,,,,,,,,,,
20150712-M-Wimbledon-F-Roger_Federer-Novak_Djokovic,1,S-DTM,13,0,0,0,0,4,9,,,,,,,,,,
20150712-M-Wimbledon-F-Roger_Federer-Novak_Djokovic,1,S-DTL,4,1,0,0,1,2,2,,,,,,,,,,
20150712-M-Wimbledon-F-Roger_Federer-Novak_Djokovic,1,S-IO,1,0,0,0,0,1,0,,,,,,,,,,
20150712-M-Wimbledon-F-Roger_Federer-Novak_Djokovic,2,F-XC,67,15,4,7,4,41,26,,,,,,,,,,
20150712-M-Wimbledon-F-Roger_Federer-Novak_Djokovic,2,F-DTM,32,6,0,0,6,14,18,,,,,,,,,,
20150712-M-Wimbledon-F-Roger_Federer-Novak_Djokovic,2,F-DTL,15,4,2,0,2,9,6,,,,,,,,,,
20150712-M-Wimbledon-F-Roger_Federer-Novak_Djokovic,2,F-IO,33,8,6,1,1,23,10,,,,,,,,,,
20150712-M-Wimbledon-F-Roger_Federer-Novak_Djokovic,2,F-II,8,3,1,1,1,5,3,,,,,,,,,,
20150712-M-Wimbledon-F-Roger_Federer-Novak_Djokovic,2,B-XC,67,4,2,0,2,46,21,,,,,,,,,,
20150712-M-Wimbledon-F-Roger_Federer-Novak_Djokovic,2,B-DTM,47,5,0,2,3,26,21,,,,,,,,,,
20150712-M-Wimbledon-F-Roger_Federer-Novak_Djokovic,2,B-DTL,19,11,1,4,6,11,8,,,,,,,,,,
20150712-M-Wimbledon-F-Roger_Federer-Novak_Djokovic,2,B-IO,8,3,1,1,1,3,5,,,,,,,,,,
20150712-M-Wimbledon-F-Roger_Federer-Novak_Djokovic,2,S-XC,9,0,0,0,0,2,7,,,,,,,,,,
20150712-M-Wimbledon-F-Roger_Federer-Novak_Djokovic,2,S-DTM,6,1,0,0,1,3,3,,,,,,,,,,
20150712-M-Wimbledon-F-Roger_Federer-Novak_Djokovic,2,S-DTL,3,2,1,0,1,2,1,,,,,,,,,,
20150712-M-Wimbledon-F-Roger_Federer-Novak_Djokovic,2,S-IO,1,0,0,0,0,1,0,,,,,,,,,,
20150725-M-Bogota-SF-Michael_Berrer-Bernard_Tomic,1,F-XC,25,4,1,1,2,14,11,,,,,,,,,,
20150725-M-Bogota-SF-Michael_Berrer-Bernard_Tomic,1,F-DTM,8,1,0,1,0,1,7,,,,,,,,,,
20150725-M-Bogota-SF-Michael_Berrer-Bernard_Tomic,1,F-DTL,3,1,1,0,0,3,0,,,,,,,,,,
20150725-M-Bogota-SF-Michael_Berrer-Bernard_Tomic,1,F-IO,10,5,4,0,1,6,4,,,,,,,,,,
20150725-M-Bogota-SF-Michael_Berrer-Bernard_Tomic,1,B-XC,7,6,3,0,3,4,3,,,,,,,,,,
20150725-M-Bogota-SF-Michael_Berrer-Bernard_Tomic,1,B-DTM,3,1,0,1,0,2,1,,,,,,,,,,
20150725-M-Bogota-SF-Michael_Berrer-Bernard_Tomic,1,B-DTL,4,1,0,1,0,2,2,,,,,,,,,,
20150725-M-Bogota-SF-Michael_Berrer-Bernard_Tomic,1,B-IO,1,1,1,0,0,1,0,,,,,,,,,,
20150725-M-Bogota-SF-Michael_Berrer-Bernard_Tomic,1,S-XC,11,6,2,2,2,8,3,,,,,,,,,,
20150725-M-Bogota-SF-Michael_Berrer-Bernard_Tomic,1,S-DTM,6,1,0,0,1,2,4,,,,,,,,,,
20150725-M-Bogota-SF-Michael_Berrer-Bernard_Tomic,1,S-DTL,7,1,0,1,0,4,3,,,,,,,,,,
20150725-M-Bogota-SF-Michael_Berrer-Bernard_Tomic,1,S-IO,1,1,0,0,1,0,1,,,,,,,,,,
20150725-M-Bogota-SF-Michael_Berrer-Bernard_Tomic,2,F-XC,23,9,4,4,1,12,11,,,,,,,,,,
20150725-M-Bogota-SF-Michael_Berrer-Bernard_Tomic,2,F-DTM,6,0,0,0,0,2,4,,,,,,,,,,
20150725-M-Bogota-SF-Michael_Berrer-Bernard_Tomic,2,F-DTL,13,8,4,3,1,8,5,,,,,,,,,,
20150725-M-Bogota-SF-Michael_Berrer-Bernard_Tomic,2,F-IO,23,7,2,2,3,13,10,,,,,,,,,,
20150725-M-Bogota-SF-Michael_Berrer-Bernard_Tomic,2,B-XC,20,5,0,2,3,10,10,,,,,,,,,,
20150725-M-Bogota-SF-Michael_Berrer-Bernard_Tomic,2,B-DTM,10,1,0,0,1,6,4,,,,,,,,,,
20150725-M-Bogota-SF-Michael_Berrer-Bernard_Tomic,2,B-DTL,13,3,1,0,2,6,7,,,,,,,,,,
20150725-M-Bogota-SF-Michael_Berrer-Bernard_Tomic,2,B-IO,5,1,1,0,0,2,3,,,,,,,,,,
20150725-M-Bogota-SF-Michael_Berrer-Bernard_Tomic,2,S-XC,4,0,0,0,0,2,2,,,,,,,,,,
20150725-M-Bogota-SF-Michael_Berrer-Bernard_Tomic,2,S-DTM,1,0,0,0,0,0,1,,,,,,,,,,
20150725-M-Bogota-SF-Michael_Berrer-Bernard_Tomic,2,S-DTL,4,1,0,1,0,3,1,,,,,,,,,,
20150725-M-Bogota-SF-Michael_Berrer-Bernard_Tomic,2,S-IO,3,0,0,0,0,2,1,,,,,,,,,,
20150726-M-Bastad-F-Tommy_Robredo-Benoit_Paire,1,F-XC,54,8,2,3,3,33,21,,,,,,,,,,
20150726-M-Bastad-F-Tommy_Robredo-Benoit_Paire,1,F-DTM,54,3,0,0,3,27,27,,,,,,,,,,
20150726-M-Bastad-F-Tommy_Robredo-Benoit_Paire,1,F-DTL,14,0,0,0,0,7,7,,,,,,,,,,
20150726-M-Bastad-F-Tommy_Robredo-Benoit_Paire,1,F-IO,21,6,2,1,3,11,10,,,,,,,,,,
20150726-M-Bastad-F-Tommy_Robredo-Benoit_Paire,1,F-II,9,2,0,2,0,8,1,,,,,,,,,,
20150726-M-Bastad-F-Tommy_Robredo-Benoit_Paire,1,B-XC,15,3,1,1,1,7,8,,,,,,,,,,
20150726-M-Bastad-F-Tommy_Robredo-Benoit_Paire,1,B-DTM,32,3,0,0,3,12,20,,,,,,,,,,
20150726-M-Bastad-F-Tommy_Robredo-Benoit_Paire,1,B-DTL,11,3,2,0,1,4,7,,,,,,,,,,
20150726-M-Bastad-F-Tommy_Robredo-Benoit_Paire,1,B-IO,3,1,0,0,1,0,3,,,,,,,,,,
20150726-M-Bastad-F-Tommy_Robredo-Benoit_Paire,1,S-XC,2,0,0,0,0,0,2,,,,,,,,,,
20150726-M-Bastad-F-Tommy_Robredo-Benoit_Paire,1,S-DTM,13,1,0,0,1,3,10,,,,,,,,,,
20150726-M-Bastad-F-Tommy_Robredo-Benoit_Paire,1,S-DTL,7,3,0,0,3,2,5,,,,,,,,,,
20150726-M-Bastad-F-Tommy_Robredo-Benoit_Paire,2,F-XC,46,11,0,5,6,23,23,,,,,,,,,,
20150726-M-Bastad-F-Tommy_Robredo-Benoit_Paire,2,F-DTM,38,4,0,0,4,13,25,,,,,,,,,,
20150726-M-Bastad-F-Tommy_Robredo-Benoit_Paire,2,F-DTL,20,4,2,0,2,13,7,,,,,,,,,,
20150726-M-Bastad-F-Tommy_Robredo-Benoit_Paire,2,F-IO,13,2,1,0,1,8,5,,,,,,,,,,
20150726-M-Bastad-F-Tommy_Robredo-Benoit_Paire,2,F-II,1,0,0,0,0,1,0,,,,,,,,,,
20150726-M-Bastad-F-Tommy_Robredo-Benoit_Paire,2,B-XC,46,11,3,1,7,32,14,,,,,,,,,,
20150726-M-Bastad-F-Tommy_Robredo-Benoit_Paire,2,B-DTM,29,2,0,0,2,13,16,,,,,,,,,,
20150726-M-Bastad-F-Tommy_Robredo-Benoit_Paire,2,B-DTL,6,2,0,0,2,2,4,,,,,,,,,,
20150726-M-Bastad-F-Tommy_Robredo-Benoit_Paire,2,B-IO,14,4,4,0,0,11,3,,,,,,,,,,
20150726-M-Bastad-F-Tommy_Robredo-Benoit_Paire,2,S-DTM,2,0,0,0,0,0,2,,,,,,,,,,
20150726-M-Bogota-F-Bernard_Tomic-Adrian_Mannarino,1,F-XC,58,9,1,2,6,26,32,,,,,,,,,,
20150726-M-Bogota-F-Bernard_Tomic-Adrian_Mannarino,1,F-DTM,27,0,0,0,0,11,16,,,,,,,,,,
20150726-M-Bogota-F-Bernard_Tomic-Adrian_Mannarino,1,F-DTL,12,3,1,1,1,7,5,,,,,,,,,,
20150726-M-Bogota-F-Bernard_Tomic-Adrian_Mannarino,1,F-IO,26,5,1,2,2,15,11,,,,,,,,,,
20150726-M-Bogota-F-Bernard_Tomic-Adrian_Mannarino,1,F-II,1,1,1,0,0,1,0,,,,,,,,,,
20150726-M-Bogota-F-Bernard_Tomic-Adrian_Mannarino,1,B-XC,28,4,0,1,3,15,13,,,,,,,,,,
20150726-M-Bogota-F-Bernard_Tomic-Adrian_Mannarino,1,B-DTM,16,1,0,0,1,9,7,,,,,,,,,,
20150726-M-Bogota-F-Bernard_Tomic-Adrian_Mannarino,1,B-DTL,11,3,1,0,2,6,5,,,,,,,,,,
20150726-M-Bogota-F-Bernard_Tomic-Adrian_Mannarino,1,B-IO,14,2,0,0,2,6,8,,,,,,,,,,
20150726-M-Bogota-F-Bernard_Tomic-Adrian_Mannarino,1,S-XC,10,1,0,0,1,3,7,,,,,,,,,,
20150726-M-Bogota-F-Bernard_Tomic-Adrian_Mannarino,1,S-DTM,7,0,0,0,0,7,0,,,,,,,,,,
20150726-M-Bogota-F-Bernard_Tomic-Adrian_Mannarino,1,S-DTL,10,1,0,1,0,7,3,,,,,,,,,,
20150726-M-Bogota-F-Bernard_Tomic-Adrian_Mannarino,1,S-IO,3,0,0,0,0,2,1,,,,,,,,,,
20150726-M-Bogota-F-Bernard_Tomic-Adrian_Mannarino,2,F-XC,74,13,3,4,6,36,38,,,,,,,,,,
20150726-M-Bogota-F-Bernard_Tomic-Adrian_Mannarino,2,F-DTM,24,3,0,0,3,8,16,,,,,,,,,,
20150726-M-Bogota-F-Bernard_Tomic-Adrian_Mannarino,2,F-DTL,9,4,1,0,3,3,6,,,,,,,,,,
20150726-M-Bogota-F-Bernard_Tomic-Adrian_Mannarino,2,F-IO,9,3,2,1,0,6,3,,,,,,,,,,
20150726-M-Bogota-F-Bernard_Tomic-Adrian_Mannarino,2,B-XC,65,14,3,2,9,32,33,,,,,,,,,,
20150726-M-Bogota-F-Bernard_Tomic-Adrian_Mannarino,2,B-DTM,25,1,0,0,1,14,11,,,,,,,,,,
20150726-M-Bogota-F-Bernard_Tomic-Adrian_Mannarino,2,B-DTL,9,4,1,0,3,2,7,,,,,,,,,,
20150726-M-Bogota-F-Bernard_Tomic-Adrian_Mannarino,2,B-IO,4,0,0,0,0,4,0,,,,,,,,,,
20150726-M-Bogota-F-Bernard_Tomic-Adrian_Mannarino,2,B-II,2,1,1,0,0,1,1,,,,,,,,,,
20150726-M-Bogota-F-Bernard_Tomic-Adrian_Mannarino,2,S-XC,3,0,0,0,0,0,3,,,,,,,,,,
20150726-M-Bogota-F-Bernard_Tomic-Adrian_Mannarino,2,S-DTM,2,0,0,0,0,1,1,,,,,,,,,,
20150726-M-Bogota-F-Bernard_Tomic-Adrian_Mannarino,2,S-DTL,1,0,0,0,0,0,1,,,,,,,,,,
20150726-M-Bogota-F-Bernard_Tomic-Adrian_Mannarino,2,S-IO,3,0,0,0,0,0,3,,,,,,,,,,
20150805-M-Washington-R32-Steve_Johnson-Bernard_Tomic,1,F-XC,37,14,7,5,2,28,9,,,,,,,,,,
20150805-M-Washington-R32-Steve_Johnson-Bernard_Tomic,1,F-DTM,21,2,0,0,2,10,11,,,,,,,,,,
20150805-M-Washington-R32-Steve_Johnson-Bernard_Tomic,1,F-DTL,15,8,3,3,2,12,3,,,,,,,,,,
20150805-M-Washington-R32-Steve_Johnson-Bernard_Tomic,1,F-IO,23,6,3,1,2,14,9,,,,,,,,,,
20150805-M-Washington-R32-Steve_Johnson-Bernard_Tomic,1,F-II,7,1,0,0,1,4,3,,,,,,,,,,
20150805-M-Washington-R32-Steve_Johnson-Bernard_Tomic,1,B-XC,5,3,1,0,2,3,2,,,,,,,,,,
20150805-M-Washington-R32-Steve_Johnson-Bernard_Tomic,1,B-DTM,4,0,0,0,0,2,2,,,,,,,,,,
20150805-M-Washington-R32-Steve_Johnson-Bernard_Tomic,1,B-DTL,2,1,1,0,0,1,1,,,,,,,,,,
20150805-M-Washington-R32-Steve_Johnson-Bernard_Tomic,1,B-IO,1,1,0,1,0,1,0,,,,,,,,,,
20150805-M-Washington-R32-Steve_Johnson-Bernard_Tomic,1,S-XC,65,6,0,0,6,37,28,,,,,,,,,,
20150805-M-Washington-R32-Steve_Johnson-Bernard_Tomic,1,S-DTM,14,1,0,0,1,5,9,,,,,,,,,,
20150805-M-Washington-R32-Steve_Johnson-Bernard_Tomic,1,S-DTL,8,2,1,0,1,5,3,,,,,,,,,,
20150805-M-Washington-R32-Steve_Johnson-Bernard_Tomic,1,S-IO,3,1,0,0,1,1,2,,,,,,,,,,
20150805-M-Washington-R32-Steve_Johnson-Bernard_Tomic,2,F-XC,42,14,4,2,8,20,22,,,,,,,,,,
20150805-M-Washington-R32-Steve_Johnson-Bernard_Tomic,2,F-DTM,16,3,1,0,2,5,11,,,,,,,,,,
20150805-M-Washington-R32-Steve_Johnson-Bernard_Tomic,2,F-DTL,16,5,1,2,2,9,7,,,,,,,,,,
20150805-M-Washington-R32-Steve_Johnson-Bernard_Tomic,2,F-IO,48,8,3,2,3,29,19,,,,,,,,,,
20150805-M-Washington-R32-Steve_Johnson-Bernard_Tomic,2,F-II,4,2,2,0,0,4,0,,,,,,,,,,
20150805-M-Washington-R32-Steve_Johnson-Bernard_Tomic,2,B-XC,33,3,1,1,1,12,21,,,,,,,,,,
20150805-M-Washington-R32-Steve_Johnson-Bernard_Tomic,2,B-DTM,11,1,0,0,1,2,9,,,,,,,,,,
20150805-M-Washington-R32-Steve_Johnson-Bernard_Tomic,2,B-DTL,14,7,3,0,4,5,9,,,,,,,,,,
20150805-M-Washington-R32-Steve_Johnson-Bernard_Tomic,2,B-IO,1,0,0,0,0,1,0,,,,,,,,,,
20150805-M-Washington-R32-Steve_Johnson-Bernard_Tomic,2,S-XC,38,3,0,0,3,13,25,,,,,,,,,,
20150805-M-Washington-R32-Steve_Johnson-Bernard_Tomic,2,S-DTM,7,1,0,0,1,5,2,,,,,,,,,,
20150805-M-Washington-R32-Steve_Johnson-Bernard_Tomic,2,S-DTL,11,5,1,1,3,2,9,,,,,,,,,,
20150805-M-Washington-R32-Steve_Johnson-Bernard_Tomic,2,S-IO,1,0,0,0,0,0,1,,,,,,,,,,
20150806-M-Washington-R16-Steve_Johnson-Grigor_Dimitrov,1,F-XC,32,11,2,5,4,17,15,,,,,,,,,,
20150806-M-Washington-R16-Steve_Johnson-Grigor_Dimitrov,1,F-DTM,22,2,0,0,2,12,10,,,,,,,,,,
20150806-M-Washington-R16-Steve_Johnson-Grigor_Dimitrov,1,F-DTL,8,4,1,0,3,2,6,,,,,,,,,,
20150806-M-Washington-R16-Steve_Johnson-Grigor_Dimitrov,1,F-IO,12,3,0,1,2,7,5,,,,,,,,,,
20150806-M-Washington-R16-Steve_Johnson-Grigor_Dimitrov,1,F-II,5,5,1,4,0,5,0,,,,,,,,,,
20150806-M-Washington-R16-Steve_Johnson-Grigor_Dimitrov,1,B-XC,3,2,1,0,1,1,2,,,,,,,,,,
20150806-M-Washington-R16-Steve_Johnson-Grigor_Dimitrov,1,B-DTM,3,1,1,0,0,2,1,,,,,,,,,,
20150806-M-Washington-R16-Steve_Johnson-Grigor_Dimitrov,1,B-DTL,1,1,0,1,0,1,0,,,,,,,,,,
20150806-M-Washington-R16-Steve_Johnson-Grigor_Dimitrov,1,S-XC,17,4,1,2,1,11,6,,,,,,,,,,
20150806-M-Washington-R16-Steve_Johnson-Grigor_Dimitrov,1,S-DTM,7,0,0,0,0,2,5,,,,,,,,,,
20150806-M-Washington-R16-Steve_Johnson-Grigor_Dimitrov,2,F-XC,27,5,2,1,2,17,10,,,,,,,,,,
20150806-M-Washington-R16-Steve_Johnson-Grigor_Dimitrov,2,F-DTM,15,2,1,0,1,5,10,,,,,,,,,,
20150806-M-Washington-R16-Steve_Johnson-Grigor_Dimitrov,2,F-DTL,7,2,1,1,0,5,2,,,,,,,,,,
20150806-M-Washington-R16-Steve_Johnson-Grigor_Dimitrov,2,F-IO,27,12,3,3,6,12,15,,,,,,,,,,
20150806-M-Washington-R16-Steve_Johnson-Grigor_Dimitrov,2,F-II,5,2,0,2,0,2,3,,,,,,,,,,
20150806-M-Washington-R16-Steve_Johnson-Grigor_Dimitrov,2,B-XC,11,1,1,0,0,4,7,,,,,,,,,,
20150806-M-Washington-R16-Steve_Johnson-Grigor_Dimitrov,2,B-DTM,8,0,0,0,0,2,6,,,,,,,,,,
20150806-M-Washington-R16-Steve_Johnson-Grigor_Dimitrov,2,B-DTL,2,2,2,0,0,2,0,,,,,,,,,,
20150806-M-Washington-R16-Steve_Johnson-Grigor_Dimitrov,2,S-XC,6,3,0,0,3,1,5,,,,,,,,,,
20150806-M-Washington-R16-Steve_Johnson-Grigor_Dimitrov,2,S-DTM,6,0,0,0,0,3,3,,,,,,,,,,
20150806-M-Washington-R32-Alexandr_Dolgopolov-Ivo_Karlovic,1,F-XC,12,4,2,2,0,9,3,,,,,,,,,,
20150806-M-Washington-R32-Alexandr_Dolgopolov-Ivo_Karlovic,1,F-DTM,11,0,0,0,0,7,4,,,,,,,,,,
20150806-M-Washington-R32-Alexandr_Dolgopolov-Ivo_Karlovic,1,F-DTL,10,5,2,2,1,8,2,,,,,,,,,,
20150806-M-Washington-R32-Alexandr_Dolgopolov-Ivo_Karlovic,1,F-IO,22,7,3,4,0,16,6,,,,,,,,,,
20150806-M-Washington-R32-Alexandr_Dolgopolov-Ivo_Karlovic,1,B-XC,10,3,1,1,1,8,2,,,,,,,,,,
20150806-M-Washington-R32-Alexandr_Dolgopolov-Ivo_Karlovic,1,B-DTM,3,0,0,0,0,1,2,,,,,,,,,,
20150806-M-Washington-R32-Alexandr_Dolgopolov-Ivo_Karlovic,1,B-DTL,3,2,2,0,0,3,0,,,,,,,,,,
20150806-M-Washington-R32-Alexandr_Dolgopolov-Ivo_Karlovic,1,B-IO,1,1,1,0,0,1,0,,,,,,,,,,
20150806-M-Washington-R32-Alexandr_Dolgopolov-Ivo_Karlovic,1,S-XC,2,1,0,1,0,2,0,,,,,,,,,,
20150806-M-Washington-R32-Alexandr_Dolgopolov-Ivo_Karlovic,1,S-DTM,4,0,0,0,0,3,1,,,,,,,,,,
20150806-M-Washington-R32-Alexandr_Dolgopolov-Ivo_Karlovic,1,S-DTL,1,1,0,0,1,0,1,,,,,,,,,,
20150806-M-Washington-R32-Alexandr_Dolgopolov-Ivo_Karlovic,1,S-IO,1,0,0,0,0,1,0,,,,,,,,,,
20150806-M-Washington-R32-Alexandr_Dolgopolov-Ivo_Karlovic,2,F-XC,7,3,1,1,1,2,5,,,,,,,,,,
20150806-M-Washington-R32-Alexandr_Dolgopolov-Ivo_Karlovic,2,F-DTM,2,0,0,0,0,1,1,,,,,,,,,,
20150806-M-Washington-R32-Alexandr_Dolgopolov-Ivo_Karlovic,2,F-DTL,4,3,1,0,2,1,3,,,,,,,,,,
20150806-M-Washington-R32-Alexandr_Dolgopolov-Ivo_Karlovic,2,F-IO,7,5,1,0,4,2,5,,,,,,,,,,
20150806-M-Washington-R32-Alexandr_Dolgopolov-Ivo_Karlovic,2,F-II,1,0,0,0,0,0,1,,,,,,,,,,
20150806-M-Washington-R32-Alexandr_Dolgopolov-Ivo_Karlovic,2,B-DTM,1,0,0,0,0,0,1,,,,,,,,,,
20150806-M-Washington-R32-Alexandr_Dolgopolov-Ivo_Karlovic,2,S-XC,10,2,0,0,2,2,8,,,,,,,,,,
20150806-M-Washington-R32-Alexandr_Dolgopolov-Ivo_Karlovic,2,S-DTM,7,1,0,0,1,3,4,,,,,,,,,,
20150806-M-Washington-R32-Alexandr_Dolgopolov-Ivo_Karlovic,2,S-DTL,9,3,0,2,1,4,5,,,,,,,,,,
20150806-M-Washington-R32-Alexandr_Dolgopolov-Ivo_Karlovic,2,S-IO,4,1,0,0,1,1,3,,,,,,,,,,
20150810-M-Prague_CH-Q3-Rogerio_Dutra_Silva-Juan_Carlos_Saez,1,F-XC,19,5,4,1,0,16,3,,,,,,,,,,
20150810-M-Prague_CH-Q3-Rogerio_Dutra_Silva-Juan_Carlos_Saez,1,F-DTM,15,0,0,0,0,12,3,,,,,,,,,,
20150810-M-Prague_CH-Q3-Rogerio_Dutra_Silva-Juan_Carlos_Saez,1,F-DTL,2,1,0,1,0,2,0,,,,,,,,,,
20150810-M-Prague_CH-Q3-Rogerio_Dutra_Silva-Juan_Carlos_Saez,1,F-IO,13,1,1,0,0,12,1,,,,,,,,,,
20150810-M-Prague_CH-Q3-Rogerio_Dutra_Silva-Juan_Carlos_Saez,1,F-II,2,0,0,0,0,2,0,,,,,,,,,,
20150810-M-Prague_CH-Q3-Rogerio_Dutra_Silva-Juan_Carlos_Saez,1,B-XC,13,0,0,0,0,11,2,,,,,,,,,,
20150810-M-Prague_CH-Q3-Rogerio_Dutra_Silva-Juan_Carlos_Saez,1,B-DTM,8,1,0,0,1,7,1,,,,,,,,,,
20150810-M-Prague_CH-Q3-Rogerio_Dutra_Silva-Juan_Carlos_Saez,1,B-DTL,4,3,2,0,1,3,1,,,,,,,,,,
20150810-M-Prague_CH-Q3-Rogerio_Dutra_Silva-Juan_Carlos_Saez,1,S-XC,5,0,0,0,0,4,1,,,,,,,,,,
20150810-M-Prague_CH-Q3-Rogerio_Dutra_Silva-Juan_Carlos_Saez,1,S-DTM,3,0,0,0,0,2,1,,,,,,,,,,
20150810-M-Prague_CH-Q3-Rogerio_Dutra_Silva-Juan_Carlos_Saez,2,F-XC,17,3,0,1,2,4,13,,,,,,,,,,
20150810-M-Prague_CH-Q3-Rogerio_Dutra_Silva-Juan_Carlos_Saez,2,F-DTM,10,2,0,0,2,1,9,,,,,,,,,,
20150810-M-Prague_CH-Q3-Rogerio_Dutra_Silva-Juan_Carlos_Saez,2,F-DTL,5,1,1,0,0,2,3,,,,,,,,,,
20150810-M-Prague_CH-Q3-Rogerio_Dutra_Silva-Juan_Carlos_Saez,2,F-IO,21,11,0,0,11,1,20,,,,,,,,,,
20150810-M-Prague_CH-Q3-Rogerio_Dutra_Silva-Juan_Carlos_Saez,2,F-II,7,3,1,0,2,2,5,,,,,,,,,,
20150810-M-Prague_CH-Q3-Rogerio_Dutra_Silva-Juan_Carlos_Saez,2,B-XC,17,1,0,1,0,4,13,,,,,,,,,,
20150810-M-Prague_CH-Q3-Rogerio_Dutra_Silva-Juan_Carlos_Saez,2,B-DTM,16,4,0,0,4,2,14,,,,,,,,,,
20150810-M-Prague_CH-Q3-Rogerio_Dutra_Silva-Juan_Carlos_Saez,2,B-DTL,3,2,0,0,2,1,2,,,,,,,,,,
20150810-M-Prague_CH-Q3-Rogerio_Dutra_Silva-Juan_Carlos_Saez,2,B-IO,1,0,0,0,0,0,1,,,,,,,,,,
20150810-M-Prague_CH-Q3-Rogerio_Dutra_Silva-Juan_Carlos_Saez,2,S-DTM,1,1,0,0,1,0,1,,,,,,,,,,
20150822-M-Cincinnati-SF-Novak_Djokovic-Alexandr_Dolgopolov,1,F-XC,50,8,2,3,3,37,13,,,,,,,,,,
20150822-M-Cincinnati-SF-Novak_Djokovic-Alexandr_Dolgopolov,1,F-DTM,36,1,0,0,1,18,18,,,,,,,,,,
20150822-M-Cincinnati-SF-Novak_Djokovic-Alexandr_Dolgopolov,1,F-DTL,12,2,0,0,2,5,7,,,,,,,,,,
20150822-M-Cincinnati-SF-Novak_Djokovic-Alexandr_Dolgopolov,1,F-IO,18,3,0,2,1,13,5,,,,,,,,,,
20150822-M-Cincinnati-SF-Novak_Djokovic-Alexandr_Dolgopolov,1,F-II,1,0,0,0,0,0,1,,,,,,,,,,
20150822-M-Cincinnati-SF-Novak_Djokovic-Alexandr_Dolgopolov,1,B-XC,76,5,1,0,4,39,37,,,,,,,,,,
20150822-M-Cincinnati-SF-Novak_Djokovic-Alexandr_Dolgopolov,1,B-DTM,48,4,0,2,2,27,21,,,,,,,,,,
20150822-M-Cincinnati-SF-Novak_Djokovic-Alexandr_Dolgopolov,1,B-DTL,14,7,0,0,7,5,9,,,,,,,,,,
20150822-M-Cincinnati-SF-Novak_Djokovic-Alexandr_Dolgopolov,1,B-IO,15,4,0,2,2,6,9,,,,,,,,,,
20150822-M-Cincinnati-SF-Novak_Djokovic-Alexandr_Dolgopolov,1,S-XC,15,0,0,0,0,8,7,,,,,,,,,,
20150822-M-Cincinnati-SF-Novak_Djokovic-Alexandr_Dolgopolov,1,S-DTM,9,0,0,0,0,6,3,,,,,,,,,,
20150822-M-Cincinnati-SF-Novak_Djokovic-Alexandr_Dolgopolov,1,S-DTL,1,0,0,0,0,1,0,,,,,,,,,,
20150822-M-Cincinnati-SF-Novak_Djokovic-Alexandr_Dolgopolov,2,F-XC,77,24,7,1,16,31,46,,,,,,,,,,
20150822-M-Cincinnati-SF-Novak_Djokovic-Alexandr_Dolgopolov,2,F-DTM,17,4,0,0,4,4,13,,,,,,,,,,
20150822-M-Cincinnati-SF-Novak_Djokovic-Alexandr_Dolgopolov,2,F-DTL,16,11,4,1,6,7,9,,,,,,,,,,
20150822-M-Cincinnati-SF-Novak_Djokovic-Alexandr_Dolgopolov,2,F-IO,29,11,5,1,5,12,17,,,,,,,,,,
20150822-M-Cincinnati-SF-Novak_Djokovic-Alexandr_Dolgopolov,2,F-II,1,1,1,0,0,1,0,,,,,,,,,,
20150822-M-Cincinnati-SF-Novak_Djokovic-Alexandr_Dolgopolov,2,B-XC,84,10,1,1,8,38,46,,,,,,,,,,
20150822-M-Cincinnati-SF-Novak_Djokovic-Alexandr_Dolgopolov,2,B-DTM,67,5,1,0,4,32,35,,,,,,,,,,
20150822-M-Cincinnati-SF-Novak_Djokovic-Alexandr_Dolgopolov,2,B-DTL,11,6,3,1,2,7,4,,,,,,,,,,
20150822-M-Cincinnati-SF-Novak_Djokovic-Alexandr_Dolgopolov,2,B-IO,1,1,0,0,1,0,1,,,,,,,,,,
20150822-M-Cincinnati-SF-Novak_Djokovic-Alexandr_Dolgopolov,2,S-XC,4,0,0,0,0,1,3,,,,,,,,,,
20150822-M-Cincinnati-SF-Novak_Djokovic-Alexandr_Dolgopolov,2,S-DTM,6,0,0,0,0,3,3,,,,,,,,,,
20150822-M-Cincinnati-SF-Novak_Djokovic-Alexandr_Dolgopolov,2,S-DTL,2,1,0,0,1,1,1,,,,,,,,,,
20150824-M-Manerbio_CH-R32-Antonio_Veic-Andrey_Kuznetsov,1,F-XC,19,5,2,0,3,8,11,,,,,,,,,,
20150824-M-Manerbio_CH-R32-Antonio_Veic-Andrey_Kuznetsov,1,F-DTM,15,2,0,1,1,5,10,,,,,,,,,,
20150824-M-Manerbio_CH-R32-Antonio_Veic-Andrey_Kuznetsov,1,F-DTL,5,1,0,0,1,1,4,,,,,,,,,,
20150824-M-Manerbio_CH-R32-Antonio_Veic-Andrey_Kuznetsov,1,F-IO,17,4,2,2,0,10,7,,,,,,,,,,
20150824-M-Manerbio_CH-R32-Antonio_Veic-Andrey_Kuznetsov,1,B-XC,17,1,1,0,0,4,13,,,,,,,,,,
20150824-M-Manerbio_CH-R32-Antonio_Veic-Andrey_Kuznetsov,1,B-DTM,18,6,0,1,5,2,16,,,,,,,,,,
20150824-M-Manerbio_CH-R32-Antonio_Veic-Andrey_Kuznetsov,1,B-DTL,3,2,0,0,2,0,3,,,,,,,,,,
20150824-M-Manerbio_CH-R32-Antonio_Veic-Andrey_Kuznetsov,1,S-XC,9,0,0,0,0,3,6,,,,,,,,,,
20150824-M-Manerbio_CH-R32-Antonio_Veic-Andrey_Kuznetsov,1,S-DTM,1,1,0,0,1,0,1,,,,,,,,,,
20150824-M-Manerbio_CH-R32-Antonio_Veic-Andrey_Kuznetsov,2,F-XC,29,11,6,4,1,25,4,,,,,,,,,,
20150824-M-Manerbio_CH-R32-Antonio_Veic-Andrey_Kuznetsov,2,F-DTM,9,1,0,1,0,5,4,,,,,,,,,,
20150824-M-Manerbio_CH-R32-Antonio_Veic-Andrey_Kuznetsov,2,F-DTL,4,1,0,0,1,3,1,,,,,,,,,,
20150824-M-Manerbio_CH-R32-Antonio_Veic-Andrey_Kuznetsov,2,F-IO,10,5,2,1,2,7,3,,,,,,,,,,
20150824-M-Manerbio_CH-R32-Antonio_Veic-Andrey_Kuznetsov,2,F-II,1,0,0,0,0,1,0,,,,,,,,,,
20150824-M-Manerbio_CH-R32-Antonio_Veic-Andrey_Kuznetsov,2,B-XC,29,5,3,1,1,24,5,,,,,,,,,,
20150824-M-Manerbio_CH-R32-Antonio_Veic-Andrey_Kuznetsov,2,B-DTM,10,1,0,0,1,4,6,,,,,,,,,,
20150824-M-Manerbio_CH-R32-Antonio_Veic-Andrey_Kuznetsov,2,B-DTL,5,3,2,0,1,4,1,,,,,,,,,,
20150824-M-Manerbio_CH-R32-Antonio_Veic-Andrey_Kuznetsov,2,B-IO,2,0,0,0,0,2,0,,,,,,,,,,
20150824-M-Manerbio_CH-R32-Antonio_Veic-Andrey_Kuznetsov,2,S-XC,2,0,0,0,0,0,2,,,,,,,,,,
20150824-M-Manerbio_CH-R32-Antonio_Veic-Andrey_Kuznetsov,2,S-DTM,3,0,0,0,0,1,2,,,,,,,,,,
20150824-M-Manerbio_CH-R32-Antonio_Veic-Andrey_Kuznetsov,2,S-DTL,3,3,0,1,2,1,2,,,,,,,,,,
20150829-M-Winston_Salem-F-Pierre_Hugues_Herbert-Kevin_Anderson,1,F-XC,12,6,2,0,4,5,7,,,,,,,,,,
20150829-M-Winston_Salem-F-Pierre_Hugues_Herbert-Kevin_Anderson,1,F-DTM,8,2,0,0,2,3,5,,,,,,,,,,
20150829-M-Winston_Salem-F-Pierre_Hugues_Herbert-Kevin_Anderson,1,F-DTL,3,0,0,0,0,3,0,,,,,,,,,,
20150829-M-Winston_Salem-F-Pierre_Hugues_Herbert-Kevin_Anderson,1,F-IO,14,3,0,0,3,6,8,,,,,,,,,,
20150829-M-Winston_Salem-F-Pierre_Hugues_Herbert-Kevin_Anderson,1,B-XC,6,1,0,0,1,3,3,,,,,,,,,,
20150829-M-Winston_Salem-F-Pierre_Hugues_Herbert-Kevin_Anderson,1,B-DTM,6,0,0,0,0,4,2,,,,,,,,,,
20150829-M-Winston_Salem-F-Pierre_Hugues_Herbert-Kevin_Anderson,1,B-DTL,2,1,0,0,1,1,1,,,,,,,,,,
20150829-M-Winston_Salem-F-Pierre_Hugues_Herbert-Kevin_Anderson,1,S-XC,8,2,0,0,2,0,8,,,,,,,,,,
20150829-M-Winston_Salem-F-Pierre_Hugues_Herbert-Kevin_Anderson,1,S-DTM,9,1,0,0,1,3,6,,,,,,,,,,
20150829-M-Winston_Salem-F-Pierre_Hugues_Herbert-Kevin_Anderson,1,S-DTL,1,1,0,1,0,1,0,,,,,,,,,,
20150829-M-Winston_Salem-F-Pierre_Hugues_Herbert-Kevin_Anderson,1,S-IO,2,0,0,0,0,0,2,,,,,,,,,,
20150829-M-Winston_Salem-F-Pierre_Hugues_Herbert-Kevin_Anderson,2,F-XC,23,13,8,2,3,15,8,,,,,,,,,,
20150829-M-Winston_Salem-F-Pierre_Hugues_Herbert-Kevin_Anderson,2,F-DTM,18,1,0,0,1,11,7,,,,,,,,,,
20150829-M-Winston_Salem-F-Pierre_Hugues_Herbert-Kevin_Anderson,2,F-DTL,1,1,0,1,0,1,0,,,,,,,,,,
20150829-M-Winston_Salem-F-Pierre_Hugues_Herbert-Kevin_Anderson,2,F-IO,16,4,1,1,2,9,7,,,,,,,,,,
20150829-M-Winston_Salem-F-Pierre_Hugues_Herbert-Kevin_Anderson,2,B-XC,10,0,0,0,0,6,4,,,,,,,,,,
20150829-M-Winston_Salem-F-Pierre_Hugues_Herbert-Kevin_Anderson,2,B-DTM,10,0,0,0,0,6,4,,,,,,,,,,
20150829-M-Winston_Salem-F-Pierre_Hugues_Herbert-Kevin_Anderson,2,B-DTL,4,2,2,0,0,3,1,,,,,,,,,,
20150829-M-Winston_Salem-F-Pierre_Hugues_Herbert-Kevin_Anderson,2,S-XC,3,1,1,0,0,2,1,,,,,,,,,,
20150831-M-US_Open-R128-Tim_Smyczek-Milos_Raonic,1,F-XC,23,7,0,3,4,11,12,,,,,,,,,,
20150831-M-US_Open-R128-Tim_Smyczek-Milos_Raonic,1,F-DTM,18,1,0,0,1,13,5,,,,,,,,,,
20150831-M-US_Open-R128-Tim_Smyczek-Milos_Raonic,1,F-DTL,7,3,3,0,0,7,0,,,,,,,,,,
20150831-M-US_Open-R128-Tim_Smyczek-Milos_Raonic,1,F-IO,24,8,0,1,7,7,17,,,,,,,,,,
20150831-M-US_Open-R128-Tim_Smyczek-Milos_Raonic,1,F-II,1,1,1,0,0,1,0,,,,,,,,,,
20150831-M-US_Open-R128-Tim_Smyczek-Milos_Raonic,1,B-XC,22,1,0,1,0,14,8,,,,,,,,,,
20150831-M-US_Open-R128-Tim_Smyczek-Milos_Raonic,1,B-DTM,14,3,0,0,3,7,7,,,,,,,,,,
20150831-M-US_Open-R128-Tim_Smyczek-Milos_Raonic,1,B-DTL,3,3,2,0,1,2,1,,,,,,,,,,
20150831-M-US_Open-R128-Tim_Smyczek-Milos_Raonic,1,B-IO,1,1,0,1,0,1,0,,,,,,,,,,
20150831-M-US_Open-R128-Tim_Smyczek-Milos_Raonic,1,S-XC,1,0,0,0,0,1,0,,,,,,,,,,
20150831-M-US_Open-R128-Tim_Smyczek-Milos_Raonic,1,S-DTM,3,0,0,0,0,1,2,,,,,,,,,,
20150831-M-US_Open-R128-Tim_Smyczek-Milos_Raonic,2,F-XC,21,7,0,2,5,10,11,,,,,,,,,,
20150831-M-US_Open-R128-Tim_Smyczek-Milos_Raonic,2,F-DTM,8,2,0,0,2,1,7,,,,,,,,,,
20150831-M-US_Open-R128-Tim_Smyczek-Milos_Raonic,2,F-DTL,8,6,3,1,2,5,3,,,,,,,,,,
20150831-M-US_Open-R128-Tim_Smyczek-Milos_Raonic,2,F-IO,31,14,5,4,5,16,15,,,,,,,,,,
20150831-M-US_Open-R128-Tim_Smyczek-Milos_Raonic,2,F-II,8,6,0,3,3,3,5,,,,,,,,,,
20150831-M-US_Open-R128-Tim_Smyczek-Milos_Raonic,2,B-XC,12,2,0,1,1,6,6,,,,,,,,,,
20150831-M-US_Open-R128-Tim_Smyczek-Milos_Raonic,2,B-DTM,13,3,0,0,3,4,9,,,,,,,,,,
20150831-M-US_Open-R128-Tim_Smyczek-Milos_Raonic,2,B-DTL,3,2,1,0,1,2,1,,,,,,,,,,
20150831-M-US_Open-R128-Tim_Smyczek-Milos_Raonic,2,B-IO,1,1,0,0,1,0,1,,,,,,,,,,
20150831-M-US_Open-R128-Tim_Smyczek-Milos_Raonic,2,S-XC,4,1,0,0,1,2,2,,,,,,,,,,
20150831-M-US_Open-R128-Tim_Smyczek-Milos_Raonic,2,S-DTM,2,0,0,0,0,1,1,,,,,,,,,,
20150831-M-US_Open-R128-Tim_Smyczek-Milos_Raonic,2,S-DTL,1,0,0,0,0,0,1,,,,,,,,,,
20150901-M-US_Open-R128-Roger_Federer-Leonardo_Mayer,1,F-XC,14,5,1,1,3,9,5,,,,,,,,,,
20150901-M-US_Open-R128-Roger_Federer-Leonardo_Mayer,1,F-DTM,11,1,0,1,0,9,2,,,,,,,,,,
20150901-M-US_Open-R128-Roger_Federer-Leonardo_Mayer,1,F-DTL,2,0,0,0,0,2,0,,,,,,,,,,
20150901-M-US_Open-R128-Roger_Federer-Leonardo_Mayer,1,F-IO,13,6,1,4,1,10,3,,,,,,,,,,
20150901-M-US_Open-R128-Roger_Federer-Leonardo_Mayer,1,F-II,3,2,1,0,1,2,1,,,,,,,,,,
20150901-M-US_Open-R128-Roger_Federer-Leonardo_Mayer,1,B-XC,8,2,0,1,1,7,1,,,,,,,,,,
20150901-M-US_Open-R128-Roger_Federer-Leonardo_Mayer,1,B-DTM,10,1,0,0,1,6,4,,,,,,,,,,
20150901-M-US_Open-R128-Roger_Federer-Leonardo_Mayer,1,B-DTL,2,2,0,1,1,1,1,,,,,,,,,,
20150901-M-US_Open-R128-Roger_Federer-Leonardo_Mayer,1,B-IO,1,0,0,0,0,1,0,,,,,,,,,,
20150901-M-US_Open-R128-Roger_Federer-Leonardo_Mayer,1,S-XC,8,1,1,0,0,4,4,,,,,,,,,,
20150901-M-US_Open-R128-Roger_Federer-Leonardo_Mayer,1,S-DTL,1,0,0,0,0,0,1,,,,,,,,,,
20150901-M-US_Open-R128-Roger_Federer-Leonardo_Mayer,1,S-IO,1,1,1,0,0,1,0,,,,,,,,,,
20150901-M-US_Open-R128-Roger_Federer-Leonardo_Mayer,2,F-XC,20,10,2,4,4,9,11,,,,,,,,,,
20150901-M-US_Open-R128-Roger_Federer-Leonardo_Mayer,2,F-DTM,13,2,0,0,2,3,10,,,,,,,,,,
20150901-M-US_Open-R128-Roger_Federer-Leonardo_Mayer,2,F-DTL,3,1,0,0,1,0,3,,,,,,,,,,
20150901-M-US_Open-R128-Roger_Federer-Leonardo_Mayer,2,F-IO,17,7,2,1,4,7,10,,,,,,,,,,
20150901-M-US_Open-R128-Roger_Federer-Leonardo_Mayer,2,F-II,3,2,1,1,0,2,1,,,,,,,,,,
20150901-M-US_Open-R128-Roger_Federer-Leonardo_Mayer,2,B-XC,15,5,2,0,3,6,9,,,,,,,,,,
20150901-M-US_Open-R128-Roger_Federer-Leonardo_Mayer,2,B-DTM,12,2,0,2,0,6,6,,,,,,,,,,
20150901-M-US_Open-R128-Roger_Federer-Leonardo_Mayer,2,B-DTL,6,6,3,0,3,3,3,,,,,,,,,,
20150901-M-US_Open-R128-Roger_Federer-Leonardo_Mayer,2,B-IO,1,1,0,0,1,0,1,,,,,,,,,,
20150901-M-US_Open-R128-Roger_Federer-Leonardo_Mayer,2,S-XC,2,0,0,0,0,0,2,,,,,,,,,,
20150902-M-US_Open-R64-Fernando_Verdasco-Milos_Raonic,1,F-XC,44,10,1,7,2,25,19,,,,,,,,,,
20150902-M-US_Open-R64-Fernando_Verdasco-Milos_Raonic,1,F-DTM,17,1,0,0,1,6,11,,,,,,,,,,
20150902-M-US_Open-R64-Fernando_Verdasco-Milos_Raonic,1,F-DTL,13,8,3,1,4,5,8,,,,,,,,,,
20150902-M-US_Open-R64-Fernando_Verdasco-Milos_Raonic,1,F-IO,13,7,4,3,0,11,2,,,,,,,,,,
20150902-M-US_Open-R64-Fernando_Verdasco-Milos_Raonic,1,F-II,4,1,0,0,1,0,4,,,,,,,,,,
20150902-M-US_Open-R64-Fernando_Verdasco-Milos_Raonic,1,B-XC,16,4,1,1,2,10,6,,,,,,,,,,
20150902-M-US_Open-R64-Fernando_Verdasco-Milos_Raonic,1,B-DTM,20,2,0,0,2,6,14,,,,,,,,,,
20150902-M-US_Open-R64-Fernando_Verdasco-Milos_Raonic,1,B-DTL,9,1,0,0,1,3,6,,,,,,,,,,
20150902-M-US_Open-R64-Fernando_Verdasco-Milos_Raonic,1,B-IO,6,0,0,0,0,1,5,,,,,,,,,,
20150902-M-US_Open-R64-Fernando_Verdasco-Milos_Raonic,1,B-II,1,0,0,0,0,0,1,,,,,,,,,,
20150902-M-US_Open-R64-Fernando_Verdasco-Milos_Raonic,1,S-XC,9,3,2,0,1,5,4,,,,,,,,,,
20150902-M-US_Open-R64-Fernando_Verdasco-Milos_Raonic,1,S-DTM,8,0,0,0,0,2,6,,,,,,,,,,
20150902-M-US_Open-R64-Fernando_Verdasco-Milos_Raonic,1,S-DTL,5,2,0,0,2,2,3,,,,,,,,,,
20150902-M-US_Open-R64-Fernando_Verdasco-Milos_Raonic,2,F-XC,39,15,3,7,5,26,13,,,,,,,,,,
20150902-M-US_Open-R64-Fernando_Verdasco-Milos_Raonic,2,F-DTM,17,3,0,0,3,5,12,,,,,,,,,,
20150902-M-US_Open-R64-Fernando_Verdasco-Milos_Raonic,2,F-DTL,18,12,4,3,5,11,7,,,,,,,,,,
20150902-M-US_Open-R64-Fernando_Verdasco-Milos_Raonic,2,F-IO,27,14,5,5,4,22,5,,,,,,,,,,
20150902-M-US_Open-R64-Fernando_Verdasco-Milos_Raonic,2,F-II,13,2,0,1,1,9,4,,,,,,,,,,
20150902-M-US_Open-R64-Fernando_Verdasco-Milos_Raonic,2,B-XC,18,5,1,1,3,12,6,,,,,,,,,,
20150902-M-US_Open-R64-Fernando_Verdasco-Milos_Raonic,2,B-DTM,16,3,0,0,3,5,11,,,,,,,,,,
20150902-M-US_Open-R64-Fernando_Verdasco-Milos_Raonic,2,B-DTL,14,8,3,1,4,9,5,,,,,,,,,,
20150902-M-US_Open-R64-Fernando_Verdasco-Milos_Raonic,2,B-IO,1,0,0,0,0,0,1,,,,,,,,,,
20150902-M-US_Open-R64-Fernando_Verdasco-Milos_Raonic,2,S-XC,7,3,1,1,1,5,2,,,,,,,,,,
20150902-M-US_Open-R64-Fernando_Verdasco-Milos_Raonic,2,S-DTM,3,2,0,1,1,1,2,,,,,,,,,,
20150902-M-US_Open-R64-Fernando_Verdasco-Milos_Raonic,2,S-DTL,1,0,0,0,0,1,0,,,,,,,,,,
20150902-M-US_Open-R64-Fernando_Verdasco-Milos_Raonic,2,S-IO,1,1,0,1,0,1,0,,,,,,,,,,
20150903-M-US_Open-R64-Bernard_Tomic-Lleyton_Hewitt,1,F-XC,85,23,7,5,11,45,40,,,,,,,,,,
20150903-M-US_Open-R64-Bernard_Tomic-Lleyton_Hewitt,1,F-DTM,30,1,0,1,0,13,17,,,,,,,,,,
20150903-M-US_Open-R64-Bernard_Tomic-Lleyton_Hewitt,1,F-DTL,36,12,2,1,9,15,21,,,,,,,,,,
20150903-M-US_Open-R64-Bernard_Tomic-Lleyton_Hewitt,1,F-IO,56,11,6,2,3,31,25,,,,,,,,,,
20150903-M-US_Open-R64-Bernard_Tomic-Lleyton_Hewitt,1,F-II,9,2,1,0,1,6,3,,,,,,,,,,
20150903-M-US_Open-R64-Bernard_Tomic-Lleyton_Hewitt,1,B-XC,57,12,1,0,11,26,31,,,,,,,,,,
20150903-M-US_Open-R64-Bernard_Tomic-Lleyton_Hewitt,1,B-DTM,24,3,0,0,3,9,15,,,,,,,,,,
20150903-M-US_Open-R64-Bernard_Tomic-Lleyton_Hewitt,1,B-DTL,35,14,2,1,11,13,22,,,,,,,,,,
20150903-M-US_Open-R64-Bernard_Tomic-Lleyton_Hewitt,1,B-IO,6,1,0,0,1,2,4,,,,,,,,,,
20150903-M-US_Open-R64-Bernard_Tomic-Lleyton_Hewitt,1,S-XC,42,2,0,0,2,25,17,,,,,,,,,,
20150903-M-US_Open-R64-Bernard_Tomic-Lleyton_Hewitt,1,S-DTM,32,0,0,0,0,12,20,,,,,,,,,,
20150903-M-US_Open-R64-Bernard_Tomic-Lleyton_Hewitt,1,S-DTL,15,2,0,0,2,6,9,,,,,,,,,,
20150903-M-US_Open-R64-Bernard_Tomic-Lleyton_Hewitt,1,S-IO,8,1,0,0,1,4,4,,,,,,,,,,
20150903-M-US_Open-R64-Bernard_Tomic-Lleyton_Hewitt,2,F-XC,93,22,7,3,12,53,40,,,,,,,,,,
20150903-M-US_Open-R64-Bernard_Tomic-Lleyton_Hewitt,2,F-DTM,33,5,0,0,5,12,21,,,,,,,,,,
20150903-M-US_Open-R64-Bernard_Tomic-Lleyton_Hewitt,2,F-DTL,38,12,3,2,7,21,17,,,,,,,,,,
20150903-M-US_Open-R64-Bernard_Tomic-Lleyton_Hewitt,2,F-IO,61,16,7,2,7,35,26,,,,,,,,,,
20150903-M-US_Open-R64-Bernard_Tomic-Lleyton_Hewitt,2,F-II,6,3,1,0,2,2,4,,,,,,,,,,
20150903-M-US_Open-R64-Bernard_Tomic-Lleyton_Hewitt,2,B-XC,59,10,1,2,7,27,32,,,,,,,,,,
20150903-M-US_Open-R64-Bernard_Tomic-Lleyton_Hewitt,2,B-DTM,36,5,1,1,3,19,17,,,,,,,,,,
20150903-M-US_Open-R64-Bernard_Tomic-Lleyton_Hewitt,2,B-DTL,12,6,1,0,5,2,10,,,,,,,,,,
20150903-M-US_Open-R64-Bernard_Tomic-Lleyton_Hewitt,2,B-IO,11,2,0,0,2,6,5,,,,,,,,,,
20150903-M-US_Open-R64-Bernard_Tomic-Lleyton_Hewitt,2,S-XC,52,3,0,1,2,27,25,,,,,,,,,,
20150903-M-US_Open-R64-Bernard_Tomic-Lleyton_Hewitt,2,S-DTM,18,0,0,0,0,7,11,,,,,,,,,,
20150903-M-US_Open-R64-Bernard_Tomic-Lleyton_Hewitt,2,S-DTL,6,1,0,0,1,1,5,,,,,,,,,,
20150903-M-US_Open-R64-Bernard_Tomic-Lleyton_Hewitt,2,S-IO,3,0,0,0,0,1,2,,,,,,,,,,
20150903-M-US_Open-R64-Bernard_Tomic-Lleyton_Hewitt,2,S-II,1,0,0,0,0,0,1,,,,,,,,,,
20150903-M-US_Open-R64-Steve_Darcis-Roger_Federer,1,F-XC,14,6,1,3,2,6,8,,,,,,,,,,
20150903-M-US_Open-R64-Steve_Darcis-Roger_Federer,1,F-DTM,23,1,0,0,1,8,15,,,,,,,,,,
20150903-M-US_Open-R64-Steve_Darcis-Roger_Federer,1,F-DTL,7,1,0,0,1,0,7,,,,,,,,,,
20150903-M-US_Open-R64-Steve_Darcis-Roger_Federer,1,F-IO,22,6,0,2,4,6,16,,,,,,,,,,
20150903-M-US_Open-R64-Steve_Darcis-Roger_Federer,1,B-XC,14,3,1,1,1,3,11,,,,,,,,,,
20150903-M-US_Open-R64-Steve_Darcis-Roger_Federer,1,B-DTM,9,2,0,0,2,1,8,,,,,,,,,,
20150903-M-US_Open-R64-Steve_Darcis-Roger_Federer,1,S-XC,25,1,1,0,0,3,22,,,,,,,,,,
20150903-M-US_Open-R64-Steve_Darcis-Roger_Federer,1,S-DTM,8,1,0,0,1,2,6,,,,,,,,,,
20150903-M-US_Open-R64-Steve_Darcis-Roger_Federer,1,S-DTL,4,1,0,1,0,3,1,,,,,,,,,,
20150903-M-US_Open-R64-Steve_Darcis-Roger_Federer,2,F-XC,13,4,1,2,1,11,2,,,,,,,,,,
20150903-M-US_Open-R64-Steve_Darcis-Roger_Federer,2,F-DTM,18,6,2,2,2,11,7,,,,,,,,,,
20150903-M-US_Open-R64-Steve_Darcis-Roger_Federer,2,F-DTL,6,4,3,0,1,5,1,,,,,,,,,,
20150903-M-US_Open-R64-Steve_Darcis-Roger_Federer,2,F-IO,20,8,3,2,3,16,4,,,,,,,,,,
20150903-M-US_Open-R64-Steve_Darcis-Roger_Federer,2,F-II,6,2,0,2,0,6,0,,,,,,,,,,
20150903-M-US_Open-R64-Steve_Darcis-Roger_Federer,2,B-XC,15,3,2,1,0,13,2,,,,,,,,,,
20150903-M-US_Open-R64-Steve_Darcis-Roger_Federer,2,B-DTM,15,5,0,1,4,8,7,,,,,,,,,,
20150903-M-US_Open-R64-Steve_Darcis-Roger_Federer,2,B-DTL,4,2,1,0,1,3,1,,,,,,,,,,
20150903-M-US_Open-R64-Steve_Darcis-Roger_Federer,2,B-IO,1,1,1,0,0,1,0,,,,,,,,,,
20150903-M-US_Open-R64-Steve_Darcis-Roger_Federer,2,S-XC,17,1,1,0,0,16,1,,,,,,,,,,
20150903-M-US_Open-R64-Steve_Darcis-Roger_Federer,2,S-DTM,4,1,0,1,0,3,1,,,,,,,,,,
20150903-M-US_Open-R64-Steve_Darcis-Roger_Federer,2,S-IO,1,0,0,0,0,1,0,,,,,,,,,,
20150905-M-US_Open-R32-Roger_Federer-Philipp_Kohlschreiber,1,F-XC,17,8,5,0,3,11,6,,,,,,,,,,
20150905-M-US_Open-R32-Roger_Federer-Philipp_Kohlschreiber,1,F-DTM,13,1,0,0,1,7,6,,,,,,,,,,
20150905-M-US_Open-R32-Roger_Federer-Philipp_Kohlschreiber,1,F-DTL,8,3,1,0,2,4,4,,,,,,,,,,
20150905-M-US_Open-R32-Roger_Federer-Philipp_Kohlschreiber,1,F-IO,14,5,0,1,4,7,7,,,,,,,,,,
20150905-M-US_Open-R32-Roger_Federer-Philipp_Kohlschreiber,1,F-II,6,4,3,0,1,3,3,,,,,,,,,,
20150905-M-US_Open-R32-Roger_Federer-Philipp_Kohlschreiber,1,B-XC,18,4,1,1,2,14,4,,,,,,,,,,
20150905-M-US_Open-R32-Roger_Federer-Philipp_Kohlschreiber,1,B-DTM,19,3,1,1,1,8,11,,,,,,,,,,
20150905-M-US_Open-R32-Roger_Federer-Philipp_Kohlschreiber,1,B-DTL,5,3,0,2,1,3,2,,,,,,,,,,
20150905-M-US_Open-R32-Roger_Federer-Philipp_Kohlschreiber,1,S-XC,10,1,0,1,0,3,7,,,,,,,,,,
20150905-M-US_Open-R32-Roger_Federer-Philipp_Kohlschreiber,1,S-DTM,3,0,0,0,0,1,2,,,,,,,,,,
20150905-M-US_Open-R32-Roger_Federer-Philipp_Kohlschreiber,1,S-DTL,2,0,0,0,0,0,2,,,,,,,,,,
20150905-M-US_Open-R32-Roger_Federer-Philipp_Kohlschreiber,2,F-XC,20,10,3,5,2,12,8,,,,,,,,,,
20150905-M-US_Open-R32-Roger_Federer-Philipp_Kohlschreiber,2,F-DTM,16,2,1,0,1,8,8,,,,,,,,,,
20150905-M-US_Open-R32-Roger_Federer-Philipp_Kohlschreiber,2,F-DTL,9,4,2,1,1,4,5,,,,,,,,,,
20150905-M-US_Open-R32-Roger_Federer-Philipp_Kohlschreiber,2,F-IO,23,4,2,1,1,15,8,,,,,,,,,,
20150905-M-US_Open-R32-Roger_Federer-Philipp_Kohlschreiber,2,F-II,3,2,0,1,1,2,1,,,,,,,,,,
20150905-M-US_Open-R32-Roger_Federer-Philipp_Kohlschreiber,2,B-XC,21,6,0,2,4,8,13,,,,,,,,,,
20150905-M-US_Open-R32-Roger_Federer-Philipp_Kohlschreiber,2,B-DTM,12,4,1,1,2,5,7,,,,,,,,,,
20150905-M-US_Open-R32-Roger_Federer-Philipp_Kohlschreiber,2,B-DTL,9,4,0,1,3,3,6,,,,,,,,,,
20150905-M-US_Open-R32-Roger_Federer-Philipp_Kohlschreiber,2,B-IO,1,1,1,0,0,1,0,,,,,,,,,,
20150905-M-US_Open-R32-Roger_Federer-Philipp_Kohlschreiber,2,S-XC,6,1,0,0,1,1,5,,,,,,,,,,
20150905-M-US_Open-R32-Roger_Federer-Philipp_Kohlschreiber,2,S-DTM,2,0,0,0,0,0,2,,,,,,,,,,
20150905-M-US_Open-R32-Roger_Federer-Philipp_Kohlschreiber,2,S-DTL,1,0,0,0,0,0,1,,,,,,,,,,
20150905-M-US_Open-R32-Roger_Federer-Philipp_Kohlschreiber,2,S-IO,2,1,0,1,0,2,0,,,,,,,,,,
20150907-M-US_Open-R16-Andy_Murray-Kevin_Anderson,1,F-XC,54,13,4,1,8,25,29,,,,,,,,,,
20150907-M-US_Open-R16-Andy_Murray-Kevin_Anderson,1,F-DTM,29,3,0,0,3,11,18,,,,,,,,,,
20150907-M-US_Open-R16-Andy_Murray-Kevin_Anderson,1,F-DTL,28,6,0,3,3,19,9,,,,,,,,,,
20150907-M-US_Open-R16-Andy_Murray-Kevin_Anderson,1,F-IO,25,6,2,2,2,17,8,,,,,,,,,,
20150907-M-US_Open-R16-Andy_Murray-Kevin_Anderson,1,F-II,2,1,1,0,0,1,1,,,,,,,,,,
20150907-M-US_Open-R16-Andy_Murray-Kevin_Anderson,1,B-XC,64,9,4,1,4,40,24,,,,,,,,,,
20150907-M-US_Open-R16-Andy_Murray-Kevin_Anderson,1,B-DTM,30,0,0,0,0,11,19,,,,,,,,,,
20150907-M-US_Open-R16-Andy_Murray-Kevin_Anderson,1,B-DTL,13,5,4,1,0,10,3,,,,,,,,,,
20150907-M-US_Open-R16-Andy_Murray-Kevin_Anderson,1,B-IO,7,2,1,0,1,2,5,,,,,,,,,,
20150907-M-US_Open-R16-Andy_Murray-Kevin_Anderson,1,S-XC,23,1,0,0,1,14,9,,,,,,,,,,
20150907-M-US_Open-R16-Andy_Murray-Kevin_Anderson,1,S-DTM,15,0,0,0,0,6,9,,,,,,,,,,
20150907-M-US_Open-R16-Andy_Murray-Kevin_Anderson,2,F-XC,63,14,5,2,7,33,30,,,,,,,,,,
20150907-M-US_Open-R16-Andy_Murray-Kevin_Anderson,2,F-DTM,24,4,0,0,4,11,13,,,,,,,,,,
20150907-M-US_Open-R16-Andy_Murray-Kevin_Anderson,2,F-DTL,16,8,2,3,3,12,4,,,,,,,,,,
20150907-M-US_Open-R16-Andy_Murray-Kevin_Anderson,2,F-IO,70,27,10,7,10,42,28,,,,,,,,,,
20150907-M-US_Open-R16-Andy_Murray-Kevin_Anderson,2,F-II,7,3,0,1,2,2,5,,,,,,,,,,
20150907-M-US_Open-R16-Andy_Murray-Kevin_Anderson,2,B-XC,60,13,1,1,11,20,40,,,,,,,,,,
20150907-M-US_Open-R16-Andy_Murray-Kevin_Anderson,2,B-DTM,31,3,0,0,3,13,18,,,,,,,,,,
20150907-M-US_Open-R16-Andy_Murray-Kevin_Anderson,2,B-DTL,16,7,0,2,5,6,10,,,,,,,,,,
20150907-M-US_Open-R16-Andy_Murray-Kevin_Anderson,2,B-IO,7,4,2,1,1,5,2,,,,,,,,,,
20150907-M-US_Open-R16-Andy_Murray-Kevin_Anderson,2,S-XC,12,2,0,0,2,3,9,,,,,,,,,,
20150907-M-US_Open-R16-Andy_Murray-Kevin_Anderson,2,S-DTM,4,0,0,0,0,0,4,,,,,,,,,,
20150907-M-US_Open-R16-Andy_Murray-Kevin_Anderson,2,S-DTL,3,1,0,0,1,1,2,,,,,,,,,,
20150907-M-US_Open-R16-Andy_Murray-Kevin_Anderson,2,S-IO,1,0,0,0,0,0,1,,,,,,,,,,
20150908-M-US_Open-R16-Roger_Federer-John_Isner,1,F-XC,19,6,4,2,0,16,3,,,,,,,,,,
20150908-M-US_Open-R16-Roger_Federer-John_Isner,1,F-DTM,27,6,0,3,3,18,9,,,,,,,,,,
20150908-M-US_Open-R16-Roger_Federer-John_Isner,1,F-DTL,7,4,2,2,0,5,2,,,,,,,,,,
20150908-M-US_Open-R16-Roger_Federer-John_Isner,1,F-IO,20,7,4,1,2,13,7,,,,,,,,,,
20150908-M-US_Open-R16-Roger_Federer-John_Isner,1,F-II,3,2,1,1,0,2,1,,,,,,,,,,
20150908-M-US_Open-R16-Roger_Federer-John_Isner,1,B-XC,19,4,1,2,1,16,3,,,,,,,,,,
20150908-M-US_Open-R16-Roger_Federer-John_Isner,1,B-DTM,30,4,0,2,2,17,13,,,,,,,,,,
20150908-M-US_Open-R16-Roger_Federer-John_Isner,1,B-DTL,9,9,7,1,1,8,1,,,,,,,,,,
20150908-M-US_Open-R16-Roger_Federer-John_Isner,1,S-XC,10,0,0,0,0,9,1,,,,,,,,,,
20150908-M-US_Open-R16-Roger_Federer-John_Isner,1,S-DTM,2,1,0,0,1,0,2,,,,,,,,,,
20150908-M-US_Open-R16-Roger_Federer-John_Isner,1,S-DTL,3,1,0,0,1,1,2,,,,,,,,,,
20150908-M-US_Open-R16-Roger_Federer-John_Isner,2,F-XC,25,11,2,6,3,12,13,,,,,,,,,,
20150908-M-US_Open-R16-Roger_Federer-John_Isner,2,F-DTM,22,5,0,1,4,7,15,,,,,,,,,,
20150908-M-US_Open-R16-Roger_Federer-John_Isner,2,F-DTL,5,3,0,1,2,1,4,,,,,,,,,,
20150908-M-US_Open-R16-Roger_Federer-John_Isner,2,F-IO,38,12,4,2,6,14,24,,,,,,,,,,
20150908-M-US_Open-R16-Roger_Federer-John_Isner,2,F-II,1,0,0,0,0,0,1,,,,,,,,,,
20150908-M-US_Open-R16-Roger_Federer-John_Isner,2,B-XC,20,4,1,0,3,7,13,,,,,,,,,,
20150908-M-US_Open-R16-Roger_Federer-John_Isner,2,B-DTM,16,4,0,1,3,5,11,,,,,,,,,,
20150908-M-US_Open-R16-Roger_Federer-John_Isner,2,B-DTL,7,3,1,1,1,2,5,,,,,,,,,,
20150908-M-US_Open-R16-Roger_Federer-John_Isner,2,B-IO,1,0,0,0,0,0,1,,,,,,,,,,
20150908-M-US_Open-R16-Roger_Federer-John_Isner,2,S-XC,11,2,0,0,2,2,9,,,,,,,,,,
20150908-M-US_Open-R16-Roger_Federer-John_Isner,2,S-DTM,4,0,0,0,0,0,4,,,,,,,,,,
20150908-M-US_Open-R16-Roger_Federer-John_Isner,2,S-DTL,1,0,0,0,0,0,1,,,,,,,,,,
20150909-M-US_Open-QF-Novak_Djokovic-Feliciano_Lopez,1,F-XC,61,9,3,2,4,43,18,,,,,,,,,,
20150909-M-US_Open-QF-Novak_Djokovic-Feliciano_Lopez,1,F-DTM,27,2,1,0,1,17,10,,,,,,,,,,
20150909-M-US_Open-QF-Novak_Djokovic-Feliciano_Lopez,1,F-DTL,10,5,2,1,2,5,5,,,,,,,,,,
20150909-M-US_Open-QF-Novak_Djokovic-Feliciano_Lopez,1,F-IO,28,5,2,1,2,22,6,,,,,,,,,,
20150909-M-US_Open-QF-Novak_Djokovic-Feliciano_Lopez,1,B-XC,36,8,3,2,3,23,13,,,,,,,,,,
20150909-M-US_Open-QF-Novak_Djokovic-Feliciano_Lopez,1,B-DTM,52,7,1,1,5,31,21,,,,,,,,,,
20150909-M-US_Open-QF-Novak_Djokovic-Feliciano_Lopez,1,B-DTL,13,5,2,0,3,7,6,,,,,,,,,,
20150909-M-US_Open-QF-Novak_Djokovic-Feliciano_Lopez,1,B-IO,13,3,1,0,2,6,7,,,,,,,,,,
20150909-M-US_Open-QF-Novak_Djokovic-Feliciano_Lopez,1,S-XC,1,0,0,0,0,0,1,,,,,,,,,,
20150909-M-US_Open-QF-Novak_Djokovic-Feliciano_Lopez,1,S-DTM,3,0,0,0,0,1,2,,,,,,,,,,
20150909-M-US_Open-QF-Novak_Djokovic-Feliciano_Lopez,1,S-DTL,1,0,0,0,0,1,0,,,,,,,,,,
20150909-M-US_Open-QF-Novak_Djokovic-Feliciano_Lopez,1,S-IO,3,0,0,0,0,2,1,,,,,,,,,,
20150909-M-US_Open-QF-Novak_Djokovic-Feliciano_Lopez,2,F-XC,52,12,3,1,8,20,32,,,,,,,,,,
20150909-M-US_Open-QF-Novak_Djokovic-Feliciano_Lopez,2,F-DTM,40,7,0,0,7,10,30,,,,,,,,,,
20150909-M-US_Open-QF-Novak_Djokovic-Feliciano_Lopez,2,F-DTL,7,1,1,0,0,3,4,,,,,,,,,,
20150909-M-US_Open-QF-Novak_Djokovic-Feliciano_Lopez,2,F-IO,10,4,0,1,3,5,5,,,,,,,,,,
20150909-M-US_Open-QF-Novak_Djokovic-Feliciano_Lopez,2,B-XC,18,8,2,1,5,7,11,,,,,,,,,,
20150909-M-US_Open-QF-Novak_Djokovic-Feliciano_Lopez,2,B-DTM,14,3,0,0,3,3,11,,,,,,,,,,
20150909-M-US_Open-QF-Novak_Djokovic-Feliciano_Lopez,2,B-DTL,4,2,0,0,2,1,3,,,,,,,,,,
20150909-M-US_Open-QF-Novak_Djokovic-Feliciano_Lopez,2,B-IO,1,1,0,0,1,0,1,,,,,,,,,,
20150909-M-US_Open-QF-Novak_Djokovic-Feliciano_Lopez,2,S-XC,19,1,0,0,1,4,15,,,,,,,,,,
20150909-M-US_Open-QF-Novak_Djokovic-Feliciano_Lopez,2,S-DTM,40,5,0,0,5,14,26,,,,,,,,,,
20150909-M-US_Open-QF-Novak_Djokovic-Feliciano_Lopez,2,S-DTL,8,4,2,0,2,3,5,,,,,,,,,,
20150909-M-US_Open-QF-Novak_Djokovic-Feliciano_Lopez,2,S-IO,13,1,0,0,1,6,7,,,,,,,,,,
20150910-M-US_Open-QF-Roger_Federer-Richard_Gasquet,1,F-XC,24,14,8,2,4,17,7,,,,,,,,,,
20150910-M-US_Open-QF-Roger_Federer-Richard_Gasquet,1,F-DTM,13,0,0,0,0,6,7,,,,,,,,,,
20150910-M-US_Open-QF-Roger_Federer-Richard_Gasquet,1,F-DTL,2,1,0,0,1,1,1,,,,,,,,,,
20150910-M-US_Open-QF-Roger_Federer-Richard_Gasquet,1,F-IO,18,3,2,0,1,15,3,,,,,,,,,,
20150910-M-US_Open-QF-Roger_Federer-Richard_Gasquet,1,F-II,5,3,1,1,1,4,1,,,,,,,,,,
20150910-M-US_Open-QF-Roger_Federer-Richard_Gasquet,1,B-XC,22,12,5,2,5,11,11,,,,,,,,,,
20150910-M-US_Open-QF-Roger_Federer-Richard_Gasquet,1,B-DTM,18,3,0,0,3,10,8,,,,,,,,,,
20150910-M-US_Open-QF-Roger_Federer-Richard_Gasquet,1,B-DTL,5,3,1,0,2,2,3,,,,,,,,,,
20150910-M-US_Open-QF-Roger_Federer-Richard_Gasquet,1,S-XC,4,1,1,0,0,1,3,,,,,,,,,,
20150910-M-US_Open-QF-Roger_Federer-Richard_Gasquet,1,S-DTM,5,0,0,0,0,5,0,,,,,,,,,,
20150910-M-US_Open-QF-Roger_Federer-Richard_Gasquet,1,S-IO,1,0,0,0,0,1,0,,,,,,,,,,
20150910-M-US_Open-QF-Roger_Federer-Richard_Gasquet,2,F-XC,12,7,1,1,5,4,8,,,,,,,,,,
20150910-M-US_Open-QF-Roger_Federer-Richard_Gasquet,2,F-DTM,24,0,0,0,0,8,16,,,,,,,,,,
20150910-M-US_Open-QF-Roger_Federer-Richard_Gasquet,2,F-DTL,7,3,1,0,2,2,5,,,,,,,,,,
20150910-M-US_Open-QF-Roger_Federer-Richard_Gasquet,2,F-IO,9,1,0,1,0,4,5,,,,,,,,,,
20150910-M-US_Open-QF-Roger_Federer-Richard_Gasquet,2,B-XC,31,6,0,3,3,11,20,,,,,,,,,,
20150910-M-US_Open-QF-Roger_Federer-Richard_Gasquet,2,B-DTM,13,0,0,0,0,7,6,,,,,,,,,,
20150910-M-US_Open-QF-Roger_Federer-Richard_Gasquet,2,B-DTL,9,4,1,0,3,4,5,,,,,,,,,,
20150910-M-US_Open-QF-Roger_Federer-Richard_Gasquet,2,B-IO,7,3,1,1,1,5,2,,,,,,,,,,
20150910-M-US_Open-QF-Roger_Federer-Richard_Gasquet,2,S-XC,8,1,0,0,1,2,6,,,,,,,,,,
20150910-M-US_Open-QF-Roger_Federer-Richard_Gasquet,2,S-DTM,2,0,0,0,0,0,2,,,,,,,,,,
20150911-M-US_Open-SF-Novak_Djokovic-Marin_Cilic,1,F-XC,27,8,3,1,4,19,8,,,,,,,,,,
20150911-M-US_Open-SF-Novak_Djokovic-Marin_Cilic,1,F-DTM,25,0,0,0,0,22,3,,,,,,,,,,
20150911-M-US_Open-SF-Novak_Djokovic-Marin_Cilic,1,F-DTL,2,2,0,2,0,2,0,,,,,,,,,,
20150911-M-US_Open-SF-Novak_Djokovic-Marin_Cilic,1,F-IO,13,6,2,1,3,8,5,,,,,,,,,,
20150911-M-US_Open-SF-Novak_Djokovic-Marin_Cilic,1,F-II,1,1,0,1,0,1,0,,,,,,,,,,
20150911-M-US_Open-SF-Novak_Djokovic-Marin_Cilic,1,B-XC,23,4,1,2,1,21,2,,,,,,,,,,
20150911-M-US_Open-SF-Novak_Djokovic-Marin_Cilic,1,B-DTM,33,0,0,0,0,27,6,,,,,,,,,,
20150911-M-US_Open-SF-Novak_Djokovic-Marin_Cilic,1,B-DTL,5,5,2,1,2,3,2,,,,,,,,,,
20150911-M-US_Open-SF-Novak_Djokovic-Marin_Cilic,1,B-IO,3,1,1,0,0,3,0,,,,,,,,,,
20150911-M-US_Open-SF-Novak_Djokovic-Marin_Cilic,1,S-XC,10,3,0,1,2,6,4,,,,,,,,,,
20150911-M-US_Open-SF-Novak_Djokovic-Marin_Cilic,1,S-DTM,6,0,0,0,0,4,2,,,,,,,,,,
20150911-M-US_Open-SF-Novak_Djokovic-Marin_Cilic,1,S-DTL,1,0,0,0,0,1,0,,,,,,,,,,
20150911-M-US_Open-SF-Novak_Djokovic-Marin_Cilic,2,F-XC,37,13,1,3,9,10,27,,,,,,,,,,
20150911-M-US_Open-SF-Novak_Djokovic-Marin_Cilic,2,F-DTM,25,4,0,0,4,6,19,,,,,,,,,,
20150911-M-US_Open-SF-Novak_Djokovic-Marin_Cilic,2,F-DTL,3,1,0,0,1,0,3,,,,,,,,,,
20150911-M-US_Open-SF-Novak_Djokovic-Marin_Cilic,2,F-IO,23,6,1,1,4,5,18,,,,,,,,,,
20150911-M-US_Open-SF-Novak_Djokovic-Marin_Cilic,2,F-II,1,0,0,0,0,0,1,,,,,,,,,,
20150911-M-US_Open-SF-Novak_Djokovic-Marin_Cilic,2,B-XC,27,4,0,0,4,6,21,,,,,,,,,,
20150911-M-US_Open-SF-Novak_Djokovic-Marin_Cilic,2,B-DTM,23,3,0,0,3,3,20,,,,,,,,,,
20150911-M-US_Open-SF-Novak_Djokovic-Marin_Cilic,2,B-DTL,3,2,0,0,2,0,3,,,,,,,,,,
20150911-M-US_Open-SF-Novak_Djokovic-Marin_Cilic,2,B-IO,2,1,0,0,1,0,2,,,,,,,,,,
20150911-M-US_Open-SF-Novak_Djokovic-Marin_Cilic,2,S-XC,5,3,0,0,3,0,5,,,,,,,,,,
20150911-M-US_Open-SF-Novak_Djokovic-Marin_Cilic,2,S-DTM,6,0,0,0,0,1,5,,,,,,,,,,
20150911-M-US_Open-SF-Stanislas_Wawrinka-Roger_Federer,1,F-XC,30,6,3,0,3,9,21,,,,,,,,,,
20150911-M-US_Open-SF-Stanislas_Wawrinka-Roger_Federer,1,F-DTM,24,6,0,1,5,8,16,,,,,,,,,,
20150911-M-US_Open-SF-Stanislas_Wawrinka-Roger_Federer,1,F-DTL,3,0,0,0,0,0,3,,,,,,,,,,
20150911-M-US_Open-SF-Stanislas_Wawrinka-Roger_Federer,1,F-IO,21,10,3,1,6,10,11,,,,,,,,,,
20150911-M-US_Open-SF-Stanislas_Wawrinka-Roger_Federer,1,F-II,2,1,0,1,0,2,0,,,,,,,,,,
20150911-M-US_Open-SF-Stanislas_Wawrinka-Roger_Federer,1,B-XC,28,11,3,1,7,10,18,,,,,,,,,,
20150911-M-US_Open-SF-Stanislas_Wawrinka-Roger_Federer,1,B-DTM,20,9,0,2,7,6,14,,,,,,,,,,
20150911-M-US_Open-SF-Stanislas_Wawrinka-Roger_Federer,1,B-DTL,2,2,0,0,2,0,2,,,,,,,,,,
20150911-M-US_Open-SF-Stanislas_Wawrinka-Roger_Federer,1,B-IO,1,1,1,0,0,1,0,,,,,,,,,,
20150911-M-US_Open-SF-Stanislas_Wawrinka-Roger_Federer,1,S-XC,2,0,0,0,0,1,1,,,,,,,,,,
20150911-M-US_Open-SF-Stanislas_Wawrinka-Roger_Federer,1,S-DTM,2,0,0,0,0,0,2,,,,,,,,,,
20150911-M-US_Open-SF-Stanislas_Wawrinka-Roger_Federer,1,S-DTL,1,0,0,0,0,0,1,,,,,,,,,,
20150911-M-US_Open-SF-Stanislas_Wawrinka-Roger_Federer,2,F-XC,25,7,2,3,2,21,4,,,,,,,,,,
20150911-M-US_Open-SF-Stanislas_Wawrinka-Roger_Federer,2,F-DTM,17,2,1,0,1,9,8,,,,,,,,,,
20150911-M-US_Open-SF-Stanislas_Wawrinka-Roger_Federer,2,F-DTL,5,2,1,1,0,3,2,,,,,,,,,,
20150911-M-US_Open-SF-Stanislas_Wawrinka-Roger_Federer,2,F-IO,15,4,1,1,2,11,4,,,,,,,,,,
20150911-M-US_Open-SF-Stanislas_Wawrinka-Roger_Federer,2,F-II,2,0,0,0,0,2,0,,,,,,,,,,
20150911-M-US_Open-SF-Stanislas_Wawrinka-Roger_Federer,2,B-XC,12,3,1,1,1,8,4,,,,,,,,,,
20150911-M-US_Open-SF-Stanislas_Wawrinka-Roger_Federer,2,B-DTM,19,0,0,0,0,7,12,,,,,,,,,,
20150911-M-US_Open-SF-Stanislas_Wawrinka-Roger_Federer,2,B-DTL,5,1,1,0,0,4,1,,,,,,,,,,
20150911-M-US_Open-SF-Stanislas_Wawrinka-Roger_Federer,2,B-IO,1,0,0,0,0,1,0,,,,,,,,,,
20150911-M-US_Open-SF-Stanislas_Wawrinka-Roger_Federer,2,S-XC,6,0,0,0,0,4,2,,,,,,,,,,
20150911-M-US_Open-SF-Stanislas_Wawrinka-Roger_Federer,2,S-DTM,9,0,0,0,0,7,2,,,,,,,,,,
20150911-M-US_Open-SF-Stanislas_Wawrinka-Roger_Federer,2,S-DTL,1,1,0,0,1,0,1,,,,,,,,,,
20150913-M-US_Open-F-Roger_Federer-Novak_Djokovic,1,F-XC,59,23,3,4,16,29,30,,,,,,,,,,
20150913-M-US_Open-F-Roger_Federer-Novak_Djokovic,1,F-DTM,57,6,0,1,5,15,42,,,,,,,,,,
20150913-M-US_Open-F-Roger_Federer-Novak_Djokovic,1,F-DTL,21,9,5,0,4,7,14,,,,,,,,,,
20150913-M-US_Open-F-Roger_Federer-Novak_Djokovic,1,F-IO,37,15,6,2,7,21,16,,,,,,,,,,
20150913-M-US_Open-F-Roger_Federer-Novak_Djokovic,1,F-II,8,3,2,1,0,4,4,,,,,,,,,,
20150913-M-US_Open-F-Roger_Federer-Novak_Djokovic,1,B-XC,67,9,3,1,5,25,42,,,,,,,,,,
20150913-M-US_Open-F-Roger_Federer-Novak_Djokovic,1,B-DTM,57,6,0,0,6,19,38,,,,,,,,,,
20150913-M-US_Open-F-Roger_Federer-Novak_Djokovic,1,B-DTL,15,7,4,0,3,7,8,,,,,,,,,,
20150913-M-US_Open-F-Roger_Federer-Novak_Djokovic,1,B-IO,6,3,2,0,1,4,2,,,,,,,,,,
20150913-M-US_Open-F-Roger_Federer-Novak_Djokovic,1,S-XC,38,4,0,1,3,10,28,,,,,,,,,,
20150913-M-US_Open-F-Roger_Federer-Novak_Djokovic,1,S-DTM,26,3,0,0,3,8,18,,,,,,,,,,
20150913-M-US_Open-F-Roger_Federer-Novak_Djokovic,1,S-DTL,2,0,0,0,0,1,1,,,,,,,,,,
20150913-M-US_Open-F-Roger_Federer-Novak_Djokovic,2,F-XC,76,16,5,4,7,48,28,,,,,,,,,,
20150913-M-US_Open-F-Roger_Federer-Novak_Djokovic,2,F-DTM,61,5,1,2,2,30,31,,,,,,,,,,
20150913-M-US_Open-F-Roger_Federer-Novak_Djokovic,2,F-DTL,14,2,1,0,1,8,6,,,,,,,,,,
20150913-M-US_Open-F-Roger_Federer-Novak_Djokovic,2,F-IO,59,9,5,2,2,43,16,,,,,,,,,,
20150913-M-US_Open-F-Roger_Federer-Novak_Djokovic,2,F-II,4,2,1,1,0,3,1,,,,,,,,,,
20150913-M-US_Open-F-Roger_Federer-Novak_Djokovic,2,B-XC,120,15,3,4,8,77,43,,,,,,,,,,
20150913-M-US_Open-F-Roger_Federer-Novak_Djokovic,2,B-DTM,62,14,1,3,10,31,31,,,,,,,,,,
20150913-M-US_Open-F-Roger_Federer-Novak_Djokovic,2,B-DTL,17,9,4,3,2,14,3,,,,,,,,,,
20150913-M-US_Open-F-Roger_Federer-Novak_Djokovic,2,B-IO,7,2,0,1,1,5,2,,,,,,,,,,
20150913-M-US_Open-F-Roger_Federer-Novak_Djokovic,2,S-XC,1,0,0,0,0,1,0,,,,,,,,,,
20150913-M-US_Open-F-Roger_Federer-Novak_Djokovic,2,S-DTM,2,0,0,0,0,1,1,,,,,,,,,,
20150914-M-Istanbul_CH-SF-Karen_Khachanov-Yannick_Mertens,1,F-XC,17,9,6,1,2,8,9,,,,,,,,,,
20150914-M-Istanbul_CH-SF-Karen_Khachanov-Yannick_Mertens,1,F-DTM,15,0,0,0,0,10,5,,,,,,,,,,
20150914-M-Istanbul_CH-SF-Karen_Khachanov-Yannick_Mertens,1,F-DTL,5,2,1,0,1,3,2,,,,,,,,,,
20150914-M-Istanbul_CH-SF-Karen_Khachanov-Yannick_Mertens,1,F-IO,14,4,2,0,2,10,4,,,,,,,,,,
20150914-M-Istanbul_CH-SF-Karen_Khachanov-Yannick_Mertens,1,F-II,2,2,1,1,0,2,0,,,,,,,,,,
20150914-M-Istanbul_CH-SF-Karen_Khachanov-Yannick_Mertens,1,B-XC,23,6,0,3,3,11,12,,,,,,,,,,
20150914-M-Istanbul_CH-SF-Karen_Khachanov-Yannick_Mertens,1,B-DTM,11,1,0,0,1,3,8,,,,,,,,,,
20150914-M-Istanbul_CH-SF-Karen_Khachanov-Yannick_Mertens,1,B-DTL,9,9,3,2,4,5,4,,,,,,,,,,
20150914-M-Istanbul_CH-SF-Karen_Khachanov-Yannick_Mertens,1,B-IO,1,0,0,0,0,1,0,,,,,,,,,,
20150914-M-Istanbul_CH-SF-Karen_Khachanov-Yannick_Mertens,1,S-XC,1,0,0,0,0,0,1,,,,,,,,,,
20150914-M-Istanbul_CH-SF-Karen_Khachanov-Yannick_Mertens,1,S-DTM,1,0,0,0,0,1,0,,,,,,,,,,
20150914-M-Istanbul_CH-SF-Karen_Khachanov-Yannick_Mertens,2,F-XC,21,9,1,3,5,11,10,,,,,,,,,,
20150914-M-Istanbul_CH-SF-Karen_Khachanov-Yannick_Mertens,2,F-DTM,15,3,0,1,2,5,10,,,,,,,,,,
20150914-M-Istanbul_CH-SF-Karen_Khachanov-Yannick_Mertens,2,F-DTL,2,1,1,0,0,2,0,,,,,,,,,,
20150914-M-Istanbul_CH-SF-Karen_Khachanov-Yannick_Mertens,2,F-IO,7,3,0,2,1,5,2,,,,,,,,,,
20150914-M-Istanbul_CH-SF-Karen_Khachanov-Yannick_Mertens,2,F-II,2,1,0,0,1,1,1,,,,,,,,,,
20150914-M-Istanbul_CH-SF-Karen_Khachanov-Yannick_Mertens,2,B-XC,27,4,0,0,4,11,16,,,,,,,,,,
20150914-M-Istanbul_CH-SF-Karen_Khachanov-Yannick_Mertens,2,B-DTM,21,3,0,0,3,9,12,,,,,,,,,,
20150914-M-Istanbul_CH-SF-Karen_Khachanov-Yannick_Mertens,2,B-DTL,1,1,0,0,1,0,1,,,,,,,,,,
20150914-M-Istanbul_CH-SF-Karen_Khachanov-Yannick_Mertens,2,B-IO,1,0,0,0,0,1,0,,,,,,,,,,
20150914-M-Istanbul_CH-SF-Karen_Khachanov-Yannick_Mertens,2,S-XC,2,0,0,0,0,0,2,,,,,,,,,,
20150914-M-Istanbul_CH-SF-Karen_Khachanov-Yannick_Mertens,2,S-DTM,3,1,0,0,1,0,3,,,,,,,,,,
20150914-M-Szczecin_CH-R32-Inigo_Cervantes_Huegun-Vladimir_Ivanov,1,F-XC,20,5,1,0,4,9,11,,,,,,,,,,
20150914-M-Szczecin_CH-R32-Inigo_Cervantes_Huegun-Vladimir_Ivanov,1,F-DTM,9,1,0,0,1,6,3,,,,,,,,,,
20150914-M-Szczecin_CH-R32-Inigo_Cervantes_Huegun-Vladimir_Ivanov,1,F-DTL,5,1,0,1,0,3,2,,,,,,,,,,
20150914-M-Szczecin_CH-R32-Inigo_Cervantes_Huegun-Vladimir_Ivanov,1,F-IO,20,5,3,0,2,12,8,,,,,,,,,,
20150914-M-Szczecin_CH-R32-Inigo_Cervantes_Huegun-Vladimir_Ivanov,1,F-II,2,1,0,0,1,1,1,,,,,,,,,,
20150914-M-Szczecin_CH-R32-Inigo_Cervantes_Huegun-Vladimir_Ivanov,1,B-XC,53,9,1,0,8,32,21,,,,,,,,,,
20150914-M-Szczecin_CH-R32-Inigo_Cervantes_Huegun-Vladimir_Ivanov,1,B-DTM,16,2,0,0,2,8,8,,,,,,,,,,
20150914-M-Szczecin_CH-R32-Inigo_Cervantes_Huegun-Vladimir_Ivanov,1,B-DTL,9,6,4,0,2,7,2,,,,,,,,,,
20150914-M-Szczecin_CH-R32-Inigo_Cervantes_Huegun-Vladimir_Ivanov,1,B-IO,6,2,0,0,2,1,5,,,,,,,,,,
20150914-M-Szczecin_CH-R32-Inigo_Cervantes_Huegun-Vladimir_Ivanov,1,S-XC,4,0,0,0,0,3,1,,,,,,,,,,
20150914-M-Szczecin_CH-R32-Inigo_Cervantes_Huegun-Vladimir_Ivanov,1,S-DTM,3,1,0,1,0,3,0,,,,,,,,,,
20150914-M-Szczecin_CH-R32-Inigo_Cervantes_Huegun-Vladimir_Ivanov,1,S-DTL,1,0,0,0,0,0,1,,,,,,,,,,
20150914-M-Szczecin_CH-R32-Inigo_Cervantes_Huegun-Vladimir_Ivanov,2,F-XC,17,2,0,2,0,9,8,,,,,,,,,,
20150914-M-Szczecin_CH-R32-Inigo_Cervantes_Huegun-Vladimir_Ivanov,2,F-DTM,14,2,0,0,2,9,5,,,,,,,,,,
20150914-M-Szczecin_CH-R32-Inigo_Cervantes_Huegun-Vladimir_Ivanov,2,F-DTL,10,5,1,1,3,5,5,,,,,,,,,,
20150914-M-Szczecin_CH-R32-Inigo_Cervantes_Huegun-Vladimir_Ivanov,2,F-IO,14,4,0,1,3,5,9,,,,,,,,,,
20150914-M-Szczecin_CH-R32-Inigo_Cervantes_Huegun-Vladimir_Ivanov,2,B-XC,53,12,1,1,10,17,36,,,,,,,,,,
20150914-M-Szczecin_CH-R32-Inigo_Cervantes_Huegun-Vladimir_Ivanov,2,B-DTM,26,2,0,0,2,6,20,,,,,,,,,,
20150914-M-Szczecin_CH-R32-Inigo_Cervantes_Huegun-Vladimir_Ivanov,2,B-DTL,6,5,3,0,2,4,2,,,,,,,,,,
20150914-M-Szczecin_CH-R32-Inigo_Cervantes_Huegun-Vladimir_Ivanov,2,S-XC,9,4,0,0,4,2,7,,,,,,,,,,
20150914-M-Szczecin_CH-R32-Inigo_Cervantes_Huegun-Vladimir_Ivanov,2,S-DTM,4,1,1,0,0,2,2,,,,,,,,,,
20150921-M-Izmir_CH-R16-Lukas_Lacko-Laurynas_Grigelis,1,F-XC,34,8,5,1,2,24,10,,,,,,,,,,
20150921-M-Izmir_CH-R16-Lukas_Lacko-Laurynas_Grigelis,1,F-DTM,16,0,0,0,0,14,2,,,,,,,,,,
20150921-M-Izmir_CH-R16-Lukas_Lacko-Laurynas_Grigelis,1,F-DTL,3,2,2,0,0,3,0,,,,,,,,,,
20150921-M-Izmir_CH-R16-Lukas_Lacko-Laurynas_Grigelis,1,F-IO,8,5,3,2,0,7,1,,,,,,,,,,
20150921-M-Izmir_CH-R16-Lukas_Lacko-Laurynas_Grigelis,1,F-II,1,0,0,0,0,1,0,,,,,,,,,,
20150921-M-Izmir_CH-R16-Lukas_Lacko-Laurynas_Grigelis,1,B-XC,30,2,0,1,1,19,11,,,,,,,,,,
20150921-M-Izmir_CH-R16-Lukas_Lacko-Laurynas_Grigelis,1,B-DTM,25,2,0,1,1,16,9,,,,,,,,,,
20150921-M-Izmir_CH-R16-Lukas_Lacko-Laurynas_Grigelis,1,B-DTL,6,2,1,1,0,5,1,,,,,,,,,,
20150921-M-Izmir_CH-R16-Lukas_Lacko-Laurynas_Grigelis,1,B-IO,4,2,1,0,1,2,2,,,,,,,,,,
20150921-M-Izmir_CH-R16-Lukas_Lacko-Laurynas_Grigelis,1,S-XC,3,0,0,0,0,2,1,,,,,,,,,,
20150921-M-Izmir_CH-R16-Lukas_Lacko-Laurynas_Grigelis,1,S-DTM,7,0,0,0,0,6,1,,,,,,,,,,
20150921-M-Izmir_CH-R16-Lukas_Lacko-Laurynas_Grigelis,1,S-DTL,3,0,0,0,0,0,3,,,,,,,,,,
20150921-M-Izmir_CH-R16-Lukas_Lacko-Laurynas_Grigelis,1,S-IO,1,0,0,0,0,0,1,,,,,,,,,,
20150921-M-Izmir_CH-R16-Lukas_Lacko-Laurynas_Grigelis,2,F-XC,30,4,2,1,1,8,22,,,,,,,,,,
20150921-M-Izmir_CH-R16-Lukas_Lacko-Laurynas_Grigelis,2,F-DTM,14,1,0,0,1,5,9,,,,,,,,,,
20150921-M-Izmir_CH-R16-Lukas_Lacko-Laurynas_Grigelis,2,F-DTL,15,5,2,0,3,6,9,,,,,,,,,,
20150921-M-Izmir_CH-R16-Lukas_Lacko-Laurynas_Grigelis,2,F-IO,15,2,0,0,2,2,13,,,,,,,,,,
20150921-M-Izmir_CH-R16-Lukas_Lacko-Laurynas_Grigelis,2,B-XC,39,9,0,5,4,14,25,,,,,,,,,,
20150921-M-Izmir_CH-R16-Lukas_Lacko-Laurynas_Grigelis,2,B-DTM,10,1,0,0,1,3,7,,,,,,,,,,
20150921-M-Izmir_CH-R16-Lukas_Lacko-Laurynas_Grigelis,2,B-DTL,10,5,2,1,2,4,6,,,,,,,,,,
20150921-M-Izmir_CH-R16-Lukas_Lacko-Laurynas_Grigelis,2,B-IO,8,4,1,0,3,2,6,,,,,,,,,,
20150921-M-Izmir_CH-R16-Lukas_Lacko-Laurynas_Grigelis,2,S-XC,6,0,0,0,0,2,4,,,,,,,,,,
20150921-M-Izmir_CH-SF-Marius_Copil-Farrukh_Dustov,1,F-XC,15,8,4,2,2,11,4,,,,,,,,,,
20150921-M-Izmir_CH-SF-Marius_Copil-Farrukh_Dustov,1,F-DTM,8,1,0,0,1,5,3,,,,,,,,,,
20150921-M-Izmir_CH-SF-Marius_Copil-Farrukh_Dustov,1,F-DTL,4,0,0,0,0,4,0,,,,,,,,,,
20150921-M-Izmir_CH-SF-Marius_Copil-Farrukh_Dustov,1,F-IO,4,1,1,0,0,3,1,,,,,,,,,,
20150921-M-Izmir_CH-SF-Marius_Copil-Farrukh_Dustov,1,F-II,1,1,1,0,0,1,0,,,,,,,,,,
20150921-M-Izmir_CH-SF-Marius_Copil-Farrukh_Dustov,1,B-XC,16,5,2,2,1,13,3,,,,,,,,,,
20150921-M-Izmir_CH-SF-Marius_Copil-Farrukh_Dustov,1,B-DTM,5,2,0,0,2,1,4,,,,,,,,,,
20150921-M-Izmir_CH-SF-Marius_Copil-Farrukh_Dustov,1,B-DTL,2,2,1,1,0,2,0,,,,,,,,,,
20150921-M-Izmir_CH-SF-Marius_Copil-Farrukh_Dustov,1,S-XC,1,0,0,0,0,1,0,,,,,,,,,,
20150921-M-Izmir_CH-SF-Marius_Copil-Farrukh_Dustov,1,S-DTM,4,0,0,0,0,1,3,,,,,,,,,,
20150921-M-Izmir_CH-SF-Marius_Copil-Farrukh_Dustov,1,S-DTL,1,0,0,0,0,1,0,,,,,,,,,,
20150921-M-Izmir_CH-SF-Marius_Copil-Farrukh_Dustov,1,S-IO,3,3,2,1,0,3,0,,,,,,,,,,
20150921-M-Izmir_CH-SF-Marius_Copil-Farrukh_Dustov,2,F-XC,21,9,0,2,7,5,16,,,,,,,,,,
20150921-M-Izmir_CH-SF-Marius_Copil-Farrukh_Dustov,2,F-DTM,7,2,0,0,2,2,5,,,,,,,,,,
20150921-M-Izmir_CH-SF-Marius_Copil-Farrukh_Dustov,2,F-DTL,2,0,0,0,0,2,0,,,,,,,,,,
20150921-M-Izmir_CH-SF-Marius_Copil-Farrukh_Dustov,2,F-IO,9,6,1,0,5,3,6,,,,,,,,,,
20150921-M-Izmir_CH-SF-Marius_Copil-Farrukh_Dustov,2,B-XC,16,2,1,0,1,4,12,,,,,,,,,,
20150921-M-Izmir_CH-SF-Marius_Copil-Farrukh_Dustov,2,B-DTM,8,1,0,0,1,3,5,,,,,,,,,,
20150921-M-Izmir_CH-SF-Marius_Copil-Farrukh_Dustov,2,B-DTL,4,3,2,0,1,2,2,,,,,,,,,,
20150921-M-Izmir_CH-SF-Marius_Copil-Farrukh_Dustov,2,S-XC,3,0,0,0,0,2,1,,,,,,,,,,
20150921-M-Izmir_CH-SF-Marius_Copil-Farrukh_Dustov,2,S-DTM,3,0,0,0,0,0,3,,,,,,,,,,
20150921-M-Kaohsiung_CH-R32-Chieh_Fu_Wang-Jiri_Vesely,1,F-XC,24,10,3,1,6,7,17,,,,,,,,,,
20150921-M-Kaohsiung_CH-R32-Chieh_Fu_Wang-Jiri_Vesely,1,F-DTM,9,2,0,0,2,1,8,,,,,,,,,,
20150921-M-Kaohsiung_CH-R32-Chieh_Fu_Wang-Jiri_Vesely,1,F-DTL,4,4,1,0,3,1,3,,,,,,,,,,
20150921-M-Kaohsiung_CH-R32-Chieh_Fu_Wang-Jiri_Vesely,1,F-IO,8,3,0,1,2,2,6,,,,,,,,,,
20150921-M-Kaohsiung_CH-R32-Chieh_Fu_Wang-Jiri_Vesely,1,F-II,5,4,0,1,3,2,3,,,,,,,,,,
20150921-M-Kaohsiung_CH-R32-Chieh_Fu_Wang-Jiri_Vesely,1,B-XC,10,4,0,0,4,0,10,,,,,,,,,,
20150921-M-Kaohsiung_CH-R32-Chieh_Fu_Wang-Jiri_Vesely,1,B-DTM,5,0,0,0,0,1,4,,,,,,,,,,
20150921-M-Kaohsiung_CH-R32-Chieh_Fu_Wang-Jiri_Vesely,1,B-DTL,3,3,0,0,3,0,3,,,,,,,,,,
20150921-M-Kaohsiung_CH-R32-Chieh_Fu_Wang-Jiri_Vesely,1,B-IO,4,1,0,0,1,0,4,,,,,,,,,,
20150921-M-Kaohsiung_CH-R32-Chieh_Fu_Wang-Jiri_Vesely,1,S-XC,1,0,0,0,0,0,1,,,,,,,,,,
20150921-M-Kaohsiung_CH-R32-Chieh_Fu_Wang-Jiri_Vesely,1,S-DTM,2,2,0,0,2,0,2,,,,,,,,,,
20150921-M-Kaohsiung_CH-R32-Chieh_Fu_Wang-Jiri_Vesely,1,S-DTL,1,0,0,0,0,1,0,,,,,,,,,,
20150921-M-Kaohsiung_CH-R32-Chieh_Fu_Wang-Jiri_Vesely,2,F-XC,16,1,0,0,1,13,3,,,,,,,,,,
20150921-M-Kaohsiung_CH-R32-Chieh_Fu_Wang-Jiri_Vesely,2,F-DTM,6,0,0,0,0,6,0,,,,,,,,,,
20150921-M-Kaohsiung_CH-R32-Chieh_Fu_Wang-Jiri_Vesely,2,F-DTL,3,2,2,0,0,2,1,,,,,,,,,,
20150921-M-Kaohsiung_CH-R32-Chieh_Fu_Wang-Jiri_Vesely,2,F-IO,1,0,0,0,0,0,1,,,,,,,,,,
20150921-M-Kaohsiung_CH-R32-Chieh_Fu_Wang-Jiri_Vesely,2,B-XC,10,4,0,2,2,8,2,,,,,,,,,,
20150921-M-Kaohsiung_CH-R32-Chieh_Fu_Wang-Jiri_Vesely,2,B-DTM,10,1,0,0,1,8,2,,,,,,,,,,
20150921-M-Kaohsiung_CH-R32-Chieh_Fu_Wang-Jiri_Vesely,2,B-DTL,2,0,0,0,0,2,0,,,,,,,,,,
20150921-M-Kaohsiung_CH-R32-Chieh_Fu_Wang-Jiri_Vesely,2,B-IO,1,0,0,0,0,1,0,,,,,,,,,,
20150921-M-Kaohsiung_CH-R32-Chieh_Fu_Wang-Jiri_Vesely,2,S-XC,2,0,0,0,0,0,2,,,,,,,,,,
20150921-M-Kaohsiung_CH-R32-Chieh_Fu_Wang-Jiri_Vesely,2,S-DTM,3,0,0,0,0,3,0,,,,,,,,,,
20150921-M-Kaohsiung_CH-R32-Chieh_Fu_Wang-Jiri_Vesely,2,S-DTL,1,0,0,0,0,1,0,,,,,,,,,,
20150921-M-Kaohsiung_CH-R32-Chieh_Fu_Wang-Jiri_Vesely,2,S-IO,1,0,0,0,0,0,1,,,,,,,,,,
20150921-M-Kaohsiung_CH-R32-Hyeon_Chung-Liang_Chi_Huang,1,F-XC,24,5,4,0,1,21,3,,,,,,,,,,
20150921-M-Kaohsiung_CH-R32-Hyeon_Chung-Liang_Chi_Huang,1,F-DTM,8,1,0,1,0,7,1,,,,,,,,,,
20150921-M-Kaohsiung_CH-R32-Hyeon_Chung-Liang_Chi_Huang,1,F-DTL,8,5,2,2,1,7,1,,,,,,,,,,
20150921-M-Kaohsiung_CH-R32-Hyeon_Chung-Liang_Chi_Huang,1,F-IO,5,4,2,2,0,4,1,,,,,,,,,,
20150921-M-Kaohsiung_CH-R32-Hyeon_Chung-Liang_Chi_Huang,1,B-XC,21,5,1,4,0,21,0,,,,,,,,,,
20150921-M-Kaohsiung_CH-R32-Hyeon_Chung-Liang_Chi_Huang,1,B-DTM,20,0,0,0,0,16,4,,,,,,,,,,
20150921-M-Kaohsiung_CH-R32-Hyeon_Chung-Liang_Chi_Huang,1,B-DTL,6,5,2,1,2,4,2,,,,,,,,,,
20150921-M-Kaohsiung_CH-R32-Hyeon_Chung-Liang_Chi_Huang,1,B-IO,3,2,1,1,0,2,1,,,,,,,,,,
20150921-M-Kaohsiung_CH-R32-Hyeon_Chung-Liang_Chi_Huang,1,S-XC,1,0,0,0,0,1,0,,,,,,,,,,
20150921-M-Kaohsiung_CH-R32-Hyeon_Chung-Liang_Chi_Huang,2,F-XC,22,3,0,0,3,2,20,,,,,,,,,,
20150921-M-Kaohsiung_CH-R32-Hyeon_Chung-Liang_Chi_Huang,2,F-DTM,20,3,0,0,3,4,16,,,,,,,,,,
20150921-M-Kaohsiung_CH-R32-Hyeon_Chung-Liang_Chi_Huang,2,F-DTL,2,1,0,0,1,0,2,,,,,,,,,,
20150921-M-Kaohsiung_CH-R32-Hyeon_Chung-Liang_Chi_Huang,2,F-IO,18,2,0,1,1,4,14,,,,,,,,,,
20150921-M-Kaohsiung_CH-R32-Hyeon_Chung-Liang_Chi_Huang,2,F-II,2,1,1,0,0,1,1,,,,,,,,,,
20150921-M-Kaohsiung_CH-R32-Hyeon_Chung-Liang_Chi_Huang,2,B-XC,19,0,0,0,0,1,18,,,,,,,,,,
20150921-M-Kaohsiung_CH-R32-Hyeon_Chung-Liang_Chi_Huang,2,B-DTM,8,2,0,0,2,1,7,,,,,,,,,,
20150921-M-Kaohsiung_CH-R32-Hyeon_Chung-Liang_Chi_Huang,2,B-DTL,1,0,0,0,0,0,1,,,,,,,,,,
20150921-M-Kaohsiung_CH-R32-Hyeon_Chung-Liang_Chi_Huang,2,S-XC,1,0,0,0,0,1,0,,,,,,,,,,
20150921-M-Kaohsiung_CH-R32-Hyeon_Chung-Liang_Chi_Huang,2,S-DTL,1,1,0,1,0,1,0,,,,,,,,,,
20150923-M-St_Petersburg-R16-Andreas_Haider_Maurer-Dominic_Thiem,1,F-XC,31,6,4,0,2,13,18,,,,,,,,,,
20150923-M-St_Petersburg-R16-Andreas_Haider_Maurer-Dominic_Thiem,1,F-DTM,25,2,0,0,2,3,22,,,,,,,,,,
20150923-M-St_Petersburg-R16-Andreas_Haider_Maurer-Dominic_Thiem,1,F-DTL,3,1,1,0,0,1,2,,,,,,,,,,
20150923-M-St_Petersburg-R16-Andreas_Haider_Maurer-Dominic_Thiem,1,F-IO,28,8,1,0,7,14,14,,,,,,,,,,
20150923-M-St_Petersburg-R16-Andreas_Haider_Maurer-Dominic_Thiem,1,B-XC,17,4,0,0,4,5,12,,,,,,,,,,
20150923-M-St_Petersburg-R16-Andreas_Haider_Maurer-Dominic_Thiem,1,B-DTM,26,1,0,0,1,4,22,,,,,,,,,,
20150923-M-St_Petersburg-R16-Andreas_Haider_Maurer-Dominic_Thiem,1,B-DTL,1,1,0,0,1,0,1,,,,,,,,,,
20150923-M-St_Petersburg-R16-Andreas_Haider_Maurer-Dominic_Thiem,1,B-IO,4,3,0,0,3,1,3,,,,,,,,,,
20150923-M-St_Petersburg-R16-Andreas_Haider_Maurer-Dominic_Thiem,1,S-XC,12,0,0,0,0,3,9,,,,,,,,,,
20150923-M-St_Petersburg-R16-Andreas_Haider_Maurer-Dominic_Thiem,1,S-DTM,5,0,0,0,0,1,4,,,,,,,,,,
20150923-M-St_Petersburg-R16-Andreas_Haider_Maurer-Dominic_Thiem,1,S-DTL,2,1,1,0,0,1,1,,,,,,,,,,
20150923-M-St_Petersburg-R16-Andreas_Haider_Maurer-Dominic_Thiem,2,F-XC,36,13,4,3,6,25,11,,,,,,,,,,
20150923-M-St_Petersburg-R16-Andreas_Haider_Maurer-Dominic_Thiem,2,F-DTM,32,2,0,0,2,23,9,,,,,,,,,,
20150923-M-St_Petersburg-R16-Andreas_Haider_Maurer-Dominic_Thiem,2,F-DTL,3,1,0,0,1,2,1,,,,,,,,,,
20150923-M-St_Petersburg-R16-Andreas_Haider_Maurer-Dominic_Thiem,2,F-IO,27,9,2,4,3,20,7,,,,,,,,,,
20150923-M-St_Petersburg-R16-Andreas_Haider_Maurer-Dominic_Thiem,2,F-II,2,0,0,0,0,0,2,,,,,,,,,,
20150923-M-St_Petersburg-R16-Andreas_Haider_Maurer-Dominic_Thiem,2,B-XC,12,1,1,0,0,8,4,,,,,,,,,,
20150923-M-St_Petersburg-R16-Andreas_Haider_Maurer-Dominic_Thiem,2,B-DTM,13,0,0,0,0,9,4,,,,,,,,,,
20150923-M-St_Petersburg-R16-Andreas_Haider_Maurer-Dominic_Thiem,2,B-DTL,9,5,2,0,3,6,3,,,,,,,,,,
20150923-M-St_Petersburg-R16-Andreas_Haider_Maurer-Dominic_Thiem,2,B-IO,3,0,0,0,0,1,2,,,,,,,,,,
20150923-M-St_Petersburg-R16-Andreas_Haider_Maurer-Dominic_Thiem,2,S-XC,9,0,0,0,0,6,3,,,,,,,,,,
20150923-M-St_Petersburg-R16-Andreas_Haider_Maurer-Dominic_Thiem,2,S-DTM,11,2,0,0,2,5,6,,,,,,,,,,
20150923-M-St_Petersburg-R16-Andreas_Haider_Maurer-Dominic_Thiem,2,S-DTL,3,0,0,0,0,1,2,,,,,,,,,,
20150923-M-St_Petersburg-R16-Andreas_Haider_Maurer-Dominic_Thiem,2,S-IO,1,1,1,0,0,1,0,,,,,,,,,,
20150923-M-St_Petersburg-R32-Thanasi_Kokkinakis-Marcel_Granollers,1,F-XC,18,7,5,0,2,10,8,,,,,,,,,,
20150923-M-St_Petersburg-R32-Thanasi_Kokkinakis-Marcel_Granollers,1,F-DTM,15,2,0,0,2,3,12,,,,,,,,,,
20150923-M-St_Petersburg-R32-Thanasi_Kokkinakis-Marcel_Granollers,1,F-DTL,7,3,2,0,1,2,5,,,,,,,,,,
20150923-M-St_Petersburg-R32-Thanasi_Kokkinakis-Marcel_Granollers,1,F-IO,22,13,7,2,4,11,11,,,,,,,,,,
20150923-M-St_Petersburg-R32-Thanasi_Kokkinakis-Marcel_Granollers,1,F-II,5,1,1,0,0,1,4,,,,,,,,,,
20150923-M-St_Petersburg-R32-Thanasi_Kokkinakis-Marcel_Granollers,1,B-XC,30,7,0,1,6,10,20,,,,,,,,,,
20150923-M-St_Petersburg-R32-Thanasi_Kokkinakis-Marcel_Granollers,1,B-DTM,23,5,0,0,5,4,19,,,,,,,,,,
20150923-M-St_Petersburg-R32-Thanasi_Kokkinakis-Marcel_Granollers,1,B-DTL,6,4,1,0,3,1,5,,,,,,,,,,
20150923-M-St_Petersburg-R32-Thanasi_Kokkinakis-Marcel_Granollers,1,B-IO,4,1,0,0,1,3,1,,,,,,,,,,
20150923-M-St_Petersburg-R32-Thanasi_Kokkinakis-Marcel_Granollers,1,S-XC,3,0,0,0,0,0,3,,,,,,,,,,
20150923-M-St_Petersburg-R32-Thanasi_Kokkinakis-Marcel_Granollers,1,S-DTM,3,0,0,0,0,0,3,,,,,,,,,,
20150923-M-St_Petersburg-R32-Thanasi_Kokkinakis-Marcel_Granollers,2,F-XC,5,1,1,0,0,4,1,,,,,,,,,,
20150923-M-St_Petersburg-R32-Thanasi_Kokkinakis-Marcel_Granollers,2,F-DTM,17,1,0,0,1,10,7,,,,,,,,,,
20150923-M-St_Petersburg-R32-Thanasi_Kokkinakis-Marcel_Granollers,2,F-DTL,7,3,1,1,1,6,1,,,,,,,,,,
20150923-M-St_Petersburg-R32-Thanasi_Kokkinakis-Marcel_Granollers,2,F-IO,7,0,0,0,0,7,0,,,,,,,,,,
20150923-M-St_Petersburg-R32-Thanasi_Kokkinakis-Marcel_Granollers,2,B-XC,28,4,0,2,2,22,6,,,,,,,,,,
20150923-M-St_Petersburg-R32-Thanasi_Kokkinakis-Marcel_Granollers,2,B-DTM,30,1,0,0,1,17,13,,,,,,,,,,
20150923-M-St_Petersburg-R32-Thanasi_Kokkinakis-Marcel_Granollers,2,B-DTL,1,1,1,0,0,1,0,,,,,,,,,,
20150923-M-St_Petersburg-R32-Thanasi_Kokkinakis-Marcel_Granollers,2,B-IO,4,0,0,0,0,4,0,,,,,,,,,,
20150923-M-St_Petersburg-R32-Thanasi_Kokkinakis-Marcel_Granollers,2,S-XC,5,0,0,0,0,4,1,,,,,,,,,,
20150923-M-St_Petersburg-R32-Thanasi_Kokkinakis-Marcel_Granollers,2,S-DTM,5,0,0,0,0,4,1,,,,,,,,,,
20150924-M-St_Petersburg-R16-Roberto_Bautista_Agut-Teymuraz_Gabashvili,1,F-XC,79,14,4,3,7,39,40,,,,,,,,,,
20150924-M-St_Petersburg-R16-Roberto_Bautista_Agut-Teymuraz_Gabashvili,1,F-DTM,61,5,0,3,2,29,32,,,,,,,,,,
20150924-M-St_Petersburg-R16-Roberto_Bautista_Agut-Teymuraz_Gabashvili,1,F-DTL,15,3,0,1,2,6,9,,,,,,,,,,
20150924-M-St_Petersburg-R16-Roberto_Bautista_Agut-Teymuraz_Gabashvili,1,F-IO,58,16,3,5,8,30,28,,,,,,,,,,
20150924-M-St_Petersburg-R16-Roberto_Bautista_Agut-Teymuraz_Gabashvili,1,F-II,4,3,0,0,3,0,4,,,,,,,,,,
20150924-M-St_Petersburg-R16-Roberto_Bautista_Agut-Teymuraz_Gabashvili,1,B-XC,34,8,1,2,5,14,20,,,,,,,,,,
20150924-M-St_Petersburg-R16-Roberto_Bautista_Agut-Teymuraz_Gabashvili,1,B-DTM,82,4,0,0,4,42,40,,,,,,,,,,
20150924-M-St_Petersburg-R16-Roberto_Bautista_Agut-Teymuraz_Gabashvili,1,B-DTL,7,4,0,1,3,3,4,,,,,,,,,,
20150924-M-St_Petersburg-R16-Roberto_Bautista_Agut-Teymuraz_Gabashvili,1,B-IO,2,1,0,0,1,1,1,,,,,,,,,,
20150924-M-St_Petersburg-R16-Roberto_Bautista_Agut-Teymuraz_Gabashvili,1,S-XC,23,2,0,1,1,6,17,,,,,,,,,,
20150924-M-St_Petersburg-R16-Roberto_Bautista_Agut-Teymuraz_Gabashvili,1,S-DTM,18,2,1,0,1,7,11,,,,,,,,,,
20150924-M-St_Petersburg-R16-Roberto_Bautista_Agut-Teymuraz_Gabashvili,1,S-DTL,2,0,0,0,0,1,1,,,,,,,,,,
20150924-M-St_Petersburg-R16-Roberto_Bautista_Agut-Teymuraz_Gabashvili,1,S-IO,1,0,0,0,0,0,1,,,,,,,,,,
20150924-M-St_Petersburg-R16-Roberto_Bautista_Agut-Teymuraz_Gabashvili,2,F-XC,73,17,9,2,6,41,32,,,,,,,,,,
20150924-M-St_Petersburg-R16-Roberto_Bautista_Agut-Teymuraz_Gabashvili,2,F-DTM,68,4,1,1,2,38,30,,,,,,,,,,
20150924-M-St_Petersburg-R16-Roberto_Bautista_Agut-Teymuraz_Gabashvili,2,F-DTL,15,6,3,0,3,7,8,,,,,,,,,,
20150924-M-St_Petersburg-R16-Roberto_Bautista_Agut-Teymuraz_Gabashvili,2,F-IO,33,14,5,2,7,14,19,,,,,,,,,,
20150924-M-St_Petersburg-R16-Roberto_Bautista_Agut-Teymuraz_Gabashvili,2,F-II,2,1,0,0,1,0,2,,,,,,,,,,
20150924-M-St_Petersburg-R16-Roberto_Bautista_Agut-Teymuraz_Gabashvili,2,B-XC,79,7,1,2,4,44,35,,,,,,,,,,
20150924-M-St_Petersburg-R16-Roberto_Bautista_Agut-Teymuraz_Gabashvili,2,B-DTM,66,5,0,0,5,36,30,,,,,,,,,,
20150924-M-St_Petersburg-R16-Roberto_Bautista_Agut-Teymuraz_Gabashvili,2,B-DTL,13,10,5,0,5,5,8,,,,,,,,,,
20150924-M-St_Petersburg-R16-Roberto_Bautista_Agut-Teymuraz_Gabashvili,2,B-IO,14,5,0,2,3,8,6,,,,,,,,,,
20150924-M-St_Petersburg-R16-Roberto_Bautista_Agut-Teymuraz_Gabashvili,2,S-XC,10,0,0,0,0,6,4,,,,,,,,,,
20150924-M-St_Petersburg-R16-Roberto_Bautista_Agut-Teymuraz_Gabashvili,2,S-DTM,9,2,0,0,2,2,7,,,,,,,,,,
20150924-M-St_Petersburg-R16-Roberto_Bautista_Agut-Teymuraz_Gabashvili,2,S-DTL,7,1,0,1,0,4,3,,,,,,,,,,
20150925-M-Metz-QF-Martin_Klizan-Guillermo_Garcia_Lopez,1,F-XC,70,18,3,5,10,28,42,,,,,,,,,,
20150925-M-Metz-QF-Martin_Klizan-Guillermo_Garcia_Lopez,1,F-DTM,24,4,0,1,3,14,10,,,,,,,,,,
20150925-M-Metz-QF-Martin_Klizan-Guillermo_Garcia_Lopez,1,F-DTL,7,3,3,0,0,3,4,,,,,,,,,,
20150925-M-Metz-QF-Martin_Klizan-Guillermo_Garcia_Lopez,1,F-IO,10,3,0,3,0,8,2,,,,,,,,,,
20150925-M-Metz-QF-Martin_Klizan-Guillermo_Garcia_Lopez,1,F-II,4,2,0,1,1,3,1,,,,,,,,,,
20150925-M-Metz-QF-Martin_Klizan-Guillermo_Garcia_Lopez,1,B-XC,65,16,2,4,10,23,42,,,,,,,,,,
20150925-M-Metz-QF-Martin_Klizan-Guillermo_Garcia_Lopez,1,B-DTM,35,3,1,0,2,11,24,,,,,,,,,,
20150925-M-Metz-QF-Martin_Klizan-Guillermo_Garcia_Lopez,1,B-DTL,16,6,3,3,0,12,4,,,,,,,,,,
20150925-M-Metz-QF-Martin_Klizan-Guillermo_Garcia_Lopez,1,B-IO,9,1,1,0,0,5,4,,,,,,,,,,
20150925-M-Metz-QF-Martin_Klizan-Guillermo_Garcia_Lopez,1,S-XC,1,0,0,0,0,0,1,,,,,,,,,,
20150925-M-Metz-QF-Martin_Klizan-Guillermo_Garcia_Lopez,1,S-DTM,1,0,0,0,0,1,0,,,,,,,,,,
20150925-M-Metz-QF-Martin_Klizan-Guillermo_Garcia_Lopez,1,S-DTL,1,1,1,0,0,1,0,,,,,,,,,,
20150925-M-Metz-QF-Martin_Klizan-Guillermo_Garcia_Lopez,1,S-IO,2,0,0,0,0,0,2,,,,,,,,,,
20150925-M-Metz-QF-Martin_Klizan-Guillermo_Garcia_Lopez,2,F-XC,49,10,3,1,6,29,20,,,,,,,,,,
20150925-M-Metz-QF-Martin_Klizan-Guillermo_Garcia_Lopez,2,F-DTM,43,3,0,0,3,26,17,,,,,,,,,,
20150925-M-Metz-QF-Martin_Klizan-Guillermo_Garcia_Lopez,2,F-DTL,17,6,5,1,0,11,6,,,,,,,,,,
20150925-M-Metz-QF-Martin_Klizan-Guillermo_Garcia_Lopez,2,F-IO,23,7,4,1,2,15,8,,,,,,,,,,
20150925-M-Metz-QF-Martin_Klizan-Guillermo_Garcia_Lopez,2,F-II,4,1,1,0,0,2,2,,,,,,,,,,
20150925-M-Metz-QF-Martin_Klizan-Guillermo_Garcia_Lopez,2,B-XC,17,3,1,1,1,9,8,,,,,,,,,,
20150925-M-Metz-QF-Martin_Klizan-Guillermo_Garcia_Lopez,2,B-DTM,42,1,0,0,1,23,19,,,,,,,,,,
20150925-M-Metz-QF-Martin_Klizan-Guillermo_Garcia_Lopez,2,B-DTL,18,6,2,3,1,14,4,,,,,,,,,,
20150925-M-Metz-QF-Martin_Klizan-Guillermo_Garcia_Lopez,2,B-IO,5,2,0,0,2,3,2,,,,,,,,,,
20150925-M-Metz-QF-Martin_Klizan-Guillermo_Garcia_Lopez,2,S-XC,4,0,0,0,0,2,2,,,,,,,,,,
20150925-M-Metz-QF-Martin_Klizan-Guillermo_Garcia_Lopez,2,S-DTM,10,2,0,1,1,7,3,,,,,,,,,,
20150925-M-Metz-QF-Martin_Klizan-Guillermo_Garcia_Lopez,2,S-DTL,9,1,0,0,1,3,6,,,,,,,,,,
20150925-M-St_Petersburg-QF-Milos_Raonic-Tommy_Robredo,1,F-XC,10,3,1,1,1,8,2,,,,,,,,,,
20150925-M-St_Petersburg-QF-Milos_Raonic-Tommy_Robredo,1,F-DTM,9,3,1,0,2,6,3,,,,,,,,,,
20150925-M-St_Petersburg-QF-Milos_Raonic-Tommy_Robredo,1,F-DTL,7,2,0,0,2,4,3,,,,,,,,,,
20150925-M-St_Petersburg-QF-Milos_Raonic-Tommy_Robredo,1,F-IO,18,8,5,1,2,13,5,,,,,,,,,,
20150925-M-St_Petersburg-QF-Milos_Raonic-Tommy_Robredo,1,F-II,1,1,0,0,1,0,1,,,,,,,,,,
20150925-M-St_Petersburg-QF-Milos_Raonic-Tommy_Robredo,1,B-XC,5,2,0,0,2,2,3,,,,,,,,,,
20150925-M-St_Petersburg-QF-Milos_Raonic-Tommy_Robredo,1,B-DTM,7,0,0,0,0,4,3,,,,,,,,,,
20150925-M-St_Petersburg-QF-Milos_Raonic-Tommy_Robredo,1,B-DTL,4,4,2,0,2,2,2,,,,,,,,,,
20150925-M-St_Petersburg-QF-Milos_Raonic-Tommy_Robredo,1,B-IO,3,1,1,0,0,3,0,,,,,,,,,,
20150925-M-St_Petersburg-QF-Milos_Raonic-Tommy_Robredo,1,S-XC,5,0,0,0,0,4,1,,,,,,,,,,
20150925-M-St_Petersburg-QF-Milos_Raonic-Tommy_Robredo,1,S-DTL,1,1,0,1,0,1,0,,,,,,,,,,
20150925-M-St_Petersburg-QF-Milos_Raonic-Tommy_Robredo,1,S-IO,1,1,0,1,0,1,0,,,,,,,,,,
20150925-M-St_Petersburg-QF-Milos_Raonic-Tommy_Robredo,2,F-XC,11,4,0,1,3,4,7,,,,,,,,,,
20150925-M-St_Petersburg-QF-Milos_Raonic-Tommy_Robredo,2,F-DTM,10,3,0,0,3,1,9,,,,,,,,,,
20150925-M-St_Petersburg-QF-Milos_Raonic-Tommy_Robredo,2,F-DTL,2,0,0,0,0,0,2,,,,,,,,,,
20150925-M-St_Petersburg-QF-Milos_Raonic-Tommy_Robredo,2,F-IO,8,1,0,1,0,4,4,,,,,,,,,,
20150925-M-St_Petersburg-QF-Milos_Raonic-Tommy_Robredo,2,F-II,1,0,0,0,0,0,1,,,,,,,,,,
20150925-M-St_Petersburg-QF-Milos_Raonic-Tommy_Robredo,2,B-XC,10,2,0,2,0,4,6,,,,,,,,,,
20150925-M-St_Petersburg-QF-Milos_Raonic-Tommy_Robredo,2,B-DTM,8,2,0,1,1,3,5,,,,,,,,,,
20150925-M-St_Petersburg-QF-Milos_Raonic-Tommy_Robredo,2,B-DTL,3,2,1,0,1,1,2,,,,,,,,,,
20150925-M-St_Petersburg-QF-Milos_Raonic-Tommy_Robredo,2,B-IO,1,1,0,0,1,0,1,,,,,,,,,,
20150925-M-St_Petersburg-QF-Milos_Raonic-Tommy_Robredo,2,S-XC,6,1,0,1,0,2,4,,,,,,,,,,
20150925-M-St_Petersburg-QF-Milos_Raonic-Tommy_Robredo,2,S-DTM,7,0,0,0,0,3,4,,,,,,,,,,
20150925-M-St_Petersburg-QF-Milos_Raonic-Tommy_Robredo,2,S-DTL,1,0,0,0,0,0,1,,,,,,,,,,
20150925-M-St_Petersburg-QF-Milos_Raonic-Tommy_Robredo,2,S-IO,2,0,0,0,0,1,1,,,,,,,,,,
20150927-M-Metz-F-Jo_Wilfried_Tsonga-Gilles_Simon,1,F-XC,62,24,11,3,10,30,32,,,,,,,,,,
20150927-M-Metz-F-Jo_Wilfried_Tsonga-Gilles_Simon,1,F-DTM,34,5,1,0,4,12,22,,,,,,,,,,
20150927-M-Metz-F-Jo_Wilfried_Tsonga-Gilles_Simon,1,F-DTL,13,6,2,2,2,5,8,,,,,,,,,,
20150927-M-Metz-F-Jo_Wilfried_Tsonga-Gilles_Simon,1,F-IO,41,17,2,7,8,23,18,,,,,,,,,,
20150927-M-Metz-F-Jo_Wilfried_Tsonga-Gilles_Simon,1,F-II,5,4,1,1,2,2,3,,,,,,,,,,
20150927-M-Metz-F-Jo_Wilfried_Tsonga-Gilles_Simon,1,B-XC,28,4,0,0,4,9,19,,,,,,,,,,
20150927-M-Metz-F-Jo_Wilfried_Tsonga-Gilles_Simon,1,B-DTM,32,3,0,0,3,5,27,,,,,,,,,,
20150927-M-Metz-F-Jo_Wilfried_Tsonga-Gilles_Simon,1,B-DTL,11,3,0,1,2,6,5,,,,,,,,,,
20150927-M-Metz-F-Jo_Wilfried_Tsonga-Gilles_Simon,1,B-IO,4,2,1,0,1,2,2,,,,,,,,,,
20150927-M-Metz-F-Jo_Wilfried_Tsonga-Gilles_Simon,1,S-XC,28,2,0,1,1,12,16,,,,,,,,,,
20150927-M-Metz-F-Jo_Wilfried_Tsonga-Gilles_Simon,1,S-DTM,14,0,0,0,0,5,9,,,,,,,,,,
20150927-M-Metz-F-Jo_Wilfried_Tsonga-Gilles_Simon,2,F-XC,45,8,4,2,2,32,13,,,,,,,,,,
20150927-M-Metz-F-Jo_Wilfried_Tsonga-Gilles_Simon,2,F-DTM,48,3,0,0,3,32,16,,,,,,,,,,
20150927-M-Metz-F-Jo_Wilfried_Tsonga-Gilles_Simon,2,F-DTL,16,5,3,2,0,8,8,,,,,,,,,,
20150927-M-Metz-F-Jo_Wilfried_Tsonga-Gilles_Simon,2,F-IO,25,8,3,2,3,14,11,,,,,,,,,,
20150927-M-Metz-F-Jo_Wilfried_Tsonga-Gilles_Simon,2,F-II,3,2,1,0,1,1,2,,,,,,,,,,
20150927-M-Metz-F-Jo_Wilfried_Tsonga-Gilles_Simon,2,B-XC,66,9,1,5,3,42,24,,,,,,,,,,
20150927-M-Metz-F-Jo_Wilfried_Tsonga-Gilles_Simon,2,B-DTM,47,1,1,0,0,30,17,,,,,,,,,,
20150927-M-Metz-F-Jo_Wilfried_Tsonga-Gilles_Simon,2,B-DTL,19,6,2,3,1,12,7,,,,,,,,,,
20150927-M-Metz-F-Jo_Wilfried_Tsonga-Gilles_Simon,2,B-IO,4,1,0,0,1,3,1,,,,,,,,,,
20150927-M-Metz-F-Jo_Wilfried_Tsonga-Gilles_Simon,2,S-XC,1,0,0,0,0,0,1,,,,,,,,,,
20150927-M-Metz-F-Jo_Wilfried_Tsonga-Gilles_Simon,2,S-DTM,1,0,0,0,0,0,1,,,,,,,,,,
20150927-M-Metz-F-Jo_Wilfried_Tsonga-Gilles_Simon,2,S-DTL,1,0,0,0,0,1,0,,,,,,,,,,
20150927-M-Metz-SF-Jo_Wilfried_Tsonga-Philipp_Kohlschreiber,1,F-XC,12,8,5,2,1,9,3,,,,,,,,,,
20150927-M-Metz-SF-Jo_Wilfried_Tsonga-Philipp_Kohlschreiber,1,F-DTM,10,1,0,0,1,6,4,,,,,,,,,,
20150927-M-Metz-SF-Jo_Wilfried_Tsonga-Philipp_Kohlschreiber,1,F-DTL,2,2,0,1,1,1,1,,,,,,,,,,
20150927-M-Metz-SF-Jo_Wilfried_Tsonga-Philipp_Kohlschreiber,1,F-IO,9,7,4,2,1,7,2,,,,,,,,,,
20150927-M-Metz-SF-Jo_Wilfried_Tsonga-Philipp_Kohlschreiber,1,B-XC,8,3,0,2,1,6,2,,,,,,,,,,
20150927-M-Metz-SF-Jo_Wilfried_Tsonga-Philipp_Kohlschreiber,1,B-DTM,16,2,0,1,1,13,3,,,,,,,,,,
20150927-M-Metz-SF-Jo_Wilfried_Tsonga-Philipp_Kohlschreiber,1,B-IO,1,0,0,0,0,1,0,,,,,,,,,,
20150927-M-Metz-SF-Jo_Wilfried_Tsonga-Philipp_Kohlschreiber,1,S-XC,5,1,0,0,1,2,3,,,,,,,,,,
20150927-M-Metz-SF-Jo_Wilfried_Tsonga-Philipp_Kohlschreiber,1,S-DTM,3,1,0,0,1,1,2,,,,,,,,,,
20150927-M-Metz-SF-Jo_Wilfried_Tsonga-Philipp_Kohlschreiber,1,S-DTL,1,0,0,0,0,0,1,,,,,,,,,,
20150927-M-Metz-SF-Jo_Wilfried_Tsonga-Philipp_Kohlschreiber,2,F-XC,11,5,1,1,3,6,5,,,,,,,,,,
20150927-M-Metz-SF-Jo_Wilfried_Tsonga-Philipp_Kohlschreiber,2,F-DTM,15,0,0,0,0,5,10,,,,,,,,,,
20150927-M-Metz-SF-Jo_Wilfried_Tsonga-Philipp_Kohlschreiber,2,F-DTL,2,1,0,0,1,0,2,,,,,,,,,,
20150927-M-Metz-SF-Jo_Wilfried_Tsonga-Philipp_Kohlschreiber,2,F-IO,13,5,1,2,2,7,6,,,,,,,,,,
20150927-M-Metz-SF-Jo_Wilfried_Tsonga-Philipp_Kohlschreiber,2,F-II,1,1,1,0,0,1,0,,,,,,,,,,
20150927-M-Metz-SF-Jo_Wilfried_Tsonga-Philipp_Kohlschreiber,2,B-XC,15,2,0,0,2,1,14,,,,,,,,,,
20150927-M-Metz-SF-Jo_Wilfried_Tsonga-Philipp_Kohlschreiber,2,B-DTM,7,0,0,0,0,4,3,,,,,,,,,,
20150927-M-Metz-SF-Jo_Wilfried_Tsonga-Philipp_Kohlschreiber,2,B-IO,2,1,0,1,0,1,1,,,,,,,,,,
20150927-M-Metz-SF-Jo_Wilfried_Tsonga-Philipp_Kohlschreiber,2,S-XC,4,0,0,0,0,1,3,,,,,,,,,,
20150927-M-Metz-SF-Jo_Wilfried_Tsonga-Philipp_Kohlschreiber,2,S-DTM,2,0,0,0,0,1,1,,,,,,,,,,
20150928-M-Pereira_CH-R16-Marcelo_Arevalo-Alejandro_Falla,1,F-XC,22,4,2,0,2,14,8,,,,,,,,,,
20150928-M-Pereira_CH-R16-Marcelo_Arevalo-Alejandro_Falla,1,F-DTM,14,1,0,0,1,8,6,,,,,,,,,,
20150928-M-Pereira_CH-R16-Marcelo_Arevalo-Alejandro_Falla,1,F-DTL,4,3,2,1,0,3,1,,,,,,,,,,
20150928-M-Pereira_CH-R16-Marcelo_Arevalo-Alejandro_Falla,1,F-IO,6,1,1,0,0,2,4,,,,,,,,,,
20150928-M-Pereira_CH-R16-Marcelo_Arevalo-Alejandro_Falla,1,F-II,2,1,0,1,0,1,1,,,,,,,,,,
20150928-M-Pereira_CH-R16-Marcelo_Arevalo-Alejandro_Falla,1,B-XC,10,3,2,0,1,8,2,,,,,,,,,,
20150928-M-Pereira_CH-R16-Marcelo_Arevalo-Alejandro_Falla,1,B-DTM,14,1,0,0,1,6,8,,,,,,,,,,
20150928-M-Pereira_CH-R16-Marcelo_Arevalo-Alejandro_Falla,1,B-DTL,7,0,0,0,0,3,4,,,,,,,,,,
20150928-M-Pereira_CH-R16-Marcelo_Arevalo-Alejandro_Falla,1,B-IO,1,0,0,0,0,1,0,,,,,,,,,,
20150928-M-Pereira_CH-R16-Marcelo_Arevalo-Alejandro_Falla,1,S-XC,2,0,0,0,0,1,1,,,,,,,,,,
20150928-M-Pereira_CH-R16-Marcelo_Arevalo-Alejandro_Falla,1,S-DTM,2,0,0,0,0,1,1,,,,,,,,,,
20150928-M-Pereira_CH-R16-Marcelo_Arevalo-Alejandro_Falla,1,S-DTL,2,0,0,0,0,1,1,,,,,,,,,,
20150928-M-Pereira_CH-R16-Marcelo_Arevalo-Alejandro_Falla,2,F-XC,33,7,1,2,4,16,17,,,,,,,,,,
20150928-M-Pereira_CH-R16-Marcelo_Arevalo-Alejandro_Falla,2,F-DTM,9,3,1,0,2,4,5,,,,,,,,,,
20150928-M-Pereira_CH-R16-Marcelo_Arevalo-Alejandro_Falla,2,F-DTL,5,0,0,0,0,3,2,,,,,,,,,,
20150928-M-Pereira_CH-R16-Marcelo_Arevalo-Alejandro_Falla,2,F-IO,17,8,3,2,3,9,8,,,,,,,,,,
20150928-M-Pereira_CH-R16-Marcelo_Arevalo-Alejandro_Falla,2,F-II,2,1,0,1,0,2,0,,,,,,,,,,
20150928-M-Pereira_CH-R16-Marcelo_Arevalo-Alejandro_Falla,2,B-XC,18,10,2,3,5,7,11,,,,,,,,,,
20150928-M-Pereira_CH-R16-Marcelo_Arevalo-Alejandro_Falla,2,B-DTM,9,1,0,0,1,4,5,,,,,,,,,,
20150928-M-Pereira_CH-R16-Marcelo_Arevalo-Alejandro_Falla,2,B-DTL,8,2,0,0,2,3,5,,,,,,,,,,
20150928-M-Pereira_CH-R16-Marcelo_Arevalo-Alejandro_Falla,2,B-IO,1,1,0,1,0,1,0,,,,,,,,,,
20150928-M-Pereira_CH-R16-Marcelo_Arevalo-Alejandro_Falla,2,S-DTM,2,0,0,0,0,0,2,,,,,,,,,,
20150928-M-Pereira_CH-R16-Marcelo_Arevalo-Alejandro_Falla,2,S-DTL,1,1,0,1,0,1,0,,,,,,,,,,
20150929-M-Tiburon_CH-R32-Jared_Donaldson-Darian_King,1,F-XC,60,8,3,2,3,33,27,,,,,,,,,,
20150929-M-Tiburon_CH-R32-Jared_Donaldson-Darian_King,1,F-DTM,18,2,0,0,2,9,9,,,,,,,,,,
20150929-M-Tiburon_CH-R32-Jared_Donaldson-Darian_King,1,F-DTL,11,5,1,2,2,7,4,,,,,,,,,,
20150929-M-Tiburon_CH-R32-Jared_Donaldson-Darian_King,1,F-IO,33,11,3,3,5,20,13,,,,,,,,,,
20150929-M-Tiburon_CH-R32-Jared_Donaldson-Darian_King,1,F-II,2,1,1,0,0,1,1,,,,,,,,,,
20150929-M-Tiburon_CH-R32-Jared_Donaldson-Darian_King,1,B-XC,45,7,2,1,4,23,22,,,,,,,,,,
20150929-M-Tiburon_CH-R32-Jared_Donaldson-Darian_King,1,B-DTM,22,2,0,0,2,15,7,,,,,,,,,,
20150929-M-Tiburon_CH-R32-Jared_Donaldson-Darian_King,1,B-DTL,13,6,2,2,2,9,4,,,,,,,,,,
20150929-M-Tiburon_CH-R32-Jared_Donaldson-Darian_King,1,B-IO,4,2,1,0,1,3,1,,,,,,,,,,
20150929-M-Tiburon_CH-R32-Jared_Donaldson-Darian_King,1,S-XC,1,1,0,0,1,0,1,,,,,,,,,,
20150929-M-Tiburon_CH-R32-Jared_Donaldson-Darian_King,1,S-DTL,1,0,0,0,0,0,1,,,,,,,,,,
20150929-M-Tiburon_CH-R32-Jared_Donaldson-Darian_King,2,F-XC,39,5,3,0,2,21,18,,,,,,,,,,
20150929-M-Tiburon_CH-R32-Jared_Donaldson-Darian_King,2,F-DTM,24,3,0,0,3,6,18,,,,,,,,,,
20150929-M-Tiburon_CH-R32-Jared_Donaldson-Darian_King,2,F-DTL,24,6,1,0,5,6,18,,,,,,,,,,
20150929-M-Tiburon_CH-R32-Jared_Donaldson-Darian_King,2,F-IO,15,1,0,0,1,9,6,,,,,,,,,,
20150929-M-Tiburon_CH-R32-Jared_Donaldson-Darian_King,2,B-XC,36,1,0,0,1,16,20,,,,,,,,,,
20150929-M-Tiburon_CH-R32-Jared_Donaldson-Darian_King,2,B-DTM,33,3,0,0,3,10,23,,,,,,,,,,
20150929-M-Tiburon_CH-R32-Jared_Donaldson-Darian_King,2,B-DTL,11,3,1,0,2,3,8,,,,,,,,,,
20150929-M-Tiburon_CH-R32-Jared_Donaldson-Darian_King,2,B-IO,1,1,0,0,1,0,1,,,,,,,,,,
20150929-M-Tiburon_CH-R32-Jared_Donaldson-Darian_King,2,S-DTM,5,0,0,0,0,2,3,,,,,,,,,,
20150929-M-Tiburon_CH-R32-Jared_Donaldson-Darian_King,2,S-DTL,1,0,0,0,0,0,1,,,,,,,,,,
20151003-M-Kuala_Lumpur-SF-Feliciano_Lopez-Nick_Kyrgios,1,F-XC,50,11,2,4,5,24,26,,,,,,,,,,
20151003-M-Kuala_Lumpur-SF-Feliciano_Lopez-Nick_Kyrgios,1,F-DTM,7,0,0,0,0,2,5,,,,,,,,,,
20151003-M-Kuala_Lumpur-SF-Feliciano_Lopez-Nick_Kyrgios,1,F-DTL,9,5,3,1,1,5,4,,,,,,,,,,
20151003-M-Kuala_Lumpur-SF-Feliciano_Lopez-Nick_Kyrgios,1,F-IO,9,1,1,0,0,6,3,,,,,,,,,,
20151003-M-Kuala_Lumpur-SF-Feliciano_Lopez-Nick_Kyrgios,1,F-II,1,1,0,0,1,0,1,,,,,,,,,,
20151003-M-Kuala_Lumpur-SF-Feliciano_Lopez-Nick_Kyrgios,1,B-XC,9,4,2,1,1,4,5,,,,,,,,,,
20151003-M-Kuala_Lumpur-SF-Feliciano_Lopez-Nick_Kyrgios,1,B-DTM,7,2,0,0,2,2,5,,,,,,,,,,
20151003-M-Kuala_Lumpur-SF-Feliciano_Lopez-Nick_Kyrgios,1,B-DTL,2,1,0,1,0,2,0,,,,,,,,,,
20151003-M-Kuala_Lumpur-SF-Feliciano_Lopez-Nick_Kyrgios,1,B-IO,3,1,0,1,0,2,1,,,,,,,,,,
20151003-M-Kuala_Lumpur-SF-Feliciano_Lopez-Nick_Kyrgios,1,B-II,1,1,0,0,1,0,1,,,,,,,,,,
20151003-M-Kuala_Lumpur-SF-Feliciano_Lopez-Nick_Kyrgios,1,S-XC,15,2,0,2,0,12,3,,,,,,,,,,
20151003-M-Kuala_Lumpur-SF-Feliciano_Lopez-Nick_Kyrgios,1,S-DTM,7,1,0,1,0,3,4,,,,,,,,,,
20151003-M-Kuala_Lumpur-SF-Feliciano_Lopez-Nick_Kyrgios,1,S-DTL,15,1,0,1,0,10,5,,,,,,,,,,
20151003-M-Kuala_Lumpur-SF-Feliciano_Lopez-Nick_Kyrgios,1,S-IO,6,1,0,0,1,2,4,,,,,,,,,,
20151003-M-Kuala_Lumpur-SF-Feliciano_Lopez-Nick_Kyrgios,2,F-XC,36,6,0,5,1,18,18,,,,,,,,,,
20151003-M-Kuala_Lumpur-SF-Feliciano_Lopez-Nick_Kyrgios,2,F-DTM,16,3,0,1,2,6,10,,,,,,,,,,
20151003-M-Kuala_Lumpur-SF-Feliciano_Lopez-Nick_Kyrgios,2,F-DTL,11,2,1,1,0,6,5,,,,,,,,,,
20151003-M-Kuala_Lumpur-SF-Feliciano_Lopez-Nick_Kyrgios,2,F-IO,13,3,0,2,1,7,6,,,,,,,,,,
20151003-M-Kuala_Lumpur-SF-Feliciano_Lopez-Nick_Kyrgios,2,F-II,4,1,1,0,0,3,1,,,,,,,,,,
20151003-M-Kuala_Lumpur-SF-Feliciano_Lopez-Nick_Kyrgios,2,B-XC,39,10,3,4,3,25,14,,,,,,,,,,
20151003-M-Kuala_Lumpur-SF-Feliciano_Lopez-Nick_Kyrgios,2,B-DTM,10,1,0,0,1,6,4,,,,,,,,,,
20151003-M-Kuala_Lumpur-SF-Feliciano_Lopez-Nick_Kyrgios,2,B-DTL,18,7,2,1,4,4,14,,,,,,,,,,
20151003-M-Kuala_Lumpur-SF-Feliciano_Lopez-Nick_Kyrgios,2,B-IO,4,1,0,0,1,3,1,,,,,,,,,,
20151003-M-Kuala_Lumpur-SF-Feliciano_Lopez-Nick_Kyrgios,2,S-XC,3,0,0,0,0,1,2,,,,,,,,,,
20151003-M-Kuala_Lumpur-SF-Feliciano_Lopez-Nick_Kyrgios,2,S-DTM,2,0,0,0,0,0,2,,,,,,,,,,
20151003-M-Kuala_Lumpur-SF-Feliciano_Lopez-Nick_Kyrgios,2,S-DTL,1,1,0,0,1,0,1,,,,,,,,,,
20151004-M-Kuala_Lumpur-F-David_Ferrer-Feliciano_Lopez,1,F-XC,55,12,3,5,4,43,12,,,,,,,,,,
20151004-M-Kuala_Lumpur-F-David_Ferrer-Feliciano_Lopez,1,F-DTM,28,0,0,0,0,18,10,,,,,,,,,,
20151004-M-Kuala_Lumpur-F-David_Ferrer-Feliciano_Lopez,1,F-DTL,9,6,4,2,0,9,0,,,,,,,,,,
20151004-M-Kuala_Lumpur-F-David_Ferrer-Feliciano_Lopez,1,F-IO,23,8,3,2,3,16,7,,,,,,,,,,
20151004-M-Kuala_Lumpur-F-David_Ferrer-Feliciano_Lopez,1,F-II,5,1,0,1,0,3,2,,,,,,,,,,
20151004-M-Kuala_Lumpur-F-David_Ferrer-Feliciano_Lopez,1,B-XC,12,6,2,1,3,6,6,,,,,,,,,,
20151004-M-Kuala_Lumpur-F-David_Ferrer-Feliciano_Lopez,1,B-DTM,12,1,0,0,1,6,6,,,,,,,,,,
20151004-M-Kuala_Lumpur-F-David_Ferrer-Feliciano_Lopez,1,B-DTL,15,6,0,2,4,7,8,,,,,,,,,,
20151004-M-Kuala_Lumpur-F-David_Ferrer-Feliciano_Lopez,1,B-IO,4,0,0,0,0,2,2,,,,,,,,,,
20151004-M-Kuala_Lumpur-F-David_Ferrer-Feliciano_Lopez,1,S-DTM,1,0,0,0,0,0,1,,,,,,,,,,
20151004-M-Kuala_Lumpur-F-David_Ferrer-Feliciano_Lopez,1,S-DTL,4,1,0,0,1,2,2,,,,,,,,,,
20151004-M-Kuala_Lumpur-F-David_Ferrer-Feliciano_Lopez,2,F-XC,16,4,1,0,3,4,12,,,,,,,,,,
20151004-M-Kuala_Lumpur-F-David_Ferrer-Feliciano_Lopez,2,F-DTM,15,1,0,0,1,8,7,,,,,,,,,,
20151004-M-Kuala_Lumpur-F-David_Ferrer-Feliciano_Lopez,2,F-DTL,1,0,0,0,0,0,1,,,,,,,,,,
20151004-M-Kuala_Lumpur-F-David_Ferrer-Feliciano_Lopez,2,F-IO,6,1,0,0,1,3,3,,,,,,,,,,
20151004-M-Kuala_Lumpur-F-David_Ferrer-Feliciano_Lopez,2,B-XC,9,4,0,1,3,1,8,,,,,,,,,,
20151004-M-Kuala_Lumpur-F-David_Ferrer-Feliciano_Lopez,2,B-DTM,15,5,0,0,5,4,11,,,,,,,,,,
20151004-M-Kuala_Lumpur-F-David_Ferrer-Feliciano_Lopez,2,S-XC,23,4,1,1,2,8,15,,,,,,,,,,
20151004-M-Kuala_Lumpur-F-David_Ferrer-Feliciano_Lopez,2,S-DTM,21,1,0,0,1,2,19,,,,,,,,,,
20151004-M-Kuala_Lumpur-F-David_Ferrer-Feliciano_Lopez,2,S-DTL,12,2,0,0,2,5,7,,,,,,,,,,
20151004-M-Kuala_Lumpur-F-David_Ferrer-Feliciano_Lopez,2,S-IO,10,2,0,1,1,5,5,,,,,,,,,,
20151005-M-Beijing-R32-David_Goffin-Andreas_Seppi,1,F-XC,27,6,2,2,2,14,13,,,,,,,,,,
20151005-M-Beijing-R32-David_Goffin-Andreas_Seppi,1,F-DTM,13,0,0,0,0,5,8,,,,,,,,,,
20151005-M-Beijing-R32-David_Goffin-Andreas_Seppi,1,F-DTL,6,3,1,0,2,3,3,,,,,,,,,,
20151005-M-Beijing-R32-David_Goffin-Andreas_Seppi,1,F-IO,15,5,1,2,2,9,6,,,,,,,,,,
20151005-M-Beijing-R32-David_Goffin-Andreas_Seppi,1,F-II,5,4,2,1,1,4,1,,,,,,,,,,
20151005-M-Beijing-R32-David_Goffin-Andreas_Seppi,1,B-XC,23,3,1,0,2,11,12,,,,,,,,,,
20151005-M-Beijing-R32-David_Goffin-Andreas_Seppi,1,B-DTM,32,5,0,2,3,16,16,,,,,,,,,,
20151005-M-Beijing-R32-David_Goffin-Andreas_Seppi,1,B-DTL,3,1,0,0,1,2,1,,,,,,,,,,
20151005-M-Beijing-R32-David_Goffin-Andreas_Seppi,1,B-IO,5,2,1,0,1,3,2,,,,,,,,,,
20151005-M-Beijing-R32-David_Goffin-Andreas_Seppi,1,S-XC,1,0,0,0,0,0,1,,,,,,,,,,
20151005-M-Beijing-R32-David_Goffin-Andreas_Seppi,1,S-DTM,4,0,0,0,0,2,2,,,,,,,,,,
20151005-M-Beijing-R32-David_Goffin-Andreas_Seppi,1,S-DTL,1,0,0,0,0,1,0,,,,,,,,,,
20151005-M-Beijing-R32-David_Goffin-Andreas_Seppi,1,S-II,1,0,0,0,0,0,1,,,,,,,,,,
20151005-M-Beijing-R32-David_Goffin-Andreas_Seppi,2,F-XC,23,6,3,2,1,14,9,,,,,,,,,,
20151005-M-Beijing-R32-David_Goffin-Andreas_Seppi,2,F-DTM,17,2,0,0,2,9,8,,,,,,,,,,
20151005-M-Beijing-R32-David_Goffin-Andreas_Seppi,2,F-DTL,11,3,1,0,2,5,6,,,,,,,,,,
20151005-M-Beijing-R32-David_Goffin-Andreas_Seppi,2,F-IO,12,4,1,1,2,7,5,,,,,,,,,,
20151005-M-Beijing-R32-David_Goffin-Andreas_Seppi,2,B-XC,29,5,0,0,5,11,18,,,,,,,,,,
20151005-M-Beijing-R32-David_Goffin-Andreas_Seppi,2,B-DTM,23,3,0,0,3,8,15,,,,,,,,,,
20151005-M-Beijing-R32-David_Goffin-Andreas_Seppi,2,B-DTL,5,2,0,2,0,4,1,,,,,,,,,,
20151005-M-Beijing-R32-David_Goffin-Andreas_Seppi,2,B-IO,4,1,0,0,1,2,2,,,,,,,,,,
20151005-M-Beijing-R32-David_Goffin-Andreas_Seppi,2,S-XC,4,0,0,0,0,1,3,,,,,,,,,,
20151005-M-Beijing-R32-David_Goffin-Andreas_Seppi,2,S-DTM,2,0,0,0,0,1,1,,,,,,,,,,
20151005-M-Mohammedia_CH-R32-David_Perez_Sanz-Pablo_Carreno_Busta,1,F-XC,5,0,0,0,0,3,2,,,,,,,,,,
20151005-M-Mohammedia_CH-R32-David_Perez_Sanz-Pablo_Carreno_Busta,1,F-DTM,5,0,0,0,0,3,2,,,,,,,,,,
20151005-M-Mohammedia_CH-R32-David_Perez_Sanz-Pablo_Carreno_Busta,1,F-DTL,3,1,0,0,1,0,3,,,,,,,,,,
20151005-M-Mohammedia_CH-R32-David_Perez_Sanz-Pablo_Carreno_Busta,1,F-IO,13,6,2,3,1,8,5,,,,,,,,,,
20151005-M-Mohammedia_CH-R32-David_Perez_Sanz-Pablo_Carreno_Busta,1,B-XC,32,8,2,0,6,18,14,,,,,,,,,,
20151005-M-Mohammedia_CH-R32-David_Perez_Sanz-Pablo_Carreno_Busta,1,B-DTM,10,2,0,0,2,4,6,,,,,,,,,,
20151005-M-Mohammedia_CH-R32-David_Perez_Sanz-Pablo_Carreno_Busta,1,B-DTL,5,3,3,0,0,4,1,,,,,,,,,,
20151005-M-Mohammedia_CH-R32-David_Perez_Sanz-Pablo_Carreno_Busta,1,S-XC,2,0,0,0,0,0,2,,,,,,,,,,
20151005-M-Mohammedia_CH-R32-David_Perez_Sanz-Pablo_Carreno_Busta,1,S-DTL,1,0,0,0,0,0,1,,,,,,,,,,
20151005-M-Mohammedia_CH-R32-David_Perez_Sanz-Pablo_Carreno_Busta,2,F-XC,10,6,3,1,2,7,3,,,,,,,,,,
20151005-M-Mohammedia_CH-R32-David_Perez_Sanz-Pablo_Carreno_Busta,2,F-DTM,7,0,0,0,0,4,3,,,,,,,,,,
20151005-M-Mohammedia_CH-R32-David_Perez_Sanz-Pablo_Carreno_Busta,2,F-DTL,1,1,1,0,0,1,0,,,,,,,,,,
20151005-M-Mohammedia_CH-R32-David_Perez_Sanz-Pablo_Carreno_Busta,2,F-IO,12,5,1,3,1,9,3,,,,,,,,,,
20151005-M-Mohammedia_CH-R32-David_Perez_Sanz-Pablo_Carreno_Busta,2,F-II,3,2,2,0,0,3,0,,,,,,,,,,
20151005-M-Mohammedia_CH-R32-David_Perez_Sanz-Pablo_Carreno_Busta,2,B-XC,24,4,0,1,3,9,15,,,,,,,,,,
20151005-M-Mohammedia_CH-R32-David_Perez_Sanz-Pablo_Carreno_Busta,2,B-DTM,7,0,0,0,0,3,4,,,,,,,,,,
20151005-M-Mohammedia_CH-R32-David_Perez_Sanz-Pablo_Carreno_Busta,2,B-DTL,4,3,2,0,1,3,1,,,,,,,,,,
20151005-M-Mohammedia_CH-R32-David_Perez_Sanz-Pablo_Carreno_Busta,2,S-XC,1,0,0,0,0,1,0,,,,,,,,,,
20151005-M-Mohammedia_CH-R32-David_Perez_Sanz-Pablo_Carreno_Busta,2,S-DTM,1,0,0,0,0,0,1,,,,,,,,,,
20151005-M-Mons_CH-Q3-Yannick_Mertens-Scott_Griekspoor,1,F-XC,34,8,4,0,4,19,15,,,,,,,,,,
20151005-M-Mons_CH-Q3-Yannick_Mertens-Scott_Griekspoor,1,F-DTM,23,1,0,0,1,10,13,,,,,,,,,,
20151005-M-Mons_CH-Q3-Yannick_Mertens-Scott_Griekspoor,1,F-DTL,5,1,1,0,0,3,2,,,,,,,,,,
20151005-M-Mons_CH-Q3-Yannick_Mertens-Scott_Griekspoor,1,F-IO,11,1,1,0,0,6,5,,,,,,,,,,
20151005-M-Mons_CH-Q3-Yannick_Mertens-Scott_Griekspoor,1,B-XC,39,3,0,1,2,26,13,,,,,,,,,,
20151005-M-Mons_CH-Q3-Yannick_Mertens-Scott_Griekspoor,1,B-DTM,26,1,0,1,0,19,7,,,,,,,,,,
20151005-M-Mons_CH-Q3-Yannick_Mertens-Scott_Griekspoor,1,B-DTL,1,1,0,1,0,1,0,,,,,,,,,,
20151005-M-Mons_CH-Q3-Yannick_Mertens-Scott_Griekspoor,1,S-XC,7,1,1,0,0,5,2,,,,,,,,,,
20151005-M-Mons_CH-Q3-Yannick_Mertens-Scott_Griekspoor,1,S-DTM,4,1,0,0,1,1,3,,,,,,,,,,
20151005-M-Mons_CH-Q3-Yannick_Mertens-Scott_Griekspoor,1,S-DTL,1,1,0,0,1,0,1,,,,,,,,,,
20151005-M-Mons_CH-Q3-Yannick_Mertens-Scott_Griekspoor,2,F-XC,35,8,2,1,5,19,16,,,,,,,,,,
20151005-M-Mons_CH-Q3-Yannick_Mertens-Scott_Griekspoor,2,F-DTM,21,1,0,0,1,9,12,,,,,,,,,,
20151005-M-Mons_CH-Q3-Yannick_Mertens-Scott_Griekspoor,2,F-DTL,5,0,0,0,0,2,3,,,,,,,,,,
20151005-M-Mons_CH-Q3-Yannick_Mertens-Scott_Griekspoor,2,F-IO,19,6,0,2,4,3,16,,,,,,,,,,
20151005-M-Mons_CH-Q3-Yannick_Mertens-Scott_Griekspoor,2,F-II,1,0,0,0,0,1,0,,,,,,,,,,
20151005-M-Mons_CH-Q3-Yannick_Mertens-Scott_Griekspoor,2,B-XC,30,3,1,0,2,9,21,,,,,,,,,,
20151005-M-Mons_CH-Q3-Yannick_Mertens-Scott_Griekspoor,2,B-DTM,17,3,0,0,3,5,12,,,,,,,,,,
20151005-M-Mons_CH-Q3-Yannick_Mertens-Scott_Griekspoor,2,B-DTL,3,1,1,0,0,2,1,,,,,,,,,,
20151005-M-Mons_CH-Q3-Yannick_Mertens-Scott_Griekspoor,2,B-IO,2,1,0,0,1,0,2,,,,,,,,,,
20151005-M-Mons_CH-Q3-Yannick_Mertens-Scott_Griekspoor,2,S-XC,12,1,0,0,1,6,6,,,,,,,,,,
20151005-M-Mons_CH-Q3-Yannick_Mertens-Scott_Griekspoor,2,S-DTM,5,0,0,0,0,3,2,,,,,,,,,,
20151005-M-Mons_CH-Q3-Yannick_Mertens-Scott_Griekspoor,2,S-DTL,1,0,0,0,0,0,1,,,,,,,,,,
20151006-M-Beijing-R32-Novak_Djokovic-Simone_Bolelli,1,F-XC,21,8,3,1,4,11,10,,,,,,,,,,
20151006-M-Beijing-R32-Novak_Djokovic-Simone_Bolelli,1,F-DTM,10,0,0,0,0,6,4,,,,,,,,,,
20151006-M-Beijing-R32-Novak_Djokovic-Simone_Bolelli,1,F-DTL,6,2,0,1,1,2,4,,,,,,,,,,
20151006-M-Beijing-R32-Novak_Djokovic-Simone_Bolelli,1,F-IO,5,1,1,0,0,4,1,,,,,,,,,,
20151006-M-Beijing-R32-Novak_Djokovic-Simone_Bolelli,1,F-II,3,0,0,0,0,1,2,,,,,,,,,,
20151006-M-Beijing-R32-Novak_Djokovic-Simone_Bolelli,1,B-XC,26,4,2,1,1,18,8,,,,,,,,,,
20151006-M-Beijing-R32-Novak_Djokovic-Simone_Bolelli,1,B-DTM,13,2,0,0,2,4,9,,,,,,,,,,
20151006-M-Beijing-R32-Novak_Djokovic-Simone_Bolelli,1,B-DTL,10,5,0,3,2,5,5,,,,,,,,,,
20151006-M-Beijing-R32-Novak_Djokovic-Simone_Bolelli,1,B-IO,7,4,2,0,2,5,2,,,,,,,,,,
20151006-M-Beijing-R32-Novak_Djokovic-Simone_Bolelli,1,S-XC,3,1,0,0,1,1,2,,,,,,,,,,
20151006-M-Beijing-R32-Novak_Djokovic-Simone_Bolelli,1,S-DTM,3,0,0,0,0,2,1,,,,,,,,,,
20151006-M-Beijing-R32-Novak_Djokovic-Simone_Bolelli,1,S-DTL,1,0,0,0,0,0,1,,,,,,,,,,
20151006-M-Beijing-R32-Novak_Djokovic-Simone_Bolelli,2,F-XC,35,12,3,1,9,14,21,,,,,,,,,,
20151006-M-Beijing-R32-Novak_Djokovic-Simone_Bolelli,2,F-DTM,11,1,0,1,0,6,5,,,,,,,,,,
20151006-M-Beijing-R32-Novak_Djokovic-Simone_Bolelli,2,F-DTL,7,3,0,1,2,2,5,,,,,,,,,,
20151006-M-Beijing-R32-Novak_Djokovic-Simone_Bolelli,2,F-IO,21,3,0,0,3,8,13,,,,,,,,,,
20151006-M-Beijing-R32-Novak_Djokovic-Simone_Bolelli,2,F-II,1,1,0,1,0,1,0,,,,,,,,,,
20151006-M-Beijing-R32-Novak_Djokovic-Simone_Bolelli,2,B-XC,17,3,0,0,3,7,10,,,,,,,,,,
20151006-M-Beijing-R32-Novak_Djokovic-Simone_Bolelli,2,B-DTM,9,2,1,0,1,2,7,,,,,,,,,,
20151006-M-Beijing-R32-Novak_Djokovic-Simone_Bolelli,2,B-DTL,1,1,0,0,1,0,1,,,,,,,,,,
20151006-M-Beijing-R32-Novak_Djokovic-Simone_Bolelli,2,B-IO,1,0,0,0,0,1,0,,,,,,,,,,
20151006-M-Beijing-R32-Novak_Djokovic-Simone_Bolelli,2,S-XC,14,2,0,0,2,7,7,,,,,,,,,,
20151006-M-Beijing-R32-Novak_Djokovic-Simone_Bolelli,2,S-DTM,2,0,0,0,0,1,1,,,,,,,,,,
20151008-M-Beijing-R16-Novak_Djokovic-Ze_Zhang,1,F-XC,26,6,2,2,2,19,7,,,,,,,,,,
20151008-M-Beijing-R16-Novak_Djokovic-Ze_Zhang,1,F-DTM,7,1,0,0,1,4,3,,,,,,,,,,
20151008-M-Beijing-R16-Novak_Djokovic-Ze_Zhang,1,F-DTL,12,5,0,0,5,7,5,,,,,,,,,,
20151008-M-Beijing-R16-Novak_Djokovic-Ze_Zhang,1,F-IO,17,5,2,0,3,11,6,,,,,,,,,,
20151008-M-Beijing-R16-Novak_Djokovic-Ze_Zhang,1,F-II,1,1,1,0,0,1,0,,,,,,,,,,
20151008-M-Beijing-R16-Novak_Djokovic-Ze_Zhang,1,B-XC,23,4,2,1,1,16,7,,,,,,,,,,
20151008-M-Beijing-R16-Novak_Djokovic-Ze_Zhang,1,B-DTM,15,0,0,0,0,12,3,,,,,,,,,,
20151008-M-Beijing-R16-Novak_Djokovic-Ze_Zhang,1,B-DTL,3,1,0,1,0,2,1,,,,,,,,,,
20151008-M-Beijing-R16-Novak_Djokovic-Ze_Zhang,1,B-IO,5,1,1,0,0,2,3,,,,,,,,,,
20151008-M-Beijing-R16-Novak_Djokovic-Ze_Zhang,1,S-XC,3,0,0,0,0,2,1,,,,,,,,,,
20151008-M-Beijing-R16-Novak_Djokovic-Ze_Zhang,1,S-DTM,1,0,0,0,0,0,1,,,,,,,,,,
20151008-M-Beijing-R16-Novak_Djokovic-Ze_Zhang,1,S-DTL,1,1,0,0,1,0,1,,,,,,,,,,
20151008-M-Beijing-R16-Novak_Djokovic-Ze_Zhang,2,F-XC,17,0,0,0,0,7,10,,,,,,,,,,
20151008-M-Beijing-R16-Novak_Djokovic-Ze_Zhang,2,F-DTM,20,0,0,0,0,6,14,,,,,,,,,,
20151008-M-Beijing-R16-Novak_Djokovic-Ze_Zhang,2,F-DTL,2,0,0,0,0,1,1,,,,,,,,,,
20151008-M-Beijing-R16-Novak_Djokovic-Ze_Zhang,2,F-IO,11,2,0,0,2,2,9,,,,,,,,,,
20151008-M-Beijing-R16-Novak_Djokovic-Ze_Zhang,2,B-XC,18,2,0,0,2,6,12,,,,,,,,,,
20151008-M-Beijing-R16-Novak_Djokovic-Ze_Zhang,2,B-DTM,29,3,0,0,3,8,21,,,,,,,,,,
20151008-M-Beijing-R16-Novak_Djokovic-Ze_Zhang,2,B-DTL,4,1,0,0,1,1,3,,,,,,,,,,
20151008-M-Beijing-R16-Novak_Djokovic-Ze_Zhang,2,B-IO,5,2,0,0,2,3,2,,,,,,,,,,
20151008-M-Beijing-R16-Novak_Djokovic-Ze_Zhang,2,S-XC,4,1,0,0,1,0,4,,,,,,,,,,
20151008-M-Beijing-R16-Novak_Djokovic-Ze_Zhang,2,S-DTM,3,0,0,0,0,1,2,,,,,,,,,,
20151008-M-Beijing-R16-Novak_Djokovic-Ze_Zhang,2,S-DTL,1,0,0,0,0,1,0,,,,,,,,,,
20151008-M-Sacramento_CH-R16-Jared_Donaldson-Tennys_Sandgren,1,F-XC,41,15,3,3,9,23,18,,,,,,,,,,
20151008-M-Sacramento_CH-R16-Jared_Donaldson-Tennys_Sandgren,1,F-DTM,22,1,0,1,0,14,8,,,,,,,,,,
20151008-M-Sacramento_CH-R16-Jared_Donaldson-Tennys_Sandgren,1,F-DTL,9,6,1,2,3,4,5,,,,,,,,,,
20151008-M-Sacramento_CH-R16-Jared_Donaldson-Tennys_Sandgren,1,F-IO,15,6,0,3,3,9,6,,,,,,,,,,
20151008-M-Sacramento_CH-R16-Jared_Donaldson-Tennys_Sandgren,1,F-II,1,0,0,0,0,0,1,,,,,,,,,,
20151008-M-Sacramento_CH-R16-Jared_Donaldson-Tennys_Sandgren,1,B-XC,39,3,0,1,2,28,11,,,,,,,,,,
20151008-M-Sacramento_CH-R16-Jared_Donaldson-Tennys_Sandgren,1,B-DTM,20,2,0,0,2,15,5,,,,,,,,,,
20151008-M-Sacramento_CH-R16-Jared_Donaldson-Tennys_Sandgren,1,B-DTL,15,8,4,3,1,13,2,,,,,,,,,,
20151008-M-Sacramento_CH-R16-Jared_Donaldson-Tennys_Sandgren,1,B-IO,3,1,0,0,1,2,1,,,,,,,,,,
20151008-M-Sacramento_CH-R16-Jared_Donaldson-Tennys_Sandgren,1,S-XC,2,0,0,0,0,2,0,,,,,,,,,,
20151008-M-Sacramento_CH-R16-Jared_Donaldson-Tennys_Sandgren,1,S-DTM,5,0,0,0,0,2,3,,,,,,,,,,
20151008-M-Sacramento_CH-R16-Jared_Donaldson-Tennys_Sandgren,2,F-XC,37,8,1,0,7,14,23,,,,,,,,,,
20151008-M-Sacramento_CH-R16-Jared_Donaldson-Tennys_Sandgren,2,F-DTM,14,0,0,0,0,7,7,,,,,,,,,,
20151008-M-Sacramento_CH-R16-Jared_Donaldson-Tennys_Sandgren,2,F-DTL,10,2,1,0,1,3,7,,,,,,,,,,
20151008-M-Sacramento_CH-R16-Jared_Donaldson-Tennys_Sandgren,2,F-IO,22,4,2,0,2,8,14,,,,,,,,,,
20151008-M-Sacramento_CH-R16-Jared_Donaldson-Tennys_Sandgren,2,B-XC,40,6,1,0,5,9,31,,,,,,,,,,
20151008-M-Sacramento_CH-R16-Jared_Donaldson-Tennys_Sandgren,2,B-DTM,29,3,0,1,2,13,16,,,,,,,,,,
20151008-M-Sacramento_CH-R16-Jared_Donaldson-Tennys_Sandgren,2,B-DTL,5,0,0,0,0,2,3,,,,,,,,,,
20151008-M-Sacramento_CH-R16-Jared_Donaldson-Tennys_Sandgren,2,S-XC,3,0,0,0,0,0,3,,,,,,,,,,
20151008-M-Sacramento_CH-R16-Jared_Donaldson-Tennys_Sandgren,2,S-DTM,2,0,0,0,0,1,1,,,,,,,,,,
20151008-M-Tokyo-R16-Roberto_Bautista_Agut-Nick_Kyrgios,1,F-XC,29,8,3,3,2,14,15,,,,,,,,,,
20151008-M-Tokyo-R16-Roberto_Bautista_Agut-Nick_Kyrgios,1,F-DTM,13,0,0,0,0,3,10,,,,,,,,,,
20151008-M-Tokyo-R16-Roberto_Bautista_Agut-Nick_Kyrgios,1,F-DTL,9,4,2,0,2,3,6,,,,,,,,,,
20151008-M-Tokyo-R16-Roberto_Bautista_Agut-Nick_Kyrgios,1,F-IO,23,7,3,1,3,12,11,,,,,,,,,,
20151008-M-Tokyo-R16-Roberto_Bautista_Agut-Nick_Kyrgios,1,F-II,2,1,0,0,1,1,1,,,,,,,,,,
20151008-M-Tokyo-R16-Roberto_Bautista_Agut-Nick_Kyrgios,1,B-XC,5,2,0,0,2,1,4,,,,,,,,,,
20151008-M-Tokyo-R16-Roberto_Bautista_Agut-Nick_Kyrgios,1,B-DTM,30,4,0,0,4,8,22,,,,,,,,,,
20151008-M-Tokyo-R16-Roberto_Bautista_Agut-Nick_Kyrgios,1,B-IO,1,1,0,0,1,0,1,,,,,,,,,,
20151008-M-Tokyo-R16-Roberto_Bautista_Agut-Nick_Kyrgios,1,S-XC,5,0,0,0,0,2,3,,,,,,,,,,
20151008-M-Tokyo-R16-Roberto_Bautista_Agut-Nick_Kyrgios,1,S-DTM,4,0,0,0,0,2,2,,,,,,,,,,
20151008-M-Tokyo-R16-Roberto_Bautista_Agut-Nick_Kyrgios,2,F-XC,28,4,1,3,0,21,7,,,,,,,,,,
20151008-M-Tokyo-R16-Roberto_Bautista_Agut-Nick_Kyrgios,2,F-DTM,12,1,0,0,1,6,6,,,,,,,,,,
20151008-M-Tokyo-R16-Roberto_Bautista_Agut-Nick_Kyrgios,2,F-DTL,7,1,0,1,0,4,3,,,,,,,,,,
20151008-M-Tokyo-R16-Roberto_Bautista_Agut-Nick_Kyrgios,2,F-IO,10,2,2,0,0,9,1,,,,,,,,,,
20151008-M-Tokyo-R16-Roberto_Bautista_Agut-Nick_Kyrgios,2,F-II,2,2,0,2,0,2,0,,,,,,,,,,
20151008-M-Tokyo-R16-Roberto_Bautista_Agut-Nick_Kyrgios,2,B-XC,17,4,2,0,2,10,7,,,,,,,,,,
20151008-M-Tokyo-R16-Roberto_Bautista_Agut-Nick_Kyrgios,2,B-DTM,15,2,0,0,2,12,3,,,,,,,,,,
20151008-M-Tokyo-R16-Roberto_Bautista_Agut-Nick_Kyrgios,2,B-DTL,5,2,1,1,0,4,1,,,,,,,,,,
20151008-M-Tokyo-R16-Roberto_Bautista_Agut-Nick_Kyrgios,2,B-IO,4,1,1,0,0,4,0,,,,,,,,,,
20151008-M-Tokyo-R16-Roberto_Bautista_Agut-Nick_Kyrgios,2,S-XC,2,1,0,0,1,0,2,,,,,,,,,,
20151008-M-Tokyo-R16-Roberto_Bautista_Agut-Nick_Kyrgios,2,S-DTM,4,1,0,0,1,1,3,,,,,,,,,,
20151008-M-Tokyo-R16-Roberto_Bautista_Agut-Nick_Kyrgios,2,S-DTL,1,0,0,0,0,1,0,,,,,,,,,,
20151009-M-Beijing-QF-John_Isner-Novak_Djokovic,1,F-XC,8,4,1,0,3,5,3,,,,,,,,,,
20151009-M-Beijing-QF-John_Isner-Novak_Djokovic,1,F-DTM,4,0,0,0,0,1,3,,,,,,,,,,
20151009-M-Beijing-QF-John_Isner-Novak_Djokovic,1,F-DTL,2,1,0,0,1,0,2,,,,,,,,,,
20151009-M-Beijing-QF-John_Isner-Novak_Djokovic,1,F-IO,17,5,0,1,4,6,11,,,,,,,,,,
20151009-M-Beijing-QF-John_Isner-Novak_Djokovic,1,F-II,2,1,0,0,1,0,2,,,,,,,,,,
20151009-M-Beijing-QF-John_Isner-Novak_Djokovic,1,B-XC,12,5,0,1,4,1,11,,,,,,,,,,
20151009-M-Beijing-QF-John_Isner-Novak_Djokovic,1,B-DTM,4,0,0,0,0,1,3,,,,,,,,,,
20151009-M-Beijing-QF-John_Isner-Novak_Djokovic,1,B-DTL,3,1,0,0,1,0,3,,,,,,,,,,
20151009-M-Beijing-QF-John_Isner-Novak_Djokovic,1,S-XC,4,1,0,0,1,2,2,,,,,,,,,,
20151009-M-Beijing-QF-John_Isner-Novak_Djokovic,1,S-DTM,3,0,0,0,0,0,3,,,,,,,,,,
20151009-M-Beijing-QF-John_Isner-Novak_Djokovic,2,F-XC,7,2,1,0,1,5,2,,,,,,,,,,
20151009-M-Beijing-QF-John_Isner-Novak_Djokovic,2,F-DTM,3,2,0,2,0,2,1,,,,,,,,,,
20151009-M-Beijing-QF-John_Isner-Novak_Djokovic,2,F-DTL,5,2,0,0,2,2,3,,,,,,,,,,
20151009-M-Beijing-QF-John_Isner-Novak_Djokovic,2,F-IO,12,5,2,1,2,9,3,,,,,,,,,,
20151009-M-Beijing-QF-John_Isner-Novak_Djokovic,2,B-XC,17,2,1,1,0,14,3,,,,,,,,,,
20151009-M-Beijing-QF-John_Isner-Novak_Djokovic,2,B-DTM,6,0,0,0,0,4,2,,,,,,,,,,
20151009-M-Beijing-QF-John_Isner-Novak_Djokovic,2,B-DTL,3,1,1,0,0,3,0,,,,,,,,,,
20151009-M-Beijing-QF-John_Isner-Novak_Djokovic,2,B-IO,1,0,0,0,0,1,0,,,,,,,,,,
20151009-M-Beijing-QF-John_Isner-Novak_Djokovic,2,S-XC,3,1,0,0,1,2,1,,,,,,,,,,
20151009-M-Beijing-QF-John_Isner-Novak_Djokovic,2,S-DTM,1,0,0,0,0,0,1,,,,,,,,,,
20151009-M-Sacramento_CH-QF-Jared_Donaldson-Mackenzie_Mcdonald,1,F-XC,28,6,1,1,4,18,10,,,,,,,,,,
20151009-M-Sacramento_CH-QF-Jared_Donaldson-Mackenzie_Mcdonald,1,F-DTM,10,1,0,0,1,5,5,,,,,,,,,,
20151009-M-Sacramento_CH-QF-Jared_Donaldson-Mackenzie_Mcdonald,1,F-DTL,5,2,1,0,1,2,3,,,,,,,,,,
20151009-M-Sacramento_CH-QF-Jared_Donaldson-Mackenzie_Mcdonald,1,F-IO,15,6,4,0,2,10,5,,,,,,,,,,
20151009-M-Sacramento_CH-QF-Jared_Donaldson-Mackenzie_Mcdonald,1,F-II,2,2,1,1,0,2,0,,,,,,,,,,
20151009-M-Sacramento_CH-QF-Jared_Donaldson-Mackenzie_Mcdonald,1,B-XC,18,7,4,0,3,11,7,,,,,,,,,,
20151009-M-Sacramento_CH-QF-Jared_Donaldson-Mackenzie_Mcdonald,1,B-DTM,13,2,0,0,2,8,5,,,,,,,,,,
20151009-M-Sacramento_CH-QF-Jared_Donaldson-Mackenzie_Mcdonald,1,B-DTL,11,5,4,0,1,7,4,,,,,,,,,,
20151009-M-Sacramento_CH-QF-Jared_Donaldson-Mackenzie_Mcdonald,1,B-IO,3,2,0,2,0,3,0,,,,,,,,,,
20151009-M-Sacramento_CH-QF-Jared_Donaldson-Mackenzie_Mcdonald,1,S-DTM,2,0,0,0,0,2,0,,,,,,,,,,
20151009-M-Sacramento_CH-QF-Jared_Donaldson-Mackenzie_Mcdonald,1,S-II,1,0,0,0,0,1,0,,,,,,,,,,
20151009-M-Sacramento_CH-QF-Jared_Donaldson-Mackenzie_Mcdonald,2,F-XC,25,12,1,1,10,7,18,,,,,,,,,,
20151009-M-Sacramento_CH-QF-Jared_Donaldson-Mackenzie_Mcdonald,2,F-DTM,13,1,0,0,1,4,9,,,,,,,,,,
20151009-M-Sacramento_CH-QF-Jared_Donaldson-Mackenzie_Mcdonald,2,F-DTL,15,3,1,1,1,4,11,,,,,,,,,,
20151009-M-Sacramento_CH-QF-Jared_Donaldson-Mackenzie_Mcdonald,2,F-IO,13,4,1,3,0,10,3,,,,,,,,,,
20151009-M-Sacramento_CH-QF-Jared_Donaldson-Mackenzie_Mcdonald,2,B-XC,19,9,2,1,6,7,12,,,,,,,,,,
20151009-M-Sacramento_CH-QF-Jared_Donaldson-Mackenzie_Mcdonald,2,B-DTM,13,2,0,0,2,3,10,,,,,,,,,,
20151009-M-Sacramento_CH-QF-Jared_Donaldson-Mackenzie_Mcdonald,2,B-DTL,4,0,0,0,0,3,1,,,,,,,,,,
20151009-M-Sacramento_CH-QF-Jared_Donaldson-Mackenzie_Mcdonald,2,B-IO,3,1,0,0,1,1,2,,,,,,,,,,
20151009-M-Sacramento_CH-QF-Jared_Donaldson-Mackenzie_Mcdonald,2,S-XC,5,0,0,0,0,2,3,,,,,,,,,,
20151009-M-Sacramento_CH-QF-Jared_Donaldson-Mackenzie_Mcdonald,2,S-DTM,3,0,0,0,0,1,2,,,,,,,,,,
20151009-M-Sacramento_CH-QF-Jared_Donaldson-Mackenzie_Mcdonald,2,S-DTL,1,0,0,0,0,1,0,,,,,,,,,,
20151010-M-Beijing-SF-David_Ferrer-Novak_Djokovic,1,F-XC,36,8,1,0,7,14,22,,,,,,,,,,
20151010-M-Beijing-SF-David_Ferrer-Novak_Djokovic,1,F-DTM,27,3,0,0,3,7,20,,,,,,,,,,
20151010-M-Beijing-SF-David_Ferrer-Novak_Djokovic,1,F-DTL,6,2,1,0,1,2,4,,,,,,,,,,
20151010-M-Beijing-SF-David_Ferrer-Novak_Djokovic,1,F-IO,34,6,1,1,4,10,24,,,,,,,,,,
20151010-M-Beijing-SF-David_Ferrer-Novak_Djokovic,1,F-II,1,0,0,0,0,0,1,,,,,,,,,,
20151010-M-Beijing-SF-David_Ferrer-Novak_Djokovic,1,B-XC,30,7,0,0,7,8,22,,,,,,,,,,
20151010-M-Beijing-SF-David_Ferrer-Novak_Djokovic,1,B-DTM,36,3,0,0,3,14,22,,,,,,,,,,
20151010-M-Beijing-SF-David_Ferrer-Novak_Djokovic,1,B-DTL,7,3,0,1,2,1,6,,,,,,,,,,
20151010-M-Beijing-SF-David_Ferrer-Novak_Djokovic,1,B-IO,6,0,0,0,0,3,3,,,,,,,,,,
20151010-M-Beijing-SF-David_Ferrer-Novak_Djokovic,1,B-II,1,0,0,0,0,1,0,,,,,,,,,,
20151010-M-Beijing-SF-David_Ferrer-Novak_Djokovic,1,S-DTM,3,0,0,0,0,2,1,,,,,,,,,,
20151010-M-Beijing-SF-David_Ferrer-Novak_Djokovic,2,F-XC,34,8,4,2,2,23,11,,,,,,,,,,
20151010-M-Beijing-SF-David_Ferrer-Novak_Djokovic,2,F-DTM,12,0,0,0,0,7,5,,,,,,,,,,
20151010-M-Beijing-SF-David_Ferrer-Novak_Djokovic,2,F-DTL,17,3,2,0,1,11,6,,,,,,,,,,
20151010-M-Beijing-SF-David_Ferrer-Novak_Djokovic,2,F-IO,24,7,1,1,5,13,11,,,,,,,,,,
20151010-M-Beijing-SF-David_Ferrer-Novak_Djokovic,2,F-II,1,1,0,1,0,1,0,,,,,,,,,,
20151010-M-Beijing-SF-David_Ferrer-Novak_Djokovic,2,B-XC,42,9,2,2,5,27,15,,,,,,,,,,
20151010-M-Beijing-SF-David_Ferrer-Novak_Djokovic,2,B-DTM,20,0,0,0,0,12,8,,,,,,,,,,
20151010-M-Beijing-SF-David_Ferrer-Novak_Djokovic,2,B-DTL,12,5,1,0,4,6,6,,,,,,,,,,
20151010-M-Beijing-SF-David_Ferrer-Novak_Djokovic,2,B-IO,15,4,0,0,4,8,7,,,,,,,,,,
20151010-M-Beijing-SF-David_Ferrer-Novak_Djokovic,2,S-XC,4,0,0,0,0,3,1,,,,,,,,,,
20151010-M-Beijing-SF-David_Ferrer-Novak_Djokovic,2,S-DTM,4,0,0,0,0,2,2,,,,,,,,,,
20151010-M-Tokyo-SF-Gilles_Muller-Stanislas_Wawrinka,1,F-XC,20,5,2,2,1,13,7,,,,,,,,,,
20151010-M-Tokyo-SF-Gilles_Muller-Stanislas_Wawrinka,1,F-DTM,15,1,0,0,1,10,5,,,,,,,,,,
20151010-M-Tokyo-SF-Gilles_Muller-Stanislas_Wawrinka,1,F-DTL,5,1,0,0,1,1,4,,,,,,,,,,
20151010-M-Tokyo-SF-Gilles_Muller-Stanislas_Wawrinka,1,F-IO,8,1,0,1,0,5,3,,,,,,,,,,
20151010-M-Tokyo-SF-Gilles_Muller-Stanislas_Wawrinka,1,B-XC,13,2,0,1,1,11,2,,,,,,,,,,
20151010-M-Tokyo-SF-Gilles_Muller-Stanislas_Wawrinka,1,B-DTM,11,2,0,1,1,8,3,,,,,,,,,,
20151010-M-Tokyo-SF-Gilles_Muller-Stanislas_Wawrinka,1,B-DTL,4,0,0,0,0,4,0,,,,,,,,,,
20151010-M-Tokyo-SF-Gilles_Muller-Stanislas_Wawrinka,1,B-IO,2,1,0,1,0,1,1,,,,,,,,,,
20151010-M-Tokyo-SF-Gilles_Muller-Stanislas_Wawrinka,1,S-XC,11,2,0,0,2,4,7,,,,,,,,,,
20151010-M-Tokyo-SF-Gilles_Muller-Stanislas_Wawrinka,1,S-DTM,6,0,0,0,0,2,4,,,,,,,,,,
20151010-M-Tokyo-SF-Gilles_Muller-Stanislas_Wawrinka,1,S-DTL,7,0,0,0,0,4,3,,,,,,,,,,
20151010-M-Tokyo-SF-Gilles_Muller-Stanislas_Wawrinka,1,S-IO,2,1,0,0,1,1,1,,,,,,,,,,
20151010-M-Tokyo-SF-Gilles_Muller-Stanislas_Wawrinka,2,F-XC,37,7,2,3,2,16,21,,,,,,,,,,
20151010-M-Tokyo-SF-Gilles_Muller-Stanislas_Wawrinka,2,F-DTM,21,1,0,0,1,6,15,,,,,,,,,,
20151010-M-Tokyo-SF-Gilles_Muller-Stanislas_Wawrinka,2,F-DTL,5,5,2,0,3,2,3,,,,,,,,,,
20151010-M-Tokyo-SF-Gilles_Muller-Stanislas_Wawrinka,2,F-IO,9,8,5,1,2,7,2,,,,,,,,,,
20151010-M-Tokyo-SF-Gilles_Muller-Stanislas_Wawrinka,2,B-XC,16,5,3,0,2,8,8,,,,,,,,,,
20151010-M-Tokyo-SF-Gilles_Muller-Stanislas_Wawrinka,2,B-DTM,22,2,1,0,1,11,11,,,,,,,,,,
20151010-M-Tokyo-SF-Gilles_Muller-Stanislas_Wawrinka,2,B-DTL,7,7,5,1,1,6,1,,,,,,,,,,
20151010-M-Tokyo-SF-Gilles_Muller-Stanislas_Wawrinka,2,B-IO,3,1,0,0,1,1,2,,,,,,,,,,
20151010-M-Tokyo-SF-Gilles_Muller-Stanislas_Wawrinka,2,S-XC,4,1,0,0,1,0,4,,,,,,,,,,
20151010-M-Tokyo-SF-Gilles_Muller-Stanislas_Wawrinka,2,S-DTM,5,0,0,0,0,1,4,,,,,,,,,,
20151010-M-Tokyo-SF-Gilles_Muller-Stanislas_Wawrinka,2,S-DTL,5,1,0,0,1,1,4,,,,,,,,,,
20151010-M-Tokyo-SF-Gilles_Muller-Stanislas_Wawrinka,2,S-IO,4,0,0,0,0,1,3,,,,,,,,,,
20151010-M-Tokyo-SF-Kei_Nishikori-Benoit_Paire,1,F-XC,34,8,1,3,4,16,18,,,,,,,,,,
20151010-M-Tokyo-SF-Kei_Nishikori-Benoit_Paire,1,F-DTM,20,3,1,1,1,9,11,,,,,,,,,,
20151010-M-Tokyo-SF-Kei_Nishikori-Benoit_Paire,1,F-DTL,7,5,0,4,1,5,2,,,,,,,,,,
20151010-M-Tokyo-SF-Kei_Nishikori-Benoit_Paire,1,F-IO,18,3,1,1,1,10,8,,,,,,,,,,
20151010-M-Tokyo-SF-Kei_Nishikori-Benoit_Paire,1,B-XC,45,16,1,8,7,27,18,,,,,,,,,,
20151010-M-Tokyo-SF-Kei_Nishikori-Benoit_Paire,1,B-DTM,27,1,0,1,0,17,10,,,,,,,,,,
20151010-M-Tokyo-SF-Kei_Nishikori-Benoit_Paire,1,B-DTL,9,4,1,2,1,6,3,,,,,,,,,,
20151010-M-Tokyo-SF-Kei_Nishikori-Benoit_Paire,1,B-IO,8,4,1,1,2,6,2,,,,,,,,,,
20151010-M-Tokyo-SF-Kei_Nishikori-Benoit_Paire,1,S-XC,3,1,1,0,0,2,1,,,,,,,,,,
20151010-M-Tokyo-SF-Kei_Nishikori-Benoit_Paire,1,S-DTM,1,0,0,0,0,0,1,,,,,,,,,,
20151010-M-Tokyo-SF-Kei_Nishikori-Benoit_Paire,1,S-DTL,1,1,0,1,0,1,0,,,,,,,,,,
20151010-M-Tokyo-SF-Kei_Nishikori-Benoit_Paire,1,S-IO,1,0,0,0,0,1,0,,,,,,,,,,
20151010-M-Tokyo-SF-Kei_Nishikori-Benoit_Paire,2,F-XC,20,5,1,2,2,9,11,,,,,,,,,,
20151010-M-Tokyo-SF-Kei_Nishikori-Benoit_Paire,2,F-DTM,26,2,0,0,2,11,15,,,,,,,,,,
20151010-M-Tokyo-SF-Kei_Nishikori-Benoit_Paire,2,F-DTL,11,4,1,0,3,6,5,,,,,,,,,,
20151010-M-Tokyo-SF-Kei_Nishikori-Benoit_Paire,2,F-IO,5,0,0,0,0,1,4,,,,,,,,,,
20151010-M-Tokyo-SF-Kei_Nishikori-Benoit_Paire,2,B-XC,37,4,1,0,3,14,23,,,,,,,,,,
20151010-M-Tokyo-SF-Kei_Nishikori-Benoit_Paire,2,B-DTM,21,3,1,0,2,9,12,,,,,,,,,,
20151010-M-Tokyo-SF-Kei_Nishikori-Benoit_Paire,2,B-DTL,7,3,2,0,1,3,4,,,,,,,,,,
20151010-M-Tokyo-SF-Kei_Nishikori-Benoit_Paire,2,B-IO,5,2,1,1,0,3,2,,,,,,,,,,
20151010-M-Tokyo-SF-Kei_Nishikori-Benoit_Paire,2,S-XC,4,0,0,0,0,0,4,,,,,,,,,,
20151010-M-Tokyo-SF-Kei_Nishikori-Benoit_Paire,2,S-DTM,7,0,0,0,0,4,3,,,,,,,,,,
20151010-M-Tokyo-SF-Kei_Nishikori-Benoit_Paire,2,S-DTL,3,1,0,0,1,0,3,,,,,,,,,,
20151010-M-Tokyo-SF-Kei_Nishikori-Benoit_Paire,2,S-IO,2,0,0,0,0,2,0,,,,,,,,,,
20151011-M-Beijing-F-Rafael_Nadal-Novak_Djokovic,1,F-XC,60,2,0,0,2,27,33,,,,,,,,,,
20151011-M-Beijing-F-Rafael_Nadal-Novak_Djokovic,1,F-DTM,34,2,0,0,2,9,25,,,,,,,,,,
20151011-M-Beijing-F-Rafael_Nadal-Novak_Djokovic,1,F-DTL,11,7,3,1,3,4,7,,,,,,,,,,
20151011-M-Beijing-F-Rafael_Nadal-Novak_Djokovic,1,F-IO,17,4,0,0,4,7,10,,,,,,,,,,
20151011-M-Beijing-F-Rafael_Nadal-Novak_Djokovic,1,F-II,1,1,0,1,0,1,0,,,,,,,,,,
20151011-M-Beijing-F-Rafael_Nadal-Novak_Djokovic,1,B-XC,28,6,2,4,0,16,12,,,,,,,,,,
20151011-M-Beijing-F-Rafael_Nadal-Novak_Djokovic,1,B-DTM,19,1,0,0,1,4,15,,,,,,,,,,
20151011-M-Beijing-F-Rafael_Nadal-Novak_Djokovic,1,B-DTL,6,3,1,1,1,4,2,,,,,,,,,,
20151011-M-Beijing-F-Rafael_Nadal-Novak_Djokovic,1,B-IO,5,2,0,1,1,1,4,,,,,,,,,,
20151011-M-Beijing-F-Rafael_Nadal-Novak_Djokovic,1,S-XC,6,0,0,0,0,3,3,,,,,,,,,,
20151011-M-Beijing-F-Rafael_Nadal-Novak_Djokovic,1,S-DTM,18,1,0,0,1,5,13,,,,,,,,,,
20151011-M-Beijing-F-Rafael_Nadal-Novak_Djokovic,1,S-DTL,9,0,0,0,0,3,6,,,,,,,,,,
20151011-M-Beijing-F-Rafael_Nadal-Novak_Djokovic,1,S-IO,4,0,0,0,0,2,2,,,,,,,,,,
20151011-M-Beijing-F-Rafael_Nadal-Novak_Djokovic,2,F-XC,47,10,2,4,4,29,18,,,,,,,,,,
20151011-M-Beijing-F-Rafael_Nadal-Novak_Djokovic,2,F-DTM,21,1,0,0,1,15,6,,,,,,,,,,
20151011-M-Beijing-F-Rafael_Nadal-Novak_Djokovic,2,F-DTL,11,3,1,0,2,5,6,,,,,,,,,,
20151011-M-Beijing-F-Rafael_Nadal-Novak_Djokovic,2,F-IO,29,10,3,4,3,18,11,,,,,,,,,,
20151011-M-Beijing-F-Rafael_Nadal-Novak_Djokovic,2,F-II,1,1,0,0,1,0,1,,,,,,,,,,
20151011-M-Beijing-F-Rafael_Nadal-Novak_Djokovic,2,B-XC,38,8,3,2,3,24,14,,,,,,,,,,
20151011-M-Beijing-F-Rafael_Nadal-Novak_Djokovic,2,B-DTM,52,0,0,0,0,33,19,,,,,,,,,,
20151011-M-Beijing-F-Rafael_Nadal-Novak_Djokovic,2,B-DTL,13,2,1,0,1,6,7,,,,,,,,,,
20151011-M-Beijing-F-Rafael_Nadal-Novak_Djokovic,2,B-IO,7,1,0,1,0,4,3,,,,,,,,,,
20151011-M-Beijing-F-Rafael_Nadal-Novak_Djokovic,2,S-XC,1,1,1,0,0,1,0,,,,,,,,,,
20151011-M-Beijing-F-Rafael_Nadal-Novak_Djokovic,2,S-DTM,3,0,0,0,0,1,2,,,,,,,,,,
20151011-M-Beijing-F-Rafael_Nadal-Novak_Djokovic,2,S-DTL,1,0,0,0,0,0,1,,,,,,,,,,
20151011-M-Tokyo-F-Stanislas_Wawrinka-Benoit_Paire,1,F-XC,30,7,3,1,3,21,9,,,,,,,,,,
20151011-M-Tokyo-F-Stanislas_Wawrinka-Benoit_Paire,1,F-DTM,20,3,0,0,3,14,6,,,,,,,,,,
20151011-M-Tokyo-F-Stanislas_Wawrinka-Benoit_Paire,1,F-DTL,5,2,1,1,0,5,0,,,,,,,,,,
20151011-M-Tokyo-F-Stanislas_Wawrinka-Benoit_Paire,1,F-IO,7,3,2,1,0,4,3,,,,,,,,,,
20151011-M-Tokyo-F-Stanislas_Wawrinka-Benoit_Paire,1,B-XC,17,3,0,2,1,13,4,,,,,,,,,,
20151011-M-Tokyo-F-Stanislas_Wawrinka-Benoit_Paire,1,B-DTM,13,3,0,0,3,5,8,,,,,,,,,,
20151011-M-Tokyo-F-Stanislas_Wawrinka-Benoit_Paire,1,B-DTL,5,3,1,1,1,3,2,,,,,,,,,,
20151011-M-Tokyo-F-Stanislas_Wawrinka-Benoit_Paire,1,B-IO,2,1,1,0,0,2,0,,,,,,,,,,
20151011-M-Tokyo-F-Stanislas_Wawrinka-Benoit_Paire,1,S-XC,4,0,0,0,0,3,1,,,,,,,,,,
20151011-M-Tokyo-F-Stanislas_Wawrinka-Benoit_Paire,1,S-DTM,4,0,0,0,0,3,1,,,,,,,,,,
20151011-M-Tokyo-F-Stanislas_Wawrinka-Benoit_Paire,1,S-DTL,4,0,0,0,0,4,0,,,,,,,,,,
20151011-M-Tokyo-F-Stanislas_Wawrinka-Benoit_Paire,2,F-XC,33,12,1,3,8,8,25,,,,,,,,,,
20151011-M-Tokyo-F-Stanislas_Wawrinka-Benoit_Paire,2,F-DTM,14,3,0,0,3,3,11,,,,,,,,,,
20151011-M-Tokyo-F-Stanislas_Wawrinka-Benoit_Paire,2,F-DTL,8,5,0,0,5,1,7,,,,,,,,,,
20151011-M-Tokyo-F-Stanislas_Wawrinka-Benoit_Paire,2,F-IO,2,0,0,0,0,2,0,,,,,,,,,,
20151011-M-Tokyo-F-Stanislas_Wawrinka-Benoit_Paire,2,B-XC,21,9,1,1,7,5,16,,,,,,,,,,
20151011-M-Tokyo-F-Stanislas_Wawrinka-Benoit_Paire,2,B-DTM,12,2,0,0,2,4,8,,,,,,,,,,
20151011-M-Tokyo-F-Stanislas_Wawrinka-Benoit_Paire,2,B-DTL,7,3,0,1,2,3,4,,,,,,,,,,
20151011-M-Tokyo-F-Stanislas_Wawrinka-Benoit_Paire,2,B-IO,2,1,0,0,1,1,1,,,,,,,,,,
20151011-M-Tokyo-F-Stanislas_Wawrinka-Benoit_Paire,2,S-XC,4,0,0,0,0,2,2,,,,,,,,,,
20151011-M-Tokyo-F-Stanislas_Wawrinka-Benoit_Paire,2,S-DTM,2,0,0,0,0,0,2,,,,,,,,,,
20151011-M-Tokyo-F-Stanislas_Wawrinka-Benoit_Paire,2,S-DTL,1,0,0,0,0,1,0,,,,,,,,,,
20151011-M-Tokyo-F-Stanislas_Wawrinka-Benoit_Paire,2,S-IO,1,0,0,0,0,0,1,,,,,,,,,,
20151014-M-Ho_Chi_Minh_City_CH-R16-James_Duckworth-Sanam_Singh,1,F-XC,11,5,1,4,0,9,2,,,,,,,,,,
20151014-M-Ho_Chi_Minh_City_CH-R16-James_Duckworth-Sanam_Singh,1,F-DTM,4,0,0,0,0,3,1,,,,,,,,,,
20151014-M-Ho_Chi_Minh_City_CH-R16-James_Duckworth-Sanam_Singh,1,F-DTL,1,0,0,0,0,1,0,,,,,,,,,,
20151014-M-Ho_Chi_Minh_City_CH-R16-James_Duckworth-Sanam_Singh,1,F-IO,8,3,0,3,0,7,1,,,,,,,,,,
20151014-M-Ho_Chi_Minh_City_CH-R16-James_Duckworth-Sanam_Singh,1,B-XC,6,4,0,3,1,4,2,,,,,,,,,,
20151014-M-Ho_Chi_Minh_City_CH-R16-James_Duckworth-Sanam_Singh,1,B-DTM,8,1,0,0,1,7,1,,,,,,,,,,
20151014-M-Ho_Chi_Minh_City_CH-R16-James_Duckworth-Sanam_Singh,1,B-DTL,2,1,1,0,0,1,1,,,,,,,,,,
20151014-M-Ho_Chi_Minh_City_CH-R16-James_Duckworth-Sanam_Singh,1,S-XC,5,2,0,1,1,3,2,,,,,,,,,,
20151014-M-Ho_Chi_Minh_City_CH-R16-James_Duckworth-Sanam_Singh,1,S-DTM,9,1,0,1,0,7,2,,,,,,,,,,
20151014-M-Ho_Chi_Minh_City_CH-R16-James_Duckworth-Sanam_Singh,1,S-DTL,2,0,0,0,0,1,1,,,,,,,,,,
20151014-M-Ho_Chi_Minh_City_CH-R16-James_Duckworth-Sanam_Singh,1,S-IO,1,0,0,0,0,0,1,,,,,,,,,,
20151014-M-Ho_Chi_Minh_City_CH-R16-James_Duckworth-Sanam_Singh,2,F-XC,10,5,2,0,3,5,5,,,,,,,,,,
20151014-M-Ho_Chi_Minh_City_CH-R16-James_Duckworth-Sanam_Singh,2,F-DTM,5,0,0,0,0,0,5,,,,,,,,,,
20151014-M-Ho_Chi_Minh_City_CH-R16-James_Duckworth-Sanam_Singh,2,F-DTL,3,2,1,1,0,2,1,,,,,,,,,,
20151014-M-Ho_Chi_Minh_City_CH-R16-James_Duckworth-Sanam_Singh,2,F-IO,11,3,0,0,3,3,8,,,,,,,,,,
20151014-M-Ho_Chi_Minh_City_CH-R16-James_Duckworth-Sanam_Singh,2,B-XC,11,2,1,0,1,4,7,,,,,,,,,,
20151014-M-Ho_Chi_Minh_City_CH-R16-James_Duckworth-Sanam_Singh,2,B-DTM,12,3,0,0,3,3,9,,,,,,,,,,
20151014-M-Ho_Chi_Minh_City_CH-R16-James_Duckworth-Sanam_Singh,2,B-DTL,4,2,0,0,2,1,3,,,,,,,,,,
20151014-M-Ho_Chi_Minh_City_CH-R16-James_Duckworth-Sanam_Singh,2,B-IO,1,0,0,0,0,1,0,,,,,,,,,,
20151014-M-Ho_Chi_Minh_City_CH-R16-James_Duckworth-Sanam_Singh,2,S-XC,1,0,0,0,0,0,1,,,,,,,,,,
20151014-M-Ho_Chi_Minh_City_CH-R16-James_Duckworth-Sanam_Singh,2,S-DTM,1,0,0,0,0,0,1,,,,,,,,,,
20151014-M-Ho_Chi_Minh_City_CH-R16-James_Duckworth-Sanam_Singh,2,S-DTL,1,0,0,0,0,0,1,,,,,,,,,,
20151014-M-Shanghai_Masters-R32-David_Ferrer-Bernard_Tomic,1,F-XC,32,12,3,1,8,11,21,,,,,,,,,,
20151014-M-Shanghai_Masters-R32-David_Ferrer-Bernard_Tomic,1,F-DTM,11,0,0,0,0,4,7,,,,,,,,,,
20151014-M-Shanghai_Masters-R32-David_Ferrer-Bernard_Tomic,1,F-DTL,11,5,1,1,3,3,8,,,,,,,,,,
20151014-M-Shanghai_Masters-R32-David_Ferrer-Bernard_Tomic,1,F-IO,35,5,2,0,3,14,21,,,,,,,,,,
20151014-M-Shanghai_Masters-R32-David_Ferrer-Bernard_Tomic,1,F-II,4,0,0,0,0,2,2,,,,,,,,,,
20151014-M-Shanghai_Masters-R32-David_Ferrer-Bernard_Tomic,1,B-XC,27,3,1,0,2,13,14,,,,,,,,,,
20151014-M-Shanghai_Masters-R32-David_Ferrer-Bernard_Tomic,1,B-DTM,19,2,0,0,2,6,13,,,,,,,,,,
20151014-M-Shanghai_Masters-R32-David_Ferrer-Bernard_Tomic,1,B-DTL,3,2,0,1,1,2,1,,,,,,,,,,
20151014-M-Shanghai_Masters-R32-David_Ferrer-Bernard_Tomic,1,S-XC,6,1,0,0,1,1,5,,,,,,,,,,
20151014-M-Shanghai_Masters-R32-David_Ferrer-Bernard_Tomic,1,S-DTM,3,0,0,0,0,1,2,,,,,,,,,,
20151014-M-Shanghai_Masters-R32-David_Ferrer-Bernard_Tomic,1,S-DTL,2,0,0,0,0,0,2,,,,,,,,,,
20151014-M-Shanghai_Masters-R32-David_Ferrer-Bernard_Tomic,2,F-XC,29,6,1,1,4,20,9,,,,,,,,,,
20151014-M-Shanghai_Masters-R32-David_Ferrer-Bernard_Tomic,2,F-DTM,11,0,0,0,0,7,4,,,,,,,,,,
20151014-M-Shanghai_Masters-R32-David_Ferrer-Bernard_Tomic,2,F-DTL,9,3,2,1,0,6,3,,,,,,,,,,
20151014-M-Shanghai_Masters-R32-David_Ferrer-Bernard_Tomic,2,F-IO,23,7,3,2,2,16,7,,,,,,,,,,
20151014-M-Shanghai_Masters-R32-David_Ferrer-Bernard_Tomic,2,F-II,2,0,0,0,0,2,0,,,,,,,,,,
20151014-M-Shanghai_Masters-R32-David_Ferrer-Bernard_Tomic,2,B-XC,36,6,1,0,5,20,16,,,,,,,,,,
20151014-M-Shanghai_Masters-R32-David_Ferrer-Bernard_Tomic,2,B-DTM,17,1,0,0,1,10,7,,,,,,,,,,
20151014-M-Shanghai_Masters-R32-David_Ferrer-Bernard_Tomic,2,B-DTL,17,10,4,0,6,10,7,,,,,,,,,,
20151014-M-Shanghai_Masters-R32-David_Ferrer-Bernard_Tomic,2,B-IO,3,2,2,0,0,2,1,,,,,,,,,,
20151014-M-Shanghai_Masters-R32-David_Ferrer-Bernard_Tomic,2,S-XC,4,1,0,0,1,3,1,,,,,,,,,,
20151014-M-Shanghai_Masters-R32-David_Ferrer-Bernard_Tomic,2,S-DTM,4,0,0,0,0,1,3,,,,,,,,,,
20151014-M-Shanghai_Masters-R32-David_Ferrer-Bernard_Tomic,2,S-DTL,3,1,0,1,0,1,2,,,,,,,,,,
20151014-M-Shanghai_Masters-R32-David_Ferrer-Bernard_Tomic,2,S-IO,2,0,0,0,0,1,1,,,,,,,,,,
20151014-M-Shanghai_Masters-R32-Novak_Djokovic-Martin_Klizan,1,F-XC,29,3,1,0,2,11,18,,,,,,,,,,
20151014-M-Shanghai_Masters-R32-Novak_Djokovic-Martin_Klizan,1,F-DTM,15,1,0,0,1,12,3,,,,,,,,,,
20151014-M-Shanghai_Masters-R32-Novak_Djokovic-Martin_Klizan,1,F-DTL,12,7,1,2,4,5,7,,,,,,,,,,
20151014-M-Shanghai_Masters-R32-Novak_Djokovic-Martin_Klizan,1,F-IO,14,6,1,1,4,7,7,,,,,,,,,,
20151014-M-Shanghai_Masters-R32-Novak_Djokovic-Martin_Klizan,1,F-II,2,1,0,0,1,0,2,,,,,,,,,,
20151014-M-Shanghai_Masters-R32-Novak_Djokovic-Martin_Klizan,1,B-XC,21,6,0,4,2,12,9,,,,,,,,,,
20151014-M-Shanghai_Masters-R32-Novak_Djokovic-Martin_Klizan,1,B-DTM,13,0,0,0,0,8,5,,,,,,,,,,
20151014-M-Shanghai_Masters-R32-Novak_Djokovic-Martin_Klizan,1,B-DTL,15,2,1,1,0,13,2,,,,,,,,,,
20151014-M-Shanghai_Masters-R32-Novak_Djokovic-Martin_Klizan,1,B-IO,6,1,0,0,1,2,4,,,,,,,,,,
20151014-M-Shanghai_Masters-R32-Novak_Djokovic-Martin_Klizan,1,S-DTM,1,0,0,0,0,1,0,,,,,,,,,,
20151014-M-Shanghai_Masters-R32-Novak_Djokovic-Martin_Klizan,1,S-DTL,1,0,0,0,0,1,0,,,,,,,,,,
20151014-M-Shanghai_Masters-R32-Novak_Djokovic-Martin_Klizan,2,F-XC,41,11,0,1,10,10,31,,,,,,,,,,
20151014-M-Shanghai_Masters-R32-Novak_Djokovic-Martin_Klizan,2,F-DTM,13,2,0,0,2,7,6,,,,,,,,,,
20151014-M-Shanghai_Masters-R32-Novak_Djokovic-Martin_Klizan,2,F-DTL,5,2,1,0,1,3,2,,,,,,,,,,
20151014-M-Shanghai_Masters-R32-Novak_Djokovic-Martin_Klizan,2,F-IO,5,1,0,0,1,2,3,,,,,,,,,,
20151014-M-Shanghai_Masters-R32-Novak_Djokovic-Martin_Klizan,2,B-XC,32,5,0,0,5,15,17,,,,,,,,,,
20151014-M-Shanghai_Masters-R32-Novak_Djokovic-Martin_Klizan,2,B-DTM,12,1,0,0,1,3,9,,,,,,,,,,
20151014-M-Shanghai_Masters-R32-Novak_Djokovic-Martin_Klizan,2,B-DTL,14,4,1,1,2,7,7,,,,,,,,,,
20151014-M-Shanghai_Masters-R32-Novak_Djokovic-Martin_Klizan,2,B-IO,1,0,0,0,0,0,1,,,,,,,,,,
20151014-M-Shanghai_Masters-R32-Novak_Djokovic-Martin_Klizan,2,S-DTM,1,0,0,0,0,1,0,,,,,,,,,,
20151014-M-Shanghai_Masters-R32-Novak_Djokovic-Martin_Klizan,2,S-DTL,3,0,0,0,0,2,1,,,,,,,,,,
20151014-M-Shanghai_Masters-R32-Novak_Djokovic-Martin_Klizan,2,S-IO,1,0,0,0,0,0,1,,,,,,,,,,
20151015-M-Shanghai_Masters-R16-Novak_Djokovic-Feliciano_Lopez,1,F-XC,32,2,0,1,1,24,8,,,,,,,,,,
20151015-M-Shanghai_Masters-R16-Novak_Djokovic-Feliciano_Lopez,1,F-DTM,6,0,0,0,0,1,5,,,,,,,,,,
20151015-M-Shanghai_Masters-R16-Novak_Djokovic-Feliciano_Lopez,1,F-DTL,9,3,2,1,0,8,1,,,,,,,,,,
20151015-M-Shanghai_Masters-R16-Novak_Djokovic-Feliciano_Lopez,1,F-IO,11,3,1,0,2,5,6,,,,,,,,,,
20151015-M-Shanghai_Masters-R16-Novak_Djokovic-Feliciano_Lopez,1,F-II,1,0,0,0,0,1,0,,,,,,,,,,
20151015-M-Shanghai_Masters-R16-Novak_Djokovic-Feliciano_Lopez,1,B-XC,30,10,5,2,3,20,10,,,,,,,,,,
20151015-M-Shanghai_Masters-R16-Novak_Djokovic-Feliciano_Lopez,1,B-DTM,12,1,0,0,1,6,6,,,,,,,,,,
20151015-M-Shanghai_Masters-R16-Novak_Djokovic-Feliciano_Lopez,1,B-DTL,18,5,1,1,3,10,8,,,,,,,,,,
20151015-M-Shanghai_Masters-R16-Novak_Djokovic-Feliciano_Lopez,1,B-IO,6,0,0,0,0,5,1,,,,,,,,,,
20151015-M-Shanghai_Masters-R16-Novak_Djokovic-Feliciano_Lopez,1,S-DTL,2,1,0,0,1,1,1,,,,,,,,,,
20151015-M-Shanghai_Masters-R16-Novak_Djokovic-Feliciano_Lopez,2,F-XC,31,5,1,0,4,12,19,,,,,,,,,,
20151015-M-Shanghai_Masters-R16-Novak_Djokovic-Feliciano_Lopez,2,F-DTM,12,0,0,0,0,4,8,,,,,,,,,,
20151015-M-Shanghai_Masters-R16-Novak_Djokovic-Feliciano_Lopez,2,F-DTL,5,2,1,1,0,2,3,,,,,,,,,,
20151015-M-Shanghai_Masters-R16-Novak_Djokovic-Feliciano_Lopez,2,F-IO,4,3,0,1,2,1,3,,,,,,,,,,
20151015-M-Shanghai_Masters-R16-Novak_Djokovic-Feliciano_Lopez,2,B-XC,7,3,0,0,3,1,6,,,,,,,,,,
20151015-M-Shanghai_Masters-R16-Novak_Djokovic-Feliciano_Lopez,2,B-DTM,4,0,0,0,0,2,2,,,,,,,,,,
20151015-M-Shanghai_Masters-R16-Novak_Djokovic-Feliciano_Lopez,2,B-DTL,4,1,1,0,0,3,1,,,,,,,,,,
20151015-M-Shanghai_Masters-R16-Novak_Djokovic-Feliciano_Lopez,2,S-XC,21,2,0,0,2,6,15,,,,,,,,,,
20151015-M-Shanghai_Masters-R16-Novak_Djokovic-Feliciano_Lopez,2,S-DTM,9,0,0,0,0,4,5,,,,,,,,,,
20151015-M-Shanghai_Masters-R16-Novak_Djokovic-Feliciano_Lopez,2,S-DTL,18,3,0,0,3,2,16,,,,,,,,,,
20151015-M-Shanghai_Masters-R16-Novak_Djokovic-Feliciano_Lopez,2,S-IO,5,0,0,0,0,3,2,,,,,,,,,,
20151016-M-Shanghai_Masters-QF-Rafael_Nadal-Stanislas_Wawrinka,1,F-XC,24,3,1,0,2,13,11,,,,,,,,,,
20151016-M-Shanghai_Masters-QF-Rafael_Nadal-Stanislas_Wawrinka,1,F-DTM,20,0,0,0,0,10,10,,,,,,,,,,
20151016-M-Shanghai_Masters-QF-Rafael_Nadal-Stanislas_Wawrinka,1,F-DTL,6,0,0,0,0,2,4,,,,,,,,,,
20151016-M-Shanghai_Masters-QF-Rafael_Nadal-Stanislas_Wawrinka,1,F-IO,19,7,3,2,2,15,4,,,,,,,,,,
20151016-M-Shanghai_Masters-QF-Rafael_Nadal-Stanislas_Wawrinka,1,F-II,1,1,1,0,0,1,0,,,,,,,,,,
20151016-M-Shanghai_Masters-QF-Rafael_Nadal-Stanislas_Wawrinka,1,B-XC,20,3,1,0,2,11,9,,,,,,,,,,
20151016-M-Shanghai_Masters-QF-Rafael_Nadal-Stanislas_Wawrinka,1,B-DTM,19,2,0,0,2,8,11,,,,,,,,,,
20151016-M-Shanghai_Masters-QF-Rafael_Nadal-Stanislas_Wawrinka,1,B-DTL,2,1,0,0,1,0,2,,,,,,,,,,
20151016-M-Shanghai_Masters-QF-Rafael_Nadal-Stanislas_Wawrinka,1,B-IO,2,1,1,0,0,1,1,,,,,,,,,,
20151016-M-Shanghai_Masters-QF-Rafael_Nadal-Stanislas_Wawrinka,1,S-XC,7,0,0,0,0,3,4,,,,,,,,,,
20151016-M-Shanghai_Masters-QF-Rafael_Nadal-Stanislas_Wawrinka,1,S-DTM,10,1,0,0,1,1,9,,,,,,,,,,
20151016-M-Shanghai_Masters-QF-Rafael_Nadal-Stanislas_Wawrinka,1,S-DTL,1,0,0,0,0,1,0,,,,,,,,,,
20151016-M-Shanghai_Masters-QF-Rafael_Nadal-Stanislas_Wawrinka,2,F-XC,44,6,1,1,4,25,19,,,,,,,,,,
20151016-M-Shanghai_Masters-QF-Rafael_Nadal-Stanislas_Wawrinka,2,F-DTM,20,6,0,2,4,7,13,,,,,,,,,,
20151016-M-Shanghai_Masters-QF-Rafael_Nadal-Stanislas_Wawrinka,2,F-DTL,8,6,1,0,5,2,6,,,,,,,,,,
20151016-M-Shanghai_Masters-QF-Rafael_Nadal-Stanislas_Wawrinka,2,F-IO,14,9,2,0,7,6,8,,,,,,,,,,
20151016-M-Shanghai_Masters-QF-Rafael_Nadal-Stanislas_Wawrinka,2,F-II,1,1,0,0,1,0,1,,,,,,,,,,
20151016-M-Shanghai_Masters-QF-Rafael_Nadal-Stanislas_Wawrinka,2,B-XC,19,6,0,2,4,10,9,,,,,,,,,,
20151016-M-Shanghai_Masters-QF-Rafael_Nadal-Stanislas_Wawrinka,2,B-DTM,11,1,0,0,1,6,5,,,,,,,,,,
20151016-M-Shanghai_Masters-QF-Rafael_Nadal-Stanislas_Wawrinka,2,B-DTL,5,3,1,1,1,3,2,,,,,,,,,,
20151016-M-Shanghai_Masters-QF-Rafael_Nadal-Stanislas_Wawrinka,2,B-IO,5,2,0,0,2,2,3,,,,,,,,,,
20151016-M-Shanghai_Masters-QF-Rafael_Nadal-Stanislas_Wawrinka,2,S-XC,2,0,0,0,0,0,2,,,,,,,,,,
20151016-M-Shanghai_Masters-QF-Rafael_Nadal-Stanislas_Wawrinka,2,S-DTM,4,0,0,0,0,1,3,,,,,,,,,,
20151016-M-Shanghai_Masters-QF-Rafael_Nadal-Stanislas_Wawrinka,2,S-DTL,1,0,0,0,0,1,0,,,,,,,,,,
20151016-M-Shanghai_Masters-QF-Rafael_Nadal-Stanislas_Wawrinka,2,S-IO,2,0,0,0,0,1,1,,,,,,,,,,
20151016-M-Shanghai_Masters-QF-Tomas_Berdych-Andy_Murray,1,F-XC,20,3,0,1,2,8,12,,,,,,,,,,
20151016-M-Shanghai_Masters-QF-Tomas_Berdych-Andy_Murray,1,F-DTM,21,0,0,0,0,7,14,,,,,,,,,,
20151016-M-Shanghai_Masters-QF-Tomas_Berdych-Andy_Murray,1,F-DTL,12,2,1,0,1,4,8,,,,,,,,,,
20151016-M-Shanghai_Masters-QF-Tomas_Berdych-Andy_Murray,1,F-IO,24,9,3,2,4,11,13,,,,,,,,,,
20151016-M-Shanghai_Masters-QF-Tomas_Berdych-Andy_Murray,1,F-II,2,0,0,0,0,1,1,,,,,,,,,,
20151016-M-Shanghai_Masters-QF-Tomas_Berdych-Andy_Murray,1,B-XC,16,3,2,0,1,10,6,,,,,,,,,,
20151016-M-Shanghai_Masters-QF-Tomas_Berdych-Andy_Murray,1,B-DTM,12,2,0,0,2,3,9,,,,,,,,,,
20151016-M-Shanghai_Masters-QF-Tomas_Berdych-Andy_Murray,1,B-DTL,3,1,1,0,0,1,2,,,,,,,,,,
20151016-M-Shanghai_Masters-QF-Tomas_Berdych-Andy_Murray,1,B-IO,4,2,0,1,1,2,2,,,,,,,,,,
20151016-M-Shanghai_Masters-QF-Tomas_Berdych-Andy_Murray,1,S-XC,11,2,0,0,2,5,6,,,,,,,,,,
20151016-M-Shanghai_Masters-QF-Tomas_Berdych-Andy_Murray,1,S-DTM,6,0,0,0,0,1,5,,,,,,,,,,
20151016-M-Shanghai_Masters-QF-Tomas_Berdych-Andy_Murray,1,S-DTL,3,0,0,0,0,1,2,,,,,,,,,,
20151016-M-Shanghai_Masters-QF-Tomas_Berdych-Andy_Murray,2,F-XC,30,9,3,4,2,19,11,,,,,,,,,,
20151016-M-Shanghai_Masters-QF-Tomas_Berdych-Andy_Murray,2,F-DTM,16,1,1,0,0,9,7,,,,,,,,,,
20151016-M-Shanghai_Masters-QF-Tomas_Berdych-Andy_Murray,2,F-DTL,3,1,1,0,0,3,0,,,,,,,,,,
20151016-M-Shanghai_Masters-QF-Tomas_Berdych-Andy_Murray,2,F-IO,12,4,2,2,0,11,1,,,,,,,,,,
20151016-M-Shanghai_Masters-QF-Tomas_Berdych-Andy_Murray,2,B-XC,30,8,1,2,5,16,14,,,,,,,,,,
20151016-M-Shanghai_Masters-QF-Tomas_Berdych-Andy_Murray,2,B-DTM,12,2,0,0,2,6,6,,,,,,,,,,
20151016-M-Shanghai_Masters-QF-Tomas_Berdych-Andy_Murray,2,B-DTL,4,2,0,1,1,3,1,,,,,,,,,,
20151016-M-Shanghai_Masters-QF-Tomas_Berdych-Andy_Murray,2,B-IO,4,2,1,1,0,4,0,,,,,,,,,,
20151016-M-Shanghai_Masters-QF-Tomas_Berdych-Andy_Murray,2,S-XC,8,0,0,0,0,3,5,,,,,,,,,,
20151016-M-Shanghai_Masters-QF-Tomas_Berdych-Andy_Murray,2,S-DTM,10,0,0,0,0,6,4,,,,,,,,,,
20151016-M-Shanghai_Masters-QF-Tomas_Berdych-Andy_Murray,2,S-IO,1,0,0,0,0,0,1,,,,,,,,,,
20151017-M-Shanghai_Masters-SF-Andy_Murray-Novak_Djokovic,1,F-XC,35,6,1,2,3,9,26,,,,,,,,,,
20151017-M-Shanghai_Masters-SF-Andy_Murray-Novak_Djokovic,1,F-DTM,7,0,0,0,0,2,5,,,,,,,,,,
20151017-M-Shanghai_Masters-SF-Andy_Murray-Novak_Djokovic,1,F-DTL,12,3,0,1,2,2,10,,,,,,,,,,
20151017-M-Shanghai_Masters-SF-Andy_Murray-Novak_Djokovic,1,F-IO,14,4,1,0,3,5,9,,,,,,,,,,
20151017-M-Shanghai_Masters-SF-Andy_Murray-Novak_Djokovic,1,B-XC,36,6,1,1,4,5,31,,,,,,,,,,
20151017-M-Shanghai_Masters-SF-Andy_Murray-Novak_Djokovic,1,B-DTM,22,0,0,0,0,3,19,,,,,,,,,,
20151017-M-Shanghai_Masters-SF-Andy_Murray-Novak_Djokovic,1,B-DTL,8,4,0,0,4,0,8,,,,,,,,,,
20151017-M-Shanghai_Masters-SF-Andy_Murray-Novak_Djokovic,1,B-IO,3,2,1,0,1,2,1,,,,,,,,,,
20151017-M-Shanghai_Masters-SF-Andy_Murray-Novak_Djokovic,1,S-XC,9,0,0,0,0,1,8,,,,,,,,,,
20151017-M-Shanghai_Masters-SF-Andy_Murray-Novak_Djokovic,1,S-DTM,6,0,0,0,0,0,6,,,,,,,,,,
20151017-M-Shanghai_Masters-SF-Andy_Murray-Novak_Djokovic,2,F-XC,24,5,0,4,1,21,3,,,,,,,,,,
20151017-M-Shanghai_Masters-SF-Andy_Murray-Novak_Djokovic,2,F-DTM,10,1,0,0,1,5,5,,,,,,,,,,
20151017-M-Shanghai_Masters-SF-Andy_Murray-Novak_Djokovic,2,F-DTL,17,2,0,2,0,15,2,,,,,,,,,,
20151017-M-Shanghai_Masters-SF-Andy_Murray-Novak_Djokovic,2,F-IO,5,0,0,0,0,5,0,,,,,,,,,,
20151017-M-Shanghai_Masters-SF-Andy_Murray-Novak_Djokovic,2,F-II,2,1,0,0,1,0,2,,,,,,,,,,
20151017-M-Shanghai_Masters-SF-Andy_Murray-Novak_Djokovic,2,B-XC,33,3,1,1,1,30,3,,,,,,,,,,
20151017-M-Shanghai_Masters-SF-Andy_Murray-Novak_Djokovic,2,B-DTM,20,0,0,0,0,13,7,,,,,,,,,,
20151017-M-Shanghai_Masters-SF-Andy_Murray-Novak_Djokovic,2,B-DTL,11,2,1,0,1,10,1,,,,,,,,,,
20151017-M-Shanghai_Masters-SF-Andy_Murray-Novak_Djokovic,2,B-IO,5,0,0,0,0,5,0,,,,,,,,,,
20151017-M-Shanghai_Masters-SF-Andy_Murray-Novak_Djokovic,2,S-XC,8,0,0,0,0,8,0,,,,,,,,,,
20151017-M-Shanghai_Masters-SF-Andy_Murray-Novak_Djokovic,2,S-DTM,3,0,0,0,0,0,3,,,,,,,,,,
20151018-M-Shanghai_Masters-F-Jo_Wilfried_Tsonga-Novak_Djokovic,1,F-XC,28,10,4,1,5,11,17,,,,,,,,,,
20151018-M-Shanghai_Masters-F-Jo_Wilfried_Tsonga-Novak_Djokovic,1,F-DTM,9,1,0,0,1,3,6,,,,,,,,,,
20151018-M-Shanghai_Masters-F-Jo_Wilfried_Tsonga-Novak_Djokovic,1,F-DTL,9,3,1,1,1,5,4,,,,,,,,,,
20151018-M-Shanghai_Masters-F-Jo_Wilfried_Tsonga-Novak_Djokovic,1,F-IO,26,9,0,0,9,5,21,,,,,,,,,,
20151018-M-Shanghai_Masters-F-Jo_Wilfried_Tsonga-Novak_Djokovic,1,F-II,7,3,2,0,1,4,3,,,,,,,,,,
20151018-M-Shanghai_Masters-F-Jo_Wilfried_Tsonga-Novak_Djokovic,1,B-XC,9,1,0,0,1,5,4,,,,,,,,,,
20151018-M-Shanghai_Masters-F-Jo_Wilfried_Tsonga-Novak_Djokovic,1,B-DTM,16,0,0,0,0,4,12,,,,,,,,,,
20151018-M-Shanghai_Masters-F-Jo_Wilfried_Tsonga-Novak_Djokovic,1,B-DTL,5,1,0,0,1,3,2,,,,,,,,,,
20151018-M-Shanghai_Masters-F-Jo_Wilfried_Tsonga-Novak_Djokovic,1,S-XC,17,0,0,0,0,5,12,,,,,,,,,,
20151018-M-Shanghai_Masters-F-Jo_Wilfried_Tsonga-Novak_Djokovic,1,S-DTM,6,0,0,0,0,1,5,,,,,,,,,,
20151018-M-Shanghai_Masters-F-Jo_Wilfried_Tsonga-Novak_Djokovic,1,S-DTL,6,1,0,0,1,1,5,,,,,,,,,,
20151018-M-Shanghai_Masters-F-Jo_Wilfried_Tsonga-Novak_Djokovic,2,F-XC,30,12,4,4,4,19,11,,,,,,,,,,
20151018-M-Shanghai_Masters-F-Jo_Wilfried_Tsonga-Novak_Djokovic,2,F-DTM,9,0,0,0,0,6,3,,,,,,,,,,
20151018-M-Shanghai_Masters-F-Jo_Wilfried_Tsonga-Novak_Djokovic,2,F-DTL,9,2,1,1,0,6,3,,,,,,,,,,
20151018-M-Shanghai_Masters-F-Jo_Wilfried_Tsonga-Novak_Djokovic,2,F-IO,15,5,2,2,1,11,4,,,,,,,,,,
20151018-M-Shanghai_Masters-F-Jo_Wilfried_Tsonga-Novak_Djokovic,2,F-II,3,1,1,0,0,3,0,,,,,,,,,,
20151018-M-Shanghai_Masters-F-Jo_Wilfried_Tsonga-Novak_Djokovic,2,B-XC,31,2,1,0,1,20,11,,,,,,,,,,
20151018-M-Shanghai_Masters-F-Jo_Wilfried_Tsonga-Novak_Djokovic,2,B-DTM,14,0,0,0,0,8,6,,,,,,,,,,
20151018-M-Shanghai_Masters-F-Jo_Wilfried_Tsonga-Novak_Djokovic,2,B-DTL,7,3,1,2,0,4,3,,,,,,,,,,
20151018-M-Shanghai_Masters-F-Jo_Wilfried_Tsonga-Novak_Djokovic,2,B-IO,3,2,1,1,0,3,0,,,,,,,,,,
20151018-M-Shanghai_Masters-F-Jo_Wilfried_Tsonga-Novak_Djokovic,2,S-XC,6,2,0,1,1,5,1,,,,,,,,,,
20151018-M-Shanghai_Masters-F-Jo_Wilfried_Tsonga-Novak_Djokovic,2,S-DTM,5,1,0,0,1,3,2,,,,,,,,,,
20151019-M-Brest_CH-R32-David_Guez-Ruben_Ramirez_Hidalgo,1,F-XC,50,10,1,5,4,26,24,,,,,,,,,,
20151019-M-Brest_CH-R32-David_Guez-Ruben_Ramirez_Hidalgo,1,F-DTM,33,3,1,1,1,20,13,,,,,,,,,,
20151019-M-Brest_CH-R32-David_Guez-Ruben_Ramirez_Hidalgo,1,F-DTL,12,4,3,1,0,8,4,,,,,,,,,,
20151019-M-Brest_CH-R32-David_Guez-Ruben_Ramirez_Hidalgo,1,F-IO,15,0,0,0,0,8,7,,,,,,,,,,
20151019-M-Brest_CH-R32-David_Guez-Ruben_Ramirez_Hidalgo,1,F-II,2,1,1,0,0,2,0,,,,,,,,,,
20151019-M-Brest_CH-R32-David_Guez-Ruben_Ramirez_Hidalgo,1,B-XC,67,8,2,3,3,40,27,,,,,,,,,,
20151019-M-Brest_CH-R32-David_Guez-Ruben_Ramirez_Hidalgo,1,B-DTM,47,2,0,1,1,29,18,,,,,,,,,,
20151019-M-Brest_CH-R32-David_Guez-Ruben_Ramirez_Hidalgo,1,B-DTL,6,2,1,1,0,3,3,,,,,,,,,,
20151019-M-Brest_CH-R32-David_Guez-Ruben_Ramirez_Hidalgo,1,B-IO,9,4,3,0,1,7,2,,,,,,,,,,
20151019-M-Brest_CH-R32-David_Guez-Ruben_Ramirez_Hidalgo,1,S-XC,2,0,0,0,0,1,1,,,,,,,,,,
20151019-M-Brest_CH-R32-David_Guez-Ruben_Ramirez_Hidalgo,2,F-XC,64,14,4,4,6,28,36,,,,,,,,,,
20151019-M-Brest_CH-R32-David_Guez-Ruben_Ramirez_Hidalgo,2,F-DTM,20,2,0,0,2,5,15,,,,,,,,,,
20151019-M-Brest_CH-R32-David_Guez-Ruben_Ramirez_Hidalgo,2,F-DTL,13,7,1,2,4,8,5,,,,,,,,,,
20151019-M-Brest_CH-R32-David_Guez-Ruben_Ramirez_Hidalgo,2,F-IO,21,4,2,1,1,11,10,,,,,,,,,,
20151019-M-Brest_CH-R32-David_Guez-Ruben_Ramirez_Hidalgo,2,F-II,3,2,1,0,1,2,1,,,,,,,,,,
20151019-M-Brest_CH-R32-David_Guez-Ruben_Ramirez_Hidalgo,2,B-XC,55,5,1,2,2,23,32,,,,,,,,,,
20151019-M-Brest_CH-R32-David_Guez-Ruben_Ramirez_Hidalgo,2,B-DTM,46,8,0,0,8,16,30,,,,,,,,,,
20151019-M-Brest_CH-R32-David_Guez-Ruben_Ramirez_Hidalgo,2,B-DTL,5,1,0,0,1,2,3,,,,,,,,,,
20151019-M-Brest_CH-R32-David_Guez-Ruben_Ramirez_Hidalgo,2,B-IO,3,2,1,0,1,1,2,,,,,,,,,,
20151019-M-Brest_CH-R32-David_Guez-Ruben_Ramirez_Hidalgo,2,S-XC,5,0,0,0,0,4,1,,,,,,,,,,
20151019-M-Brest_CH-R32-David_Guez-Ruben_Ramirez_Hidalgo,2,S-DTM,12,0,0,0,0,3,9,,,,,,,,,,
20151019-M-Brest_CH-R32-David_Guez-Ruben_Ramirez_Hidalgo,2,S-DTL,1,0,0,0,0,1,0,,,,,,,,,,
20151019-M-Santiago_CH-R32-Alejandro_Gonzalez-Carlos_Eduardo_Severino,1,F-XC,48,6,1,3,2,32,16,,,,,,,,,,
20151019-M-Santiago_CH-R32-Alejandro_Gonzalez-Carlos_Eduardo_Severino,1,F-DTM,25,1,0,0,1,18,7,,,,,,,,,,
20151019-M-Santiago_CH-R32-Alejandro_Gonzalez-Carlos_Eduardo_Severino,1,F-DTL,8,3,1,0,2,6,2,,,,,,,,,,
20151019-M-Santiago_CH-R32-Alejandro_Gonzalez-Carlos_Eduardo_Severino,1,F-IO,23,3,1,2,0,14,9,,,,,,,,,,
20151019-M-Santiago_CH-R32-Alejandro_Gonzalez-Carlos_Eduardo_Severino,1,F-II,5,1,0,0,1,4,1,,,,,,,,,,
20151019-M-Santiago_CH-R32-Alejandro_Gonzalez-Carlos_Eduardo_Severino,1,B-XC,77,3,1,0,2,57,20,,,,,,,,,,
20151019-M-Santiago_CH-R32-Alejandro_Gonzalez-Carlos_Eduardo_Severino,1,B-DTM,32,5,0,0,5,14,18,,,,,,,,,,
20151019-M-Santiago_CH-R32-Alejandro_Gonzalez-Carlos_Eduardo_Severino,1,B-DTL,15,5,0,1,4,9,6,,,,,,,,,,
20151019-M-Santiago_CH-R32-Alejandro_Gonzalez-Carlos_Eduardo_Severino,1,B-IO,4,2,0,1,1,3,1,,,,,,,,,,
20151019-M-Santiago_CH-R32-Alejandro_Gonzalez-Carlos_Eduardo_Severino,1,S-XC,7,0,0,0,0,5,2,,,,,,,,,,
20151019-M-Santiago_CH-R32-Alejandro_Gonzalez-Carlos_Eduardo_Severino,1,S-DTM,3,0,0,0,0,0,3,,,,,,,,,,
20151019-M-Santiago_CH-R32-Alejandro_Gonzalez-Carlos_Eduardo_Severino,2,F-XC,39,9,1,3,5,12,27,,,,,,,,,,
20151019-M-Santiago_CH-R32-Alejandro_Gonzalez-Carlos_Eduardo_Severino,2,F-DTM,33,3,0,0,3,12,21,,,,,,,,,,
20151019-M-Santiago_CH-R32-Alejandro_Gonzalez-Carlos_Eduardo_Severino,2,F-DTL,20,7,2,2,3,7,13,,,,,,,,,,
20151019-M-Santiago_CH-R32-Alejandro_Gonzalez-Carlos_Eduardo_Severino,2,F-IO,31,4,0,2,2,15,16,,,,,,,,,,
20151019-M-Santiago_CH-R32-Alejandro_Gonzalez-Carlos_Eduardo_Severino,2,F-II,3,0,0,0,0,0,3,,,,,,,,,,
20151019-M-Santiago_CH-R32-Alejandro_Gonzalez-Carlos_Eduardo_Severino,2,B-XC,69,6,0,0,6,22,47,,,,,,,,,,
20151019-M-Santiago_CH-R32-Alejandro_Gonzalez-Carlos_Eduardo_Severino,2,B-DTM,30,6,0,0,6,7,23,,,,,,,,,,
20151019-M-Santiago_CH-R32-Alejandro_Gonzalez-Carlos_Eduardo_Severino,2,B-DTL,13,7,3,0,4,5,8,,,,,,,,,,
20151019-M-Santiago_CH-R32-Alejandro_Gonzalez-Carlos_Eduardo_Severino,2,B-IO,1,1,0,0,1,0,1,,,,,,,,,,
20151019-M-Santiago_CH-R32-Alejandro_Gonzalez-Carlos_Eduardo_Severino,2,S-XC,8,0,0,0,0,1,7,,,,,,,,,,
20151019-M-Santiago_CH-R32-Alejandro_Gonzalez-Carlos_Eduardo_Severino,2,S-DTM,7,0,0,0,0,4,3,,,,,,,,,,
20151019-M-Santiago_CH-R32-Alejandro_Gonzalez-Carlos_Eduardo_Severino,2,S-DTL,2,0,0,0,0,0,2,,,,,,,,,,
20151021-M-Vienna-R16-Sergiy_Stakhovsky-Ivo_Karlovic,1,F-XC,6,3,1,0,2,2,4,,,,,,,,,,
20151021-M-Vienna-R16-Sergiy_Stakhovsky-Ivo_Karlovic,1,F-DTM,7,1,0,0,1,2,5,,,,,,,,,,
20151021-M-Vienna-R16-Sergiy_Stakhovsky-Ivo_Karlovic,1,F-DTL,3,1,0,1,0,2,1,,,,,,,,,,
20151021-M-Vienna-R16-Sergiy_Stakhovsky-Ivo_Karlovic,1,F-IO,6,2,0,1,1,3,3,,,,,,,,,,
20151021-M-Vienna-R16-Sergiy_Stakhovsky-Ivo_Karlovic,1,B-XC,8,2,0,1,1,4,4,,,,,,,,,,
20151021-M-Vienna-R16-Sergiy_Stakhovsky-Ivo_Karlovic,1,B-DTM,5,3,1,0,2,2,3,,,,,,,,,,
20151021-M-Vienna-R16-Sergiy_Stakhovsky-Ivo_Karlovic,1,B-DTL,3,1,1,0,0,1,2,,,,,,,,,,
20151021-M-Vienna-R16-Sergiy_Stakhovsky-Ivo_Karlovic,1,S-DTL,2,0,0,0,0,2,0,,,,,,,,,,
20151021-M-Vienna-R16-Sergiy_Stakhovsky-Ivo_Karlovic,1,S-IO,1,0,0,0,0,0,1,,,,,,,,,,
20151021-M-Vienna-R16-Sergiy_Stakhovsky-Ivo_Karlovic,2,F-XC,5,3,2,1,0,4,1,,,,,,,,,,
20151021-M-Vienna-R16-Sergiy_Stakhovsky-Ivo_Karlovic,2,F-DTM,4,1,0,0,1,2,2,,,,,,,,,,
20151021-M-Vienna-R16-Sergiy_Stakhovsky-Ivo_Karlovic,2,F-DTL,1,0,0,0,0,1,0,,,,,,,,,,
20151021-M-Vienna-R16-Sergiy_Stakhovsky-Ivo_Karlovic,2,F-IO,4,3,2,0,1,3,1,,,,,,,,,,
20151021-M-Vienna-R16-Sergiy_Stakhovsky-Ivo_Karlovic,2,B-DTM,2,1,0,1,0,1,1,,,,,,,,,,
20151021-M-Vienna-R16-Sergiy_Stakhovsky-Ivo_Karlovic,2,B-DTL,1,1,0,0,1,0,1,,,,,,,,,,
20151021-M-Vienna-R16-Sergiy_Stakhovsky-Ivo_Karlovic,2,S-XC,4,0,0,0,0,1,3,,,,,,,,,,
20151021-M-Vienna-R16-Sergiy_Stakhovsky-Ivo_Karlovic,2,S-DTM,2,1,0,0,1,1,1,,,,,,,,,,
20151021-M-Vienna-R16-Sergiy_Stakhovsky-Ivo_Karlovic,2,S-DTL,2,2,0,2,0,2,0,,,,,,,,,,
20151021-M-Vienna-R16-Sergiy_Stakhovsky-Ivo_Karlovic,2,S-IO,2,0,0,0,0,1,1,,,,,,,,,,
20151023-M-Stockholm-QF-Richard_Gasquet-Jeremy_Chardy,1,F-XC,54,12,2,6,4,27,27,,,,,,,,,,
20151023-M-Stockholm-QF-Richard_Gasquet-Jeremy_Chardy,1,F-DTM,33,1,0,0,1,10,23,,,,,,,,,,
20151023-M-Stockholm-QF-Richard_Gasquet-Jeremy_Chardy,1,F-DTL,28,2,2,0,0,15,13,,,,,,,,,,
20151023-M-Stockholm-QF-Richard_Gasquet-Jeremy_Chardy,1,F-IO,16,3,1,2,0,10,6,,,,,,,,,,
20151023-M-Stockholm-QF-Richard_Gasquet-Jeremy_Chardy,1,B-XC,60,8,1,5,2,29,31,,,,,,,,,,
20151023-M-Stockholm-QF-Richard_Gasquet-Jeremy_Chardy,1,B-DTM,15,2,0,1,1,8,7,,,,,,,,,,
20151023-M-Stockholm-QF-Richard_Gasquet-Jeremy_Chardy,1,B-DTL,11,4,4,0,0,8,3,,,,,,,,,,
20151023-M-Stockholm-QF-Richard_Gasquet-Jeremy_Chardy,1,B-IO,2,0,0,0,0,1,1,,,,,,,,,,
20151023-M-Stockholm-QF-Richard_Gasquet-Jeremy_Chardy,1,S-XC,10,0,0,0,0,4,6,,,,,,,,,,
20151023-M-Stockholm-QF-Richard_Gasquet-Jeremy_Chardy,1,S-DTM,11,0,0,0,0,5,6,,,,,,,,,,
20151023-M-Stockholm-QF-Richard_Gasquet-Jeremy_Chardy,1,S-DTL,1,0,0,0,0,0,1,,,,,,,,,,
20151023-M-Stockholm-QF-Richard_Gasquet-Jeremy_Chardy,2,F-XC,57,13,5,5,3,33,24,,,,,,,,,,
20151023-M-Stockholm-QF-Richard_Gasquet-Jeremy_Chardy,2,F-DTM,24,1,0,1,0,10,14,,,,,,,,,,
20151023-M-Stockholm-QF-Richard_Gasquet-Jeremy_Chardy,2,F-DTL,16,9,5,1,3,9,7,,,,,,,,,,
20151023-M-Stockholm-QF-Richard_Gasquet-Jeremy_Chardy,2,F-IO,49,21,11,6,4,30,19,,,,,,,,,,
20151023-M-Stockholm-QF-Richard_Gasquet-Jeremy_Chardy,2,F-II,13,9,1,5,3,8,5,,,,,,,,,,
20151023-M-Stockholm-QF-Richard_Gasquet-Jeremy_Chardy,2,B-XC,32,5,1,2,2,19,13,,,,,,,,,,
20151023-M-Stockholm-QF-Richard_Gasquet-Jeremy_Chardy,2,B-DTM,22,3,0,2,1,14,8,,,,,,,,,,
20151023-M-Stockholm-QF-Richard_Gasquet-Jeremy_Chardy,2,B-DTL,16,4,0,2,2,9,7,,,,,,,,,,
20151023-M-Stockholm-QF-Richard_Gasquet-Jeremy_Chardy,2,B-IO,3,1,0,0,1,0,3,,,,,,,,,,
20151023-M-Stockholm-QF-Richard_Gasquet-Jeremy_Chardy,2,S-XC,8,1,0,0,1,5,3,,,,,,,,,,
20151023-M-Stockholm-QF-Richard_Gasquet-Jeremy_Chardy,2,S-DTM,3,0,0,0,0,0,3,,,,,,,,,,
20151023-M-Stockholm-QF-Richard_Gasquet-Jeremy_Chardy,2,S-DTL,9,2,0,0,2,4,5,,,,,,,,,,
20151023-M-Stockholm-QF-Richard_Gasquet-Jeremy_Chardy,2,S-IO,1,0,0,0,0,1,0,,,,,,,,,,
20151027-M-Basel-R32-Grigor_Dimitrov-Sergiy_Stakhovsky,1,F-XC,16,7,4,1,2,12,4,,,,,,,,,,
20151027-M-Basel-R32-Grigor_Dimitrov-Sergiy_Stakhovsky,1,F-DTM,9,0,0,0,0,4,5,,,,,,,,,,
20151027-M-Basel-R32-Grigor_Dimitrov-Sergiy_Stakhovsky,1,F-DTL,5,4,3,0,1,4,1,,,,,,,,,,
20151027-M-Basel-R32-Grigor_Dimitrov-Sergiy_Stakhovsky,1,F-IO,13,4,2,0,2,9,4,,,,,,,,,,
20151027-M-Basel-R32-Grigor_Dimitrov-Sergiy_Stakhovsky,1,F-II,3,1,1,0,0,3,0,,,,,,,,,,
20151027-M-Basel-R32-Grigor_Dimitrov-Sergiy_Stakhovsky,1,B-XC,11,1,0,0,1,8,3,,,,,,,,,,
20151027-M-Basel-R32-Grigor_Dimitrov-Sergiy_Stakhovsky,1,B-DTM,19,7,0,1,6,8,11,,,,,,,,,,
20151027-M-Basel-R32-Grigor_Dimitrov-Sergiy_Stakhovsky,1,B-DTL,4,2,2,0,0,2,2,,,,,,,,,,
20151027-M-Basel-R32-Grigor_Dimitrov-Sergiy_Stakhovsky,1,B-IO,2,1,1,0,0,1,1,,,,,,,,,,
20151027-M-Basel-R32-Grigor_Dimitrov-Sergiy_Stakhovsky,1,S-XC,5,1,0,0,1,3,2,,,,,,,,,,
20151027-M-Basel-R32-Grigor_Dimitrov-Sergiy_Stakhovsky,1,S-DTM,4,1,0,0,1,0,4,,,,,,,,,,
20151027-M-Basel-R32-Grigor_Dimitrov-Sergiy_Stakhovsky,2,F-XC,8,3,0,1,2,5,3,,,,,,,,,,
20151027-M-Basel-R32-Grigor_Dimitrov-Sergiy_Stakhovsky,2,F-DTM,13,0,0,0,0,5,8,,,,,,,,,,
20151027-M-Basel-R32-Grigor_Dimitrov-Sergiy_Stakhovsky,2,F-DTL,4,2,0,0,2,1,3,,,,,,,,,,
20151027-M-Basel-R32-Grigor_Dimitrov-Sergiy_Stakhovsky,2,F-IO,10,3,0,0,3,4,6,,,,,,,,,,
20151027-M-Basel-R32-Grigor_Dimitrov-Sergiy_Stakhovsky,2,F-II,1,1,0,0,1,0,1,,,,,,,,,,
20151027-M-Basel-R32-Grigor_Dimitrov-Sergiy_Stakhovsky,2,B-XC,7,2,0,1,1,4,3,,,,,,,,,,
20151027-M-Basel-R32-Grigor_Dimitrov-Sergiy_Stakhovsky,2,B-DTM,9,4,0,0,4,3,6,,,,,,,,,,
20151027-M-Basel-R32-Grigor_Dimitrov-Sergiy_Stakhovsky,2,B-DTL,3,1,0,1,0,1,2,,,,,,,,,,
20151027-M-Basel-R32-Grigor_Dimitrov-Sergiy_Stakhovsky,2,S-XC,9,3,0,0,3,1,8,,,,,,,,,,
20151027-M-Basel-R32-Grigor_Dimitrov-Sergiy_Stakhovsky,2,S-DTM,3,0,0,0,0,0,3,,,,,,,,,,
20151027-M-Basel-R32-Grigor_Dimitrov-Sergiy_Stakhovsky,2,S-DTL,2,1,0,1,0,2,0,,,,,,,,,,
20151027-M-Basel-R32-John_Isner-Ernests_Gulbis,1,F-XC,9,5,4,0,1,7,2,,,,,,,,,,
20151027-M-Basel-R32-John_Isner-Ernests_Gulbis,1,F-DTM,9,1,0,0,1,6,3,,,,,,,,,,
20151027-M-Basel-R32-John_Isner-Ernests_Gulbis,1,F-DTL,1,1,1,0,0,1,0,,,,,,,,,,
20151027-M-Basel-R32-John_Isner-Ernests_Gulbis,1,F-IO,6,2,0,1,1,5,1,,,,,,,,,,
20151027-M-Basel-R32-John_Isner-Ernests_Gulbis,1,F-II,1,1,0,0,1,0,1,,,,,,,,,,
20151027-M-Basel-R32-John_Isner-Ernests_Gulbis,1,B-XC,4,2,1,1,0,4,0,,,,,,,,,,
20151027-M-Basel-R32-John_Isner-Ernests_Gulbis,1,B-DTM,11,1,0,0,1,6,5,,,,,,,,,,
20151027-M-Basel-R32-John_Isner-Ernests_Gulbis,1,B-DTL,3,1,0,0,1,1,2,,,,,,,,,,
20151027-M-Basel-R32-John_Isner-Ernests_Gulbis,1,B-IO,1,1,0,0,1,0,1,,,,,,,,,,
20151027-M-Basel-R32-John_Isner-Ernests_Gulbis,1,S-XC,2,0,0,0,0,1,1,,,,,,,,,,
20151027-M-Basel-R32-John_Isner-Ernests_Gulbis,1,S-DTM,6,2,0,0,2,3,3,,,,,,,,,,
20151027-M-Basel-R32-John_Isner-Ernests_Gulbis,2,F-XC,8,4,0,0,4,1,7,,,,,,,,,,
20151027-M-Basel-R32-John_Isner-Ernests_Gulbis,2,F-DTM,11,4,0,0,4,4,7,,,,,,,,,,
20151027-M-Basel-R32-John_Isner-Ernests_Gulbis,2,F-DTL,1,1,0,0,1,0,1,,,,,,,,,,
20151027-M-Basel-R32-John_Isner-Ernests_Gulbis,2,F-IO,9,3,2,0,1,5,4,,,,,,,,,,
20151027-M-Basel-R32-John_Isner-Ernests_Gulbis,2,B-XC,12,2,1,0,1,5,7,,,,,,,,,,
20151027-M-Basel-R32-John_Isner-Ernests_Gulbis,2,B-DTM,9,2,0,0,2,3,6,,,,,,,,,,
20151027-M-Basel-R32-John_Isner-Ernests_Gulbis,2,B-DTL,1,1,0,0,1,0,1,,,,,,,,,,
20151027-M-Basel-R32-John_Isner-Ernests_Gulbis,2,B-IO,1,1,0,1,0,1,0,,,,,,,,,,
20151027-M-Basel-R32-John_Isner-Ernests_Gulbis,2,S-XC,5,3,0,0,3,1,4,,,,,,,,,,
20151027-M-Basel-R32-Roger_Federer-Mikhail_Kukushkin,1,F-XC,14,3,2,0,1,10,4,,,,,,,,,,
20151027-M-Basel-R32-Roger_Federer-Mikhail_Kukushkin,1,F-DTM,11,2,1,1,0,4,7,,,,,,,,,,
20151027-M-Basel-R32-Roger_Federer-Mikhail_Kukushkin,1,F-DTL,1,0,0,0,0,0,1,,,,,,,,,,
20151027-M-Basel-R32-Roger_Federer-Mikhail_Kukushkin,1,F-IO,10,5,2,2,1,6,4,,,,,,,,,,
20151027-M-Basel-R32-Roger_Federer-Mikhail_Kukushkin,1,B-XC,9,4,0,2,2,4,5,,,,,,,,,,
20151027-M-Basel-R32-Roger_Federer-Mikhail_Kukushkin,1,B-DTM,7,1,1,0,0,3,4,,,,,,,,,,
20151027-M-Basel-R32-Roger_Federer-Mikhail_Kukushkin,1,B-DTL,3,3,2,1,0,3,0,,,,,,,,,,
20151027-M-Basel-R32-Roger_Federer-Mikhail_Kukushkin,1,S-XC,8,4,0,3,1,6,2,,,,,,,,,,
20151027-M-Basel-R32-Roger_Federer-Mikhail_Kukushkin,1,S-DTM,5,0,0,0,0,3,2,,,,,,,,,,
20151027-M-Basel-R32-Roger_Federer-Mikhail_Kukushkin,2,F-XC,9,2,2,0,0,7,2,,,,,,,,,,
20151027-M-Basel-R32-Roger_Federer-Mikhail_Kukushkin,2,F-DTM,15,3,0,0,3,6,9,,,,,,,,,,
20151027-M-Basel-R32-Roger_Federer-Mikhail_Kukushkin,2,F-DTL,3,0,0,0,0,2,1,,,,,,,,,,
20151027-M-Basel-R32-Roger_Federer-Mikhail_Kukushkin,2,F-IO,16,8,3,0,5,6,10,,,,,,,,,,
20151027-M-Basel-R32-Roger_Federer-Mikhail_Kukushkin,2,F-II,1,0,0,0,0,0,1,,,,,,,,,,
20151027-M-Basel-R32-Roger_Federer-Mikhail_Kukushkin,2,B-XC,14,3,2,0,1,8,6,,,,,,,,,,
20151027-M-Basel-R32-Roger_Federer-Mikhail_Kukushkin,2,B-DTM,8,3,0,2,1,4,4,,,,,,,,,,
20151027-M-Basel-R32-Roger_Federer-Mikhail_Kukushkin,2,B-DTL,3,1,0,0,1,0,3,,,,,,,,,,
20151027-M-Basel-R32-Roger_Federer-Mikhail_Kukushkin,2,B-IO,2,0,0,0,0,1,1,,,,,,,,,,
20151027-M-Basel-R32-Roger_Federer-Mikhail_Kukushkin,2,S-XC,3,0,0,0,0,0,3,,,,,,,,,,
20151027-M-Basel-R32-Roger_Federer-Mikhail_Kukushkin,2,S-DTM,1,0,0,0,0,0,1,,,,,,,,,,
20151027-M-Basel-R32-Roger_Federer-Mikhail_Kukushkin,2,S-DTL,2,0,0,0,0,1,1,,,,,,,,,,
20151029-M-Basel-R16-Philipp_Kohlschreiber-Roger_Federer,1,F-XC,23,9,3,3,3,13,10,,,,,,,,,,
20151029-M-Basel-R16-Philipp_Kohlschreiber-Roger_Federer,1,F-DTM,23,6,1,0,5,9,14,,,,,,,,,,
20151029-M-Basel-R16-Philipp_Kohlschreiber-Roger_Federer,1,F-DTL,2,1,1,0,0,2,0,,,,,,,,,,
20151029-M-Basel-R16-Philipp_Kohlschreiber-Roger_Federer,1,F-IO,16,5,2,0,3,7,9,,,,,,,,,,
20151029-M-Basel-R16-Philipp_Kohlschreiber-Roger_Federer,1,F-II,1,0,0,0,0,1,0,,,,,,,,,,
20151029-M-Basel-R16-Philipp_Kohlschreiber-Roger_Federer,1,B-XC,15,5,3,1,1,7,8,,,,,,,,,,
20151029-M-Basel-R16-Philipp_Kohlschreiber-Roger_Federer,1,B-DTM,15,2,1,0,1,4,11,,,,,,,,,,
20151029-M-Basel-R16-Philipp_Kohlschreiber-Roger_Federer,1,B-DTL,2,1,1,0,0,1,1,,,,,,,,,,
20151029-M-Basel-R16-Philipp_Kohlschreiber-Roger_Federer,1,B-IO,2,1,1,0,0,1,1,,,,,,,,,,
20151029-M-Basel-R16-Philipp_Kohlschreiber-Roger_Federer,1,S-XC,4,0,0,0,0,1,3,,,,,,,,,,
20151029-M-Basel-R16-Philipp_Kohlschreiber-Roger_Federer,1,S-DTM,6,0,0,0,0,1,5,,,,,,,,,,
20151029-M-Basel-R16-Philipp_Kohlschreiber-Roger_Federer,1,S-DTL,2,0,0,0,0,1,1,,,,,,,,,,
20151029-M-Basel-R16-Philipp_Kohlschreiber-Roger_Federer,1,S-IO,1,0,0,0,0,1,0,,,,,,,,,,
20151029-M-Basel-R16-Philipp_Kohlschreiber-Roger_Federer,2,F-XC,20,12,2,4,6,11,9,,,,,,,,,,
20151029-M-Basel-R16-Philipp_Kohlschreiber-Roger_Federer,2,F-DTM,21,2,1,1,0,14,7,,,,,,,,,,
20151029-M-Basel-R16-Philipp_Kohlschreiber-Roger_Federer,2,F-DTL,4,2,0,0,2,1,3,,,,,,,,,,
20151029-M-Basel-R16-Philipp_Kohlschreiber-Roger_Federer,2,F-IO,13,7,2,2,3,9,4,,,,,,,,,,
20151029-M-Basel-R16-Philipp_Kohlschreiber-Roger_Federer,2,F-II,1,0,0,0,0,1,0,,,,,,,,,,
20151029-M-Basel-R16-Philipp_Kohlschreiber-Roger_Federer,2,B-XC,7,2,1,0,1,3,4,,,,,,,,,,
20151029-M-Basel-R16-Philipp_Kohlschreiber-Roger_Federer,2,B-DTM,12,1,0,0,1,4,8,,,,,,,,,,
20151029-M-Basel-R16-Philipp_Kohlschreiber-Roger_Federer,2,B-DTL,4,2,0,0,2,1,3,,,,,,,,,,
20151029-M-Basel-R16-Philipp_Kohlschreiber-Roger_Federer,2,B-IO,1,1,0,0,1,0,1,,,,,,,,,,
20151029-M-Basel-R16-Philipp_Kohlschreiber-Roger_Federer,2,S-XC,4,1,0,0,1,3,1,,,,,,,,,,
20151029-M-Basel-R16-Philipp_Kohlschreiber-Roger_Federer,2,S-DTM,8,1,0,0,1,6,2,,,,,,,,,,
20151029-M-Basel-R16-Philipp_Kohlschreiber-Roger_Federer,2,S-DTL,4,1,0,1,0,3,1,,,,,,,,,,
20151029-M-Basel-R16-Philipp_Kohlschreiber-Roger_Federer,2,S-IO,1,0,0,0,0,1,0,,,,,,,,,,
20151029-M-Basel-R16-Rafael_Nadal-Grigor_Dimitrov,1,F-XC,79,7,1,3,3,48,31,,,,,,,,,,
20151029-M-Basel-R16-Rafael_Nadal-Grigor_Dimitrov,1,F-DTM,16,2,0,0,2,9,7,,,,,,,,,,
20151029-M-Basel-R16-Rafael_Nadal-Grigor_Dimitrov,1,F-DTL,14,7,3,3,1,7,7,,,,,,,,,,
20151029-M-Basel-R16-Rafael_Nadal-Grigor_Dimitrov,1,F-IO,31,12,3,5,4,21,10,,,,,,,,,,
20151029-M-Basel-R16-Rafael_Nadal-Grigor_Dimitrov,1,F-II,4,1,0,0,1,3,1,,,,,,,,,,
20151029-M-Basel-R16-Rafael_Nadal-Grigor_Dimitrov,1,B-XC,33,5,0,2,3,20,13,,,,,,,,,,
20151029-M-Basel-R16-Rafael_Nadal-Grigor_Dimitrov,1,B-DTM,25,3,0,2,1,13,12,,,,,,,,,,
20151029-M-Basel-R16-Rafael_Nadal-Grigor_Dimitrov,1,B-DTL,19,4,0,1,3,11,8,,,,,,,,,,
20151029-M-Basel-R16-Rafael_Nadal-Grigor_Dimitrov,1,B-IO,7,1,0,1,0,5,2,,,,,,,,,,
20151029-M-Basel-R16-Rafael_Nadal-Grigor_Dimitrov,1,S-XC,4,2,1,1,0,4,0,,,,,,,,,,
20151029-M-Basel-R16-Rafael_Nadal-Grigor_Dimitrov,1,S-DTM,1,0,0,0,0,0,1,,,,,,,,,,
20151029-M-Basel-R16-Rafael_Nadal-Grigor_Dimitrov,1,S-DTL,7,1,0,0,1,4,3,,,,,,,,,,
20151029-M-Basel-R16-Rafael_Nadal-Grigor_Dimitrov,2,F-XC,68,9,2,4,3,28,40,,,,,,,,,,
20151029-M-Basel-R16-Rafael_Nadal-Grigor_Dimitrov,2,F-DTM,24,3,0,0,3,10,14,,,,,,,,,,
20151029-M-Basel-R16-Rafael_Nadal-Grigor_Dimitrov,2,F-DTL,11,7,2,4,1,6,5,,,,,,,,,,
20151029-M-Basel-R16-Rafael_Nadal-Grigor_Dimitrov,2,F-IO,22,13,8,1,3,14,8,,,,,,,,,,
20151029-M-Basel-R16-Rafael_Nadal-Grigor_Dimitrov,2,F-II,4,2,1,0,1,3,1,,,,,,,,,,
20151029-M-Basel-R16-Rafael_Nadal-Grigor_Dimitrov,2,B-XC,22,7,0,3,4,11,11,,,,,,,,,,
20151029-M-Basel-R16-Rafael_Nadal-Grigor_Dimitrov,2,B-DTM,47,8,0,0,8,11,36,,,,,,,,,,
20151029-M-Basel-R16-Rafael_Nadal-Grigor_Dimitrov,2,B-DTL,13,5,2,0,3,6,7,,,,,,,,,,
20151029-M-Basel-R16-Rafael_Nadal-Grigor_Dimitrov,2,B-IO,2,1,1,0,0,2,0,,,,,,,,,,
20151029-M-Basel-R16-Rafael_Nadal-Grigor_Dimitrov,2,S-XC,11,1,1,0,0,5,6,,,,,,,,,,
20151029-M-Basel-R16-Rafael_Nadal-Grigor_Dimitrov,2,S-DTM,12,0,0,0,0,3,9,,,,,,,,,,
20151029-M-Basel-R16-Rafael_Nadal-Grigor_Dimitrov,2,S-DTL,9,3,0,0,3,3,6,,,,,,,,,,
20151030-M-Basel-QF-Roger_Federer-David_Goffin,1,F-XC,34,8,2,2,4,21,13,,,,,,,,,,
20151030-M-Basel-QF-Roger_Federer-David_Goffin,1,F-DTM,25,6,1,1,4,11,14,,,,,,,,,,
20151030-M-Basel-QF-Roger_Federer-David_Goffin,1,F-DTL,16,7,3,1,3,10,6,,,,,,,,,,
20151030-M-Basel-QF-Roger_Federer-David_Goffin,1,F-IO,16,8,0,3,5,6,10,,,,,,,,,,
20151030-M-Basel-QF-Roger_Federer-David_Goffin,1,F-II,4,1,0,0,1,3,1,,,,,,,,,,
20151030-M-Basel-QF-Roger_Federer-David_Goffin,1,B-XC,12,7,1,5,1,8,4,,,,,,,,,,
20151030-M-Basel-QF-Roger_Federer-David_Goffin,1,B-DTM,23,1,1,0,0,11,12,,,,,,,,,,
20151030-M-Basel-QF-Roger_Federer-David_Goffin,1,B-DTL,2,1,0,0,1,1,1,,,,,,,,,,
20151030-M-Basel-QF-Roger_Federer-David_Goffin,1,B-IO,3,1,0,0,1,2,1,,,,,,,,,,
20151030-M-Basel-QF-Roger_Federer-David_Goffin,1,S-XC,14,1,0,0,1,7,7,,,,,,,,,,
20151030-M-Basel-QF-Roger_Federer-David_Goffin,1,S-DTM,9,0,0,0,0,5,4,,,,,,,,,,
20151030-M-Basel-QF-Roger_Federer-David_Goffin,1,S-DTL,4,2,1,1,0,3,1,,,,,,,,,,
20151030-M-Basel-QF-Roger_Federer-David_Goffin,1,S-IO,1,0,0,0,0,1,0,,,,,,,,,,
20151030-M-Basel-QF-Roger_Federer-David_Goffin,1,S-II,1,0,0,0,0,0,1,,,,,,,,,,
20151030-M-Basel-QF-Roger_Federer-David_Goffin,2,F-XC,37,5,1,0,4,13,24,,,,,,,,,,
20151030-M-Basel-QF-Roger_Federer-David_Goffin,2,F-DTM,26,1,0,0,1,11,15,,,,,,,,,,
20151030-M-Basel-QF-Roger_Federer-David_Goffin,2,F-DTL,13,5,1,1,3,5,8,,,,,,,,,,
20151030-M-Basel-QF-Roger_Federer-David_Goffin,2,F-IO,12,3,1,0,2,4,8,,,,,,,,,,
20151030-M-Basel-QF-Roger_Federer-David_Goffin,2,F-II,5,1,1,0,0,3,2,,,,,,,,,,
20151030-M-Basel-QF-Roger_Federer-David_Goffin,2,B-XC,39,6,1,2,3,20,19,,,,,,,,,,
20151030-M-Basel-QF-Roger_Federer-David_Goffin,2,B-DTM,15,3,1,0,2,10,5,,,,,,,,,,
20151030-M-Basel-QF-Roger_Federer-David_Goffin,2,B-DTL,4,1,0,0,1,1,3,,,,,,,,,,
20151030-M-Basel-QF-Roger_Federer-David_Goffin,2,B-IO,5,1,1,0,0,4,1,,,,,,,,,,
20151030-M-Basel-QF-Roger_Federer-David_Goffin,2,S-XC,3,0,0,0,0,1,2,,,,,,,,,,
20151030-M-Basel-QF-Roger_Federer-David_Goffin,2,S-DTM,3,0,0,0,0,0,3,,,,,,,,,,
20151030-M-Basel-QF-Roger_Federer-David_Goffin,2,S-DTL,1,0,0,0,0,1,0,,,,,,,,,,
20151031-M-Basel-SF-Rafael_Nadal-Richard_Gasquet,1,F-XC,86,16,7,6,3,56,30,,,,,,,,,,
20151031-M-Basel-SF-Rafael_Nadal-Richard_Gasquet,1,F-DTM,22,2,0,2,0,13,9,,,,,,,,,,
20151031-M-Basel-SF-Rafael_Nadal-Richard_Gasquet,1,F-DTL,12,7,5,0,2,8,4,,,,,,,,,,
20151031-M-Basel-SF-Rafael_Nadal-Richard_Gasquet,1,F-IO,38,9,3,4,2,26,12,,,,,,,,,,
20151031-M-Basel-SF-Rafael_Nadal-Richard_Gasquet,1,F-II,2,0,0,0,0,1,1,,,,,,,,,,
20151031-M-Basel-SF-Rafael_Nadal-Richard_Gasquet,1,B-XC,40,6,1,2,3,18,22,,,,,,,,,,
20151031-M-Basel-SF-Rafael_Nadal-Richard_Gasquet,1,B-DTM,27,2,1,1,0,12,15,,,,,,,,,,
20151031-M-Basel-SF-Rafael_Nadal-Richard_Gasquet,1,B-DTL,14,6,1,2,3,8,6,,,,,,,,,,
20151031-M-Basel-SF-Rafael_Nadal-Richard_Gasquet,1,B-IO,1,0,0,0,0,0,1,,,,,,,,,,
20151031-M-Basel-SF-Rafael_Nadal-Richard_Gasquet,1,S-XC,6,0,0,0,0,3,3,,,,,,,,,,
20151031-M-Basel-SF-Rafael_Nadal-Richard_Gasquet,1,S-DTM,8,0,0,0,0,4,4,,,,,,,,,,
20151031-M-Basel-SF-Rafael_Nadal-Richard_Gasquet,1,S-DTL,2,0,0,0,0,2,0,,,,,,,,,,
20151031-M-Basel-SF-Rafael_Nadal-Richard_Gasquet,2,F-XC,79,7,1,5,1,38,41,,,,,,,,,,
20151031-M-Basel-SF-Rafael_Nadal-Richard_Gasquet,2,F-DTM,29,5,0,1,4,12,17,,,,,,,,,,
20151031-M-Basel-SF-Rafael_Nadal-Richard_Gasquet,2,F-DTL,12,6,3,1,2,7,5,,,,,,,,,,
20151031-M-Basel-SF-Rafael_Nadal-Richard_Gasquet,2,F-IO,5,3,1,0,2,3,2,,,,,,,,,,
20151031-M-Basel-SF-Rafael_Nadal-Richard_Gasquet,2,B-XC,47,12,1,4,7,22,25,,,,,,,,,,
20151031-M-Basel-SF-Rafael_Nadal-Richard_Gasquet,2,B-DTM,29,1,0,0,1,13,16,,,,,,,,,,
20151031-M-Basel-SF-Rafael_Nadal-Richard_Gasquet,2,B-DTL,16,10,5,0,5,8,8,,,,,,,,,,
20151031-M-Basel-SF-Rafael_Nadal-Richard_Gasquet,2,B-IO,7,2,0,2,0,4,3,,,,,,,,,,
20151031-M-Basel-SF-Rafael_Nadal-Richard_Gasquet,2,S-XC,7,0,0,0,0,1,6,,,,,,,,,,
20151031-M-Basel-SF-Rafael_Nadal-Richard_Gasquet,2,S-DTM,17,2,0,0,2,1,16,,,,,,,,,,
20151031-M-Basel-SF-Rafael_Nadal-Richard_Gasquet,2,S-DTL,1,1,1,0,0,1,0,,,,,,,,,,
20151031-M-Basel-SF-Roger_Federer-Jack_Sock,1,F-XC,12,4,0,1,3,6,6,,,,,,,,,,
20151031-M-Basel-SF-Roger_Federer-Jack_Sock,1,F-DTM,12,4,1,0,3,5,7,,,,,,,,,,
20151031-M-Basel-SF-Roger_Federer-Jack_Sock,1,F-DTL,4,2,1,0,1,3,1,,,,,,,,,,
20151031-M-Basel-SF-Roger_Federer-Jack_Sock,1,F-IO,14,8,3,0,5,7,7,,,,,,,,,,
20151031-M-Basel-SF-Roger_Federer-Jack_Sock,1,F-II,2,1,1,0,0,1,1,,,,,,,,,,
20151031-M-Basel-SF-Roger_Federer-Jack_Sock,1,B-XC,6,1,0,0,1,2,4,,,,,,,,,,
20151031-M-Basel-SF-Roger_Federer-Jack_Sock,1,B-DTM,8,2,0,1,1,4,4,,,,,,,,,,
20151031-M-Basel-SF-Roger_Federer-Jack_Sock,1,B-DTL,4,2,0,1,1,1,3,,,,,,,,,,
20151031-M-Basel-SF-Roger_Federer-Jack_Sock,1,S-XC,5,3,0,1,2,3,2,,,,,,,,,,
20151031-M-Basel-SF-Roger_Federer-Jack_Sock,1,S-DTM,3,0,0,0,0,1,2,,,,,,,,,,
20151031-M-Basel-SF-Roger_Federer-Jack_Sock,2,F-XC,15,5,1,2,2,8,7,,,,,,,,,,
20151031-M-Basel-SF-Roger_Federer-Jack_Sock,2,F-DTM,18,4,0,1,3,10,8,,,,,,,,,,
20151031-M-Basel-SF-Roger_Federer-Jack_Sock,2,F-DTL,1,0,0,0,0,0,1,,,,,,,,,,
20151031-M-Basel-SF-Roger_Federer-Jack_Sock,2,F-IO,23,10,1,1,8,10,13,,,,,,,,,,
20151031-M-Basel-SF-Roger_Federer-Jack_Sock,2,F-II,1,0,0,0,0,1,0,,,,,,,,,,
20151031-M-Basel-SF-Roger_Federer-Jack_Sock,2,B-XC,6,1,0,0,1,4,2,,,,,,,,,,
20151031-M-Basel-SF-Roger_Federer-Jack_Sock,2,B-DTM,2,2,0,0,2,0,2,,,,,,,,,,
20151031-M-Basel-SF-Roger_Federer-Jack_Sock,2,B-DTL,4,1,0,0,1,0,4,,,,,,,,,,
20151031-M-Basel-SF-Roger_Federer-Jack_Sock,2,B-IO,2,1,0,0,1,1,1,,,,,,,,,,
20151031-M-Basel-SF-Roger_Federer-Jack_Sock,2,S-XC,3,0,0,0,0,1,2,,,,,,,,,,
20151031-M-Basel-SF-Roger_Federer-Jack_Sock,2,S-DTM,1,1,0,1,0,1,0,,,,,,,,,,
20151031-M-Basel-SF-Roger_Federer-Jack_Sock,2,S-DTL,2,0,0,0,0,0,2,,,,,,,,,,
20151101-M-Basel-F-Rafael_Nadal-Roger_Federer,1,F-XC,29,6,1,4,1,16,13,,,,,,,,,,
20151101-M-Basel-F-Rafael_Nadal-Roger_Federer,1,F-DTM,13,1,0,0,1,2,11,,,,,,,,,,
20151101-M-Basel-F-Rafael_Nadal-Roger_Federer,1,F-DTL,5,3,3,0,0,4,1,,,,,,,,,,
20151101-M-Basel-F-Rafael_Nadal-Roger_Federer,1,F-IO,18,5,4,1,0,13,5,,,,,,,,,,
20151101-M-Basel-F-Rafael_Nadal-Roger_Federer,1,F-II,3,0,0,0,0,2,1,,,,,,,,,,
20151101-M-Basel-F-Rafael_Nadal-Roger_Federer,1,B-XC,21,7,5,1,1,9,12,,,,,,,,,,
20151101-M-Basel-F-Rafael_Nadal-Roger_Federer,1,B-DTM,15,0,0,0,0,7,8,,,,,,,,,,
20151101-M-Basel-F-Rafael_Nadal-Roger_Federer,1,B-DTL,4,1,1,0,0,2,2,,,,,,,,,,
20151101-M-Basel-F-Rafael_Nadal-Roger_Federer,1,B-IO,2,1,1,0,0,1,1,,,,,,,,,,
20151101-M-Basel-F-Rafael_Nadal-Roger_Federer,1,S-DTM,1,0,0,0,0,1,0,,,,,,,,,,
20151101-M-Basel-F-Rafael_Nadal-Roger_Federer,1,S-DTL,3,0,0,0,0,2,1,,,,,,,,,,
20151101-M-Basel-F-Rafael_Nadal-Roger_Federer,2,F-XC,26,7,6,1,0,15,11,,,,,,,,,,
20151101-M-Basel-F-Rafael_Nadal-Roger_Federer,2,F-DTM,13,0,0,0,0,10,3,,,,,,,,,,
20151101-M-Basel-F-Rafael_Nadal-Roger_Federer,2,F-DTL,8,5,3,1,1,5,3,,,,,,,,,,
20151101-M-Basel-F-Rafael_Nadal-Roger_Federer,2,F-IO,12,7,5,2,0,9,3,,,,,,,,,,
20151101-M-Basel-F-Rafael_Nadal-Roger_Federer,2,F-II,3,1,1,0,0,2,1,,,,,,,,,,
20151101-M-Basel-F-Rafael_Nadal-Roger_Federer,2,B-XC,16,5,4,0,1,11,5,,,,,,,,,,
20151101-M-Basel-F-Rafael_Nadal-Roger_Federer,2,B-DTM,10,5,0,1,4,3,7,,,,,,,,,,
20151101-M-Basel-F-Rafael_Nadal-Roger_Federer,2,B-DTL,4,0,0,0,0,2,2,,,,,,,,,,
20151101-M-Basel-F-Rafael_Nadal-Roger_Federer,2,B-IO,1,0,0,0,0,1,0,,,,,,,,,,
20151101-M-Basel-F-Rafael_Nadal-Roger_Federer,2,S-XC,1,0,0,0,0,1,0,,,,,,,,,,
20151101-M-Basel-F-Rafael_Nadal-Roger_Federer,2,S-DTM,3,0,0,0,0,0,3,,,,,,,,,,
20151101-M-Basel-F-Rafael_Nadal-Roger_Federer,2,S-DTL,1,0,0,0,0,1,0,,,,,,,,,,
20151101-M-Basel-F-Rafael_Nadal-Roger_Federer,2,S-IO,1,0,0,0,0,1,0,,,,,,,,,,
20151101-M-Valencia-F-Roberto_Bautista_Agut-Joao_Sousa,1,F-XC,59,18,4,9,5,33,26,,,,,,,,,,
20151101-M-Valencia-F-Roberto_Bautista_Agut-Joao_Sousa,1,F-DTM,19,0,0,0,0,7,12,,,,,,,,,,
20151101-M-Valencia-F-Roberto_Bautista_Agut-Joao_Sousa,1,F-DTL,23,4,3,0,1,11,12,,,,,,,,,,
20151101-M-Valencia-F-Roberto_Bautista_Agut-Joao_Sousa,1,F-IO,34,9,1,4,4,18,16,,,,,,,,,,
20151101-M-Valencia-F-Roberto_Bautista_Agut-Joao_Sousa,1,F-II,6,2,0,1,1,3,3,,,,,,,,,,
20151101-M-Valencia-F-Roberto_Bautista_Agut-Joao_Sousa,1,B-XC,54,4,0,2,2,22,32,,,,,,,,,,
20151101-M-Valencia-F-Roberto_Bautista_Agut-Joao_Sousa,1,B-DTM,23,2,0,0,2,8,15,,,,,,,,,,
20151101-M-Valencia-F-Roberto_Bautista_Agut-Joao_Sousa,1,B-DTL,16,3,0,1,2,6,10,,,,,,,,,,
20151101-M-Valencia-F-Roberto_Bautista_Agut-Joao_Sousa,1,B-IO,2,0,0,0,0,0,2,,,,,,,,,,
20151101-M-Valencia-F-Roberto_Bautista_Agut-Joao_Sousa,1,S-XC,16,1,0,0,1,9,7,,,,,,,,,,
20151101-M-Valencia-F-Roberto_Bautista_Agut-Joao_Sousa,1,S-DTM,7,0,0,0,0,1,6,,,,,,,,,,
20151101-M-Valencia-F-Roberto_Bautista_Agut-Joao_Sousa,1,S-DTL,3,1,1,0,0,2,1,,,,,,,,,,
20151101-M-Valencia-F-Roberto_Bautista_Agut-Joao_Sousa,2,F-XC,52,8,1,6,1,29,23,,,,,,,,,,
20151101-M-Valencia-F-Roberto_Bautista_Agut-Joao_Sousa,2,F-DTM,19,2,0,0,2,10,9,,,,,,,,,,
20151101-M-Valencia-F-Roberto_Bautista_Agut-Joao_Sousa,2,F-DTL,35,6,2,3,1,19,16,,,,,,,,,,
20151101-M-Valencia-F-Roberto_Bautista_Agut-Joao_Sousa,2,F-IO,62,19,8,6,5,39,23,,,,,,,,,,
20151101-M-Valencia-F-Roberto_Bautista_Agut-Joao_Sousa,2,F-II,23,12,1,7,4,16,7,,,,,,,,,,
20151101-M-Valencia-F-Roberto_Bautista_Agut-Joao_Sousa,2,B-XC,42,3,0,0,3,24,18,,,,,,,,,,
20151101-M-Valencia-F-Roberto_Bautista_Agut-Joao_Sousa,2,B-DTM,21,4,0,1,3,11,10,,,,,,,,,,
20151101-M-Valencia-F-Roberto_Bautista_Agut-Joao_Sousa,2,B-DTL,6,0,0,0,0,5,1,,,,,,,,,,
20151101-M-Valencia-F-Roberto_Bautista_Agut-Joao_Sousa,2,B-IO,3,1,1,0,0,1,2,,,,,,,,,,
20151101-M-Valencia-F-Roberto_Bautista_Agut-Joao_Sousa,2,S-XC,10,2,0,2,0,4,6,,,,,,,,,,
20151101-M-Valencia-F-Roberto_Bautista_Agut-Joao_Sousa,2,S-DTM,4,0,0,0,0,1,3,,,,,,,,,,
20151101-M-Valencia-F-Roberto_Bautista_Agut-Joao_Sousa,2,S-DTL,6,0,0,0,0,1,5,,,,,,,,,,
20151102-M-Canberra_CH-R32-Sebastian_Fanselow-Christopher_Oconnell,1,F-XC,17,6,3,1,2,12,5,,,,,,,,,,
20151102-M-Canberra_CH-R32-Sebastian_Fanselow-Christopher_Oconnell,1,F-DTM,6,0,0,0,0,3,3,,,,,,,,,,
20151102-M-Canberra_CH-R32-Sebastian_Fanselow-Christopher_Oconnell,1,F-DTL,4,2,1,0,1,3,1,,,,,,,,,,
20151102-M-Canberra_CH-R32-Sebastian_Fanselow-Christopher_Oconnell,1,F-IO,12,3,1,1,1,9,3,,,,,,,,,,
20151102-M-Canberra_CH-R32-Sebastian_Fanselow-Christopher_Oconnell,1,F-II,1,1,0,1,0,1,0,,,,,,,,,,
20151102-M-Canberra_CH-R32-Sebastian_Fanselow-Christopher_Oconnell,1,B-XC,18,5,0,3,2,9,9,,,,,,,,,,
20151102-M-Canberra_CH-R32-Sebastian_Fanselow-Christopher_Oconnell,1,B-DTM,13,0,0,0,0,8,5,,,,,,,,,,
20151102-M-Canberra_CH-R32-Sebastian_Fanselow-Christopher_Oconnell,1,B-DTL,3,3,2,1,0,3,0,,,,,,,,,,
20151102-M-Canberra_CH-R32-Sebastian_Fanselow-Christopher_Oconnell,1,S-XC,1,0,0,0,0,0,1,,,,,,,,,,
20151102-M-Canberra_CH-R32-Sebastian_Fanselow-Christopher_Oconnell,2,F-XC,19,6,0,4,2,9,10,,,,,,,,,,
20151102-M-Canberra_CH-R32-Sebastian_Fanselow-Christopher_Oconnell,2,F-DTM,7,3,0,0,3,2,5,,,,,,,,,,
20151102-M-Canberra_CH-R32-Sebastian_Fanselow-Christopher_Oconnell,2,F-DTL,5,4,1,1,2,2,3,,,,,,,,,,
20151102-M-Canberra_CH-R32-Sebastian_Fanselow-Christopher_Oconnell,2,F-IO,9,2,0,0,2,1,8,,,,,,,,,,
20151102-M-Canberra_CH-R32-Sebastian_Fanselow-Christopher_Oconnell,2,F-II,4,3,1,0,2,2,2,,,,,,,,,,
20151102-M-Canberra_CH-R32-Sebastian_Fanselow-Christopher_Oconnell,2,B-XC,15,2,0,2,0,9,6,,,,,,,,,,
20151102-M-Canberra_CH-R32-Sebastian_Fanselow-Christopher_Oconnell,2,B-DTM,8,2,0,0,2,4,4,,,,,,,,,,
20151102-M-Canberra_CH-R32-Sebastian_Fanselow-Christopher_Oconnell,2,B-DTL,2,2,1,0,1,1,1,,,,,,,,,,
20151102-M-Canberra_CH-R32-Sebastian_Fanselow-Christopher_Oconnell,2,S-XC,6,1,0,1,0,1,5,,,,,,,,,,
20151102-M-Canberra_CH-R32-Sebastian_Fanselow-Christopher_Oconnell,2,S-DTM,5,0,0,0,0,0,5,,,,,,,,,,
20151102-M-Canberra_CH-R32-Sebastian_Fanselow-Christopher_Oconnell,2,S-DTL,2,0,0,0,0,1,1,,,,,,,,,,
20151103-M-Paris-R32-Edouard_Roger_Vasselin-Ivo_Karlovic,1,F-XC,18,9,3,1,5,9,9,,,,,,,,,,
20151103-M-Paris-R32-Edouard_Roger_Vasselin-Ivo_Karlovic,1,F-DTM,9,2,1,1,0,6,3,,,,,,,,,,
20151103-M-Paris-R32-Edouard_Roger_Vasselin-Ivo_Karlovic,1,F-DTL,6,3,1,2,0,5,1,,,,,,,,,,
20151103-M-Paris-R32-Edouard_Roger_Vasselin-Ivo_Karlovic,1,F-IO,7,3,0,1,2,4,3,,,,,,,,,,
20151103-M-Paris-R32-Edouard_Roger_Vasselin-Ivo_Karlovic,1,B-XC,11,4,2,2,0,9,2,,,,,,,,,,
20151103-M-Paris-R32-Edouard_Roger_Vasselin-Ivo_Karlovic,1,B-DTM,5,2,0,1,1,1,4,,,,,,,,,,
20151103-M-Paris-R32-Edouard_Roger_Vasselin-Ivo_Karlovic,1,B-DTL,8,6,3,1,2,5,3,,,,,,,,,,
20151103-M-Paris-R32-Edouard_Roger_Vasselin-Ivo_Karlovic,1,S-XC,6,0,0,0,0,3,3,,,,,,,,,,
20151103-M-Paris-R32-Edouard_Roger_Vasselin-Ivo_Karlovic,1,S-DTM,1,0,0,0,0,0,1,,,,,,,,,,
20151103-M-Paris-R32-Edouard_Roger_Vasselin-Ivo_Karlovic,2,F-XC,13,8,1,2,5,5,8,,,,,,,,,,
20151103-M-Paris-R32-Edouard_Roger_Vasselin-Ivo_Karlovic,2,F-DTM,4,1,0,0,1,1,3,,,,,,,,,,
20151103-M-Paris-R32-Edouard_Roger_Vasselin-Ivo_Karlovic,2,F-IO,3,2,2,0,0,2,1,,,,,,,,,,
20151103-M-Paris-R32-Edouard_Roger_Vasselin-Ivo_Karlovic,2,F-II,1,1,1,0,0,1,0,,,,,,,,,,
20151103-M-Paris-R32-Edouard_Roger_Vasselin-Ivo_Karlovic,2,B-XC,1,1,0,0,1,0,1,,,,,,,,,,
20151103-M-Paris-R32-Edouard_Roger_Vasselin-Ivo_Karlovic,2,B-DTM,2,0,0,0,0,0,2,,,,,,,,,,
20151103-M-Paris-R32-Edouard_Roger_Vasselin-Ivo_Karlovic,2,B-DTL,4,3,0,0,3,1,3,,,,,,,,,,
20151103-M-Paris-R32-Edouard_Roger_Vasselin-Ivo_Karlovic,2,S-XC,6,1,0,1,0,5,1,,,,,,,,,,
20151103-M-Paris-R32-Edouard_Roger_Vasselin-Ivo_Karlovic,2,S-DTM,3,2,0,0,2,0,3,,,,,,,,,,
20151103-M-Paris-R32-Edouard_Roger_Vasselin-Ivo_Karlovic,2,S-DTL,5,2,0,0,2,1,4,,,,,,,,,,
20151103-M-Paris-R32-Edouard_Roger_Vasselin-Ivo_Karlovic,2,S-IO,3,0,0,0,0,1,2,,,,,,,,,,
20151104-M-Paris-R32-Roberto_Bautista_Agut-Jo_Wilfried_Tsonga,1,F-XC,22,2,2,0,0,12,10,,,,,,,,,,
20151104-M-Paris-R32-Roberto_Bautista_Agut-Jo_Wilfried_Tsonga,1,F-DTM,6,0,0,0,0,2,4,,,,,,,,,,
20151104-M-Paris-R32-Roberto_Bautista_Agut-Jo_Wilfried_Tsonga,1,F-DTL,8,0,0,0,0,4,4,,,,,,,,,,
20151104-M-Paris-R32-Roberto_Bautista_Agut-Jo_Wilfried_Tsonga,1,F-IO,23,2,0,0,2,11,12,,,,,,,,,,
20151104-M-Paris-R32-Roberto_Bautista_Agut-Jo_Wilfried_Tsonga,1,F-II,6,2,0,1,1,4,2,,,,,,,,,,
20151104-M-Paris-R32-Roberto_Bautista_Agut-Jo_Wilfried_Tsonga,1,B-XC,21,4,0,1,3,11,10,,,,,,,,,,
20151104-M-Paris-R32-Roberto_Bautista_Agut-Jo_Wilfried_Tsonga,1,B-DTM,15,2,0,1,1,5,10,,,,,,,,,,
20151104-M-Paris-R32-Roberto_Bautista_Agut-Jo_Wilfried_Tsonga,1,B-DTL,5,3,0,1,2,1,4,,,,,,,,,,
20151104-M-Paris-R32-Roberto_Bautista_Agut-Jo_Wilfried_Tsonga,1,S-XC,8,1,0,1,0,3,5,,,,,,,,,,
20151104-M-Paris-R32-Roberto_Bautista_Agut-Jo_Wilfried_Tsonga,1,S-DTM,3,0,0,0,0,0,3,,,,,,,,,,
20151104-M-Paris-R32-Roberto_Bautista_Agut-Jo_Wilfried_Tsonga,2,F-XC,15,5,0,2,3,6,9,,,,,,,,,,
20151104-M-Paris-R32-Roberto_Bautista_Agut-Jo_Wilfried_Tsonga,2,F-DTM,10,2,0,0,2,5,5,,,,,,,,,,
20151104-M-Paris-R32-Roberto_Bautista_Agut-Jo_Wilfried_Tsonga,2,F-DTL,5,2,0,0,2,2,3,,,,,,,,,,
20151104-M-Paris-R32-Roberto_Bautista_Agut-Jo_Wilfried_Tsonga,2,F-IO,28,11,8,1,2,22,6,,,,,,,,,,
20151104-M-Paris-R32-Roberto_Bautista_Agut-Jo_Wilfried_Tsonga,2,F-II,4,0,0,0,0,2,2,,,,,,,,,,
20151104-M-Paris-R32-Roberto_Bautista_Agut-Jo_Wilfried_Tsonga,2,B-XC,16,4,1,1,2,7,9,,,,,,,,,,
20151104-M-Paris-R32-Roberto_Bautista_Agut-Jo_Wilfried_Tsonga,2,B-DTM,7,2,0,0,2,2,5,,,,,,,,,,
20151104-M-Paris-R32-Roberto_Bautista_Agut-Jo_Wilfried_Tsonga,2,B-DTL,11,6,3,2,1,9,2,,,,,,,,,,
20151104-M-Paris-R32-Roberto_Bautista_Agut-Jo_Wilfried_Tsonga,2,B-IO,1,0,0,0,0,1,0,,,,,,,,,,
20151104-M-Paris-R32-Roberto_Bautista_Agut-Jo_Wilfried_Tsonga,2,S-XC,11,1,0,0,1,6,5,,,,,,,,,,
20151104-M-Paris-R32-Roberto_Bautista_Agut-Jo_Wilfried_Tsonga,2,S-DTM,7,0,0,0,0,3,4,,,,,,,,,,
20151104-M-Paris-R32-Roberto_Bautista_Agut-Jo_Wilfried_Tsonga,2,S-DTL,5,0,0,0,0,2,3,,,,,,,,,,
20151105-M-Paris-R16-Andy_Murray-David_Goffin,1,F-XC,22,4,0,2,2,17,5,,,,,,,,,,
20151105-M-Paris-R16-Andy_Murray-David_Goffin,1,F-DTM,9,1,0,0,1,5,4,,,,,,,,,,
20151105-M-Paris-R16-Andy_Murray-David_Goffin,1,F-DTL,2,1,0,0,1,0,2,,,,,,,,,,
20151105-M-Paris-R16-Andy_Murray-David_Goffin,1,F-IO,7,3,2,1,0,7,0,,,,,,,,,,
20151105-M-Paris-R16-Andy_Murray-David_Goffin,1,B-XC,21,3,0,2,1,15,6,,,,,,,,,,
20151105-M-Paris-R16-Andy_Murray-David_Goffin,1,B-DTM,10,2,0,1,1,8,2,,,,,,,,,,
20151105-M-Paris-R16-Andy_Murray-David_Goffin,1,B-DTL,2,2,2,0,0,2,0,,,,,,,,,,
20151105-M-Paris-R16-Andy_Murray-David_Goffin,1,B-IO,4,4,2,0,2,2,2,,,,,,,,,,
20151105-M-Paris-R16-Andy_Murray-David_Goffin,1,S-XC,14,0,0,0,0,13,1,,,,,,,,,,
20151105-M-Paris-R16-Andy_Murray-David_Goffin,1,S-DTM,7,0,0,0,0,6,1,,,,,,,,,,
20151105-M-Paris-R16-Andy_Murray-David_Goffin,2,F-XC,21,4,1,0,3,5,16,,,,,,,,,,
20151105-M-Paris-R16-Andy_Murray-David_Goffin,2,F-DTM,11,1,0,0,1,3,8,,,,,,,,,,
20151105-M-Paris-R16-Andy_Murray-David_Goffin,2,F-DTL,10,5,0,1,4,2,8,,,,,,,,,,
20151105-M-Paris-R16-Andy_Murray-David_Goffin,2,F-IO,14,2,1,0,1,6,8,,,,,,,,,,
20151105-M-Paris-R16-Andy_Murray-David_Goffin,2,F-II,5,1,1,0,0,2,3,,,,,,,,,,
20151105-M-Paris-R16-Andy_Murray-David_Goffin,2,B-XC,24,4,0,1,3,4,20,,,,,,,,,,
20151105-M-Paris-R16-Andy_Murray-David_Goffin,2,B-DTM,10,0,0,0,0,1,9,,,,,,,,,,
20151105-M-Paris-R16-Andy_Murray-David_Goffin,2,B-DTL,5,4,1,0,3,2,3,,,,,,,,,,
20151105-M-Paris-R16-Andy_Murray-David_Goffin,2,S-XC,2,1,0,1,0,1,1,,,,,,,,,,
20151105-M-Paris-R16-Andy_Murray-David_Goffin,2,S-DTM,2,0,0,0,0,1,1,,,,,,,,,,
20151105-M-Paris-R16-Novak_Djokovic-Gilles_Simon,1,F-XC,70,13,4,2,7,39,31,,,,,,,,,,
20151105-M-Paris-R16-Novak_Djokovic-Gilles_Simon,1,F-DTM,15,0,0,0,0,7,8,,,,,,,,,,
20151105-M-Paris-R16-Novak_Djokovic-Gilles_Simon,1,F-DTL,35,10,3,2,5,19,16,,,,,,,,,,
20151105-M-Paris-R16-Novak_Djokovic-Gilles_Simon,1,F-IO,26,5,2,0,3,11,15,,,,,,,,,,
20151105-M-Paris-R16-Novak_Djokovic-Gilles_Simon,1,F-II,2,0,0,0,0,2,0,,,,,,,,,,
20151105-M-Paris-R16-Novak_Djokovic-Gilles_Simon,1,B-XC,61,4,0,2,2,31,30,,,,,,,,,,
20151105-M-Paris-R16-Novak_Djokovic-Gilles_Simon,1,B-DTM,34,0,0,0,0,21,13,,,,,,,,,,
20151105-M-Paris-R16-Novak_Djokovic-Gilles_Simon,1,B-DTL,18,6,1,3,2,10,8,,,,,,,,,,
20151105-M-Paris-R16-Novak_Djokovic-Gilles_Simon,1,B-IO,10,2,0,1,1,3,7,,,,,,,,,,
20151105-M-Paris-R16-Novak_Djokovic-Gilles_Simon,1,S-XC,12,0,0,0,0,8,4,,,,,,,,,,
20151105-M-Paris-R16-Novak_Djokovic-Gilles_Simon,1,S-DTM,4,1,0,1,0,1,3,,,,,,,,,,
20151105-M-Paris-R16-Novak_Djokovic-Gilles_Simon,1,S-IO,1,0,0,0,0,0,1,,,,,,,,,,
20151105-M-Paris-R16-Novak_Djokovic-Gilles_Simon,2,F-XC,60,4,1,1,2,28,32,,,,,,,,,,
20151105-M-Paris-R16-Novak_Djokovic-Gilles_Simon,2,F-DTM,27,2,0,0,2,10,17,,,,,,,,,,
20151105-M-Paris-R16-Novak_Djokovic-Gilles_Simon,2,F-DTL,21,8,2,2,4,14,7,,,,,,,,,,
20151105-M-Paris-R16-Novak_Djokovic-Gilles_Simon,2,F-IO,22,4,1,2,1,10,12,,,,,,,,,,
20151105-M-Paris-R16-Novak_Djokovic-Gilles_Simon,2,F-II,3,1,0,0,1,1,2,,,,,,,,,,
20151105-M-Paris-R16-Novak_Djokovic-Gilles_Simon,2,B-XC,75,9,1,0,8,30,45,,,,,,,,,,
20151105-M-Paris-R16-Novak_Djokovic-Gilles_Simon,2,B-DTM,54,2,0,0,2,25,29,,,,,,,,,,
20151105-M-Paris-R16-Novak_Djokovic-Gilles_Simon,2,B-DTL,19,6,1,1,4,8,11,,,,,,,,,,
20151105-M-Paris-R16-Novak_Djokovic-Gilles_Simon,2,B-IO,4,1,0,1,0,2,2,,,,,,,,,,
20151105-M-Paris-R16-Novak_Djokovic-Gilles_Simon,2,S-DTM,4,0,0,0,0,3,1,,,,,,,,,,
20151105-M-Paris-R16-Novak_Djokovic-Gilles_Simon,2,S-IO,1,1,0,1,0,1,0,,,,,,,,,,
20151105-M-Paris-R16-Rafael_Nadal-Kevin_Anderson,1,F-XC,44,7,1,4,2,28,16,,,,,,,,,,
20151105-M-Paris-R16-Rafael_Nadal-Kevin_Anderson,1,F-DTM,13,0,0,0,0,10,3,,,,,,,,,,
20151105-M-Paris-R16-Rafael_Nadal-Kevin_Anderson,1,F-DTL,10,6,4,0,2,5,5,,,,,,,,,,
20151105-M-Paris-R16-Rafael_Nadal-Kevin_Anderson,1,F-IO,22,10,4,3,3,15,7,,,,,,,,,,
20151105-M-Paris-R16-Rafael_Nadal-Kevin_Anderson,1,F-II,3,2,1,1,0,3,0,,,,,,,,,,
20151105-M-Paris-R16-Rafael_Nadal-Kevin_Anderson,1,B-XC,37,7,3,1,3,25,12,,,,,,,,,,
20151105-M-Paris-R16-Rafael_Nadal-Kevin_Anderson,1,B-DTM,25,2,0,0,2,13,12,,,,,,,,,,
20151105-M-Paris-R16-Rafael_Nadal-Kevin_Anderson,1,B-DTL,8,1,0,1,0,6,2,,,,,,,,,,
20151105-M-Paris-R16-Rafael_Nadal-Kevin_Anderson,1,B-IO,4,2,2,0,0,3,1,,,,,,,,,,
20151105-M-Paris-R16-Rafael_Nadal-Kevin_Anderson,1,S-XC,5,1,0,0,1,3,2,,,,,,,,,,
20151105-M-Paris-R16-Rafael_Nadal-Kevin_Anderson,1,S-DTM,8,0,0,0,0,4,4,,,,,,,,,,
20151105-M-Paris-R16-Rafael_Nadal-Kevin_Anderson,1,S-DTL,7,0,0,0,0,4,3,,,,,,,,,,
20151105-M-Paris-R16-Rafael_Nadal-Kevin_Anderson,1,S-IO,1,0,0,0,0,0,1,,,,,,,,,,
20151105-M-Paris-R16-Rafael_Nadal-Kevin_Anderson,2,F-XC,53,9,0,1,8,18,35,,,,,,,,,,
20151105-M-Paris-R16-Rafael_Nadal-Kevin_Anderson,2,F-DTM,16,2,0,0,2,4,12,,,,,,,,,,
20151105-M-Paris-R16-Rafael_Nadal-Kevin_Anderson,2,F-DTL,8,7,3,0,4,4,4,,,,,,,,,,
20151105-M-Paris-R16-Rafael_Nadal-Kevin_Anderson,2,F-IO,16,7,5,1,1,11,5,,,,,,,,,,
20151105-M-Paris-R16-Rafael_Nadal-Kevin_Anderson,2,F-II,1,1,0,0,1,0,1,,,,,,,,,,
20151105-M-Paris-R16-Rafael_Nadal-Kevin_Anderson,2,B-XC,17,7,3,1,3,7,10,,,,,,,,,,
20151105-M-Paris-R16-Rafael_Nadal-Kevin_Anderson,2,B-DTM,32,2,0,0,2,11,21,,,,,,,,,,
20151105-M-Paris-R16-Rafael_Nadal-Kevin_Anderson,2,B-DTL,11,4,3,0,1,5,6,,,,,,,,,,
20151105-M-Paris-R16-Rafael_Nadal-Kevin_Anderson,2,B-IO,11,7,1,0,6,4,7,,,,,,,,,,
20151105-M-Paris-R16-Rafael_Nadal-Kevin_Anderson,2,S-XC,3,0,0,0,0,2,1,,,,,,,,,,
20151105-M-Paris-R16-Rafael_Nadal-Kevin_Anderson,2,S-DTM,5,0,0,0,0,0,5,,,,,,,,,,
20151105-M-Paris-R16-Rafael_Nadal-Kevin_Anderson,2,S-DTL,1,0,0,0,0,0,1,,,,,,,,,,
20151105-M-Paris-R16-Rafael_Nadal-Kevin_Anderson,2,S-IO,2,0,0,0,0,1,1,,,,,,,,,,
20151105-M-Paris-R16-Tomas_Berdych-Jo_Wilfried_Tsonga,1,F-XC,19,6,5,1,0,14,5,,,,,,,,,,
20151105-M-Paris-R16-Tomas_Berdych-Jo_Wilfried_Tsonga,1,F-DTM,10,1,0,1,0,7,3,,,,,,,,,,
20151105-M-Paris-R16-Tomas_Berdych-Jo_Wilfried_Tsonga,1,F-DTL,8,3,2,0,1,7,1,,,,,,,,,,
20151105-M-Paris-R16-Tomas_Berdych-Jo_Wilfried_Tsonga,1,F-IO,24,11,4,4,3,16,8,,,,,,,,,,
20151105-M-Paris-R16-Tomas_Berdych-Jo_Wilfried_Tsonga,1,F-II,4,2,0,1,1,3,1,,,,,,,,,,
20151105-M-Paris-R16-Tomas_Berdych-Jo_Wilfried_Tsonga,1,B-XC,26,1,0,0,1,21,5,,,,,,,,,,
20151105-M-Paris-R16-Tomas_Berdych-Jo_Wilfried_Tsonga,1,B-DTM,14,2,0,1,1,10,4,,,,,,,,,,
20151105-M-Paris-R16-Tomas_Berdych-Jo_Wilfried_Tsonga,1,B-DTL,7,2,1,0,1,3,4,,,,,,,,,,
20151105-M-Paris-R16-Tomas_Berdych-Jo_Wilfried_Tsonga,1,B-IO,2,1,1,0,0,2,0,,,,,,,,,,
20151105-M-Paris-R16-Tomas_Berdych-Jo_Wilfried_Tsonga,1,S-XC,6,0,0,0,0,5,1,,,,,,,,,,
20151105-M-Paris-R16-Tomas_Berdych-Jo_Wilfried_Tsonga,1,S-DTM,3,0,0,0,0,0,3,,,,,,,,,,
20151105-M-Paris-R16-Tomas_Berdych-Jo_Wilfried_Tsonga,1,S-DTL,1,0,0,0,0,1,0,,,,,,,,,,
20151105-M-Paris-R16-Tomas_Berdych-Jo_Wilfried_Tsonga,2,F-XC,16,8,2,2,4,7,9,,,,,,,,,,
20151105-M-Paris-R16-Tomas_Berdych-Jo_Wilfried_Tsonga,2,F-DTM,15,1,0,0,1,5,10,,,,,,,,,,
20151105-M-Paris-R16-Tomas_Berdych-Jo_Wilfried_Tsonga,2,F-DTL,6,5,1,0,4,2,4,,,,,,,,,,
20151105-M-Paris-R16-Tomas_Berdych-Jo_Wilfried_Tsonga,2,F-IO,21,4,0,2,2,7,14,,,,,,,,,,
20151105-M-Paris-R16-Tomas_Berdych-Jo_Wilfried_Tsonga,2,F-II,6,4,1,1,2,3,3,,,,,,,,,,
20151105-M-Paris-R16-Tomas_Berdych-Jo_Wilfried_Tsonga,2,B-XC,25,5,0,0,5,4,21,,,,,,,,,,
20151105-M-Paris-R16-Tomas_Berdych-Jo_Wilfried_Tsonga,2,B-DTM,10,1,0,1,0,5,5,,,,,,,,,,
20151105-M-Paris-R16-Tomas_Berdych-Jo_Wilfried_Tsonga,2,B-DTL,6,0,0,0,0,0,6,,,,,,,,,,
20151105-M-Paris-R16-Tomas_Berdych-Jo_Wilfried_Tsonga,2,B-IO,1,0,0,0,0,0,1,,,,,,,,,,
20151105-M-Paris-R16-Tomas_Berdych-Jo_Wilfried_Tsonga,2,S-XC,12,2,0,1,1,4,8,,,,,,,,,,
20151105-M-Paris-R16-Tomas_Berdych-Jo_Wilfried_Tsonga,2,S-DTM,6,0,0,0,0,1,5,,,,,,,,,,
20151105-M-Paris-R16-Tomas_Berdych-Jo_Wilfried_Tsonga,2,S-DTL,1,0,0,0,0,0,1,,,,,,,,,,
20151105-M-Paris-R16-Tomas_Berdych-Jo_Wilfried_Tsonga,2,S-IO,1,0,0,0,0,0,1,,,,,,,,,,
20151105-M-Paris-R32-Novak_Djokovic-Thomaz_Bellucci,1,F-XC,59,10,5,1,4,38,21,,,,,,,,,,
20151105-M-Paris-R32-Novak_Djokovic-Thomaz_Bellucci,1,F-DTM,17,2,0,0,2,9,8,,,,,,,,,,
20151105-M-Paris-R32-Novak_Djokovic-Thomaz_Bellucci,1,F-DTL,17,5,2,1,2,8,9,,,,,,,,,,
20151105-M-Paris-R32-Novak_Djokovic-Thomaz_Bellucci,1,F-IO,18,7,4,3,0,16,2,,,,,,,,,,
20151105-M-Paris-R32-Novak_Djokovic-Thomaz_Bellucci,1,F-II,2,1,1,0,0,2,0,,,,,,,,,,
20151105-M-Paris-R32-Novak_Djokovic-Thomaz_Bellucci,1,B-XC,37,6,1,2,3,26,11,,,,,,,,,,
20151105-M-Paris-R32-Novak_Djokovic-Thomaz_Bellucci,1,B-DTM,25,1,0,0,1,14,11,,,,,,,,,,
20151105-M-Paris-R32-Novak_Djokovic-Thomaz_Bellucci,1,B-DTL,14,3,0,0,3,10,4,,,,,,,,,,
20151105-M-Paris-R32-Novak_Djokovic-Thomaz_Bellucci,1,B-IO,9,1,1,0,0,6,3,,,,,,,,,,
20151105-M-Paris-R32-Novak_Djokovic-Thomaz_Bellucci,1,S-DTM,4,0,0,0,0,1,3,,,,,,,,,,
20151105-M-Paris-R32-Novak_Djokovic-Thomaz_Bellucci,1,S-DTL,2,0,0,0,0,2,0,,,,,,,,,,
20151105-M-Paris-R32-Novak_Djokovic-Thomaz_Bellucci,1,S-IO,1,0,0,0,0,0,1,,,,,,,,,,
20151105-M-Paris-R32-Novak_Djokovic-Thomaz_Bellucci,1,S-II,1,0,0,0,0,1,0,,,,,,,,,,
20151105-M-Paris-R32-Novak_Djokovic-Thomaz_Bellucci,2,F-XC,55,8,0,3,5,19,36,,,,,,,,,,
20151105-M-Paris-R32-Novak_Djokovic-Thomaz_Bellucci,2,F-DTM,26,2,0,1,1,9,17,,,,,,,,,,
20151105-M-Paris-R32-Novak_Djokovic-Thomaz_Bellucci,2,F-DTL,8,3,1,0,2,2,6,,,,,,,,,,
20151105-M-Paris-R32-Novak_Djokovic-Thomaz_Bellucci,2,F-IO,17,8,7,1,0,12,5,,,,,,,,,,
20151105-M-Paris-R32-Novak_Djokovic-Thomaz_Bellucci,2,B-XC,54,12,3,2,7,26,28,,,,,,,,,,
20151105-M-Paris-R32-Novak_Djokovic-Thomaz_Bellucci,2,B-DTM,26,4,0,1,3,6,20,,,,,,,,,,
20151105-M-Paris-R32-Novak_Djokovic-Thomaz_Bellucci,2,B-DTL,17,2,0,1,1,7,10,,,,,,,,,,
20151105-M-Paris-R32-Novak_Djokovic-Thomaz_Bellucci,2,B-IO,7,3,0,1,2,3,4,,,,,,,,,,
20151105-M-Paris-R32-Novak_Djokovic-Thomaz_Bellucci,2,S-DTM,5,0,0,0,0,2,3,,,,,,,,,,
20151105-M-Paris-R32-Novak_Djokovic-Thomaz_Bellucci,2,S-DTL,2,0,0,0,0,0,2,,,,,,,,,,
20151105-M-Paris-R32-Novak_Djokovic-Thomaz_Bellucci,2,S-IO,1,0,0,0,0,1,0,,,,,,,,,,
20151106-M-Paris-QF-Tomas_Berdych-Novak_Djokovic,1,F-XC,50,17,4,4,9,21,29,,,,,,,,,,
20151106-M-Paris-QF-Tomas_Berdych-Novak_Djokovic,1,F-DTM,17,1,0,0,1,9,8,,,,,,,,,,
20151106-M-Paris-QF-Tomas_Berdych-Novak_Djokovic,1,F-DTL,17,6,0,2,4,5,12,,,,,,,,,,
20151106-M-Paris-QF-Tomas_Berdych-Novak_Djokovic,1,F-IO,38,13,5,1,7,25,13,,,,,,,,,,
20151106-M-Paris-QF-Tomas_Berdych-Novak_Djokovic,1,F-II,7,4,3,0,1,6,1,,,,,,,,,,
20151106-M-Paris-QF-Tomas_Berdych-Novak_Djokovic,1,B-XC,54,9,2,1,6,23,31,,,,,,,,,,
20151106-M-Paris-QF-Tomas_Berdych-Novak_Djokovic,1,B-DTM,26,4,0,0,4,9,17,,,,,,,,,,
20151106-M-Paris-QF-Tomas_Berdych-Novak_Djokovic,1,B-DTL,20,8,3,1,4,8,12,,,,,,,,,,
20151106-M-Paris-QF-Tomas_Berdych-Novak_Djokovic,1,B-IO,9,3,0,1,2,4,5,,,,,,,,,,
20151106-M-Paris-QF-Tomas_Berdych-Novak_Djokovic,1,S-XC,9,0,0,0,0,4,5,,,,,,,,,,
20151106-M-Paris-QF-Tomas_Berdych-Novak_Djokovic,1,S-DTM,2,0,0,0,0,1,1,,,,,,,,,,
20151106-M-Paris-QF-Tomas_Berdych-Novak_Djokovic,1,S-DTL,3,0,0,0,0,0,3,,,,,,,,,,
20151106-M-Paris-QF-Tomas_Berdych-Novak_Djokovic,2,F-XC,48,11,4,2,5,31,17,,,,,,,,,,
20151106-M-Paris-QF-Tomas_Berdych-Novak_Djokovic,2,F-DTM,16,2,1,0,1,7,9,,,,,,,,,,
20151106-M-Paris-QF-Tomas_Berdych-Novak_Djokovic,2,F-DTL,23,2,1,0,1,17,6,,,,,,,,,,
20151106-M-Paris-QF-Tomas_Berdych-Novak_Djokovic,2,F-IO,20,4,2,1,1,13,7,,,,,,,,,,
20151106-M-Paris-QF-Tomas_Berdych-Novak_Djokovic,2,F-II,2,0,0,0,0,0,2,,,,,,,,,,
20151106-M-Paris-QF-Tomas_Berdych-Novak_Djokovic,2,B-XC,54,6,0,3,3,27,27,,,,,,,,,,
20151106-M-Paris-QF-Tomas_Berdych-Novak_Djokovic,2,B-DTM,30,6,0,1,5,17,13,,,,,,,,,,
20151106-M-Paris-QF-Tomas_Berdych-Novak_Djokovic,2,B-DTL,8,1,0,0,1,4,4,,,,,,,,,,
20151106-M-Paris-QF-Tomas_Berdych-Novak_Djokovic,2,B-IO,8,1,0,0,1,3,5,,,,,,,,,,
20151106-M-Paris-QF-Tomas_Berdych-Novak_Djokovic,2,S-XC,11,2,0,2,0,5,6,,,,,,,,,,
20151106-M-Paris-QF-Tomas_Berdych-Novak_Djokovic,2,S-DTM,2,0,0,0,0,1,1,,,,,,,,,,
20151106-M-Paris-QF-Tomas_Berdych-Novak_Djokovic,2,S-DTL,1,0,0,0,0,0,1,,,,,,,,,,
20151107-M-Paris-SF-David_Ferrer-Andy_Murray,1,F-XC,40,7,0,3,4,20,20,,,,,,,,,,
20151107-M-Paris-SF-David_Ferrer-Andy_Murray,1,F-DTM,27,1,0,0,1,9,18,,,,,,,,,,
20151107-M-Paris-SF-David_Ferrer-Andy_Murray,1,F-DTL,14,2,1,0,1,4,10,,,,,,,,,,
20151107-M-Paris-SF-David_Ferrer-Andy_Murray,1,F-IO,28,5,2,1,2,13,15,,,,,,,,,,
20151107-M-Paris-SF-David_Ferrer-Andy_Murray,1,F-II,4,1,0,1,0,3,1,,,,,,,,,,
20151107-M-Paris-SF-David_Ferrer-Andy_Murray,1,B-XC,58,3,0,0,3,34,24,,,,,,,,,,
20151107-M-Paris-SF-David_Ferrer-Andy_Murray,1,B-DTM,24,3,0,1,2,8,16,,,,,,,,,,
20151107-M-Paris-SF-David_Ferrer-Andy_Murray,1,B-DTL,10,3,0,1,2,5,5,,,,,,,,,,
20151107-M-Paris-SF-David_Ferrer-Andy_Murray,1,B-IO,3,0,0,0,0,3,0,,,,,,,,,,
20151107-M-Paris-SF-David_Ferrer-Andy_Murray,1,B-II,1,1,0,1,0,1,0,,,,,,,,,,
20151107-M-Paris-SF-David_Ferrer-Andy_Murray,1,S-XC,4,0,0,0,0,1,3,,,,,,,,,,
20151107-M-Paris-SF-David_Ferrer-Andy_Murray,1,S-DTM,3,0,0,0,0,0,3,,,,,,,,,,
20151107-M-Paris-SF-David_Ferrer-Andy_Murray,1,S-DTL,3,2,0,1,1,1,2,,,,,,,,,,
20151107-M-Paris-SF-David_Ferrer-Andy_Murray,2,F-XC,43,11,3,1,7,23,20,,,,,,,,,,
20151107-M-Paris-SF-David_Ferrer-Andy_Murray,2,F-DTM,9,0,0,0,0,2,7,,,,,,,,,,
20151107-M-Paris-SF-David_Ferrer-Andy_Murray,2,F-DTL,24,7,2,2,3,11,13,,,,,,,,,,
20151107-M-Paris-SF-David_Ferrer-Andy_Murray,2,F-IO,27,3,1,1,1,18,9,,,,,,,,,,
20151107-M-Paris-SF-David_Ferrer-Andy_Murray,2,F-II,2,0,0,0,0,1,1,,,,,,,,,,
20151107-M-Paris-SF-David_Ferrer-Andy_Murray,2,B-XC,57,13,2,2,9,30,27,,,,,,,,,,
20151107-M-Paris-SF-David_Ferrer-Andy_Murray,2,B-DTM,22,1,0,0,1,7,15,,,,,,,,,,
20151107-M-Paris-SF-David_Ferrer-Andy_Murray,2,B-DTL,17,5,1,1,3,9,8,,,,,,,,,,
20151107-M-Paris-SF-David_Ferrer-Andy_Murray,2,B-IO,11,2,1,0,1,6,5,,,,,,,,,,
20151107-M-Paris-SF-David_Ferrer-Andy_Murray,2,S-XC,9,0,0,0,0,3,6,,,,,,,,,,
20151107-M-Paris-SF-David_Ferrer-Andy_Murray,2,S-DTM,1,0,0,0,0,1,0,,,,,,,,,,
20151107-M-Paris-SF-David_Ferrer-Andy_Murray,2,S-DTL,2,0,0,0,0,2,0,,,,,,,,,,
20151107-M-Paris-SF-David_Ferrer-Andy_Murray,2,S-IO,2,0,0,0,0,2,0,,,,,,,,,,
20151107-M-Paris-SF-Novak_Djokovic-Stanislas_Wawrinka,1,F-XC,75,10,3,3,4,46,29,,,,,,,,,,
20151107-M-Paris-SF-Novak_Djokovic-Stanislas_Wawrinka,1,F-DTM,17,2,0,0,2,8,9,,,,,,,,,,
20151107-M-Paris-SF-Novak_Djokovic-Stanislas_Wawrinka,1,F-DTL,23,1,0,0,1,8,15,,,,,,,,,,
20151107-M-Paris-SF-Novak_Djokovic-Stanislas_Wawrinka,1,F-IO,46,8,1,3,4,27,19,,,,,,,,,,
20151107-M-Paris-SF-Novak_Djokovic-Stanislas_Wawrinka,1,F-II,5,1,0,0,1,3,2,,,,,,,,,,
20151107-M-Paris-SF-Novak_Djokovic-Stanislas_Wawrinka,1,B-XC,46,9,2,1,6,22,24,,,,,,,,,,
20151107-M-Paris-SF-Novak_Djokovic-Stanislas_Wawrinka,1,B-DTM,26,2,0,0,2,9,17,,,,,,,,,,
20151107-M-Paris-SF-Novak_Djokovic-Stanislas_Wawrinka,1,B-DTL,6,0,0,0,0,1,5,,,,,,,,,,
20151107-M-Paris-SF-Novak_Djokovic-Stanislas_Wawrinka,1,B-IO,3,0,0,0,0,0,3,,,,,,,,,,
20151107-M-Paris-SF-Novak_Djokovic-Stanislas_Wawrinka,1,S-XC,2,1,0,0,1,0,2,,,,,,,,,,
20151107-M-Paris-SF-Novak_Djokovic-Stanislas_Wawrinka,1,S-DTM,2,0,0,0,0,1,1,,,,,,,,,,
20151107-M-Paris-SF-Novak_Djokovic-Stanislas_Wawrinka,1,S-DTL,1,0,0,0,0,1,0,,,,,,,,,,
20151107-M-Paris-SF-Novak_Djokovic-Stanislas_Wawrinka,2,F-XC,65,22,6,1,15,30,35,,,,,,,,,,
20151107-M-Paris-SF-Novak_Djokovic-Stanislas_Wawrinka,2,F-DTM,40,3,0,0,2,18,22,,,,,,,,,,
20151107-M-Paris-SF-Novak_Djokovic-Stanislas_Wawrinka,2,F-DTL,11,6,3,0,3,5,6,,,,,,,,,,
20151107-M-Paris-SF-Novak_Djokovic-Stanislas_Wawrinka,2,F-IO,16,6,3,1,2,10,6,,,,,,,,,,
20151107-M-Paris-SF-Novak_Djokovic-Stanislas_Wawrinka,2,F-II,2,2,0,0,2,0,2,,,,,,,,,,
20151107-M-Paris-SF-Novak_Djokovic-Stanislas_Wawrinka,2,B-XC,38,3,0,2,1,21,17,,,,,,,,,,
20151107-M-Paris-SF-Novak_Djokovic-Stanislas_Wawrinka,2,B-DTM,28,1,0,0,1,15,13,,,,,,,,,,
20151107-M-Paris-SF-Novak_Djokovic-Stanislas_Wawrinka,2,B-DTL,12,6,2,1,3,6,6,,,,,,,,,,
20151107-M-Paris-SF-Novak_Djokovic-Stanislas_Wawrinka,2,B-IO,3,1,0,0,1,0,3,,,,,,,,,,
20151107-M-Paris-SF-Novak_Djokovic-Stanislas_Wawrinka,2,S-XC,24,6,0,0,6,11,13,,,,,,,,,,
20151107-M-Paris-SF-Novak_Djokovic-Stanislas_Wawrinka,2,S-DTM,21,0,0,0,0,9,12,,,,,,,,,,
20151107-M-Paris-SF-Novak_Djokovic-Stanislas_Wawrinka,2,S-DTL,3,0,0,0,0,1,2,,,,,,,,,,
20151107-M-Paris-SF-Novak_Djokovic-Stanislas_Wawrinka,2,S-IO,1,0,0,0,0,0,1,,,,,,,,,,
20151108-M-Paris-F-Andy_Murray-Novak_Djokovic,1,F-XC,39,7,2,0,5,18,21,,,,,,,,,,
20151108-M-Paris-F-Andy_Murray-Novak_Djokovic,1,F-DTM,22,3,0,0,3,7,15,,,,,,,,,,
20151108-M-Paris-F-Andy_Murray-Novak_Djokovic,1,F-DTL,6,1,1,0,0,4,2,,,,,,,,,,
20151108-M-Paris-F-Andy_Murray-Novak_Djokovic,1,F-IO,18,8,1,2,5,9,9,,,,,,,,,,
20151108-M-Paris-F-Andy_Murray-Novak_Djokovic,1,F-II,2,0,0,0,0,1,1,,,,,,,,,,
20151108-M-Paris-F-Andy_Murray-Novak_Djokovic,1,B-XC,40,8,0,3,5,19,21,,,,,,,,,,
20151108-M-Paris-F-Andy_Murray-Novak_Djokovic,1,B-DTM,45,5,0,0,5,18,27,,,,,,,,,,
20151108-M-Paris-F-Andy_Murray-Novak_Djokovic,1,B-DTL,6,3,1,1,1,3,3,,,,,,,,,,
20151108-M-Paris-F-Andy_Murray-Novak_Djokovic,1,B-IO,5,3,1,1,1,2,3,,,,,,,,,,
20151108-M-Paris-F-Andy_Murray-Novak_Djokovic,1,S-XC,10,1,0,0,1,1,9,,,,,,,,,,
20151108-M-Paris-F-Andy_Murray-Novak_Djokovic,1,S-DTM,8,2,0,0,2,5,3,,,,,,,,,,
20151108-M-Paris-F-Andy_Murray-Novak_Djokovic,1,S-IO,1,0,0,0,0,0,1,,,,,,,,,,
20151108-M-Paris-F-Andy_Murray-Novak_Djokovic,2,F-XC,37,6,1,1,4,18,19,,,,,,,,,,
20151108-M-Paris-F-Andy_Murray-Novak_Djokovic,2,F-DTM,21,2,1,1,0,12,9,,,,,,,,,,
20151108-M-Paris-F-Andy_Murray-Novak_Djokovic,2,F-DTL,12,1,1,0,0,5,7,,,,,,,,,,
20151108-M-Paris-F-Andy_Murray-Novak_Djokovic,2,F-IO,14,4,1,2,1,8,6,,,,,,,,,,
20151108-M-Paris-F-Andy_Murray-Novak_Djokovic,2,F-II,2,1,0,1,0,2,0,,,,,,,,,,
20151108-M-Paris-F-Andy_Murray-Novak_Djokovic,2,B-XC,54,7,1,5,1,33,21,,,,,,,,,,
20151108-M-Paris-F-Andy_Murray-Novak_Djokovic,2,B-DTM,31,3,0,0,3,18,13,,,,,,,,,,
20151108-M-Paris-F-Andy_Murray-Novak_Djokovic,2,B-DTL,7,1,0,1,0,5,2,,,,,,,,,,
20151108-M-Paris-F-Andy_Murray-Novak_Djokovic,2,B-IO,4,0,0,0,0,2,2,,,,,,,,,,
20151108-M-Paris-F-Andy_Murray-Novak_Djokovic,2,S-XC,8,0,0,0,0,6,2,,,,,,,,,,
20151108-M-Paris-F-Andy_Murray-Novak_Djokovic,2,S-DTM,3,0,0,0,0,0,3,,,,,,,,,,
20151109-M-Knoxville_CH-R32-Mischa_Zverev-Hunter_Reese,1,F-XC,11,2,2,0,0,7,4,,,,,,,,,,
20151109-M-Knoxville_CH-R32-Mischa_Zverev-Hunter_Reese,1,F-DTM,13,1,1,0,0,6,7,,,,,,,,,,
20151109-M-Knoxville_CH-R32-Mischa_Zverev-Hunter_Reese,1,F-DTL,6,3,1,1,1,4,2,,,,,,,,,,
20151109-M-Knoxville_CH-R32-Mischa_Zverev-Hunter_Reese,1,F-IO,7,3,0,0,3,1,6,,,,,,,,,,
20151109-M-Knoxville_CH-R32-Mischa_Zverev-Hunter_Reese,1,B-XC,11,0,0,0,0,7,4,,,,,,,,,,
20151109-M-Knoxville_CH-R32-Mischa_Zverev-Hunter_Reese,1,B-DTM,13,1,0,0,1,6,7,,,,,,,,,,
20151109-M-Knoxville_CH-R32-Mischa_Zverev-Hunter_Reese,1,B-DTL,1,0,0,0,0,1,0,,,,,,,,,,
20151109-M-Knoxville_CH-R32-Mischa_Zverev-Hunter_Reese,1,B-IO,2,2,0,1,1,1,1,,,,,,,,,,
20151109-M-Knoxville_CH-R32-Mischa_Zverev-Hunter_Reese,1,S-XC,1,0,0,0,0,1,0,,,,,,,,,,
20151109-M-Knoxville_CH-R32-Mischa_Zverev-Hunter_Reese,1,S-DTM,9,0,0,0,0,2,7,,,,,,,,,,
20151109-M-Knoxville_CH-R32-Mischa_Zverev-Hunter_Reese,1,S-DTL,2,0,0,0,0,1,1,,,,,,,,,,
20151109-M-Knoxville_CH-R32-Mischa_Zverev-Hunter_Reese,1,S-IO,2,0,0,0,0,2,0,,,,,,,,,,
20151109-M-Knoxville_CH-R32-Mischa_Zverev-Hunter_Reese,2,F-XC,19,2,0,0,2,9,10,,,,,,,,,,
20151109-M-Knoxville_CH-R32-Mischa_Zverev-Hunter_Reese,2,F-DTM,20,3,0,0,3,10,10,,,,,,,,,,
20151109-M-Knoxville_CH-R32-Mischa_Zverev-Hunter_Reese,2,F-DTL,4,1,1,0,0,2,2,,,,,,,,,,
20151109-M-Knoxville_CH-R32-Mischa_Zverev-Hunter_Reese,2,F-IO,5,2,1,0,1,3,2,,,,,,,,,,
20151109-M-Knoxville_CH-R32-Mischa_Zverev-Hunter_Reese,2,B-XC,15,2,0,1,1,5,10,,,,,,,,,,
20151109-M-Knoxville_CH-R32-Mischa_Zverev-Hunter_Reese,2,B-DTM,26,4,0,2,2,13,13,,,,,,,,,,
20151109-M-Knoxville_CH-R32-Mischa_Zverev-Hunter_Reese,2,B-DTL,3,2,1,1,0,2,1,,,,,,,,,,
20151109-M-Knoxville_CH-R32-Mischa_Zverev-Hunter_Reese,2,B-IO,5,1,0,0,1,1,4,,,,,,,,,,
20151109-M-Knoxville_CH-R32-Mischa_Zverev-Hunter_Reese,2,S-DTL,2,0,0,0,0,0,2,,,,,,,,,,
20151109-M-Kobe_CH-R16-Yoshihito_Nishioka-Yuichi_Ito,1,F-XC,37,10,0,6,4,26,11,,,,,,,,,,
20151109-M-Kobe_CH-R16-Yoshihito_Nishioka-Yuichi_Ito,1,F-DTM,23,0,0,0,0,13,10,,,,,,,,,,
20151109-M-Kobe_CH-R16-Yoshihito_Nishioka-Yuichi_Ito,1,F-DTL,12,6,3,2,1,9,3,,,,,,,,,,
20151109-M-Kobe_CH-R16-Yoshihito_Nishioka-Yuichi_Ito,1,F-IO,13,4,3,1,0,12,1,,,,,,,,,,
20151109-M-Kobe_CH-R16-Yoshihito_Nishioka-Yuichi_Ito,1,F-II,2,0,0,0,0,2,0,,,,,,,,,,
20151109-M-Kobe_CH-R16-Yoshihito_Nishioka-Yuichi_Ito,1,B-XC,28,4,0,3,1,20,8,,,,,,,,,,
20151109-M-Kobe_CH-R16-Yoshihito_Nishioka-Yuichi_Ito,1,B-DTM,11,1,0,1,0,6,5,,,,,,,,,,
20151109-M-Kobe_CH-R16-Yoshihito_Nishioka-Yuichi_Ito,1,B-DTL,4,2,0,0,2,1,3,,,,,,,,,,
20151109-M-Kobe_CH-R16-Yoshihito_Nishioka-Yuichi_Ito,1,B-IO,1,0,0,0,0,1,0,,,,,,,,,,
20151109-M-Kobe_CH-R16-Yoshihito_Nishioka-Yuichi_Ito,1,S-DTM,1,0,0,0,0,1,0,,,,,,,,,,
20151109-M-Kobe_CH-R16-Yoshihito_Nishioka-Yuichi_Ito,1,S-DTL,1,1,0,0,1,0,1,,,,,,,,,,
20151109-M-Kobe_CH-R16-Yoshihito_Nishioka-Yuichi_Ito,2,F-XC,27,7,0,1,6,8,19,,,,,,,,,,
20151109-M-Kobe_CH-R16-Yoshihito_Nishioka-Yuichi_Ito,2,F-DTM,26,1,0,0,1,7,19,,,,,,,,,,
20151109-M-Kobe_CH-R16-Yoshihito_Nishioka-Yuichi_Ito,2,F-DTL,9,2,0,1,1,2,7,,,,,,,,,,
20151109-M-Kobe_CH-R16-Yoshihito_Nishioka-Yuichi_Ito,2,F-IO,10,2,0,0,2,2,8,,,,,,,,,,
20151109-M-Kobe_CH-R16-Yoshihito_Nishioka-Yuichi_Ito,2,B-XC,24,7,1,2,4,9,15,,,,,,,,,,
20151109-M-Kobe_CH-R16-Yoshihito_Nishioka-Yuichi_Ito,2,B-DTM,15,1,0,0,1,5,10,,,,,,,,,,
20151109-M-Kobe_CH-R16-Yoshihito_Nishioka-Yuichi_Ito,2,B-DTL,2,0,0,0,0,0,2,,,,,,,,,,
20151109-M-Kobe_CH-R16-Yoshihito_Nishioka-Yuichi_Ito,2,B-IO,4,0,0,0,0,3,1,,,,,,,,,,
20151109-M-Kobe_CH-R16-Yoshihito_Nishioka-Yuichi_Ito,2,S-XC,5,0,0,0,0,2,3,,,,,,,,,,
20151109-M-Kobe_CH-R16-Yoshihito_Nishioka-Yuichi_Ito,2,S-DTM,2,1,0,0,1,0,2,,,,,,,,,,
20151109-M-Kobe_CH-R16-Yoshihito_Nishioka-Yuichi_Ito,2,S-DTL,2,0,0,0,0,0,2,,,,,,,,,,
20151109-M-Mouilleron_Le_Captif_CH-QF-Lucas_Pouille-Sergiy_Stakhovsky,1,F-XC,28,8,3,3,2,15,13,,,,,,,,,,
20151109-M-Mouilleron_Le_Captif_CH-QF-Lucas_Pouille-Sergiy_Stakhovsky,1,F-DTM,8,1,0,1,0,4,4,,,,,,,,,,
20151109-M-Mouilleron_Le_Captif_CH-QF-Lucas_Pouille-Sergiy_Stakhovsky,1,F-DTL,10,5,2,1,2,5,5,,,,,,,,,,
20151109-M-Mouilleron_Le_Captif_CH-QF-Lucas_Pouille-Sergiy_Stakhovsky,1,F-IO,15,7,3,2,2,8,7,,,,,,,,,,
20151109-M-Mouilleron_Le_Captif_CH-QF-Lucas_Pouille-Sergiy_Stakhovsky,1,F-II,3,3,3,0,0,3,0,,,,,,,,,,
20151109-M-Mouilleron_Le_Captif_CH-QF-Lucas_Pouille-Sergiy_Stakhovsky,1,B-XC,12,2,2,0,0,9,3,,,,,,,,,,
20151109-M-Mouilleron_Le_Captif_CH-QF-Lucas_Pouille-Sergiy_Stakhovsky,1,B-DTM,14,1,0,0,1,9,5,,,,,,,,,,
20151109-M-Mouilleron_Le_Captif_CH-QF-Lucas_Pouille-Sergiy_Stakhovsky,1,B-DTL,6,4,3,0,1,4,2,,,,,,,,,,
20151109-M-Mouilleron_Le_Captif_CH-QF-Lucas_Pouille-Sergiy_Stakhovsky,1,B-IO,1,1,1,0,0,1,0,,,,,,,,,,
20151109-M-Mouilleron_Le_Captif_CH-QF-Lucas_Pouille-Sergiy_Stakhovsky,1,S-XC,10,1,0,0,1,4,6,,,,,,,,,,
20151109-M-Mouilleron_Le_Captif_CH-QF-Lucas_Pouille-Sergiy_Stakhovsky,1,S-DTM,1,0,0,0,0,0,1,,,,,,,,,,
20151109-M-Mouilleron_Le_Captif_CH-QF-Lucas_Pouille-Sergiy_Stakhovsky,1,S-DTL,4,1,0,0,1,0,4,,,,,,,,,,
20151109-M-Mouilleron_Le_Captif_CH-QF-Lucas_Pouille-Sergiy_Stakhovsky,2,F-XC,12,1,0,0,1,5,7,,,,,,,,,,
20151109-M-Mouilleron_Le_Captif_CH-QF-Lucas_Pouille-Sergiy_Stakhovsky,2,F-DTM,14,2,0,0,2,7,7,,,,,,,,,,
20151109-M-Mouilleron_Le_Captif_CH-QF-Lucas_Pouille-Sergiy_Stakhovsky,2,F-DTL,9,3,1,1,1,4,5,,,,,,,,,,
20151109-M-Mouilleron_Le_Captif_CH-QF-Lucas_Pouille-Sergiy_Stakhovsky,2,F-IO,8,1,1,0,0,6,2,,,,,,,,,,
20151109-M-Mouilleron_Le_Captif_CH-QF-Lucas_Pouille-Sergiy_Stakhovsky,2,B-XC,14,2,1,0,1,6,8,,,,,,,,,,
20151109-M-Mouilleron_Le_Captif_CH-QF-Lucas_Pouille-Sergiy_Stakhovsky,2,B-DTM,8,2,0,2,0,5,3,,,,,,,,,,
20151109-M-Mouilleron_Le_Captif_CH-QF-Lucas_Pouille-Sergiy_Stakhovsky,2,B-DTL,3,2,2,0,0,2,1,,,,,,,,,,
20151109-M-Mouilleron_Le_Captif_CH-QF-Lucas_Pouille-Sergiy_Stakhovsky,2,B-IO,3,0,0,0,0,1,2,,,,,,,,,,
20151109-M-Mouilleron_Le_Captif_CH-QF-Lucas_Pouille-Sergiy_Stakhovsky,2,S-XC,11,0,0,0,0,4,7,,,,,,,,,,
20151109-M-Mouilleron_Le_Captif_CH-QF-Lucas_Pouille-Sergiy_Stakhovsky,2,S-DTM,5,1,0,0,1,1,4,,,,,,,,,,
20151109-M-Mouilleron_Le_Captif_CH-QF-Lucas_Pouille-Sergiy_Stakhovsky,2,S-DTL,3,1,0,0,1,2,1,,,,,,,,,,
20151115-M-Tour_Finals-RR-Novak_Djokovic-Kei_Nishikori,1,F-XC,31,5,2,3,0,19,12,,,,,,,,,,
20151115-M-Tour_Finals-RR-Novak_Djokovic-Kei_Nishikori,1,F-DTM,17,1,0,0,1,8,9,,,,,,,,,,
20151115-M-Tour_Finals-RR-Novak_Djokovic-Kei_Nishikori,1,F-DTL,10,0,0,0,0,5,5,,,,,,,,,,
20151115-M-Tour_Finals-RR-Novak_Djokovic-Kei_Nishikori,1,F-IO,6,2,0,0,2,4,2,,,,,,,,,,
20151115-M-Tour_Finals-RR-Novak_Djokovic-Kei_Nishikori,1,F-II,1,0,0,0,0,0,1,,,,,,,,,,
20151115-M-Tour_Finals-RR-Novak_Djokovic-Kei_Nishikori,1,B-XC,21,6,2,1,3,15,6,,,,,,,,,,
20151115-M-Tour_Finals-RR-Novak_Djokovic-Kei_Nishikori,1,B-DTM,33,1,0,0,1,19,14,,,,,,,,,,
20151115-M-Tour_Finals-RR-Novak_Djokovic-Kei_Nishikori,1,B-DTL,8,4,1,1,2,5,3,,,,,,,,,,
20151115-M-Tour_Finals-RR-Novak_Djokovic-Kei_Nishikori,1,B-IO,2,0,0,0,0,2,0,,,,,,,,,,
20151115-M-Tour_Finals-RR-Novak_Djokovic-Kei_Nishikori,1,S-XC,8,0,0,0,0,8,0,,,,,,,,,,
20151115-M-Tour_Finals-RR-Novak_Djokovic-Kei_Nishikori,1,S-DTM,2,0,0,0,0,1,1,,,,,,,,,,
20151115-M-Tour_Finals-RR-Novak_Djokovic-Kei_Nishikori,2,F-XC,37,10,0,3,7,15,22,,,,,,,,,,
20151115-M-Tour_Finals-RR-Novak_Djokovic-Kei_Nishikori,2,F-DTM,18,3,0,0,3,6,12,,,,,,,,,,
20151115-M-Tour_Finals-RR-Novak_Djokovic-Kei_Nishikori,2,F-DTL,10,5,4,0,1,5,5,,,,,,,,,,
20151115-M-Tour_Finals-RR-Novak_Djokovic-Kei_Nishikori,2,F-IO,11,2,1,1,0,6,5,,,,,,,,,,
20151115-M-Tour_Finals-RR-Novak_Djokovic-Kei_Nishikori,2,B-XC,35,4,1,0,3,11,24,,,,,,,,,,
20151115-M-Tour_Finals-RR-Novak_Djokovic-Kei_Nishikori,2,B-DTM,23,2,0,0,2,8,15,,,,,,,,,,
20151115-M-Tour_Finals-RR-Novak_Djokovic-Kei_Nishikori,2,B-DTL,5,1,0,0,1,2,3,,,,,,,,,,
20151115-M-Tour_Finals-RR-Novak_Djokovic-Kei_Nishikori,2,B-IO,3,1,1,0,0,2,1,,,,,,,,,,
20151115-M-Tour_Finals-RR-Novak_Djokovic-Kei_Nishikori,2,S-XC,3,0,0,0,0,2,1,,,,,,,,,,
20151115-M-Tour_Finals-RR-Novak_Djokovic-Kei_Nishikori,2,S-DTM,5,0,0,0,0,1,4,,,,,,,,,,
20151115-M-Tour_Finals-RR-Novak_Djokovic-Kei_Nishikori,2,S-IO,1,0,0,0,0,1,0,,,,,,,,,,
20151115-M-Tour_Finals-RR-Tomas_Berdych-Roger_Federer,1,F-XC,20,6,0,4,2,10,10,,,,,,,,,,
20151115-M-Tour_Finals-RR-Tomas_Berdych-Roger_Federer,1,F-DTM,22,3,0,1,2,14,8,,,,,,,,,,
20151115-M-Tour_Finals-RR-Tomas_Berdych-Roger_Federer,1,F-DTL,6,1,0,0,1,1,5,,,,,,,,,,
20151115-M-Tour_Finals-RR-Tomas_Berdych-Roger_Federer,1,F-IO,17,9,4,2,3,7,10,,,,,,,,,,
20151115-M-Tour_Finals-RR-Tomas_Berdych-Roger_Federer,1,F-II,1,0,0,0,0,0,1,,,,,,,,,,
20151115-M-Tour_Finals-RR-Tomas_Berdych-Roger_Federer,1,B-XC,16,2,0,0,2,4,12,,,,,,,,,,
20151115-M-Tour_Finals-RR-Tomas_Berdych-Roger_Federer,1,B-DTM,16,1,0,0,1,5,11,,,,,,,,,,
20151115-M-Tour_Finals-RR-Tomas_Berdych-Roger_Federer,1,B-DTL,2,0,0,0,0,1,1,,,,,,,,,,
20151115-M-Tour_Finals-RR-Tomas_Berdych-Roger_Federer,1,B-IO,2,0,0,0,0,1,1,,,,,,,,,,
20151115-M-Tour_Finals-RR-Tomas_Berdych-Roger_Federer,1,S-XC,3,2,0,1,1,1,2,,,,,,,,,,
20151115-M-Tour_Finals-RR-Tomas_Berdych-Roger_Federer,1,S-DTM,2,0,0,0,0,0,2,,,,,,,,,,
20151115-M-Tour_Finals-RR-Tomas_Berdych-Roger_Federer,2,F-XC,16,6,1,3,2,10,6,,,,,,,,,,
20151115-M-Tour_Finals-RR-Tomas_Berdych-Roger_Federer,2,F-DTM,15,0,0,0,0,4,11,,,,,,,,,,
20151115-M-Tour_Finals-RR-Tomas_Berdych-Roger_Federer,2,F-DTL,6,3,1,2,0,5,1,,,,,,,,,,
20151115-M-Tour_Finals-RR-Tomas_Berdych-Roger_Federer,2,F-IO,15,6,3,3,0,13,2,,,,,,,,,,
20151115-M-Tour_Finals-RR-Tomas_Berdych-Roger_Federer,2,F-II,1,1,0,1,0,1,0,,,,,,,,,,
20151115-M-Tour_Finals-RR-Tomas_Berdych-Roger_Federer,2,B-XC,9,2,1,1,0,8,1,,,,,,,,,,
20151115-M-Tour_Finals-RR-Tomas_Berdych-Roger_Federer,2,B-DTM,16,4,1,0,3,7,9,,,,,,,,,,
20151115-M-Tour_Finals-RR-Tomas_Berdych-Roger_Federer,2,B-DTL,1,0,0,0,0,1,0,,,,,,,,,,
20151115-M-Tour_Finals-RR-Tomas_Berdych-Roger_Federer,2,B-IO,3,1,0,0,1,1,2,,,,,,,,,,
20151115-M-Tour_Finals-RR-Tomas_Berdych-Roger_Federer,2,S-XC,6,0,0,0,0,5,1,,,,,,,,,,
20151115-M-Tour_Finals-RR-Tomas_Berdych-Roger_Federer,2,S-DTM,3,0,0,0,0,2,1,,,,,,,,,,
20151115-M-Tour_Finals-RR-Tomas_Berdych-Roger_Federer,2,S-DTL,2,0,0,0,0,2,0,,,,,,,,,,
20151116-M-Brescia_CH-QF-Igor_Sijsling-Farrukh_Dustov,1,F-XC,13,6,3,2,1,10,3,,,,,,,,,,
20151116-M-Brescia_CH-QF-Igor_Sijsling-Farrukh_Dustov,1,F-DTM,7,1,0,0,1,4,3,,,,,,,,,,
20151116-M-Brescia_CH-QF-Igor_Sijsling-Farrukh_Dustov,1,F-IO,12,4,3,0,1,9,3,,,,,,,,,,
20151116-M-Brescia_CH-QF-Igor_Sijsling-Farrukh_Dustov,1,F-II,2,2,1,0,1,1,1,,,,,,,,,,
20151116-M-Brescia_CH-QF-Igor_Sijsling-Farrukh_Dustov,1,B-XC,4,2,1,0,1,2,2,,,,,,,,,,
20151116-M-Brescia_CH-QF-Igor_Sijsling-Farrukh_Dustov,1,B-DTM,7,0,0,0,0,4,3,,,,,,,,,,
20151116-M-Brescia_CH-QF-Igor_Sijsling-Farrukh_Dustov,1,B-DTL,3,2,1,0,1,2,1,,,,,,,,,,
20151116-M-Brescia_CH-QF-Igor_Sijsling-Farrukh_Dustov,1,B-IO,3,2,0,0,2,0,3,,,,,,,,,,
20151116-M-Brescia_CH-QF-Igor_Sijsling-Farrukh_Dustov,1,S-XC,2,0,0,0,0,2,0,,,,,,,,,,
20151116-M-Brescia_CH-QF-Igor_Sijsling-Farrukh_Dustov,1,S-DTM,2,0,0,0,0,0,2,,,,,,,,,,
20151116-M-Brescia_CH-QF-Igor_Sijsling-Farrukh_Dustov,2,F-XC,8,2,1,0,1,5,3,,,,,,,,,,
20151116-M-Brescia_CH-QF-Igor_Sijsling-Farrukh_Dustov,2,F-DTM,8,0,0,0,0,1,7,,,,,,,,,,
20151116-M-Brescia_CH-QF-Igor_Sijsling-Farrukh_Dustov,2,F-DTL,2,1,1,0,0,1,1,,,,,,,,,,
20151116-M-Brescia_CH-QF-Igor_Sijsling-Farrukh_Dustov,2,F-IO,5,4,2,0,2,3,2,,,,,,,,,,
20151116-M-Brescia_CH-QF-Igor_Sijsling-Farrukh_Dustov,2,B-XC,4,1,0,1,0,1,3,,,,,,,,,,
20151116-M-Brescia_CH-QF-Igor_Sijsling-Farrukh_Dustov,2,B-DTM,6,1,0,1,0,3,3,,,,,,,,,,
20151116-M-Brescia_CH-QF-Igor_Sijsling-Farrukh_Dustov,2,B-DTL,2,2,0,2,0,2,0,,,,,,,,,,
20151116-M-Brescia_CH-QF-Igor_Sijsling-Farrukh_Dustov,2,B-IO,1,1,1,0,0,1,0,,,,,,,,,,
20151116-M-Brescia_CH-QF-Igor_Sijsling-Farrukh_Dustov,2,B-II,1,1,0,0,1,0,1,,,,,,,,,,
20151116-M-Brescia_CH-QF-Igor_Sijsling-Farrukh_Dustov,2,S-XC,8,0,0,0,0,3,5,,,,,,,,,,
20151116-M-Brescia_CH-QF-Igor_Sijsling-Farrukh_Dustov,2,S-DTM,6,0,0,0,0,1,5,,,,,,,,,,
20151116-M-Montevideo_CH-R32-Dario_Acosta-Carlos_Berlocq,1,F-XC,30,9,3,4,2,15,15,,,,,,,,,,
20151116-M-Montevideo_CH-R32-Dario_Acosta-Carlos_Berlocq,1,F-DTM,10,1,0,0,1,2,8,,,,,,,,,,
20151116-M-Montevideo_CH-R32-Dario_Acosta-Carlos_Berlocq,1,F-DTL,2,1,1,0,0,2,0,,,,,,,,,,
20151116-M-Montevideo_CH-R32-Dario_Acosta-Carlos_Berlocq,1,F-IO,15,6,1,3,2,6,9,,,,,,,,,,
20151116-M-Montevideo_CH-R32-Dario_Acosta-Carlos_Berlocq,1,F-II,2,1,0,0,1,1,1,,,,,,,,,,
20151116-M-Montevideo_CH-R32-Dario_Acosta-Carlos_Berlocq,1,B-XC,32,7,0,1,6,8,24,,,,,,,,,,
20151116-M-Montevideo_CH-R32-Dario_Acosta-Carlos_Berlocq,1,B-DTM,9,0,0,0,0,2,7,,,,,,,,,,
20151116-M-Montevideo_CH-R32-Dario_Acosta-Carlos_Berlocq,1,B-DTL,4,3,0,3,0,4,0,,,,,,,,,,
20151116-M-Montevideo_CH-R32-Dario_Acosta-Carlos_Berlocq,1,S-XC,4,0,0,0,0,2,2,,,,,,,,,,
20151116-M-Montevideo_CH-R32-Dario_Acosta-Carlos_Berlocq,1,S-DTM,3,0,0,0,0,0,3,,,,,,,,,,
20151116-M-Montevideo_CH-R32-Dario_Acosta-Carlos_Berlocq,1,S-DTL,3,1,0,0,1,1,2,,,,,,,,,,
20151116-M-Montevideo_CH-R32-Dario_Acosta-Carlos_Berlocq,2,F-XC,20,3,1,2,0,10,10,,,,,,,,,,
20151116-M-Montevideo_CH-R32-Dario_Acosta-Carlos_Berlocq,2,F-DTM,10,0,0,0,0,8,2,,,,,,,,,,
20151116-M-Montevideo_CH-R32-Dario_Acosta-Carlos_Berlocq,2,F-DTL,8,3,0,2,1,5,3,,,,,,,,,,
20151116-M-Montevideo_CH-R32-Dario_Acosta-Carlos_Berlocq,2,F-IO,28,7,3,4,0,23,5,,,,,,,,,,
20151116-M-Montevideo_CH-R32-Dario_Acosta-Carlos_Berlocq,2,F-II,3,0,0,0,0,2,1,,,,,,,,,,
20151116-M-Montevideo_CH-R32-Dario_Acosta-Carlos_Berlocq,2,B-XC,17,1,0,1,0,12,5,,,,,,,,,,
20151116-M-Montevideo_CH-R32-Dario_Acosta-Carlos_Berlocq,2,B-DTM,6,0,0,0,0,5,1,,,,,,,,,,
20151116-M-Montevideo_CH-R32-Dario_Acosta-Carlos_Berlocq,2,B-DTL,5,4,1,1,2,3,2,,,,,,,,,,
20151116-M-Montevideo_CH-R32-Dario_Acosta-Carlos_Berlocq,2,S-XC,2,0,0,0,0,1,1,,,,,,,,,,
20151116-M-Montevideo_CH-R32-Dario_Acosta-Carlos_Berlocq,2,S-DTM,3,0,0,0,0,0,3,,,,,,,,,,
20151116-M-Montevideo_CH-R32-Dario_Acosta-Carlos_Berlocq,2,S-DTL,2,2,1,0,1,1,1,,,,,,,,,,
20151116-M-Tour_Finals-RR-Andy_Murray-David_Ferrer,1,F-XC,32,10,3,5,2,21,11,,,,,,,,,,
20151116-M-Tour_Finals-RR-Andy_Murray-David_Ferrer,1,F-DTM,34,5,1,0,4,15,19,,,,,,,,,,
20151116-M-Tour_Finals-RR-Andy_Murray-David_Ferrer,1,F-DTL,7,2,2,0,0,5,2,,,,,,,,,,
20151116-M-Tour_Finals-RR-Andy_Murray-David_Ferrer,1,F-IO,19,4,1,1,2,8,11,,,,,,,,,,
20151116-M-Tour_Finals-RR-Andy_Murray-David_Ferrer,1,B-XC,49,2,0,0,2,32,17,,,,,,,,,,
20151116-M-Tour_Finals-RR-Andy_Murray-David_Ferrer,1,B-DTM,34,2,0,0,2,15,19,,,,,,,,,,
20151116-M-Tour_Finals-RR-Andy_Murray-David_Ferrer,1,B-DTL,6,3,3,0,0,4,2,,,,,,,,,,
20151116-M-Tour_Finals-RR-Andy_Murray-David_Ferrer,1,B-IO,9,2,1,0,1,2,7,,,,,,,,,,
20151116-M-Tour_Finals-RR-Andy_Murray-David_Ferrer,1,S-XC,8,1,0,0,1,2,6,,,,,,,,,,
20151116-M-Tour_Finals-RR-Andy_Murray-David_Ferrer,1,S-DTM,7,0,0,0,0,1,6,,,,,,,,,,
20151116-M-Tour_Finals-RR-Andy_Murray-David_Ferrer,1,S-DTL,2,0,0,0,0,0,2,,,,,,,,,,
20151116-M-Tour_Finals-RR-Andy_Murray-David_Ferrer,1,S-IO,2,0,0,0,0,2,0,,,,,,,,,,
20151116-M-Tour_Finals-RR-Andy_Murray-David_Ferrer,2,F-XC,36,4,1,1,2,22,14,,,,,,,,,,
20151116-M-Tour_Finals-RR-Andy_Murray-David_Ferrer,2,F-DTM,47,1,0,0,1,23,24,,,,,,,,,,
20151116-M-Tour_Finals-RR-Andy_Murray-David_Ferrer,2,F-DTL,5,3,2,0,1,3,2,,,,,,,,,,
20151116-M-Tour_Finals-RR-Andy_Murray-David_Ferrer,2,F-IO,24,6,3,2,1,19,5,,,,,,,,,,
20151116-M-Tour_Finals-RR-Andy_Murray-David_Ferrer,2,F-II,4,1,0,0,1,1,3,,,,,,,,,,
20151116-M-Tour_Finals-RR-Andy_Murray-David_Ferrer,2,B-XC,40,8,1,2,5,18,22,,,,,,,,,,
20151116-M-Tour_Finals-RR-Andy_Murray-David_Ferrer,2,B-DTM,44,1,0,0,1,19,25,,,,,,,,,,
20151116-M-Tour_Finals-RR-Andy_Murray-David_Ferrer,2,B-DTL,3,1,0,0,1,0,3,,,,,,,,,,
20151116-M-Tour_Finals-RR-Andy_Murray-David_Ferrer,2,B-IO,2,0,0,0,0,2,0,,,,,,,,,,
20151116-M-Tour_Finals-RR-Andy_Murray-David_Ferrer,2,S-XC,5,1,1,0,0,2,3,,,,,,,,,,
20151116-M-Tour_Finals-RR-Andy_Murray-David_Ferrer,2,S-DTM,7,0,0,0,0,2,5,,,,,,,,,,
20151116-M-Tour_Finals-RR-Andy_Murray-David_Ferrer,2,S-DTL,3,1,0,1,0,1,2,,,,,,,,,,
20151116-M-Tour_Finals-RR-Rafael_Nadal-Stanislas_Wawrinka,1,F-XC,46,6,3,1,2,28,18,,,,,,,,,,
20151116-M-Tour_Finals-RR-Rafael_Nadal-Stanislas_Wawrinka,1,F-DTM,19,0,0,0,0,11,8,,,,,,,,,,
20151116-M-Tour_Finals-RR-Rafael_Nadal-Stanislas_Wawrinka,1,F-DTL,4,1,0,1,0,4,0,,,,,,,,,,
20151116-M-Tour_Finals-RR-Rafael_Nadal-Stanislas_Wawrinka,1,F-IO,16,7,4,2,1,12,4,,,,,,,,,,
20151116-M-Tour_Finals-RR-Rafael_Nadal-Stanislas_Wawrinka,1,F-II,5,1,0,1,0,3,2,,,,,,,,,,
20151116-M-Tour_Finals-RR-Rafael_Nadal-Stanislas_Wawrinka,1,B-XC,24,4,2,1,1,16,8,,,,,,,,,,
20151116-M-Tour_Finals-RR-Rafael_Nadal-Stanislas_Wawrinka,1,B-DTM,15,1,0,0,1,10,5,,,,,,,,,,
20151116-M-Tour_Finals-RR-Rafael_Nadal-Stanislas_Wawrinka,1,B-DTL,5,1,0,1,0,3,2,,,,,,,,,,
20151116-M-Tour_Finals-RR-Rafael_Nadal-Stanislas_Wawrinka,1,B-IO,1,0,0,0,0,0,1,,,,,,,,,,
20151116-M-Tour_Finals-RR-Rafael_Nadal-Stanislas_Wawrinka,1,S-XC,1,0,0,0,0,1,0,,,,,,,,,,
20151116-M-Tour_Finals-RR-Rafael_Nadal-Stanislas_Wawrinka,1,S-DTM,10,0,0,0,0,5,5,,,,,,,,,,
20151116-M-Tour_Finals-RR-Rafael_Nadal-Stanislas_Wawrinka,1,S-DTL,4,1,0,1,0,3,1,,,,,,,,,,
20151116-M-Tour_Finals-RR-Rafael_Nadal-Stanislas_Wawrinka,2,F-XC,44,11,4,3,4,17,27,,,,,,,,,,
20151116-M-Tour_Finals-RR-Rafael_Nadal-Stanislas_Wawrinka,2,F-DTM,25,4,0,1,3,8,17,,,,,,,,,,
20151116-M-Tour_Finals-RR-Rafael_Nadal-Stanislas_Wawrinka,2,F-DTL,7,5,1,0,4,1,6,,,,,,,,,,
20151116-M-Tour_Finals-RR-Rafael_Nadal-Stanislas_Wawrinka,2,F-IO,16,11,3,2,6,8,8,,,,,,,,,,
20151116-M-Tour_Finals-RR-Rafael_Nadal-Stanislas_Wawrinka,2,F-II,3,0,0,0,0,1,2,,,,,,,,,,
20151116-M-Tour_Finals-RR-Rafael_Nadal-Stanislas_Wawrinka,2,B-XC,31,11,5,0,6,15,16,,,,,,,,,,
20151116-M-Tour_Finals-RR-Rafael_Nadal-Stanislas_Wawrinka,2,B-DTM,21,2,0,1,1,6,15,,,,,,,,,,
20151116-M-Tour_Finals-RR-Rafael_Nadal-Stanislas_Wawrinka,2,B-DTL,7,4,1,0,3,4,3,,,,,,,,,,
20151116-M-Tour_Finals-RR-Rafael_Nadal-Stanislas_Wawrinka,2,B-IO,2,1,0,0,1,0,2,,,,,,,,,,
20151116-M-Tour_Finals-RR-Rafael_Nadal-Stanislas_Wawrinka,2,S-XC,1,0,0,0,0,0,1,,,,,,,,,,
20151116-M-Tour_Finals-RR-Rafael_Nadal-Stanislas_Wawrinka,2,S-DTM,3,0,0,0,0,2,1,,,,,,,,,,
20151116-M-Tour_Finals-RR-Rafael_Nadal-Stanislas_Wawrinka,2,S-DTL,3,0,0,0,0,1,2,,,,,,,,,,
20151116-M-Tour_Finals-RR-Rafael_Nadal-Stanislas_Wawrinka,2,S-IO,1,0,0,0,0,0,1,,,,,,,,,,
20151117-M-Tour_Finals-RR-Roger_Federer-Novak_Djokovic,1,F-XC,26,4,0,1,3,13,13,,,,,,,,,,
20151117-M-Tour_Finals-RR-Roger_Federer-Novak_Djokovic,1,F-DTM,10,3,0,1,2,6,4,,,,,,,,,,
20151117-M-Tour_Finals-RR-Roger_Federer-Novak_Djokovic,1,F-DTL,12,5,1,1,3,6,6,,,,,,,,,,
20151117-M-Tour_Finals-RR-Roger_Federer-Novak_Djokovic,1,F-IO,14,5,3,1,1,8,6,,,,,,,,,,
20151117-M-Tour_Finals-RR-Roger_Federer-Novak_Djokovic,1,F-II,4,3,2,1,0,4,0,,,,,,,,,,
20151117-M-Tour_Finals-RR-Roger_Federer-Novak_Djokovic,1,B-XC,23,6,1,0,5,9,14,,,,,,,,,,
20151117-M-Tour_Finals-RR-Roger_Federer-Novak_Djokovic,1,B-DTM,19,0,0,0,0,15,4,,,,,,,,,,
20151117-M-Tour_Finals-RR-Roger_Federer-Novak_Djokovic,1,B-DTL,10,5,3,1,1,7,3,,,,,,,,,,
20151117-M-Tour_Finals-RR-Roger_Federer-Novak_Djokovic,1,S-XC,5,1,0,0,1,2,3,,,,,,,,,,
20151117-M-Tour_Finals-RR-Roger_Federer-Novak_Djokovic,1,S-DTM,1,0,0,0,0,0,1,,,,,,,,,,
20151117-M-Tour_Finals-RR-Roger_Federer-Novak_Djokovic,1,S-DTL,1,0,0,0,0,0,1,,,,,,,,,,
20151117-M-Tour_Finals-RR-Roger_Federer-Novak_Djokovic,2,F-XC,37,8,2,1,5,18,19,,,,,,,,,,
20151117-M-Tour_Finals-RR-Roger_Federer-Novak_Djokovic,2,F-DTM,14,2,0,0,2,4,10,,,,,,,,,,
20151117-M-Tour_Finals-RR-Roger_Federer-Novak_Djokovic,2,F-DTL,11,2,0,1,1,6,5,,,,,,,,,,
20151117-M-Tour_Finals-RR-Roger_Federer-Novak_Djokovic,2,F-IO,10,6,1,1,4,3,7,,,,,,,,,,
20151117-M-Tour_Finals-RR-Roger_Federer-Novak_Djokovic,2,B-XC,36,8,1,1,6,14,22,,,,,,,,,,
20151117-M-Tour_Finals-RR-Roger_Federer-Novak_Djokovic,2,B-DTM,19,3,0,0,3,9,10,,,,,,,,,,
20151117-M-Tour_Finals-RR-Roger_Federer-Novak_Djokovic,2,B-DTL,7,3,1,1,1,5,2,,,,,,,,,,
20151117-M-Tour_Finals-RR-Roger_Federer-Novak_Djokovic,2,B-IO,2,0,0,0,0,1,1,,,,,,,,,,
20151117-M-Tour_Finals-RR-Roger_Federer-Novak_Djokovic,2,S-XC,3,1,0,0,1,1,2,,,,,,,,,,
20151117-M-Tour_Finals-RR-Roger_Federer-Novak_Djokovic,2,S-DTM,1,0,0,0,0,0,1,,,,,,,,,,
20151118-M-Tour_Finals-RR-David_Ferrer-Stanislas_Wawrinka,1,F-XC,51,6,1,0,5,26,25,,,,,,,,,,
20151118-M-Tour_Finals-RR-David_Ferrer-Stanislas_Wawrinka,1,F-DTM,30,0,0,0,0,15,15,,,,,,,,,,
20151118-M-Tour_Finals-RR-David_Ferrer-Stanislas_Wawrinka,1,F-DTL,10,2,1,0,1,6,4,,,,,,,,,,
20151118-M-Tour_Finals-RR-David_Ferrer-Stanislas_Wawrinka,1,F-IO,44,5,0,1,4,24,20,,,,,,,,,,
20151118-M-Tour_Finals-RR-David_Ferrer-Stanislas_Wawrinka,1,F-II,5,1,0,1,0,2,3,,,,,,,,,,
20151118-M-Tour_Finals-RR-David_Ferrer-Stanislas_Wawrinka,1,B-XC,36,1,0,0,1,21,15,,,,,,,,,,
20151118-M-Tour_Finals-RR-David_Ferrer-Stanislas_Wawrinka,1,B-DTM,25,0,0,0,0,12,13,,,,,,,,,,
20151118-M-Tour_Finals-RR-David_Ferrer-Stanislas_Wawrinka,1,B-DTL,4,1,0,0,1,0,4,,,,,,,,,,
20151118-M-Tour_Finals-RR-David_Ferrer-Stanislas_Wawrinka,1,B-IO,3,0,0,0,0,3,0,,,,,,,,,,
20151118-M-Tour_Finals-RR-David_Ferrer-Stanislas_Wawrinka,1,S-XC,1,0,0,0,0,0,1,,,,,,,,,,
20151118-M-Tour_Finals-RR-David_Ferrer-Stanislas_Wawrinka,1,S-DTM,1,0,0,0,0,1,0,,,,,,,,,,
20151118-M-Tour_Finals-RR-David_Ferrer-Stanislas_Wawrinka,1,S-DTL,1,1,0,0,1,0,1,,,,,,,,,,
20151118-M-Tour_Finals-RR-David_Ferrer-Stanislas_Wawrinka,2,F-XC,47,16,7,2,7,28,19,,,,,,,,,,
20151118-M-Tour_Finals-RR-David_Ferrer-Stanislas_Wawrinka,2,F-DTM,18,1,0,1,0,4,14,,,,,,,,,,
20151118-M-Tour_Finals-RR-David_Ferrer-Stanislas_Wawrinka,2,F-DTL,14,10,5,0,5,8,6,,,,,,,,,,
20151118-M-Tour_Finals-RR-David_Ferrer-Stanislas_Wawrinka,2,F-IO,16,3,1,0,2,6,10,,,,,,,,,,
20151118-M-Tour_Finals-RR-David_Ferrer-Stanislas_Wawrinka,2,F-II,1,0,0,0,0,0,1,,,,,,,,,,
20151118-M-Tour_Finals-RR-David_Ferrer-Stanislas_Wawrinka,2,B-XC,39,10,1,1,8,16,23,,,,,,,,,,
20151118-M-Tour_Finals-RR-David_Ferrer-Stanislas_Wawrinka,2,B-DTM,27,2,0,0,2,8,19,,,,,,,,,,
20151118-M-Tour_Finals-RR-David_Ferrer-Stanislas_Wawrinka,2,B-DTL,14,7,4,0,3,7,7,,,,,,,,,,
20151118-M-Tour_Finals-RR-David_Ferrer-Stanislas_Wawrinka,2,B-IO,8,2,2,0,0,7,1,,,,,,,,,,
20151118-M-Tour_Finals-RR-David_Ferrer-Stanislas_Wawrinka,2,S-XC,15,3,0,1,2,7,8,,,,,,,,,,
20151118-M-Tour_Finals-RR-David_Ferrer-Stanislas_Wawrinka,2,S-DTM,5,1,0,0,1,1,4,,,,,,,,,,
20151118-M-Tour_Finals-RR-David_Ferrer-Stanislas_Wawrinka,2,S-DTL,4,0,0,0,0,2,2,,,,,,,,,,
20151118-M-Tour_Finals-RR-David_Ferrer-Stanislas_Wawrinka,2,S-IO,3,0,0,0,0,3,0,,,,,,,,,,
20151119-M-Tour_Finals-RR-Novak_Djokovic-Tomas_Berdych,1,F-XC,45,9,3,2,4,26,19,,,,,,,,,,
20151119-M-Tour_Finals-RR-Novak_Djokovic-Tomas_Berdych,1,F-DTM,18,2,0,0,2,7,11,,,,,,,,,,
20151119-M-Tour_Finals-RR-Novak_Djokovic-Tomas_Berdych,1,F-DTL,12,3,0,1,2,6,6,,,,,,,,,,
20151119-M-Tour_Finals-RR-Novak_Djokovic-Tomas_Berdych,1,F-IO,14,6,3,3,0,10,4,,,,,,,,,,
20151119-M-Tour_Finals-RR-Novak_Djokovic-Tomas_Berdych,1,F-II,3,1,0,1,0,1,2,,,,,,,,,,
20151119-M-Tour_Finals-RR-Novak_Djokovic-Tomas_Berdych,1,B-XC,26,3,0,0,3,9,17,,,,,,,,,,
20151119-M-Tour_Finals-RR-Novak_Djokovic-Tomas_Berdych,1,B-DTM,21,0,0,0,0,12,9,,,,,,,,,,
20151119-M-Tour_Finals-RR-Novak_Djokovic-Tomas_Berdych,1,B-DTL,5,2,0,1,1,3,2,,,,,,,,,,
20151119-M-Tour_Finals-RR-Novak_Djokovic-Tomas_Berdych,1,B-IO,10,5,0,2,3,4,6,,,,,,,,,,
20151119-M-Tour_Finals-RR-Novak_Djokovic-Tomas_Berdych,1,B-II,2,0,0,0,0,1,1,,,,,,,,,,
20151119-M-Tour_Finals-RR-Novak_Djokovic-Tomas_Berdych,1,S-XC,3,1,0,0,1,1,2,,,,,,,,,,
20151119-M-Tour_Finals-RR-Novak_Djokovic-Tomas_Berdych,1,S-DTM,2,0,0,0,0,1,1,,,,,,,,,,
20151119-M-Tour_Finals-RR-Novak_Djokovic-Tomas_Berdych,2,F-XC,44,7,2,0,5,24,20,,,,,,,,,,
20151119-M-Tour_Finals-RR-Novak_Djokovic-Tomas_Berdych,2,F-DTM,16,3,0,0,3,3,13,,,,,,,,,,
20151119-M-Tour_Finals-RR-Novak_Djokovic-Tomas_Berdych,2,F-DTL,20,10,1,3,6,12,8,,,,,,,,,,
20151119-M-Tour_Finals-RR-Novak_Djokovic-Tomas_Berdych,2,F-IO,18,3,0,0,3,8,10,,,,,,,,,,
20151119-M-Tour_Finals-RR-Novak_Djokovic-Tomas_Berdych,2,F-II,1,1,1,0,0,1,0,,,,,,,,,,
20151119-M-Tour_Finals-RR-Novak_Djokovic-Tomas_Berdych,2,B-XC,21,3,0,0,3,13,8,,,,,,,,,,
20151119-M-Tour_Finals-RR-Novak_Djokovic-Tomas_Berdych,2,B-DTM,16,3,0,0,3,8,8,,,,,,,,,,
20151119-M-Tour_Finals-RR-Novak_Djokovic-Tomas_Berdych,2,B-DTL,11,4,2,0,2,4,7,,,,,,,,,,
20151119-M-Tour_Finals-RR-Novak_Djokovic-Tomas_Berdych,2,B-IO,5,1,0,0,1,1,4,,,,,,,,,,
20151119-M-Tour_Finals-RR-Novak_Djokovic-Tomas_Berdych,2,S-XC,4,0,0,0,0,1,3,,,,,,,,,,
20151119-M-Tour_Finals-RR-Novak_Djokovic-Tomas_Berdych,2,S-DTM,2,0,0,0,0,0,2,,,,,,,,,,
20151119-M-Tour_Finals-RR-Novak_Djokovic-Tomas_Berdych,2,S-DTL,1,0,0,0,0,1,0,,,,,,,,,,
20151119-M-Tour_Finals-RR-Roger_Federer-Kei_Nishikori,1,F-XC,36,5,1,2,2,19,17,,,,,,,,,,
20151119-M-Tour_Finals-RR-Roger_Federer-Kei_Nishikori,1,F-DTM,21,1,0,0,1,8,13,,,,,,,,,,
20151119-M-Tour_Finals-RR-Roger_Federer-Kei_Nishikori,1,F-DTL,13,6,0,2,4,6,7,,,,,,,,,,
20151119-M-Tour_Finals-RR-Roger_Federer-Kei_Nishikori,1,F-IO,33,8,3,0,5,20,13,,,,,,,,,,
20151119-M-Tour_Finals-RR-Roger_Federer-Kei_Nishikori,1,F-II,9,4,1,3,0,6,3,,,,,,,,,,
20151119-M-Tour_Finals-RR-Roger_Federer-Kei_Nishikori,1,B-XC,41,5,2,1,2,24,17,,,,,,,,,,
20151119-M-Tour_Finals-RR-Roger_Federer-Kei_Nishikori,1,B-DTM,47,7,0,0,7,19,28,,,,,,,,,,
20151119-M-Tour_Finals-RR-Roger_Federer-Kei_Nishikori,1,B-DTL,9,6,1,5,0,7,2,,,,,,,,,,
20151119-M-Tour_Finals-RR-Roger_Federer-Kei_Nishikori,1,B-IO,2,2,0,0,2,0,2,,,,,,,,,,
20151119-M-Tour_Finals-RR-Roger_Federer-Kei_Nishikori,1,S-XC,19,1,0,1,0,10,9,,,,,,,,,,
20151119-M-Tour_Finals-RR-Roger_Federer-Kei_Nishikori,1,S-DTM,8,1,0,0,1,2,6,,,,,,,,,,
20151119-M-Tour_Finals-RR-Roger_Federer-Kei_Nishikori,1,S-DTL,2,0,0,0,0,1,1,,,,,,,,,,
20151119-M-Tour_Finals-RR-Roger_Federer-Kei_Nishikori,1,S-IO,1,1,0,1,0,1,0,,,,,,,,,,
20151119-M-Tour_Finals-RR-Roger_Federer-Kei_Nishikori,2,F-XC,39,16,3,6,7,23,16,,,,,,,,,,
20151119-M-Tour_Finals-RR-Roger_Federer-Kei_Nishikori,2,F-DTM,35,3,1,1,1,17,18,,,,,,,,,,
20151119-M-Tour_Finals-RR-Roger_Federer-Kei_Nishikori,2,F-DTL,23,7,3,2,2,14,9,,,,,,,,,,
20151119-M-Tour_Finals-RR-Roger_Federer-Kei_Nishikori,2,F-IO,37,8,3,1,4,22,15,,,,,,,,,,
20151119-M-Tour_Finals-RR-Roger_Federer-Kei_Nishikori,2,F-II,1,0,0,0,0,1,0,,,,,,,,,,
20151119-M-Tour_Finals-RR-Roger_Federer-Kei_Nishikori,2,B-XC,70,9,2,3,4,34,36,,,,,,,,,,
20151119-M-Tour_Finals-RR-Roger_Federer-Kei_Nishikori,2,B-DTM,15,2,0,0,2,5,10,,,,,,,,,,
20151119-M-Tour_Finals-RR-Roger_Federer-Kei_Nishikori,2,B-DTL,11,8,3,2,3,6,5,,,,,,,,,,
20151119-M-Tour_Finals-RR-Roger_Federer-Kei_Nishikori,2,B-IO,4,1,1,0,0,4,0,,,,,,,,,,
20151119-M-Tour_Finals-RR-Roger_Federer-Kei_Nishikori,2,S-XC,14,1,0,0,1,3,11,,,,,,,,,,
20151119-M-Tour_Finals-RR-Roger_Federer-Kei_Nishikori,2,S-DTM,3,0,0,0,0,0,3,,,,,,,,,,
20151119-M-Tour_Finals-RR-Roger_Federer-Kei_Nishikori,2,S-DTL,3,0,0,0,0,1,2,,,,,,,,,,
20151119-M-Tour_Finals-RR-Roger_Federer-Kei_Nishikori,2,S-IO,1,0,0,0,0,0,1,,,,,,,,,,
20151121-M-Tour_Finals-SF-Novak_Djokovic-Rafael_Nadal,1,F-XC,40,6,3,0,3,32,8,,,,,,,,,,
20151121-M-Tour_Finals-SF-Novak_Djokovic-Rafael_Nadal,1,F-DTM,14,0,0,0,0,11,3,,,,,,,,,,
20151121-M-Tour_Finals-SF-Novak_Djokovic-Rafael_Nadal,1,F-DTL,10,6,1,0,5,4,6,,,,,,,,,,
20151121-M-Tour_Finals-SF-Novak_Djokovic-Rafael_Nadal,1,F-IO,19,3,2,1,0,18,1,,,,,,,,,,
20151121-M-Tour_Finals-SF-Novak_Djokovic-Rafael_Nadal,1,F-II,2,1,1,0,0,1,1,,,,,,,,,,
20151121-M-Tour_Finals-SF-Novak_Djokovic-Rafael_Nadal,1,B-XC,27,8,4,1,3,19,8,,,,,,,,,,
20151121-M-Tour_Finals-SF-Novak_Djokovic-Rafael_Nadal,1,B-DTM,14,3,0,0,3,6,8,,,,,,,,,,
20151121-M-Tour_Finals-SF-Novak_Djokovic-Rafael_Nadal,1,B-DTL,18,5,3,2,0,15,3,,,,,,,,,,
20151121-M-Tour_Finals-SF-Novak_Djokovic-Rafael_Nadal,1,B-IO,4,0,0,0,0,2,2,,,,,,,,,,
20151121-M-Tour_Finals-SF-Novak_Djokovic-Rafael_Nadal,1,S-XC,1,0,0,0,0,1,0,,,,,,,,,,
20151121-M-Tour_Finals-SF-Novak_Djokovic-Rafael_Nadal,1,S-DTL,1,0,0,0,0,0,1,,,,,,,,,,
20151121-M-Tour_Finals-SF-Novak_Djokovic-Rafael_Nadal,1,S-IO,1,0,0,0,0,1,0,,,,,,,,,,
20151121-M-Tour_Finals-SF-Novak_Djokovic-Rafael_Nadal,2,F-XC,35,7,0,1,6,10,25,,,,,,,,,,
20151121-M-Tour_Finals-SF-Novak_Djokovic-Rafael_Nadal,2,F-DTM,26,1,0,0,1,7,19,,,,,,,,,,
20151121-M-Tour_Finals-SF-Novak_Djokovic-Rafael_Nadal,2,F-DTL,7,3,1,1,1,4,3,,,,,,,,,,
20151121-M-Tour_Finals-SF-Novak_Djokovic-Rafael_Nadal,2,F-IO,19,5,2,1,2,7,12,,,,,,,,,,
20151121-M-Tour_Finals-SF-Novak_Djokovic-Rafael_Nadal,2,F-II,4,1,0,1,0,2,2,,,,,,,,,,
20151121-M-Tour_Finals-SF-Novak_Djokovic-Rafael_Nadal,2,B-XC,21,0,0,0,0,7,14,,,,,,,,,,
20151121-M-Tour_Finals-SF-Novak_Djokovic-Rafael_Nadal,2,B-DTM,15,1,0,0,1,6,9,,,,,,,,,,
20151121-M-Tour_Finals-SF-Novak_Djokovic-Rafael_Nadal,2,B-DTL,7,1,0,0,1,0,7,,,,,,,,,,
20151121-M-Tour_Finals-SF-Novak_Djokovic-Rafael_Nadal,2,B-IO,4,0,0,0,0,1,3,,,,,,,,,,
20151121-M-Tour_Finals-SF-Novak_Djokovic-Rafael_Nadal,2,S-XC,2,0,0,0,0,0,2,,,,,,,,,,
20151121-M-Tour_Finals-SF-Novak_Djokovic-Rafael_Nadal,2,S-DTM,6,0,0,0,0,0,6,,,,,,,,,,
20151121-M-Tour_Finals-SF-Novak_Djokovic-Rafael_Nadal,2,S-DTL,11,2,0,0,2,2,9,,,,,,,,,,
20151121-M-Tour_Finals-SF-Novak_Djokovic-Rafael_Nadal,2,S-IO,1,0,0,0,0,0,1,,,,,,,,,,
20151121-M-Tour_Finals-SF-Novak_Djokovic-Rafael_Nadal,2,S-II,1,0,0,0,0,0,1,,,,,,,,,,
20151121-M-Tour_Finals-SF-Roger_Federer-Stanislas_Wawrinka,1,F-XC,17,7,2,2,3,11,6,,,,,,,,,,
20151121-M-Tour_Finals-SF-Roger_Federer-Stanislas_Wawrinka,1,F-DTM,12,3,0,0,3,5,7,,,,,,,,,,
20151121-M-Tour_Finals-SF-Roger_Federer-Stanislas_Wawrinka,1,F-DTL,5,1,0,0,1,4,1,,,,,,,,,,
20151121-M-Tour_Finals-SF-Roger_Federer-Stanislas_Wawrinka,1,F-IO,22,7,4,0,3,16,6,,,,,,,,,,
20151121-M-Tour_Finals-SF-Roger_Federer-Stanislas_Wawrinka,1,F-II,2,1,0,1,0,2,0,,,,,,,,,,
20151121-M-Tour_Finals-SF-Roger_Federer-Stanislas_Wawrinka,1,B-XC,13,3,1,1,1,9,4,,,,,,,,,,
20151121-M-Tour_Finals-SF-Roger_Federer-Stanislas_Wawrinka,1,B-DTM,14,0,0,0,0,9,5,,,,,,,,,,
20151121-M-Tour_Finals-SF-Roger_Federer-Stanislas_Wawrinka,1,B-DTL,3,0,0,0,0,1,2,,,,,,,,,,
20151121-M-Tour_Finals-SF-Roger_Federer-Stanislas_Wawrinka,1,B-IO,1,1,0,0,1,0,1,,,,,,,,,,
20151121-M-Tour_Finals-SF-Roger_Federer-Stanislas_Wawrinka,1,S-XC,9,1,0,0,1,4,5,,,,,,,,,,
20151121-M-Tour_Finals-SF-Roger_Federer-Stanislas_Wawrinka,1,S-DTM,1,0,0,0,0,1,0,,,,,,,,,,
20151121-M-Tour_Finals-SF-Roger_Federer-Stanislas_Wawrinka,1,S-DTL,2,1,1,0,0,2,0,,,,,,,,,,
20151121-M-Tour_Finals-SF-Roger_Federer-Stanislas_Wawrinka,2,F-XC,23,11,3,1,7,10,13,,,,,,,,,,
20151121-M-Tour_Finals-SF-Roger_Federer-Stanislas_Wawrinka,2,F-DTM,18,3,0,0,3,4,14,,,,,,,,,,
20151121-M-Tour_Finals-SF-Roger_Federer-Stanislas_Wawrinka,2,F-DTL,5,2,0,0,2,0,5,,,,,,,,,,
20151121-M-Tour_Finals-SF-Roger_Federer-Stanislas_Wawrinka,2,F-IO,11,2,1,0,1,6,5,,,,,,,,,,
20151121-M-Tour_Finals-SF-Roger_Federer-Stanislas_Wawrinka,2,F-II,1,1,1,0,0,1,0,,,,,,,,,,
20151121-M-Tour_Finals-SF-Roger_Federer-Stanislas_Wawrinka,2,B-XC,30,9,3,1,5,11,19,,,,,,,,,,
20151121-M-Tour_Finals-SF-Roger_Federer-Stanislas_Wawrinka,2,B-DTM,10,1,0,0,1,1,9,,,,,,,,,,
20151121-M-Tour_Finals-SF-Roger_Federer-Stanislas_Wawrinka,2,B-DTL,8,5,2,0,3,3,5,,,,,,,,,,
20151121-M-Tour_Finals-SF-Roger_Federer-Stanislas_Wawrinka,2,B-IO,2,0,0,0,0,2,0,,,,,,,,,,
20151121-M-Tour_Finals-SF-Roger_Federer-Stanislas_Wawrinka,2,S-XC,6,2,0,0,2,0,6,,,,,,,,,,
20151121-M-Tour_Finals-SF-Roger_Federer-Stanislas_Wawrinka,2,S-DTM,2,0,0,0,0,1,1,,,,,,,,,,
20151121-M-Tour_Finals-SF-Roger_Federer-Stanislas_Wawrinka,2,S-DTL,1,0,0,0,0,0,1,,,,,,,,,,
20151122-M-Tour_Finals-F-Roger_Federer-Novak_Djokovic,1,F-XC,33,5,1,1,3,16,17,,,,,,,,,,
20151122-M-Tour_Finals-F-Roger_Federer-Novak_Djokovic,1,F-DTM,19,0,0,0,0,7,12,,,,,,,,,,
20151122-M-Tour_Finals-F-Roger_Federer-Novak_Djokovic,1,F-DTL,20,3,0,0,3,11,9,,,,,,,,,,
20151122-M-Tour_Finals-F-Roger_Federer-Novak_Djokovic,1,F-IO,17,6,3,0,3,7,10,,,,,,,,,,
20151122-M-Tour_Finals-F-Roger_Federer-Novak_Djokovic,1,F-II,7,2,0,1,1,4,3,,,,,,,,,,
20151122-M-Tour_Finals-F-Roger_Federer-Novak_Djokovic,1,B-XC,31,6,0,0,6,9,22,,,,,,,,,,
20151122-M-Tour_Finals-F-Roger_Federer-Novak_Djokovic,1,B-DTM,22,0,0,0,0,9,13,,,,,,,,,,
20151122-M-Tour_Finals-F-Roger_Federer-Novak_Djokovic,1,B-DTL,15,9,3,2,4,6,9,,,,,,,,,,
20151122-M-Tour_Finals-F-Roger_Federer-Novak_Djokovic,1,B-IO,3,1,0,0,1,1,2,,,,,,,,,,
20151122-M-Tour_Finals-F-Roger_Federer-Novak_Djokovic,1,S-XC,13,2,0,0,2,5,8,,,,,,,,,,
20151122-M-Tour_Finals-F-Roger_Federer-Novak_Djokovic,1,S-DTM,9,2,0,0,2,5,4,,,,,,,,,,
20151122-M-Tour_Finals-F-Roger_Federer-Novak_Djokovic,1,S-DTL,1,0,0,0,0,1,0,,,,,,,,,,
20151122-M-Tour_Finals-F-Roger_Federer-Novak_Djokovic,2,F-XC,45,10,4,1,5,23,22,,,,,,,,,,
20151122-M-Tour_Finals-F-Roger_Federer-Novak_Djokovic,2,F-DTM,18,2,0,1,1,12,6,,,,,,,,,,
20151122-M-Tour_Finals-F-Roger_Federer-Novak_Djokovic,2,F-DTL,10,1,1,0,0,4,6,,,,,,,,,,
20151122-M-Tour_Finals-F-Roger_Federer-Novak_Djokovic,2,F-IO,13,1,0,1,0,11,2,,,,,,,,,,
20151122-M-Tour_Finals-F-Roger_Federer-Novak_Djokovic,2,F-II,1,1,0,0,1,0,1,,,,,,,,,,
20151122-M-Tour_Finals-F-Roger_Federer-Novak_Djokovic,2,B-XC,72,6,1,2,3,39,33,,,,,,,,,,
20151122-M-Tour_Finals-F-Roger_Federer-Novak_Djokovic,2,B-DTM,17,2,0,0,2,8,9,,,,,,,,,,
20151122-M-Tour_Finals-F-Roger_Federer-Novak_Djokovic,2,B-DTL,8,2,1,1,0,5,3,,,,,,,,,,
20151122-M-Tour_Finals-F-Roger_Federer-Novak_Djokovic,2,B-IO,8,2,1,0,1,5,3,,,,,,,,,,
20151122-M-Tour_Finals-F-Roger_Federer-Novak_Djokovic,2,S-XC,1,0,0,0,0,1,0,,,,,,,,,,
20151122-M-Tour_Finals-F-Roger_Federer-Novak_Djokovic,2,S-DTL,2,1,0,0,1,0,2,,,,,,,,,,
20151123-M-Andria_CH-R32-Adrien_Bossel-Dudi_Sela,1,F-XC,27,8,3,0,5,5,22,,,,,,,,,,
20151123-M-Andria_CH-R32-Adrien_Bossel-Dudi_Sela,1,F-DTM,7,0,0,0,0,0,7,,,,,,,,,,
20151123-M-Andria_CH-R32-Adrien_Bossel-Dudi_Sela,1,F-DTL,3,1,0,1,0,1,2,,,,,,,,,,
20151123-M-Andria_CH-R32-Adrien_Bossel-Dudi_Sela,1,F-IO,5,2,0,1,1,2,3,,,,,,,,,,
20151123-M-Andria_CH-R32-Adrien_Bossel-Dudi_Sela,1,B-XC,20,6,0,3,3,5,15,,,,,,,,,,
20151123-M-Andria_CH-R32-Adrien_Bossel-Dudi_Sela,1,B-DTM,7,2,0,0,2,0,7,,,,,,,,,,
20151123-M-Andria_CH-R32-Adrien_Bossel-Dudi_Sela,1,B-DTL,3,1,0,1,0,1,2,,,,,,,,,,
20151123-M-Andria_CH-R32-Adrien_Bossel-Dudi_Sela,1,B-IO,4,2,0,0,2,1,3,,,,,,,,,,
20151123-M-Andria_CH-R32-Adrien_Bossel-Dudi_Sela,2,F-XC,15,6,2,4,0,15,0,,,,,,,,,,
20151123-M-Andria_CH-R32-Adrien_Bossel-Dudi_Sela,2,F-DTM,10,0,0,0,0,8,2,,,,,,,,,,
20151123-M-Andria_CH-R32-Adrien_Bossel-Dudi_Sela,2,F-DTL,3,2,0,1,1,1,2,,,,,,,,,,
20151123-M-Andria_CH-R32-Adrien_Bossel-Dudi_Sela,2,F-IO,1,1,0,1,0,1,0,,,,,,,,,,
20151123-M-Andria_CH-R32-Adrien_Bossel-Dudi_Sela,2,F-II,1,0,0,0,0,1,0,,,,,,,,,,
20151123-M-Andria_CH-R32-Adrien_Bossel-Dudi_Sela,2,B-XC,19,7,1,4,2,16,3,,,,,,,,,,
20151123-M-Andria_CH-R32-Adrien_Bossel-Dudi_Sela,2,B-DTM,8,2,0,2,0,8,0,,,,,,,,,,
20151123-M-Andria_CH-R32-Adrien_Bossel-Dudi_Sela,2,B-DTL,2,1,1,0,0,2,0,,,,,,,,,,
20151123-M-Andria_CH-R32-Adrien_Bossel-Dudi_Sela,2,B-IO,2,0,0,0,0,2,0,,,,,,,,,,
20151123-M-Andria_CH-R32-Adrien_Bossel-Dudi_Sela,2,S-XC,1,0,0,0,0,1,0,,,,,,,,,,
20151123-M-Andria_CH-R32-Adrien_Bossel-Dudi_Sela,2,S-DTM,5,0,0,0,0,5,0,,,,,,,,,,
20151123-M-Andria_CH-R32-Adrien_Bossel-Dudi_Sela,2,S-DTL,3,1,0,1,0,3,0,,,,,,,,,,
20151123-M-Toyota_CH-R32-Makoto_Ochi-Konstantin_Kravchuk,1,F-XC,12,3,0,0,3,4,8,,,,,,,,,,
20151123-M-Toyota_CH-R32-Makoto_Ochi-Konstantin_Kravchuk,1,F-DTM,7,4,0,1,3,2,5,,,,,,,,,,
20151123-M-Toyota_CH-R32-Makoto_Ochi-Konstantin_Kravchuk,1,F-DTL,5,5,2,1,2,3,2,,,,,,,,,,
20151123-M-Toyota_CH-R32-Makoto_Ochi-Konstantin_Kravchuk,1,F-IO,16,10,2,2,6,7,9,,,,,,,,,,
20151123-M-Toyota_CH-R32-Makoto_Ochi-Konstantin_Kravchuk,1,B-XC,3,1,0,0,1,0,3,,,,,,,,,,
20151123-M-Toyota_CH-R32-Makoto_Ochi-Konstantin_Kravchuk,1,B-DTM,8,0,0,0,0,2,6,,,,,,,,,,
20151123-M-Toyota_CH-R32-Makoto_Ochi-Konstantin_Kravchuk,1,B-DTL,8,6,3,0,3,4,4,,,,,,,,,,
20151123-M-Toyota_CH-R32-Makoto_Ochi-Konstantin_Kravchuk,1,S-DTM,1,0,0,0,0,0,1,,,,,,,,,,
20151123-M-Toyota_CH-R32-Makoto_Ochi-Konstantin_Kravchuk,1,S-DTL,1,0,0,0,0,0,1,,,,,,,,,,
20151123-M-Toyota_CH-R32-Makoto_Ochi-Konstantin_Kravchuk,1,S-IO,1,0,0,0,0,1,0,,,,,,,,,,
20151123-M-Toyota_CH-R32-Makoto_Ochi-Konstantin_Kravchuk,2,F-XC,14,4,1,2,1,10,4,,,,,,,,,,
20151123-M-Toyota_CH-R32-Makoto_Ochi-Konstantin_Kravchuk,2,F-DTM,3,1,0,0,1,2,1,,,,,,,,,,
20151123-M-Toyota_CH-R32-Makoto_Ochi-Konstantin_Kravchuk,2,F-DTL,3,2,1,1,0,2,1,,,,,,,,,,
20151123-M-Toyota_CH-R32-Makoto_Ochi-Konstantin_Kravchuk,2,F-IO,1,0,0,0,0,1,0,,,,,,,,,,
20151123-M-Toyota_CH-R32-Makoto_Ochi-Konstantin_Kravchuk,2,B-XC,2,2,1,1,0,2,0,,,,,,,,,,
20151123-M-Toyota_CH-R32-Makoto_Ochi-Konstantin_Kravchuk,2,B-DTM,2,1,0,0,1,0,2,,,,,,,,,,
20151123-M-Toyota_CH-R32-Makoto_Ochi-Konstantin_Kravchuk,2,B-IO,2,0,0,0,0,2,0,,,,,,,,,,
20151123-M-Toyota_CH-R32-Makoto_Ochi-Konstantin_Kravchuk,2,S-XC,4,2,2,0,0,4,0,,,,,,,,,,
20151123-M-Toyota_CH-R32-Makoto_Ochi-Konstantin_Kravchuk,2,S-DTM,4,0,0,0,0,3,1,,,,,,,,,,
20151123-M-Toyota_CH-R32-Makoto_Ochi-Konstantin_Kravchuk,2,S-DTL,6,2,0,0,2,2,4,,,,,,,,,,
20151123-M-Toyota_CH-R32-Sho_Katayama-Gavin_Van_Peperzeel,1,F-XC,20,5,1,2,2,11,9,,,,,,,,,,
20151123-M-Toyota_CH-R32-Sho_Katayama-Gavin_Van_Peperzeel,1,F-DTM,9,1,0,1,0,6,3,,,,,,,,,,
20151123-M-Toyota_CH-R32-Sho_Katayama-Gavin_Van_Peperzeel,1,F-IO,8,4,1,3,0,8,0,,,,,,,,,,
20151123-M-Toyota_CH-R32-Sho_Katayama-Gavin_Van_Peperzeel,1,F-II,1,1,0,1,0,1,0,,,,,,,,,,
20151123-M-Toyota_CH-R32-Sho_Katayama-Gavin_Van_Peperzeel,1,B-XC,16,5,2,1,2,8,8,,,,,,,,,,
20151123-M-Toyota_CH-R32-Sho_Katayama-Gavin_Van_Peperzeel,1,B-DTM,7,1,0,1,0,3,4,,,,,,,,,,
20151123-M-Toyota_CH-R32-Sho_Katayama-Gavin_Van_Peperzeel,1,B-DTL,3,1,1,0,0,2,1,,,,,,,,,,
20151123-M-Toyota_CH-R32-Sho_Katayama-Gavin_Van_Peperzeel,1,B-IO,1,1,0,0,1,0,1,,,,,,,,,,
20151123-M-Toyota_CH-R32-Sho_Katayama-Gavin_Van_Peperzeel,1,S-XC,1,0,0,0,0,0,1,,,,,,,,,,
20151123-M-Toyota_CH-R32-Sho_Katayama-Gavin_Van_Peperzeel,1,S-DTM,1,0,0,0,0,0,1,,,,,,,,,,
20151123-M-Toyota_CH-R32-Sho_Katayama-Gavin_Van_Peperzeel,1,S-DTL,1,0,0,0,0,1,0,,,,,,,,,,
20151123-M-Toyota_CH-R32-Sho_Katayama-Gavin_Van_Peperzeel,2,F-XC,13,5,2,2,1,7,6,,,,,,,,,,
20151123-M-Toyota_CH-R32-Sho_Katayama-Gavin_Van_Peperzeel,2,F-DTM,11,2,0,0,2,3,8,,,,,,,,,,
20151123-M-Toyota_CH-R32-Sho_Katayama-Gavin_Van_Peperzeel,2,F-DTL,4,2,1,0,1,3,1,,,,,,,,,,
20151123-M-Toyota_CH-R32-Sho_Katayama-Gavin_Van_Peperzeel,2,F-IO,10,4,2,2,0,8,2,,,,,,,,,,
20151123-M-Toyota_CH-R32-Sho_Katayama-Gavin_Van_Peperzeel,2,B-XC,6,1,0,0,1,4,2,,,,,,,,,,
20151123-M-Toyota_CH-R32-Sho_Katayama-Gavin_Van_Peperzeel,2,B-DTM,4,1,0,0,1,2,2,,,,,,,,,,
20151123-M-Toyota_CH-R32-Sho_Katayama-Gavin_Van_Peperzeel,2,S-XC,3,0,0,0,0,0,3,,,,,,,,,,
20151123-M-Toyota_CH-R32-Sho_Katayama-Gavin_Van_Peperzeel,2,S-DTM,8,2,0,0,2,2,6,,,,,,,,,,
20160104-M-Bangkok_CH-R32-Nattan_Benjasupawan-Konstantin_Kravchuk,1,F-XC,20,5,1,1,3,9,11,,,,,,,,,,
20160104-M-Bangkok_CH-R32-Nattan_Benjasupawan-Konstantin_Kravchuk,1,F-DTM,7,0,0,0,0,2,5,,,,,,,,,,
20160104-M-Bangkok_CH-R32-Nattan_Benjasupawan-Konstantin_Kravchuk,1,F-DTL,3,1,0,0,1,0,3,,,,,,,,,,
20160104-M-Bangkok_CH-R32-Nattan_Benjasupawan-Konstantin_Kravchuk,1,F-IO,9,2,0,0,2,3,6,,,,,,,,,,
20160104-M-Bangkok_CH-R32-Nattan_Benjasupawan-Konstantin_Kravchuk,1,B-XC,17,3,0,0,3,2,15,,,,,,,,,,
20160104-M-Bangkok_CH-R32-Nattan_Benjasupawan-Konstantin_Kravchuk,1,B-DTM,17,2,0,0,2,3,14,,,,,,,,,,
20160104-M-Bangkok_CH-R32-Nattan_Benjasupawan-Konstantin_Kravchuk,1,B-DTL,4,3,0,1,2,1,3,,,,,,,,,,
20160104-M-Bangkok_CH-R32-Nattan_Benjasupawan-Konstantin_Kravchuk,1,B-IO,1,1,0,0,1,0,1,,,,,,,,,,
20160104-M-Bangkok_CH-R32-Nattan_Benjasupawan-Konstantin_Kravchuk,1,S-XC,2,0,0,0,0,0,2,,,,,,,,,,
20160104-M-Bangkok_CH-R32-Nattan_Benjasupawan-Konstantin_Kravchuk,1,S-DTM,1,0,0,0,0,0,1,,,,,,,,,,
20160104-M-Bangkok_CH-R32-Nattan_Benjasupawan-Konstantin_Kravchuk,1,S-DTL,1,0,0,0,0,0,1,,,,,,,,,,
20160104-M-Bangkok_CH-R32-Nattan_Benjasupawan-Konstantin_Kravchuk,2,F-XC,18,7,3,1,3,13,5,,,,,,,,,,
20160104-M-Bangkok_CH-R32-Nattan_Benjasupawan-Konstantin_Kravchuk,2,F-DTM,6,0,0,0,0,4,2,,,,,,,,,,
20160104-M-Bangkok_CH-R32-Nattan_Benjasupawan-Konstantin_Kravchuk,2,F-DTL,3,2,0,1,1,2,1,,,,,,,,,,
20160104-M-Bangkok_CH-R32-Nattan_Benjasupawan-Konstantin_Kravchuk,2,F-IO,7,2,1,1,0,6,1,,,,,,,,,,
20160104-M-Bangkok_CH-R32-Nattan_Benjasupawan-Konstantin_Kravchuk,2,B-XC,17,2,0,1,1,13,4,,,,,,,,,,
20160104-M-Bangkok_CH-R32-Nattan_Benjasupawan-Konstantin_Kravchuk,2,B-DTM,7,1,0,0,1,4,3,,,,,,,,,,
20160104-M-Bangkok_CH-R32-Nattan_Benjasupawan-Konstantin_Kravchuk,2,B-DTL,7,5,2,2,1,6,1,,,,,,,,,,
20160104-M-Bangkok_CH-R32-Nattan_Benjasupawan-Konstantin_Kravchuk,2,B-IO,3,0,0,0,0,2,1,,,,,,,,,,
20160104-M-Bangkok_CH-R32-Nattan_Benjasupawan-Konstantin_Kravchuk,2,S-XC,6,1,0,0,1,4,2,,,,,,,,,,
20160104-M-Bangkok_CH-R32-Nattan_Benjasupawan-Konstantin_Kravchuk,2,S-DTM,2,1,0,0,1,1,1,,,,,,,,,,
20160104-M-Doha-R32-Novak_Djokovic-Dustin_Brown,1,F-XC,26,6,2,2,2,16,10,,,,,,,,,,
20160104-M-Doha-R32-Novak_Djokovic-Dustin_Brown,1,F-DTM,4,0,0,0,0,3,1,,,,,,,,,,
20160104-M-Doha-R32-Novak_Djokovic-Dustin_Brown,1,F-DTL,7,2,1,0,1,4,3,,,,,,,,,,
20160104-M-Doha-R32-Novak_Djokovic-Dustin_Brown,1,F-IO,17,3,0,2,1,10,7,,,,,,,,,,
20160104-M-Doha-R32-Novak_Djokovic-Dustin_Brown,1,B-XC,20,2,0,1,1,11,9,,,,,,,,,,
20160104-M-Doha-R32-Novak_Djokovic-Dustin_Brown,1,B-DTM,4,0,0,0,0,2,2,,,,,,,,,,
20160104-M-Doha-R32-Novak_Djokovic-Dustin_Brown,1,B-DTL,4,2,2,0,0,2,2,,,,,,,,,,
20160104-M-Doha-R32-Novak_Djokovic-Dustin_Brown,1,B-IO,8,2,0,1,1,3,5,,,,,,,,,,
20160104-M-Doha-R32-Novak_Djokovic-Dustin_Brown,1,S-XC,3,1,0,1,0,2,1,,,,,,,,,,
20160104-M-Doha-R32-Novak_Djokovic-Dustin_Brown,2,F-XC,19,5,0,0,5,4,15,,,,,,,,,,
20160104-M-Doha-R32-Novak_Djokovic-Dustin_Brown,2,F-DTM,14,2,0,0,2,6,8,,,,,,,,,,
20160104-M-Doha-R32-Novak_Djokovic-Dustin_Brown,2,F-DTL,2,2,1,1,0,2,0,,,,,,,,,,
20160104-M-Doha-R32-Novak_Djokovic-Dustin_Brown,2,F-IO,4,0,0,0,0,2,2,,,,,,,,,,
20160104-M-Doha-R32-Novak_Djokovic-Dustin_Brown,2,F-II,2,0,0,0,0,1,1,,,,,,,,,,
20160104-M-Doha-R32-Novak_Djokovic-Dustin_Brown,2,B-XC,9,2,1,0,1,3,6,,,,,,,,,,
20160104-M-Doha-R32-Novak_Djokovic-Dustin_Brown,2,B-DTM,20,2,0,0,2,9,11,,,,,,,,,,
20160104-M-Doha-R32-Novak_Djokovic-Dustin_Brown,2,B-DTL,7,4,1,1,2,3,4,,,,,,,,,,
20160104-M-Doha-R32-Novak_Djokovic-Dustin_Brown,2,B-IO,2,0,0,0,0,2,0,,,,,,,,,,
20160104-M-Doha-R32-Novak_Djokovic-Dustin_Brown,2,S-XC,4,1,0,1,0,3,1,,,,,,,,,,
20160104-M-Doha-R32-Novak_Djokovic-Dustin_Brown,2,S-DTM,5,0,0,0,0,0,5,,,,,,,,,,
20160104-M-Hopman_Cup-RR-Jack_Sock-Alexandr_Dolgopolov,1,F-XC,10,4,1,1,2,6,4,,,,,,,,,,
20160104-M-Hopman_Cup-RR-Jack_Sock-Alexandr_Dolgopolov,1,F-DTM,6,0,0,0,0,0,6,,,,,,,,,,
20160104-M-Hopman_Cup-RR-Jack_Sock-Alexandr_Dolgopolov,1,F-DTL,2,0,0,0,0,2,0,,,,,,,,,,
20160104-M-Hopman_Cup-RR-Jack_Sock-Alexandr_Dolgopolov,1,F-IO,9,4,0,2,2,5,4,,,,,,,,,,
20160104-M-Hopman_Cup-RR-Jack_Sock-Alexandr_Dolgopolov,1,F-II,1,1,0,0,1,0,1,,,,,,,,,,
20160104-M-Hopman_Cup-RR-Jack_Sock-Alexandr_Dolgopolov,1,B-DTM,4,1,0,1,0,2,2,,,,,,,,,,
20160104-M-Hopman_Cup-RR-Jack_Sock-Alexandr_Dolgopolov,1,B-DTL,2,1,0,0,1,0,2,,,,,,,,,,
20160104-M-Hopman_Cup-RR-Jack_Sock-Alexandr_Dolgopolov,1,S-XC,14,2,0,0,2,2,12,,,,,,,,,,
20160104-M-Hopman_Cup-RR-Jack_Sock-Alexandr_Dolgopolov,1,S-DTM,2,1,0,0,1,1,1,,,,,,,,,,
20160104-M-Hopman_Cup-RR-Jack_Sock-Alexandr_Dolgopolov,1,S-DTL,1,1,0,0,1,0,1,,,,,,,,,,
20160104-M-Hopman_Cup-RR-Jack_Sock-Alexandr_Dolgopolov,2,F-XC,6,3,3,0,0,4,2,,,,,,,,,,
20160104-M-Hopman_Cup-RR-Jack_Sock-Alexandr_Dolgopolov,2,F-DTM,6,1,0,0,1,3,3,,,,,,,,,,
20160104-M-Hopman_Cup-RR-Jack_Sock-Alexandr_Dolgopolov,2,F-DTL,9,4,1,2,1,8,1,,,,,,,,,,
20160104-M-Hopman_Cup-RR-Jack_Sock-Alexandr_Dolgopolov,2,F-IO,15,9,6,1,2,11,4,,,,,,,,,,
20160104-M-Hopman_Cup-RR-Jack_Sock-Alexandr_Dolgopolov,2,F-II,2,1,0,0,1,1,1,,,,,,,,,,
20160104-M-Hopman_Cup-RR-Jack_Sock-Alexandr_Dolgopolov,2,B-XC,9,1,0,0,1,4,5,,,,,,,,,,
20160104-M-Hopman_Cup-RR-Jack_Sock-Alexandr_Dolgopolov,2,B-DTM,4,0,0,0,0,3,1,,,,,,,,,,
20160104-M-Hopman_Cup-RR-Jack_Sock-Alexandr_Dolgopolov,2,B-DTL,3,3,0,0,3,0,3,,,,,,,,,,
20160104-M-Hopman_Cup-RR-Jack_Sock-Alexandr_Dolgopolov,2,B-IO,3,2,2,0,0,2,1,,,,,,,,,,
20160104-M-Hopman_Cup-RR-Jack_Sock-Alexandr_Dolgopolov,2,S-DTM,1,0,0,0,0,0,1,,,,,,,,,,
20160104-M-Hopman_Cup-RR-Jack_Sock-Alexandr_Dolgopolov,2,S-DTL,2,0,0,0,0,1,1,,,,,,,,,,
20160106-M-Doha-R16-Rafael_Nadal-Robin_Haase,1,F-XC,37,5,2,1,2,29,8,,,,,,,,,,
20160106-M-Doha-R16-Rafael_Nadal-Robin_Haase,1,F-DTM,6,0,0,0,0,3,3,,,,,,,,,,
20160106-M-Doha-R16-Rafael_Nadal-Robin_Haase,1,F-DTL,8,4,2,2,0,7,1,,,,,,,,,,
20160106-M-Doha-R16-Rafael_Nadal-Robin_Haase,1,F-IO,22,8,4,3,1,15,7,,,,,,,,,,
20160106-M-Doha-R16-Rafael_Nadal-Robin_Haase,1,F-II,8,2,1,1,0,8,0,,,,,,,,,,
20160106-M-Doha-R16-Rafael_Nadal-Robin_Haase,1,B-XC,23,6,3,2,1,19,4,,,,,,,,,,
20160106-M-Doha-R16-Rafael_Nadal-Robin_Haase,1,B-DTM,13,0,0,0,0,9,4,,,,,,,,,,
20160106-M-Doha-R16-Rafael_Nadal-Robin_Haase,1,B-DTL,9,2,1,0,1,8,1,,,,,,,,,,
20160106-M-Doha-R16-Rafael_Nadal-Robin_Haase,1,S-XC,2,0,0,0,0,0,2,,,,,,,,,,
20160106-M-Doha-R16-Rafael_Nadal-Robin_Haase,1,S-DTM,1,0,0,0,0,0,1,,,,,,,,,,
20160106-M-Doha-R16-Rafael_Nadal-Robin_Haase,1,S-DTL,2,0,0,0,0,2,0,,,,,,,,,,
20160106-M-Doha-R16-Rafael_Nadal-Robin_Haase,2,F-XC,27,2,1,0,1,9,18,,,,,,,,,,
20160106-M-Doha-R16-Rafael_Nadal-Robin_Haase,2,F-DTM,8,0,0,0,0,2,6,,,,,,,,,,
20160106-M-Doha-R16-Rafael_Nadal-Robin_Haase,2,F-DTL,8,4,1,1,2,2,6,,,,,,,,,,
20160106-M-Doha-R16-Rafael_Nadal-Robin_Haase,2,F-IO,12,3,0,0,3,2,10,,,,,,,,,,
20160106-M-Doha-R16-Rafael_Nadal-Robin_Haase,2,F-II,2,2,0,1,1,1,1,,,,,,,,,,
20160106-M-Doha-R16-Rafael_Nadal-Robin_Haase,2,B-XC,12,4,3,0,1,4,8,,,,,,,,,,
20160106-M-Doha-R16-Rafael_Nadal-Robin_Haase,2,B-DTM,19,3,0,0,3,4,15,,,,,,,,,,
20160106-M-Doha-R16-Rafael_Nadal-Robin_Haase,2,B-DTL,9,4,1,0,3,2,7,,,,,,,,,,
20160106-M-Doha-R16-Rafael_Nadal-Robin_Haase,2,B-IO,4,1,0,0,1,1,3,,,,,,,,,,
20160106-M-Doha-R16-Rafael_Nadal-Robin_Haase,2,S-XC,7,0,0,0,0,1,6,,,,,,,,,,
20160106-M-Doha-R16-Rafael_Nadal-Robin_Haase,2,S-DTM,3,0,0,0,0,0,3,,,,,,,,,,
20160106-M-Doha-R16-Rafael_Nadal-Robin_Haase,2,S-DTL,4,0,0,0,0,0,4,,,,,,,,,,
20160108-M-Brisbane-QF-Lucas_Pouille-Milos_Raonic,1,F-XC,20,4,0,1,3,10,10,,,,,,,,,,
20160108-M-Brisbane-QF-Lucas_Pouille-Milos_Raonic,1,F-DTM,23,4,0,0,4,10,13,,,,,,,,,,
20160108-M-Brisbane-QF-Lucas_Pouille-Milos_Raonic,1,F-DTL,4,3,2,1,0,4,0,,,,,,,,,,
20160108-M-Brisbane-QF-Lucas_Pouille-Milos_Raonic,1,F-IO,11,2,1,0,1,9,2,,,,,,,,,,
20160108-M-Brisbane-QF-Lucas_Pouille-Milos_Raonic,1,B-XC,11,5,0,1,4,5,6,,,,,,,,,,
20160108-M-Brisbane-QF-Lucas_Pouille-Milos_Raonic,1,B-DTM,15,3,0,0,3,4,11,,,,,,,,,,
20160108-M-Brisbane-QF-Lucas_Pouille-Milos_Raonic,1,B-DTL,1,0,0,0,0,0,1,,,,,,,,,,
20160108-M-Brisbane-QF-Lucas_Pouille-Milos_Raonic,1,S-XC,5,1,1,0,0,3,2,,,,,,,,,,
20160108-M-Brisbane-QF-Lucas_Pouille-Milos_Raonic,1,S-DTM,3,1,0,0,1,0,3,,,,,,,,,,
20160108-M-Brisbane-QF-Lucas_Pouille-Milos_Raonic,2,F-XC,22,6,3,0,3,10,12,,,,,,,,,,
20160108-M-Brisbane-QF-Lucas_Pouille-Milos_Raonic,2,F-DTM,10,1,0,0,1,7,3,,,,,,,,,,
20160108-M-Brisbane-QF-Lucas_Pouille-Milos_Raonic,2,F-DTL,7,2,0,1,1,4,3,,,,,,,,,,
20160108-M-Brisbane-QF-Lucas_Pouille-Milos_Raonic,2,F-IO,22,7,4,0,3,14,8,,,,,,,,,,
20160108-M-Brisbane-QF-Lucas_Pouille-Milos_Raonic,2,F-II,1,0,0,0,0,0,1,,,,,,,,,,
20160108-M-Brisbane-QF-Lucas_Pouille-Milos_Raonic,2,B-DTM,5,1,0,0,1,1,4,,,,,,,,,,
20160108-M-Brisbane-QF-Lucas_Pouille-Milos_Raonic,2,B-DTL,2,2,2,0,0,2,0,,,,,,,,,,
20160108-M-Brisbane-QF-Lucas_Pouille-Milos_Raonic,2,S-XC,10,4,0,1,3,2,8,,,,,,,,,,
20160108-M-Brisbane-QF-Lucas_Pouille-Milos_Raonic,2,S-DTM,4,0,0,0,0,2,2,,,,,,,,,,
20160108-M-Brisbane-QF-Lucas_Pouille-Milos_Raonic,2,S-DTL,5,0,0,0,0,0,5,,,,,,,,,,
20160108-M-Doha-SF-Rafael_Nadal-Illya_Marchenko,1,F-XC,33,3,1,0,2,19,14,,,,,,,,,,
20160108-M-Doha-SF-Rafael_Nadal-Illya_Marchenko,1,F-DTM,5,0,0,0,0,3,2,,,,,,,,,,
20160108-M-Doha-SF-Rafael_Nadal-Illya_Marchenko,1,F-DTL,10,5,2,0,3,5,5,,,,,,,,,,
20160108-M-Doha-SF-Rafael_Nadal-Illya_Marchenko,1,F-IO,17,8,2,2,4,9,8,,,,,,,,,,
20160108-M-Doha-SF-Rafael_Nadal-Illya_Marchenko,1,F-II,4,0,0,0,0,3,1,,,,,,,,,,
20160108-M-Doha-SF-Rafael_Nadal-Illya_Marchenko,1,B-XC,18,4,1,2,1,8,10,,,,,,,,,,
20160108-M-Doha-SF-Rafael_Nadal-Illya_Marchenko,1,B-DTM,12,1,0,1,0,5,7,,,,,,,,,,
20160108-M-Doha-SF-Rafael_Nadal-Illya_Marchenko,1,B-DTL,7,2,1,0,1,1,6,,,,,,,,,,
20160108-M-Doha-SF-Rafael_Nadal-Illya_Marchenko,1,B-IO,2,0,0,0,0,1,1,,,,,,,,,,
20160108-M-Doha-SF-Rafael_Nadal-Illya_Marchenko,1,S-XC,3,0,0,0,0,1,2,,,,,,,,,,
20160108-M-Doha-SF-Rafael_Nadal-Illya_Marchenko,1,S-DTM,8,0,0,0,0,5,3,,,,,,,,,,
20160108-M-Doha-SF-Rafael_Nadal-Illya_Marchenko,1,S-DTL,12,1,0,1,0,6,6,,,,,,,,,,
20160108-M-Doha-SF-Rafael_Nadal-Illya_Marchenko,2,F-XC,39,8,1,2,5,19,20,,,,,,,,,,
20160108-M-Doha-SF-Rafael_Nadal-Illya_Marchenko,2,F-DTM,14,2,0,0,2,6,8,,,,,,,,,,
20160108-M-Doha-SF-Rafael_Nadal-Illya_Marchenko,2,F-DTL,8,3,1,0,2,6,2,,,,,,,,,,
20160108-M-Doha-SF-Rafael_Nadal-Illya_Marchenko,2,F-IO,13,7,2,2,3,9,4,,,,,,,,,,
20160108-M-Doha-SF-Rafael_Nadal-Illya_Marchenko,2,F-II,7,2,0,0,2,3,4,,,,,,,,,,
20160108-M-Doha-SF-Rafael_Nadal-Illya_Marchenko,2,B-XC,23,8,1,1,6,9,14,,,,,,,,,,
20160108-M-Doha-SF-Rafael_Nadal-Illya_Marchenko,2,B-DTM,14,2,0,0,2,6,8,,,,,,,,,,
20160108-M-Doha-SF-Rafael_Nadal-Illya_Marchenko,2,B-DTL,13,4,1,0,3,7,6,,,,,,,,,,
20160108-M-Doha-SF-Rafael_Nadal-Illya_Marchenko,2,B-IO,3,1,0,1,0,1,2,,,,,,,,,,
20160108-M-Doha-SF-Rafael_Nadal-Illya_Marchenko,2,S-DTM,4,0,0,0,0,1,3,,,,,,,,,,
20160108-M-Doha-SF-Rafael_Nadal-Illya_Marchenko,2,S-DTL,2,1,1,0,0,2,0,,,,,,,,,,
20160109-M-Brisbane-SF-Milos_Raonic-Bernard_Tomic,1,F-XC,24,11,6,3,2,18,6,,,,,,,,,,
20160109-M-Brisbane-SF-Milos_Raonic-Bernard_Tomic,1,F-DTM,13,6,0,0,6,1,12,,,,,,,,,,
20160109-M-Brisbane-SF-Milos_Raonic-Bernard_Tomic,1,F-DTL,10,6,2,1,3,4,6,,,,,,,,,,
20160109-M-Brisbane-SF-Milos_Raonic-Bernard_Tomic,1,F-IO,28,18,6,6,6,19,9,,,,,,,,,,
20160109-M-Brisbane-SF-Milos_Raonic-Bernard_Tomic,1,F-II,3,1,0,1,0,2,1,,,,,,,,,,
20160109-M-Brisbane-SF-Milos_Raonic-Bernard_Tomic,1,B-XC,3,0,0,0,0,2,1,,,,,,,,,,
20160109-M-Brisbane-SF-Milos_Raonic-Bernard_Tomic,1,B-DTM,6,1,0,0,1,0,6,,,,,,,,,,
20160109-M-Brisbane-SF-Milos_Raonic-Bernard_Tomic,1,B-DTL,6,3,1,1,1,4,2,,,,,,,,,,
20160109-M-Brisbane-SF-Milos_Raonic-Bernard_Tomic,1,B-IO,3,0,0,0,0,1,2,,,,,,,,,,
20160109-M-Brisbane-SF-Milos_Raonic-Bernard_Tomic,1,S-XC,11,1,0,0,1,6,5,,,,,,,,,,
20160109-M-Brisbane-SF-Milos_Raonic-Bernard_Tomic,1,S-DTM,7,0,0,0,0,4,3,,,,,,,,,,
20160109-M-Brisbane-SF-Milos_Raonic-Bernard_Tomic,1,S-DTL,2,1,0,0,1,1,1,,,,,,,,,,
20160109-M-Brisbane-SF-Milos_Raonic-Bernard_Tomic,2,F-XC,24,6,3,2,1,16,8,,,,,,,,,,
20160109-M-Brisbane-SF-Milos_Raonic-Bernard_Tomic,2,F-DTM,15,0,0,0,0,5,10,,,,,,,,,,
20160109-M-Brisbane-SF-Milos_Raonic-Bernard_Tomic,2,F-DTL,6,3,2,0,1,2,4,,,,,,,,,,
20160109-M-Brisbane-SF-Milos_Raonic-Bernard_Tomic,2,F-IO,16,6,2,0,4,9,7,,,,,,,,,,
20160109-M-Brisbane-SF-Milos_Raonic-Bernard_Tomic,2,F-II,1,1,1,0,0,1,0,,,,,,,,,,
20160109-M-Brisbane-SF-Milos_Raonic-Bernard_Tomic,2,B-XC,22,5,1,1,3,12,10,,,,,,,,,,
20160109-M-Brisbane-SF-Milos_Raonic-Bernard_Tomic,2,B-DTM,8,0,0,0,0,4,4,,,,,,,,,,
20160109-M-Brisbane-SF-Milos_Raonic-Bernard_Tomic,2,B-DTL,4,1,0,1,0,2,2,,,,,,,,,,
20160109-M-Brisbane-SF-Milos_Raonic-Bernard_Tomic,2,B-IO,4,1,0,0,1,3,1,,,,,,,,,,
20160109-M-Brisbane-SF-Milos_Raonic-Bernard_Tomic,2,S-XC,4,0,0,0,0,3,1,,,,,,,,,,
20160109-M-Brisbane-SF-Milos_Raonic-Bernard_Tomic,2,S-DTM,2,0,0,0,0,1,1,,,,,,,,,,
20160109-M-Brisbane-SF-Milos_Raonic-Bernard_Tomic,2,S-DTL,2,1,0,0,1,0,2,,,,,,,,,,
20160109-M-Brisbane-SF-Milos_Raonic-Bernard_Tomic,2,S-IO,1,0,0,0,0,0,1,,,,,,,,,,
20160109-M-Brisbane-SF-Roger_Federer-Dominic_Thiem,1,F-XC,12,5,0,4,1,8,4,,,,,,,,,,
20160109-M-Brisbane-SF-Roger_Federer-Dominic_Thiem,1,F-DTM,20,1,0,0,1,11,9,,,,,,,,,,
20160109-M-Brisbane-SF-Roger_Federer-Dominic_Thiem,1,F-DTL,3,1,0,1,0,3,0,,,,,,,,,,
20160109-M-Brisbane-SF-Roger_Federer-Dominic_Thiem,1,F-IO,11,3,1,0,2,7,4,,,,,,,,,,
20160109-M-Brisbane-SF-Roger_Federer-Dominic_Thiem,1,F-II,1,1,1,0,0,1,0,,,,,,,,,,
20160109-M-Brisbane-SF-Roger_Federer-Dominic_Thiem,1,B-XC,17,4,0,1,3,12,5,,,,,,,,,,
20160109-M-Brisbane-SF-Roger_Federer-Dominic_Thiem,1,B-DTM,17,1,0,1,0,10,7,,,,,,,,,,
20160109-M-Brisbane-SF-Roger_Federer-Dominic_Thiem,1,B-DTL,3,1,0,1,0,3,0,,,,,,,,,,
20160109-M-Brisbane-SF-Roger_Federer-Dominic_Thiem,1,B-IO,2,0,0,0,0,2,0,,,,,,,,,,
20160109-M-Brisbane-SF-Roger_Federer-Dominic_Thiem,1,S-XC,7,1,0,0,1,4,3,,,,,,,,,,
20160109-M-Brisbane-SF-Roger_Federer-Dominic_Thiem,1,S-DTM,4,0,0,0,0,1,3,,,,,,,,,,
20160109-M-Brisbane-SF-Roger_Federer-Dominic_Thiem,2,F-XC,22,7,4,1,2,11,11,,,,,,,,,,
20160109-M-Brisbane-SF-Roger_Federer-Dominic_Thiem,2,F-DTM,19,4,0,1,3,4,15,,,,,,,,,,
20160109-M-Brisbane-SF-Roger_Federer-Dominic_Thiem,2,F-DTL,2,0,0,0,0,1,1,,,,,,,,,,
20160109-M-Brisbane-SF-Roger_Federer-Dominic_Thiem,2,F-IO,22,8,5,0,3,10,12,,,,,,,,,,
20160109-M-Brisbane-SF-Roger_Federer-Dominic_Thiem,2,F-II,3,2,0,0,2,0,3,,,,,,,,,,
20160109-M-Brisbane-SF-Roger_Federer-Dominic_Thiem,2,B-XC,19,7,4,1,2,10,9,,,,,,,,,,
20160109-M-Brisbane-SF-Roger_Federer-Dominic_Thiem,2,B-DTM,14,3,0,1,2,5,9,,,,,,,,,,
20160109-M-Brisbane-SF-Roger_Federer-Dominic_Thiem,2,B-DTL,4,2,0,0,2,1,3,,,,,,,,,,
20160109-M-Brisbane-SF-Roger_Federer-Dominic_Thiem,2,B-IO,1,1,0,0,1,0,1,,,,,,,,,,
20160109-M-Brisbane-SF-Roger_Federer-Dominic_Thiem,2,S-XC,5,1,0,0,1,1,4,,,,,,,,,,
20160109-M-Brisbane-SF-Roger_Federer-Dominic_Thiem,2,S-DTM,5,0,0,0,0,2,3,,,,,,,,,,
20160109-M-Brisbane-SF-Roger_Federer-Dominic_Thiem,2,S-DTL,1,0,0,0,0,0,1,,,,,,,,,,
20160109-M-Brisbane-SF-Roger_Federer-Dominic_Thiem,2,S-IO,1,0,0,0,0,1,0,,,,,,,,,,
20160109-M-Doha-SF-Novak_Djokovic-Tomas_Berdych,1,F-XC,41,10,4,3,3,26,15,,,,,,,,,,
20160109-M-Doha-SF-Novak_Djokovic-Tomas_Berdych,1,F-DTM,17,4,0,1,3,8,9,,,,,,,,,,
20160109-M-Doha-SF-Novak_Djokovic-Tomas_Berdych,1,F-DTL,9,2,0,1,1,4,5,,,,,,,,,,
20160109-M-Doha-SF-Novak_Djokovic-Tomas_Berdych,1,F-IO,21,8,3,1,4,11,10,,,,,,,,,,
20160109-M-Doha-SF-Novak_Djokovic-Tomas_Berdych,1,F-II,1,0,0,0,0,1,0,,,,,,,,,,
20160109-M-Doha-SF-Novak_Djokovic-Tomas_Berdych,1,B-XC,69,7,1,1,5,33,36,,,,,,,,,,
20160109-M-Doha-SF-Novak_Djokovic-Tomas_Berdych,1,B-DTM,23,2,0,1,1,11,12,,,,,,,,,,
20160109-M-Doha-SF-Novak_Djokovic-Tomas_Berdych,1,B-DTL,15,2,2,0,0,9,6,,,,,,,,,,
20160109-M-Doha-SF-Novak_Djokovic-Tomas_Berdych,1,B-IO,4,0,0,0,0,4,0,,,,,,,,,,
20160109-M-Doha-SF-Novak_Djokovic-Tomas_Berdych,1,S-XC,21,1,0,0,1,8,13,,,,,,,,,,
20160109-M-Doha-SF-Novak_Djokovic-Tomas_Berdych,1,S-DTM,5,0,0,0,0,2,3,,,,,,,,,,
20160109-M-Doha-SF-Novak_Djokovic-Tomas_Berdych,2,F-XC,40,13,4,2,7,17,23,,,,,,,,,,
20160109-M-Doha-SF-Novak_Djokovic-Tomas_Berdych,2,F-DTM,12,0,0,0,0,5,7,,,,,,,,,,
20160109-M-Doha-SF-Novak_Djokovic-Tomas_Berdych,2,F-DTL,22,10,3,1,6,11,11,,,,,,,,,,
20160109-M-Doha-SF-Novak_Djokovic-Tomas_Berdych,2,F-IO,37,8,3,2,3,20,17,,,,,,,,,,
20160109-M-Doha-SF-Novak_Djokovic-Tomas_Berdych,2,F-II,3,2,0,1,1,2,1,,,,,,,,,,
20160109-M-Doha-SF-Novak_Djokovic-Tomas_Berdych,2,B-XC,46,4,0,0,4,25,21,,,,,,,,,,
20160109-M-Doha-SF-Novak_Djokovic-Tomas_Berdych,2,B-DTM,23,1,0,0,1,12,11,,,,,,,,,,
20160109-M-Doha-SF-Novak_Djokovic-Tomas_Berdych,2,B-DTL,8,2,1,0,1,4,4,,,,,,,,,,
20160109-M-Doha-SF-Novak_Djokovic-Tomas_Berdych,2,B-IO,4,0,0,0,0,3,1,,,,,,,,,,
20160109-M-Doha-SF-Novak_Djokovic-Tomas_Berdych,2,S-XC,24,1,0,0,1,12,12,,,,,,,,,,
20160109-M-Doha-SF-Novak_Djokovic-Tomas_Berdych,2,S-DTM,3,0,0,0,0,0,3,,,,,,,,,,
20160109-M-Doha-SF-Novak_Djokovic-Tomas_Berdych,2,S-DTL,3,0,0,0,0,1,2,,,,,,,,,,
20160110-M-Brisbane-F-Roger_Federer-Milos_Raonic,1,F-XC,15,4,2,0,2,8,7,,,,,,,,,,
20160110-M-Brisbane-F-Roger_Federer-Milos_Raonic,1,F-DTM,23,1,0,1,0,14,9,,,,,,,,,,
20160110-M-Brisbane-F-Roger_Federer-Milos_Raonic,1,F-DTL,7,2,0,0,2,4,3,,,,,,,,,,
20160110-M-Brisbane-F-Roger_Federer-Milos_Raonic,1,F-IO,8,1,0,0,1,1,7,,,,,,,,,,
20160110-M-Brisbane-F-Roger_Federer-Milos_Raonic,1,F-II,1,0,0,0,0,0,1,,,,,,,,,,
20160110-M-Brisbane-F-Roger_Federer-Milos_Raonic,1,B-XC,15,5,0,0,5,3,12,,,,,,,,,,
20160110-M-Brisbane-F-Roger_Federer-Milos_Raonic,1,B-DTM,18,3,0,0,3,11,7,,,,,,,,,,
20160110-M-Brisbane-F-Roger_Federer-Milos_Raonic,1,B-DTL,5,4,2,0,2,2,3,,,,,,,,,,
20160110-M-Brisbane-F-Roger_Federer-Milos_Raonic,1,B-IO,1,0,0,0,0,0,1,,,,,,,,,,
20160110-M-Brisbane-F-Roger_Federer-Milos_Raonic,1,S-XC,5,0,0,0,0,2,3,,,,,,,,,,
20160110-M-Brisbane-F-Roger_Federer-Milos_Raonic,1,S-DTM,1,0,0,0,0,0,1,,,,,,,,,,
20160110-M-Brisbane-F-Roger_Federer-Milos_Raonic,1,S-DTL,1,1,1,0,0,1,0,,,,,,,,,,
20160110-M-Brisbane-F-Roger_Federer-Milos_Raonic,2,F-XC,20,9,4,2,3,13,7,,,,,,,,,,
20160110-M-Brisbane-F-Roger_Federer-Milos_Raonic,2,F-DTM,11,1,0,1,0,5,6,,,,,,,,,,
20160110-M-Brisbane-F-Roger_Federer-Milos_Raonic,2,F-DTL,5,3,0,2,1,4,1,,,,,,,,,,
20160110-M-Brisbane-F-Roger_Federer-Milos_Raonic,2,F-IO,32,12,1,5,6,21,11,,,,,,,,,,
20160110-M-Brisbane-F-Roger_Federer-Milos_Raonic,2,F-II,2,2,2,0,0,2,0,,,,,,,,,,
20160110-M-Brisbane-F-Roger_Federer-Milos_Raonic,2,B-XC,12,6,0,2,4,4,8,,,,,,,,,,
20160110-M-Brisbane-F-Roger_Federer-Milos_Raonic,2,B-DTM,9,1,0,1,0,4,5,,,,,,,,,,
20160110-M-Brisbane-F-Roger_Federer-Milos_Raonic,2,B-DTL,3,2,2,0,0,2,1,,,,,,,,,,
20160110-M-Brisbane-F-Roger_Federer-Milos_Raonic,2,B-IO,2,2,0,0,2,0,2,,,,,,,,,,
20160110-M-Brisbane-F-Roger_Federer-Milos_Raonic,2,S-XC,7,1,0,0,1,1,6,,,,,,,,,,
20160110-M-Brisbane-F-Roger_Federer-Milos_Raonic,2,S-DTM,3,0,0,0,0,2,1,,,,,,,,,,
20160110-M-Brisbane-F-Roger_Federer-Milos_Raonic,2,S-IO,1,0,0,0,0,1,0,,,,,,,,,,
20160110-M-Doha-F-Novak_Djokovic-Rafael_Nadal,1,F-XC,48,9,6,2,1,35,13,,,,,,,,,,
20160110-M-Doha-F-Novak_Djokovic-Rafael_Nadal,1,F-DTM,15,1,0,0,1,7,8,,,,,,,,,,
20160110-M-Doha-F-Novak_Djokovic-Rafael_Nadal,1,F-DTL,18,8,5,1,2,13,5,,,,,,,,,,
20160110-M-Doha-F-Novak_Djokovic-Rafael_Nadal,1,F-IO,24,10,6,2,2,16,8,,,,,,,,,,
20160110-M-Doha-F-Novak_Djokovic-Rafael_Nadal,1,F-II,1,0,0,0,0,0,1,,,,,,,,,,
20160110-M-Doha-F-Novak_Djokovic-Rafael_Nadal,1,B-XC,41,3,2,1,0,29,12,,,,,,,,,,
20160110-M-Doha-F-Novak_Djokovic-Rafael_Nadal,1,B-DTM,21,3,0,1,2,12,9,,,,,,,,,,
20160110-M-Doha-F-Novak_Djokovic-Rafael_Nadal,1,B-DTL,14,4,1,2,1,9,5,,,,,,,,,,
20160110-M-Doha-F-Novak_Djokovic-Rafael_Nadal,1,B-IO,7,2,0,1,1,5,2,,,,,,,,,,
20160110-M-Doha-F-Novak_Djokovic-Rafael_Nadal,1,S-XC,1,0,0,0,0,1,0,,,,,,,,,,
20160110-M-Doha-F-Novak_Djokovic-Rafael_Nadal,1,S-DTM,2,0,0,0,0,0,2,,,,,,,,,,
20160110-M-Doha-F-Novak_Djokovic-Rafael_Nadal,1,S-DTL,2,0,0,0,0,0,2,,,,,,,,,,
20160110-M-Doha-F-Novak_Djokovic-Rafael_Nadal,1,S-IO,1,0,0,0,0,1,0,,,,,,,,,,
20160110-M-Doha-F-Novak_Djokovic-Rafael_Nadal,2,F-XC,47,1,0,1,0,22,25,,,,,,,,,,
20160110-M-Doha-F-Novak_Djokovic-Rafael_Nadal,2,F-DTM,25,1,0,0,1,7,18,,,,,,,,,,
20160110-M-Doha-F-Novak_Djokovic-Rafael_Nadal,2,F-DTL,21,6,1,2,3,10,11,,,,,,,,,,
20160110-M-Doha-F-Novak_Djokovic-Rafael_Nadal,2,F-IO,11,3,0,0,3,5,6,,,,,,,,,,
20160110-M-Doha-F-Novak_Djokovic-Rafael_Nadal,2,F-II,2,1,0,0,1,0,2,,,,,,,,,,
20160110-M-Doha-F-Novak_Djokovic-Rafael_Nadal,2,B-XC,31,2,0,2,0,12,19,,,,,,,,,,
20160110-M-Doha-F-Novak_Djokovic-Rafael_Nadal,2,B-DTM,17,0,0,0,0,6,11,,,,,,,,,,
20160110-M-Doha-F-Novak_Djokovic-Rafael_Nadal,2,B-DTL,9,1,1,0,0,2,7,,,,,,,,,,
20160110-M-Doha-F-Novak_Djokovic-Rafael_Nadal,2,B-IO,3,0,0,0,0,0,3,,,,,,,,,,
20160110-M-Doha-F-Novak_Djokovic-Rafael_Nadal,2,S-XC,2,0,0,0,0,0,2,,,,,,,,,,
20160110-M-Doha-F-Novak_Djokovic-Rafael_Nadal,2,S-DTM,11,0,0,0,0,2,9,,,,,,,,,,
20160110-M-Doha-F-Novak_Djokovic-Rafael_Nadal,2,S-DTL,8,1,0,0,1,3,5,,,,,,,,,,
20160110-M-Doha-F-Novak_Djokovic-Rafael_Nadal,2,S-IO,1,0,0,0,0,0,1,,,,,,,,,,
20160116-M-Chennai-F-Stanislas_Wawrinka-Borna_Coric,1,F-XC,25,8,1,3,4,13,12,,,,,,,,,,
20160116-M-Chennai-F-Stanislas_Wawrinka-Borna_Coric,1,F-DTM,7,0,0,0,0,5,2,,,,,,,,,,
20160116-M-Chennai-F-Stanislas_Wawrinka-Borna_Coric,1,F-DTL,6,2,1,0,1,5,1,,,,,,,,,,
20160116-M-Chennai-F-Stanislas_Wawrinka-Borna_Coric,1,F-IO,11,4,2,1,1,8,3,,,,,,,,,,
20160116-M-Chennai-F-Stanislas_Wawrinka-Borna_Coric,1,F-II,7,2,1,1,0,5,2,,,,,,,,,,
20160116-M-Chennai-F-Stanislas_Wawrinka-Borna_Coric,1,B-XC,22,5,2,1,2,11,11,,,,,,,,,,
20160116-M-Chennai-F-Stanislas_Wawrinka-Borna_Coric,1,B-DTM,12,5,0,1,4,5,7,,,,,,,,,,
20160116-M-Chennai-F-Stanislas_Wawrinka-Borna_Coric,1,B-DTL,9,3,1,0,2,5,4,,,,,,,,,,
20160116-M-Chennai-F-Stanislas_Wawrinka-Borna_Coric,1,B-IO,3,3,1,1,1,2,1,,,,,,,,,,
20160116-M-Chennai-F-Stanislas_Wawrinka-Borna_Coric,1,S-XC,15,0,0,0,0,7,8,,,,,,,,,,
20160116-M-Chennai-F-Stanislas_Wawrinka-Borna_Coric,1,S-DTM,1,0,0,0,0,0,1,,,,,,,,,,
20160116-M-Chennai-F-Stanislas_Wawrinka-Borna_Coric,1,S-DTL,1,0,0,0,0,0,1,,,,,,,,,,
20160116-M-Chennai-F-Stanislas_Wawrinka-Borna_Coric,2,F-XC,25,4,2,0,2,10,15,,,,,,,,,,
20160116-M-Chennai-F-Stanislas_Wawrinka-Borna_Coric,2,F-DTM,8,1,0,1,0,4,4,,,,,,,,,,
20160116-M-Chennai-F-Stanislas_Wawrinka-Borna_Coric,2,F-DTL,11,2,0,0,2,6,5,,,,,,,,,,
20160116-M-Chennai-F-Stanislas_Wawrinka-Borna_Coric,2,F-IO,13,1,0,0,1,8,5,,,,,,,,,,
20160116-M-Chennai-F-Stanislas_Wawrinka-Borna_Coric,2,F-II,4,3,0,1,2,1,3,,,,,,,,,,
20160116-M-Chennai-F-Stanislas_Wawrinka-Borna_Coric,2,B-XC,29,4,0,1,3,13,16,,,,,,,,,,
20160116-M-Chennai-F-Stanislas_Wawrinka-Borna_Coric,2,B-DTM,8,0,0,0,0,4,4,,,,,,,,,,
20160116-M-Chennai-F-Stanislas_Wawrinka-Borna_Coric,2,B-DTL,5,2,0,1,1,2,3,,,,,,,,,,
20160116-M-Chennai-F-Stanislas_Wawrinka-Borna_Coric,2,S-XC,4,0,0,0,0,0,4,,,,,,,,,,
20160116-M-Chennai-F-Stanislas_Wawrinka-Borna_Coric,2,S-DTM,4,0,0,0,0,1,3,,,,,,,,,,
20160116-M-Chennai-F-Stanislas_Wawrinka-Borna_Coric,2,S-DTL,2,0,0,0,0,0,2,,,,,,,,,,
20160116-M-Sydney-F-Viktor_Troicki-Grigor_Dimitrov,1,F-XC,59,9,0,4,5,23,36,,,,,,,,,,
20160116-M-Sydney-F-Viktor_Troicki-Grigor_Dimitrov,1,F-DTM,94,3,0,0,3,42,52,,,,,,,,,,
20160116-M-Sydney-F-Viktor_Troicki-Grigor_Dimitrov,1,F-DTL,28,8,3,1,4,11,17,,,,,,,,,,
20160116-M-Sydney-F-Viktor_Troicki-Grigor_Dimitrov,1,F-IO,51,11,2,1,8,23,28,,,,,,,,,,
20160116-M-Sydney-F-Viktor_Troicki-Grigor_Dimitrov,1,F-II,1,0,0,0,0,1,0,,,,,,,,,,
20160116-M-Sydney-F-Viktor_Troicki-Grigor_Dimitrov,1,B-XC,115,9,2,3,4,44,71,,,,,,,,,,
20160116-M-Sydney-F-Viktor_Troicki-Grigor_Dimitrov,1,B-DTM,76,8,1,2,5,34,42,,,,,,,,,,
20160116-M-Sydney-F-Viktor_Troicki-Grigor_Dimitrov,1,B-DTL,18,10,2,4,4,8,10,,,,,,,,,,
20160116-M-Sydney-F-Viktor_Troicki-Grigor_Dimitrov,1,B-IO,9,5,1,2,2,6,3,,,,,,,,,,
20160116-M-Sydney-F-Viktor_Troicki-Grigor_Dimitrov,1,S-XC,1,1,0,0,1,0,1,,,,,,,,,,
20160116-M-Sydney-F-Viktor_Troicki-Grigor_Dimitrov,1,S-DTM,3,0,0,0,0,1,2,,,,,,,,,,
20160116-M-Sydney-F-Viktor_Troicki-Grigor_Dimitrov,1,S-DTL,3,1,0,0,1,0,3,,,,,,,,,,
20160116-M-Sydney-F-Viktor_Troicki-Grigor_Dimitrov,1,S-IO,2,1,1,0,0,2,0,,,,,,,,,,
20160116-M-Sydney-F-Viktor_Troicki-Grigor_Dimitrov,2,F-XC,86,11,6,2,3,50,36,,,,,,,,,,
20160116-M-Sydney-F-Viktor_Troicki-Grigor_Dimitrov,2,F-DTM,73,2,0,1,1,38,35,,,,,,,,,,
20160116-M-Sydney-F-Viktor_Troicki-Grigor_Dimitrov,2,F-DTL,14,7,2,2,3,7,7,,,,,,,,,,
20160116-M-Sydney-F-Viktor_Troicki-Grigor_Dimitrov,2,F-IO,63,23,7,8,8,43,20,,,,,,,,,,
20160116-M-Sydney-F-Viktor_Troicki-Grigor_Dimitrov,2,F-II,11,3,1,0,2,7,4,,,,,,,,,,
20160116-M-Sydney-F-Viktor_Troicki-Grigor_Dimitrov,2,B-XC,45,6,0,1,5,23,22,,,,,,,,,,
20160116-M-Sydney-F-Viktor_Troicki-Grigor_Dimitrov,2,B-DTM,76,6,0,1,5,42,34,,,,,,,,,,
20160116-M-Sydney-F-Viktor_Troicki-Grigor_Dimitrov,2,B-DTL,13,9,3,1,5,7,6,,,,,,,,,,
20160116-M-Sydney-F-Viktor_Troicki-Grigor_Dimitrov,2,B-IO,3,1,1,0,0,3,0,,,,,,,,,,
20160116-M-Sydney-F-Viktor_Troicki-Grigor_Dimitrov,2,S-XC,16,1,0,0,1,7,9,,,,,,,,,,
20160116-M-Sydney-F-Viktor_Troicki-Grigor_Dimitrov,2,S-DTM,45,1,0,0,1,25,20,,,,,,,,,,
20160116-M-Sydney-F-Viktor_Troicki-Grigor_Dimitrov,2,S-DTL,10,0,0,0,0,6,4,,,,,,,,,,
20160116-M-Sydney-F-Viktor_Troicki-Grigor_Dimitrov,2,S-IO,2,0,0,0,0,1,1,,,,,,,,,,
20160118-M-Manila_CH-R32-Ruben_Gonzales-Igor_Sijsling,1,F-XC,9,3,0,0,3,1,8,,,,,,,,,,
20160118-M-Manila_CH-R32-Ruben_Gonzales-Igor_Sijsling,1,F-DTM,2,2,0,0,2,0,2,,,,,,,,,,
20160118-M-Manila_CH-R32-Ruben_Gonzales-Igor_Sijsling,1,F-DTL,2,1,0,1,0,1,1,,,,,,,,,,
20160118-M-Manila_CH-R32-Ruben_Gonzales-Igor_Sijsling,1,F-IO,10,3,1,0,2,3,7,,,,,,,,,,
20160118-M-Manila_CH-R32-Ruben_Gonzales-Igor_Sijsling,1,F-II,4,3,0,0,3,0,4,,,,,,,,,,
20160118-M-Manila_CH-R32-Ruben_Gonzales-Igor_Sijsling,1,B-XC,2,0,0,0,0,0,2,,,,,,,,,,
20160118-M-Manila_CH-R32-Ruben_Gonzales-Igor_Sijsling,1,B-DTM,1,0,0,0,0,0,1,,,,,,,,,,
20160118-M-Manila_CH-R32-Ruben_Gonzales-Igor_Sijsling,1,S-XC,4,0,0,0,0,0,4,,,,,,,,,,
20160118-M-Manila_CH-R32-Ruben_Gonzales-Igor_Sijsling,1,S-DTM,4,0,0,0,0,0,4,,,,,,,,,,
20160118-M-Manila_CH-R32-Ruben_Gonzales-Igor_Sijsling,1,S-DTL,1,1,0,0,1,0,1,,,,,,,,,,
20160118-M-Manila_CH-R32-Ruben_Gonzales-Igor_Sijsling,2,F-XC,7,3,3,0,0,6,1,,,,,,,,,,
20160118-M-Manila_CH-R32-Ruben_Gonzales-Igor_Sijsling,2,F-DTM,6,0,0,0,0,6,0,,,,,,,,,,
20160118-M-Manila_CH-R32-Ruben_Gonzales-Igor_Sijsling,2,F-DTL,5,0,0,0,0,4,1,,,,,,,,,,
20160118-M-Manila_CH-R32-Ruben_Gonzales-Igor_Sijsling,2,F-IO,6,3,2,1,0,5,1,,,,,,,,,,
20160118-M-Manila_CH-R32-Ruben_Gonzales-Igor_Sijsling,2,F-II,3,2,2,0,0,3,0,,,,,,,,,,
20160118-M-Manila_CH-R32-Ruben_Gonzales-Igor_Sijsling,2,B-XC,8,4,2,2,0,8,0,,,,,,,,,,
20160118-M-Manila_CH-R32-Ruben_Gonzales-Igor_Sijsling,2,B-DTM,5,0,0,0,0,1,4,,,,,,,,,,
20160118-M-Manila_CH-R32-Ruben_Gonzales-Igor_Sijsling,2,B-DTL,4,2,1,1,0,4,0,,,,,,,,,,
20160118-M-Manila_CH-R32-Ruben_Gonzales-Igor_Sijsling,2,B-IO,2,2,1,1,0,2,0,,,,,,,,,,
20160118-M-Manila_CH-R32-Ruben_Gonzales-Igor_Sijsling,2,S-XC,4,0,0,0,0,4,0,,,,,,,,,,
20160118-M-Manila_CH-R32-Ruben_Gonzales-Igor_Sijsling,2,S-DTM,2,0,0,0,0,0,2,,,,,,,,,,
20160118-M-Manila_CH-R32-Ruben_Gonzales-Igor_Sijsling,2,S-DTL,1,0,0,0,0,1,0,,,,,,,,,,
20160122-M-Australian_Open-R32-Gilles_Simon-Federico_Delbonis,1,F-XC,47,9,4,1,4,28,19,,,,,,,,,,
20160122-M-Australian_Open-R32-Gilles_Simon-Federico_Delbonis,1,F-DTM,43,1,0,1,0,26,17,,,,,,,,,,
20160122-M-Australian_Open-R32-Gilles_Simon-Federico_Delbonis,1,F-DTL,9,3,3,0,0,9,0,,,,,,,,,,
20160122-M-Australian_Open-R32-Gilles_Simon-Federico_Delbonis,1,F-IO,30,9,4,3,2,18,12,,,,,,,,,,
20160122-M-Australian_Open-R32-Gilles_Simon-Federico_Delbonis,1,B-XC,44,5,2,2,1,30,14,,,,,,,,,,
20160122-M-Australian_Open-R32-Gilles_Simon-Federico_Delbonis,1,B-DTM,49,3,0,2,1,36,13,,,,,,,,,,
20160122-M-Australian_Open-R32-Gilles_Simon-Federico_Delbonis,1,B-DTL,10,4,2,0,2,5,5,,,,,,,,,,
20160122-M-Australian_Open-R32-Gilles_Simon-Federico_Delbonis,1,B-IO,8,2,1,0,1,4,4,,,,,,,,,,
20160122-M-Australian_Open-R32-Gilles_Simon-Federico_Delbonis,1,S-DTM,2,0,0,0,0,1,1,,,,,,,,,,
20160122-M-Australian_Open-R32-Gilles_Simon-Federico_Delbonis,2,F-XC,63,9,3,1,5,17,46,,,,,,,,,,
20160122-M-Australian_Open-R32-Gilles_Simon-Federico_Delbonis,2,F-DTM,56,6,2,0,4,20,36,,,,,,,,,,
20160122-M-Australian_Open-R32-Gilles_Simon-Federico_Delbonis,2,F-DTL,18,9,2,2,5,8,10,,,,,,,,,,
20160122-M-Australian_Open-R32-Gilles_Simon-Federico_Delbonis,2,F-IO,23,11,5,2,4,8,15,,,,,,,,,,
20160122-M-Australian_Open-R32-Gilles_Simon-Federico_Delbonis,2,F-II,2,1,1,0,0,1,1,,,,,,,,,,
20160122-M-Australian_Open-R32-Gilles_Simon-Federico_Delbonis,2,B-XC,31,9,1,1,7,10,21,,,,,,,,,,
20160122-M-Australian_Open-R32-Gilles_Simon-Federico_Delbonis,2,B-DTM,39,3,0,0,3,15,24,,,,,,,,,,
20160122-M-Australian_Open-R32-Gilles_Simon-Federico_Delbonis,2,B-DTL,4,1,0,0,1,2,2,,,,,,,,,,
20160122-M-Australian_Open-R32-Gilles_Simon-Federico_Delbonis,2,B-IO,5,2,0,0,2,1,4,,,,,,,,,,
20160122-M-Australian_Open-R32-Gilles_Simon-Federico_Delbonis,2,S-XC,2,0,0,0,0,1,1,,,,,,,,,,
20160122-M-Australian_Open-R32-Gilles_Simon-Federico_Delbonis,2,S-DTM,13,3,0,1,2,8,5,,,,,,,,,,
20160122-M-Australian_Open-R32-Gilles_Simon-Federico_Delbonis,2,S-DTL,5,1,0,0,1,2,3,,,,,,,,,,
20160124-M-Australian_Open-R16-Novak_Djokovic-Gilles_Simon,1,F-XC,207,36,7,12,17,95,112,,,,,,,,,,
20160124-M-Australian_Open-R16-Novak_Djokovic-Gilles_Simon,1,F-DTM,74,4,0,0,4,30,44,,,,,,,,,,
20160124-M-Australian_Open-R16-Novak_Djokovic-Gilles_Simon,1,F-DTL,76,21,4,4,13,40,36,,,,,,,,,,
20160124-M-Australian_Open-R16-Novak_Djokovic-Gilles_Simon,1,F-IO,103,31,12,5,14,50,53,,,,,,,,,,
20160124-M-Australian_Open-R16-Novak_Djokovic-Gilles_Simon,1,F-II,8,3,1,2,0,4,4,,,,,,,,,,
20160124-M-Australian_Open-R16-Novak_Djokovic-Gilles_Simon,1,B-XC,175,21,3,3,15,87,88,,,,,,,,,,
20160124-M-Australian_Open-R16-Novak_Djokovic-Gilles_Simon,1,B-DTM,83,3,0,0,3,30,53,,,,,,,,,,
20160124-M-Australian_Open-R16-Novak_Djokovic-Gilles_Simon,1,B-DTL,61,18,3,3,12,29,32,,,,,,,,,,
20160124-M-Australian_Open-R16-Novak_Djokovic-Gilles_Simon,1,B-IO,35,7,3,1,3,17,18,,,,,,,,,,
20160124-M-Australian_Open-R16-Novak_Djokovic-Gilles_Simon,1,S-XC,45,7,0,0,7,20,25,,,,,,,,,,
20160124-M-Australian_Open-R16-Novak_Djokovic-Gilles_Simon,1,S-DTM,28,1,0,0,1,10,18,,,,,,,,,,
20160124-M-Australian_Open-R16-Novak_Djokovic-Gilles_Simon,1,S-DTL,4,1,0,0,1,1,3,,,,,,,,,,
20160124-M-Australian_Open-R16-Novak_Djokovic-Gilles_Simon,1,S-IO,2,0,0,0,0,1,1,,,,,,,,,,
20160124-M-Australian_Open-R16-Novak_Djokovic-Gilles_Simon,2,F-XC,172,10,3,3,4,98,74,,,,,,,,,,
20160124-M-Australian_Open-R16-Novak_Djokovic-Gilles_Simon,2,F-DTM,136,13,1,0,12,79,57,,,,,,,,,,
20160124-M-Australian_Open-R16-Novak_Djokovic-Gilles_Simon,2,F-DTL,47,12,4,3,5,28,19,,,,,,,,,,
20160124-M-Australian_Open-R16-Novak_Djokovic-Gilles_Simon,2,F-IO,55,10,4,3,3,32,23,,,,,,,,,,
20160124-M-Australian_Open-R16-Novak_Djokovic-Gilles_Simon,2,B-XC,236,14,4,2,8,131,105,,,,,,,,,,
20160124-M-Australian_Open-R16-Novak_Djokovic-Gilles_Simon,2,B-DTM,153,11,0,0,11,72,81,,,,,,,,,,
20160124-M-Australian_Open-R16-Novak_Djokovic-Gilles_Simon,2,B-DTL,53,15,6,3,6,30,23,,,,,,,,,,
20160124-M-Australian_Open-R16-Novak_Djokovic-Gilles_Simon,2,B-IO,24,4,0,2,2,10,14,,,,,,,,,,
20160124-M-Australian_Open-R16-Novak_Djokovic-Gilles_Simon,2,S-XC,7,1,1,0,0,3,4,,,,,,,,,,
20160124-M-Australian_Open-R16-Novak_Djokovic-Gilles_Simon,2,S-DTM,6,0,0,0,0,1,5,,,,,,,,,,
20160124-M-Australian_Open-R16-Novak_Djokovic-Gilles_Simon,2,S-DTL,1,1,0,0,1,0,1,,,,,,,,,,
20160125-M-Australian_Open-R16-Stanislas_Wawrinka-Milos_Raonic,1,F-XC,60,27,9,6,12,34,26,,,,,,,,,,
20160125-M-Australian_Open-R16-Stanislas_Wawrinka-Milos_Raonic,1,F-DTM,47,4,1,0,3,21,26,,,,,,,,,,
20160125-M-Australian_Open-R16-Stanislas_Wawrinka-Milos_Raonic,1,F-DTL,17,9,4,1,4,10,7,,,,,,,,,,
20160125-M-Australian_Open-R16-Stanislas_Wawrinka-Milos_Raonic,1,F-IO,25,11,4,6,1,16,9,,,,,,,,,,
20160125-M-Australian_Open-R16-Stanislas_Wawrinka-Milos_Raonic,1,F-II,2,1,0,0,1,1,1,,,,,,,,,,
20160125-M-Australian_Open-R16-Stanislas_Wawrinka-Milos_Raonic,1,B-XC,31,9,7,1,1,18,13,,,,,,,,,,
20160125-M-Australian_Open-R16-Stanislas_Wawrinka-Milos_Raonic,1,B-DTM,34,3,1,1,1,20,14,,,,,,,,,,
20160125-M-Australian_Open-R16-Stanislas_Wawrinka-Milos_Raonic,1,B-DTL,6,3,2,1,0,4,2,,,,,,,,,,
20160125-M-Australian_Open-R16-Stanislas_Wawrinka-Milos_Raonic,1,B-IO,5,3,2,1,0,4,1,,,,,,,,,,
20160125-M-Australian_Open-R16-Stanislas_Wawrinka-Milos_Raonic,1,S-XC,19,1,0,0,1,7,12,,,,,,,,,,
20160125-M-Australian_Open-R16-Stanislas_Wawrinka-Milos_Raonic,1,S-DTM,13,0,0,0,0,7,6,,,,,,,,,,
20160125-M-Australian_Open-R16-Stanislas_Wawrinka-Milos_Raonic,1,S-DTL,3,1,0,0,1,0,3,,,,,,,,,,
20160125-M-Australian_Open-R16-Stanislas_Wawrinka-Milos_Raonic,2,F-XC,43,13,6,3,4,21,22,,,,,,,,,,
20160125-M-Australian_Open-R16-Stanislas_Wawrinka-Milos_Raonic,2,F-DTM,26,3,0,1,2,12,14,,,,,,,,,,
20160125-M-Australian_Open-R16-Stanislas_Wawrinka-Milos_Raonic,2,F-DTL,3,1,1,0,0,1,2,,,,,,,,,,
20160125-M-Australian_Open-R16-Stanislas_Wawrinka-Milos_Raonic,2,F-IO,54,18,2,3,13,23,31,,,,,,,,,,
20160125-M-Australian_Open-R16-Stanislas_Wawrinka-Milos_Raonic,2,F-II,3,3,3,0,0,3,0,,,,,,,,,,
20160125-M-Australian_Open-R16-Stanislas_Wawrinka-Milos_Raonic,2,B-XC,13,1,0,1,0,4,9,,,,,,,,,,
20160125-M-Australian_Open-R16-Stanislas_Wawrinka-Milos_Raonic,2,B-DTM,17,4,0,1,3,4,13,,,,,,,,,,
20160125-M-Australian_Open-R16-Stanislas_Wawrinka-Milos_Raonic,2,B-DTL,3,1,0,0,1,1,2,,,,,,,,,,
20160125-M-Australian_Open-R16-Stanislas_Wawrinka-Milos_Raonic,2,B-IO,4,2,1,0,1,2,2,,,,,,,,,,
20160125-M-Australian_Open-R16-Stanislas_Wawrinka-Milos_Raonic,2,S-XC,14,2,0,1,1,8,6,,,,,,,,,,
20160125-M-Australian_Open-R16-Stanislas_Wawrinka-Milos_Raonic,2,S-DTM,10,1,0,0,1,5,5,,,,,,,,,,
20160125-M-Australian_Open-R16-Stanislas_Wawrinka-Milos_Raonic,2,S-DTL,9,2,0,2,0,6,3,,,,,,,,,,
20160125-M-Australian_Open-R16-Stanislas_Wawrinka-Milos_Raonic,2,S-IO,2,0,0,0,0,2,0,,,,,,,,,,
20160126-M-Australian_Open-QF-Novak_Djokovic-Kei_Nishikori,1,F-XC,32,7,3,2,2,20,12,,,,,,,,,,
20160126-M-Australian_Open-QF-Novak_Djokovic-Kei_Nishikori,1,F-DTM,29,3,0,0,3,13,16,,,,,,,,,,
20160126-M-Australian_Open-QF-Novak_Djokovic-Kei_Nishikori,1,F-DTL,5,1,0,0,1,3,2,,,,,,,,,,
20160126-M-Australian_Open-QF-Novak_Djokovic-Kei_Nishikori,1,F-IO,21,8,3,3,2,16,5,,,,,,,,,,
20160126-M-Australian_Open-QF-Novak_Djokovic-Kei_Nishikori,1,F-II,1,1,0,1,0,1,0,,,,,,,,,,
20160126-M-Australian_Open-QF-Novak_Djokovic-Kei_Nishikori,1,B-XC,40,8,3,1,4,23,17,,,,,,,,,,
20160126-M-Australian_Open-QF-Novak_Djokovic-Kei_Nishikori,1,B-DTM,55,2,0,1,1,33,22,,,,,,,,,,
20160126-M-Australian_Open-QF-Novak_Djokovic-Kei_Nishikori,1,B-DTL,8,3,0,2,1,4,4,,,,,,,,,,
20160126-M-Australian_Open-QF-Novak_Djokovic-Kei_Nishikori,1,B-IO,8,4,1,1,2,4,4,,,,,,,,,,
20160126-M-Australian_Open-QF-Novak_Djokovic-Kei_Nishikori,1,S-XC,4,0,0,0,0,0,4,,,,,,,,,,
20160126-M-Australian_Open-QF-Novak_Djokovic-Kei_Nishikori,1,S-DTM,8,1,0,0,1,4,4,,,,,,,,,,
20160126-M-Australian_Open-QF-Novak_Djokovic-Kei_Nishikori,1,S-DTL,1,0,0,0,0,1,0,,,,,,,,,,
20160126-M-Australian_Open-QF-Novak_Djokovic-Kei_Nishikori,2,F-XC,33,9,1,0,8,17,16,,,,,,,,,,
20160126-M-Australian_Open-QF-Novak_Djokovic-Kei_Nishikori,2,F-DTM,30,5,0,0,5,9,21,,,,,,,,,,
20160126-M-Australian_Open-QF-Novak_Djokovic-Kei_Nishikori,2,F-DTL,16,10,4,1,5,6,10,,,,,,,,,,
20160126-M-Australian_Open-QF-Novak_Djokovic-Kei_Nishikori,2,F-IO,18,8,1,0,7,8,10,,,,,,,,,,
20160126-M-Australian_Open-QF-Novak_Djokovic-Kei_Nishikori,2,B-XC,49,12,1,4,7,21,28,,,,,,,,,,
20160126-M-Australian_Open-QF-Novak_Djokovic-Kei_Nishikori,2,B-DTM,43,5,1,0,4,17,26,,,,,,,,,,
20160126-M-Australian_Open-QF-Novak_Djokovic-Kei_Nishikori,2,B-DTL,6,4,1,0,3,1,5,,,,,,,,,,
20160126-M-Australian_Open-QF-Novak_Djokovic-Kei_Nishikori,2,B-IO,13,6,2,0,4,5,8,,,,,,,,,,
20160126-M-Australian_Open-QF-Novak_Djokovic-Kei_Nishikori,2,S-XC,10,0,0,0,0,2,8,,,,,,,,,,
20160126-M-Australian_Open-QF-Novak_Djokovic-Kei_Nishikori,2,S-DTM,6,0,0,0,0,2,4,,,,,,,,,,
20160126-M-Australian_Open-QF-Novak_Djokovic-Kei_Nishikori,2,S-DTL,1,0,0,0,0,1,0,,,,,,,,,,
20160126-M-Australian_Open-QF-Novak_Djokovic-Kei_Nishikori,2,S-IO,1,0,0,0,0,0,1,,,,,,,,,,
20160127-M-Australian_Open-QF-Milos_Raonic-Gael_Monfils,1,F-XC,35,15,7,5,3,24,11,,,,,,,,,,
20160127-M-Australian_Open-QF-Milos_Raonic-Gael_Monfils,1,F-DTM,10,1,0,0,1,3,7,,,,,,,,,,
20160127-M-Australian_Open-QF-Milos_Raonic-Gael_Monfils,1,F-DTL,8,4,2,1,1,5,3,,,,,,,,,,
20160127-M-Australian_Open-QF-Milos_Raonic-Gael_Monfils,1,F-IO,52,22,6,10,6,32,20,,,,,,,,,,
20160127-M-Australian_Open-QF-Milos_Raonic-Gael_Monfils,1,F-II,3,2,0,1,1,2,1,,,,,,,,,,
20160127-M-Australian_Open-QF-Milos_Raonic-Gael_Monfils,1,B-XC,11,2,0,1,1,7,4,,,,,,,,,,
20160127-M-Australian_Open-QF-Milos_Raonic-Gael_Monfils,1,B-DTM,11,2,0,0,2,4,7,,,,,,,,,,
20160127-M-Australian_Open-QF-Milos_Raonic-Gael_Monfils,1,B-DTL,10,6,3,1,2,7,3,,,,,,,,,,
20160127-M-Australian_Open-QF-Milos_Raonic-Gael_Monfils,1,B-IO,1,0,0,0,0,0,1,,,,,,,,,,
20160127-M-Australian_Open-QF-Milos_Raonic-Gael_Monfils,1,S-XC,12,2,0,0,2,4,8,,,,,,,,,,
20160127-M-Australian_Open-QF-Milos_Raonic-Gael_Monfils,1,S-DTM,4,0,0,0,0,2,2,,,,,,,,,,
20160127-M-Australian_Open-QF-Milos_Raonic-Gael_Monfils,1,S-DTL,6,5,0,2,3,2,4,,,,,,,,,,
20160127-M-Australian_Open-QF-Milos_Raonic-Gael_Monfils,2,F-XC,26,11,5,3,3,13,13,,,,,,,,,,
20160127-M-Australian_Open-QF-Milos_Raonic-Gael_Monfils,2,F-DTM,16,1,0,0,1,6,10,,,,,,,,,,
20160127-M-Australian_Open-QF-Milos_Raonic-Gael_Monfils,2,F-DTL,9,3,2,1,0,4,5,,,,,,,,,,
20160127-M-Australian_Open-QF-Milos_Raonic-Gael_Monfils,2,F-IO,25,2,2,0,0,15,10,,,,,,,,,,
20160127-M-Australian_Open-QF-Milos_Raonic-Gael_Monfils,2,B-XC,31,0,0,0,0,12,19,,,,,,,,,,
20160127-M-Australian_Open-QF-Milos_Raonic-Gael_Monfils,2,B-DTM,29,1,0,0,1,18,11,,,,,,,,,,
20160127-M-Australian_Open-QF-Milos_Raonic-Gael_Monfils,2,B-DTL,9,4,2,1,1,5,4,,,,,,,,,,
20160127-M-Australian_Open-QF-Milos_Raonic-Gael_Monfils,2,B-IO,1,1,1,0,0,1,0,,,,,,,,,,
20160127-M-Australian_Open-QF-Milos_Raonic-Gael_Monfils,2,S-XC,1,0,0,0,0,1,0,,,,,,,,,,
20160128-M-Australian_Open-SF-Novak_Djokovic-Roger_Federer,1,F-XC,42,12,5,5,2,32,10,,,,,,,,,,
20160128-M-Australian_Open-SF-Novak_Djokovic-Roger_Federer,1,F-DTM,21,1,0,0,1,14,7,,,,,,,,,,
20160128-M-Australian_Open-SF-Novak_Djokovic-Roger_Federer,1,F-DTL,11,2,1,0,1,9,2,,,,,,,,,,
20160128-M-Australian_Open-SF-Novak_Djokovic-Roger_Federer,1,F-IO,28,10,3,4,3,18,10,,,,,,,,,,
20160128-M-Australian_Open-SF-Novak_Djokovic-Roger_Federer,1,B-XC,71,7,2,3,2,50,21,,,,,,,,,,
20160128-M-Australian_Open-SF-Novak_Djokovic-Roger_Federer,1,B-DTM,59,2,0,0,2,39,20,,,,,,,,,,
20160128-M-Australian_Open-SF-Novak_Djokovic-Roger_Federer,1,B-DTL,5,3,2,1,0,4,1,,,,,,,,,,
20160128-M-Australian_Open-SF-Novak_Djokovic-Roger_Federer,1,B-IO,11,6,3,2,1,7,4,,,,,,,,,,
20160128-M-Australian_Open-SF-Novak_Djokovic-Roger_Federer,1,S-XC,3,0,0,0,0,2,1,,,,,,,,,,
20160128-M-Australian_Open-SF-Novak_Djokovic-Roger_Federer,1,S-DTM,3,0,0,0,0,2,1,,,,,,,,,,
20160128-M-Australian_Open-SF-Novak_Djokovic-Roger_Federer,2,F-XC,45,15,3,4,8,17,28,,,,,,,,,,
20160128-M-Australian_Open-SF-Novak_Djokovic-Roger_Federer,2,F-DTM,37,3,0,0,3,9,28,,,,,,,,,,
20160128-M-Australian_Open-SF-Novak_Djokovic-Roger_Federer,2,F-DTL,11,1,1,0,0,3,8,,,,,,,,,,
20160128-M-Australian_Open-SF-Novak_Djokovic-Roger_Federer,2,F-IO,29,10,5,2,3,15,14,,,,,,,,,,
20160128-M-Australian_Open-SF-Novak_Djokovic-Roger_Federer,2,F-II,4,3,1,0,2,1,3,,,,,,,,,,
20160128-M-Australian_Open-SF-Novak_Djokovic-Roger_Federer,2,B-XC,29,4,1,0,3,8,21,,,,,,,,,,
20160128-M-Australian_Open-SF-Novak_Djokovic-Roger_Federer,2,B-DTM,48,11,3,0,8,13,35,,,,,,,,,,
20160128-M-Australian_Open-SF-Novak_Djokovic-Roger_Federer,2,B-DTL,9,5,0,1,4,1,8,,,,,,,,,,
20160128-M-Australian_Open-SF-Novak_Djokovic-Roger_Federer,2,B-IO,4,2,1,0,1,1,3,,,,,,,,,,
20160128-M-Australian_Open-SF-Novak_Djokovic-Roger_Federer,2,S-XC,17,1,0,0,1,6,11,,,,,,,,,,
20160128-M-Australian_Open-SF-Novak_Djokovic-Roger_Federer,2,S-DTM,13,0,0,0,0,4,9,,,,,,,,,,
20160128-M-Australian_Open-SF-Novak_Djokovic-Roger_Federer,2,S-DTL,3,2,0,0,2,0,3,,,,,,,,,,
20160128-M-Australian_Open-SF-Novak_Djokovic-Roger_Federer,2,S-IO,2,1,0,0,1,0,2,,,,,,,,,,
20160128-M-Maui_CH-R16-Michael_Mmoh-Kyle_Edmund,1,F-XC,25,2,0,0,2,7,18,,,,,,,,,,
20160128-M-Maui_CH-R16-Michael_Mmoh-Kyle_Edmund,1,F-DTM,9,1,0,0,1,2,7,,,,,,,,,,
20160128-M-Maui_CH-R16-Michael_Mmoh-Kyle_Edmund,1,F-DTL,5,1,0,1,0,3,2,,,,,,,,,,
20160128-M-Maui_CH-R16-Michael_Mmoh-Kyle_Edmund,1,F-IO,13,2,0,0,2,5,8,,,,,,,,,,
20160128-M-Maui_CH-R16-Michael_Mmoh-Kyle_Edmund,1,F-II,6,2,0,0,2,2,4,,,,,,,,,,
20160128-M-Maui_CH-R16-Michael_Mmoh-Kyle_Edmund,1,B-XC,40,4,0,0,4,12,28,,,,,,,,,,
20160128-M-Maui_CH-R16-Michael_Mmoh-Kyle_Edmund,1,B-DTM,12,1,0,0,1,3,9,,,,,,,,,,
20160128-M-Maui_CH-R16-Michael_Mmoh-Kyle_Edmund,1,B-DTL,1,0,0,0,0,1,0,,,,,,,,,,
20160128-M-Maui_CH-R16-Michael_Mmoh-Kyle_Edmund,1,B-IO,2,0,0,0,0,0,2,,,,,,,,,,
20160128-M-Maui_CH-R16-Michael_Mmoh-Kyle_Edmund,1,S-DTM,3,0,0,0,0,1,2,,,,,,,,,,
20160128-M-Maui_CH-R16-Michael_Mmoh-Kyle_Edmund,2,F-XC,21,9,3,2,4,13,8,,,,,,,,,,
20160128-M-Maui_CH-R16-Michael_Mmoh-Kyle_Edmund,2,F-DTM,14,0,0,0,0,8,6,,,,,,,,,,
20160128-M-Maui_CH-R16-Michael_Mmoh-Kyle_Edmund,2,F-DTL,11,2,1,0,1,8,3,,,,,,,,,,
20160128-M-Maui_CH-R16-Michael_Mmoh-Kyle_Edmund,2,F-IO,21,9,5,2,2,16,5,,,,,,,,,,
20160128-M-Maui_CH-R16-Michael_Mmoh-Kyle_Edmund,2,F-II,4,1,0,0,1,3,1,,,,,,,,,,
20160128-M-Maui_CH-R16-Michael_Mmoh-Kyle_Edmund,2,B-XC,28,2,0,0,2,16,12,,,,,,,,,,
20160128-M-Maui_CH-R16-Michael_Mmoh-Kyle_Edmund,2,B-DTM,7,1,1,0,0,4,3,,,,,,,,,,
20160128-M-Maui_CH-R16-Michael_Mmoh-Kyle_Edmund,2,B-DTL,11,3,2,0,1,8,3,,,,,,,,,,
20160128-M-Maui_CH-R16-Michael_Mmoh-Kyle_Edmund,2,B-IO,1,0,0,0,0,1,0,,,,,,,,,,
20160128-M-Maui_CH-R16-Michael_Mmoh-Kyle_Edmund,2,S-XC,1,0,0,0,0,1,0,,,,,,,,,,
20160129-M-Australian_Open-SF-Andy_Murray-Milos_Raonic,1,F-XC,50,11,4,5,2,35,15,,,,,,,,,,
20160129-M-Australian_Open-SF-Andy_Murray-Milos_Raonic,1,F-DTM,46,2,0,0,2,27,19,,,,,,,,,,
20160129-M-Australian_Open-SF-Andy_Murray-Milos_Raonic,1,F-DTL,20,4,1,1,2,10,10,,,,,,,,,,
20160129-M-Australian_Open-SF-Andy_Murray-Milos_Raonic,1,F-IO,30,9,4,1,4,21,9,,,,,,,,,,
20160129-M-Australian_Open-SF-Andy_Murray-Milos_Raonic,1,F-II,2,1,0,1,0,2,0,,,,,,,,,,
20160129-M-Australian_Open-SF-Andy_Murray-Milos_Raonic,1,B-XC,54,8,3,2,3,33,21,,,,,,,,,,
20160129-M-Australian_Open-SF-Andy_Murray-Milos_Raonic,1,B-DTM,42,2,0,0,2,26,16,,,,,,,,,,
20160129-M-Australian_Open-SF-Andy_Murray-Milos_Raonic,1,B-DTL,10,7,4,2,1,8,2,,,,,,,,,,
20160129-M-Australian_Open-SF-Andy_Murray-Milos_Raonic,1,B-IO,7,2,0,1,1,2,5,,,,,,,,,,
20160129-M-Australian_Open-SF-Andy_Murray-Milos_Raonic,1,S-XC,11,1,0,1,0,4,7,,,,,,,,,,
20160129-M-Australian_Open-SF-Andy_Murray-Milos_Raonic,1,S-DTM,7,0,0,0,0,2,5,,,,,,,,,,
20160129-M-Australian_Open-SF-Andy_Murray-Milos_Raonic,1,S-DTL,6,3,1,0,2,1,5,,,,,,,,,,
20160129-M-Australian_Open-SF-Andy_Murray-Milos_Raonic,2,F-XC,62,26,11,5,10,35,27,,,,,,,,,,
20160129-M-Australian_Open-SF-Andy_Murray-Milos_Raonic,2,F-DTM,26,1,0,0,1,9,17,,,,,,,,,,
20160129-M-Australian_Open-SF-Andy_Murray-Milos_Raonic,2,F-DTL,12,5,2,1,2,8,4,,,,,,,,,,
20160129-M-Australian_Open-SF-Andy_Murray-Milos_Raonic,2,F-IO,75,25,5,7,13,37,38,,,,,,,,,,
20160129-M-Australian_Open-SF-Andy_Murray-Milos_Raonic,2,F-II,6,3,2,1,0,5,1,,,,,,,,,,
20160129-M-Australian_Open-SF-Andy_Murray-Milos_Raonic,2,B-XC,27,10,1,1,8,10,17,,,,,,,,,,
20160129-M-Australian_Open-SF-Andy_Murray-Milos_Raonic,2,B-DTM,38,7,0,0,7,13,25,,,,,,,,,,
20160129-M-Australian_Open-SF-Andy_Murray-Milos_Raonic,2,B-DTL,8,6,0,1,5,2,6,,,,,,,,,,
20160129-M-Australian_Open-SF-Andy_Murray-Milos_Raonic,2,B-IO,10,5,2,1,2,4,6,,,,,,,,,,
20160129-M-Australian_Open-SF-Andy_Murray-Milos_Raonic,2,S-XC,25,5,0,1,4,9,16,,,,,,,,,,
20160129-M-Australian_Open-SF-Andy_Murray-Milos_Raonic,2,S-DTM,12,2,0,0,2,4,8,,,,,,,,,,
20160129-M-Australian_Open-SF-Andy_Murray-Milos_Raonic,2,S-DTL,5,3,0,0,3,0,5,,,,,,,,,,
20160129-M-Australian_Open-SF-Andy_Murray-Milos_Raonic,2,S-IO,1,0,0,0,0,0,1,,,,,,,,,,
20160131-M-Australian_Open-F-Novak_Djokovic-Andy_Murray,1,F-XC,65,14,5,6,3,46,19,,,,,,,,,,
20160131-M-Australian_Open-F-Novak_Djokovic-Andy_Murray,1,F-DTM,73,4,1,0,3,38,35,,,,,,,,,,
20160131-M-Australian_Open-F-Novak_Djokovic-Andy_Murray,1,F-DTL,17,1,0,1,0,10,7,,,,,,,,,,
20160131-M-Australian_Open-F-Novak_Djokovic-Andy_Murray,1,F-IO,43,7,3,0,4,27,16,,,,,,,,,,
20160131-M-Australian_Open-F-Novak_Djokovic-Andy_Murray,1,F-II,3,1,1,0,0,3,0,,,,,,,,,,
20160131-M-Australian_Open-F-Novak_Djokovic-Andy_Murray,1,B-XC,85,12,3,3,6,53,32,,,,,,,,,,
20160131-M-Australian_Open-F-Novak_Djokovic-Andy_Murray,1,B-DTM,123,8,0,0,8,66,57,,,,,,,,,,
20160131-M-Australian_Open-F-Novak_Djokovic-Andy_Murray,1,B-DTL,18,7,1,2,4,11,7,,,,,,,,,,
20160131-M-Australian_Open-F-Novak_Djokovic-Andy_Murray,1,B-IO,13,4,2,1,1,10,3,,,,,,,,,,
20160131-M-Australian_Open-F-Novak_Djokovic-Andy_Murray,1,S-XC,11,0,0,0,0,4,7,,,,,,,,,,
20160131-M-Australian_Open-F-Novak_Djokovic-Andy_Murray,1,S-DTM,20,1,0,0,1,8,12,,,,,,,,,,
20160131-M-Australian_Open-F-Novak_Djokovic-Andy_Murray,1,S-DTL,1,0,0,0,0,1,0,,,,,,,,,,
20160131-M-Australian_Open-F-Novak_Djokovic-Andy_Murray,1,S-IO,2,0,0,0,0,0,2,,,,,,,,,,
20160131-M-Australian_Open-F-Novak_Djokovic-Andy_Murray,2,F-XC,90,20,5,6,9,39,51,,,,,,,,,,
20160131-M-Australian_Open-F-Novak_Djokovic-Andy_Murray,2,F-DTM,56,1,0,0,1,24,32,,,,,,,,,,
20160131-M-Australian_Open-F-Novak_Djokovic-Andy_Murray,2,F-DTL,23,7,1,1,5,8,15,,,,,,,,,,
20160131-M-Australian_Open-F-Novak_Djokovic-Andy_Murray,2,F-IO,59,13,1,3,9,20,39,,,,,,,,,,
20160131-M-Australian_Open-F-Novak_Djokovic-Andy_Murray,2,F-II,1,1,1,0,0,1,0,,,,,,,,,,
20160131-M-Australian_Open-F-Novak_Djokovic-Andy_Murray,2,B-XC,86,18,4,4,10,43,43,,,,,,,,,,
20160131-M-Australian_Open-F-Novak_Djokovic-Andy_Murray,2,B-DTM,78,6,0,0,6,28,50,,,,,,,,,,
20160131-M-Australian_Open-F-Novak_Djokovic-Andy_Murray,2,B-DTL,10,5,1,0,4,3,7,,,,,,,,,,
20160131-M-Australian_Open-F-Novak_Djokovic-Andy_Murray,2,B-IO,13,7,2,0,5,5,8,,,,,,,,,,
20160131-M-Australian_Open-F-Novak_Djokovic-Andy_Murray,2,S-XC,30,2,0,0,2,13,17,,,,,,,,,,
20160131-M-Australian_Open-F-Novak_Djokovic-Andy_Murray,2,S-DTM,23,0,0,0,0,10,13,,,,,,,,,,
20160131-M-Australian_Open-F-Novak_Djokovic-Andy_Murray,2,S-DTL,3,1,0,0,1,0,3,,,,,,,,,,
20160131-M-Australian_Open-F-Novak_Djokovic-Andy_Murray,2,S-IO,3,0,0,0,0,3,0,,,,,,,,,,
20160202-M-Dallas_CH-R32-Samuel_Groth-Francis_Tiafoe,1,F-XC,12,2,0,0,2,3,9,,,,,,,,,,
20160202-M-Dallas_CH-R32-Samuel_Groth-Francis_Tiafoe,1,F-DTM,3,1,0,0,1,1,2,,,,,,,,,,
20160202-M-Dallas_CH-R32-Samuel_Groth-Francis_Tiafoe,1,F-DTL,2,2,1,0,1,1,1,,,,,,,,,,
20160202-M-Dallas_CH-R32-Samuel_Groth-Francis_Tiafoe,1,F-IO,4,2,0,1,1,3,1,,,,,,,,,,
20160202-M-Dallas_CH-R32-Samuel_Groth-Francis_Tiafoe,1,B-XC,6,2,0,1,1,3,3,,,,,,,,,,
20160202-M-Dallas_CH-R32-Samuel_Groth-Francis_Tiafoe,1,B-DTM,5,1,0,0,1,3,2,,,,,,,,,,
20160202-M-Dallas_CH-R32-Samuel_Groth-Francis_Tiafoe,1,B-DTL,3,2,1,0,1,1,2,,,,,,,,,,
20160202-M-Dallas_CH-R32-Samuel_Groth-Francis_Tiafoe,1,S-XC,8,0,0,0,0,4,4,,,,,,,,,,
20160202-M-Dallas_CH-R32-Samuel_Groth-Francis_Tiafoe,1,S-DTM,4,0,0,0,0,0,4,,,,,,,,,,
20160202-M-Dallas_CH-R32-Samuel_Groth-Francis_Tiafoe,1,S-DTL,2,0,0,0,0,0,2,,,,,,,,,,
20160202-M-Dallas_CH-R32-Samuel_Groth-Francis_Tiafoe,2,F-XC,15,6,2,2,2,11,4,,,,,,,,,,
20160202-M-Dallas_CH-R32-Samuel_Groth-Francis_Tiafoe,2,F-DTM,2,0,0,0,0,2,0,,,,,,,,,,
20160202-M-Dallas_CH-R32-Samuel_Groth-Francis_Tiafoe,2,F-DTL,4,1,1,0,0,3,1,,,,,,,,,,
20160202-M-Dallas_CH-R32-Samuel_Groth-Francis_Tiafoe,2,F-IO,12,4,0,3,1,7,5,,,,,,,,,,
20160202-M-Dallas_CH-R32-Samuel_Groth-Francis_Tiafoe,2,F-II,3,1,0,0,1,1,2,,,,,,,,,,
20160202-M-Dallas_CH-R32-Samuel_Groth-Francis_Tiafoe,2,B-XC,15,5,1,1,3,7,8,,,,,,,,,,
20160202-M-Dallas_CH-R32-Samuel_Groth-Francis_Tiafoe,2,B-DTM,3,1,0,0,1,1,2,,,,,,,,,,
20160202-M-Dallas_CH-R32-Samuel_Groth-Francis_Tiafoe,2,B-DTL,7,4,2,2,0,5,2,,,,,,,,,,
20160202-M-Dallas_CH-R32-Samuel_Groth-Francis_Tiafoe,2,B-IO,1,1,0,0,1,0,1,,,,,,,,,,
20160202-M-Dallas_CH-R32-Samuel_Groth-Francis_Tiafoe,2,S-XC,2,1,0,0,1,1,1,,,,,,,,,,
20160202-M-Dallas_CH-R32-Samuel_Groth-Francis_Tiafoe,2,S-DTM,2,1,0,0,1,1,1,,,,,,,,,,
20160202-M-Dallas_CH-R32-Samuel_Groth-Francis_Tiafoe,2,S-DTL,1,1,0,0,1,0,1,,,,,,,,,,
20160202-M-Dallas_CH-R32-Samuel_Groth-Francis_Tiafoe,2,S-IO,1,0,0,0,0,0,1,,,,,,,,,,
20160202-M-Quito-R32-Guido_Pella-Victor_Estrella,1,F-XC,37,10,2,3,5,13,24,,,,,,,,,,
20160202-M-Quito-R32-Guido_Pella-Victor_Estrella,1,F-DTM,24,2,0,0,2,8,16,,,,,,,,,,
20160202-M-Quito-R32-Guido_Pella-Victor_Estrella,1,F-DTL,3,3,2,0,1,2,1,,,,,,,,,,
20160202-M-Quito-R32-Guido_Pella-Victor_Estrella,1,F-IO,11,8,2,2,4,5,6,,,,,,,,,,
20160202-M-Quito-R32-Guido_Pella-Victor_Estrella,1,B-XC,10,1,1,0,0,6,4,,,,,,,,,,
20160202-M-Quito-R32-Guido_Pella-Victor_Estrella,1,B-DTM,25,2,0,0,2,9,16,,,,,,,,,,
20160202-M-Quito-R32-Guido_Pella-Victor_Estrella,1,B-DTL,4,1,0,1,0,2,2,,,,,,,,,,
20160202-M-Quito-R32-Guido_Pella-Victor_Estrella,1,B-IO,2,0,0,0,0,0,2,,,,,,,,,,
20160202-M-Quito-R32-Guido_Pella-Victor_Estrella,1,S-XC,1,0,0,0,0,1,0,,,,,,,,,,
20160202-M-Quito-R32-Guido_Pella-Victor_Estrella,1,S-DTM,5,1,0,0,1,1,4,,,,,,,,,,
20160202-M-Quito-R32-Guido_Pella-Victor_Estrella,1,S-DTL,1,0,0,0,0,1,0,,,,,,,,,,
20160202-M-Quito-R32-Guido_Pella-Victor_Estrella,1,S-IO,9,2,0,0,2,1,8,,,,,,,,,,
20160202-M-Quito-R32-Guido_Pella-Victor_Estrella,2,F-XC,33,11,1,2,8,17,16,,,,,,,,,,
20160202-M-Quito-R32-Guido_Pella-Victor_Estrella,2,F-DTM,30,2,0,0,2,17,13,,,,,,,,,,
20160202-M-Quito-R32-Guido_Pella-Victor_Estrella,2,F-DTL,5,5,2,2,1,4,1,,,,,,,,,,
20160202-M-Quito-R32-Guido_Pella-Victor_Estrella,2,F-IO,36,15,8,2,5,27,9,,,,,,,,,,
20160202-M-Quito-R32-Guido_Pella-Victor_Estrella,2,B-XC,1,1,0,0,1,0,1,,,,,,,,,,
20160202-M-Quito-R32-Guido_Pella-Victor_Estrella,2,B-DTM,1,1,0,0,1,0,1,,,,,,,,,,
20160202-M-Quito-R32-Guido_Pella-Victor_Estrella,2,S-XC,11,0,0,0,0,8,3,,,,,,,,,,
20160202-M-Quito-R32-Guido_Pella-Victor_Estrella,2,S-DTM,17,1,0,0,1,12,5,,,,,,,,,,
20160202-M-Quito-R32-Guido_Pella-Victor_Estrella,2,S-DTL,5,0,0,0,0,5,0,,,,,,,,,,
20160202-M-Sofia-R32-Marius_Copil-Hyeon_Chung,1,F-XC,13,7,1,1,5,7,6,,,,,,,,,,
20160202-M-Sofia-R32-Marius_Copil-Hyeon_Chung,1,F-DTM,15,6,0,0,6,5,10,,,,,,,,,,
20160202-M-Sofia-R32-Marius_Copil-Hyeon_Chung,1,F-DTL,1,0,0,0,0,1,0,,,,,,,,,,
20160202-M-Sofia-R32-Marius_Copil-Hyeon_Chung,1,F-IO,9,6,4,2,0,8,1,,,,,,,,,,
20160202-M-Sofia-R32-Marius_Copil-Hyeon_Chung,1,B-XC,9,3,1,0,2,7,2,,,,,,,,,,
20160202-M-Sofia-R32-Marius_Copil-Hyeon_Chung,1,B-DTM,15,1,0,0,1,10,5,,,,,,,,,,
20160202-M-Sofia-R32-Marius_Copil-Hyeon_Chung,1,B-DTL,2,2,1,0,1,1,1,,,,,,,,,,
20160202-M-Sofia-R32-Marius_Copil-Hyeon_Chung,1,B-IO,2,2,0,1,1,1,1,,,,,,,,,,
20160202-M-Sofia-R32-Marius_Copil-Hyeon_Chung,1,S-XC,7,2,0,0,2,3,4,,,,,,,,,,
20160202-M-Sofia-R32-Marius_Copil-Hyeon_Chung,1,S-DTM,5,1,0,0,1,2,3,,,,,,,,,,
20160202-M-Sofia-R32-Marius_Copil-Hyeon_Chung,1,S-DTL,1,1,1,0,0,1,0,,,,,,,,,,
20160202-M-Sofia-R32-Marius_Copil-Hyeon_Chung,1,S-IO,1,1,0,1,0,1,0,,,,,,,,,,
20160202-M-Sofia-R32-Marius_Copil-Hyeon_Chung,2,F-XC,15,0,0,0,0,6,9,,,,,,,,,,
20160202-M-Sofia-R32-Marius_Copil-Hyeon_Chung,2,F-DTM,19,3,0,0,3,8,11,,,,,,,,,,
20160202-M-Sofia-R32-Marius_Copil-Hyeon_Chung,2,F-DTL,3,1,0,0,1,1,2,,,,,,,,,,
20160202-M-Sofia-R32-Marius_Copil-Hyeon_Chung,2,F-IO,12,5,1,0,4,2,10,,,,,,,,,,
20160202-M-Sofia-R32-Marius_Copil-Hyeon_Chung,2,B-XC,13,4,0,2,2,6,7,,,,,,,,,,
20160202-M-Sofia-R32-Marius_Copil-Hyeon_Chung,2,B-DTM,20,1,0,0,1,9,11,,,,,,,,,,
20160202-M-Sofia-R32-Marius_Copil-Hyeon_Chung,2,B-IO,2,1,0,1,0,2,0,,,,,,,,,,
20160202-M-Sofia-R32-Marius_Copil-Hyeon_Chung,2,S-XC,1,0,0,0,0,0,1,,,,,,,,,,
20160202-M-Sofia-R32-Marius_Copil-Hyeon_Chung,2,S-DTM,3,0,0,0,0,0,3,,,,,,,,,,
20160202-M-Sofia-R32-Marius_Copil-Hyeon_Chung,2,S-IO,1,0,0,0,0,0,1,,,,,,,,,,
20160205-M-Quito-QF-Bernard_Tomic-Paolo_Lorenzi,1,F-XC,37,14,7,1,6,24,13,,,,,,,,,,
20160205-M-Quito-QF-Bernard_Tomic-Paolo_Lorenzi,1,F-DTM,30,5,0,3,2,19,11,,,,,,,,,,
20160205-M-Quito-QF-Bernard_Tomic-Paolo_Lorenzi,1,F-DTL,11,6,3,1,2,7,4,,,,,,,,,,
20160205-M-Quito-QF-Bernard_Tomic-Paolo_Lorenzi,1,F-IO,28,6,4,0,2,19,9,,,,,,,,,,
20160205-M-Quito-QF-Bernard_Tomic-Paolo_Lorenzi,1,F-II,1,1,0,0,1,0,1,,,,,,,,,,
20160205-M-Quito-QF-Bernard_Tomic-Paolo_Lorenzi,1,B-XC,29,5,1,1,3,13,16,,,,,,,,,,
20160205-M-Quito-QF-Bernard_Tomic-Paolo_Lorenzi,1,B-DTM,22,0,0,0,0,11,11,,,,,,,,,,
20160205-M-Quito-QF-Bernard_Tomic-Paolo_Lorenzi,1,B-DTL,16,14,2,3,9,6,10,,,,,,,,,,
20160205-M-Quito-QF-Bernard_Tomic-Paolo_Lorenzi,1,B-IO,3,1,1,0,0,3,0,,,,,,,,,,
20160205-M-Quito-QF-Bernard_Tomic-Paolo_Lorenzi,1,S-XC,6,1,0,0,1,2,4,,,,,,,,,,
20160205-M-Quito-QF-Bernard_Tomic-Paolo_Lorenzi,1,S-DTM,3,0,0,0,0,1,2,,,,,,,,,,
20160205-M-Quito-QF-Bernard_Tomic-Paolo_Lorenzi,1,S-DTL,3,1,1,0,0,1,2,,,,,,,,,,
20160205-M-Quito-QF-Bernard_Tomic-Paolo_Lorenzi,1,S-IO,2,0,0,0,0,2,0,,,,,,,,,,
20160205-M-Quito-QF-Bernard_Tomic-Paolo_Lorenzi,2,F-XC,23,11,6,1,4,11,12,,,,,,,,,,
20160205-M-Quito-QF-Bernard_Tomic-Paolo_Lorenzi,2,F-DTM,31,4,1,0,3,14,17,,,,,,,,,,
20160205-M-Quito-QF-Bernard_Tomic-Paolo_Lorenzi,2,F-DTL,5,0,0,0,0,2,3,,,,,,,,,,
20160205-M-Quito-QF-Bernard_Tomic-Paolo_Lorenzi,2,F-IO,13,4,2,1,1,7,6,,,,,,,,,,
20160205-M-Quito-QF-Bernard_Tomic-Paolo_Lorenzi,2,F-II,2,0,0,0,0,2,0,,,,,,,,,,
20160205-M-Quito-QF-Bernard_Tomic-Paolo_Lorenzi,2,B-XC,42,8,2,2,4,23,19,,,,,,,,,,
20160205-M-Quito-QF-Bernard_Tomic-Paolo_Lorenzi,2,B-DTM,32,6,1,0,5,11,21,,,,,,,,,,
20160205-M-Quito-QF-Bernard_Tomic-Paolo_Lorenzi,2,B-DTL,10,3,2,1,0,8,2,,,,,,,,,,
20160205-M-Quito-QF-Bernard_Tomic-Paolo_Lorenzi,2,B-IO,8,2,0,1,1,4,4,,,,,,,,,,
20160205-M-Quito-QF-Bernard_Tomic-Paolo_Lorenzi,2,S-XC,7,0,0,0,0,1,6,,,,,,,,,,
20160205-M-Quito-QF-Bernard_Tomic-Paolo_Lorenzi,2,S-DTM,4,0,0,0,0,0,4,,,,,,,,,,
20160205-M-Quito-QF-Bernard_Tomic-Paolo_Lorenzi,2,S-DTL,2,0,0,0,0,0,2,,,,,,,,,,
20160206-M-Sofia-SF-Roberto_Bautista_Agut-Gilles_Muller,1,F-XC,29,4,2,1,1,22,7,,,,,,,,,,
20160206-M-Sofia-SF-Roberto_Bautista_Agut-Gilles_Muller,1,F-DTM,17,1,0,1,0,10,7,,,,,,,,,,
20160206-M-Sofia-SF-Roberto_Bautista_Agut-Gilles_Muller,1,F-DTL,9,6,4,0,2,5,4,,,,,,,,,,
20160206-M-Sofia-SF-Roberto_Bautista_Agut-Gilles_Muller,1,F-IO,17,5,3,2,0,12,5,,,,,,,,,,
20160206-M-Sofia-SF-Roberto_Bautista_Agut-Gilles_Muller,1,F-II,4,0,0,0,0,2,2,,,,,,,,,,
20160206-M-Sofia-SF-Roberto_Bautista_Agut-Gilles_Muller,1,B-XC,13,4,2,0,2,6,7,,,,,,,,,,
20160206-M-Sofia-SF-Roberto_Bautista_Agut-Gilles_Muller,1,B-DTM,15,1,0,0,1,9,6,,,,,,,,,,
20160206-M-Sofia-SF-Roberto_Bautista_Agut-Gilles_Muller,1,B-DTL,9,3,0,1,2,5,4,,,,,,,,,,
20160206-M-Sofia-SF-Roberto_Bautista_Agut-Gilles_Muller,1,B-IO,2,2,0,1,1,1,1,,,,,,,,,,
20160206-M-Sofia-SF-Roberto_Bautista_Agut-Gilles_Muller,1,S-XC,4,0,0,0,0,4,0,,,,,,,,,,
20160206-M-Sofia-SF-Roberto_Bautista_Agut-Gilles_Muller,1,S-DTM,8,0,0,0,0,4,4,,,,,,,,,,
20160206-M-Sofia-SF-Roberto_Bautista_Agut-Gilles_Muller,1,S-DTL,9,2,0,0,2,2,7,,,,,,,,,,
20160206-M-Sofia-SF-Roberto_Bautista_Agut-Gilles_Muller,1,S-IO,1,0,0,0,0,0,1,,,,,,,,,,
20160206-M-Sofia-SF-Roberto_Bautista_Agut-Gilles_Muller,2,F-XC,35,11,4,2,5,16,19,,,,,,,,,,
20160206-M-Sofia-SF-Roberto_Bautista_Agut-Gilles_Muller,2,F-DTM,9,0,0,0,0,4,5,,,,,,,,,,
20160206-M-Sofia-SF-Roberto_Bautista_Agut-Gilles_Muller,2,F-DTL,8,3,0,0,3,4,4,,,,,,,,,,
20160206-M-Sofia-SF-Roberto_Bautista_Agut-Gilles_Muller,2,F-IO,13,10,3,3,4,6,7,,,,,,,,,,
20160206-M-Sofia-SF-Roberto_Bautista_Agut-Gilles_Muller,2,F-II,2,1,0,1,0,2,0,,,,,,,,,,
20160206-M-Sofia-SF-Roberto_Bautista_Agut-Gilles_Muller,2,B-XC,10,5,1,0,4,2,8,,,,,,,,,,
20160206-M-Sofia-SF-Roberto_Bautista_Agut-Gilles_Muller,2,B-DTM,11,2,0,0,2,3,8,,,,,,,,,,
20160206-M-Sofia-SF-Roberto_Bautista_Agut-Gilles_Muller,2,B-DTL,10,3,1,0,2,4,6,,,,,,,,,,
20160206-M-Sofia-SF-Roberto_Bautista_Agut-Gilles_Muller,2,B-IO,4,2,0,0,2,1,3,,,,,,,,,,
20160206-M-Sofia-SF-Roberto_Bautista_Agut-Gilles_Muller,2,S-XC,8,0,0,0,0,4,4,,,,,,,,,,
20160206-M-Sofia-SF-Roberto_Bautista_Agut-Gilles_Muller,2,S-DTM,8,0,0,0,0,1,7,,,,,,,,,,
20160206-M-Sofia-SF-Roberto_Bautista_Agut-Gilles_Muller,2,S-DTL,9,0,0,0,0,3,6,,,,,,,,,,
20160206-M-Sofia-SF-Roberto_Bautista_Agut-Gilles_Muller,2,S-IO,2,0,0,0,0,2,0,,,,,,,,,,
20160208-M-Rotterdam-R32-Thiemo_De_Bakker-Borna_Coric,1,F-XC,25,8,2,3,3,11,14,,,,,,,,,,
20160208-M-Rotterdam-R32-Thiemo_De_Bakker-Borna_Coric,1,F-DTM,52,4,0,0,4,22,30,,,,,,,,,,
20160208-M-Rotterdam-R32-Thiemo_De_Bakker-Borna_Coric,1,F-DTL,16,5,0,2,3,6,10,,,,,,,,,,
20160208-M-Rotterdam-R32-Thiemo_De_Bakker-Borna_Coric,1,F-IO,23,10,1,2,7,10,13,,,,,,,,,,
20160208-M-Rotterdam-R32-Thiemo_De_Bakker-Borna_Coric,1,F-II,1,0,0,0,0,0,1,,,,,,,,,,
20160208-M-Rotterdam-R32-Thiemo_De_Bakker-Borna_Coric,1,B-XC,9,4,2,0,2,3,6,,,,,,,,,,
20160208-M-Rotterdam-R32-Thiemo_De_Bakker-Borna_Coric,1,B-DTM,46,5,0,0,5,23,23,,,,,,,,,,
20160208-M-Rotterdam-R32-Thiemo_De_Bakker-Borna_Coric,1,B-DTL,13,4,1,0,3,5,8,,,,,,,,,,
20160208-M-Rotterdam-R32-Thiemo_De_Bakker-Borna_Coric,1,B-IO,5,1,0,1,0,4,1,,,,,,,,,,
20160208-M-Rotterdam-R32-Thiemo_De_Bakker-Borna_Coric,1,S-XC,14,1,0,0,1,6,8,,,,,,,,,,
20160208-M-Rotterdam-R32-Thiemo_De_Bakker-Borna_Coric,1,S-DTM,9,1,0,0,1,1,8,,,,,,,,,,
20160208-M-Rotterdam-R32-Thiemo_De_Bakker-Borna_Coric,1,S-DTL,3,1,1,0,0,3,0,,,,,,,,,,
20160208-M-Rotterdam-R32-Thiemo_De_Bakker-Borna_Coric,1,S-IO,3,1,0,1,0,2,1,,,,,,,,,,
20160208-M-Rotterdam-R32-Thiemo_De_Bakker-Borna_Coric,2,F-XC,63,16,3,5,8,39,24,,,,,,,,,,
20160208-M-Rotterdam-R32-Thiemo_De_Bakker-Borna_Coric,2,F-DTM,39,6,0,0,6,14,25,,,,,,,,,,
20160208-M-Rotterdam-R32-Thiemo_De_Bakker-Borna_Coric,2,F-DTL,8,4,2,0,2,3,5,,,,,,,,,,
20160208-M-Rotterdam-R32-Thiemo_De_Bakker-Borna_Coric,2,F-IO,44,9,3,1,5,25,19,,,,,,,,,,
20160208-M-Rotterdam-R32-Thiemo_De_Bakker-Borna_Coric,2,B-XC,23,6,1,3,2,11,12,,,,,,,,,,
20160208-M-Rotterdam-R32-Thiemo_De_Bakker-Borna_Coric,2,B-DTM,27,1,1,0,0,17,10,,,,,,,,,,
20160208-M-Rotterdam-R32-Thiemo_De_Bakker-Borna_Coric,2,B-DTL,6,3,1,0,2,2,4,,,,,,,,,,
20160208-M-Rotterdam-R32-Thiemo_De_Bakker-Borna_Coric,2,B-IO,2,2,2,0,0,2,0,,,,,,,,,,
20160208-M-Rotterdam-R32-Thiemo_De_Bakker-Borna_Coric,2,S-XC,5,2,1,1,0,5,0,,,,,,,,,,
20160208-M-Rotterdam-R32-Thiemo_De_Bakker-Borna_Coric,2,S-DTM,4,0,0,0,0,3,1,,,,,,,,,,
20160208-M-Rotterdam-R32-Thiemo_De_Bakker-Borna_Coric,2,S-DTL,2,2,0,0,2,0,2,,,,,,,,,,
20160208-M-Rotterdam-R32-Thiemo_De_Bakker-Borna_Coric,2,S-IO,1,0,0,0,0,1,0,,,,,,,,,,
20160213-M-Buenos_Aires-SF-Rafael_Nadal-Dominic_Thiem,1,F-XC,59,14,3,6,5,40,19,,,,,,,,,,
20160213-M-Buenos_Aires-SF-Rafael_Nadal-Dominic_Thiem,1,F-DTM,10,0,0,0,0,5,5,,,,,,,,,,
20160213-M-Buenos_Aires-SF-Rafael_Nadal-Dominic_Thiem,1,F-DTL,15,11,5,2,4,9,6,,,,,,,,,,
20160213-M-Buenos_Aires-SF-Rafael_Nadal-Dominic_Thiem,1,F-IO,35,14,8,2,4,22,13,,,,,,,,,,
20160213-M-Buenos_Aires-SF-Rafael_Nadal-Dominic_Thiem,1,F-II,12,3,0,1,2,7,5,,,,,,,,,,
20160213-M-Buenos_Aires-SF-Rafael_Nadal-Dominic_Thiem,1,B-XC,55,13,3,5,5,33,22,,,,,,,,,,
20160213-M-Buenos_Aires-SF-Rafael_Nadal-Dominic_Thiem,1,B-DTM,20,2,0,1,1,5,15,,,,,,,,,,
20160213-M-Buenos_Aires-SF-Rafael_Nadal-Dominic_Thiem,1,B-DTL,29,15,4,2,9,14,15,,,,,,,,,,
20160213-M-Buenos_Aires-SF-Rafael_Nadal-Dominic_Thiem,1,B-IO,7,2,1,1,0,4,3,,,,,,,,,,
20160213-M-Buenos_Aires-SF-Rafael_Nadal-Dominic_Thiem,1,S-XC,3,3,1,1,1,2,1,,,,,,,,,,
20160213-M-Buenos_Aires-SF-Rafael_Nadal-Dominic_Thiem,1,S-DTM,5,0,0,0,0,0,5,,,,,,,,,,
20160213-M-Buenos_Aires-SF-Rafael_Nadal-Dominic_Thiem,1,S-DTL,5,0,0,0,0,2,3,,,,,,,,,,
20160213-M-Buenos_Aires-SF-Rafael_Nadal-Dominic_Thiem,1,S-IO,2,0,0,0,0,0,2,,,,,,,,,,
20160213-M-Buenos_Aires-SF-Rafael_Nadal-Dominic_Thiem,2,F-XC,86,12,4,7,1,51,35,,,,,,,,,,
20160213-M-Buenos_Aires-SF-Rafael_Nadal-Dominic_Thiem,2,F-DTM,28,4,1,1,2,11,17,,,,,,,,,,
20160213-M-Buenos_Aires-SF-Rafael_Nadal-Dominic_Thiem,2,F-DTL,18,11,3,2,6,9,9,,,,,,,,,,
20160213-M-Buenos_Aires-SF-Rafael_Nadal-Dominic_Thiem,2,F-IO,15,7,4,1,2,9,6,,,,,,,,,,
20160213-M-Buenos_Aires-SF-Rafael_Nadal-Dominic_Thiem,2,F-II,7,5,4,0,1,5,2,,,,,,,,,,
20160213-M-Buenos_Aires-SF-Rafael_Nadal-Dominic_Thiem,2,B-XC,20,5,1,0,4,8,12,,,,,,,,,,
20160213-M-Buenos_Aires-SF-Rafael_Nadal-Dominic_Thiem,2,B-DTM,27,4,0,1,3,10,17,,,,,,,,,,
20160213-M-Buenos_Aires-SF-Rafael_Nadal-Dominic_Thiem,2,B-DTL,18,6,4,1,1,12,6,,,,,,,,,,
20160213-M-Buenos_Aires-SF-Rafael_Nadal-Dominic_Thiem,2,B-IO,2,1,0,0,1,1,1,,,,,,,,,,
20160213-M-Buenos_Aires-SF-Rafael_Nadal-Dominic_Thiem,2,S-XC,9,1,1,0,0,4,5,,,,,,,,,,
20160213-M-Buenos_Aires-SF-Rafael_Nadal-Dominic_Thiem,2,S-DTM,5,0,0,0,0,0,5,,,,,,,,,,
20160213-M-Buenos_Aires-SF-Rafael_Nadal-Dominic_Thiem,2,S-DTL,7,0,0,0,0,2,5,,,,,,,,,,
20160213-M-Buenos_Aires-SF-Rafael_Nadal-Dominic_Thiem,2,S-IO,1,0,0,0,0,1,0,,,,,,,,,,
20160218-M-Rio_de_Janeiro-R16-Inigo_Cervantes_Huegun-Alexandr_Dolgopolov,1,F-XC,19,4,0,2,2,10,9,,,,,,,,,,
20160218-M-Rio_de_Janeiro-R16-Inigo_Cervantes_Huegun-Alexandr_Dolgopolov,1,F-DTM,17,2,0,1,1,7,10,,,,,,,,,,
20160218-M-Rio_de_Janeiro-R16-Inigo_Cervantes_Huegun-Alexandr_Dolgopolov,1,F-DTL,4,2,1,0,1,2,2,,,,,,,,,,
20160218-M-Rio_de_Janeiro-R16-Inigo_Cervantes_Huegun-Alexandr_Dolgopolov,1,F-IO,17,5,1,1,3,8,9,,,,,,,,,,
20160218-M-Rio_de_Janeiro-R16-Inigo_Cervantes_Huegun-Alexandr_Dolgopolov,1,F-II,5,0,0,0,0,1,4,,,,,,,,,,
20160218-M-Rio_de_Janeiro-R16-Inigo_Cervantes_Huegun-Alexandr_Dolgopolov,1,B-XC,19,8,1,4,3,9,10,,,,,,,,,,
20160218-M-Rio_de_Janeiro-R16-Inigo_Cervantes_Huegun-Alexandr_Dolgopolov,1,B-DTM,15,3,0,0,3,3,12,,,,,,,,,,
20160218-M-Rio_de_Janeiro-R16-Inigo_Cervantes_Huegun-Alexandr_Dolgopolov,1,B-DTL,2,1,1,0,0,2,0,,,,,,,,,,
20160218-M-Rio_de_Janeiro-R16-Inigo_Cervantes_Huegun-Alexandr_Dolgopolov,1,B-IO,1,0,0,0,0,1,0,,,,,,,,,,
20160218-M-Rio_de_Janeiro-R16-Inigo_Cervantes_Huegun-Alexandr_Dolgopolov,1,S-XC,4,0,0,0,0,2,2,,,,,,,,,,
20160218-M-Rio_de_Janeiro-R16-Inigo_Cervantes_Huegun-Alexandr_Dolgopolov,1,S-DTM,5,2,0,0,2,1,4,,,,,,,,,,
20160218-M-Rio_de_Janeiro-R16-Inigo_Cervantes_Huegun-Alexandr_Dolgopolov,2,F-XC,30,11,5,3,3,19,11,,,,,,,,,,
20160218-M-Rio_de_Janeiro-R16-Inigo_Cervantes_Huegun-Alexandr_Dolgopolov,2,F-DTM,9,2,0,1,1,6,3,,,,,,,,,,
20160218-M-Rio_de_Janeiro-R16-Inigo_Cervantes_Huegun-Alexandr_Dolgopolov,2,F-DTL,1,0,0,0,0,0,1,,,,,,,,,,
20160218-M-Rio_de_Janeiro-R16-Inigo_Cervantes_Huegun-Alexandr_Dolgopolov,2,F-IO,14,9,4,2,3,9,5,,,,,,,,,,
20160218-M-Rio_de_Janeiro-R16-Inigo_Cervantes_Huegun-Alexandr_Dolgopolov,2,B-XC,19,5,1,0,4,11,8,,,,,,,,,,
20160218-M-Rio_de_Janeiro-R16-Inigo_Cervantes_Huegun-Alexandr_Dolgopolov,2,B-DTM,26,4,0,2,2,16,10,,,,,,,,,,
20160218-M-Rio_de_Janeiro-R16-Inigo_Cervantes_Huegun-Alexandr_Dolgopolov,2,B-DTL,3,2,0,1,1,2,1,,,,,,,,,,
20160218-M-Rio_de_Janeiro-R16-Inigo_Cervantes_Huegun-Alexandr_Dolgopolov,2,B-IO,3,2,2,0,0,3,0,,,,,,,,,,
20160218-M-Rio_de_Janeiro-R16-Inigo_Cervantes_Huegun-Alexandr_Dolgopolov,2,S-XC,6,1,1,0,0,4,2,,,,,,,,,,
20160218-M-Rio_de_Janeiro-R16-Inigo_Cervantes_Huegun-Alexandr_Dolgopolov,2,S-DTM,4,1,1,0,0,2,2,,,,,,,,,,
20160219-M-Marseille-QF-Richard_Gasquet-Nick_Kyrgios,1,F-XC,25,4,0,1,3,12,13,,,,,,,,,,
20160219-M-Marseille-QF-Richard_Gasquet-Nick_Kyrgios,1,F-DTM,17,0,0,0,0,8,9,,,,,,,,,,
20160219-M-Marseille-QF-Richard_Gasquet-Nick_Kyrgios,1,F-DTL,17,3,0,0,3,3,14,,,,,,,,,,
20160219-M-Marseille-QF-Richard_Gasquet-Nick_Kyrgios,1,F-IO,10,1,0,0,1,3,7,,,,,,,,,,
20160219-M-Marseille-QF-Richard_Gasquet-Nick_Kyrgios,1,B-XC,30,0,0,0,0,11,19,,,,,,,,,,
20160219-M-Marseille-QF-Richard_Gasquet-Nick_Kyrgios,1,B-DTM,10,1,0,1,0,5,5,,,,,,,,,,
20160219-M-Marseille-QF-Richard_Gasquet-Nick_Kyrgios,1,B-DTL,4,4,1,2,1,3,1,,,,,,,,,,
20160219-M-Marseille-QF-Richard_Gasquet-Nick_Kyrgios,1,B-IO,1,0,0,0,0,0,1,,,,,,,,,,
20160219-M-Marseille-QF-Richard_Gasquet-Nick_Kyrgios,1,S-XC,11,0,0,0,0,1,10,,,,,,,,,,
20160219-M-Marseille-QF-Richard_Gasquet-Nick_Kyrgios,1,S-DTM,3,0,0,0,0,2,1,,,,,,,,,,
20160219-M-Marseille-QF-Richard_Gasquet-Nick_Kyrgios,2,F-XC,26,5,1,0,4,15,11,,,,,,,,,,
20160219-M-Marseille-QF-Richard_Gasquet-Nick_Kyrgios,2,F-DTM,9,3,0,1,2,3,6,,,,,,,,,,
20160219-M-Marseille-QF-Richard_Gasquet-Nick_Kyrgios,2,F-DTL,3,2,1,0,1,2,1,,,,,,,,,,
20160219-M-Marseille-QF-Richard_Gasquet-Nick_Kyrgios,2,F-IO,9,7,3,3,1,8,1,,,,,,,,,,
20160219-M-Marseille-QF-Richard_Gasquet-Nick_Kyrgios,2,F-II,6,3,1,2,0,5,1,,,,,,,,,,
20160219-M-Marseille-QF-Richard_Gasquet-Nick_Kyrgios,2,B-XC,37,7,2,1,4,24,13,,,,,,,,,,
20160219-M-Marseille-QF-Richard_Gasquet-Nick_Kyrgios,2,B-DTM,10,0,0,0,0,6,4,,,,,,,,,,
20160219-M-Marseille-QF-Richard_Gasquet-Nick_Kyrgios,2,B-DTL,14,6,2,2,2,9,5,,,,,,,,,,
20160219-M-Marseille-QF-Richard_Gasquet-Nick_Kyrgios,2,B-IO,6,1,0,0,1,2,4,,,,,,,,,,
20160219-M-Marseille-QF-Richard_Gasquet-Nick_Kyrgios,2,S-DTM,3,0,0,0,0,1,2,,,,,,,,,,
20160219-M-Marseille-QF-Richard_Gasquet-Nick_Kyrgios,2,S-DTL,2,0,0,0,0,2,0,,,,,,,,,,
20160219-M-Wroclaw_CH-QF-Albano_Olivetti-Dustin_Brown,1,F-XC,1,1,1,0,0,1,0,,,,,,,,,,
20160219-M-Wroclaw_CH-QF-Albano_Olivetti-Dustin_Brown,1,F-DTL,3,1,0,0,1,2,1,,,,,,,,,,
20160219-M-Wroclaw_CH-QF-Albano_Olivetti-Dustin_Brown,1,F-IO,1,1,1,0,0,1,0,,,,,,,,,,
20160219-M-Wroclaw_CH-QF-Albano_Olivetti-Dustin_Brown,1,B-XC,1,1,1,0,0,1,0,,,,,,,,,,
20160219-M-Wroclaw_CH-QF-Albano_Olivetti-Dustin_Brown,1,B-DTL,1,0,0,0,0,0,1,,,,,,,,,,
20160219-M-Wroclaw_CH-QF-Albano_Olivetti-Dustin_Brown,1,B-IO,1,0,0,0,0,1,0,,,,,,,,,,
20160219-M-Wroclaw_CH-QF-Albano_Olivetti-Dustin_Brown,1,S-XC,4,1,1,0,0,2,2,,,,,,,,,,
20160219-M-Wroclaw_CH-QF-Albano_Olivetti-Dustin_Brown,1,S-DTM,1,0,0,0,0,1,0,,,,,,,,,,
20160219-M-Wroclaw_CH-QF-Albano_Olivetti-Dustin_Brown,2,F-DTM,2,1,0,0,1,1,1,,,,,,,,,,
20160219-M-Wroclaw_CH-QF-Albano_Olivetti-Dustin_Brown,2,F-DTL,1,0,0,0,0,0,1,,,,,,,,,,
20160219-M-Wroclaw_CH-QF-Albano_Olivetti-Dustin_Brown,2,B-XC,2,1,0,0,1,0,2,,,,,,,,,,
20160219-M-Wroclaw_CH-QF-Albano_Olivetti-Dustin_Brown,2,B-DTM,1,1,0,0,1,0,1,,,,,,,,,,
20160219-M-Wroclaw_CH-QF-Albano_Olivetti-Dustin_Brown,2,B-DTL,1,1,0,0,1,0,1,,,,,,,,,,
20160219-M-Wroclaw_CH-QF-Albano_Olivetti-Dustin_Brown,2,B-IO,1,1,0,0,1,0,1,,,,,,,,,,
20160219-M-Wroclaw_CH-QF-Albano_Olivetti-Dustin_Brown,2,S-DTL,2,0,0,0,0,1,1,,,,,,,,,,
20160220-M-Marseille-SF-Tomas_Berdych-Nick_Kyrgios,1,F-XC,30,13,5,2,6,10,20,,,,,,,,,,
20160220-M-Marseille-SF-Tomas_Berdych-Nick_Kyrgios,1,F-DTM,11,1,0,0,1,2,9,,,,,,,,,,
20160220-M-Marseille-SF-Tomas_Berdych-Nick_Kyrgios,1,F-DTL,3,0,0,0,0,1,2,,,,,,,,,,
20160220-M-Marseille-SF-Tomas_Berdych-Nick_Kyrgios,1,F-IO,14,6,2,1,3,5,9,,,,,,,,,,
20160220-M-Marseille-SF-Tomas_Berdych-Nick_Kyrgios,1,F-II,2,2,1,1,0,2,0,,,,,,,,,,
20160220-M-Marseille-SF-Tomas_Berdych-Nick_Kyrgios,1,B-XC,17,3,0,2,1,8,9,,,,,,,,,,
20160220-M-Marseille-SF-Tomas_Berdych-Nick_Kyrgios,1,B-DTM,15,0,0,0,0,7,8,,,,,,,,,,
20160220-M-Marseille-SF-Tomas_Berdych-Nick_Kyrgios,1,B-DTL,6,3,1,0,2,2,4,,,,,,,,,,
20160220-M-Marseille-SF-Tomas_Berdych-Nick_Kyrgios,1,B-IO,4,0,0,0,0,1,3,,,,,,,,,,
20160220-M-Marseille-SF-Tomas_Berdych-Nick_Kyrgios,1,S-XC,10,1,0,0,1,4,6,,,,,,,,,,
20160220-M-Marseille-SF-Tomas_Berdych-Nick_Kyrgios,1,S-DTM,6,1,0,0,1,1,5,,,,,,,,,,
20160220-M-Marseille-SF-Tomas_Berdych-Nick_Kyrgios,2,F-XC,18,6,4,1,1,14,4,,,,,,,,,,
20160220-M-Marseille-SF-Tomas_Berdych-Nick_Kyrgios,2,F-DTM,11,0,0,0,0,9,2,,,,,,,,,,
20160220-M-Marseille-SF-Tomas_Berdych-Nick_Kyrgios,2,F-DTL,7,1,1,0,0,6,1,,,,,,,,,,
20160220-M-Marseille-SF-Tomas_Berdych-Nick_Kyrgios,2,F-IO,10,4,2,2,0,7,3,,,,,,,,,,
20160220-M-Marseille-SF-Tomas_Berdych-Nick_Kyrgios,2,F-II,4,3,2,0,1,3,1,,,,,,,,,,
20160220-M-Marseille-SF-Tomas_Berdych-Nick_Kyrgios,2,B-XC,22,4,1,2,1,12,10,,,,,,,,,,
20160220-M-Marseille-SF-Tomas_Berdych-Nick_Kyrgios,2,B-DTM,23,0,0,0,0,15,8,,,,,,,,,,
20160220-M-Marseille-SF-Tomas_Berdych-Nick_Kyrgios,2,B-DTL,3,3,2,0,1,2,1,,,,,,,,,,
20160220-M-Marseille-SF-Tomas_Berdych-Nick_Kyrgios,2,B-IO,2,0,0,0,0,2,0,,,,,,,,,,
20160220-M-Marseille-SF-Tomas_Berdych-Nick_Kyrgios,2,S-XC,1,0,0,0,0,0,1,,,,,,,,,,
20160220-M-Marseille-SF-Tomas_Berdych-Nick_Kyrgios,2,S-DTM,1,0,0,0,0,1,0,,,,,,,,,,
20160220-M-Rio_de_Janeiro-SF-Dominic_Thiem-Guido_Pella,1,F-XC,48,8,3,3,2,20,28,,,,,,,,,,
20160220-M-Rio_de_Janeiro-SF-Dominic_Thiem-Guido_Pella,1,F-DTM,45,4,0,0,4,16,29,,,,,,,,,,
20160220-M-Rio_de_Janeiro-SF-Dominic_Thiem-Guido_Pella,1,F-DTL,5,2,1,0,1,2,3,,,,,,,,,,
20160220-M-Rio_de_Janeiro-SF-Dominic_Thiem-Guido_Pella,1,F-IO,23,10,1,3,6,13,10,,,,,,,,,,
20160220-M-Rio_de_Janeiro-SF-Dominic_Thiem-Guido_Pella,1,B-XC,9,2,0,0,2,2,7,,,,,,,,,,
20160220-M-Rio_de_Janeiro-SF-Dominic_Thiem-Guido_Pella,1,B-DTM,17,5,0,0,5,2,15,,,,,,,,,,
20160220-M-Rio_de_Janeiro-SF-Dominic_Thiem-Guido_Pella,1,B-DTL,2,1,1,0,0,1,1,,,,,,,,,,
20160220-M-Rio_de_Janeiro-SF-Dominic_Thiem-Guido_Pella,1,B-IO,4,3,2,0,1,2,2,,,,,,,,,,
20160220-M-Rio_de_Janeiro-SF-Dominic_Thiem-Guido_Pella,1,S-XC,2,0,0,0,0,1,1,,,,,,,,,,
20160220-M-Rio_de_Janeiro-SF-Dominic_Thiem-Guido_Pella,1,S-DTM,10,1,0,0,1,4,6,,,,,,,,,,
20160220-M-Rio_de_Janeiro-SF-Dominic_Thiem-Guido_Pella,1,S-DTL,1,0,0,0,0,0,1,,,,,,,,,,
20160220-M-Rio_de_Janeiro-SF-Dominic_Thiem-Guido_Pella,2,F-XC,38,8,4,1,3,27,11,,,,,,,,,,
20160220-M-Rio_de_Janeiro-SF-Dominic_Thiem-Guido_Pella,2,F-DTM,32,2,0,1,1,18,14,,,,,,,,,,
20160220-M-Rio_de_Janeiro-SF-Dominic_Thiem-Guido_Pella,2,F-DTL,8,2,0,1,1,4,4,,,,,,,,,,
20160220-M-Rio_de_Janeiro-SF-Dominic_Thiem-Guido_Pella,2,F-IO,19,8,3,1,4,11,8,,,,,,,,,,
20160220-M-Rio_de_Janeiro-SF-Dominic_Thiem-Guido_Pella,2,F-II,1,1,1,0,0,1,0,,,,,,,,,,
20160220-M-Rio_de_Janeiro-SF-Dominic_Thiem-Guido_Pella,2,B-XC,22,7,1,3,3,14,8,,,,,,,,,,
20160220-M-Rio_de_Janeiro-SF-Dominic_Thiem-Guido_Pella,2,B-DTM,32,1,0,0,1,22,10,,,,,,,,,,
20160220-M-Rio_de_Janeiro-SF-Dominic_Thiem-Guido_Pella,2,B-DTL,4,0,0,0,0,2,2,,,,,,,,,,
20160220-M-Rio_de_Janeiro-SF-Dominic_Thiem-Guido_Pella,2,B-IO,2,0,0,0,0,2,0,,,,,,,,,,
20160220-M-Rio_de_Janeiro-SF-Dominic_Thiem-Guido_Pella,2,S-XC,3,2,1,1,0,2,1,,,,,,,,,,
20160220-M-Rio_de_Janeiro-SF-Dominic_Thiem-Guido_Pella,2,S-DTM,3,0,0,0,0,2,1,,,,,,,,,,
20160220-M-Rio_de_Janeiro-SF-Dominic_Thiem-Guido_Pella,2,S-DTL,3,3,1,1,1,2,1,,,,,,,,,,
20160223-M-Cherbourg_CH-R32-Jurgen_Zopp-Jordan_Thompson,1,F-XC,41,10,1,1,8,12,29,,,,,,,,,,
20160223-M-Cherbourg_CH-R32-Jurgen_Zopp-Jordan_Thompson,1,F-DTM,17,2,0,1,1,2,15,,,,,,,,,,
20160223-M-Cherbourg_CH-R32-Jurgen_Zopp-Jordan_Thompson,1,F-DTL,1,1,1,0,0,1,0,,,,,,,,,,
20160223-M-Cherbourg_CH-R32-Jurgen_Zopp-Jordan_Thompson,1,F-IO,28,6,0,1,5,9,19,,,,,,,,,,
20160223-M-Cherbourg_CH-R32-Jurgen_Zopp-Jordan_Thompson,1,F-II,7,3,0,1,2,2,5,,,,,,,,,,
20160223-M-Cherbourg_CH-R32-Jurgen_Zopp-Jordan_Thompson,1,B-XC,41,2,0,0,2,14,27,,,,,,,,,,
20160223-M-Cherbourg_CH-R32-Jurgen_Zopp-Jordan_Thompson,1,B-DTM,12,1,0,0,1,3,9,,,,,,,,,,
20160223-M-Cherbourg_CH-R32-Jurgen_Zopp-Jordan_Thompson,1,B-DTL,3,1,0,1,0,2,1,,,,,,,,,,
20160223-M-Cherbourg_CH-R32-Jurgen_Zopp-Jordan_Thompson,1,B-IO,5,0,0,0,0,2,3,,,,,,,,,,
20160223-M-Cherbourg_CH-R32-Jurgen_Zopp-Jordan_Thompson,1,S-XC,5,1,0,0,1,2,3,,,,,,,,,,
20160223-M-Cherbourg_CH-R32-Jurgen_Zopp-Jordan_Thompson,1,S-DTM,1,0,0,0,0,0,1,,,,,,,,,,
20160223-M-Cherbourg_CH-R32-Jurgen_Zopp-Jordan_Thompson,1,S-DTL,1,0,0,0,0,0,1,,,,,,,,,,
20160223-M-Cherbourg_CH-R32-Jurgen_Zopp-Jordan_Thompson,2,F-XC,14,3,3,0,0,11,3,,,,,,,,,,
20160223-M-Cherbourg_CH-R32-Jurgen_Zopp-Jordan_Thompson,2,F-DTM,27,1,0,0,1,18,9,,,,,,,,,,
20160223-M-Cherbourg_CH-R32-Jurgen_Zopp-Jordan_Thompson,2,F-DTL,16,3,1,1,1,11,5,,,,,,,,,,
20160223-M-Cherbourg_CH-R32-Jurgen_Zopp-Jordan_Thompson,2,F-IO,18,0,0,0,0,14,4,,,,,,,,,,
20160223-M-Cherbourg_CH-R32-Jurgen_Zopp-Jordan_Thompson,2,F-II,1,0,0,0,0,1,0,,,,,,,,,,
20160223-M-Cherbourg_CH-R32-Jurgen_Zopp-Jordan_Thompson,2,B-XC,33,3,0,0,3,19,14,,,,,,,,,,
20160223-M-Cherbourg_CH-R32-Jurgen_Zopp-Jordan_Thompson,2,B-DTM,17,2,0,1,1,13,4,,,,,,,,,,
20160223-M-Cherbourg_CH-R32-Jurgen_Zopp-Jordan_Thompson,2,B-DTL,16,6,2,2,2,12,4,,,,,,,,,,
20160223-M-Cherbourg_CH-R32-Jurgen_Zopp-Jordan_Thompson,2,B-IO,2,0,0,0,0,2,0,,,,,,,,,,
20160223-M-Cherbourg_CH-R32-Jurgen_Zopp-Jordan_Thompson,2,S-XC,3,0,0,0,0,0,3,,,,,,,,,,
20160223-M-Cherbourg_CH-R32-Jurgen_Zopp-Jordan_Thompson,2,S-DTM,7,0,0,0,0,3,4,,,,,,,,,,
20160223-M-Cherbourg_CH-R32-Jurgen_Zopp-Jordan_Thompson,2,S-DTL,1,0,0,0,0,0,1,,,,,,,,,,
20160225-M-Cherbourg_CH-R16-Ramkumar_Ramanathan-Adam_Pavlasek,1,F-XC,32,8,3,2,3,15,17,,,,,,,,,,
20160225-M-Cherbourg_CH-R16-Ramkumar_Ramanathan-Adam_Pavlasek,1,F-DTM,18,5,0,1,4,7,11,,,,,,,,,,
20160225-M-Cherbourg_CH-R16-Ramkumar_Ramanathan-Adam_Pavlasek,1,F-DTL,10,4,1,1,2,5,5,,,,,,,,,,
20160225-M-Cherbourg_CH-R16-Ramkumar_Ramanathan-Adam_Pavlasek,1,F-IO,21,4,2,0,2,6,15,,,,,,,,,,
20160225-M-Cherbourg_CH-R16-Ramkumar_Ramanathan-Adam_Pavlasek,1,F-II,11,4,2,1,1,6,5,,,,,,,,,,
20160225-M-Cherbourg_CH-R16-Ramkumar_Ramanathan-Adam_Pavlasek,1,B-XC,18,3,1,0,2,6,12,,,,,,,,,,
20160225-M-Cherbourg_CH-R16-Ramkumar_Ramanathan-Adam_Pavlasek,1,B-DTM,8,0,0,0,0,1,7,,,,,,,,,,
20160225-M-Cherbourg_CH-R16-Ramkumar_Ramanathan-Adam_Pavlasek,1,B-DTL,5,4,0,0,4,0,5,,,,,,,,,,
20160225-M-Cherbourg_CH-R16-Ramkumar_Ramanathan-Adam_Pavlasek,1,S-XC,9,1,0,0,1,7,2,,,,,,,,,,
20160225-M-Cherbourg_CH-R16-Ramkumar_Ramanathan-Adam_Pavlasek,1,S-DTM,3,0,0,0,0,0,3,,,,,,,,,,
20160225-M-Cherbourg_CH-R16-Ramkumar_Ramanathan-Adam_Pavlasek,1,S-DTL,4,1,0,0,1,0,4,,,,,,,,,,
20160225-M-Cherbourg_CH-R16-Ramkumar_Ramanathan-Adam_Pavlasek,1,S-IO,1,0,0,0,0,0,1,,,,,,,,,,
20160225-M-Cherbourg_CH-R16-Ramkumar_Ramanathan-Adam_Pavlasek,2,F-XC,23,5,1,0,4,11,12,,,,,,,,,,
20160225-M-Cherbourg_CH-R16-Ramkumar_Ramanathan-Adam_Pavlasek,2,F-DTM,19,2,0,1,1,13,6,,,,,,,,,,
20160225-M-Cherbourg_CH-R16-Ramkumar_Ramanathan-Adam_Pavlasek,2,F-DTL,15,6,2,3,1,11,4,,,,,,,,,,
20160225-M-Cherbourg_CH-R16-Ramkumar_Ramanathan-Adam_Pavlasek,2,F-IO,22,7,3,2,2,14,8,,,,,,,,,,
20160225-M-Cherbourg_CH-R16-Ramkumar_Ramanathan-Adam_Pavlasek,2,F-II,4,0,0,0,0,4,0,,,,,,,,,,
20160225-M-Cherbourg_CH-R16-Ramkumar_Ramanathan-Adam_Pavlasek,2,B-XC,20,1,0,0,1,13,7,,,,,,,,,,
20160225-M-Cherbourg_CH-R16-Ramkumar_Ramanathan-Adam_Pavlasek,2,B-DTM,12,2,0,0,2,6,6,,,,,,,,,,
20160225-M-Cherbourg_CH-R16-Ramkumar_Ramanathan-Adam_Pavlasek,2,B-DTL,9,2,0,0,2,4,5,,,,,,,,,,
20160225-M-Cherbourg_CH-R16-Ramkumar_Ramanathan-Adam_Pavlasek,2,B-IO,1,1,1,0,0,1,0,,,,,,,,,,
20160225-M-Cherbourg_CH-R16-Ramkumar_Ramanathan-Adam_Pavlasek,2,S-XC,9,1,0,0,1,5,4,,,,,,,,,,
20160227-M-Cherbourg_CH-SF-Jordan_Thompson-Vincent_Millot,1,F-XC,31,2,0,1,1,18,13,,,,,,,,,,
20160227-M-Cherbourg_CH-SF-Jordan_Thompson-Vincent_Millot,1,F-DTM,18,3,1,0,2,10,8,,,,,,,,,,
20160227-M-Cherbourg_CH-SF-Jordan_Thompson-Vincent_Millot,1,F-DTL,14,3,1,0,2,8,6,,,,,,,,,,
20160227-M-Cherbourg_CH-SF-Jordan_Thompson-Vincent_Millot,1,F-IO,9,3,1,1,1,6,3,,,,,,,,,,
20160227-M-Cherbourg_CH-SF-Jordan_Thompson-Vincent_Millot,1,F-II,1,1,1,0,0,1,0,,,,,,,,,,
20160227-M-Cherbourg_CH-SF-Jordan_Thompson-Vincent_Millot,1,B-XC,24,4,0,1,3,15,9,,,,,,,,,,
20160227-M-Cherbourg_CH-SF-Jordan_Thompson-Vincent_Millot,1,B-DTM,23,0,0,0,0,14,9,,,,,,,,,,
20160227-M-Cherbourg_CH-SF-Jordan_Thompson-Vincent_Millot,1,B-DTL,6,2,1,0,1,4,2,,,,,,,,,,
20160227-M-Cherbourg_CH-SF-Jordan_Thompson-Vincent_Millot,1,B-IO,1,0,0,0,0,0,1,,,,,,,,,,
20160227-M-Cherbourg_CH-SF-Jordan_Thompson-Vincent_Millot,1,S-XC,2,0,0,0,0,1,1,,,,,,,,,,
20160227-M-Cherbourg_CH-SF-Jordan_Thompson-Vincent_Millot,1,S-DTM,3,0,0,0,0,1,2,,,,,,,,,,
20160227-M-Cherbourg_CH-SF-Jordan_Thompson-Vincent_Millot,1,S-DTL,3,1,1,0,0,2,1,,,,,,,,,,
20160227-M-Cherbourg_CH-SF-Jordan_Thompson-Vincent_Millot,2,F-XC,44,9,3,0,6,12,32,,,,,,,,,,
20160227-M-Cherbourg_CH-SF-Jordan_Thompson-Vincent_Millot,2,F-DTM,13,2,0,0,2,6,7,,,,,,,,,,
20160227-M-Cherbourg_CH-SF-Jordan_Thompson-Vincent_Millot,2,F-DTL,11,6,1,1,4,3,8,,,,,,,,,,
20160227-M-Cherbourg_CH-SF-Jordan_Thompson-Vincent_Millot,2,F-IO,22,6,1,1,4,12,10,,,,,,,,,,
20160227-M-Cherbourg_CH-SF-Jordan_Thompson-Vincent_Millot,2,F-II,1,0,0,0,0,0,1,,,,,,,,,,
20160227-M-Cherbourg_CH-SF-Jordan_Thompson-Vincent_Millot,2,B-XC,26,8,1,1,6,9,17,,,,,,,,,,
20160227-M-Cherbourg_CH-SF-Jordan_Thompson-Vincent_Millot,2,B-DTM,10,1,0,0,1,4,6,,,,,,,,,,
20160227-M-Cherbourg_CH-SF-Jordan_Thompson-Vincent_Millot,2,B-DTL,12,4,1,0,3,6,6,,,,,,,,,,
20160227-M-Cherbourg_CH-SF-Jordan_Thompson-Vincent_Millot,2,B-IO,7,1,0,1,0,4,3,,,,,,,,,,
20160227-M-Cherbourg_CH-SF-Jordan_Thompson-Vincent_Millot,2,S-DTM,1,0,0,0,0,0,1,,,,,,,,,,
20160304-M-Quimper_CH-QF-Paul_Henri_Mathieu-Igor_Sijsling,1,F-XC,19,6,1,2,3,6,13,,,,,,,,,,
20160304-M-Quimper_CH-QF-Paul_Henri_Mathieu-Igor_Sijsling,1,F-DTM,3,2,0,0,2,0,3,,,,,,,,,,
20160304-M-Quimper_CH-QF-Paul_Henri_Mathieu-Igor_Sijsling,1,F-DTL,9,3,1,0,2,2,7,,,,,,,,,,
20160304-M-Quimper_CH-QF-Paul_Henri_Mathieu-Igor_Sijsling,1,F-IO,13,6,3,2,1,8,5,,,,,,,,,,
20160304-M-Quimper_CH-QF-Paul_Henri_Mathieu-Igor_Sijsling,1,B-XC,29,2,1,0,1,15,14,,,,,,,,,,
20160304-M-Quimper_CH-QF-Paul_Henri_Mathieu-Igor_Sijsling,1,B-DTM,9,1,0,0,1,2,7,,,,,,,,,,
20160304-M-Quimper_CH-QF-Paul_Henri_Mathieu-Igor_Sijsling,1,B-DTL,8,3,0,2,1,4,4,,,,,,,,,,
20160304-M-Quimper_CH-QF-Paul_Henri_Mathieu-Igor_Sijsling,1,B-IO,1,1,0,0,1,0,1,,,,,,,,,,
20160304-M-Quimper_CH-QF-Paul_Henri_Mathieu-Igor_Sijsling,1,S-DTL,1,0,0,0,0,0,1,,,,,,,,,,
20160304-M-Quimper_CH-QF-Paul_Henri_Mathieu-Igor_Sijsling,2,F-XC,10,3,0,2,1,8,2,,,,,,,,,,
20160304-M-Quimper_CH-QF-Paul_Henri_Mathieu-Igor_Sijsling,2,F-DTM,10,0,0,0,0,6,4,,,,,,,,,,
20160304-M-Quimper_CH-QF-Paul_Henri_Mathieu-Igor_Sijsling,2,F-DTL,9,6,2,1,3,5,4,,,,,,,,,,
20160304-M-Quimper_CH-QF-Paul_Henri_Mathieu-Igor_Sijsling,2,F-IO,8,2,1,0,1,6,2,,,,,,,,,,
20160304-M-Quimper_CH-QF-Paul_Henri_Mathieu-Igor_Sijsling,2,B-XC,7,1,0,0,1,3,4,,,,,,,,,,
20160304-M-Quimper_CH-QF-Paul_Henri_Mathieu-Igor_Sijsling,2,B-DTM,6,1,0,0,1,3,3,,,,,,,,,,
20160304-M-Quimper_CH-QF-Paul_Henri_Mathieu-Igor_Sijsling,2,B-DTL,6,4,3,0,1,5,1,,,,,,,,,,
20160304-M-Quimper_CH-QF-Paul_Henri_Mathieu-Igor_Sijsling,2,B-IO,1,0,0,0,0,1,0,,,,,,,,,,
20160304-M-Quimper_CH-QF-Paul_Henri_Mathieu-Igor_Sijsling,2,S-XC,21,1,0,0,1,11,10,,,,,,,,,,
20160304-M-Quimper_CH-QF-Paul_Henri_Mathieu-Igor_Sijsling,2,S-DTM,6,0,0,0,0,1,5,,,,,,,,,,
20160304-M-Quimper_CH-QF-Paul_Henri_Mathieu-Igor_Sijsling,2,S-DTL,1,0,0,0,0,1,0,,,,,,,,,,
20160304-M-Quimper_CH-QF-Paul_Henri_Mathieu-Igor_Sijsling,2,S-IO,1,0,0,0,0,1,0,,,,,,,,,,
20160307-M-Puebla_CH-Q3-Fernando_Romboli-Stefano_Napolitano,1,F-XC,5,3,0,1,2,2,3,,,,,,,,,,
20160307-M-Puebla_CH-Q3-Fernando_Romboli-Stefano_Napolitano,1,F-DTM,10,1,0,1,0,5,5,,,,,,,,,,
20160307-M-Puebla_CH-Q3-Fernando_Romboli-Stefano_Napolitano,1,F-DTL,3,1,0,0,1,0,3,,,,,,,,,,
20160307-M-Puebla_CH-Q3-Fernando_Romboli-Stefano_Napolitano,1,F-IO,2,0,0,0,0,1,1,,,,,,,,,,
20160307-M-Puebla_CH-Q3-Fernando_Romboli-Stefano_Napolitano,1,B-DTM,1,0,0,0,0,1,0,,,,,,,,,,
20160307-M-Puebla_CH-Q3-Fernando_Romboli-Stefano_Napolitano,1,B-DTL,5,1,0,0,1,2,3,,,,,,,,,,
20160307-M-Puebla_CH-Q3-Fernando_Romboli-Stefano_Napolitano,1,S-XC,5,3,0,1,2,2,3,,,,,,,,,,
20160307-M-Puebla_CH-Q3-Fernando_Romboli-Stefano_Napolitano,1,S-DTM,7,1,0,0,1,2,5,,,,,,,,,,
20160307-M-Puebla_CH-Q3-Fernando_Romboli-Stefano_Napolitano,1,S-DTL,3,0,0,0,0,1,2,,,,,,,,,,
20160307-M-Puebla_CH-Q3-Fernando_Romboli-Stefano_Napolitano,2,F-XC,23,10,6,3,1,17,6,,,,,,,,,,
20160307-M-Puebla_CH-Q3-Fernando_Romboli-Stefano_Napolitano,2,F-DTM,2,0,0,0,0,0,2,,,,,,,,,,
20160307-M-Puebla_CH-Q3-Fernando_Romboli-Stefano_Napolitano,2,F-IO,8,1,1,0,0,5,3,,,,,,,,,,
20160307-M-Puebla_CH-Q3-Fernando_Romboli-Stefano_Napolitano,2,F-II,5,4,1,1,2,3,2,,,,,,,,,,
20160307-M-Puebla_CH-Q3-Fernando_Romboli-Stefano_Napolitano,2,B-XC,14,4,1,2,1,9,5,,,,,,,,,,
20160307-M-Puebla_CH-Q3-Fernando_Romboli-Stefano_Napolitano,2,B-DTM,8,4,1,1,2,6,2,,,,,,,,,,
20160307-M-Puebla_CH-Q3-Fernando_Romboli-Stefano_Napolitano,2,B-IO,1,1,1,0,0,1,0,,,,,,,,,,
20160307-M-Puebla_CH-Q3-Fernando_Romboli-Stefano_Napolitano,2,S-XC,3,1,0,0,1,2,1,,,,,,,,,,
20160307-M-Puebla_CH-Q3-Fernando_Romboli-Stefano_Napolitano,2,S-DTM,1,0,0,0,0,0,1,,,,,,,,,,
20160310-M-Indian_Wells_Masters-R128-Damir_Dzumhur-Marcel_Granollers,1,F-XC,6,1,0,0,1,2,4,,,,,,,,,,
20160310-M-Indian_Wells_Masters-R128-Damir_Dzumhur-Marcel_Granollers,1,F-DTM,7,0,0,0,0,3,4,,,,,,,,,,
20160310-M-Indian_Wells_Masters-R128-Damir_Dzumhur-Marcel_Granollers,1,F-DTL,9,2,0,0,2,0,9,,,,,,,,,,
20160310-M-Indian_Wells_Masters-R128-Damir_Dzumhur-Marcel_Granollers,1,F-IO,19,5,0,1,4,5,14,,,,,,,,,,
20160310-M-Indian_Wells_Masters-R128-Damir_Dzumhur-Marcel_Granollers,1,F-II,1,0,0,0,0,0,1,,,,,,,,,,
20160310-M-Indian_Wells_Masters-R128-Damir_Dzumhur-Marcel_Granollers,1,B-XC,40,7,1,3,3,15,25,,,,,,,,,,
20160310-M-Indian_Wells_Masters-R128-Damir_Dzumhur-Marcel_Granollers,1,B-DTM,24,2,0,0,2,8,16,,,,,,,,,,
20160310-M-Indian_Wells_Masters-R128-Damir_Dzumhur-Marcel_Granollers,1,B-DTL,21,11,2,2,7,8,13,,,,,,,,,,
20160310-M-Indian_Wells_Masters-R128-Damir_Dzumhur-Marcel_Granollers,1,B-IO,8,2,0,1,1,3,5,,,,,,,,,,
20160310-M-Indian_Wells_Masters-R128-Damir_Dzumhur-Marcel_Granollers,1,S-XC,13,0,0,0,0,3,10,,,,,,,,,,
20160310-M-Indian_Wells_Masters-R128-Damir_Dzumhur-Marcel_Granollers,1,S-DTM,1,0,0,0,0,0,1,,,,,,,,,,
20160310-M-Indian_Wells_Masters-R128-Damir_Dzumhur-Marcel_Granollers,1,S-DTL,4,1,0,1,0,2,2,,,,,,,,,,
20160310-M-Indian_Wells_Masters-R128-Damir_Dzumhur-Marcel_Granollers,2,F-XC,17,3,2,0,1,11,6,,,,,,,,,,
20160310-M-Indian_Wells_Masters-R128-Damir_Dzumhur-Marcel_Granollers,2,F-DTM,10,0,0,0,0,5,5,,,,,,,,,,
20160310-M-Indian_Wells_Masters-R128-Damir_Dzumhur-Marcel_Granollers,2,F-DTL,12,3,0,2,1,9,3,,,,,,,,,,
20160310-M-Indian_Wells_Masters-R128-Damir_Dzumhur-Marcel_Granollers,2,F-IO,12,3,0,0,3,6,6,,,,,,,,,,
20160310-M-Indian_Wells_Masters-R128-Damir_Dzumhur-Marcel_Granollers,2,B-XC,41,2,0,1,1,27,14,,,,,,,,,,
20160310-M-Indian_Wells_Masters-R128-Damir_Dzumhur-Marcel_Granollers,2,B-DTM,20,1,0,0,1,14,6,,,,,,,,,,
20160310-M-Indian_Wells_Masters-R128-Damir_Dzumhur-Marcel_Granollers,2,B-DTL,4,1,0,1,0,3,1,,,,,,,,,,
20160310-M-Indian_Wells_Masters-R128-Damir_Dzumhur-Marcel_Granollers,2,B-IO,2,1,0,1,0,2,0,,,,,,,,,,
20160310-M-Indian_Wells_Masters-R128-Damir_Dzumhur-Marcel_Granollers,2,S-XC,18,2,0,0,2,13,5,,,,,,,,,,
20160310-M-Indian_Wells_Masters-R128-Damir_Dzumhur-Marcel_Granollers,2,S-DTM,7,0,0,0,0,6,1,,,,,,,,,,
20160310-M-Indian_Wells_Masters-R128-Damir_Dzumhur-Marcel_Granollers,2,S-DTL,2,0,0,0,0,1,1,,,,,,,,,,
20160310-M-Indian_Wells_Masters-R128-Damir_Dzumhur-Marcel_Granollers,2,S-IO,1,0,0,0,0,1,0,,,,,,,,,,
20160310-M-Indian_Wells_Masters-R128-Pablo_Carreno_Busta-Evgeny_Donskoy,1,F-XC,21,8,3,2,3,13,8,,,,,,,,,,
20160310-M-Indian_Wells_Masters-R128-Pablo_Carreno_Busta-Evgeny_Donskoy,1,F-DTM,12,0,0,0,0,9,3,,,,,,,,,,
20160310-M-Indian_Wells_Masters-R128-Pablo_Carreno_Busta-Evgeny_Donskoy,1,F-DTL,1,1,1,0,0,1,0,,,,,,,,,,
20160310-M-Indian_Wells_Masters-R128-Pablo_Carreno_Busta-Evgeny_Donskoy,1,F-IO,10,3,0,1,2,6,4,,,,,,,,,,
20160310-M-Indian_Wells_Masters-R128-Pablo_Carreno_Busta-Evgeny_Donskoy,1,B-XC,25,8,1,2,5,15,10,,,,,,,,,,
20160310-M-Indian_Wells_Masters-R128-Pablo_Carreno_Busta-Evgeny_Donskoy,1,B-DTM,16,0,0,0,0,11,5,,,,,,,,,,
20160310-M-Indian_Wells_Masters-R128-Pablo_Carreno_Busta-Evgeny_Donskoy,1,B-IO,3,2,1,0,1,1,2,,,,,,,,,,
20160310-M-Indian_Wells_Masters-R128-Pablo_Carreno_Busta-Evgeny_Donskoy,1,S-XC,3,0,0,0,0,0,3,,,,,,,,,,
20160310-M-Indian_Wells_Masters-R128-Pablo_Carreno_Busta-Evgeny_Donskoy,1,S-DTM,1,0,0,0,0,0,1,,,,,,,,,,
20160310-M-Indian_Wells_Masters-R128-Pablo_Carreno_Busta-Evgeny_Donskoy,1,S-DTL,1,0,0,0,0,0,1,,,,,,,,,,
20160310-M-Indian_Wells_Masters-R128-Pablo_Carreno_Busta-Evgeny_Donskoy,2,F-XC,17,8,3,3,2,8,9,,,,,,,,,,
20160310-M-Indian_Wells_Masters-R128-Pablo_Carreno_Busta-Evgeny_Donskoy,2,F-DTM,23,4,0,1,3,8,15,,,,,,,,,,
20160310-M-Indian_Wells_Masters-R128-Pablo_Carreno_Busta-Evgeny_Donskoy,2,F-DTL,3,0,0,0,0,1,2,,,,,,,,,,
20160310-M-Indian_Wells_Masters-R128-Pablo_Carreno_Busta-Evgeny_Donskoy,2,F-IO,7,4,1,0,3,4,3,,,,,,,,,,
20160310-M-Indian_Wells_Masters-R128-Pablo_Carreno_Busta-Evgeny_Donskoy,2,B-XC,17,5,1,0,4,7,10,,,,,,,,,,
20160310-M-Indian_Wells_Masters-R128-Pablo_Carreno_Busta-Evgeny_Donskoy,2,B-DTM,20,2,0,0,2,7,13,,,,,,,,,,
20160310-M-Indian_Wells_Masters-R128-Pablo_Carreno_Busta-Evgeny_Donskoy,2,B-DTL,1,0,0,0,0,0,1,,,,,,,,,,
20160310-M-Indian_Wells_Masters-R128-Pablo_Carreno_Busta-Evgeny_Donskoy,2,B-IO,1,0,0,0,0,0,1,,,,,,,,,,
20160310-M-Indian_Wells_Masters-R128-Pablo_Carreno_Busta-Evgeny_Donskoy,2,S-XC,2,0,0,0,0,1,1,,,,,,,,,,
20160310-M-Indian_Wells_Masters-R128-Pablo_Carreno_Busta-Evgeny_Donskoy,2,S-DTM,4,0,0,0,0,0,4,,,,,,,,,,
20160310-M-Indian_Wells_Masters-R128-Pablo_Carreno_Busta-Evgeny_Donskoy,2,S-DTL,1,1,1,0,0,1,0,,,,,,,,,,
20160310-M-Puebla_CH-R16-Dennis_Novak-Agustin_Velotti,1,F-XC,34,6,1,3,2,17,17,,,,,,,,,,
20160310-M-Puebla_CH-R16-Dennis_Novak-Agustin_Velotti,1,F-DTM,13,3,1,0,2,4,9,,,,,,,,,,
20160310-M-Puebla_CH-R16-Dennis_Novak-Agustin_Velotti,1,F-DTL,8,3,2,0,1,4,4,,,,,,,,,,
20160310-M-Puebla_CH-R16-Dennis_Novak-Agustin_Velotti,1,F-IO,30,10,2,3,5,18,12,,,,,,,,,,
20160310-M-Puebla_CH-R16-Dennis_Novak-Agustin_Velotti,1,F-II,1,0,0,0,0,0,1,,,,,,,,,,
20160310-M-Puebla_CH-R16-Dennis_Novak-Agustin_Velotti,1,B-XC,30,5,0,0,5,9,21,,,,,,,,,,
20160310-M-Puebla_CH-R16-Dennis_Novak-Agustin_Velotti,1,B-DTM,10,2,0,0,2,0,10,,,,,,,,,,
20160310-M-Puebla_CH-R16-Dennis_Novak-Agustin_Velotti,1,B-DTL,6,5,1,0,4,1,5,,,,,,,,,,
20160310-M-Puebla_CH-R16-Dennis_Novak-Agustin_Velotti,1,B-IO,5,1,0,0,1,2,3,,,,,,,,,,
20160310-M-Puebla_CH-R16-Dennis_Novak-Agustin_Velotti,1,S-XC,9,2,0,0,2,1,8,,,,,,,,,,
20160310-M-Puebla_CH-R16-Dennis_Novak-Agustin_Velotti,1,S-IO,1,0,0,0,0,1,0,,,,,,,,,,
20160310-M-Puebla_CH-R16-Dennis_Novak-Agustin_Velotti,2,F-XC,13,5,1,3,1,8,5,,,,,,,,,,
20160310-M-Puebla_CH-R16-Dennis_Novak-Agustin_Velotti,2,F-DTM,24,3,0,0,3,16,8,,,,,,,,,,
20160310-M-Puebla_CH-R16-Dennis_Novak-Agustin_Velotti,2,F-DTL,7,4,1,1,2,4,3,,,,,,,,,,
20160310-M-Puebla_CH-R16-Dennis_Novak-Agustin_Velotti,2,F-IO,18,3,1,2,0,15,3,,,,,,,,,,
20160310-M-Puebla_CH-R16-Dennis_Novak-Agustin_Velotti,2,F-II,5,0,0,0,0,4,1,,,,,,,,,,
20160310-M-Puebla_CH-R16-Dennis_Novak-Agustin_Velotti,2,B-XC,13,1,1,0,0,10,3,,,,,,,,,,
20160310-M-Puebla_CH-R16-Dennis_Novak-Agustin_Velotti,2,B-DTM,23,1,0,0,1,11,12,,,,,,,,,,
20160310-M-Puebla_CH-R16-Dennis_Novak-Agustin_Velotti,2,B-DTL,5,1,0,1,0,4,1,,,,,,,,,,
20160310-M-Puebla_CH-R16-Dennis_Novak-Agustin_Velotti,2,B-IO,1,1,1,0,0,1,0,,,,,,,,,,
20160310-M-Puebla_CH-R16-Dennis_Novak-Agustin_Velotti,2,S-XC,11,0,0,0,0,6,5,,,,,,,,,,
20160310-M-Puebla_CH-R16-Dennis_Novak-Agustin_Velotti,2,S-DTM,9,1,0,0,1,3,6,,,,,,,,,,
20160310-M-Puebla_CH-R16-Dennis_Novak-Agustin_Velotti,2,S-DTL,4,0,0,0,0,1,3,,,,,,,,,,
20160312-M-Indian_Wells_Masters-R64-Jeremy_Chardy-Andrey_Kuznetsov,1,F-XC,20,12,4,5,3,12,8,,,,,,,,,,
20160312-M-Indian_Wells_Masters-R64-Jeremy_Chardy-Andrey_Kuznetsov,1,F-DTM,14,1,0,0,1,4,10,,,,,,,,,,
20160312-M-Indian_Wells_Masters-R64-Jeremy_Chardy-Andrey_Kuznetsov,1,F-DTL,1,1,0,0,1,0,1,,,,,,,,,,
20160312-M-Indian_Wells_Masters-R64-Jeremy_Chardy-Andrey_Kuznetsov,1,F-IO,19,10,5,1,4,8,11,,,,,,,,,,
20160312-M-Indian_Wells_Masters-R64-Jeremy_Chardy-Andrey_Kuznetsov,1,F-II,2,1,1,0,0,2,0,,,,,,,,,,
20160312-M-Indian_Wells_Masters-R64-Jeremy_Chardy-Andrey_Kuznetsov,1,B-XC,5,2,0,0,2,1,4,,,,,,,,,,
20160312-M-Indian_Wells_Masters-R64-Jeremy_Chardy-Andrey_Kuznetsov,1,B-DTM,12,0,0,0,0,3,9,,,,,,,,,,
20160312-M-Indian_Wells_Masters-R64-Jeremy_Chardy-Andrey_Kuznetsov,1,B-DTL,1,1,0,1,0,1,0,,,,,,,,,,
20160312-M-Indian_Wells_Masters-R64-Jeremy_Chardy-Andrey_Kuznetsov,1,B-IO,1,1,1,0,0,1,0,,,,,,,,,,
20160312-M-Indian_Wells_Masters-R64-Jeremy_Chardy-Andrey_Kuznetsov,1,S-XC,2,1,0,0,1,0,2,,,,,,,,,,
20160312-M-Indian_Wells_Masters-R64-Jeremy_Chardy-Andrey_Kuznetsov,1,S-DTM,3,0,0,0,0,1,2,,,,,,,,,,
20160312-M-Indian_Wells_Masters-R64-Jeremy_Chardy-Andrey_Kuznetsov,2,F-XC,12,6,4,1,1,11,1,,,,,,,,,,
20160312-M-Indian_Wells_Masters-R64-Jeremy_Chardy-Andrey_Kuznetsov,2,F-DTM,17,2,0,2,0,12,5,,,,,,,,,,
20160312-M-Indian_Wells_Masters-R64-Jeremy_Chardy-Andrey_Kuznetsov,2,F-DTL,2,2,1,0,1,1,1,,,,,,,,,,
20160312-M-Indian_Wells_Masters-R64-Jeremy_Chardy-Andrey_Kuznetsov,2,F-IO,10,5,1,3,1,8,2,,,,,,,,,,
20160312-M-Indian_Wells_Masters-R64-Jeremy_Chardy-Andrey_Kuznetsov,2,B-XC,18,4,3,0,1,13,5,,,,,,,,,,
20160312-M-Indian_Wells_Masters-R64-Jeremy_Chardy-Andrey_Kuznetsov,2,B-DTM,13,1,0,0,1,4,9,,,,,,,,,,
20160312-M-Indian_Wells_Masters-R64-Jeremy_Chardy-Andrey_Kuznetsov,2,B-DTL,3,3,3,0,0,3,0,,,,,,,,,,
20160312-M-Indian_Wells_Masters-R64-Jeremy_Chardy-Andrey_Kuznetsov,2,B-IO,2,1,0,0,1,1,1,,,,,,,,,,
20160312-M-Indian_Wells_Masters-R64-Jeremy_Chardy-Andrey_Kuznetsov,2,S-XC,2,0,0,0,0,0,2,,,,,,,,,,
20160312-M-Indian_Wells_Masters-R64-Jeremy_Chardy-Andrey_Kuznetsov,2,S-DTM,2,0,0,0,0,1,1,,,,,,,,,,
20160312-M-Indian_Wells_Masters-R64-Jeremy_Chardy-Andrey_Kuznetsov,2,S-DTL,1,0,0,0,0,1,0,,,,,,,,,,
20160312-M-Indian_Wells_Masters-R64-Milos_Raonic-Inigo_Cervantes_Huegun,1,F-XC,12,5,3,2,0,11,1,,,,,,,,,,
20160312-M-Indian_Wells_Masters-R64-Milos_Raonic-Inigo_Cervantes_Huegun,1,F-DTM,7,0,0,0,0,3,4,,,,,,,,,,
20160312-M-Indian_Wells_Masters-R64-Milos_Raonic-Inigo_Cervantes_Huegun,1,F-DTL,4,1,0,1,0,1,3,,,,,,,,,,
20160312-M-Indian_Wells_Masters-R64-Milos_Raonic-Inigo_Cervantes_Huegun,1,F-IO,19,8,1,3,4,10,9,,,,,,,,,,
20160312-M-Indian_Wells_Masters-R64-Milos_Raonic-Inigo_Cervantes_Huegun,1,F-II,2,1,1,0,0,2,0,,,,,,,,,,
20160312-M-Indian_Wells_Masters-R64-Milos_Raonic-Inigo_Cervantes_Huegun,1,B-XC,1,0,0,0,0,1,0,,,,,,,,,,
20160312-M-Indian_Wells_Masters-R64-Milos_Raonic-Inigo_Cervantes_Huegun,1,B-DTM,2,0,0,0,0,1,1,,,,,,,,,,
20160312-M-Indian_Wells_Masters-R64-Milos_Raonic-Inigo_Cervantes_Huegun,1,B-DTL,3,2,1,0,1,2,1,,,,,,,,,,
20160312-M-Indian_Wells_Masters-R64-Milos_Raonic-Inigo_Cervantes_Huegun,1,S-XC,15,2,0,0,2,10,5,,,,,,,,,,
20160312-M-Indian_Wells_Masters-R64-Milos_Raonic-Inigo_Cervantes_Huegun,1,S-DTM,2,0,0,0,0,1,1,,,,,,,,,,
20160312-M-Indian_Wells_Masters-R64-Milos_Raonic-Inigo_Cervantes_Huegun,1,S-DTL,1,0,0,0,0,1,0,,,,,,,,,,
20160312-M-Indian_Wells_Masters-R64-Milos_Raonic-Inigo_Cervantes_Huegun,2,F-XC,17,5,1,2,2,10,7,,,,,,,,,,
20160312-M-Indian_Wells_Masters-R64-Milos_Raonic-Inigo_Cervantes_Huegun,2,F-DTM,13,3,0,0,3,2,11,,,,,,,,,,
20160312-M-Indian_Wells_Masters-R64-Milos_Raonic-Inigo_Cervantes_Huegun,2,F-DTL,3,1,0,1,0,1,2,,,,,,,,,,
20160312-M-Indian_Wells_Masters-R64-Milos_Raonic-Inigo_Cervantes_Huegun,2,F-IO,11,2,0,2,0,5,6,,,,,,,,,,
20160312-M-Indian_Wells_Masters-R64-Milos_Raonic-Inigo_Cervantes_Huegun,2,B-XC,13,1,0,0,1,5,8,,,,,,,,,,
20160312-M-Indian_Wells_Masters-R64-Milos_Raonic-Inigo_Cervantes_Huegun,2,B-DTM,7,1,0,0,1,4,3,,,,,,,,,,
20160312-M-Indian_Wells_Masters-R64-Milos_Raonic-Inigo_Cervantes_Huegun,2,B-DTL,5,4,2,2,0,4,1,,,,,,,,,,
20160312-M-Indian_Wells_Masters-R64-Milos_Raonic-Inigo_Cervantes_Huegun,2,B-IO,1,1,0,0,1,0,1,,,,,,,,,,
20160312-M-Indian_Wells_Masters-R64-Milos_Raonic-Inigo_Cervantes_Huegun,2,S-XC,4,1,0,0,1,1,3,,,,,,,,,,
20160312-M-Indian_Wells_Masters-R64-Milos_Raonic-Inigo_Cervantes_Huegun,2,S-DTM,1,0,0,0,0,0,1,,,,,,,,,,
20160312-M-Indian_Wells_Masters-R64-Milos_Raonic-Inigo_Cervantes_Huegun,2,S-DTL,1,1,0,0,1,0,1,,,,,,,,,,
20160312-M-Indian_Wells_Masters-R64-Stanislas_Wawrinka-Illya_Marchenko,1,F-XC,24,13,4,4,5,14,10,,,,,,,,,,
20160312-M-Indian_Wells_Masters-R64-Stanislas_Wawrinka-Illya_Marchenko,1,F-DTM,23,4,0,0,4,8,15,,,,,,,,,,
20160312-M-Indian_Wells_Masters-R64-Stanislas_Wawrinka-Illya_Marchenko,1,F-DTL,2,1,0,0,1,1,1,,,,,,,,,,
20160312-M-Indian_Wells_Masters-R64-Stanislas_Wawrinka-Illya_Marchenko,1,F-IO,16,5,2,2,1,14,2,,,,,,,,,,
20160312-M-Indian_Wells_Masters-R64-Stanislas_Wawrinka-Illya_Marchenko,1,F-II,1,1,0,0,1,0,1,,,,,,,,,,
20160312-M-Indian_Wells_Masters-R64-Stanislas_Wawrinka-Illya_Marchenko,1,B-XC,12,4,1,1,2,7,5,,,,,,,,,,
20160312-M-Indian_Wells_Masters-R64-Stanislas_Wawrinka-Illya_Marchenko,1,B-DTM,12,0,0,0,0,9,3,,,,,,,,,,
20160312-M-Indian_Wells_Masters-R64-Stanislas_Wawrinka-Illya_Marchenko,1,B-DTL,5,3,1,1,1,3,2,,,,,,,,,,
20160312-M-Indian_Wells_Masters-R64-Stanislas_Wawrinka-Illya_Marchenko,1,B-IO,1,1,1,0,0,1,0,,,,,,,,,,
20160312-M-Indian_Wells_Masters-R64-Stanislas_Wawrinka-Illya_Marchenko,1,S-XC,10,1,0,0,1,3,7,,,,,,,,,,
20160312-M-Indian_Wells_Masters-R64-Stanislas_Wawrinka-Illya_Marchenko,1,S-DTM,4,0,0,0,0,3,1,,,,,,,,,,
20160312-M-Indian_Wells_Masters-R64-Stanislas_Wawrinka-Illya_Marchenko,2,F-XC,28,8,1,1,6,10,18,,,,,,,,,,
20160312-M-Indian_Wells_Masters-R64-Stanislas_Wawrinka-Illya_Marchenko,2,F-DTM,18,1,0,0,1,8,10,,,,,,,,,,
20160312-M-Indian_Wells_Masters-R64-Stanislas_Wawrinka-Illya_Marchenko,2,F-DTL,2,1,0,1,0,1,1,,,,,,,,,,
20160312-M-Indian_Wells_Masters-R64-Stanislas_Wawrinka-Illya_Marchenko,2,F-IO,15,6,0,2,4,7,8,,,,,,,,,,
20160312-M-Indian_Wells_Masters-R64-Stanislas_Wawrinka-Illya_Marchenko,2,F-II,1,0,0,0,0,1,0,,,,,,,,,,
20160312-M-Indian_Wells_Masters-R64-Stanislas_Wawrinka-Illya_Marchenko,2,B-XC,22,7,0,0,7,6,16,,,,,,,,,,
20160312-M-Indian_Wells_Masters-R64-Stanislas_Wawrinka-Illya_Marchenko,2,B-DTM,11,1,0,0,1,2,9,,,,,,,,,,
20160312-M-Indian_Wells_Masters-R64-Stanislas_Wawrinka-Illya_Marchenko,2,B-DTL,1,1,0,1,0,1,0,,,,,,,,,,
20160312-M-Indian_Wells_Masters-R64-Stanislas_Wawrinka-Illya_Marchenko,2,B-IO,1,1,0,0,1,0,1,,,,,,,,,,
20160312-M-Indian_Wells_Masters-R64-Stanislas_Wawrinka-Illya_Marchenko,2,S-XC,5,0,0,0,0,3,2,,,,,,,,,,
20160312-M-Indian_Wells_Masters-R64-Stanislas_Wawrinka-Illya_Marchenko,2,S-DTM,6,0,0,0,0,2,4,,,,,,,,,,
20160312-M-Indian_Wells_Masters-R64-Stanislas_Wawrinka-Illya_Marchenko,2,S-DTL,1,0,0,0,0,1,0,,,,,,,,,,
20160315-M-Indian_Wells_Masters-R32-Gilles_Simon-Alexander_Zverev,1,F-XC,24,9,2,0,7,10,14,,,,,,,,,,
20160315-M-Indian_Wells_Masters-R32-Gilles_Simon-Alexander_Zverev,1,F-DTM,35,2,0,0,2,13,22,,,,,,,,,,
20160315-M-Indian_Wells_Masters-R32-Gilles_Simon-Alexander_Zverev,1,F-DTL,9,5,0,2,3,3,6,,,,,,,,,,
20160315-M-Indian_Wells_Masters-R32-Gilles_Simon-Alexander_Zverev,1,F-IO,11,5,1,1,3,6,5,,,,,,,,,,
20160315-M-Indian_Wells_Masters-R32-Gilles_Simon-Alexander_Zverev,1,B-XC,38,8,2,2,4,12,26,,,,,,,,,,
20160315-M-Indian_Wells_Masters-R32-Gilles_Simon-Alexander_Zverev,1,B-DTM,48,2,0,0,2,13,35,,,,,,,,,,
20160315-M-Indian_Wells_Masters-R32-Gilles_Simon-Alexander_Zverev,1,B-DTL,10,7,3,2,2,7,3,,,,,,,,,,
20160315-M-Indian_Wells_Masters-R32-Gilles_Simon-Alexander_Zverev,1,B-IO,4,2,0,0,2,1,3,,,,,,,,,,
20160315-M-Indian_Wells_Masters-R32-Gilles_Simon-Alexander_Zverev,2,F-XC,37,6,3,2,1,23,14,,,,,,,,,,
20160315-M-Indian_Wells_Masters-R32-Gilles_Simon-Alexander_Zverev,2,F-DTM,22,1,0,0,1,16,6,,,,,,,,,,
20160315-M-Indian_Wells_Masters-R32-Gilles_Simon-Alexander_Zverev,2,F-DTL,5,2,1,1,0,3,2,,,,,,,,,,
20160315-M-Indian_Wells_Masters-R32-Gilles_Simon-Alexander_Zverev,2,F-IO,16,3,2,1,0,11,5,,,,,,,,,,
20160315-M-Indian_Wells_Masters-R32-Gilles_Simon-Alexander_Zverev,2,B-XC,38,3,1,1,1,23,15,,,,,,,,,,
20160315-M-Indian_Wells_Masters-R32-Gilles_Simon-Alexander_Zverev,2,B-DTM,29,3,0,0,3,23,6,,,,,,,,,,
20160315-M-Indian_Wells_Masters-R32-Gilles_Simon-Alexander_Zverev,2,B-DTL,4,1,1,0,0,3,1,,,,,,,,,,
20160315-M-Indian_Wells_Masters-R32-Gilles_Simon-Alexander_Zverev,2,B-IO,6,2,1,1,0,5,1,,,,,,,,,,
20160315-M-Indian_Wells_Masters-R32-Gilles_Simon-Alexander_Zverev,2,S-XC,1,0,0,0,0,0,1,,,,,,,,,,
20160315-M-Indian_Wells_Masters-R32-Gilles_Simon-Alexander_Zverev,2,S-DTM,5,0,0,0,0,3,2,,,,,,,,,,
20160315-M-Indian_Wells_Masters-R32-Gilles_Simon-Alexander_Zverev,2,S-IO,3,0,0,0,0,2,1,,,,,,,,,,
20160316-M-Indian_Wells_Masters-R16-Jo_Wilfried_Tsonga-Dominic_Thiem,1,F-XC,18,6,3,2,1,17,1,,,,,,,,,,
20160316-M-Indian_Wells_Masters-R16-Jo_Wilfried_Tsonga-Dominic_Thiem,1,F-DTM,13,0,0,0,0,9,4,,,,,,,,,,
20160316-M-Indian_Wells_Masters-R16-Jo_Wilfried_Tsonga-Dominic_Thiem,1,F-DTL,2,2,0,1,1,1,1,,,,,,,,,,
20160316-M-Indian_Wells_Masters-R16-Jo_Wilfried_Tsonga-Dominic_Thiem,1,F-IO,21,11,3,4,4,15,6,,,,,,,,,,
20160316-M-Indian_Wells_Masters-R16-Jo_Wilfried_Tsonga-Dominic_Thiem,1,F-II,3,2,1,1,0,3,0,,,,,,,,,,
20160316-M-Indian_Wells_Masters-R16-Jo_Wilfried_Tsonga-Dominic_Thiem,1,B-XC,9,0,0,0,0,6,3,,,,,,,,,,
20160316-M-Indian_Wells_Masters-R16-Jo_Wilfried_Tsonga-Dominic_Thiem,1,B-DTM,6,2,0,1,1,5,1,,,,,,,,,,
20160316-M-Indian_Wells_Masters-R16-Jo_Wilfried_Tsonga-Dominic_Thiem,1,B-DTL,4,2,0,0,2,1,3,,,,,,,,,,
20160316-M-Indian_Wells_Masters-R16-Jo_Wilfried_Tsonga-Dominic_Thiem,1,B-IO,1,1,0,0,1,0,1,,,,,,,,,,
20160316-M-Indian_Wells_Masters-R16-Jo_Wilfried_Tsonga-Dominic_Thiem,1,S-XC,1,0,0,0,0,1,0,,,,,,,,,,
20160316-M-Indian_Wells_Masters-R16-Jo_Wilfried_Tsonga-Dominic_Thiem,1,S-DTM,3,0,0,0,0,2,1,,,,,,,,,,
20160316-M-Indian_Wells_Masters-R16-Jo_Wilfried_Tsonga-Dominic_Thiem,2,F-XC,9,2,0,1,1,3,6,,,,,,,,,,
20160316-M-Indian_Wells_Masters-R16-Jo_Wilfried_Tsonga-Dominic_Thiem,2,F-DTM,14,1,0,0,1,2,12,,,,,,,,,,
20160316-M-Indian_Wells_Masters-R16-Jo_Wilfried_Tsonga-Dominic_Thiem,2,F-DTL,4,1,0,1,0,1,3,,,,,,,,,,
20160316-M-Indian_Wells_Masters-R16-Jo_Wilfried_Tsonga-Dominic_Thiem,2,F-IO,20,9,0,4,5,8,12,,,,,,,,,,
20160316-M-Indian_Wells_Masters-R16-Jo_Wilfried_Tsonga-Dominic_Thiem,2,F-II,1,0,0,0,0,0,1,,,,,,,,,,
20160316-M-Indian_Wells_Masters-R16-Jo_Wilfried_Tsonga-Dominic_Thiem,2,B-XC,5,0,0,0,0,2,3,,,,,,,,,,
20160316-M-Indian_Wells_Masters-R16-Jo_Wilfried_Tsonga-Dominic_Thiem,2,B-DTM,9,1,0,0,1,1,8,,,,,,,,,,
20160316-M-Indian_Wells_Masters-R16-Jo_Wilfried_Tsonga-Dominic_Thiem,2,B-DTL,4,3,2,0,1,2,2,,,,,,,,,,
20160316-M-Indian_Wells_Masters-R16-Jo_Wilfried_Tsonga-Dominic_Thiem,2,B-IO,1,1,1,0,0,1,0,,,,,,,,,,
20160316-M-Indian_Wells_Masters-R16-Jo_Wilfried_Tsonga-Dominic_Thiem,2,S-XC,4,1,0,0,1,0,4,,,,,,,,,,
20160316-M-Indian_Wells_Masters-R16-Jo_Wilfried_Tsonga-Dominic_Thiem,2,S-DTM,3,1,0,0,1,0,3,,,,,,,,,,
20160316-M-Indian_Wells_Masters-R16-Jo_Wilfried_Tsonga-Dominic_Thiem,2,S-DTL,1,0,0,0,0,1,0,,,,,,,,,,
20160317-M-Indian_Wells_Masters-QF-Marin_Cilic-David_Goffin,1,F-XC,35,14,5,1,8,11,24,,,,,,,,,,
20160317-M-Indian_Wells_Masters-QF-Marin_Cilic-David_Goffin,1,F-DTM,33,5,1,1,3,14,19,,,,,,,,,,
20160317-M-Indian_Wells_Masters-QF-Marin_Cilic-David_Goffin,1,F-DTL,8,2,0,2,0,3,5,,,,,,,,,,
20160317-M-Indian_Wells_Masters-QF-Marin_Cilic-David_Goffin,1,F-IO,31,9,0,3,6,10,21,,,,,,,,,,
20160317-M-Indian_Wells_Masters-QF-Marin_Cilic-David_Goffin,1,B-XC,31,4,0,1,3,9,22,,,,,,,,,,
20160317-M-Indian_Wells_Masters-QF-Marin_Cilic-David_Goffin,1,B-DTM,21,3,0,1,2,4,17,,,,,,,,,,
20160317-M-Indian_Wells_Masters-QF-Marin_Cilic-David_Goffin,1,B-DTL,2,0,0,0,0,2,0,,,,,,,,,,
20160317-M-Indian_Wells_Masters-QF-Marin_Cilic-David_Goffin,1,B-IO,4,2,1,0,1,2,2,,,,,,,,,,
20160317-M-Indian_Wells_Masters-QF-Marin_Cilic-David_Goffin,1,S-XC,6,1,0,0,1,5,1,,,,,,,,,,
20160317-M-Indian_Wells_Masters-QF-Marin_Cilic-David_Goffin,1,S-DTM,4,0,0,0,0,2,2,,,,,,,,,,
20160317-M-Indian_Wells_Masters-QF-Marin_Cilic-David_Goffin,1,S-DTL,1,0,0,0,0,0,1,,,,,,,,,,
20160317-M-Indian_Wells_Masters-QF-Marin_Cilic-David_Goffin,2,F-XC,27,7,2,4,1,18,9,,,,,,,,,,
20160317-M-Indian_Wells_Masters-QF-Marin_Cilic-David_Goffin,2,F-DTM,31,0,0,0,0,21,10,,,,,,,,,,
20160317-M-Indian_Wells_Masters-QF-Marin_Cilic-David_Goffin,2,F-DTL,5,3,2,0,1,3,2,,,,,,,,,,
20160317-M-Indian_Wells_Masters-QF-Marin_Cilic-David_Goffin,2,F-IO,20,11,4,3,4,11,9,,,,,,,,,,
20160317-M-Indian_Wells_Masters-QF-Marin_Cilic-David_Goffin,2,F-II,3,1,1,0,0,2,1,,,,,,,,,,
20160317-M-Indian_Wells_Masters-QF-Marin_Cilic-David_Goffin,2,B-XC,38,5,2,1,2,25,13,,,,,,,,,,
20160317-M-Indian_Wells_Masters-QF-Marin_Cilic-David_Goffin,2,B-DTM,41,4,1,1,2,24,17,,,,,,,,,,
20160317-M-Indian_Wells_Masters-QF-Marin_Cilic-David_Goffin,2,B-DTL,7,6,3,2,1,5,2,,,,,,,,,,
20160317-M-Indian_Wells_Masters-QF-Marin_Cilic-David_Goffin,2,B-IO,5,2,1,0,1,4,1,,,,,,,,,,
20160317-M-Indian_Wells_Masters-QF-Marin_Cilic-David_Goffin,2,S-XC,2,0,0,0,0,1,1,,,,,,,,,,
20160317-M-Indian_Wells_Masters-QF-Marin_Cilic-David_Goffin,2,S-DTL,1,0,0,0,0,0,1,,,,,,,,,,
20160319-M-Indian_Wells_Masters-SF-Rafael_Nadal-Novak_Djokovic,1,F-XC,95,11,1,2,8,37,58,,,,,,,,,,
20160319-M-Indian_Wells_Masters-SF-Rafael_Nadal-Novak_Djokovic,1,F-DTM,20,0,0,0,0,6,14,,,,,,,,,,
20160319-M-Indian_Wells_Masters-SF-Rafael_Nadal-Novak_Djokovic,1,F-DTL,17,7,4,1,2,11,6,,,,,,,,,,
20160319-M-Indian_Wells_Masters-SF-Rafael_Nadal-Novak_Djokovic,1,F-IO,25,10,2,4,4,12,13,,,,,,,,,,
20160319-M-Indian_Wells_Masters-SF-Rafael_Nadal-Novak_Djokovic,1,F-II,6,2,0,1,1,3,3,,,,,,,,,,
20160319-M-Indian_Wells_Masters-SF-Rafael_Nadal-Novak_Djokovic,1,B-XC,35,9,0,4,5,10,25,,,,,,,,,,
20160319-M-Indian_Wells_Masters-SF-Rafael_Nadal-Novak_Djokovic,1,B-DTM,30,4,0,0,4,12,18,,,,,,,,,,
20160319-M-Indian_Wells_Masters-SF-Rafael_Nadal-Novak_Djokovic,1,B-DTL,19,0,0,0,0,6,13,,,,,,,,,,
20160319-M-Indian_Wells_Masters-SF-Rafael_Nadal-Novak_Djokovic,1,B-IO,6,2,0,0,2,4,2,,,,,,,,,,
20160319-M-Indian_Wells_Masters-SF-Rafael_Nadal-Novak_Djokovic,1,B-II,1,0,0,0,0,0,1,,,,,,,,,,
20160319-M-Indian_Wells_Masters-SF-Rafael_Nadal-Novak_Djokovic,1,S-XC,5,0,0,0,0,2,3,,,,,,,,,,
20160319-M-Indian_Wells_Masters-SF-Rafael_Nadal-Novak_Djokovic,1,S-DTM,6,0,0,0,0,3,3,,,,,,,,,,
20160319-M-Indian_Wells_Masters-SF-Rafael_Nadal-Novak_Djokovic,1,S-DTL,8,1,0,0,1,2,6,,,,,,,,,,
20160319-M-Indian_Wells_Masters-SF-Rafael_Nadal-Novak_Djokovic,1,S-IO,1,0,0,0,0,0,1,,,,,,,,,,
20160319-M-Indian_Wells_Masters-SF-Rafael_Nadal-Novak_Djokovic,2,F-XC,53,11,2,4,5,37,16,,,,,,,,,,
20160319-M-Indian_Wells_Masters-SF-Rafael_Nadal-Novak_Djokovic,2,F-DTM,14,1,0,0,1,9,5,,,,,,,,,,
20160319-M-Indian_Wells_Masters-SF-Rafael_Nadal-Novak_Djokovic,2,F-DTL,16,6,4,1,1,14,2,,,,,,,,,,
20160319-M-Indian_Wells_Masters-SF-Rafael_Nadal-Novak_Djokovic,2,F-IO,36,10,2,5,3,20,16,,,,,,,,,,
20160319-M-Indian_Wells_Masters-SF-Rafael_Nadal-Novak_Djokovic,2,F-II,5,1,1,0,0,4,1,,,,,,,,,,
20160319-M-Indian_Wells_Masters-SF-Rafael_Nadal-Novak_Djokovic,2,B-XC,46,3,2,0,1,27,19,,,,,,,,,,
20160319-M-Indian_Wells_Masters-SF-Rafael_Nadal-Novak_Djokovic,2,B-DTM,36,3,0,1,2,24,12,,,,,,,,,,
20160319-M-Indian_Wells_Masters-SF-Rafael_Nadal-Novak_Djokovic,2,B-DTL,34,11,4,1,6,16,18,,,,,,,,,,
20160319-M-Indian_Wells_Masters-SF-Rafael_Nadal-Novak_Djokovic,2,B-IO,8,2,0,0,2,2,6,,,,,,,,,,
20160319-M-Indian_Wells_Masters-SF-Rafael_Nadal-Novak_Djokovic,2,B-II,1,0,0,0,0,1,0,,,,,,,,,,
20160319-M-Indian_Wells_Masters-SF-Rafael_Nadal-Novak_Djokovic,2,S-DTL,4,0,0,0,0,2,2,,,,,,,,,,
20160319-M-Indian_Wells_Masters-SF-Rafael_Nadal-Novak_Djokovic,2,S-IO,1,0,0,0,0,1,0,,,,,,,,,,
20160320-M-Indian_Wells_Masters-F-Milos_Raonic-Novak_Djokovic,1,F-XC,36,10,0,2,8,7,29,,,,,,,,,,
20160320-M-Indian_Wells_Masters-F-Milos_Raonic-Novak_Djokovic,1,F-DTM,4,2,0,0,2,0,4,,,,,,,,,,
20160320-M-Indian_Wells_Masters-F-Milos_Raonic-Novak_Djokovic,1,F-DTL,3,3,2,0,1,2,1,,,,,,,,,,
20160320-M-Indian_Wells_Masters-F-Milos_Raonic-Novak_Djokovic,1,F-IO,25,7,2,0,5,8,17,,,,,,,,,,
20160320-M-Indian_Wells_Masters-F-Milos_Raonic-Novak_Djokovic,1,F-II,5,2,0,2,0,4,1,,,,,,,,,,
20160320-M-Indian_Wells_Masters-F-Milos_Raonic-Novak_Djokovic,1,B-XC,3,1,0,0,1,0,3,,,,,,,,,,
20160320-M-Indian_Wells_Masters-F-Milos_Raonic-Novak_Djokovic,1,B-DTM,5,2,0,0,2,0,5,,,,,,,,,,
20160320-M-Indian_Wells_Masters-F-Milos_Raonic-Novak_Djokovic,1,B-DTL,2,0,0,0,0,0,2,,,,,,,,,,
20160320-M-Indian_Wells_Masters-F-Milos_Raonic-Novak_Djokovic,1,B-IO,1,0,0,0,0,0,1,,,,,,,,,,
20160320-M-Indian_Wells_Masters-F-Milos_Raonic-Novak_Djokovic,1,S-XC,12,2,0,0,2,4,8,,,,,,,,,,
20160320-M-Indian_Wells_Masters-F-Milos_Raonic-Novak_Djokovic,1,S-DTM,4,1,0,0,1,2,2,,,,,,,,,,
20160320-M-Indian_Wells_Masters-F-Milos_Raonic-Novak_Djokovic,1,S-DTL,2,1,0,0,1,1,1,,,,,,,,,,
20160320-M-Indian_Wells_Masters-F-Milos_Raonic-Novak_Djokovic,1,S-IO,3,0,0,0,0,1,2,,,,,,,,,,
20160320-M-Indian_Wells_Masters-F-Milos_Raonic-Novak_Djokovic,2,F-XC,24,7,4,2,1,20,4,,,,,,,,,,
20160320-M-Indian_Wells_Masters-F-Milos_Raonic-Novak_Djokovic,2,F-DTM,18,0,0,0,0,15,3,,,,,,,,,,
20160320-M-Indian_Wells_Masters-F-Milos_Raonic-Novak_Djokovic,2,F-DTL,11,4,1,2,1,8,3,,,,,,,,,,
20160320-M-Indian_Wells_Masters-F-Milos_Raonic-Novak_Djokovic,2,F-IO,4,1,1,0,0,2,2,,,,,,,,,,
20160320-M-Indian_Wells_Masters-F-Milos_Raonic-Novak_Djokovic,2,F-II,1,0,0,0,0,1,0,,,,,,,,,,
20160320-M-Indian_Wells_Masters-F-Milos_Raonic-Novak_Djokovic,2,B-XC,16,2,0,1,1,7,9,,,,,,,,,,
20160320-M-Indian_Wells_Masters-F-Milos_Raonic-Novak_Djokovic,2,B-DTM,10,0,0,0,0,6,4,,,,,,,,,,
20160320-M-Indian_Wells_Masters-F-Milos_Raonic-Novak_Djokovic,2,B-DTL,4,2,2,0,0,4,0,,,,,,,,,,
20160320-M-Indian_Wells_Masters-F-Milos_Raonic-Novak_Djokovic,2,B-IO,1,0,0,0,0,1,0,,,,,,,,,,
20160320-M-Indian_Wells_Masters-F-Milos_Raonic-Novak_Djokovic,2,S-XC,3,0,0,0,0,0,3,,,,,,,,,,
20160320-M-Indian_Wells_Masters-F-Milos_Raonic-Novak_Djokovic,2,S-DTM,1,0,0,0,0,1,0,,,,,,,,,,
20160320-M-Indian_Wells_Masters-F-Milos_Raonic-Novak_Djokovic,2,S-DTL,1,1,0,1,0,1,0,,,,,,,,,,
20160323-M-Guadalajara_CH-R16-Dennis_Novikov-Eduardo_Struvay,1,F-XC,13,6,3,2,1,10,3,,,,,,,,,,
20160323-M-Guadalajara_CH-R16-Dennis_Novikov-Eduardo_Struvay,1,F-DTM,6,0,0,0,0,6,0,,,,,,,,,,
20160323-M-Guadalajara_CH-R16-Dennis_Novikov-Eduardo_Struvay,1,F-DTL,3,2,0,1,1,1,2,,,,,,,,,,
20160323-M-Guadalajara_CH-R16-Dennis_Novikov-Eduardo_Struvay,1,F-IO,10,3,1,2,0,8,2,,,,,,,,,,
20160323-M-Guadalajara_CH-R16-Dennis_Novikov-Eduardo_Struvay,1,F-II,1,1,1,0,0,1,0,,,,,,,,,,
20160323-M-Guadalajara_CH-R16-Dennis_Novikov-Eduardo_Struvay,1,B-XC,23,3,1,0,2,13,10,,,,,,,,,,
20160323-M-Guadalajara_CH-R16-Dennis_Novikov-Eduardo_Struvay,1,B-DTM,6,2,0,1,1,3,3,,,,,,,,,,
20160323-M-Guadalajara_CH-R16-Dennis_Novikov-Eduardo_Struvay,1,B-DTL,3,3,2,0,1,2,1,,,,,,,,,,
20160323-M-Guadalajara_CH-R16-Dennis_Novikov-Eduardo_Struvay,1,S-XC,1,0,0,0,0,0,1,,,,,,,,,,
20160323-M-Guadalajara_CH-R16-Dennis_Novikov-Eduardo_Struvay,2,F-XC,11,4,1,0,3,2,9,,,,,,,,,,
20160323-M-Guadalajara_CH-R16-Dennis_Novikov-Eduardo_Struvay,2,F-DTM,3,0,0,0,0,1,2,,,,,,,,,,
20160323-M-Guadalajara_CH-R16-Dennis_Novikov-Eduardo_Struvay,2,F-DTL,5,3,0,2,1,3,2,,,,,,,,,,
20160323-M-Guadalajara_CH-R16-Dennis_Novikov-Eduardo_Struvay,2,F-IO,1,1,1,0,0,1,0,,,,,,,,,,
20160323-M-Guadalajara_CH-R16-Dennis_Novikov-Eduardo_Struvay,2,B-XC,8,1,1,0,0,4,4,,,,,,,,,,
20160323-M-Guadalajara_CH-R16-Dennis_Novikov-Eduardo_Struvay,2,B-DTM,3,0,0,0,0,3,0,,,,,,,,,,
20160323-M-Guadalajara_CH-R16-Dennis_Novikov-Eduardo_Struvay,2,B-DTL,5,5,1,2,2,3,2,,,,,,,,,,
20160323-M-Guadalajara_CH-R16-Dennis_Novikov-Eduardo_Struvay,2,B-IO,1,0,0,0,0,0,1,,,,,,,,,,
20160323-M-Guadalajara_CH-R16-Dennis_Novikov-Eduardo_Struvay,2,S-XC,8,1,0,0,1,1,7,,,,,,,,,,
20160323-M-Guadalajara_CH-R16-Dennis_Novikov-Eduardo_Struvay,2,S-DTM,7,0,0,0,0,3,4,,,,,,,,,,
20160323-M-Guadalajara_CH-R16-Dennis_Novikov-Eduardo_Struvay,2,S-DTL,2,0,0,0,0,2,0,,,,,,,,,,
20160326-M-San_Luis_Potosi_CH-SF-Marcelo_Arevalo-Federico_Gaio,1,F-XC,24,6,3,1,2,18,6,,,,,,,,,,
20160326-M-San_Luis_Potosi_CH-SF-Marcelo_Arevalo-Federico_Gaio,1,F-DTM,2,1,0,0,1,1,1,,,,,,,,,,
20160326-M-San_Luis_Potosi_CH-SF-Marcelo_Arevalo-Federico_Gaio,1,F-DTL,6,2,1,1,0,6,0,,,,,,,,,,
20160326-M-San_Luis_Potosi_CH-SF-Marcelo_Arevalo-Federico_Gaio,1,F-IO,16,3,1,1,1,12,4,,,,,,,,,,
20160326-M-San_Luis_Potosi_CH-SF-Marcelo_Arevalo-Federico_Gaio,1,B-XC,2,0,0,0,0,0,2,,,,,,,,,,
20160326-M-San_Luis_Potosi_CH-SF-Marcelo_Arevalo-Federico_Gaio,1,B-DTM,4,0,0,0,0,3,1,,,,,,,,,,
20160326-M-San_Luis_Potosi_CH-SF-Marcelo_Arevalo-Federico_Gaio,1,B-DTL,2,1,0,0,1,0,2,,,,,,,,,,
20160326-M-San_Luis_Potosi_CH-SF-Marcelo_Arevalo-Federico_Gaio,1,S-DTM,2,0,0,0,0,2,0,,,,,,,,,,
20160326-M-San_Luis_Potosi_CH-SF-Marcelo_Arevalo-Federico_Gaio,1,S-IO,1,1,0,0,1,0,1,,,,,,,,,,
20160326-M-San_Luis_Potosi_CH-SF-Marcelo_Arevalo-Federico_Gaio,2,F-XC,15,9,2,3,4,7,8,,,,,,,,,,
20160326-M-San_Luis_Potosi_CH-SF-Marcelo_Arevalo-Federico_Gaio,2,F-DTM,9,0,0,0,0,0,9,,,,,,,,,,
20160326-M-San_Luis_Potosi_CH-SF-Marcelo_Arevalo-Federico_Gaio,2,F-DTL,8,7,3,0,4,3,5,,,,,,,,,,
20160326-M-San_Luis_Potosi_CH-SF-Marcelo_Arevalo-Federico_Gaio,2,F-IO,13,6,1,1,4,6,7,,,,,,,,,,
20160326-M-San_Luis_Potosi_CH-SF-Marcelo_Arevalo-Federico_Gaio,2,F-II,1,1,1,0,0,1,0,,,,,,,,,,
20160326-M-San_Luis_Potosi_CH-SF-Marcelo_Arevalo-Federico_Gaio,2,B-XC,1,1,0,0,1,0,1,,,,,,,,,,
20160326-M-San_Luis_Potosi_CH-SF-Marcelo_Arevalo-Federico_Gaio,2,B-DTM,9,3,0,0,3,3,6,,,,,,,,,,
20160326-M-San_Luis_Potosi_CH-SF-Marcelo_Arevalo-Federico_Gaio,2,B-DTL,1,1,0,0,1,0,1,,,,,,,,,,
20160326-M-San_Luis_Potosi_CH-SF-Marcelo_Arevalo-Federico_Gaio,2,S-XC,2,0,0,0,0,0,2,,,,,,,,,,
20160326-M-San_Luis_Potosi_CH-SF-Marcelo_Arevalo-Federico_Gaio,2,S-DTM,4,1,0,0,1,0,4,,,,,,,,,,
20160326-M-San_Luis_Potosi_CH-SF-Marcelo_Arevalo-Federico_Gaio,2,S-DTL,3,1,0,0,1,1,2,,,,,,,,,,
20160327-M-Miami_Masters-R32-Richard_Gasquet-Benoit_Paire,1,F-XC,26,3,1,2,0,21,5,,,,,,,,,,
20160327-M-Miami_Masters-R32-Richard_Gasquet-Benoit_Paire,1,F-DTM,16,3,0,1,2,10,6,,,,,,,,,,
20160327-M-Miami_Masters-R32-Richard_Gasquet-Benoit_Paire,1,F-DTL,5,1,1,0,0,5,0,,,,,,,,,,
20160327-M-Miami_Masters-R32-Richard_Gasquet-Benoit_Paire,1,F-IO,2,1,0,0,1,1,1,,,,,,,,,,
20160327-M-Miami_Masters-R32-Richard_Gasquet-Benoit_Paire,1,B-XC,20,5,2,0,3,14,6,,,,,,,,,,
20160327-M-Miami_Masters-R32-Richard_Gasquet-Benoit_Paire,1,B-DTM,24,1,0,0,1,16,8,,,,,,,,,,
20160327-M-Miami_Masters-R32-Richard_Gasquet-Benoit_Paire,1,B-DTL,4,2,1,1,0,4,0,,,,,,,,,,
20160327-M-Miami_Masters-R32-Richard_Gasquet-Benoit_Paire,1,B-IO,2,0,0,0,0,1,1,,,,,,,,,,
20160327-M-Miami_Masters-R32-Richard_Gasquet-Benoit_Paire,1,S-XC,2,0,0,0,0,1,1,,,,,,,,,,
20160327-M-Miami_Masters-R32-Richard_Gasquet-Benoit_Paire,1,S-DTM,3,0,0,0,0,2,1,,,,,,,,,,
20160327-M-Miami_Masters-R32-Richard_Gasquet-Benoit_Paire,2,F-XC,26,7,1,1,5,6,20,,,,,,,,,,
20160327-M-Miami_Masters-R32-Richard_Gasquet-Benoit_Paire,2,F-DTM,22,1,0,0,1,11,11,,,,,,,,,,
20160327-M-Miami_Masters-R32-Richard_Gasquet-Benoit_Paire,2,F-DTL,8,6,1,1,4,2,6,,,,,,,,,,
20160327-M-Miami_Masters-R32-Richard_Gasquet-Benoit_Paire,2,F-IO,10,4,2,1,1,3,7,,,,,,,,,,
20160327-M-Miami_Masters-R32-Richard_Gasquet-Benoit_Paire,2,B-XC,17,7,2,1,4,7,10,,,,,,,,,,
20160327-M-Miami_Masters-R32-Richard_Gasquet-Benoit_Paire,2,B-DTM,19,5,0,0,5,3,16,,,,,,,,,,
20160327-M-Miami_Masters-R32-Richard_Gasquet-Benoit_Paire,2,B-DTL,5,3,2,0,1,2,3,,,,,,,,,,
20160327-M-Miami_Masters-R32-Richard_Gasquet-Benoit_Paire,2,B-IO,5,3,0,0,3,2,3,,,,,,,,,,
20160327-M-Miami_Masters-R32-Richard_Gasquet-Benoit_Paire,2,S-XC,1,0,0,0,0,0,1,,,,,,,,,,
20160327-M-Miami_Masters-R32-Richard_Gasquet-Benoit_Paire,2,S-DTM,3,1,0,0,1,0,3,,,,,,,,,,
20160327-M-Miami_Masters-R32-Richard_Gasquet-Benoit_Paire,2,S-DTL,1,1,0,0,1,0,1,,,,,,,,,,
20160327-M-Miami_Masters-R32-Tomas_Berdych-Steve_Johnson,1,F-XC,22,8,4,2,2,15,7,,,,,,,,,,
20160327-M-Miami_Masters-R32-Tomas_Berdych-Steve_Johnson,1,F-DTM,7,1,0,0,1,3,4,,,,,,,,,,
20160327-M-Miami_Masters-R32-Tomas_Berdych-Steve_Johnson,1,F-DTL,12,5,2,2,1,7,5,,,,,,,,,,
20160327-M-Miami_Masters-R32-Tomas_Berdych-Steve_Johnson,1,F-IO,37,12,2,5,5,27,10,,,,,,,,,,
20160327-M-Miami_Masters-R32-Tomas_Berdych-Steve_Johnson,1,F-II,4,2,1,1,0,4,0,,,,,,,,,,
20160327-M-Miami_Masters-R32-Tomas_Berdych-Steve_Johnson,1,B-XC,38,14,5,3,6,21,17,,,,,,,,,,
20160327-M-Miami_Masters-R32-Tomas_Berdych-Steve_Johnson,1,B-DTM,5,0,0,0,0,5,0,,,,,,,,,,
20160327-M-Miami_Masters-R32-Tomas_Berdych-Steve_Johnson,1,B-DTL,2,0,0,0,0,2,0,,,,,,,,,,
20160327-M-Miami_Masters-R32-Tomas_Berdych-Steve_Johnson,1,B-IO,4,0,0,0,0,4,0,,,,,,,,,,
20160327-M-Miami_Masters-R32-Tomas_Berdych-Steve_Johnson,1,S-XC,17,2,0,1,1,12,5,,,,,,,,,,
20160327-M-Miami_Masters-R32-Tomas_Berdych-Steve_Johnson,1,S-DTM,3,0,0,0,0,1,2,,,,,,,,,,
20160327-M-Miami_Masters-R32-Tomas_Berdych-Steve_Johnson,1,S-DTL,1,1,0,0,1,0,1,,,,,,,,,,
20160327-M-Miami_Masters-R32-Tomas_Berdych-Steve_Johnson,2,F-XC,21,9,4,2,3,11,10,,,,,,,,,,
20160327-M-Miami_Masters-R32-Tomas_Berdych-Steve_Johnson,2,F-DTM,12,1,0,0,1,7,5,,,,,,,,,,
20160327-M-Miami_Masters-R32-Tomas_Berdych-Steve_Johnson,2,F-DTL,8,3,3,0,0,4,4,,,,,,,,,,
20160327-M-Miami_Masters-R32-Tomas_Berdych-Steve_Johnson,2,F-IO,19,9,2,3,4,10,9,,,,,,,,,,
20160327-M-Miami_Masters-R32-Tomas_Berdych-Steve_Johnson,2,F-II,8,4,1,1,2,2,6,,,,,,,,,,
20160327-M-Miami_Masters-R32-Tomas_Berdych-Steve_Johnson,2,B-XC,11,3,2,1,0,5,6,,,,,,,,,,
20160327-M-Miami_Masters-R32-Tomas_Berdych-Steve_Johnson,2,B-DTM,6,1,0,0,1,1,5,,,,,,,,,,
20160327-M-Miami_Masters-R32-Tomas_Berdych-Steve_Johnson,2,B-DTL,5,2,2,0,0,3,2,,,,,,,,,,
20160327-M-Miami_Masters-R32-Tomas_Berdych-Steve_Johnson,2,B-IO,1,0,0,0,0,1,0,,,,,,,,,,
20160327-M-Miami_Masters-R32-Tomas_Berdych-Steve_Johnson,2,B-II,3,0,0,0,0,0,3,,,,,,,,,,
20160327-M-Miami_Masters-R32-Tomas_Berdych-Steve_Johnson,2,S-XC,38,6,0,3,3,14,24,,,,,,,,,,
20160327-M-Miami_Masters-R32-Tomas_Berdych-Steve_Johnson,2,S-DTM,2,0,0,0,0,0,2,,,,,,,,,,
20160327-M-Miami_Masters-R32-Tomas_Berdych-Steve_Johnson,2,S-DTL,8,3,0,0,3,1,7,,,,,,,,,,
20160327-M-Miami_Masters-R32-Viktor_Troicki-David_Goffin,1,F-XC,21,5,0,2,3,12,9,,,,,,,,,,
20160327-M-Miami_Masters-R32-Viktor_Troicki-David_Goffin,1,F-DTM,29,2,0,0,2,9,20,,,,,,,,,,
20160327-M-Miami_Masters-R32-Viktor_Troicki-David_Goffin,1,F-DTL,4,2,1,0,1,2,2,,,,,,,,,,
20160327-M-Miami_Masters-R32-Viktor_Troicki-David_Goffin,1,F-IO,21,8,0,1,7,7,14,,,,,,,,,,
20160327-M-Miami_Masters-R32-Viktor_Troicki-David_Goffin,1,F-II,2,0,0,0,0,1,1,,,,,,,,,,
20160327-M-Miami_Masters-R32-Viktor_Troicki-David_Goffin,1,B-XC,30,4,0,1,3,14,16,,,,,,,,,,
20160327-M-Miami_Masters-R32-Viktor_Troicki-David_Goffin,1,B-DTM,19,0,0,0,0,3,16,,,,,,,,,,
20160327-M-Miami_Masters-R32-Viktor_Troicki-David_Goffin,1,B-DTL,6,2,1,0,1,3,3,,,,,,,,,,
20160327-M-Miami_Masters-R32-Viktor_Troicki-David_Goffin,1,B-IO,2,0,0,0,0,1,1,,,,,,,,,,
20160327-M-Miami_Masters-R32-Viktor_Troicki-David_Goffin,1,S-XC,3,2,0,0,2,1,2,,,,,,,,,,
20160327-M-Miami_Masters-R32-Viktor_Troicki-David_Goffin,1,S-DTM,3,2,0,0,2,1,2,,,,,,,,,,
20160327-M-Miami_Masters-R32-Viktor_Troicki-David_Goffin,1,S-IO,1,0,0,0,0,0,1,,,,,,,,,,
20160327-M-Miami_Masters-R32-Viktor_Troicki-David_Goffin,2,F-XC,23,5,2,1,2,15,8,,,,,,,,,,
20160327-M-Miami_Masters-R32-Viktor_Troicki-David_Goffin,2,F-DTM,30,0,0,0,0,19,11,,,,,,,,,,
20160327-M-Miami_Masters-R32-Viktor_Troicki-David_Goffin,2,F-DTL,10,3,2,0,1,5,5,,,,,,,,,,
20160327-M-Miami_Masters-R32-Viktor_Troicki-David_Goffin,2,F-IO,20,7,4,2,1,17,3,,,,,,,,,,
20160327-M-Miami_Masters-R32-Viktor_Troicki-David_Goffin,2,F-II,4,1,0,1,0,2,2,,,,,,,,,,
20160327-M-Miami_Masters-R32-Viktor_Troicki-David_Goffin,2,B-XC,20,6,1,2,3,8,12,,,,,,,,,,
20160327-M-Miami_Masters-R32-Viktor_Troicki-David_Goffin,2,B-DTM,33,3,0,0,3,20,13,,,,,,,,,,
20160327-M-Miami_Masters-R32-Viktor_Troicki-David_Goffin,2,B-DTL,5,2,0,0,2,2,3,,,,,,,,,,
20160327-M-Miami_Masters-R32-Viktor_Troicki-David_Goffin,2,B-IO,1,0,0,0,0,0,1,,,,,,,,,,
20160327-M-Miami_Masters-R32-Viktor_Troicki-David_Goffin,2,S-XC,4,0,0,0,0,2,2,,,,,,,,,,
20160327-M-Miami_Masters-R32-Viktor_Troicki-David_Goffin,2,S-DTM,2,0,0,0,0,1,1,,,,,,,,,,
20160328-M-Miami_Masters-QF-Milos_Raonic-Nick_Kyrgios,1,F-XC,40,17,6,5,6,25,15,,,,,,,,,,
20160328-M-Miami_Masters-QF-Milos_Raonic-Nick_Kyrgios,1,F-DTM,17,1,0,0,1,8,9,,,,,,,,,,
20160328-M-Miami_Masters-QF-Milos_Raonic-Nick_Kyrgios,1,F-DTL,4,1,0,0,1,1,3,,,,,,,,,,
20160328-M-Miami_Masters-QF-Milos_Raonic-Nick_Kyrgios,1,F-IO,35,14,6,2,6,15,20,,,,,,,,,,
20160328-M-Miami_Masters-QF-Milos_Raonic-Nick_Kyrgios,1,F-II,3,1,1,0,0,2,1,,,,,,,,,,
20160328-M-Miami_Masters-QF-Milos_Raonic-Nick_Kyrgios,1,B-XC,13,3,0,1,2,4,9,,,,,,,,,,
20160328-M-Miami_Masters-QF-Milos_Raonic-Nick_Kyrgios,1,B-DTM,11,0,0,0,0,6,5,,,,,,,,,,
20160328-M-Miami_Masters-QF-Milos_Raonic-Nick_Kyrgios,1,B-DTL,3,2,2,0,0,3,0,,,,,,,,,,
20160328-M-Miami_Masters-QF-Milos_Raonic-Nick_Kyrgios,1,S-XC,12,3,0,1,2,5,7,,,,,,,,,,
20160328-M-Miami_Masters-QF-Milos_Raonic-Nick_Kyrgios,1,S-DTM,7,0,0,0,0,5,2,,,,,,,,,,
20160328-M-Miami_Masters-QF-Milos_Raonic-Nick_Kyrgios,1,S-DTL,5,2,0,0,2,0,5,,,,,,,,,,
20160328-M-Miami_Masters-QF-Milos_Raonic-Nick_Kyrgios,2,F-XC,35,18,6,4,8,17,18,,,,,,,,,,
20160328-M-Miami_Masters-QF-Milos_Raonic-Nick_Kyrgios,2,F-DTM,23,3,1,0,2,10,13,,,,,,,,,,
20160328-M-Miami_Masters-QF-Milos_Raonic-Nick_Kyrgios,2,F-DTL,6,4,2,0,2,3,3,,,,,,,,,,
20160328-M-Miami_Masters-QF-Milos_Raonic-Nick_Kyrgios,2,F-IO,14,6,2,2,2,9,5,,,,,,,,,,
20160328-M-Miami_Masters-QF-Milos_Raonic-Nick_Kyrgios,2,F-II,1,0,0,0,0,1,0,,,,,,,,,,
20160328-M-Miami_Masters-QF-Milos_Raonic-Nick_Kyrgios,2,B-XC,32,4,2,0,2,20,12,,,,,,,,,,
20160328-M-Miami_Masters-QF-Milos_Raonic-Nick_Kyrgios,2,B-DTM,18,0,0,0,0,14,4,,,,,,,,,,
20160328-M-Miami_Masters-QF-Milos_Raonic-Nick_Kyrgios,2,B-DTL,12,6,2,0,4,7,5,,,,,,,,,,
20160328-M-Miami_Masters-QF-Milos_Raonic-Nick_Kyrgios,2,B-IO,4,1,1,0,0,3,1,,,,,,,,,,
20160328-M-Miami_Masters-QF-Milos_Raonic-Nick_Kyrgios,2,S-XC,2,0,0,0,0,1,1,,,,,,,,,,
20160328-M-Miami_Masters-QF-Milos_Raonic-Nick_Kyrgios,2,S-DTM,2,0,0,0,0,0,2,,,,,,,,,,
20160328-M-Miami_Masters-QF-Milos_Raonic-Nick_Kyrgios,2,S-DTL,1,0,0,0,0,0,1,,,,,,,,,,
20160328-M-Miami_Masters-R16-Roberto_Bautista_Agut-Jo_Wilfried_Tsonga,1,F-XC,32,12,8,3,1,19,13,,,,,,,,,,
20160328-M-Miami_Masters-R16-Roberto_Bautista_Agut-Jo_Wilfried_Tsonga,1,F-DTM,35,4,2,0,2,17,18,,,,,,,,,,
20160328-M-Miami_Masters-R16-Roberto_Bautista_Agut-Jo_Wilfried_Tsonga,1,F-DTL,19,3,2,0,1,8,11,,,,,,,,,,
20160328-M-Miami_Masters-R16-Roberto_Bautista_Agut-Jo_Wilfried_Tsonga,1,F-IO,43,12,5,2,5,23,20,,,,,,,,,,
20160328-M-Miami_Masters-R16-Roberto_Bautista_Agut-Jo_Wilfried_Tsonga,1,F-II,8,6,4,1,1,6,2,,,,,,,,,,
20160328-M-Miami_Masters-R16-Roberto_Bautista_Agut-Jo_Wilfried_Tsonga,1,B-XC,15,2,0,0,2,9,6,,,,,,,,,,
20160328-M-Miami_Masters-R16-Roberto_Bautista_Agut-Jo_Wilfried_Tsonga,1,B-DTM,20,4,0,0,4,11,9,,,,,,,,,,
20160328-M-Miami_Masters-R16-Roberto_Bautista_Agut-Jo_Wilfried_Tsonga,1,B-DTL,10,5,2,0,3,5,5,,,,,,,,,,
20160328-M-Miami_Masters-R16-Roberto_Bautista_Agut-Jo_Wilfried_Tsonga,1,B-IO,1,0,0,0,0,1,0,,,,,,,,,,
20160328-M-Miami_Masters-R16-Roberto_Bautista_Agut-Jo_Wilfried_Tsonga,1,S-XC,6,0,0,0,0,2,4,,,,,,,,,,
20160328-M-Miami_Masters-R16-Roberto_Bautista_Agut-Jo_Wilfried_Tsonga,1,S-DTM,7,0,0,0,0,1,6,,,,,,,,,,
20160328-M-Miami_Masters-R16-Roberto_Bautista_Agut-Jo_Wilfried_Tsonga,1,S-DTL,3,0,0,0,0,1,2,,,,,,,,,,
20160328-M-Miami_Masters-R16-Roberto_Bautista_Agut-Jo_Wilfried_Tsonga,2,F-XC,44,17,3,7,7,26,18,,,,,,,,,,
20160328-M-Miami_Masters-R16-Roberto_Bautista_Agut-Jo_Wilfried_Tsonga,2,F-DTM,18,3,0,1,2,6,12,,,,,,,,,,
20160328-M-Miami_Masters-R16-Roberto_Bautista_Agut-Jo_Wilfried_Tsonga,2,F-DTL,9,2,1,0,1,7,2,,,,,,,,,,
20160328-M-Miami_Masters-R16-Roberto_Bautista_Agut-Jo_Wilfried_Tsonga,2,F-IO,42,20,9,4,7,24,18,,,,,,,,,,
20160328-M-Miami_Masters-R16-Roberto_Bautista_Agut-Jo_Wilfried_Tsonga,2,F-II,9,2,1,1,0,7,2,,,,,,,,,,
20160328-M-Miami_Masters-R16-Roberto_Bautista_Agut-Jo_Wilfried_Tsonga,2,B-XC,15,3,1,1,1,8,7,,,,,,,,,,
20160328-M-Miami_Masters-R16-Roberto_Bautista_Agut-Jo_Wilfried_Tsonga,2,B-DTM,16,1,0,0,1,6,10,,,,,,,,,,
20160328-M-Miami_Masters-R16-Roberto_Bautista_Agut-Jo_Wilfried_Tsonga,2,B-DTL,7,2,2,0,0,5,2,,,,,,,,,,
20160328-M-Miami_Masters-R16-Roberto_Bautista_Agut-Jo_Wilfried_Tsonga,2,B-IO,3,2,0,0,2,1,2,,,,,,,,,,
20160328-M-Miami_Masters-R16-Roberto_Bautista_Agut-Jo_Wilfried_Tsonga,2,S-XC,25,4,0,0,4,10,15,,,,,,,,,,
20160328-M-Miami_Masters-R16-Roberto_Bautista_Agut-Jo_Wilfried_Tsonga,2,S-DTM,13,1,0,0,1,7,6,,,,,,,,,,
20160328-M-Miami_Masters-R16-Roberto_Bautista_Agut-Jo_Wilfried_Tsonga,2,S-DTL,1,0,0,0,0,1,0,,,,,,,,,,
20050507-M-Rome_Masters-SF-Andre_Agassi-Guillermo_Coria,1,F-XC,83,23,7,2,14,36,47
20050507-M-Rome_Masters-SF-Andre_Agassi-Guillermo_Coria,1,F-DTM,18,0,0,0,0,4,14
20050507-M-Rome_Masters-SF-Andre_Agassi-Guillermo_Coria,1,F-DTL,15,4,1,2,1,7,8
20050507-M-Rome_Masters-SF-Andre_Agassi-Guillermo_Coria,1,F-IO,37,12,5,3,4,20,17
20050507-M-Rome_Masters-SF-Andre_Agassi-Guillermo_Coria,1,F-II,5,2,1,0,1,4,1
20050507-M-Rome_Masters-SF-Andre_Agassi-Guillermo_Coria,1,B-XC,86,7,1,1,5,27,59
20050507-M-Rome_Masters-SF-Andre_Agassi-Guillermo_Coria,1,B-DTM,23,2,0,0,2,7,16
20050507-M-Rome_Masters-SF-Andre_Agassi-Guillermo_Coria,1,B-DTL,20,9,2,1,6,9,11
20050507-M-Rome_Masters-SF-Andre_Agassi-Guillermo_Coria,1,B-IO,8,1,0,0,1,4,4
20050507-M-Rome_Masters-SF-Andre_Agassi-Guillermo_Coria,1,S-XC,9,1,1,0,0,2,7
20050507-M-Rome_Masters-SF-Andre_Agassi-Guillermo_Coria,1,S-DTM,6,1,0,0,1,0,6
20050507-M-Rome_Masters-SF-Andre_Agassi-Guillermo_Coria,1,S-DTL,2,1,0,0,1,1,1
20050507-M-Rome_Masters-SF-Andre_Agassi-Guillermo_Coria,1,S-IO,1,0,0,0,0,1,0
20050507-M-Rome_Masters-SF-Andre_Agassi-Guillermo_Coria,2,F-XC,31,5,1,3,1,20,11
20050507-M-Rome_Masters-SF-Andre_Agassi-Guillermo_Coria,2,F-DTM,42,1,0,0,1,21,21
20050507-M-Rome_Masters-SF-Andre_Agassi-Guillermo_Coria,2,F-DTL,33,5,0,1,4,20,13
20050507-M-Rome_Masters-SF-Andre_Agassi-Guillermo_Coria,2,F-IO,18,5,3,1,1,14,4
20050507-M-Rome_Masters-SF-Andre_Agassi-Guillermo_Coria,2,F-II,7,2,1,1,0,7,0
20050507-M-Rome_Masters-SF-Andre_Agassi-Guillermo_Coria,2,B-XC,58,2,1,0,1,36,22
20050507-M-Rome_Masters-SF-Andre_Agassi-Guillermo_Coria,2,B-DTM,44,1,0,0,1,29,15
20050507-M-Rome_Masters-SF-Andre_Agassi-Guillermo_Coria,2,B-DTL,21,5,1,2,2,12,9
20050507-M-Rome_Masters-SF-Andre_Agassi-Guillermo_Coria,2,B-IO,7,3,1,0,2,4,3
20050507-M-Rome_Masters-SF-Andre_Agassi-Guillermo_Coria,2,S-XC,7,1,0,0,1,4,3
20050507-M-Rome_Masters-SF-Andre_Agassi-Guillermo_Coria,2,S-DTM,7,0,0,0,0,4,3
20050507-M-Rome_Masters-SF-Andre_Agassi-Guillermo_Coria,2,S-DTL,1,0,0,0,0,1,0
20160216-M-Delray_Beach-R32-Juan_Martin_Del_Potro-Denis_Kudla,1,F-XC,31,6,1,2,3,19,12
20160216-M-Delray_Beach-R32-Juan_Martin_Del_Potro-Denis_Kudla,1,F-DTM,6,0,0,0,0,2,4
20160216-M-Delray_Beach-R32-Juan_Martin_Del_Potro-Denis_Kudla,1,F-DTL,2,2,2,0,0,2,0
20160216-M-Delray_Beach-R32-Juan_Martin_Del_Potro-Denis_Kudla,1,F-IO,26,4,2,0,2,17,9
20160216-M-Delray_Beach-R32-Juan_Martin_Del_Potro-Denis_Kudla,1,F-II,5,2,0,1,1,4,1
20160216-M-Delray_Beach-R32-Juan_Martin_Del_Potro-Denis_Kudla,1,B-XC,18,2,0,0,2,11,7
20160216-M-Delray_Beach-R32-Juan_Martin_Del_Potro-Denis_Kudla,1,B-DTM,2,0,0,0,0,0,2
20160216-M-Delray_Beach-R32-Juan_Martin_Del_Potro-Denis_Kudla,1,B-DTL,2,2,0,2,0,2,0
20160216-M-Delray_Beach-R32-Juan_Martin_Del_Potro-Denis_Kudla,1,B-IO,1,1,0,0,1,0,1
20160216-M-Delray_Beach-R32-Juan_Martin_Del_Potro-Denis_Kudla,1,S-XC,30,1,0,0,1,11,19
20160216-M-Delray_Beach-R32-Juan_Martin_Del_Potro-Denis_Kudla,1,S-DTM,5,1,0,0,1,2,3
20160216-M-Delray_Beach-R32-Juan_Martin_Del_Potro-Denis_Kudla,2,F-XC,11,5,0,0,5,0,11
20160216-M-Delray_Beach-R32-Juan_Martin_Del_Potro-Denis_Kudla,2,F-DTM,12,3,0,0,3,5,7
20160216-M-Delray_Beach-R32-Juan_Martin_Del_Potro-Denis_Kudla,2,F-DTL,11,1,0,0,1,6,5
20160216-M-Delray_Beach-R32-Juan_Martin_Del_Potro-Denis_Kudla,2,F-IO,14,4,0,0,4,7,7
20160216-M-Delray_Beach-R32-Juan_Martin_Del_Potro-Denis_Kudla,2,F-II,2,1,0,0,1,1,1
20160216-M-Delray_Beach-R32-Juan_Martin_Del_Potro-Denis_Kudla,2,B-XC,30,3,0,0,3,13,17
20160216-M-Delray_Beach-R32-Juan_Martin_Del_Potro-Denis_Kudla,2,B-DTM,14,0,0,0,0,8,6
20160216-M-Delray_Beach-R32-Juan_Martin_Del_Potro-Denis_Kudla,2,B-DTL,11,7,3,2,2,7,4
20160216-M-Delray_Beach-R32-Juan_Martin_Del_Potro-Denis_Kudla,2,B-IO,5,3,1,1,1,4,1
20160216-M-Delray_Beach-R32-Juan_Martin_Del_Potro-Denis_Kudla,2,S-XC,17,1,0,0,1,6,11
20160216-M-Delray_Beach-R32-Juan_Martin_Del_Potro-Denis_Kudla,2,S-DTM,2,0,0,0,0,1,1
20160216-M-Delray_Beach-R32-Juan_Martin_Del_Potro-Denis_Kudla,2,S-DTL,3,0,0,0,0,3,0
19840610-M-Roland_Garros-F-John_Mcenroe-Ivan_Lendl,1,F-XC,47,7,1,1,5,15,32
19840610-M-Roland_Garros-F-John_Mcenroe-Ivan_Lendl,1,F-DTM,31,4,0,1,3,11,20
19840610-M-Roland_Garros-F-John_Mcenroe-Ivan_Lendl,1,F-DTL,20,10,2,2,6,10,10
19840610-M-Roland_Garros-F-John_Mcenroe-Ivan_Lendl,1,F-IO,10,5,1,2,2,5,5
19840610-M-Roland_Garros-F-John_Mcenroe-Ivan_Lendl,1,F-II,2,0,0,0,0,2,0
19840610-M-Roland_Garros-F-John_Mcenroe-Ivan_Lendl,1,B-XC,37,8,2,1,5,14,23
19840610-M-Roland_Garros-F-John_Mcenroe-Ivan_Lendl,1,B-DTM,48,3,0,0,3,22,26
19840610-M-Roland_Garros-F-John_Mcenroe-Ivan_Lendl,1,B-DTL,18,5,1,2,2,9,9
19840610-M-Roland_Garros-F-John_Mcenroe-Ivan_Lendl,1,B-IO,15,3,0,0,3,7,8
19840610-M-Roland_Garros-F-John_Mcenroe-Ivan_Lendl,1,S-XC,15,2,0,1,1,6,9
19840610-M-Roland_Garros-F-John_Mcenroe-Ivan_Lendl,1,S-DTM,24,3,0,0,3,8,16
19840610-M-Roland_Garros-F-John_Mcenroe-Ivan_Lendl,1,S-DTL,20,4,1,1,2,7,13
19840610-M-Roland_Garros-F-John_Mcenroe-Ivan_Lendl,1,S-IO,4,1,0,0,1,2,2
19840610-M-Roland_Garros-F-John_Mcenroe-Ivan_Lendl,2,F-XC,85,10,5,3,2,45,40
19840610-M-Roland_Garros-F-John_Mcenroe-Ivan_Lendl,2,F-DTM,35,4,0,2,2,20,15
19840610-M-Roland_Garros-F-John_Mcenroe-Ivan_Lendl,2,F-DTL,10,3,1,1,1,5,5
19840610-M-Roland_Garros-F-John_Mcenroe-Ivan_Lendl,2,F-IO,27,8,4,2,2,22,5
19840610-M-Roland_Garros-F-John_Mcenroe-Ivan_Lendl,2,F-II,2,1,0,1,0,2,0
19840610-M-Roland_Garros-F-John_Mcenroe-Ivan_Lendl,2,B-XC,63,14,8,2,4,41,22
19840610-M-Roland_Garros-F-John_Mcenroe-Ivan_Lendl,2,B-DTM,55,2,1,0,1,31,24
19840610-M-Roland_Garros-F-John_Mcenroe-Ivan_Lendl,2,B-DTL,33,6,2,1,3,16,17
19840610-M-Roland_Garros-F-John_Mcenroe-Ivan_Lendl,2,B-IO,21,2,1,1,0,15,6
19840610-M-Roland_Garros-F-John_Mcenroe-Ivan_Lendl,2,B-II,2,1,0,1,0,2,0
19840610-M-Roland_Garros-F-John_Mcenroe-Ivan_Lendl,2,S-XC,9,1,1,0,0,4,5
19840610-M-Roland_Garros-F-John_Mcenroe-Ivan_Lendl,2,S-DTM,5,1,0,0,1,2,3
19840610-M-Roland_Garros-F-John_Mcenroe-Ivan_Lendl,2,S-DTL,4,1,0,1,0,3,1
19840610-M-Roland_Garros-F-John_Mcenroe-Ivan_Lendl,2,S-IO,1,0,0,0,0,1,0
20160403-M-Miami_Masters-F-Novak_Djokovic-Kei_Nishikori,1,F-XC,37,9,3,2,4,19,18
20160403-M-Miami_Masters-F-Novak_Djokovic-Kei_Nishikori,1,F-DTM,15,1,0,0,1,7,8
20160403-M-Miami_Masters-F-Novak_Djokovic-Kei_Nishikori,1,F-DTL,17,7,3,2,2,11,6
20160403-M-Miami_Masters-F-Novak_Djokovic-Kei_Nishikori,1,F-IO,13,3,0,1,2,9,4
20160403-M-Miami_Masters-F-Novak_Djokovic-Kei_Nishikori,1,F-II,2,0,0,0,0,1,1
20160403-M-Miami_Masters-F-Novak_Djokovic-Kei_Nishikori,1,B-XC,54,3,0,1,2,20,34
20160403-M-Miami_Masters-F-Novak_Djokovic-Kei_Nishikori,1,B-DTM,25,0,0,0,0,18,7
20160403-M-Miami_Masters-F-Novak_Djokovic-Kei_Nishikori,1,B-DTL,17,10,5,1,4,10,7
20160403-M-Miami_Masters-F-Novak_Djokovic-Kei_Nishikori,1,B-IO,8,1,1,0,0,5,3
20160403-M-Miami_Masters-F-Novak_Djokovic-Kei_Nishikori,1,S-XC,10,3,0,1,2,4,6
20160403-M-Miami_Masters-F-Novak_Djokovic-Kei_Nishikori,1,S-DTM,4,0,0,0,0,1,3
20160403-M-Miami_Masters-F-Novak_Djokovic-Kei_Nishikori,1,S-DTL,1,1,0,1,0,1,0
20160403-M-Miami_Masters-F-Novak_Djokovic-Kei_Nishikori,2,F-XC,42,9,0,1,8,17,25
20160403-M-Miami_Masters-F-Novak_Djokovic-Kei_Nishikori,2,F-DTM,16,2,0,0,2,7,9
20160403-M-Miami_Masters-F-Novak_Djokovic-Kei_Nishikori,2,F-DTL,17,4,4,0,0,9,8
20160403-M-Miami_Masters-F-Novak_Djokovic-Kei_Nishikori,2,F-IO,24,4,2,0,2,15,9
20160403-M-Miami_Masters-F-Novak_Djokovic-Kei_Nishikori,2,F-II,4,0,0,0,0,1,3
20160403-M-Miami_Masters-F-Novak_Djokovic-Kei_Nishikori,2,B-XC,64,7,0,0,7,30,34
20160403-M-Miami_Masters-F-Novak_Djokovic-Kei_Nishikori,2,B-DTM,17,1,0,0,1,8,9
20160403-M-Miami_Masters-F-Novak_Djokovic-Kei_Nishikori,2,B-DTL,10,2,0,0,2,5,5
20160403-M-Miami_Masters-F-Novak_Djokovic-Kei_Nishikori,2,B-IO,2,0,0,0,0,1,1
20160403-M-Miami_Masters-F-Novak_Djokovic-Kei_Nishikori,2,S-XC,5,0,0,0,0,2,3
20160403-M-Miami_Masters-F-Novak_Djokovic-Kei_Nishikori,2,S-DTM,4,0,0,0,0,2,2
20160403-M-Miami_Masters-F-Novak_Djokovic-Kei_Nishikori,2,S-DTL,1,0,0,0,0,1,0
20160219-M-Delray_Beach-QF-Juan_Martin_Del_Potro-Jeremy_Chardy,1,F-XC,31,7,2,2,3,19,12
20160219-M-Delray_Beach-QF-Juan_Martin_Del_Potro-Jeremy_Chardy,1,F-DTM,19,1,0,0,1,14,5
20160219-M-Delray_Beach-QF-Juan_Martin_Del_Potro-Jeremy_Chardy,1,F-DTL,6,3,1,0,2,3,3
20160219-M-Delray_Beach-QF-Juan_Martin_Del_Potro-Jeremy_Chardy,1,F-IO,22,1,0,1,0,18,4
20160219-M-Delray_Beach-QF-Juan_Martin_Del_Potro-Jeremy_Chardy,1,F-II,3,2,0,0,2,1,2
20160219-M-Delray_Beach-QF-Juan_Martin_Del_Potro-Jeremy_Chardy,1,B-XC,33,3,0,0,3,21,12
20160219-M-Delray_Beach-QF-Juan_Martin_Del_Potro-Jeremy_Chardy,1,B-DTM,12,0,0,0,0,9,3
20160219-M-Delray_Beach-QF-Juan_Martin_Del_Potro-Jeremy_Chardy,1,B-DTL,2,1,0,1,0,1,1
20160219-M-Delray_Beach-QF-Juan_Martin_Del_Potro-Jeremy_Chardy,1,S-XC,20,1,0,0,1,12,8
20160219-M-Delray_Beach-QF-Juan_Martin_Del_Potro-Jeremy_Chardy,1,S-DTM,5,0,0,0,0,3,2
20160219-M-Delray_Beach-QF-Juan_Martin_Del_Potro-Jeremy_Chardy,2,F-XC,26,8,4,0,4,10,16
20160219-M-Delray_Beach-QF-Juan_Martin_Del_Potro-Jeremy_Chardy,2,F-DTM,22,6,0,1,5,6,16
20160219-M-Delray_Beach-QF-Juan_Martin_Del_Potro-Jeremy_Chardy,2,F-DTL,13,2,0,0,2,4,9
20160219-M-Delray_Beach-QF-Juan_Martin_Del_Potro-Jeremy_Chardy,2,F-IO,54,17,3,2,12,16,38
20160219-M-Delray_Beach-QF-Juan_Martin_Del_Potro-Jeremy_Chardy,2,F-II,11,3,1,1,1,7,4
20160219-M-Delray_Beach-QF-Juan_Martin_Del_Potro-Jeremy_Chardy,2,B-XC,9,2,0,0,2,1,8
20160219-M-Delray_Beach-QF-Juan_Martin_Del_Potro-Jeremy_Chardy,2,B-DTM,4,1,0,0,1,0,4
20160219-M-Delray_Beach-QF-Juan_Martin_Del_Potro-Jeremy_Chardy,2,B-DTL,4,0,0,0,0,2,2
20160219-M-Delray_Beach-QF-Juan_Martin_Del_Potro-Jeremy_Chardy,2,S-XC,16,3,0,0,3,4,12
20160219-M-Delray_Beach-QF-Juan_Martin_Del_Potro-Jeremy_Chardy,2,S-DTM,6,2,0,0,2,1,5
20160219-M-Delray_Beach-QF-Juan_Martin_Del_Potro-Jeremy_Chardy,2,S-DTL,2,0,0,0,0,1,1
19800608-M-Roland_Garros-F-Vitas_Gerulaitis-Bjorn_Borg,1,F-XC,21,2,1,0,1,6,15
19800608-M-Roland_Garros-F-Vitas_Gerulaitis-Bjorn_Borg,1,F-DTM,48,1,0,0,1,14,34
19800608-M-Roland_Garros-F-Vitas_Gerulaitis-Bjorn_Borg,1,F-DTL,41,9,1,1,7,10,31
19800608-M-Roland_Garros-F-Vitas_Gerulaitis-Bjorn_Borg,1,F-IO,36,3,0,1,2,13,23
19800608-M-Roland_Garros-F-Vitas_Gerulaitis-Bjorn_Borg,1,F-II,1,1,0,0,1,0,1
19800608-M-Roland_Garros-F-Vitas_Gerulaitis-Bjorn_Borg,1,B-XC,6,3,1,0,2,1,5
19800608-M-Roland_Garros-F-Vitas_Gerulaitis-Bjorn_Borg,1,B-DTM,4,0,0,0,0,1,3
19800608-M-Roland_Garros-F-Vitas_Gerulaitis-Bjorn_Borg,1,B-DTL,3,2,0,1,1,1,2
19800608-M-Roland_Garros-F-Vitas_Gerulaitis-Bjorn_Borg,1,S-XC,74,1,1,0,0,21,53
19800608-M-Roland_Garros-F-Vitas_Gerulaitis-Bjorn_Borg,1,S-DTM,59,1,0,0,1,20,39
19800608-M-Roland_Garros-F-Vitas_Gerulaitis-Bjorn_Borg,1,S-DTL,20,1,0,1,0,7,13
19800608-M-Roland_Garros-F-Vitas_Gerulaitis-Bjorn_Borg,1,S-IO,9,2,1,0,1,3,6
19800608-M-Roland_Garros-F-Vitas_Gerulaitis-Bjorn_Borg,2,F-XC,73,11,4,2,5,50,23
19800608-M-Roland_Garros-F-Vitas_Gerulaitis-Bjorn_Borg,2,F-DTM,38,1,0,1,0,22,16
19800608-M-Roland_Garros-F-Vitas_Gerulaitis-Bjorn_Borg,2,F-DTL,12,3,2,1,0,8,4
19800608-M-Roland_Garros-F-Vitas_Gerulaitis-Bjorn_Borg,2,F-IO,25,4,3,0,1,17,8
19800608-M-Roland_Garros-F-Vitas_Gerulaitis-Bjorn_Borg,2,F-II,5,0,0,0,0,4,1
19800608-M-Roland_Garros-F-Vitas_Gerulaitis-Bjorn_Borg,2,B-XC,122,10,2,4,4,84,38
19800608-M-Roland_Garros-F-Vitas_Gerulaitis-Bjorn_Borg,2,B-DTM,70,2,0,1,1,48,22
19800608-M-Roland_Garros-F-Vitas_Gerulaitis-Bjorn_Borg,2,B-DTL,19,1,1,0,0,15,4
19800608-M-Roland_Garros-F-Vitas_Gerulaitis-Bjorn_Borg,2,B-IO,8,2,2,0,0,7,1
19800608-M-Roland_Garros-F-Vitas_Gerulaitis-Bjorn_Borg,2,S-XC,5,0,0,0,0,3,2
19800608-M-Roland_Garros-F-Vitas_Gerulaitis-Bjorn_Borg,2,S-DTM,4,0,0,0,0,3,1
19800608-M-Roland_Garros-F-Vitas_Gerulaitis-Bjorn_Borg,2,S-DTL,5,0,0,0,0,3,2
19780611-M-Roland_Garros-F-Bjorn_Borg-Guillermo_Vilas,1,F-XC,180,9,4,2,3,124,56
19780611-M-Roland_Garros-F-Bjorn_Borg-Guillermo_Vilas,1,F-DTM,41,1,0,0,1,27,14
19780611-M-Roland_Garros-F-Bjorn_Borg-Guillermo_Vilas,1,F-DTL,21,5,2,0,3,10,11
19780611-M-Roland_Garros-F-Bjorn_Borg-Guillermo_Vilas,1,F-IO,33,7,3,1,3,23,10
19780611-M-Roland_Garros-F-Bjorn_Borg-Guillermo_Vilas,1,F-II,13,0,0,0,0,8,5
19780611-M-Roland_Garros-F-Bjorn_Borg-Guillermo_Vilas,1,B-XC,89,8,3,4,1,63,26
19780611-M-Roland_Garros-F-Bjorn_Borg-Guillermo_Vilas,1,B-DTM,65,0,0,0,0,41,24
19780611-M-Roland_Garros-F-Bjorn_Borg-Guillermo_Vilas,1,B-DTL,54,5,2,0,3,40,14
19780611-M-Roland_Garros-F-Bjorn_Borg-Guillermo_Vilas,1,B-IO,17,0,0,0,0,11,6
19780611-M-Roland_Garros-F-Bjorn_Borg-Guillermo_Vilas,1,S-XC,1,0,0,0,0,1,0
19780611-M-Roland_Garros-F-Bjorn_Borg-Guillermo_Vilas,1,S-DTM,6,0,0,0,0,4,2
19780611-M-Roland_Garros-F-Bjorn_Borg-Guillermo_Vilas,1,S-DTL,6,0,0,0,0,3,3
19780611-M-Roland_Garros-F-Bjorn_Borg-Guillermo_Vilas,2,F-XC,85,7,1,0,6,31,54
19780611-M-Roland_Garros-F-Bjorn_Borg-Guillermo_Vilas,2,F-DTM,38,1,1,0,0,9,29
19780611-M-Roland_Garros-F-Bjorn_Borg-Guillermo_Vilas,2,F-DTL,19,3,2,0,1,5,14
19780611-M-Roland_Garros-F-Bjorn_Borg-Guillermo_Vilas,2,F-IO,26,1,0,0,1,7,19
19780611-M-Roland_Garros-F-Bjorn_Borg-Guillermo_Vilas,2,F-II,3,0,0,0,0,1,2
19780611-M-Roland_Garros-F-Bjorn_Borg-Guillermo_Vilas,2,B-XC,31,5,1,0,4,11,20
19780611-M-Roland_Garros-F-Bjorn_Borg-Guillermo_Vilas,2,B-DTM,21,2,0,1,1,8,13
19780611-M-Roland_Garros-F-Bjorn_Borg-Guillermo_Vilas,2,B-DTL,36,6,0,2,4,9,27
19780611-M-Roland_Garros-F-Bjorn_Borg-Guillermo_Vilas,2,B-IO,11,1,0,0,1,4,7
19780611-M-Roland_Garros-F-Bjorn_Borg-Guillermo_Vilas,2,S-XC,65,5,1,0,4,25,40
19780611-M-Roland_Garros-F-Bjorn_Borg-Guillermo_Vilas,2,S-DTM,82,4,0,0,4,26,56
19780611-M-Roland_Garros-F-Bjorn_Borg-Guillermo_Vilas,2,S-DTL,70,4,0,0,4,17,53
19780611-M-Roland_Garros-F-Bjorn_Borg-Guillermo_Vilas,2,S-IO,21,6,0,0,6,5,16
19831211-M-Australian_Open-F-Mats_Wilander-Ivan_Lendl,1,F-XC,16,2,1,0,1,7,9
19831211-M-Australian_Open-F-Mats_Wilander-Ivan_Lendl,1,F-DTM,56,0,0,0,0,25,31
19831211-M-Australian_Open-F-Mats_Wilander-Ivan_Lendl,1,F-DTL,18,3,2,1,0,10,8
19831211-M-Australian_Open-F-Mats_Wilander-Ivan_Lendl,1,F-IO,20,4,0,1,3,10,10
19831211-M-Australian_Open-F-Mats_Wilander-Ivan_Lendl,1,B-XC,106,4,1,1,2,48,58
19831211-M-Australian_Open-F-Mats_Wilander-Ivan_Lendl,1,B-DTM,48,1,0,0,1,18,30
19831211-M-Australian_Open-F-Mats_Wilander-Ivan_Lendl,1,B-DTL,20,5,2,0,3,9,11
19831211-M-Australian_Open-F-Mats_Wilander-Ivan_Lendl,1,B-IO,17,5,3,0,2,10,7
19831211-M-Australian_Open-F-Mats_Wilander-Ivan_Lendl,1,S-XC,20,1,0,0,1,11,9
19831211-M-Australian_Open-F-Mats_Wilander-Ivan_Lendl,1,S-DTM,7,0,0,0,0,1,6
19831211-M-Australian_Open-F-Mats_Wilander-Ivan_Lendl,1,S-DTL,4,2,0,2,0,4,0
19831211-M-Australian_Open-F-Mats_Wilander-Ivan_Lendl,2,F-XC,37,5,1,3,1,18,19
19831211-M-Australian_Open-F-Mats_Wilander-Ivan_Lendl,2,F-DTM,25,3,0,1,2,14,11
19831211-M-Australian_Open-F-Mats_Wilander-Ivan_Lendl,2,F-DTL,11,2,0,0,2,3,8
19831211-M-Australian_Open-F-Mats_Wilander-Ivan_Lendl,2,F-IO,19,7,5,1,1,15,4
19831211-M-Australian_Open-F-Mats_Wilander-Ivan_Lendl,2,F-II,3,2,0,0,2,0,3
19831211-M-Australian_Open-F-Mats_Wilander-Ivan_Lendl,2,B-XC,31,4,1,2,1,20,11
19831211-M-Australian_Open-F-Mats_Wilander-Ivan_Lendl,2,B-DTM,32,0,0,0,0,16,16
19831211-M-Australian_Open-F-Mats_Wilander-Ivan_Lendl,2,B-DTL,10,2,2,0,0,8,2
19831211-M-Australian_Open-F-Mats_Wilander-Ivan_Lendl,2,B-IO,6,2,1,0,1,3,3
19831211-M-Australian_Open-F-Mats_Wilander-Ivan_Lendl,2,S-XC,104,0,0,0,0,53,51
19831211-M-Australian_Open-F-Mats_Wilander-Ivan_Lendl,2,S-DTM,55,3,0,1,2,31,24
19831211-M-Australian_Open-F-Mats_Wilander-Ivan_Lendl,2,S-DTL,7,1,0,0,1,4,3
19831211-M-Australian_Open-F-Mats_Wilander-Ivan_Lendl,2,S-IO,6,0,0,0,0,1,5
19840708-M-Wimbledon-F-John_Mcenroe-Jimmy_Connors,1,F-XC,2,1,1,0,0,2,0
19840708-M-Wimbledon-F-John_Mcenroe-Jimmy_Connors,1,F-DTL,1,0,0,0,0,1,0
19840708-M-Wimbledon-F-John_Mcenroe-Jimmy_Connors,1,F-IO,3,2,1,0,1,2,1
19840708-M-Wimbledon-F-John_Mcenroe-Jimmy_Connors,1,B-XC,2,1,1,0,0,2,0
19840708-M-Wimbledon-F-John_Mcenroe-Jimmy_Connors,1,B-DTM,5,2,1,1,0,4,1
19840708-M-Wimbledon-F-John_Mcenroe-Jimmy_Connors,1,B-DTL,2,0,0,0,0,0,2
19840708-M-Wimbledon-F-John_Mcenroe-Jimmy_Connors,1,B-IO,2,2,2,0,0,2,0
19840708-M-Wimbledon-F-John_Mcenroe-Jimmy_Connors,1,S-DTM,4,1,0,0,1,3,1
19840708-M-Wimbledon-F-John_Mcenroe-Jimmy_Connors,1,S-DTL,1,1,1,0,0,1,0
19840708-M-Wimbledon-F-John_Mcenroe-Jimmy_Connors,2,F-XC,4,2,0,1,1,1,3
19840708-M-Wimbledon-F-John_Mcenroe-Jimmy_Connors,2,F-DTM,2,0,0,0,0,1,1
19840708-M-Wimbledon-F-John_Mcenroe-Jimmy_Connors,2,F-DTL,3,2,1,0,1,1,2
19840708-M-Wimbledon-F-John_Mcenroe-Jimmy_Connors,2,B-XC,9,4,4,0,0,4,5
19840708-M-Wimbledon-F-John_Mcenroe-Jimmy_Connors,2,B-DTM,1,0,0,0,0,0,1
19840708-M-Wimbledon-F-John_Mcenroe-Jimmy_Connors,2,B-IO,1,0,0,0,0,0,1
19840708-M-Wimbledon-F-John_Mcenroe-Jimmy_Connors,2,S-XC,1,1,0,0,1,0,1
19840708-M-Wimbledon-F-John_Mcenroe-Jimmy_Connors,2,S-DTM,2,0,0,0,0,0,2
19840708-M-Wimbledon-F-John_Mcenroe-Jimmy_Connors,2,S-DTL,1,0,0,0,0,0,1
20160409-M-Houston-SF-John_Isner-Jack_Sock,1,F-XC,10,6,3,2,1,6,4
20160409-M-Houston-SF-John_Isner-Jack_Sock,1,F-DTM,12,3,0,0,3,4,8
20160409-M-Houston-SF-John_Isner-Jack_Sock,1,F-DTL,5,3,1,0,2,2,3
20160409-M-Houston-SF-John_Isner-Jack_Sock,1,F-IO,22,11,4,1,6,13,9
20160409-M-Houston-SF-John_Isner-Jack_Sock,1,B-XC,4,1,0,0,1,2,2
20160409-M-Houston-SF-John_Isner-Jack_Sock,1,B-DTM,26,4,0,0,4,7,19
20160409-M-Houston-SF-John_Isner-Jack_Sock,1,B-DTL,4,0,0,0,0,1,3
20160409-M-Houston-SF-John_Isner-Jack_Sock,1,B-IO,1,0,0,0,0,0,1
20160409-M-Houston-SF-John_Isner-Jack_Sock,1,S-XC,3,1,0,0,1,0,3
20160409-M-Houston-SF-John_Isner-Jack_Sock,1,S-DTM,3,0,0,0,0,1,2
20160409-M-Houston-SF-John_Isner-Jack_Sock,2,F-XC,22,9,3,3,3,13,9
20160409-M-Houston-SF-John_Isner-Jack_Sock,2,F-DTM,19,0,0,0,0,13,6
20160409-M-Houston-SF-John_Isner-Jack_Sock,2,F-DTL,3,0,0,0,0,3,0
20160409-M-Houston-SF-John_Isner-Jack_Sock,2,F-IO,26,9,3,3,3,18,8
20160409-M-Houston-SF-John_Isner-Jack_Sock,2,F-II,2,1,0,0,1,0,2
20160409-M-Houston-SF-John_Isner-Jack_Sock,2,B-XC,5,1,1,0,0,3,2
20160409-M-Houston-SF-John_Isner-Jack_Sock,2,B-DTM,12,0,0,0,0,5,7
20160409-M-Houston-SF-John_Isner-Jack_Sock,2,B-IO,1,1,0,0,1,0,1
20160409-M-Houston-SF-John_Isner-Jack_Sock,2,S-XC,2,1,0,0,1,1,1
20160409-M-Houston-SF-John_Isner-Jack_Sock,2,S-DTM,5,1,0,0,1,2,3
20000130-M-Australian_Open-F-Yevgeny_Kafelnikov-Andre_Agassi,1,F-XC,64,13,2,6,5,30,34
20000130-M-Australian_Open-F-Yevgeny_Kafelnikov-Andre_Agassi,1,F-DTM,32,3,0,0,3,11,21
20000130-M-Australian_Open-F-Yevgeny_Kafelnikov-Andre_Agassi,1,F-DTL,19,11,7,1,3,12,7
20000130-M-Australian_Open-F-Yevgeny_Kafelnikov-Andre_Agassi,1,F-IO,22,8,4,1,3,9,13
20000130-M-Australian_Open-F-Yevgeny_Kafelnikov-Andre_Agassi,1,F-II,7,4,2,0,2,3,4
20000130-M-Australian_Open-F-Yevgeny_Kafelnikov-Andre_Agassi,1,B-XC,88,10,2,2,6,37,51
20000130-M-Australian_Open-F-Yevgeny_Kafelnikov-Andre_Agassi,1,B-DTM,33,5,0,0,5,11,22
20000130-M-Australian_Open-F-Yevgeny_Kafelnikov-Andre_Agassi,1,B-DTL,25,14,7,1,6,13,12
20000130-M-Australian_Open-F-Yevgeny_Kafelnikov-Andre_Agassi,1,B-IO,2,1,0,0,1,0,2
20000130-M-Australian_Open-F-Yevgeny_Kafelnikov-Andre_Agassi,1,S-XC,22,2,0,0,2,10,12
20000130-M-Australian_Open-F-Yevgeny_Kafelnikov-Andre_Agassi,1,S-DTM,5,1,1,0,0,1,4
20000130-M-Australian_Open-F-Yevgeny_Kafelnikov-Andre_Agassi,2,F-XC,54,6,4,2,0,35,19
20000130-M-Australian_Open-F-Yevgeny_Kafelnikov-Andre_Agassi,2,F-DTM,37,5,1,1,3,21,16
20000130-M-Australian_Open-F-Yevgeny_Kafelnikov-Andre_Agassi,2,F-DTL,28,11,4,3,4,16,12
20000130-M-Australian_Open-F-Yevgeny_Kafelnikov-Andre_Agassi,2,F-IO,24,5,2,2,1,13,11
20000130-M-Australian_Open-F-Yevgeny_Kafelnikov-Andre_Agassi,2,F-II,5,2,1,1,0,4,1
20000130-M-Australian_Open-F-Yevgeny_Kafelnikov-Andre_Agassi,2,B-XC,89,8,3,4,1,64,25
20000130-M-Australian_Open-F-Yevgeny_Kafelnikov-Andre_Agassi,2,B-DTM,26,4,0,1,3,14,12
20000130-M-Australian_Open-F-Yevgeny_Kafelnikov-Andre_Agassi,2,B-DTL,27,12,5,1,6,13,14
20000130-M-Australian_Open-F-Yevgeny_Kafelnikov-Andre_Agassi,2,B-IO,4,1,1,0,0,2,2
20000130-M-Australian_Open-F-Yevgeny_Kafelnikov-Andre_Agassi,2,S-XC,15,1,0,0,1,7,8
20000130-M-Australian_Open-F-Yevgeny_Kafelnikov-Andre_Agassi,2,S-DTM,7,0,0,0,0,2,5
20000130-M-Australian_Open-F-Yevgeny_Kafelnikov-Andre_Agassi,2,S-DTL,4,1,1,0,0,2,2
20160410-M-Marrakech-F-Federico_Delbonis-Borna_Coric,1,F-XC,31,6,2,1,3,18,13
20160410-M-Marrakech-F-Federico_Delbonis-Borna_Coric,1,F-DTM,48,7,1,0,6,18,30
20160410-M-Marrakech-F-Federico_Delbonis-Borna_Coric,1,F-DTL,6,1,1,0,0,4,2
20160410-M-Marrakech-F-Federico_Delbonis-Borna_Coric,1,F-IO,15,10,5,1,4,8,7
20160410-M-Marrakech-F-Federico_Delbonis-Borna_Coric,1,F-II,3,2,2,0,0,2,1
20160410-M-Marrakech-F-Federico_Delbonis-Borna_Coric,1,B-XC,18,6,0,0,6,7,11
20160410-M-Marrakech-F-Federico_Delbonis-Borna_Coric,1,B-DTM,24,3,0,0,3,11,13
20160410-M-Marrakech-F-Federico_Delbonis-Borna_Coric,1,B-DTL,6,3,0,1,2,2,4
20160410-M-Marrakech-F-Federico_Delbonis-Borna_Coric,1,B-IO,4,1,0,0,1,2,2
20160410-M-Marrakech-F-Federico_Delbonis-Borna_Coric,1,S-DTM,3,0,0,0,0,2,1
20160410-M-Marrakech-F-Federico_Delbonis-Borna_Coric,2,F-XC,34,6,1,0,5,16,18
20160410-M-Marrakech-F-Federico_Delbonis-Borna_Coric,2,F-DTM,27,4,0,0,4,15,12
20160410-M-Marrakech-F-Federico_Delbonis-Borna_Coric,2,F-DTL,3,1,0,0,1,1,2
20160410-M-Marrakech-F-Federico_Delbonis-Borna_Coric,2,F-IO,19,10,4,3,3,11,8
20160410-M-Marrakech-F-Federico_Delbonis-Borna_Coric,2,B-XC,20,7,0,2,5,8,12
20160410-M-Marrakech-F-Federico_Delbonis-Borna_Coric,2,B-DTM,37,5,0,0,5,18,19
20160410-M-Marrakech-F-Federico_Delbonis-Borna_Coric,2,B-DTL,8,1,0,0,1,4,4
20160410-M-Marrakech-F-Federico_Delbonis-Borna_Coric,2,B-IO,4,1,1,0,0,3,1
20160410-M-Marrakech-F-Federico_Delbonis-Borna_Coric,2,S-DTM,2,0,0,0,0,0,2
20160326-M-San_Luis_Potosi_CH-SF-Albert_Montanes-Pedja_Krstin,1,F-XC,35,6,2,0,4,15,20
20160326-M-San_Luis_Potosi_CH-SF-Albert_Montanes-Pedja_Krstin,1,F-DTM,17,4,0,0,4,6,11
20160326-M-San_Luis_Potosi_CH-SF-Albert_Montanes-Pedja_Krstin,1,F-DTL,6,0,0,0,0,2,4
20160326-M-San_Luis_Potosi_CH-SF-Albert_Montanes-Pedja_Krstin,1,F-IO,46,5,0,2,3,22,24
20160326-M-San_Luis_Potosi_CH-SF-Albert_Montanes-Pedja_Krstin,1,F-II,12,5,2,1,2,8,4
20160326-M-San_Luis_Potosi_CH-SF-Albert_Montanes-Pedja_Krstin,1,B-XC,7,1,0,0,1,1,6
20160326-M-San_Luis_Potosi_CH-SF-Albert_Montanes-Pedja_Krstin,1,B-DTM,6,1,0,0,1,2,4
20160326-M-San_Luis_Potosi_CH-SF-Albert_Montanes-Pedja_Krstin,1,B-DTL,2,2,1,1,0,2,0
20160326-M-San_Luis_Potosi_CH-SF-Albert_Montanes-Pedja_Krstin,1,S-XC,38,6,2,0,4,16,22
20160326-M-San_Luis_Potosi_CH-SF-Albert_Montanes-Pedja_Krstin,1,S-DTM,7,2,0,0,2,3,4
20160326-M-San_Luis_Potosi_CH-SF-Albert_Montanes-Pedja_Krstin,1,S-DTL,3,1,0,0,1,2,1
20160326-M-San_Luis_Potosi_CH-SF-Albert_Montanes-Pedja_Krstin,1,S-IO,1,1,0,0,1,0,1
20160326-M-San_Luis_Potosi_CH-SF-Albert_Montanes-Pedja_Krstin,2,F-XC,27,7,2,3,2,19,8
20160326-M-San_Luis_Potosi_CH-SF-Albert_Montanes-Pedja_Krstin,2,F-DTM,17,0,0,0,0,7,10
20160326-M-San_Luis_Potosi_CH-SF-Albert_Montanes-Pedja_Krstin,2,F-DTL,19,3,0,2,1,11,8
20160326-M-San_Luis_Potosi_CH-SF-Albert_Montanes-Pedja_Krstin,2,F-IO,23,1,0,0,1,10,13
20160326-M-San_Luis_Potosi_CH-SF-Albert_Montanes-Pedja_Krstin,2,F-II,2,0,0,0,0,2,0
20160326-M-San_Luis_Potosi_CH-SF-Albert_Montanes-Pedja_Krstin,2,B-XC,56,2,0,1,1,33,23
20160326-M-San_Luis_Potosi_CH-SF-Albert_Montanes-Pedja_Krstin,2,B-DTM,26,5,0,1,4,13,13
20160326-M-San_Luis_Potosi_CH-SF-Albert_Montanes-Pedja_Krstin,2,B-DTL,13,6,1,3,2,9,4
20160326-M-San_Luis_Potosi_CH-SF-Albert_Montanes-Pedja_Krstin,2,B-IO,2,0,0,0,0,0,2
20160326-M-San_Luis_Potosi_CH-SF-Albert_Montanes-Pedja_Krstin,2,S-XC,2,0,0,0,0,0,2
20160326-M-San_Luis_Potosi_CH-SF-Albert_Montanes-Pedja_Krstin,2,S-DTM,2,0,0,0,0,1,1
20160412-M-Monte_Carlo_Masters-R64-Joao_Sousa-Ivo_Karlovic,1,F-XC,11,5,1,1,3,8,3
20160412-M-Monte_Carlo_Masters-R64-Joao_Sousa-Ivo_Karlovic,1,F-DTM,12,0,0,0,0,7,5
20160412-M-Monte_Carlo_Masters-R64-Joao_Sousa-Ivo_Karlovic,1,F-DTL,13,5,2,2,1,10,3
20160412-M-Monte_Carlo_Masters-R64-Joao_Sousa-Ivo_Karlovic,1,F-IO,21,3,1,1,1,15,6
20160412-M-Monte_Carlo_Masters-R64-Joao_Sousa-Ivo_Karlovic,1,F-II,5,2,2,0,0,4,1
20160412-M-Monte_Carlo_Masters-R64-Joao_Sousa-Ivo_Karlovic,1,B-XC,2,0,0,0,0,1,1
20160412-M-Monte_Carlo_Masters-R64-Joao_Sousa-Ivo_Karlovic,1,B-DTM,1,0,0,0,0,1,0
20160412-M-Monte_Carlo_Masters-R64-Joao_Sousa-Ivo_Karlovic,1,B-DTL,1,1,1,0,0,1,0
20160412-M-Monte_Carlo_Masters-R64-Joao_Sousa-Ivo_Karlovic,1,B-IO,2,2,1,0,1,1,1
20160412-M-Monte_Carlo_Masters-R64-Joao_Sousa-Ivo_Karlovic,1,S-II,1,0,0,0,0,1,0
20160412-M-Monte_Carlo_Masters-R64-Joao_Sousa-Ivo_Karlovic,2,F-XC,10,4,1,0,3,4,6
20160412-M-Monte_Carlo_Masters-R64-Joao_Sousa-Ivo_Karlovic,2,F-DTM,2,1,0,0,1,1,1
20160412-M-Monte_Carlo_Masters-R64-Joao_Sousa-Ivo_Karlovic,2,F-DTL,3,2,0,0,2,0,3
20160412-M-Monte_Carlo_Masters-R64-Joao_Sousa-Ivo_Karlovic,2,F-IO,3,3,0,1,2,1,2
20160412-M-Monte_Carlo_Masters-R64-Joao_Sousa-Ivo_Karlovic,2,B-XC,1,0,0,0,0,0,1
20160412-M-Monte_Carlo_Masters-R64-Joao_Sousa-Ivo_Karlovic,2,B-DTM,1,0,0,0,0,0,1
20160412-M-Monte_Carlo_Masters-R64-Joao_Sousa-Ivo_Karlovic,2,S-XC,6,2,0,0,2,0,6
20160412-M-Monte_Carlo_Masters-R64-Joao_Sousa-Ivo_Karlovic,2,S-DTM,13,2,0,0,2,3,10
20160412-M-Monte_Carlo_Masters-R64-Joao_Sousa-Ivo_Karlovic,2,S-DTL,6,3,0,0,3,0,6
20160412-M-Monte_Carlo_Masters-R64-Joao_Sousa-Ivo_Karlovic,2,S-IO,1,1,0,0,1,0,1
20130811-M-Canada_Masters-F-Milos_Raonic-Rafael_Nadal,1,F-XC,25,5,0,1,4,9,16
20130811-M-Canada_Masters-F-Milos_Raonic-Rafael_Nadal,1,F-DTM,13,0,0,0,0,2,11
20130811-M-Canada_Masters-F-Milos_Raonic-Rafael_Nadal,1,F-DTL,4,4,1,1,2,2,2
20130811-M-Canada_Masters-F-Milos_Raonic-Rafael_Nadal,1,F-IO,13,5,2,1,2,5,8
20130811-M-Canada_Masters-F-Milos_Raonic-Rafael_Nadal,1,F-II,4,2,0,0,2,1,3
20130811-M-Canada_Masters-F-Milos_Raonic-Rafael_Nadal,1,B-XC,7,2,0,1,1,2,5
20130811-M-Canada_Masters-F-Milos_Raonic-Rafael_Nadal,1,B-DTM,4,1,0,0,1,0,4
20130811-M-Canada_Masters-F-Milos_Raonic-Rafael_Nadal,1,B-DTL,7,3,0,0,3,1,6
20130811-M-Canada_Masters-F-Milos_Raonic-Rafael_Nadal,1,S-DTM,1,0,0,0,0,1,0
20130811-M-Canada_Masters-F-Milos_Raonic-Rafael_Nadal,1,S-DTL,1,1,0,0,1,0,1
20130811-M-Canada_Masters-F-Milos_Raonic-Rafael_Nadal,2,F-XC,20,5,3,0,2,15,5
20130811-M-Canada_Masters-F-Milos_Raonic-Rafael_Nadal,2,F-DTM,3,0,0,0,0,2,1
20130811-M-Canada_Masters-F-Milos_Raonic-Rafael_Nadal,2,F-DTL,8,5,2,2,1,5,3
20130811-M-Canada_Masters-F-Milos_Raonic-Rafael_Nadal,2,F-IO,17,7,3,1,3,13,4
20130811-M-Canada_Masters-F-Milos_Raonic-Rafael_Nadal,2,F-II,3,0,0,0,0,3,0
20130811-M-Canada_Masters-F-Milos_Raonic-Rafael_Nadal,2,B-XC,11,5,2,2,1,7,4
20130811-M-Canada_Masters-F-Milos_Raonic-Rafael_Nadal,2,B-DTM,7,0,0,0,0,5,2
20130811-M-Canada_Masters-F-Milos_Raonic-Rafael_Nadal,2,B-DTL,4,1,1,0,0,2,2
20130811-M-Canada_Masters-F-Milos_Raonic-Rafael_Nadal,2,S-DTM,2,0,0,0,0,1,1
20130811-M-Canada_Masters-F-Milos_Raonic-Rafael_Nadal,2,S-DTL,2,0,0,0,0,2,0
20130811-M-Canada_Masters-F-Milos_Raonic-Rafael_Nadal,2,S-IO,1,0,0,0,0,1,0
20160413-M-Monte_Carlo_Masters-R32-Novak_Djokovic-Jiri_Vesely,1,F-XC,52,11,4,2,5,26,26
20160413-M-Monte_Carlo_Masters-R32-Novak_Djokovic-Jiri_Vesely,1,F-DTM,43,2,0,0,2,22,21
20160413-M-Monte_Carlo_Masters-R32-Novak_Djokovic-Jiri_Vesely,1,F-DTL,17,10,3,2,5,9,8
20160413-M-Monte_Carlo_Masters-R32-Novak_Djokovic-Jiri_Vesely,1,F-IO,34,8,0,2,6,18,16
20160413-M-Monte_Carlo_Masters-R32-Novak_Djokovic-Jiri_Vesely,1,F-II,3,2,2,0,0,2,1
20160413-M-Monte_Carlo_Masters-R32-Novak_Djokovic-Jiri_Vesely,1,B-XC,26,4,4,0,0,16,10
20160413-M-Monte_Carlo_Masters-R32-Novak_Djokovic-Jiri_Vesely,1,B-DTM,40,4,0,2,2,20,20
20160413-M-Monte_Carlo_Masters-R32-Novak_Djokovic-Jiri_Vesely,1,B-DTL,12,3,1,0,2,5,7
20160413-M-Monte_Carlo_Masters-R32-Novak_Djokovic-Jiri_Vesely,1,B-IO,6,2,1,0,1,3,3
20160413-M-Monte_Carlo_Masters-R32-Novak_Djokovic-Jiri_Vesely,1,B-II,1,1,1,0,0,1,0
20160413-M-Monte_Carlo_Masters-R32-Novak_Djokovic-Jiri_Vesely,1,S-XC,2,1,1,0,0,2,0
20160413-M-Monte_Carlo_Masters-R32-Novak_Djokovic-Jiri_Vesely,1,S-DTM,2,1,0,0,1,1,1
20160413-M-Monte_Carlo_Masters-R32-Novak_Djokovic-Jiri_Vesely,2,F-XC,46,9,1,3,5,22,24
20160413-M-Monte_Carlo_Masters-R32-Novak_Djokovic-Jiri_Vesely,2,F-DTM,43,4,0,1,3,18,25
20160413-M-Monte_Carlo_Masters-R32-Novak_Djokovic-Jiri_Vesely,2,F-DTL,9,5,1,2,2,5,4
20160413-M-Monte_Carlo_Masters-R32-Novak_Djokovic-Jiri_Vesely,2,F-IO,15,4,1,0,3,8,7
20160413-M-Monte_Carlo_Masters-R32-Novak_Djokovic-Jiri_Vesely,2,B-XC,44,6,0,2,4,20,24
20160413-M-Monte_Carlo_Masters-R32-Novak_Djokovic-Jiri_Vesely,2,B-DTM,37,4,0,0,4,21,16
20160413-M-Monte_Carlo_Masters-R32-Novak_Djokovic-Jiri_Vesely,2,B-DTL,8,5,4,0,1,4,4
20160413-M-Monte_Carlo_Masters-R32-Novak_Djokovic-Jiri_Vesely,2,B-IO,13,5,1,2,2,8,5
20160413-M-Monte_Carlo_Masters-R32-Novak_Djokovic-Jiri_Vesely,2,S-XC,2,0,0,0,0,2,0
20160413-M-Monte_Carlo_Masters-R32-Novak_Djokovic-Jiri_Vesely,2,S-DTM,7,0,0,0,0,5,2
20160413-M-Monte_Carlo_Masters-R32-Novak_Djokovic-Jiri_Vesely,2,S-DTL,4,1,1,0,0,2,2
20160413-M-Monte_Carlo_Masters-R32-Novak_Djokovic-Jiri_Vesely,2,S-IO,1,0,0,0,0,0,1
20160415-M-Gwangju_CH-QF-Grega_Zemlja-Matt_Reid,1,F-XC,16,7,2,4,1,15,1
20160415-M-Gwangju_CH-QF-Grega_Zemlja-Matt_Reid,1,F-DTM,6,0,0,0,0,4,2
20160415-M-Gwangju_CH-QF-Grega_Zemlja-Matt_Reid,1,F-DTL,3,1,0,1,0,3,0
20160415-M-Gwangju_CH-QF-Grega_Zemlja-Matt_Reid,1,F-IO,10,1,1,0,0,7,3
20160415-M-Gwangju_CH-QF-Grega_Zemlja-Matt_Reid,1,F-II,3,2,2,0,0,3,0
20160415-M-Gwangju_CH-QF-Grega_Zemlja-Matt_Reid,1,B-XC,13,1,1,0,0,13,0
20160415-M-Gwangju_CH-QF-Grega_Zemlja-Matt_Reid,1,B-DTM,3,1,0,0,1,1,2
20160415-M-Gwangju_CH-QF-Grega_Zemlja-Matt_Reid,1,B-DTL,3,3,2,1,0,3,0
20160415-M-Gwangju_CH-QF-Grega_Zemlja-Matt_Reid,1,B-IO,1,1,0,1,0,1,0
20160415-M-Gwangju_CH-QF-Grega_Zemlja-Matt_Reid,1,S-XC,8,1,0,1,0,7,1
20160415-M-Gwangju_CH-QF-Grega_Zemlja-Matt_Reid,1,S-DTM,1,0,0,0,0,0,1
20160415-M-Gwangju_CH-QF-Grega_Zemlja-Matt_Reid,1,S-DTL,2,0,0,0,0,2,0
20160415-M-Gwangju_CH-QF-Grega_Zemlja-Matt_Reid,2,F-XC,6,1,0,0,1,2,4
20160415-M-Gwangju_CH-QF-Grega_Zemlja-Matt_Reid,2,F-DTM,8,2,0,1,1,1,7
20160415-M-Gwangju_CH-QF-Grega_Zemlja-Matt_Reid,2,F-DTL,3,1,0,0,1,0,3
20160415-M-Gwangju_CH-QF-Grega_Zemlja-Matt_Reid,2,F-IO,12,1,0,1,0,3,9
20160415-M-Gwangju_CH-QF-Grega_Zemlja-Matt_Reid,2,F-II,2,1,0,0,1,0,2
20160415-M-Gwangju_CH-QF-Grega_Zemlja-Matt_Reid,2,B-XC,5,0,0,0,0,0,5
20160415-M-Gwangju_CH-QF-Grega_Zemlja-Matt_Reid,2,B-DTM,6,0,0,0,0,1,5
20160415-M-Gwangju_CH-QF-Grega_Zemlja-Matt_Reid,2,B-DTL,5,4,2,0,2,2,3
20160415-M-Gwangju_CH-QF-Grega_Zemlja-Matt_Reid,2,B-IO,3,0,0,0,0,0,3
20160415-M-Gwangju_CH-QF-Grega_Zemlja-Matt_Reid,2,S-XC,8,2,0,0,2,0,8
20160415-M-Gwangju_CH-QF-Grega_Zemlja-Matt_Reid,2,S-DTM,3,0,0,0,0,1,2
20050130-M-Australian_Open-F-Lleyton_Hewitt-Marat_Safin,1,F-XC,95,9,2,4,3,53,42
20050130-M-Australian_Open-F-Lleyton_Hewitt-Marat_Safin,1,F-DTM,31,0,0,0,0,17,14
20050130-M-Australian_Open-F-Lleyton_Hewitt-Marat_Safin,1,F-DTL,30,10,5,3,2,15,15
20050130-M-Australian_Open-F-Lleyton_Hewitt-Marat_Safin,1,F-IO,22,11,6,4,1,17,5
20050130-M-Australian_Open-F-Lleyton_Hewitt-Marat_Safin,1,B-XC,117,8,0,4,4,60,57
20050130-M-Australian_Open-F-Lleyton_Hewitt-Marat_Safin,1,B-DTM,42,1,0,0,1,23,19
20050130-M-Australian_Open-F-Lleyton_Hewitt-Marat_Safin,1,B-DTL,13,7,3,3,1,10,3
20050130-M-Australian_Open-F-Lleyton_Hewitt-Marat_Safin,1,B-IO,10,1,0,0,1,4,6
20050130-M-Australian_Open-F-Lleyton_Hewitt-Marat_Safin,1,S-XC,12,1,0,0,1,5,7
20050130-M-Australian_Open-F-Lleyton_Hewitt-Marat_Safin,1,S-DTM,9,0,0,0,0,5,4
20050130-M-Australian_Open-F-Lleyton_Hewitt-Marat_Safin,1,S-DTL,6,1,0,0,1,1,5
20050130-M-Australian_Open-F-Lleyton_Hewitt-Marat_Safin,2,F-XC,84,16,3,6,7,42,42
20050130-M-Australian_Open-F-Lleyton_Hewitt-Marat_Safin,2,F-DTM,39,2,1,0,1,18,21
20050130-M-Australian_Open-F-Lleyton_Hewitt-Marat_Safin,2,F-DTL,31,11,7,3,1,19,12
20050130-M-Australian_Open-F-Lleyton_Hewitt-Marat_Safin,2,F-IO,23,9,1,4,4,11,12
20050130-M-Australian_Open-F-Lleyton_Hewitt-Marat_Safin,2,F-II,4,1,0,0,1,2,2
20050130-M-Australian_Open-F-Lleyton_Hewitt-Marat_Safin,2,B-XC,96,16,5,5,6,50,46
20050130-M-Australian_Open-F-Lleyton_Hewitt-Marat_Safin,2,B-DTM,45,1,0,0,1,17,28
20050130-M-Australian_Open-F-Lleyton_Hewitt-Marat_Safin,2,B-DTL,36,14,3,3,8,16,20
20050130-M-Australian_Open-F-Lleyton_Hewitt-Marat_Safin,2,B-IO,8,3,1,1,1,3,5
20050130-M-Australian_Open-F-Lleyton_Hewitt-Marat_Safin,2,S-XC,12,1,0,0,1,6,6
20050130-M-Australian_Open-F-Lleyton_Hewitt-Marat_Safin,2,S-DTM,3,0,0,0,0,2,1
20050130-M-Australian_Open-F-Lleyton_Hewitt-Marat_Safin,2,S-DTL,1,0,0,0,0,1,0
20050130-M-Australian_Open-F-Lleyton_Hewitt-Marat_Safin,2,S-IO,3,0,0,0,0,2,1
20160416-M-Monte_Carlo_Masters-SF-Jo_Wilfried_Tsonga-Gael_Monfils,1,F-XC,30,6,2,2,2,14,16
20160416-M-Monte_Carlo_Masters-SF-Jo_Wilfried_Tsonga-Gael_Monfils,1,F-DTM,14,2,0,0,2,6,8
20160416-M-Monte_Carlo_Masters-SF-Jo_Wilfried_Tsonga-Gael_Monfils,1,F-DTL,8,4,1,0,3,3,5
20160416-M-Monte_Carlo_Masters-SF-Jo_Wilfried_Tsonga-Gael_Monfils,1,F-IO,27,10,2,1,7,11,16
20160416-M-Monte_Carlo_Masters-SF-Jo_Wilfried_Tsonga-Gael_Monfils,1,F-II,8,3,0,0,3,1,7
20160416-M-Monte_Carlo_Masters-SF-Jo_Wilfried_Tsonga-Gael_Monfils,1,B-XC,38,7,0,2,5,12,26
20160416-M-Monte_Carlo_Masters-SF-Jo_Wilfried_Tsonga-Gael_Monfils,1,B-DTM,15,0,0,0,0,6,9
20160416-M-Monte_Carlo_Masters-SF-Jo_Wilfried_Tsonga-Gael_Monfils,1,B-DTL,9,4,1,0,3,3,6
20160416-M-Monte_Carlo_Masters-SF-Jo_Wilfried_Tsonga-Gael_Monfils,1,S-XC,5,1,0,0,1,3,2
20160416-M-Monte_Carlo_Masters-SF-Jo_Wilfried_Tsonga-Gael_Monfils,1,S-DTM,2,0,0,0,0,1,1
20160416-M-Monte_Carlo_Masters-SF-Jo_Wilfried_Tsonga-Gael_Monfils,1,S-DTL,4,1,0,0,1,1,3
20160416-M-Monte_Carlo_Masters-SF-Jo_Wilfried_Tsonga-Gael_Monfils,2,F-XC,27,6,3,0,3,16,11
20160416-M-Monte_Carlo_Masters-SF-Jo_Wilfried_Tsonga-Gael_Monfils,2,F-DTM,17,1,0,0,1,13,4
20160416-M-Monte_Carlo_Masters-SF-Jo_Wilfried_Tsonga-Gael_Monfils,2,F-DTL,8,3,2,0,1,5,3
20160416-M-Monte_Carlo_Masters-SF-Jo_Wilfried_Tsonga-Gael_Monfils,2,F-IO,21,1,0,1,0,13,8
20160416-M-Monte_Carlo_Masters-SF-Jo_Wilfried_Tsonga-Gael_Monfils,2,F-II,4,2,0,1,1,1,3
20160416-M-Monte_Carlo_Masters-SF-Jo_Wilfried_Tsonga-Gael_Monfils,2,B-XC,41,5,0,1,4,24,17
20160416-M-Monte_Carlo_Masters-SF-Jo_Wilfried_Tsonga-Gael_Monfils,2,B-DTM,14,1,0,1,0,9,5
20160416-M-Monte_Carlo_Masters-SF-Jo_Wilfried_Tsonga-Gael_Monfils,2,B-DTL,9,6,3,1,2,5,4
20160416-M-Monte_Carlo_Masters-SF-Jo_Wilfried_Tsonga-Gael_Monfils,2,B-IO,2,1,0,0,1,1,1
20160416-M-Monte_Carlo_Masters-SF-Jo_Wilfried_Tsonga-Gael_Monfils,2,S-XC,1,1,0,1,0,1,0
20050505-M-Rome_Masters-R16-Andy_Roddick-Fernando_Verdasco,1,F-XC,87,16,2,4,10,35,52
20050505-M-Rome_Masters-R16-Andy_Roddick-Fernando_Verdasco,1,F-DTM,14,2,0,0,2,7,7
20050505-M-Rome_Masters-R16-Andy_Roddick-Fernando_Verdasco,1,F-DTL,22,8,4,2,2,13,9
20050505-M-Rome_Masters-R16-Andy_Roddick-Fernando_Verdasco,1,F-IO,38,11,5,2,4,19,19
20050505-M-Rome_Masters-R16-Andy_Roddick-Fernando_Verdasco,1,F-II,8,1,0,0,1,5,3
20050505-M-Rome_Masters-R16-Andy_Roddick-Fernando_Verdasco,1,B-XC,41,10,1,1,8,15,26
20050505-M-Rome_Masters-R16-Andy_Roddick-Fernando_Verdasco,1,B-DTM,26,2,0,0,2,10,16
20050505-M-Rome_Masters-R16-Andy_Roddick-Fernando_Verdasco,1,B-DTL,18,1,1,0,0,8,10
20050505-M-Rome_Masters-R16-Andy_Roddick-Fernando_Verdasco,1,B-IO,5,1,0,0,1,1,4
20050505-M-Rome_Masters-R16-Andy_Roddick-Fernando_Verdasco,1,S-XC,9,3,0,0,3,2,7
20050505-M-Rome_Masters-R16-Andy_Roddick-Fernando_Verdasco,1,S-DTM,5,0,0,0,0,0,5
20050505-M-Rome_Masters-R16-Andy_Roddick-Fernando_Verdasco,1,S-DTL,3,3,2,0,1,2,1
20050505-M-Rome_Masters-R16-Andy_Roddick-Fernando_Verdasco,1,S-IO,3,0,0,0,0,1,2
20050505-M-Rome_Masters-R16-Andy_Roddick-Fernando_Verdasco,2,F-XC,93,19,7,3,9,52,41
20050505-M-Rome_Masters-R16-Andy_Roddick-Fernando_Verdasco,2,F-DTM,20,4,0,0,4,7,13
20050505-M-Rome_Masters-R16-Andy_Roddick-Fernando_Verdasco,2,F-DTL,15,8,3,2,3,9,6
20050505-M-Rome_Masters-R16-Andy_Roddick-Fernando_Verdasco,2,F-IO,43,25,17,6,2,32,11
20050505-M-Rome_Masters-R16-Andy_Roddick-Fernando_Verdasco,2,F-II,13,5,1,1,3,8,5
20050505-M-Rome_Masters-R16-Andy_Roddick-Fernando_Verdasco,2,B-XC,62,23,7,2,14,31,31
20050505-M-Rome_Masters-R16-Andy_Roddick-Fernando_Verdasco,2,B-DTM,13,2,1,0,1,9,4
20050505-M-Rome_Masters-R16-Andy_Roddick-Fernando_Verdasco,2,B-DTL,30,7,2,0,5,18,12
20050505-M-Rome_Masters-R16-Andy_Roddick-Fernando_Verdasco,2,B-IO,1,0,0,0,0,0,1
20050505-M-Rome_Masters-R16-Andy_Roddick-Fernando_Verdasco,2,S-XC,1,0,0,0,0,0,1
20050505-M-Rome_Masters-R16-Andy_Roddick-Fernando_Verdasco,2,S-DTM,4,0,0,0,0,3,1
19940130-M-Australian_Open-F-Pete_Sampras-Todd_Martin,1,F-XC,26,13,3,2,8,14,12
19940130-M-Australian_Open-F-Pete_Sampras-Todd_Martin,1,F-DTM,24,6,0,1,5,10,14
19940130-M-Australian_Open-F-Pete_Sampras-Todd_Martin,1,F-DTL,6,2,2,0,0,4,2
19940130-M-Australian_Open-F-Pete_Sampras-Todd_Martin,1,F-IO,18,7,5,2,0,15,3
19940130-M-Australian_Open-F-Pete_Sampras-Todd_Martin,1,F-II,5,1,1,0,0,4,1
19940130-M-Australian_Open-F-Pete_Sampras-Todd_Martin,1,B-XC,33,9,1,2,6,18,15
19940130-M-Australian_Open-F-Pete_Sampras-Todd_Martin,1,B-DTM,25,0,0,0,0,17,8
19940130-M-Australian_Open-F-Pete_Sampras-Todd_Martin,1,B-DTL,11,8,2,2,4,5,6
19940130-M-Australian_Open-F-Pete_Sampras-Todd_Martin,1,B-IO,2,1,1,0,0,2,0
19940130-M-Australian_Open-F-Pete_Sampras-Todd_Martin,1,S-XC,16,1,0,0,1,11,5
19940130-M-Australian_Open-F-Pete_Sampras-Todd_Martin,1,S-DTM,8,1,0,0,1,4,4
19940130-M-Australian_Open-F-Pete_Sampras-Todd_Martin,1,S-DTL,1,0,0,0,0,1,0
19940130-M-Australian_Open-F-Pete_Sampras-Todd_Martin,2,F-XC,21,11,3,3,5,10,11
19940130-M-Australian_Open-F-Pete_Sampras-Todd_Martin,2,F-DTM,16,4,0,0,4,0,16
19940130-M-Australian_Open-F-Pete_Sampras-Todd_Martin,2,F-DTL,9,2,0,0,2,3,6
19940130-M-Australian_Open-F-Pete_Sampras-Todd_Martin,2,F-IO,39,6,2,2,2,19,20
19940130-M-Australian_Open-F-Pete_Sampras-Todd_Martin,2,F-II,3,1,0,0,1,0,3
19940130-M-Australian_Open-F-Pete_Sampras-Todd_Martin,2,B-XC,39,6,4,0,2,16,23
19940130-M-Australian_Open-F-Pete_Sampras-Todd_Martin,2,B-DTM,16,1,0,0,1,7,9
19940130-M-Australian_Open-F-Pete_Sampras-Todd_Martin,2,B-DTL,10,6,3,0,3,6,4
19940130-M-Australian_Open-F-Pete_Sampras-Todd_Martin,2,B-IO,5,4,1,2,1,4,1
19940130-M-Australian_Open-F-Pete_Sampras-Todd_Martin,2,S-XC,12,1,0,0,1,5,7
19940130-M-Australian_Open-F-Pete_Sampras-Todd_Martin,2,S-DTM,1,0,0,0,0,0,1
19940130-M-Australian_Open-F-Pete_Sampras-Todd_Martin,2,S-DTL,8,3,0,2,1,4,4
19890129-M-Australian_Open-F-Ivan_Lendl-Miroslav_Mecir,1,F-XC,37,5,1,1,3,19,18
19890129-M-Australian_Open-F-Ivan_Lendl-Miroslav_Mecir,1,F-DTM,22,1,0,1,0,8,14
19890129-M-Australian_Open-F-Ivan_Lendl-Miroslav_Mecir,1,F-DTL,15,9,3,2,4,9,6
19890129-M-Australian_Open-F-Ivan_Lendl-Miroslav_Mecir,1,F-IO,15,4,1,1,2,5,10
19890129-M-Australian_Open-F-Ivan_Lendl-Miroslav_Mecir,1,F-II,1,0,0,0,0,0,1
19890129-M-Australian_Open-F-Ivan_Lendl-Miroslav_Mecir,1,B-XC,18,2,0,0,2,7,11
19890129-M-Australian_Open-F-Ivan_Lendl-Miroslav_Mecir,1,B-DTM,13,4,0,0,4,2,11
19890129-M-Australian_Open-F-Ivan_Lendl-Miroslav_Mecir,1,B-DTL,7,4,1,0,3,2,5
19890129-M-Australian_Open-F-Ivan_Lendl-Miroslav_Mecir,1,S-XC,58,3,0,1,2,18,40
19890129-M-Australian_Open-F-Ivan_Lendl-Miroslav_Mecir,1,S-DTM,43,4,0,0,4,17,26
19890129-M-Australian_Open-F-Ivan_Lendl-Miroslav_Mecir,1,S-DTL,7,1,1,0,0,3,4
19890129-M-Australian_Open-F-Ivan_Lendl-Miroslav_Mecir,1,S-IO,4,0,0,0,0,1,3
19890129-M-Australian_Open-F-Ivan_Lendl-Miroslav_Mecir,2,F-XC,35,8,3,1,4,16,19
19890129-M-Australian_Open-F-Ivan_Lendl-Miroslav_Mecir,2,F-DTM,22,3,0,0,3,11,11
19890129-M-Australian_Open-F-Ivan_Lendl-Miroslav_Mecir,2,F-DTL,14,3,0,0,3,10,4
19890129-M-Australian_Open-F-Ivan_Lendl-Miroslav_Mecir,2,F-IO,16,2,1,0,1,12,4
19890129-M-Australian_Open-F-Ivan_Lendl-Miroslav_Mecir,2,B-XC,87,3,0,0,3,54,33
19890129-M-Australian_Open-F-Ivan_Lendl-Miroslav_Mecir,2,B-DTM,27,2,1,0,1,18,9
19890129-M-Australian_Open-F-Ivan_Lendl-Miroslav_Mecir,2,B-DTL,12,5,2,2,1,8,4
19890129-M-Australian_Open-F-Ivan_Lendl-Miroslav_Mecir,2,B-IO,11,5,1,0,4,4,7
19890129-M-Australian_Open-F-Ivan_Lendl-Miroslav_Mecir,2,S-XC,6,0,0,0,0,2,4
19890129-M-Australian_Open-F-Ivan_Lendl-Miroslav_Mecir,2,S-DTM,4,0,0,0,0,2,2
19890129-M-Australian_Open-F-Ivan_Lendl-Miroslav_Mecir,2,S-IO,1,1,0,0,1,0,1
20160420-M-Savannah_CH-R16-Tennys_Sandgren-Gerald_Melzer,1,F-XC,67,9,2,0,7,31,36
20160420-M-Savannah_CH-R16-Tennys_Sandgren-Gerald_Melzer,1,F-DTM,12,2,1,0,1,6,6
20160420-M-Savannah_CH-R16-Tennys_Sandgren-Gerald_Melzer,1,F-DTL,7,4,2,0,2,4,3
20160420-M-Savannah_CH-R16-Tennys_Sandgren-Gerald_Melzer,1,F-IO,6,2,1,0,1,3,3
20160420-M-Savannah_CH-R16-Tennys_Sandgren-Gerald_Melzer,1,F-II,7,0,0,0,0,2,5
20160420-M-Savannah_CH-R16-Tennys_Sandgren-Gerald_Melzer,1,B-XC,40,13,4,3,6,18,22
20160420-M-Savannah_CH-R16-Tennys_Sandgren-Gerald_Melzer,1,B-DTM,23,1,0,0,1,11,12
20160420-M-Savannah_CH-R16-Tennys_Sandgren-Gerald_Melzer,1,B-DTL,11,1,0,0,1,3,8
20160420-M-Savannah_CH-R16-Tennys_Sandgren-Gerald_Melzer,1,B-IO,3,0,0,0,0,2,1
20160420-M-Savannah_CH-R16-Tennys_Sandgren-Gerald_Melzer,1,S-XC,1,0,0,0,0,0,1
20160420-M-Savannah_CH-R16-Tennys_Sandgren-Gerald_Melzer,1,S-DTM,2,0,0,0,0,0,2
20160420-M-Savannah_CH-R16-Tennys_Sandgren-Gerald_Melzer,1,S-DTL,4,0,0,0,0,4,0
20160420-M-Savannah_CH-R16-Tennys_Sandgren-Gerald_Melzer,2,F-XC,52,7,4,2,1,32,20
20160420-M-Savannah_CH-R16-Tennys_Sandgren-Gerald_Melzer,2,F-DTM,10,2,0,0,2,3,7
20160420-M-Savannah_CH-R16-Tennys_Sandgren-Gerald_Melzer,2,F-DTL,8,6,3,0,3,5,3
20160420-M-Savannah_CH-R16-Tennys_Sandgren-Gerald_Melzer,2,F-IO,15,3,1,2,0,8,7
20160420-M-Savannah_CH-R16-Tennys_Sandgren-Gerald_Melzer,2,F-II,7,0,0,0,0,4,3
20160420-M-Savannah_CH-R16-Tennys_Sandgren-Gerald_Melzer,2,B-XC,41,5,2,0,3,22,19
20160420-M-Savannah_CH-R16-Tennys_Sandgren-Gerald_Melzer,2,B-DTM,20,1,0,0,1,9,11
20160420-M-Savannah_CH-R16-Tennys_Sandgren-Gerald_Melzer,2,B-DTL,17,3,1,1,1,10,7
20160420-M-Savannah_CH-R16-Tennys_Sandgren-Gerald_Melzer,2,B-IO,2,0,0,0,0,2,0
20160420-M-Savannah_CH-R16-Tennys_Sandgren-Gerald_Melzer,2,S-DTL,6,2,0,1,1,2,4
19950611-M-Roland_Garros-F-Michael_Chang-Thomas_Muster,1,F-XC,87,9,4,1,4,46,41
19950611-M-Roland_Garros-F-Michael_Chang-Thomas_Muster,1,F-DTM,37,2,0,0,2,15,22
19950611-M-Roland_Garros-F-Michael_Chang-Thomas_Muster,1,F-DTL,17,1,0,0,1,6,11
19950611-M-Roland_Garros-F-Michael_Chang-Thomas_Muster,1,F-IO,39,11,3,3,5,19,20
19950611-M-Roland_Garros-F-Michael_Chang-Thomas_Muster,1,F-II,18,5,1,0,4,7,11
19950611-M-Roland_Garros-F-Michael_Chang-Thomas_Muster,1,B-XC,84,12,1,2,9,41,43
19950611-M-Roland_Garros-F-Michael_Chang-Thomas_Muster,1,B-DTM,53,3,0,0,3,19,34
19950611-M-Roland_Garros-F-Michael_Chang-Thomas_Muster,1,B-DTL,24,5,1,0,4,10,14
19950611-M-Roland_Garros-F-Michael_Chang-Thomas_Muster,1,B-IO,9,1,0,0,1,5,4
19950611-M-Roland_Garros-F-Michael_Chang-Thomas_Muster,1,S-XC,1,0,0,0,0,1,0
19950611-M-Roland_Garros-F-Michael_Chang-Thomas_Muster,1,S-DTM,4,0,0,0,0,2,2
19950611-M-Roland_Garros-F-Michael_Chang-Thomas_Muster,1,S-DTL,3,0,0,0,0,0,3
19950611-M-Roland_Garros-F-Michael_Chang-Thomas_Muster,2,F-XC,136,10,2,4,4,86,50
19950611-M-Roland_Garros-F-Michael_Chang-Thomas_Muster,2,F-DTM,42,1,0,0,1,19,23
19950611-M-Roland_Garros-F-Michael_Chang-Thomas_Muster,2,F-DTL,21,6,2,1,3,12,9
19950611-M-Roland_Garros-F-Michael_Chang-Thomas_Muster,2,F-IO,31,10,3,2,5,17,14
19950611-M-Roland_Garros-F-Michael_Chang-Thomas_Muster,2,F-II,10,1,0,0,1,5,5
19950611-M-Roland_Garros-F-Michael_Chang-Thomas_Muster,2,B-XC,37,12,3,3,6,20,17
19950611-M-Roland_Garros-F-Michael_Chang-Thomas_Muster,2,B-DTM,60,3,0,0,3,30,30
19950611-M-Roland_Garros-F-Michael_Chang-Thomas_Muster,2,B-DTL,12,5,2,1,2,9,3
19950611-M-Roland_Garros-F-Michael_Chang-Thomas_Muster,2,B-IO,3,1,0,0,1,1,2
19950611-M-Roland_Garros-F-Michael_Chang-Thomas_Muster,2,S-XC,2,0,0,0,0,2,0
19950611-M-Roland_Garros-F-Michael_Chang-Thomas_Muster,2,S-DTM,8,0,0,0,0,2,6
19950611-M-Roland_Garros-F-Michael_Chang-Thomas_Muster,2,S-DTL,5,2,0,1,1,3,2
19950611-M-Roland_Garros-F-Michael_Chang-Thomas_Muster,2,S-IO,1,0,0,0,0,0,1
20091122-M-Tour_Finals-RR-Andy_Murray-Roger_Federer,1,F-XC,44,9,0,3,6,20,24
20091122-M-Tour_Finals-RR-Andy_Murray-Roger_Federer,1,F-DTM,15,1,0,0,1,5,10
20091122-M-Tour_Finals-RR-Andy_Murray-Roger_Federer,1,F-DTL,16,4,1,2,1,10,6
20091122-M-Tour_Finals-RR-Andy_Murray-Roger_Federer,1,F-IO,29,3,2,0,1,13,16
20091122-M-Tour_Finals-RR-Andy_Murray-Roger_Federer,1,F-II,3,2,0,1,1,2,1
20091122-M-Tour_Finals-RR-Andy_Murray-Roger_Federer,1,B-XC,61,4,2,0,2,25,36
20091122-M-Tour_Finals-RR-Andy_Murray-Roger_Federer,1,B-DTM,13,1,0,0,1,6,7
20091122-M-Tour_Finals-RR-Andy_Murray-Roger_Federer,1,B-DTL,10,4,0,0,4,3,7
20091122-M-Tour_Finals-RR-Andy_Murray-Roger_Federer,1,B-IO,3,3,0,2,1,2,1
20091122-M-Tour_Finals-RR-Andy_Murray-Roger_Federer,1,S-XC,9,0,0,0,0,4,5
20091122-M-Tour_Finals-RR-Andy_Murray-Roger_Federer,1,S-DTM,6,1,0,0,1,0,6
20091122-M-Tour_Finals-RR-Andy_Murray-Roger_Federer,1,S-DTL,3,1,0,0,1,1,2
20091122-M-Tour_Finals-RR-Andy_Murray-Roger_Federer,2,F-XC,36,10,2,3,5,22,14
20091122-M-Tour_Finals-RR-Andy_Murray-Roger_Federer,2,F-DTM,14,2,0,0,2,4,10
20091122-M-Tour_Finals-RR-Andy_Murray-Roger_Federer,2,F-DTL,13,6,0,2,4,8,5
20091122-M-Tour_Finals-RR-Andy_Murray-Roger_Federer,2,F-IO,28,13,7,3,3,17,11
20091122-M-Tour_Finals-RR-Andy_Murray-Roger_Federer,2,F-II,9,3,1,1,1,6,3
20091122-M-Tour_Finals-RR-Andy_Murray-Roger_Federer,2,B-XC,41,5,0,0,5,24,17
20091122-M-Tour_Finals-RR-Andy_Murray-Roger_Federer,2,B-DTM,17,0,0,0,0,8,9
20091122-M-Tour_Finals-RR-Andy_Murray-Roger_Federer,2,B-DTL,13,3,0,2,1,8,5
20091122-M-Tour_Finals-RR-Andy_Murray-Roger_Federer,2,B-IO,2,1,1,0,0,1,1
20091122-M-Tour_Finals-RR-Andy_Murray-Roger_Federer,2,S-XC,26,1,0,0,1,14,12
20091122-M-Tour_Finals-RR-Andy_Murray-Roger_Federer,2,S-DTM,3,1,0,0,1,0,3
20091122-M-Tour_Finals-RR-Andy_Murray-Roger_Federer,2,S-DTL,5,0,0,0,0,3,2
20091122-M-Tour_Finals-RR-Andy_Murray-Roger_Federer,2,S-IO,1,0,0,0,0,0,1
20160421-M-Barcelona-R16-Feliciano_Lopez-Philipp_Kohlschreiber,1,F-XC,68,15,2,3,10,34,34
20160421-M-Barcelona-R16-Feliciano_Lopez-Philipp_Kohlschreiber,1,F-DTM,39,5,0,1,4,11,28
20160421-M-Barcelona-R16-Feliciano_Lopez-Philipp_Kohlschreiber,1,F-DTL,6,4,3,0,1,4,2
20160421-M-Barcelona-R16-Feliciano_Lopez-Philipp_Kohlschreiber,1,F-IO,40,12,5,2,5,23,17
20160421-M-Barcelona-R16-Feliciano_Lopez-Philipp_Kohlschreiber,1,F-II,7,2,1,0,1,4,3
20160421-M-Barcelona-R16-Feliciano_Lopez-Philipp_Kohlschreiber,1,B-XC,39,8,1,0,7,14,25
20160421-M-Barcelona-R16-Feliciano_Lopez-Philipp_Kohlschreiber,1,B-DTM,33,4,0,0,4,12,21
20160421-M-Barcelona-R16-Feliciano_Lopez-Philipp_Kohlschreiber,1,B-DTL,1,0,0,0,0,0,1
20160421-M-Barcelona-R16-Feliciano_Lopez-Philipp_Kohlschreiber,1,B-IO,3,1,0,0,1,2,1
20160421-M-Barcelona-R16-Feliciano_Lopez-Philipp_Kohlschreiber,1,S-XC,14,3,0,0,3,5,9
20160421-M-Barcelona-R16-Feliciano_Lopez-Philipp_Kohlschreiber,1,S-DTM,17,1,0,0,1,8,9
20160421-M-Barcelona-R16-Feliciano_Lopez-Philipp_Kohlschreiber,1,S-DTL,17,4,0,2,2,9,8
20160421-M-Barcelona-R16-Feliciano_Lopez-Philipp_Kohlschreiber,1,S-IO,2,0,0,0,0,1,1
20160421-M-Barcelona-R16-Feliciano_Lopez-Philipp_Kohlschreiber,2,F-XC,84,19,3,7,9,51,33
20160421-M-Barcelona-R16-Feliciano_Lopez-Philipp_Kohlschreiber,2,F-DTM,43,3,1,0,2,23,20
20160421-M-Barcelona-R16-Feliciano_Lopez-Philipp_Kohlschreiber,2,F-DTL,20,10,4,0,6,8,12
20160421-M-Barcelona-R16-Feliciano_Lopez-Philipp_Kohlschreiber,2,F-IO,24,12,7,2,3,16,8
20160421-M-Barcelona-R16-Feliciano_Lopez-Philipp_Kohlschreiber,2,F-II,6,0,0,0,0,0,6
20160421-M-Barcelona-R16-Feliciano_Lopez-Philipp_Kohlschreiber,2,B-XC,36,10,6,1,3,19,17
20160421-M-Barcelona-R16-Feliciano_Lopez-Philipp_Kohlschreiber,2,B-DTM,27,3,0,0,3,14,13
20160421-M-Barcelona-R16-Feliciano_Lopez-Philipp_Kohlschreiber,2,B-DTL,17,5,1,0,4,12,5
20160421-M-Barcelona-R16-Feliciano_Lopez-Philipp_Kohlschreiber,2,B-IO,4,1,0,1,0,4,0
20160421-M-Barcelona-R16-Feliciano_Lopez-Philipp_Kohlschreiber,2,S-XC,8,0,0,0,0,3,5
20160421-M-Barcelona-R16-Feliciano_Lopez-Philipp_Kohlschreiber,2,S-DTM,9,1,0,0,1,1,8
20160421-M-Barcelona-R16-Feliciano_Lopez-Philipp_Kohlschreiber,2,S-DTL,5,3,0,0,3,2,3
20160421-M-Barcelona-R16-Feliciano_Lopez-Philipp_Kohlschreiber,2,S-IO,5,0,0,0,0,3,2
20120802-M-Olympics-QF-John_Isner-Roger_Federer,1,F-XC,15,9,2,4,3,11,4
20120802-M-Olympics-QF-John_Isner-Roger_Federer,1,F-DTM,7,3,0,0,3,1,6
20120802-M-Olympics-QF-John_Isner-Roger_Federer,1,F-DTL,11,3,1,0,2,3,8
20120802-M-Olympics-QF-John_Isner-Roger_Federer,1,F-IO,20,8,1,2,5,9,11
20120802-M-Olympics-QF-John_Isner-Roger_Federer,1,F-II,4,1,0,0,1,1,3
20120802-M-Olympics-QF-John_Isner-Roger_Federer,1,B-XC,9,4,0,1,3,3,6
20120802-M-Olympics-QF-John_Isner-Roger_Federer,1,B-DTM,11,2,0,0,2,2,9
20120802-M-Olympics-QF-John_Isner-Roger_Federer,1,B-DTL,3,1,0,1,0,2,1
20120802-M-Olympics-QF-John_Isner-Roger_Federer,1,B-IO,1,0,0,0,0,0,1
20120802-M-Olympics-QF-John_Isner-Roger_Federer,1,S-XC,5,1,0,0,1,1,4
20120802-M-Olympics-QF-John_Isner-Roger_Federer,1,S-DTM,2,0,0,0,0,0,2
20120802-M-Olympics-QF-John_Isner-Roger_Federer,2,F-XC,16,5,4,1,0,13,3
20120802-M-Olympics-QF-John_Isner-Roger_Federer,2,F-DTM,16,3,0,0,3,9,7
20120802-M-Olympics-QF-John_Isner-Roger_Federer,2,F-DTL,5,1,0,0,1,1,4
20120802-M-Olympics-QF-John_Isner-Roger_Federer,2,F-IO,21,8,3,1,4,14,7
20120802-M-Olympics-QF-John_Isner-Roger_Federer,2,F-II,2,2,1,0,1,1,1
20120802-M-Olympics-QF-John_Isner-Roger_Federer,2,B-XC,5,1,1,0,0,3,2
20120802-M-Olympics-QF-John_Isner-Roger_Federer,2,B-DTM,10,1,0,0,1,3,7
20120802-M-Olympics-QF-John_Isner-Roger_Federer,2,B-DTL,7,5,3,2,0,5,2
20120802-M-Olympics-QF-John_Isner-Roger_Federer,2,B-IO,1,0,0,0,0,1,0
20120802-M-Olympics-QF-John_Isner-Roger_Federer,2,S-XC,5,0,0,0,0,4,1
20120802-M-Olympics-QF-John_Isner-Roger_Federer,2,S-DTM,1,0,0,0,0,1,0
20120802-M-Olympics-QF-John_Isner-Roger_Federer,2,S-DTL,1,0,0,0,0,1,0
20160425-M-Bucharest-F-Fernando_Verdasco-Lucas_Pouille,1,F-XC,58,3,0,1,2,38,20
20160425-M-Bucharest-F-Fernando_Verdasco-Lucas_Pouille,1,F-DTM,21,3,0,1,2,8,13
20160425-M-Bucharest-F-Fernando_Verdasco-Lucas_Pouille,1,F-DTL,12,9,6,2,1,9,3
20160425-M-Bucharest-F-Fernando_Verdasco-Lucas_Pouille,1,F-IO,26,10,8,1,1,19,7
20160425-M-Bucharest-F-Fernando_Verdasco-Lucas_Pouille,1,F-II,2,1,1,0,0,2,0
20160425-M-Bucharest-F-Fernando_Verdasco-Lucas_Pouille,1,B-XC,24,6,1,1,4,9,15
20160425-M-Bucharest-F-Fernando_Verdasco-Lucas_Pouille,1,B-DTM,15,0,0,0,0,7,8
20160425-M-Bucharest-F-Fernando_Verdasco-Lucas_Pouille,1,B-DTL,13,5,0,2,3,7,6
20160425-M-Bucharest-F-Fernando_Verdasco-Lucas_Pouille,1,B-IO,5,0,0,0,0,4,1
20160425-M-Bucharest-F-Fernando_Verdasco-Lucas_Pouille,1,B-II,1,0,0,0,0,1,0
20160425-M-Bucharest-F-Fernando_Verdasco-Lucas_Pouille,1,S-XC,3,1,0,0,1,1,2
20160425-M-Bucharest-F-Fernando_Verdasco-Lucas_Pouille,1,S-DTM,1,0,0,0,0,1,0
20160425-M-Bucharest-F-Fernando_Verdasco-Lucas_Pouille,1,S-DTL,4,0,0,0,0,3,1
20160425-M-Bucharest-F-Fernando_Verdasco-Lucas_Pouille,2,F-XC,39,9,5,1,3,20,19
20160425-M-Bucharest-F-Fernando_Verdasco-Lucas_Pouille,2,F-DTM,25,5,0,0,5,8,17
20160425-M-Bucharest-F-Fernando_Verdasco-Lucas_Pouille,2,F-DTL,8,4,3,0,1,5,3
20160425-M-Bucharest-F-Fernando_Verdasco-Lucas_Pouille,2,F-IO,9,5,1,2,2,4,5
20160425-M-Bucharest-F-Fernando_Verdasco-Lucas_Pouille,2,F-II,2,0,0,0,0,0,2
20160425-M-Bucharest-F-Fernando_Verdasco-Lucas_Pouille,2,B-XC,31,6,2,3,1,15,16
20160425-M-Bucharest-F-Fernando_Verdasco-Lucas_Pouille,2,B-DTM,32,4,0,0,4,9,23
20160425-M-Bucharest-F-Fernando_Verdasco-Lucas_Pouille,2,B-DTL,8,2,1,0,1,3,5
20160425-M-Bucharest-F-Fernando_Verdasco-Lucas_Pouille,2,B-IO,4,0,0,0,0,1,3
20160425-M-Bucharest-F-Fernando_Verdasco-Lucas_Pouille,2,S-XC,1,0,0,0,0,0,1
20160425-M-Bucharest-F-Fernando_Verdasco-Lucas_Pouille,2,S-DTM,6,0,0,0,0,3,3
20160425-M-Bucharest-F-Fernando_Verdasco-Lucas_Pouille,2,S-DTL,1,0,0,0,0,1,0
20160425-M-Bucharest-F-Fernando_Verdasco-Lucas_Pouille,2,S-IO,1,0,0,0,0,1,0
19970126-M-Australian_Open-F-Pete_Sampras-Carlos_Moya,1,F-XC,36,11,1,5,5,22,14
19970126-M-Australian_Open-F-Pete_Sampras-Carlos_Moya,1,F-DTM,9,1,0,0,1,6,3
19970126-M-Australian_Open-F-Pete_Sampras-Carlos_Moya,1,F-DTL,6,5,2,1,2,4,2
19970126-M-Australian_Open-F-Pete_Sampras-Carlos_Moya,1,F-IO,14,5,3,0,2,11,3
19970126-M-Australian_Open-F-Pete_Sampras-Carlos_Moya,1,F-II,5,2,0,2,0,4,1
19970126-M-Australian_Open-F-Pete_Sampras-Carlos_Moya,1,B-XC,29,4,1,2,1,24,5
19970126-M-Australian_Open-F-Pete_Sampras-Carlos_Moya,1,B-DTM,9,2,0,0,2,3,6
19970126-M-Australian_Open-F-Pete_Sampras-Carlos_Moya,1,B-DTL,9,2,0,0,2,3,6
19970126-M-Australian_Open-F-Pete_Sampras-Carlos_Moya,1,B-IO,5,1,0,1,0,4,1
19970126-M-Australian_Open-F-Pete_Sampras-Carlos_Moya,1,S-XC,13,0,0,0,0,8,5
19970126-M-Australian_Open-F-Pete_Sampras-Carlos_Moya,1,S-DTM,4,0,0,0,0,4,0
19970126-M-Australian_Open-F-Pete_Sampras-Carlos_Moya,1,S-DTL,1,0,0,0,0,1,0
19970126-M-Australian_Open-F-Pete_Sampras-Carlos_Moya,2,F-XC,19,4,1,1,2,9,10
19970126-M-Australian_Open-F-Pete_Sampras-Carlos_Moya,2,F-DTM,21,3,1,1,1,8,13
19970126-M-Australian_Open-F-Pete_Sampras-Carlos_Moya,2,F-DTL,17,3,0,1,2,5,12
19970126-M-Australian_Open-F-Pete_Sampras-Carlos_Moya,2,F-IO,31,6,2,1,3,13,18
19970126-M-Australian_Open-F-Pete_Sampras-Carlos_Moya,2,F-II,3,1,0,0,1,1,2
19970126-M-Australian_Open-F-Pete_Sampras-Carlos_Moya,2,B-XC,25,3,0,0,3,7,18
19970126-M-Australian_Open-F-Pete_Sampras-Carlos_Moya,2,B-DTM,13,3,0,0,3,1,12
19970126-M-Australian_Open-F-Pete_Sampras-Carlos_Moya,2,B-DTL,7,2,1,0,1,4,3
19970126-M-Australian_Open-F-Pete_Sampras-Carlos_Moya,2,B-IO,1,1,1,0,0,1,0
19970126-M-Australian_Open-F-Pete_Sampras-Carlos_Moya,2,S-XC,2,0,0,0,0,0,2
19970126-M-Australian_Open-F-Pete_Sampras-Carlos_Moya,2,S-DTM,10,0,0,0,0,0,10
19970126-M-Australian_Open-F-Pete_Sampras-Carlos_Moya,2,S-DTL,4,2,1,1,0,2,2
19851208-M-Australian_Open-F-Stefan_Edberg-Mats_Wilander,1,F-XC,11,5,2,0,3,4,7
19851208-M-Australian_Open-F-Stefan_Edberg-Mats_Wilander,1,F-DTM,4,2,0,0,2,1,3
19851208-M-Australian_Open-F-Stefan_Edberg-Mats_Wilander,1,F-DTL,2,1,1,0,0,1,1
19851208-M-Australian_Open-F-Stefan_Edberg-Mats_Wilander,1,F-IO,2,1,1,0,0,2,0
19851208-M-Australian_Open-F-Stefan_Edberg-Mats_Wilander,1,F-II,1,0,0,0,0,1,0
19851208-M-Australian_Open-F-Stefan_Edberg-Mats_Wilander,1,B-XC,13,8,5,2,1,11,2
19851208-M-Australian_Open-F-Stefan_Edberg-Mats_Wilander,1,B-DTM,10,1,0,0,1,4,6
19851208-M-Australian_Open-F-Stefan_Edberg-Mats_Wilander,1,B-DTL,5,4,2,1,1,4,1
19851208-M-Australian_Open-F-Stefan_Edberg-Mats_Wilander,1,B-IO,1,1,1,0,0,1,0
19851208-M-Australian_Open-F-Stefan_Edberg-Mats_Wilander,1,S-XC,2,0,0,0,0,1,1
19851208-M-Australian_Open-F-Stefan_Edberg-Mats_Wilander,1,S-DTM,5,0,0,0,0,3,2
19851208-M-Australian_Open-F-Stefan_Edberg-Mats_Wilander,1,S-DTL,2,0,0,0,0,1,1
19851208-M-Australian_Open-F-Stefan_Edberg-Mats_Wilander,1,S-IO,1,0,0,0,0,1,0
19851208-M-Australian_Open-F-Stefan_Edberg-Mats_Wilander,2,F-XC,13,4,2,1,1,8,5
19851208-M-Australian_Open-F-Stefan_Edberg-Mats_Wilander,2,F-DTM,12,1,0,0,1,5,7
19851208-M-Australian_Open-F-Stefan_Edberg-Mats_Wilander,2,F-DTL,8,6,2,1,3,3,5
19851208-M-Australian_Open-F-Stefan_Edberg-Mats_Wilander,2,F-IO,5,0,0,0,0,3,2
19851208-M-Australian_Open-F-Stefan_Edberg-Mats_Wilander,2,F-II,1,1,0,0,1,0,1
19851208-M-Australian_Open-F-Stefan_Edberg-Mats_Wilander,2,B-XC,12,3,2,0,1,6,6
19851208-M-Australian_Open-F-Stefan_Edberg-Mats_Wilander,2,B-DTM,8,3,0,0,3,3,5
19851208-M-Australian_Open-F-Stefan_Edberg-Mats_Wilander,2,B-DTL,5,3,2,0,1,3,2
19851208-M-Australian_Open-F-Stefan_Edberg-Mats_Wilander,2,B-IO,1,1,1,0,0,1,0
19851208-M-Australian_Open-F-Stefan_Edberg-Mats_Wilander,2,S-XC,6,1,0,1,0,2,4
19851208-M-Australian_Open-F-Stefan_Edberg-Mats_Wilander,2,S-DTM,6,0,0,0,0,0,6
19851208-M-Australian_Open-F-Stefan_Edberg-Mats_Wilander,2,S-DTL,4,0,0,0,0,1,3
19851208-M-Australian_Open-F-Stefan_Edberg-Mats_Wilander,2,S-IO,3,0,0,0,0,2,1
19830703-M-Wimbledon-F-Chris_Lewis-John_Mcenroe,1,F-XC,7,3,2,1,0,4,3
19830703-M-Wimbledon-F-Chris_Lewis-John_Mcenroe,1,F-DTM,4,2,0,1,1,2,2
19830703-M-Wimbledon-F-Chris_Lewis-John_Mcenroe,1,B-XC,1,1,0,0,1,0,1
19830703-M-Wimbledon-F-Chris_Lewis-John_Mcenroe,1,B-DTM,2,0,0,0,0,0,2
19830703-M-Wimbledon-F-Chris_Lewis-John_Mcenroe,1,B-DTL,3,1,0,1,0,2,1
19830703-M-Wimbledon-F-Chris_Lewis-John_Mcenroe,1,S-DTM,2,0,0,0,0,1,1
19830703-M-Wimbledon-F-Chris_Lewis-John_Mcenroe,2,F-XC,8,6,6,0,0,8,0
19830703-M-Wimbledon-F-Chris_Lewis-John_Mcenroe,2,F-DTM,2,1,0,1,0,1,1
19830703-M-Wimbledon-F-Chris_Lewis-John_Mcenroe,2,F-DTL,5,3,2,1,0,4,1
19830703-M-Wimbledon-F-Chris_Lewis-John_Mcenroe,2,F-IO,1,0,0,0,0,1,0
19830703-M-Wimbledon-F-Chris_Lewis-John_Mcenroe,2,F-II,1,1,1,0,0,1,0
19830703-M-Wimbledon-F-Chris_Lewis-John_Mcenroe,2,B-XC,4,2,2,0,0,3,1
19830703-M-Wimbledon-F-Chris_Lewis-John_Mcenroe,2,B-DTM,3,1,0,0,1,2,1
19830703-M-Wimbledon-F-Chris_Lewis-John_Mcenroe,2,B-DTL,5,4,1,1,2,3,2
19830703-M-Wimbledon-F-Chris_Lewis-John_Mcenroe,2,B-IO,1,1,1,0,0,1,0
19830703-M-Wimbledon-F-Chris_Lewis-John_Mcenroe,2,S-XC,2,2,2,0,0,2,0
19830703-M-Wimbledon-F-Chris_Lewis-John_Mcenroe,2,S-DTM,1,0,0,0,0,0,1
19830703-M-Wimbledon-F-Chris_Lewis-John_Mcenroe,2,S-IO,1,1,1,0,0,1,0
19880605-M-Roland_Garros-F-Mats_Wilander-Henri_Leconte,1,F-XC,78,6,3,1,2,58,20
19880605-M-Roland_Garros-F-Mats_Wilander-Henri_Leconte,1,F-DTM,22,0,0,0,0,13,9
19880605-M-Roland_Garros-F-Mats_Wilander-Henri_Leconte,1,F-DTL,13,6,3,2,1,9,4
19880605-M-Roland_Garros-F-Mats_Wilander-Henri_Leconte,1,F-IO,3,2,1,0,1,2,1
19880605-M-Roland_Garros-F-Mats_Wilander-Henri_Leconte,1,F-II,2,0,0,0,0,1,1
19880605-M-Roland_Garros-F-Mats_Wilander-Henri_Leconte,1,B-XC,22,10,7,3,0,16,6
19880605-M-Roland_Garros-F-Mats_Wilander-Henri_Leconte,1,B-DTM,31,0,0,0,0,18,13
19880605-M-Roland_Garros-F-Mats_Wilander-Henri_Leconte,1,B-DTL,31,4,1,1,2,19,12
19880605-M-Roland_Garros-F-Mats_Wilander-Henri_Leconte,1,B-IO,19,4,2,2,0,15,4
19880605-M-Roland_Garros-F-Mats_Wilander-Henri_Leconte,1,S-XC,5,2,2,0,0,3,2
19880605-M-Roland_Garros-F-Mats_Wilander-Henri_Leconte,1,S-DTM,7,0,0,0,0,4,3
19880605-M-Roland_Garros-F-Mats_Wilander-Henri_Leconte,1,S-DTL,13,2,1,1,0,7,6
19880605-M-Roland_Garros-F-Mats_Wilander-Henri_Leconte,1,S-IO,1,1,0,1,0,1,0
19880605-M-Roland_Garros-F-Mats_Wilander-Henri_Leconte,2,F-XC,34,6,2,1,3,18,16
19880605-M-Roland_Garros-F-Mats_Wilander-Henri_Leconte,2,F-DTM,3,0,0,0,0,2,1
19880605-M-Roland_Garros-F-Mats_Wilander-Henri_Leconte,2,F-IO,7,3,1,1,1,4,3
19880605-M-Roland_Garros-F-Mats_Wilander-Henri_Leconte,2,F-II,2,2,0,0,2,0,2
19880605-M-Roland_Garros-F-Mats_Wilander-Henri_Leconte,2,B-XC,53,14,1,4,9,18,35
19880605-M-Roland_Garros-F-Mats_Wilander-Henri_Leconte,2,B-DTM,11,0,0,0,0,4,7
19880605-M-Roland_Garros-F-Mats_Wilander-Henri_Leconte,2,B-DTL,10,5,3,1,1,6,4
19880605-M-Roland_Garros-F-Mats_Wilander-Henri_Leconte,2,B-IO,3,2,1,0,1,1,2
19880605-M-Roland_Garros-F-Mats_Wilander-Henri_Leconte,2,S-XC,24,2,0,0,2,7,17
19880605-M-Roland_Garros-F-Mats_Wilander-Henri_Leconte,2,S-DTM,28,4,0,0,4,7,21
19880605-M-Roland_Garros-F-Mats_Wilander-Henri_Leconte,2,S-DTL,36,6,0,0,6,7,29
19880605-M-Roland_Garros-F-Mats_Wilander-Henri_Leconte,2,S-IO,12,4,0,0,4,3,9
20101015-M-Shanghai_Masters-SF-Novak_Djokovic-Roger_Federer,1,F-XC,44,11,1,5,5,15,29
20101015-M-Shanghai_Masters-SF-Novak_Djokovic-Roger_Federer,1,F-DTM,12,2,0,1,1,2,10
20101015-M-Shanghai_Masters-SF-Novak_Djokovic-Roger_Federer,1,F-DTL,7,0,0,0,0,5,2
20101015-M-Shanghai_Masters-SF-Novak_Djokovic-Roger_Federer,1,F-IO,26,5,1,2,2,13,13
20101015-M-Shanghai_Masters-SF-Novak_Djokovic-Roger_Federer,1,F-II,6,3,0,1,2,2,4
20101015-M-Shanghai_Masters-SF-Novak_Djokovic-Roger_Federer,1,B-XC,61,11,1,5,5,29,32
20101015-M-Shanghai_Masters-SF-Novak_Djokovic-Roger_Federer,1,B-DTM,17,2,0,0,2,2,15
20101015-M-Shanghai_Masters-SF-Novak_Djokovic-Roger_Federer,1,B-DTL,19,10,4,0,6,7,12
20101015-M-Shanghai_Masters-SF-Novak_Djokovic-Roger_Federer,1,B-IO,5,2,0,2,0,4,1
20101015-M-Shanghai_Masters-SF-Novak_Djokovic-Roger_Federer,1,S-DTM,4,0,0,0,0,1,3
20101015-M-Shanghai_Masters-SF-Novak_Djokovic-Roger_Federer,1,S-DTL,2,1,0,0,1,0,2
20101015-M-Shanghai_Masters-SF-Novak_Djokovic-Roger_Federer,2,F-XC,35,8,4,2,2,27,8
20101015-M-Shanghai_Masters-SF-Novak_Djokovic-Roger_Federer,2,F-DTM,17,2,0,0,2,10,7
20101015-M-Shanghai_Masters-SF-Novak_Djokovic-Roger_Federer,2,F-DTL,17,6,4,0,2,12,5
20101015-M-Shanghai_Masters-SF-Novak_Djokovic-Roger_Federer,2,F-IO,31,8,4,2,2,25,6
20101015-M-Shanghai_Masters-SF-Novak_Djokovic-Roger_Federer,2,F-II,6,2,0,1,1,4,2
20101015-M-Shanghai_Masters-SF-Novak_Djokovic-Roger_Federer,2,B-XC,38,5,1,1,3,24,14
20101015-M-Shanghai_Masters-SF-Novak_Djokovic-Roger_Federer,2,B-DTM,17,2,0,0,2,9,8
20101015-M-Shanghai_Masters-SF-Novak_Djokovic-Roger_Federer,2,B-DTL,12,6,1,2,3,8,4
20101015-M-Shanghai_Masters-SF-Novak_Djokovic-Roger_Federer,2,S-XC,15,0,0,0,0,8,7
20101015-M-Shanghai_Masters-SF-Novak_Djokovic-Roger_Federer,2,S-DTM,5,0,0,0,0,1,4
20101015-M-Shanghai_Masters-SF-Novak_Djokovic-Roger_Federer,2,S-DTL,3,0,0,0,0,1,2
20160427-M-Istanbul-R32-Teymuraz_Gabashvili-Damir_Dzumhur,1,F-XC,40,13,5,5,3,25,15
20160427-M-Istanbul-R32-Teymuraz_Gabashvili-Damir_Dzumhur,1,F-DTM,28,2,0,0,2,11,17
20160427-M-Istanbul-R32-Teymuraz_Gabashvili-Damir_Dzumhur,1,F-DTL,2,0,0,0,0,2,0
20160427-M-Istanbul-R32-Teymuraz_Gabashvili-Damir_Dzumhur,1,F-IO,31,10,2,3,5,16,15
20160427-M-Istanbul-R32-Teymuraz_Gabashvili-Damir_Dzumhur,1,F-II,7,3,1,1,1,4,3
20160427-M-Istanbul-R32-Teymuraz_Gabashvili-Damir_Dzumhur,1,B-XC,59,9,3,1,5,32,27
20160427-M-Istanbul-R32-Teymuraz_Gabashvili-Damir_Dzumhur,1,B-DTM,18,3,0,0,3,6,12
20160427-M-Istanbul-R32-Teymuraz_Gabashvili-Damir_Dzumhur,1,B-DTL,4,2,0,0,2,0,4
20160427-M-Istanbul-R32-Teymuraz_Gabashvili-Damir_Dzumhur,1,B-IO,6,3,0,2,1,3,3
20160427-M-Istanbul-R32-Teymuraz_Gabashvili-Damir_Dzumhur,1,S-XC,6,2,0,0,2,0,6
20160427-M-Istanbul-R32-Teymuraz_Gabashvili-Damir_Dzumhur,1,S-DTM,1,0,0,0,0,0,1
20160427-M-Istanbul-R32-Teymuraz_Gabashvili-Damir_Dzumhur,1,S-DTL,3,1,0,0,1,1,2
20160427-M-Istanbul-R32-Teymuraz_Gabashvili-Damir_Dzumhur,2,F-XC,6,1,0,0,1,3,3
20160427-M-Istanbul-R32-Teymuraz_Gabashvili-Damir_Dzumhur,2,F-DTM,19,0,0,0,0,6,13
20160427-M-Istanbul-R32-Teymuraz_Gabashvili-Damir_Dzumhur,2,F-DTL,14,5,2,1,2,11,3
20160427-M-Istanbul-R32-Teymuraz_Gabashvili-Damir_Dzumhur,2,F-IO,12,1,0,1,0,11,1
20160427-M-Istanbul-R32-Teymuraz_Gabashvili-Damir_Dzumhur,2,F-II,1,0,0,0,0,1,0
20160427-M-Istanbul-R32-Teymuraz_Gabashvili-Damir_Dzumhur,2,B-XC,36,3,0,0,3,18,18
20160427-M-Istanbul-R32-Teymuraz_Gabashvili-Damir_Dzumhur,2,B-DTM,27,0,0,0,0,10,17
20160427-M-Istanbul-R32-Teymuraz_Gabashvili-Damir_Dzumhur,2,B-DTL,14,9,4,2,3,8,6
20160427-M-Istanbul-R32-Teymuraz_Gabashvili-Damir_Dzumhur,2,B-IO,6,2,1,0,1,3,3
20160427-M-Istanbul-R32-Teymuraz_Gabashvili-Damir_Dzumhur,2,S-XC,14,1,0,0,1,5,9
20160427-M-Istanbul-R32-Teymuraz_Gabashvili-Damir_Dzumhur,2,S-DTM,11,0,0,0,0,5,6
20160427-M-Istanbul-R32-Teymuraz_Gabashvili-Damir_Dzumhur,2,S-DTL,3,1,0,1,0,3,0
20160427-M-Istanbul-R32-Teymuraz_Gabashvili-Damir_Dzumhur,2,S-IO,1,0,0,0,0,1,0
20101121-M-Tour_Finals-RR-Novak_Djokovic-Andy_Roddick,1,F-XC,25,4,2,2,0,18,7
20101121-M-Tour_Finals-RR-Novak_Djokovic-Andy_Roddick,1,F-DTM,23,1,0,0,1,11,12
20101121-M-Tour_Finals-RR-Novak_Djokovic-Andy_Roddick,1,F-DTL,14,4,2,1,1,9,5
20101121-M-Tour_Finals-RR-Novak_Djokovic-Andy_Roddick,1,F-IO,14,5,3,0,2,8,6
20101121-M-Tour_Finals-RR-Novak_Djokovic-Andy_Roddick,1,F-II,5,1,0,1,0,3,2
20101121-M-Tour_Finals-RR-Novak_Djokovic-Andy_Roddick,1,B-XC,26,3,0,1,2,15,11
20101121-M-Tour_Finals-RR-Novak_Djokovic-Andy_Roddick,1,B-DTM,13,0,0,0,0,4,9
20101121-M-Tour_Finals-RR-Novak_Djokovic-Andy_Roddick,1,B-DTL,10,4,1,1,2,4,6
20101121-M-Tour_Finals-RR-Novak_Djokovic-Andy_Roddick,1,B-IO,3,1,0,0,1,1,2
20101121-M-Tour_Finals-RR-Novak_Djokovic-Andy_Roddick,1,S-XC,7,1,0,0,1,1,6
20101121-M-Tour_Finals-RR-Novak_Djokovic-Andy_Roddick,1,S-DTM,3,0,0,0,0,2,1
20101121-M-Tour_Finals-RR-Novak_Djokovic-Andy_Roddick,1,S-DTL,9,0,0,0,0,6,3
20101121-M-Tour_Finals-RR-Novak_Djokovic-Andy_Roddick,2,F-XC,43,6,2,1,3,17,26
20101121-M-Tour_Finals-RR-Novak_Djokovic-Andy_Roddick,2,F-DTM,11,0,0,0,0,5,6
20101121-M-Tour_Finals-RR-Novak_Djokovic-Andy_Roddick,2,F-DTL,13,3,0,1,2,6,7
20101121-M-Tour_Finals-RR-Novak_Djokovic-Andy_Roddick,2,F-IO,14,1,0,0,1,9,5
20101121-M-Tour_Finals-RR-Novak_Djokovic-Andy_Roddick,2,F-II,4,2,0,0,2,2,2
20101121-M-Tour_Finals-RR-Novak_Djokovic-Andy_Roddick,2,B-XC,30,4,0,1,3,17,13
20101121-M-Tour_Finals-RR-Novak_Djokovic-Andy_Roddick,2,B-DTM,9,0,0,0,0,4,5
20101121-M-Tour_Finals-RR-Novak_Djokovic-Andy_Roddick,2,B-DTL,2,0,0,0,0,1,1
20101121-M-Tour_Finals-RR-Novak_Djokovic-Andy_Roddick,2,S-XC,16,2,0,0,2,4,12
20101121-M-Tour_Finals-RR-Novak_Djokovic-Andy_Roddick,2,S-DTM,2,0,0,0,0,1,1
20101121-M-Tour_Finals-RR-Novak_Djokovic-Andy_Roddick,2,S-DTL,3,0,0,0,0,2,1
20091122-M-Tour_Finals-RR-Robin_Soderling-Nikolay_Davydenko,1,F-XC,67,15,4,3,8,26,41
20091122-M-Tour_Finals-RR-Robin_Soderling-Nikolay_Davydenko,1,F-DTM,30,5,0,1,4,7,23
20091122-M-Tour_Finals-RR-Robin_Soderling-Nikolay_Davydenko,1,F-DTL,28,4,2,1,1,10,18
20091122-M-Tour_Finals-RR-Robin_Soderling-Nikolay_Davydenko,1,F-IO,29,8,0,1,7,11,18
20091122-M-Tour_Finals-RR-Robin_Soderling-Nikolay_Davydenko,1,F-II,10,4,1,3,0,6,4
20091122-M-Tour_Finals-RR-Robin_Soderling-Nikolay_Davydenko,1,B-XC,44,9,1,3,5,20,24
20091122-M-Tour_Finals-RR-Robin_Soderling-Nikolay_Davydenko,1,B-DTM,23,3,0,0,3,5,18
20091122-M-Tour_Finals-RR-Robin_Soderling-Nikolay_Davydenko,1,B-DTL,16,6,2,1,3,9,7
20091122-M-Tour_Finals-RR-Robin_Soderling-Nikolay_Davydenko,1,B-IO,6,2,0,0,2,2,4
20091122-M-Tour_Finals-RR-Robin_Soderling-Nikolay_Davydenko,1,S-XC,4,0,0,0,0,1,3
20091122-M-Tour_Finals-RR-Robin_Soderling-Nikolay_Davydenko,1,S-DTM,2,0,0,0,0,1,1
20091122-M-Tour_Finals-RR-Robin_Soderling-Nikolay_Davydenko,2,F-XC,70,9,4,1,4,46,24
20091122-M-Tour_Finals-RR-Robin_Soderling-Nikolay_Davydenko,2,F-DTM,26,1,0,0,1,18,8
20091122-M-Tour_Finals-RR-Robin_Soderling-Nikolay_Davydenko,2,F-DTL,19,5,1,2,2,12,7
20091122-M-Tour_Finals-RR-Robin_Soderling-Nikolay_Davydenko,2,F-IO,19,6,1,3,2,13,6
20091122-M-Tour_Finals-RR-Robin_Soderling-Nikolay_Davydenko,2,F-II,2,1,0,1,0,2,0
20091122-M-Tour_Finals-RR-Robin_Soderling-Nikolay_Davydenko,2,B-XC,53,9,3,2,4,28,25
20091122-M-Tour_Finals-RR-Robin_Soderling-Nikolay_Davydenko,2,B-DTM,34,1,0,0,1,26,8
20091122-M-Tour_Finals-RR-Robin_Soderling-Nikolay_Davydenko,2,B-DTL,10,3,0,0,3,3,7
20091122-M-Tour_Finals-RR-Robin_Soderling-Nikolay_Davydenko,2,B-IO,2,1,1,0,0,2,0
20091122-M-Tour_Finals-RR-Robin_Soderling-Nikolay_Davydenko,2,S-XC,6,0,0,0,0,4,2
20091122-M-Tour_Finals-RR-Robin_Soderling-Nikolay_Davydenko,2,S-DTM,6,0,0,0,0,5,1
20091122-M-Tour_Finals-RR-Robin_Soderling-Nikolay_Davydenko,2,S-DTL,1,0,0,0,0,1,0
20010508-M-Rome_Masters-R32-Roger_Federer-Marat_Safin,1,F-XC,63,15,2,1,12,29,34
20010508-M-Rome_Masters-R32-Roger_Federer-Marat_Safin,1,F-DTM,10,1,0,0,1,4,6
20010508-M-Rome_Masters-R32-Roger_Federer-Marat_Safin,1,F-DTL,40,17,5,1,11,18,22
20010508-M-Rome_Masters-R32-Roger_Federer-Marat_Safin,1,F-IO,35,10,4,2,4,22,13
20010508-M-Rome_Masters-R32-Roger_Federer-Marat_Safin,1,F-II,21,11,4,1,6,11,10
20010508-M-Rome_Masters-R32-Roger_Federer-Marat_Safin,1,B-XC,78,8,1,0,7,37,41
20010508-M-Rome_Masters-R32-Roger_Federer-Marat_Safin,1,B-DTM,22,3,0,0,3,11,11
20010508-M-Rome_Masters-R32-Roger_Federer-Marat_Safin,1,B-DTL,33,14,3,1,10,11,22
20010508-M-Rome_Masters-R32-Roger_Federer-Marat_Safin,1,B-IO,5,2,0,1,1,4,1
20010508-M-Rome_Masters-R32-Roger_Federer-Marat_Safin,1,S-XC,41,1,0,0,1,22,19
20010508-M-Rome_Masters-R32-Roger_Federer-Marat_Safin,1,S-DTM,4,0,0,0,0,1,3
20010508-M-Rome_Masters-R32-Roger_Federer-Marat_Safin,1,S-DTL,10,1,1,0,0,6,4
20010508-M-Rome_Masters-R32-Roger_Federer-Marat_Safin,1,S-IO,1,0,0,0,0,1,0
20010508-M-Rome_Masters-R32-Roger_Federer-Marat_Safin,2,F-XC,61,8,4,0,4,36,25
20010508-M-Rome_Masters-R32-Roger_Federer-Marat_Safin,2,F-DTM,28,4,0,1,3,17,11
20010508-M-Rome_Masters-R32-Roger_Federer-Marat_Safin,2,F-DTL,43,14,3,1,10,20,23
20010508-M-Rome_Masters-R32-Roger_Federer-Marat_Safin,2,F-IO,19,2,1,1,0,8,11
20010508-M-Rome_Masters-R32-Roger_Federer-Marat_Safin,2,F-II,8,1,1,0,0,6,2
20010508-M-Rome_Masters-R32-Roger_Federer-Marat_Safin,2,B-XC,124,16,2,4,10,63,61
20010508-M-Rome_Masters-R32-Roger_Federer-Marat_Safin,2,B-DTM,15,4,0,0,4,5,10
20010508-M-Rome_Masters-R32-Roger_Federer-Marat_Safin,2,B-DTL,20,5,2,0,3,10,10
20010508-M-Rome_Masters-R32-Roger_Federer-Marat_Safin,2,B-IO,1,0,0,0,0,0,1
20010508-M-Rome_Masters-R32-Roger_Federer-Marat_Safin,2,S-XC,25,3,1,0,2,10,15
20010508-M-Rome_Masters-R32-Roger_Federer-Marat_Safin,2,S-DTM,2,0,0,0,0,1,1
20010508-M-Rome_Masters-R32-Roger_Federer-Marat_Safin,2,S-DTL,5,3,1,0,2,2,3
19870914-M-US_Open-F-Ivan_Lendl-Mats_Wilander,1,F-XC,108,28,11,6,11,65,43
19870914-M-US_Open-F-Ivan_Lendl-Mats_Wilander,1,F-DTM,74,5,0,2,3,37,37
19870914-M-US_Open-F-Ivan_Lendl-Mats_Wilander,1,F-DTL,27,4,1,2,1,14,13
19870914-M-US_Open-F-Ivan_Lendl-Mats_Wilander,1,F-IO,99,15,2,8,5,55,44
19870914-M-US_Open-F-Ivan_Lendl-Mats_Wilander,1,F-II,15,6,1,3,2,10,5
19870914-M-US_Open-F-Ivan_Lendl-Mats_Wilander,1,B-XC,132,5,1,1,3,72,60
19870914-M-US_Open-F-Ivan_Lendl-Mats_Wilander,1,B-DTM,77,1,0,0,1,39,38
19870914-M-US_Open-F-Ivan_Lendl-Mats_Wilander,1,B-DTL,15,4,4,0,0,8,7
19870914-M-US_Open-F-Ivan_Lendl-Mats_Wilander,1,B-IO,12,5,2,1,2,4,8
19870914-M-US_Open-F-Ivan_Lendl-Mats_Wilander,1,S-XC,119,6,2,0,4,63,56
19870914-M-US_Open-F-Ivan_Lendl-Mats_Wilander,1,S-DTM,84,4,0,0,4,50,34
19870914-M-US_Open-F-Ivan_Lendl-Mats_Wilander,1,S-DTL,16,1,1,0,0,6,10
19870914-M-US_Open-F-Ivan_Lendl-Mats_Wilander,1,S-IO,10,3,1,0,2,3,7
19870914-M-US_Open-F-Ivan_Lendl-Mats_Wilander,2,F-XC,69,6,1,1,4,35,34
19870914-M-US_Open-F-Ivan_Lendl-Mats_Wilander,2,F-DTM,133,2,0,1,1,64,69
19870914-M-US_Open-F-Ivan_Lendl-Mats_Wilander,2,F-DTL,30,6,2,2,2,13,17
19870914-M-US_Open-F-Ivan_Lendl-Mats_Wilander,2,F-IO,43,0,0,0,0,18,25
19870914-M-US_Open-F-Ivan_Lendl-Mats_Wilander,2,F-II,1,0,0,0,0,0,1
19870914-M-US_Open-F-Ivan_Lendl-Mats_Wilander,2,B-XC,143,8,1,2,5,70,73
19870914-M-US_Open-F-Ivan_Lendl-Mats_Wilander,2,B-DTM,86,3,0,0,3,34,52
19870914-M-US_Open-F-Ivan_Lendl-Mats_Wilander,2,B-DTL,34,11,4,2,5,16,18
19870914-M-US_Open-F-Ivan_Lendl-Mats_Wilander,2,B-IO,11,4,2,1,1,6,5
19870914-M-US_Open-F-Ivan_Lendl-Mats_Wilander,2,S-XC,135,8,1,1,6,57,78
19870914-M-US_Open-F-Ivan_Lendl-Mats_Wilander,2,S-DTM,49,3,0,0,3,25,24
19870914-M-US_Open-F-Ivan_Lendl-Mats_Wilander,2,S-DTL,12,2,0,1,1,4,8
19870914-M-US_Open-F-Ivan_Lendl-Mats_Wilander,2,S-IO,3,0,0,0,0,1,2
20160502-M-Karshi_CH-R32-Pavel_Tsoy-Nikola_Milojevic,1,F-XC,21,6,1,0,5,5,16
20160502-M-Karshi_CH-R32-Pavel_Tsoy-Nikola_Milojevic,1,F-DTM,18,4,0,0,4,2,16
20160502-M-Karshi_CH-R32-Pavel_Tsoy-Nikola_Milojevic,1,F-DTL,10,0,0,0,0,3,7
20160502-M-Karshi_CH-R32-Pavel_Tsoy-Nikola_Milojevic,1,F-IO,26,7,1,1,5,8,18
20160502-M-Karshi_CH-R32-Pavel_Tsoy-Nikola_Milojevic,1,F-II,1,1,0,0,1,0,1
20160502-M-Karshi_CH-R32-Pavel_Tsoy-Nikola_Milojevic,1,B-XC,4,0,0,0,0,0,4
20160502-M-Karshi_CH-R32-Pavel_Tsoy-Nikola_Milojevic,1,B-DTM,4,2,0,0,2,0,4
20160502-M-Karshi_CH-R32-Pavel_Tsoy-Nikola_Milojevic,1,B-DTL,2,0,0,0,0,0,2
20160502-M-Karshi_CH-R32-Pavel_Tsoy-Nikola_Milojevic,1,S-XC,23,2,0,0,2,6,17
20160502-M-Karshi_CH-R32-Pavel_Tsoy-Nikola_Milojevic,1,S-DTM,9,0,0,0,0,5,4
20160502-M-Karshi_CH-R32-Pavel_Tsoy-Nikola_Milojevic,1,S-DTL,2,1,0,0,1,1,1
20160502-M-Karshi_CH-R32-Pavel_Tsoy-Nikola_Milojevic,2,F-XC,23,4,2,2,0,17,6
20160502-M-Karshi_CH-R32-Pavel_Tsoy-Nikola_Milojevic,2,F-DTM,8,1,0,1,0,5,3
20160502-M-Karshi_CH-R32-Pavel_Tsoy-Nikola_Milojevic,2,F-DTL,6,3,1,0,2,4,2
20160502-M-Karshi_CH-R32-Pavel_Tsoy-Nikola_Milojevic,2,F-IO,24,4,0,2,2,18,6
20160502-M-Karshi_CH-R32-Pavel_Tsoy-Nikola_Milojevic,2,F-II,3,0,0,0,0,3,0
20160502-M-Karshi_CH-R32-Pavel_Tsoy-Nikola_Milojevic,2,B-XC,23,6,4,0,2,19,4
20160502-M-Karshi_CH-R32-Pavel_Tsoy-Nikola_Milojevic,2,B-DTM,5,1,0,0,1,3,2
20160502-M-Karshi_CH-R32-Pavel_Tsoy-Nikola_Milojevic,2,B-DTL,11,4,1,0,3,6,5
20160502-M-Karshi_CH-R32-Pavel_Tsoy-Nikola_Milojevic,2,B-IO,3,2,2,0,0,3,0
20160502-M-Karshi_CH-R32-Pavel_Tsoy-Nikola_Milojevic,2,S-XC,4,0,0,0,0,2,2
20160502-M-Karshi_CH-R32-Pavel_Tsoy-Nikola_Milojevic,2,S-DTL,2,1,0,0,1,1,1
20160501-M-Munich-F-Dominic_Thiem-Philipp_Kohlschreiber,1,F-XC,58,22,8,6,8,30,28
20160501-M-Munich-F-Dominic_Thiem-Philipp_Kohlschreiber,1,F-DTM,35,2,1,0,1,18,17
20160501-M-Munich-F-Dominic_Thiem-Philipp_Kohlschreiber,1,F-DTL,13,3,3,0,0,8,5
20160501-M-Munich-F-Dominic_Thiem-Philipp_Kohlschreiber,1,F-IO,42,14,9,2,3,21,21
20160501-M-Munich-F-Dominic_Thiem-Philipp_Kohlschreiber,1,F-II,14,11,4,2,5,6,8
20160501-M-Munich-F-Dominic_Thiem-Philipp_Kohlschreiber,1,B-XC,32,6,1,1,4,8,24
20160501-M-Munich-F-Dominic_Thiem-Philipp_Kohlschreiber,1,B-DTM,21,4,1,0,3,6,15
20160501-M-Munich-F-Dominic_Thiem-Philipp_Kohlschreiber,1,B-DTL,12,6,3,0,3,5,7
20160501-M-Munich-F-Dominic_Thiem-Philipp_Kohlschreiber,1,B-IO,6,6,1,1,4,2,4
20160501-M-Munich-F-Dominic_Thiem-Philipp_Kohlschreiber,1,S-XC,18,1,0,0,1,4,14
20160501-M-Munich-F-Dominic_Thiem-Philipp_Kohlschreiber,1,S-DTM,19,2,0,0,2,7,12
20160501-M-Munich-F-Dominic_Thiem-Philipp_Kohlschreiber,1,S-DTL,3,1,0,0,1,0,3
20160501-M-Munich-F-Dominic_Thiem-Philipp_Kohlschreiber,1,S-IO,2,0,0,0,0,1,1
20160501-M-Munich-F-Dominic_Thiem-Philipp_Kohlschreiber,2,F-XC,54,18,8,6,4,35,19
20160501-M-Munich-F-Dominic_Thiem-Philipp_Kohlschreiber,2,F-DTM,45,4,0,1,3,24,21
20160501-M-Munich-F-Dominic_Thiem-Philipp_Kohlschreiber,2,F-DTL,13,2,1,0,1,6,7
20160501-M-Munich-F-Dominic_Thiem-Philipp_Kohlschreiber,2,F-IO,48,8,0,1,7,25,23
20160501-M-Munich-F-Dominic_Thiem-Philipp_Kohlschreiber,2,F-II,12,6,1,3,2,6,6
20160501-M-Munich-F-Dominic_Thiem-Philipp_Kohlschreiber,2,B-XC,38,4,1,1,2,29,9
20160501-M-Munich-F-Dominic_Thiem-Philipp_Kohlschreiber,2,B-DTM,18,3,0,1,2,11,7
20160501-M-Munich-F-Dominic_Thiem-Philipp_Kohlschreiber,2,B-DTL,6,4,3,0,1,5,1
20160501-M-Munich-F-Dominic_Thiem-Philipp_Kohlschreiber,2,B-IO,2,1,0,1,0,1,1
20160501-M-Munich-F-Dominic_Thiem-Philipp_Kohlschreiber,2,S-XC,15,0,0,0,0,11,4
20160501-M-Munich-F-Dominic_Thiem-Philipp_Kohlschreiber,2,S-DTM,7,0,0,0,0,3,4
20160501-M-Munich-F-Dominic_Thiem-Philipp_Kohlschreiber,2,S-DTL,2,1,1,0,0,2,0
20111009-M-Tokyo-F-Rafael_Nadal-Andy_Murray,1,F-XC,61,2,1,0,1,30,31
20111009-M-Tokyo-F-Rafael_Nadal-Andy_Murray,1,F-DTM,20,1,0,0,1,8,12
20111009-M-Tokyo-F-Rafael_Nadal-Andy_Murray,1,F-DTL,29,7,2,2,3,13,16
20111009-M-Tokyo-F-Rafael_Nadal-Andy_Murray,1,F-IO,28,6,2,2,2,13,15
20111009-M-Tokyo-F-Rafael_Nadal-Andy_Murray,1,F-II,12,0,0,0,0,2,10
20111009-M-Tokyo-F-Rafael_Nadal-Andy_Murray,1,B-XC,58,10,2,1,7,18,40
20111009-M-Tokyo-F-Rafael_Nadal-Andy_Murray,1,B-DTM,40,0,0,0,0,17,23
20111009-M-Tokyo-F-Rafael_Nadal-Andy_Murray,1,B-DTL,19,1,0,1,0,9,10
20111009-M-Tokyo-F-Rafael_Nadal-Andy_Murray,1,B-IO,3,0,0,0,0,3,0
20111009-M-Tokyo-F-Rafael_Nadal-Andy_Murray,1,S-XC,6,0,0,0,0,0,6
20111009-M-Tokyo-F-Rafael_Nadal-Andy_Murray,1,S-DTM,22,0,0,0,0,9,13
20111009-M-Tokyo-F-Rafael_Nadal-Andy_Murray,1,S-DTL,17,0,0,0,0,6,11
20111009-M-Tokyo-F-Rafael_Nadal-Andy_Murray,1,S-IO,1,0,0,0,0,0,1
20111009-M-Tokyo-F-Rafael_Nadal-Andy_Murray,2,F-XC,124,23,4,8,11,83,41
20111009-M-Tokyo-F-Rafael_Nadal-Andy_Murray,2,F-DTM,10,1,1,0,0,3,7
20111009-M-Tokyo-F-Rafael_Nadal-Andy_Murray,2,F-DTL,17,5,3,2,0,12,5
20111009-M-Tokyo-F-Rafael_Nadal-Andy_Murray,2,F-IO,29,11,3,6,2,21,8
20111009-M-Tokyo-F-Rafael_Nadal-Andy_Murray,2,F-II,3,1,1,0,0,1,2
20111009-M-Tokyo-F-Rafael_Nadal-Andy_Murray,2,B-XC,53,12,4,3,5,34,19
20111009-M-Tokyo-F-Rafael_Nadal-Andy_Murray,2,B-DTM,25,4,0,0,4,11,14
20111009-M-Tokyo-F-Rafael_Nadal-Andy_Murray,2,B-DTL,37,9,6,1,2,24,13
20111009-M-Tokyo-F-Rafael_Nadal-Andy_Murray,2,B-IO,13,0,0,0,0,6,7
20111009-M-Tokyo-F-Rafael_Nadal-Andy_Murray,2,S-XC,6,0,0,0,0,3,3
20111009-M-Tokyo-F-Rafael_Nadal-Andy_Murray,2,S-DTM,2,0,0,0,0,0,2
20111009-M-Tokyo-F-Rafael_Nadal-Andy_Murray,2,S-DTL,5,0,0,0,0,2,3
20111009-M-Tokyo-F-Rafael_Nadal-Andy_Murray,2,S-IO,1,0,0,0,0,1,0
20160505-M-Madrid-R16-Richard_Gasquet-Kei_Nishikori,1,F-XC,18,5,3,1,1,8,10
20160505-M-Madrid-R16-Richard_Gasquet-Kei_Nishikori,1,F-DTM,27,0,0,0,0,3,24
20160505-M-Madrid-R16-Richard_Gasquet-Kei_Nishikori,1,F-DTL,9,1,1,0,0,3,6
20160505-M-Madrid-R16-Richard_Gasquet-Kei_Nishikori,1,F-IO,11,5,1,1,3,4,7
20160505-M-Madrid-R16-Richard_Gasquet-Kei_Nishikori,1,B-XC,85,7,1,3,3,34,51
20160505-M-Madrid-R16-Richard_Gasquet-Kei_Nishikori,1,B-DTM,22,1,0,0,1,3,19
20160505-M-Madrid-R16-Richard_Gasquet-Kei_Nishikori,1,B-DTL,12,7,4,0,3,4,8
20160505-M-Madrid-R16-Richard_Gasquet-Kei_Nishikori,1,B-IO,6,1,0,1,0,6,0
20160505-M-Madrid-R16-Richard_Gasquet-Kei_Nishikori,1,S-XC,10,0,0,0,0,3,7
20160505-M-Madrid-R16-Richard_Gasquet-Kei_Nishikori,1,S-DTM,7,1,0,0,1,2,5
20160505-M-Madrid-R16-Richard_Gasquet-Kei_Nishikori,1,S-DTL,1,0,0,0,0,0,1
20160505-M-Madrid-R16-Richard_Gasquet-Kei_Nishikori,2,F-XC,28,6,2,3,1,24,4
20160505-M-Madrid-R16-Richard_Gasquet-Kei_Nishikori,2,F-DTM,20,5,1,2,2,16,4
20160505-M-Madrid-R16-Richard_Gasquet-Kei_Nishikori,2,F-DTL,9,8,5,0,3,6,3
20160505-M-Madrid-R16-Richard_Gasquet-Kei_Nishikori,2,F-IO,35,14,8,3,3,25,10
20160505-M-Madrid-R16-Richard_Gasquet-Kei_Nishikori,2,F-II,6,5,1,3,1,5,1
20160505-M-Madrid-R16-Richard_Gasquet-Kei_Nishikori,2,B-XC,73,14,3,5,6,46,27
20160505-M-Madrid-R16-Richard_Gasquet-Kei_Nishikori,2,B-DTM,33,2,0,1,1,24,9
20160505-M-Madrid-R16-Richard_Gasquet-Kei_Nishikori,2,B-DTL,14,5,3,0,2,6,8
20160505-M-Madrid-R16-Richard_Gasquet-Kei_Nishikori,2,B-IO,5,2,1,0,1,4,1
20160505-M-Madrid-R16-Richard_Gasquet-Kei_Nishikori,2,S-DTM,5,0,0,0,0,2,3
20160505-M-Madrid-R16-Richard_Gasquet-Kei_Nishikori,2,S-DTL,1,1,1,0,0,1,0
20160505-M-Madrid-R16-Richard_Gasquet-Kei_Nishikori,2,S-IO,1,0,0,0,0,0,1
20101126-M-Tour_Finals-SF-Roger_Federer-Novak_Djokovic,1,F-XC,33,7,4,1,2,20,13
20101126-M-Tour_Finals-SF-Roger_Federer-Novak_Djokovic,1,F-DTM,18,0,0,0,0,13,5
20101126-M-Tour_Finals-SF-Roger_Federer-Novak_Djokovic,1,F-DTL,18,5,3,1,1,13,5
20101126-M-Tour_Finals-SF-Roger_Federer-Novak_Djokovic,1,F-IO,24,4,2,1,1,16,8
20101126-M-Tour_Finals-SF-Roger_Federer-Novak_Djokovic,1,F-II,6,4,3,0,1,4,2
20101126-M-Tour_Finals-SF-Roger_Federer-Novak_Djokovic,1,B-XC,32,5,0,1,4,18,14
20101126-M-Tour_Finals-SF-Roger_Federer-Novak_Djokovic,1,B-DTM,15,0,0,0,0,9,6
20101126-M-Tour_Finals-SF-Roger_Federer-Novak_Djokovic,1,B-DTL,5,2,1,0,1,2,3
20101126-M-Tour_Finals-SF-Roger_Federer-Novak_Djokovic,1,B-IO,1,1,1,0,0,1,0
20101126-M-Tour_Finals-SF-Roger_Federer-Novak_Djokovic,1,S-XC,21,0,0,0,0,12,9
20101126-M-Tour_Finals-SF-Roger_Federer-Novak_Djokovic,1,S-DTM,5,0,0,0,0,2,3
20101126-M-Tour_Finals-SF-Roger_Federer-Novak_Djokovic,1,S-DTL,4,0,0,0,0,3,1
20101126-M-Tour_Finals-SF-Roger_Federer-Novak_Djokovic,1,S-IO,1,0,0,0,0,0,1
20101126-M-Tour_Finals-SF-Roger_Federer-Novak_Djokovic,2,F-XC,42,17,4,6,7,24,18
20101126-M-Tour_Finals-SF-Roger_Federer-Novak_Djokovic,2,F-DTM,17,1,0,0,1,6,11
20101126-M-Tour_Finals-SF-Roger_Federer-Novak_Djokovic,2,F-DTL,11,2,1,0,1,6,5
20101126-M-Tour_Finals-SF-Roger_Federer-Novak_Djokovic,2,F-IO,17,1,1,0,0,7,10
20101126-M-Tour_Finals-SF-Roger_Federer-Novak_Djokovic,2,F-II,5,0,0,0,0,3,2
20101126-M-Tour_Finals-SF-Roger_Federer-Novak_Djokovic,2,B-XC,54,1,0,1,0,20,34
20101126-M-Tour_Finals-SF-Roger_Federer-Novak_Djokovic,2,B-DTM,20,0,0,0,0,7,13
20101126-M-Tour_Finals-SF-Roger_Federer-Novak_Djokovic,2,B-DTL,15,4,1,1,2,3,12
20101126-M-Tour_Finals-SF-Roger_Federer-Novak_Djokovic,2,B-IO,3,1,0,0,1,1,2
20101126-M-Tour_Finals-SF-Roger_Federer-Novak_Djokovic,2,S-XC,2,0,0,0,0,1,1
20101126-M-Tour_Finals-SF-Roger_Federer-Novak_Djokovic,2,S-DTM,3,0,0,0,0,0,3
20101126-M-Tour_Finals-SF-Roger_Federer-Novak_Djokovic,2,S-IO,1,0,0,0,0,0,1
19830911-M-US_Open-F-Jimmy_Connors-Ivan_Lendl,1,F-XC,116,23,3,7,13,54,62
19830911-M-US_Open-F-Jimmy_Connors-Ivan_Lendl,1,F-DTM,48,7,1,0,6,20,28
19830911-M-US_Open-F-Jimmy_Connors-Ivan_Lendl,1,F-DTL,9,3,1,0,2,4,5
19830911-M-US_Open-F-Jimmy_Connors-Ivan_Lendl,1,F-IO,25,9,2,3,4,14,11
19830911-M-US_Open-F-Jimmy_Connors-Ivan_Lendl,1,B-XC,69,9,3,2,4,39,30
19830911-M-US_Open-F-Jimmy_Connors-Ivan_Lendl,1,B-DTM,66,5,0,0,5,32,34
19830911-M-US_Open-F-Jimmy_Connors-Ivan_Lendl,1,B-DTL,18,9,5,3,1,11,7
19830911-M-US_Open-F-Jimmy_Connors-Ivan_Lendl,1,B-IO,40,12,0,4,8,20,20
19830911-M-US_Open-F-Jimmy_Connors-Ivan_Lendl,1,S-XC,8,2,0,1,1,3,5
19830911-M-US_Open-F-Jimmy_Connors-Ivan_Lendl,1,S-DTM,9,0,0,0,0,6,3
19830911-M-US_Open-F-Jimmy_Connors-Ivan_Lendl,1,S-DTL,2,1,0,0,1,1,1
19830911-M-US_Open-F-Jimmy_Connors-Ivan_Lendl,1,S-IO,4,0,0,0,0,0,4
19830911-M-US_Open-F-Jimmy_Connors-Ivan_Lendl,2,F-XC,85,13,0,7,6,36,49
19830911-M-US_Open-F-Jimmy_Connors-Ivan_Lendl,2,F-DTM,68,2,0,1,1,36,32
19830911-M-US_Open-F-Jimmy_Connors-Ivan_Lendl,2,F-DTL,25,14,3,4,7,12,13
19830911-M-US_Open-F-Jimmy_Connors-Ivan_Lendl,2,F-IO,34,14,1,3,10,16,18
19830911-M-US_Open-F-Jimmy_Connors-Ivan_Lendl,2,F-II,1,1,0,1,0,1,0
19830911-M-US_Open-F-Jimmy_Connors-Ivan_Lendl,2,B-XC,33,5,1,0,4,17,16
19830911-M-US_Open-F-Jimmy_Connors-Ivan_Lendl,2,B-DTM,53,8,0,1,7,25,28
19830911-M-US_Open-F-Jimmy_Connors-Ivan_Lendl,2,B-DTL,17,7,5,1,1,12,5
19830911-M-US_Open-F-Jimmy_Connors-Ivan_Lendl,2,B-IO,11,5,1,1,3,5,6
19830911-M-US_Open-F-Jimmy_Connors-Ivan_Lendl,2,S-XC,39,3,0,1,2,22,17
19830911-M-US_Open-F-Jimmy_Connors-Ivan_Lendl,2,S-DTM,65,3,0,0,3,27,38
19830911-M-US_Open-F-Jimmy_Connors-Ivan_Lendl,2,S-DTL,11,0,0,0,0,5,6
19830911-M-US_Open-F-Jimmy_Connors-Ivan_Lendl,2,S-IO,3,0,0,0,0,3,0
20160509-M-Seoul_CH-R32-Ho_Gi_Kang-Yuichi_Sugita,1,F-XC,42,4,0,1,3,17,25
20160509-M-Seoul_CH-R32-Ho_Gi_Kang-Yuichi_Sugita,1,F-DTM,20,6,0,1,5,5,15
20160509-M-Seoul_CH-R32-Ho_Gi_Kang-Yuichi_Sugita,1,F-DTL,4,1,0,0,1,3,1
20160509-M-Seoul_CH-R32-Ho_Gi_Kang-Yuichi_Sugita,1,F-IO,16,3,0,2,1,13,3
20160509-M-Seoul_CH-R32-Ho_Gi_Kang-Yuichi_Sugita,1,F-II,3,2,0,1,1,2,1
20160509-M-Seoul_CH-R32-Ho_Gi_Kang-Yuichi_Sugita,1,B-XC,4,0,0,0,0,3,1
20160509-M-Seoul_CH-R32-Ho_Gi_Kang-Yuichi_Sugita,1,B-DTM,20,6,1,0,5,9,11
20160509-M-Seoul_CH-R32-Ho_Gi_Kang-Yuichi_Sugita,1,B-DTL,13,4,1,1,2,4,9
20160509-M-Seoul_CH-R32-Ho_Gi_Kang-Yuichi_Sugita,1,B-IO,7,0,0,0,0,3,4
20160509-M-Seoul_CH-R32-Ho_Gi_Kang-Yuichi_Sugita,1,S-XC,3,1,0,0,1,0,3
20160509-M-Seoul_CH-R32-Ho_Gi_Kang-Yuichi_Sugita,1,S-DTM,5,2,0,0,2,0,5
20160509-M-Seoul_CH-R32-Ho_Gi_Kang-Yuichi_Sugita,1,S-DTL,6,2,0,0,2,1,5
20160509-M-Seoul_CH-R32-Ho_Gi_Kang-Yuichi_Sugita,1,S-IO,2,0,0,0,0,1,1
20160509-M-Seoul_CH-R32-Ho_Gi_Kang-Yuichi_Sugita,2,F-XC,37,6,2,2,2,21,16
20160509-M-Seoul_CH-R32-Ho_Gi_Kang-Yuichi_Sugita,2,F-DTM,11,0,0,0,0,3,8
20160509-M-Seoul_CH-R32-Ho_Gi_Kang-Yuichi_Sugita,2,F-DTL,1,0,0,0,0,1,0
20160509-M-Seoul_CH-R32-Ho_Gi_Kang-Yuichi_Sugita,2,F-IO,8,0,0,0,0,5,3
20160509-M-Seoul_CH-R32-Ho_Gi_Kang-Yuichi_Sugita,2,F-II,3,1,0,1,0,2,1
20160509-M-Seoul_CH-R32-Ho_Gi_Kang-Yuichi_Sugita,2,B-XC,34,8,1,4,3,22,12
20160509-M-Seoul_CH-R32-Ho_Gi_Kang-Yuichi_Sugita,2,B-DTM,20,1,0,1,0,8,12
20160509-M-Seoul_CH-R32-Ho_Gi_Kang-Yuichi_Sugita,2,B-DTL,11,2,0,0,2,9,2
20160509-M-Seoul_CH-R32-Ho_Gi_Kang-Yuichi_Sugita,2,B-IO,6,1,0,0,1,4,2
20160509-M-Seoul_CH-R32-Ho_Gi_Kang-Yuichi_Sugita,2,S-XC,1,0,0,0,0,0,1
20160509-M-Seoul_CH-R32-Ho_Gi_Kang-Yuichi_Sugita,2,S-DTL,4,0,0,0,0,1,3
20120730-M-Olympics-R32-Juan_Martin_Del_Potro-Andreas_Seppi,1,F-XC,49,17,4,3,10,22,27
20120730-M-Olympics-R32-Juan_Martin_Del_Potro-Andreas_Seppi,1,F-DTM,19,1,0,0,1,6,13
20120730-M-Olympics-R32-Juan_Martin_Del_Potro-Andreas_Seppi,1,F-DTL,16,4,1,2,1,8,8
20120730-M-Olympics-R32-Juan_Martin_Del_Potro-Andreas_Seppi,1,F-IO,28,9,3,2,4,19,9
20120730-M-Olympics-R32-Juan_Martin_Del_Potro-Andreas_Seppi,1,F-II,1,0,0,0,0,1,0
20120730-M-Olympics-R32-Juan_Martin_Del_Potro-Andreas_Seppi,1,B-XC,61,5,1,0,4,30,31
20120730-M-Olympics-R32-Juan_Martin_Del_Potro-Andreas_Seppi,1,B-DTM,20,2,0,0,2,11,9
20120730-M-Olympics-R32-Juan_Martin_Del_Potro-Andreas_Seppi,1,B-DTL,2,0,0,0,0,1,1
20120730-M-Olympics-R32-Juan_Martin_Del_Potro-Andreas_Seppi,1,B-IO,4,1,0,0,1,2,2
20120730-M-Olympics-R32-Juan_Martin_Del_Potro-Andreas_Seppi,1,S-XC,20,1,0,0,1,8,12
20120730-M-Olympics-R32-Juan_Martin_Del_Potro-Andreas_Seppi,1,S-DTM,2,0,0,0,0,0,2
20120730-M-Olympics-R32-Juan_Martin_Del_Potro-Andreas_Seppi,1,S-DTL,1,0,0,0,0,1,0
20120730-M-Olympics-R32-Juan_Martin_Del_Potro-Andreas_Seppi,2,F-XC,40,11,4,0,7,22,18
20120730-M-Olympics-R32-Juan_Martin_Del_Potro-Andreas_Seppi,2,F-DTM,12,1,0,0,1,6,6
20120730-M-Olympics-R32-Juan_Martin_Del_Potro-Andreas_Seppi,2,F-DTL,16,4,1,0,3,10,6
20120730-M-Olympics-R32-Juan_Martin_Del_Potro-Andreas_Seppi,2,F-IO,26,7,5,0,2,15,11
20120730-M-Olympics-R32-Juan_Martin_Del_Potro-Andreas_Seppi,2,F-II,6,0,0,0,0,4,2
20120730-M-Olympics-R32-Juan_Martin_Del_Potro-Andreas_Seppi,2,B-XC,40,4,0,0,4,16,24
20120730-M-Olympics-R32-Juan_Martin_Del_Potro-Andreas_Seppi,2,B-DTM,42,5,1,0,4,19,23
20120730-M-Olympics-R32-Juan_Martin_Del_Potro-Andreas_Seppi,2,B-DTL,17,5,3,1,1,11,6
20120730-M-Olympics-R32-Juan_Martin_Del_Potro-Andreas_Seppi,2,B-IO,2,2,2,0,0,2,0
20120730-M-Olympics-R32-Juan_Martin_Del_Potro-Andreas_Seppi,2,S-XC,18,4,0,0,4,7,11
20120730-M-Olympics-R32-Juan_Martin_Del_Potro-Andreas_Seppi,2,S-DTM,9,0,0,0,0,6,3
20120730-M-Olympics-R32-Juan_Martin_Del_Potro-Andreas_Seppi,2,S-DTL,2,0,0,0,0,2,0
20120730-M-Olympics-R32-Juan_Martin_Del_Potro-Andreas_Seppi,2,S-IO,1,1,0,0,1,0,1
20110513-M-Rome_Masters-SF-Novak_Djokovic-Andy_Murray,1,F-XC,107,11,2,4,5,64,43
20110513-M-Rome_Masters-SF-Novak_Djokovic-Andy_Murray,1,F-DTM,37,2,0,0,2,19,18
20110513-M-Rome_Masters-SF-Novak_Djokovic-Andy_Murray,1,F-DTL,39,2,0,1,1,28,11
20110513-M-Rome_Masters-SF-Novak_Djokovic-Andy_Murray,1,F-IO,61,17,6,5,6,41,20
20110513-M-Rome_Masters-SF-Novak_Djokovic-Andy_Murray,1,F-II,12,4,3,1,0,8,4
20110513-M-Rome_Masters-SF-Novak_Djokovic-Andy_Murray,1,B-XC,162,12,3,2,7,86,76
20110513-M-Rome_Masters-SF-Novak_Djokovic-Andy_Murray,1,B-DTM,38,2,1,0,1,18,20
20110513-M-Rome_Masters-SF-Novak_Djokovic-Andy_Murray,1,B-DTL,61,8,4,1,3,38,23
20110513-M-Rome_Masters-SF-Novak_Djokovic-Andy_Murray,1,B-IO,6,1,0,0,1,4,2
20110513-M-Rome_Masters-SF-Novak_Djokovic-Andy_Murray,1,S-XC,6,1,0,0,1,3,3
20110513-M-Rome_Masters-SF-Novak_Djokovic-Andy_Murray,1,S-DTM,1,0,0,0,0,1,0
20110513-M-Rome_Masters-SF-Novak_Djokovic-Andy_Murray,1,S-DTL,4,0,0,0,0,3,1
20110513-M-Rome_Masters-SF-Novak_Djokovic-Andy_Murray,2,F-XC,127,17,5,1,11,45,82
20110513-M-Rome_Masters-SF-Novak_Djokovic-Andy_Murray,2,F-DTM,27,0,0,0,0,11,16
20110513-M-Rome_Masters-SF-Novak_Djokovic-Andy_Murray,2,F-DTL,43,6,1,1,4,19,24
20110513-M-Rome_Masters-SF-Novak_Djokovic-Andy_Murray,2,F-IO,44,11,3,2,6,19,25
20110513-M-Rome_Masters-SF-Novak_Djokovic-Andy_Murray,2,F-II,2,1,0,0,1,0,2
20110513-M-Rome_Masters-SF-Novak_Djokovic-Andy_Murray,2,B-XC,161,5,1,1,3,75,86
20110513-M-Rome_Masters-SF-Novak_Djokovic-Andy_Murray,2,B-DTM,37,2,0,0,2,15,22
20110513-M-Rome_Masters-SF-Novak_Djokovic-Andy_Murray,2,B-DTL,32,7,4,0,3,15,17
20110513-M-Rome_Masters-SF-Novak_Djokovic-Andy_Murray,2,B-IO,2,0,0,0,0,2,0
20110513-M-Rome_Masters-SF-Novak_Djokovic-Andy_Murray,2,S-XC,29,2,0,0,2,6,23
20110513-M-Rome_Masters-SF-Novak_Djokovic-Andy_Murray,2,S-DTM,12,0,0,0,0,3,9
20110513-M-Rome_Masters-SF-Novak_Djokovic-Andy_Murray,2,S-DTL,5,0,0,0,0,2,3
20110513-M-Rome_Masters-SF-Novak_Djokovic-Andy_Murray,2,S-IO,1,0,0,0,0,1,0
20120812-M-Canada_Masters-F-Novak_Djokovic-Richard_Gasquet,1,F-XC,16,5,3,2,0,16,0
20120812-M-Canada_Masters-F-Novak_Djokovic-Richard_Gasquet,1,F-DTM,10,1,0,0,1,7,3
20120812-M-Canada_Masters-F-Novak_Djokovic-Richard_Gasquet,1,F-DTL,4,2,1,1,0,4,0
20120812-M-Canada_Masters-F-Novak_Djokovic-Richard_Gasquet,1,F-IO,28,10,2,4,4,18,10
20120812-M-Canada_Masters-F-Novak_Djokovic-Richard_Gasquet,1,F-II,5,3,0,3,0,4,1
20120812-M-Canada_Masters-F-Novak_Djokovic-Richard_Gasquet,1,B-XC,29,2,0,0,2,25,4
20120812-M-Canada_Masters-F-Novak_Djokovic-Richard_Gasquet,1,B-DTM,7,0,0,0,0,5,2
20120812-M-Canada_Masters-F-Novak_Djokovic-Richard_Gasquet,1,B-DTL,18,2,0,1,1,16,2
20120812-M-Canada_Masters-F-Novak_Djokovic-Richard_Gasquet,1,B-IO,3,1,1,0,0,3,0
20120812-M-Canada_Masters-F-Novak_Djokovic-Richard_Gasquet,1,S-DTM,1,0,0,0,0,1,0
20120812-M-Canada_Masters-F-Novak_Djokovic-Richard_Gasquet,2,F-XC,18,7,0,0,7,1,17
20120812-M-Canada_Masters-F-Novak_Djokovic-Richard_Gasquet,2,F-DTM,14,3,0,0,3,2,12
20120812-M-Canada_Masters-F-Novak_Djokovic-Richard_Gasquet,2,F-DTL,9,3,2,1,0,3,6
20120812-M-Canada_Masters-F-Novak_Djokovic-Richard_Gasquet,2,F-IO,6,0,0,0,0,3,3
20120812-M-Canada_Masters-F-Novak_Djokovic-Richard_Gasquet,2,B-XC,41,4,1,0,3,6,35
20120812-M-Canada_Masters-F-Novak_Djokovic-Richard_Gasquet,2,B-DTM,3,0,0,0,0,1,2
20120812-M-Canada_Masters-F-Novak_Djokovic-Richard_Gasquet,2,B-DTL,5,4,1,0,3,2,3
20120812-M-Canada_Masters-F-Novak_Djokovic-Richard_Gasquet,2,B-IO,4,3,1,1,1,2,2
20120812-M-Canada_Masters-F-Novak_Djokovic-Richard_Gasquet,2,S-XC,9,2,0,0,2,3,6
20120812-M-Canada_Masters-F-Novak_Djokovic-Richard_Gasquet,2,S-DTM,4,0,0,0,0,2,2
20120812-M-Canada_Masters-F-Novak_Djokovic-Richard_Gasquet,2,S-DTL,1,0,0,0,0,0,1
20130813-M-Canada_Masters-QF-Novak_Djokovic-Richard_Gasquet,1,F-XC,12,4,4,0,0,8,4
20130813-M-Canada_Masters-QF-Novak_Djokovic-Richard_Gasquet,1,F-DTM,2,1,0,0,1,1,1
20130813-M-Canada_Masters-QF-Novak_Djokovic-Richard_Gasquet,1,F-DTL,9,3,3,0,0,6,3
20130813-M-Canada_Masters-QF-Novak_Djokovic-Richard_Gasquet,1,F-IO,21,7,3,0,4,14,7
20130813-M-Canada_Masters-QF-Novak_Djokovic-Richard_Gasquet,1,F-II,3,1,0,0,1,1,2
20130813-M-Canada_Masters-QF-Novak_Djokovic-Richard_Gasquet,1,B-XC,16,4,1,1,2,9,7
20130813-M-Canada_Masters-QF-Novak_Djokovic-Richard_Gasquet,1,B-DTM,8,1,1,0,0,4,4
20130813-M-Canada_Masters-QF-Novak_Djokovic-Richard_Gasquet,1,B-DTL,11,2,2,0,0,10,1
20130813-M-Canada_Masters-QF-Novak_Djokovic-Richard_Gasquet,1,B-IO,7,0,0,0,0,6,1
20130813-M-Canada_Masters-QF-Novak_Djokovic-Richard_Gasquet,1,S-DTM,2,0,0,0,0,2,0
20130813-M-Canada_Masters-QF-Novak_Djokovic-Richard_Gasquet,2,F-XC,17,4,3,0,1,7,10
20130813-M-Canada_Masters-QF-Novak_Djokovic-Richard_Gasquet,2,F-DTM,14,1,0,0,1,4,10
20130813-M-Canada_Masters-QF-Novak_Djokovic-Richard_Gasquet,2,F-DTL,7,1,1,0,0,2,5
20130813-M-Canada_Masters-QF-Novak_Djokovic-Richard_Gasquet,2,F-IO,2,0,0,0,0,2,0
20130813-M-Canada_Masters-QF-Novak_Djokovic-Richard_Gasquet,2,B-XC,22,3,0,1,2,7,15
20130813-M-Canada_Masters-QF-Novak_Djokovic-Richard_Gasquet,2,B-DTM,9,2,0,0,2,2,7
20130813-M-Canada_Masters-QF-Novak_Djokovic-Richard_Gasquet,2,B-DTL,4,3,1,0,2,2,2
20130813-M-Canada_Masters-QF-Novak_Djokovic-Richard_Gasquet,2,B-IO,3,2,1,0,1,1,2
20130813-M-Canada_Masters-QF-Novak_Djokovic-Richard_Gasquet,2,S-XC,5,0,0,0,0,3,2
20130813-M-Canada_Masters-QF-Novak_Djokovic-Richard_Gasquet,2,S-DTM,4,0,0,0,0,0,4
20120728-M-Olympics-R64-Roger_Federer-Alejandro_Falla,1,F-XC,60,16,9,2,5,44,16
20120728-M-Olympics-R64-Roger_Federer-Alejandro_Falla,1,F-DTM,13,3,0,0,3,3,10
20120728-M-Olympics-R64-Roger_Federer-Alejandro_Falla,1,F-DTL,16,10,5,1,4,7,9
20120728-M-Olympics-R64-Roger_Federer-Alejandro_Falla,1,F-IO,18,5,1,0,4,7,11
20120728-M-Olympics-R64-Roger_Federer-Alejandro_Falla,1,F-II,8,3,1,1,1,4,4
20120728-M-Olympics-R64-Roger_Federer-Alejandro_Falla,1,B-XC,31,9,3,1,5,18,13
20120728-M-Olympics-R64-Roger_Federer-Alejandro_Falla,1,B-DTM,11,4,0,0,4,5,6
20120728-M-Olympics-R64-Roger_Federer-Alejandro_Falla,1,B-DTL,20,4,3,0,1,11,9
20120728-M-Olympics-R64-Roger_Federer-Alejandro_Falla,1,B-IO,1,0,0,0,0,0,1
20120728-M-Olympics-R64-Roger_Federer-Alejandro_Falla,1,S-XC,14,2,0,0,2,7,7
20120728-M-Olympics-R64-Roger_Federer-Alejandro_Falla,1,S-DTM,9,1,0,0,1,3,6
20120728-M-Olympics-R64-Roger_Federer-Alejandro_Falla,1,S-DTL,8,0,0,0,0,5,3
20120728-M-Olympics-R64-Roger_Federer-Alejandro_Falla,1,S-IO,1,0,0,0,0,1,0
20120728-M-Olympics-R64-Roger_Federer-Alejandro_Falla,2,F-XC,46,8,2,2,4,22,24
20120728-M-Olympics-R64-Roger_Federer-Alejandro_Falla,2,F-DTM,5,1,0,0,1,2,3
20120728-M-Olympics-R64-Roger_Federer-Alejandro_Falla,2,F-DTL,16,9,2,4,3,8,8
20120728-M-Olympics-R64-Roger_Federer-Alejandro_Falla,2,F-IO,7,0,0,0,0,3,4
20120728-M-Olympics-R64-Roger_Federer-Alejandro_Falla,2,F-II,1,1,0,1,0,1,0
20120728-M-Olympics-R64-Roger_Federer-Alejandro_Falla,2,B-XC,39,7,1,3,3,17,22
20120728-M-Olympics-R64-Roger_Federer-Alejandro_Falla,2,B-DTM,21,5,0,0,5,6,15
20120728-M-Olympics-R64-Roger_Federer-Alejandro_Falla,2,B-DTL,27,5,1,1,3,12,15
20120728-M-Olympics-R64-Roger_Federer-Alejandro_Falla,2,B-IO,21,0,0,0,0,12,9
20120728-M-Olympics-R64-Roger_Federer-Alejandro_Falla,2,S-XC,9,0,0,0,0,3,6
20120728-M-Olympics-R64-Roger_Federer-Alejandro_Falla,2,S-DTM,4,0,0,0,0,3,1
20120728-M-Olympics-R64-Roger_Federer-Alejandro_Falla,2,S-DTL,14,2,0,0,2,2,12
20120728-M-Olympics-R64-Roger_Federer-Alejandro_Falla,2,S-IO,3,1,0,0,1,1,2
20160506-M-Madrid_Masters-QF-Kei_Nishikori-Nick_Kyrgios,1,F-XC,32,15,7,2,6,22,10
20160506-M-Madrid_Masters-QF-Kei_Nishikori-Nick_Kyrgios,1,F-DTM,39,4,0,0,4,26,13
20160506-M-Madrid_Masters-QF-Kei_Nishikori-Nick_Kyrgios,1,F-DTL,11,2,1,0,1,7,4
20160506-M-Madrid_Masters-QF-Kei_Nishikori-Nick_Kyrgios,1,F-IO,41,17,6,3,8,27,14
20160506-M-Madrid_Masters-QF-Kei_Nishikori-Nick_Kyrgios,1,F-II,6,2,0,1,1,5,1
20160506-M-Madrid_Masters-QF-Kei_Nishikori-Nick_Kyrgios,1,B-XC,56,7,2,0,5,36,20
20160506-M-Madrid_Masters-QF-Kei_Nishikori-Nick_Kyrgios,1,B-DTM,32,3,1,0,2,21,11
20160506-M-Madrid_Masters-QF-Kei_Nishikori-Nick_Kyrgios,1,B-DTL,18,13,10,2,1,15,3
20160506-M-Madrid_Masters-QF-Kei_Nishikori-Nick_Kyrgios,1,B-IO,10,9,6,1,2,8,2
20160506-M-Madrid_Masters-QF-Kei_Nishikori-Nick_Kyrgios,1,S-XC,6,1,1,0,0,5,1
20160506-M-Madrid_Masters-QF-Kei_Nishikori-Nick_Kyrgios,1,S-DTM,7,1,0,0,1,2,5
20160506-M-Madrid_Masters-QF-Kei_Nishikori-Nick_Kyrgios,1,S-DTL,1,0,0,0,0,1,0
20160506-M-Madrid_Masters-QF-Kei_Nishikori-Nick_Kyrgios,2,F-XC,29,6,2,1,3,12,17
20160506-M-Madrid_Masters-QF-Kei_Nishikori-Nick_Kyrgios,2,F-DTM,25,4,0,0,4,5,20
20160506-M-Madrid_Masters-QF-Kei_Nishikori-Nick_Kyrgios,2,F-DTL,8,1,0,0,1,4,4
20160506-M-Madrid_Masters-QF-Kei_Nishikori-Nick_Kyrgios,2,F-IO,25,11,4,2,5,10,15
20160506-M-Madrid_Masters-QF-Kei_Nishikori-Nick_Kyrgios,2,F-II,5,3,1,0,2,2,3
20160506-M-Madrid_Masters-QF-Kei_Nishikori-Nick_Kyrgios,2,B-XC,71,16,3,5,8,22,49
20160506-M-Madrid_Masters-QF-Kei_Nishikori-Nick_Kyrgios,2,B-DTM,40,7,0,1,6,12,28
20160506-M-Madrid_Masters-QF-Kei_Nishikori-Nick_Kyrgios,2,B-DTL,11,2,0,0,2,3,8
20160506-M-Madrid_Masters-QF-Kei_Nishikori-Nick_Kyrgios,2,B-IO,8,1,0,0,1,2,6
20160506-M-Madrid_Masters-QF-Kei_Nishikori-Nick_Kyrgios,2,S-XC,8,2,1,0,1,4,4
20160506-M-Madrid_Masters-QF-Kei_Nishikori-Nick_Kyrgios,2,S-DTM,5,0,0,0,0,2,3
20160515-M-Rome_Masters-F-Andy_Murray-Novak_Djokovic,1,F-XC,62,11,5,3,3,34,28
20160515-M-Rome_Masters-F-Andy_Murray-Novak_Djokovic,1,F-DTM,23,2,1,0,1,14,9
20160515-M-Rome_Masters-F-Andy_Murray-Novak_Djokovic,1,F-DTL,14,3,1,1,1,8,6
20160515-M-Rome_Masters-F-Andy_Murray-Novak_Djokovic,1,F-IO,22,5,0,3,2,15,7
20160515-M-Rome_Masters-F-Andy_Murray-Novak_Djokovic,1,F-II,1,0,0,0,0,1,0
20160515-M-Rome_Masters-F-Andy_Murray-Novak_Djokovic,1,B-XC,42,2,1,0,1,23,19
20160515-M-Rome_Masters-F-Andy_Murray-Novak_Djokovic,1,B-DTM,40,2,0,0,2,16,24
20160515-M-Rome_Masters-F-Andy_Murray-Novak_Djokovic,1,B-DTL,6,4,1,0,3,1,5
20160515-M-Rome_Masters-F-Andy_Murray-Novak_Djokovic,1,B-IO,3,1,1,0,0,2,1
20160515-M-Rome_Masters-F-Andy_Murray-Novak_Djokovic,1,S-XC,13,1,0,0,1,3,10
20160515-M-Rome_Masters-F-Andy_Murray-Novak_Djokovic,1,S-DTM,4,0,0,0,0,1,3
20160515-M-Rome_Masters-F-Andy_Murray-Novak_Djokovic,2,F-XC,37,3,0,0,3,16,21
20160515-M-Rome_Masters-F-Andy_Murray-Novak_Djokovic,2,F-DTM,24,3,1,0,2,8,16
20160515-M-Rome_Masters-F-Andy_Murray-Novak_Djokovic,2,F-DTL,16,6,1,2,3,9,7
20160515-M-Rome_Masters-F-Andy_Murray-Novak_Djokovic,2,F-IO,20,4,2,0,2,11,9
20160515-M-Rome_Masters-F-Andy_Murray-Novak_Djokovic,2,F-II,2,1,0,1,0,2,0
20160515-M-Rome_Masters-F-Andy_Murray-Novak_Djokovic,2,B-XC,53,7,1,2,4,29,24
20160515-M-Rome_Masters-F-Andy_Murray-Novak_Djokovic,2,B-DTM,41,4,1,0,3,23,18
20160515-M-Rome_Masters-F-Andy_Murray-Novak_Djokovic,2,B-DTL,13,3,1,1,1,5,8
20160515-M-Rome_Masters-F-Andy_Murray-Novak_Djokovic,2,B-IO,11,1,1,0,0,6,5
20160515-M-Rome_Masters-F-Andy_Murray-Novak_Djokovic,2,S-XC,8,2,0,0,2,2,6
20160515-M-Rome_Masters-F-Andy_Murray-Novak_Djokovic,2,S-DTM,4,0,0,0,0,0,4
20060922-M-Davis_Cup_World_Group_PO-RR-Roger_Federer-Novak_Djokovic,1,F-XC,70,27,13,6,8,45,25
20060922-M-Davis_Cup_World_Group_PO-RR-Roger_Federer-Novak_Djokovic,1,F-DTM,10,3,1,1,1,5,5
20060922-M-Davis_Cup_World_Group_PO-RR-Roger_Federer-Novak_Djokovic,1,F-DTL,17,6,3,1,2,9,8
20060922-M-Davis_Cup_World_Group_PO-RR-Roger_Federer-Novak_Djokovic,1,F-IO,21,4,2,0,2,11,10
20060922-M-Davis_Cup_World_Group_PO-RR-Roger_Federer-Novak_Djokovic,1,F-II,4,2,0,1,1,1,3
20060922-M-Davis_Cup_World_Group_PO-RR-Roger_Federer-Novak_Djokovic,1,B-XC,33,6,3,0,3,22,11
20060922-M-Davis_Cup_World_Group_PO-RR-Roger_Federer-Novak_Djokovic,1,B-DTM,8,0,0,0,0,3,5
20060922-M-Davis_Cup_World_Group_PO-RR-Roger_Federer-Novak_Djokovic,1,B-DTL,16,9,5,0,4,10,6
20060922-M-Davis_Cup_World_Group_PO-RR-Roger_Federer-Novak_Djokovic,1,B-IO,2,0,0,0,0,2,0
20060922-M-Davis_Cup_World_Group_PO-RR-Roger_Federer-Novak_Djokovic,1,S-XC,19,1,0,0,1,10,9
20060922-M-Davis_Cup_World_Group_PO-RR-Roger_Federer-Novak_Djokovic,1,S-DTM,6,0,0,0,0,3,3
20060922-M-Davis_Cup_World_Group_PO-RR-Roger_Federer-Novak_Djokovic,1,S-DTL,2,0,0,0,0,1,1
20060922-M-Davis_Cup_World_Group_PO-RR-Roger_Federer-Novak_Djokovic,2,F-XC,37,7,3,2,2,18,19
20060922-M-Davis_Cup_World_Group_PO-RR-Roger_Federer-Novak_Djokovic,2,F-DTM,17,1,0,1,0,7,10
20060922-M-Davis_Cup_World_Group_PO-RR-Roger_Federer-Novak_Djokovic,2,F-DTL,18,4,0,1,3,4,14
20060922-M-Davis_Cup_World_Group_PO-RR-Roger_Federer-Novak_Djokovic,2,F-IO,27,5,0,2,3,13,14
20060922-M-Davis_Cup_World_Group_PO-RR-Roger_Federer-Novak_Djokovic,2,F-II,9,1,1,0,0,5,4
20060922-M-Davis_Cup_World_Group_PO-RR-Roger_Federer-Novak_Djokovic,2,B-XC,36,8,1,4,3,21,15
20060922-M-Davis_Cup_World_Group_PO-RR-Roger_Federer-Novak_Djokovic,2,B-DTM,21,1,0,0,1,8,13
20060922-M-Davis_Cup_World_Group_PO-RR-Roger_Federer-Novak_Djokovic,2,B-DTL,20,8,0,1,7,5,15
20060922-M-Davis_Cup_World_Group_PO-RR-Roger_Federer-Novak_Djokovic,2,B-IO,4,2,0,0,2,0,4
20060922-M-Davis_Cup_World_Group_PO-RR-Roger_Federer-Novak_Djokovic,2,S-XC,4,0,0,0,0,1,3
20060922-M-Davis_Cup_World_Group_PO-RR-Roger_Federer-Novak_Djokovic,2,S-DTM,3,0,0,0,0,0,3
20060922-M-Davis_Cup_World_Group_PO-RR-Roger_Federer-Novak_Djokovic,2,S-DTL,2,0,0,0,0,1,1
20080815-M-Olympics-SF-Novak_Djokovic-Rafael_Nadal,1,F-XC,67,10,1,5,4,36,31
20080815-M-Olympics-SF-Novak_Djokovic-Rafael_Nadal,1,F-DTM,7,1,0,1,0,4,3
20080815-M-Olympics-SF-Novak_Djokovic-Rafael_Nadal,1,F-DTL,19,7,2,3,2,13,6
20080815-M-Olympics-SF-Novak_Djokovic-Rafael_Nadal,1,F-IO,37,10,1,1,8,14,23
20080815-M-Olympics-SF-Novak_Djokovic-Rafael_Nadal,1,F-II,5,1,0,0,1,2,3
20080815-M-Olympics-SF-Novak_Djokovic-Rafael_Nadal,1,B-XC,43,14,3,4,7,18,25
20080815-M-Olympics-SF-Novak_Djokovic-Rafael_Nadal,1,B-DTM,22,1,0,0,1,12,10
20080815-M-Olympics-SF-Novak_Djokovic-Rafael_Nadal,1,B-DTL,29,3,1,1,1,14,15
20080815-M-Olympics-SF-Novak_Djokovic-Rafael_Nadal,1,B-IO,6,0,0,0,0,4,2
20080815-M-Olympics-SF-Novak_Djokovic-Rafael_Nadal,1,S-DTL,5,0,0,0,0,5,0
20080815-M-Olympics-SF-Novak_Djokovic-Rafael_Nadal,1,S-IO,1,1,0,0,1,0,1
20080815-M-Olympics-SF-Novak_Djokovic-Rafael_Nadal,2,F-XC,67,6,1,1,4,39,28
20080815-M-Olympics-SF-Novak_Djokovic-Rafael_Nadal,2,F-DTM,15,0,0,0,0,7,8
20080815-M-Olympics-SF-Novak_Djokovic-Rafael_Nadal,2,F-DTL,21,8,3,1,4,12,9
20080815-M-Olympics-SF-Novak_Djokovic-Rafael_Nadal,2,F-IO,19,6,1,3,2,7,12
20080815-M-Olympics-SF-Novak_Djokovic-Rafael_Nadal,2,F-II,10,2,1,0,1,3,7
20080815-M-Olympics-SF-Novak_Djokovic-Rafael_Nadal,2,B-XC,42,8,1,3,4,19,23
20080815-M-Olympics-SF-Novak_Djokovic-Rafael_Nadal,2,B-DTM,22,3,0,0,3,12,10
20080815-M-Olympics-SF-Novak_Djokovic-Rafael_Nadal,2,B-DTL,13,3,1,1,1,7,6
20080815-M-Olympics-SF-Novak_Djokovic-Rafael_Nadal,2,B-IO,5,0,0,0,0,1,4
20080815-M-Olympics-SF-Novak_Djokovic-Rafael_Nadal,2,S-XC,8,0,0,0,0,3,5
20080815-M-Olympics-SF-Novak_Djokovic-Rafael_Nadal,2,S-DTM,7,1,0,1,0,6,1
20080815-M-Olympics-SF-Novak_Djokovic-Rafael_Nadal,2,S-DTL,7,0,0,0,0,1,6
20131101-M-Paris_Masters-QF-Novak_Djokovic-Stanislas_Wawrinka,1,F-XC,24,5,3,1,1,18,6
20131101-M-Paris_Masters-QF-Novak_Djokovic-Stanislas_Wawrinka,1,F-DTM,13,2,0,0,2,3,10
20131101-M-Paris_Masters-QF-Novak_Djokovic-Stanislas_Wawrinka,1,F-DTL,13,1,0,1,0,7,6
20131101-M-Paris_Masters-QF-Novak_Djokovic-Stanislas_Wawrinka,1,F-IO,26,4,1,1,2,16,10
20131101-M-Paris_Masters-QF-Novak_Djokovic-Stanislas_Wawrinka,1,F-II,5,4,0,3,1,3,2
20131101-M-Paris_Masters-QF-Novak_Djokovic-Stanislas_Wawrinka,1,B-XC,44,5,0,1,4,20,24
20131101-M-Paris_Masters-QF-Novak_Djokovic-Stanislas_Wawrinka,1,B-DTM,18,1,0,0,1,6,12
20131101-M-Paris_Masters-QF-Novak_Djokovic-Stanislas_Wawrinka,1,B-DTL,18,7,1,1,5,9,9
20131101-M-Paris_Masters-QF-Novak_Djokovic-Stanislas_Wawrinka,1,B-IO,4,1,1,0,0,2,2
20131101-M-Paris_Masters-QF-Novak_Djokovic-Stanislas_Wawrinka,1,S-XC,7,0,0,0,0,3,4
20131101-M-Paris_Masters-QF-Novak_Djokovic-Stanislas_Wawrinka,1,S-DTM,1,0,0,0,0,0,1
20131101-M-Paris_Masters-QF-Novak_Djokovic-Stanislas_Wawrinka,1,S-DTL,1,1,0,0,1,0,1
20131101-M-Paris_Masters-QF-Novak_Djokovic-Stanislas_Wawrinka,2,F-XC,37,9,2,0,7,20,17
20131101-M-Paris_Masters-QF-Novak_Djokovic-Stanislas_Wawrinka,2,F-DTM,17,0,0,0,0,7,10
20131101-M-Paris_Masters-QF-Novak_Djokovic-Stanislas_Wawrinka,2,F-DTL,13,3,0,1,2,6,7
20131101-M-Paris_Masters-QF-Novak_Djokovic-Stanislas_Wawrinka,2,F-IO,7,2,0,1,1,4,3
20131101-M-Paris_Masters-QF-Novak_Djokovic-Stanislas_Wawrinka,2,F-II,1,0,0,0,0,1,0
20131101-M-Paris_Masters-QF-Novak_Djokovic-Stanislas_Wawrinka,2,B-XC,42,7,0,2,5,23,19
20131101-M-Paris_Masters-QF-Novak_Djokovic-Stanislas_Wawrinka,2,B-DTM,12,2,0,0,2,5,7
20131101-M-Paris_Masters-QF-Novak_Djokovic-Stanislas_Wawrinka,2,B-DTL,14,7,4,0,3,7,7
20131101-M-Paris_Masters-QF-Novak_Djokovic-Stanislas_Wawrinka,2,B-IO,1,0,0,0,0,1,0
20131101-M-Paris_Masters-QF-Novak_Djokovic-Stanislas_Wawrinka,2,S-XC,21,2,0,0,2,8,13
20131101-M-Paris_Masters-QF-Novak_Djokovic-Stanislas_Wawrinka,2,S-DTM,11,0,0,0,0,1,10
20131101-M-Paris_Masters-QF-Novak_Djokovic-Stanislas_Wawrinka,2,S-DTL,1,1,0,0,1,0,1
20131104-M-Tour_Finals-RR-Richard_Gasquet-Novak_Djokovic,1,F-XC,71,15,2,4,9,33,38
20131104-M-Tour_Finals-RR-Richard_Gasquet-Novak_Djokovic,1,F-DTM,30,1,0,1,0,13,17
20131104-M-Tour_Finals-RR-Richard_Gasquet-Novak_Djokovic,1,F-DTL,19,3,2,0,1,13,6
20131104-M-Tour_Finals-RR-Richard_Gasquet-Novak_Djokovic,1,F-IO,19,3,1,1,1,11,8
20131104-M-Tour_Finals-RR-Richard_Gasquet-Novak_Djokovic,1,B-XC,86,12,1,4,7,53,33
20131104-M-Tour_Finals-RR-Richard_Gasquet-Novak_Djokovic,1,B-DTM,29,3,0,2,1,17,12
20131104-M-Tour_Finals-RR-Richard_Gasquet-Novak_Djokovic,1,B-DTL,14,4,1,0,3,7,7
20131104-M-Tour_Finals-RR-Richard_Gasquet-Novak_Djokovic,1,B-IO,8,2,2,0,0,8,0
20131104-M-Tour_Finals-RR-Richard_Gasquet-Novak_Djokovic,1,S-XC,18,0,0,0,0,11,7
20131104-M-Tour_Finals-RR-Richard_Gasquet-Novak_Djokovic,1,S-DTM,5,1,0,0,1,2,3
20131104-M-Tour_Finals-RR-Richard_Gasquet-Novak_Djokovic,1,S-DTL,1,1,1,0,0,1,0
20131104-M-Tour_Finals-RR-Richard_Gasquet-Novak_Djokovic,2,F-XC,47,12,4,4,4,28,19
20131104-M-Tour_Finals-RR-Richard_Gasquet-Novak_Djokovic,2,F-DTM,35,5,0,0,5,12,23
20131104-M-Tour_Finals-RR-Richard_Gasquet-Novak_Djokovic,2,F-DTL,17,6,2,1,3,8,9
20131104-M-Tour_Finals-RR-Richard_Gasquet-Novak_Djokovic,2,F-IO,34,9,2,4,3,21,13
20131104-M-Tour_Finals-RR-Richard_Gasquet-Novak_Djokovic,2,F-II,2,2,0,1,1,1,1
20131104-M-Tour_Finals-RR-Richard_Gasquet-Novak_Djokovic,2,B-XC,71,12,2,1,9,26,45
20131104-M-Tour_Finals-RR-Richard_Gasquet-Novak_Djokovic,2,B-DTM,33,2,0,0,2,12,21
20131104-M-Tour_Finals-RR-Richard_Gasquet-Novak_Djokovic,2,B-DTL,45,10,1,0,9,16,29
20131104-M-Tour_Finals-RR-Richard_Gasquet-Novak_Djokovic,2,B-IO,14,1,0,1,0,10,4
20131104-M-Tour_Finals-RR-Richard_Gasquet-Novak_Djokovic,2,S-XC,7,0,0,0,0,3,4
20131104-M-Tour_Finals-RR-Richard_Gasquet-Novak_Djokovic,2,S-DTM,3,0,0,0,0,0,3
20131104-M-Tour_Finals-RR-Richard_Gasquet-Novak_Djokovic,2,S-DTL,2,0,0,0,0,1,1
19900610-M-Roland_Garros-F-Andres_Gomez-Andre_Agassi,1,F-XC,95,10,4,0,6,43,52
19900610-M-Roland_Garros-F-Andres_Gomez-Andre_Agassi,1,F-DTM,31,2,0,0,2,10,21
19900610-M-Roland_Garros-F-Andres_Gomez-Andre_Agassi,1,F-DTL,17,11,3,0,8,4,13
19900610-M-Roland_Garros-F-Andres_Gomez-Andre_Agassi,1,F-IO,35,16,6,3,7,20,15
19900610-M-Roland_Garros-F-Andres_Gomez-Andre_Agassi,1,F-II,10,7,1,5,1,8,2
19900610-M-Roland_Garros-F-Andres_Gomez-Andre_Agassi,1,B-XC,39,14,3,6,5,20,19
19900610-M-Roland_Garros-F-Andres_Gomez-Andre_Agassi,1,B-DTM,33,3,0,0,3,15,18
19900610-M-Roland_Garros-F-Andres_Gomez-Andre_Agassi,1,B-DTL,11,5,2,0,3,3,8
19900610-M-Roland_Garros-F-Andres_Gomez-Andre_Agassi,1,B-IO,5,1,0,0,1,1,4
19900610-M-Roland_Garros-F-Andres_Gomez-Andre_Agassi,1,S-XC,17,1,0,0,1,5,12
19900610-M-Roland_Garros-F-Andres_Gomez-Andre_Agassi,1,S-DTM,35,5,0,0,5,7,28
19900610-M-Roland_Garros-F-Andres_Gomez-Andre_Agassi,1,S-DTL,14,1,0,0,1,3,11
19900610-M-Roland_Garros-F-Andres_Gomez-Andre_Agassi,1,S-IO,5,1,1,0,0,2,3
19900610-M-Roland_Garros-F-Andres_Gomez-Andre_Agassi,2,F-XC,92,8,1,3,4,57,35
19900610-M-Roland_Garros-F-Andres_Gomez-Andre_Agassi,2,F-DTM,17,1,0,0,1,12,5
19900610-M-Roland_Garros-F-Andres_Gomez-Andre_Agassi,2,F-DTL,15,6,4,0,2,7,8
19900610-M-Roland_Garros-F-Andres_Gomez-Andre_Agassi,2,F-IO,28,9,4,4,1,21,7
19900610-M-Roland_Garros-F-Andres_Gomez-Andre_Agassi,2,F-II,12,1,0,0,1,9,3
19900610-M-Roland_Garros-F-Andres_Gomez-Andre_Agassi,2,B-XC,76,21,5,11,5,53,23
19900610-M-Roland_Garros-F-Andres_Gomez-Andre_Agassi,2,B-DTM,44,2,0,1,1,19,25
19900610-M-Roland_Garros-F-Andres_Gomez-Andre_Agassi,2,B-DTL,41,5,1,1,3,23,18
19900610-M-Roland_Garros-F-Andres_Gomez-Andre_Agassi,2,B-IO,10,3,1,0,2,6,4
19900610-M-Roland_Garros-F-Andres_Gomez-Andre_Agassi,2,S-XC,2,0,0,0,0,1,1
19900610-M-Roland_Garros-F-Andres_Gomez-Andre_Agassi,2,S-DTM,8,0,0,0,0,3,5
19900610-M-Roland_Garros-F-Andres_Gomez-Andre_Agassi,2,S-DTL,2,0,0,0,0,1,1
19900610-M-Roland_Garros-F-Andres_Gomez-Andre_Agassi,2,S-IO,1,0,0,0,0,1,0
20130517-M-Rome_Masters-SF-Tomas_Berdych-Rafael_Nadal,1,F-XC,32,4,1,1,2,17,15
20130517-M-Rome_Masters-SF-Tomas_Berdych-Rafael_Nadal,1,F-DTM,6,0,0,0,0,3,3
20130517-M-Rome_Masters-SF-Tomas_Berdych-Rafael_Nadal,1,F-DTL,8,4,1,0,3,3,5
20130517-M-Rome_Masters-SF-Tomas_Berdych-Rafael_Nadal,1,F-IO,9,5,2,0,3,3,6
20130517-M-Rome_Masters-SF-Tomas_Berdych-Rafael_Nadal,1,F-II,4,0,0,0,0,2,2
20130517-M-Rome_Masters-SF-Tomas_Berdych-Rafael_Nadal,1,B-XC,31,3,1,1,1,13,18
20130517-M-Rome_Masters-SF-Tomas_Berdych-Rafael_Nadal,1,B-DTM,13,1,0,0,1,4,9
20130517-M-Rome_Masters-SF-Tomas_Berdych-Rafael_Nadal,1,B-DTL,17,6,1,3,2,10,7
20130517-M-Rome_Masters-SF-Tomas_Berdych-Rafael_Nadal,1,B-IO,1,0,0,0,0,0,1
20130517-M-Rome_Masters-SF-Tomas_Berdych-Rafael_Nadal,1,S-XC,3,0,0,0,0,0,3
20130517-M-Rome_Masters-SF-Tomas_Berdych-Rafael_Nadal,1,S-DTM,2,0,0,0,0,0,2
20130517-M-Rome_Masters-SF-Tomas_Berdych-Rafael_Nadal,1,S-DTL,4,0,0,0,0,1,3
20130517-M-Rome_Masters-SF-Tomas_Berdych-Rafael_Nadal,2,F-XC,44,9,2,6,1,33,11
20130517-M-Rome_Masters-SF-Tomas_Berdych-Rafael_Nadal,2,F-DTM,7,1,0,0,1,3,4
20130517-M-Rome_Masters-SF-Tomas_Berdych-Rafael_Nadal,2,F-DTL,12,7,4,2,1,10,2
20130517-M-Rome_Masters-SF-Tomas_Berdych-Rafael_Nadal,2,F-IO,16,7,4,2,1,12,4
20130517-M-Rome_Masters-SF-Tomas_Berdych-Rafael_Nadal,2,F-II,14,6,2,2,2,9,5
20130517-M-Rome_Masters-SF-Tomas_Berdych-Rafael_Nadal,2,B-XC,18,5,3,1,1,9,9
20130517-M-Rome_Masters-SF-Tomas_Berdych-Rafael_Nadal,2,B-DTM,3,0,0,0,0,2,1
20130517-M-Rome_Masters-SF-Tomas_Berdych-Rafael_Nadal,2,B-DTL,11,2,0,0,2,3,8
20130517-M-Rome_Masters-SF-Tomas_Berdych-Rafael_Nadal,2,B-IO,1,0,0,0,0,0,1
20130517-M-Rome_Masters-SF-Tomas_Berdych-Rafael_Nadal,2,S-XC,3,1,1,0,0,2,1
20130517-M-Rome_Masters-SF-Tomas_Berdych-Rafael_Nadal,2,S-DTM,4,0,0,0,0,2,2
20130517-M-Rome_Masters-SF-Tomas_Berdych-Rafael_Nadal,2,S-DTL,4,0,0,0,0,3,1
20130517-M-Rome_Masters-SF-Tomas_Berdych-Rafael_Nadal,2,S-IO,1,0,0,0,0,1,0
20131102-M-Paris_Masters-SF-Novak_Djokovic-Roger_Federer,1,F-XC,46,10,4,2,4,24,22
20131102-M-Paris_Masters-SF-Novak_Djokovic-Roger_Federer,1,F-DTM,16,0,0,0,0,7,9
20131102-M-Paris_Masters-SF-Novak_Djokovic-Roger_Federer,1,F-DTL,15,2,1,0,1,9,6
20131102-M-Paris_Masters-SF-Novak_Djokovic-Roger_Federer,1,F-IO,27,6,3,0,3,16,11
20131102-M-Paris_Masters-SF-Novak_Djokovic-Roger_Federer,1,F-II,9,5,2,3,0,8,1
20131102-M-Paris_Masters-SF-Novak_Djokovic-Roger_Federer,1,B-XC,60,10,0,3,7,29,31
20131102-M-Paris_Masters-SF-Novak_Djokovic-Roger_Federer,1,B-DTM,16,3,0,0,3,5,11
20131102-M-Paris_Masters-SF-Novak_Djokovic-Roger_Federer,1,B-DTL,19,8,1,2,5,7,12
20131102-M-Paris_Masters-SF-Novak_Djokovic-Roger_Federer,1,B-IO,3,1,0,0,1,2,1
20131102-M-Paris_Masters-SF-Novak_Djokovic-Roger_Federer,1,S-XC,7,0,0,0,0,3,4
20131102-M-Paris_Masters-SF-Novak_Djokovic-Roger_Federer,1,S-DTM,1,0,0,0,0,0,1
20131102-M-Paris_Masters-SF-Novak_Djokovic-Roger_Federer,1,S-DTL,4,2,0,0,2,0,4
20131102-M-Paris_Masters-SF-Novak_Djokovic-Roger_Federer,2,F-XC,41,11,2,5,4,27,14
20131102-M-Paris_Masters-SF-Novak_Djokovic-Roger_Federer,2,F-DTM,19,3,0,0,3,9,10
20131102-M-Paris_Masters-SF-Novak_Djokovic-Roger_Federer,2,F-DTL,14,4,1,1,2,8,6
20131102-M-Paris_Masters-SF-Novak_Djokovic-Roger_Federer,2,F-IO,22,7,2,2,3,11,11
20131102-M-Paris_Masters-SF-Novak_Djokovic-Roger_Federer,2,F-II,5,2,1,1,0,3,2
20131102-M-Paris_Masters-SF-Novak_Djokovic-Roger_Federer,2,B-XC,40,6,1,1,4,16,24
20131102-M-Paris_Masters-SF-Novak_Djokovic-Roger_Federer,2,B-DTM,22,4,1,0,3,11,11
20131102-M-Paris_Masters-SF-Novak_Djokovic-Roger_Federer,2,B-DTL,13,4,0,1,3,5,8
20131102-M-Paris_Masters-SF-Novak_Djokovic-Roger_Federer,2,S-XC,24,1,0,0,1,10,14
20131102-M-Paris_Masters-SF-Novak_Djokovic-Roger_Federer,2,S-DTM,3,0,0,0,0,2,1
20131102-M-Paris_Masters-SF-Novak_Djokovic-Roger_Federer,2,S-DTL,3,1,0,1,0,1,2
20110909-M-US_Open-SF-Roger_Federer-Novak_Djokovic,1,F-XC,71,26,6,7,13,34,37
20110909-M-US_Open-SF-Roger_Federer-Novak_Djokovic,1,F-DTM,36,6,0,0,6,9,27
20110909-M-US_Open-SF-Roger_Federer-Novak_Djokovic,1,F-DTL,21,7,3,3,1,11,10
20110909-M-US_Open-SF-Roger_Federer-Novak_Djokovic,1,F-IO,60,22,10,7,5,35,25
20110909-M-US_Open-SF-Roger_Federer-Novak_Djokovic,1,F-II,15,7,4,1,2,10,5
20110909-M-US_Open-SF-Roger_Federer-Novak_Djokovic,1,B-XC,97,14,1,1,12,44,53
20110909-M-US_Open-SF-Roger_Federer-Novak_Djokovic,1,B-DTM,45,4,0,0,4,12,33
20110909-M-US_Open-SF-Roger_Federer-Novak_Djokovic,1,B-DTL,20,11,3,2,6,8,12
20110909-M-US_Open-SF-Roger_Federer-Novak_Djokovic,1,B-IO,1,0,0,0,0,1,0
20110909-M-US_Open-SF-Roger_Federer-Novak_Djokovic,1,S-XC,36,0,0,0,0,17,19
20110909-M-US_Open-SF-Roger_Federer-Novak_Djokovic,1,S-DTM,6,1,0,0,1,0,6
20110909-M-US_Open-SF-Roger_Federer-Novak_Djokovic,1,S-DTL,4,1,0,0,1,2,2
20110909-M-US_Open-SF-Roger_Federer-Novak_Djokovic,1,S-IO,1,0,0,0,0,0,1
20110909-M-US_Open-SF-Roger_Federer-Novak_Djokovic,2,F-XC,74,21,5,8,8,51,23
20110909-M-US_Open-SF-Roger_Federer-Novak_Djokovic,2,F-DTM,29,2,0,0,2,12,17
20110909-M-US_Open-SF-Roger_Federer-Novak_Djokovic,2,F-DTL,17,6,1,3,2,12,5
20110909-M-US_Open-SF-Roger_Federer-Novak_Djokovic,2,F-IO,53,9,9,0,0,39,14
20110909-M-US_Open-SF-Roger_Federer-Novak_Djokovic,2,F-II,12,6,2,0,4,7,5
20110909-M-US_Open-SF-Roger_Federer-Novak_Djokovic,2,B-XC,141,16,3,6,7,83,58
20110909-M-US_Open-SF-Roger_Federer-Novak_Djokovic,2,B-DTM,34,2,0,0,2,14,20
20110909-M-US_Open-SF-Roger_Federer-Novak_Djokovic,2,B-DTL,20,12,4,4,4,14,6
20110909-M-US_Open-SF-Roger_Federer-Novak_Djokovic,2,B-IO,7,3,3,0,0,4,3
20110909-M-US_Open-SF-Roger_Federer-Novak_Djokovic,2,S-XC,3,0,0,0,0,1,2
20110909-M-US_Open-SF-Roger_Federer-Novak_Djokovic,2,S-DTM,1,0,0,0,0,0,1
20110909-M-US_Open-SF-Roger_Federer-Novak_Djokovic,2,S-DTL,1,0,0,0,0,0,1
19990606-M-Roland_Garros-F-Andrei_Medvedev-Andre_Agassi,1,F-XC,74,19,7,6,6,38,36
19990606-M-Roland_Garros-F-Andrei_Medvedev-Andre_Agassi,1,F-DTM,56,5,0,0,5,19,37
19990606-M-Roland_Garros-F-Andrei_Medvedev-Andre_Agassi,1,F-DTL,32,9,3,2,4,16,16
19990606-M-Roland_Garros-F-Andrei_Medvedev-Andre_Agassi,1,F-IO,38,9,2,3,4,23,15
19990606-M-Roland_Garros-F-Andrei_Medvedev-Andre_Agassi,1,F-II,4,3,0,0,3,0,4
19990606-M-Roland_Garros-F-Andrei_Medvedev-Andre_Agassi,1,B-XC,49,5,2,1,2,23,26
19990606-M-Roland_Garros-F-Andrei_Medvedev-Andre_Agassi,1,B-DTM,59,7,0,0,7,17,42
19990606-M-Roland_Garros-F-Andrei_Medvedev-Andre_Agassi,1,B-DTL,33,18,5,2,11,13,20
19990606-M-Roland_Garros-F-Andrei_Medvedev-Andre_Agassi,1,B-IO,5,2,2,0,0,4,1
19990606-M-Roland_Garros-F-Andrei_Medvedev-Andre_Agassi,1,S-XC,15,1,0,0,1,4,11
19990606-M-Roland_Garros-F-Andrei_Medvedev-Andre_Agassi,1,S-DTM,13,2,0,0,2,4,9
19990606-M-Roland_Garros-F-Andrei_Medvedev-Andre_Agassi,1,S-DTL,4,0,0,0,0,2,2
19990606-M-Roland_Garros-F-Andrei_Medvedev-Andre_Agassi,2,F-XC,106,20,7,4,9,63,43
19990606-M-Roland_Garros-F-Andrei_Medvedev-Andre_Agassi,2,F-DTM,49,4,0,0,4,20,29
19990606-M-Roland_Garros-F-Andrei_Medvedev-Andre_Agassi,2,F-DTL,14,4,0,2,2,8,6
19990606-M-Roland_Garros-F-Andrei_Medvedev-Andre_Agassi,2,F-IO,45,9,3,2,4,32,13
19990606-M-Roland_Garros-F-Andrei_Medvedev-Andre_Agassi,2,F-II,8,1,1,0,0,4,4
19990606-M-Roland_Garros-F-Andrei_Medvedev-Andre_Agassi,2,B-XC,78,9,1,1,7,49,29
19990606-M-Roland_Garros-F-Andrei_Medvedev-Andre_Agassi,2,B-DTM,36,3,0,1,2,19,17
19990606-M-Roland_Garros-F-Andrei_Medvedev-Andre_Agassi,2,B-DTL,26,17,9,3,5,16,10
19990606-M-Roland_Garros-F-Andrei_Medvedev-Andre_Agassi,2,B-IO,7,1,0,0,1,4,3
19990606-M-Roland_Garros-F-Andrei_Medvedev-Andre_Agassi,2,S-XC,8,1,1,0,0,3,5
19990606-M-Roland_Garros-F-Andrei_Medvedev-Andre_Agassi,2,S-DTM,7,0,0,0,0,6,1
19990606-M-Roland_Garros-F-Andrei_Medvedev-Andre_Agassi,2,S-DTL,3,1,0,0,1,0,3
20100126-M-Australian_Open-QF-Novak_Djokovic-Jo_Wilfried_Tsonga,1,F-XC,108,27,6,9,12,70,38
20100126-M-Australian_Open-QF-Novak_Djokovic-Jo_Wilfried_Tsonga,1,F-DTM,26,0,0,0,0,13,13
20100126-M-Australian_Open-QF-Novak_Djokovic-Jo_Wilfried_Tsonga,1,F-DTL,39,6,3,1,2,29,10
20100126-M-Australian_Open-QF-Novak_Djokovic-Jo_Wilfried_Tsonga,1,F-IO,71,13,2,6,5,38,33
20100126-M-Australian_Open-QF-Novak_Djokovic-Jo_Wilfried_Tsonga,1,F-II,10,3,1,2,0,7,3
20100126-M-Australian_Open-QF-Novak_Djokovic-Jo_Wilfried_Tsonga,1,B-XC,96,16,3,4,9,56,40
20100126-M-Australian_Open-QF-Novak_Djokovic-Jo_Wilfried_Tsonga,1,B-DTM,28,3,0,1,2,11,17
20100126-M-Australian_Open-QF-Novak_Djokovic-Jo_Wilfried_Tsonga,1,B-DTL,30,14,3,5,6,17,13
20100126-M-Australian_Open-QF-Novak_Djokovic-Jo_Wilfried_Tsonga,1,B-IO,6,4,1,0,3,3,3
20100126-M-Australian_Open-QF-Novak_Djokovic-Jo_Wilfried_Tsonga,1,S-XC,26,0,0,0,0,13,13
20100126-M-Australian_Open-QF-Novak_Djokovic-Jo_Wilfried_Tsonga,1,S-DTM,9,0,0,0,0,6,3
20100126-M-Australian_Open-QF-Novak_Djokovic-Jo_Wilfried_Tsonga,1,S-DTL,4,1,0,1,0,3,1
20100126-M-Australian_Open-QF-Novak_Djokovic-Jo_Wilfried_Tsonga,2,F-XC,111,24,5,7,12,44,67
20100126-M-Australian_Open-QF-Novak_Djokovic-Jo_Wilfried_Tsonga,2,F-DTM,26,2,0,0,2,11,15
20100126-M-Australian_Open-QF-Novak_Djokovic-Jo_Wilfried_Tsonga,2,F-DTL,41,5,2,0,3,19,22
20100126-M-Australian_Open-QF-Novak_Djokovic-Jo_Wilfried_Tsonga,2,F-IO,71,14,3,3,8,39,32
20100126-M-Australian_Open-QF-Novak_Djokovic-Jo_Wilfried_Tsonga,2,F-II,19,6,1,2,3,8,11
20100126-M-Australian_Open-QF-Novak_Djokovic-Jo_Wilfried_Tsonga,2,B-XC,86,13,2,3,8,38,48
20100126-M-Australian_Open-QF-Novak_Djokovic-Jo_Wilfried_Tsonga,2,B-DTM,35,4,0,0,4,16,19
20100126-M-Australian_Open-QF-Novak_Djokovic-Jo_Wilfried_Tsonga,2,B-DTL,28,12,1,4,7,9,19
20100126-M-Australian_Open-QF-Novak_Djokovic-Jo_Wilfried_Tsonga,2,B-IO,4,1,0,1,0,3,1
20100126-M-Australian_Open-QF-Novak_Djokovic-Jo_Wilfried_Tsonga,2,S-XC,25,1,0,0,1,7,18
20100126-M-Australian_Open-QF-Novak_Djokovic-Jo_Wilfried_Tsonga,2,S-DTM,12,1,0,0,1,3,9
20100126-M-Australian_Open-QF-Novak_Djokovic-Jo_Wilfried_Tsonga,2,S-DTL,3,0,0,0,0,1,2
20120510-M-Madrid_Masters-QF-David_Ferrer-Roger_Federer,1,F-XC,28,9,1,2,6,13,15
20120510-M-Madrid_Masters-QF-David_Ferrer-Roger_Federer,1,F-DTM,5,1,1,0,0,2,3
20120510-M-Madrid_Masters-QF-David_Ferrer-Roger_Federer,1,F-DTL,12,2,1,0,1,5,7
20120510-M-Madrid_Masters-QF-David_Ferrer-Roger_Federer,1,F-IO,31,10,2,2,6,19,12
20120510-M-Madrid_Masters-QF-David_Ferrer-Roger_Federer,1,F-II,9,7,3,2,2,6,3
20120510-M-Madrid_Masters-QF-David_Ferrer-Roger_Federer,1,B-XC,25,2,1,0,1,12,13
20120510-M-Madrid_Masters-QF-David_Ferrer-Roger_Federer,1,B-DTM,3,0,0,0,0,1,2
20120510-M-Madrid_Masters-QF-David_Ferrer-Roger_Federer,1,B-DTL,14,6,2,1,3,7,7
20120510-M-Madrid_Masters-QF-David_Ferrer-Roger_Federer,1,B-IO,3,2,1,0,1,1,2
20120510-M-Madrid_Masters-QF-David_Ferrer-Roger_Federer,1,S-XC,2,0,0,0,0,1,1
20120510-M-Madrid_Masters-QF-David_Ferrer-Roger_Federer,1,S-DTL,1,0,0,0,0,0,1
20120510-M-Madrid_Masters-QF-David_Ferrer-Roger_Federer,2,F-XC,19,6,0,4,2,13,6
20120510-M-Madrid_Masters-QF-David_Ferrer-Roger_Federer,2,F-DTM,7,2,0,0,2,3,4
20120510-M-Madrid_Masters-QF-David_Ferrer-Roger_Federer,2,F-DTL,9,5,3,0,2,5,4
20120510-M-Madrid_Masters-QF-David_Ferrer-Roger_Federer,2,F-IO,14,7,2,4,1,10,4
20120510-M-Madrid_Masters-QF-David_Ferrer-Roger_Federer,2,F-II,3,2,0,2,0,3,0
20120510-M-Madrid_Masters-QF-David_Ferrer-Roger_Federer,2,B-XC,18,2,0,1,1,9,9
20120510-M-Madrid_Masters-QF-David_Ferrer-Roger_Federer,2,B-DTM,13,2,0,0,2,6,7
20120510-M-Madrid_Masters-QF-David_Ferrer-Roger_Federer,2,B-DTL,9,1,0,0,1,5,4
20120510-M-Madrid_Masters-QF-David_Ferrer-Roger_Federer,2,S-XC,11,1,0,0,1,5,6
20120510-M-Madrid_Masters-QF-David_Ferrer-Roger_Federer,2,S-DTM,1,0,0,0,0,1,0
20120510-M-Madrid_Masters-QF-David_Ferrer-Roger_Federer,2,S-DTL,3,0,0,0,0,1,2
19930704-M-Wimbledon-F-Jim_Courier-Pete_Sampras,1,F-XC,19,10,4,4,2,11,8
19930704-M-Wimbledon-F-Jim_Courier-Pete_Sampras,1,F-DTM,11,1,0,0,1,5,6
19930704-M-Wimbledon-F-Jim_Courier-Pete_Sampras,1,F-DTL,10,4,3,0,1,4,6
19930704-M-Wimbledon-F-Jim_Courier-Pete_Sampras,1,F-IO,48,10,5,3,2,32,16
19930704-M-Wimbledon-F-Jim_Courier-Pete_Sampras,1,F-II,7,4,1,2,1,4,3
19930704-M-Wimbledon-F-Jim_Courier-Pete_Sampras,1,B-XC,20,3,1,0,2,9,11
19930704-M-Wimbledon-F-Jim_Courier-Pete_Sampras,1,B-DTM,7,0,0,0,0,4,3
19930704-M-Wimbledon-F-Jim_Courier-Pete_Sampras,1,B-DTL,8,6,4,1,1,5,3
19930704-M-Wimbledon-F-Jim_Courier-Pete_Sampras,1,S-XC,11,0,0,0,0,6,5
19930704-M-Wimbledon-F-Jim_Courier-Pete_Sampras,1,S-DTM,4,0,0,0,0,2,2
19930704-M-Wimbledon-F-Jim_Courier-Pete_Sampras,1,S-DTL,3,2,0,0,2,0,3
19930704-M-Wimbledon-F-Jim_Courier-Pete_Sampras,2,F-XC,13,5,2,2,1,9,4
19930704-M-Wimbledon-F-Jim_Courier-Pete_Sampras,2,F-DTM,5,1,0,0,1,2,3
19930704-M-Wimbledon-F-Jim_Courier-Pete_Sampras,2,F-DTL,3,3,1,2,0,3,0
19930704-M-Wimbledon-F-Jim_Courier-Pete_Sampras,2,F-IO,12,3,3,0,0,9,3
19930704-M-Wimbledon-F-Jim_Courier-Pete_Sampras,2,F-II,1,1,1,0,0,1,0
19930704-M-Wimbledon-F-Jim_Courier-Pete_Sampras,2,B-XC,17,6,2,0,4,8,9
19930704-M-Wimbledon-F-Jim_Courier-Pete_Sampras,2,B-DTM,12,2,0,0,2,5,7
19930704-M-Wimbledon-F-Jim_Courier-Pete_Sampras,2,B-DTL,7,4,1,0,3,2,5
19930704-M-Wimbledon-F-Jim_Courier-Pete_Sampras,2,B-IO,1,1,0,0,1,0,1
19930704-M-Wimbledon-F-Jim_Courier-Pete_Sampras,2,S-XC,20,3,1,0,2,7,13
19930704-M-Wimbledon-F-Jim_Courier-Pete_Sampras,2,S-DTM,8,1,0,0,1,4,4
19930704-M-Wimbledon-F-Jim_Courier-Pete_Sampras,2,S-DTL,6,1,0,0,1,2,4
19820704-M-Wimbledon-F-John_Mcenroe-Jimmy_Connors,1,F-XC,35,4,1,0,3,18,17
19820704-M-Wimbledon-F-John_Mcenroe-Jimmy_Connors,1,F-DTM,43,3,0,0,3,20,23
19820704-M-Wimbledon-F-John_Mcenroe-Jimmy_Connors,1,F-DTL,13,5,1,0,4,6,7
19820704-M-Wimbledon-F-John_Mcenroe-Jimmy_Connors,1,F-IO,7,2,0,1,1,4,3
19820704-M-Wimbledon-F-John_Mcenroe-Jimmy_Connors,1,B-XC,26,10,3,2,5,12,14
19820704-M-Wimbledon-F-John_Mcenroe-Jimmy_Connors,1,B-DTM,24,1,0,0,1,8,16
19820704-M-Wimbledon-F-John_Mcenroe-Jimmy_Connors,1,B-DTL,8,4,4,0,0,4,4
19820704-M-Wimbledon-F-John_Mcenroe-Jimmy_Connors,1,B-IO,2,1,0,0,1,1,1
19820704-M-Wimbledon-F-John_Mcenroe-Jimmy_Connors,1,B-II,1,0,0,0,0,0,1
19820704-M-Wimbledon-F-John_Mcenroe-Jimmy_Connors,1,S-XC,5,0,0,0,0,3,2
19820704-M-Wimbledon-F-John_Mcenroe-Jimmy_Connors,1,S-DTM,36,4,0,0,4,15,21
19820704-M-Wimbledon-F-John_Mcenroe-Jimmy_Connors,1,S-DTL,3,1,0,0,1,1,2
19820704-M-Wimbledon-F-John_Mcenroe-Jimmy_Connors,1,S-IO,1,0,0,0,0,0,1
19820704-M-Wimbledon-F-John_Mcenroe-Jimmy_Connors,2,F-XC,52,15,4,2,9,25,27
19820704-M-Wimbledon-F-John_Mcenroe-Jimmy_Connors,2,F-DTM,33,5,1,1,3,14,19
19820704-M-Wimbledon-F-John_Mcenroe-Jimmy_Connors,2,F-DTL,11,4,2,1,1,5,6
19820704-M-Wimbledon-F-John_Mcenroe-Jimmy_Connors,2,F-IO,25,8,2,1,5,14,11
19820704-M-Wimbledon-F-John_Mcenroe-Jimmy_Connors,2,F-II,1,0,0,0,0,1,0
19820704-M-Wimbledon-F-John_Mcenroe-Jimmy_Connors,2,B-XC,49,12,4,2,6,28,21
19820704-M-Wimbledon-F-John_Mcenroe-Jimmy_Connors,2,B-DTM,29,1,0,0,1,13,16
19820704-M-Wimbledon-F-John_Mcenroe-Jimmy_Connors,2,B-DTL,13,3,1,1,1,5,8
19820704-M-Wimbledon-F-John_Mcenroe-Jimmy_Connors,2,B-IO,22,5,0,0,5,7,15
19820704-M-Wimbledon-F-John_Mcenroe-Jimmy_Connors,2,S-XC,9,5,0,3,2,7,2
19820704-M-Wimbledon-F-John_Mcenroe-Jimmy_Connors,2,S-DTM,7,0,0,0,0,2,5
19820704-M-Wimbledon-F-John_Mcenroe-Jimmy_Connors,2,S-DTL,1,0,0,0,0,1,0
19820704-M-Wimbledon-F-John_Mcenroe-Jimmy_Connors,2,S-IO,6,1,1,0,0,6,0
20050508-M-Rome_Masters-F-Rafael_Nadal-Guillermo_Coria,1,F-XC,251,23,8,6,9,132,119
20050508-M-Rome_Masters-F-Rafael_Nadal-Guillermo_Coria,1,F-DTM,37,3,0,0,3,15,22
20050508-M-Rome_Masters-F-Rafael_Nadal-Guillermo_Coria,1,F-DTL,82,30,12,5,13,45,37
20050508-M-Rome_Masters-F-Rafael_Nadal-Guillermo_Coria,1,F-IO,98,22,12,4,6,56,42
20050508-M-Rome_Masters-F-Rafael_Nadal-Guillermo_Coria,1,F-II,58,10,2,4,4,32,26
20050508-M-Rome_Masters-F-Rafael_Nadal-Guillermo_Coria,1,B-XC,153,23,3,4,16,75,78
20050508-M-Rome_Masters-F-Rafael_Nadal-Guillermo_Coria,1,B-DTM,55,7,0,0,7,28,27
20050508-M-Rome_Masters-F-Rafael_Nadal-Guillermo_Coria,1,B-DTL,67,6,2,0,4,30,37
20050508-M-Rome_Masters-F-Rafael_Nadal-Guillermo_Coria,1,B-IO,15,1,1,0,0,9,6
20050508-M-Rome_Masters-F-Rafael_Nadal-Guillermo_Coria,1,S-XC,4,0,0,0,0,2,2
20050508-M-Rome_Masters-F-Rafael_Nadal-Guillermo_Coria,1,S-DTM,10,1,1,0,0,3,7
20050508-M-Rome_Masters-F-Rafael_Nadal-Guillermo_Coria,1,S-DTL,12,2,1,0,1,5,7
20050508-M-Rome_Masters-F-Rafael_Nadal-Guillermo_Coria,1,S-IO,1,0,0,0,0,0,1
20050508-M-Rome_Masters-F-Rafael_Nadal-Guillermo_Coria,2,F-XC,219,24,5,3,16,103,116
20050508-M-Rome_Masters-F-Rafael_Nadal-Guillermo_Coria,2,F-DTM,49,6,1,1,4,23,26
20050508-M-Rome_Masters-F-Rafael_Nadal-Guillermo_Coria,2,F-DTL,65,14,3,5,6,32,33
20050508-M-Rome_Masters-F-Rafael_Nadal-Guillermo_Coria,2,F-IO,82,21,6,7,8,47,35
20050508-M-Rome_Masters-F-Rafael_Nadal-Guillermo_Coria,2,F-II,45,10,3,3,4,27,18
20050508-M-Rome_Masters-F-Rafael_Nadal-Guillermo_Coria,2,B-XC,154,20,6,5,9,73,81
20050508-M-Rome_Masters-F-Rafael_Nadal-Guillermo_Coria,2,B-DTM,84,8,2,0,6,33,51
20050508-M-Rome_Masters-F-Rafael_Nadal-Guillermo_Coria,2,B-DTL,107,16,6,2,8,57,50
20050508-M-Rome_Masters-F-Rafael_Nadal-Guillermo_Coria,2,B-IO,8,2,1,0,1,4,4
20050508-M-Rome_Masters-F-Rafael_Nadal-Guillermo_Coria,2,S-XC,6,0,0,0,0,4,2
20050508-M-Rome_Masters-F-Rafael_Nadal-Guillermo_Coria,2,S-DTM,7,0,0,0,0,2,5
20050508-M-Rome_Masters-F-Rafael_Nadal-Guillermo_Coria,2,S-DTL,7,2,0,0,2,4,3
20120729-M-Olympics-R64-Andy_Murray-Stanislas_Wawrinka,1,F-XC,37,8,2,2,4,26,11
20120729-M-Olympics-R64-Andy_Murray-Stanislas_Wawrinka,1,F-DTM,13,0,0,0,0,8,5
20120729-M-Olympics-R64-Andy_Murray-Stanislas_Wawrinka,1,F-DTL,11,1,0,0,1,7,4
20120729-M-Olympics-R64-Andy_Murray-Stanislas_Wawrinka,1,F-IO,10,3,0,2,1,5,5
20120729-M-Olympics-R64-Andy_Murray-Stanislas_Wawrinka,1,B-XC,22,0,0,0,0,10,12
20120729-M-Olympics-R64-Andy_Murray-Stanislas_Wawrinka,1,B-DTM,17,1,0,1,0,11,6
20120729-M-Olympics-R64-Andy_Murray-Stanislas_Wawrinka,1,B-DTL,9,1,1,0,0,6,3
20120729-M-Olympics-R64-Andy_Murray-Stanislas_Wawrinka,1,B-IO,3,1,0,0,1,1,2
20120729-M-Olympics-R64-Andy_Murray-Stanislas_Wawrinka,1,S-XC,6,0,0,0,0,3,3
20120729-M-Olympics-R64-Andy_Murray-Stanislas_Wawrinka,1,S-DTM,3,1,0,0,1,2,1
20120729-M-Olympics-R64-Andy_Murray-Stanislas_Wawrinka,1,S-DTL,3,1,1,0,0,2,1
20120729-M-Olympics-R64-Andy_Murray-Stanislas_Wawrinka,1,S-IO,2,1,0,1,0,2,0
20120729-M-Olympics-R64-Andy_Murray-Stanislas_Wawrinka,2,F-XC,50,12,1,2,9,14,36
20120729-M-Olympics-R64-Andy_Murray-Stanislas_Wawrinka,2,F-DTM,11,0,0,0,0,4,7
20120729-M-Olympics-R64-Andy_Murray-Stanislas_Wawrinka,2,F-DTL,12,5,1,0,4,2,10
20120729-M-Olympics-R64-Andy_Murray-Stanislas_Wawrinka,2,F-IO,11,2,1,0,1,6,5
20120729-M-Olympics-R64-Andy_Murray-Stanislas_Wawrinka,2,F-II,3,2,0,0,2,0,3
20120729-M-Olympics-R64-Andy_Murray-Stanislas_Wawrinka,2,B-XC,22,4,0,2,2,11,11
20120729-M-Olympics-R64-Andy_Murray-Stanislas_Wawrinka,2,B-DTM,9,3,1,0,2,5,4
20120729-M-Olympics-R64-Andy_Murray-Stanislas_Wawrinka,2,B-DTL,10,2,1,1,0,7,3
20120729-M-Olympics-R64-Andy_Murray-Stanislas_Wawrinka,2,B-IO,5,1,0,0,1,2,3
20120729-M-Olympics-R64-Andy_Murray-Stanislas_Wawrinka,2,S-XC,10,1,0,0,1,5,5
20120729-M-Olympics-R64-Andy_Murray-Stanislas_Wawrinka,2,S-DTM,6,1,0,0,1,1,5
20120729-M-Olympics-R64-Andy_Murray-Stanislas_Wawrinka,2,S-DTL,3,1,0,0,1,1,2
19880704-M-Wimbledon-F-Stefan_Edberg-Boris_Becker,1,F-XC,3,2,1,0,1,1,2
19880704-M-Wimbledon-F-Stefan_Edberg-Boris_Becker,1,F-DTM,5,0,0,0,0,2,3
19880704-M-Wimbledon-F-Stefan_Edberg-Boris_Becker,1,F-DTL,1,0,0,0,0,0,1
19880704-M-Wimbledon-F-Stefan_Edberg-Boris_Becker,1,F-IO,1,0,0,0,0,0,1
19880704-M-Wimbledon-F-Stefan_Edberg-Boris_Becker,1,B-XC,7,7,2,3,2,5,2
19880704-M-Wimbledon-F-Stefan_Edberg-Boris_Becker,1,B-DTM,3,3,1,0,2,1,2
19880704-M-Wimbledon-F-Stefan_Edberg-Boris_Becker,1,B-DTL,5,4,1,2,1,4,1
19880704-M-Wimbledon-F-Stefan_Edberg-Boris_Becker,1,B-IO,5,3,3,0,0,3,2
19880704-M-Wimbledon-F-Stefan_Edberg-Boris_Becker,1,S-XC,1,0,0,0,0,0,1
19880704-M-Wimbledon-F-Stefan_Edberg-Boris_Becker,1,S-DTM,2,0,0,0,0,1,1
19880704-M-Wimbledon-F-Stefan_Edberg-Boris_Becker,2,F-XC,4,2,0,1,1,2,2
19880704-M-Wimbledon-F-Stefan_Edberg-Boris_Becker,2,F-DTM,6,1,0,1,0,1,5
19880704-M-Wimbledon-F-Stefan_Edberg-Boris_Becker,2,F-DTL,4,3,2,1,0,3,1
19880704-M-Wimbledon-F-Stefan_Edberg-Boris_Becker,2,F-IO,5,3,0,2,1,2,3
19880704-M-Wimbledon-F-Stefan_Edberg-Boris_Becker,2,B-XC,6,2,1,0,1,2,4
19880704-M-Wimbledon-F-Stefan_Edberg-Boris_Becker,2,B-DTM,8,2,0,1,1,1,7
19880704-M-Wimbledon-F-Stefan_Edberg-Boris_Becker,2,B-DTL,3,1,0,0,1,1,2
19880704-M-Wimbledon-F-Stefan_Edberg-Boris_Becker,2,B-IO,2,1,0,0,1,0,2
19880704-M-Wimbledon-F-Stefan_Edberg-Boris_Becker,2,S-XC,2,0,0,0,0,0,2
19880704-M-Wimbledon-F-Stefan_Edberg-Boris_Becker,2,S-DTM,2,0,0,0,0,1,1
19880704-M-Wimbledon-F-Stefan_Edberg-Boris_Becker,2,S-DTL,1,0,0,0,0,0,1
19880704-M-Wimbledon-F-Stefan_Edberg-Boris_Becker,2,S-IO,1,1,0,0,1,0,1
19880704-M-Wimbledon-F-Stefan_Edberg-Boris_Becker,2,S-II,1,1,0,1,0,1,0
19880124-M-Australian_Open-F-Pat_Cash-Mats_Wilander,1,F-XC,38,9,2,0,7,15,23
19880124-M-Australian_Open-F-Pat_Cash-Mats_Wilander,1,F-DTM,27,2,1,0,1,11,16
19880124-M-Australian_Open-F-Pat_Cash-Mats_Wilander,1,F-DTL,10,4,1,0,3,3,7
19880124-M-Australian_Open-F-Pat_Cash-Mats_Wilander,1,F-IO,17,4,1,1,2,11,6
19880124-M-Australian_Open-F-Pat_Cash-Mats_Wilander,1,F-II,1,1,0,0,1,0,1
19880124-M-Australian_Open-F-Pat_Cash-Mats_Wilander,1,B-XC,33,8,1,3,4,16,17
19880124-M-Australian_Open-F-Pat_Cash-Mats_Wilander,1,B-DTM,37,3,0,0,3,7,30
19880124-M-Australian_Open-F-Pat_Cash-Mats_Wilander,1,B-DTL,7,4,4,0,0,6,1
19880124-M-Australian_Open-F-Pat_Cash-Mats_Wilander,1,B-IO,4,1,0,0,1,2,2
19880124-M-Australian_Open-F-Pat_Cash-Mats_Wilander,1,S-XC,15,1,0,0,1,6,9
19880124-M-Australian_Open-F-Pat_Cash-Mats_Wilander,1,S-DTM,19,3,0,1,2,8,11
19880124-M-Australian_Open-F-Pat_Cash-Mats_Wilander,1,S-DTL,4,2,0,0,2,0,4
19880124-M-Australian_Open-F-Pat_Cash-Mats_Wilander,1,S-IO,5,2,0,0,2,3,2
19880124-M-Australian_Open-F-Pat_Cash-Mats_Wilander,2,F-XC,41,8,2,4,2,25,16
19880124-M-Australian_Open-F-Pat_Cash-Mats_Wilander,2,F-DTM,51,3,2,0,1,29,22
19880124-M-Australian_Open-F-Pat_Cash-Mats_Wilander,2,F-DTL,28,11,3,4,4,13,15
19880124-M-Australian_Open-F-Pat_Cash-Mats_Wilander,2,F-IO,29,12,3,3,6,14,15
19880124-M-Australian_Open-F-Pat_Cash-Mats_Wilander,2,F-II,1,0,0,0,0,1,0
19880124-M-Australian_Open-F-Pat_Cash-Mats_Wilander,2,B-XC,44,9,2,2,5,21,23
19880124-M-Australian_Open-F-Pat_Cash-Mats_Wilander,2,B-DTM,42,4,0,0,4,18,24
19880124-M-Australian_Open-F-Pat_Cash-Mats_Wilander,2,B-DTL,20,4,2,1,1,10,10
19880124-M-Australian_Open-F-Pat_Cash-Mats_Wilander,2,B-IO,12,4,4,0,0,8,4
19880124-M-Australian_Open-F-Pat_Cash-Mats_Wilander,2,S-XC,17,1,0,0,0,14,3
19880124-M-Australian_Open-F-Pat_Cash-Mats_Wilander,2,S-DTM,5,0,0,0,0,3,2
19880124-M-Australian_Open-F-Pat_Cash-Mats_Wilander,2,S-DTL,2,0,0,0,0,1,1
19880124-M-Australian_Open-F-Pat_Cash-Mats_Wilander,2,S-IO,2,0,0,0,0,1,1
20150130-M-Australian_Open-SF-Novak_Djokovic-Stanislas_Wawrinka,1,F-XC,71,20,5,9,6,42,29
20150130-M-Australian_Open-SF-Novak_Djokovic-Stanislas_Wawrinka,1,F-DTM,56,5,1,0,4,31,25
20150130-M-Australian_Open-SF-Novak_Djokovic-Stanislas_Wawrinka,1,F-DTL,39,11,2,3,6,25,14
20150130-M-Australian_Open-SF-Novak_Djokovic-Stanislas_Wawrinka,1,F-IO,50,9,1,6,2,28,22
20150130-M-Australian_Open-SF-Novak_Djokovic-Stanislas_Wawrinka,1,F-II,3,2,1,1,0,3,0
20150130-M-Australian_Open-SF-Novak_Djokovic-Stanislas_Wawrinka,1,B-XC,103,9,0,3,6,48,55
20150130-M-Australian_Open-SF-Novak_Djokovic-Stanislas_Wawrinka,1,B-DTM,60,4,0,0,4,26,34
20150130-M-Australian_Open-SF-Novak_Djokovic-Stanislas_Wawrinka,1,B-DTL,31,7,1,3,3,18,13
20150130-M-Australian_Open-SF-Novak_Djokovic-Stanislas_Wawrinka,1,B-IO,17,2,0,0,2,9,8
20150130-M-Australian_Open-SF-Novak_Djokovic-Stanislas_Wawrinka,1,S-XC,6,0,0,0,0,3,3
20150130-M-Australian_Open-SF-Novak_Djokovic-Stanislas_Wawrinka,1,S-DTM,7,0,0,0,0,4,3
20150130-M-Australian_Open-SF-Novak_Djokovic-Stanislas_Wawrinka,1,S-DTL,2,0,0,0,0,1,1
20150130-M-Australian_Open-SF-Novak_Djokovic-Stanislas_Wawrinka,1,S-IO,2,0,0,0,0,1,1
20150130-M-Australian_Open-SF-Novak_Djokovic-Stanislas_Wawrinka,2,F-XC,115,21,5,3,13,49,66
20150130-M-Australian_Open-SF-Novak_Djokovic-Stanislas_Wawrinka,2,F-DTM,38,3,1,0,2,13,25
20150130-M-Australian_Open-SF-Novak_Djokovic-Stanislas_Wawrinka,2,F-DTL,35,13,4,3,6,21,14
20150130-M-Australian_Open-SF-Novak_Djokovic-Stanislas_Wawrinka,2,F-IO,38,16,4,3,9,19,19
20150130-M-Australian_Open-SF-Novak_Djokovic-Stanislas_Wawrinka,2,F-II,5,1,0,1,0,3,2
20150130-M-Australian_Open-SF-Novak_Djokovic-Stanislas_Wawrinka,2,B-XC,142,21,0,7,14,74,68
20150130-M-Australian_Open-SF-Novak_Djokovic-Stanislas_Wawrinka,2,B-DTM,51,4,0,1,3,23,28
20150130-M-Australian_Open-SF-Novak_Djokovic-Stanislas_Wawrinka,2,B-DTL,25,13,6,2,5,13,12
20150130-M-Australian_Open-SF-Novak_Djokovic-Stanislas_Wawrinka,2,B-IO,11,5,1,1,3,5,6
20150130-M-Australian_Open-SF-Novak_Djokovic-Stanislas_Wawrinka,2,S-XC,10,1,0,0,1,5,5
20150130-M-Australian_Open-SF-Novak_Djokovic-Stanislas_Wawrinka,2,S-DTM,6,0,0,0,0,0,6
20150130-M-Australian_Open-SF-Novak_Djokovic-Stanislas_Wawrinka,2,S-DTL,2,0,0,0,0,1,1
20160220-M-Marseille-QF-Stanislas_Wawrinka-Benoit_Paire,1,F-XC,48,10,3,5,2,27,21
20160220-M-Marseille-QF-Stanislas_Wawrinka-Benoit_Paire,1,F-DTM,15,4,1,0,3,6,9
20160220-M-Marseille-QF-Stanislas_Wawrinka-Benoit_Paire,1,F-DTL,9,3,2,1,0,8,1
20160220-M-Marseille-QF-Stanislas_Wawrinka-Benoit_Paire,1,F-IO,12,5,1,2,2,7,5
20160220-M-Marseille-QF-Stanislas_Wawrinka-Benoit_Paire,1,F-II,4,1,0,0,1,2,2
20160220-M-Marseille-QF-Stanislas_Wawrinka-Benoit_Paire,1,B-XC,31,5,2,1,2,22,9
20160220-M-Marseille-QF-Stanislas_Wawrinka-Benoit_Paire,1,B-DTM,19,2,0,2,0,15,4
20160220-M-Marseille-QF-Stanislas_Wawrinka-Benoit_Paire,1,B-DTL,12,4,1,0,3,5,7
20160220-M-Marseille-QF-Stanislas_Wawrinka-Benoit_Paire,1,B-IO,4,2,0,1,1,3,1
20160220-M-Marseille-QF-Stanislas_Wawrinka-Benoit_Paire,1,B-II,3,0,0,0,0,2,1
20160220-M-Marseille-QF-Stanislas_Wawrinka-Benoit_Paire,1,S-XC,5,0,0,0,0,2,3
20160220-M-Marseille-QF-Stanislas_Wawrinka-Benoit_Paire,1,S-DTM,3,2,0,0,2,0,3
20160220-M-Marseille-QF-Stanislas_Wawrinka-Benoit_Paire,1,S-DTL,1,0,0,0,0,0,1
20160220-M-Marseille-QF-Stanislas_Wawrinka-Benoit_Paire,1,S-IO,1,0,0,0,0,0,1
20160220-M-Marseille-QF-Stanislas_Wawrinka-Benoit_Paire,2,F-XC,32,9,2,2,5,16,16
20160220-M-Marseille-QF-Stanislas_Wawrinka-Benoit_Paire,2,F-DTM,17,0,0,0,0,7,10
20160220-M-Marseille-QF-Stanislas_Wawrinka-Benoit_Paire,2,F-DTL,14,3,1,1,1,5,9
20160220-M-Marseille-QF-Stanislas_Wawrinka-Benoit_Paire,2,F-IO,8,3,2,0,1,5,3
20160220-M-Marseille-QF-Stanislas_Wawrinka-Benoit_Paire,2,B-XC,41,7,1,2,4,13,28
20160220-M-Marseille-QF-Stanislas_Wawrinka-Benoit_Paire,2,B-DTM,14,3,0,0,3,4,10
20160220-M-Marseille-QF-Stanislas_Wawrinka-Benoit_Paire,2,B-DTL,15,8,2,1,5,5,10
20160220-M-Marseille-QF-Stanislas_Wawrinka-Benoit_Paire,2,B-IO,18,8,5,1,2,11,7
20160220-M-Marseille-QF-Stanislas_Wawrinka-Benoit_Paire,2,B-II,1,0,0,0,0,0,1
20160220-M-Marseille-QF-Stanislas_Wawrinka-Benoit_Paire,2,S-XC,2,1,0,0,1,0,2
20160220-M-Marseille-QF-Stanislas_Wawrinka-Benoit_Paire,2,S-DTM,1,0,0,0,0,0,1
20160220-M-Marseille-QF-Stanislas_Wawrinka-Benoit_Paire,2,S-DTL,1,0,0,0,0,0,1
20160220-M-Marseille-QF-Stanislas_Wawrinka-Benoit_Paire,2,S-IO,2,1,0,0,1,1,1
20120802-M-Olympics-QF-Nicolas_Almagro-Andy_Murray,1,F-XC,27,4,1,2,1,14,13
20120802-M-Olympics-QF-Nicolas_Almagro-Andy_Murray,1,F-DTM,8,0,0,0,0,3,5
20120802-M-Olympics-QF-Nicolas_Almagro-Andy_Murray,1,F-DTL,12,3,1,1,1,7,5
20120802-M-Olympics-QF-Nicolas_Almagro-Andy_Murray,1,F-IO,13,5,1,3,1,6,7
20120802-M-Olympics-QF-Nicolas_Almagro-Andy_Murray,1,F-II,2,0,0,0,0,0,2
20120802-M-Olympics-QF-Nicolas_Almagro-Andy_Murray,1,B-XC,11,3,1,0,2,3,8
20120802-M-Olympics-QF-Nicolas_Almagro-Andy_Murray,1,B-DTM,6,0,0,0,0,4,2
20120802-M-Olympics-QF-Nicolas_Almagro-Andy_Murray,1,B-DTL,3,0,0,0,0,1,2
20120802-M-Olympics-QF-Nicolas_Almagro-Andy_Murray,1,B-IO,1,0,0,0,0,0,1
20120802-M-Olympics-QF-Nicolas_Almagro-Andy_Murray,1,S-XC,2,1,0,0,1,1,1
20120802-M-Olympics-QF-Nicolas_Almagro-Andy_Murray,1,S-DTM,4,2,0,0,2,0,4
20120802-M-Olympics-QF-Nicolas_Almagro-Andy_Murray,1,S-DTL,2,0,0,0,0,0,2
20120802-M-Olympics-QF-Nicolas_Almagro-Andy_Murray,2,F-XC,27,7,6,1,0,20,7
20120802-M-Olympics-QF-Nicolas_Almagro-Andy_Murray,2,F-DTM,5,0,0,0,0,2,3
20120802-M-Olympics-QF-Nicolas_Almagro-Andy_Murray,2,F-DTL,7,4,3,0,1,4,3
20120802-M-Olympics-QF-Nicolas_Almagro-Andy_Murray,2,F-IO,4,2,1,1,0,4,0
20120802-M-Olympics-QF-Nicolas_Almagro-Andy_Murray,2,F-II,1,1,1,0,0,1,0
20120802-M-Olympics-QF-Nicolas_Almagro-Andy_Murray,2,B-XC,13,3,0,1,2,7,6
20120802-M-Olympics-QF-Nicolas_Almagro-Andy_Murray,2,B-DTM,5,0,0,0,0,3,2
20120802-M-Olympics-QF-Nicolas_Almagro-Andy_Murray,2,B-DTL,6,2,0,1,1,3,3
20120802-M-Olympics-QF-Nicolas_Almagro-Andy_Murray,2,B-IO,2,1,0,0,1,0,2
20120802-M-Olympics-QF-Nicolas_Almagro-Andy_Murray,2,S-DTM,7,0,0,0,0,6,1
20030809-M-Canada_Masters-SF-Roger_Federer-Andy_Roddick,1,F-XC,32,6,2,1,3,14,18
20030809-M-Canada_Masters-SF-Roger_Federer-Andy_Roddick,1,F-DTM,16,2,0,0,2,6,10
20030809-M-Canada_Masters-SF-Roger_Federer-Andy_Roddick,1,F-DTL,12,7,5,2,0,12,0
20030809-M-Canada_Masters-SF-Roger_Federer-Andy_Roddick,1,F-IO,29,8,3,2,3,16,13
20030809-M-Canada_Masters-SF-Roger_Federer-Andy_Roddick,1,F-II,6,2,1,1,0,5,1
20030809-M-Canada_Masters-SF-Roger_Federer-Andy_Roddick,1,B-XC,33,7,1,0,6,14,19
20030809-M-Canada_Masters-SF-Roger_Federer-Andy_Roddick,1,B-DTM,12,3,1,0,2,8,4
20030809-M-Canada_Masters-SF-Roger_Federer-Andy_Roddick,1,B-DTL,20,8,4,3,1,13,7
20030809-M-Canada_Masters-SF-Roger_Federer-Andy_Roddick,1,B-IO,2,0,0,0,0,0,2
20030809-M-Canada_Masters-SF-Roger_Federer-Andy_Roddick,1,S-XC,22,2,0,1,1,8,14
20030809-M-Canada_Masters-SF-Roger_Federer-Andy_Roddick,1,S-DTM,10,1,0,0,1,5,5
20030809-M-Canada_Masters-SF-Roger_Federer-Andy_Roddick,1,S-DTL,5,1,1,0,0,5,0
20030809-M-Canada_Masters-SF-Roger_Federer-Andy_Roddick,2,F-XC,33,9,2,1,6,14,19
20030809-M-Canada_Masters-SF-Roger_Federer-Andy_Roddick,2,F-DTM,12,0,0,0,0,8,4
20030809-M-Canada_Masters-SF-Roger_Federer-Andy_Roddick,2,F-DTL,17,6,3,1,2,8,9
20030809-M-Canada_Masters-SF-Roger_Federer-Andy_Roddick,2,F-IO,54,11,2,3,6,28,26
20030809-M-Canada_Masters-SF-Roger_Federer-Andy_Roddick,2,F-II,2,1,0,1,0,2,0
20030809-M-Canada_Masters-SF-Roger_Federer-Andy_Roddick,2,B-XC,44,6,1,0,5,20,24
20030809-M-Canada_Masters-SF-Roger_Federer-Andy_Roddick,2,B-DTM,10,1,1,0,0,6,4
20030809-M-Canada_Masters-SF-Roger_Federer-Andy_Roddick,2,B-DTL,3,0,0,0,0,1,2
20030809-M-Canada_Masters-SF-Roger_Federer-Andy_Roddick,2,S-XC,8,1,0,0,1,4,4
20030809-M-Canada_Masters-SF-Roger_Federer-Andy_Roddick,2,S-DTL,1,0,0,0,0,1,0
20030809-M-Canada_Masters-SF-Roger_Federer-Andy_Roddick,2,S-IO,1,1,1,0,0,1,0
20160528-M-Roland_Garros-R32-Alexander_Zverev-Dominic_Thiem,1,F-XC,48,9,6,1,2,25,23
20160528-M-Roland_Garros-R32-Alexander_Zverev-Dominic_Thiem,1,F-DTM,50,4,0,0,4,18,32
20160528-M-Roland_Garros-R32-Alexander_Zverev-Dominic_Thiem,1,F-DTL,17,5,3,1,1,10,7
20160528-M-Roland_Garros-R32-Alexander_Zverev-Dominic_Thiem,1,F-IO,26,5,2,1,2,14,12
20160528-M-Roland_Garros-R32-Alexander_Zverev-Dominic_Thiem,1,F-II,4,3,2,1,0,3,1
20160528-M-Roland_Garros-R32-Alexander_Zverev-Dominic_Thiem,1,B-XC,110,14,0,5,9,53,57
20160528-M-Roland_Garros-R32-Alexander_Zverev-Dominic_Thiem,1,B-DTM,48,4,0,1,3,20,28
20160528-M-Roland_Garros-R32-Alexander_Zverev-Dominic_Thiem,1,B-DTL,10,2,1,0,1,5,5
20160528-M-Roland_Garros-R32-Alexander_Zverev-Dominic_Thiem,1,B-IO,9,1,1,0,0,2,7
20160528-M-Roland_Garros-R32-Alexander_Zverev-Dominic_Thiem,1,S-XC,9,2,0,0,2,1,8
20160528-M-Roland_Garros-R32-Alexander_Zverev-Dominic_Thiem,1,S-DTM,11,0,0,0,0,2,9
20160528-M-Roland_Garros-R32-Alexander_Zverev-Dominic_Thiem,1,S-DTL,5,1,0,0,1,0,5
20160528-M-Roland_Garros-R32-Alexander_Zverev-Dominic_Thiem,1,S-IO,1,0,0,0,0,0,1
20160528-M-Roland_Garros-R32-Alexander_Zverev-Dominic_Thiem,2,F-XC,79,29,7,12,10,46,33
20160528-M-Roland_Garros-R32-Alexander_Zverev-Dominic_Thiem,2,F-DTM,42,3,1,1,1,28,14
20160528-M-Roland_Garros-R32-Alexander_Zverev-Dominic_Thiem,2,F-DTL,19,7,3,3,1,14,5
20160528-M-Roland_Garros-R32-Alexander_Zverev-Dominic_Thiem,2,F-IO,41,12,5,4,3,29,12
20160528-M-Roland_Garros-R32-Alexander_Zverev-Dominic_Thiem,2,F-II,6,4,0,1,3,3,3
20160528-M-Roland_Garros-R32-Alexander_Zverev-Dominic_Thiem,2,B-XC,36,7,3,1,3,18,18
20160528-M-Roland_Garros-R32-Alexander_Zverev-Dominic_Thiem,2,B-DTM,36,1,0,0,1,19,17
20160528-M-Roland_Garros-R32-Alexander_Zverev-Dominic_Thiem,2,B-DTL,17,7,5,0,2,11,6
20160528-M-Roland_Garros-R32-Alexander_Zverev-Dominic_Thiem,2,B-IO,8,4,2,1,1,5,3
20160528-M-Roland_Garros-R32-Alexander_Zverev-Dominic_Thiem,2,S-XC,52,4,0,0,4,25,27
20160528-M-Roland_Garros-R32-Alexander_Zverev-Dominic_Thiem,2,S-DTM,26,2,0,0,2,13,13
20160528-M-Roland_Garros-R32-Alexander_Zverev-Dominic_Thiem,2,S-DTL,3,1,1,0,0,2,1
19900708-M-Wimbledon-F-Boris_Becker-Stefan_Edberg,1,F-XC,2,1,0,0,1,0,2
19900708-M-Wimbledon-F-Boris_Becker-Stefan_Edberg,1,F-DTM,1,0,0,0,0,1,0
19900708-M-Wimbledon-F-Boris_Becker-Stefan_Edberg,1,F-DTL,1,0,0,0,0,0,1
19900708-M-Wimbledon-F-Boris_Becker-Stefan_Edberg,1,F-IO,1,1,0,0,1,0,1
19900708-M-Wimbledon-F-Boris_Becker-Stefan_Edberg,1,B-XC,6,6,4,1,1,5,1
19900708-M-Wimbledon-F-Boris_Becker-Stefan_Edberg,1,B-DTM,4,2,1,0,1,1,3
19900708-M-Wimbledon-F-Boris_Becker-Stefan_Edberg,1,B-DTL,7,7,4,1,2,5,2
19900708-M-Wimbledon-F-Boris_Becker-Stefan_Edberg,1,S-DTL,1,0,0,0,0,0,1
19900708-M-Wimbledon-F-Boris_Becker-Stefan_Edberg,1,S-IO,1,0,0,0,0,1,0
19900708-M-Wimbledon-F-Boris_Becker-Stefan_Edberg,2,F-XC,3,3,2,0,1,2,1
19900708-M-Wimbledon-F-Boris_Becker-Stefan_Edberg,2,F-DTL,2,2,1,0,1,1,1
19900708-M-Wimbledon-F-Boris_Becker-Stefan_Edberg,2,F-IO,2,1,1,0,0,1,1
19900708-M-Wimbledon-F-Boris_Becker-Stefan_Edberg,2,B-XC,4,1,0,0,1,0,4
19900708-M-Wimbledon-F-Boris_Becker-Stefan_Edberg,2,B-DTM,1,0,0,0,0,0,1
19900708-M-Wimbledon-F-Boris_Becker-Stefan_Edberg,2,B-DTL,5,4,2,0,2,2,3
19900708-M-Wimbledon-F-Boris_Becker-Stefan_Edberg,2,B-IO,3,2,0,1,1,1,2
19941116-M-Tour_Finals-RR-Michael_Chang-Andre_Agassi,1,F-XC,40,5,0,1,4,16,24
19941116-M-Tour_Finals-RR-Michael_Chang-Andre_Agassi,1,F-DTM,9,1,0,0,1,4,5
19941116-M-Tour_Finals-RR-Michael_Chang-Andre_Agassi,1,F-DTL,21,6,3,0,3,12,9
19941116-M-Tour_Finals-RR-Michael_Chang-Andre_Agassi,1,F-IO,9,3,3,0,0,7,2
19941116-M-Tour_Finals-RR-Michael_Chang-Andre_Agassi,1,F-II,5,3,1,1,1,3,2
19941116-M-Tour_Finals-RR-Michael_Chang-Andre_Agassi,1,B-XC,25,11,0,2,9,11,14
19941116-M-Tour_Finals-RR-Michael_Chang-Andre_Agassi,1,B-DTM,16,2,0,0,2,4,12
19941116-M-Tour_Finals-RR-Michael_Chang-Andre_Agassi,1,B-DTL,23,6,0,1,5,9,14
19941116-M-Tour_Finals-RR-Michael_Chang-Andre_Agassi,1,B-IO,4,0,0,0,0,2,2
19941116-M-Tour_Finals-RR-Michael_Chang-Andre_Agassi,1,S-XC,2,0,0,0,0,2,0
19941116-M-Tour_Finals-RR-Michael_Chang-Andre_Agassi,1,S-DTM,1,0,0,0,0,0,1
19941116-M-Tour_Finals-RR-Michael_Chang-Andre_Agassi,1,S-DTL,5,1,0,0,1,2,3
19941116-M-Tour_Finals-RR-Michael_Chang-Andre_Agassi,1,S-IO,1,0,0,0,0,0,1
19941116-M-Tour_Finals-RR-Michael_Chang-Andre_Agassi,2,F-XC,59,9,0,5,4,32,27
19941116-M-Tour_Finals-RR-Michael_Chang-Andre_Agassi,2,F-DTM,10,1,1,0,0,8,2
19941116-M-Tour_Finals-RR-Michael_Chang-Andre_Agassi,2,F-DTL,27,11,3,2,6,13,14
19941116-M-Tour_Finals-RR-Michael_Chang-Andre_Agassi,2,F-IO,14,6,0,2,4,7,7
19941116-M-Tour_Finals-RR-Michael_Chang-Andre_Agassi,2,B-XC,32,8,1,3,4,15,17
19941116-M-Tour_Finals-RR-Michael_Chang-Andre_Agassi,2,B-DTM,7,0,0,0,0,3,4
19941116-M-Tour_Finals-RR-Michael_Chang-Andre_Agassi,2,B-DTL,3,1,1,0,0,1,2
19941116-M-Tour_Finals-RR-Michael_Chang-Andre_Agassi,2,B-IO,1,1,1,0,0,1,0
19941116-M-Tour_Finals-RR-Michael_Chang-Andre_Agassi,2,S-XC,1,0,0,0,0,0,1
19941116-M-Tour_Finals-RR-Michael_Chang-Andre_Agassi,2,S-DTL,2,1,1,0,0,1,1
20040807-M-Cincinnati_Masters-SF-Andy_Roddick-Andre_Agassi,1,F-XC,41,12,5,2,5,15,26
20040807-M-Cincinnati_Masters-SF-Andy_Roddick-Andre_Agassi,1,F-DTM,11,1,1,0,0,2,9
20040807-M-Cincinnati_Masters-SF-Andy_Roddick-Andre_Agassi,1,F-DTL,16,8,3,0,5,6,10
20040807-M-Cincinnati_Masters-SF-Andy_Roddick-Andre_Agassi,1,F-IO,19,8,7,0,1,12,7
20040807-M-Cincinnati_Masters-SF-Andy_Roddick-Andre_Agassi,1,F-II,10,5,1,0,4,2,8
20040807-M-Cincinnati_Masters-SF-Andy_Roddick-Andre_Agassi,1,B-XC,45,4,0,0,4,12,33
20040807-M-Cincinnati_Masters-SF-Andy_Roddick-Andre_Agassi,1,B-DTM,22,1,0,0,1,8,14
20040807-M-Cincinnati_Masters-SF-Andy_Roddick-Andre_Agassi,1,B-DTL,14,10,4,1,5,8,6
20040807-M-Cincinnati_Masters-SF-Andy_Roddick-Andre_Agassi,1,B-IO,8,2,0,0,2,2,6
20040807-M-Cincinnati_Masters-SF-Andy_Roddick-Andre_Agassi,1,S-XC,14,0,0,0,0,3,11
20040807-M-Cincinnati_Masters-SF-Andy_Roddick-Andre_Agassi,1,S-DTM,4,0,0,0,0,1,3
20040807-M-Cincinnati_Masters-SF-Andy_Roddick-Andre_Agassi,1,S-DTL,4,2,0,0,2,0,4
20040807-M-Cincinnati_Masters-SF-Andy_Roddick-Andre_Agassi,2,F-XC,47,10,1,8,1,38,9
20040807-M-Cincinnati_Masters-SF-Andy_Roddick-Andre_Agassi,2,F-DTM,13,2,0,0,2,6,7
20040807-M-Cincinnati_Masters-SF-Andy_Roddick-Andre_Agassi,2,F-DTL,17,5,2,2,1,13,4
20040807-M-Cincinnati_Masters-SF-Andy_Roddick-Andre_Agassi,2,F-IO,28,3,1,0,2,16,12
20040807-M-Cincinnati_Masters-SF-Andy_Roddick-Andre_Agassi,2,F-II,4,3,2,0,1,3,1
20040807-M-Cincinnati_Masters-SF-Andy_Roddick-Andre_Agassi,2,B-XC,67,9,6,1,2,55,12
20040807-M-Cincinnati_Masters-SF-Andy_Roddick-Andre_Agassi,2,B-DTM,12,1,0,0,1,7,5
20040807-M-Cincinnati_Masters-SF-Andy_Roddick-Andre_Agassi,2,B-DTL,9,3,1,1,1,5,4
20040807-M-Cincinnati_Masters-SF-Andy_Roddick-Andre_Agassi,2,B-IO,1,0,0,0,0,1,0
20040807-M-Cincinnati_Masters-SF-Andy_Roddick-Andre_Agassi,2,S-XC,4,0,0,0,0,2,2
20040807-M-Cincinnati_Masters-SF-Andy_Roddick-Andre_Agassi,2,S-DTL,1,0,0,0,0,1,0
19990131-M-Australian_Open-F-Yevgeny_Kafelnikov-Thomas_Enqvist,1,F-XC,69,10,4,1,4,44,25
19990131-M-Australian_Open-F-Yevgeny_Kafelnikov-Thomas_Enqvist,1,F-DTM,36,3,0,0,3,23,13
19990131-M-Australian_Open-F-Yevgeny_Kafelnikov-Thomas_Enqvist,1,F-DTL,26,5,2,0,3,15,11
19990131-M-Australian_Open-F-Yevgeny_Kafelnikov-Thomas_Enqvist,1,F-IO,28,5,2,3,0,17,11
19990131-M-Australian_Open-F-Yevgeny_Kafelnikov-Thomas_Enqvist,1,F-II,2,0,0,0,0,2,0
19990131-M-Australian_Open-F-Yevgeny_Kafelnikov-Thomas_Enqvist,1,B-XC,55,7,1,1,5,30,25
19990131-M-Australian_Open-F-Yevgeny_Kafelnikov-Thomas_Enqvist,1,B-DTM,29,2,0,0,2,16,13
19990131-M-Australian_Open-F-Yevgeny_Kafelnikov-Thomas_Enqvist,1,B-DTL,6,5,1,2,2,4,2
19990131-M-Australian_Open-F-Yevgeny_Kafelnikov-Thomas_Enqvist,1,B-IO,4,0,0,0,0,2,2
19990131-M-Australian_Open-F-Yevgeny_Kafelnikov-Thomas_Enqvist,1,S-XC,31,1,0,0,1,21,10
19990131-M-Australian_Open-F-Yevgeny_Kafelnikov-Thomas_Enqvist,1,S-DTM,23,4,0,0,4,6,17
19990131-M-Australian_Open-F-Yevgeny_Kafelnikov-Thomas_Enqvist,1,S-DTL,3,0,0,0,0,3,0
19990131-M-Australian_Open-F-Yevgeny_Kafelnikov-Thomas_Enqvist,1,S-IO,1,0,0,0,0,1,0
19990131-M-Australian_Open-F-Yevgeny_Kafelnikov-Thomas_Enqvist,2,F-XC,71,22,7,3,12,26,45
19990131-M-Australian_Open-F-Yevgeny_Kafelnikov-Thomas_Enqvist,2,F-DTM,22,6,0,0,6,9,13
19990131-M-Australian_Open-F-Yevgeny_Kafelnikov-Thomas_Enqvist,2,F-DTL,18,10,2,0,8,7,11
19990131-M-Australian_Open-F-Yevgeny_Kafelnikov-Thomas_Enqvist,2,F-IO,21,9,3,3,3,12,9
19990131-M-Australian_Open-F-Yevgeny_Kafelnikov-Thomas_Enqvist,2,F-II,1,0,0,0,0,0,1
19990131-M-Australian_Open-F-Yevgeny_Kafelnikov-Thomas_Enqvist,2,B-XC,76,7,2,1,4,35,41
19990131-M-Australian_Open-F-Yevgeny_Kafelnikov-Thomas_Enqvist,2,B-DTM,49,3,0,1,2,17,32
19990131-M-Australian_Open-F-Yevgeny_Kafelnikov-Thomas_Enqvist,2,B-DTL,36,17,6,2,9,13,23
19990131-M-Australian_Open-F-Yevgeny_Kafelnikov-Thomas_Enqvist,2,B-IO,16,8,2,0,6,6,10
19990131-M-Australian_Open-F-Yevgeny_Kafelnikov-Thomas_Enqvist,2,S-XC,14,2,0,0,2,4,10
19990131-M-Australian_Open-F-Yevgeny_Kafelnikov-Thomas_Enqvist,2,S-DTM,4,0,0,0,0,0,4
19990131-M-Australian_Open-F-Yevgeny_Kafelnikov-Thomas_Enqvist,2,S-DTL,6,3,0,0,3,2,4
20080905-M-US_Open-SF-Rafael_Nadal-Andy_Murray,1,F-XC,101,12,4,2,6,43,58
20080905-M-US_Open-SF-Rafael_Nadal-Andy_Murray,1,F-DTM,44,3,0,0,3,14,30
20080905-M-US_Open-SF-Rafael_Nadal-Andy_Murray,1,F-DTL,34,7,2,1,4,17,17
20080905-M-US_Open-SF-Rafael_Nadal-Andy_Murray,1,F-IO,59,10,4,2,4,33,26
20080905-M-US_Open-SF-Rafael_Nadal-Andy_Murray,1,F-II,21,5,1,1,3,9,12
20080905-M-US_Open-SF-Rafael_Nadal-Andy_Murray,1,B-XC,49,9,0,1,8,20,29
20080905-M-US_Open-SF-Rafael_Nadal-Andy_Murray,1,B-DTM,26,2,0,0,2,7,19
20080905-M-US_Open-SF-Rafael_Nadal-Andy_Murray,1,B-DTL,18,6,3,1,2,12,6
20080905-M-US_Open-SF-Rafael_Nadal-Andy_Murray,1,B-IO,1,0,0,0,0,1,0
20080905-M-US_Open-SF-Rafael_Nadal-Andy_Murray,1,S-XC,8,1,0,0,1,2,6
20080905-M-US_Open-SF-Rafael_Nadal-Andy_Murray,1,S-DTM,7,0,0,0,0,5,2
20080905-M-US_Open-SF-Rafael_Nadal-Andy_Murray,1,S-DTL,6,0,0,0,0,3,3
20080905-M-US_Open-SF-Rafael_Nadal-Andy_Murray,1,S-IO,1,0,0,0,0,1,0
20080905-M-US_Open-SF-Rafael_Nadal-Andy_Murray,2,F-XC,95,16,3,5,8,55,40
20080905-M-US_Open-SF-Rafael_Nadal-Andy_Murray,2,F-DTM,22,6,1,0,5,5,17
20080905-M-US_Open-SF-Rafael_Nadal-Andy_Murray,2,F-DTL,48,18,5,4,9,25,23
20080905-M-US_Open-SF-Rafael_Nadal-Andy_Murray,2,F-IO,40,14,5,2,7,23,17
20080905-M-US_Open-SF-Rafael_Nadal-Andy_Murray,2,F-II,2,2,0,1,1,1,1
20080905-M-US_Open-SF-Rafael_Nadal-Andy_Murray,2,B-XC,50,17,5,2,10,30,20
20080905-M-US_Open-SF-Rafael_Nadal-Andy_Murray,2,B-DTM,25,3,0,2,1,15,10
20080905-M-US_Open-SF-Rafael_Nadal-Andy_Murray,2,B-DTL,29,10,3,3,4,19,10
20080905-M-US_Open-SF-Rafael_Nadal-Andy_Murray,2,B-IO,6,1,0,1,0,5,1
20080905-M-US_Open-SF-Rafael_Nadal-Andy_Murray,2,S-XC,6,0,0,0,0,3,3
20080905-M-US_Open-SF-Rafael_Nadal-Andy_Murray,2,S-DTM,13,3,0,0,3,6,7
20080905-M-US_Open-SF-Rafael_Nadal-Andy_Murray,2,S-DTL,14,2,1,0,1,6,8
20070123-M-Australian_Open-QF-Rafael_Nadal-Fernando_Gonzalez,1,F-XC,94,20,2,9,9,43,51
20070123-M-Australian_Open-QF-Rafael_Nadal-Fernando_Gonzalez,1,F-DTM,9,1,0,1,0,3,6
20070123-M-Australian_Open-QF-Rafael_Nadal-Fernando_Gonzalez,1,F-DTL,19,11,2,3,6,6,13
20070123-M-Australian_Open-QF-Rafael_Nadal-Fernando_Gonzalez,1,F-IO,25,10,3,3,4,17,8
20070123-M-Australian_Open-QF-Rafael_Nadal-Fernando_Gonzalez,1,F-II,22,2,0,1,1,9,13
20070123-M-Australian_Open-QF-Rafael_Nadal-Fernando_Gonzalez,1,B-XC,21,4,1,3,0,11,10
20070123-M-Australian_Open-QF-Rafael_Nadal-Fernando_Gonzalez,1,B-DTM,14,0,0,0,0,7,7
20070123-M-Australian_Open-QF-Rafael_Nadal-Fernando_Gonzalez,1,B-DTL,18,3,0,1,2,10,8
20070123-M-Australian_Open-QF-Rafael_Nadal-Fernando_Gonzalez,1,B-IO,2,1,0,0,1,1,1
20070123-M-Australian_Open-QF-Rafael_Nadal-Fernando_Gonzalez,1,S-XC,3,0,0,0,0,1,2
20070123-M-Australian_Open-QF-Rafael_Nadal-Fernando_Gonzalez,1,S-DTM,1,0,0,0,0,0,1
20070123-M-Australian_Open-QF-Rafael_Nadal-Fernando_Gonzalez,1,S-DTL,2,0,0,0,0,2,0
20070123-M-Australian_Open-QF-Rafael_Nadal-Fernando_Gonzalez,2,F-XC,42,4,2,0,2,24,18
20070123-M-Australian_Open-QF-Rafael_Nadal-Fernando_Gonzalez,2,F-DTM,8,2,0,1,1,5,3
20070123-M-Australian_Open-QF-Rafael_Nadal-Fernando_Gonzalez,2,F-DTL,15,10,3,2,5,9,6
20070123-M-Australian_Open-QF-Rafael_Nadal-Fernando_Gonzalez,2,F-IO,41,19,11,2,6,24,17
20070123-M-Australian_Open-QF-Rafael_Nadal-Fernando_Gonzalez,2,F-II,10,4,1,2,1,7,3
20070123-M-Australian_Open-QF-Rafael_Nadal-Fernando_Gonzalez,2,B-XC,20,7,3,0,4,11,9
20070123-M-Australian_Open-QF-Rafael_Nadal-Fernando_Gonzalez,2,B-DTM,14,0,0,0,0,7,7
20070123-M-Australian_Open-QF-Rafael_Nadal-Fernando_Gonzalez,2,B-DTL,14,6,2,1,3,5,9
20070123-M-Australian_Open-QF-Rafael_Nadal-Fernando_Gonzalez,2,B-IO,1,1,0,1,0,1,0
20070123-M-Australian_Open-QF-Rafael_Nadal-Fernando_Gonzalez,2,S-XC,33,3,0,0,3,19,14
20070123-M-Australian_Open-QF-Rafael_Nadal-Fernando_Gonzalez,2,S-DTM,14,0,0,0,0,9,5
20070123-M-Australian_Open-QF-Rafael_Nadal-Fernando_Gonzalez,2,S-DTL,13,0,0,0,0,6,7
20070123-M-Australian_Open-QF-Rafael_Nadal-Fernando_Gonzalez,2,S-IO,1,0,0,0,0,0,1
19930131-M-Australian_Open-F-Jim_Courier-Stefan_Edberg,1,F-XC,21,9,5,2,2,15,6
19930131-M-Australian_Open-F-Jim_Courier-Stefan_Edberg,1,F-DTM,16,2,0,2,0,9,7
19930131-M-Australian_Open-F-Jim_Courier-Stefan_Edberg,1,F-DTL,6,2,2,0,0,4,2
19930131-M-Australian_Open-F-Jim_Courier-Stefan_Edberg,1,F-IO,19,8,5,0,3,11,8
19930131-M-Australian_Open-F-Jim_Courier-Stefan_Edberg,1,F-II,5,2,2,0,0,3,2
19930131-M-Australian_Open-F-Jim_Courier-Stefan_Edberg,1,B-XC,31,9,4,1,4,18,13
19930131-M-Australian_Open-F-Jim_Courier-Stefan_Edberg,1,B-DTM,12,1,0,0,1,7,5
19930131-M-Australian_Open-F-Jim_Courier-Stefan_Edberg,1,B-DTL,3,2,0,1,1,1,2
19930131-M-Australian_Open-F-Jim_Courier-Stefan_Edberg,1,B-IO,1,0,0,0,0,0,1
19930131-M-Australian_Open-F-Jim_Courier-Stefan_Edberg,1,S-XC,9,1,1,0,0,4,5
19930131-M-Australian_Open-F-Jim_Courier-Stefan_Edberg,1,S-DTM,1,0,0,0,0,0,1
19930131-M-Australian_Open-F-Jim_Courier-Stefan_Edberg,1,S-DTL,2,1,1,0,0,2,0
19930131-M-Australian_Open-F-Jim_Courier-Stefan_Edberg,2,F-XC,13,4,1,0,3,5,8
19930131-M-Australian_Open-F-Jim_Courier-Stefan_Edberg,2,F-DTM,3,0,0,0,0,1,2
19930131-M-Australian_Open-F-Jim_Courier-Stefan_Edberg,2,F-DTL,8,4,1,2,1,6,2
19930131-M-Australian_Open-F-Jim_Courier-Stefan_Edberg,2,F-IO,6,0,0,0,0,2,4
19930131-M-Australian_Open-F-Jim_Courier-Stefan_Edberg,2,B-XC,16,2,0,0,2,8,8
19930131-M-Australian_Open-F-Jim_Courier-Stefan_Edberg,2,B-DTM,9,3,0,0,3,1,8
19930131-M-Australian_Open-F-Jim_Courier-Stefan_Edberg,2,B-DTL,6,4,2,0,2,3,3
19930131-M-Australian_Open-F-Jim_Courier-Stefan_Edberg,2,S-XC,11,2,0,1,1,4,7
19930131-M-Australian_Open-F-Jim_Courier-Stefan_Edberg,2,S-DTM,8,1,0,0,1,2,6
19930131-M-Australian_Open-F-Jim_Courier-Stefan_Edberg,2,S-IO,2,0,0,0,0,0,2
19860907-M-US_Open-F-Miroslav_Mecir-Ivan_Lendl,1,F-XC,39,7,1,1,5,15,24
19860907-M-US_Open-F-Miroslav_Mecir-Ivan_Lendl,1,F-DTM,34,4,0,0,4,11,23
19860907-M-US_Open-F-Miroslav_Mecir-Ivan_Lendl,1,F-DTL,22,8,1,2,5,8,14
19860907-M-US_Open-F-Miroslav_Mecir-Ivan_Lendl,1,F-IO,24,7,1,0,6,11,13
19860907-M-US_Open-F-Miroslav_Mecir-Ivan_Lendl,1,F-II,1,1,0,0,1,0,1
19860907-M-US_Open-F-Miroslav_Mecir-Ivan_Lendl,1,B-XC,96,7,0,3,4,47,49
19860907-M-US_Open-F-Miroslav_Mecir-Ivan_Lendl,1,B-DTM,29,2,0,1,1,11,18
19860907-M-US_Open-F-Miroslav_Mecir-Ivan_Lendl,1,B-DTL,19,9,1,1,7,5,14
19860907-M-US_Open-F-Miroslav_Mecir-Ivan_Lendl,1,B-IO,13,5,1,0,4,3,10
19860907-M-US_Open-F-Miroslav_Mecir-Ivan_Lendl,1,S-XC,5,0,0,0,0,2,3
19860907-M-US_Open-F-Miroslav_Mecir-Ivan_Lendl,1,S-DTM,2,0,0,0,0,0,2
19860907-M-US_Open-F-Miroslav_Mecir-Ivan_Lendl,1,S-DTL,1,0,0,0,0,1,0
19860907-M-US_Open-F-Miroslav_Mecir-Ivan_Lendl,2,F-XC,52,6,4,2,0,39,13
19860907-M-US_Open-F-Miroslav_Mecir-Ivan_Lendl,2,F-DTM,25,3,1,1,1,11,14
19860907-M-US_Open-F-Miroslav_Mecir-Ivan_Lendl,2,F-DTL,13,7,1,1,5,5,8
19860907-M-US_Open-F-Miroslav_Mecir-Ivan_Lendl,2,F-IO,25,5,2,2,1,20,5
19860907-M-US_Open-F-Miroslav_Mecir-Ivan_Lendl,2,B-XC,60,8,2,2,4,34,26
19860907-M-US_Open-F-Miroslav_Mecir-Ivan_Lendl,2,B-DTM,20,2,0,0,2,9,11
19860907-M-US_Open-F-Miroslav_Mecir-Ivan_Lendl,2,B-DTL,17,6,4,2,0,13,4
19860907-M-US_Open-F-Miroslav_Mecir-Ivan_Lendl,2,B-IO,2,2,1,0,1,1,1
19860907-M-US_Open-F-Miroslav_Mecir-Ivan_Lendl,2,S-XC,24,2,0,1,1,13,11
19860907-M-US_Open-F-Miroslav_Mecir-Ivan_Lendl,2,S-DTM,36,4,0,0,4,17,19
19860907-M-US_Open-F-Miroslav_Mecir-Ivan_Lendl,2,S-DTL,3,0,0,0,0,0,3
19860907-M-US_Open-F-Miroslav_Mecir-Ivan_Lendl,2,S-IO,2,1,0,0,1,1,1
20120729-M-Olympics-R64-Jo_Wilfried_Tsonga-Thomaz_Bellucci,1,F-XC,46,9,4,2,3,24,22
20120729-M-Olympics-R64-Jo_Wilfried_Tsonga-Thomaz_Bellucci,1,F-DTM,7,0,0,0,0,2,5
20120729-M-Olympics-R64-Jo_Wilfried_Tsonga-Thomaz_Bellucci,1,F-DTL,9,4,2,2,0,6,3
20120729-M-Olympics-R64-Jo_Wilfried_Tsonga-Thomaz_Bellucci,1,F-IO,14,8,2,3,3,11,3
20120729-M-Olympics-R64-Jo_Wilfried_Tsonga-Thomaz_Bellucci,1,F-II,5,0,0,0,0,4,1
20120729-M-Olympics-R64-Jo_Wilfried_Tsonga-Thomaz_Bellucci,1,B-XC,14,5,0,2,3,7,7
20120729-M-Olympics-R64-Jo_Wilfried_Tsonga-Thomaz_Bellucci,1,B-DTM,16,5,1,0,4,9,7
20120729-M-Olympics-R64-Jo_Wilfried_Tsonga-Thomaz_Bellucci,1,B-DTL,8,3,0,0,3,2,6
20120729-M-Olympics-R64-Jo_Wilfried_Tsonga-Thomaz_Bellucci,1,B-IO,1,0,0,0,0,1,0
20120729-M-Olympics-R64-Jo_Wilfried_Tsonga-Thomaz_Bellucci,1,S-XC,1,1,1,0,0,1,0
20120729-M-Olympics-R64-Jo_Wilfried_Tsonga-Thomaz_Bellucci,1,S-DTM,11,2,0,0,2,4,7
20120729-M-Olympics-R64-Jo_Wilfried_Tsonga-Thomaz_Bellucci,1,S-DTL,13,2,0,0,2,9,4
20120729-M-Olympics-R64-Jo_Wilfried_Tsonga-Thomaz_Bellucci,2,F-XC,41,12,3,4,5,18,23
20120729-M-Olympics-R64-Jo_Wilfried_Tsonga-Thomaz_Bellucci,2,F-DTM,12,3,0,0,3,4,8
20120729-M-Olympics-R64-Jo_Wilfried_Tsonga-Thomaz_Bellucci,2,F-DTL,7,4,2,1,1,6,1
20120729-M-Olympics-R64-Jo_Wilfried_Tsonga-Thomaz_Bellucci,2,F-IO,28,13,3,5,5,16,12
20120729-M-Olympics-R64-Jo_Wilfried_Tsonga-Thomaz_Bellucci,2,F-II,5,1,0,1,0,3,2
20120729-M-Olympics-R64-Jo_Wilfried_Tsonga-Thomaz_Bellucci,2,B-XC,20,2,1,0,1,7,13
20120729-M-Olympics-R64-Jo_Wilfried_Tsonga-Thomaz_Bellucci,2,B-DTM,11,1,0,0,1,5,6
20120729-M-Olympics-R64-Jo_Wilfried_Tsonga-Thomaz_Bellucci,2,B-DTL,14,6,2,1,3,6,8
20120729-M-Olympics-R64-Jo_Wilfried_Tsonga-Thomaz_Bellucci,2,B-IO,1,1,0,1,0,1,0
20120729-M-Olympics-R64-Jo_Wilfried_Tsonga-Thomaz_Bellucci,2,S-XC,2,0,0,0,0,1,1
20120729-M-Olympics-R64-Jo_Wilfried_Tsonga-Thomaz_Bellucci,2,S-DTM,2,0,0,0,0,1,1
20120729-M-Olympics-R64-Jo_Wilfried_Tsonga-Thomaz_Bellucci,2,S-DTL,11,0,0,0,0,5,6
20120729-M-Olympics-R64-Jo_Wilfried_Tsonga-Thomaz_Bellucci,2,S-IO,3,0,0,0,0,2,1
20010128-M-Australian_Open-F-Arnaud_Clement-Andre_Agassi,1,F-XC,33,10,6,0,4,22,11
20010128-M-Australian_Open-F-Arnaud_Clement-Andre_Agassi,1,F-DTM,36,3,0,0,3,18,18
20010128-M-Australian_Open-F-Arnaud_Clement-Andre_Agassi,1,F-DTL,20,6,3,1,2,8,12
20010128-M-Australian_Open-F-Arnaud_Clement-Andre_Agassi,1,F-IO,29,10,6,0,4,18,11
20010128-M-Australian_Open-F-Arnaud_Clement-Andre_Agassi,1,F-II,6,3,0,2,1,3,3
20010128-M-Australian_Open-F-Arnaud_Clement-Andre_Agassi,1,B-XC,89,10,2,0,8,42,47
20010128-M-Australian_Open-F-Arnaud_Clement-Andre_Agassi,1,B-DTM,24,3,0,0,3,10,14
20010128-M-Australian_Open-F-Arnaud_Clement-Andre_Agassi,1,B-DTL,24,12,6,2,4,15,9
20010128-M-Australian_Open-F-Arnaud_Clement-Andre_Agassi,1,B-IO,6,2,0,0,2,2,4
20010128-M-Australian_Open-F-Arnaud_Clement-Andre_Agassi,1,B-II,1,0,0,0,0,1,0
20010128-M-Australian_Open-F-Arnaud_Clement-Andre_Agassi,1,S-XC,3,0,0,0,0,1,2
20010128-M-Australian_Open-F-Arnaud_Clement-Andre_Agassi,1,S-DTM,4,0,0,0,0,1,3
20010128-M-Australian_Open-F-Arnaud_Clement-Andre_Agassi,2,F-XC,48,11,3,3,5,24,24
20010128-M-Australian_Open-F-Arnaud_Clement-Andre_Agassi,2,F-DTM,22,3,0,1,2,8,14
20010128-M-Australian_Open-F-Arnaud_Clement-Andre_Agassi,2,F-DTL,7,1,1,0,0,3,4
20010128-M-Australian_Open-F-Arnaud_Clement-Andre_Agassi,2,F-IO,15,7,2,3,2,8,7
20010128-M-Australian_Open-F-Arnaud_Clement-Andre_Agassi,2,F-II,5,1,0,0,1,3,2
20010128-M-Australian_Open-F-Arnaud_Clement-Andre_Agassi,2,B-XC,113,11,1,3,7,56,57
20010128-M-Australian_Open-F-Arnaud_Clement-Andre_Agassi,2,B-DTM,25,3,0,0,3,10,15
20010128-M-Australian_Open-F-Arnaud_Clement-Andre_Agassi,2,B-DTL,16,5,3,1,1,9,7
20010128-M-Australian_Open-F-Arnaud_Clement-Andre_Agassi,2,B-IO,6,3,0,2,1,4,2
20010128-M-Australian_Open-F-Arnaud_Clement-Andre_Agassi,2,S-XC,11,1,1,0,0,6,5
20160603-M-Roland_Garros-SF-Stanislas_Wawrinka-Andy_Murray,1,F-XC,59,16,3,2,11,28,31
20160603-M-Roland_Garros-SF-Stanislas_Wawrinka-Andy_Murray,1,F-DTM,48,5,2,0,3,23,25
20160603-M-Roland_Garros-SF-Stanislas_Wawrinka-Andy_Murray,1,F-DTL,11,4,1,0,3,3,8
20160603-M-Roland_Garros-SF-Stanislas_Wawrinka-Andy_Murray,1,F-IO,35,15,9,3,3,24,11
20160603-M-Roland_Garros-SF-Stanislas_Wawrinka-Andy_Murray,1,F-II,10,4,0,3,1,6,4
20160603-M-Roland_Garros-SF-Stanislas_Wawrinka-Andy_Murray,1,B-XC,61,4,1,0,3,26,35
20160603-M-Roland_Garros-SF-Stanislas_Wawrinka-Andy_Murray,1,B-DTM,37,2,0,0,2,14,23
20160603-M-Roland_Garros-SF-Stanislas_Wawrinka-Andy_Murray,1,B-DTL,15,3,1,0,2,5,10
20160603-M-Roland_Garros-SF-Stanislas_Wawrinka-Andy_Murray,1,B-IO,11,5,1,1,3,4,7
20160603-M-Roland_Garros-SF-Stanislas_Wawrinka-Andy_Murray,1,S-XC,14,1,0,0,1,5,9
20160603-M-Roland_Garros-SF-Stanislas_Wawrinka-Andy_Murray,1,S-DTM,9,0,0,0,0,3,6
20160603-M-Roland_Garros-SF-Stanislas_Wawrinka-Andy_Murray,1,S-DTL,5,2,0,0,2,1,4
20160603-M-Roland_Garros-SF-Stanislas_Wawrinka-Andy_Murray,1,S-IO,2,1,0,0,1,1,1
20160603-M-Roland_Garros-SF-Stanislas_Wawrinka-Andy_Murray,2,F-XC,71,15,7,4,4,44,27
20160603-M-Roland_Garros-SF-Stanislas_Wawrinka-Andy_Murray,2,F-DTM,45,4,0,2,2,21,24
20160603-M-Roland_Garros-SF-Stanislas_Wawrinka-Andy_Murray,2,F-DTL,31,4,0,2,2,19,12
20160603-M-Roland_Garros-SF-Stanislas_Wawrinka-Andy_Murray,2,F-IO,36,9,1,6,2,23,13
20160603-M-Roland_Garros-SF-Stanislas_Wawrinka-Andy_Murray,2,F-II,1,0,0,0,0,1,0
20160603-M-Roland_Garros-SF-Stanislas_Wawrinka-Andy_Murray,2,B-XC,31,4,2,1,1,21,10
20160603-M-Roland_Garros-SF-Stanislas_Wawrinka-Andy_Murray,2,B-DTM,39,4,1,1,2,23,16
20160603-M-Roland_Garros-SF-Stanislas_Wawrinka-Andy_Murray,2,B-DTL,9,6,3,1,2,5,4
20160603-M-Roland_Garros-SF-Stanislas_Wawrinka-Andy_Murray,2,B-IO,2,1,0,1,0,1,1
20160603-M-Roland_Garros-SF-Stanislas_Wawrinka-Andy_Murray,2,S-XC,15,0,0,0,0,8,7
20160603-M-Roland_Garros-SF-Stanislas_Wawrinka-Andy_Murray,2,S-DTM,24,1,0,0,1,11,13
20160603-M-Roland_Garros-SF-Stanislas_Wawrinka-Andy_Murray,2,S-DTL,2,0,0,0,0,1,1
20160603-M-Roland_Garros-SF-Novak_Djokovic-Dominic_Thiem,1,F-XC,47,8,3,4,1,32,15
20160603-M-Roland_Garros-SF-Novak_Djokovic-Dominic_Thiem,1,F-DTM,35,4,0,2,2,14,21
20160603-M-Roland_Garros-SF-Novak_Djokovic-Dominic_Thiem,1,F-DTL,9,1,1,0,0,7,2
20160603-M-Roland_Garros-SF-Novak_Djokovic-Dominic_Thiem,1,F-IO,32,3,2,0,1,26,6
20160603-M-Roland_Garros-SF-Novak_Djokovic-Dominic_Thiem,1,F-II,3,1,0,1,0,2,1
20160603-M-Roland_Garros-SF-Novak_Djokovic-Dominic_Thiem,1,B-XC,64,9,4,2,3,46,18
20160603-M-Roland_Garros-SF-Novak_Djokovic-Dominic_Thiem,1,B-DTM,30,3,0,0,3,19,11
20160603-M-Roland_Garros-SF-Novak_Djokovic-Dominic_Thiem,1,B-DTL,11,3,0,1,2,8,3
20160603-M-Roland_Garros-SF-Novak_Djokovic-Dominic_Thiem,1,B-IO,8,1,0,1,0,5,3
20160603-M-Roland_Garros-SF-Novak_Djokovic-Dominic_Thiem,1,S-XC,7,0,0,0,0,3,4
20160603-M-Roland_Garros-SF-Novak_Djokovic-Dominic_Thiem,1,S-DTM,5,0,0,0,0,1,4
20160603-M-Roland_Garros-SF-Novak_Djokovic-Dominic_Thiem,1,S-DTL,1,0,0,0,0,1,0
20160603-M-Roland_Garros-SF-Novak_Djokovic-Dominic_Thiem,2,F-XC,59,18,7,4,7,30,29
20160603-M-Roland_Garros-SF-Novak_Djokovic-Dominic_Thiem,2,F-DTM,34,4,0,1,3,10,24
20160603-M-Roland_Garros-SF-Novak_Djokovic-Dominic_Thiem,2,F-DTL,20,7,1,1,5,6,14
20160603-M-Roland_Garros-SF-Novak_Djokovic-Dominic_Thiem,2,F-IO,30,6,2,1,3,13,17
20160603-M-Roland_Garros-SF-Novak_Djokovic-Dominic_Thiem,2,F-II,2,2,0,1,1,1,1
20160603-M-Roland_Garros-SF-Novak_Djokovic-Dominic_Thiem,2,B-XC,45,8,2,0,6,16,29
20160603-M-Roland_Garros-SF-Novak_Djokovic-Dominic_Thiem,2,B-DTM,32,3,0,0,3,9,23
20160603-M-Roland_Garros-SF-Novak_Djokovic-Dominic_Thiem,2,B-DTL,21,14,7,0,7,11,10
20160603-M-Roland_Garros-SF-Novak_Djokovic-Dominic_Thiem,2,B-IO,1,0,0,0,0,1,0
20160603-M-Roland_Garros-SF-Novak_Djokovic-Dominic_Thiem,2,S-XC,19,1,0,0,1,1,18
20160603-M-Roland_Garros-SF-Novak_Djokovic-Dominic_Thiem,2,S-DTM,13,0,0,0,0,4,9
20160603-M-Roland_Garros-SF-Novak_Djokovic-Dominic_Thiem,2,S-DTL,1,0,0,0,0,0,1
20080307-M-Dubai-QF-Igor_Andreev-Novak_Djokovic,1,F-XC,21,4,1,1,2,7,14
20080307-M-Dubai-QF-Igor_Andreev-Novak_Djokovic,1,F-DTM,13,1,0,0,1,3,10
20080307-M-Dubai-QF-Igor_Andreev-Novak_Djokovic,1,F-DTL,5,0,0,0,0,3,2
20080307-M-Dubai-QF-Igor_Andreev-Novak_Djokovic,1,F-IO,20,4,0,0,4,4,16
20080307-M-Dubai-QF-Igor_Andreev-Novak_Djokovic,1,F-II,2,2,1,0,1,1,1
20080307-M-Dubai-QF-Igor_Andreev-Novak_Djokovic,1,B-XC,12,4,0,0,4,3,9
20080307-M-Dubai-QF-Igor_Andreev-Novak_Djokovic,1,B-DTM,10,0,0,0,0,1,9
20080307-M-Dubai-QF-Igor_Andreev-Novak_Djokovic,1,B-DTL,3,2,0,1,1,2,1
20080307-M-Dubai-QF-Igor_Andreev-Novak_Djokovic,1,S-XC,8,1,0,1,0,3,5
20080307-M-Dubai-QF-Igor_Andreev-Novak_Djokovic,1,S-DTM,7,0,0,0,0,0,7
20080307-M-Dubai-QF-Igor_Andreev-Novak_Djokovic,1,S-DTL,2,1,0,0,1,0,2
20080307-M-Dubai-QF-Igor_Andreev-Novak_Djokovic,2,F-XC,21,6,3,3,0,18,3
20080307-M-Dubai-QF-Igor_Andreev-Novak_Djokovic,2,F-DTM,8,0,0,0,0,7,1
20080307-M-Dubai-QF-Igor_Andreev-Novak_Djokovic,2,F-DTL,4,2,1,0,1,2,2
20080307-M-Dubai-QF-Igor_Andreev-Novak_Djokovic,2,F-IO,15,6,1,4,1,12,3
20080307-M-Dubai-QF-Igor_Andreev-Novak_Djokovic,2,F-II,6,1,1,0,0,4,2
20080307-M-Dubai-QF-Igor_Andreev-Novak_Djokovic,2,B-XC,19,1,0,0,1,16,3
20080307-M-Dubai-QF-Igor_Andreev-Novak_Djokovic,2,B-DTM,12,1,0,0,1,6,6
20080307-M-Dubai-QF-Igor_Andreev-Novak_Djokovic,2,B-DTL,5,4,2,1,1,4,1
20080307-M-Dubai-QF-Igor_Andreev-Novak_Djokovic,2,B-IO,5,2,0,1,1,2,3
20080307-M-Dubai-QF-Igor_Andreev-Novak_Djokovic,2,S-XC,2,1,0,0,1,1,1
20080307-M-Dubai-QF-Igor_Andreev-Novak_Djokovic,2,S-DTM,1,0,0,0,0,0,1
20080307-M-Dubai-QF-Igor_Andreev-Novak_Djokovic,2,S-DTL,1,1,0,0,1,0,1
20020127-M-Australian_Open-F-Thomas_Johansson-Marat_Safin,1,F-XC,34,10,2,3,5,18,16
20020127-M-Australian_Open-F-Thomas_Johansson-Marat_Safin,1,F-DTM,33,1,0,0,1,17,16
20020127-M-Australian_Open-F-Thomas_Johansson-Marat_Safin,1,F-DTL,23,4,1,1,2,13,10
20020127-M-Australian_Open-F-Thomas_Johansson-Marat_Safin,1,F-IO,37,5,2,1,2,23,14
20020127-M-Australian_Open-F-Thomas_Johansson-Marat_Safin,1,F-II,1,0,0,0,0,1,0
20020127-M-Australian_Open-F-Thomas_Johansson-Marat_Safin,1,B-XC,68,20,6,5,9,37,31
20020127-M-Australian_Open-F-Thomas_Johansson-Marat_Safin,1,B-DTM,59,4,1,0,3,33,26
20020127-M-Australian_Open-F-Thomas_Johansson-Marat_Safin,1,B-DTL,15,12,5,1,6,7,8
20020127-M-Australian_Open-F-Thomas_Johansson-Marat_Safin,1,B-IO,12,5,1,1,3,7,5
20020127-M-Australian_Open-F-Thomas_Johansson-Marat_Safin,1,S-XC,21,0,0,0,0,8,13
20020127-M-Australian_Open-F-Thomas_Johansson-Marat_Safin,1,S-DTM,12,1,1,0,0,6,6
20020127-M-Australian_Open-F-Thomas_Johansson-Marat_Safin,1,S-DTL,2,1,1,0,0,1,1
20020127-M-Australian_Open-F-Thomas_Johansson-Marat_Safin,2,F-XC,52,5,1,0,4,25,27
20020127-M-Australian_Open-F-Thomas_Johansson-Marat_Safin,2,F-DTM,43,3,0,1,2,14,29
20020127-M-Australian_Open-F-Thomas_Johansson-Marat_Safin,2,F-DTL,8,4,2,0,2,6,2
20020127-M-Australian_Open-F-Thomas_Johansson-Marat_Safin,2,F-IO,13,3,2,0,1,9,4
20020127-M-Australian_Open-F-Thomas_Johansson-Marat_Safin,2,F-II,1,1,0,1,0,1,0
20020127-M-Australian_Open-F-Thomas_Johansson-Marat_Safin,2,B-XC,108,14,3,3,8,51,57
20020127-M-Australian_Open-F-Thomas_Johansson-Marat_Safin,2,B-DTM,60,9,1,0,8,27,33
20020127-M-Australian_Open-F-Thomas_Johansson-Marat_Safin,2,B-DTL,11,9,5,1,3,7,4
20020127-M-Australian_Open-F-Thomas_Johansson-Marat_Safin,2,B-IO,5,0,0,0,0,3,2
20020127-M-Australian_Open-F-Thomas_Johansson-Marat_Safin,2,S-XC,8,1,0,1,0,5,3
20020127-M-Australian_Open-F-Thomas_Johansson-Marat_Safin,2,S-DTM,11,0,0,0,0,5,6
20020127-M-Australian_Open-F-Thomas_Johansson-Marat_Safin,2,S-DTL,6,1,0,1,0,2,4
20020127-M-Australian_Open-F-Thomas_Johansson-Marat_Safin,2,S-IO,1,0,0,0,0,1,0
20120801-M-Olympics-R16-Novak_Djokovic-Lleyton_Hewitt,1,F-XC,41,9,7,0,2,25,16
20120801-M-Olympics-R16-Novak_Djokovic-Lleyton_Hewitt,1,F-DTM,16,3,1,0,2,4,12
20120801-M-Olympics-R16-Novak_Djokovic-Lleyton_Hewitt,1,F-DTL,17,6,2,3,1,11,6
20120801-M-Olympics-R16-Novak_Djokovic-Lleyton_Hewitt,1,F-IO,30,8,1,5,2,19,11
20120801-M-Olympics-R16-Novak_Djokovic-Lleyton_Hewitt,1,F-II,2,0,0,0,0,2,0
20120801-M-Olympics-R16-Novak_Djokovic-Lleyton_Hewitt,1,B-XC,44,5,0,1,4,16,28
20120801-M-Olympics-R16-Novak_Djokovic-Lleyton_Hewitt,1,B-DTM,18,0,0,0,0,7,11
20120801-M-Olympics-R16-Novak_Djokovic-Lleyton_Hewitt,1,B-DTL,24,5,2,0,3,16,8
20120801-M-Olympics-R16-Novak_Djokovic-Lleyton_Hewitt,1,B-IO,6,2,0,1,1,1,5
20120801-M-Olympics-R16-Novak_Djokovic-Lleyton_Hewitt,1,S-XC,14,1,0,0,1,8,6
20120801-M-Olympics-R16-Novak_Djokovic-Lleyton_Hewitt,1,S-DTM,9,0,0,0,0,2,7
20120801-M-Olympics-R16-Novak_Djokovic-Lleyton_Hewitt,1,S-DTL,6,3,1,1,1,5,1
20120801-M-Olympics-R16-Novak_Djokovic-Lleyton_Hewitt,1,S-IO,1,0,0,0,0,1,0
20120801-M-Olympics-R16-Novak_Djokovic-Lleyton_Hewitt,2,F-XC,42,7,1,2,4,22,20
20120801-M-Olympics-R16-Novak_Djokovic-Lleyton_Hewitt,2,F-DTM,29,3,0,0,3,13,16
20120801-M-Olympics-R16-Novak_Djokovic-Lleyton_Hewitt,2,F-DTL,19,3,2,0,1,7,12
20120801-M-Olympics-R16-Novak_Djokovic-Lleyton_Hewitt,2,F-IO,32,4,2,0,2,16,16
20120801-M-Olympics-R16-Novak_Djokovic-Lleyton_Hewitt,2,F-II,1,1,1,0,0,1,0
20120801-M-Olympics-R16-Novak_Djokovic-Lleyton_Hewitt,2,B-XC,66,9,1,2,6,32,34
20120801-M-Olympics-R16-Novak_Djokovic-Lleyton_Hewitt,2,B-DTM,19,2,0,1,1,9,10
20120801-M-Olympics-R16-Novak_Djokovic-Lleyton_Hewitt,2,B-DTL,13,7,6,1,0,12,1
20120801-M-Olympics-R16-Novak_Djokovic-Lleyton_Hewitt,2,B-IO,6,0,0,0,0,3,3
20120801-M-Olympics-R16-Novak_Djokovic-Lleyton_Hewitt,2,S-XC,8,0,0,0,0,4,4
20120801-M-Olympics-R16-Novak_Djokovic-Lleyton_Hewitt,2,S-DTM,2,0,0,0,0,2,0
20120801-M-Olympics-R16-Novak_Djokovic-Lleyton_Hewitt,2,S-DTL,2,0,0,0,0,1,1
20120801-M-Olympics-R16-Novak_Djokovic-Lleyton_Hewitt,2,S-IO,1,0,0,0,0,0,1
20101122-M-Tour_Finals-RR-Robin_Soderling-Andy_Murray,1,F-XC,31,5,0,4,1,24,7
20101122-M-Tour_Finals-RR-Robin_Soderling-Andy_Murray,1,F-DTM,6,0,0,0,0,2,4
20101122-M-Tour_Finals-RR-Robin_Soderling-Andy_Murray,1,F-DTL,14,2,1,0,1,10,4
20101122-M-Tour_Finals-RR-Robin_Soderling-Andy_Murray,1,F-IO,38,10,2,2,6,13,25
20101122-M-Tour_Finals-RR-Robin_Soderling-Andy_Murray,1,F-II,8,4,1,1,2,3,5
20101122-M-Tour_Finals-RR-Robin_Soderling-Andy_Murray,1,B-XC,43,3,0,1,2,19,24
20101122-M-Tour_Finals-RR-Robin_Soderling-Andy_Murray,1,B-DTM,6,1,0,0,1,2,4
20101122-M-Tour_Finals-RR-Robin_Soderling-Andy_Murray,1,B-DTL,6,1,1,0,0,5,1
20101122-M-Tour_Finals-RR-Robin_Soderling-Andy_Murray,1,B-IO,7,1,0,0,1,4,3
20101122-M-Tour_Finals-RR-Robin_Soderling-Andy_Murray,1,S-XC,4,0,0,0,0,2,2
20101122-M-Tour_Finals-RR-Robin_Soderling-Andy_Murray,1,S-DTM,1,0,0,0,0,1,0
20101122-M-Tour_Finals-RR-Robin_Soderling-Andy_Murray,1,S-DTL,1,1,0,0,1,0,1
20101122-M-Tour_Finals-RR-Robin_Soderling-Andy_Murray,2,F-XC,35,9,3,3,3,16,19
20101122-M-Tour_Finals-RR-Robin_Soderling-Andy_Murray,2,F-DTM,8,2,0,1,1,3,5
20101122-M-Tour_Finals-RR-Robin_Soderling-Andy_Murray,2,F-DTL,8,0,0,0,0,1,7
20101122-M-Tour_Finals-RR-Robin_Soderling-Andy_Murray,2,F-IO,10,2,1,0,1,6,4
20101122-M-Tour_Finals-RR-Robin_Soderling-Andy_Murray,2,F-II,2,2,2,0,0,2,0
20101122-M-Tour_Finals-RR-Robin_Soderling-Andy_Murray,2,B-XC,34,3,0,1,2,22,12
20101122-M-Tour_Finals-RR-Robin_Soderling-Andy_Murray,2,B-DTM,11,1,0,1,0,8,3
20101122-M-Tour_Finals-RR-Robin_Soderling-Andy_Murray,2,B-DTL,10,7,4,0,3,5,5
20101122-M-Tour_Finals-RR-Robin_Soderling-Andy_Murray,2,B-IO,3,1,1,0,0,3,0
20101122-M-Tour_Finals-RR-Robin_Soderling-Andy_Murray,2,S-XC,31,0,0,0,0,18,13
20101122-M-Tour_Finals-RR-Robin_Soderling-Andy_Murray,2,S-DTM,11,0,0,0,0,5,6
20101122-M-Tour_Finals-RR-Robin_Soderling-Andy_Murray,2,S-DTL,3,0,0,0,0,0,3
20060318-M-Indian_Wells_Masters-SF-James_Blake-Rafael_Nadal,1,F-XC,56,16,2,7,7,26,30
20060318-M-Indian_Wells_Masters-SF-James_Blake-Rafael_Nadal,1,F-DTM,22,2,0,1,1,9,13
20060318-M-Indian_Wells_Masters-SF-James_Blake-Rafael_Nadal,1,F-DTL,10,4,2,1,1,7,3
20060318-M-Indian_Wells_Masters-SF-James_Blake-Rafael_Nadal,1,F-IO,26,8,4,1,3,18,8
20060318-M-Indian_Wells_Masters-SF-James_Blake-Rafael_Nadal,1,F-II,9,3,0,1,2,3,6
20060318-M-Indian_Wells_Masters-SF-James_Blake-Rafael_Nadal,1,B-XC,43,8,1,1,6,18,25
20060318-M-Indian_Wells_Masters-SF-James_Blake-Rafael_Nadal,1,B-DTM,25,1,0,0,1,8,17
20060318-M-Indian_Wells_Masters-SF-James_Blake-Rafael_Nadal,1,B-DTL,8,1,0,0,1,5,3
20060318-M-Indian_Wells_Masters-SF-James_Blake-Rafael_Nadal,1,B-IO,1,1,0,0,1,0,1
20060318-M-Indian_Wells_Masters-SF-James_Blake-Rafael_Nadal,1,S-XC,1,0,0,0,0,1,0
20060318-M-Indian_Wells_Masters-SF-James_Blake-Rafael_Nadal,1,S-DTM,2,0,0,0,0,0,2
20060318-M-Indian_Wells_Masters-SF-James_Blake-Rafael_Nadal,1,S-DTL,1,0,0,0,0,0,1
20060318-M-Indian_Wells_Masters-SF-James_Blake-Rafael_Nadal,2,F-XC,82,7,3,0,4,44,38
20060318-M-Indian_Wells_Masters-SF-James_Blake-Rafael_Nadal,2,F-DTM,13,0,0,0,0,6,7
20060318-M-Indian_Wells_Masters-SF-James_Blake-Rafael_Nadal,2,F-DTL,11,7,4,0,3,7,4
20060318-M-Indian_Wells_Masters-SF-James_Blake-Rafael_Nadal,2,F-IO,16,3,0,2,1,10,6
20060318-M-Indian_Wells_Masters-SF-James_Blake-Rafael_Nadal,2,F-II,3,1,0,1,0,2,1
20060318-M-Indian_Wells_Masters-SF-James_Blake-Rafael_Nadal,2,B-XC,25,6,0,0,6,12,13
20060318-M-Indian_Wells_Masters-SF-James_Blake-Rafael_Nadal,2,B-DTM,16,1,0,0,1,8,8
20060318-M-Indian_Wells_Masters-SF-James_Blake-Rafael_Nadal,2,B-DTL,23,6,3,0,3,13,10
20060318-M-Indian_Wells_Masters-SF-James_Blake-Rafael_Nadal,2,B-IO,6,1,0,1,0,3,3
20060318-M-Indian_Wells_Masters-SF-James_Blake-Rafael_Nadal,2,S-DTM,4,0,0,0,0,2,2
20060318-M-Indian_Wells_Masters-SF-James_Blake-Rafael_Nadal,2,S-DTL,2,0,0,0,0,1,1
20060318-M-Indian_Wells_Masters-SF-James_Blake-Rafael_Nadal,2,S-IO,2,0,0,0,0,0,2
19800907-M-US_Open-F-John_Mcenroe-Bjorn_Borg,1,F-XC,34,6,2,0,4,17,17
19800907-M-US_Open-F-John_Mcenroe-Bjorn_Borg,1,F-DTM,21,2,0,0,2,10,11
19800907-M-US_Open-F-John_Mcenroe-Bjorn_Borg,1,F-DTL,9,1,1,0,0,3,6
19800907-M-US_Open-F-John_Mcenroe-Bjorn_Borg,1,F-IO,3,1,0,0,1,1,2
19800907-M-US_Open-F-John_Mcenroe-Bjorn_Borg,1,F-II,1,0,0,0,0,0,1
19800907-M-US_Open-F-John_Mcenroe-Bjorn_Borg,1,B-XC,33,10,4,0,6,12,21
19800907-M-US_Open-F-John_Mcenroe-Bjorn_Borg,1,B-DTM,20,1,0,0,1,5,15
19800907-M-US_Open-F-John_Mcenroe-Bjorn_Borg,1,B-DTL,13,3,0,1,2,8,5
19800907-M-US_Open-F-John_Mcenroe-Bjorn_Borg,1,B-IO,5,1,0,0,1,4,1
19800907-M-US_Open-F-John_Mcenroe-Bjorn_Borg,1,S-XC,19,1,0,0,1,10,9
19800907-M-US_Open-F-John_Mcenroe-Bjorn_Borg,1,S-DTM,28,2,0,0,2,13,15
19800907-M-US_Open-F-John_Mcenroe-Bjorn_Borg,1,S-DTL,14,3,0,0,3,7,7
19800907-M-US_Open-F-John_Mcenroe-Bjorn_Borg,1,S-IO,4,0,0,0,0,2,2
19800907-M-US_Open-F-John_Mcenroe-Bjorn_Borg,2,F-XC,79,18,7,6,5,47,32
19800907-M-US_Open-F-John_Mcenroe-Bjorn_Borg,2,F-DTM,23,3,0,1,2,12,11
19800907-M-US_Open-F-John_Mcenroe-Bjorn_Borg,2,F-DTL,17,8,6,0,2,11,6
19800907-M-US_Open-F-John_Mcenroe-Bjorn_Borg,2,F-IO,21,9,3,2,4,11,10
19800907-M-US_Open-F-John_Mcenroe-Bjorn_Borg,2,F-II,7,0,0,0,0,7,0
19800907-M-US_Open-F-John_Mcenroe-Bjorn_Borg,2,B-XC,49,12,6,0,6,24,25
19800907-M-US_Open-F-John_Mcenroe-Bjorn_Borg,2,B-DTM,40,2,0,0,2,19,21
19800907-M-US_Open-F-John_Mcenroe-Bjorn_Borg,2,B-DTL,31,12,5,3,4,15,16
19800907-M-US_Open-F-John_Mcenroe-Bjorn_Borg,2,B-IO,12,3,2,0,1,5,7
19800907-M-US_Open-F-John_Mcenroe-Bjorn_Borg,2,S-XC,3,1,0,0,1,1,2
19800907-M-US_Open-F-John_Mcenroe-Bjorn_Borg,2,S-DTM,5,0,0,0,0,4,1
19800907-M-US_Open-F-John_Mcenroe-Bjorn_Borg,2,S-IO,3,0,0,0,0,1,2
20120801-M-Olympics-R16-Roger_Federer-Denis_Istomin,1,F-XC,31,9,2,2,5,16,15
20120801-M-Olympics-R16-Roger_Federer-Denis_Istomin,1,F-DTM,13,1,0,0,1,10,3
20120801-M-Olympics-R16-Roger_Federer-Denis_Istomin,1,F-DTL,15,3,0,1,2,6,9
20120801-M-Olympics-R16-Roger_Federer-Denis_Istomin,1,F-IO,25,4,0,2,2,16,9
20120801-M-Olympics-R16-Roger_Federer-Denis_Istomin,1,F-II,7,3,3,0,0,4,3
20120801-M-Olympics-R16-Roger_Federer-Denis_Istomin,1,B-XC,18,4,0,1,3,7,11
20120801-M-Olympics-R16-Roger_Federer-Denis_Istomin,1,B-DTM,10,1,0,0,1,7,3
20120801-M-Olympics-R16-Roger_Federer-Denis_Istomin,1,B-DTL,8,4,1,0,3,4,4
20120801-M-Olympics-R16-Roger_Federer-Denis_Istomin,1,B-IO,1,0,0,0,0,0,1
20120801-M-Olympics-R16-Roger_Federer-Denis_Istomin,1,S-XC,9,1,0,0,1,5,4
20120801-M-Olympics-R16-Roger_Federer-Denis_Istomin,1,S-DTM,4,0,0,0,0,2,2
20120801-M-Olympics-R16-Roger_Federer-Denis_Istomin,1,S-DTL,4,2,1,0,1,2,2
20120801-M-Olympics-R16-Roger_Federer-Denis_Istomin,2,F-XC,28,11,0,4,7,12,16
20120801-M-Olympics-R16-Roger_Federer-Denis_Istomin,2,F-DTM,12,2,0,0,2,3,9
20120801-M-Olympics-R16-Roger_Federer-Denis_Istomin,2,F-DTL,8,1,0,1,0,6,2
20120801-M-Olympics-R16-Roger_Federer-Denis_Istomin,2,F-IO,19,1,1,0,0,6,13
20120801-M-Olympics-R16-Roger_Federer-Denis_Istomin,2,F-II,1,1,0,0,1,0,1
20120801-M-Olympics-R16-Roger_Federer-Denis_Istomin,2,B-XC,24,3,0,2,1,14,10
20120801-M-Olympics-R16-Roger_Federer-Denis_Istomin,2,B-DTM,20,2,0,0,2,6,14
20120801-M-Olympics-R16-Roger_Federer-Denis_Istomin,2,B-DTL,20,3,1,0,2,11,9
20120801-M-Olympics-R16-Roger_Federer-Denis_Istomin,2,B-IO,2,0,0,0,0,0,2
20120801-M-Olympics-R16-Roger_Federer-Denis_Istomin,2,S-XC,2,1,0,0,1,0,2
20120801-M-Olympics-R16-Roger_Federer-Denis_Istomin,2,S-DTM,3,0,0,0,0,1,2
20120801-M-Olympics-R16-Roger_Federer-Denis_Istomin,2,S-DTL,2,0,0,0,0,1,1
19820606-M-Roland_Garros-F-Guillermo_Vilas-Mats_Wilander,1,F-XC,167,5,3,0,2,64,103
19820606-M-Roland_Garros-F-Guillermo_Vilas-Mats_Wilander,1,F-DTM,126,0,0,0,0,52,74
19820606-M-Roland_Garros-F-Guillermo_Vilas-Mats_Wilander,1,F-DTL,13,1,1,0,0,4,9
19820606-M-Roland_Garros-F-Guillermo_Vilas-Mats_Wilander,1,F-IO,31,2,0,0,2,10,21
19820606-M-Roland_Garros-F-Guillermo_Vilas-Mats_Wilander,1,F-II,3,0,0,0,0,3,0
19820606-M-Roland_Garros-F-Guillermo_Vilas-Mats_Wilander,1,B-XC,92,1,1,0,0,33,59
19820606-M-Roland_Garros-F-Guillermo_Vilas-Mats_Wilander,1,B-DTM,214,1,0,0,1,78,136
19820606-M-Roland_Garros-F-Guillermo_Vilas-Mats_Wilander,1,B-DTL,43,4,1,1,2,16,27
19820606-M-Roland_Garros-F-Guillermo_Vilas-Mats_Wilander,1,B-IO,11,0,0,0,0,7,4
19820606-M-Roland_Garros-F-Guillermo_Vilas-Mats_Wilander,1,B-II,1,0,0,0,0,1,0
19820606-M-Roland_Garros-F-Guillermo_Vilas-Mats_Wilander,1,S-XC,2,0,0,0,0,1,1
19820606-M-Roland_Garros-F-Guillermo_Vilas-Mats_Wilander,1,S-DTM,6,1,0,0,1,2,4
19820606-M-Roland_Garros-F-Guillermo_Vilas-Mats_Wilander,1,S-DTL,1,0,0,0,0,1,0
19820606-M-Roland_Garros-F-Guillermo_Vilas-Mats_Wilander,2,F-XC,142,5,2,1,2,90,52
19820606-M-Roland_Garros-F-Guillermo_Vilas-Mats_Wilander,2,F-DTM,52,1,0,0,1,31,21
19820606-M-Roland_Garros-F-Guillermo_Vilas-Mats_Wilander,2,F-DTL,13,3,0,0,3,7,6
19820606-M-Roland_Garros-F-Guillermo_Vilas-Mats_Wilander,2,F-IO,27,5,1,1,3,17,10
19820606-M-Roland_Garros-F-Guillermo_Vilas-Mats_Wilander,2,B-XC,134,14,5,3,6,79,55
19820606-M-Roland_Garros-F-Guillermo_Vilas-Mats_Wilander,2,B-DTM,192,1,0,0,1,117,75
19820606-M-Roland_Garros-F-Guillermo_Vilas-Mats_Wilander,2,B-DTL,56,8,2,3,3,35,21
19820606-M-Roland_Garros-F-Guillermo_Vilas-Mats_Wilander,2,B-IO,84,7,3,1,3,56,28
19820606-M-Roland_Garros-F-Guillermo_Vilas-Mats_Wilander,2,S-XC,1,0,0,0,0,1,0
19820606-M-Roland_Garros-F-Guillermo_Vilas-Mats_Wilander,2,S-DTM,4,0,0,0,0,1,3
19820606-M-Roland_Garros-F-Guillermo_Vilas-Mats_Wilander,2,S-IO,1,0,0,0,0,0,1
20131031-M-Paris_Masters-R16-John_Isner-Novak_Djokovic,1,F-XC,21,8,2,0,6,9,12
20131031-M-Paris_Masters-R16-John_Isner-Novak_Djokovic,1,F-DTM,13,2,0,0,2,2,11
20131031-M-Paris_Masters-R16-John_Isner-Novak_Djokovic,1,F-DTL,14,5,0,1,4,3,11
20131031-M-Paris_Masters-R16-John_Isner-Novak_Djokovic,1,F-IO,39,12,4,1,7,18,21
20131031-M-Paris_Masters-R16-John_Isner-Novak_Djokovic,1,F-II,6,4,2,0,2,3,3
20131031-M-Paris_Masters-R16-John_Isner-Novak_Djokovic,1,B-XC,6,2,0,0,2,2,4
20131031-M-Paris_Masters-R16-John_Isner-Novak_Djokovic,1,B-DTM,16,2,0,0,2,4,12
20131031-M-Paris_Masters-R16-John_Isner-Novak_Djokovic,1,B-DTL,6,3,0,0,3,1,5
20131031-M-Paris_Masters-R16-John_Isner-Novak_Djokovic,1,B-IO,2,0,0,0,0,1,1
20131031-M-Paris_Masters-R16-John_Isner-Novak_Djokovic,1,S-XC,21,3,0,0,3,5,16
20131031-M-Paris_Masters-R16-John_Isner-Novak_Djokovic,1,S-DTM,7,0,0,0,0,0,7
20131031-M-Paris_Masters-R16-John_Isner-Novak_Djokovic,2,F-XC,26,9,5,0,4,18,8
20131031-M-Paris_Masters-R16-John_Isner-Novak_Djokovic,2,F-DTM,14,1,1,0,0,8,6
20131031-M-Paris_Masters-R16-John_Isner-Novak_Djokovic,2,F-DTL,8,4,2,0,2,5,3
20131031-M-Paris_Masters-R16-John_Isner-Novak_Djokovic,2,F-IO,16,6,1,2,3,12,4
20131031-M-Paris_Masters-R16-John_Isner-Novak_Djokovic,2,B-XC,30,7,1,3,3,19,11
20131031-M-Paris_Masters-R16-John_Isner-Novak_Djokovic,2,B-DTM,13,1,0,0,1,7,6
20131031-M-Paris_Masters-R16-John_Isner-Novak_Djokovic,2,B-DTL,17,8,3,2,3,13,4
20131031-M-Paris_Masters-R16-John_Isner-Novak_Djokovic,2,B-IO,5,3,2,0,1,3,2
20131031-M-Paris_Masters-R16-John_Isner-Novak_Djokovic,2,S-XC,6,0,0,0,0,4,2
20131031-M-Paris_Masters-R16-John_Isner-Novak_Djokovic,2,S-DTM,1,0,0,0,0,1,0
20131031-M-Paris_Masters-R16-John_Isner-Novak_Djokovic,2,S-DTL,3,1,0,0,1,2,1
19930606-M-Roland_Garros-F-Jim_Courier-Sergi_Bruguera,1,F-XC,63,19,7,4,8,32,31
19930606-M-Roland_Garros-F-Jim_Courier-Sergi_Bruguera,1,F-DTM,32,2,0,0,2,12,20
19930606-M-Roland_Garros-F-Jim_Courier-Sergi_Bruguera,1,F-DTL,11,3,1,1,1,4,7
19930606-M-Roland_Garros-F-Jim_Courier-Sergi_Bruguera,1,F-IO,93,10,3,1,6,46,47
19930606-M-Roland_Garros-F-Jim_Courier-Sergi_Bruguera,1,F-II,19,9,0,5,4,11,8
19930606-M-Roland_Garros-F-Jim_Courier-Sergi_Bruguera,1,B-XC,72,10,0,3,7,22,50
19930606-M-Roland_Garros-F-Jim_Courier-Sergi_Bruguera,1,B-DTM,18,3,0,0,3,5,13
19930606-M-Roland_Garros-F-Jim_Courier-Sergi_Bruguera,1,B-DTL,7,4,1,0,3,4,3
19930606-M-Roland_Garros-F-Jim_Courier-Sergi_Bruguera,1,B-IO,1,0,0,0,0,0,1
19930606-M-Roland_Garros-F-Jim_Courier-Sergi_Bruguera,1,S-XC,10,1,0,0,1,4,6
19930606-M-Roland_Garros-F-Jim_Courier-Sergi_Bruguera,1,S-DTM,5,2,0,0,2,1,4
19930606-M-Roland_Garros-F-Jim_Courier-Sergi_Bruguera,1,S-DTL,3,0,0,0,0,0,3
19930606-M-Roland_Garros-F-Jim_Courier-Sergi_Bruguera,2,F-XC,46,15,6,2,7,28,18
19930606-M-Roland_Garros-F-Jim_Courier-Sergi_Bruguera,2,F-DTM,30,1,0,0,1,15,15
19930606-M-Roland_Garros-F-Jim_Courier-Sergi_Bruguera,2,F-DTL,12,2,1,1,0,7,5
19930606-M-Roland_Garros-F-Jim_Courier-Sergi_Bruguera,2,F-IO,36,8,5,0,3,24,12
19930606-M-Roland_Garros-F-Jim_Courier-Sergi_Bruguera,2,F-II,11,4,3,0,1,7,4
19930606-M-Roland_Garros-F-Jim_Courier-Sergi_Bruguera,2,B-XC,111,7,4,0,3,72,39
19930606-M-Roland_Garros-F-Jim_Courier-Sergi_Bruguera,2,B-DTM,34,2,0,0,2,14,20
19930606-M-Roland_Garros-F-Jim_Courier-Sergi_Bruguera,2,B-DTL,31,15,5,4,6,22,9
19930606-M-Roland_Garros-F-Jim_Courier-Sergi_Bruguera,2,B-IO,2,1,0,1,0,2,0
19930606-M-Roland_Garros-F-Jim_Courier-Sergi_Bruguera,2,S-XC,14,4,0,2,2,8,6
19930606-M-Roland_Garros-F-Jim_Courier-Sergi_Bruguera,2,S-DTM,5,0,0,0,0,1,4
19930606-M-Roland_Garros-F-Jim_Courier-Sergi_Bruguera,2,S-DTL,5,1,0,0,1,2,3
19940911-M-US_Open-F-Michael_Stich-Andre_Agassi,1,F-XC,19,2,1,0,1,7,12
19940911-M-US_Open-F-Michael_Stich-Andre_Agassi,1,F-DTM,19,2,0,0,2,5,14
19940911-M-US_Open-F-Michael_Stich-Andre_Agassi,1,F-DTL,3,0,0,0,0,1,2
19940911-M-US_Open-F-Michael_Stich-Andre_Agassi,1,F-IO,6,1,0,0,1,1,5
19940911-M-US_Open-F-Michael_Stich-Andre_Agassi,1,B-XC,12,5,1,0,4,3,9
19940911-M-US_Open-F-Michael_Stich-Andre_Agassi,1,B-DTM,28,6,0,0,6,9,19
19940911-M-US_Open-F-Michael_Stich-Andre_Agassi,1,B-DTL,8,4,0,1,3,3,5
19940911-M-US_Open-F-Michael_Stich-Andre_Agassi,1,B-IO,1,0,0,0,0,0,1
19940911-M-US_Open-F-Michael_Stich-Andre_Agassi,1,S-XC,22,1,0,0,1,7,15
19940911-M-US_Open-F-Michael_Stich-Andre_Agassi,1,S-DTM,13,3,0,0,3,4,9
19940911-M-US_Open-F-Michael_Stich-Andre_Agassi,1,S-DTL,3,1,0,0,1,0,3
19940911-M-US_Open-F-Michael_Stich-Andre_Agassi,1,S-IO,1,0,0,0,0,0,1
19940911-M-US_Open-F-Michael_Stich-Andre_Agassi,2,F-XC,37,10,2,6,2,25,12
19940911-M-US_Open-F-Michael_Stich-Andre_Agassi,2,F-DTM,30,2,0,1,1,20,10
19940911-M-US_Open-F-Michael_Stich-Andre_Agassi,2,F-DTL,20,8,3,1,4,13,7
19940911-M-US_Open-F-Michael_Stich-Andre_Agassi,2,F-IO,33,6,2,3,1,25,8
19940911-M-US_Open-F-Michael_Stich-Andre_Agassi,2,F-II,2,0,0,0,0,0,2
19940911-M-US_Open-F-Michael_Stich-Andre_Agassi,2,B-XC,38,10,2,3,5,23,15
19940911-M-US_Open-F-Michael_Stich-Andre_Agassi,2,B-DTM,15,2,0,2,0,11,4
19940911-M-US_Open-F-Michael_Stich-Andre_Agassi,2,B-DTL,6,2,0,0,2,1,5
19940911-M-US_Open-F-Michael_Stich-Andre_Agassi,2,B-IO,5,2,1,0,1,3,2
19940911-M-US_Open-F-Michael_Stich-Andre_Agassi,2,S-XC,2,0,0,0,0,1,1
19940911-M-US_Open-F-Michael_Stich-Andre_Agassi,2,S-DTM,1,0,0,0,0,1,0
20030608-M-Roland_Garros-F-Martin_Verkerk-Juan_Carlos_Ferrero,1,F-XC,33,7,3,0,4,12,21
20030608-M-Roland_Garros-F-Martin_Verkerk-Juan_Carlos_Ferrero,1,F-DTM,45,8,0,0,8,7,38
20030608-M-Roland_Garros-F-Martin_Verkerk-Juan_Carlos_Ferrero,1,F-DTL,12,2,0,0,2,5,7
20030608-M-Roland_Garros-F-Martin_Verkerk-Juan_Carlos_Ferrero,1,F-IO,41,8,3,2,3,13,28
20030608-M-Roland_Garros-F-Martin_Verkerk-Juan_Carlos_Ferrero,1,F-II,2,1,0,0,1,0,2
20030608-M-Roland_Garros-F-Martin_Verkerk-Juan_Carlos_Ferrero,1,B-XC,33,3,0,1,2,9,24
20030608-M-Roland_Garros-F-Martin_Verkerk-Juan_Carlos_Ferrero,1,B-DTM,41,2,0,0,2,13,28
20030608-M-Roland_Garros-F-Martin_Verkerk-Juan_Carlos_Ferrero,1,B-DTL,6,3,2,0,1,3,3
20030608-M-Roland_Garros-F-Martin_Verkerk-Juan_Carlos_Ferrero,1,B-IO,7,4,0,1,3,4,3
20030608-M-Roland_Garros-F-Martin_Verkerk-Juan_Carlos_Ferrero,1,S-XC,19,1,0,0,1,9,10
20030608-M-Roland_Garros-F-Martin_Verkerk-Juan_Carlos_Ferrero,1,S-DTM,8,2,0,0,2,2,6
20030608-M-Roland_Garros-F-Martin_Verkerk-Juan_Carlos_Ferrero,2,F-XC,51,14,9,2,3,40,11
20030608-M-Roland_Garros-F-Martin_Verkerk-Juan_Carlos_Ferrero,2,F-DTM,34,3,0,1,2,25,9
20030608-M-Roland_Garros-F-Martin_Verkerk-Juan_Carlos_Ferrero,2,F-DTL,12,4,2,0,2,8,4
20030608-M-Roland_Garros-F-Martin_Verkerk-Juan_Carlos_Ferrero,2,F-IO,36,8,3,3,2,22,14
20030608-M-Roland_Garros-F-Martin_Verkerk-Juan_Carlos_Ferrero,2,F-II,5,1,1,0,0,2,3
20030608-M-Roland_Garros-F-Martin_Verkerk-Juan_Carlos_Ferrero,2,B-XC,40,4,1,0,3,26,14
20030608-M-Roland_Garros-F-Martin_Verkerk-Juan_Carlos_Ferrero,2,B-DTM,43,2,0,2,0,31,12
20030608-M-Roland_Garros-F-Martin_Verkerk-Juan_Carlos_Ferrero,2,B-DTL,17,5,3,2,0,12,5
20030608-M-Roland_Garros-F-Martin_Verkerk-Juan_Carlos_Ferrero,2,B-IO,5,1,1,0,0,4,1
20030608-M-Roland_Garros-F-Martin_Verkerk-Juan_Carlos_Ferrero,2,S-XC,1,0,0,0,0,1,0
20030608-M-Roland_Garros-F-Martin_Verkerk-Juan_Carlos_Ferrero,2,S-DTM,1,0,0,0,0,1,0
20030608-M-Roland_Garros-F-Martin_Verkerk-Juan_Carlos_Ferrero,2,S-DTL,2,0,0,0,0,2,0
20060305-M-Dubai-F-Roger_Federer-Rafael_Nadal,1,F-XC,62,11,3,1,7,38,24
20060305-M-Dubai-F-Roger_Federer-Rafael_Nadal,1,F-DTM,15,3,0,0,3,7,8
20060305-M-Dubai-F-Roger_Federer-Rafael_Nadal,1,F-DTL,15,9,6,2,1,11,4
20060305-M-Dubai-F-Roger_Federer-Rafael_Nadal,1,F-IO,30,10,3,3,4,19,11
20060305-M-Dubai-F-Roger_Federer-Rafael_Nadal,1,F-II,7,1,0,0,1,3,4
20060305-M-Dubai-F-Roger_Federer-Rafael_Nadal,1,B-XC,27,9,2,0,7,17,10
20060305-M-Dubai-F-Roger_Federer-Rafael_Nadal,1,B-DTM,21,2,0,0,2,8,13
20060305-M-Dubai-F-Roger_Federer-Rafael_Nadal,1,B-DTL,32,3,0,0,3,13,19
20060305-M-Dubai-F-Roger_Federer-Rafael_Nadal,1,B-IO,1,0,0,0,0,1,0
20060305-M-Dubai-F-Roger_Federer-Rafael_Nadal,1,S-XC,10,0,0,0,0,7,3
20060305-M-Dubai-F-Roger_Federer-Rafael_Nadal,1,S-DTM,4,0,0,0,0,1,3
20060305-M-Dubai-F-Roger_Federer-Rafael_Nadal,1,S-DTL,21,1,0,0,1,14,7
20060305-M-Dubai-F-Roger_Federer-Rafael_Nadal,1,S-IO,5,0,0,0,0,4,1
20060305-M-Dubai-F-Roger_Federer-Rafael_Nadal,2,F-XC,81,11,3,5,3,43,38
20060305-M-Dubai-F-Roger_Federer-Rafael_Nadal,2,F-DTM,13,1,0,0,1,5,8
20060305-M-Dubai-F-Roger_Federer-Rafael_Nadal,2,F-DTL,14,4,1,1,2,5,9
20060305-M-Dubai-F-Roger_Federer-Rafael_Nadal,2,F-IO,15,5,1,3,1,7,8
20060305-M-Dubai-F-Roger_Federer-Rafael_Nadal,2,F-II,10,2,0,2,0,8,2
20060305-M-Dubai-F-Roger_Federer-Rafael_Nadal,2,B-XC,53,9,2,2,5,23,30
20060305-M-Dubai-F-Roger_Federer-Rafael_Nadal,2,B-DTM,29,3,0,0,3,10,19
20060305-M-Dubai-F-Roger_Federer-Rafael_Nadal,2,B-DTL,37,7,3,1,3,14,23
20060305-M-Dubai-F-Roger_Federer-Rafael_Nadal,2,B-IO,6,0,0,0,0,2,4
20060305-M-Dubai-F-Roger_Federer-Rafael_Nadal,2,S-XC,1,0,0,0,0,0,1
20060305-M-Dubai-F-Roger_Federer-Rafael_Nadal,2,S-DTM,5,0,0,0,0,1,4
20060305-M-Dubai-F-Roger_Federer-Rafael_Nadal,2,S-DTL,3,0,0,0,0,2,1
19970706-M-Wimbledon-F-Cedric_Pioline-Pete_Sampras,1,F-XC,2,1,1,0,0,2,0
19970706-M-Wimbledon-F-Cedric_Pioline-Pete_Sampras,1,F-DTM,2,0,0,0,0,0,2
19970706-M-Wimbledon-F-Cedric_Pioline-Pete_Sampras,1,F-DTL,1,0,0,0,0,0,1
19970706-M-Wimbledon-F-Cedric_Pioline-Pete_Sampras,1,F-IO,1,0,0,0,0,0,1
19970706-M-Wimbledon-F-Cedric_Pioline-Pete_Sampras,1,B-XC,2,1,1,0,0,1,1
19970706-M-Wimbledon-F-Cedric_Pioline-Pete_Sampras,1,B-DTM,4,2,1,0,1,2,2
19970706-M-Wimbledon-F-Cedric_Pioline-Pete_Sampras,1,B-DTL,3,3,1,0,2,1,2
19970706-M-Wimbledon-F-Cedric_Pioline-Pete_Sampras,1,S-DTL,1,0,0,0,0,0,1
19970706-M-Wimbledon-F-Cedric_Pioline-Pete_Sampras,2,F-DTM,1,0,0,0,0,0,1
19970706-M-Wimbledon-F-Cedric_Pioline-Pete_Sampras,2,F-DTL,4,2,2,0,0,4,0
19970706-M-Wimbledon-F-Cedric_Pioline-Pete_Sampras,2,F-IO,4,4,2,1,1,3,1
19970706-M-Wimbledon-F-Cedric_Pioline-Pete_Sampras,2,B-XC,1,1,0,0,1,0,1
19970706-M-Wimbledon-F-Cedric_Pioline-Pete_Sampras,2,B-DTM,1,0,0,0,0,1,0
19970706-M-Wimbledon-F-Cedric_Pioline-Pete_Sampras,2,B-DTL,3,3,2,0,1,2,1
19970706-M-Wimbledon-F-Cedric_Pioline-Pete_Sampras,2,S-XC,1,0,0,0,0,1,0
20120805-M-Olympics-BR-Novak_Djokovic-Juan_Martin_Del_Potro,1,F-XC,39,9,5,1,3,20,19
20120805-M-Olympics-BR-Novak_Djokovic-Juan_Martin_Del_Potro,1,F-DTM,16,1,0,0,1,6,10
20120805-M-Olympics-BR-Novak_Djokovic-Juan_Martin_Del_Potro,1,F-DTL,15,4,3,1,0,11,4
20120805-M-Olympics-BR-Novak_Djokovic-Juan_Martin_Del_Potro,1,F-IO,20,6,2,1,3,13,7
20120805-M-Olympics-BR-Novak_Djokovic-Juan_Martin_Del_Potro,1,F-II,4,3,2,0,1,3,1
20120805-M-Olympics-BR-Novak_Djokovic-Juan_Martin_Del_Potro,1,B-XC,41,1,0,0,1,23,18
20120805-M-Olympics-BR-Novak_Djokovic-Juan_Martin_Del_Potro,1,B-DTM,17,0,0,0,0,11,6
20120805-M-Olympics-BR-Novak_Djokovic-Juan_Martin_Del_Potro,1,B-DTL,22,7,1,1,5,10,12
20120805-M-Olympics-BR-Novak_Djokovic-Juan_Martin_Del_Potro,1,B-IO,3,1,0,0,1,1,2
20120805-M-Olympics-BR-Novak_Djokovic-Juan_Martin_Del_Potro,1,S-XC,5,0,0,0,0,3,2
20120805-M-Olympics-BR-Novak_Djokovic-Juan_Martin_Del_Potro,1,S-DTM,1,0,0,0,0,0,1
20120805-M-Olympics-BR-Novak_Djokovic-Juan_Martin_Del_Potro,1,S-DTL,4,1,0,0,1,2,2
20120805-M-Olympics-BR-Novak_Djokovic-Juan_Martin_Del_Potro,2,F-XC,49,19,8,7,4,30,19
20120805-M-Olympics-BR-Novak_Djokovic-Juan_Martin_Del_Potro,2,F-DTM,16,2,1,0,1,8,8
20120805-M-Olympics-BR-Novak_Djokovic-Juan_Martin_Del_Potro,2,F-DTL,14,6,3,0,3,7,7
20120805-M-Olympics-BR-Novak_Djokovic-Juan_Martin_Del_Potro,2,F-IO,25,3,2,0,1,10,15
20120805-M-Olympics-BR-Novak_Djokovic-Juan_Martin_Del_Potro,2,F-II,2,1,0,1,0,1,1
20120805-M-Olympics-BR-Novak_Djokovic-Juan_Martin_Del_Potro,2,B-XC,59,4,0,1,3,28,31
20120805-M-Olympics-BR-Novak_Djokovic-Juan_Martin_Del_Potro,2,B-DTM,20,2,0,0,2,6,14
20120805-M-Olympics-BR-Novak_Djokovic-Juan_Martin_Del_Potro,2,B-DTL,7,1,0,1,0,6,1
20120805-M-Olympics-BR-Novak_Djokovic-Juan_Martin_Del_Potro,2,B-IO,1,0,0,0,0,0,1
20120805-M-Olympics-BR-Novak_Djokovic-Juan_Martin_Del_Potro,2,S-XC,9,0,0,0,0,3,6
20120805-M-Olympics-BR-Novak_Djokovic-Juan_Martin_Del_Potro,2,S-DTM,1,0,0,0,0,0,1
20120805-M-Olympics-BR-Novak_Djokovic-Juan_Martin_Del_Potro,2,S-DTL,2,0,0,0,0,1,1
20101121-M-Tour_Finals-RR-Tomas_Berdych-Novak_Djokovic,1,F-XC,50,5,1,2,2,24,26
20101121-M-Tour_Finals-RR-Tomas_Berdych-Novak_Djokovic,1,F-DTM,16,1,0,0,1,5,11
20101121-M-Tour_Finals-RR-Tomas_Berdych-Novak_Djokovic,1,F-DTL,11,0,0,0,0,3,8
20101121-M-Tour_Finals-RR-Tomas_Berdych-Novak_Djokovic,1,F-IO,21,6,0,0,6,5,16
20101121-M-Tour_Finals-RR-Tomas_Berdych-Novak_Djokovic,1,F-II,7,5,2,0,3,3,4
20101121-M-Tour_Finals-RR-Tomas_Berdych-Novak_Djokovic,1,B-XC,44,5,0,0,5,17,27
20101121-M-Tour_Finals-RR-Tomas_Berdych-Novak_Djokovic,1,B-DTM,13,0,0,0,0,5,8
20101121-M-Tour_Finals-RR-Tomas_Berdych-Novak_Djokovic,1,B-DTL,10,3,0,0,3,3,7
20101121-M-Tour_Finals-RR-Tomas_Berdych-Novak_Djokovic,1,B-IO,4,2,0,1,1,3,1
20101121-M-Tour_Finals-RR-Tomas_Berdych-Novak_Djokovic,1,S-XC,3,0,0,0,0,2,1
20101121-M-Tour_Finals-RR-Tomas_Berdych-Novak_Djokovic,1,S-DTM,3,0,0,0,0,1,2
20101121-M-Tour_Finals-RR-Tomas_Berdych-Novak_Djokovic,2,F-XC,43,8,3,1,4,27,16
20101121-M-Tour_Finals-RR-Tomas_Berdych-Novak_Djokovic,2,F-DTM,19,1,0,0,1,10,9
20101121-M-Tour_Finals-RR-Tomas_Berdych-Novak_Djokovic,2,F-DTL,15,3,2,0,1,7,8
20101121-M-Tour_Finals-RR-Tomas_Berdych-Novak_Djokovic,2,F-IO,14,3,0,2,1,9,5
20101121-M-Tour_Finals-RR-Tomas_Berdych-Novak_Djokovic,2,F-II,2,0,0,0,0,1,1
20101121-M-Tour_Finals-RR-Tomas_Berdych-Novak_Djokovic,2,B-XC,40,3,0,2,1,31,9
20101121-M-Tour_Finals-RR-Tomas_Berdych-Novak_Djokovic,2,B-DTM,9,2,0,0,2,5,4
20101121-M-Tour_Finals-RR-Tomas_Berdych-Novak_Djokovic,2,B-DTL,17,6,2,1,3,10,7
20101121-M-Tour_Finals-RR-Tomas_Berdych-Novak_Djokovic,2,B-IO,2,0,0,0,0,0,2
20101121-M-Tour_Finals-RR-Tomas_Berdych-Novak_Djokovic,2,S-XC,7,0,0,0,0,3,4
20101121-M-Tour_Finals-RR-Tomas_Berdych-Novak_Djokovic,2,S-DTM,4,0,0,0,0,3,1
19940703-M-Wimbledon-F-Pete_Sampras-Goran_Ivanisevic,1,F-XC,2,1,1,0,0,2,0
19940703-M-Wimbledon-F-Pete_Sampras-Goran_Ivanisevic,1,F-DTM,2,1,0,1,0,2,0
19940703-M-Wimbledon-F-Pete_Sampras-Goran_Ivanisevic,1,F-DTL,2,2,2,0,0,2,0
19940703-M-Wimbledon-F-Pete_Sampras-Goran_Ivanisevic,1,F-IO,1,1,1,0,0,1,0
19940703-M-Wimbledon-F-Pete_Sampras-Goran_Ivanisevic,1,B-XC,3,3,1,0,2,1,2
19940703-M-Wimbledon-F-Pete_Sampras-Goran_Ivanisevic,1,B-DTM,2,0,0,0,0,0,2
19940703-M-Wimbledon-F-Pete_Sampras-Goran_Ivanisevic,1,B-DTL,6,5,2,3,0,5,1
19940703-M-Wimbledon-F-Pete_Sampras-Goran_Ivanisevic,1,B-IO,4,4,0,2,2,2,2
19940703-M-Wimbledon-F-Pete_Sampras-Goran_Ivanisevic,1,B-II,1,1,1,0,0,1,0
19940703-M-Wimbledon-F-Pete_Sampras-Goran_Ivanisevic,1,S-XC,1,0,0,0,0,0,1
19940703-M-Wimbledon-F-Pete_Sampras-Goran_Ivanisevic,1,S-DTL,1,0,0,0,0,0,1
19940703-M-Wimbledon-F-Pete_Sampras-Goran_Ivanisevic,2,F-XC,5,1,0,0,1,3,2
19940703-M-Wimbledon-F-Pete_Sampras-Goran_Ivanisevic,2,F-DTM,1,0,0,0,0,0,1
19940703-M-Wimbledon-F-Pete_Sampras-Goran_Ivanisevic,2,F-IO,1,1,1,0,0,1,0
19940703-M-Wimbledon-F-Pete_Sampras-Goran_Ivanisevic,2,B-XC,2,1,0,0,1,1,1
19940703-M-Wimbledon-F-Pete_Sampras-Goran_Ivanisevic,2,B-DTM,4,2,1,0,1,1,3
19940703-M-Wimbledon-F-Pete_Sampras-Goran_Ivanisevic,2,B-DTL,1,1,1,0,0,1,0
19940703-M-Wimbledon-F-Pete_Sampras-Goran_Ivanisevic,2,B-IO,3,2,1,0,1,1,2
19940703-M-Wimbledon-F-Pete_Sampras-Goran_Ivanisevic,2,S-DTM,1,0,0,0,0,1,0
19940703-M-Wimbledon-F-Pete_Sampras-Goran_Ivanisevic,2,S-IO,1,0,0,0,0,0,1
20120801-M-Olympics-R16-Andy_Murray-Marcos_Baghdatis,1,F-XC,57,22,10,5,7,27,30
20120801-M-Olympics-R16-Andy_Murray-Marcos_Baghdatis,1,F-DTM,22,2,0,0,2,6,16
20120801-M-Olympics-R16-Andy_Murray-Marcos_Baghdatis,1,F-DTL,21,3,0,1,2,11,10
20120801-M-Olympics-R16-Andy_Murray-Marcos_Baghdatis,1,F-IO,23,5,0,3,2,16,7
20120801-M-Olympics-R16-Andy_Murray-Marcos_Baghdatis,1,F-II,1,0,0,0,0,0,1
20120801-M-Olympics-R16-Andy_Murray-Marcos_Baghdatis,1,B-XC,33,3,0,1,2,19,14
20120801-M-Olympics-R16-Andy_Murray-Marcos_Baghdatis,1,B-DTM,17,0,0,0,0,7,10
20120801-M-Olympics-R16-Andy_Murray-Marcos_Baghdatis,1,B-DTL,8,3,2,0,1,4,4
20120801-M-Olympics-R16-Andy_Murray-Marcos_Baghdatis,1,B-IO,5,1,0,1,0,2,3
20120801-M-Olympics-R16-Andy_Murray-Marcos_Baghdatis,1,S-XC,19,0,0,0,0,14,5
20120801-M-Olympics-R16-Andy_Murray-Marcos_Baghdatis,1,S-DTM,13,1,0,0,1,4,9
20120801-M-Olympics-R16-Andy_Murray-Marcos_Baghdatis,1,S-DTL,7,0,0,0,0,4,3
20120801-M-Olympics-R16-Andy_Murray-Marcos_Baghdatis,1,S-IO,2,1,0,1,0,1,1
20120801-M-Olympics-R16-Andy_Murray-Marcos_Baghdatis,2,F-XC,59,11,0,6,5,34,25
20120801-M-Olympics-R16-Andy_Murray-Marcos_Baghdatis,2,F-DTM,21,2,0,0,2,10,11
20120801-M-Olympics-R16-Andy_Murray-Marcos_Baghdatis,2,F-DTL,13,6,2,2,2,8,5
20120801-M-Olympics-R16-Andy_Murray-Marcos_Baghdatis,2,F-IO,35,9,3,1,5,20,15
20120801-M-Olympics-R16-Andy_Murray-Marcos_Baghdatis,2,F-II,4,3,1,1,1,2,2
20120801-M-Olympics-R16-Andy_Murray-Marcos_Baghdatis,2,B-XC,37,5,1,2,2,18,19
20120801-M-Olympics-R16-Andy_Murray-Marcos_Baghdatis,2,B-DTM,23,1,0,0,1,8,15
20120801-M-Olympics-R16-Andy_Murray-Marcos_Baghdatis,2,B-DTL,18,5,0,1,4,6,12
20120801-M-Olympics-R16-Andy_Murray-Marcos_Baghdatis,2,B-IO,3,1,0,0,1,1,2
20120801-M-Olympics-R16-Andy_Murray-Marcos_Baghdatis,2,S-XC,15,0,0,0,0,7,8
20120801-M-Olympics-R16-Andy_Murray-Marcos_Baghdatis,2,S-DTM,9,1,0,0,1,4,5
20120801-M-Olympics-R16-Andy_Murray-Marcos_Baghdatis,2,S-DTL,6,1,0,0,1,3,3
20000709-M-Wimbledon-F-Patrick_Rafter-Pete_Sampras,1,F-XC,5,1,0,1,0,4,1
20000709-M-Wimbledon-F-Patrick_Rafter-Pete_Sampras,1,F-DTM,4,1,0,0,1,2,2
20000709-M-Wimbledon-F-Patrick_Rafter-Pete_Sampras,1,F-DTL,2,0,0,0,0,1,1
20000709-M-Wimbledon-F-Patrick_Rafter-Pete_Sampras,1,F-IO,1,1,0,0,1,0,1
20000709-M-Wimbledon-F-Patrick_Rafter-Pete_Sampras,1,F-II,1,0,0,0,0,1,0
20000709-M-Wimbledon-F-Patrick_Rafter-Pete_Sampras,1,B-XC,5,4,2,0,2,3,2
20000709-M-Wimbledon-F-Patrick_Rafter-Pete_Sampras,1,B-DTM,4,0,0,0,0,1,3
20000709-M-Wimbledon-F-Patrick_Rafter-Pete_Sampras,1,B-DTL,4,2,0,0,2,2,2
20000709-M-Wimbledon-F-Patrick_Rafter-Pete_Sampras,1,B-IO,3,1,1,0,0,3,0
20000709-M-Wimbledon-F-Patrick_Rafter-Pete_Sampras,1,S-XC,1,0,0,0,0,1,0
20000709-M-Wimbledon-F-Patrick_Rafter-Pete_Sampras,1,S-DTM,1,0,0,0,0,0,1
20000709-M-Wimbledon-F-Patrick_Rafter-Pete_Sampras,2,F-XC,8,3,1,2,0,4,4
20000709-M-Wimbledon-F-Patrick_Rafter-Pete_Sampras,2,F-DTM,2,0,0,0,0,0,2
20000709-M-Wimbledon-F-Patrick_Rafter-Pete_Sampras,2,F-DTL,1,1,1,0,0,1,0
20000709-M-Wimbledon-F-Patrick_Rafter-Pete_Sampras,2,F-IO,11,7,4,1,2,7,4
20000709-M-Wimbledon-F-Patrick_Rafter-Pete_Sampras,2,F-II,1,1,0,0,1,0,1
20000709-M-Wimbledon-F-Patrick_Rafter-Pete_Sampras,2,B-XC,11,7,2,1,4,4,7
20000709-M-Wimbledon-F-Patrick_Rafter-Pete_Sampras,2,B-DTL,4,2,1,0,1,1,3
20000709-M-Wimbledon-F-Patrick_Rafter-Pete_Sampras,2,S-XC,6,2,1,0,1,3,3
20000709-M-Wimbledon-F-Patrick_Rafter-Pete_Sampras,2,S-DTL,1,0,0,0,0,0,1
20120729-M-Olympics-R64-Novak_Djokovic-Fabio_Fognini,1,F-XC,38,9,4,3,2,25,13
20120729-M-Olympics-R64-Novak_Djokovic-Fabio_Fognini,1,F-DTM,8,0,0,0,0,5,3
20120729-M-Olympics-R64-Novak_Djokovic-Fabio_Fognini,1,F-DTL,16,5,3,1,1,10,6
20120729-M-Olympics-R64-Novak_Djokovic-Fabio_Fognini,1,F-IO,43,16,3,5,8,22,21
20120729-M-Olympics-R64-Novak_Djokovic-Fabio_Fognini,1,F-II,7,2,0,1,1,3,4
20120729-M-Olympics-R64-Novak_Djokovic-Fabio_Fognini,1,B-XC,49,9,3,1,5,27,22
20120729-M-Olympics-R64-Novak_Djokovic-Fabio_Fognini,1,B-DTM,28,4,0,2,2,17,11
20120729-M-Olympics-R64-Novak_Djokovic-Fabio_Fognini,1,B-DTL,13,4,1,2,1,9,4
20120729-M-Olympics-R64-Novak_Djokovic-Fabio_Fognini,1,B-IO,4,3,0,0,3,1,3
20120729-M-Olympics-R64-Novak_Djokovic-Fabio_Fognini,1,S-XC,13,0,0,0,0,7,6
20120729-M-Olympics-R64-Novak_Djokovic-Fabio_Fognini,1,S-DTM,5,1,0,0,1,3,2
20120729-M-Olympics-R64-Novak_Djokovic-Fabio_Fognini,1,S-IO,2,1,0,0,1,1,1
20120729-M-Olympics-R64-Novak_Djokovic-Fabio_Fognini,2,F-XC,28,5,0,1,4,12,16
20120729-M-Olympics-R64-Novak_Djokovic-Fabio_Fognini,2,F-DTM,16,3,0,0,3,5,11
20120729-M-Olympics-R64-Novak_Djokovic-Fabio_Fognini,2,F-DTL,19,4,0,0,4,8,11
20120729-M-Olympics-R64-Novak_Djokovic-Fabio_Fognini,2,F-IO,17,4,1,1,2,7,10
20120729-M-Olympics-R64-Novak_Djokovic-Fabio_Fognini,2,F-II,1,1,0,0,1,0,1
20120729-M-Olympics-R64-Novak_Djokovic-Fabio_Fognini,2,B-XC,36,2,0,0,2,16,20
20120729-M-Olympics-R64-Novak_Djokovic-Fabio_Fognini,2,B-DTM,36,5,0,0,5,12,24
20120729-M-Olympics-R64-Novak_Djokovic-Fabio_Fognini,2,B-DTL,10,4,2,0,2,6,4
20120729-M-Olympics-R64-Novak_Djokovic-Fabio_Fognini,2,B-IO,5,2,0,2,0,3,2
20120729-M-Olympics-R64-Novak_Djokovic-Fabio_Fognini,2,S-XC,21,1,0,0,1,11,10
20120729-M-Olympics-R64-Novak_Djokovic-Fabio_Fognini,2,S-DTM,21,0,0,0,0,7,14
20120729-M-Olympics-R64-Novak_Djokovic-Fabio_Fognini,2,S-DTL,3,2,0,1,1,1,2
20120729-M-Olympics-R64-Novak_Djokovic-Fabio_Fognini,2,S-IO,2,1,0,1,0,2,0
20160619-M-Fergana_CH-F-Radu_Albot-Konstantin_Kravchuk,1,F-XC,29,4,0,1,3,16,13
20160619-M-Fergana_CH-F-Radu_Albot-Konstantin_Kravchuk,1,F-DTM,25,1,0,0,1,12,13
20160619-M-Fergana_CH-F-Radu_Albot-Konstantin_Kravchuk,1,F-DTL,13,4,2,1,1,8,5
20160619-M-Fergana_CH-F-Radu_Albot-Konstantin_Kravchuk,1,F-IO,18,1,0,1,0,12,6
20160619-M-Fergana_CH-F-Radu_Albot-Konstantin_Kravchuk,1,F-II,8,2,1,1,0,4,4
20160619-M-Fergana_CH-F-Radu_Albot-Konstantin_Kravchuk,1,B-XC,40,2,0,0,2,22,18
20160619-M-Fergana_CH-F-Radu_Albot-Konstantin_Kravchuk,1,B-DTM,14,0,0,0,0,10,4
20160619-M-Fergana_CH-F-Radu_Albot-Konstantin_Kravchuk,1,B-DTL,4,3,0,2,1,3,1
20160619-M-Fergana_CH-F-Radu_Albot-Konstantin_Kravchuk,1,B-IO,1,0,0,0,0,1,0
20160619-M-Fergana_CH-F-Radu_Albot-Konstantin_Kravchuk,1,S-XC,4,1,1,0,0,4,0
20160619-M-Fergana_CH-F-Radu_Albot-Konstantin_Kravchuk,1,S-DTM,2,1,0,0,1,1,1
20160619-M-Fergana_CH-F-Radu_Albot-Konstantin_Kravchuk,2,F-XC,40,11,3,3,5,19,21
20160619-M-Fergana_CH-F-Radu_Albot-Konstantin_Kravchuk,2,F-DTM,7,3,0,0,3,1,6
20160619-M-Fergana_CH-F-Radu_Albot-Konstantin_Kravchuk,2,F-DTL,8,3,1,0,2,4,4
20160619-M-Fergana_CH-F-Radu_Albot-Konstantin_Kravchuk,2,F-IO,19,6,0,1,5,6,13
20160619-M-Fergana_CH-F-Radu_Albot-Konstantin_Kravchuk,2,F-II,4,1,1,0,0,3,1
20160619-M-Fergana_CH-F-Radu_Albot-Konstantin_Kravchuk,2,B-XC,32,2,0,0,2,12,20
20160619-M-Fergana_CH-F-Radu_Albot-Konstantin_Kravchuk,2,B-DTM,9,2,0,0,2,3,6
20160619-M-Fergana_CH-F-Radu_Albot-Konstantin_Kravchuk,2,B-DTL,8,4,0,1,3,2,6
20160619-M-Fergana_CH-F-Radu_Albot-Konstantin_Kravchuk,2,B-IO,4,0,0,0,0,2,2
20160619-M-Fergana_CH-F-Radu_Albot-Konstantin_Kravchuk,2,S-XC,22,3,0,0,3,7,15
20160619-M-Fergana_CH-F-Radu_Albot-Konstantin_Kravchuk,2,S-DTM,6,1,1,0,0,4,2
20160619-M-Fergana_CH-F-Radu_Albot-Konstantin_Kravchuk,2,S-DTL,8,1,0,0,1,3,5
20160619-M-Fergana_CH-F-Radu_Albot-Konstantin_Kravchuk,2,S-IO,1,0,0,0,0,1,0
19910707-M-Wimbledon-F-Boris_Becker-Michael_Stich,1,F-XC,4,2,2,0,0,2,2
19910707-M-Wimbledon-F-Boris_Becker-Michael_Stich,1,F-DTM,1,0,0,0,0,1,0
19910707-M-Wimbledon-F-Boris_Becker-Michael_Stich,1,F-DTL,1,1,1,0,0,1,0
19910707-M-Wimbledon-F-Boris_Becker-Michael_Stich,1,F-IO,4,3,0,2,1,3,1
19910707-M-Wimbledon-F-Boris_Becker-Michael_Stich,1,B-XC,2,1,1,0,0,2,0
19910707-M-Wimbledon-F-Boris_Becker-Michael_Stich,1,B-DTL,4,4,1,2,1,3,1
19910707-M-Wimbledon-F-Boris_Becker-Michael_Stich,1,S-DTL,3,2,1,0,1,1,2
19910707-M-Wimbledon-F-Boris_Becker-Michael_Stich,1,S-IO,1,0,0,0,0,0,1
19910707-M-Wimbledon-F-Boris_Becker-Michael_Stich,2,F-XC,5,1,0,1,0,2,3
19910707-M-Wimbledon-F-Boris_Becker-Michael_Stich,2,F-DTM,1,0,0,0,0,0,1
19910707-M-Wimbledon-F-Boris_Becker-Michael_Stich,2,F-DTL,5,3,3,0,0,4,1
19910707-M-Wimbledon-F-Boris_Becker-Michael_Stich,2,F-IO,1,0,0,0,0,1,0
19910707-M-Wimbledon-F-Boris_Becker-Michael_Stich,2,B-XC,8,4,3,0,1,4,4
19910707-M-Wimbledon-F-Boris_Becker-Michael_Stich,2,B-DTM,4,1,0,0,1,0,4
19910707-M-Wimbledon-F-Boris_Becker-Michael_Stich,2,B-DTL,6,5,0,0,5,1,5
19910707-M-Wimbledon-F-Boris_Becker-Michael_Stich,2,B-IO,8,6,4,0,2,5,3
19910707-M-Wimbledon-F-Boris_Becker-Michael_Stich,2,S-XC,1,0,0,0,0,1,0
19910707-M-Wimbledon-F-Boris_Becker-Michael_Stich,2,S-IO,1,0,0,0,0,0,1
19860706-M-Wimbledon-F-Boris_Becker-Ivan_Lendl,1,F-XC,4,3,1,2,0,3,1
19860706-M-Wimbledon-F-Boris_Becker-Ivan_Lendl,1,F-DTM,1,0,0,0,0,0,1
19860706-M-Wimbledon-F-Boris_Becker-Ivan_Lendl,1,F-DTL,1,0,0,0,0,1,0
19860706-M-Wimbledon-F-Boris_Becker-Ivan_Lendl,1,F-IO,1,1,1,0,0,1,0
19860706-M-Wimbledon-F-Boris_Becker-Ivan_Lendl,1,B-XC,3,2,2,0,0,2,1
19860706-M-Wimbledon-F-Boris_Becker-Ivan_Lendl,1,B-DTM,1,0,0,0,0,1,0
19860706-M-Wimbledon-F-Boris_Becker-Ivan_Lendl,1,B-DTL,2,1,1,0,0,1,1
19860706-M-Wimbledon-F-Boris_Becker-Ivan_Lendl,1,B-IO,1,1,0,0,1,0,1
19860706-M-Wimbledon-F-Boris_Becker-Ivan_Lendl,1,S-XC,1,1,1,0,0,1,0
19860706-M-Wimbledon-F-Boris_Becker-Ivan_Lendl,1,S-DTL,1,1,0,1,0,1,0
19860706-M-Wimbledon-F-Boris_Becker-Ivan_Lendl,1,S-IO,1,0,0,0,0,0,1
19860706-M-Wimbledon-F-Boris_Becker-Ivan_Lendl,2,F-XC,3,2,2,0,0,2,1
19860706-M-Wimbledon-F-Boris_Becker-Ivan_Lendl,2,F-DTM,1,1,1,0,0,1,0
19860706-M-Wimbledon-F-Boris_Becker-Ivan_Lendl,2,F-DTL,2,1,1,0,0,1,1
19860706-M-Wimbledon-F-Boris_Becker-Ivan_Lendl,2,B-XC,7,5,2,2,1,4,3
19860706-M-Wimbledon-F-Boris_Becker-Ivan_Lendl,2,B-DTM,4,2,1,1,0,2,2
19860706-M-Wimbledon-F-Boris_Becker-Ivan_Lendl,2,B-DTL,3,1,1,0,0,1,2
19860706-M-Wimbledon-F-Boris_Becker-Ivan_Lendl,2,B-IO,2,1,1,0,0,1,1
19860706-M-Wimbledon-F-Boris_Becker-Ivan_Lendl,2,S-XC,1,0,0,0,0,1,0
19860706-M-Wimbledon-F-Boris_Becker-Ivan_Lendl,2,S-DTM,1,0,0,0,0,0,1
19870705-M-Wimbledon-F-Pat_Cash-Ivan_Lendl,1,F-XC,6,3,1,0,2,1,5
19870705-M-Wimbledon-F-Pat_Cash-Ivan_Lendl,1,F-DTM,1,0,0,0,0,0,1
19870705-M-Wimbledon-F-Pat_Cash-Ivan_Lendl,1,F-DTL,2,1,1,0,0,1,1
19870705-M-Wimbledon-F-Pat_Cash-Ivan_Lendl,1,F-IO,2,2,0,0,2,0,2
19870705-M-Wimbledon-F-Pat_Cash-Ivan_Lendl,1,B-XC,4,1,0,0,1,0,4
19870705-M-Wimbledon-F-Pat_Cash-Ivan_Lendl,1,B-DTM,5,0,0,0,0,3,2
19870705-M-Wimbledon-F-Pat_Cash-Ivan_Lendl,1,B-DTL,7,5,3,0,2,3,4
19870705-M-Wimbledon-F-Pat_Cash-Ivan_Lendl,1,B-IO,1,1,1,0,0,1,0
19870705-M-Wimbledon-F-Pat_Cash-Ivan_Lendl,1,S-XC,1,0,0,0,0,0,1
19870705-M-Wimbledon-F-Pat_Cash-Ivan_Lendl,1,S-DTM,2,1,1,0,0,1,1
19870705-M-Wimbledon-F-Pat_Cash-Ivan_Lendl,1,S-DTL,1,0,0,0,0,0,1
19870705-M-Wimbledon-F-Pat_Cash-Ivan_Lendl,2,F-XC,2,2,2,0,0,2,0
19870705-M-Wimbledon-F-Pat_Cash-Ivan_Lendl,2,F-DTM,1,0,0,0,0,0,1
19870705-M-Wimbledon-F-Pat_Cash-Ivan_Lendl,2,F-DTL,2,1,1,0,0,1,1
19870705-M-Wimbledon-F-Pat_Cash-Ivan_Lendl,2,F-IO,6,5,2,2,1,5,1
19870705-M-Wimbledon-F-Pat_Cash-Ivan_Lendl,2,B-XC,1,1,0,0,1,0,1
19870705-M-Wimbledon-F-Pat_Cash-Ivan_Lendl,2,B-DTM,6,1,0,0,1,2,4
19870705-M-Wimbledon-F-Pat_Cash-Ivan_Lendl,2,B-DTL,3,1,0,0,1,0,3
19870705-M-Wimbledon-F-Pat_Cash-Ivan_Lendl,2,B-IO,1,0,0,0,0,0,1
19870705-M-Wimbledon-F-Pat_Cash-Ivan_Lendl,2,S-XC,1,0,0,0,0,1,0
19870705-M-Wimbledon-F-Pat_Cash-Ivan_Lendl,2,S-DTM,3,0,0,0,0,2,1
19870705-M-Wimbledon-F-Pat_Cash-Ivan_Lendl,2,S-IO,1,1,0,0,1,0,1
20020609-M-Roland_Garros-F-Albert_Costa-Juan_Carlos_Ferrero,1,F-XC,61,17,8,5,4,41,20
20020609-M-Roland_Garros-F-Albert_Costa-Juan_Carlos_Ferrero,1,F-DTM,29,0,0,0,0,16,13
20020609-M-Roland_Garros-F-Albert_Costa-Juan_Carlos_Ferrero,1,F-DTL,21,9,3,2,4,10,11
20020609-M-Roland_Garros-F-Albert_Costa-Juan_Carlos_Ferrero,1,F-IO,50,9,4,3,2,38,12
20020609-M-Roland_Garros-F-Albert_Costa-Juan_Carlos_Ferrero,1,F-II,10,2,2,0,0,7,3
20020609-M-Roland_Garros-F-Albert_Costa-Juan_Carlos_Ferrero,1,B-XC,36,2,0,0,2,19,17
20020609-M-Roland_Garros-F-Albert_Costa-Juan_Carlos_Ferrero,1,B-DTM,27,6,0,1,5,13,14
20020609-M-Roland_Garros-F-Albert_Costa-Juan_Carlos_Ferrero,1,B-DTL,21,11,2,1,8,8,13
20020609-M-Roland_Garros-F-Albert_Costa-Juan_Carlos_Ferrero,1,B-IO,2,1,0,1,0,2,0
20020609-M-Roland_Garros-F-Albert_Costa-Juan_Carlos_Ferrero,1,S-XC,16,1,1,0,0,14,2
20020609-M-Roland_Garros-F-Albert_Costa-Juan_Carlos_Ferrero,1,S-DTM,1,0,0,0,0,0,1
20020609-M-Roland_Garros-F-Albert_Costa-Juan_Carlos_Ferrero,1,S-DTL,5,1,0,0,1,3,2
20020609-M-Roland_Garros-F-Albert_Costa-Juan_Carlos_Ferrero,2,F-XC,59,17,6,4,7,32,27
20020609-M-Roland_Garros-F-Albert_Costa-Juan_Carlos_Ferrero,2,F-DTM,36,5,0,1,4,7,29
20020609-M-Roland_Garros-F-Albert_Costa-Juan_Carlos_Ferrero,2,F-DTL,22,6,1,0,5,11,11
20020609-M-Roland_Garros-F-Albert_Costa-Juan_Carlos_Ferrero,2,F-IO,29,8,3,4,1,16,13
20020609-M-Roland_Garros-F-Albert_Costa-Juan_Carlos_Ferrero,2,F-II,11,5,0,2,3,2,9
20020609-M-Roland_Garros-F-Albert_Costa-Juan_Carlos_Ferrero,2,B-XC,73,6,1,0,5,25,48
20020609-M-Roland_Garros-F-Albert_Costa-Juan_Carlos_Ferrero,2,B-DTM,27,4,0,0,4,7,20
20020609-M-Roland_Garros-F-Albert_Costa-Juan_Carlos_Ferrero,2,B-DTL,14,7,2,2,3,8,6
20020609-M-Roland_Garros-F-Albert_Costa-Juan_Carlos_Ferrero,2,B-IO,2,0,0,0,0,1,1
20020609-M-Roland_Garros-F-Albert_Costa-Juan_Carlos_Ferrero,2,S-XC,1,0,0,0,0,0,1
20020609-M-Roland_Garros-F-Albert_Costa-Juan_Carlos_Ferrero,2,S-DTM,4,0,0,0,0,1,3
20020609-M-Roland_Garros-F-Albert_Costa-Juan_Carlos_Ferrero,2,S-DTL,4,0,0,0,0,1,3
20120812-M-Finland_F1-F-Milos_Sekulic-Vladimir_Ivanov,1,F-XC,21,7,2,3,2,10,11
20120812-M-Finland_F1-F-Milos_Sekulic-Vladimir_Ivanov,1,F-DTM,3,1,0,0,1,1,2
20120812-M-Finland_F1-F-Milos_Sekulic-Vladimir_Ivanov,1,F-DTL,7,2,1,1,0,4,3
20120812-M-Finland_F1-F-Milos_Sekulic-Vladimir_Ivanov,1,F-IO,15,4,0,1,3,6,9
20120812-M-Finland_F1-F-Milos_Sekulic-Vladimir_Ivanov,1,F-II,4,3,0,1,2,2,2
20120812-M-Finland_F1-F-Milos_Sekulic-Vladimir_Ivanov,1,B-XC,54,10,1,1,8,22,32
20120812-M-Finland_F1-F-Milos_Sekulic-Vladimir_Ivanov,1,B-DTM,9,1,0,0,1,4,5
20120812-M-Finland_F1-F-Milos_Sekulic-Vladimir_Ivanov,1,B-DTL,5,3,0,1,2,1,4
20120812-M-Finland_F1-F-Milos_Sekulic-Vladimir_Ivanov,1,B-IO,1,0,0,0,0,1,0
20120812-M-Finland_F1-F-Milos_Sekulic-Vladimir_Ivanov,1,S-XC,7,0,0,0,0,2,5
20120812-M-Finland_F1-F-Milos_Sekulic-Vladimir_Ivanov,1,S-DTM,1,0,0,0,0,0,1
20120812-M-Finland_F1-F-Milos_Sekulic-Vladimir_Ivanov,1,S-DTL,4,0,0,0,0,2,2
20120812-M-Finland_F1-F-Milos_Sekulic-Vladimir_Ivanov,2,F-XC,15,3,0,2,1,8,7
20120812-M-Finland_F1-F-Milos_Sekulic-Vladimir_Ivanov,2,F-DTM,5,0,0,0,0,2,3
20120812-M-Finland_F1-F-Milos_Sekulic-Vladimir_Ivanov,2,F-DTL,13,4,2,1,1,10,3
20120812-M-Finland_F1-F-Milos_Sekulic-Vladimir_Ivanov,2,F-IO,13,3,3,0,0,9,4
20120812-M-Finland_F1-F-Milos_Sekulic-Vladimir_Ivanov,2,F-II,5,2,2,0,0,3,2
20120812-M-Finland_F1-F-Milos_Sekulic-Vladimir_Ivanov,2,B-XC,47,5,0,1,4,27,20
20120812-M-Finland_F1-F-Milos_Sekulic-Vladimir_Ivanov,2,B-DTM,11,2,0,1,1,6,5
20120812-M-Finland_F1-F-Milos_Sekulic-Vladimir_Ivanov,2,B-DTL,4,3,0,2,1,3,1
20120812-M-Finland_F1-F-Milos_Sekulic-Vladimir_Ivanov,2,S-XC,7,0,0,0,0,4,3
20120812-M-Finland_F1-F-Milos_Sekulic-Vladimir_Ivanov,2,S-DTM,4,0,0,0,0,1,3
20120812-M-Finland_F1-F-Milos_Sekulic-Vladimir_Ivanov,2,S-DTL,2,0,0,0,0,0,2
19920607-M-Roland_Garros-F-Jim_Courier-Petr_Korda,1,F-XC,39,5,1,2,2,23,16
19920607-M-Roland_Garros-F-Jim_Courier-Petr_Korda,1,F-DTM,21,1,0,0,1,12,9
19920607-M-Roland_Garros-F-Jim_Courier-Petr_Korda,1,F-DTL,4,1,0,0,1,1,3
19920607-M-Roland_Garros-F-Jim_Courier-Petr_Korda,1,F-IO,15,5,2,1,2,8,7
19920607-M-Roland_Garros-F-Jim_Courier-Petr_Korda,1,F-II,1,1,0,1,0,1,0
19920607-M-Roland_Garros-F-Jim_Courier-Petr_Korda,1,B-XC,17,2,1,1,0,10,7
19920607-M-Roland_Garros-F-Jim_Courier-Petr_Korda,1,B-DTM,29,2,0,0,2,19,10
19920607-M-Roland_Garros-F-Jim_Courier-Petr_Korda,1,B-DTL,8,4,1,1,2,5,3
19920607-M-Roland_Garros-F-Jim_Courier-Petr_Korda,1,B-IO,2,0,0,0,0,2,0
19920607-M-Roland_Garros-F-Jim_Courier-Petr_Korda,1,S-XC,3,0,0,0,0,1,2
19920607-M-Roland_Garros-F-Jim_Courier-Petr_Korda,1,S-DTM,7,0,0,0,0,3,4
19920607-M-Roland_Garros-F-Jim_Courier-Petr_Korda,1,S-DTL,2,0,0,0,0,2,0
19920607-M-Roland_Garros-F-Jim_Courier-Petr_Korda,1,S-IO,1,0,0,0,0,1,0
19920607-M-Roland_Garros-F-Jim_Courier-Petr_Korda,2,F-XC,40,8,3,1,4,23,17
19920607-M-Roland_Garros-F-Jim_Courier-Petr_Korda,2,F-DTM,16,4,0,0,4,4,12
19920607-M-Roland_Garros-F-Jim_Courier-Petr_Korda,2,F-DTL,9,6,2,0,4,3,6
19920607-M-Roland_Garros-F-Jim_Courier-Petr_Korda,2,F-IO,11,7,2,1,4,3,8
19920607-M-Roland_Garros-F-Jim_Courier-Petr_Korda,2,F-II,2,2,0,0,2,0,2
19920607-M-Roland_Garros-F-Jim_Courier-Petr_Korda,2,B-XC,17,4,3,0,1,9,8
19920607-M-Roland_Garros-F-Jim_Courier-Petr_Korda,2,B-DTM,11,2,0,0,2,2,9
19920607-M-Roland_Garros-F-Jim_Courier-Petr_Korda,2,B-DTL,5,3,2,0,1,2,3
19920607-M-Roland_Garros-F-Jim_Courier-Petr_Korda,2,B-IO,9,1,0,0,1,3,6
19920607-M-Roland_Garros-F-Jim_Courier-Petr_Korda,2,S-XC,11,3,0,1,2,3,8
19920607-M-Roland_Garros-F-Jim_Courier-Petr_Korda,2,S-DTM,15,2,0,0,2,7,8
19920607-M-Roland_Garros-F-Jim_Courier-Petr_Korda,2,S-DTL,7,0,0,0,0,2,5
19920607-M-Roland_Garros-F-Jim_Courier-Petr_Korda,2,S-IO,7,2,0,1,1,2,5
20000611-M-Roland_Garros-F-Magnus_Norman-Gustavo_Kuerten,1,F-XC,96,21,6,1,14,42,54
20000611-M-Roland_Garros-F-Magnus_Norman-Gustavo_Kuerten,1,F-DTM,59,9,1,0,8,23,36
20000611-M-Roland_Garros-F-Magnus_Norman-Gustavo_Kuerten,1,F-DTL,23,8,3,1,4,13,10
20000611-M-Roland_Garros-F-Magnus_Norman-Gustavo_Kuerten,1,F-IO,88,31,12,5,14,51,37
20000611-M-Roland_Garros-F-Magnus_Norman-Gustavo_Kuerten,1,F-II,17,8,5,0,3,11,6
20000611-M-Roland_Garros-F-Magnus_Norman-Gustavo_Kuerten,1,B-XC,65,15,3,2,10,27,38
20000611-M-Roland_Garros-F-Magnus_Norman-Gustavo_Kuerten,1,B-DTM,34,2,0,1,1,17,17
20000611-M-Roland_Garros-F-Magnus_Norman-Gustavo_Kuerten,1,B-DTL,28,9,2,1,6,17,11
20000611-M-Roland_Garros-F-Magnus_Norman-Gustavo_Kuerten,1,B-IO,13,3,1,1,1,7,6
20000611-M-Roland_Garros-F-Magnus_Norman-Gustavo_Kuerten,1,S-XC,8,3,1,1,1,7,1
20000611-M-Roland_Garros-F-Magnus_Norman-Gustavo_Kuerten,1,S-DTM,5,0,0,0,0,1,4
20000611-M-Roland_Garros-F-Magnus_Norman-Gustavo_Kuerten,1,S-DTL,5,1,0,1,0,2,3
20000611-M-Roland_Garros-F-Magnus_Norman-Gustavo_Kuerten,2,F-XC,80,15,6,3,6,42,38
20000611-M-Roland_Garros-F-Magnus_Norman-Gustavo_Kuerten,2,F-DTM,52,3,0,0,3,30,22
20000611-M-Roland_Garros-F-Magnus_Norman-Gustavo_Kuerten,2,F-DTL,37,17,3,2,12,12,25
20000611-M-Roland_Garros-F-Magnus_Norman-Gustavo_Kuerten,2,F-IO,40,14,5,3,6,23,17
20000611-M-Roland_Garros-F-Magnus_Norman-Gustavo_Kuerten,2,F-II,2,1,0,0,1,1,1
20000611-M-Roland_Garros-F-Magnus_Norman-Gustavo_Kuerten,2,B-XC,98,16,0,3,13,44,54
20000611-M-Roland_Garros-F-Magnus_Norman-Gustavo_Kuerten,2,B-DTM,38,4,1,0,3,17,21
20000611-M-Roland_Garros-F-Magnus_Norman-Gustavo_Kuerten,2,B-DTL,25,11,4,1,6,9,16
20000611-M-Roland_Garros-F-Magnus_Norman-Gustavo_Kuerten,2,B-IO,6,2,0,1,1,5,1
20000611-M-Roland_Garros-F-Magnus_Norman-Gustavo_Kuerten,2,S-XC,12,3,0,0,3,4,8
20000611-M-Roland_Garros-F-Magnus_Norman-Gustavo_Kuerten,2,S-DTM,12,0,0,0,0,7,5
20010610-M-Roland_Garros-F-Alex_Corretja-Gustavo_Kuerten,1,F-XC,51,9,4,2,3,24,27
20010610-M-Roland_Garros-F-Alex_Corretja-Gustavo_Kuerten,1,F-DTM,76,5,0,0,5,30,46
20010610-M-Roland_Garros-F-Alex_Corretja-Gustavo_Kuerten,1,F-DTL,32,6,2,1,3,15,17
20010610-M-Roland_Garros-F-Alex_Corretja-Gustavo_Kuerten,1,F-IO,67,12,1,1,10,24,43
20010610-M-Roland_Garros-F-Alex_Corretja-Gustavo_Kuerten,1,F-II,4,3,2,0,1,2,2
20010610-M-Roland_Garros-F-Alex_Corretja-Gustavo_Kuerten,1,B-XC,85,9,4,0,5,42,43
20010610-M-Roland_Garros-F-Alex_Corretja-Gustavo_Kuerten,1,B-DTM,59,5,1,1,3,24,35
20010610-M-Roland_Garros-F-Alex_Corretja-Gustavo_Kuerten,1,B-DTL,32,15,7,0,8,15,17
20010610-M-Roland_Garros-F-Alex_Corretja-Gustavo_Kuerten,1,B-IO,8,3,1,0,2,4,4
20010610-M-Roland_Garros-F-Alex_Corretja-Gustavo_Kuerten,1,S-XC,13,1,0,1,0,11,2
20010610-M-Roland_Garros-F-Alex_Corretja-Gustavo_Kuerten,1,S-DTM,21,2,0,0,2,6,15
20010610-M-Roland_Garros-F-Alex_Corretja-Gustavo_Kuerten,1,S-DTL,4,2,1,0,1,2,2
20010610-M-Roland_Garros-F-Alex_Corretja-Gustavo_Kuerten,2,F-XC,80,20,7,3,10,46,34
20010610-M-Roland_Garros-F-Alex_Corretja-Gustavo_Kuerten,2,F-DTM,46,4,0,1,3,26,20
20010610-M-Roland_Garros-F-Alex_Corretja-Gustavo_Kuerten,2,F-DTL,11,1,1,0,0,6,5
20010610-M-Roland_Garros-F-Alex_Corretja-Gustavo_Kuerten,2,F-IO,62,18,2,5,11,29,33
20010610-M-Roland_Garros-F-Alex_Corretja-Gustavo_Kuerten,2,F-II,10,6,1,3,2,7,3
20010610-M-Roland_Garros-F-Alex_Corretja-Gustavo_Kuerten,2,B-XC,123,14,4,3,7,68,55
20010610-M-Roland_Garros-F-Alex_Corretja-Gustavo_Kuerten,2,B-DTM,67,5,0,1,4,41,26
20010610-M-Roland_Garros-F-Alex_Corretja-Gustavo_Kuerten,2,B-DTL,21,8,3,2,3,14,7
20010610-M-Roland_Garros-F-Alex_Corretja-Gustavo_Kuerten,2,B-IO,8,0,0,0,0,5,3
20010610-M-Roland_Garros-F-Alex_Corretja-Gustavo_Kuerten,2,S-XC,7,1,0,0,1,4,3
20010610-M-Roland_Garros-F-Alex_Corretja-Gustavo_Kuerten,2,S-DTM,7,0,0,0,0,2,5
20010610-M-Roland_Garros-F-Alex_Corretja-Gustavo_Kuerten,2,S-DTL,1,1,1,0,0,1,0
20160708-M-Wimbledon-SF-Andy_Murray-Tomas_Berdych,1,F-XC,31,9,2,5,2,23,8
20160708-M-Wimbledon-SF-Andy_Murray-Tomas_Berdych,1,F-DTM,27,1,0,0,1,12,15
20160708-M-Wimbledon-SF-Andy_Murray-Tomas_Berdych,1,F-DTL,4,3,1,1,1,3,1
20160708-M-Wimbledon-SF-Andy_Murray-Tomas_Berdych,1,F-IO,17,5,0,3,2,12,5
20160708-M-Wimbledon-SF-Andy_Murray-Tomas_Berdych,1,F-II,1,1,0,1,0,1,0
20160708-M-Wimbledon-SF-Andy_Murray-Tomas_Berdych,1,B-XC,41,2,0,2,0,24,17
20160708-M-Wimbledon-SF-Andy_Murray-Tomas_Berdych,1,B-DTM,25,2,0,0,2,9,16
20160708-M-Wimbledon-SF-Andy_Murray-Tomas_Berdych,1,B-DTL,4,3,2,1,0,3,1
20160708-M-Wimbledon-SF-Andy_Murray-Tomas_Berdych,1,B-IO,4,3,2,1,0,4,0
20160708-M-Wimbledon-SF-Andy_Murray-Tomas_Berdych,1,S-XC,17,0,0,0,0,7,10
20160708-M-Wimbledon-SF-Andy_Murray-Tomas_Berdych,1,S-DTM,12,1,0,0,1,5,7
20160708-M-Wimbledon-SF-Andy_Murray-Tomas_Berdych,1,S-DTL,2,0,0,0,0,0,2
20160708-M-Wimbledon-SF-Andy_Murray-Tomas_Berdych,2,F-XC,25,10,2,3,5,12,13
20160708-M-Wimbledon-SF-Andy_Murray-Tomas_Berdych,2,F-DTM,25,4,0,1,3,10,15
20160708-M-Wimbledon-SF-Andy_Murray-Tomas_Berdych,2,F-DTL,9,4,2,0,2,5,4
20160708-M-Wimbledon-SF-Andy_Murray-Tomas_Berdych,2,F-IO,45,15,2,2,11,24,21
20160708-M-Wimbledon-SF-Andy_Murray-Tomas_Berdych,2,F-II,7,4,1,2,1,4,3
20160708-M-Wimbledon-SF-Andy_Murray-Tomas_Berdych,2,B-XC,23,7,3,1,3,10,13
20160708-M-Wimbledon-SF-Andy_Murray-Tomas_Berdych,2,B-DTM,25,3,0,0,3,9,16
20160708-M-Wimbledon-SF-Andy_Murray-Tomas_Berdych,2,B-DTL,7,3,0,2,1,2,5
20160708-M-Wimbledon-SF-Andy_Murray-Tomas_Berdych,2,B-IO,6,1,0,0,1,3,3
20160708-M-Wimbledon-SF-Andy_Murray-Tomas_Berdych,2,S-XC,14,1,0,1,0,8,6
20160708-M-Wimbledon-SF-Andy_Murray-Tomas_Berdych,2,S-DTM,7,0,0,0,0,1,6
20160708-M-Wimbledon-SF-Andy_Murray-Tomas_Berdych,2,S-DTL,4,1,0,1,0,1,3
20160708-M-Wimbledon-SF-Milos_Raonic-Roger_Federer,1,F-XC,35,19,8,7,4,23,12
20160708-M-Wimbledon-SF-Milos_Raonic-Roger_Federer,1,F-DTM,17,0,0,0,0,7,10
20160708-M-Wimbledon-SF-Milos_Raonic-Roger_Federer,1,F-DTL,9,4,1,2,1,6,3
20160708-M-Wimbledon-SF-Milos_Raonic-Roger_Federer,1,F-IO,50,24,4,8,12,32,18
20160708-M-Wimbledon-SF-Milos_Raonic-Roger_Federer,1,F-II,3,1,1,0,0,2,1
20160708-M-Wimbledon-SF-Milos_Raonic-Roger_Federer,1,B-XC,15,2,1,0,1,7,8
20160708-M-Wimbledon-SF-Milos_Raonic-Roger_Federer,1,B-DTM,18,6,2,1,3,7,11
20160708-M-Wimbledon-SF-Milos_Raonic-Roger_Federer,1,B-DTL,11,8,3,2,3,5,6
20160708-M-Wimbledon-SF-Milos_Raonic-Roger_Federer,1,B-IO,5,2,1,0,1,3,2
20160708-M-Wimbledon-SF-Milos_Raonic-Roger_Federer,1,S-XC,12,4,0,1,3,4,8
20160708-M-Wimbledon-SF-Milos_Raonic-Roger_Federer,1,S-DTM,7,1,0,0,1,3,4
20160708-M-Wimbledon-SF-Milos_Raonic-Roger_Federer,1,S-DTL,9,5,1,3,1,6,3
20160708-M-Wimbledon-SF-Milos_Raonic-Roger_Federer,1,S-IO,1,1,0,0,1,0,1
20160708-M-Wimbledon-SF-Milos_Raonic-Roger_Federer,2,F-XC,28,13,7,4,2,17,11
20160708-M-Wimbledon-SF-Milos_Raonic-Roger_Federer,2,F-DTM,30,0,0,0,0,21,9
20160708-M-Wimbledon-SF-Milos_Raonic-Roger_Federer,2,F-DTL,12,4,2,2,0,6,6
20160708-M-Wimbledon-SF-Milos_Raonic-Roger_Federer,2,F-IO,23,13,4,4,5,13,10
20160708-M-Wimbledon-SF-Milos_Raonic-Roger_Federer,2,B-XC,23,7,0,4,3,11,12
20160708-M-Wimbledon-SF-Milos_Raonic-Roger_Federer,2,B-DTM,24,2,0,0,2,8,16
20160708-M-Wimbledon-SF-Milos_Raonic-Roger_Federer,2,B-DTL,10,5,3,2,0,5,5
20160708-M-Wimbledon-SF-Milos_Raonic-Roger_Federer,2,B-IO,5,2,1,1,0,3,2
20160708-M-Wimbledon-SF-Milos_Raonic-Roger_Federer,2,S-XC,12,1,0,1,0,4,8
20160708-M-Wimbledon-SF-Milos_Raonic-Roger_Federer,2,S-DTM,6,2,1,0,1,2,4
20160708-M-Wimbledon-SF-Milos_Raonic-Roger_Federer,2,S-DTL,1,0,0,0,0,1,0
19940605-M-Roland_Garros-F-Sergi_Bruguera-Alberto_Berasategui,1,F-XC,87,13,4,2,7,48,39
19940605-M-Roland_Garros-F-Sergi_Bruguera-Alberto_Berasategui,1,F-DTM,52,0,0,0,0,33,19
19940605-M-Roland_Garros-F-Sergi_Bruguera-Alberto_Berasategui,1,F-DTL,24,5,0,0,5,9,15
19940605-M-Roland_Garros-F-Sergi_Bruguera-Alberto_Berasategui,1,F-IO,95,9,2,2,5,66,29
19940605-M-Roland_Garros-F-Sergi_Bruguera-Alberto_Berasategui,1,F-II,20,6,2,2,2,9,11
19940605-M-Roland_Garros-F-Sergi_Bruguera-Alberto_Berasategui,1,B-XC,214,9,1,1,7,119,95
19940605-M-Roland_Garros-F-Sergi_Bruguera-Alberto_Berasategui,1,B-DTM,63,3,0,0,3,23,40
19940605-M-Roland_Garros-F-Sergi_Bruguera-Alberto_Berasategui,1,B-DTL,20,9,2,2,5,9,11
19940605-M-Roland_Garros-F-Sergi_Bruguera-Alberto_Berasategui,1,B-IO,6,1,1,0,0,5,1
19940605-M-Roland_Garros-F-Sergi_Bruguera-Alberto_Berasategui,1,S-XC,24,2,0,0,2,10,14
19940605-M-Roland_Garros-F-Sergi_Bruguera-Alberto_Berasategui,1,S-DTM,11,1,0,0,1,6,5
19940605-M-Roland_Garros-F-Sergi_Bruguera-Alberto_Berasategui,1,S-DTL,3,0,0,0,0,1,2
19940605-M-Roland_Garros-F-Sergi_Bruguera-Alberto_Berasategui,1,S-IO,1,0,0,0,0,0,1
19940605-M-Roland_Garros-F-Sergi_Bruguera-Alberto_Berasategui,2,F-XC,96,25,12,5,8,56,40
19940605-M-Roland_Garros-F-Sergi_Bruguera-Alberto_Berasategui,2,F-DTM,99,4,1,1,2,45,54
19940605-M-Roland_Garros-F-Sergi_Bruguera-Alberto_Berasategui,2,F-DTL,22,2,0,0,2,11,11
19940605-M-Roland_Garros-F-Sergi_Bruguera-Alberto_Berasategui,2,F-IO,209,26,2,6,18,108,101
19940605-M-Roland_Garros-F-Sergi_Bruguera-Alberto_Berasategui,2,F-II,44,20,8,3,9,20,24
19940605-M-Roland_Garros-F-Sergi_Bruguera-Alberto_Berasategui,2,B-XC,109,13,2,0,11,39,70
19940605-M-Roland_Garros-F-Sergi_Bruguera-Alberto_Berasategui,2,B-DTM,52,5,0,0,5,15,37
19940605-M-Roland_Garros-F-Sergi_Bruguera-Alberto_Berasategui,2,B-DTL,18,7,2,1,4,5,13
19940605-M-Roland_Garros-F-Sergi_Bruguera-Alberto_Berasategui,2,S-XC,8,1,1,0,0,2,6
19940605-M-Roland_Garros-F-Sergi_Bruguera-Alberto_Berasategui,2,S-DTM,4,2,1,0,1,1,3
19940605-M-Roland_Garros-F-Sergi_Bruguera-Alberto_Berasategui,2,S-DTL,1,0,0,0,0,1,0
20160119-M-Australian_Open-R128-Rafael_Nadal-Fernando_Verdasco,1,F-XC,66,18,8,10,0,37,29
20160119-M-Australian_Open-R128-Rafael_Nadal-Fernando_Verdasco,1,F-DTM,33,2,1,1,0,15,18
20160119-M-Australian_Open-R128-Rafael_Nadal-Fernando_Verdasco,1,F-DTL,30,9,3,2,4,17,13
20160119-M-Australian_Open-R128-Rafael_Nadal-Fernando_Verdasco,1,F-IO,41,16,8,4,4,27,14
20160119-M-Australian_Open-R128-Rafael_Nadal-Fernando_Verdasco,1,F-II,7,4,0,3,1,4,3
20160119-M-Australian_Open-R128-Rafael_Nadal-Fernando_Verdasco,1,B-XC,55,9,0,6,3,26,29
20160119-M-Australian_Open-R128-Rafael_Nadal-Fernando_Verdasco,1,B-DTM,34,1,0,1,0,10,24
20160119-M-Australian_Open-R128-Rafael_Nadal-Fernando_Verdasco,1,B-DTL,20,2,1,1,0,12,8
20160119-M-Australian_Open-R128-Rafael_Nadal-Fernando_Verdasco,1,B-IO,9,0,0,0,0,5,4
20160119-M-Australian_Open-R128-Rafael_Nadal-Fernando_Verdasco,1,S-XC,11,0,0,0,0,8,3
20160119-M-Australian_Open-R128-Rafael_Nadal-Fernando_Verdasco,1,S-DTM,8,0,0,0,0,0,8
20160119-M-Australian_Open-R128-Rafael_Nadal-Fernando_Verdasco,1,S-DTL,4,0,0,0,0,0,4
20160119-M-Australian_Open-R128-Rafael_Nadal-Fernando_Verdasco,2,F-XC,85,38,15,14,9,52,33
20160119-M-Australian_Open-R128-Rafael_Nadal-Fernando_Verdasco,2,F-DTM,29,9,0,2,7,14,15
20160119-M-Australian_Open-R128-Rafael_Nadal-Fernando_Verdasco,2,F-DTL,30,15,8,2,5,18,12
20160119-M-Australian_Open-R128-Rafael_Nadal-Fernando_Verdasco,2,F-IO,45,20,10,3,7,31,14
20160119-M-Australian_Open-R128-Rafael_Nadal-Fernando_Verdasco,2,F-II,10,5,2,0,3,3,7
20160119-M-Australian_Open-R128-Rafael_Nadal-Fernando_Verdasco,2,B-XC,74,12,2,3,7,37,37
20160119-M-Australian_Open-R128-Rafael_Nadal-Fernando_Verdasco,2,B-DTM,31,3,0,1,2,18,13
20160119-M-Australian_Open-R128-Rafael_Nadal-Fernando_Verdasco,2,B-DTL,26,13,4,3,6,12,14
20160119-M-Australian_Open-R128-Rafael_Nadal-Fernando_Verdasco,2,B-IO,4,2,1,0,1,2,2
20160119-M-Australian_Open-R128-Rafael_Nadal-Fernando_Verdasco,2,S-XC,6,2,0,1,1,3,3
20160119-M-Australian_Open-R128-Rafael_Nadal-Fernando_Verdasco,2,S-DTM,2,0,0,0,0,0,2
20160119-M-Australian_Open-R128-Rafael_Nadal-Fernando_Verdasco,2,S-DTL,2,1,0,0,1,1,1
20160710-M-Winnetka_CH-F-Yoshihito_Nishioka-Francis_Tiafoe,1,F-XC,60,10,1,5,4,38,22
20160710-M-Winnetka_CH-F-Yoshihito_Nishioka-Francis_Tiafoe,1,F-DTM,26,1,0,0,1,15,11
20160710-M-Winnetka_CH-F-Yoshihito_Nishioka-Francis_Tiafoe,1,F-DTL,13,6,3,1,2,7,6
20160710-M-Winnetka_CH-F-Yoshihito_Nishioka-Francis_Tiafoe,1,F-IO,7,4,2,1,1,5,2
20160710-M-Winnetka_CH-F-Yoshihito_Nishioka-Francis_Tiafoe,1,F-II,2,1,0,0,1,0,2
20160710-M-Winnetka_CH-F-Yoshihito_Nishioka-Francis_Tiafoe,1,B-XC,70,11,3,5,3,41,29
20160710-M-Winnetka_CH-F-Yoshihito_Nishioka-Francis_Tiafoe,1,B-DTM,23,1,0,1,0,13,10
20160710-M-Winnetka_CH-F-Yoshihito_Nishioka-Francis_Tiafoe,1,B-DTL,9,4,1,1,2,3,6
20160710-M-Winnetka_CH-F-Yoshihito_Nishioka-Francis_Tiafoe,1,B-IO,9,3,2,0,1,6,3
20160710-M-Winnetka_CH-F-Yoshihito_Nishioka-Francis_Tiafoe,1,S-XC,1,0,0,0,0,0,1
20160710-M-Winnetka_CH-F-Yoshihito_Nishioka-Francis_Tiafoe,1,S-DTM,2,0,0,0,0,2,0
20160710-M-Winnetka_CH-F-Yoshihito_Nishioka-Francis_Tiafoe,1,S-DTL,2,0,0,0,0,2,0
20160710-M-Winnetka_CH-F-Yoshihito_Nishioka-Francis_Tiafoe,1,S-IO,1,0,0,0,0,0,1
20160710-M-Winnetka_CH-F-Yoshihito_Nishioka-Francis_Tiafoe,2,F-XC,69,15,3,4,8,30,39
20160710-M-Winnetka_CH-F-Yoshihito_Nishioka-Francis_Tiafoe,2,F-DTM,21,3,0,1,2,9,12
20160710-M-Winnetka_CH-F-Yoshihito_Nishioka-Francis_Tiafoe,2,F-DTL,24,4,1,1,2,10,14
20160710-M-Winnetka_CH-F-Yoshihito_Nishioka-Francis_Tiafoe,2,F-IO,16,6,2,1,3,9,7
20160710-M-Winnetka_CH-F-Yoshihito_Nishioka-Francis_Tiafoe,2,F-II,3,1,0,0,1,0,3
20160710-M-Winnetka_CH-F-Yoshihito_Nishioka-Francis_Tiafoe,2,B-XC,38,11,2,2,7,13,25
20160710-M-Winnetka_CH-F-Yoshihito_Nishioka-Francis_Tiafoe,2,B-DTM,21,1,0,1,0,5,16
20160710-M-Winnetka_CH-F-Yoshihito_Nishioka-Francis_Tiafoe,2,B-DTL,16,3,1,0,2,8,8
20160710-M-Winnetka_CH-F-Yoshihito_Nishioka-Francis_Tiafoe,2,B-IO,3,0,0,0,0,1,2
20160710-M-Winnetka_CH-F-Yoshihito_Nishioka-Francis_Tiafoe,2,S-XC,2,0,0,0,0,2,0
20160710-M-Winnetka_CH-F-Yoshihito_Nishioka-Francis_Tiafoe,2,S-DTM,3,0,0,0,0,2,1
20160710-M-Winnetka_CH-F-Yoshihito_Nishioka-Francis_Tiafoe,2,S-DTL,3,1,0,0,1,1,2
20160710-M-Winnetka_CH-F-Yoshihito_Nishioka-Francis_Tiafoe,2,S-IO,1,0,0,0,0,0,1
20150123-M-Australian_Open-R32-Fernando_Verdasco-Novak_Djokovic,1,F-XC,69,19,5,8,6,29,40
20150123-M-Australian_Open-R32-Fernando_Verdasco-Novak_Djokovic,1,F-DTM,20,0,0,0,0,9,11
20150123-M-Australian_Open-R32-Fernando_Verdasco-Novak_Djokovic,1,F-DTL,10,6,2,0,4,2,8
20150123-M-Australian_Open-R32-Fernando_Verdasco-Novak_Djokovic,1,F-IO,27,15,4,3,8,10,17
20150123-M-Australian_Open-R32-Fernando_Verdasco-Novak_Djokovic,1,F-II,5,0,0,0,0,1,4
20150123-M-Australian_Open-R32-Fernando_Verdasco-Novak_Djokovic,1,B-XC,33,8,1,2,5,19,14
20150123-M-Australian_Open-R32-Fernando_Verdasco-Novak_Djokovic,1,B-DTM,15,1,0,0,1,5,10
20150123-M-Australian_Open-R32-Fernando_Verdasco-Novak_Djokovic,1,B-DTL,11,4,2,1,1,7,4
20150123-M-Australian_Open-R32-Fernando_Verdasco-Novak_Djokovic,1,B-IO,6,1,0,0,1,1,5
20150123-M-Australian_Open-R32-Fernando_Verdasco-Novak_Djokovic,1,S-XC,7,0,0,0,0,3,4
20150123-M-Australian_Open-R32-Fernando_Verdasco-Novak_Djokovic,1,S-DTM,5,0,0,0,0,1,4
20150123-M-Australian_Open-R32-Fernando_Verdasco-Novak_Djokovic,1,S-DTL,2,1,0,1,0,1,1
20150123-M-Australian_Open-R32-Fernando_Verdasco-Novak_Djokovic,2,F-XC,49,12,11,1,0,30,19
20150123-M-Australian_Open-R32-Fernando_Verdasco-Novak_Djokovic,2,F-DTM,16,1,0,1,0,11,5
20150123-M-Australian_Open-R32-Fernando_Verdasco-Novak_Djokovic,2,F-DTL,13,7,3,2,2,8,5
20150123-M-Australian_Open-R32-Fernando_Verdasco-Novak_Djokovic,2,F-IO,28,9,3,2,4,19,9
20150123-M-Australian_Open-R32-Fernando_Verdasco-Novak_Djokovic,2,F-II,1,0,0,0,0,1,0
20150123-M-Australian_Open-R32-Fernando_Verdasco-Novak_Djokovic,2,B-XC,31,10,3,4,3,25,6
20150123-M-Australian_Open-R32-Fernando_Verdasco-Novak_Djokovic,2,B-DTM,30,5,0,3,2,15,15
20150123-M-Australian_Open-R32-Fernando_Verdasco-Novak_Djokovic,2,B-DTL,21,6,1,2,3,12,9
20150123-M-Australian_Open-R32-Fernando_Verdasco-Novak_Djokovic,2,B-IO,8,1,1,0,0,4,4
20150123-M-Australian_Open-R32-Fernando_Verdasco-Novak_Djokovic,2,S-XC,1,0,0,0,0,1,0
20150123-M-Australian_Open-R32-Fernando_Verdasco-Novak_Djokovic,2,S-DTM,3,0,0,0,0,0,3
20150123-M-Australian_Open-R32-Fernando_Verdasco-Novak_Djokovic,2,S-DTL,3,1,1,0,0,3,0
20150123-M-Australian_Open-R32-Fernando_Verdasco-Novak_Djokovic,2,S-IO,1,0,0,0,0,1,0
20160710-M-Wimbledon-F-Milos_Raonic-Andy_Murray,1,F-XC,43,9,2,1,6,19,24
20160710-M-Wimbledon-F-Milos_Raonic-Andy_Murray,1,F-DTM,17,2,0,0,2,7,10
20160710-M-Wimbledon-F-Milos_Raonic-Andy_Murray,1,F-DTL,17,7,0,1,6,6,11
20160710-M-Wimbledon-F-Milos_Raonic-Andy_Murray,1,F-IO,41,8,2,1,5,25,16
20160710-M-Wimbledon-F-Milos_Raonic-Andy_Murray,1,F-II,9,4,1,3,0,8,1
20160710-M-Wimbledon-F-Milos_Raonic-Andy_Murray,1,B-XC,6,2,0,0,2,2,4
20160710-M-Wimbledon-F-Milos_Raonic-Andy_Murray,1,B-DTM,14,2,0,0,2,6,8
20160710-M-Wimbledon-F-Milos_Raonic-Andy_Murray,1,B-DTL,2,1,0,0,1,1,1
20160710-M-Wimbledon-F-Milos_Raonic-Andy_Murray,1,B-IO,1,0,0,0,0,1,0
20160710-M-Wimbledon-F-Milos_Raonic-Andy_Murray,1,S-XC,27,6,0,1,5,11,16
20160710-M-Wimbledon-F-Milos_Raonic-Andy_Murray,1,S-DTM,22,2,0,0,2,8,14
20160710-M-Wimbledon-F-Milos_Raonic-Andy_Murray,1,S-DTL,5,1,1,0,0,2,3
20160710-M-Wimbledon-F-Milos_Raonic-Andy_Murray,1,S-IO,2,1,1,0,0,2,0
20160710-M-Wimbledon-F-Milos_Raonic-Andy_Murray,2,F-XC,53,9,3,3,3,35,18
20160710-M-Wimbledon-F-Milos_Raonic-Andy_Murray,2,F-DTM,24,2,0,0,2,10,14
20160710-M-Wimbledon-F-Milos_Raonic-Andy_Murray,2,F-DTL,14,2,0,1,1,7,7
20160710-M-Wimbledon-F-Milos_Raonic-Andy_Murray,2,F-IO,23,6,4,2,0,19,4
20160710-M-Wimbledon-F-Milos_Raonic-Andy_Murray,2,F-II,1,0,0,0,0,0,1
20160710-M-Wimbledon-F-Milos_Raonic-Andy_Murray,2,B-XC,50,16,5,4,7,26,24
20160710-M-Wimbledon-F-Milos_Raonic-Andy_Murray,2,B-DTM,23,1,0,0,1,12,11
20160710-M-Wimbledon-F-Milos_Raonic-Andy_Murray,2,B-DTL,13,9,5,1,3,7,6
20160710-M-Wimbledon-F-Milos_Raonic-Andy_Murray,2,B-IO,5,3,1,0,2,1,4
20160710-M-Wimbledon-F-Milos_Raonic-Andy_Murray,2,S-XC,11,2,0,0,2,1,10
20160710-M-Wimbledon-F-Milos_Raonic-Andy_Murray,2,S-DTM,11,0,0,0,0,5,6
20160710-M-Wimbledon-F-Milos_Raonic-Andy_Murray,2,S-DTL,4,1,0,0,1,3,1
20050908-M-US_Open-QF-Andre_Agassi-James_Blake,1,F-XC,106,33,6,13,14,54,52
20050908-M-US_Open-QF-Andre_Agassi-James_Blake,1,F-DTM,32,3,1,1,1,12,20
20050908-M-US_Open-QF-Andre_Agassi-James_Blake,1,F-DTL,38,12,5,2,5,22,16
20050908-M-US_Open-QF-Andre_Agassi-James_Blake,1,F-IO,28,9,2,3,4,14,14
20050908-M-US_Open-QF-Andre_Agassi-James_Blake,1,F-II,6,3,2,1,0,5,1
20050908-M-US_Open-QF-Andre_Agassi-James_Blake,1,B-XC,88,15,0,5,10,53,35
20050908-M-US_Open-QF-Andre_Agassi-James_Blake,1,B-DTM,26,2,0,1,1,8,18
20050908-M-US_Open-QF-Andre_Agassi-James_Blake,1,B-DTL,12,7,3,2,2,6,6
20050908-M-US_Open-QF-Andre_Agassi-James_Blake,1,B-IO,3,2,1,1,0,2,1
20050908-M-US_Open-QF-Andre_Agassi-James_Blake,1,S-XC,7,0,0,0,0,3,4
20050908-M-US_Open-QF-Andre_Agassi-James_Blake,1,S-DTM,2,0,0,0,0,1,1
20050908-M-US_Open-QF-Andre_Agassi-James_Blake,1,S-DTL,1,0,0,0,0,0,1
20050908-M-US_Open-QF-Andre_Agassi-James_Blake,2,F-XC,93,18,6,1,11,49,44
20050908-M-US_Open-QF-Andre_Agassi-James_Blake,2,F-DTM,26,0,0,0,0,11,15
20050908-M-US_Open-QF-Andre_Agassi-James_Blake,2,F-DTL,20,12,6,2,4,9,11
20050908-M-US_Open-QF-Andre_Agassi-James_Blake,2,F-IO,34,12,6,4,2,24,10
20050908-M-US_Open-QF-Andre_Agassi-James_Blake,2,F-II,7,4,3,0,1,5,2
20050908-M-US_Open-QF-Andre_Agassi-James_Blake,2,B-XC,66,8,1,4,3,29,37
20050908-M-US_Open-QF-Andre_Agassi-James_Blake,2,B-DTM,35,3,0,1,2,16,19
20050908-M-US_Open-QF-Andre_Agassi-James_Blake,2,B-DTL,16,6,0,2,4,7,9
20050908-M-US_Open-QF-Andre_Agassi-James_Blake,2,B-IO,12,2,1,1,0,9,3
20050908-M-US_Open-QF-Andre_Agassi-James_Blake,2,S-XC,15,0,0,0,0,5,10
20050908-M-US_Open-QF-Andre_Agassi-James_Blake,2,S-DTM,10,0,0,0,0,1,9
20050908-M-US_Open-QF-Andre_Agassi-James_Blake,2,S-DTL,4,0,0,0,0,2,2
20050908-M-US_Open-QF-Andre_Agassi-James_Blake,2,S-IO,1,0,0,0,0,1,0
20150503-M-Estoril-F-Richard_Gasquet-Nick_Kyrgios,1,F-XC,31,7,3,1,3,25,6
20150503-M-Estoril-F-Richard_Gasquet-Nick_Kyrgios,1,F-DTM,10,0,0,0,0,7,3
20150503-M-Estoril-F-Richard_Gasquet-Nick_Kyrgios,1,F-DTL,12,3,2,1,0,8,4
20150503-M-Estoril-F-Richard_Gasquet-Nick_Kyrgios,1,F-IO,9,5,1,1,3,4,5
20150503-M-Estoril-F-Richard_Gasquet-Nick_Kyrgios,1,F-II,1,1,0,1,0,1,0
20150503-M-Estoril-F-Richard_Gasquet-Nick_Kyrgios,1,B-XC,41,3,0,3,0,35,6
20150503-M-Estoril-F-Richard_Gasquet-Nick_Kyrgios,1,B-DTM,7,1,1,0,0,4,3
20150503-M-Estoril-F-Richard_Gasquet-Nick_Kyrgios,1,B-DTL,10,5,3,2,0,8,2
20150503-M-Estoril-F-Richard_Gasquet-Nick_Kyrgios,1,B-IO,2,0,0,0,0,2,0
20150503-M-Estoril-F-Richard_Gasquet-Nick_Kyrgios,1,S-XC,10,0,0,0,0,9,1
20150503-M-Estoril-F-Richard_Gasquet-Nick_Kyrgios,1,S-DTM,1,0,0,0,0,1,0
20150503-M-Estoril-F-Richard_Gasquet-Nick_Kyrgios,1,S-DTL,1,0,0,0,0,1,0
20150503-M-Estoril-F-Richard_Gasquet-Nick_Kyrgios,2,F-XC,34,8,4,3,1,14,20
20150503-M-Estoril-F-Richard_Gasquet-Nick_Kyrgios,2,F-DTM,9,0,0,0,0,3,6
20150503-M-Estoril-F-Richard_Gasquet-Nick_Kyrgios,2,F-DTL,9,3,0,1,2,2,7
20150503-M-Estoril-F-Richard_Gasquet-Nick_Kyrgios,2,F-IO,14,4,2,1,1,4,10
20150503-M-Estoril-F-Richard_Gasquet-Nick_Kyrgios,2,F-II,8,3,1,1,1,4,4
20150503-M-Estoril-F-Richard_Gasquet-Nick_Kyrgios,2,B-XC,39,6,0,0,6,9,30
20150503-M-Estoril-F-Richard_Gasquet-Nick_Kyrgios,2,B-DTM,10,4,1,0,3,2,8
20150503-M-Estoril-F-Richard_Gasquet-Nick_Kyrgios,2,B-DTL,12,4,2,0,2,3,9
20150503-M-Estoril-F-Richard_Gasquet-Nick_Kyrgios,2,B-IO,3,1,0,0,1,0,3
20150503-M-Estoril-F-Richard_Gasquet-Nick_Kyrgios,2,S-XC,2,0,0,0,0,0,2
20150503-M-Estoril-F-Richard_Gasquet-Nick_Kyrgios,2,S-DTM,1,0,0,0,0,0,1
20150503-M-Estoril-F-Richard_Gasquet-Nick_Kyrgios,2,S-DTL,2,1,0,0,1,0,2
20160716-M-Hamburg-SF-Pablo_Cuevas-Renzo_Olivo,1,F-XC,42,16,7,4,5,29,13
20160716-M-Hamburg-SF-Pablo_Cuevas-Renzo_Olivo,1,F-DTM,30,4,0,0,4,13,17
20160716-M-Hamburg-SF-Pablo_Cuevas-Renzo_Olivo,1,F-DTL,7,2,0,1,1,3,4
20160716-M-Hamburg-SF-Pablo_Cuevas-Renzo_Olivo,1,F-IO,49,17,4,7,6,32,17
20160716-M-Hamburg-SF-Pablo_Cuevas-Renzo_Olivo,1,F-II,2,0,0,0,0,0,2
20160716-M-Hamburg-SF-Pablo_Cuevas-Renzo_Olivo,1,B-XC,26,2,0,1,1,14,12
20160716-M-Hamburg-SF-Pablo_Cuevas-Renzo_Olivo,1,B-DTM,22,5,0,4,1,11,11
20160716-M-Hamburg-SF-Pablo_Cuevas-Renzo_Olivo,1,B-DTL,3,3,1,1,1,2,1
20160716-M-Hamburg-SF-Pablo_Cuevas-Renzo_Olivo,1,B-IO,3,1,1,0,0,2,1
20160716-M-Hamburg-SF-Pablo_Cuevas-Renzo_Olivo,1,S-XC,5,2,0,2,0,2,3
20160716-M-Hamburg-SF-Pablo_Cuevas-Renzo_Olivo,1,S-DTM,1,0,0,0,0,0,1
20160716-M-Hamburg-SF-Pablo_Cuevas-Renzo_Olivo,2,F-XC,29,8,1,4,3,16,13
20160716-M-Hamburg-SF-Pablo_Cuevas-Renzo_Olivo,2,F-DTM,27,2,0,0,2,17,10
20160716-M-Hamburg-SF-Pablo_Cuevas-Renzo_Olivo,2,F-DTL,5,2,1,1,0,2,3
20160716-M-Hamburg-SF-Pablo_Cuevas-Renzo_Olivo,2,F-IO,28,8,0,5,3,16,12
20160716-M-Hamburg-SF-Pablo_Cuevas-Renzo_Olivo,2,F-II,4,1,0,0,1,3,1
20160716-M-Hamburg-SF-Pablo_Cuevas-Renzo_Olivo,2,B-XC,21,3,1,1,1,8,13
20160716-M-Hamburg-SF-Pablo_Cuevas-Renzo_Olivo,2,B-DTM,27,3,0,0,3,12,15
20160716-M-Hamburg-SF-Pablo_Cuevas-Renzo_Olivo,2,B-DTL,6,4,3,0,1,4,2
20160716-M-Hamburg-SF-Pablo_Cuevas-Renzo_Olivo,2,B-IO,1,0,0,0,0,1,0
20160716-M-Hamburg-SF-Pablo_Cuevas-Renzo_Olivo,2,S-XC,14,1,0,0,1,6,8
20160716-M-Hamburg-SF-Pablo_Cuevas-Renzo_Olivo,2,S-DTM,9,0,0,0,0,1,8
20160716-M-Hamburg-SF-Pablo_Cuevas-Renzo_Olivo,2,S-IO,1,0,0,0,0,0,1
20160716-M-Hamburg-SF-Martin_Klizan-Stephane_Robert,1,F-XC,27,7,2,3,2,16,11
20160716-M-Hamburg-SF-Martin_Klizan-Stephane_Robert,1,F-DTM,19,1,0,0,1,10,9
20160716-M-Hamburg-SF-Martin_Klizan-Stephane_Robert,1,F-DTL,7,4,2,0,2,3,4
20160716-M-Hamburg-SF-Martin_Klizan-Stephane_Robert,1,F-IO,12,6,1,4,1,10,2
20160716-M-Hamburg-SF-Martin_Klizan-Stephane_Robert,1,F-II,1,0,0,0,0,0,1
20160716-M-Hamburg-SF-Martin_Klizan-Stephane_Robert,1,B-XC,38,10,2,5,3,25,13
20160716-M-Hamburg-SF-Martin_Klizan-Stephane_Robert,1,B-DTM,14,3,0,0,3,6,8
20160716-M-Hamburg-SF-Martin_Klizan-Stephane_Robert,1,B-DTL,9,4,2,0,2,4,5
20160716-M-Hamburg-SF-Martin_Klizan-Stephane_Robert,1,B-IO,5,1,0,0,1,2,3
20160716-M-Hamburg-SF-Martin_Klizan-Stephane_Robert,1,B-II,1,0,0,0,0,1,0
20160716-M-Hamburg-SF-Martin_Klizan-Stephane_Robert,1,S-DTM,5,0,0,0,0,4,1
20160716-M-Hamburg-SF-Martin_Klizan-Stephane_Robert,2,F-XC,26,4,2,2,0,10,16
20160716-M-Hamburg-SF-Martin_Klizan-Stephane_Robert,2,F-DTM,20,4,2,0,2,9,11
20160716-M-Hamburg-SF-Martin_Klizan-Stephane_Robert,2,F-DTL,14,8,5,0,3,6,8
20160716-M-Hamburg-SF-Martin_Klizan-Stephane_Robert,2,F-IO,10,7,3,0,4,4,6
20160716-M-Hamburg-SF-Martin_Klizan-Stephane_Robert,2,B-XC,20,4,1,0,3,9,11
20160716-M-Hamburg-SF-Martin_Klizan-Stephane_Robert,2,B-DTM,29,1,0,0,1,13,16
20160716-M-Hamburg-SF-Martin_Klizan-Stephane_Robert,2,B-DTL,15,3,2,1,0,6,9
20160716-M-Hamburg-SF-Martin_Klizan-Stephane_Robert,2,B-IO,10,1,0,0,1,6,4
20110120-M-Australian_Open-R64-Gilles_Simon-Roger_Federer,1,F-XC,102,21,8,7,6,55,47
20110120-M-Australian_Open-R64-Gilles_Simon-Roger_Federer,1,F-DTM,44,3,0,1,2,16,28
20110120-M-Australian_Open-R64-Gilles_Simon-Roger_Federer,1,F-DTL,35,10,4,3,3,16,19
20110120-M-Australian_Open-R64-Gilles_Simon-Roger_Federer,1,F-IO,57,9,2,5,2,31,26
20110120-M-Australian_Open-R64-Gilles_Simon-Roger_Federer,1,F-II,5,1,0,0,1,1,4
20110120-M-Australian_Open-R64-Gilles_Simon-Roger_Federer,1,B-XC,194,19,7,1,11,92,102
20110120-M-Australian_Open-R64-Gilles_Simon-Roger_Federer,1,B-DTM,42,2,0,0,2,18,24
20110120-M-Australian_Open-R64-Gilles_Simon-Roger_Federer,1,B-DTL,34,6,3,1,2,21,13
20110120-M-Australian_Open-R64-Gilles_Simon-Roger_Federer,1,B-IO,2,0,0,0,0,2,0
20110120-M-Australian_Open-R64-Gilles_Simon-Roger_Federer,1,S-XC,6,0,0,0,0,2,4
20110120-M-Australian_Open-R64-Gilles_Simon-Roger_Federer,1,S-DTM,4,1,0,0,1,0,4
20110120-M-Australian_Open-R64-Gilles_Simon-Roger_Federer,1,S-DTL,1,0,0,0,0,0,1
20110120-M-Australian_Open-R64-Gilles_Simon-Roger_Federer,2,F-XC,100,26,5,8,13,52,48
20110120-M-Australian_Open-R64-Gilles_Simon-Roger_Federer,2,F-DTM,30,2,0,1,1,17,13
20110120-M-Australian_Open-R64-Gilles_Simon-Roger_Federer,2,F-DTL,37,7,1,3,3,21,16
20110120-M-Australian_Open-R64-Gilles_Simon-Roger_Federer,2,F-IO,63,15,5,4,6,31,32
20110120-M-Australian_Open-R64-Gilles_Simon-Roger_Federer,2,F-II,25,5,0,1,4,14,11
20110120-M-Australian_Open-R64-Gilles_Simon-Roger_Federer,2,B-XC,103,15,1,5,9,60,43
20110120-M-Australian_Open-R64-Gilles_Simon-Roger_Federer,2,B-DTM,57,2,0,0,2,21,36
20110120-M-Australian_Open-R64-Gilles_Simon-Roger_Federer,2,B-DTL,25,7,1,2,4,12,13
20110120-M-Australian_Open-R64-Gilles_Simon-Roger_Federer,2,B-IO,6,2,1,0,1,5,1
20110120-M-Australian_Open-R64-Gilles_Simon-Roger_Federer,2,S-XC,37,0,0,0,0,21,16
20110120-M-Australian_Open-R64-Gilles_Simon-Roger_Federer,2,S-DTM,10,0,0,0,0,3,7
20110120-M-Australian_Open-R64-Gilles_Simon-Roger_Federer,2,S-DTL,10,1,0,1,0,5,5
20110120-M-Australian_Open-R64-Gilles_Simon-Roger_Federer,2,S-IO,2,0,0,0,0,2,0
19910609-M-Roland_Garros-F-Andre_Agassi-Jim_Courier,1,F-XC,67,17,5,2,10,33,34
19910609-M-Roland_Garros-F-Andre_Agassi-Jim_Courier,1,F-DTM,54,5,0,0,5,27,27
19910609-M-Roland_Garros-F-Andre_Agassi-Jim_Courier,1,F-DTL,11,3,1,0,2,4,7
19910609-M-Roland_Garros-F-Andre_Agassi-Jim_Courier,1,F-IO,85,21,9,6,6,57,28
19910609-M-Roland_Garros-F-Andre_Agassi-Jim_Courier,1,F-II,22,10,3,4,3,14,8
19910609-M-Roland_Garros-F-Andre_Agassi-Jim_Courier,1,B-XC,100,16,1,4,11,49,51
19910609-M-Roland_Garros-F-Andre_Agassi-Jim_Courier,1,B-DTM,40,3,1,0,2,20,20
19910609-M-Roland_Garros-F-Andre_Agassi-Jim_Courier,1,B-DTL,19,12,2,2,8,7,12
19910609-M-Roland_Garros-F-Andre_Agassi-Jim_Courier,1,B-IO,4,3,1,0,2,1,3
19910609-M-Roland_Garros-F-Andre_Agassi-Jim_Courier,1,S-XC,4,0,0,0,0,1,3
19910609-M-Roland_Garros-F-Andre_Agassi-Jim_Courier,1,S-DTM,2,0,0,0,0,0,2
19910609-M-Roland_Garros-F-Andre_Agassi-Jim_Courier,2,F-XC,57,19,7,3,9,28,29
19910609-M-Roland_Garros-F-Andre_Agassi-Jim_Courier,2,F-DTM,61,4,0,0,4,28,33
19910609-M-Roland_Garros-F-Andre_Agassi-Jim_Courier,2,F-DTL,17,3,1,1,1,11,6
19910609-M-Roland_Garros-F-Andre_Agassi-Jim_Courier,2,F-IO,54,17,7,6,4,30,24
19910609-M-Roland_Garros-F-Andre_Agassi-Jim_Courier,2,F-II,6,2,1,0,1,4,2
19910609-M-Roland_Garros-F-Andre_Agassi-Jim_Courier,2,B-XC,75,10,0,4,6,32,43
19910609-M-Roland_Garros-F-Andre_Agassi-Jim_Courier,2,B-DTM,64,8,0,1,7,32,32
19910609-M-Roland_Garros-F-Andre_Agassi-Jim_Courier,2,B-DTL,12,11,3,1,7,5,7
19910609-M-Roland_Garros-F-Andre_Agassi-Jim_Courier,2,B-IO,4,2,2,0,0,3,1
19910609-M-Roland_Garros-F-Andre_Agassi-Jim_Courier,2,S-XC,26,0,0,0,0,9,17
19910609-M-Roland_Garros-F-Andre_Agassi-Jim_Courier,2,S-DTM,20,3,0,0,3,6,14
19910609-M-Roland_Garros-F-Andre_Agassi-Jim_Courier,2,S-DTL,8,3,1,0,2,5,3
20111127-M-Tour_Finals-F-Roger_Federer-Jo_Wilfried_Tsonga,1,F-XC,34,7,3,2,2,24,10
20111127-M-Tour_Finals-F-Roger_Federer-Jo_Wilfried_Tsonga,1,F-DTM,33,5,0,0,5,9,24
20111127-M-Tour_Finals-F-Roger_Federer-Jo_Wilfried_Tsonga,1,F-DTL,9,4,0,1,3,3,6
20111127-M-Tour_Finals-F-Roger_Federer-Jo_Wilfried_Tsonga,1,F-IO,21,4,1,2,1,12,9
20111127-M-Tour_Finals-F-Roger_Federer-Jo_Wilfried_Tsonga,1,F-II,8,3,0,3,0,5,3
20111127-M-Tour_Finals-F-Roger_Federer-Jo_Wilfried_Tsonga,1,B-XC,24,5,0,0,5,5,19
20111127-M-Tour_Finals-F-Roger_Federer-Jo_Wilfried_Tsonga,1,B-DTM,19,3,0,1,2,7,12
20111127-M-Tour_Finals-F-Roger_Federer-Jo_Wilfried_Tsonga,1,B-DTL,9,4,1,1,2,6,3
20111127-M-Tour_Finals-F-Roger_Federer-Jo_Wilfried_Tsonga,1,B-IO,1,1,1,0,0,1,0
20111127-M-Tour_Finals-F-Roger_Federer-Jo_Wilfried_Tsonga,1,S-XC,6,0,0,0,0,4,2
20111127-M-Tour_Finals-F-Roger_Federer-Jo_Wilfried_Tsonga,1,S-DTM,5,0,0,0,0,2,3
20111127-M-Tour_Finals-F-Roger_Federer-Jo_Wilfried_Tsonga,1,S-DTL,2,0,0,0,0,0,2
20111127-M-Tour_Finals-F-Roger_Federer-Jo_Wilfried_Tsonga,2,F-XC,33,10,4,3,3,21,12
20111127-M-Tour_Finals-F-Roger_Federer-Jo_Wilfried_Tsonga,2,F-DTM,30,5,1,0,4,16,14
20111127-M-Tour_Finals-F-Roger_Federer-Jo_Wilfried_Tsonga,2,F-DTL,10,5,0,0,5,3,7
20111127-M-Tour_Finals-F-Roger_Federer-Jo_Wilfried_Tsonga,2,F-IO,26,6,1,1,4,15,11
20111127-M-Tour_Finals-F-Roger_Federer-Jo_Wilfried_Tsonga,2,B-XC,22,5,1,2,2,12,10
20111127-M-Tour_Finals-F-Roger_Federer-Jo_Wilfried_Tsonga,2,B-DTM,17,2,0,0,2,4,13
20111127-M-Tour_Finals-F-Roger_Federer-Jo_Wilfried_Tsonga,2,B-DTL,8,3,2,1,0,6,2
20111127-M-Tour_Finals-F-Roger_Federer-Jo_Wilfried_Tsonga,2,B-IO,3,3,1,0,2,1,2
20111127-M-Tour_Finals-F-Roger_Federer-Jo_Wilfried_Tsonga,2,S-XC,13,2,1,0,1,9,4
20111127-M-Tour_Finals-F-Roger_Federer-Jo_Wilfried_Tsonga,2,S-DTM,5,0,0,0,0,1,4
20101128-M-Tour_Finals-F-Roger_Federer-Rafael_Nadal,1,F-XC,31,7,3,2,2,18,13
20101128-M-Tour_Finals-F-Roger_Federer-Rafael_Nadal,1,F-DTM,16,3,0,0,3,11,5
20101128-M-Tour_Finals-F-Roger_Federer-Rafael_Nadal,1,F-DTL,3,3,1,0,2,1,2
20101128-M-Tour_Finals-F-Roger_Federer-Rafael_Nadal,1,F-IO,19,11,7,3,1,15,4
20101128-M-Tour_Finals-F-Roger_Federer-Rafael_Nadal,1,F-II,2,1,1,0,0,1,1
20101128-M-Tour_Finals-F-Roger_Federer-Rafael_Nadal,1,B-XC,25,9,5,1,3,10,15
20101128-M-Tour_Finals-F-Roger_Federer-Rafael_Nadal,1,B-DTM,36,2,0,0,2,22,14
20101128-M-Tour_Finals-F-Roger_Federer-Rafael_Nadal,1,B-DTL,9,2,0,1,1,5,4
20101128-M-Tour_Finals-F-Roger_Federer-Rafael_Nadal,1,B-IO,1,0,0,0,0,0,1
20101128-M-Tour_Finals-F-Roger_Federer-Rafael_Nadal,1,S-XC,7,2,0,1,1,3,4
20101128-M-Tour_Finals-F-Roger_Federer-Rafael_Nadal,1,S-DTM,4,0,0,0,0,1,3
20101128-M-Tour_Finals-F-Roger_Federer-Rafael_Nadal,1,S-DTL,1,0,0,0,0,0,1
20101128-M-Tour_Finals-F-Roger_Federer-Rafael_Nadal,1,S-IO,2,0,0,0,0,1,1
20101128-M-Tour_Finals-F-Roger_Federer-Rafael_Nadal,2,F-XC,67,6,2,2,2,34,33
20101128-M-Tour_Finals-F-Roger_Federer-Rafael_Nadal,2,F-DTM,20,3,1,2,0,11,9
20101128-M-Tour_Finals-F-Roger_Federer-Rafael_Nadal,2,F-DTL,11,6,3,0,3,6,5
20101128-M-Tour_Finals-F-Roger_Federer-Rafael_Nadal,2,F-IO,7,2,0,1,1,4,3
20101128-M-Tour_Finals-F-Roger_Federer-Rafael_Nadal,2,F-II,5,1,0,0,1,1,4
20101128-M-Tour_Finals-F-Roger_Federer-Rafael_Nadal,2,B-XC,19,5,1,2,2,12,7
20101128-M-Tour_Finals-F-Roger_Federer-Rafael_Nadal,2,B-DTM,17,2,0,0,2,4,13
20101128-M-Tour_Finals-F-Roger_Federer-Rafael_Nadal,2,B-DTL,8,2,0,0,2,5,3
20101128-M-Tour_Finals-F-Roger_Federer-Rafael_Nadal,2,B-IO,6,1,0,0,1,1,5
20101128-M-Tour_Finals-F-Roger_Federer-Rafael_Nadal,2,S-XC,1,1,0,1,0,1,0
20101128-M-Tour_Finals-F-Roger_Federer-Rafael_Nadal,2,S-DTM,5,1,0,0,1,2,3
20101128-M-Tour_Finals-F-Roger_Federer-Rafael_Nadal,2,S-DTL,3,0,0,0,0,1,2
20100108-M-Doha-SF-Roger_Federer-Nikolay_Davydenko,1,F-XC,32,11,4,4,3,17,15
20100108-M-Doha-SF-Roger_Federer-Nikolay_Davydenko,1,F-DTM,14,3,1,0,2,6,8
20100108-M-Doha-SF-Roger_Federer-Nikolay_Davydenko,1,F-DTL,8,0,0,0,0,3,5
20100108-M-Doha-SF-Roger_Federer-Nikolay_Davydenko,1,F-IO,18,8,3,0,5,6,12
20100108-M-Doha-SF-Roger_Federer-Nikolay_Davydenko,1,F-II,3,1,1,0,0,2,1
20100108-M-Doha-SF-Roger_Federer-Nikolay_Davydenko,1,B-XC,19,2,0,0,2,6,13
20100108-M-Doha-SF-Roger_Federer-Nikolay_Davydenko,1,B-DTM,14,2,0,1,1,5,9
20100108-M-Doha-SF-Roger_Federer-Nikolay_Davydenko,1,B-DTL,9,5,0,2,3,4,5
20100108-M-Doha-SF-Roger_Federer-Nikolay_Davydenko,1,S-XC,12,1,0,0,1,5,7
20100108-M-Doha-SF-Roger_Federer-Nikolay_Davydenko,1,S-DTM,8,0,0,0,0,3,5
20100108-M-Doha-SF-Roger_Federer-Nikolay_Davydenko,1,S-DTL,2,0,0,0,0,0,2
20100108-M-Doha-SF-Roger_Federer-Nikolay_Davydenko,2,F-XC,26,6,2,2,2,13,13
20100108-M-Doha-SF-Roger_Federer-Nikolay_Davydenko,2,F-DTM,11,1,0,1,0,7,4
20100108-M-Doha-SF-Roger_Federer-Nikolay_Davydenko,2,F-DTL,12,4,1,1,2,7,5
20100108-M-Doha-SF-Roger_Federer-Nikolay_Davydenko,2,F-IO,14,3,1,0,2,6,8
20100108-M-Doha-SF-Roger_Federer-Nikolay_Davydenko,2,F-II,4,0,0,0,0,3,1
20100108-M-Doha-SF-Roger_Federer-Nikolay_Davydenko,2,B-XC,43,10,4,5,1,30,13
20100108-M-Doha-SF-Roger_Federer-Nikolay_Davydenko,2,B-DTM,15,3,0,1,2,9,6
20100108-M-Doha-SF-Roger_Federer-Nikolay_Davydenko,2,B-DTL,8,3,1,0,2,5,3
20100108-M-Doha-SF-Roger_Federer-Nikolay_Davydenko,2,B-IO,3,1,0,0,1,2,1
20100108-M-Doha-SF-Roger_Federer-Nikolay_Davydenko,2,S-DTM,1,0,0,0,0,1,0
20160731-M-Astana_CH-F-Evgeny_Donskoy-Konstantin_Kravchuk,1,F-XC,27,13,3,6,4,21,6
20160731-M-Astana_CH-F-Evgeny_Donskoy-Konstantin_Kravchuk,1,F-DTM,9,0,0,0,0,5,4
20160731-M-Astana_CH-F-Evgeny_Donskoy-Konstantin_Kravchuk,1,F-DTL,5,2,1,0,1,3,2
20160731-M-Astana_CH-F-Evgeny_Donskoy-Konstantin_Kravchuk,1,F-IO,15,6,1,4,1,11,4
20160731-M-Astana_CH-F-Evgeny_Donskoy-Konstantin_Kravchuk,1,F-II,3,2,0,2,0,3,0
20160731-M-Astana_CH-F-Evgeny_Donskoy-Konstantin_Kravchuk,1,B-XC,19,1,1,0,0,11,8
20160731-M-Astana_CH-F-Evgeny_Donskoy-Konstantin_Kravchuk,1,B-DTM,8,0,0,0,0,4,4
20160731-M-Astana_CH-F-Evgeny_Donskoy-Konstantin_Kravchuk,1,B-DTL,5,4,3,0,1,4,1
20160731-M-Astana_CH-F-Evgeny_Donskoy-Konstantin_Kravchuk,1,S-XC,4,2,0,0,2,1,3
20160731-M-Astana_CH-F-Evgeny_Donskoy-Konstantin_Kravchuk,1,S-DTM,1,0,0,0,0,0,1
20160731-M-Astana_CH-F-Evgeny_Donskoy-Konstantin_Kravchuk,2,F-XC,15,5,2,1,2,6,9
20160731-M-Astana_CH-F-Evgeny_Donskoy-Konstantin_Kravchuk,2,F-DTM,11,1,0,1,0,4,7
20160731-M-Astana_CH-F-Evgeny_Donskoy-Konstantin_Kravchuk,2,F-DTL,2,0,0,0,0,0,2
20160731-M-Astana_CH-F-Evgeny_Donskoy-Konstantin_Kravchuk,2,F-IO,11,4,1,1,2,7,4
20160731-M-Astana_CH-F-Evgeny_Donskoy-Konstantin_Kravchuk,2,F-II,2,1,0,1,0,1,1
20160731-M-Astana_CH-F-Evgeny_Donskoy-Konstantin_Kravchuk,2,B-XC,15,3,1,0,2,8,7
20160731-M-Astana_CH-F-Evgeny_Donskoy-Konstantin_Kravchuk,2,B-DTM,6,0,0,0,0,2,4
20160731-M-Astana_CH-F-Evgeny_Donskoy-Konstantin_Kravchuk,2,B-DTL,8,5,2,0,3,3,5
20160731-M-Astana_CH-F-Evgeny_Donskoy-Konstantin_Kravchuk,2,B-IO,1,1,0,0,1,0,1
20160731-M-Astana_CH-F-Evgeny_Donskoy-Konstantin_Kravchuk,2,S-XC,10,3,0,0,3,1,9
20160731-M-Astana_CH-F-Evgeny_Donskoy-Konstantin_Kravchuk,2,S-DTM,1,0,0,0,0,1,0
20160731-M-Astana_CH-F-Evgeny_Donskoy-Konstantin_Kravchuk,2,S-DTL,3,0,0,0,0,1,2
20160731-M-Astana_CH-F-Evgeny_Donskoy-Konstantin_Kravchuk,2,S-IO,1,0,0,0,0,0,1
20160126-M-Australian_Open-QF-Roger_Federer-Tomas_Berdych,1,F-XC,33,16,11,3,2,23,10
20160126-M-Australian_Open-QF-Roger_Federer-Tomas_Berdych,1,F-DTM,37,3,0,1,2,17,20
20160126-M-Australian_Open-QF-Roger_Federer-Tomas_Berdych,1,F-DTL,4,2,1,0,1,2,2
20160126-M-Australian_Open-QF-Roger_Federer-Tomas_Berdych,1,F-IO,30,12,7,2,3,19,11
20160126-M-Australian_Open-QF-Roger_Federer-Tomas_Berdych,1,F-II,3,1,1,0,0,2,1
20160126-M-Australian_Open-QF-Roger_Federer-Tomas_Berdych,1,B-XC,26,6,3,2,1,19,7
20160126-M-Australian_Open-QF-Roger_Federer-Tomas_Berdych,1,B-DTM,32,7,1,0,6,17,15
20160126-M-Australian_Open-QF-Roger_Federer-Tomas_Berdych,1,B-DTL,9,4,2,0,2,6,3
20160126-M-Australian_Open-QF-Roger_Federer-Tomas_Berdych,1,S-XC,7,0,0,0,0,5,2
20160126-M-Australian_Open-QF-Roger_Federer-Tomas_Berdych,1,S-DTM,9,1,0,0,1,6,3
20160126-M-Australian_Open-QF-Roger_Federer-Tomas_Berdych,1,S-DTL,1,1,0,0,1,0,1
20160126-M-Australian_Open-QF-Roger_Federer-Tomas_Berdych,1,S-IO,1,0,0,0,0,1,0
20160126-M-Australian_Open-QF-Roger_Federer-Tomas_Berdych,2,F-XC,37,11,4,3,4,19,18
20160126-M-Australian_Open-QF-Roger_Federer-Tomas_Berdych,2,F-DTM,30,3,0,0,3,14,16
20160126-M-Australian_Open-QF-Roger_Federer-Tomas_Berdych,2,F-DTL,8,2,1,0,1,4,4
20160126-M-Australian_Open-QF-Roger_Federer-Tomas_Berdych,2,F-IO,41,12,5,5,2,19,22
20160126-M-Australian_Open-QF-Roger_Federer-Tomas_Berdych,2,F-II,3,3,1,2,0,3,0
20160126-M-Australian_Open-QF-Roger_Federer-Tomas_Berdych,2,B-XC,32,4,0,0,4,8,24
20160126-M-Australian_Open-QF-Roger_Federer-Tomas_Berdych,2,B-DTM,19,1,0,0,1,6,13
20160126-M-Australian_Open-QF-Roger_Federer-Tomas_Berdych,2,B-DTL,7,3,1,2,0,5,2
20160126-M-Australian_Open-QF-Roger_Federer-Tomas_Berdych,2,B-IO,4,2,0,0,2,2,2
20160126-M-Australian_Open-QF-Roger_Federer-Tomas_Berdych,2,S-XC,12,0,0,0,0,3,9
20160126-M-Australian_Open-QF-Roger_Federer-Tomas_Berdych,2,S-DTM,9,1,0,0,1,5,4
20160126-M-Australian_Open-QF-Roger_Federer-Tomas_Berdych,2,S-DTL,4,1,0,0,1,0,4
20160126-M-Australian_Open-QF-Roger_Federer-Tomas_Berdych,2,S-IO,1,1,0,0,1,0,1
20031116-M-Masters_Cup-F-Roger_Federer-Andre_Agassi,1,F-XC,31,15,9,2,4,21,10
20031116-M-Masters_Cup-F-Roger_Federer-Andre_Agassi,1,F-DTM,17,3,1,1,1,11,6
20031116-M-Masters_Cup-F-Roger_Federer-Andre_Agassi,1,F-DTL,6,2,0,2,0,6,0
20031116-M-Masters_Cup-F-Roger_Federer-Andre_Agassi,1,F-IO,11,7,5,1,1,7,4
20031116-M-Masters_Cup-F-Roger_Federer-Andre_Agassi,1,F-II,3,2,0,1,1,1,2
20031116-M-Masters_Cup-F-Roger_Federer-Andre_Agassi,1,B-XC,23,4,1,1,2,15,8
20031116-M-Masters_Cup-F-Roger_Federer-Andre_Agassi,1,B-DTM,24,1,0,0,1,9,15
20031116-M-Masters_Cup-F-Roger_Federer-Andre_Agassi,1,B-DTL,8,7,4,1,2,6,2
20031116-M-Masters_Cup-F-Roger_Federer-Andre_Agassi,1,B-IO,4,3,3,0,0,3,1
20031116-M-Masters_Cup-F-Roger_Federer-Andre_Agassi,1,S-XC,13,2,0,1,1,8,5
20031116-M-Masters_Cup-F-Roger_Federer-Andre_Agassi,1,S-DTM,2,0,0,0,0,0,2
20031116-M-Masters_Cup-F-Roger_Federer-Andre_Agassi,1,S-DTL,4,1,0,0,1,1,3
20031116-M-Masters_Cup-F-Roger_Federer-Andre_Agassi,2,F-XC,29,11,3,1,7,11,18
20031116-M-Masters_Cup-F-Roger_Federer-Andre_Agassi,2,F-DTM,16,3,1,0,2,5,11
20031116-M-Masters_Cup-F-Roger_Federer-Andre_Agassi,2,F-DTL,6,5,1,2,2,3,3
20031116-M-Masters_Cup-F-Roger_Federer-Andre_Agassi,2,F-IO,13,7,1,3,3,8,5
20031116-M-Masters_Cup-F-Roger_Federer-Andre_Agassi,2,B-XC,56,4,0,1,3,26,30
20031116-M-Masters_Cup-F-Roger_Federer-Andre_Agassi,2,B-DTM,17,3,0,1,2,9,8
20031116-M-Masters_Cup-F-Roger_Federer-Andre_Agassi,2,B-DTL,11,5,2,1,2,5,6
20031116-M-Masters_Cup-F-Roger_Federer-Andre_Agassi,2,B-IO,2,1,0,1,0,2,0
20031116-M-Masters_Cup-F-Roger_Federer-Andre_Agassi,2,S-XC,3,0,0,0,0,1,2
20031116-M-Masters_Cup-F-Roger_Federer-Andre_Agassi,2,S-DTM,3,1,0,0,1,1,2
20070905-M-US_Open-QF-Roger_Federer-Andy_Roddick,1,F-XC,53,25,8,9,8,38,15
20070905-M-US_Open-QF-Roger_Federer-Andy_Roddick,1,F-DTM,37,3,2,0,1,23,14
20070905-M-US_Open-QF-Roger_Federer-Andy_Roddick,1,F-DTL,13,6,1,3,2,6,7
20070905-M-US_Open-QF-Roger_Federer-Andy_Roddick,1,F-IO,17,6,3,1,2,12,5
20070905-M-US_Open-QF-Roger_Federer-Andy_Roddick,1,F-II,5,4,0,3,1,4,1
20070905-M-US_Open-QF-Roger_Federer-Andy_Roddick,1,B-XC,31,4,4,0,0,21,10
20070905-M-US_Open-QF-Roger_Federer-Andy_Roddick,1,B-DTM,29,1,0,0,1,17,12
20070905-M-US_Open-QF-Roger_Federer-Andy_Roddick,1,B-DTL,11,8,3,1,4,5,6
20070905-M-US_Open-QF-Roger_Federer-Andy_Roddick,1,B-IO,4,2,2,0,0,2,2
20070905-M-US_Open-QF-Roger_Federer-Andy_Roddick,1,S-XC,15,0,0,0,0,11,4
20070905-M-US_Open-QF-Roger_Federer-Andy_Roddick,1,S-DTM,11,1,0,0,1,7,4
20070905-M-US_Open-QF-Roger_Federer-Andy_Roddick,1,S-DTL,3,0,0,0,0,2,1
20070905-M-US_Open-QF-Roger_Federer-Andy_Roddick,1,S-IO,1,0,0,0,0,1,0
20070905-M-US_Open-QF-Roger_Federer-Andy_Roddick,2,F-XC,37,7,0,3,4,16,21
20070905-M-US_Open-QF-Roger_Federer-Andy_Roddick,2,F-DTM,34,5,1,1,3,10,24
20070905-M-US_Open-QF-Roger_Federer-Andy_Roddick,2,F-DTL,9,2,0,0,2,2,7
20070905-M-US_Open-QF-Roger_Federer-Andy_Roddick,2,F-IO,41,10,3,2,5,21,20
20070905-M-US_Open-QF-Roger_Federer-Andy_Roddick,2,F-II,5,2,1,0,1,1,4
20070905-M-US_Open-QF-Roger_Federer-Andy_Roddick,2,B-XC,26,4,2,1,1,13,13
20070905-M-US_Open-QF-Roger_Federer-Andy_Roddick,2,B-DTM,27,1,0,0,1,8,19
20070905-M-US_Open-QF-Roger_Federer-Andy_Roddick,2,B-DTL,9,3,0,1,2,3,6
20070905-M-US_Open-QF-Roger_Federer-Andy_Roddick,2,B-IO,4,2,0,0,2,0,4
20070905-M-US_Open-QF-Roger_Federer-Andy_Roddick,2,S-XC,9,0,0,0,0,3,6
20070905-M-US_Open-QF-Roger_Federer-Andy_Roddick,2,S-DTM,2,0,0,0,0,0,2
20061119-M-Masters_Cup-F-Roger_Federer-James_Blake,1,F-XC,23,6,1,3,2,11,12
20061119-M-Masters_Cup-F-Roger_Federer-James_Blake,1,F-DTM,21,4,1,0,3,14,7
20061119-M-Masters_Cup-F-Roger_Federer-James_Blake,1,F-DTL,9,4,0,2,2,6,3
20061119-M-Masters_Cup-F-Roger_Federer-James_Blake,1,F-IO,22,7,3,1,3,15,7
20061119-M-Masters_Cup-F-Roger_Federer-James_Blake,1,F-II,3,2,1,1,0,2,1
20061119-M-Masters_Cup-F-Roger_Federer-James_Blake,1,B-XC,25,4,1,0,3,11,14
20061119-M-Masters_Cup-F-Roger_Federer-James_Blake,1,B-DTM,33,6,1,1,4,23,10
20061119-M-Masters_Cup-F-Roger_Federer-James_Blake,1,B-DTL,20,14,9,2,3,13,7
20061119-M-Masters_Cup-F-Roger_Federer-James_Blake,1,B-IO,8,7,6,1,0,8,0
20061119-M-Masters_Cup-F-Roger_Federer-James_Blake,1,S-XC,13,2,0,1,1,8,5
20061119-M-Masters_Cup-F-Roger_Federer-James_Blake,1,S-DTM,3,1,0,0,1,2,1
20061119-M-Masters_Cup-F-Roger_Federer-James_Blake,1,S-IO,1,1,0,0,1,0,1
20061119-M-Masters_Cup-F-Roger_Federer-James_Blake,2,F-XC,27,7,1,2,4,12,15
20061119-M-Masters_Cup-F-Roger_Federer-James_Blake,2,F-DTM,21,2,0,0,2,8,13
20061119-M-Masters_Cup-F-Roger_Federer-James_Blake,2,F-DTL,2,1,0,0,1,1,1
20061119-M-Masters_Cup-F-Roger_Federer-James_Blake,2,F-IO,24,9,2,1,6,7,17
20061119-M-Masters_Cup-F-Roger_Federer-James_Blake,2,F-II,6,2,2,0,0,2,4
20061119-M-Masters_Cup-F-Roger_Federer-James_Blake,2,B-XC,48,8,2,0,6,19,29
20061119-M-Masters_Cup-F-Roger_Federer-James_Blake,2,B-DTM,18,3,0,0,3,2,16
20061119-M-Masters_Cup-F-Roger_Federer-James_Blake,2,B-DTL,7,3,2,1,0,4,3
20061119-M-Masters_Cup-F-Roger_Federer-James_Blake,2,B-IO,2,1,0,0,1,0,2
20061119-M-Masters_Cup-F-Roger_Federer-James_Blake,2,S-XC,12,2,0,1,1,4,8
20061119-M-Masters_Cup-F-Roger_Federer-James_Blake,2,S-DTM,3,0,0,0,0,1,2
20061119-M-Masters_Cup-F-Roger_Federer-James_Blake,2,S-DTL,2,1,0,1,0,1,1
20160729-M-Scheveningen_CH-QF-Alexey_Vatutin-Robin_Haase,1,F-XC,18,1,0,0,1,7,11
20160729-M-Scheveningen_CH-QF-Alexey_Vatutin-Robin_Haase,1,F-DTM,11,2,0,1,1,4,7
20160729-M-Scheveningen_CH-QF-Alexey_Vatutin-Robin_Haase,1,F-DTL,5,2,2,0,0,3,2
20160729-M-Scheveningen_CH-QF-Alexey_Vatutin-Robin_Haase,1,F-IO,13,3,0,1,2,4,9
20160729-M-Scheveningen_CH-QF-Alexey_Vatutin-Robin_Haase,1,F-II,1,1,1,0,0,1,0
20160729-M-Scheveningen_CH-QF-Alexey_Vatutin-Robin_Haase,1,B-XC,31,7,1,1,5,7,24
20160729-M-Scheveningen_CH-QF-Alexey_Vatutin-Robin_Haase,1,B-DTM,5,0,0,0,0,3,2
20160729-M-Scheveningen_CH-QF-Alexey_Vatutin-Robin_Haase,1,B-DTL,7,3,0,2,1,2,5
20160729-M-Scheveningen_CH-QF-Alexey_Vatutin-Robin_Haase,1,B-IO,2,1,0,1,0,1,1
20160729-M-Scheveningen_CH-QF-Alexey_Vatutin-Robin_Haase,1,S-XC,3,1,0,1,0,2,1
20160729-M-Scheveningen_CH-QF-Alexey_Vatutin-Robin_Haase,2,F-XC,18,6,1,4,1,11,7
20160729-M-Scheveningen_CH-QF-Alexey_Vatutin-Robin_Haase,2,F-DTM,7,0,0,0,0,5,2
20160729-M-Scheveningen_CH-QF-Alexey_Vatutin-Robin_Haase,2,F-DTL,9,3,2,0,1,6,3
20160729-M-Scheveningen_CH-QF-Alexey_Vatutin-Robin_Haase,2,F-IO,8,4,0,1,3,4,4
20160729-M-Scheveningen_CH-QF-Alexey_Vatutin-Robin_Haase,2,F-II,2,1,0,1,0,2,0
20160729-M-Scheveningen_CH-QF-Alexey_Vatutin-Robin_Haase,2,B-XC,4,1,0,1,0,3,1
20160729-M-Scheveningen_CH-QF-Alexey_Vatutin-Robin_Haase,2,B-DTM,10,2,0,1,1,7,3
20160729-M-Scheveningen_CH-QF-Alexey_Vatutin-Robin_Haase,2,B-DTL,3,1,0,0,1,2,1
20160729-M-Scheveningen_CH-QF-Alexey_Vatutin-Robin_Haase,2,B-IO,1,0,0,0,0,1,0
20160729-M-Scheveningen_CH-QF-Alexey_Vatutin-Robin_Haase,2,S-XC,14,1,0,0,1,10,4
20160729-M-Scheveningen_CH-QF-Alexey_Vatutin-Robin_Haase,2,S-DTM,7,0,0,0,0,5,2
20160729-M-Scheveningen_CH-QF-Alexey_Vatutin-Robin_Haase,2,S-DTL,1,1,0,1,0,1,0
20160729-M-Scheveningen_CH-QF-Alexey_Vatutin-Robin_Haase,2,S-IO,1,0,0,0,0,0,1
20160718-M-Washington-R64-Dudi_Sela-Taylor_Harry_Fritz,1,F-XC,8,3,1,1,1,3,5
20160718-M-Washington-R64-Dudi_Sela-Taylor_Harry_Fritz,1,F-DTM,40,4,0,0,4,21,19
20160718-M-Washington-R64-Dudi_Sela-Taylor_Harry_Fritz,1,F-DTL,4,1,0,0,1,2,2
20160718-M-Washington-R64-Dudi_Sela-Taylor_Harry_Fritz,1,F-IO,12,6,1,1,4,8,4
20160718-M-Washington-R64-Dudi_Sela-Taylor_Harry_Fritz,1,B-XC,13,4,2,1,1,8,5
20160718-M-Washington-R64-Dudi_Sela-Taylor_Harry_Fritz,1,B-DTM,17,1,0,0,1,7,10
20160718-M-Washington-R64-Dudi_Sela-Taylor_Harry_Fritz,1,B-DTL,7,3,0,1,2,4,3
20160718-M-Washington-R64-Dudi_Sela-Taylor_Harry_Fritz,1,B-IO,5,2,0,1,1,2,3
20160718-M-Washington-R64-Dudi_Sela-Taylor_Harry_Fritz,1,S-XC,8,1,0,0,1,5,3
20160718-M-Washington-R64-Dudi_Sela-Taylor_Harry_Fritz,1,S-DTM,5,0,0,0,0,2,3
20160718-M-Washington-R64-Dudi_Sela-Taylor_Harry_Fritz,1,S-DTL,2,0,0,0,0,2,0
20160718-M-Washington-R64-Dudi_Sela-Taylor_Harry_Fritz,1,S-IO,1,0,0,0,0,1,0
20160718-M-Washington-R64-Dudi_Sela-Taylor_Harry_Fritz,2,F-XC,31,13,3,2,8,16,15
20160718-M-Washington-R64-Dudi_Sela-Taylor_Harry_Fritz,2,F-DTM,33,5,0,0,5,17,16
20160718-M-Washington-R64-Dudi_Sela-Taylor_Harry_Fritz,2,F-DTL,5,2,1,0,1,1,4
20160718-M-Washington-R64-Dudi_Sela-Taylor_Harry_Fritz,2,F-IO,15,4,0,2,2,7,8
20160718-M-Washington-R64-Dudi_Sela-Taylor_Harry_Fritz,2,B-XC,30,5,2,1,2,11,19
20160718-M-Washington-R64-Dudi_Sela-Taylor_Harry_Fritz,2,B-DTM,18,1,0,1,0,7,11
20160718-M-Washington-R64-Dudi_Sela-Taylor_Harry_Fritz,2,B-DTL,5,1,0,1,0,1,4
20160718-M-Washington-R64-Dudi_Sela-Taylor_Harry_Fritz,2,B-IO,7,3,1,1,1,5,2
20160718-M-Washington-R64-Dudi_Sela-Taylor_Harry_Fritz,2,S-XC,1,0,0,0,0,0,1
20160718-M-Washington-R64-Dudi_Sela-Taylor_Harry_Fritz,2,S-DTM,2,0,0,0,0,0,2
20160807-M-Granby_CH-F-Marcelo_Arevalo-Francis_Tiafoe,1,F-XC,16,6,1,1,4,8,8
20160807-M-Granby_CH-F-Marcelo_Arevalo-Francis_Tiafoe,1,F-DTM,6,2,0,1,1,1,5
20160807-M-Granby_CH-F-Marcelo_Arevalo-Francis_Tiafoe,1,F-DTL,3,1,0,0,1,0,3
20160807-M-Granby_CH-F-Marcelo_Arevalo-Francis_Tiafoe,1,F-IO,22,4,1,0,3,8,14
20160807-M-Granby_CH-F-Marcelo_Arevalo-Francis_Tiafoe,1,F-II,7,6,2,0,4,2,5
20160807-M-Granby_CH-F-Marcelo_Arevalo-Francis_Tiafoe,1,B-XC,21,5,0,2,3,9,12
20160807-M-Granby_CH-F-Marcelo_Arevalo-Francis_Tiafoe,1,B-DTM,3,0,0,0,0,0,3
20160807-M-Granby_CH-F-Marcelo_Arevalo-Francis_Tiafoe,1,B-DTL,2,0,0,0,0,0,2
20160807-M-Granby_CH-F-Marcelo_Arevalo-Francis_Tiafoe,1,S-XC,2,0,0,0,0,2,0
20160807-M-Granby_CH-F-Marcelo_Arevalo-Francis_Tiafoe,1,S-DTM,1,0,0,0,0,0,1
20160807-M-Granby_CH-F-Marcelo_Arevalo-Francis_Tiafoe,1,S-DTL,3,0,0,0,0,2,1
20160807-M-Granby_CH-F-Marcelo_Arevalo-Francis_Tiafoe,1,S-IO,1,0,0,0,0,1,0
20160807-M-Granby_CH-F-Marcelo_Arevalo-Francis_Tiafoe,2,F-XC,14,5,4,1,0,11,3
20160807-M-Granby_CH-F-Marcelo_Arevalo-Francis_Tiafoe,2,F-DTM,9,0,0,0,0,4,5
20160807-M-Granby_CH-F-Marcelo_Arevalo-Francis_Tiafoe,2,F-DTL,9,2,0,2,0,4,5
20160807-M-Granby_CH-F-Marcelo_Arevalo-Francis_Tiafoe,2,F-IO,5,1,0,0,1,3,2
20160807-M-Granby_CH-F-Marcelo_Arevalo-Francis_Tiafoe,2,B-XC,23,2,0,1,1,13,10
20160807-M-Granby_CH-F-Marcelo_Arevalo-Francis_Tiafoe,2,B-DTM,4,1,0,1,0,4,0
20160807-M-Granby_CH-F-Marcelo_Arevalo-Francis_Tiafoe,2,B-DTL,6,4,4,0,0,5,1
20160807-M-Granby_CH-F-Marcelo_Arevalo-Francis_Tiafoe,2,S-XC,7,0,0,0,0,6,1
20160807-M-Granby_CH-F-Marcelo_Arevalo-Francis_Tiafoe,2,S-DTM,4,0,0,0,0,1,3
20160807-M-Granby_CH-F-Marcelo_Arevalo-Francis_Tiafoe,2,S-DTL,3,1,0,0,1,0,3
20160807-M-Granby_CH-F-Marcelo_Arevalo-Francis_Tiafoe,2,S-IO,1,0,0,0,0,1,0
20071118-M-Masters_Cup-F-David_Ferrer-Roger_Federer,1,F-XC,38,10,2,2,6,20,18
20071118-M-Masters_Cup-F-David_Ferrer-Roger_Federer,1,F-DTM,45,2,0,1,1,18,27
20071118-M-Masters_Cup-F-David_Ferrer-Roger_Federer,1,F-DTL,12,3,2,1,0,7,5
20071118-M-Masters_Cup-F-David_Ferrer-Roger_Federer,1,F-IO,50,10,0,3,7,23,27
20071118-M-Masters_Cup-F-David_Ferrer-Roger_Federer,1,F-II,7,2,1,1,0,5,2
20071118-M-Masters_Cup-F-David_Ferrer-Roger_Federer,1,B-XC,58,7,1,0,6,30,28
20071118-M-Masters_Cup-F-David_Ferrer-Roger_Federer,1,B-DTM,30,3,0,0,3,14,16
20071118-M-Masters_Cup-F-David_Ferrer-Roger_Federer,1,B-DTL,6,5,1,0,4,1,5
20071118-M-Masters_Cup-F-David_Ferrer-Roger_Federer,1,B-IO,1,1,1,0,0,1,0
20071118-M-Masters_Cup-F-David_Ferrer-Roger_Federer,1,S-XC,5,0,0,0,0,2,3
20071118-M-Masters_Cup-F-David_Ferrer-Roger_Federer,1,S-DTM,2,0,0,0,0,1,1
20071118-M-Masters_Cup-F-David_Ferrer-Roger_Federer,1,S-DTL,1,0,0,0,0,1,0
20071118-M-Masters_Cup-F-David_Ferrer-Roger_Federer,1,S-IO,1,0,0,0,0,0,1
20071118-M-Masters_Cup-F-David_Ferrer-Roger_Federer,2,F-XC,38,10,3,3,4,23,15
20071118-M-Masters_Cup-F-David_Ferrer-Roger_Federer,2,F-DTM,22,2,0,0,2,7,15
20071118-M-Masters_Cup-F-David_Ferrer-Roger_Federer,2,F-DTL,16,8,1,3,4,9,7
20071118-M-Masters_Cup-F-David_Ferrer-Roger_Federer,2,F-IO,18,7,2,1,4,9,9
20071118-M-Masters_Cup-F-David_Ferrer-Roger_Federer,2,F-II,3,1,0,0,1,1,2
20071118-M-Masters_Cup-F-David_Ferrer-Roger_Federer,2,B-XC,38,6,2,0,4,17,21
20071118-M-Masters_Cup-F-David_Ferrer-Roger_Federer,2,B-DTM,37,5,0,1,4,18,19
20071118-M-Masters_Cup-F-David_Ferrer-Roger_Federer,2,B-DTL,14,7,1,2,4,8,6
20071118-M-Masters_Cup-F-David_Ferrer-Roger_Federer,2,B-IO,2,2,1,1,0,2,0
20071118-M-Masters_Cup-F-David_Ferrer-Roger_Federer,2,S-XC,34,1,0,0,1,17,17
20071118-M-Masters_Cup-F-David_Ferrer-Roger_Federer,2,S-DTM,12,0,0,0,0,7,5
20071118-M-Masters_Cup-F-David_Ferrer-Roger_Federer,2,S-DTL,6,1,1,0,0,4,2
20071118-M-Masters_Cup-F-David_Ferrer-Roger_Federer,2,S-IO,2,1,1,0,0,1,1
20110815-M-Cincinnati_Masters-R32-Roger_Federer-Juan_Martin_Del_Potro,1,F-XC,29,9,3,3,3,20,9
20110815-M-Cincinnati_Masters-R32-Roger_Federer-Juan_Martin_Del_Potro,1,F-DTM,19,2,0,1,1,7,12
20110815-M-Cincinnati_Masters-R32-Roger_Federer-Juan_Martin_Del_Potro,1,F-DTL,8,4,2,0,2,2,6
20110815-M-Cincinnati_Masters-R32-Roger_Federer-Juan_Martin_Del_Potro,1,F-IO,17,8,5,2,1,10,7
20110815-M-Cincinnati_Masters-R32-Roger_Federer-Juan_Martin_Del_Potro,1,F-II,5,2,1,1,0,4,1
20110815-M-Cincinnati_Masters-R32-Roger_Federer-Juan_Martin_Del_Potro,1,B-XC,16,3,0,1,2,8,8
20110815-M-Cincinnati_Masters-R32-Roger_Federer-Juan_Martin_Del_Potro,1,B-DTM,11,1,0,0,1,3,8
20110815-M-Cincinnati_Masters-R32-Roger_Federer-Juan_Martin_Del_Potro,1,B-DTL,5,2,1,0,1,2,3
20110815-M-Cincinnati_Masters-R32-Roger_Federer-Juan_Martin_Del_Potro,1,B-IO,1,0,0,0,0,1,0
20110815-M-Cincinnati_Masters-R32-Roger_Federer-Juan_Martin_Del_Potro,1,S-XC,14,0,0,0,0,3,11
20110815-M-Cincinnati_Masters-R32-Roger_Federer-Juan_Martin_Del_Potro,1,S-DTM,2,0,0,0,0,1,1
20110815-M-Cincinnati_Masters-R32-Roger_Federer-Juan_Martin_Del_Potro,1,S-DTL,3,0,0,0,0,1,2
20110815-M-Cincinnati_Masters-R32-Roger_Federer-Juan_Martin_Del_Potro,2,F-XC,35,12,3,6,3,18,17
20110815-M-Cincinnati_Masters-R32-Roger_Federer-Juan_Martin_Del_Potro,2,F-DTM,17,2,0,0,2,4,13
20110815-M-Cincinnati_Masters-R32-Roger_Federer-Juan_Martin_Del_Potro,2,F-DTL,8,1,1,0,0,5,3
20110815-M-Cincinnati_Masters-R32-Roger_Federer-Juan_Martin_Del_Potro,2,F-IO,29,7,3,2,2,20,9
20110815-M-Cincinnati_Masters-R32-Roger_Federer-Juan_Martin_Del_Potro,2,F-II,4,3,1,0,2,2,2
20110815-M-Cincinnati_Masters-R32-Roger_Federer-Juan_Martin_Del_Potro,2,B-XC,28,5,0,1,4,15,13
20110815-M-Cincinnati_Masters-R32-Roger_Federer-Juan_Martin_Del_Potro,2,B-DTM,17,0,0,0,0,10,7
20110815-M-Cincinnati_Masters-R32-Roger_Federer-Juan_Martin_Del_Potro,2,B-DTL,3,3,1,1,1,2,1
20110815-M-Cincinnati_Masters-R32-Roger_Federer-Juan_Martin_Del_Potro,2,S-XC,8,1,0,0,1,2,6
20110815-M-Cincinnati_Masters-R32-Roger_Federer-Juan_Martin_Del_Potro,2,S-DTM,1,0,0,0,0,0,1
20121011-M-Shanghai_Masters-QF-Marin_Cilic-Roger_Federer,1,F-XC,16,8,4,1,3,7,9
20121011-M-Shanghai_Masters-QF-Marin_Cilic-Roger_Federer,1,F-DTM,14,3,0,0,3,5,9
20121011-M-Shanghai_Masters-QF-Marin_Cilic-Roger_Federer,1,F-DTL,9,3,1,2,0,4,5
20121011-M-Shanghai_Masters-QF-Marin_Cilic-Roger_Federer,1,F-IO,27,6,0,3,3,10,17
20121011-M-Shanghai_Masters-QF-Marin_Cilic-Roger_Federer,1,F-II,1,1,0,0,1,0,1
20121011-M-Shanghai_Masters-QF-Marin_Cilic-Roger_Federer,1,B-XC,35,7,0,2,5,14,21
20121011-M-Shanghai_Masters-QF-Marin_Cilic-Roger_Federer,1,B-DTM,7,2,0,1,1,2,5
20121011-M-Shanghai_Masters-QF-Marin_Cilic-Roger_Federer,1,B-DTL,10,7,2,1,4,3,7
20121011-M-Shanghai_Masters-QF-Marin_Cilic-Roger_Federer,1,B-IO,3,2,2,0,0,2,1
20121011-M-Shanghai_Masters-QF-Marin_Cilic-Roger_Federer,1,S-XC,3,0,0,0,0,2,1
20121011-M-Shanghai_Masters-QF-Marin_Cilic-Roger_Federer,1,S-DTM,3,0,0,0,0,0,3
20121011-M-Shanghai_Masters-QF-Marin_Cilic-Roger_Federer,2,F-XC,20,8,4,2,2,13,7
20121011-M-Shanghai_Masters-QF-Marin_Cilic-Roger_Federer,2,F-DTM,10,2,0,0,2,4,6
20121011-M-Shanghai_Masters-QF-Marin_Cilic-Roger_Federer,2,F-DTL,8,3,1,1,1,5,3
20121011-M-Shanghai_Masters-QF-Marin_Cilic-Roger_Federer,2,F-IO,13,5,2,3,0,11,2
20121011-M-Shanghai_Masters-QF-Marin_Cilic-Roger_Federer,2,B-XC,19,5,1,0,4,6,13
20121011-M-Shanghai_Masters-QF-Marin_Cilic-Roger_Federer,2,B-DTM,17,1,0,1,0,16,1
20121011-M-Shanghai_Masters-QF-Marin_Cilic-Roger_Federer,2,B-DTL,5,5,2,1,2,3,2
20121011-M-Shanghai_Masters-QF-Marin_Cilic-Roger_Federer,2,B-IO,1,1,0,0,1,0,1
20121011-M-Shanghai_Masters-QF-Marin_Cilic-Roger_Federer,2,S-XC,13,1,0,0,1,9,4
20121011-M-Shanghai_Masters-QF-Marin_Cilic-Roger_Federer,2,S-DTM,4,0,0,0,0,2,2
20121011-M-Shanghai_Masters-QF-Marin_Cilic-Roger_Federer,2,S-DTL,2,0,0,0,0,0,2
20010204-M-Milan-F-Julien_Boutter-Roger_Federer,1,F-XC,41,13,3,2,8,21,20
20010204-M-Milan-F-Julien_Boutter-Roger_Federer,1,F-DTM,21,6,0,1,5,6,15
20010204-M-Milan-F-Julien_Boutter-Roger_Federer,1,F-DTL,6,5,1,0,4,2,4
20010204-M-Milan-F-Julien_Boutter-Roger_Federer,1,F-IO,8,3,0,3,0,6,2
20010204-M-Milan-F-Julien_Boutter-Roger_Federer,1,F-II,3,1,1,0,0,3,0
20010204-M-Milan-F-Julien_Boutter-Roger_Federer,1,B-XC,29,10,1,1,8,10,19
20010204-M-Milan-F-Julien_Boutter-Roger_Federer,1,B-DTM,22,1,0,0,1,7,15
20010204-M-Milan-F-Julien_Boutter-Roger_Federer,1,B-DTL,12,8,3,0,5,5,7
20010204-M-Milan-F-Julien_Boutter-Roger_Federer,1,B-IO,4,3,1,0,2,2,2
20010204-M-Milan-F-Julien_Boutter-Roger_Federer,1,S-XC,5,1,0,0,1,4,1
20010204-M-Milan-F-Julien_Boutter-Roger_Federer,1,S-DTM,2,0,0,0,0,1,1
20010204-M-Milan-F-Julien_Boutter-Roger_Federer,1,S-DTL,1,1,0,0,1,0,1
20010204-M-Milan-F-Julien_Boutter-Roger_Federer,2,F-XC,39,10,2,3,5,22,17
20010204-M-Milan-F-Julien_Boutter-Roger_Federer,2,F-DTM,27,2,0,0,2,13,14
20010204-M-Milan-F-Julien_Boutter-Roger_Federer,2,F-DTL,9,4,1,2,1,6,3
20010204-M-Milan-F-Julien_Boutter-Roger_Federer,2,F-IO,25,6,1,0,5,11,14
20010204-M-Milan-F-Julien_Boutter-Roger_Federer,2,F-II,3,2,0,0,2,0,3
20010204-M-Milan-F-Julien_Boutter-Roger_Federer,2,B-XC,10,2,1,0,1,6,4
20010204-M-Milan-F-Julien_Boutter-Roger_Federer,2,B-DTM,11,1,0,1,0,9,2
20010204-M-Milan-F-Julien_Boutter-Roger_Federer,2,B-DTL,2,0,0,0,0,2,0
20010204-M-Milan-F-Julien_Boutter-Roger_Federer,2,B-IO,1,0,0,0,0,1,0
20010204-M-Milan-F-Julien_Boutter-Roger_Federer,2,S-XC,3,0,0,0,0,2,1
20010204-M-Milan-F-Julien_Boutter-Roger_Federer,2,S-DTM,16,0,0,0,0,6,10
20010204-M-Milan-F-Julien_Boutter-Roger_Federer,2,S-IO,1,0,0,0,0,1,0
20160706-M-Wimbledon-QF-Marin_Cilic-Roger_Federer,1,F-XC,41,22,9,7,6,23,18
20160706-M-Wimbledon-QF-Marin_Cilic-Roger_Federer,1,F-DTM,24,3,0,0,3,13,11
20160706-M-Wimbledon-QF-Marin_Cilic-Roger_Federer,1,F-DTL,10,3,1,0,2,5,5
20160706-M-Wimbledon-QF-Marin_Cilic-Roger_Federer,1,F-IO,56,18,7,3,8,34,22
20160706-M-Wimbledon-QF-Marin_Cilic-Roger_Federer,1,B-XC,56,10,2,3,4,27,29
20160706-M-Wimbledon-QF-Marin_Cilic-Roger_Federer,1,B-DTM,32,5,0,0,5,16,16
20160706-M-Wimbledon-QF-Marin_Cilic-Roger_Federer,1,B-DTL,8,5,1,2,2,4,4
20160706-M-Wimbledon-QF-Marin_Cilic-Roger_Federer,1,B-IO,8,4,1,2,1,4,4
20160706-M-Wimbledon-QF-Marin_Cilic-Roger_Federer,1,S-XC,6,1,0,1,0,5,1
20160706-M-Wimbledon-QF-Marin_Cilic-Roger_Federer,1,S-DTM,5,1,1,0,0,2,3
20160706-M-Wimbledon-QF-Marin_Cilic-Roger_Federer,2,F-XC,31,18,5,3,10,17,14
20160706-M-Wimbledon-QF-Marin_Cilic-Roger_Federer,2,F-DTM,29,1,0,0,1,15,14
20160706-M-Wimbledon-QF-Marin_Cilic-Roger_Federer,2,F-DTL,5,2,2,0,0,2,3
20160706-M-Wimbledon-QF-Marin_Cilic-Roger_Federer,2,F-IO,25,11,5,2,4,15,10
20160706-M-Wimbledon-QF-Marin_Cilic-Roger_Federer,2,F-II,2,2,0,1,1,1,1
20160706-M-Wimbledon-QF-Marin_Cilic-Roger_Federer,2,B-XC,35,11,3,1,7,19,16
20160706-M-Wimbledon-QF-Marin_Cilic-Roger_Federer,2,B-DTM,35,5,1,1,3,13,22
20160706-M-Wimbledon-QF-Marin_Cilic-Roger_Federer,2,B-DTL,13,9,5,0,4,5,8
20160706-M-Wimbledon-QF-Marin_Cilic-Roger_Federer,2,B-IO,5,3,1,1,1,2,3
20160706-M-Wimbledon-QF-Marin_Cilic-Roger_Federer,2,S-XC,19,1,0,0,1,1,18
20160706-M-Wimbledon-QF-Marin_Cilic-Roger_Federer,2,S-DTM,25,2,0,1,1,15,10
20160706-M-Wimbledon-QF-Marin_Cilic-Roger_Federer,2,S-DTL,5,1,0,0,1,4,1
20160706-M-Wimbledon-QF-Marin_Cilic-Roger_Federer,2,S-IO,1,0,0,0,0,0,1
20041003-M-Bangkok-F-Andy_Roddick-Roger_Federer,1,F-XC,20,3,1,0,2,9,11
20041003-M-Bangkok-F-Andy_Roddick-Roger_Federer,1,F-DTM,14,0,0,0,0,3,11
20041003-M-Bangkok-F-Andy_Roddick-Roger_Federer,1,F-DTL,3,2,0,0,2,0,3
20041003-M-Bangkok-F-Andy_Roddick-Roger_Federer,1,F-IO,23,6,0,2,4,9,14
20041003-M-Bangkok-F-Andy_Roddick-Roger_Federer,1,F-II,1,1,0,1,0,1,0
20041003-M-Bangkok-F-Andy_Roddick-Roger_Federer,1,B-XC,22,3,0,1,2,8,14
20041003-M-Bangkok-F-Andy_Roddick-Roger_Federer,1,B-DTM,9,1,0,0,1,3,6
20041003-M-Bangkok-F-Andy_Roddick-Roger_Federer,1,B-DTL,2,1,1,0,0,1,1
20041003-M-Bangkok-F-Andy_Roddick-Roger_Federer,1,S-DTM,3,0,0,0,0,0,3
20041003-M-Bangkok-F-Andy_Roddick-Roger_Federer,1,S-DTL,2,2,0,1,1,1,1
20041003-M-Bangkok-F-Andy_Roddick-Roger_Federer,2,F-XC,25,11,6,0,5,15,10
20041003-M-Bangkok-F-Andy_Roddick-Roger_Federer,2,F-DTM,15,3,3,0,0,9,6
20041003-M-Bangkok-F-Andy_Roddick-Roger_Federer,2,F-DTL,8,4,1,0,3,4,4
20041003-M-Bangkok-F-Andy_Roddick-Roger_Federer,2,F-IO,10,3,3,0,0,8,2
20041003-M-Bangkok-F-Andy_Roddick-Roger_Federer,2,F-II,2,1,0,1,0,2,0
20041003-M-Bangkok-F-Andy_Roddick-Roger_Federer,2,B-XC,14,2,1,0,1,9,5
20041003-M-Bangkok-F-Andy_Roddick-Roger_Federer,2,B-DTM,9,3,0,1,2,6,3
20041003-M-Bangkok-F-Andy_Roddick-Roger_Federer,2,B-DTL,3,2,1,0,1,2,1
20041003-M-Bangkok-F-Andy_Roddick-Roger_Federer,2,S-XC,10,0,0,0,0,7,3
20041003-M-Bangkok-F-Andy_Roddick-Roger_Federer,2,S-DTM,5,0,0,0,0,2,3
20041003-M-Bangkok-F-Andy_Roddick-Roger_Federer,2,S-DTL,3,1,0,1,0,2,1
20090517-M-Madrid_Masters-F-Rafael_Nadal-Roger_Federer,1,F-XC,40,6,1,0,5,26,14
20090517-M-Madrid_Masters-F-Rafael_Nadal-Roger_Federer,1,F-DTM,11,0,0,0,0,5,6
20090517-M-Madrid_Masters-F-Rafael_Nadal-Roger_Federer,1,F-DTL,4,3,1,2,0,3,1
20090517-M-Madrid_Masters-F-Rafael_Nadal-Roger_Federer,1,F-IO,10,6,5,1,0,9,1
20090517-M-Madrid_Masters-F-Rafael_Nadal-Roger_Federer,1,F-II,1,1,0,0,1,0,1
20090517-M-Madrid_Masters-F-Rafael_Nadal-Roger_Federer,1,B-XC,11,6,1,2,3,5,6
20090517-M-Madrid_Masters-F-Rafael_Nadal-Roger_Federer,1,B-DTM,23,3,0,0,3,7,16
20090517-M-Madrid_Masters-F-Rafael_Nadal-Roger_Federer,1,B-DTL,15,4,1,0,3,5,10
20090517-M-Madrid_Masters-F-Rafael_Nadal-Roger_Federer,1,B-IO,6,1,1,0,0,1,5
20090517-M-Madrid_Masters-F-Rafael_Nadal-Roger_Federer,1,S-XC,1,1,0,1,0,1,0
20090517-M-Madrid_Masters-F-Rafael_Nadal-Roger_Federer,1,S-DTM,1,0,0,0,0,0,1
20090517-M-Madrid_Masters-F-Rafael_Nadal-Roger_Federer,1,S-DTL,1,0,0,0,0,0,1
20090517-M-Madrid_Masters-F-Rafael_Nadal-Roger_Federer,1,S-IO,1,0,0,0,0,0,1
20090517-M-Madrid_Masters-F-Rafael_Nadal-Roger_Federer,2,F-XC,30,8,4,2,2,23,7
20090517-M-Madrid_Masters-F-Rafael_Nadal-Roger_Federer,2,F-DTM,21,3,1,0,2,11,10
20090517-M-Madrid_Masters-F-Rafael_Nadal-Roger_Federer,2,F-DTL,1,1,0,1,0,1,0
20090517-M-Madrid_Masters-F-Rafael_Nadal-Roger_Federer,2,F-IO,19,11,3,1,7,9,10
20090517-M-Madrid_Masters-F-Rafael_Nadal-Roger_Federer,2,F-II,6,5,1,2,2,4,2
20090517-M-Madrid_Masters-F-Rafael_Nadal-Roger_Federer,2,B-XC,12,5,1,1,3,4,8
20090517-M-Madrid_Masters-F-Rafael_Nadal-Roger_Federer,2,B-DTM,23,3,0,0,3,8,15
20090517-M-Madrid_Masters-F-Rafael_Nadal-Roger_Federer,2,B-DTL,6,3,0,1,2,3,3
20090517-M-Madrid_Masters-F-Rafael_Nadal-Roger_Federer,2,B-IO,3,0,0,0,0,2,1
20090517-M-Madrid_Masters-F-Rafael_Nadal-Roger_Federer,2,S-DTM,2,0,0,0,0,0,2
20090517-M-Madrid_Masters-F-Rafael_Nadal-Roger_Federer,2,S-DTL,2,1,0,0,1,1,1
20080420-M-Estoril-F-Nikolay_Davydenko-Roger_Federer,1,F-XC,41,13,3,5,5,23,18
20080420-M-Estoril-F-Nikolay_Davydenko-Roger_Federer,1,F-DTM,52,5,0,1,4,28,24
20080420-M-Estoril-F-Nikolay_Davydenko-Roger_Federer,1,F-DTL,8,3,2,0,1,5,3
20080420-M-Estoril-F-Nikolay_Davydenko-Roger_Federer,1,F-IO,20,8,0,2,6,10,10
20080420-M-Estoril-F-Nikolay_Davydenko-Roger_Federer,1,F-II,1,0,0,0,0,1,0
20080420-M-Estoril-F-Nikolay_Davydenko-Roger_Federer,1,B-XC,31,6,3,1,2,21,10
20080420-M-Estoril-F-Nikolay_Davydenko-Roger_Federer,1,B-DTM,45,3,0,1,2,25,20
20080420-M-Estoril-F-Nikolay_Davydenko-Roger_Federer,1,B-DTL,2,1,0,0,1,1,1
20080420-M-Estoril-F-Nikolay_Davydenko-Roger_Federer,1,B-IO,4,3,0,1,2,2,2
20080420-M-Estoril-F-Nikolay_Davydenko-Roger_Federer,1,S-XC,1,1,1,0,0,1,0
20080420-M-Estoril-F-Nikolay_Davydenko-Roger_Federer,1,S-DTM,3,0,0,0,0,1,2
20080420-M-Estoril-F-Nikolay_Davydenko-Roger_Federer,2,F-XC,34,8,3,1,4,17,17
20080420-M-Estoril-F-Nikolay_Davydenko-Roger_Federer,2,F-DTM,61,10,0,1,9,24,37
20080420-M-Estoril-F-Nikolay_Davydenko-Roger_Federer,2,F-DTL,4,3,1,1,1,2,2
20080420-M-Estoril-F-Nikolay_Davydenko-Roger_Federer,2,F-IO,16,5,1,3,1,11,5
20080420-M-Estoril-F-Nikolay_Davydenko-Roger_Federer,2,B-XC,13,5,1,1,3,6,7
20080420-M-Estoril-F-Nikolay_Davydenko-Roger_Federer,2,B-DTM,36,2,1,0,1,13,23
20080420-M-Estoril-F-Nikolay_Davydenko-Roger_Federer,2,B-DTL,6,4,0,1,3,2,4
20080420-M-Estoril-F-Nikolay_Davydenko-Roger_Federer,2,B-IO,3,1,0,0,1,1,2
20080420-M-Estoril-F-Nikolay_Davydenko-Roger_Federer,2,S-XC,5,0,0,0,0,2,3
20080420-M-Estoril-F-Nikolay_Davydenko-Roger_Federer,2,S-DTM,18,0,0,0,0,7,11
20080420-M-Estoril-F-Nikolay_Davydenko-Roger_Federer,2,S-DTL,1,0,0,0,0,0,1
20061008-M-Tokyo-F-Roger_Federer-Tim_Henman,1,F-XC,7,2,1,0,1,6,1
20061008-M-Tokyo-F-Roger_Federer-Tim_Henman,1,F-DTM,9,1,1,0,0,5,4
20061008-M-Tokyo-F-Roger_Federer-Tim_Henman,1,F-DTL,3,3,0,3,0,3,0
20061008-M-Tokyo-F-Roger_Federer-Tim_Henman,1,F-IO,11,4,1,3,0,10,1
20061008-M-Tokyo-F-Roger_Federer-Tim_Henman,1,F-II,1,0,0,0,0,1,0
20061008-M-Tokyo-F-Roger_Federer-Tim_Henman,1,B-XC,10,4,4,0,0,10,0
20061008-M-Tokyo-F-Roger_Federer-Tim_Henman,1,B-DTM,13,3,1,1,1,6,7
20061008-M-Tokyo-F-Roger_Federer-Tim_Henman,1,B-DTL,1,1,1,0,0,1,0
20061008-M-Tokyo-F-Roger_Federer-Tim_Henman,1,B-IO,1,1,1,0,0,1,0
20061008-M-Tokyo-F-Roger_Federer-Tim_Henman,1,S-XC,6,1,0,1,0,5,1
20061008-M-Tokyo-F-Roger_Federer-Tim_Henman,1,S-DTM,2,0,0,0,0,0,2
20061008-M-Tokyo-F-Roger_Federer-Tim_Henman,1,S-DTL,2,1,0,0,1,1,1
20061008-M-Tokyo-F-Roger_Federer-Tim_Henman,2,F-XC,10,5,1,1,3,4,6
20061008-M-Tokyo-F-Roger_Federer-Tim_Henman,2,F-DTM,9,3,0,0,3,0,9
20061008-M-Tokyo-F-Roger_Federer-Tim_Henman,2,F-DTL,3,2,1,1,0,3,0
20061008-M-Tokyo-F-Roger_Federer-Tim_Henman,2,F-IO,12,2,0,1,1,5,7
20061008-M-Tokyo-F-Roger_Federer-Tim_Henman,2,F-II,1,1,1,0,0,1,0
20061008-M-Tokyo-F-Roger_Federer-Tim_Henman,2,B-XC,4,2,1,1,0,2,2
20061008-M-Tokyo-F-Roger_Federer-Tim_Henman,2,B-DTM,7,0,0,0,0,1,6
20061008-M-Tokyo-F-Roger_Federer-Tim_Henman,2,B-DTL,1,0,0,0,0,0,1
20061008-M-Tokyo-F-Roger_Federer-Tim_Henman,2,B-IO,1,0,0,0,0,0,1
20061008-M-Tokyo-F-Roger_Federer-Tim_Henman,2,S-XC,9,1,0,0,1,2,7
20061008-M-Tokyo-F-Roger_Federer-Tim_Henman,2,S-DTM,7,2,0,0,2,3,4
20061008-M-Tokyo-F-Roger_Federer-Tim_Henman,2,S-DTL,1,0,0,0,0,0,1
20110108-M-Doha-F-Roger_Federer-Nikolay_Davydenko,1,F-XC,25,9,3,3,3,15,10
20110108-M-Doha-F-Roger_Federer-Nikolay_Davydenko,1,F-DTM,11,0,0,0,0,8,3
20110108-M-Doha-F-Roger_Federer-Nikolay_Davydenko,1,F-DTL,5,3,0,1,2,2,3
20110108-M-Doha-F-Roger_Federer-Nikolay_Davydenko,1,F-IO,18,11,7,3,1,15,3
20110108-M-Doha-F-Roger_Federer-Nikolay_Davydenko,1,B-XC,18,5,1,0,4,10,8
20110108-M-Doha-F-Roger_Federer-Nikolay_Davydenko,1,B-DTM,15,1,0,0,1,10,5
20110108-M-Doha-F-Roger_Federer-Nikolay_Davydenko,1,B-DTL,5,3,0,2,1,3,2
20110108-M-Doha-F-Roger_Federer-Nikolay_Davydenko,1,B-IO,3,2,2,0,0,3,0
20110108-M-Doha-F-Roger_Federer-Nikolay_Davydenko,1,S-XC,6,1,0,0,1,3,3
20110108-M-Doha-F-Roger_Federer-Nikolay_Davydenko,1,S-DTM,4,0,0,0,0,2,2
20110108-M-Doha-F-Roger_Federer-Nikolay_Davydenko,2,F-XC,12,5,2,1,2,7,5
20110108-M-Doha-F-Roger_Federer-Nikolay_Davydenko,2,F-DTM,28,3,0,1,2,10,18
20110108-M-Doha-F-Roger_Federer-Nikolay_Davydenko,2,F-DTL,5,1,0,0,1,1,4
20110108-M-Doha-F-Roger_Federer-Nikolay_Davydenko,2,F-IO,12,2,0,0,2,4,8
20110108-M-Doha-F-Roger_Federer-Nikolay_Davydenko,2,F-II,1,0,0,0,0,1,0
20110108-M-Doha-F-Roger_Federer-Nikolay_Davydenko,2,B-XC,18,3,1,0,2,5,13
20110108-M-Doha-F-Roger_Federer-Nikolay_Davydenko,2,B-DTM,21,1,0,0,1,9,12
20110108-M-Doha-F-Roger_Federer-Nikolay_Davydenko,2,B-DTL,6,5,0,1,4,2,4
20110108-M-Doha-F-Roger_Federer-Nikolay_Davydenko,2,B-IO,2,1,1,0,0,2,0
20110108-M-Doha-F-Roger_Federer-Nikolay_Davydenko,2,S-DTL,1,0,0,0,0,0,1
19830605-M-Roland_Garros-F-Mats_Wilander-Yannick_Noah,1,F-XC,57,8,0,4,4,30,27
19830605-M-Roland_Garros-F-Mats_Wilander-Yannick_Noah,1,F-DTM,130,1,0,0,1,64,66
19830605-M-Roland_Garros-F-Mats_Wilander-Yannick_Noah,1,F-DTL,17,4,1,0,3,7,10
19830605-M-Roland_Garros-F-Mats_Wilander-Yannick_Noah,1,F-IO,38,7,2,0,5,16,22
19830605-M-Roland_Garros-F-Mats_Wilander-Yannick_Noah,1,F-II,1,1,0,1,0,1,0
19830605-M-Roland_Garros-F-Mats_Wilander-Yannick_Noah,1,B-XC,87,14,6,1,7,45,42
19830605-M-Roland_Garros-F-Mats_Wilander-Yannick_Noah,1,B-DTM,100,4,1,1,2,32,68
19830605-M-Roland_Garros-F-Mats_Wilander-Yannick_Noah,1,B-DTL,12,4,0,3,1,7,5
19830605-M-Roland_Garros-F-Mats_Wilander-Yannick_Noah,1,B-IO,19,9,2,2,5,9,10
19830605-M-Roland_Garros-F-Mats_Wilander-Yannick_Noah,1,S-XC,6,2,2,0,0,4,2
19830605-M-Roland_Garros-F-Mats_Wilander-Yannick_Noah,1,S-DTM,2,0,0,0,0,1,1
19830605-M-Roland_Garros-F-Mats_Wilander-Yannick_Noah,1,S-DTL,4,0,0,0,0,1,3
19830605-M-Roland_Garros-F-Mats_Wilander-Yannick_Noah,2,F-XC,50,6,2,1,3,31,19
19830605-M-Roland_Garros-F-Mats_Wilander-Yannick_Noah,2,F-DTM,73,6,0,0,6,35,38
19830605-M-Roland_Garros-F-Mats_Wilander-Yannick_Noah,2,F-DTL,10,5,0,3,2,5,5
19830605-M-Roland_Garros-F-Mats_Wilander-Yannick_Noah,2,F-IO,8,2,0,1,1,4,4
19830605-M-Roland_Garros-F-Mats_Wilander-Yannick_Noah,2,F-II,1,0,0,0,0,1,0
19830605-M-Roland_Garros-F-Mats_Wilander-Yannick_Noah,2,B-XC,10,5,2,1,2,4,6
19830605-M-Roland_Garros-F-Mats_Wilander-Yannick_Noah,2,B-DTM,78,0,0,0,0,40,38
19830605-M-Roland_Garros-F-Mats_Wilander-Yannick_Noah,2,B-DTL,11,3,0,1,2,7,4
19830605-M-Roland_Garros-F-Mats_Wilander-Yannick_Noah,2,B-IO,7,1,0,0,1,1,6
19830605-M-Roland_Garros-F-Mats_Wilander-Yannick_Noah,2,S-XC,75,2,0,1,1,42,33
19830605-M-Roland_Garros-F-Mats_Wilander-Yannick_Noah,2,S-DTM,82,4,0,1,3,46,36
19830605-M-Roland_Garros-F-Mats_Wilander-Yannick_Noah,2,S-DTL,9,1,0,0,1,3,6
19830605-M-Roland_Garros-F-Mats_Wilander-Yannick_Noah,2,S-IO,15,4,1,1,2,11,4
20070810-M-Canada_Masters-SF-Roger_Federer-Radek_Stepanek,1,F-XC,18,7,3,3,1,12,6
20070810-M-Canada_Masters-SF-Roger_Federer-Radek_Stepanek,1,F-DTM,9,1,0,1,0,6,3
20070810-M-Canada_Masters-SF-Roger_Federer-Radek_Stepanek,1,F-DTL,7,3,1,1,1,5,2
20070810-M-Canada_Masters-SF-Roger_Federer-Radek_Stepanek,1,F-IO,9,2,1,0,1,6,3
20070810-M-Canada_Masters-SF-Roger_Federer-Radek_Stepanek,1,F-II,3,1,0,0,1,1,2
20070810-M-Canada_Masters-SF-Roger_Federer-Radek_Stepanek,1,B-XC,18,4,1,2,1,10,8
20070810-M-Canada_Masters-SF-Roger_Federer-Radek_Stepanek,1,B-DTM,9,2,0,1,1,2,7
20070810-M-Canada_Masters-SF-Roger_Federer-Radek_Stepanek,1,B-DTL,9,4,3,1,0,6,3
20070810-M-Canada_Masters-SF-Roger_Federer-Radek_Stepanek,1,S-XC,8,0,0,0,0,3,5
20070810-M-Canada_Masters-SF-Roger_Federer-Radek_Stepanek,1,S-DTM,2,0,0,0,0,2,0
20070810-M-Canada_Masters-SF-Roger_Federer-Radek_Stepanek,1,S-DTL,3,1,0,1,0,2,1
20070810-M-Canada_Masters-SF-Roger_Federer-Radek_Stepanek,2,F-XC,7,1,0,1,0,2,5
20070810-M-Canada_Masters-SF-Roger_Federer-Radek_Stepanek,2,F-DTM,9,0,0,0,0,3,6
20070810-M-Canada_Masters-SF-Roger_Federer-Radek_Stepanek,2,F-DTL,6,3,0,2,1,5,1
20070810-M-Canada_Masters-SF-Roger_Federer-Radek_Stepanek,2,F-IO,4,2,0,0,2,0,4
20070810-M-Canada_Masters-SF-Roger_Federer-Radek_Stepanek,2,B-XC,17,5,1,2,2,11,6
20070810-M-Canada_Masters-SF-Roger_Federer-Radek_Stepanek,2,B-DTM,6,1,0,1,0,3,3
20070810-M-Canada_Masters-SF-Roger_Federer-Radek_Stepanek,2,B-DTL,9,4,1,1,2,5,4
20070810-M-Canada_Masters-SF-Roger_Federer-Radek_Stepanek,2,B-IO,2,0,0,0,0,1,1
20070810-M-Canada_Masters-SF-Roger_Federer-Radek_Stepanek,2,S-XC,12,4,0,2,2,5,7
20070810-M-Canada_Masters-SF-Roger_Federer-Radek_Stepanek,2,S-DTL,1,1,0,1,0,1,0
20101010-M-Tokyo-F-Rafael_Nadal-Gael_Monfils,1,F-XC,68,9,3,5,1,58,10
20101010-M-Tokyo-F-Rafael_Nadal-Gael_Monfils,1,F-DTM,15,0,0,0,0,12,3
20101010-M-Tokyo-F-Rafael_Nadal-Gael_Monfils,1,F-DTL,16,7,3,3,1,12,4
20101010-M-Tokyo-F-Rafael_Nadal-Gael_Monfils,1,F-IO,15,8,4,3,1,14,1
20101010-M-Tokyo-F-Rafael_Nadal-Gael_Monfils,1,F-II,7,2,1,0,1,6,1
20101010-M-Tokyo-F-Rafael_Nadal-Gael_Monfils,1,B-XC,11,5,1,2,2,8,3
20101010-M-Tokyo-F-Rafael_Nadal-Gael_Monfils,1,B-DTM,9,0,0,0,0,7,2
20101010-M-Tokyo-F-Rafael_Nadal-Gael_Monfils,1,B-DTL,14,1,1,0,0,13,1
20101010-M-Tokyo-F-Rafael_Nadal-Gael_Monfils,1,B-IO,3,0,0,0,0,2,1
20101010-M-Tokyo-F-Rafael_Nadal-Gael_Monfils,1,S-XC,10,1,0,1,0,6,4
20101010-M-Tokyo-F-Rafael_Nadal-Gael_Monfils,1,S-DTM,1,0,0,0,0,0,1
20101010-M-Tokyo-F-Rafael_Nadal-Gael_Monfils,1,S-DTL,2,0,0,0,0,0,2
20101010-M-Tokyo-F-Rafael_Nadal-Gael_Monfils,2,F-XC,35,4,1,3,0,11,24
20101010-M-Tokyo-F-Rafael_Nadal-Gael_Monfils,2,F-DTM,18,2,0,0,2,4,14
20101010-M-Tokyo-F-Rafael_Nadal-Gael_Monfils,2,F-DTL,7,4,1,2,1,3,4
20101010-M-Tokyo-F-Rafael_Nadal-Gael_Monfils,2,F-IO,11,3,1,0,2,1,10
20101010-M-Tokyo-F-Rafael_Nadal-Gael_Monfils,2,F-II,2,1,0,0,1,0,2
20101010-M-Tokyo-F-Rafael_Nadal-Gael_Monfils,2,B-XC,40,4,0,0,4,7,33
20101010-M-Tokyo-F-Rafael_Nadal-Gael_Monfils,2,B-DTM,29,0,0,0,0,4,25
20101010-M-Tokyo-F-Rafael_Nadal-Gael_Monfils,2,B-DTL,10,0,0,0,0,2,8
20101010-M-Tokyo-F-Rafael_Nadal-Gael_Monfils,2,B-IO,3,0,0,0,0,1,2
20101010-M-Tokyo-F-Rafael_Nadal-Gael_Monfils,2,S-XC,1,0,0,0,0,0,1
19821213-M-Australian_Open-F-Steve_Denton-Johan_Kriek,1,F-XC,3,0,0,0,0,2,1
19821213-M-Australian_Open-F-Steve_Denton-Johan_Kriek,1,F-DTM,4,2,0,2,0,2,2
19821213-M-Australian_Open-F-Steve_Denton-Johan_Kriek,1,F-DTL,1,0,0,0,0,1,0
19821213-M-Australian_Open-F-Steve_Denton-Johan_Kriek,1,F-IO,1,1,0,0,1,0,1
19821213-M-Australian_Open-F-Steve_Denton-Johan_Kriek,1,B-XC,3,3,1,0,2,1,2
19821213-M-Australian_Open-F-Steve_Denton-Johan_Kriek,1,B-DTM,2,0,0,0,0,0,2
19821213-M-Australian_Open-F-Steve_Denton-Johan_Kriek,1,B-DTL,2,1,1,0,0,1,1
19821213-M-Australian_Open-F-Steve_Denton-Johan_Kriek,1,B-IO,2,0,0,0,0,1,1
19821213-M-Australian_Open-F-Steve_Denton-Johan_Kriek,1,S-XC,3,2,0,1,1,1,2
19821213-M-Australian_Open-F-Steve_Denton-Johan_Kriek,1,S-DTM,3,2,0,0,2,0,3
19821213-M-Australian_Open-F-Steve_Denton-Johan_Kriek,1,S-IO,1,1,1,0,0,1,0
19821213-M-Australian_Open-F-Steve_Denton-Johan_Kriek,2,F-XC,8,6,4,1,1,5,3
19821213-M-Australian_Open-F-Steve_Denton-Johan_Kriek,2,F-DTM,5,1,0,0,1,2,3
19821213-M-Australian_Open-F-Steve_Denton-Johan_Kriek,2,F-DTL,3,1,0,0,1,1,2
19821213-M-Australian_Open-F-Steve_Denton-Johan_Kriek,2,F-IO,5,1,1,0,0,3,2
19821213-M-Australian_Open-F-Steve_Denton-Johan_Kriek,2,F-II,1,0,0,0,0,1,0
19821213-M-Australian_Open-F-Steve_Denton-Johan_Kriek,2,B-XC,3,2,2,0,0,3,0
19821213-M-Australian_Open-F-Steve_Denton-Johan_Kriek,2,B-DTM,1,1,1,0,0,1,0
19821213-M-Australian_Open-F-Steve_Denton-Johan_Kriek,2,B-DTL,1,1,1,0,0,1,0
19821213-M-Australian_Open-F-Steve_Denton-Johan_Kriek,2,B-IO,2,2,2,0,0,2,0
19821213-M-Australian_Open-F-Steve_Denton-Johan_Kriek,2,S-XC,2,1,0,1,0,2,0
19821213-M-Australian_Open-F-Steve_Denton-Johan_Kriek,2,S-DTM,1,0,0,0,0,0,1
20030615-M-Halle-F-Roger_Federer-Nicolas_Kiefer,1,F-XC,10,5,3,2,0,9,1
20030615-M-Halle-F-Roger_Federer-Nicolas_Kiefer,1,F-DTM,11,4,0,0,4,5,6
20030615-M-Halle-F-Roger_Federer-Nicolas_Kiefer,1,F-DTL,2,1,1,0,0,2,0
20030615-M-Halle-F-Roger_Federer-Nicolas_Kiefer,1,F-IO,7,3,2,0,1,3,4
20030615-M-Halle-F-Roger_Federer-Nicolas_Kiefer,1,B-XC,6,2,1,0,1,4,2
20030615-M-Halle-F-Roger_Federer-Nicolas_Kiefer,1,B-DTM,9,0,0,0,0,5,4
20030615-M-Halle-F-Roger_Federer-Nicolas_Kiefer,1,B-DTL,4,2,0,1,1,3,1
20030615-M-Halle-F-Roger_Federer-Nicolas_Kiefer,1,S-XC,6,1,0,1,0,4,2
20030615-M-Halle-F-Roger_Federer-Nicolas_Kiefer,1,S-DTM,8,2,1,1,0,4,4
20030615-M-Halle-F-Roger_Federer-Nicolas_Kiefer,1,S-DTL,2,0,0,0,0,1,1
20030615-M-Halle-F-Roger_Federer-Nicolas_Kiefer,1,S-IO,1,0,0,0,0,1,0
20030615-M-Halle-F-Roger_Federer-Nicolas_Kiefer,2,F-XC,10,5,1,1,3,4,6
20030615-M-Halle-F-Roger_Federer-Nicolas_Kiefer,2,F-DTM,12,1,0,0,1,4,8
20030615-M-Halle-F-Roger_Federer-Nicolas_Kiefer,2,F-DTL,7,3,0,0,3,1,6
20030615-M-Halle-F-Roger_Federer-Nicolas_Kiefer,2,F-IO,15,1,1,0,0,7,8
20030615-M-Halle-F-Roger_Federer-Nicolas_Kiefer,2,F-II,1,1,0,0,1,0,1
20030615-M-Halle-F-Roger_Federer-Nicolas_Kiefer,2,B-XC,4,0,0,0,0,2,2
20030615-M-Halle-F-Roger_Federer-Nicolas_Kiefer,2,B-DTM,11,2,0,2,0,4,7
20030615-M-Halle-F-Roger_Federer-Nicolas_Kiefer,2,B-DTL,1,0,0,0,0,0,1
20030615-M-Halle-F-Roger_Federer-Nicolas_Kiefer,2,B-IO,2,0,0,0,0,0,2
20030615-M-Halle-F-Roger_Federer-Nicolas_Kiefer,2,S-XC,3,1,0,0,1,0,3
20030615-M-Halle-F-Roger_Federer-Nicolas_Kiefer,2,S-DTM,4,0,0,0,0,3,1
20030615-M-Halle-F-Roger_Federer-Nicolas_Kiefer,2,S-DTL,1,0,0,0,0,0,1
20040314-M-Indian_Wells_Masters-F-Roger_Federer-Tim_Henman,1,F-XC,18,9,4,3,2,16,2
20040314-M-Indian_Wells_Masters-F-Roger_Federer-Tim_Henman,1,F-DTM,13,2,0,0,2,7,6
20040314-M-Indian_Wells_Masters-F-Roger_Federer-Tim_Henman,1,F-DTL,4,1,0,1,0,3,1
20040314-M-Indian_Wells_Masters-F-Roger_Federer-Tim_Henman,1,F-IO,8,1,0,0,1,6,2
20040314-M-Indian_Wells_Masters-F-Roger_Federer-Tim_Henman,1,F-II,2,1,1,0,0,2,0
20040314-M-Indian_Wells_Masters-F-Roger_Federer-Tim_Henman,1,B-XC,19,6,3,1,2,14,5
20040314-M-Indian_Wells_Masters-F-Roger_Federer-Tim_Henman,1,B-DTM,8,1,0,0,1,4,4
20040314-M-Indian_Wells_Masters-F-Roger_Federer-Tim_Henman,1,B-DTL,2,0,0,0,0,2,0
20040314-M-Indian_Wells_Masters-F-Roger_Federer-Tim_Henman,1,B-IO,2,1,0,0,1,1,1
20040314-M-Indian_Wells_Masters-F-Roger_Federer-Tim_Henman,1,S-XC,2,1,1,0,0,2,0
20040314-M-Indian_Wells_Masters-F-Roger_Federer-Tim_Henman,1,S-DTM,2,0,0,0,0,1,1
20040314-M-Indian_Wells_Masters-F-Roger_Federer-Tim_Henman,1,S-DTL,1,0,0,0,0,0,1
20040314-M-Indian_Wells_Masters-F-Roger_Federer-Tim_Henman,2,F-XC,12,2,0,1,1,6,6
20040314-M-Indian_Wells_Masters-F-Roger_Federer-Tim_Henman,2,F-DTM,15,5,0,0,5,1,14
20040314-M-Indian_Wells_Masters-F-Roger_Federer-Tim_Henman,2,F-DTL,4,2,1,0,1,1,3
20040314-M-Indian_Wells_Masters-F-Roger_Federer-Tim_Henman,2,F-IO,11,2,0,1,1,6,5
20040314-M-Indian_Wells_Masters-F-Roger_Federer-Tim_Henman,2,B-XC,3,0,0,0,0,2,1
20040314-M-Indian_Wells_Masters-F-Roger_Federer-Tim_Henman,2,B-DTM,6,0,0,0,0,1,5
20040314-M-Indian_Wells_Masters-F-Roger_Federer-Tim_Henman,2,B-DTL,3,2,0,0,2,0,3
20040314-M-Indian_Wells_Masters-F-Roger_Federer-Tim_Henman,2,S-XC,15,2,0,0,2,3,12
20040314-M-Indian_Wells_Masters-F-Roger_Federer-Tim_Henman,2,S-DTM,3,2,0,0,2,0,3
20040314-M-Indian_Wells_Masters-F-Roger_Federer-Tim_Henman,2,S-DTL,2,1,0,0,1,0,2
20130105-M-Brisbane-SF-Kei_Nishikori-Andy_Murray,1,F-XC,16,5,3,0,2,10,6
20130105-M-Brisbane-SF-Kei_Nishikori-Andy_Murray,1,F-DTM,11,1,0,0,1,3,8
20130105-M-Brisbane-SF-Kei_Nishikori-Andy_Murray,1,F-DTL,4,2,0,0,2,1,3
20130105-M-Brisbane-SF-Kei_Nishikori-Andy_Murray,1,F-IO,7,1,1,0,0,5,2
20130105-M-Brisbane-SF-Kei_Nishikori-Andy_Murray,1,F-II,1,0,0,0,0,0,1
20130105-M-Brisbane-SF-Kei_Nishikori-Andy_Murray,1,B-XC,22,3,0,2,0,11,11
20130105-M-Brisbane-SF-Kei_Nishikori-Andy_Murray,1,B-DTM,15,2,0,0,2,7,8
20130105-M-Brisbane-SF-Kei_Nishikori-Andy_Murray,1,B-DTL,3,1,0,0,0,1,2
20130105-M-Brisbane-SF-Kei_Nishikori-Andy_Murray,1,B-IO,4,1,0,0,1,2,2
20130105-M-Brisbane-SF-Kei_Nishikori-Andy_Murray,1,S-XC,1,0,0,0,0,0,1
20130105-M-Brisbane-SF-Kei_Nishikori-Andy_Murray,1,S-DTM,3,0,0,0,0,0,3
20130105-M-Brisbane-SF-Kei_Nishikori-Andy_Murray,1,S-DTL,1,0,0,0,0,0,1
20130105-M-Brisbane-SF-Kei_Nishikori-Andy_Murray,2,F-XC,10,4,2,1,1,7,3
20130105-M-Brisbane-SF-Kei_Nishikori-Andy_Murray,2,F-DTM,12,3,0,1,1,6,6
20130105-M-Brisbane-SF-Kei_Nishikori-Andy_Murray,2,F-DTL,2,2,0,0,2,0,2
20130105-M-Brisbane-SF-Kei_Nishikori-Andy_Murray,2,F-IO,7,4,1,2,1,5,2
20130105-M-Brisbane-SF-Kei_Nishikori-Andy_Murray,2,F-II,1,1,1,0,0,1,0
20130105-M-Brisbane-SF-Kei_Nishikori-Andy_Murray,2,B-XC,14,5,2,0,3,8,6
20130105-M-Brisbane-SF-Kei_Nishikori-Andy_Murray,2,B-DTM,17,1,0,0,1,8,9
20130105-M-Brisbane-SF-Kei_Nishikori-Andy_Murray,2,B-DTL,1,1,1,0,0,1,0
20130105-M-Brisbane-SF-Kei_Nishikori-Andy_Murray,2,S-XC,8,1,0,0,1,5,3
20130105-M-Brisbane-SF-Kei_Nishikori-Andy_Murray,2,S-DTM,8,0,0,0,0,5,3
20130105-M-Brisbane-SF-Kei_Nishikori-Andy_Murray,2,S-DTL,1,0,0,0,0,0,1
20130105-M-Brisbane-SF-Kei_Nishikori-Andy_Murray,2,S-IO,1,0,0,0,0,0,1
19810104-M-Australian_Open-F-Kim_Warwick-Brian_Teacher,1,F-XC,7,2,0,0,2,2,5
19810104-M-Australian_Open-F-Kim_Warwick-Brian_Teacher,1,F-DTM,7,1,0,1,0,2,5
19810104-M-Australian_Open-F-Kim_Warwick-Brian_Teacher,1,F-DTL,4,3,0,0,3,0,4
19810104-M-Australian_Open-F-Kim_Warwick-Brian_Teacher,1,F-IO,6,4,0,2,2,2,4
19810104-M-Australian_Open-F-Kim_Warwick-Brian_Teacher,1,B-XC,3,2,2,0,0,2,1
19810104-M-Australian_Open-F-Kim_Warwick-Brian_Teacher,1,B-DTM,2,0,0,0,0,0,2
19810104-M-Australian_Open-F-Kim_Warwick-Brian_Teacher,1,B-IO,5,3,1,0,2,2,3
19810104-M-Australian_Open-F-Kim_Warwick-Brian_Teacher,1,S-XC,2,0,0,0,0,1,1
19810104-M-Australian_Open-F-Kim_Warwick-Brian_Teacher,1,S-DTM,2,0,0,0,0,1,1
19810104-M-Australian_Open-F-Kim_Warwick-Brian_Teacher,1,S-IO,1,0,0,0,0,0,1
19810104-M-Australian_Open-F-Kim_Warwick-Brian_Teacher,2,F-XC,5,2,2,0,0,4,1
19810104-M-Australian_Open-F-Kim_Warwick-Brian_Teacher,2,F-DTM,8,0,0,0,0,2,6
19810104-M-Australian_Open-F-Kim_Warwick-Brian_Teacher,2,F-DTL,3,2,2,0,0,3,0
19810104-M-Australian_Open-F-Kim_Warwick-Brian_Teacher,2,F-IO,1,1,1,0,0,1,0
19810104-M-Australian_Open-F-Kim_Warwick-Brian_Teacher,2,B-XC,5,1,1,0,0,2,3
19810104-M-Australian_Open-F-Kim_Warwick-Brian_Teacher,2,B-DTM,4,1,0,0,1,0,4
19810104-M-Australian_Open-F-Kim_Warwick-Brian_Teacher,2,B-DTL,1,1,0,0,1,0,1
19810104-M-Australian_Open-F-Kim_Warwick-Brian_Teacher,2,S-DTM,1,0,0,0,0,1,0
19810104-M-Australian_Open-F-Kim_Warwick-Brian_Teacher,2,S-DTL,1,1,0,0,1,0,1
19810104-M-Australian_Open-F-Kim_Warwick-Brian_Teacher,2,S-IO,2,0,0,0,0,2,0
19850609-M-Roland_Garros-F-Mats_Wilander-Ivan_Lendl,1,F-XC,59,8,2,4,2,37,22
19850609-M-Roland_Garros-F-Mats_Wilander-Ivan_Lendl,1,F-DTM,166,6,0,2,4,89,77
19850609-M-Roland_Garros-F-Mats_Wilander-Ivan_Lendl,1,F-DTL,15,3,1,0,2,11,4
19850609-M-Roland_Garros-F-Mats_Wilander-Ivan_Lendl,1,F-IO,74,10,1,4,5,44,30
19850609-M-Roland_Garros-F-Mats_Wilander-Ivan_Lendl,1,F-II,7,3,1,1,1,5,2
19850609-M-Roland_Garros-F-Mats_Wilander-Ivan_Lendl,1,B-XC,142,5,1,1,3,93,49
19850609-M-Roland_Garros-F-Mats_Wilander-Ivan_Lendl,1,B-DTM,141,10,0,3,7,74,67
19850609-M-Roland_Garros-F-Mats_Wilander-Ivan_Lendl,1,B-DTL,24,6,3,1,2,18,6
19850609-M-Roland_Garros-F-Mats_Wilander-Ivan_Lendl,1,B-IO,15,4,0,2,2,8,7
19850609-M-Roland_Garros-F-Mats_Wilander-Ivan_Lendl,1,S-XC,21,1,0,0,1,10,11
19850609-M-Roland_Garros-F-Mats_Wilander-Ivan_Lendl,1,S-DTM,19,1,0,0,1,5,14
19850609-M-Roland_Garros-F-Mats_Wilander-Ivan_Lendl,1,S-DTL,4,0,0,0,0,1,3
19850609-M-Roland_Garros-F-Mats_Wilander-Ivan_Lendl,2,F-XC,77,17,8,1,8,34,43
19850609-M-Roland_Garros-F-Mats_Wilander-Ivan_Lendl,2,F-DTM,139,6,1,0,5,67,72
19850609-M-Roland_Garros-F-Mats_Wilander-Ivan_Lendl,2,F-DTL,12,2,0,0,2,5,7
19850609-M-Roland_Garros-F-Mats_Wilander-Ivan_Lendl,2,F-IO,87,11,5,2,4,45,42
19850609-M-Roland_Garros-F-Mats_Wilander-Ivan_Lendl,2,F-II,3,1,0,0,1,0,3
19850609-M-Roland_Garros-F-Mats_Wilander-Ivan_Lendl,2,B-XC,109,3,0,0,3,38,71
19850609-M-Roland_Garros-F-Mats_Wilander-Ivan_Lendl,2,B-DTM,168,5,0,0,5,62,106
19850609-M-Roland_Garros-F-Mats_Wilander-Ivan_Lendl,2,B-DTL,13,4,2,1,1,8,5
19850609-M-Roland_Garros-F-Mats_Wilander-Ivan_Lendl,2,B-IO,10,4,1,1,2,4,6
19850609-M-Roland_Garros-F-Mats_Wilander-Ivan_Lendl,2,S-XC,28,2,0,1,1,13,15
19850609-M-Roland_Garros-F-Mats_Wilander-Ivan_Lendl,2,S-DTM,40,3,0,0,3,7,33
19850609-M-Roland_Garros-F-Mats_Wilander-Ivan_Lendl,2,S-DTL,2,0,0,0,0,0,2
19850609-M-Roland_Garros-F-Mats_Wilander-Ivan_Lendl,2,S-IO,1,0,0,0,0,0,1
20051002-M-Bangkok-F-Roger_Federer-Andy_Murray,1,F-XC,32,7,4,1,2,16,16
20051002-M-Bangkok-F-Roger_Federer-Andy_Murray,1,F-DTM,26,3,0,2,1,18,8
20051002-M-Bangkok-F-Roger_Federer-Andy_Murray,1,F-DTL,2,1,0,0,1,0,2
20051002-M-Bangkok-F-Roger_Federer-Andy_Murray,1,F-IO,24,9,4,4,1,19,5
20051002-M-Bangkok-F-Roger_Federer-Andy_Murray,1,F-II,3,1,1,0,0,2,1
20051002-M-Bangkok-F-Roger_Federer-Andy_Murray,1,B-XC,24,6,0,1,5,16,8
20051002-M-Bangkok-F-Roger_Federer-Andy_Murray,1,B-DTM,23,1,0,0,1,10,13
20051002-M-Bangkok-F-Roger_Federer-Andy_Murray,1,B-DTL,4,4,1,1,2,2,2
20051002-M-Bangkok-F-Roger_Federer-Andy_Murray,1,B-IO,1,1,0,0,1,0,1
20051002-M-Bangkok-F-Roger_Federer-Andy_Murray,1,S-XC,15,2,0,1,1,9,6
20051002-M-Bangkok-F-Roger_Federer-Andy_Murray,1,S-DTM,11,0,0,0,0,5,6
20051002-M-Bangkok-F-Roger_Federer-Andy_Murray,1,S-DTL,1,0,0,0,0,0,1
20051002-M-Bangkok-F-Roger_Federer-Andy_Murray,1,S-IO,1,0,0,0,0,0,1
20051002-M-Bangkok-F-Roger_Federer-Andy_Murray,2,F-XC,24,10,2,5,3,14,10
20051002-M-Bangkok-F-Roger_Federer-Andy_Murray,2,F-DTM,36,5,1,0,4,16,20
20051002-M-Bangkok-F-Roger_Federer-Andy_Murray,2,F-DTL,7,4,1,1,2,3,4
20051002-M-Bangkok-F-Roger_Federer-Andy_Murray,2,F-IO,25,9,1,5,3,14,11
20051002-M-Bangkok-F-Roger_Federer-Andy_Murray,2,F-II,2,2,0,0,2,0,2
20051002-M-Bangkok-F-Roger_Federer-Andy_Murray,2,B-XC,16,5,0,0,5,5,11
20051002-M-Bangkok-F-Roger_Federer-Andy_Murray,2,B-DTM,31,3,0,0,3,10,21
20051002-M-Bangkok-F-Roger_Federer-Andy_Murray,2,B-DTL,3,0,0,0,0,1,2
20051002-M-Bangkok-F-Roger_Federer-Andy_Murray,2,B-IO,6,5,2,0,3,2,4
20051002-M-Bangkok-F-Roger_Federer-Andy_Murray,2,S-XC,14,2,0,0,2,6,8
20051002-M-Bangkok-F-Roger_Federer-Andy_Murray,2,S-DTM,11,0,0,0,0,5,6
20051002-M-Bangkok-F-Roger_Federer-Andy_Murray,2,S-DTL,2,0,0,0,0,2,0
20051002-M-Bangkok-F-Roger_Federer-Andy_Murray,2,S-IO,2,0,0,0,0,1,1
20050108-M-Doha-F-Roger_Federer-Ivan_Ljubicic,1,F-XC,18,2,2,0,0,8,10
20050108-M-Doha-F-Roger_Federer-Ivan_Ljubicic,1,F-DTM,23,2,0,0,2,10,13
20050108-M-Doha-F-Roger_Federer-Ivan_Ljubicic,1,F-DTL,6,2,2,0,0,3,3
20050108-M-Doha-F-Roger_Federer-Ivan_Ljubicic,1,F-IO,9,4,1,1,2,5,4
20050108-M-Doha-F-Roger_Federer-Ivan_Ljubicic,1,F-II,2,0,0,0,0,2,0
20050108-M-Doha-F-Roger_Federer-Ivan_Ljubicic,1,B-XC,9,0,0,0,0,5,4
20050108-M-Doha-F-Roger_Federer-Ivan_Ljubicic,1,B-DTM,8,1,0,1,0,6,2
20050108-M-Doha-F-Roger_Federer-Ivan_Ljubicic,1,B-DTL,4,2,0,1,1,2,2
20050108-M-Doha-F-Roger_Federer-Ivan_Ljubicic,1,B-IO,1,1,1,0,0,1,0
20050108-M-Doha-F-Roger_Federer-Ivan_Ljubicic,1,S-XC,8,0,0,0,0,4,4
20050108-M-Doha-F-Roger_Federer-Ivan_Ljubicic,1,S-DTM,11,2,0,0,2,3,8
20050108-M-Doha-F-Roger_Federer-Ivan_Ljubicic,1,S-DTL,2,0,0,0,0,1,1
20050108-M-Doha-F-Roger_Federer-Ivan_Ljubicic,1,S-IO,1,0,0,0,0,1,0
20050108-M-Doha-F-Roger_Federer-Ivan_Ljubicic,2,F-XC,22,3,0,0,3,11,11
20050108-M-Doha-F-Roger_Federer-Ivan_Ljubicic,2,F-DTM,20,3,0,0,3,9,11
20050108-M-Doha-F-Roger_Federer-Ivan_Ljubicic,2,F-DTL,5,3,2,0,1,3,2
20050108-M-Doha-F-Roger_Federer-Ivan_Ljubicic,2,F-IO,11,3,0,0,3,6,5
20050108-M-Doha-F-Roger_Federer-Ivan_Ljubicic,2,F-II,1,0,0,0,0,1,0
20050108-M-Doha-F-Roger_Federer-Ivan_Ljubicic,2,B-XC,22,8,3,2,2,13,9
20050108-M-Doha-F-Roger_Federer-Ivan_Ljubicic,2,B-DTM,14,3,0,0,3,4,10
20050108-M-Doha-F-Roger_Federer-Ivan_Ljubicic,2,B-DTL,7,4,0,2,2,3,4
20050108-M-Doha-F-Roger_Federer-Ivan_Ljubicic,2,B-IO,2,2,0,2,0,2,0
20050108-M-Doha-F-Roger_Federer-Ivan_Ljubicic,2,S-XC,7,1,0,1,0,2,5
20050108-M-Doha-F-Roger_Federer-Ivan_Ljubicic,2,S-DTM,7,2,0,0,2,2,5
20050108-M-Doha-F-Roger_Federer-Ivan_Ljubicic,2,S-DTL,1,0,0,0,0,0,1
20050108-M-Doha-F-Roger_Federer-Ivan_Ljubicic,2,S-IO,2,0,0,0,0,1,1
19870125-M-Australian_Open-F-Stefan_Edberg-Pat_Cash,1,F-XC,11,5,3,0,2,5,6
19870125-M-Australian_Open-F-Stefan_Edberg-Pat_Cash,1,F-DTM,4,1,1,0,0,1,3
19870125-M-Australian_Open-F-Stefan_Edberg-Pat_Cash,1,F-DTL,5,4,3,0,1,3,2
19870125-M-Australian_Open-F-Stefan_Edberg-Pat_Cash,1,F-IO,4,2,1,1,0,2,2
19870125-M-Australian_Open-F-Stefan_Edberg-Pat_Cash,1,B-XC,8,6,1,0,5,2,6
19870125-M-Australian_Open-F-Stefan_Edberg-Pat_Cash,1,B-DTM,14,4,0,2,2,4,10
19870125-M-Australian_Open-F-Stefan_Edberg-Pat_Cash,1,B-DTL,6,4,2,1,1,3,3
19870125-M-Australian_Open-F-Stefan_Edberg-Pat_Cash,1,B-IO,5,2,1,0,1,1,4
19870125-M-Australian_Open-F-Stefan_Edberg-Pat_Cash,1,S-XC,1,0,0,0,0,0,1
19870125-M-Australian_Open-F-Stefan_Edberg-Pat_Cash,2,F-XC,5,5,5,0,0,5,0
19870125-M-Australian_Open-F-Stefan_Edberg-Pat_Cash,2,F-DTM,5,3,1,1,1,2,3
19870125-M-Australian_Open-F-Stefan_Edberg-Pat_Cash,2,F-DTL,4,2,2,0,0,4,0
19870125-M-Australian_Open-F-Stefan_Edberg-Pat_Cash,2,F-IO,2,0,0,0,0,2,0
19870125-M-Australian_Open-F-Stefan_Edberg-Pat_Cash,2,B-XC,2,1,0,1,0,1,1
19870125-M-Australian_Open-F-Stefan_Edberg-Pat_Cash,2,B-DTM,4,1,0,0,1,0,4
19870125-M-Australian_Open-F-Stefan_Edberg-Pat_Cash,2,B-DTL,2,1,1,0,0,1,1
19870125-M-Australian_Open-F-Stefan_Edberg-Pat_Cash,2,B-IO,2,2,2,0,0,2,0
19870125-M-Australian_Open-F-Stefan_Edberg-Pat_Cash,2,S-XC,2,1,0,1,0,2,0
19870125-M-Australian_Open-F-Stefan_Edberg-Pat_Cash,2,S-DTM,1,0,0,0,0,1,0
19870125-M-Australian_Open-F-Stefan_Edberg-Pat_Cash,2,S-DTL,1,1,0,0,1,0,1
20020113-M-Sydney-F-Roger_Federer-Juan_Ignacio_Chela,1,F-XC,23,5,3,1,1,15,8
20020113-M-Sydney-F-Roger_Federer-Juan_Ignacio_Chela,1,F-DTM,27,5,1,0,4,13,14
20020113-M-Sydney-F-Roger_Federer-Juan_Ignacio_Chela,1,F-DTL,3,1,0,1,0,3,0
20020113-M-Sydney-F-Roger_Federer-Juan_Ignacio_Chela,1,F-IO,12,1,0,1,0,6,6
20020113-M-Sydney-F-Roger_Federer-Juan_Ignacio_Chela,1,F-II,1,1,1,0,0,1,0
20020113-M-Sydney-F-Roger_Federer-Juan_Ignacio_Chela,1,B-XC,3,2,0,0,2,1,2
20020113-M-Sydney-F-Roger_Federer-Juan_Ignacio_Chela,1,B-DTM,5,0,0,0,0,3,2
20020113-M-Sydney-F-Roger_Federer-Juan_Ignacio_Chela,1,B-DTL,2,2,1,0,1,1,1
20020113-M-Sydney-F-Roger_Federer-Juan_Ignacio_Chela,1,B-IO,2,1,0,0,1,1,1
20020113-M-Sydney-F-Roger_Federer-Juan_Ignacio_Chela,1,S-XC,3,0,0,0,0,3,0
20020113-M-Sydney-F-Roger_Federer-Juan_Ignacio_Chela,1,S-DTM,10,2,0,0,2,2,8
20020113-M-Sydney-F-Roger_Federer-Juan_Ignacio_Chela,1,S-IO,1,0,0,0,0,0,1
20020113-M-Sydney-F-Roger_Federer-Juan_Ignacio_Chela,2,F-XC,23,3,0,2,1,11,12
20020113-M-Sydney-F-Roger_Federer-Juan_Ignacio_Chela,2,F-DTM,25,1,0,0,1,13,12
20020113-M-Sydney-F-Roger_Federer-Juan_Ignacio_Chela,2,F-DTL,4,2,1,0,1,3,1
20020113-M-Sydney-F-Roger_Federer-Juan_Ignacio_Chela,2,F-IO,9,5,0,4,1,6,3
20020113-M-Sydney-F-Roger_Federer-Juan_Ignacio_Chela,2,F-II,1,1,1,0,0,1,0
20020113-M-Sydney-F-Roger_Federer-Juan_Ignacio_Chela,2,B-XC,13,7,2,0,5,5,8
20020113-M-Sydney-F-Roger_Federer-Juan_Ignacio_Chela,2,B-DTM,20,1,0,0,1,7,13
20020113-M-Sydney-F-Roger_Federer-Juan_Ignacio_Chela,2,B-DTL,1,1,1,0,0,1,0
20020113-M-Sydney-F-Roger_Federer-Juan_Ignacio_Chela,2,B-IO,2,1,0,0,1,0,2
20020113-M-Sydney-F-Roger_Federer-Juan_Ignacio_Chela,2,S-DTM,2,0,0,0,0,1,1
20020113-M-Sydney-F-Roger_Federer-Juan_Ignacio_Chela,2,S-DTL,1,0,0,0,0,1,0
20050821-M-Cincinnati_Masters-F-Andy_Roddick-Roger_Federer,1,F-XC,18,4,1,1,2,6,12
20050821-M-Cincinnati_Masters-F-Andy_Roddick-Roger_Federer,1,F-DTM,17,1,0,0,1,7,10
20050821-M-Cincinnati_Masters-F-Andy_Roddick-Roger_Federer,1,F-DTL,3,1,0,0,1,0,3
20050821-M-Cincinnati_Masters-F-Andy_Roddick-Roger_Federer,1,F-IO,13,5,2,1,2,7,6
20050821-M-Cincinnati_Masters-F-Andy_Roddick-Roger_Federer,1,F-II,1,0,0,0,0,1,0
20050821-M-Cincinnati_Masters-F-Andy_Roddick-Roger_Federer,1,B-XC,10,0,0,0,0,3,7
20050821-M-Cincinnati_Masters-F-Andy_Roddick-Roger_Federer,1,B-DTM,13,3,0,0,3,7,6
20050821-M-Cincinnati_Masters-F-Andy_Roddick-Roger_Federer,1,B-DTL,1,1,1,0,0,1,0
20050821-M-Cincinnati_Masters-F-Andy_Roddick-Roger_Federer,1,B-IO,1,1,0,0,1,0,1
20050821-M-Cincinnati_Masters-F-Andy_Roddick-Roger_Federer,1,S-XC,8,1,0,0,1,4,4
20050821-M-Cincinnati_Masters-F-Andy_Roddick-Roger_Federer,1,S-DTM,4,0,0,0,0,1,3
20050821-M-Cincinnati_Masters-F-Andy_Roddick-Roger_Federer,2,F-XC,13,7,3,2,2,11,2
20050821-M-Cincinnati_Masters-F-Andy_Roddick-Roger_Federer,2,F-DTM,21,3,0,1,2,9,12
20050821-M-Cincinnati_Masters-F-Andy_Roddick-Roger_Federer,2,F-DTL,2,2,2,0,0,2,0
20050821-M-Cincinnati_Masters-F-Andy_Roddick-Roger_Federer,2,F-IO,12,3,1,1,1,6,6
20050821-M-Cincinnati_Masters-F-Andy_Roddick-Roger_Federer,2,F-II,2,1,0,0,1,1,1
20050821-M-Cincinnati_Masters-F-Andy_Roddick-Roger_Federer,2,B-XC,10,4,1,2,1,5,5
20050821-M-Cincinnati_Masters-F-Andy_Roddick-Roger_Federer,2,B-DTM,11,2,0,0,2,5,6
20050821-M-Cincinnati_Masters-F-Andy_Roddick-Roger_Federer,2,B-DTL,2,1,1,0,0,2,0
20050821-M-Cincinnati_Masters-F-Andy_Roddick-Roger_Federer,2,B-IO,1,1,0,0,1,0,1
20050821-M-Cincinnati_Masters-F-Andy_Roddick-Roger_Federer,2,S-XC,4,0,0,0,0,3,1
20050821-M-Cincinnati_Masters-F-Andy_Roddick-Roger_Federer,2,S-DTM,8,2,1,0,1,6,2
20050821-M-Cincinnati_Masters-F-Andy_Roddick-Roger_Federer,2,S-DTL,3,0,0,0,0,2,1
20080615-M-Halle-F-Roger_Federer-Philipp_Kohlschreiber,1,F-XC,18,9,3,4,2,15,3
20080615-M-Halle-F-Roger_Federer-Philipp_Kohlschreiber,1,F-DTM,21,3,0,0,3,10,11
20080615-M-Halle-F-Roger_Federer-Philipp_Kohlschreiber,1,F-DTL,5,2,1,1,0,3,2
20080615-M-Halle-F-Roger_Federer-Philipp_Kohlschreiber,1,F-IO,12,5,1,3,1,10,2
20080615-M-Halle-F-Roger_Federer-Philipp_Kohlschreiber,1,F-II,1,0,0,0,0,1,0
20080615-M-Halle-F-Roger_Federer-Philipp_Kohlschreiber,1,B-XC,11,3,0,0,3,8,3
20080615-M-Halle-F-Roger_Federer-Philipp_Kohlschreiber,1,B-DTM,16,0,0,0,0,10,6
20080615-M-Halle-F-Roger_Federer-Philipp_Kohlschreiber,1,B-DTL,2,1,0,0,1,0,2
20080615-M-Halle-F-Roger_Federer-Philipp_Kohlschreiber,1,S-XC,12,0,0,0,0,10,2
20080615-M-Halle-F-Roger_Federer-Philipp_Kohlschreiber,1,S-DTM,15,1,0,1,0,10,5
20080615-M-Halle-F-Roger_Federer-Philipp_Kohlschreiber,1,S-IO,1,0,0,0,0,1,0
20080615-M-Halle-F-Roger_Federer-Philipp_Kohlschreiber,2,F-XC,19,6,1,2,3,6,13
20080615-M-Halle-F-Roger_Federer-Philipp_Kohlschreiber,2,F-DTM,14,0,0,0,0,7,7
20080615-M-Halle-F-Roger_Federer-Philipp_Kohlschreiber,2,F-DTL,4,3,1,0,2,1,3
20080615-M-Halle-F-Roger_Federer-Philipp_Kohlschreiber,2,F-IO,21,5,1,1,3,7,14
20080615-M-Halle-F-Roger_Federer-Philipp_Kohlschreiber,2,B-XC,24,8,1,4,3,10,14
20080615-M-Halle-F-Roger_Federer-Philipp_Kohlschreiber,2,B-DTM,17,3,0,1,2,4,13
20080615-M-Halle-F-Roger_Federer-Philipp_Kohlschreiber,2,B-DTL,2,0,0,0,0,1,1
20080615-M-Halle-F-Roger_Federer-Philipp_Kohlschreiber,2,B-IO,3,2,0,0,2,1,2
20080615-M-Halle-F-Roger_Federer-Philipp_Kohlschreiber,2,S-XC,7,0,0,0,0,0,7
20080615-M-Halle-F-Roger_Federer-Philipp_Kohlschreiber,2,S-DTM,7,0,0,0,0,1,6
20080615-M-Halle-F-Roger_Federer-Philipp_Kohlschreiber,2,S-DTL,5,1,0,0,1,2,3
20080615-M-Halle-F-Roger_Federer-Philipp_Kohlschreiber,2,S-IO,3,2,0,0,2,0,3
20140109-M-Sydney-QF-Juan_Martin_Del_Potro-Radek_Stepanek,1,F-XC,46,13,3,4,6,24,22
20140109-M-Sydney-QF-Juan_Martin_Del_Potro-Radek_Stepanek,1,F-DTM,23,3,0,0,3,13,10
20140109-M-Sydney-QF-Juan_Martin_Del_Potro-Radek_Stepanek,1,F-DTL,6,2,2,0,0,5,1
20140109-M-Sydney-QF-Juan_Martin_Del_Potro-Radek_Stepanek,1,F-IO,46,8,4,3,1,23,23
20140109-M-Sydney-QF-Juan_Martin_Del_Potro-Radek_Stepanek,1,F-II,12,6,0,3,3,5,7
20140109-M-Sydney-QF-Juan_Martin_Del_Potro-Radek_Stepanek,1,B-XC,36,8,1,2,5,21,15
20140109-M-Sydney-QF-Juan_Martin_Del_Potro-Radek_Stepanek,1,B-DTM,29,5,0,1,4,11,18
20140109-M-Sydney-QF-Juan_Martin_Del_Potro-Radek_Stepanek,1,B-DTL,9,5,0,2,3,3,6
20140109-M-Sydney-QF-Juan_Martin_Del_Potro-Radek_Stepanek,1,B-IO,4,1,0,0,1,0,4
20140109-M-Sydney-QF-Juan_Martin_Del_Potro-Radek_Stepanek,1,S-XC,47,1,0,1,0,29,18
20140109-M-Sydney-QF-Juan_Martin_Del_Potro-Radek_Stepanek,1,S-DTM,10,0,0,0,0,4,6
20140109-M-Sydney-QF-Juan_Martin_Del_Potro-Radek_Stepanek,1,S-DTL,5,1,0,1,0,2,3
20140109-M-Sydney-QF-Juan_Martin_Del_Potro-Radek_Stepanek,1,S-IO,1,0,0,0,0,0,1
20140109-M-Sydney-QF-Juan_Martin_Del_Potro-Radek_Stepanek,2,F-XC,29,10,6,1,3,14,15
20140109-M-Sydney-QF-Juan_Martin_Del_Potro-Radek_Stepanek,2,F-DTM,23,0,0,0,0,15,8
20140109-M-Sydney-QF-Juan_Martin_Del_Potro-Radek_Stepanek,2,F-DTL,21,5,2,0,3,14,7
20140109-M-Sydney-QF-Juan_Martin_Del_Potro-Radek_Stepanek,2,F-IO,35,5,3,0,2,18,17
20140109-M-Sydney-QF-Juan_Martin_Del_Potro-Radek_Stepanek,2,F-II,3,1,0,0,1,2,1
20140109-M-Sydney-QF-Juan_Martin_Del_Potro-Radek_Stepanek,2,B-XC,40,6,0,1,5,19,21
20140109-M-Sydney-QF-Juan_Martin_Del_Potro-Radek_Stepanek,2,B-DTM,33,1,0,1,0,16,17
20140109-M-Sydney-QF-Juan_Martin_Del_Potro-Radek_Stepanek,2,B-DTL,19,10,3,4,3,12,7
20140109-M-Sydney-QF-Juan_Martin_Del_Potro-Radek_Stepanek,2,B-IO,6,3,0,2,1,3,3
20140109-M-Sydney-QF-Juan_Martin_Del_Potro-Radek_Stepanek,2,S-XC,34,0,0,0,0,8,26
20140109-M-Sydney-QF-Juan_Martin_Del_Potro-Radek_Stepanek,2,S-DTM,15,0,0,0,0,5,10
20140109-M-Sydney-QF-Juan_Martin_Del_Potro-Radek_Stepanek,2,S-DTL,3,1,0,1,0,1,2
20160908-M-US_Open-QF-Juan_Martin_Del_Potro-Stanislas_Wawrinka,1,F-XC,88,29,5,8,16,48,40
20160908-M-US_Open-QF-Juan_Martin_Del_Potro-Stanislas_Wawrinka,1,F-DTM,51,6,0,1,5,21,30
20160908-M-US_Open-QF-Juan_Martin_Del_Potro-Stanislas_Wawrinka,1,F-DTL,5,2,0,1,1,4,1
20160908-M-US_Open-QF-Juan_Martin_Del_Potro-Stanislas_Wawrinka,1,F-IO,54,10,1,3,6,25,29
20160908-M-US_Open-QF-Juan_Martin_Del_Potro-Stanislas_Wawrinka,1,F-II,5,2,2,0,0,2,3
20160908-M-US_Open-QF-Juan_Martin_Del_Potro-Stanislas_Wawrinka,1,B-XC,31,3,0,1,2,15,16
20160908-M-US_Open-QF-Juan_Martin_Del_Potro-Stanislas_Wawrinka,1,B-DTM,28,2,0,0,2,13,15
20160908-M-US_Open-QF-Juan_Martin_Del_Potro-Stanislas_Wawrinka,1,B-DTL,2,1,0,0,1,1,1
20160908-M-US_Open-QF-Juan_Martin_Del_Potro-Stanislas_Wawrinka,1,S-XC,49,0,0,0,0,23,26
20160908-M-US_Open-QF-Juan_Martin_Del_Potro-Stanislas_Wawrinka,1,S-DTM,31,1,0,0,1,14,17
20160908-M-US_Open-QF-Juan_Martin_Del_Potro-Stanislas_Wawrinka,1,S-DTL,3,0,0,0,0,1,2
20160908-M-US_Open-QF-Juan_Martin_Del_Potro-Stanislas_Wawrinka,1,S-IO,3,0,0,0,0,1,2
20160908-M-US_Open-QF-Juan_Martin_Del_Potro-Stanislas_Wawrinka,1,S-II,1,1,0,1,0,1,0
20160908-M-US_Open-QF-Juan_Martin_Del_Potro-Stanislas_Wawrinka,2,F-XC,50,17,5,3,9,26,24
20160908-M-US_Open-QF-Juan_Martin_Del_Potro-Stanislas_Wawrinka,2,F-DTM,46,5,1,0,4,24,22
20160908-M-US_Open-QF-Juan_Martin_Del_Potro-Stanislas_Wawrinka,2,F-DTL,16,4,2,0,2,8,8
20160908-M-US_Open-QF-Juan_Martin_Del_Potro-Stanislas_Wawrinka,2,F-IO,30,10,8,1,1,22,8
20160908-M-US_Open-QF-Juan_Martin_Del_Potro-Stanislas_Wawrinka,2,F-II,4,3,1,1,1,3,1
20160908-M-US_Open-QF-Juan_Martin_Del_Potro-Stanislas_Wawrinka,2,B-XC,72,8,0,2,6,41,31
20160908-M-US_Open-QF-Juan_Martin_Del_Potro-Stanislas_Wawrinka,2,B-DTM,61,3,1,0,2,24,37
20160908-M-US_Open-QF-Juan_Martin_Del_Potro-Stanislas_Wawrinka,2,B-DTL,20,13,7,0,6,14,6
20160908-M-US_Open-QF-Juan_Martin_Del_Potro-Stanislas_Wawrinka,2,B-IO,14,9,3,1,5,7,7
20160908-M-US_Open-QF-Juan_Martin_Del_Potro-Stanislas_Wawrinka,2,S-XC,33,2,0,0,2,16,17
20160908-M-US_Open-QF-Juan_Martin_Del_Potro-Stanislas_Wawrinka,2,S-DTM,8,1,0,1,0,4,4
20160908-M-US_Open-QF-Juan_Martin_Del_Potro-Stanislas_Wawrinka,2,S-DTL,6,1,0,0,1,3,3
20160908-M-US_Open-QF-Juan_Martin_Del_Potro-Stanislas_Wawrinka,2,S-IO,2,1,1,0,0,1,1
20160906-M-US_Open-QF-Lucas_Pouille-Gael_Monfils,1,F-XC,43,12,2,3,7,19,24
20160906-M-US_Open-QF-Lucas_Pouille-Gael_Monfils,1,F-DTM,27,4,0,1,3,8,19
20160906-M-US_Open-QF-Lucas_Pouille-Gael_Monfils,1,F-DTL,8,1,0,1,0,4,4
20160906-M-US_Open-QF-Lucas_Pouille-Gael_Monfils,1,F-IO,32,7,0,1,6,15,17
20160906-M-US_Open-QF-Lucas_Pouille-Gael_Monfils,1,F-II,5,0,0,0,0,1,4
20160906-M-US_Open-QF-Lucas_Pouille-Gael_Monfils,1,B-XC,33,8,2,1,5,10,23
20160906-M-US_Open-QF-Lucas_Pouille-Gael_Monfils,1,B-DTM,26,4,0,0,4,14,12
20160906-M-US_Open-QF-Lucas_Pouille-Gael_Monfils,1,B-DTL,4,2,0,0,2,1,3
20160906-M-US_Open-QF-Lucas_Pouille-Gael_Monfils,1,B-IO,2,2,0,0,2,0,2
20160906-M-US_Open-QF-Lucas_Pouille-Gael_Monfils,1,S-XC,6,0,0,0,0,0,6
20160906-M-US_Open-QF-Lucas_Pouille-Gael_Monfils,1,S-DTM,3,0,0,0,0,2,1
20160906-M-US_Open-QF-Lucas_Pouille-Gael_Monfils,1,S-DTL,1,0,0,0,0,0,1
20160906-M-US_Open-QF-Lucas_Pouille-Gael_Monfils,1,S-IO,1,0,0,0,0,1,0
20160906-M-US_Open-QF-Lucas_Pouille-Gael_Monfils,2,F-XC,34,7,4,1,2,23,11
20160906-M-US_Open-QF-Lucas_Pouille-Gael_Monfils,2,F-DTM,37,2,0,1,1,19,18
20160906-M-US_Open-QF-Lucas_Pouille-Gael_Monfils,2,F-DTL,7,4,2,0,2,3,4
20160906-M-US_Open-QF-Lucas_Pouille-Gael_Monfils,2,F-IO,25,8,4,2,2,18,7
20160906-M-US_Open-QF-Lucas_Pouille-Gael_Monfils,2,F-II,1,0,0,0,0,1,0
20160906-M-US_Open-QF-Lucas_Pouille-Gael_Monfils,2,B-XC,28,2,1,0,1,17,11
20160906-M-US_Open-QF-Lucas_Pouille-Gael_Monfils,2,B-DTM,34,1,0,0,1,19,15
20160906-M-US_Open-QF-Lucas_Pouille-Gael_Monfils,2,B-DTL,8,5,2,1,2,4,4
20160906-M-US_Open-QF-Lucas_Pouille-Gael_Monfils,2,S-XC,9,1,0,1,0,4,5
20160906-M-US_Open-QF-Lucas_Pouille-Gael_Monfils,2,S-DTM,6,0,0,0,0,0,6
20111106-M-Basel-F-Kei_Nishikori-Roger_Federer,1,F-XC,23,4,1,2,1,13,10
20111106-M-Basel-F-Kei_Nishikori-Roger_Federer,1,F-DTM,9,0,0,0,0,4,5
20111106-M-Basel-F-Kei_Nishikori-Roger_Federer,1,F-DTL,10,1,0,0,1,4,6
20111106-M-Basel-F-Kei_Nishikori-Roger_Federer,1,F-IO,16,4,0,3,1,9,7
20111106-M-Basel-F-Kei_Nishikori-Roger_Federer,1,F-II,4,1,0,1,0,3,1
20111106-M-Basel-F-Kei_Nishikori-Roger_Federer,1,B-XC,36,3,1,0,2,11,25
20111106-M-Basel-F-Kei_Nishikori-Roger_Federer,1,B-DTM,6,0,0,0,0,0,6
20111106-M-Basel-F-Kei_Nishikori-Roger_Federer,1,B-DTL,7,3,1,0,2,5,2
20111106-M-Basel-F-Kei_Nishikori-Roger_Federer,1,S-XC,5,1,0,1,0,2,3
20111106-M-Basel-F-Kei_Nishikori-Roger_Federer,1,S-DTM,2,0,0,0,0,0,2
20111106-M-Basel-F-Kei_Nishikori-Roger_Federer,1,S-DTL,3,0,0,0,0,1,2
20111106-M-Basel-F-Kei_Nishikori-Roger_Federer,1,S-IO,2,0,0,0,0,0,2
20111106-M-Basel-F-Kei_Nishikori-Roger_Federer,2,F-XC,24,9,3,4,2,16,8
20111106-M-Basel-F-Kei_Nishikori-Roger_Federer,2,F-DTM,7,0,0,0,0,3,4
20111106-M-Basel-F-Kei_Nishikori-Roger_Federer,2,F-DTL,8,4,1,2,1,5,3
20111106-M-Basel-F-Kei_Nishikori-Roger_Federer,2,F-IO,15,6,2,3,1,13,2
20111106-M-Basel-F-Kei_Nishikori-Roger_Federer,2,F-II,5,2,0,2,0,4,1
20111106-M-Basel-F-Kei_Nishikori-Roger_Federer,2,B-XC,21,3,0,0,3,14,7
20111106-M-Basel-F-Kei_Nishikori-Roger_Federer,2,B-DTM,10,0,0,0,0,5,5
20111106-M-Basel-F-Kei_Nishikori-Roger_Federer,2,B-DTL,7,4,4,0,0,6,1
20111106-M-Basel-F-Kei_Nishikori-Roger_Federer,2,S-XC,13,0,0,0,0,6,7
20111106-M-Basel-F-Kei_Nishikori-Roger_Federer,2,S-DTM,5,0,0,0,0,1,4
20111106-M-Basel-F-Kei_Nishikori-Roger_Federer,2,S-DTL,3,1,0,0,1,1,2
20081026-M-Basel-F-Roger_Federer-David_Nalbandian,1,F-XC,24,10,2,3,5,14,10
20081026-M-Basel-F-Roger_Federer-David_Nalbandian,1,F-DTM,12,2,0,2,0,9,3
20081026-M-Basel-F-Roger_Federer-David_Nalbandian,1,F-DTL,5,2,2,0,0,5,0
20081026-M-Basel-F-Roger_Federer-David_Nalbandian,1,F-IO,7,2,1,0,1,5,2
20081026-M-Basel-F-Roger_Federer-David_Nalbandian,1,B-XC,16,5,1,2,2,12,4
20081026-M-Basel-F-Roger_Federer-David_Nalbandian,1,B-DTM,20,3,0,0,3,14,6
20081026-M-Basel-F-Roger_Federer-David_Nalbandian,1,B-DTL,5,3,1,2,0,4,1
20081026-M-Basel-F-Roger_Federer-David_Nalbandian,1,B-IO,1,1,1,0,0,1,0
20081026-M-Basel-F-Roger_Federer-David_Nalbandian,1,S-XC,8,0,0,0,0,7,1
20081026-M-Basel-F-Roger_Federer-David_Nalbandian,1,S-DTM,6,1,0,0,1,2,4
20081026-M-Basel-F-Roger_Federer-David_Nalbandian,2,F-XC,20,4,3,1,0,10,10
20081026-M-Basel-F-Roger_Federer-David_Nalbandian,2,F-DTM,19,3,1,0,2,8,11
20081026-M-Basel-F-Roger_Federer-David_Nalbandian,2,F-DTL,1,0,0,0,0,0,1
20081026-M-Basel-F-Roger_Federer-David_Nalbandian,2,F-IO,11,6,2,2,2,5,6
20081026-M-Basel-F-Roger_Federer-David_Nalbandian,2,B-XC,28,3,0,1,2,8,20
20081026-M-Basel-F-Roger_Federer-David_Nalbandian,2,B-DTM,17,2,0,0,2,5,12
20081026-M-Basel-F-Roger_Federer-David_Nalbandian,2,B-DTL,5,2,0,1,1,2,3
20081026-M-Basel-F-Roger_Federer-David_Nalbandian,2,B-IO,6,2,1,0,1,3,3
20081026-M-Basel-F-Roger_Federer-David_Nalbandian,2,S-XC,3,1,0,1,0,2,1
20081026-M-Basel-F-Roger_Federer-David_Nalbandian,2,S-DTM,5,0,0,0,0,1,4
20081026-M-Basel-F-Roger_Federer-David_Nalbandian,2,S-DTL,1,0,0,0,0,0,1
20050226-M-Acapulco-F-Rafael_Nadal-Albert_Montanes,1,F-XC,36,3,2,1,0,28,8
20050226-M-Acapulco-F-Rafael_Nadal-Albert_Montanes,1,F-DTM,4,1,0,0,1,3,1
20050226-M-Acapulco-F-Rafael_Nadal-Albert_Montanes,1,F-DTL,11,6,2,1,3,7,4
20050226-M-Acapulco-F-Rafael_Nadal-Albert_Montanes,1,F-IO,15,7,4,1,2,12,3
20050226-M-Acapulco-F-Rafael_Nadal-Albert_Montanes,1,F-II,9,2,1,0,1,7,2
20050226-M-Acapulco-F-Rafael_Nadal-Albert_Montanes,1,B-XC,27,2,2,0,0,19,8
20050226-M-Acapulco-F-Rafael_Nadal-Albert_Montanes,1,B-DTM,6,0,0,0,0,6,0
20050226-M-Acapulco-F-Rafael_Nadal-Albert_Montanes,1,B-DTL,13,2,0,2,0,10,3
20050226-M-Acapulco-F-Rafael_Nadal-Albert_Montanes,1,S-XC,1,0,0,0,0,0,1
20050226-M-Acapulco-F-Rafael_Nadal-Albert_Montanes,1,S-DTL,3,0,0,0,0,1,2
20050226-M-Acapulco-F-Rafael_Nadal-Albert_Montanes,2,F-XC,41,4,1,0,3,9,32
20050226-M-Acapulco-F-Rafael_Nadal-Albert_Montanes,2,F-DTM,5,0,0,0,0,0,5
20050226-M-Acapulco-F-Rafael_Nadal-Albert_Montanes,2,F-DTL,14,3,1,1,1,7,7
20050226-M-Acapulco-F-Rafael_Nadal-Albert_Montanes,2,F-IO,14,9,2,1,6,4,10
20050226-M-Acapulco-F-Rafael_Nadal-Albert_Montanes,2,F-II,8,0,0,0,0,2,6
20050226-M-Acapulco-F-Rafael_Nadal-Albert_Montanes,2,B-XC,23,4,3,0,1,8,15
20050226-M-Acapulco-F-Rafael_Nadal-Albert_Montanes,2,B-DTM,5,0,0,0,0,1,4
20050226-M-Acapulco-F-Rafael_Nadal-Albert_Montanes,2,B-DTL,6,1,0,0,1,2,4
20050226-M-Acapulco-F-Rafael_Nadal-Albert_Montanes,2,S-XC,4,0,0,0,0,0,4
20050226-M-Acapulco-F-Rafael_Nadal-Albert_Montanes,2,S-DTM,6,0,0,0,0,1,5
20050226-M-Acapulco-F-Rafael_Nadal-Albert_Montanes,2,S-DTL,7,0,0,0,0,2,5
20111113-M-Paris_Masters-F-Roger_Federer-Jo_Wilfried_Tsonga,1,F-XC,18,8,3,2,3,13,5
20111113-M-Paris_Masters-F-Roger_Federer-Jo_Wilfried_Tsonga,1,F-DTM,28,4,1,2,1,18,10
20111113-M-Paris_Masters-F-Roger_Federer-Jo_Wilfried_Tsonga,1,F-DTL,1,1,1,0,0,1,0
20111113-M-Paris_Masters-F-Roger_Federer-Jo_Wilfried_Tsonga,1,F-IO,17,8,4,3,1,14,3
20111113-M-Paris_Masters-F-Roger_Federer-Jo_Wilfried_Tsonga,1,F-II,1,0,0,0,0,1,0
20111113-M-Paris_Masters-F-Roger_Federer-Jo_Wilfried_Tsonga,1,B-XC,14,2,2,0,0,10,4
20111113-M-Paris_Masters-F-Roger_Federer-Jo_Wilfried_Tsonga,1,B-DTM,13,1,0,0,1,7,6
20111113-M-Paris_Masters-F-Roger_Federer-Jo_Wilfried_Tsonga,1,B-DTL,3,3,0,2,1,2,1
20111113-M-Paris_Masters-F-Roger_Federer-Jo_Wilfried_Tsonga,1,B-IO,2,1,0,1,0,2,0
20111113-M-Paris_Masters-F-Roger_Federer-Jo_Wilfried_Tsonga,1,S-XC,2,0,0,0,0,1,1
20111113-M-Paris_Masters-F-Roger_Federer-Jo_Wilfried_Tsonga,1,S-DTM,4,1,0,0,1,1,3
20111113-M-Paris_Masters-F-Roger_Federer-Jo_Wilfried_Tsonga,1,S-DTL,1,0,0,0,0,1,0
20111113-M-Paris_Masters-F-Roger_Federer-Jo_Wilfried_Tsonga,2,F-XC,14,5,1,3,1,8,6
20111113-M-Paris_Masters-F-Roger_Federer-Jo_Wilfried_Tsonga,2,F-DTM,21,3,0,0,3,4,17
20111113-M-Paris_Masters-F-Roger_Federer-Jo_Wilfried_Tsonga,2,F-DTL,2,2,1,0,1,1,1
20111113-M-Paris_Masters-F-Roger_Federer-Jo_Wilfried_Tsonga,2,F-IO,11,6,2,1,3,6,5
20111113-M-Paris_Masters-F-Roger_Federer-Jo_Wilfried_Tsonga,2,F-II,2,0,0,0,0,1,1
20111113-M-Paris_Masters-F-Roger_Federer-Jo_Wilfried_Tsonga,2,B-XC,17,7,1,0,6,6,11
20111113-M-Paris_Masters-F-Roger_Federer-Jo_Wilfried_Tsonga,2,B-DTM,18,1,0,0,1,5,13
20111113-M-Paris_Masters-F-Roger_Federer-Jo_Wilfried_Tsonga,2,B-DTL,3,2,0,0,2,0,3
20111113-M-Paris_Masters-F-Roger_Federer-Jo_Wilfried_Tsonga,2,B-IO,2,1,0,1,0,1,1
20111113-M-Paris_Masters-F-Roger_Federer-Jo_Wilfried_Tsonga,2,S-XC,4,0,0,0,0,1,3
20160911-M-US_Open-F-Novak_Djokovic-Stanislas_Wawrinka,1,F-XC,94,21,4,9,8,50,44
20160911-M-US_Open-F-Novak_Djokovic-Stanislas_Wawrinka,1,F-DTM,106,9,0,2,7,46,60
20160911-M-US_Open-F-Novak_Djokovic-Stanislas_Wawrinka,1,F-DTL,18,4,0,1,3,8,10
20160911-M-US_Open-F-Novak_Djokovic-Stanislas_Wawrinka,1,F-IO,48,16,3,6,7,26,22
20160911-M-US_Open-F-Novak_Djokovic-Stanislas_Wawrinka,1,F-II,4,1,1,0,0,4,0
20160911-M-US_Open-F-Novak_Djokovic-Stanislas_Wawrinka,1,B-XC,96,10,1,6,3,48,48
20160911-M-US_Open-F-Novak_Djokovic-Stanislas_Wawrinka,1,B-DTM,91,8,0,3,5,31,60
20160911-M-US_Open-F-Novak_Djokovic-Stanislas_Wawrinka,1,B-DTL,13,5,2,0,3,8,5
20160911-M-US_Open-F-Novak_Djokovic-Stanislas_Wawrinka,1,B-IO,8,5,0,1,4,2,6
20160911-M-US_Open-F-Novak_Djokovic-Stanislas_Wawrinka,1,S-XC,6,0,0,0,0,3,3
20160911-M-US_Open-F-Novak_Djokovic-Stanislas_Wawrinka,1,S-DTM,9,0,0,0,0,4,5
20160911-M-US_Open-F-Novak_Djokovic-Stanislas_Wawrinka,1,S-IO,3,1,0,1,0,2,1
20160911-M-US_Open-F-Novak_Djokovic-Stanislas_Wawrinka,2,F-XC,96,19,8,6,5,62,34
20160911-M-US_Open-F-Novak_Djokovic-Stanislas_Wawrinka,2,F-DTM,106,12,3,2,7,50,56
20160911-M-US_Open-F-Novak_Djokovic-Stanislas_Wawrinka,2,F-DTL,10,6,1,2,3,6,4
20160911-M-US_Open-F-Novak_Djokovic-Stanislas_Wawrinka,2,F-IO,40,13,4,3,6,25,15
20160911-M-US_Open-F-Novak_Djokovic-Stanislas_Wawrinka,2,F-II,3,2,1,0,1,1,2
20160911-M-US_Open-F-Novak_Djokovic-Stanislas_Wawrinka,2,B-XC,73,6,1,2,3,36,37
20160911-M-US_Open-F-Novak_Djokovic-Stanislas_Wawrinka,2,B-DTM,105,13,2,2,9,68,37
20160911-M-US_Open-F-Novak_Djokovic-Stanislas_Wawrinka,2,B-DTL,26,14,8,0,6,15,11
20160911-M-US_Open-F-Novak_Djokovic-Stanislas_Wawrinka,2,B-IO,12,4,1,0,3,7,5
20160911-M-US_Open-F-Novak_Djokovic-Stanislas_Wawrinka,2,S-XC,27,2,0,0,2,12,15
20160911-M-US_Open-F-Novak_Djokovic-Stanislas_Wawrinka,2,S-DTM,21,3,1,0,2,8,13
20160911-M-US_Open-F-Novak_Djokovic-Stanislas_Wawrinka,2,S-DTL,3,1,0,0,1,0,3
20010906-M-US_Open-QF-Pete_Sampras-Andre_Agassi,1,F-XC,35,12,4,4,4,16,19
20010906-M-US_Open-QF-Pete_Sampras-Andre_Agassi,1,F-DTM,6,1,0,0,1,3,3
20010906-M-US_Open-QF-Pete_Sampras-Andre_Agassi,1,F-DTL,10,5,4,0,1,6,4
20010906-M-US_Open-QF-Pete_Sampras-Andre_Agassi,1,F-IO,4,3,1,0,2,1,3
20010906-M-US_Open-QF-Pete_Sampras-Andre_Agassi,1,F-II,2,1,0,0,1,1,1
20010906-M-US_Open-QF-Pete_Sampras-Andre_Agassi,1,B-XC,41,5,0,0,5,15,26
20010906-M-US_Open-QF-Pete_Sampras-Andre_Agassi,1,B-DTM,16,3,0,0,3,5,11
20010906-M-US_Open-QF-Pete_Sampras-Andre_Agassi,1,B-DTL,21,13,5,3,5,11,10
20010906-M-US_Open-QF-Pete_Sampras-Andre_Agassi,1,S-XC,24,2,1,0,1,5,19
20010906-M-US_Open-QF-Pete_Sampras-Andre_Agassi,1,S-DTM,4,1,0,0,1,2,2
20010906-M-US_Open-QF-Pete_Sampras-Andre_Agassi,1,S-DTL,6,0,0,0,0,3,3
20010906-M-US_Open-QF-Pete_Sampras-Andre_Agassi,2,F-XC,52,16,4,9,3,32,20
20010906-M-US_Open-QF-Pete_Sampras-Andre_Agassi,2,F-DTM,9,1,0,1,0,6,3
20010906-M-US_Open-QF-Pete_Sampras-Andre_Agassi,2,F-DTL,19,6,3,1,2,12,7
20010906-M-US_Open-QF-Pete_Sampras-Andre_Agassi,2,F-IO,33,12,7,2,3,23,10
20010906-M-US_Open-QF-Pete_Sampras-Andre_Agassi,2,F-II,10,6,2,3,1,6,4
20010906-M-US_Open-QF-Pete_Sampras-Andre_Agassi,2,B-XC,86,12,4,5,3,58,28
20010906-M-US_Open-QF-Pete_Sampras-Andre_Agassi,2,B-DTM,9,1,0,0,1,4,5
20010906-M-US_Open-QF-Pete_Sampras-Andre_Agassi,2,B-DTL,14,6,3,1,2,8,6
20010906-M-US_Open-QF-Pete_Sampras-Andre_Agassi,2,B-IO,2,2,2,0,0,2,0
20010906-M-US_Open-QF-Pete_Sampras-Andre_Agassi,2,S-XC,2,0,0,0,0,0,2
20010906-M-US_Open-QF-Pete_Sampras-Andre_Agassi,2,S-DTM,1,0,0,0,0,1,0
20060509-M-Rome_Masters-R64-Carlos_Moya-Rafael_Nadal,1,F-XC,88,9,2,3,4,50,38
20060509-M-Rome_Masters-R64-Carlos_Moya-Rafael_Nadal,1,F-DTM,10,0,0,0,0,4,6
20060509-M-Rome_Masters-R64-Carlos_Moya-Rafael_Nadal,1,F-DTL,20,8,1,3,4,9,11
20060509-M-Rome_Masters-R64-Carlos_Moya-Rafael_Nadal,1,F-IO,45,17,10,3,4,27,18
20060509-M-Rome_Masters-R64-Carlos_Moya-Rafael_Nadal,1,F-II,22,5,2,1,2,12,10
20060509-M-Rome_Masters-R64-Carlos_Moya-Rafael_Nadal,1,B-XC,30,8,2,0,6,13,17
20060509-M-Rome_Masters-R64-Carlos_Moya-Rafael_Nadal,1,B-DTM,19,3,0,0,3,7,12
20060509-M-Rome_Masters-R64-Carlos_Moya-Rafael_Nadal,1,B-DTL,37,2,1,0,1,16,21
20060509-M-Rome_Masters-R64-Carlos_Moya-Rafael_Nadal,1,B-IO,1,0,0,0,0,0,1
20060509-M-Rome_Masters-R64-Carlos_Moya-Rafael_Nadal,1,S-XC,6,0,0,0,0,3,3
20060509-M-Rome_Masters-R64-Carlos_Moya-Rafael_Nadal,1,S-DTM,5,0,0,0,0,1,4
20060509-M-Rome_Masters-R64-Carlos_Moya-Rafael_Nadal,1,S-DTL,5,1,0,0,1,2,3
20060509-M-Rome_Masters-R64-Carlos_Moya-Rafael_Nadal,2,F-XC,71,3,1,1,1,40,31
20060509-M-Rome_Masters-R64-Carlos_Moya-Rafael_Nadal,2,F-DTM,7,0,0,0,0,3,4
20060509-M-Rome_Masters-R64-Carlos_Moya-Rafael_Nadal,2,F-DTL,20,11,6,2,3,14,6
20060509-M-Rome_Masters-R64-Carlos_Moya-Rafael_Nadal,2,F-IO,22,7,3,3,1,14,8
20060509-M-Rome_Masters-R64-Carlos_Moya-Rafael_Nadal,2,F-II,17,3,1,2,0,8,9
20060509-M-Rome_Masters-R64-Carlos_Moya-Rafael_Nadal,2,B-XC,68,15,4,4,7,32,36
20060509-M-Rome_Masters-R64-Carlos_Moya-Rafael_Nadal,2,B-DTM,17,0,0,0,0,10,7
20060509-M-Rome_Masters-R64-Carlos_Moya-Rafael_Nadal,2,B-DTL,52,5,1,0,4,25,27
20060509-M-Rome_Masters-R64-Carlos_Moya-Rafael_Nadal,2,B-IO,1,0,0,0,0,1,0
20060509-M-Rome_Masters-R64-Carlos_Moya-Rafael_Nadal,2,S-XC,1,0,0,0,0,0,1
20060509-M-Rome_Masters-R64-Carlos_Moya-Rafael_Nadal,2,S-DTM,3,0,0,0,0,1,2
20160123-M-Australian_Open-R32-Stanislas_Wawrinka-Lukas_Rosol,1,F-XC,17,5,3,2,0,14,3
20160123-M-Australian_Open-R32-Stanislas_Wawrinka-Lukas_Rosol,1,F-DTM,18,3,0,1,2,9,9
20160123-M-Australian_Open-R32-Stanislas_Wawrinka-Lukas_Rosol,1,F-DTL,8,5,2,1,1,4,4
20160123-M-Australian_Open-R32-Stanislas_Wawrinka-Lukas_Rosol,1,F-IO,9,3,2,0,1,3,6
20160123-M-Australian_Open-R32-Stanislas_Wawrinka-Lukas_Rosol,1,B-XC,16,5,4,1,0,12,4
20160123-M-Australian_Open-R32-Stanislas_Wawrinka-Lukas_Rosol,1,B-DTM,18,4,0,3,1,10,8
20160123-M-Australian_Open-R32-Stanislas_Wawrinka-Lukas_Rosol,1,B-DTL,9,4,3,0,1,7,2
20160123-M-Australian_Open-R32-Stanislas_Wawrinka-Lukas_Rosol,1,B-IO,9,9,5,1,3,6,3
20160123-M-Australian_Open-R32-Stanislas_Wawrinka-Lukas_Rosol,1,S-XC,16,1,0,0,1,7,9
20160123-M-Australian_Open-R32-Stanislas_Wawrinka-Lukas_Rosol,1,S-DTM,12,0,0,0,0,5,7
20160123-M-Australian_Open-R32-Stanislas_Wawrinka-Lukas_Rosol,1,S-DTL,1,0,0,0,0,0,1
20160123-M-Australian_Open-R32-Stanislas_Wawrinka-Lukas_Rosol,1,S-IO,2,0,0,0,0,0,2
20160123-M-Australian_Open-R32-Stanislas_Wawrinka-Lukas_Rosol,2,F-XC,26,12,5,1,6,11,15
20160123-M-Australian_Open-R32-Stanislas_Wawrinka-Lukas_Rosol,2,F-DTM,21,2,0,1,1,7,14
20160123-M-Australian_Open-R32-Stanislas_Wawrinka-Lukas_Rosol,2,F-DTL,6,0,0,0,0,4,2
20160123-M-Australian_Open-R32-Stanislas_Wawrinka-Lukas_Rosol,2,F-IO,23,8,3,3,2,13,10
20160123-M-Australian_Open-R32-Stanislas_Wawrinka-Lukas_Rosol,2,F-II,1,1,1,0,0,1,0
20160123-M-Australian_Open-R32-Stanislas_Wawrinka-Lukas_Rosol,2,B-XC,20,3,1,1,1,11,9
20160123-M-Australian_Open-R32-Stanislas_Wawrinka-Lukas_Rosol,2,B-DTM,14,4,0,0,4,6,8
20160123-M-Australian_Open-R32-Stanislas_Wawrinka-Lukas_Rosol,2,B-DTL,9,5,1,0,4,3,6
20160123-M-Australian_Open-R32-Stanislas_Wawrinka-Lukas_Rosol,2,S-XC,8,2,0,1,1,4,4
20160123-M-Australian_Open-R32-Stanislas_Wawrinka-Lukas_Rosol,2,S-DTM,4,1,0,0,1,0,4
20160123-M-Australian_Open-R32-Stanislas_Wawrinka-Lukas_Rosol,2,S-DTL,3,0,0,0,0,1,2
19890611-M-Roland_Garros-F-Michael_Chang-Stefan_Edberg,1,F-XC,96,15,3,6,6,56,40
19890611-M-Roland_Garros-F-Michael_Chang-Stefan_Edberg,1,F-DTM,67,0,0,0,0,29,38
19890611-M-Roland_Garros-F-Michael_Chang-Stefan_Edberg,1,F-DTL,17,7,6,1,0,14,3
19890611-M-Roland_Garros-F-Michael_Chang-Stefan_Edberg,1,F-IO,20,7,3,1,3,14,6
19890611-M-Roland_Garros-F-Michael_Chang-Stefan_Edberg,1,B-XC,145,13,5,3,5,84,61
19890611-M-Roland_Garros-F-Michael_Chang-Stefan_Edberg,1,B-DTM,181,7,1,3,3,106,75
19890611-M-Roland_Garros-F-Michael_Chang-Stefan_Edberg,1,B-DTL,29,9,3,4,2,19,10
19890611-M-Roland_Garros-F-Michael_Chang-Stefan_Edberg,1,B-IO,35,9,3,4,2,21,14
19890611-M-Roland_Garros-F-Michael_Chang-Stefan_Edberg,1,S-XC,3,0,0,0,0,2,1
19890611-M-Roland_Garros-F-Michael_Chang-Stefan_Edberg,1,S-DTM,8,0,0,0,0,3,5
19890611-M-Roland_Garros-F-Michael_Chang-Stefan_Edberg,1,S-DTL,1,0,0,0,0,1,0
19890611-M-Roland_Garros-F-Michael_Chang-Stefan_Edberg,2,F-XC,96,18,3,5,10,41,55
19890611-M-Roland_Garros-F-Michael_Chang-Stefan_Edberg,2,F-DTM,103,12,1,2,9,42,61
19890611-M-Roland_Garros-F-Michael_Chang-Stefan_Edberg,2,F-DTL,20,7,3,1,3,10,10
19890611-M-Roland_Garros-F-Michael_Chang-Stefan_Edberg,2,F-IO,29,6,1,4,1,15,14
19890611-M-Roland_Garros-F-Michael_Chang-Stefan_Edberg,2,B-XC,54,13,2,4,7,22,32
19890611-M-Roland_Garros-F-Michael_Chang-Stefan_Edberg,2,B-DTM,56,4,0,1,3,20,36
19890611-M-Roland_Garros-F-Michael_Chang-Stefan_Edberg,2,B-DTL,10,2,1,0,1,4,6
19890611-M-Roland_Garros-F-Michael_Chang-Stefan_Edberg,2,B-IO,10,5,4,0,1,4,6
19890611-M-Roland_Garros-F-Michael_Chang-Stefan_Edberg,2,S-XC,65,3,1,0,2,28,37
19890611-M-Roland_Garros-F-Michael_Chang-Stefan_Edberg,2,S-DTM,68,7,0,1,6,24,44
19890611-M-Roland_Garros-F-Michael_Chang-Stefan_Edberg,2,S-DTL,10,3,2,0,1,6,4
19890611-M-Roland_Garros-F-Michael_Chang-Stefan_Edberg,2,S-IO,2,0,0,0,0,2,0
20120121-M-Australian_Open-R32-Michael_Llodra-Andy_Murray,1,F-XC,24,2,0,1,1,6,18
20120121-M-Australian_Open-R32-Michael_Llodra-Andy_Murray,1,F-DTM,7,0,0,0,0,2,5
20120121-M-Australian_Open-R32-Michael_Llodra-Andy_Murray,1,F-DTL,9,4,1,2,1,5,4
20120121-M-Australian_Open-R32-Michael_Llodra-Andy_Murray,1,F-IO,5,3,0,2,1,3,2
20120121-M-Australian_Open-R32-Michael_Llodra-Andy_Murray,1,B-XC,9,2,0,0,2,1,8
20120121-M-Australian_Open-R32-Michael_Llodra-Andy_Murray,1,B-DTM,4,0,0,0,0,0,4
20120121-M-Australian_Open-R32-Michael_Llodra-Andy_Murray,1,B-DTL,4,1,0,1,0,3,1
20120121-M-Australian_Open-R32-Michael_Llodra-Andy_Murray,1,B-IO,1,0,0,0,0,0,1
20120121-M-Australian_Open-R32-Michael_Llodra-Andy_Murray,1,S-XC,18,3,0,2,1,10,8
20120121-M-Australian_Open-R32-Michael_Llodra-Andy_Murray,1,S-DTM,7,0,0,0,0,3,4
20120121-M-Australian_Open-R32-Michael_Llodra-Andy_Murray,1,S-DTL,15,2,0,1,1,6,9
20120121-M-Australian_Open-R32-Michael_Llodra-Andy_Murray,1,S-IO,3,0,0,0,0,1,2
20120121-M-Australian_Open-R32-Michael_Llodra-Andy_Murray,2,F-XC,49,13,7,4,2,33,16
20120121-M-Australian_Open-R32-Michael_Llodra-Andy_Murray,2,F-DTM,5,0,0,0,0,2,3
20120121-M-Australian_Open-R32-Michael_Llodra-Andy_Murray,2,F-DTL,18,4,2,1,1,11,7
20120121-M-Australian_Open-R32-Michael_Llodra-Andy_Murray,2,F-IO,15,2,0,2,0,13,2
20120121-M-Australian_Open-R32-Michael_Llodra-Andy_Murray,2,F-II,7,3,3,0,0,5,2
20120121-M-Australian_Open-R32-Michael_Llodra-Andy_Murray,2,B-XC,30,13,8,3,2,22,8
20120121-M-Australian_Open-R32-Michael_Llodra-Andy_Murray,2,B-DTM,11,2,0,1,1,6,5
20120121-M-Australian_Open-R32-Michael_Llodra-Andy_Murray,2,B-DTL,8,2,1,1,0,6,2
20120121-M-Australian_Open-R32-Michael_Llodra-Andy_Murray,2,B-IO,6,0,0,0,0,1,5
20120121-M-Australian_Open-R32-Michael_Llodra-Andy_Murray,2,B-II,1,0,0,0,0,1,0
20120121-M-Australian_Open-R32-Michael_Llodra-Andy_Murray,2,S-XC,1,0,0,0,0,1,0
20120121-M-Australian_Open-R32-Michael_Llodra-Andy_Murray,2,S-DTM,1,0,0,0,0,0,1
20120121-M-Australian_Open-R32-Michael_Llodra-Andy_Murray,2,S-DTL,5,1,0,0,1,2,3
20040801-M-Canada_Masters-F-Roger_Federer-Andy_Roddick,1,F-XC,30,8,2,4,2,17,13
20040801-M-Canada_Masters-F-Roger_Federer-Andy_Roddick,1,F-DTM,28,3,0,0,3,20,8
20040801-M-Canada_Masters-F-Roger_Federer-Andy_Roddick,1,F-DTL,2,1,1,0,0,2,0
20040801-M-Canada_Masters-F-Roger_Federer-Andy_Roddick,1,F-IO,18,4,3,0,1,11,7
20040801-M-Canada_Masters-F-Roger_Federer-Andy_Roddick,1,F-II,2,0,0,0,0,2,0
20040801-M-Canada_Masters-F-Roger_Federer-Andy_Roddick,1,B-XC,35,5,2,1,2,21,14
20040801-M-Canada_Masters-F-Roger_Federer-Andy_Roddick,1,B-DTM,47,6,3,0,3,22,25
20040801-M-Canada_Masters-F-Roger_Federer-Andy_Roddick,1,B-DTL,3,2,0,1,1,1,2
20040801-M-Canada_Masters-F-Roger_Federer-Andy_Roddick,1,B-IO,4,1,1,0,0,3,1
20040801-M-Canada_Masters-F-Roger_Federer-Andy_Roddick,1,S-XC,7,2,0,1,1,3,4
20040801-M-Canada_Masters-F-Roger_Federer-Andy_Roddick,1,S-DTM,6,0,0,0,0,1,5
20040801-M-Canada_Masters-F-Roger_Federer-Andy_Roddick,1,S-DTL,2,0,0,0,0,0,2
20040801-M-Canada_Masters-F-Roger_Federer-Andy_Roddick,2,F-XC,41,15,1,6,8,19,22
20040801-M-Canada_Masters-F-Roger_Federer-Andy_Roddick,2,F-DTM,32,3,1,0,2,16,16
20040801-M-Canada_Masters-F-Roger_Federer-Andy_Roddick,2,F-DTL,6,1,0,0,1,5,1
20040801-M-Canada_Masters-F-Roger_Federer-Andy_Roddick,2,F-IO,33,4,0,1,3,17,16
20040801-M-Canada_Masters-F-Roger_Federer-Andy_Roddick,2,F-II,4,2,1,1,0,2,2
20040801-M-Canada_Masters-F-Roger_Federer-Andy_Roddick,2,B-XC,26,1,1,0,0,14,12
20040801-M-Canada_Masters-F-Roger_Federer-Andy_Roddick,2,B-DTM,37,2,0,1,1,13,24
20040801-M-Canada_Masters-F-Roger_Federer-Andy_Roddick,2,B-DTL,1,1,0,0,1,0,1
20040801-M-Canada_Masters-F-Roger_Federer-Andy_Roddick,2,B-IO,2,1,1,0,0,1,1
20040801-M-Canada_Masters-F-Roger_Federer-Andy_Roddick,2,S-XC,6,2,0,1,1,2,4
20040801-M-Canada_Masters-F-Roger_Federer-Andy_Roddick,2,S-DTM,3,1,0,0,1,0,3
20040801-M-Canada_Masters-F-Roger_Federer-Andy_Roddick,2,S-DTL,3,1,0,1,0,1,2
19850825-M-Cincinnati-F-Mats_Wilander-Boris_Becker,1,F-XC,9,3,1,2,0,4,5
19850825-M-Cincinnati-F-Mats_Wilander-Boris_Becker,1,F-DTM,5,0,0,0,0,2,3
19850825-M-Cincinnati-F-Mats_Wilander-Boris_Becker,1,F-DTL,23,7,1,1,5,6,17
19850825-M-Cincinnati-F-Mats_Wilander-Boris_Becker,1,F-IO,2,0,0,0,0,1,1
19850825-M-Cincinnati-F-Mats_Wilander-Boris_Becker,1,B-XC,28,9,2,2,5,12,16
19850825-M-Cincinnati-F-Mats_Wilander-Boris_Becker,1,B-DTM,4,1,0,0,1,0,4
19850825-M-Cincinnati-F-Mats_Wilander-Boris_Becker,1,B-DTL,10,4,1,2,1,4,6
19850825-M-Cincinnati-F-Mats_Wilander-Boris_Becker,1,B-IO,4,2,0,1,1,1,3
19850825-M-Cincinnati-F-Mats_Wilander-Boris_Becker,1,S-XC,11,0,0,0,0,3,8
19850825-M-Cincinnati-F-Mats_Wilander-Boris_Becker,1,S-DTM,1,0,0,0,0,0,1
19850825-M-Cincinnati-F-Mats_Wilander-Boris_Becker,1,S-DTL,1,0,0,0,0,0,1
19850825-M-Cincinnati-F-Mats_Wilander-Boris_Becker,2,F-XC,15,1,1,0,0,12,3
19850825-M-Cincinnati-F-Mats_Wilander-Boris_Becker,2,F-DTL,2,1,0,1,0,2,0
19850825-M-Cincinnati-F-Mats_Wilander-Boris_Becker,2,F-IO,8,4,1,2,1,6,2
19850825-M-Cincinnati-F-Mats_Wilander-Boris_Becker,2,F-II,5,1,0,0,1,4,1
19850825-M-Cincinnati-F-Mats_Wilander-Boris_Becker,2,B-XC,14,3,0,2,1,10,4
19850825-M-Cincinnati-F-Mats_Wilander-Boris_Becker,2,B-DTM,6,2,0,0,2,4,2
19850825-M-Cincinnati-F-Mats_Wilander-Boris_Becker,2,B-DTL,9,1,1,0,0,6,3
19850825-M-Cincinnati-F-Mats_Wilander-Boris_Becker,2,S-XC,20,2,0,1,1,13,7
19850825-M-Cincinnati-F-Mats_Wilander-Boris_Becker,2,S-DTL,1,1,0,1,0,1,0
20050815-M-Canada_Masters-F-Rafael_Nadal-Andre_Agassi,1,F-XC,73,7,1,5,1,43,30
20050815-M-Canada_Masters-F-Rafael_Nadal-Andre_Agassi,1,F-DTM,16,0,0,0,0,9,7
20050815-M-Canada_Masters-F-Rafael_Nadal-Andre_Agassi,1,F-DTL,19,8,3,2,3,7,12
20050815-M-Canada_Masters-F-Rafael_Nadal-Andre_Agassi,1,F-IO,13,6,2,2,2,10,3
20050815-M-Canada_Masters-F-Rafael_Nadal-Andre_Agassi,1,F-II,10,3,1,0,2,6,4
20050815-M-Canada_Masters-F-Rafael_Nadal-Andre_Agassi,1,B-XC,57,10,1,7,2,34,23
20050815-M-Canada_Masters-F-Rafael_Nadal-Andre_Agassi,1,B-DTM,32,0,0,0,0,16,16
20050815-M-Canada_Masters-F-Rafael_Nadal-Andre_Agassi,1,B-DTL,25,6,3,2,1,16,9
20050815-M-Canada_Masters-F-Rafael_Nadal-Andre_Agassi,1,B-IO,1,0,0,0,0,1,0
20050815-M-Canada_Masters-F-Rafael_Nadal-Andre_Agassi,1,S-XC,4,0,0,0,0,2,2
20050815-M-Canada_Masters-F-Rafael_Nadal-Andre_Agassi,1,S-DTM,17,0,0,0,0,11,6
20050815-M-Canada_Masters-F-Rafael_Nadal-Andre_Agassi,1,S-DTL,6,0,0,0,0,2,4
20050815-M-Canada_Masters-F-Rafael_Nadal-Andre_Agassi,1,S-IO,1,0,0,0,0,1,0
20050815-M-Canada_Masters-F-Rafael_Nadal-Andre_Agassi,2,F-XC,119,19,3,9,7,56,63
20050815-M-Canada_Masters-F-Rafael_Nadal-Andre_Agassi,2,F-DTM,12,1,0,0,1,6,6
20050815-M-Canada_Masters-F-Rafael_Nadal-Andre_Agassi,2,F-DTL,10,5,3,1,1,7,3
20050815-M-Canada_Masters-F-Rafael_Nadal-Andre_Agassi,2,F-IO,9,2,0,1,1,5,4
20050815-M-Canada_Masters-F-Rafael_Nadal-Andre_Agassi,2,F-II,7,1,0,0,1,1,6
20050815-M-Canada_Masters-F-Rafael_Nadal-Andre_Agassi,2,B-XC,71,15,2,2,11,32,39
20050815-M-Canada_Masters-F-Rafael_Nadal-Andre_Agassi,2,B-DTM,13,3,0,0,3,2,11
20050815-M-Canada_Masters-F-Rafael_Nadal-Andre_Agassi,2,B-DTL,30,4,1,2,1,16,14
20050815-M-Canada_Masters-F-Rafael_Nadal-Andre_Agassi,2,B-IO,10,1,0,0,1,7,3
20050815-M-Canada_Masters-F-Rafael_Nadal-Andre_Agassi,2,S-XC,1,0,0,0,0,1,0
20050815-M-Canada_Masters-F-Rafael_Nadal-Andre_Agassi,2,S-DTM,1,0,0,0,0,0,1
20050815-M-Canada_Masters-F-Rafael_Nadal-Andre_Agassi,2,S-DTL,2,2,0,2,0,2,0
20101017-M-Shanghai_Masters-F-Roger_Federer-Andy_Murray,1,F-XC,38,13,1,4,8,13,25
20101017-M-Shanghai_Masters-F-Roger_Federer-Andy_Murray,1,F-DTM,38,6,0,1,5,16,22
20101017-M-Shanghai_Masters-F-Roger_Federer-Andy_Murray,1,F-DTL,6,3,1,1,1,4,2
20101017-M-Shanghai_Masters-F-Roger_Federer-Andy_Murray,1,F-IO,31,9,4,1,4,12,19
20101017-M-Shanghai_Masters-F-Roger_Federer-Andy_Murray,1,F-II,3,2,1,1,0,2,1
20101017-M-Shanghai_Masters-F-Roger_Federer-Andy_Murray,1,B-XC,27,2,0,0,2,12,15
20101017-M-Shanghai_Masters-F-Roger_Federer-Andy_Murray,1,B-DTM,34,3,0,0,3,14,20
20101017-M-Shanghai_Masters-F-Roger_Federer-Andy_Murray,1,B-DTL,6,4,0,0,4,2,4
20101017-M-Shanghai_Masters-F-Roger_Federer-Andy_Murray,1,B-IO,5,2,0,1,1,2,3
20101017-M-Shanghai_Masters-F-Roger_Federer-Andy_Murray,1,S-XC,12,0,0,0,0,3,9
20101017-M-Shanghai_Masters-F-Roger_Federer-Andy_Murray,1,S-DTM,12,0,0,0,0,4,8
20101017-M-Shanghai_Masters-F-Roger_Federer-Andy_Murray,2,F-XC,27,8,3,3,2,19,8
20101017-M-Shanghai_Masters-F-Roger_Federer-Andy_Murray,2,F-DTM,37,3,0,0,3,21,16
20101017-M-Shanghai_Masters-F-Roger_Federer-Andy_Murray,2,F-DTL,6,2,1,1,0,5,1
20101017-M-Shanghai_Masters-F-Roger_Federer-Andy_Murray,2,F-IO,23,6,1,2,3,12,11
20101017-M-Shanghai_Masters-F-Roger_Federer-Andy_Murray,2,B-XC,40,5,2,1,2,20,20
20101017-M-Shanghai_Masters-F-Roger_Federer-Andy_Murray,2,B-DTM,49,4,0,1,3,32,17
20101017-M-Shanghai_Masters-F-Roger_Federer-Andy_Murray,2,B-DTL,5,3,2,0,1,3,2
20101017-M-Shanghai_Masters-F-Roger_Federer-Andy_Murray,2,B-IO,4,1,1,0,0,3,1
20101017-M-Shanghai_Masters-F-Roger_Federer-Andy_Murray,2,S-XC,4,0,0,0,0,3,1
20101017-M-Shanghai_Masters-F-Roger_Federer-Andy_Murray,2,S-DTM,4,0,0,0,0,3,1
20101017-M-Shanghai_Masters-F-Roger_Federer-Andy_Murray,2,S-DTL,1,0,0,0,0,1,0
20161016-M-Shanghai_Masters-F-Roberto_Bautista_Agut-Andy_Murray,1,F-XC,35,8,4,0,4,14,21
20161016-M-Shanghai_Masters-F-Roberto_Bautista_Agut-Andy_Murray,1,F-DTM,34,2,1,0,1,11,23
20161016-M-Shanghai_Masters-F-Roberto_Bautista_Agut-Andy_Murray,1,F-DTL,7,2,0,0,2,3,4
20161016-M-Shanghai_Masters-F-Roberto_Bautista_Agut-Andy_Murray,1,F-IO,27,6,3,1,2,13,14
20161016-M-Shanghai_Masters-F-Roberto_Bautista_Agut-Andy_Murray,1,F-II,5,2,0,2,0,4,1
20161016-M-Shanghai_Masters-F-Roberto_Bautista_Agut-Andy_Murray,1,B-XC,20,2,0,0,2,7,13
20161016-M-Shanghai_Masters-F-Roberto_Bautista_Agut-Andy_Murray,1,B-DTM,68,8,1,1,6,31,37
20161016-M-Shanghai_Masters-F-Roberto_Bautista_Agut-Andy_Murray,1,B-DTL,2,1,0,0,1,1,1
20161016-M-Shanghai_Masters-F-Roberto_Bautista_Agut-Andy_Murray,1,B-IO,4,1,0,0,1,1,3
20161016-M-Shanghai_Masters-F-Roberto_Bautista_Agut-Andy_Murray,1,S-XC,12,2,0,1,1,4,8
20161016-M-Shanghai_Masters-F-Roberto_Bautista_Agut-Andy_Murray,1,S-DTM,5,0,0,0,0,1,4
20161016-M-Shanghai_Masters-F-Roberto_Bautista_Agut-Andy_Murray,1,S-DTL,2,0,0,0,0,0,2
20161016-M-Shanghai_Masters-F-Roberto_Bautista_Agut-Andy_Murray,2,F-XC,37,11,3,2,6,24,13
20161016-M-Shanghai_Masters-F-Roberto_Bautista_Agut-Andy_Murray,2,F-DTM,30,2,1,1,0,16,14
20161016-M-Shanghai_Masters-F-Roberto_Bautista_Agut-Andy_Murray,2,F-DTL,8,0,0,0,0,5,3
20161016-M-Shanghai_Masters-F-Roberto_Bautista_Agut-Andy_Murray,2,F-IO,26,9,1,6,2,18,8
20161016-M-Shanghai_Masters-F-Roberto_Bautista_Agut-Andy_Murray,2,B-XC,43,1,0,0,1,22,21
20161016-M-Shanghai_Masters-F-Roberto_Bautista_Agut-Andy_Murray,2,B-DTM,41,6,0,1,5,23,18
20161016-M-Shanghai_Masters-F-Roberto_Bautista_Agut-Andy_Murray,2,B-DTL,2,0,0,0,0,2,0
20161016-M-Shanghai_Masters-F-Roberto_Bautista_Agut-Andy_Murray,2,B-IO,5,0,0,0,0,3,2
20161016-M-Shanghai_Masters-F-Roberto_Bautista_Agut-Andy_Murray,2,S-XC,10,1,0,1,0,5,5
20161016-M-Shanghai_Masters-F-Roberto_Bautista_Agut-Andy_Murray,2,S-DTM,15,1,0,0,1,9,6
20161016-M-Shanghai_Masters-F-Roberto_Bautista_Agut-Andy_Murray,2,S-DTL,3,1,0,0,1,1,2
20161016-M-Shanghai_Masters-F-Roberto_Bautista_Agut-Andy_Murray,2,S-IO,3,1,0,1,0,2,1
20030330-M-Miami_Masters-F-Andre_Agassi-Carlos_Moya,1,F-XC,31,3,1,0,2,21,10
20030330-M-Miami_Masters-F-Andre_Agassi-Carlos_Moya,1,F-DTM,10,0,0,0,0,4,6
20030330-M-Miami_Masters-F-Andre_Agassi-Carlos_Moya,1,F-DTL,22,6,1,3,2,15,7
20030330-M-Miami_Masters-F-Andre_Agassi-Carlos_Moya,1,F-IO,14,7,6,1,0,13,1
20030330-M-Miami_Masters-F-Andre_Agassi-Carlos_Moya,1,F-II,1,0,0,0,0,0,1
20030330-M-Miami_Masters-F-Andre_Agassi-Carlos_Moya,1,B-XC,37,6,1,0,5,15,22
20030330-M-Miami_Masters-F-Andre_Agassi-Carlos_Moya,1,B-DTM,6,0,0,0,0,4,2
20030330-M-Miami_Masters-F-Andre_Agassi-Carlos_Moya,1,B-DTL,9,2,1,0,1,4,5
20030330-M-Miami_Masters-F-Andre_Agassi-Carlos_Moya,1,S-XC,5,1,0,0,1,2,3
20030330-M-Miami_Masters-F-Andre_Agassi-Carlos_Moya,1,S-DTL,1,0,0,0,0,0,1
20030330-M-Miami_Masters-F-Andre_Agassi-Carlos_Moya,2,F-XC,37,7,1,0,6,12,25
20030330-M-Miami_Masters-F-Andre_Agassi-Carlos_Moya,2,F-DTM,9,1,1,0,0,4,5
20030330-M-Miami_Masters-F-Andre_Agassi-Carlos_Moya,2,F-DTL,10,2,1,1,0,8,2
20030330-M-Miami_Masters-F-Andre_Agassi-Carlos_Moya,2,F-IO,20,5,1,1,3,11,9
20030330-M-Miami_Masters-F-Andre_Agassi-Carlos_Moya,2,F-II,2,1,1,0,0,2,0
20030330-M-Miami_Masters-F-Andre_Agassi-Carlos_Moya,2,B-XC,23,4,1,2,1,13,10
20030330-M-Miami_Masters-F-Andre_Agassi-Carlos_Moya,2,B-DTM,5,2,0,0,2,0,5
20030330-M-Miami_Masters-F-Andre_Agassi-Carlos_Moya,2,B-DTL,21,10,3,3,4,10,11
20030330-M-Miami_Masters-F-Andre_Agassi-Carlos_Moya,2,B-IO,2,0,0,0,0,1,1
20030330-M-Miami_Masters-F-Andre_Agassi-Carlos_Moya,2,S-XC,10,0,0,0,0,4,6
20030330-M-Miami_Masters-F-Andre_Agassi-Carlos_Moya,2,S-DTM,3,0,0,0,0,0,3
20030330-M-Miami_Masters-F-Andre_Agassi-Carlos_Moya,2,S-DTL,3,0,0,0,0,1,2
20110821-M-Cincinnati_Masters-F-Novak_Djokovic-Andy_Murray,1,F-XC,38,10,1,2,7,14,24
20110821-M-Cincinnati_Masters-F-Novak_Djokovic-Andy_Murray,1,F-DTM,13,1,0,0,1,4,9
20110821-M-Cincinnati_Masters-F-Novak_Djokovic-Andy_Murray,1,F-DTL,16,6,1,2,3,8,8
20110821-M-Cincinnati_Masters-F-Novak_Djokovic-Andy_Murray,1,F-IO,36,11,4,4,3,21,15
20110821-M-Cincinnati_Masters-F-Novak_Djokovic-Andy_Murray,1,F-II,8,3,0,2,1,3,5
20110821-M-Cincinnati_Masters-F-Novak_Djokovic-Andy_Murray,1,B-XC,41,3,0,0,3,14,27
20110821-M-Cincinnati_Masters-F-Novak_Djokovic-Andy_Murray,1,B-DTM,10,0,0,0,0,6,4
20110821-M-Cincinnati_Masters-F-Novak_Djokovic-Andy_Murray,1,B-DTL,12,7,0,0,7,3,9
20110821-M-Cincinnati_Masters-F-Novak_Djokovic-Andy_Murray,1,B-IO,4,0,0,0,0,0,4
20110821-M-Cincinnati_Masters-F-Novak_Djokovic-Andy_Murray,1,S-XC,8,1,0,0,1,1,7
20110821-M-Cincinnati_Masters-F-Novak_Djokovic-Andy_Murray,1,S-DTM,1,0,0,0,0,0,1
20110821-M-Cincinnati_Masters-F-Novak_Djokovic-Andy_Murray,1,S-DTL,2,0,0,0,0,0,2
20110821-M-Cincinnati_Masters-F-Novak_Djokovic-Andy_Murray,2,F-XC,39,5,1,1,3,23,16
20110821-M-Cincinnati_Masters-F-Novak_Djokovic-Andy_Murray,2,F-DTM,9,0,0,0,0,6,3
20110821-M-Cincinnati_Masters-F-Novak_Djokovic-Andy_Murray,2,F-DTL,14,4,1,1,2,10,4
20110821-M-Cincinnati_Masters-F-Novak_Djokovic-Andy_Murray,2,F-IO,10,0,0,0,0,5,5
20110821-M-Cincinnati_Masters-F-Novak_Djokovic-Andy_Murray,2,B-XC,36,2,0,1,1,25,11
20110821-M-Cincinnati_Masters-F-Novak_Djokovic-Andy_Murray,2,B-DTM,18,1,0,0,1,8,10
20110821-M-Cincinnati_Masters-F-Novak_Djokovic-Andy_Murray,2,B-DTL,11,2,1,1,0,8,3
20110821-M-Cincinnati_Masters-F-Novak_Djokovic-Andy_Murray,2,B-IO,3,0,0,0,0,2,1
20110821-M-Cincinnati_Masters-F-Novak_Djokovic-Andy_Murray,2,S-XC,18,1,0,1,0,12,6
20110821-M-Cincinnati_Masters-F-Novak_Djokovic-Andy_Murray,2,S-DTM,6,1,0,0,1,1,5
20110821-M-Cincinnati_Masters-F-Novak_Djokovic-Andy_Murray,2,S-DTL,2,0,0,0,0,0,2
20161101-M-Charlottesville_CH-R32-Denis_Kudla-Tommy_Paul,1,F-XC,12,3,0,1,2,6,6
20161101-M-Charlottesville_CH-R32-Denis_Kudla-Tommy_Paul,1,F-DTM,21,3,0,1,2,8,13
20161101-M-Charlottesville_CH-R32-Denis_Kudla-Tommy_Paul,1,F-DTL,5,2,1,1,0,3,2
20161101-M-Charlottesville_CH-R32-Denis_Kudla-Tommy_Paul,1,F-IO,14,3,0,2,1,10,4
20161101-M-Charlottesville_CH-R32-Denis_Kudla-Tommy_Paul,1,F-II,1,1,1,0,0,1,0
20161101-M-Charlottesville_CH-R32-Denis_Kudla-Tommy_Paul,1,B-XC,17,3,2,0,1,12,5
20161101-M-Charlottesville_CH-R32-Denis_Kudla-Tommy_Paul,1,B-DTM,8,2,0,1,1,5,3
20161101-M-Charlottesville_CH-R32-Denis_Kudla-Tommy_Paul,1,B-DTL,7,5,1,2,2,3,4
20161101-M-Charlottesville_CH-R32-Denis_Kudla-Tommy_Paul,1,B-IO,3,1,1,0,0,3,0
20161101-M-Charlottesville_CH-R32-Denis_Kudla-Tommy_Paul,1,S-XC,5,0,0,0,0,4,1
20161101-M-Charlottesville_CH-R32-Denis_Kudla-Tommy_Paul,1,S-DTM,2,0,0,0,0,2,0
20161101-M-Charlottesville_CH-R32-Denis_Kudla-Tommy_Paul,2,F-XC,20,8,2,1,5,9,11
20161101-M-Charlottesville_CH-R32-Denis_Kudla-Tommy_Paul,2,F-DTM,11,1,0,0,1,5,6
20161101-M-Charlottesville_CH-R32-Denis_Kudla-Tommy_Paul,2,F-DTL,4,1,1,0,0,2,2
20161101-M-Charlottesville_CH-R32-Denis_Kudla-Tommy_Paul,2,F-IO,6,3,0,1,2,2,4
20161101-M-Charlottesville_CH-R32-Denis_Kudla-Tommy_Paul,2,F-II,2,2,1,0,1,1,1
20161101-M-Charlottesville_CH-R32-Denis_Kudla-Tommy_Paul,2,B-XC,32,9,0,3,6,13,19
20161101-M-Charlottesville_CH-R32-Denis_Kudla-Tommy_Paul,2,B-DTM,17,0,0,0,0,5,12
20161101-M-Charlottesville_CH-R32-Denis_Kudla-Tommy_Paul,2,B-DTL,8,2,1,0,1,2,6
20161101-M-Charlottesville_CH-R32-Denis_Kudla-Tommy_Paul,2,B-IO,3,1,1,0,0,3,0
20161101-M-Charlottesville_CH-R32-Denis_Kudla-Tommy_Paul,2,S-XC,1,0,0,0,0,0,1
20161101-M-Charlottesville_CH-R32-Denis_Kudla-Tommy_Paul,2,S-DTM,1,0,0,0,0,1,0
20161101-M-Charlottesville_CH-R32-Peter_Polansky-Noah_Rubin,1,F-XC,30,6,2,4,0,26,4
20161101-M-Charlottesville_CH-R32-Peter_Polansky-Noah_Rubin,1,F-DTM,6,0,0,0,0,4,2
20161101-M-Charlottesville_CH-R32-Peter_Polansky-Noah_Rubin,1,F-DTL,5,3,1,1,1,2,3
20161101-M-Charlottesville_CH-R32-Peter_Polansky-Noah_Rubin,1,F-IO,4,1,1,0,0,2,2
20161101-M-Charlottesville_CH-R32-Peter_Polansky-Noah_Rubin,1,F-II,2,2,0,1,1,1,1
20161101-M-Charlottesville_CH-R32-Peter_Polansky-Noah_Rubin,1,B-XC,24,3,1,0,2,17,7
20161101-M-Charlottesville_CH-R32-Peter_Polansky-Noah_Rubin,1,B-DTM,15,0,0,0,0,11,4
20161101-M-Charlottesville_CH-R32-Peter_Polansky-Noah_Rubin,1,B-DTL,6,4,2,2,0,6,0
20161101-M-Charlottesville_CH-R32-Peter_Polansky-Noah_Rubin,1,B-IO,1,0,0,0,0,0,1
20161101-M-Charlottesville_CH-R32-Peter_Polansky-Noah_Rubin,1,S-XC,6,0,0,0,0,3,3
20161101-M-Charlottesville_CH-R32-Peter_Polansky-Noah_Rubin,1,S-DTM,5,0,0,0,0,2,3
20161101-M-Charlottesville_CH-R32-Peter_Polansky-Noah_Rubin,1,S-DTL,2,0,0,0,0,1,1
20161101-M-Charlottesville_CH-R32-Peter_Polansky-Noah_Rubin,1,S-IO,1,1,1,0,0,1,0
20161101-M-Charlottesville_CH-R32-Peter_Polansky-Noah_Rubin,2,F-XC,27,7,2,2,3,9,18
20161101-M-Charlottesville_CH-R32-Peter_Polansky-Noah_Rubin,2,F-DTM,13,2,0,0,2,2,11
20161101-M-Charlottesville_CH-R32-Peter_Polansky-Noah_Rubin,2,F-DTL,9,2,1,0,1,4,5
20161101-M-Charlottesville_CH-R32-Peter_Polansky-Noah_Rubin,2,F-IO,16,6,1,2,3,5,11
20161101-M-Charlottesville_CH-R32-Peter_Polansky-Noah_Rubin,2,F-II,2,1,1,0,0,2,0
20161101-M-Charlottesville_CH-R32-Peter_Polansky-Noah_Rubin,2,B-XC,31,6,1,2,3,9,22
20161101-M-Charlottesville_CH-R32-Peter_Polansky-Noah_Rubin,2,B-DTM,4,0,0,0,0,0,4
20161101-M-Charlottesville_CH-R32-Peter_Polansky-Noah_Rubin,2,B-DTL,4,2,1,1,0,4,0
20161101-M-Charlottesville_CH-R32-Peter_Polansky-Noah_Rubin,2,B-IO,3,3,0,1,2,1,2
20161101-M-Charlottesville_CH-R32-Peter_Polansky-Noah_Rubin,2,S-XC,4,0,0,0,0,2,2
20161101-M-Charlottesville_CH-R32-Peter_Polansky-Noah_Rubin,2,S-DTM,1,0,0,0,0,0,1
20160804-M-Granby_CH-R16-Gregoire_Barrere-Denis_Shapovalov,1,F-XC,14,5,1,2,2,9,5
20160804-M-Granby_CH-R16-Gregoire_Barrere-Denis_Shapovalov,1,F-DTM,10,2,0,0,2,3,7
20160804-M-Granby_CH-R16-Gregoire_Barrere-Denis_Shapovalov,1,F-DTL,4,3,0,2,1,2,2
20160804-M-Granby_CH-R16-Gregoire_Barrere-Denis_Shapovalov,1,F-IO,6,4,0,2,2,2,4
20160804-M-Granby_CH-R16-Gregoire_Barrere-Denis_Shapovalov,1,B-XC,14,7,0,2,5,6,8
20160804-M-Granby_CH-R16-Gregoire_Barrere-Denis_Shapovalov,1,B-DTM,5,1,0,0,1,2,3
20160804-M-Granby_CH-R16-Gregoire_Barrere-Denis_Shapovalov,1,B-DTL,3,0,0,0,0,1,2
20160804-M-Granby_CH-R16-Gregoire_Barrere-Denis_Shapovalov,1,B-IO,4,0,0,0,0,1,3
20160804-M-Granby_CH-R16-Gregoire_Barrere-Denis_Shapovalov,1,S-XC,1,0,0,0,0,0,1
20160804-M-Granby_CH-R16-Gregoire_Barrere-Denis_Shapovalov,1,S-DTM,4,0,0,0,0,1,3
20160804-M-Granby_CH-R16-Gregoire_Barrere-Denis_Shapovalov,2,F-XC,22,8,3,2,3,12,10
20160804-M-Granby_CH-R16-Gregoire_Barrere-Denis_Shapovalov,2,F-DTM,7,2,1,0,1,5,2
20160804-M-Granby_CH-R16-Gregoire_Barrere-Denis_Shapovalov,2,F-DTL,3,2,0,1,1,2,1
20160804-M-Granby_CH-R16-Gregoire_Barrere-Denis_Shapovalov,2,F-IO,5,2,1,1,0,5,0
20160804-M-Granby_CH-R16-Gregoire_Barrere-Denis_Shapovalov,2,F-II,3,2,0,2,0,2,1
20160804-M-Granby_CH-R16-Gregoire_Barrere-Denis_Shapovalov,2,B-XC,9,3,1,0,2,4,5
20160804-M-Granby_CH-R16-Gregoire_Barrere-Denis_Shapovalov,2,B-DTM,1,0,0,0,0,1,0
20160804-M-Granby_CH-R16-Gregoire_Barrere-Denis_Shapovalov,2,B-DTL,1,1,0,0,1,0,1
20160804-M-Granby_CH-R16-Gregoire_Barrere-Denis_Shapovalov,2,S-DTM,4,0,0,0,0,2,2
20160804-M-Granby_CH-R16-Gregoire_Barrere-Denis_Shapovalov,2,S-DTL,1,0,0,0,0,1,0
20160804-M-Granby_CH-R16-Gregoire_Barrere-Denis_Shapovalov,2,S-IO,1,1,0,1,0,1,0
20160413-M-Monte_Carlo_Masters-R32-Rafael_Nadal-Aljaz_Bedene,1,F-XC,67,10,3,3,4,51,16
20160413-M-Monte_Carlo_Masters-R32-Rafael_Nadal-Aljaz_Bedene,1,F-DTM,16,2,0,0,2,7,9
20160413-M-Monte_Carlo_Masters-R32-Rafael_Nadal-Aljaz_Bedene,1,F-DTL,13,5,4,1,0,11,2
20160413-M-Monte_Carlo_Masters-R32-Rafael_Nadal-Aljaz_Bedene,1,F-IO,24,8,1,4,3,18,6
20160413-M-Monte_Carlo_Masters-R32-Rafael_Nadal-Aljaz_Bedene,1,F-II,7,1,0,1,0,7,0
20160413-M-Monte_Carlo_Masters-R32-Rafael_Nadal-Aljaz_Bedene,1,B-XC,27,4,1,2,1,16,11
20160413-M-Monte_Carlo_Masters-R32-Rafael_Nadal-Aljaz_Bedene,1,B-DTM,7,0,0,0,0,4,3
20160413-M-Monte_Carlo_Masters-R32-Rafael_Nadal-Aljaz_Bedene,1,B-DTL,16,1,0,0,1,11,5
20160413-M-Monte_Carlo_Masters-R32-Rafael_Nadal-Aljaz_Bedene,1,B-IO,4,3,0,0,3,0,4
20160413-M-Monte_Carlo_Masters-R32-Rafael_Nadal-Aljaz_Bedene,1,S-DTM,3,0,0,0,0,2,1
20160413-M-Monte_Carlo_Masters-R32-Rafael_Nadal-Aljaz_Bedene,1,S-DTL,2,0,0,0,0,2,0
20160413-M-Monte_Carlo_Masters-R32-Rafael_Nadal-Aljaz_Bedene,2,F-XC,37,6,1,3,2,12,25
20160413-M-Monte_Carlo_Masters-R32-Rafael_Nadal-Aljaz_Bedene,2,F-DTM,23,1,0,0,1,10,13
20160413-M-Monte_Carlo_Masters-R32-Rafael_Nadal-Aljaz_Bedene,2,F-DTL,9,3,1,0,2,2,7
20160413-M-Monte_Carlo_Masters-R32-Rafael_Nadal-Aljaz_Bedene,2,F-IO,27,9,1,4,4,9,18
20160413-M-Monte_Carlo_Masters-R32-Rafael_Nadal-Aljaz_Bedene,2,F-II,9,3,0,1,2,3,6
20160413-M-Monte_Carlo_Masters-R32-Rafael_Nadal-Aljaz_Bedene,2,B-XC,31,8,0,3,5,7,24
20160413-M-Monte_Carlo_Masters-R32-Rafael_Nadal-Aljaz_Bedene,2,B-DTM,26,1,0,0,1,10,16
20160413-M-Monte_Carlo_Masters-R32-Rafael_Nadal-Aljaz_Bedene,2,B-DTL,16,6,0,1,5,2,14
20160413-M-Monte_Carlo_Masters-R32-Rafael_Nadal-Aljaz_Bedene,2,B-IO,2,0,0,0,0,0,2
20160413-M-Monte_Carlo_Masters-R32-Rafael_Nadal-Aljaz_Bedene,2,S-XC,2,0,0,0,0,0,2
20160413-M-Monte_Carlo_Masters-R32-Rafael_Nadal-Aljaz_Bedene,2,S-DTM,1,0,0,0,0,0,1
20160413-M-Monte_Carlo_Masters-R32-Rafael_Nadal-Aljaz_Bedene,2,S-DTL,2,0,0,0,0,0,2
20160730-M-Canada_Masters-SF-Novak_Djokovic-Gael_Monfils,1,F-XC,49,9,3,3,3,35,14
20160730-M-Canada_Masters-SF-Novak_Djokovic-Gael_Monfils,1,F-DTM,15,2,0,1,1,12,3
20160730-M-Canada_Masters-SF-Novak_Djokovic-Gael_Monfils,1,F-DTL,20,4,1,1,2,14,6
20160730-M-Canada_Masters-SF-Novak_Djokovic-Gael_Monfils,1,F-IO,27,5,0,4,1,18,9
20160730-M-Canada_Masters-SF-Novak_Djokovic-Gael_Monfils,1,F-II,5,0,0,0,0,5,0
20160730-M-Canada_Masters-SF-Novak_Djokovic-Gael_Monfils,1,B-XC,34,3,0,2,1,28,6
20160730-M-Canada_Masters-SF-Novak_Djokovic-Gael_Monfils,1,B-DTM,12,1,0,0,1,9,3
20160730-M-Canada_Masters-SF-Novak_Djokovic-Gael_Monfils,1,B-DTL,9,3,2,0,1,8,1
20160730-M-Canada_Masters-SF-Novak_Djokovic-Gael_Monfils,1,B-IO,4,1,0,1,0,3,1
20160730-M-Canada_Masters-SF-Novak_Djokovic-Gael_Monfils,1,S-XC,9,0,0,0,0,7,2
20160730-M-Canada_Masters-SF-Novak_Djokovic-Gael_Monfils,1,S-DTM,4,0,0,0,0,4,0
20160730-M-Canada_Masters-SF-Novak_Djokovic-Gael_Monfils,1,S-DTL,1,0,0,0,0,0,1
20160730-M-Canada_Masters-SF-Novak_Djokovic-Gael_Monfils,2,F-XC,46,5,0,2,3,14,32
20160730-M-Canada_Masters-SF-Novak_Djokovic-Gael_Monfils,2,F-DTM,10,1,0,0,1,2,8
20160730-M-Canada_Masters-SF-Novak_Djokovic-Gael_Monfils,2,F-DTL,11,4,0,0,4,2,9
20160730-M-Canada_Masters-SF-Novak_Djokovic-Gael_Monfils,2,F-IO,16,3,1,2,0,3,13
20160730-M-Canada_Masters-SF-Novak_Djokovic-Gael_Monfils,2,F-II,1,0,0,0,0,0,1
20160730-M-Canada_Masters-SF-Novak_Djokovic-Gael_Monfils,2,B-XC,43,5,0,1,4,7,36
20160730-M-Canada_Masters-SF-Novak_Djokovic-Gael_Monfils,2,B-DTM,38,1,0,0,1,13,25
20160730-M-Canada_Masters-SF-Novak_Djokovic-Gael_Monfils,2,B-DTL,12,6,2,0,4,2,10
20160730-M-Canada_Masters-SF-Novak_Djokovic-Gael_Monfils,2,B-IO,2,1,0,0,1,1,1
20160730-M-Canada_Masters-SF-Novak_Djokovic-Gael_Monfils,2,S-XC,2,1,0,0,1,0,2
20160730-M-Canada_Masters-SF-Novak_Djokovic-Gael_Monfils,2,S-DTM,2,0,0,0,0,0,2
20160730-M-Canada_Masters-SF-Novak_Djokovic-Gael_Monfils,2,S-DTL,1,0,0,0,0,0,1
20161106-M-Paris_Masters-F-Andy_Murray-John_Isner,1,F-XC,24,11,4,5,2,19,5
20161106-M-Paris_Masters-F-Andy_Murray-John_Isner,1,F-DTM,31,3,1,0,2,21,10
20161106-M-Paris_Masters-F-Andy_Murray-John_Isner,1,F-DTL,3,1,0,1,0,1,2
20161106-M-Paris_Masters-F-Andy_Murray-John_Isner,1,F-IO,32,7,1,4,2,24,8
20161106-M-Paris_Masters-F-Andy_Murray-John_Isner,1,B-XC,32,4,1,3,0,23,9
20161106-M-Paris_Masters-F-Andy_Murray-John_Isner,1,B-DTM,35,5,0,3,2,20,15
20161106-M-Paris_Masters-F-Andy_Murray-John_Isner,1,B-DTL,6,2,2,0,0,4,2
20161106-M-Paris_Masters-F-Andy_Murray-John_Isner,1,B-IO,4,1,0,1,0,4,0
20161106-M-Paris_Masters-F-Andy_Murray-John_Isner,1,S-XC,2,1,1,0,0,1,1
20161106-M-Paris_Masters-F-Andy_Murray-John_Isner,1,S-DTM,6,0,0,0,0,4,2
20161106-M-Paris_Masters-F-Andy_Murray-John_Isner,1,S-DTL,1,0,0,0,0,0,1
20161106-M-Paris_Masters-F-Andy_Murray-John_Isner,1,S-IO,1,0,0,0,0,1,0
20161106-M-Paris_Masters-F-Andy_Murray-John_Isner,2,F-XC,18,7,6,1,0,11,7
20161106-M-Paris_Masters-F-Andy_Murray-John_Isner,2,F-DTM,25,4,1,0,3,5,20
20161106-M-Paris_Masters-F-Andy_Murray-John_Isner,2,F-DTL,3,0,0,0,0,1,2
20161106-M-Paris_Masters-F-Andy_Murray-John_Isner,2,F-IO,22,12,8,0,4,10,12
20161106-M-Paris_Masters-F-Andy_Murray-John_Isner,2,F-II,1,0,0,0,0,0,1
20161106-M-Paris_Masters-F-Andy_Murray-John_Isner,2,B-XC,13,3,0,1,2,7,6
20161106-M-Paris_Masters-F-Andy_Murray-John_Isner,2,B-DTM,34,4,0,1,3,9,25
20161106-M-Paris_Masters-F-Andy_Murray-John_Isner,2,B-DTL,4,3,0,1,2,2,2
20161106-M-Paris_Masters-F-Andy_Murray-John_Isner,2,B-IO,1,1,0,0,1,0,1
20161106-M-Paris_Masters-F-Andy_Murray-John_Isner,2,S-XC,8,3,0,0,3,2,6
20161106-M-Paris_Masters-F-Andy_Murray-John_Isner,2,S-DTM,13,3,0,0,3,2,11
20161106-M-Paris_Masters-F-Andy_Murray-John_Isner,2,S-DTL,1,0,0,0,0,0,1
19881202-M-Masters_Cup-F-Boris_Becker-Ivan_Lendl,1,F-XC,31,7,0,3,4,14,17
19881202-M-Masters_Cup-F-Boris_Becker-Ivan_Lendl,1,F-DTM,11,0,0,0,0,4,7
19881202-M-Masters_Cup-F-Boris_Becker-Ivan_Lendl,1,F-DTL,35,8,0,3,5,17,18
19881202-M-Masters_Cup-F-Boris_Becker-Ivan_Lendl,1,F-IO,39,7,1,1,5,17,22
19881202-M-Masters_Cup-F-Boris_Becker-Ivan_Lendl,1,F-II,2,2,0,1,1,1,1
19881202-M-Masters_Cup-F-Boris_Becker-Ivan_Lendl,1,B-XC,63,8,1,3,4,34,29
19881202-M-Masters_Cup-F-Boris_Becker-Ivan_Lendl,1,B-DTM,22,2,1,0,1,8,14
19881202-M-Masters_Cup-F-Boris_Becker-Ivan_Lendl,1,B-DTL,35,12,4,4,4,20,15
19881202-M-Masters_Cup-F-Boris_Becker-Ivan_Lendl,1,B-IO,5,4,0,0,4,0,5
19881202-M-Masters_Cup-F-Boris_Becker-Ivan_Lendl,1,S-XC,102,5,0,1,4,48,54
19881202-M-Masters_Cup-F-Boris_Becker-Ivan_Lendl,1,S-DTM,17,1,0,0,1,5,12
19881202-M-Masters_Cup-F-Boris_Becker-Ivan_Lendl,1,S-DTL,18,9,2,3,4,6,12
19881202-M-Masters_Cup-F-Boris_Becker-Ivan_Lendl,1,S-IO,5,0,0,0,0,0,5
19881202-M-Masters_Cup-F-Boris_Becker-Ivan_Lendl,2,F-XC,51,13,7,4,2,32,19
19881202-M-Masters_Cup-F-Boris_Becker-Ivan_Lendl,2,F-DTM,21,1,1,0,0,14,7
19881202-M-Masters_Cup-F-Boris_Becker-Ivan_Lendl,2,F-DTL,35,11,5,3,3,21,14
19881202-M-Masters_Cup-F-Boris_Becker-Ivan_Lendl,2,F-IO,70,10,4,4,2,39,31
19881202-M-Masters_Cup-F-Boris_Becker-Ivan_Lendl,2,F-II,7,3,0,2,1,5,2
19881202-M-Masters_Cup-F-Boris_Becker-Ivan_Lendl,2,B-XC,55,13,4,1,8,24,31
19881202-M-Masters_Cup-F-Boris_Becker-Ivan_Lendl,2,B-DTM,25,3,0,0,3,10,15
19881202-M-Masters_Cup-F-Boris_Becker-Ivan_Lendl,2,B-DTL,21,10,5,0,5,10,11
19881202-M-Masters_Cup-F-Boris_Becker-Ivan_Lendl,2,B-IO,1,1,1,0,0,1,0
19881202-M-Masters_Cup-F-Boris_Becker-Ivan_Lendl,2,S-XC,106,10,2,3,5,58,48
19881202-M-Masters_Cup-F-Boris_Becker-Ivan_Lendl,2,S-DTM,26,3,0,2,1,17,9
19881202-M-Masters_Cup-F-Boris_Becker-Ivan_Lendl,2,S-DTL,18,3,0,2,1,9,9
19881202-M-Masters_Cup-F-Boris_Becker-Ivan_Lendl,2,S-IO,2,1,0,0,1,1,1
20140101-M-Brisbane-R16-Matthew_Ebden-Kei_Nishikori,1,F-XC,17,6,2,1,3,7,10
20140101-M-Brisbane-R16-Matthew_Ebden-Kei_Nishikori,1,F-DTM,9,2,0,0,2,3,6
20140101-M-Brisbane-R16-Matthew_Ebden-Kei_Nishikori,1,F-DTL,3,2,0,0,2,1,2
20140101-M-Brisbane-R16-Matthew_Ebden-Kei_Nishikori,1,F-IO,8,3,1,1,1,6,2
20140101-M-Brisbane-R16-Matthew_Ebden-Kei_Nishikori,1,B-XC,7,5,1,0,4,2,5
20140101-M-Brisbane-R16-Matthew_Ebden-Kei_Nishikori,1,B-DTM,15,1,0,0,1,8,7
20140101-M-Brisbane-R16-Matthew_Ebden-Kei_Nishikori,1,B-DTL,2,1,0,0,1,1,1
20140101-M-Brisbane-R16-Matthew_Ebden-Kei_Nishikori,1,B-IO,1,1,0,0,1,0,1
20140101-M-Brisbane-R16-Matthew_Ebden-Kei_Nishikori,1,S-XC,3,0,0,0,0,1,2
20140101-M-Brisbane-R16-Matthew_Ebden-Kei_Nishikori,1,S-DTM,10,2,0,0,2,2,8
20140101-M-Brisbane-R16-Matthew_Ebden-Kei_Nishikori,2,F-XC,21,6,3,3,0,14,7
20140101-M-Brisbane-R16-Matthew_Ebden-Kei_Nishikori,2,F-DTM,9,3,0,0,3,2,7
20140101-M-Brisbane-R16-Matthew_Ebden-Kei_Nishikori,2,F-DTL,6,3,2,0,1,5,1
20140101-M-Brisbane-R16-Matthew_Ebden-Kei_Nishikori,2,F-IO,12,2,1,0,1,9,3
20140101-M-Brisbane-R16-Matthew_Ebden-Kei_Nishikori,2,F-II,1,1,0,0,1,0,1
20140101-M-Brisbane-R16-Matthew_Ebden-Kei_Nishikori,2,B-XC,13,5,1,3,1,9,4
20140101-M-Brisbane-R16-Matthew_Ebden-Kei_Nishikori,2,B-DTM,17,3,0,0,3,7,10
20140101-M-Brisbane-R16-Matthew_Ebden-Kei_Nishikori,2,B-DTL,2,2,1,0,1,1,1
20160108-M-Brisbane-QF-Roger_Federer-Grigor_Dimitrov,1,F-XC,37,13,2,6,4,22,15
20160108-M-Brisbane-QF-Roger_Federer-Grigor_Dimitrov,1,F-DTM,42,7,0,4,3,21,21
20160108-M-Brisbane-QF-Roger_Federer-Grigor_Dimitrov,1,F-DTL,7,3,1,1,1,3,4
20160108-M-Brisbane-QF-Roger_Federer-Grigor_Dimitrov,1,F-IO,24,11,4,4,3,16,8
20160108-M-Brisbane-QF-Roger_Federer-Grigor_Dimitrov,1,B-XC,7,2,1,1,0,6,1
20160108-M-Brisbane-QF-Roger_Federer-Grigor_Dimitrov,1,B-DTM,23,1,0,0,1,11,12
20160108-M-Brisbane-QF-Roger_Federer-Grigor_Dimitrov,1,B-DTL,2,1,0,0,1,0,2
20160108-M-Brisbane-QF-Roger_Federer-Grigor_Dimitrov,1,B-IO,2,1,1,0,0,1,1
20160108-M-Brisbane-QF-Roger_Federer-Grigor_Dimitrov,1,S-DTM,5,0,0,0,0,3,2
20160108-M-Brisbane-QF-Roger_Federer-Grigor_Dimitrov,2,F-XC,42,12,3,6,3,27,15
20160108-M-Brisbane-QF-Roger_Federer-Grigor_Dimitrov,2,F-DTM,26,5,1,2,2,11,15
20160108-M-Brisbane-QF-Roger_Federer-Grigor_Dimitrov,2,F-DTL,7,5,3,1,1,4,3
20160108-M-Brisbane-QF-Roger_Federer-Grigor_Dimitrov,2,F-IO,22,10,2,5,3,15,7
20160108-M-Brisbane-QF-Roger_Federer-Grigor_Dimitrov,2,F-II,1,0,0,0,0,0,1
20160108-M-Brisbane-QF-Roger_Federer-Grigor_Dimitrov,2,B-XC,7,2,1,1,0,5,2
20160108-M-Brisbane-QF-Roger_Federer-Grigor_Dimitrov,2,B-DTM,32,5,1,1,3,14,18
20160108-M-Brisbane-QF-Roger_Federer-Grigor_Dimitrov,2,B-DTL,6,2,0,0,2,3,3
20160108-M-Brisbane-QF-Roger_Federer-Grigor_Dimitrov,2,B-IO,6,5,1,0,4,2,4
20160108-M-Brisbane-QF-Roger_Federer-Grigor_Dimitrov,2,S-XC,5,2,0,0,2,2,3
20160108-M-Brisbane-QF-Roger_Federer-Grigor_Dimitrov,2,S-DTM,8,0,0,0,0,3,5
20160611-M-Stuttgart-SF-Roger_Federer-Dominic_Thiem,1,F-XC,22,12,2,3,7,9,13
20160611-M-Stuttgart-SF-Roger_Federer-Dominic_Thiem,1,F-DTM,12,1,0,1,0,6,6
20160611-M-Stuttgart-SF-Roger_Federer-Dominic_Thiem,1,F-DTL,6,2,0,0,2,1,5
20160611-M-Stuttgart-SF-Roger_Federer-Dominic_Thiem,1,F-IO,16,6,0,4,2,12,4
20160611-M-Stuttgart-SF-Roger_Federer-Dominic_Thiem,1,B-XC,4,1,1,0,0,2,2
20160611-M-Stuttgart-SF-Roger_Federer-Dominic_Thiem,1,B-DTM,18,4,0,2,2,5,13
20160611-M-Stuttgart-SF-Roger_Federer-Dominic_Thiem,1,B-DTL,6,3,0,1,2,2,4
20160611-M-Stuttgart-SF-Roger_Federer-Dominic_Thiem,1,B-IO,2,2,1,0,1,1,1
20160611-M-Stuttgart-SF-Roger_Federer-Dominic_Thiem,1,S-XC,4,0,0,0,0,0,4
20160611-M-Stuttgart-SF-Roger_Federer-Dominic_Thiem,1,S-DTM,10,0,0,0,0,3,7
20160611-M-Stuttgart-SF-Roger_Federer-Dominic_Thiem,1,S-DTL,1,0,0,0,0,0,1
20160611-M-Stuttgart-SF-Roger_Federer-Dominic_Thiem,2,F-XC,26,13,7,4,2,15,11
20160611-M-Stuttgart-SF-Roger_Federer-Dominic_Thiem,2,F-DTM,15,4,0,1,3,5,10
20160611-M-Stuttgart-SF-Roger_Federer-Dominic_Thiem,2,F-DTL,6,2,0,1,1,4,2
20160611-M-Stuttgart-SF-Roger_Federer-Dominic_Thiem,2,F-IO,9,5,3,1,1,6,3
20160611-M-Stuttgart-SF-Roger_Federer-Dominic_Thiem,2,B-XC,10,5,2,2,1,8,2
20160611-M-Stuttgart-SF-Roger_Federer-Dominic_Thiem,2,B-DTM,14,4,0,2,2,6,8
20160611-M-Stuttgart-SF-Roger_Federer-Dominic_Thiem,2,B-DTL,7,6,2,0,4,2,5
20160611-M-Stuttgart-SF-Roger_Federer-Dominic_Thiem,2,B-IO,8,3,0,2,1,4,4
20160611-M-Stuttgart-SF-Roger_Federer-Dominic_Thiem,2,S-XC,12,1,0,1,0,9,3
20160611-M-Stuttgart-SF-Roger_Federer-Dominic_Thiem,2,S-DTM,13,1,0,0,1,7,6
20160611-M-Stuttgart-SF-Roger_Federer-Dominic_Thiem,2,S-DTL,2,1,0,0,1,1,1
20140101-M-Brisbane-R16-Jarkko_Nieminen-Roger_Federer,1,F-XC,17,7,3,3,1,13,4
20140101-M-Brisbane-R16-Jarkko_Nieminen-Roger_Federer,1,F-DTM,26,3,0,0,3,8,18
20140101-M-Brisbane-R16-Jarkko_Nieminen-Roger_Federer,1,F-DTL,8,2,2,0,0,5,3
20140101-M-Brisbane-R16-Jarkko_Nieminen-Roger_Federer,1,F-IO,8,3,2,0,1,5,3
20140101-M-Brisbane-R16-Jarkko_Nieminen-Roger_Federer,1,B-XC,9,5,0,1,4,3,6
20140101-M-Brisbane-R16-Jarkko_Nieminen-Roger_Federer,1,B-DTM,14,1,0,0,1,6,8
20140101-M-Brisbane-R16-Jarkko_Nieminen-Roger_Federer,1,B-DTL,7,0,0,0,0,5,2
20140101-M-Brisbane-R16-Jarkko_Nieminen-Roger_Federer,1,B-IO,10,3,2,0,1,6,4
20140101-M-Brisbane-R16-Jarkko_Nieminen-Roger_Federer,1,S-DTM,3,0,0,0,0,0,3
20140101-M-Brisbane-R16-Jarkko_Nieminen-Roger_Federer,1,S-DTL,2,0,0,0,0,2,0
20140101-M-Brisbane-R16-Jarkko_Nieminen-Roger_Federer,1,S-IO,6,0,0,0,0,4,2
20140101-M-Brisbane-R16-Jarkko_Nieminen-Roger_Federer,2,F-XC,20,8,3,3,2,16,4
20140101-M-Brisbane-R16-Jarkko_Nieminen-Roger_Federer,2,F-DTM,14,2,0,0,2,8,6
20140101-M-Brisbane-R16-Jarkko_Nieminen-Roger_Federer,2,F-DTL,2,2,0,0,2,0,2
20140101-M-Brisbane-R16-Jarkko_Nieminen-Roger_Federer,2,F-IO,22,11,7,3,1,16,6
20140101-M-Brisbane-R16-Jarkko_Nieminen-Roger_Federer,2,F-II,2,0,0,0,0,0,2
20140101-M-Brisbane-R16-Jarkko_Nieminen-Roger_Federer,2,B-XC,15,8,1,2,5,7,8
20140101-M-Brisbane-R16-Jarkko_Nieminen-Roger_Federer,2,B-DTM,18,2,0,0,2,9,9
20140101-M-Brisbane-R16-Jarkko_Nieminen-Roger_Federer,2,B-DTL,3,2,0,1,1,2,1
20140101-M-Brisbane-R16-Jarkko_Nieminen-Roger_Federer,2,B-IO,2,0,0,0,0,0,2
20140101-M-Brisbane-R16-Jarkko_Nieminen-Roger_Federer,2,S-XC,6,1,0,0,1,2,4
20140101-M-Brisbane-R16-Jarkko_Nieminen-Roger_Federer,2,S-DTM,2,0,0,0,0,0,2
20140101-M-Brisbane-R16-Jarkko_Nieminen-Roger_Federer,2,S-DTL,1,0,0,0,0,0,1
20161120-M-London-F-Andy_Murray-Novak_Djokovic,1,F-XC,42,9,4,1,4,27,15
20161120-M-London-F-Andy_Murray-Novak_Djokovic,1,F-DTM,40,2,0,0,2,20,20
20161120-M-London-F-Andy_Murray-Novak_Djokovic,1,F-DTL,2,1,1,0,0,2,0
20161120-M-London-F-Andy_Murray-Novak_Djokovic,1,F-IO,23,5,0,2,3,15,8
20161120-M-London-F-Andy_Murray-Novak_Djokovic,1,F-II,1,0,0,0,0,0,1
20161120-M-London-F-Andy_Murray-Novak_Djokovic,1,B-XC,49,3,1,1,1,30,19
20161120-M-London-F-Andy_Murray-Novak_Djokovic,1,B-DTM,65,5,1,1,3,35,30
20161120-M-London-F-Andy_Murray-Novak_Djokovic,1,B-DTL,2,1,0,0,1,0,2
20161120-M-London-F-Andy_Murray-Novak_Djokovic,1,B-IO,2,1,0,0,1,1,1
20161120-M-London-F-Andy_Murray-Novak_Djokovic,1,S-XC,11,0,0,0,0,10,1
20161120-M-London-F-Andy_Murray-Novak_Djokovic,1,S-DTM,13,1,0,0,1,6,7
20161120-M-London-F-Andy_Murray-Novak_Djokovic,1,S-DTL,2,0,0,0,0,0,2
20161120-M-London-F-Andy_Murray-Novak_Djokovic,1,S-IO,2,2,0,1,1,1,1
20161120-M-London-F-Andy_Murray-Novak_Djokovic,2,F-XC,27,9,1,4,4,14,13
20161120-M-London-F-Andy_Murray-Novak_Djokovic,2,F-DTM,40,3,1,0,2,16,24
20161120-M-London-F-Andy_Murray-Novak_Djokovic,2,F-DTL,4,0,0,0,0,1,3
20161120-M-London-F-Andy_Murray-Novak_Djokovic,2,F-IO,29,7,1,0,6,13,16
20161120-M-London-F-Andy_Murray-Novak_Djokovic,2,F-II,1,0,0,0,0,0,1
20161120-M-London-F-Andy_Murray-Novak_Djokovic,2,B-XC,46,6,0,1,5,17,29
20161120-M-London-F-Andy_Murray-Novak_Djokovic,2,B-DTM,70,9,0,0,9,27,43
20161120-M-London-F-Andy_Murray-Novak_Djokovic,2,B-DTL,6,1,1,0,0,4,2
20161120-M-London-F-Andy_Murray-Novak_Djokovic,2,B-IO,15,3,1,0,2,8,7
20161120-M-London-F-Andy_Murray-Novak_Djokovic,2,S-XC,14,1,0,0,1,4,10
20161120-M-London-F-Andy_Murray-Novak_Djokovic,2,S-DTM,13,0,0,0,0,3,10
20161120-M-London-F-Andy_Murray-Novak_Djokovic,2,S-DTL,1,0,0,0,0,0,1
20161120-M-London-F-Andy_Murray-Novak_Djokovic,2,S-IO,1,0,0,0,0,1,0
20161126-M-Andria_CH-SF-Egor_Gerasimov-Matteo_Berrettini,1,F-XC,31,6,1,2,3,20,11
20161126-M-Andria_CH-SF-Egor_Gerasimov-Matteo_Berrettini,1,F-DTM,8,0,0,0,0,4,4
20161126-M-Andria_CH-SF-Egor_Gerasimov-Matteo_Berrettini,1,F-DTL,5,2,0,1,1,2,3
20161126-M-Andria_CH-SF-Egor_Gerasimov-Matteo_Berrettini,1,F-IO,14,4,1,1,2,10,4
20161126-M-Andria_CH-SF-Egor_Gerasimov-Matteo_Berrettini,1,F-II,2,1,0,0,1,1,1
20161126-M-Andria_CH-SF-Egor_Gerasimov-Matteo_Berrettini,1,B-XC,22,2,1,1,0,11,11
20161126-M-Andria_CH-SF-Egor_Gerasimov-Matteo_Berrettini,1,B-DTM,11,2,0,0,2,5,6
20161126-M-Andria_CH-SF-Egor_Gerasimov-Matteo_Berrettini,1,B-DTL,6,4,2,1,1,5,1
20161126-M-Andria_CH-SF-Egor_Gerasimov-Matteo_Berrettini,1,B-IO,2,1,1,0,0,2,0
20161126-M-Andria_CH-SF-Egor_Gerasimov-Matteo_Berrettini,1,S-XC,2,1,0,0,1,1,1
20161126-M-Andria_CH-SF-Egor_Gerasimov-Matteo_Berrettini,1,S-DTM,2,0,0,0,0,0,2
20161126-M-Andria_CH-SF-Egor_Gerasimov-Matteo_Berrettini,1,S-DTL,1,0,0,0,0,0,1
20161126-M-Andria_CH-SF-Egor_Gerasimov-Matteo_Berrettini,2,F-XC,35,11,1,4,6,18,17
20161126-M-Andria_CH-SF-Egor_Gerasimov-Matteo_Berrettini,2,F-DTM,15,6,1,1,4,4,11
20161126-M-Andria_CH-SF-Egor_Gerasimov-Matteo_Berrettini,2,F-DTL,10,3,0,1,2,5,5
20161126-M-Andria_CH-SF-Egor_Gerasimov-Matteo_Berrettini,2,F-IO,15,7,3,1,3,8,7
20161126-M-Andria_CH-SF-Egor_Gerasimov-Matteo_Berrettini,2,F-II,2,1,1,0,0,1,1
20161126-M-Andria_CH-SF-Egor_Gerasimov-Matteo_Berrettini,2,B-XC,6,1,0,1,0,5,1
20161126-M-Andria_CH-SF-Egor_Gerasimov-Matteo_Berrettini,2,B-DTM,4,0,0,0,0,0,4
20161126-M-Andria_CH-SF-Egor_Gerasimov-Matteo_Berrettini,2,B-DTL,1,1,0,1,0,1,0
20161126-M-Andria_CH-SF-Egor_Gerasimov-Matteo_Berrettini,2,B-IO,2,0,0,0,0,0,2
20161126-M-Andria_CH-SF-Egor_Gerasimov-Matteo_Berrettini,2,S-XC,16,0,0,0,0,8,8
20161126-M-Andria_CH-SF-Egor_Gerasimov-Matteo_Berrettini,2,S-DTM,8,0,0,0,0,3,5
20161126-M-Andria_CH-SF-Egor_Gerasimov-Matteo_Berrettini,2,S-DTL,2,2,0,0,2,0,2
20161118-M-London-RR-Stanislas_Wawrinka-Andy_Murray,1,F-XC,42,7,2,1,4,16,26
20161118-M-London-RR-Stanislas_Wawrinka-Andy_Murray,1,F-DTM,19,3,0,0,3,7,12
20161118-M-London-RR-Stanislas_Wawrinka-Andy_Murray,1,F-DTL,16,6,3,1,2,7,9
20161118-M-London-RR-Stanislas_Wawrinka-Andy_Murray,1,F-IO,25,4,3,0,1,16,9
20161118-M-London-RR-Stanislas_Wawrinka-Andy_Murray,1,F-II,5,2,1,1,0,2,3
20161118-M-London-RR-Stanislas_Wawrinka-Andy_Murray,1,B-XC,45,11,3,0,8,24,21
20161118-M-London-RR-Stanislas_Wawrinka-Andy_Murray,1,B-DTM,14,0,0,0,0,5,9
20161118-M-London-RR-Stanislas_Wawrinka-Andy_Murray,1,B-DTL,7,2,1,0,1,4,3
20161118-M-London-RR-Stanislas_Wawrinka-Andy_Murray,1,B-IO,2,0,0,0,0,2,0
20161118-M-London-RR-Stanislas_Wawrinka-Andy_Murray,1,S-XC,17,2,1,0,1,4,13
20161118-M-London-RR-Stanislas_Wawrinka-Andy_Murray,1,S-DTM,7,1,0,0,1,1,6
20161118-M-London-RR-Stanislas_Wawrinka-Andy_Murray,1,S-DTL,1,1,0,0,1,0,1
20161118-M-London-RR-Stanislas_Wawrinka-Andy_Murray,1,S-IO,1,0,0,0,0,0,1
20161118-M-London-RR-Stanislas_Wawrinka-Andy_Murray,2,F-XC,42,7,3,3,1,30,12
20161118-M-London-RR-Stanislas_Wawrinka-Andy_Murray,2,F-DTM,18,1,0,0,1,9,9
20161118-M-London-RR-Stanislas_Wawrinka-Andy_Murray,2,F-DTL,12,0,0,0,0,7,5
20161118-M-London-RR-Stanislas_Wawrinka-Andy_Murray,2,F-IO,21,4,0,2,2,12,9
20161118-M-London-RR-Stanislas_Wawrinka-Andy_Murray,2,F-II,3,1,0,1,0,3,0
20161118-M-London-RR-Stanislas_Wawrinka-Andy_Murray,2,B-XC,40,6,0,2,4,22,18
20161118-M-London-RR-Stanislas_Wawrinka-Andy_Murray,2,B-DTM,19,3,0,0,3,7,12
20161118-M-London-RR-Stanislas_Wawrinka-Andy_Murray,2,B-DTL,2,1,1,0,0,2,0
20161118-M-London-RR-Stanislas_Wawrinka-Andy_Murray,2,B-IO,4,2,1,0,1,2,2
20161118-M-London-RR-Stanislas_Wawrinka-Andy_Murray,2,S-XC,11,0,0,0,0,7,4
20161118-M-London-RR-Stanislas_Wawrinka-Andy_Murray,2,S-DTM,9,0,0,0,0,4,5
20161118-M-London-RR-Stanislas_Wawrinka-Andy_Murray,2,S-DTL,5,1,0,0,1,3,2
20161118-M-London-RR-Stanislas_Wawrinka-Andy_Murray,2,S-IO,1,0,0,0,0,0,1
20040613-M-Halle-F-Roger_Federer-Mardy_Fish,1,F-XC,14,4,1,2,1,10,4
20040613-M-Halle-F-Roger_Federer-Mardy_Fish,1,F-DTM,19,4,3,0,1,14,5
20040613-M-Halle-F-Roger_Federer-Mardy_Fish,1,F-IO,6,3,2,0,1,5,1
20040613-M-Halle-F-Roger_Federer-Mardy_Fish,1,B-XC,12,3,1,1,1,9,3
20040613-M-Halle-F-Roger_Federer-Mardy_Fish,1,B-DTM,23,5,2,1,2,18,5
20040613-M-Halle-F-Roger_Federer-Mardy_Fish,1,B-DTL,4,3,1,2,0,4,0
20040613-M-Halle-F-Roger_Federer-Mardy_Fish,1,B-IO,1,0,0,0,0,0,1
20040613-M-Halle-F-Roger_Federer-Mardy_Fish,1,S-XC,7,0,0,0,0,6,1
20040613-M-Halle-F-Roger_Federer-Mardy_Fish,1,S-DTM,10,1,1,0,0,7,3
20040613-M-Halle-F-Roger_Federer-Mardy_Fish,1,S-DTL,1,0,0,0,0,1,0
20040613-M-Halle-F-Roger_Federer-Mardy_Fish,2,F-XC,11,4,1,2,1,4,7
20040613-M-Halle-F-Roger_Federer-Mardy_Fish,2,F-DTM,17,2,0,0,2,5,12
20040613-M-Halle-F-Roger_Federer-Mardy_Fish,2,F-DTL,3,2,1,0,1,1,2
20040613-M-Halle-F-Roger_Federer-Mardy_Fish,2,F-IO,15,4,2,0,2,3,12
20040613-M-Halle-F-Roger_Federer-Mardy_Fish,2,F-II,1,0,0,0,0,1,0
20040613-M-Halle-F-Roger_Federer-Mardy_Fish,2,B-XC,21,3,2,0,1,6,15
20040613-M-Halle-F-Roger_Federer-Mardy_Fish,2,B-DTM,23,4,0,0,4,6,17
20040613-M-Halle-F-Roger_Federer-Mardy_Fish,2,B-IO,3,1,0,0,1,0,3
20040613-M-Halle-F-Roger_Federer-Mardy_Fish,2,S-DTM,1,0,0,0,0,0,1
20040613-M-Halle-F-Roger_Federer-Mardy_Fish,2,S-DTL,1,1,0,0,1,0,1
20060813-M-Canada_Masters-F-Roger_Federer-Richard_Gasquet,1,F-XC,39,8,2,1,5,23,16
20060813-M-Canada_Masters-F-Roger_Federer-Richard_Gasquet,1,F-DTM,46,9,1,4,4,27,19
20060813-M-Canada_Masters-F-Roger_Federer-Richard_Gasquet,1,F-DTL,5,2,0,0,2,2,3
20060813-M-Canada_Masters-F-Roger_Federer-Richard_Gasquet,1,F-IO,36,18,5,5,8,23,13
20060813-M-Canada_Masters-F-Roger_Federer-Richard_Gasquet,1,F-II,2,1,0,0,1,1,1
20060813-M-Canada_Masters-F-Roger_Federer-Richard_Gasquet,1,B-XC,36,11,1,7,3,17,19
20060813-M-Canada_Masters-F-Roger_Federer-Richard_Gasquet,1,B-DTM,52,4,1,1,2,17,35
20060813-M-Canada_Masters-F-Roger_Federer-Richard_Gasquet,1,B-DTL,7,4,2,1,1,4,3
20060813-M-Canada_Masters-F-Roger_Federer-Richard_Gasquet,1,B-IO,5,3,0,0,3,1,4
20060813-M-Canada_Masters-F-Roger_Federer-Richard_Gasquet,1,S-XC,9,0,0,0,0,5,4
20060813-M-Canada_Masters-F-Roger_Federer-Richard_Gasquet,1,S-DTM,10,1,0,0,1,4,6
20060813-M-Canada_Masters-F-Roger_Federer-Richard_Gasquet,1,S-DTL,1,1,0,1,0,1,0
20060813-M-Canada_Masters-F-Roger_Federer-Richard_Gasquet,2,F-XC,42,14,4,3,7,22,20
20060813-M-Canada_Masters-F-Roger_Federer-Richard_Gasquet,2,F-DTM,62,4,0,2,2,29,33
20060813-M-Canada_Masters-F-Roger_Federer-Richard_Gasquet,2,F-DTL,4,1,1,0,0,1,3
20060813-M-Canada_Masters-F-Roger_Federer-Richard_Gasquet,2,F-IO,25,7,2,2,3,15,10
20060813-M-Canada_Masters-F-Roger_Federer-Richard_Gasquet,2,F-II,1,1,1,0,0,1,0
20060813-M-Canada_Masters-F-Roger_Federer-Richard_Gasquet,2,B-XC,47,7,3,2,2,29,18
20060813-M-Canada_Masters-F-Roger_Federer-Richard_Gasquet,2,B-DTM,37,2,0,0,2,21,16
20060813-M-Canada_Masters-F-Roger_Federer-Richard_Gasquet,2,B-DTL,2,0,0,0,0,1,1
20060813-M-Canada_Masters-F-Roger_Federer-Richard_Gasquet,2,B-IO,2,2,1,1,0,2,0
20060813-M-Canada_Masters-F-Roger_Federer-Richard_Gasquet,2,S-XC,9,0,0,0,0,3,6
20060813-M-Canada_Masters-F-Roger_Federer-Richard_Gasquet,2,S-DTM,4,2,0,0,2,1,3
20060813-M-Canada_Masters-F-Roger_Federer-Richard_Gasquet,2,S-DTL,2,0,0,0,0,0,2
20070819-M-Cincinnati_Masters-F-Roger_Federer-James_Blake,1,F-XC,16,5,1,3,1,12,4
20070819-M-Cincinnati_Masters-F-Roger_Federer-James_Blake,1,F-DTM,30,5,1,0,4,14,16
20070819-M-Cincinnati_Masters-F-Roger_Federer-James_Blake,1,F-DTL,2,1,1,0,0,2,0
20070819-M-Cincinnati_Masters-F-Roger_Federer-James_Blake,1,F-IO,15,8,2,2,4,6,9
20070819-M-Cincinnati_Masters-F-Roger_Federer-James_Blake,1,F-II,2,2,1,0,1,1,1
20070819-M-Cincinnati_Masters-F-Roger_Federer-James_Blake,1,B-XC,12,2,0,0,2,3,9
20070819-M-Cincinnati_Masters-F-Roger_Federer-James_Blake,1,B-DTM,14,2,0,0,2,4,10
20070819-M-Cincinnati_Masters-F-Roger_Federer-James_Blake,1,B-DTL,4,3,0,1,2,2,2
20070819-M-Cincinnati_Masters-F-Roger_Federer-James_Blake,1,S-XC,3,1,0,1,0,1,2
20070819-M-Cincinnati_Masters-F-Roger_Federer-James_Blake,1,S-DTM,4,0,0,0,0,2,2
20070819-M-Cincinnati_Masters-F-Roger_Federer-James_Blake,1,S-IO,1,0,0,0,0,0,1
20070819-M-Cincinnati_Masters-F-Roger_Federer-James_Blake,2,F-XC,17,6,2,0,4,5,12
20070819-M-Cincinnati_Masters-F-Roger_Federer-James_Blake,2,F-DTM,17,1,1,0,0,9,8
20070819-M-Cincinnati_Masters-F-Roger_Federer-James_Blake,2,F-DTL,8,5,2,0,3,3,5
20070819-M-Cincinnati_Masters-F-Roger_Federer-James_Blake,2,F-IO,16,5,2,1,2,10,6
20070819-M-Cincinnati_Masters-F-Roger_Federer-James_Blake,2,F-II,1,1,0,1,0,1,0
20070819-M-Cincinnati_Masters-F-Roger_Federer-James_Blake,2,B-XC,13,3,1,1,1,10,3
20070819-M-Cincinnati_Masters-F-Roger_Federer-James_Blake,2,B-DTM,15,3,1,0,2,9,6
20070819-M-Cincinnati_Masters-F-Roger_Federer-James_Blake,2,B-DTL,3,2,0,1,1,1,2
20070819-M-Cincinnati_Masters-F-Roger_Federer-James_Blake,2,B-IO,2,0,0,0,0,1,1
20070819-M-Cincinnati_Masters-F-Roger_Federer-James_Blake,2,S-XC,3,0,0,0,0,3,0
20070819-M-Cincinnati_Masters-F-Roger_Federer-James_Blake,2,S-DTM,5,1,0,0,1,1,4
20070819-M-Cincinnati_Masters-F-Roger_Federer-James_Blake,2,S-IO,1,0,0,0,0,0,1
20090531-M-Roland_Garros-R16-Robin_Soderling-Rafael_Nadal,1,F-XC,112,23,10,3,10,64,48
20090531-M-Roland_Garros-R16-Robin_Soderling-Rafael_Nadal,1,F-DTM,78,7,0,2,5,37,41
20090531-M-Roland_Garros-R16-Robin_Soderling-Rafael_Nadal,1,F-DTL,24,12,3,1,8,13,11
20090531-M-Roland_Garros-R16-Robin_Soderling-Rafael_Nadal,1,F-IO,72,40,14,11,15,41,31
20090531-M-Roland_Garros-R16-Robin_Soderling-Rafael_Nadal,1,F-II,8,2,2,0,0,7,1
20090531-M-Roland_Garros-R16-Robin_Soderling-Rafael_Nadal,1,B-XC,63,19,3,9,7,36,27
20090531-M-Roland_Garros-R16-Robin_Soderling-Rafael_Nadal,1,B-DTM,70,10,0,1,9,27,43
20090531-M-Roland_Garros-R16-Robin_Soderling-Rafael_Nadal,1,B-DTL,46,11,3,0,8,20,26
20090531-M-Roland_Garros-R16-Robin_Soderling-Rafael_Nadal,1,B-IO,18,9,1,2,6,9,9
20090531-M-Roland_Garros-R16-Robin_Soderling-Rafael_Nadal,1,S-XC,2,0,0,0,0,0,2
20090531-M-Roland_Garros-R16-Robin_Soderling-Rafael_Nadal,1,S-DTM,5,1,0,1,0,3,2
20090531-M-Roland_Garros-R16-Robin_Soderling-Rafael_Nadal,2,F-XC,120,13,4,4,5,64,56
20090531-M-Roland_Garros-R16-Robin_Soderling-Rafael_Nadal,2,F-DTM,71,8,2,0,6,37,34
20090531-M-Roland_Garros-R16-Robin_Soderling-Rafael_Nadal,2,F-DTL,23,7,7,0,0,15,8
20090531-M-Roland_Garros-R16-Robin_Soderling-Rafael_Nadal,2,F-IO,57,14,8,0,6,28,29
20090531-M-Roland_Garros-R16-Robin_Soderling-Rafael_Nadal,2,F-II,5,1,0,0,1,3,2
20090531-M-Roland_Garros-R16-Robin_Soderling-Rafael_Nadal,2,B-XC,47,13,4,3,6,25,22
20090531-M-Roland_Garros-R16-Robin_Soderling-Rafael_Nadal,2,B-DTM,62,4,0,1,3,30,32
20090531-M-Roland_Garros-R16-Robin_Soderling-Rafael_Nadal,2,B-DTL,20,4,2,0,2,8,12
20090531-M-Roland_Garros-R16-Robin_Soderling-Rafael_Nadal,2,B-IO,2,0,0,0,0,0,2
20090531-M-Roland_Garros-R16-Robin_Soderling-Rafael_Nadal,2,B-II,1,0,0,0,0,1,0
20090531-M-Roland_Garros-R16-Robin_Soderling-Rafael_Nadal,2,S-XC,7,0,0,0,0,3,4
20090531-M-Roland_Garros-R16-Robin_Soderling-Rafael_Nadal,2,S-DTM,34,2,0,1,1,11,23
20090531-M-Roland_Garros-R16-Robin_Soderling-Rafael_Nadal,2,S-DTL,4,0,0,0,0,2,2
20090531-M-Roland_Garros-R16-Robin_Soderling-Rafael_Nadal,2,S-IO,3,0,0,0,0,3,0
20090531-M-Roland_Garros-R16-Robin_Soderling-Rafael_Nadal,2,S-II,2,0,0,0,0,1,1
20150813-M-Canada_Masters-R16-Novak_Djokovic-Jack_Sock,1,F-XC,22,9,6,2,1,16,6
20150813-M-Canada_Masters-R16-Novak_Djokovic-Jack_Sock,1,F-DTM,13,1,0,0,1,7,6
20150813-M-Canada_Masters-R16-Novak_Djokovic-Jack_Sock,1,F-DTL,5,1,1,0,0,4,1
20150813-M-Canada_Masters-R16-Novak_Djokovic-Jack_Sock,1,F-IO,12,0,0,0,0,9,3
20150813-M-Canada_Masters-R16-Novak_Djokovic-Jack_Sock,1,F-II,2,2,1,0,1,1,1
20150813-M-Canada_Masters-R16-Novak_Djokovic-Jack_Sock,1,B-XC,20,4,0,1,3,13,7
20150813-M-Canada_Masters-R16-Novak_Djokovic-Jack_Sock,1,B-DTM,22,1,1,0,0,15,7
20150813-M-Canada_Masters-R16-Novak_Djokovic-Jack_Sock,1,B-DTL,6,2,0,1,1,3,3
20150813-M-Canada_Masters-R16-Novak_Djokovic-Jack_Sock,1,B-IO,5,4,2,0,2,3,2
20150813-M-Canada_Masters-R16-Novak_Djokovic-Jack_Sock,1,S-XC,4,0,0,0,0,2,2
20150813-M-Canada_Masters-R16-Novak_Djokovic-Jack_Sock,1,S-DTM,4,0,0,0,0,2,2
20150813-M-Canada_Masters-R16-Novak_Djokovic-Jack_Sock,1,S-DTL,2,0,0,0,0,2,0
20150813-M-Canada_Masters-R16-Novak_Djokovic-Jack_Sock,2,F-XC,24,7,1,2,4,10,14
20150813-M-Canada_Masters-R16-Novak_Djokovic-Jack_Sock,2,F-DTM,19,2,0,0,2,5,14
20150813-M-Canada_Masters-R16-Novak_Djokovic-Jack_Sock,2,F-DTL,4,1,0,0,1,3,1
20150813-M-Canada_Masters-R16-Novak_Djokovic-Jack_Sock,2,F-IO,30,9,3,1,5,13,17
20150813-M-Canada_Masters-R16-Novak_Djokovic-Jack_Sock,2,F-II,2,1,0,1,0,1,1
20150813-M-Canada_Masters-R16-Novak_Djokovic-Jack_Sock,2,B-XC,7,2,0,0,2,2,5
20150813-M-Canada_Masters-R16-Novak_Djokovic-Jack_Sock,2,B-DTM,9,2,0,1,1,2,7
20150813-M-Canada_Masters-R16-Novak_Djokovic-Jack_Sock,2,B-DTL,2,1,0,0,1,0,2
20150813-M-Canada_Masters-R16-Novak_Djokovic-Jack_Sock,2,B-IO,1,1,0,0,1,0,1
20150813-M-Canada_Masters-R16-Novak_Djokovic-Jack_Sock,2,S-XC,10,0,0,0,0,3,7
20150813-M-Canada_Masters-R16-Novak_Djokovic-Jack_Sock,2,S-DTM,5,0,0,0,0,1,4
20150813-M-Canada_Masters-R16-Novak_Djokovic-Jack_Sock,2,S-DTL,1,0,0,0,0,0,1
20150815-M-Canada_Masters-SF-Andy_Murray-Kei_Nishikori,1,F-XC,16,5,4,1,0,9,7
20150815-M-Canada_Masters-SF-Andy_Murray-Kei_Nishikori,1,F-DTM,10,0,0,0,0,2,8
20150815-M-Canada_Masters-SF-Andy_Murray-Kei_Nishikori,1,F-DTL,3,0,0,0,0,1,2
20150815-M-Canada_Masters-SF-Andy_Murray-Kei_Nishikori,1,F-IO,10,4,0,2,2,7,3
20150815-M-Canada_Masters-SF-Andy_Murray-Kei_Nishikori,1,B-XC,19,4,2,0,2,12,7
20150815-M-Canada_Masters-SF-Andy_Murray-Kei_Nishikori,1,B-DTM,10,1,0,0,1,5,5
20150815-M-Canada_Masters-SF-Andy_Murray-Kei_Nishikori,1,B-DTL,2,2,1,0,1,1,1
20150815-M-Canada_Masters-SF-Andy_Murray-Kei_Nishikori,1,B-IO,1,1,0,1,0,1,0
20150815-M-Canada_Masters-SF-Andy_Murray-Kei_Nishikori,1,S-XC,11,0,0,0,0,5,6
20150815-M-Canada_Masters-SF-Andy_Murray-Kei_Nishikori,1,S-DTM,8,0,0,0,0,5,3
20150815-M-Canada_Masters-SF-Andy_Murray-Kei_Nishikori,1,S-DTL,2,0,0,0,0,0,2
20150815-M-Canada_Masters-SF-Andy_Murray-Kei_Nishikori,1,S-IO,2,0,0,0,0,1,1
20150815-M-Canada_Masters-SF-Andy_Murray-Kei_Nishikori,2,F-XC,20,9,5,1,3,13,7
20150815-M-Canada_Masters-SF-Andy_Murray-Kei_Nishikori,2,F-DTM,11,1,0,0,1,5,6
20150815-M-Canada_Masters-SF-Andy_Murray-Kei_Nishikori,2,F-DTL,7,5,4,0,1,4,3
20150815-M-Canada_Masters-SF-Andy_Murray-Kei_Nishikori,2,F-IO,11,1,0,1,0,9,2
20150815-M-Canada_Masters-SF-Andy_Murray-Kei_Nishikori,2,F-II,2,2,0,0,2,0,2
20150815-M-Canada_Masters-SF-Andy_Murray-Kei_Nishikori,2,B-XC,26,4,0,1,3,12,14
20150815-M-Canada_Masters-SF-Andy_Murray-Kei_Nishikori,2,B-DTM,9,0,0,0,0,0,9
20150815-M-Canada_Masters-SF-Andy_Murray-Kei_Nishikori,2,B-DTL,7,1,0,0,1,1,6
20150815-M-Canada_Masters-SF-Andy_Murray-Kei_Nishikori,2,B-IO,3,1,0,0,1,2,1
20150815-M-Canada_Masters-SF-Andy_Murray-Kei_Nishikori,2,S-XC,3,0,0,0,0,2,1
20150815-M-Canada_Masters-SF-Andy_Murray-Kei_Nishikori,2,S-DTM,4,0,0,0,0,0,4
20150815-M-Canada_Masters-SF-Andy_Murray-Kei_Nishikori,2,S-IO,2,0,0,0,0,2,0
20150816-M-Canada_Masters-F-Andy_Murray-Novak_Djokovic,1,F-XC,54,10,4,1,5,26,28
20150816-M-Canada_Masters-F-Andy_Murray-Novak_Djokovic,1,F-DTM,25,3,1,0,2,5,20
20150816-M-Canada_Masters-F-Andy_Murray-Novak_Djokovic,1,F-DTL,14,4,1,0,3,5,9
20150816-M-Canada_Masters-F-Andy_Murray-Novak_Djokovic,1,F-IO,58,11,1,2,8,32,26
20150816-M-Canada_Masters-F-Andy_Murray-Novak_Djokovic,1,F-II,5,2,0,1,1,2,3
20150816-M-Canada_Masters-F-Andy_Murray-Novak_Djokovic,1,B-XC,85,16,8,2,6,45,40
20150816-M-Canada_Masters-F-Andy_Murray-Novak_Djokovic,1,B-DTM,35,6,0,1,5,12,23
20150816-M-Canada_Masters-F-Andy_Murray-Novak_Djokovic,1,B-DTL,14,6,1,2,3,8,6
20150816-M-Canada_Masters-F-Andy_Murray-Novak_Djokovic,1,B-IO,8,2,1,0,1,2,6
20150816-M-Canada_Masters-F-Andy_Murray-Novak_Djokovic,1,S-XC,21,2,0,1,1,9,12
20150816-M-Canada_Masters-F-Andy_Murray-Novak_Djokovic,1,S-DTM,15,0,0,0,0,5,10
20150816-M-Canada_Masters-F-Andy_Murray-Novak_Djokovic,1,S-DTL,1,0,0,0,0,0,1
20150816-M-Canada_Masters-F-Andy_Murray-Novak_Djokovic,1,S-IO,2,0,0,0,0,0,2
20150816-M-Canada_Masters-F-Andy_Murray-Novak_Djokovic,2,F-XC,45,14,4,5,5,25,20
20150816-M-Canada_Masters-F-Andy_Murray-Novak_Djokovic,2,F-DTM,36,4,1,2,1,25,11
20150816-M-Canada_Masters-F-Andy_Murray-Novak_Djokovic,2,F-DTL,17,3,0,1,2,8,9
20150816-M-Canada_Masters-F-Andy_Murray-Novak_Djokovic,2,F-IO,36,8,4,1,3,26,10
20150816-M-Canada_Masters-F-Andy_Murray-Novak_Djokovic,2,F-II,1,1,0,0,1,0,1
20150816-M-Canada_Masters-F-Andy_Murray-Novak_Djokovic,2,B-XC,65,10,3,2,5,34,31
20150816-M-Canada_Masters-F-Andy_Murray-Novak_Djokovic,2,B-DTM,61,6,0,0,6,30,31
20150816-M-Canada_Masters-F-Andy_Murray-Novak_Djokovic,2,B-DTL,20,8,1,2,5,9,11
20150816-M-Canada_Masters-F-Andy_Murray-Novak_Djokovic,2,B-IO,14,3,0,1,2,7,7
20150816-M-Canada_Masters-F-Andy_Murray-Novak_Djokovic,2,S-XC,26,0,0,0,0,14,12
20150816-M-Canada_Masters-F-Andy_Murray-Novak_Djokovic,2,S-DTM,13,0,0,0,0,3,10
20150816-M-Canada_Masters-F-Andy_Murray-Novak_Djokovic,2,S-DTL,2,0,0,0,0,1,1
20160506-M-Madrid_Masters-QF-Andy_Murray-Tomas_Berdych,1,F-XC,26,10,4,3,3,19,7
20160506-M-Madrid_Masters-QF-Andy_Murray-Tomas_Berdych,1,F-DTM,8,0,0,0,0,6,2
20160506-M-Madrid_Masters-QF-Andy_Murray-Tomas_Berdych,1,F-DTL,5,0,0,0,0,3,2
20160506-M-Madrid_Masters-QF-Andy_Murray-Tomas_Berdych,1,F-IO,3,2,0,1,1,2,1
20160506-M-Madrid_Masters-QF-Andy_Murray-Tomas_Berdych,1,B-XC,17,0,0,0,0,10,7
20160506-M-Madrid_Masters-QF-Andy_Murray-Tomas_Berdych,1,B-DTM,24,1,0,0,1,13,11
20160506-M-Madrid_Masters-QF-Andy_Murray-Tomas_Berdych,1,B-DTL,5,4,1,1,2,3,2
20160506-M-Madrid_Masters-QF-Andy_Murray-Tomas_Berdych,1,B-IO,3,1,1,0,0,2,1
20160506-M-Madrid_Masters-QF-Andy_Murray-Tomas_Berdych,1,S-XC,9,0,0,0,0,4,5
20160506-M-Madrid_Masters-QF-Andy_Murray-Tomas_Berdych,1,S-DTM,4,0,0,0,0,2,2
20160506-M-Madrid_Masters-QF-Andy_Murray-Tomas_Berdych,2,F-XC,23,8,2,2,4,9,14
20160506-M-Madrid_Masters-QF-Andy_Murray-Tomas_Berdych,2,F-DTM,13,0,0,0,0,6,7
20160506-M-Madrid_Masters-QF-Andy_Murray-Tomas_Berdych,2,F-DTL,8,3,0,0,3,1,7
20160506-M-Madrid_Masters-QF-Andy_Murray-Tomas_Berdych,2,F-IO,23,7,3,1,3,12,11
20160506-M-Madrid_Masters-QF-Andy_Murray-Tomas_Berdych,2,F-II,4,2,1,1,0,2,2
20160506-M-Madrid_Masters-QF-Andy_Murray-Tomas_Berdych,2,B-XC,27,4,0,1,3,9,18
20160506-M-Madrid_Masters-QF-Andy_Murray-Tomas_Berdych,2,B-DTM,21,3,0,0,3,8,13
20160506-M-Madrid_Masters-QF-Andy_Murray-Tomas_Berdych,2,B-DTL,7,5,3,0,2,4,3
20160506-M-Madrid_Masters-QF-Andy_Murray-Tomas_Berdych,2,B-IO,1,1,0,0,1,0,1
20160506-M-Madrid_Masters-QF-Andy_Murray-Tomas_Berdych,2,S-XC,2,1,0,1,0,1,1
20160506-M-Madrid_Masters-QF-Andy_Murray-Tomas_Berdych,2,S-DTM,2,0,0,0,0,0,2
20160506-M-Madrid_Masters-QF-Andy_Murray-Tomas_Berdych,2,S-DTL,2,0,0,0,0,0,2
20130607-M-Roland_Garros-SF-Novak_Djokovic-Rafael_Nadal,1,F-XC,122,24,4,8,12,57,65
20130607-M-Roland_Garros-SF-Novak_Djokovic-Rafael_Nadal,1,F-DTM,98,13,0,2,11,50,48
20130607-M-Roland_Garros-SF-Novak_Djokovic-Rafael_Nadal,1,F-DTL,11,5,2,1,2,6,5
20130607-M-Roland_Garros-SF-Novak_Djokovic-Rafael_Nadal,1,F-IO,77,22,13,3,6,41,36
20130607-M-Roland_Garros-SF-Novak_Djokovic-Rafael_Nadal,1,F-II,4,1,1,0,0,4,0
20130607-M-Roland_Garros-SF-Novak_Djokovic-Rafael_Nadal,1,B-XC,80,19,4,6,9,37,43
20130607-M-Roland_Garros-SF-Novak_Djokovic-Rafael_Nadal,1,B-DTM,114,13,0,2,11,49,65
20130607-M-Roland_Garros-SF-Novak_Djokovic-Rafael_Nadal,1,B-DTL,35,6,3,0,3,16,19
20130607-M-Roland_Garros-SF-Novak_Djokovic-Rafael_Nadal,1,B-IO,22,10,1,1,8,8,14
20130607-M-Roland_Garros-SF-Novak_Djokovic-Rafael_Nadal,1,S-DTM,1,0,0,0,0,1,0
20130607-M-Roland_Garros-SF-Novak_Djokovic-Rafael_Nadal,1,S-DTL,5,0,0,0,0,3,2
20130607-M-Roland_Garros-SF-Novak_Djokovic-Rafael_Nadal,1,S-IO,1,1,0,0,1,0,1
20130607-M-Roland_Garros-SF-Novak_Djokovic-Rafael_Nadal,2,F-XC,122,18,5,5,8,74,48
20130607-M-Roland_Garros-SF-Novak_Djokovic-Rafael_Nadal,2,F-DTM,103,8,0,1,7,50,53
20130607-M-Roland_Garros-SF-Novak_Djokovic-Rafael_Nadal,2,F-DTL,20,13,11,0,2,16,4
20130607-M-Roland_Garros-SF-Novak_Djokovic-Rafael_Nadal,2,F-IO,62,24,17,3,4,43,19
20130607-M-Roland_Garros-SF-Novak_Djokovic-Rafael_Nadal,2,F-II,6,3,0,1,2,2,4
20130607-M-Roland_Garros-SF-Novak_Djokovic-Rafael_Nadal,2,B-XC,56,16,7,4,5,34,22
20130607-M-Roland_Garros-SF-Novak_Djokovic-Rafael_Nadal,2,B-DTM,93,4,0,0,4,48,45
20130607-M-Roland_Garros-SF-Novak_Djokovic-Rafael_Nadal,2,B-DTL,35,6,3,3,0,21,14
20130607-M-Roland_Garros-SF-Novak_Djokovic-Rafael_Nadal,2,B-IO,24,4,1,1,2,11,13
20130607-M-Roland_Garros-SF-Novak_Djokovic-Rafael_Nadal,2,B-II,2,1,1,0,0,2,0
20130607-M-Roland_Garros-SF-Novak_Djokovic-Rafael_Nadal,2,S-XC,1,0,0,0,0,0,1
20130607-M-Roland_Garros-SF-Novak_Djokovic-Rafael_Nadal,2,S-DTM,27,2,0,0,2,10,17
20130607-M-Roland_Garros-SF-Novak_Djokovic-Rafael_Nadal,2,S-DTL,10,0,0,0,0,5,5
19960609-M-Roland_Garros-F-Michael_Stich-Yevgeny_Kafelnikov,1,F-XC,38,11,4,1,6,15,23
19960609-M-Roland_Garros-F-Michael_Stich-Yevgeny_Kafelnikov,1,F-DTM,22,0,0,0,0,9,13
19960609-M-Roland_Garros-F-Michael_Stich-Yevgeny_Kafelnikov,1,F-DTL,21,4,0,2,2,8,13
19960609-M-Roland_Garros-F-Michael_Stich-Yevgeny_Kafelnikov,1,F-IO,26,10,2,0,8,8,18
19960609-M-Roland_Garros-F-Michael_Stich-Yevgeny_Kafelnikov,1,F-II,3,2,2,0,0,2,1
19960609-M-Roland_Garros-F-Michael_Stich-Yevgeny_Kafelnikov,1,B-XC,61,9,4,1,4,28,33
19960609-M-Roland_Garros-F-Michael_Stich-Yevgeny_Kafelnikov,1,B-DTM,26,3,0,0,3,5,21
19960609-M-Roland_Garros-F-Michael_Stich-Yevgeny_Kafelnikov,1,B-DTL,18,5,1,1,3,6,12
19960609-M-Roland_Garros-F-Michael_Stich-Yevgeny_Kafelnikov,1,B-IO,8,6,2,0,4,2,6
19960609-M-Roland_Garros-F-Michael_Stich-Yevgeny_Kafelnikov,1,S-XC,34,2,0,0,2,15,19
19960609-M-Roland_Garros-F-Michael_Stich-Yevgeny_Kafelnikov,1,S-DTM,14,5,0,0,5,4,10
19960609-M-Roland_Garros-F-Michael_Stich-Yevgeny_Kafelnikov,1,S-DTL,7,1,0,0,1,2,5
19960609-M-Roland_Garros-F-Michael_Stich-Yevgeny_Kafelnikov,1,S-IO,2,1,0,0,1,1,1
19960609-M-Roland_Garros-F-Michael_Stich-Yevgeny_Kafelnikov,2,F-XC,62,14,3,6,5,40,22
19960609-M-Roland_Garros-F-Michael_Stich-Yevgeny_Kafelnikov,2,F-DTM,28,2,1,0,1,23,5
19960609-M-Roland_Garros-F-Michael_Stich-Yevgeny_Kafelnikov,2,F-DTL,18,8,3,1,4,9,9
19960609-M-Roland_Garros-F-Michael_Stich-Yevgeny_Kafelnikov,2,F-IO,23,8,2,2,4,12,11
19960609-M-Roland_Garros-F-Michael_Stich-Yevgeny_Kafelnikov,2,F-II,1,0,0,0,0,1,0
19960609-M-Roland_Garros-F-Michael_Stich-Yevgeny_Kafelnikov,2,B-XC,82,18,2,6,10,52,30
19960609-M-Roland_Garros-F-Michael_Stich-Yevgeny_Kafelnikov,2,B-DTM,23,0,0,0,0,12,11
19960609-M-Roland_Garros-F-Michael_Stich-Yevgeny_Kafelnikov,2,B-DTL,21,8,1,2,5,12,9
19960609-M-Roland_Garros-F-Michael_Stich-Yevgeny_Kafelnikov,2,B-IO,7,6,0,2,4,3,4
19960609-M-Roland_Garros-F-Michael_Stich-Yevgeny_Kafelnikov,2,S-XC,32,7,2,2,3,18,14
19960609-M-Roland_Garros-F-Michael_Stich-Yevgeny_Kafelnikov,2,S-DTM,8,2,1,0,1,4,4
19980607-M-Roland_Garros-F-Alex_Corretja-Carlos_Moya,1,F-XC,61,11,4,5,2,34,27
19980607-M-Roland_Garros-F-Alex_Corretja-Carlos_Moya,1,F-DTM,25,1,0,0,1,10,15
19980607-M-Roland_Garros-F-Alex_Corretja-Carlos_Moya,1,F-DTL,22,5,2,0,3,11,11
19980607-M-Roland_Garros-F-Alex_Corretja-Carlos_Moya,1,F-IO,48,6,1,0,5,21,27
19980607-M-Roland_Garros-F-Alex_Corretja-Carlos_Moya,1,F-II,8,2,1,0,1,4,4
19980607-M-Roland_Garros-F-Alex_Corretja-Carlos_Moya,1,B-XC,67,7,2,1,4,30,37
19980607-M-Roland_Garros-F-Alex_Corretja-Carlos_Moya,1,B-DTM,25,3,0,0,3,8,17
19980607-M-Roland_Garros-F-Alex_Corretja-Carlos_Moya,1,B-DTL,15,6,1,1,4,5,10
19980607-M-Roland_Garros-F-Alex_Corretja-Carlos_Moya,1,B-IO,2,1,1,0,0,1,1
19980607-M-Roland_Garros-F-Alex_Corretja-Carlos_Moya,1,B-II,1,0,0,0,0,0,1
19980607-M-Roland_Garros-F-Alex_Corretja-Carlos_Moya,1,S-XC,26,4,0,1,3,12,14
19980607-M-Roland_Garros-F-Alex_Corretja-Carlos_Moya,1,S-DTM,5,0,0,0,0,1,4
19980607-M-Roland_Garros-F-Alex_Corretja-Carlos_Moya,1,S-DTL,5,1,0,0,1,1,4
19980607-M-Roland_Garros-F-Alex_Corretja-Carlos_Moya,2,F-XC,45,6,1,3,2,27,18
19980607-M-Roland_Garros-F-Alex_Corretja-Carlos_Moya,2,F-DTM,47,7,0,1,6,22,25
19980607-M-Roland_Garros-F-Alex_Corretja-Carlos_Moya,2,F-DTL,22,6,2,1,3,13,9
19980607-M-Roland_Garros-F-Alex_Corretja-Carlos_Moya,2,F-IO,54,9,3,2,4,35,19
19980607-M-Roland_Garros-F-Alex_Corretja-Carlos_Moya,2,F-II,19,9,3,2,4,8,11
19980607-M-Roland_Garros-F-Alex_Corretja-Carlos_Moya,2,B-XC,61,7,1,1,5,34,27
19980607-M-Roland_Garros-F-Alex_Corretja-Carlos_Moya,2,B-DTM,33,4,0,1,3,15,18
19980607-M-Roland_Garros-F-Alex_Corretja-Carlos_Moya,2,B-DTL,11,5,2,1,2,7,4
19980607-M-Roland_Garros-F-Alex_Corretja-Carlos_Moya,2,B-IO,5,1,0,1,0,3,2
19980607-M-Roland_Garros-F-Alex_Corretja-Carlos_Moya,2,S-XC,5,1,1,0,0,2,3
19980607-M-Roland_Garros-F-Alex_Corretja-Carlos_Moya,2,S-DTL,2,0,0,0,0,0,2
20140529-M-Roland_Garros-R64-Rafael_Nadal-Dominic_Thiem,1,F-XC,85,9,1,4,4,57,28
20140529-M-Roland_Garros-R64-Rafael_Nadal-Dominic_Thiem,1,F-DTM,30,3,0,0,3,8,22
20140529-M-Roland_Garros-R64-Rafael_Nadal-Dominic_Thiem,1,F-DTL,22,10,3,5,2,17,5
20140529-M-Roland_Garros-R64-Rafael_Nadal-Dominic_Thiem,1,F-IO,32,9,1,5,3,18,14
20140529-M-Roland_Garros-R64-Rafael_Nadal-Dominic_Thiem,1,F-II,11,1,1,0,0,8,3
20140529-M-Roland_Garros-R64-Rafael_Nadal-Dominic_Thiem,1,B-XC,50,5,1,3,1,35,15
20140529-M-Roland_Garros-R64-Rafael_Nadal-Dominic_Thiem,1,B-DTM,34,1,1,0,0,20,14
20140529-M-Roland_Garros-R64-Rafael_Nadal-Dominic_Thiem,1,B-DTL,24,3,0,1,2,14,10
20140529-M-Roland_Garros-R64-Rafael_Nadal-Dominic_Thiem,1,B-IO,3,0,0,0,0,1,2
20140529-M-Roland_Garros-R64-Rafael_Nadal-Dominic_Thiem,1,S-DTM,4,1,0,1,0,1,3
20140529-M-Roland_Garros-R64-Rafael_Nadal-Dominic_Thiem,1,S-DTL,5,0,0,0,0,3,2
20140529-M-Roland_Garros-R64-Rafael_Nadal-Dominic_Thiem,1,S-IO,1,1,0,1,0,1,0
20140529-M-Roland_Garros-R64-Rafael_Nadal-Dominic_Thiem,2,F-XC,83,6,2,1,3,38,45
20140529-M-Roland_Garros-R64-Rafael_Nadal-Dominic_Thiem,2,F-DTM,30,4,0,2,2,14,16
20140529-M-Roland_Garros-R64-Rafael_Nadal-Dominic_Thiem,2,F-DTL,18,8,3,0,5,9,9
20140529-M-Roland_Garros-R64-Rafael_Nadal-Dominic_Thiem,2,F-IO,37,13,8,2,3,21,16
20140529-M-Roland_Garros-R64-Rafael_Nadal-Dominic_Thiem,2,F-II,9,1,1,0,0,3,6
20140529-M-Roland_Garros-R64-Rafael_Nadal-Dominic_Thiem,2,B-XC,48,14,4,2,8,19,29
20140529-M-Roland_Garros-R64-Rafael_Nadal-Dominic_Thiem,2,B-DTM,41,3,0,0,3,10,31
20140529-M-Roland_Garros-R64-Rafael_Nadal-Dominic_Thiem,2,B-DTL,20,9,1,1,7,5,15
20140529-M-Roland_Garros-R64-Rafael_Nadal-Dominic_Thiem,2,B-IO,2,0,0,0,0,1,1
20140529-M-Roland_Garros-R64-Rafael_Nadal-Dominic_Thiem,2,S-XC,2,0,0,0,0,0,2
20140529-M-Roland_Garros-R64-Rafael_Nadal-Dominic_Thiem,2,S-DTM,4,0,0,0,0,3,1
20060514-M-Rome_Masters-F-Roger_Federer-Rafael_Nadal,1,F-XC,197,41,7,15,19,98,99
20060514-M-Rome_Masters-F-Roger_Federer-Rafael_Nadal,1,F-DTM,30,6,0,2,4,12,18
20060514-M-Rome_Masters-F-Roger_Federer-Rafael_Nadal,1,F-DTL,53,26,9,1,16,24,29
20060514-M-Rome_Masters-F-Roger_Federer-Rafael_Nadal,1,F-IO,45,21,10,5,6,29,16
20060514-M-Rome_Masters-F-Roger_Federer-Rafael_Nadal,1,F-II,57,11,1,7,3,33,24
20060514-M-Rome_Masters-F-Roger_Federer-Rafael_Nadal,1,B-XC,69,14,2,5,7,32,37
20060514-M-Rome_Masters-F-Roger_Federer-Rafael_Nadal,1,B-DTM,59,3,0,1,2,18,41
20060514-M-Rome_Masters-F-Roger_Federer-Rafael_Nadal,1,B-DTL,66,6,1,0,5,37,29
20060514-M-Rome_Masters-F-Roger_Federer-Rafael_Nadal,1,S-XC,14,2,0,0,2,5,9
20060514-M-Rome_Masters-F-Roger_Federer-Rafael_Nadal,1,S-DTM,8,1,0,0,1,2,6
20060514-M-Rome_Masters-F-Roger_Federer-Rafael_Nadal,1,S-DTL,31,2,0,0,2,15,16
20060514-M-Rome_Masters-F-Roger_Federer-Rafael_Nadal,1,S-IO,2,0,0,0,0,0,2
20060514-M-Rome_Masters-F-Roger_Federer-Rafael_Nadal,2,F-XC,168,24,6,6,12,100,68
20060514-M-Rome_Masters-F-Roger_Federer-Rafael_Nadal,2,F-DTM,21,2,2,0,0,15,6
20060514-M-Rome_Masters-F-Roger_Federer-Rafael_Nadal,2,F-DTL,33,14,4,1,9,15,18
20060514-M-Rome_Masters-F-Roger_Federer-Rafael_Nadal,2,F-IO,64,22,12,6,4,46,18
20060514-M-Rome_Masters-F-Roger_Federer-Rafael_Nadal,2,F-II,36,3,0,3,0,24,12
20060514-M-Rome_Masters-F-Roger_Federer-Rafael_Nadal,2,B-XC,139,18,2,7,9,71,68
20060514-M-Rome_Masters-F-Roger_Federer-Rafael_Nadal,2,B-DTM,37,1,0,0,1,17,20
20060514-M-Rome_Masters-F-Roger_Federer-Rafael_Nadal,2,B-DTL,110,14,5,2,7,47,63
20060514-M-Rome_Masters-F-Roger_Federer-Rafael_Nadal,2,B-IO,7,2,0,1,1,4,3
20060514-M-Rome_Masters-F-Roger_Federer-Rafael_Nadal,2,S-XC,5,3,1,1,1,2,3
20060514-M-Rome_Masters-F-Roger_Federer-Rafael_Nadal,2,S-DTM,4,0,0,0,0,1,3
20060514-M-Rome_Masters-F-Roger_Federer-Rafael_Nadal,2,S-DTL,8,0,0,0,0,2,6
20090605-M-Roland_Garros-SF-Roger_Federer-Juan_Martin_Del_Potro,1,F-XC,57,19,5,10,4,29,28
20090605-M-Roland_Garros-SF-Roger_Federer-Juan_Martin_Del_Potro,1,F-DTM,38,4,0,2,2,16,22
20090605-M-Roland_Garros-SF-Roger_Federer-Juan_Martin_Del_Potro,1,F-DTL,24,8,7,1,0,16,8
20090605-M-Roland_Garros-SF-Roger_Federer-Juan_Martin_Del_Potro,1,F-IO,49,14,4,9,1,37,12
20090605-M-Roland_Garros-SF-Roger_Federer-Juan_Martin_Del_Potro,1,F-II,13,7,2,4,1,9,4
20090605-M-Roland_Garros-SF-Roger_Federer-Juan_Martin_Del_Potro,1,B-XC,48,6,0,4,2,24,24
20090605-M-Roland_Garros-SF-Roger_Federer-Juan_Martin_Del_Potro,1,B-DTM,41,2,0,0,2,18,23
20090605-M-Roland_Garros-SF-Roger_Federer-Juan_Martin_Del_Potro,1,B-DTL,19,7,6,0,1,14,5
20090605-M-Roland_Garros-SF-Roger_Federer-Juan_Martin_Del_Potro,1,B-IO,2,1,0,1,0,2,0
20090605-M-Roland_Garros-SF-Roger_Federer-Juan_Martin_Del_Potro,1,S-XC,28,2,0,1,1,13,15
20090605-M-Roland_Garros-SF-Roger_Federer-Juan_Martin_Del_Potro,1,S-DTM,12,1,0,1,0,4,8
20090605-M-Roland_Garros-SF-Roger_Federer-Juan_Martin_Del_Potro,1,S-DTL,5,1,1,0,0,3,2
20090605-M-Roland_Garros-SF-Roger_Federer-Juan_Martin_Del_Potro,2,F-XC,66,27,7,16,4,41,25
20090605-M-Roland_Garros-SF-Roger_Federer-Juan_Martin_Del_Potro,2,F-DTM,39,4,1,0,3,18,21
20090605-M-Roland_Garros-SF-Roger_Federer-Juan_Martin_Del_Potro,2,F-DTL,24,7,3,2,2,13,11
20090605-M-Roland_Garros-SF-Roger_Federer-Juan_Martin_Del_Potro,2,F-IO,61,14,6,5,3,34,27
20090605-M-Roland_Garros-SF-Roger_Federer-Juan_Martin_Del_Potro,2,F-II,1,1,1,0,0,1,0
20090605-M-Roland_Garros-SF-Roger_Federer-Juan_Martin_Del_Potro,2,B-XC,86,13,2,8,3,43,43
20090605-M-Roland_Garros-SF-Roger_Federer-Juan_Martin_Del_Potro,2,B-DTM,31,3,0,0,3,12,19
20090605-M-Roland_Garros-SF-Roger_Federer-Juan_Martin_Del_Potro,2,B-DTL,19,10,5,3,2,10,9
20090605-M-Roland_Garros-SF-Roger_Federer-Juan_Martin_Del_Potro,2,B-IO,10,5,1,2,2,6,4
20090605-M-Roland_Garros-SF-Roger_Federer-Juan_Martin_Del_Potro,2,S-XC,10,1,0,0,1,3,7
20090605-M-Roland_Garros-SF-Roger_Federer-Juan_Martin_Del_Potro,2,S-DTM,5,0,0,0,0,0,5
20090605-M-Roland_Garros-SF-Roger_Federer-Juan_Martin_Del_Potro,2,S-IO,1,0,0,0,0,0,1
20060319-M-Indian_Wells_Masters-F-Roger_Federer-James_Blake,1,F-XC,32,18,6,11,1,26,6
20060319-M-Indian_Wells_Masters-F-Roger_Federer-James_Blake,1,F-DTM,16,0,0,0,0,11,5
20060319-M-Indian_Wells_Masters-F-Roger_Federer-James_Blake,1,F-DTL,6,5,2,2,1,5,1
20060319-M-Indian_Wells_Masters-F-Roger_Federer-James_Blake,1,F-IO,28,9,5,1,3,16,12
20060319-M-Indian_Wells_Masters-F-Roger_Federer-James_Blake,1,F-II,4,2,0,1,1,3,1
20060319-M-Indian_Wells_Masters-F-Roger_Federer-James_Blake,1,B-XC,24,5,2,1,2,14,10
20060319-M-Indian_Wells_Masters-F-Roger_Federer-James_Blake,1,B-DTM,35,7,1,2,4,21,14
20060319-M-Indian_Wells_Masters-F-Roger_Federer-James_Blake,1,B-DTL,7,1,0,0,1,3,4
20060319-M-Indian_Wells_Masters-F-Roger_Federer-James_Blake,1,B-IO,3,1,1,0,0,1,2
20060319-M-Indian_Wells_Masters-F-Roger_Federer-James_Blake,1,S-XC,15,3,0,0,3,7,8
20060319-M-Indian_Wells_Masters-F-Roger_Federer-James_Blake,1,S-DTM,6,0,0,0,0,4,2
20060319-M-Indian_Wells_Masters-F-Roger_Federer-James_Blake,1,S-DTL,6,2,0,2,0,3,3
20060319-M-Indian_Wells_Masters-F-Roger_Federer-James_Blake,1,S-IO,4,1,0,1,0,4,0
20060319-M-Indian_Wells_Masters-F-Roger_Federer-James_Blake,2,F-XC,25,11,3,4,4,9,16
20060319-M-Indian_Wells_Masters-F-Roger_Federer-James_Blake,2,F-DTM,34,5,0,2,3,11,23
20060319-M-Indian_Wells_Masters-F-Roger_Federer-James_Blake,2,F-DTL,6,1,0,0,1,1,5
20060319-M-Indian_Wells_Masters-F-Roger_Federer-James_Blake,2,F-IO,41,12,2,4,6,19,22
20060319-M-Indian_Wells_Masters-F-Roger_Federer-James_Blake,2,F-II,4,3,2,1,0,3,1
20060319-M-Indian_Wells_Masters-F-Roger_Federer-James_Blake,2,B-XC,41,8,1,2,5,18,23
20060319-M-Indian_Wells_Masters-F-Roger_Federer-James_Blake,2,B-DTM,13,0,0,0,0,6,7
20060319-M-Indian_Wells_Masters-F-Roger_Federer-James_Blake,2,B-DTL,5,3,1,1,1,2,3
20060319-M-Indian_Wells_Masters-F-Roger_Federer-James_Blake,2,S-XC,5,0,0,0,0,2,3
20060319-M-Indian_Wells_Masters-F-Roger_Federer-James_Blake,2,S-DTM,9,0,0,0,0,4,5
20100821-M-Cincinnati_Masters-F-Mardy_Fish-Roger_Federer,1,F-XC,33,8,1,1,6,14,19
20100821-M-Cincinnati_Masters-F-Mardy_Fish-Roger_Federer,1,F-DTM,42,2,0,0,2,17,25
20100821-M-Cincinnati_Masters-F-Mardy_Fish-Roger_Federer,1,F-DTL,11,2,0,0,2,5,6
20100821-M-Cincinnati_Masters-F-Mardy_Fish-Roger_Federer,1,F-IO,18,7,2,1,4,8,10
20100821-M-Cincinnati_Masters-F-Mardy_Fish-Roger_Federer,1,F-II,1,1,0,0,1,0,1
20100821-M-Cincinnati_Masters-F-Mardy_Fish-Roger_Federer,1,B-XC,43,10,2,6,2,26,17
20100821-M-Cincinnati_Masters-F-Mardy_Fish-Roger_Federer,1,B-DTM,43,7,0,1,6,17,26
20100821-M-Cincinnati_Masters-F-Mardy_Fish-Roger_Federer,1,B-DTL,5,4,1,0,3,1,4
20100821-M-Cincinnati_Masters-F-Mardy_Fish-Roger_Federer,1,B-IO,5,3,1,0,2,2,3
20100821-M-Cincinnati_Masters-F-Mardy_Fish-Roger_Federer,1,S-XC,2,0,0,0,0,0,2
20100821-M-Cincinnati_Masters-F-Mardy_Fish-Roger_Federer,1,S-DTM,2,0,0,0,0,1,1
20100821-M-Cincinnati_Masters-F-Mardy_Fish-Roger_Federer,1,S-DTL,1,1,0,0,1,0,1
20100821-M-Cincinnati_Masters-F-Mardy_Fish-Roger_Federer,2,F-XC,43,13,6,4,3,27,16
20100821-M-Cincinnati_Masters-F-Mardy_Fish-Roger_Federer,2,F-DTM,31,4,0,0,4,15,16
20100821-M-Cincinnati_Masters-F-Mardy_Fish-Roger_Federer,2,F-DTL,9,4,1,0,3,5,4
20100821-M-Cincinnati_Masters-F-Mardy_Fish-Roger_Federer,2,F-IO,40,16,6,7,3,29,11
20100821-M-Cincinnati_Masters-F-Mardy_Fish-Roger_Federer,2,F-II,4,2,1,0,1,3,1
20100821-M-Cincinnati_Masters-F-Mardy_Fish-Roger_Federer,2,B-XC,25,6,0,1,5,10,15
20100821-M-Cincinnati_Masters-F-Mardy_Fish-Roger_Federer,2,B-DTM,28,4,0,1,3,15,13
20100821-M-Cincinnati_Masters-F-Mardy_Fish-Roger_Federer,2,B-DTL,8,6,2,2,2,5,3
20100821-M-Cincinnati_Masters-F-Mardy_Fish-Roger_Federer,2,B-IO,1,1,0,0,1,0,1
20100821-M-Cincinnati_Masters-F-Mardy_Fish-Roger_Federer,2,S-XC,8,2,0,0,2,4,4
20100821-M-Cincinnati_Masters-F-Mardy_Fish-Roger_Federer,2,S-DTM,14,2,0,0,2,6,8
20061022-M-Madrid_Masters-F-Roger_Federer-Fernando_Gonzalez,1,F-XC,25,12,5,2,5,16,9
20061022-M-Madrid_Masters-F-Roger_Federer-Fernando_Gonzalez,1,F-DTM,36,7,2,2,3,21,15
20061022-M-Madrid_Masters-F-Roger_Federer-Fernando_Gonzalez,1,F-DTL,2,1,1,0,0,2,0
20061022-M-Madrid_Masters-F-Roger_Federer-Fernando_Gonzalez,1,F-IO,19,7,3,3,1,14,5
20061022-M-Madrid_Masters-F-Roger_Federer-Fernando_Gonzalez,1,F-II,3,2,0,1,1,1,2
20061022-M-Madrid_Masters-F-Roger_Federer-Fernando_Gonzalez,1,B-XC,24,3,0,2,1,13,11
20061022-M-Madrid_Masters-F-Roger_Federer-Fernando_Gonzalez,1,B-DTM,27,4,0,0,4,13,14
20061022-M-Madrid_Masters-F-Roger_Federer-Fernando_Gonzalez,1,B-DTL,6,5,5,0,0,5,1
20061022-M-Madrid_Masters-F-Roger_Federer-Fernando_Gonzalez,1,B-IO,1,0,0,0,0,1,0
20061022-M-Madrid_Masters-F-Roger_Federer-Fernando_Gonzalez,1,S-XC,11,0,0,0,0,5,6
20061022-M-Madrid_Masters-F-Roger_Federer-Fernando_Gonzalez,1,S-DTM,13,2,0,0,2,6,7
20061022-M-Madrid_Masters-F-Roger_Federer-Fernando_Gonzalez,1,S-DTL,2,2,1,0,1,1,1
20061022-M-Madrid_Masters-F-Roger_Federer-Fernando_Gonzalez,2,F-XC,25,9,2,4,3,10,15
20061022-M-Madrid_Masters-F-Roger_Federer-Fernando_Gonzalez,2,F-DTM,16,5,1,0,4,4,12
20061022-M-Madrid_Masters-F-Roger_Federer-Fernando_Gonzalez,2,F-DTL,1,0,0,0,0,1,0
20061022-M-Madrid_Masters-F-Roger_Federer-Fernando_Gonzalez,2,F-IO,37,8,2,1,5,21,16
20061022-M-Madrid_Masters-F-Roger_Federer-Fernando_Gonzalez,2,F-II,5,3,1,1,1,3,2
20061022-M-Madrid_Masters-F-Roger_Federer-Fernando_Gonzalez,2,B-XC,17,6,1,2,3,8,9
20061022-M-Madrid_Masters-F-Roger_Federer-Fernando_Gonzalez,2,B-DTM,25,2,0,1,1,8,17
20061022-M-Madrid_Masters-F-Roger_Federer-Fernando_Gonzalez,2,B-DTL,6,4,0,0,4,1,5
20061022-M-Madrid_Masters-F-Roger_Federer-Fernando_Gonzalez,2,B-IO,3,2,1,0,1,1,2
20061022-M-Madrid_Masters-F-Roger_Federer-Fernando_Gonzalez,2,S-XC,20,1,0,1,0,10,10
20061022-M-Madrid_Masters-F-Roger_Federer-Fernando_Gonzalez,2,S-DTM,16,0,0,0,0,7,9
20061022-M-Madrid_Masters-F-Roger_Federer-Fernando_Gonzalez,2,S-DTL,1,0,0,0,0,0,1
20061022-M-Madrid_Masters-F-Roger_Federer-Fernando_Gonzalez,2,S-IO,1,0,0,0,0,0,1
20050127-M-Australian_Open-SF-Roger_Federer-Marat_Safin,1,F-XC,70,23,4,12,7,39,31
20050127-M-Australian_Open-SF-Roger_Federer-Marat_Safin,1,F-DTM,30,3,0,0,3,16,14
20050127-M-Australian_Open-SF-Roger_Federer-Marat_Safin,1,F-DTL,26,4,1,1,2,13,13
20050127-M-Australian_Open-SF-Roger_Federer-Marat_Safin,1,F-IO,34,14,7,3,4,21,13
20050127-M-Australian_Open-SF-Roger_Federer-Marat_Safin,1,F-II,9,6,2,2,2,5,4
20050127-M-Australian_Open-SF-Roger_Federer-Marat_Safin,1,B-XC,60,6,1,3,2,31,29
20050127-M-Australian_Open-SF-Roger_Federer-Marat_Safin,1,B-DTM,62,3,0,1,2,32,30
20050127-M-Australian_Open-SF-Roger_Federer-Marat_Safin,1,B-DTL,28,10,2,4,4,13,15
20050127-M-Australian_Open-SF-Roger_Federer-Marat_Safin,1,B-IO,5,2,1,0,1,2,3
20050127-M-Australian_Open-SF-Roger_Federer-Marat_Safin,1,S-XC,36,1,0,1,0,9,27
20050127-M-Australian_Open-SF-Roger_Federer-Marat_Safin,1,S-DTM,11,1,1,0,0,4,7
20050127-M-Australian_Open-SF-Roger_Federer-Marat_Safin,1,S-DTL,14,2,0,1,1,4,10
20050127-M-Australian_Open-SF-Roger_Federer-Marat_Safin,1,S-IO,1,0,0,0,0,0,1
20050127-M-Australian_Open-SF-Roger_Federer-Marat_Safin,2,F-XC,81,27,7,14,6,48,33
20050127-M-Australian_Open-SF-Roger_Federer-Marat_Safin,2,F-DTM,33,4,1,0,3,18,15
20050127-M-Australian_Open-SF-Roger_Federer-Marat_Safin,2,F-DTL,32,11,4,2,5,15,17
20050127-M-Australian_Open-SF-Roger_Federer-Marat_Safin,2,F-IO,43,12,2,5,5,27,16
20050127-M-Australian_Open-SF-Roger_Federer-Marat_Safin,2,F-II,3,2,0,0,2,1,2
20050127-M-Australian_Open-SF-Roger_Federer-Marat_Safin,2,B-XC,136,30,4,14,12,74,62
20050127-M-Australian_Open-SF-Roger_Federer-Marat_Safin,2,B-DTM,40,0,0,0,0,19,21
20050127-M-Australian_Open-SF-Roger_Federer-Marat_Safin,2,B-DTL,22,14,4,5,5,13,9
20050127-M-Australian_Open-SF-Roger_Federer-Marat_Safin,2,B-IO,11,4,1,1,2,6,5
20050127-M-Australian_Open-SF-Roger_Federer-Marat_Safin,2,B-II,1,0,0,0,0,1,0
20050127-M-Australian_Open-SF-Roger_Federer-Marat_Safin,2,S-XC,22,3,0,0,3,9,13
20050127-M-Australian_Open-SF-Roger_Federer-Marat_Safin,2,S-DTM,2,0,0,0,0,1,1
20050127-M-Australian_Open-SF-Roger_Federer-Marat_Safin,2,S-DTL,3,0,0,0,0,1,2
20160607-M-Stuttgart-R32-Viktor_Troicki-Florian_Mayer,1,F-XC,16,3,0,0,3,5,11
20160607-M-Stuttgart-R32-Viktor_Troicki-Florian_Mayer,1,F-DTM,3,0,0,0,0,1,2
20160607-M-Stuttgart-R32-Viktor_Troicki-Florian_Mayer,1,F-DTL,7,5,2,1,2,4,3
20160607-M-Stuttgart-R32-Viktor_Troicki-Florian_Mayer,1,F-IO,4,4,3,0,1,3,1
20160607-M-Stuttgart-R32-Viktor_Troicki-Florian_Mayer,1,B-XC,15,2,2,0,0,6,9
20160607-M-Stuttgart-R32-Viktor_Troicki-Florian_Mayer,1,B-DTM,6,1,0,0,1,2,4
20160607-M-Stuttgart-R32-Viktor_Troicki-Florian_Mayer,1,B-DTL,11,8,3,0,5,5,6
20160607-M-Stuttgart-R32-Viktor_Troicki-Florian_Mayer,1,B-IO,4,2,2,0,0,2,2
20160607-M-Stuttgart-R32-Viktor_Troicki-Florian_Mayer,1,S-XC,1,0,0,0,0,0,1
20160607-M-Stuttgart-R32-Viktor_Troicki-Florian_Mayer,1,S-DTM,4,2,0,0,2,0,4
20160607-M-Stuttgart-R32-Viktor_Troicki-Florian_Mayer,1,S-DTL,1,1,0,0,1,0,1
20160607-M-Stuttgart-R32-Viktor_Troicki-Florian_Mayer,1,S-IO,2,1,0,0,1,0,2
20160607-M-Stuttgart-R32-Viktor_Troicki-Florian_Mayer,2,F-XC,16,3,1,2,0,12,4
20160607-M-Stuttgart-R32-Viktor_Troicki-Florian_Mayer,2,F-DTM,6,1,0,0,1,1,5
20160607-M-Stuttgart-R32-Viktor_Troicki-Florian_Mayer,2,F-DTL,3,1,0,1,0,3,0
20160607-M-Stuttgart-R32-Viktor_Troicki-Florian_Mayer,2,F-IO,3,1,0,0,1,1,2
20160607-M-Stuttgart-R32-Viktor_Troicki-Florian_Mayer,2,B-XC,5,0,0,0,0,2,3
20160607-M-Stuttgart-R32-Viktor_Troicki-Florian_Mayer,2,B-DTM,4,0,0,0,0,3,1
20160607-M-Stuttgart-R32-Viktor_Troicki-Florian_Mayer,2,B-DTL,3,2,0,2,0,3,0
20160607-M-Stuttgart-R32-Viktor_Troicki-Florian_Mayer,2,B-IO,1,0,0,0,0,0,1
20160607-M-Stuttgart-R32-Viktor_Troicki-Florian_Mayer,2,S-XC,12,1,0,0,1,5,7
20160607-M-Stuttgart-R32-Viktor_Troicki-Florian_Mayer,2,S-DTM,7,1,0,0,1,4,3
20160607-M-Stuttgart-R32-Viktor_Troicki-Florian_Mayer,2,S-DTL,4,1,0,0,1,3,1
20160607-M-Stuttgart-R32-Viktor_Troicki-Florian_Mayer,2,S-IO,3,0,0,0,0,2,1
20020324-M-Miami_Masters-F-Roger_Federer-Andre_Agassi,1,F-XC,47,11,6,1,4,26,21
20020324-M-Miami_Masters-F-Roger_Federer-Andre_Agassi,1,F-DTM,45,9,0,2,7,25,20
20020324-M-Miami_Masters-F-Roger_Federer-Andre_Agassi,1,F-DTL,17,14,6,2,6,8,9
20020324-M-Miami_Masters-F-Roger_Federer-Andre_Agassi,1,F-IO,19,8,5,0,3,13,6
20020324-M-Miami_Masters-F-Roger_Federer-Andre_Agassi,1,F-II,2,2,1,0,1,1,1
20020324-M-Miami_Masters-F-Roger_Federer-Andre_Agassi,1,B-XC,24,5,1,0,4,15,9
20020324-M-Miami_Masters-F-Roger_Federer-Andre_Agassi,1,B-DTM,45,12,2,2,8,24,21
20020324-M-Miami_Masters-F-Roger_Federer-Andre_Agassi,1,B-DTL,6,3,0,0,3,3,3
20020324-M-Miami_Masters-F-Roger_Federer-Andre_Agassi,1,B-IO,5,1,0,0,1,1,4
20020324-M-Miami_Masters-F-Roger_Federer-Andre_Agassi,1,S-XC,11,1,0,1,0,4,7
20020324-M-Miami_Masters-F-Roger_Federer-Andre_Agassi,1,S-DTM,19,3,0,0,3,8,11
20020324-M-Miami_Masters-F-Roger_Federer-Andre_Agassi,1,S-DTL,4,0,0,0,0,2,2
20020324-M-Miami_Masters-F-Roger_Federer-Andre_Agassi,1,S-IO,1,0,0,0,0,0,1
20020324-M-Miami_Masters-F-Roger_Federer-Andre_Agassi,2,F-XC,62,16,3,6,7,32,30
20020324-M-Miami_Masters-F-Roger_Federer-Andre_Agassi,2,F-DTM,50,7,0,2,5,18,32
20020324-M-Miami_Masters-F-Roger_Federer-Andre_Agassi,2,F-DTL,11,3,1,1,1,6,5
20020324-M-Miami_Masters-F-Roger_Federer-Andre_Agassi,2,F-IO,20,6,0,2,4,10,10
20020324-M-Miami_Masters-F-Roger_Federer-Andre_Agassi,2,F-II,1,1,1,0,0,1,0
20020324-M-Miami_Masters-F-Roger_Federer-Andre_Agassi,2,B-XC,49,14,0,7,7,23,26
20020324-M-Miami_Masters-F-Roger_Federer-Andre_Agassi,2,B-DTM,27,1,0,0,1,14,13
20020324-M-Miami_Masters-F-Roger_Federer-Andre_Agassi,2,B-DTL,11,3,2,1,0,7,4
20020324-M-Miami_Masters-F-Roger_Federer-Andre_Agassi,2,B-IO,4,2,0,0,2,0,4
20020324-M-Miami_Masters-F-Roger_Federer-Andre_Agassi,2,S-XC,9,2,1,0,1,4,5
20020324-M-Miami_Masters-F-Roger_Federer-Andre_Agassi,2,S-DTM,5,0,0,0,0,1,4
20130921-M-Metz-SF-Jo_Wilfried_Tsonga-Florian_Mayer,1,F-XC,44,17,11,3,3,31,13
20130921-M-Metz-SF-Jo_Wilfried_Tsonga-Florian_Mayer,1,F-DTM,7,0,0,0,0,0,7
20130921-M-Metz-SF-Jo_Wilfried_Tsonga-Florian_Mayer,1,F-DTL,16,6,3,1,2,10,6
20130921-M-Metz-SF-Jo_Wilfried_Tsonga-Florian_Mayer,1,F-IO,30,9,4,1,4,19,11
20130921-M-Metz-SF-Jo_Wilfried_Tsonga-Florian_Mayer,1,F-II,6,3,1,2,0,4,2
20130921-M-Metz-SF-Jo_Wilfried_Tsonga-Florian_Mayer,1,B-XC,27,5,0,2,3,17,10
20130921-M-Metz-SF-Jo_Wilfried_Tsonga-Florian_Mayer,1,B-DTM,11,1,0,0,1,7,4
20130921-M-Metz-SF-Jo_Wilfried_Tsonga-Florian_Mayer,1,B-DTL,8,1,0,0,1,5,3
20130921-M-Metz-SF-Jo_Wilfried_Tsonga-Florian_Mayer,1,B-IO,1,1,0,0,1,0,1
20130921-M-Metz-SF-Jo_Wilfried_Tsonga-Florian_Mayer,1,B-II,1,1,0,0,1,0,1
20130921-M-Metz-SF-Jo_Wilfried_Tsonga-Florian_Mayer,1,S-XC,16,0,0,0,0,8,8
20130921-M-Metz-SF-Jo_Wilfried_Tsonga-Florian_Mayer,1,S-DTM,10,1,0,0,1,5,5
20130921-M-Metz-SF-Jo_Wilfried_Tsonga-Florian_Mayer,1,S-DTL,10,3,1,0,2,4,6
20130921-M-Metz-SF-Jo_Wilfried_Tsonga-Florian_Mayer,1,S-IO,1,0,0,0,0,0,1
20130921-M-Metz-SF-Jo_Wilfried_Tsonga-Florian_Mayer,2,F-XC,37,11,3,5,3,19,18
20130921-M-Metz-SF-Jo_Wilfried_Tsonga-Florian_Mayer,2,F-DTM,10,1,0,0,1,4,6
20130921-M-Metz-SF-Jo_Wilfried_Tsonga-Florian_Mayer,2,F-DTL,9,2,1,0,1,5,4
20130921-M-Metz-SF-Jo_Wilfried_Tsonga-Florian_Mayer,2,F-IO,12,3,0,1,2,4,8
20130921-M-Metz-SF-Jo_Wilfried_Tsonga-Florian_Mayer,2,F-II,1,1,0,0,1,0,1
20130921-M-Metz-SF-Jo_Wilfried_Tsonga-Florian_Mayer,2,B-XC,38,8,4,2,2,17,21
20130921-M-Metz-SF-Jo_Wilfried_Tsonga-Florian_Mayer,2,B-DTM,8,0,0,0,0,6,2
20130921-M-Metz-SF-Jo_Wilfried_Tsonga-Florian_Mayer,2,B-DTL,11,2,0,1,1,5,6
20130921-M-Metz-SF-Jo_Wilfried_Tsonga-Florian_Mayer,2,B-IO,2,0,0,0,0,2,0
20130921-M-Metz-SF-Jo_Wilfried_Tsonga-Florian_Mayer,2,S-XC,32,2,0,1,1,13,19
20130921-M-Metz-SF-Jo_Wilfried_Tsonga-Florian_Mayer,2,S-DTM,6,0,0,0,0,2,4
20130921-M-Metz-SF-Jo_Wilfried_Tsonga-Florian_Mayer,2,S-DTL,3,0,0,0,0,1,2
20130921-M-Metz-SF-Jo_Wilfried_Tsonga-Florian_Mayer,2,S-IO,1,0,0,0,0,0,1
20170102-M-Doha-R32-Vasek_Pospisil-Fernando_Verdasco,1,F-XC,22,6,2,2,2,10,12
20170102-M-Doha-R32-Vasek_Pospisil-Fernando_Verdasco,1,F-DTM,21,9,0,0,9,3,18
20170102-M-Doha-R32-Vasek_Pospisil-Fernando_Verdasco,1,F-DTL,1,1,0,0,1,0,1
20170102-M-Doha-R32-Vasek_Pospisil-Fernando_Verdasco,1,F-IO,13,6,2,1,3,4,9
20170102-M-Doha-R32-Vasek_Pospisil-Fernando_Verdasco,1,B-XC,10,1,0,0,1,3,7
20170102-M-Doha-R32-Vasek_Pospisil-Fernando_Verdasco,1,B-DTM,23,3,0,0,3,6,17
20170102-M-Doha-R32-Vasek_Pospisil-Fernando_Verdasco,1,B-DTL,1,0,0,0,0,0,1
20170102-M-Doha-R32-Vasek_Pospisil-Fernando_Verdasco,1,S-XC,1,0,0,0,0,0,1
20170102-M-Doha-R32-Vasek_Pospisil-Fernando_Verdasco,1,S-DTM,4,0,0,0,0,1,3
20170102-M-Doha-R32-Vasek_Pospisil-Fernando_Verdasco,1,S-DTL,4,0,0,0,0,1,3
20170102-M-Doha-R32-Vasek_Pospisil-Fernando_Verdasco,1,S-IO,1,0,0,0,0,0,1
20170102-M-Doha-R32-Vasek_Pospisil-Fernando_Verdasco,2,F-XC,33,5,0,4,1,26,7
20170102-M-Doha-R32-Vasek_Pospisil-Fernando_Verdasco,2,F-DTM,13,4,0,0,4,3,10
20170102-M-Doha-R32-Vasek_Pospisil-Fernando_Verdasco,2,F-DTL,8,4,3,1,0,7,1
20170102-M-Doha-R32-Vasek_Pospisil-Fernando_Verdasco,2,F-IO,23,14,5,5,4,16,7
20170102-M-Doha-R32-Vasek_Pospisil-Fernando_Verdasco,2,B-XC,10,4,1,2,1,7,3
20170102-M-Doha-R32-Vasek_Pospisil-Fernando_Verdasco,2,B-DTM,14,2,0,0,2,10,4
20170102-M-Doha-R32-Vasek_Pospisil-Fernando_Verdasco,2,B-DTL,4,0,0,0,0,3,1
20170102-M-Doha-R32-Vasek_Pospisil-Fernando_Verdasco,2,B-IO,2,0,0,0,0,2,0
20170102-M-Doha-R32-Vasek_Pospisil-Fernando_Verdasco,2,S-DTM,3,1,0,0,1,2,1
20170102-M-Doha-R32-Vasek_Pospisil-Fernando_Verdasco,2,S-DTL,1,0,0,0,0,1,0
20170102-M-Doha-R32-Vasek_Pospisil-Fernando_Verdasco,2,S-II,1,0,0,0,0,1,0
20150526-M-Roland_Garros-R128-Richard_Gasquet-Germain_Gigounon,1,F-XC,39,13,6,1,6,23,16
20150526-M-Roland_Garros-R128-Richard_Gasquet-Germain_Gigounon,1,F-DTM,35,1,0,0,1,21,14
20150526-M-Roland_Garros-R128-Richard_Gasquet-Germain_Gigounon,1,F-DTL,24,6,3,0,3,14,10
20150526-M-Roland_Garros-R128-Richard_Gasquet-Germain_Gigounon,1,F-IO,33,7,1,3,3,22,11
20150526-M-Roland_Garros-R128-Richard_Gasquet-Germain_Gigounon,1,F-II,1,1,1,0,0,1,0
20150526-M-Roland_Garros-R128-Richard_Gasquet-Germain_Gigounon,1,B-XC,76,4,1,3,0,51,25
20150526-M-Roland_Garros-R128-Richard_Gasquet-Germain_Gigounon,1,B-DTM,14,0,0,0,0,9,5
20150526-M-Roland_Garros-R128-Richard_Gasquet-Germain_Gigounon,1,B-DTL,10,6,5,0,1,8,2
20150526-M-Roland_Garros-R128-Richard_Gasquet-Germain_Gigounon,1,B-IO,6,2,0,0,2,4,2
20150526-M-Roland_Garros-R128-Richard_Gasquet-Germain_Gigounon,1,S-XC,4,0,0,0,0,1,3
20150526-M-Roland_Garros-R128-Richard_Gasquet-Germain_Gigounon,1,S-DTM,2,0,0,0,0,1,1
20150526-M-Roland_Garros-R128-Richard_Gasquet-Germain_Gigounon,2,F-XC,48,11,0,1,10,16,32
20150526-M-Roland_Garros-R128-Richard_Gasquet-Germain_Gigounon,2,F-DTM,15,2,0,0,2,7,8
20150526-M-Roland_Garros-R128-Richard_Gasquet-Germain_Gigounon,2,F-DTL,4,0,0,0,0,1,3
20150526-M-Roland_Garros-R128-Richard_Gasquet-Germain_Gigounon,2,F-IO,16,4,1,0,3,5,11
20150526-M-Roland_Garros-R128-Richard_Gasquet-Germain_Gigounon,2,F-II,3,0,0,0,0,3,0
20150526-M-Roland_Garros-R128-Richard_Gasquet-Germain_Gigounon,2,B-XC,70,8,1,1,6,23,47
20150526-M-Roland_Garros-R128-Richard_Gasquet-Germain_Gigounon,2,B-DTM,52,3,1,0,2,16,36
20150526-M-Roland_Garros-R128-Richard_Gasquet-Germain_Gigounon,2,B-DTL,19,5,5,0,0,11,8
20150526-M-Roland_Garros-R128-Richard_Gasquet-Germain_Gigounon,2,B-IO,7,3,1,1,1,5,2
20150526-M-Roland_Garros-R128-Richard_Gasquet-Germain_Gigounon,2,S-XC,11,2,1,0,1,5,6
20150526-M-Roland_Garros-R128-Richard_Gasquet-Germain_Gigounon,2,S-DTM,7,1,1,0,0,2,5
20150526-M-Roland_Garros-R128-Richard_Gasquet-Germain_Gigounon,2,S-DTL,3,1,1,0,0,1,2
20101024-M-Stockholm-F-Roger_Federer-Florian_Mayer,1,F-XC,38,14,6,3,5,23,15
20101024-M-Stockholm-F-Roger_Federer-Florian_Mayer,1,F-DTM,13,0,0,0,0,12,1
20101024-M-Stockholm-F-Roger_Federer-Florian_Mayer,1,F-DTL,15,5,1,3,1,9,6
20101024-M-Stockholm-F-Roger_Federer-Florian_Mayer,1,F-IO,13,4,2,2,0,9,4
20101024-M-Stockholm-F-Roger_Federer-Florian_Mayer,1,F-II,5,2,0,0,2,1,4
20101024-M-Stockholm-F-Roger_Federer-Florian_Mayer,1,B-XC,21,5,2,0,3,10,11
20101024-M-Stockholm-F-Roger_Federer-Florian_Mayer,1,B-DTM,10,3,0,0,3,4,6
20101024-M-Stockholm-F-Roger_Federer-Florian_Mayer,1,B-DTL,5,2,1,1,0,4,1
20101024-M-Stockholm-F-Roger_Federer-Florian_Mayer,1,S-XC,12,3,1,2,0,8,4
20101024-M-Stockholm-F-Roger_Federer-Florian_Mayer,1,S-DTM,2,0,0,0,0,2,0
20101024-M-Stockholm-F-Roger_Federer-Florian_Mayer,1,S-DTL,3,0,0,0,0,1,2
20101024-M-Stockholm-F-Roger_Federer-Florian_Mayer,2,F-XC,26,4,1,3,0,15,11
20101024-M-Stockholm-F-Roger_Federer-Florian_Mayer,2,F-DTM,8,0,0,0,0,3,5
20101024-M-Stockholm-F-Roger_Federer-Florian_Mayer,2,F-DTL,9,1,0,0,1,4,5
20101024-M-Stockholm-F-Roger_Federer-Florian_Mayer,2,F-IO,11,1,1,0,0,4,7
20101024-M-Stockholm-F-Roger_Federer-Florian_Mayer,2,F-II,2,0,0,0,0,1,1
20101024-M-Stockholm-F-Roger_Federer-Florian_Mayer,2,B-XC,25,7,1,2,4,13,12
20101024-M-Stockholm-F-Roger_Federer-Florian_Mayer,2,B-DTM,9,0,0,0,0,3,6
20101024-M-Stockholm-F-Roger_Federer-Florian_Mayer,2,B-DTL,5,1,1,0,0,2,3
20101024-M-Stockholm-F-Roger_Federer-Florian_Mayer,2,B-IO,2,0,0,0,0,1,1
20101024-M-Stockholm-F-Roger_Federer-Florian_Mayer,2,S-XC,10,2,0,1,1,4,6
20101024-M-Stockholm-F-Roger_Federer-Florian_Mayer,2,S-DTM,4,1,0,0,1,0,4
20101024-M-Stockholm-F-Roger_Federer-Florian_Mayer,2,S-DTL,5,0,0,0,0,3,2
20170104-M-Doha-R16-Jo_Wilfried_Tsonga-Dustin_Brown,1,F-XC,14,7,5,1,1,11,3
20170104-M-Doha-R16-Jo_Wilfried_Tsonga-Dustin_Brown,1,F-DTM,1,1,0,1,0,1,0
20170104-M-Doha-R16-Jo_Wilfried_Tsonga-Dustin_Brown,1,F-DTL,8,5,1,2,2,4,4
20170104-M-Doha-R16-Jo_Wilfried_Tsonga-Dustin_Brown,1,F-IO,4,1,0,1,0,3,1
20170104-M-Doha-R16-Jo_Wilfried_Tsonga-Dustin_Brown,1,F-II,4,3,1,1,1,3,1
20170104-M-Doha-R16-Jo_Wilfried_Tsonga-Dustin_Brown,1,B-XC,6,3,1,0,2,4,2
20170104-M-Doha-R16-Jo_Wilfried_Tsonga-Dustin_Brown,1,B-DTM,1,0,0,0,0,1,0
20170104-M-Doha-R16-Jo_Wilfried_Tsonga-Dustin_Brown,1,B-DTL,3,2,1,1,0,3,0
20170104-M-Doha-R16-Jo_Wilfried_Tsonga-Dustin_Brown,1,S-XC,8,1,0,1,0,8,0
20170104-M-Doha-R16-Jo_Wilfried_Tsonga-Dustin_Brown,1,S-DTM,4,0,0,0,0,1,3
20170104-M-Doha-R16-Jo_Wilfried_Tsonga-Dustin_Brown,2,F-XC,16,2,0,0,2,5,11
20170104-M-Doha-R16-Jo_Wilfried_Tsonga-Dustin_Brown,2,F-DTM,3,1,0,0,1,1,2
20170104-M-Doha-R16-Jo_Wilfried_Tsonga-Dustin_Brown,2,F-DTL,3,1,0,0,1,0,3
20170104-M-Doha-R16-Jo_Wilfried_Tsonga-Dustin_Brown,2,F-IO,6,1,0,0,1,3,3
20170104-M-Doha-R16-Jo_Wilfried_Tsonga-Dustin_Brown,2,F-II,2,2,0,1,1,1,1
20170104-M-Doha-R16-Jo_Wilfried_Tsonga-Dustin_Brown,2,B-XC,12,2,1,0,1,2,10
20170104-M-Doha-R16-Jo_Wilfried_Tsonga-Dustin_Brown,2,B-DTM,1,0,0,0,0,0,1
20170104-M-Doha-R16-Jo_Wilfried_Tsonga-Dustin_Brown,2,B-DTL,6,4,1,1,2,2,4
20170104-M-Doha-R16-Jo_Wilfried_Tsonga-Dustin_Brown,2,B-IO,2,2,0,1,1,1,1
20170104-M-Doha-R16-Jo_Wilfried_Tsonga-Dustin_Brown,2,S-XC,2,0,0,0,0,0,2
20170104-M-Doha-R16-Jo_Wilfried_Tsonga-Dustin_Brown,2,S-DTM,1,0,0,0,0,0,1
20170104-M-Doha-R16-Jo_Wilfried_Tsonga-Dustin_Brown,2,S-DTL,1,0,0,0,0,0,1
20040516-M-Hamburg_Masters-F-Roger_Federer-Guillermo_Coria,1,F-XC,41,20,9,5,6,27,14
20040516-M-Hamburg_Masters-F-Roger_Federer-Guillermo_Coria,1,F-DTM,43,9,0,1,8,21,22
20040516-M-Hamburg_Masters-F-Roger_Federer-Guillermo_Coria,1,F-DTL,2,2,1,0,1,1,1
20040516-M-Hamburg_Masters-F-Roger_Federer-Guillermo_Coria,1,F-IO,28,12,3,3,6,17,11
20040516-M-Hamburg_Masters-F-Roger_Federer-Guillermo_Coria,1,F-II,7,5,3,1,1,6,1
20040516-M-Hamburg_Masters-F-Roger_Federer-Guillermo_Coria,1,B-XC,41,2,0,1,1,24,17
20040516-M-Hamburg_Masters-F-Roger_Federer-Guillermo_Coria,1,B-DTM,48,3,0,0,3,27,21
20040516-M-Hamburg_Masters-F-Roger_Federer-Guillermo_Coria,1,B-DTL,9,3,0,1,2,3,6
20040516-M-Hamburg_Masters-F-Roger_Federer-Guillermo_Coria,1,B-IO,4,3,2,0,1,3,1
20040516-M-Hamburg_Masters-F-Roger_Federer-Guillermo_Coria,1,S-XC,19,3,1,0,2,13,6
20040516-M-Hamburg_Masters-F-Roger_Federer-Guillermo_Coria,1,S-DTM,16,2,0,0,2,9,7
20040516-M-Hamburg_Masters-F-Roger_Federer-Guillermo_Coria,1,S-DTL,1,0,0,0,0,0,1
20040516-M-Hamburg_Masters-F-Roger_Federer-Guillermo_Coria,2,F-XC,15,3,0,0,3,2,13
20040516-M-Hamburg_Masters-F-Roger_Federer-Guillermo_Coria,2,F-DTM,64,5,0,3,2,33,31
20040516-M-Hamburg_Masters-F-Roger_Federer-Guillermo_Coria,2,F-DTL,7,0,0,0,0,3,4
20040516-M-Hamburg_Masters-F-Roger_Federer-Guillermo_Coria,2,F-IO,39,13,1,3,9,15,24
20040516-M-Hamburg_Masters-F-Roger_Federer-Guillermo_Coria,2,F-II,3,3,2,1,0,3,0
20040516-M-Hamburg_Masters-F-Roger_Federer-Guillermo_Coria,2,B-XC,74,11,3,2,6,33,41
20040516-M-Hamburg_Masters-F-Roger_Federer-Guillermo_Coria,2,B-DTM,28,5,0,1,4,13,15
20040516-M-Hamburg_Masters-F-Roger_Federer-Guillermo_Coria,2,B-DTL,10,7,1,4,2,7,3
20040516-M-Hamburg_Masters-F-Roger_Federer-Guillermo_Coria,2,B-IO,8,2,0,0,2,2,6
20040516-M-Hamburg_Masters-F-Roger_Federer-Guillermo_Coria,2,S-XC,4,1,1,0,0,1,3
20040516-M-Hamburg_Masters-F-Roger_Federer-Guillermo_Coria,2,S-DTM,1,0,0,0,0,0,1
20040516-M-Hamburg_Masters-F-Roger_Federer-Guillermo_Coria,2,S-DTL,1,0,0,0,0,1,0
20170107-M-Doha-F-Novak_Djokovic-Andy_Murray,1,F-XC,80,6,1,3,2,38,42
20170107-M-Doha-F-Novak_Djokovic-Andy_Murray,1,F-DTM,29,1,0,0,1,10,19
20170107-M-Doha-F-Novak_Djokovic-Andy_Murray,1,F-DTL,50,7,4,0,3,26,24
20170107-M-Doha-F-Novak_Djokovic-Andy_Murray,1,F-IO,37,2,2,0,0,25,12
20170107-M-Doha-F-Novak_Djokovic-Andy_Murray,1,F-II,11,3,2,1,0,8,3
20170107-M-Doha-F-Novak_Djokovic-Andy_Murray,1,B-XC,109,8,1,4,3,60,49
20170107-M-Doha-F-Novak_Djokovic-Andy_Murray,1,B-DTM,72,3,0,0,3,26,46
20170107-M-Doha-F-Novak_Djokovic-Andy_Murray,1,B-DTL,49,9,1,3,5,23,26
20170107-M-Doha-F-Novak_Djokovic-Andy_Murray,1,B-IO,12,1,1,0,0,7,5
20170107-M-Doha-F-Novak_Djokovic-Andy_Murray,1,S-XC,28,2,0,1,1,12,16
20170107-M-Doha-F-Novak_Djokovic-Andy_Murray,1,S-DTM,11,0,0,0,0,5,6
20170107-M-Doha-F-Novak_Djokovic-Andy_Murray,1,S-DTL,3,0,0,0,0,0,3
20170107-M-Doha-F-Novak_Djokovic-Andy_Murray,2,F-XC,104,9,1,2,6,60,44
20170107-M-Doha-F-Novak_Djokovic-Andy_Murray,2,F-DTM,28,3,1,0,2,14,14
20170107-M-Doha-F-Novak_Djokovic-Andy_Murray,2,F-DTL,35,4,0,1,3,17,18
20170107-M-Doha-F-Novak_Djokovic-Andy_Murray,2,F-IO,58,11,2,4,5,35,23
20170107-M-Doha-F-Novak_Djokovic-Andy_Murray,2,F-II,2,0,0,0,0,1,1
20170107-M-Doha-F-Novak_Djokovic-Andy_Murray,2,B-XC,155,19,2,5,12,76,79
20170107-M-Doha-F-Novak_Djokovic-Andy_Murray,2,B-DTM,41,3,1,0,2,21,20
20170107-M-Doha-F-Novak_Djokovic-Andy_Murray,2,B-DTL,14,4,1,2,1,8,6
20170107-M-Doha-F-Novak_Djokovic-Andy_Murray,2,B-IO,3,0,0,0,0,2,1
20170107-M-Doha-F-Novak_Djokovic-Andy_Murray,2,S-XC,24,0,0,0,0,12,12
20170107-M-Doha-F-Novak_Djokovic-Andy_Murray,2,S-DTM,11,2,1,0,1,3,8
20170107-M-Doha-F-Novak_Djokovic-Andy_Murray,2,S-DTL,4,0,0,0,0,3,1
20170112-M-Auckland-QF-Steve_Johnson-John_Isner,1,F-XC,19,7,4,1,2,16,3
20170112-M-Auckland-QF-Steve_Johnson-John_Isner,1,F-DTM,7,1,0,0,1,4,3
20170112-M-Auckland-QF-Steve_Johnson-John_Isner,1,F-DTL,3,1,1,0,0,1,2
20170112-M-Auckland-QF-Steve_Johnson-John_Isner,1,F-IO,23,9,3,4,2,18,5
20170112-M-Auckland-QF-Steve_Johnson-John_Isner,1,F-II,3,3,2,1,0,3,0
20170112-M-Auckland-QF-Steve_Johnson-John_Isner,1,B-XC,3,3,2,0,1,2,1
20170112-M-Auckland-QF-Steve_Johnson-John_Isner,1,B-DTM,13,1,0,0,1,5,8
20170112-M-Auckland-QF-Steve_Johnson-John_Isner,1,B-DTL,10,8,2,2,4,5,5
20170112-M-Auckland-QF-Steve_Johnson-John_Isner,1,S-XC,26,6,0,1,5,13,13
20170112-M-Auckland-QF-Steve_Johnson-John_Isner,1,S-DTM,6,0,0,0,0,4,2
20170112-M-Auckland-QF-Steve_Johnson-John_Isner,1,S-DTL,1,0,0,0,0,0,1
20170112-M-Auckland-QF-Steve_Johnson-John_Isner,2,F-XC,10,4,1,3,0,7,3
20170112-M-Auckland-QF-Steve_Johnson-John_Isner,2,F-DTM,8,0,0,0,0,1,7
20170112-M-Auckland-QF-Steve_Johnson-John_Isner,2,F-DTL,9,4,0,1,3,2,7
20170112-M-Auckland-QF-Steve_Johnson-John_Isner,2,F-IO,33,7,3,2,2,16,17
20170112-M-Auckland-QF-Steve_Johnson-John_Isner,2,F-II,3,3,0,1,2,1,2
20170112-M-Auckland-QF-Steve_Johnson-John_Isner,2,B-XC,10,3,0,2,1,4,6
20170112-M-Auckland-QF-Steve_Johnson-John_Isner,2,B-DTM,6,1,0,0,1,1,5
20170112-M-Auckland-QF-Steve_Johnson-John_Isner,2,B-DTL,8,5,2,0,3,3,5
20170112-M-Auckland-QF-Steve_Johnson-John_Isner,2,B-IO,1,1,1,0,0,1,0
20170112-M-Auckland-QF-Steve_Johnson-John_Isner,2,S-XC,6,1,0,0,1,2,4
20170112-M-Auckland-QF-Steve_Johnson-John_Isner,2,S-DTM,5,1,0,0,1,1,4
20000514-M-Rome_Masters-F-Magnus_Norman-Gustavo_Kuerten,1,F-XC,62,14,5,3,6,33,29
20000514-M-Rome_Masters-F-Magnus_Norman-Gustavo_Kuerten,1,F-DTM,18,1,0,0,1,8,10
20000514-M-Rome_Masters-F-Magnus_Norman-Gustavo_Kuerten,1,F-DTL,45,13,5,1,7,22,23
20000514-M-Rome_Masters-F-Magnus_Norman-Gustavo_Kuerten,1,F-IO,59,13,3,3,7,33,26
20000514-M-Rome_Masters-F-Magnus_Norman-Gustavo_Kuerten,1,F-II,9,4,2,1,1,7,2
20000514-M-Rome_Masters-F-Magnus_Norman-Gustavo_Kuerten,1,B-XC,116,16,6,4,6,72,44
20000514-M-Rome_Masters-F-Magnus_Norman-Gustavo_Kuerten,1,B-DTM,17,0,0,0,0,8,9
20000514-M-Rome_Masters-F-Magnus_Norman-Gustavo_Kuerten,1,B-DTL,24,7,1,1,5,10,14
20000514-M-Rome_Masters-F-Magnus_Norman-Gustavo_Kuerten,1,B-IO,2,2,1,0,1,1,1
20000514-M-Rome_Masters-F-Magnus_Norman-Gustavo_Kuerten,1,S-XC,10,0,0,0,0,5,5
20000514-M-Rome_Masters-F-Magnus_Norman-Gustavo_Kuerten,1,S-DTM,4,0,0,0,0,2,2
20000514-M-Rome_Masters-F-Magnus_Norman-Gustavo_Kuerten,1,S-DTL,3,0,0,0,0,2,1
20000514-M-Rome_Masters-F-Magnus_Norman-Gustavo_Kuerten,2,F-XC,81,18,10,1,7,43,38
20000514-M-Rome_Masters-F-Magnus_Norman-Gustavo_Kuerten,2,F-DTM,17,2,0,0,2,6,11
20000514-M-Rome_Masters-F-Magnus_Norman-Gustavo_Kuerten,2,F-DTL,23,8,3,3,2,10,13
20000514-M-Rome_Masters-F-Magnus_Norman-Gustavo_Kuerten,2,F-IO,44,10,1,3,6,19,25
20000514-M-Rome_Masters-F-Magnus_Norman-Gustavo_Kuerten,2,F-II,11,5,0,1,4,5,6
20000514-M-Rome_Masters-F-Magnus_Norman-Gustavo_Kuerten,2,B-XC,126,19,4,3,12,52,74
20000514-M-Rome_Masters-F-Magnus_Norman-Gustavo_Kuerten,2,B-DTM,17,1,0,0,1,6,11
20000514-M-Rome_Masters-F-Magnus_Norman-Gustavo_Kuerten,2,B-DTL,35,18,4,3,11,18,17
20000514-M-Rome_Masters-F-Magnus_Norman-Gustavo_Kuerten,2,B-IO,2,0,0,0,0,1,1
20000514-M-Rome_Masters-F-Magnus_Norman-Gustavo_Kuerten,2,S-XC,18,1,0,1,0,11,7
20000514-M-Rome_Masters-F-Magnus_Norman-Gustavo_Kuerten,2,S-DTM,3,0,0,0,0,0,3
20000514-M-Rome_Masters-F-Magnus_Norman-Gustavo_Kuerten,2,S-DTL,1,1,0,0,1,0,1
20101121-M-Tour_Finals-RR-Andy_Roddick-Rafael_Nadal,1,F-XC,55,6,1,3,2,26,29
20101121-M-Tour_Finals-RR-Andy_Roddick-Rafael_Nadal,1,F-DTM,14,1,0,0,1,6,8
20101121-M-Tour_Finals-RR-Andy_Roddick-Rafael_Nadal,1,F-DTL,7,3,0,1,2,2,5
20101121-M-Tour_Finals-RR-Andy_Roddick-Rafael_Nadal,1,F-IO,23,6,1,2,3,7,16
20101121-M-Tour_Finals-RR-Andy_Roddick-Rafael_Nadal,1,F-II,3,2,0,1,1,1,2
20101121-M-Tour_Finals-RR-Andy_Roddick-Rafael_Nadal,1,B-XC,72,9,0,1,8,17,55
20101121-M-Tour_Finals-RR-Andy_Roddick-Rafael_Nadal,1,B-DTM,35,4,0,1,3,13,22
20101121-M-Tour_Finals-RR-Andy_Roddick-Rafael_Nadal,1,B-DTL,21,2,1,1,0,7,14
20101121-M-Tour_Finals-RR-Andy_Roddick-Rafael_Nadal,1,B-IO,5,0,0,0,0,2,3
20101121-M-Tour_Finals-RR-Andy_Roddick-Rafael_Nadal,1,S-XC,2,0,0,0,0,1,1
20101121-M-Tour_Finals-RR-Andy_Roddick-Rafael_Nadal,1,S-DTM,1,0,0,0,0,0,1
20101121-M-Tour_Finals-RR-Andy_Roddick-Rafael_Nadal,1,S-DTL,10,2,0,1,1,4,6
20101121-M-Tour_Finals-RR-Andy_Roddick-Rafael_Nadal,1,S-IO,3,0,0,0,0,2,1
20101121-M-Tour_Finals-RR-Andy_Roddick-Rafael_Nadal,2,F-XC,104,13,3,4,6,73,31
20101121-M-Tour_Finals-RR-Andy_Roddick-Rafael_Nadal,2,F-DTM,31,4,0,0,4,18,13
20101121-M-Tour_Finals-RR-Andy_Roddick-Rafael_Nadal,2,F-DTL,29,10,7,0,3,22,7
20101121-M-Tour_Finals-RR-Andy_Roddick-Rafael_Nadal,2,F-IO,23,9,3,1,5,14,9
20101121-M-Tour_Finals-RR-Andy_Roddick-Rafael_Nadal,2,F-II,20,10,3,4,3,13,7
20101121-M-Tour_Finals-RR-Andy_Roddick-Rafael_Nadal,2,B-XC,18,9,5,1,3,9,9
20101121-M-Tour_Finals-RR-Andy_Roddick-Rafael_Nadal,2,B-DTM,19,0,0,0,0,13,6
20101121-M-Tour_Finals-RR-Andy_Roddick-Rafael_Nadal,2,B-DTL,23,5,2,2,1,14,9
20101121-M-Tour_Finals-RR-Andy_Roddick-Rafael_Nadal,2,B-IO,3,0,0,0,0,2,1
20101121-M-Tour_Finals-RR-Andy_Roddick-Rafael_Nadal,2,S-XC,4,2,0,0,2,1,3
20101121-M-Tour_Finals-RR-Andy_Roddick-Rafael_Nadal,2,S-DTM,6,0,0,0,0,4,2
20101121-M-Tour_Finals-RR-Andy_Roddick-Rafael_Nadal,2,S-DTL,7,0,0,0,0,5,2
20121012-M-Shanghai_Masters-SF-Roger_Federer-Andy_Murray,1,F-XC,25,8,2,4,2,18,7
20121012-M-Shanghai_Masters-SF-Roger_Federer-Andy_Murray,1,F-DTM,13,1,0,0,1,6,7
20121012-M-Shanghai_Masters-SF-Roger_Federer-Andy_Murray,1,F-DTL,4,2,1,0,1,1,3
20121012-M-Shanghai_Masters-SF-Roger_Federer-Andy_Murray,1,F-IO,21,5,3,0,2,11,10
20121012-M-Shanghai_Masters-SF-Roger_Federer-Andy_Murray,1,F-II,4,2,0,1,1,3,1
20121012-M-Shanghai_Masters-SF-Roger_Federer-Andy_Murray,1,B-XC,17,5,0,0,5,5,12
20121012-M-Shanghai_Masters-SF-Roger_Federer-Andy_Murray,1,B-DTM,19,1,0,0,1,10,9
20121012-M-Shanghai_Masters-SF-Roger_Federer-Andy_Murray,1,B-DTL,8,2,1,1,0,4,4
20121012-M-Shanghai_Masters-SF-Roger_Federer-Andy_Murray,1,S-XC,16,1,0,0,1,8,8
20121012-M-Shanghai_Masters-SF-Roger_Federer-Andy_Murray,1,S-DTM,2,0,0,0,0,0,2
20121012-M-Shanghai_Masters-SF-Roger_Federer-Andy_Murray,2,F-XC,23,10,4,1,5,10,13
20121012-M-Shanghai_Masters-SF-Roger_Federer-Andy_Murray,2,F-DTM,11,1,0,0,1,3,8
20121012-M-Shanghai_Masters-SF-Roger_Federer-Andy_Murray,2,F-DTL,8,2,1,0,1,4,4
20121012-M-Shanghai_Masters-SF-Roger_Federer-Andy_Murray,2,F-IO,22,7,2,3,2,14,8
20121012-M-Shanghai_Masters-SF-Roger_Federer-Andy_Murray,2,F-II,2,1,0,0,1,0,2
20121012-M-Shanghai_Masters-SF-Roger_Federer-Andy_Murray,2,B-XC,40,7,2,4,1,21,19
20121012-M-Shanghai_Masters-SF-Roger_Federer-Andy_Murray,2,B-DTM,8,2,0,1,1,3,5
20121012-M-Shanghai_Masters-SF-Roger_Federer-Andy_Murray,2,B-DTL,7,2,1,0,1,2,5
20121012-M-Shanghai_Masters-SF-Roger_Federer-Andy_Murray,2,B-IO,2,1,0,0,1,0,2
20121012-M-Shanghai_Masters-SF-Roger_Federer-Andy_Murray,2,S-XC,7,1,0,0,1,4,3
20121012-M-Shanghai_Masters-SF-Roger_Federer-Andy_Murray,2,S-DTM,5,1,0,0,1,2,3
20121012-M-Shanghai_Masters-SF-Roger_Federer-Andy_Murray,2,S-DTL,1,0,0,0,0,0,1
20121012-M-Shanghai_Masters-SF-Roger_Federer-Andy_Murray,2,S-IO,1,1,0,1,0,1,0
20160304-M-Davis_Cup_World_Group_R1-RR-Frank_Dancevic-Gael_Monfils,1,F-XC,28,7,3,2,2,10,18
20160304-M-Davis_Cup_World_Group_R1-RR-Frank_Dancevic-Gael_Monfils,1,F-DTM,5,0,0,0,0,2,3
20160304-M-Davis_Cup_World_Group_R1-RR-Frank_Dancevic-Gael_Monfils,1,F-DTL,11,5,2,1,2,5,6
20160304-M-Davis_Cup_World_Group_R1-RR-Frank_Dancevic-Gael_Monfils,1,F-IO,18,6,1,1,3,4,14
20160304-M-Davis_Cup_World_Group_R1-RR-Frank_Dancevic-Gael_Monfils,1,F-II,6,2,1,1,0,3,3
20160304-M-Davis_Cup_World_Group_R1-RR-Frank_Dancevic-Gael_Monfils,1,B-XC,28,10,4,2,4,13,15
20160304-M-Davis_Cup_World_Group_R1-RR-Frank_Dancevic-Gael_Monfils,1,B-DTM,8,1,0,0,1,2,6
20160304-M-Davis_Cup_World_Group_R1-RR-Frank_Dancevic-Gael_Monfils,1,B-DTL,9,3,2,1,0,5,4
20160304-M-Davis_Cup_World_Group_R1-RR-Frank_Dancevic-Gael_Monfils,1,B-IO,1,0,0,0,0,1,0
20160304-M-Davis_Cup_World_Group_R1-RR-Frank_Dancevic-Gael_Monfils,1,S-XC,5,1,0,0,1,1,4
20160304-M-Davis_Cup_World_Group_R1-RR-Frank_Dancevic-Gael_Monfils,1,S-DTL,2,0,0,0,0,1,1
20160304-M-Davis_Cup_World_Group_R1-RR-Frank_Dancevic-Gael_Monfils,2,F-XC,30,13,7,5,1,22,8
20160304-M-Davis_Cup_World_Group_R1-RR-Frank_Dancevic-Gael_Monfils,2,F-DTM,7,1,1,0,0,5,2
20160304-M-Davis_Cup_World_Group_R1-RR-Frank_Dancevic-Gael_Monfils,2,F-DTL,9,2,1,1,0,9,0
20160304-M-Davis_Cup_World_Group_R1-RR-Frank_Dancevic-Gael_Monfils,2,F-IO,11,4,2,2,0,7,4
20160304-M-Davis_Cup_World_Group_R1-RR-Frank_Dancevic-Gael_Monfils,2,F-II,2,2,2,0,0,2,0
20160304-M-Davis_Cup_World_Group_R1-RR-Frank_Dancevic-Gael_Monfils,2,B-XC,26,6,2,1,3,13,13
20160304-M-Davis_Cup_World_Group_R1-RR-Frank_Dancevic-Gael_Monfils,2,B-DTM,6,0,0,0,0,5,1
20160304-M-Davis_Cup_World_Group_R1-RR-Frank_Dancevic-Gael_Monfils,2,B-DTL,14,9,7,0,2,10,4
20160304-M-Davis_Cup_World_Group_R1-RR-Frank_Dancevic-Gael_Monfils,2,B-IO,2,1,1,0,0,2,0
20160304-M-Davis_Cup_World_Group_R1-RR-Frank_Dancevic-Gael_Monfils,2,S-XC,7,0,0,0,0,6,1
20160304-M-Davis_Cup_World_Group_R1-RR-Frank_Dancevic-Gael_Monfils,2,S-DTL,3,2,0,2,0,3,0
20111111-M-Paris_Masters-QF-Roger_Federer-Juan_Monaco,1,F-XC,43,11,1,4,6,24,19
20111111-M-Paris_Masters-QF-Roger_Federer-Juan_Monaco,1,F-DTM,18,0,0,0,0,11,7
20111111-M-Paris_Masters-QF-Roger_Federer-Juan_Monaco,1,F-DTL,7,3,0,1,2,4,3
20111111-M-Paris_Masters-QF-Roger_Federer-Juan_Monaco,1,F-IO,32,14,2,6,6,19,13
20111111-M-Paris_Masters-QF-Roger_Federer-Juan_Monaco,1,F-II,4,1,0,0,1,1,3
20111111-M-Paris_Masters-QF-Roger_Federer-Juan_Monaco,1,B-XC,31,8,0,2,6,14,17
20111111-M-Paris_Masters-QF-Roger_Federer-Juan_Monaco,1,B-DTM,18,2,0,0,2,8,10
20111111-M-Paris_Masters-QF-Roger_Federer-Juan_Monaco,1,B-DTL,5,5,2,0,3,2,3
20111111-M-Paris_Masters-QF-Roger_Federer-Juan_Monaco,1,S-XC,17,2,0,0,2,6,11
20111111-M-Paris_Masters-QF-Roger_Federer-Juan_Monaco,1,S-DTM,5,0,0,0,0,0,5
20111111-M-Paris_Masters-QF-Roger_Federer-Juan_Monaco,1,S-DTL,1,0,0,0,0,0,1
20111111-M-Paris_Masters-QF-Roger_Federer-Juan_Monaco,2,F-XC,25,6,1,3,2,15,10
20111111-M-Paris_Masters-QF-Roger_Federer-Juan_Monaco,2,F-DTM,21,1,0,0,1,10,11
20111111-M-Paris_Masters-QF-Roger_Federer-Juan_Monaco,2,F-DTL,16,4,1,2,1,8,8
20111111-M-Paris_Masters-QF-Roger_Federer-Juan_Monaco,2,F-IO,35,5,0,2,3,19,16
20111111-M-Paris_Masters-QF-Roger_Federer-Juan_Monaco,2,F-II,11,1,1,0,0,5,6
20111111-M-Paris_Masters-QF-Roger_Federer-Juan_Monaco,2,B-XC,29,6,0,0,6,17,12
20111111-M-Paris_Masters-QF-Roger_Federer-Juan_Monaco,2,B-DTM,16,5,0,2,3,6,10
20111111-M-Paris_Masters-QF-Roger_Federer-Juan_Monaco,2,B-DTL,3,1,0,0,1,1,2
20111111-M-Paris_Masters-QF-Roger_Federer-Juan_Monaco,2,B-IO,2,1,0,0,1,1,1
20111111-M-Paris_Masters-QF-Roger_Federer-Juan_Monaco,2,S-XC,8,1,0,1,0,3,5
20111111-M-Paris_Masters-QF-Roger_Federer-Juan_Monaco,2,S-DTM,7,0,0,0,0,2,5
20111111-M-Paris_Masters-QF-Roger_Federer-Juan_Monaco,2,S-DTL,2,1,0,0,1,0,2
20111111-M-Paris_Masters-QF-Roger_Federer-Juan_Monaco,2,S-IO,1,0,0,0,0,0,1
20070520-M-Hamburg_Masters-F-Roger_Federer-Rafael_Nadal,1,F-XC,52,11,3,4,4,32,20
20070520-M-Hamburg_Masters-F-Roger_Federer-Rafael_Nadal,1,F-DTM,39,5,2,0,3,27,12
20070520-M-Hamburg_Masters-F-Roger_Federer-Rafael_Nadal,1,F-DTL,12,4,2,2,0,7,5
20070520-M-Hamburg_Masters-F-Roger_Federer-Rafael_Nadal,1,F-IO,43,17,3,5,9,20,23
20070520-M-Hamburg_Masters-F-Roger_Federer-Rafael_Nadal,1,F-II,6,3,2,0,1,3,3
20070520-M-Hamburg_Masters-F-Roger_Federer-Rafael_Nadal,1,B-XC,37,6,0,1,5,17,20
20070520-M-Hamburg_Masters-F-Roger_Federer-Rafael_Nadal,1,B-DTM,62,2,0,0,2,45,17
20070520-M-Hamburg_Masters-F-Roger_Federer-Rafael_Nadal,1,B-DTL,16,1,1,0,0,10,6
20070520-M-Hamburg_Masters-F-Roger_Federer-Rafael_Nadal,1,B-IO,5,0,0,0,0,2,3
20070520-M-Hamburg_Masters-F-Roger_Federer-Rafael_Nadal,1,S-XC,2,0,0,0,0,1,1
20070520-M-Hamburg_Masters-F-Roger_Federer-Rafael_Nadal,1,S-DTM,11,0,0,0,0,1,10
20070520-M-Hamburg_Masters-F-Roger_Federer-Rafael_Nadal,1,S-DTL,7,0,0,0,0,4,3
20070520-M-Hamburg_Masters-F-Roger_Federer-Rafael_Nadal,2,F-XC,97,9,1,4,4,44,53
20070520-M-Hamburg_Masters-F-Roger_Federer-Rafael_Nadal,2,F-DTM,46,5,0,1,4,14,32
20070520-M-Hamburg_Masters-F-Roger_Federer-Rafael_Nadal,2,F-DTL,7,4,2,0,2,3,4
20070520-M-Hamburg_Masters-F-Roger_Federer-Rafael_Nadal,2,F-IO,24,6,2,1,3,10,14
20070520-M-Hamburg_Masters-F-Roger_Federer-Rafael_Nadal,2,F-II,4,0,0,0,0,2,2
20070520-M-Hamburg_Masters-F-Roger_Federer-Rafael_Nadal,2,B-XC,31,8,2,1,5,15,16
20070520-M-Hamburg_Masters-F-Roger_Federer-Rafael_Nadal,2,B-DTM,51,2,0,0,2,17,34
20070520-M-Hamburg_Masters-F-Roger_Federer-Rafael_Nadal,2,B-DTL,21,6,3,0,3,9,12
20070520-M-Hamburg_Masters-F-Roger_Federer-Rafael_Nadal,2,B-IO,10,3,1,0,2,3,7
20070520-M-Hamburg_Masters-F-Roger_Federer-Rafael_Nadal,2,S-DTM,4,0,0,0,0,2,2
20170118-M-Australian_Open-R64-Nick_Kyrgios-Andreas_Seppi,1,F-XC,74,17,3,4,10,31,43
20170118-M-Australian_Open-R64-Nick_Kyrgios-Andreas_Seppi,1,F-DTM,37,3,0,1,2,12,25
20170118-M-Australian_Open-R64-Nick_Kyrgios-Andreas_Seppi,1,F-DTL,23,5,1,0,4,11,12
20170118-M-Australian_Open-R64-Nick_Kyrgios-Andreas_Seppi,1,F-IO,76,18,3,8,7,38,38
20170118-M-Australian_Open-R64-Nick_Kyrgios-Andreas_Seppi,1,F-II,5,2,1,0,1,2,3
20170118-M-Australian_Open-R64-Nick_Kyrgios-Andreas_Seppi,1,B-XC,80,14,2,6,6,40,40
20170118-M-Australian_Open-R64-Nick_Kyrgios-Andreas_Seppi,1,B-DTM,42,1,0,0,1,19,23
20170118-M-Australian_Open-R64-Nick_Kyrgios-Andreas_Seppi,1,B-DTL,18,7,2,2,3,13,5
20170118-M-Australian_Open-R64-Nick_Kyrgios-Andreas_Seppi,1,B-IO,11,7,2,1,4,5,6
20170118-M-Australian_Open-R64-Nick_Kyrgios-Andreas_Seppi,1,S-XC,9,0,0,0,0,3,6
20170118-M-Australian_Open-R64-Nick_Kyrgios-Andreas_Seppi,1,S-DTM,10,2,0,1,1,2,8
20170118-M-Australian_Open-R64-Nick_Kyrgios-Andreas_Seppi,1,S-DTL,2,0,0,0,0,1,1
20170118-M-Australian_Open-R64-Nick_Kyrgios-Andreas_Seppi,2,F-XC,71,20,11,4,5,46,25
20170118-M-Australian_Open-R64-Nick_Kyrgios-Andreas_Seppi,2,F-DTM,51,3,0,0,3,32,19
20170118-M-Australian_Open-R64-Nick_Kyrgios-Andreas_Seppi,2,F-DTL,14,6,2,1,3,6,8
20170118-M-Australian_Open-R64-Nick_Kyrgios-Andreas_Seppi,2,F-IO,35,15,7,5,3,25,10
20170118-M-Australian_Open-R64-Nick_Kyrgios-Andreas_Seppi,2,F-II,3,1,1,0,0,2,1
20170118-M-Australian_Open-R64-Nick_Kyrgios-Andreas_Seppi,2,B-XC,78,14,3,1,10,42,36
20170118-M-Australian_Open-R64-Nick_Kyrgios-Andreas_Seppi,2,B-DTM,72,2,0,1,1,42,30
20170118-M-Australian_Open-R64-Nick_Kyrgios-Andreas_Seppi,2,B-DTL,19,11,5,2,4,13,6
20170118-M-Australian_Open-R64-Nick_Kyrgios-Andreas_Seppi,2,B-IO,12,4,2,0,2,6,6
20170118-M-Australian_Open-R64-Nick_Kyrgios-Andreas_Seppi,2,S-XC,21,2,0,2,0,11,10
20170118-M-Australian_Open-R64-Nick_Kyrgios-Andreas_Seppi,2,S-DTM,22,1,0,0,1,5,17
20170118-M-Australian_Open-R64-Nick_Kyrgios-Andreas_Seppi,2,S-DTL,4,0,0,0,0,3,1
20170118-M-Australian_Open-R64-Nick_Kyrgios-Andreas_Seppi,2,S-IO,2,0,0,0,0,0,2
20110123-M-Australian_Open-R16-Robin_Soderling-Alexandr_Dolgopolov,1,F-XC,69,24,6,6,12,33,36
20110123-M-Australian_Open-R16-Robin_Soderling-Alexandr_Dolgopolov,1,F-DTM,37,3,0,1,2,17,20
20110123-M-Australian_Open-R16-Robin_Soderling-Alexandr_Dolgopolov,1,F-DTL,27,8,2,1,5,12,15
20110123-M-Australian_Open-R16-Robin_Soderling-Alexandr_Dolgopolov,1,F-IO,66,21,4,8,9,32,34
20110123-M-Australian_Open-R16-Robin_Soderling-Alexandr_Dolgopolov,1,F-II,7,4,1,2,1,3,4
20110123-M-Australian_Open-R16-Robin_Soderling-Alexandr_Dolgopolov,1,B-XC,56,2,1,0,1,29,27
20110123-M-Australian_Open-R16-Robin_Soderling-Alexandr_Dolgopolov,1,B-DTM,21,3,1,0,2,7,14
20110123-M-Australian_Open-R16-Robin_Soderling-Alexandr_Dolgopolov,1,B-DTL,33,12,3,6,3,20,13
20110123-M-Australian_Open-R16-Robin_Soderling-Alexandr_Dolgopolov,1,B-IO,6,2,0,1,1,4,2
20110123-M-Australian_Open-R16-Robin_Soderling-Alexandr_Dolgopolov,1,S-XC,20,2,1,0,1,11,9
20110123-M-Australian_Open-R16-Robin_Soderling-Alexandr_Dolgopolov,1,S-DTM,7,0,0,0,0,1,6
20110123-M-Australian_Open-R16-Robin_Soderling-Alexandr_Dolgopolov,1,S-DTL,8,2,1,0,1,2,6
20110123-M-Australian_Open-R16-Robin_Soderling-Alexandr_Dolgopolov,2,F-XC,71,21,14,3,4,44,27
20110123-M-Australian_Open-R16-Robin_Soderling-Alexandr_Dolgopolov,2,F-DTM,16,3,1,0,2,6,10
20110123-M-Australian_Open-R16-Robin_Soderling-Alexandr_Dolgopolov,2,F-DTL,21,7,3,0,4,11,10
20110123-M-Australian_Open-R16-Robin_Soderling-Alexandr_Dolgopolov,2,F-IO,24,8,4,2,2,14,10
20110123-M-Australian_Open-R16-Robin_Soderling-Alexandr_Dolgopolov,2,F-II,5,1,1,0,0,3,2
20110123-M-Australian_Open-R16-Robin_Soderling-Alexandr_Dolgopolov,2,B-XC,70,8,4,1,3,37,33
20110123-M-Australian_Open-R16-Robin_Soderling-Alexandr_Dolgopolov,2,B-DTM,26,1,0,0,1,14,12
20110123-M-Australian_Open-R16-Robin_Soderling-Alexandr_Dolgopolov,2,B-DTL,6,5,2,2,1,4,2
20110123-M-Australian_Open-R16-Robin_Soderling-Alexandr_Dolgopolov,2,B-IO,6,2,2,0,0,4,2
20110123-M-Australian_Open-R16-Robin_Soderling-Alexandr_Dolgopolov,2,S-XC,37,1,0,0,1,16,21
20110123-M-Australian_Open-R16-Robin_Soderling-Alexandr_Dolgopolov,2,S-DTM,18,1,0,0,1,6,12
20110123-M-Australian_Open-R16-Robin_Soderling-Alexandr_Dolgopolov,2,S-DTL,10,0,0,0,0,6,4
20110123-M-Australian_Open-R16-Robin_Soderling-Alexandr_Dolgopolov,2,S-IO,2,0,0,0,0,2,0
20170122-M-Australian_Open-R16-Roger_Federer-Kei_Nishikori,1,F-XC,33,14,5,3,6,20,13
20170122-M-Australian_Open-R16-Roger_Federer-Kei_Nishikori,1,F-DTM,25,3,0,1,2,11,14
20170122-M-Australian_Open-R16-Roger_Federer-Kei_Nishikori,1,F-DTL,18,5,4,1,0,11,7
20170122-M-Australian_Open-R16-Roger_Federer-Kei_Nishikori,1,F-IO,32,17,8,5,4,23,9
20170122-M-Australian_Open-R16-Roger_Federer-Kei_Nishikori,1,F-II,9,7,3,3,1,8,1
20170122-M-Australian_Open-R16-Roger_Federer-Kei_Nishikori,1,B-XC,39,7,3,0,4,19,20
20170122-M-Australian_Open-R16-Roger_Federer-Kei_Nishikori,1,B-DTM,43,2,0,0,2,19,24
20170122-M-Australian_Open-R16-Roger_Federer-Kei_Nishikori,1,B-DTL,17,9,4,1,4,7,10
20170122-M-Australian_Open-R16-Roger_Federer-Kei_Nishikori,1,B-IO,6,1,0,1,0,3,3
20170122-M-Australian_Open-R16-Roger_Federer-Kei_Nishikori,1,S-XC,21,3,0,0,3,7,14
20170122-M-Australian_Open-R16-Roger_Federer-Kei_Nishikori,1,S-DTM,6,1,0,0,1,2,4
20170122-M-Australian_Open-R16-Roger_Federer-Kei_Nishikori,1,S-DTL,7,1,0,0,1,4,3
20170122-M-Australian_Open-R16-Roger_Federer-Kei_Nishikori,2,F-XC,43,11,5,5,1,26,17
20170122-M-Australian_Open-R16-Roger_Federer-Kei_Nishikori,2,F-DTM,27,2,1,0,1,12,15
20170122-M-Australian_Open-R16-Roger_Federer-Kei_Nishikori,2,F-DTL,18,8,1,3,4,10,8
20170122-M-Australian_Open-R16-Roger_Federer-Kei_Nishikori,2,F-IO,39,10,3,4,3,23,16
20170122-M-Australian_Open-R16-Roger_Federer-Kei_Nishikori,2,F-II,1,0,0,0,0,0,1
20170122-M-Australian_Open-R16-Roger_Federer-Kei_Nishikori,2,B-XC,72,13,2,5,6,37,35
20170122-M-Australian_Open-R16-Roger_Federer-Kei_Nishikori,2,B-DTM,24,2,1,0,1,12,12
20170122-M-Australian_Open-R16-Roger_Federer-Kei_Nishikori,2,B-DTL,15,7,3,0,4,7,8
20170122-M-Australian_Open-R16-Roger_Federer-Kei_Nishikori,2,B-IO,3,1,1,0,0,2,1
20170122-M-Australian_Open-R16-Roger_Federer-Kei_Nishikori,2,S-XC,12,0,0,0,0,6,6
20170122-M-Australian_Open-R16-Roger_Federer-Kei_Nishikori,2,S-DTM,6,1,0,0,1,0,6
20170122-M-Australian_Open-R16-Roger_Federer-Kei_Nishikori,2,S-DTL,7,3,0,1,2,2,5
20040328-M-Miami_Masters-R32-Roger_Federer-Rafael_Nadal,1,F-XC,50,15,5,2,8,25,25
20040328-M-Miami_Masters-R32-Roger_Federer-Rafael_Nadal,1,F-DTM,16,2,0,0,2,5,11
20040328-M-Miami_Masters-R32-Roger_Federer-Rafael_Nadal,1,F-DTL,7,3,2,0,1,3,4
20040328-M-Miami_Masters-R32-Roger_Federer-Rafael_Nadal,1,F-IO,11,2,2,0,0,5,6
20040328-M-Miami_Masters-R32-Roger_Federer-Rafael_Nadal,1,F-II,5,1,0,0,1,2,3
20040328-M-Miami_Masters-R32-Roger_Federer-Rafael_Nadal,1,B-XC,9,0,0,0,0,4,5
20040328-M-Miami_Masters-R32-Roger_Federer-Rafael_Nadal,1,B-DTM,22,1,0,0,1,5,17
20040328-M-Miami_Masters-R32-Roger_Federer-Rafael_Nadal,1,B-DTL,10,2,0,0,2,2,8
20040328-M-Miami_Masters-R32-Roger_Federer-Rafael_Nadal,1,S-XC,2,1,1,0,0,1,1
20040328-M-Miami_Masters-R32-Roger_Federer-Rafael_Nadal,1,S-DTM,3,0,0,0,0,0,3
20040328-M-Miami_Masters-R32-Roger_Federer-Rafael_Nadal,1,S-DTL,3,0,0,0,0,1,2
20040328-M-Miami_Masters-R32-Roger_Federer-Rafael_Nadal,2,F-XC,40,3,1,2,0,31,9
20040328-M-Miami_Masters-R32-Roger_Federer-Rafael_Nadal,2,F-DTM,6,1,0,1,0,5,1
20040328-M-Miami_Masters-R32-Roger_Federer-Rafael_Nadal,2,F-DTL,7,3,0,2,1,4,3
20040328-M-Miami_Masters-R32-Roger_Federer-Rafael_Nadal,2,F-IO,17,7,1,3,3,9,8
20040328-M-Miami_Masters-R32-Roger_Federer-Rafael_Nadal,2,F-II,6,1,0,1,0,5,1
20040328-M-Miami_Masters-R32-Roger_Federer-Rafael_Nadal,2,B-XC,29,8,3,3,2,18,11
20040328-M-Miami_Masters-R32-Roger_Federer-Rafael_Nadal,2,B-DTM,22,3,0,1,2,13,9
20040328-M-Miami_Masters-R32-Roger_Federer-Rafael_Nadal,2,B-DTL,11,4,0,0,4,5,6
20040328-M-Miami_Masters-R32-Roger_Federer-Rafael_Nadal,2,B-IO,3,3,0,1,2,1,2
20040328-M-Miami_Masters-R32-Roger_Federer-Rafael_Nadal,2,S-DTM,1,0,0,0,0,0,1
20040328-M-Miami_Masters-R32-Roger_Federer-Rafael_Nadal,2,S-DTL,2,0,0,0,0,2,0
20050601-M-Roland_Garros-SF-Roger_Federer-Rafael_Nadal,1,F-XC,110,19,1,6,12,44,66
20050601-M-Roland_Garros-SF-Roger_Federer-Rafael_Nadal,1,F-DTM,53,5,0,2,3,23,30
20050601-M-Roland_Garros-SF-Roger_Federer-Rafael_Nadal,1,F-DTL,23,11,2,3,6,11,12
20050601-M-Roland_Garros-SF-Roger_Federer-Rafael_Nadal,1,F-IO,51,27,11,3,13,24,27
20050601-M-Roland_Garros-SF-Roger_Federer-Rafael_Nadal,1,F-II,13,4,3,1,0,6,7
20050601-M-Roland_Garros-SF-Roger_Federer-Rafael_Nadal,1,B-XC,32,9,2,2,5,13,19
20050601-M-Roland_Garros-SF-Roger_Federer-Rafael_Nadal,1,B-DTM,39,3,0,0,3,18,21
20050601-M-Roland_Garros-SF-Roger_Federer-Rafael_Nadal,1,B-DTL,30,6,1,0,5,12,18
20050601-M-Roland_Garros-SF-Roger_Federer-Rafael_Nadal,1,B-IO,9,0,0,0,0,8,1
20050601-M-Roland_Garros-SF-Roger_Federer-Rafael_Nadal,1,S-XC,9,0,0,0,0,4,5
20050601-M-Roland_Garros-SF-Roger_Federer-Rafael_Nadal,1,S-DTM,9,2,0,0,2,3,6
20050601-M-Roland_Garros-SF-Roger_Federer-Rafael_Nadal,1,S-DTL,15,5,0,0,5,4,11
20050601-M-Roland_Garros-SF-Roger_Federer-Rafael_Nadal,1,S-IO,1,0,0,0,0,0,1
20050601-M-Roland_Garros-SF-Roger_Federer-Rafael_Nadal,2,F-XC,111,13,3,3,7,62,49
20050601-M-Roland_Garros-SF-Roger_Federer-Rafael_Nadal,2,F-DTM,40,2,0,0,2,15,25
20050601-M-Roland_Garros-SF-Roger_Federer-Rafael_Nadal,2,F-DTL,15,8,3,2,3,8,7
20050601-M-Roland_Garros-SF-Roger_Federer-Rafael_Nadal,2,F-IO,48,15,2,9,4,33,15
20050601-M-Roland_Garros-SF-Roger_Federer-Rafael_Nadal,2,F-II,12,1,0,0,1,6,6
20050601-M-Roland_Garros-SF-Roger_Federer-Rafael_Nadal,2,B-XC,83,23,3,10,10,47,36
20050601-M-Roland_Garros-SF-Roger_Federer-Rafael_Nadal,2,B-DTM,58,3,0,1,2,32,26
20050601-M-Roland_Garros-SF-Roger_Federer-Rafael_Nadal,2,B-DTL,24,5,2,1,2,14,10
20050601-M-Roland_Garros-SF-Roger_Federer-Rafael_Nadal,2,B-IO,6,2,1,0,1,4,2
20050601-M-Roland_Garros-SF-Roger_Federer-Rafael_Nadal,2,S-XC,2,1,0,0,1,1,1
20050601-M-Roland_Garros-SF-Roger_Federer-Rafael_Nadal,2,S-DTM,4,0,0,0,0,1,3
20050601-M-Roland_Garros-SF-Roger_Federer-Rafael_Nadal,2,S-DTL,4,1,0,0,1,1,3
20170121-M-Australian_Open-R32-Milos_Raonic-Gilles_Simon,1,F-XC,31,8,4,2,2,18,13
20170121-M-Australian_Open-R32-Milos_Raonic-Gilles_Simon,1,F-DTM,10,1,0,0,1,2,8
20170121-M-Australian_Open-R32-Milos_Raonic-Gilles_Simon,1,F-DTL,14,4,0,3,1,6,8
20170121-M-Australian_Open-R32-Milos_Raonic-Gilles_Simon,1,F-IO,59,11,2,3,6,31,28
20170121-M-Australian_Open-R32-Milos_Raonic-Gilles_Simon,1,F-II,4,2,0,1,1,2,2
20170121-M-Australian_Open-R32-Milos_Raonic-Gilles_Simon,1,B-XC,10,1,1,0,0,5,5
20170121-M-Australian_Open-R32-Milos_Raonic-Gilles_Simon,1,B-DTM,8,2,0,1,1,3,5
20170121-M-Australian_Open-R32-Milos_Raonic-Gilles_Simon,1,B-DTL,1,0,0,0,0,0,1
20170121-M-Australian_Open-R32-Milos_Raonic-Gilles_Simon,1,B-IO,4,1,0,0,1,1,3
20170121-M-Australian_Open-R32-Milos_Raonic-Gilles_Simon,1,S-XC,36,3,0,0,3,13,23
20170121-M-Australian_Open-R32-Milos_Raonic-Gilles_Simon,1,S-DTM,11,1,0,0,1,4,7
20170121-M-Australian_Open-R32-Milos_Raonic-Gilles_Simon,1,S-DTL,6,0,0,0,0,3,3
20170121-M-Australian_Open-R32-Milos_Raonic-Gilles_Simon,1,S-IO,1,0,0,0,0,1,0
20170121-M-Australian_Open-R32-Milos_Raonic-Gilles_Simon,2,F-XC,30,8,5,2,1,21,9
20170121-M-Australian_Open-R32-Milos_Raonic-Gilles_Simon,2,F-DTM,22,0,0,0,0,14,8
20170121-M-Australian_Open-R32-Milos_Raonic-Gilles_Simon,2,F-DTL,17,6,2,3,1,11,6
20170121-M-Australian_Open-R32-Milos_Raonic-Gilles_Simon,2,F-IO,40,10,2,7,1,25,15
20170121-M-Australian_Open-R32-Milos_Raonic-Gilles_Simon,2,F-II,2,2,2,0,0,2,0
20170121-M-Australian_Open-R32-Milos_Raonic-Gilles_Simon,2,B-XC,61,10,1,5,4,31,30
20170121-M-Australian_Open-R32-Milos_Raonic-Gilles_Simon,2,B-DTM,29,2,0,0,2,12,17
20170121-M-Australian_Open-R32-Milos_Raonic-Gilles_Simon,2,B-DTL,28,10,6,2,2,20,8
20170121-M-Australian_Open-R32-Milos_Raonic-Gilles_Simon,2,B-IO,1,1,0,0,1,0,1
20170121-M-Australian_Open-R32-Milos_Raonic-Gilles_Simon,2,S-XC,1,0,0,0,0,0,1
20170121-M-Australian_Open-R32-Milos_Raonic-Gilles_Simon,2,S-DTM,1,0,0,0,0,0,1
20090323-M-Indian_Wells_Masters-F-Rafael_Nadal-Andy_Murray,1,F-XC,64,11,4,3,4,42,22
20090323-M-Indian_Wells_Masters-F-Rafael_Nadal-Andy_Murray,1,F-DTM,29,2,1,1,0,16,13
20090323-M-Indian_Wells_Masters-F-Rafael_Nadal-Andy_Murray,1,F-DTL,9,2,0,1,1,5,4
20090323-M-Indian_Wells_Masters-F-Rafael_Nadal-Andy_Murray,1,F-IO,27,5,0,2,3,20,7
20090323-M-Indian_Wells_Masters-F-Rafael_Nadal-Andy_Murray,1,F-II,6,4,2,0,2,4,2
20090323-M-Indian_Wells_Masters-F-Rafael_Nadal-Andy_Murray,1,B-XC,46,8,1,4,3,30,16
20090323-M-Indian_Wells_Masters-F-Rafael_Nadal-Andy_Murray,1,B-DTM,17,2,0,0,2,7,10
20090323-M-Indian_Wells_Masters-F-Rafael_Nadal-Andy_Murray,1,B-DTL,7,2,0,1,1,5,2
20090323-M-Indian_Wells_Masters-F-Rafael_Nadal-Andy_Murray,1,B-IO,2,1,0,1,0,1,1
20090323-M-Indian_Wells_Masters-F-Rafael_Nadal-Andy_Murray,1,S-XC,20,0,0,0,0,16,4
20090323-M-Indian_Wells_Masters-F-Rafael_Nadal-Andy_Murray,1,S-DTM,17,1,0,0,1,13,4
20090323-M-Indian_Wells_Masters-F-Rafael_Nadal-Andy_Murray,1,S-DTL,4,0,0,0,0,3,1
20090323-M-Indian_Wells_Masters-F-Rafael_Nadal-Andy_Murray,1,S-IO,2,0,0,0,0,1,1
20090323-M-Indian_Wells_Masters-F-Rafael_Nadal-Andy_Murray,2,F-XC,93,9,1,1,7,24,69
20090323-M-Indian_Wells_Masters-F-Rafael_Nadal-Andy_Murray,2,F-DTM,29,1,0,0,1,10,19
20090323-M-Indian_Wells_Masters-F-Rafael_Nadal-Andy_Murray,2,F-DTL,16,4,1,1,2,11,5
20090323-M-Indian_Wells_Masters-F-Rafael_Nadal-Andy_Murray,2,F-IO,18,3,0,1,2,10,8
20090323-M-Indian_Wells_Masters-F-Rafael_Nadal-Andy_Murray,2,F-II,1,0,0,0,0,1,0
20090323-M-Indian_Wells_Masters-F-Rafael_Nadal-Andy_Murray,2,B-XC,21,3,0,1,2,6,15
20090323-M-Indian_Wells_Masters-F-Rafael_Nadal-Andy_Murray,2,B-DTM,31,2,0,0,2,9,22
20090323-M-Indian_Wells_Masters-F-Rafael_Nadal-Andy_Murray,2,B-DTL,16,3,0,0,3,5,11
20090323-M-Indian_Wells_Masters-F-Rafael_Nadal-Andy_Murray,2,B-IO,6,0,0,0,0,3,3
20090323-M-Indian_Wells_Masters-F-Rafael_Nadal-Andy_Murray,2,S-XC,2,0,0,0,0,1,1
20090323-M-Indian_Wells_Masters-F-Rafael_Nadal-Andy_Murray,2,S-DTM,4,1,0,0,1,0,4
20090323-M-Indian_Wells_Masters-F-Rafael_Nadal-Andy_Murray,2,S-DTL,8,0,0,0,0,5,3
20090323-M-Indian_Wells_Masters-F-Rafael_Nadal-Andy_Murray,2,S-IO,1,0,0,0,0,0,1
20160724-M-Washington-F-Gael_Monfils-Ivo_Karlovic,1,F-XC,12,5,3,1,1,9,3
20160724-M-Washington-F-Gael_Monfils-Ivo_Karlovic,1,F-DTM,7,0,0,0,0,5,2
20160724-M-Washington-F-Gael_Monfils-Ivo_Karlovic,1,F-DTL,7,1,0,0,1,3,4
20160724-M-Washington-F-Gael_Monfils-Ivo_Karlovic,1,F-IO,13,3,2,0,1,8,5
20160724-M-Washington-F-Gael_Monfils-Ivo_Karlovic,1,B-XC,9,3,1,0,2,2,7
20160724-M-Washington-F-Gael_Monfils-Ivo_Karlovic,1,B-DTM,3,0,0,0,0,1,2
20160724-M-Washington-F-Gael_Monfils-Ivo_Karlovic,1,B-DTL,8,5,4,1,0,7,1
20160724-M-Washington-F-Gael_Monfils-Ivo_Karlovic,1,B-IO,2,1,1,0,0,1,1
20160724-M-Washington-F-Gael_Monfils-Ivo_Karlovic,2,F-XC,8,5,2,3,0,6,2
20160724-M-Washington-F-Gael_Monfils-Ivo_Karlovic,2,F-DTM,4,1,0,0,1,1,3
20160724-M-Washington-F-Gael_Monfils-Ivo_Karlovic,2,F-DTL,4,2,1,0,1,2,2
20160724-M-Washington-F-Gael_Monfils-Ivo_Karlovic,2,F-IO,7,6,2,1,3,3,4
20160724-M-Washington-F-Gael_Monfils-Ivo_Karlovic,2,F-II,2,0,0,0,0,1,1
20160724-M-Washington-F-Gael_Monfils-Ivo_Karlovic,2,B-XC,1,0,0,0,0,0,1
20160724-M-Washington-F-Gael_Monfils-Ivo_Karlovic,2,S-XC,8,3,1,0,2,4,4
20160724-M-Washington-F-Gael_Monfils-Ivo_Karlovic,2,S-DTM,3,1,0,0,1,1,2
20160724-M-Washington-F-Gael_Monfils-Ivo_Karlovic,2,S-DTL,1,0,0,0,0,1,0
20160724-M-Washington-F-Gael_Monfils-Ivo_Karlovic,2,S-IO,1,0,0,0,0,0,1
20160720-M-Washington-R32-Taylor_Harry_Fritz-Alexander_Zverev,1,F-XC,33,8,1,1,6,17,16
20160720-M-Washington-R32-Taylor_Harry_Fritz-Alexander_Zverev,1,F-DTM,27,3,0,0,3,13,14
20160720-M-Washington-R32-Taylor_Harry_Fritz-Alexander_Zverev,1,F-DTL,4,3,0,0,3,0,4
20160720-M-Washington-R32-Taylor_Harry_Fritz-Alexander_Zverev,1,F-IO,13,7,2,3,2,9,4
20160720-M-Washington-R32-Taylor_Harry_Fritz-Alexander_Zverev,1,B-XC,14,3,0,0,3,5,9
20160720-M-Washington-R32-Taylor_Harry_Fritz-Alexander_Zverev,1,B-DTM,16,2,0,0,2,5,11
20160720-M-Washington-R32-Taylor_Harry_Fritz-Alexander_Zverev,1,B-DTL,4,0,0,0,0,2,2
20160720-M-Washington-R32-Taylor_Harry_Fritz-Alexander_Zverev,1,B-IO,2,1,0,1,0,2,0
20160720-M-Washington-R32-Taylor_Harry_Fritz-Alexander_Zverev,1,S-IO,1,0,0,0,0,1,0
20160720-M-Washington-R32-Taylor_Harry_Fritz-Alexander_Zverev,2,F-XC,28,13,4,3,6,16,12
20160720-M-Washington-R32-Taylor_Harry_Fritz-Alexander_Zverev,2,F-DTM,13,3,0,0,3,3,10
20160720-M-Washington-R32-Taylor_Harry_Fritz-Alexander_Zverev,2,F-DTL,7,5,2,0,3,3,4
20160720-M-Washington-R32-Taylor_Harry_Fritz-Alexander_Zverev,2,F-IO,15,11,3,1,7,8,7
20160720-M-Washington-R32-Taylor_Harry_Fritz-Alexander_Zverev,2,B-XC,18,4,2,1,1,15,3
20160720-M-Washington-R32-Taylor_Harry_Fritz-Alexander_Zverev,2,B-DTM,13,2,0,0,2,3,10
20160720-M-Washington-R32-Taylor_Harry_Fritz-Alexander_Zverev,2,B-DTL,7,4,0,2,2,3,4
20160720-M-Washington-R32-Taylor_Harry_Fritz-Alexander_Zverev,2,B-IO,8,2,1,0,1,3,5
20160720-M-Washington-R32-Taylor_Harry_Fritz-Alexander_Zverev,2,S-DTM,3,0,0,0,0,0,3
20160720-M-Washington-R32-Taylor_Harry_Fritz-Alexander_Zverev,2,S-DTL,1,1,1,0,0,1,0
20170124-M-Australian_Open-QF-Milos_Raonic-Rafael_Nadal,1,F-XC,61,14,1,5,8,30,31
20170124-M-Australian_Open-QF-Milos_Raonic-Rafael_Nadal,1,F-DTM,18,2,0,2,0,8,10
20170124-M-Australian_Open-QF-Milos_Raonic-Rafael_Nadal,1,F-DTL,9,4,0,3,1,5,4
20170124-M-Australian_Open-QF-Milos_Raonic-Rafael_Nadal,1,F-IO,41,18,6,6,6,21,20
20170124-M-Australian_Open-QF-Milos_Raonic-Rafael_Nadal,1,F-II,14,3,0,2,1,4,10
20170124-M-Australian_Open-QF-Milos_Raonic-Rafael_Nadal,1,B-XC,16,3,0,0,3,4,12
20170124-M-Australian_Open-QF-Milos_Raonic-Rafael_Nadal,1,B-DTM,17,0,0,0,0,7,10
20170124-M-Australian_Open-QF-Milos_Raonic-Rafael_Nadal,1,B-DTL,20,5,0,0,5,5,15
20170124-M-Australian_Open-QF-Milos_Raonic-Rafael_Nadal,1,B-IO,2,1,0,0,1,0,2
20170124-M-Australian_Open-QF-Milos_Raonic-Rafael_Nadal,1,S-XC,1,0,0,0,0,0,1
20170124-M-Australian_Open-QF-Milos_Raonic-Rafael_Nadal,1,S-DTM,1,0,0,0,0,0,1
20170124-M-Australian_Open-QF-Milos_Raonic-Rafael_Nadal,1,S-DTL,6,0,0,0,0,3,3
20170124-M-Australian_Open-QF-Milos_Raonic-Rafael_Nadal,1,S-IO,3,1,0,0,1,1,2
20170124-M-Australian_Open-QF-Milos_Raonic-Rafael_Nadal,2,F-XC,48,9,2,3,4,31,17
20170124-M-Australian_Open-QF-Milos_Raonic-Rafael_Nadal,2,F-DTM,23,0,0,0,0,15,8
20170124-M-Australian_Open-QF-Milos_Raonic-Rafael_Nadal,2,F-DTL,19,13,5,5,3,15,4
20170124-M-Australian_Open-QF-Milos_Raonic-Rafael_Nadal,2,F-IO,26,8,5,0,3,13,13
20170124-M-Australian_Open-QF-Milos_Raonic-Rafael_Nadal,2,F-II,7,3,1,1,1,6,1
20170124-M-Australian_Open-QF-Milos_Raonic-Rafael_Nadal,2,B-XC,32,11,6,3,2,21,11
20170124-M-Australian_Open-QF-Milos_Raonic-Rafael_Nadal,2,B-DTM,15,2,0,1,1,12,3
20170124-M-Australian_Open-QF-Milos_Raonic-Rafael_Nadal,2,B-DTL,11,8,4,2,2,8,3
20170124-M-Australian_Open-QF-Milos_Raonic-Rafael_Nadal,2,B-IO,6,2,1,1,0,5,1
20170124-M-Australian_Open-QF-Milos_Raonic-Rafael_Nadal,2,S-XC,7,0,0,0,0,3,4
20170124-M-Australian_Open-QF-Milos_Raonic-Rafael_Nadal,2,S-DTM,12,1,0,1,0,8,4
20170124-M-Australian_Open-QF-Milos_Raonic-Rafael_Nadal,2,S-DTL,11,1,0,0,1,4,7
20170120-M-Australian_Open-R32-Tomas_Berdych-Roger_Federer,1,F-XC,12,3,2,0,1,4,8
20170120-M-Australian_Open-R32-Tomas_Berdych-Roger_Federer,1,F-DTM,14,1,0,0,1,4,10
20170120-M-Australian_Open-R32-Tomas_Berdych-Roger_Federer,1,F-DTL,5,0,0,0,0,2,3
20170120-M-Australian_Open-R32-Tomas_Berdych-Roger_Federer,1,F-IO,20,4,1,0,3,6,14
20170120-M-Australian_Open-R32-Tomas_Berdych-Roger_Federer,1,F-II,2,1,0,0,1,0,2
20170120-M-Australian_Open-R32-Tomas_Berdych-Roger_Federer,1,B-XC,20,1,0,1,0,8,12
20170120-M-Australian_Open-R32-Tomas_Berdych-Roger_Federer,1,B-DTM,13,1,0,0,1,6,7
20170120-M-Australian_Open-R32-Tomas_Berdych-Roger_Federer,1,B-DTL,1,1,0,0,1,0,1
20170120-M-Australian_Open-R32-Tomas_Berdych-Roger_Federer,1,B-IO,1,1,0,0,1,0,1
20170120-M-Australian_Open-R32-Tomas_Berdych-Roger_Federer,1,S-XC,2,0,0,0,0,2,0
20170120-M-Australian_Open-R32-Tomas_Berdych-Roger_Federer,1,S-DTM,7,1,0,0,1,2,5
20170120-M-Australian_Open-R32-Tomas_Berdych-Roger_Federer,1,S-DTL,3,0,0,0,0,1,2
20170120-M-Australian_Open-R32-Tomas_Berdych-Roger_Federer,2,F-XC,22,12,4,7,1,17,5
20170120-M-Australian_Open-R32-Tomas_Berdych-Roger_Federer,2,F-DTM,19,6,1,1,4,11,8
20170120-M-Australian_Open-R32-Tomas_Berdych-Roger_Federer,2,F-DTL,1,0,0,0,0,1,0
20170120-M-Australian_Open-R32-Tomas_Berdych-Roger_Federer,2,F-IO,15,5,4,1,0,13,2
20170120-M-Australian_Open-R32-Tomas_Berdych-Roger_Federer,2,F-II,3,1,0,0,1,2,1
20170120-M-Australian_Open-R32-Tomas_Berdych-Roger_Federer,2,B-XC,18,6,4,0,2,13,5
20170120-M-Australian_Open-R32-Tomas_Berdych-Roger_Federer,2,B-DTM,12,4,0,1,3,7,5
20170120-M-Australian_Open-R32-Tomas_Berdych-Roger_Federer,2,B-DTL,7,7,2,2,3,4,3
20170120-M-Australian_Open-R32-Tomas_Berdych-Roger_Federer,2,B-IO,2,1,1,0,0,2,0
20170120-M-Australian_Open-R32-Tomas_Berdych-Roger_Federer,2,S-XC,6,1,1,0,0,3,3
20170120-M-Australian_Open-R32-Tomas_Berdych-Roger_Federer,2,S-DTM,7,0,0,0,0,6,1
20170120-M-Australian_Open-R32-Tomas_Berdych-Roger_Federer,2,S-DTL,3,0,0,0,0,0,3
20170206-M-Davis_Cup_World_Group_R1-RR-Kyle_Edmund-Denis_Shapovalov,1,F-XC,24,6,1,4,1,16,8
20170206-M-Davis_Cup_World_Group_R1-RR-Kyle_Edmund-Denis_Shapovalov,1,F-DTM,12,0,0,0,0,10,2
20170206-M-Davis_Cup_World_Group_R1-RR-Kyle_Edmund-Denis_Shapovalov,1,F-DTL,7,4,1,3,0,5,2
20170206-M-Davis_Cup_World_Group_R1-RR-Kyle_Edmund-Denis_Shapovalov,1,F-IO,14,6,2,0,4,7,7
20170206-M-Davis_Cup_World_Group_R1-RR-Kyle_Edmund-Denis_Shapovalov,1,F-II,3,0,0,0,0,1,2
20170206-M-Davis_Cup_World_Group_R1-RR-Kyle_Edmund-Denis_Shapovalov,1,B-XC,5,1,0,0,1,2,3
20170206-M-Davis_Cup_World_Group_R1-RR-Kyle_Edmund-Denis_Shapovalov,1,B-DTM,5,0,0,0,0,2,3
20170206-M-Davis_Cup_World_Group_R1-RR-Kyle_Edmund-Denis_Shapovalov,1,B-DTL,6,3,3,0,0,5,1
20170206-M-Davis_Cup_World_Group_R1-RR-Kyle_Edmund-Denis_Shapovalov,1,B-IO,3,2,0,0,2,1,2
20170206-M-Davis_Cup_World_Group_R1-RR-Kyle_Edmund-Denis_Shapovalov,1,S-DTM,3,0,0,0,0,1,2
20170206-M-Davis_Cup_World_Group_R1-RR-Kyle_Edmund-Denis_Shapovalov,2,F-XC,17,6,0,3,3,9,8
20170206-M-Davis_Cup_World_Group_R1-RR-Kyle_Edmund-Denis_Shapovalov,2,F-DTM,12,1,0,0,1,6,6
20170206-M-Davis_Cup_World_Group_R1-RR-Kyle_Edmund-Denis_Shapovalov,2,F-DTL,2,1,0,1,0,1,1
20170206-M-Davis_Cup_World_Group_R1-RR-Kyle_Edmund-Denis_Shapovalov,2,F-IO,15,8,1,2,5,6,9
20170206-M-Davis_Cup_World_Group_R1-RR-Kyle_Edmund-Denis_Shapovalov,2,F-II,1,0,0,0,0,0,1
20170206-M-Davis_Cup_World_Group_R1-RR-Kyle_Edmund-Denis_Shapovalov,2,B-XC,12,8,3,2,3,7,5
20170206-M-Davis_Cup_World_Group_R1-RR-Kyle_Edmund-Denis_Shapovalov,2,B-DTM,9,1,0,0,1,4,5
20170206-M-Davis_Cup_World_Group_R1-RR-Kyle_Edmund-Denis_Shapovalov,2,B-DTL,4,2,0,1,1,3,1
20170206-M-Davis_Cup_World_Group_R1-RR-Kyle_Edmund-Denis_Shapovalov,2,B-II,1,0,0,0,0,0,1
20170206-M-Davis_Cup_World_Group_R1-RR-Kyle_Edmund-Denis_Shapovalov,2,S-XC,1,0,0,0,0,0,1
20170206-M-Davis_Cup_World_Group_R1-RR-Kyle_Edmund-Denis_Shapovalov,2,S-DTM,2,0,0,0,0,0,2
20170206-M-Davis_Cup_World_Group_R1-RR-Kyle_Edmund-Denis_Shapovalov,2,S-DTL,3,0,0,0,0,0,3
20100815-M-Canada_Masters-SF-Roger_Federer-Novak_Djokovic,1,F-XC,53,15,5,3,7,21,32
20100815-M-Canada_Masters-SF-Roger_Federer-Novak_Djokovic,1,F-DTM,30,4,1,1,2,16,14
20100815-M-Canada_Masters-SF-Roger_Federer-Novak_Djokovic,1,F-DTL,15,3,0,1,2,4,11
20100815-M-Canada_Masters-SF-Roger_Federer-Novak_Djokovic,1,F-IO,27,13,3,3,7,16,11
20100815-M-Canada_Masters-SF-Roger_Federer-Novak_Djokovic,1,F-II,6,3,1,1,1,4,2
20100815-M-Canada_Masters-SF-Roger_Federer-Novak_Djokovic,1,B-XC,36,5,0,2,3,14,22
20100815-M-Canada_Masters-SF-Roger_Federer-Novak_Djokovic,1,B-DTM,23,4,0,1,3,10,13
20100815-M-Canada_Masters-SF-Roger_Federer-Novak_Djokovic,1,B-DTL,12,5,1,1,3,5,7
20100815-M-Canada_Masters-SF-Roger_Federer-Novak_Djokovic,1,B-IO,1,0,0,0,0,0,1
20100815-M-Canada_Masters-SF-Roger_Federer-Novak_Djokovic,1,S-XC,20,1,0,0,1,6,14
20100815-M-Canada_Masters-SF-Roger_Federer-Novak_Djokovic,1,S-DTM,10,0,0,0,0,3,7
20100815-M-Canada_Masters-SF-Roger_Federer-Novak_Djokovic,1,S-DTL,3,1,0,0,1,0,3
20100815-M-Canada_Masters-SF-Roger_Federer-Novak_Djokovic,2,F-XC,44,9,3,1,5,27,17
20100815-M-Canada_Masters-SF-Roger_Federer-Novak_Djokovic,2,F-DTM,20,1,0,1,0,9,11
20100815-M-Canada_Masters-SF-Roger_Federer-Novak_Djokovic,2,F-DTL,11,4,3,0,1,7,4
20100815-M-Canada_Masters-SF-Roger_Federer-Novak_Djokovic,2,F-IO,41,17,8,2,7,26,15
20100815-M-Canada_Masters-SF-Roger_Federer-Novak_Djokovic,2,F-II,8,3,2,1,0,6,2
20100815-M-Canada_Masters-SF-Roger_Federer-Novak_Djokovic,2,B-XC,68,18,3,4,11,38,30
20100815-M-Canada_Masters-SF-Roger_Federer-Novak_Djokovic,2,B-DTM,26,4,0,1,3,12,14
20100815-M-Canada_Masters-SF-Roger_Federer-Novak_Djokovic,2,B-DTL,23,11,1,2,8,10,13
20100815-M-Canada_Masters-SF-Roger_Federer-Novak_Djokovic,2,B-IO,11,4,1,0,3,4,7
20100815-M-Canada_Masters-SF-Roger_Federer-Novak_Djokovic,2,S-XC,6,0,0,0,0,3,3
20100815-M-Canada_Masters-SF-Roger_Federer-Novak_Djokovic,2,S-DTM,2,0,0,0,0,1,1
20160919-M-Metz-F-Lucas_Pouille-Dominic_Thiem,1,F-XC,10,5,0,2,3,6,4
20160919-M-Metz-F-Lucas_Pouille-Dominic_Thiem,1,F-DTM,16,1,0,1,0,12,4
20160919-M-Metz-F-Lucas_Pouille-Dominic_Thiem,1,F-DTL,5,2,2,0,0,4,1
20160919-M-Metz-F-Lucas_Pouille-Dominic_Thiem,1,F-IO,15,6,3,2,1,10,5
20160919-M-Metz-F-Lucas_Pouille-Dominic_Thiem,1,F-II,3,2,1,0,1,2,1
20160919-M-Metz-F-Lucas_Pouille-Dominic_Thiem,1,B-XC,12,1,0,1,0,6,6
20160919-M-Metz-F-Lucas_Pouille-Dominic_Thiem,1,B-DTM,6,0,0,0,0,2,4
20160919-M-Metz-F-Lucas_Pouille-Dominic_Thiem,1,B-DTL,2,0,0,0,0,0,2
20160919-M-Metz-F-Lucas_Pouille-Dominic_Thiem,1,B-IO,4,1,0,1,0,4,0
20160919-M-Metz-F-Lucas_Pouille-Dominic_Thiem,1,S-XC,3,0,0,0,0,2,1
20160919-M-Metz-F-Lucas_Pouille-Dominic_Thiem,1,S-DTM,9,0,0,0,0,4,5
20160919-M-Metz-F-Lucas_Pouille-Dominic_Thiem,1,S-DTL,1,0,0,0,0,0,1
20160919-M-Metz-F-Lucas_Pouille-Dominic_Thiem,1,S-II,1,0,0,0,0,0,1
20160919-M-Metz-F-Lucas_Pouille-Dominic_Thiem,2,F-XC,15,5,2,2,1,11,4
20160919-M-Metz-F-Lucas_Pouille-Dominic_Thiem,2,F-DTM,12,3,1,0,2,5,7
20160919-M-Metz-F-Lucas_Pouille-Dominic_Thiem,2,F-DTL,3,2,0,0,2,1,2
20160919-M-Metz-F-Lucas_Pouille-Dominic_Thiem,2,F-IO,21,10,7,2,1,16,5
20160919-M-Metz-F-Lucas_Pouille-Dominic_Thiem,2,F-II,3,0,0,0,0,1,2
20160919-M-Metz-F-Lucas_Pouille-Dominic_Thiem,2,B-XC,12,4,1,0,3,4,8
20160919-M-Metz-F-Lucas_Pouille-Dominic_Thiem,2,B-DTM,12,1,0,0,1,3,9
20160919-M-Metz-F-Lucas_Pouille-Dominic_Thiem,2,B-DTL,7,5,2,2,1,5,2
20160919-M-Metz-F-Lucas_Pouille-Dominic_Thiem,2,B-IO,3,2,0,0,2,1,2
20160919-M-Metz-F-Lucas_Pouille-Dominic_Thiem,2,B-II,1,1,0,0,1,0,1
20160919-M-Metz-F-Lucas_Pouille-Dominic_Thiem,2,S-XC,4,0,0,0,0,2,2
20160919-M-Metz-F-Lucas_Pouille-Dominic_Thiem,2,S-DTM,8,0,0,0,0,1,7
20160919-M-Metz-F-Lucas_Pouille-Dominic_Thiem,2,S-DTL,2,0,0,0,0,0,2
20160919-M-Metz-F-Lucas_Pouille-Dominic_Thiem,2,S-II,2,0,0,0,0,1,1
20080726-M-Canada_Masters-SF-Andy_Murray-Rafael_Nadal,1,F-XC,100,8,1,2,5,43,57
20080726-M-Canada_Masters-SF-Andy_Murray-Rafael_Nadal,1,F-DTM,25,4,0,0,4,6,19
20080726-M-Canada_Masters-SF-Andy_Murray-Rafael_Nadal,1,F-DTL,29,13,3,2,8,13,16
20080726-M-Canada_Masters-SF-Andy_Murray-Rafael_Nadal,1,F-IO,13,4,1,2,1,7,6
20080726-M-Canada_Masters-SF-Andy_Murray-Rafael_Nadal,1,B-XC,35,12,2,4,6,15,20
20080726-M-Canada_Masters-SF-Andy_Murray-Rafael_Nadal,1,B-DTM,25,2,0,1,1,12,13
20080726-M-Canada_Masters-SF-Andy_Murray-Rafael_Nadal,1,B-DTL,18,8,2,3,3,9,9
20080726-M-Canada_Masters-SF-Andy_Murray-Rafael_Nadal,1,B-IO,7,2,0,1,1,3,4
20080726-M-Canada_Masters-SF-Andy_Murray-Rafael_Nadal,1,S-DTM,2,0,0,0,0,2,0
20080726-M-Canada_Masters-SF-Andy_Murray-Rafael_Nadal,1,S-DTL,4,0,0,0,0,3,1
20080726-M-Canada_Masters-SF-Andy_Murray-Rafael_Nadal,1,S-IO,1,0,0,0,0,0,1
20080726-M-Canada_Masters-SF-Andy_Murray-Rafael_Nadal,2,F-XC,59,7,3,2,2,32,27
20080726-M-Canada_Masters-SF-Andy_Murray-Rafael_Nadal,2,F-DTM,19,2,0,0,2,11,8
20080726-M-Canada_Masters-SF-Andy_Murray-Rafael_Nadal,2,F-DTL,17,5,1,3,1,12,5
20080726-M-Canada_Masters-SF-Andy_Murray-Rafael_Nadal,2,F-IO,34,4,1,1,2,25,9
20080726-M-Canada_Masters-SF-Andy_Murray-Rafael_Nadal,2,F-II,12,1,0,1,0,9,3
20080726-M-Canada_Masters-SF-Andy_Murray-Rafael_Nadal,2,B-XC,63,8,0,3,5,32,31
20080726-M-Canada_Masters-SF-Andy_Murray-Rafael_Nadal,2,B-DTM,22,0,0,0,0,11,11
20080726-M-Canada_Masters-SF-Andy_Murray-Rafael_Nadal,2,B-DTL,8,3,0,1,2,4,4
20080726-M-Canada_Masters-SF-Andy_Murray-Rafael_Nadal,2,B-IO,4,1,0,0,1,1,3
20080726-M-Canada_Masters-SF-Andy_Murray-Rafael_Nadal,2,S-XC,10,1,0,1,0,5,5
20080726-M-Canada_Masters-SF-Andy_Murray-Rafael_Nadal,2,S-DTM,10,0,0,0,0,5,5
20080726-M-Canada_Masters-SF-Andy_Murray-Rafael_Nadal,2,S-DTL,2,0,0,0,0,1,1
20121008-M-Shanghai_Masters-R16-Roger_Federer-Stanislas_Wawrinka,1,F-XC,31,12,5,4,3,20,11
20121008-M-Shanghai_Masters-R16-Roger_Federer-Stanislas_Wawrinka,1,F-DTM,23,2,0,0,2,12,11
20121008-M-Shanghai_Masters-R16-Roger_Federer-Stanislas_Wawrinka,1,F-DTL,14,6,3,2,1,11,3
20121008-M-Shanghai_Masters-R16-Roger_Federer-Stanislas_Wawrinka,1,F-IO,27,8,4,4,0,20,7
20121008-M-Shanghai_Masters-R16-Roger_Federer-Stanislas_Wawrinka,1,F-II,4,2,0,2,0,2,2
20121008-M-Shanghai_Masters-R16-Roger_Federer-Stanislas_Wawrinka,1,B-XC,26,6,1,1,4,10,16
20121008-M-Shanghai_Masters-R16-Roger_Federer-Stanislas_Wawrinka,1,B-DTM,18,4,0,2,2,12,6
20121008-M-Shanghai_Masters-R16-Roger_Federer-Stanislas_Wawrinka,1,B-DTL,11,3,1,1,1,6,5
20121008-M-Shanghai_Masters-R16-Roger_Federer-Stanislas_Wawrinka,1,B-IO,4,1,1,0,0,4,0
20121008-M-Shanghai_Masters-R16-Roger_Federer-Stanislas_Wawrinka,1,B-II,1,1,0,1,0,1,0
20121008-M-Shanghai_Masters-R16-Roger_Federer-Stanislas_Wawrinka,1,S-XC,4,1,0,0,1,0,4
20121008-M-Shanghai_Masters-R16-Roger_Federer-Stanislas_Wawrinka,1,S-DTM,5,1,0,1,0,3,2
20121008-M-Shanghai_Masters-R16-Roger_Federer-Stanislas_Wawrinka,1,S-DTL,1,0,0,0,0,1,0
20121008-M-Shanghai_Masters-R16-Roger_Federer-Stanislas_Wawrinka,2,F-XC,26,6,1,5,0,11,15
20121008-M-Shanghai_Masters-R16-Roger_Federer-Stanislas_Wawrinka,2,F-DTM,13,3,1,0,2,6,7
20121008-M-Shanghai_Masters-R16-Roger_Federer-Stanislas_Wawrinka,2,F-DTL,11,4,1,1,2,4,7
20121008-M-Shanghai_Masters-R16-Roger_Federer-Stanislas_Wawrinka,2,F-IO,11,5,1,3,1,6,5
20121008-M-Shanghai_Masters-R16-Roger_Federer-Stanislas_Wawrinka,2,B-XC,41,14,1,5,8,13,28
20121008-M-Shanghai_Masters-R16-Roger_Federer-Stanislas_Wawrinka,2,B-DTM,21,3,0,1,2,8,13
20121008-M-Shanghai_Masters-R16-Roger_Federer-Stanislas_Wawrinka,2,B-DTL,13,9,0,3,6,6,7
20121008-M-Shanghai_Masters-R16-Roger_Federer-Stanislas_Wawrinka,2,B-IO,8,5,1,1,3,2,6
20121008-M-Shanghai_Masters-R16-Roger_Federer-Stanislas_Wawrinka,2,S-XC,12,0,0,0,0,8,4
20121008-M-Shanghai_Masters-R16-Roger_Federer-Stanislas_Wawrinka,2,S-DTM,8,0,0,0,0,3,5
20121008-M-Shanghai_Masters-R16-Roger_Federer-Stanislas_Wawrinka,2,S-IO,1,0,0,0,0,0,1
20170211-M-San_Francisco_CH-SF-Vasek_Pospisil-Michael_Mmoh,1,F-XC,24,8,1,3,4,11,13
20170211-M-San_Francisco_CH-SF-Vasek_Pospisil-Michael_Mmoh,1,F-DTM,13,1,0,0,1,6,7
20170211-M-San_Francisco_CH-SF-Vasek_Pospisil-Michael_Mmoh,1,F-DTL,7,3,1,1,1,4,3
20170211-M-San_Francisco_CH-SF-Vasek_Pospisil-Michael_Mmoh,1,F-IO,16,5,1,3,1,10,6
20170211-M-San_Francisco_CH-SF-Vasek_Pospisil-Michael_Mmoh,1,F-II,2,1,0,1,0,2,0
20170211-M-San_Francisco_CH-SF-Vasek_Pospisil-Michael_Mmoh,1,B-XC,7,0,0,0,0,2,5
20170211-M-San_Francisco_CH-SF-Vasek_Pospisil-Michael_Mmoh,1,B-DTM,3,0,0,0,0,1,2
20170211-M-San_Francisco_CH-SF-Vasek_Pospisil-Michael_Mmoh,1,B-DTL,1,1,1,0,0,1,0
20170211-M-San_Francisco_CH-SF-Vasek_Pospisil-Michael_Mmoh,1,S-XC,12,1,0,1,0,8,4
20170211-M-San_Francisco_CH-SF-Vasek_Pospisil-Michael_Mmoh,1,S-DTM,8,0,0,0,0,3,5
20170211-M-San_Francisco_CH-SF-Vasek_Pospisil-Michael_Mmoh,1,S-DTL,6,1,0,0,1,2,4
20170211-M-San_Francisco_CH-SF-Vasek_Pospisil-Michael_Mmoh,1,S-IO,1,0,0,0,0,1,0
20170211-M-San_Francisco_CH-SF-Vasek_Pospisil-Michael_Mmoh,2,F-XC,19,4,0,3,1,13,6
20170211-M-San_Francisco_CH-SF-Vasek_Pospisil-Michael_Mmoh,2,F-DTM,19,3,0,2,1,10,9
20170211-M-San_Francisco_CH-SF-Vasek_Pospisil-Michael_Mmoh,2,F-DTL,5,1,0,0,1,2,3
20170211-M-San_Francisco_CH-SF-Vasek_Pospisil-Michael_Mmoh,2,F-IO,16,2,0,0,2,5,11
20170211-M-San_Francisco_CH-SF-Vasek_Pospisil-Michael_Mmoh,2,B-XC,17,1,1,0,0,10,7
20170211-M-San_Francisco_CH-SF-Vasek_Pospisil-Michael_Mmoh,2,B-DTM,8,2,0,1,1,4,4
20170211-M-San_Francisco_CH-SF-Vasek_Pospisil-Michael_Mmoh,2,B-DTL,4,0,0,0,0,2,2
20170211-M-San_Francisco_CH-SF-Vasek_Pospisil-Michael_Mmoh,2,B-IO,1,0,0,0,0,0,1
20170211-M-San_Francisco_CH-SF-Vasek_Pospisil-Michael_Mmoh,2,S-XC,4,0,0,0,0,1,3
20170211-M-San_Francisco_CH-SF-Vasek_Pospisil-Michael_Mmoh,2,S-DTM,2,0,0,0,0,1,1
20170211-M-San_Francisco_CH-SF-Vasek_Pospisil-Michael_Mmoh,2,S-DTL,2,1,0,0,1,0,2
20170211-M-San_Francisco_CH-SF-Vasek_Pospisil-Michael_Mmoh,2,S-IO,1,1,0,0,1,0,1
20170210-M-San_Francisco_CH-QF-Vasek_Pospisil-Francis_Tiafoe,1,F-XC,20,6,2,3,1,14,6
20170210-M-San_Francisco_CH-QF-Vasek_Pospisil-Francis_Tiafoe,1,F-DTM,5,0,0,0,0,4,1
20170210-M-San_Francisco_CH-QF-Vasek_Pospisil-Francis_Tiafoe,1,F-DTL,3,2,0,1,1,2,1
20170210-M-San_Francisco_CH-QF-Vasek_Pospisil-Francis_Tiafoe,1,F-IO,15,5,2,3,0,11,4
20170210-M-San_Francisco_CH-QF-Vasek_Pospisil-Francis_Tiafoe,1,F-II,1,0,0,0,0,1,0
20170210-M-San_Francisco_CH-QF-Vasek_Pospisil-Francis_Tiafoe,1,B-XC,4,2,0,0,2,2,2
20170210-M-San_Francisco_CH-QF-Vasek_Pospisil-Francis_Tiafoe,1,B-DTM,5,0,0,0,0,5,0
20170210-M-San_Francisco_CH-QF-Vasek_Pospisil-Francis_Tiafoe,1,S-XC,8,1,0,1,0,4,4
20170210-M-San_Francisco_CH-QF-Vasek_Pospisil-Francis_Tiafoe,1,S-DTM,8,0,0,0,0,5,3
20170210-M-San_Francisco_CH-QF-Vasek_Pospisil-Francis_Tiafoe,1,S-DTL,2,0,0,0,0,2,0
20170210-M-San_Francisco_CH-QF-Vasek_Pospisil-Francis_Tiafoe,2,F-XC,13,5,0,2,3,5,8
20170210-M-San_Francisco_CH-QF-Vasek_Pospisil-Francis_Tiafoe,2,F-DTM,9,0,0,0,0,3,6
20170210-M-San_Francisco_CH-QF-Vasek_Pospisil-Francis_Tiafoe,2,F-DTL,9,1,0,0,1,2,7
20170210-M-San_Francisco_CH-QF-Vasek_Pospisil-Francis_Tiafoe,2,F-IO,9,4,1,1,2,2,7
20170210-M-San_Francisco_CH-QF-Vasek_Pospisil-Francis_Tiafoe,2,F-II,2,1,1,0,0,2,0
20170210-M-San_Francisco_CH-QF-Vasek_Pospisil-Francis_Tiafoe,2,B-XC,14,6,1,1,4,4,10
20170210-M-San_Francisco_CH-QF-Vasek_Pospisil-Francis_Tiafoe,2,B-DTM,4,0,0,0,0,1,3
20170210-M-San_Francisco_CH-QF-Vasek_Pospisil-Francis_Tiafoe,2,B-IO,2,1,0,0,1,0,2
20170210-M-San_Francisco_CH-QF-Vasek_Pospisil-Francis_Tiafoe,2,S-XC,7,2,0,1,1,3,4
20170210-M-San_Francisco_CH-QF-Vasek_Pospisil-Francis_Tiafoe,2,S-DTM,2,0,0,0,0,0,2
20170210-M-San_Francisco_CH-QF-Vasek_Pospisil-Francis_Tiafoe,2,S-IO,1,0,0,0,0,0,1
20080606-M-Roland_Garros-SF-Novak_Djokovic-Rafael_Nadal,1,F-XC,125,17,5,5,7,45,80
20080606-M-Roland_Garros-SF-Novak_Djokovic-Rafael_Nadal,1,F-DTM,26,1,0,0,1,7,19
20080606-M-Roland_Garros-SF-Novak_Djokovic-Rafael_Nadal,1,F-DTL,25,11,3,5,3,13,12
20080606-M-Roland_Garros-SF-Novak_Djokovic-Rafael_Nadal,1,F-IO,44,17,5,3,9,20,24
20080606-M-Roland_Garros-SF-Novak_Djokovic-Rafael_Nadal,1,F-II,2,1,0,1,0,2,0
20080606-M-Roland_Garros-SF-Novak_Djokovic-Rafael_Nadal,1,B-XC,70,14,7,1,6,27,43
20080606-M-Roland_Garros-SF-Novak_Djokovic-Rafael_Nadal,1,B-DTM,60,3,0,1,2,16,44
20080606-M-Roland_Garros-SF-Novak_Djokovic-Rafael_Nadal,1,B-DTL,43,7,2,2,3,18,25
20080606-M-Roland_Garros-SF-Novak_Djokovic-Rafael_Nadal,1,B-IO,11,0,0,0,0,7,4
20080606-M-Roland_Garros-SF-Novak_Djokovic-Rafael_Nadal,1,S-XC,1,0,0,0,0,0,1
20080606-M-Roland_Garros-SF-Novak_Djokovic-Rafael_Nadal,1,S-DTM,5,0,0,0,0,2,3
20080606-M-Roland_Garros-SF-Novak_Djokovic-Rafael_Nadal,1,S-DTL,3,0,0,0,0,3,0
20080606-M-Roland_Garros-SF-Novak_Djokovic-Rafael_Nadal,1,S-IO,2,1,0,0,1,0,2
20080606-M-Roland_Garros-SF-Novak_Djokovic-Rafael_Nadal,2,F-XC,110,15,5,8,2,74,36
20080606-M-Roland_Garros-SF-Novak_Djokovic-Rafael_Nadal,2,F-DTM,27,2,1,0,1,13,14
20080606-M-Roland_Garros-SF-Novak_Djokovic-Rafael_Nadal,2,F-DTL,37,10,4,4,2,28,9
20080606-M-Roland_Garros-SF-Novak_Djokovic-Rafael_Nadal,2,F-IO,35,8,5,3,0,26,9
20080606-M-Roland_Garros-SF-Novak_Djokovic-Rafael_Nadal,2,F-II,20,3,1,1,1,12,8
20080606-M-Roland_Garros-SF-Novak_Djokovic-Rafael_Nadal,2,B-XC,69,11,2,5,4,46,23
20080606-M-Roland_Garros-SF-Novak_Djokovic-Rafael_Nadal,2,B-DTM,40,5,0,0,5,25,15
20080606-M-Roland_Garros-SF-Novak_Djokovic-Rafael_Nadal,2,B-DTL,33,6,1,3,2,18,15
20080606-M-Roland_Garros-SF-Novak_Djokovic-Rafael_Nadal,2,B-IO,7,0,0,0,0,4,3
20080606-M-Roland_Garros-SF-Novak_Djokovic-Rafael_Nadal,2,S-XC,5,1,0,1,0,4,1
20080606-M-Roland_Garros-SF-Novak_Djokovic-Rafael_Nadal,2,S-DTM,13,0,0,0,0,8,5
20080606-M-Roland_Garros-SF-Novak_Djokovic-Rafael_Nadal,2,S-DTL,14,1,0,0,1,8,6
20080606-M-Roland_Garros-SF-Novak_Djokovic-Rafael_Nadal,2,S-IO,3,0,0,0,0,2,1
20060423-M-Monte_Carlo_Masters-F-Roger_Federer-Rafael_Nadal,1,F-XC,113,20,8,4,8,56,57
20060423-M-Monte_Carlo_Masters-F-Roger_Federer-Rafael_Nadal,1,F-DTM,100,2,0,0,2,39,61
20060423-M-Monte_Carlo_Masters-F-Roger_Federer-Rafael_Nadal,1,F-DTL,15,10,4,3,3,10,5
20060423-M-Monte_Carlo_Masters-F-Roger_Federer-Rafael_Nadal,1,F-IO,76,29,14,7,8,42,34
20060423-M-Monte_Carlo_Masters-F-Roger_Federer-Rafael_Nadal,1,F-II,14,9,2,4,3,10,4
20060423-M-Monte_Carlo_Masters-F-Roger_Federer-Rafael_Nadal,1,B-XC,56,15,2,2,11,18,38
20060423-M-Monte_Carlo_Masters-F-Roger_Federer-Rafael_Nadal,1,B-DTM,90,13,0,0,13,22,68
20060423-M-Monte_Carlo_Masters-F-Roger_Federer-Rafael_Nadal,1,B-DTL,18,6,2,0,4,7,11
20060423-M-Monte_Carlo_Masters-F-Roger_Federer-Rafael_Nadal,1,B-IO,9,2,1,0,1,4,5
20060423-M-Monte_Carlo_Masters-F-Roger_Federer-Rafael_Nadal,1,S-XC,14,5,1,1,3,3,11
20060423-M-Monte_Carlo_Masters-F-Roger_Federer-Rafael_Nadal,1,S-DTM,23,2,0,0,2,4,19
20060423-M-Monte_Carlo_Masters-F-Roger_Federer-Rafael_Nadal,1,S-DTL,12,3,0,1,2,4,8
20060423-M-Monte_Carlo_Masters-F-Roger_Federer-Rafael_Nadal,2,F-XC,174,19,8,5,6,119,55
20060423-M-Monte_Carlo_Masters-F-Roger_Federer-Rafael_Nadal,2,F-DTM,94,9,1,3,5,59,35
20060423-M-Monte_Carlo_Masters-F-Roger_Federer-Rafael_Nadal,2,F-DTL,10,4,3,1,0,10,0
20060423-M-Monte_Carlo_Masters-F-Roger_Federer-Rafael_Nadal,2,F-IO,42,15,7,6,2,33,9
20060423-M-Monte_Carlo_Masters-F-Roger_Federer-Rafael_Nadal,2,F-II,8,4,0,4,0,6,2
20060423-M-Monte_Carlo_Masters-F-Roger_Federer-Rafael_Nadal,2,B-XC,69,15,5,5,5,35,34
20060423-M-Monte_Carlo_Masters-F-Roger_Federer-Rafael_Nadal,2,B-DTM,85,7,1,2,4,39,46
20060423-M-Monte_Carlo_Masters-F-Roger_Federer-Rafael_Nadal,2,B-DTL,18,3,2,0,1,12,6
20060423-M-Monte_Carlo_Masters-F-Roger_Federer-Rafael_Nadal,2,B-IO,14,1,0,0,1,9,5
20060423-M-Monte_Carlo_Masters-F-Roger_Federer-Rafael_Nadal,2,B-II,1,1,0,0,1,0,1
20060423-M-Monte_Carlo_Masters-F-Roger_Federer-Rafael_Nadal,2,S-XC,1,0,0,0,0,0,1
20060423-M-Monte_Carlo_Masters-F-Roger_Federer-Rafael_Nadal,2,S-DTM,10,1,0,0,1,1,9
20060423-M-Monte_Carlo_Masters-F-Roger_Federer-Rafael_Nadal,2,S-DTL,6,0,0,0,0,2,4
20170126-M-Australian_Open-SF-Roger_Federer-Stanislas_Wawrinka,1,F-XC,43,15,3,6,6,25,18
20170126-M-Australian_Open-SF-Roger_Federer-Stanislas_Wawrinka,1,F-DTM,38,6,0,2,4,17,21
20170126-M-Australian_Open-SF-Roger_Federer-Stanislas_Wawrinka,1,F-DTL,11,2,2,0,0,7,4
20170126-M-Australian_Open-SF-Roger_Federer-Stanislas_Wawrinka,1,F-IO,37,11,3,1,7,22,15
20170126-M-Australian_Open-SF-Roger_Federer-Stanislas_Wawrinka,1,F-II,4,2,0,1,1,2,2
20170126-M-Australian_Open-SF-Roger_Federer-Stanislas_Wawrinka,1,B-XC,47,15,5,2,8,20,27
20170126-M-Australian_Open-SF-Roger_Federer-Stanislas_Wawrinka,1,B-DTM,33,7,0,1,6,17,16
20170126-M-Australian_Open-SF-Roger_Federer-Stanislas_Wawrinka,1,B-DTL,7,4,2,0,2,3,4
20170126-M-Australian_Open-SF-Roger_Federer-Stanislas_Wawrinka,1,B-IO,5,2,0,0,2,1,4
20170126-M-Australian_Open-SF-Roger_Federer-Stanislas_Wawrinka,1,S-XC,12,1,0,1,0,8,4
20170126-M-Australian_Open-SF-Roger_Federer-Stanislas_Wawrinka,1,S-DTM,8,0,0,0,0,2,6
20170126-M-Australian_Open-SF-Roger_Federer-Stanislas_Wawrinka,1,S-DTL,7,3,1,2,0,7,0
20170126-M-Australian_Open-SF-Roger_Federer-Stanislas_Wawrinka,1,S-IO,1,0,0,0,0,1,0
20170126-M-Australian_Open-SF-Roger_Federer-Stanislas_Wawrinka,2,F-XC,52,19,9,5,5,27,25
20170126-M-Australian_Open-SF-Roger_Federer-Stanislas_Wawrinka,2,F-DTM,35,0,0,0,0,17,18
20170126-M-Australian_Open-SF-Roger_Federer-Stanislas_Wawrinka,2,F-DTL,14,4,3,0,1,9,5
20170126-M-Australian_Open-SF-Roger_Federer-Stanislas_Wawrinka,2,F-IO,27,10,5,2,3,13,14
20170126-M-Australian_Open-SF-Roger_Federer-Stanislas_Wawrinka,2,F-II,5,3,1,2,0,5,0
20170126-M-Australian_Open-SF-Roger_Federer-Stanislas_Wawrinka,2,B-XC,70,20,7,4,9,39,31
20170126-M-Australian_Open-SF-Roger_Federer-Stanislas_Wawrinka,2,B-DTM,28,2,0,0,2,14,14
20170126-M-Australian_Open-SF-Roger_Federer-Stanislas_Wawrinka,2,B-DTL,11,5,0,0,5,3,8
20170126-M-Australian_Open-SF-Roger_Federer-Stanislas_Wawrinka,2,B-IO,4,3,0,1,2,2,2
20170126-M-Australian_Open-SF-Roger_Federer-Stanislas_Wawrinka,2,S-XC,17,0,0,0,0,6,11
20170126-M-Australian_Open-SF-Roger_Federer-Stanislas_Wawrinka,2,S-DTM,8,0,0,0,0,2,6
20170126-M-Australian_Open-SF-Roger_Federer-Stanislas_Wawrinka,2,S-DTL,3,0,0,0,0,1,2
20080511-M-Hamburg_Masters-F-Roger_Federer-Rafael_Nadal,1,F-XC,96,16,7,4,5,41,55
20080511-M-Hamburg_Masters-F-Roger_Federer-Rafael_Nadal,1,F-DTM,51,7,0,2,5,13,38
20080511-M-Hamburg_Masters-F-Roger_Federer-Rafael_Nadal,1,F-DTL,19,11,4,4,3,13,6
20080511-M-Hamburg_Masters-F-Roger_Federer-Rafael_Nadal,1,F-IO,25,11,3,5,3,11,14
20080511-M-Hamburg_Masters-F-Roger_Federer-Rafael_Nadal,1,F-II,11,4,0,3,1,6,5
20080511-M-Hamburg_Masters-F-Roger_Federer-Rafael_Nadal,1,B-XC,32,12,1,3,8,15,17
20080511-M-Hamburg_Masters-F-Roger_Federer-Rafael_Nadal,1,B-DTM,71,4,0,0,4,19,52
20080511-M-Hamburg_Masters-F-Roger_Federer-Rafael_Nadal,1,B-DTL,17,3,1,0,2,10,7
20080511-M-Hamburg_Masters-F-Roger_Federer-Rafael_Nadal,1,B-IO,9,1,1,0,0,4,5
20080511-M-Hamburg_Masters-F-Roger_Federer-Rafael_Nadal,1,S-XC,5,1,0,1,0,3,2
20080511-M-Hamburg_Masters-F-Roger_Federer-Rafael_Nadal,1,S-DTM,8,0,0,0,0,4,4
20080511-M-Hamburg_Masters-F-Roger_Federer-Rafael_Nadal,1,S-DTL,6,1,0,0,1,1,5
20080511-M-Hamburg_Masters-F-Roger_Federer-Rafael_Nadal,2,F-XC,104,17,5,6,6,61,43
20080511-M-Hamburg_Masters-F-Roger_Federer-Rafael_Nadal,2,F-DTM,40,3,0,2,1,27,13
20080511-M-Hamburg_Masters-F-Roger_Federer-Rafael_Nadal,2,F-DTL,11,6,3,2,1,8,3
20080511-M-Hamburg_Masters-F-Roger_Federer-Rafael_Nadal,2,F-IO,29,15,7,6,2,25,4
20080511-M-Hamburg_Masters-F-Roger_Federer-Rafael_Nadal,2,F-II,15,5,2,2,1,12,3
20080511-M-Hamburg_Masters-F-Roger_Federer-Rafael_Nadal,2,B-XC,71,14,3,4,7,40,31
20080511-M-Hamburg_Masters-F-Roger_Federer-Rafael_Nadal,2,B-DTM,48,1,0,1,0,35,13
20080511-M-Hamburg_Masters-F-Roger_Federer-Rafael_Nadal,2,B-DTL,18,3,2,1,0,8,10
20080511-M-Hamburg_Masters-F-Roger_Federer-Rafael_Nadal,2,B-IO,10,3,2,0,1,5,5
20080511-M-Hamburg_Masters-F-Roger_Federer-Rafael_Nadal,2,S-XC,1,1,1,0,0,1,0
20080511-M-Hamburg_Masters-F-Roger_Federer-Rafael_Nadal,2,S-DTM,9,0,0,0,0,3,6
20080511-M-Hamburg_Masters-F-Roger_Federer-Rafael_Nadal,2,S-DTL,4,0,0,0,0,2,2
20080511-M-Hamburg_Masters-F-Roger_Federer-Rafael_Nadal,2,S-IO,1,0,0,0,0,1,0
20021110-M-Paris_Masters-F-Marat_Safin-Lleyton_Hewitt,1,F-XC,82,13,3,4,6,38,44
20021110-M-Paris_Masters-F-Marat_Safin-Lleyton_Hewitt,1,F-DTM,27,4,0,1,3,11,16
20021110-M-Paris_Masters-F-Marat_Safin-Lleyton_Hewitt,1,F-DTL,19,7,3,1,3,8,11
20021110-M-Paris_Masters-F-Marat_Safin-Lleyton_Hewitt,1,F-IO,19,7,3,3,1,12,7
20021110-M-Paris_Masters-F-Marat_Safin-Lleyton_Hewitt,1,F-II,2,0,0,0,0,0,2
20021110-M-Paris_Masters-F-Marat_Safin-Lleyton_Hewitt,1,B-XC,75,6,1,4,1,38,37
20021110-M-Paris_Masters-F-Marat_Safin-Lleyton_Hewitt,1,B-DTM,28,1,0,0,1,4,24
20021110-M-Paris_Masters-F-Marat_Safin-Lleyton_Hewitt,1,B-DTL,17,6,3,1,2,9,8
20021110-M-Paris_Masters-F-Marat_Safin-Lleyton_Hewitt,1,B-IO,8,2,1,0,1,4,4
20021110-M-Paris_Masters-F-Marat_Safin-Lleyton_Hewitt,1,S-XC,7,1,0,0,1,4,3
20021110-M-Paris_Masters-F-Marat_Safin-Lleyton_Hewitt,1,S-DTM,5,1,0,0,1,1,4
20021110-M-Paris_Masters-F-Marat_Safin-Lleyton_Hewitt,1,S-DTL,1,0,0,0,0,1,0
20021110-M-Paris_Masters-F-Marat_Safin-Lleyton_Hewitt,2,F-XC,92,14,3,5,6,49,43
20021110-M-Paris_Masters-F-Marat_Safin-Lleyton_Hewitt,2,F-DTM,26,0,0,0,0,14,12
20021110-M-Paris_Masters-F-Marat_Safin-Lleyton_Hewitt,2,F-DTL,25,7,4,0,3,15,10
20021110-M-Paris_Masters-F-Marat_Safin-Lleyton_Hewitt,2,F-IO,21,6,2,3,1,14,7
20021110-M-Paris_Masters-F-Marat_Safin-Lleyton_Hewitt,2,F-II,4,1,0,1,0,2,2
20021110-M-Paris_Masters-F-Marat_Safin-Lleyton_Hewitt,2,B-XC,72,6,0,2,4,38,34
20021110-M-Paris_Masters-F-Marat_Safin-Lleyton_Hewitt,2,B-DTM,35,3,0,0,3,20,15
20021110-M-Paris_Masters-F-Marat_Safin-Lleyton_Hewitt,2,B-DTL,8,3,0,0,3,2,6
20021110-M-Paris_Masters-F-Marat_Safin-Lleyton_Hewitt,2,B-IO,5,0,0,0,0,2,3
20021110-M-Paris_Masters-F-Marat_Safin-Lleyton_Hewitt,2,S-XC,14,1,0,0,1,8,6
20021110-M-Paris_Masters-F-Marat_Safin-Lleyton_Hewitt,2,S-DTM,7,1,0,0,1,4,3
20021110-M-Paris_Masters-F-Marat_Safin-Lleyton_Hewitt,2,S-DTL,2,0,0,0,0,2,0
20021110-M-Paris_Masters-F-Marat_Safin-Lleyton_Hewitt,2,S-IO,1,1,1,0,0,1,0
20130224-M-Memphis-F-Feliciano_Lopez-Kei_Nishikori,1,F-XC,31,1,0,0,1,4,27
20130224-M-Memphis-F-Feliciano_Lopez-Kei_Nishikori,1,F-DTM,10,0,0,0,0,1,9
20130224-M-Memphis-F-Feliciano_Lopez-Kei_Nishikori,1,F-DTL,4,1,0,0,1,0,4
20130224-M-Memphis-F-Feliciano_Lopez-Kei_Nishikori,1,F-IO,4,2,0,1,1,1,3
20130224-M-Memphis-F-Feliciano_Lopez-Kei_Nishikori,1,B-XC,11,3,0,0,3,2,9
20130224-M-Memphis-F-Feliciano_Lopez-Kei_Nishikori,1,B-DTM,5,0,0,0,0,2,3
20130224-M-Memphis-F-Feliciano_Lopez-Kei_Nishikori,1,B-DTL,1,0,0,0,0,0,1
20130224-M-Memphis-F-Feliciano_Lopez-Kei_Nishikori,1,S-XC,23,2,0,1,1,3,20
20130224-M-Memphis-F-Feliciano_Lopez-Kei_Nishikori,1,S-DTM,13,1,0,0,1,6,7
20130224-M-Memphis-F-Feliciano_Lopez-Kei_Nishikori,1,S-DTL,10,1,0,0,1,5,5
20130224-M-Memphis-F-Feliciano_Lopez-Kei_Nishikori,1,S-IO,3,1,0,0,1,1,2
20130224-M-Memphis-F-Feliciano_Lopez-Kei_Nishikori,2,F-XC,36,4,2,2,0,26,10
20130224-M-Memphis-F-Feliciano_Lopez-Kei_Nishikori,2,F-DTM,5,2,2,0,0,4,1
20130224-M-Memphis-F-Feliciano_Lopez-Kei_Nishikori,2,F-DTL,20,7,6,1,0,19,1
20130224-M-Memphis-F-Feliciano_Lopez-Kei_Nishikori,2,F-IO,12,6,2,1,3,7,5
20130224-M-Memphis-F-Feliciano_Lopez-Kei_Nishikori,2,F-II,1,0,0,0,0,1,0
20130224-M-Memphis-F-Feliciano_Lopez-Kei_Nishikori,2,B-XC,29,10,1,6,3,22,7
20130224-M-Memphis-F-Feliciano_Lopez-Kei_Nishikori,2,B-DTM,8,1,0,0,1,6,2
20130224-M-Memphis-F-Feliciano_Lopez-Kei_Nishikori,2,B-DTL,14,1,0,1,0,12,2
20130224-M-Memphis-F-Feliciano_Lopez-Kei_Nishikori,2,B-IO,4,1,1,0,0,2,2
20130224-M-Memphis-F-Feliciano_Lopez-Kei_Nishikori,2,S-XC,2,0,0,0,0,1,1
20130224-M-Memphis-F-Feliciano_Lopez-Kei_Nishikori,2,S-DTM,2,0,0,0,0,2,0
20130224-M-Memphis-F-Feliciano_Lopez-Kei_Nishikori,2,S-DTL,1,0,0,0,0,0,1
20130224-M-Memphis-F-Feliciano_Lopez-Kei_Nishikori,2,S-IO,1,0,0,0,0,0,1
20170216-M-Cherbourg_CH-R16-Axel_Michon-Peter_Gojowczyk,1,F-XC,39,6,1,4,1,20,19
20170216-M-Cherbourg_CH-R16-Axel_Michon-Peter_Gojowczyk,1,F-DTM,10,1,0,0,1,2,8
20170216-M-Cherbourg_CH-R16-Axel_Michon-Peter_Gojowczyk,1,F-DTL,6,3,2,1,0,4,2
20170216-M-Cherbourg_CH-R16-Axel_Michon-Peter_Gojowczyk,1,F-IO,6,3,1,0,2,1,5
20170216-M-Cherbourg_CH-R16-Axel_Michon-Peter_Gojowczyk,1,B-XC,14,6,1,2,3,5,9
20170216-M-Cherbourg_CH-R16-Axel_Michon-Peter_Gojowczyk,1,B-DTM,11,2,0,1,1,3,8
20170216-M-Cherbourg_CH-R16-Axel_Michon-Peter_Gojowczyk,1,B-DTL,1,0,0,0,0,0,1
20170216-M-Cherbourg_CH-R16-Axel_Michon-Peter_Gojowczyk,1,B-IO,4,1,0,0,1,1,3
20170216-M-Cherbourg_CH-R16-Axel_Michon-Peter_Gojowczyk,1,S-XC,2,0,0,0,0,0,2
20170216-M-Cherbourg_CH-R16-Axel_Michon-Peter_Gojowczyk,1,S-DTM,1,0,0,0,0,1,0
20170216-M-Cherbourg_CH-R16-Axel_Michon-Peter_Gojowczyk,2,F-XC,21,6,4,1,1,15,6
20170216-M-Cherbourg_CH-R16-Axel_Michon-Peter_Gojowczyk,2,F-DTM,6,2,0,2,0,5,1
20170216-M-Cherbourg_CH-R16-Axel_Michon-Peter_Gojowczyk,2,F-DTL,10,3,0,2,1,8,2
20170216-M-Cherbourg_CH-R16-Axel_Michon-Peter_Gojowczyk,2,F-IO,11,4,1,1,2,7,4
20170216-M-Cherbourg_CH-R16-Axel_Michon-Peter_Gojowczyk,2,F-II,1,1,0,0,1,0,1
20170216-M-Cherbourg_CH-R16-Axel_Michon-Peter_Gojowczyk,2,B-XC,24,6,3,1,2,11,13
20170216-M-Cherbourg_CH-R16-Axel_Michon-Peter_Gojowczyk,2,B-DTM,10,0,0,0,0,6,4
20170216-M-Cherbourg_CH-R16-Axel_Michon-Peter_Gojowczyk,2,B-DTL,8,4,2,1,1,5,3
20170216-M-Cherbourg_CH-R16-Axel_Michon-Peter_Gojowczyk,2,B-IO,1,1,0,1,0,1,0
20170216-M-Cherbourg_CH-R16-Axel_Michon-Peter_Gojowczyk,2,S-DTM,1,0,0,0,0,0,1
20170216-M-Cherbourg_CH-R16-Axel_Michon-Peter_Gojowczyk,2,S-DTL,1,0,0,0,0,1,0
20151118-M-Tour_Finals-RR-Rafael_Nadal-Andy_Murray,1,F-XC,44,6,1,3,2,33,11
20151118-M-Tour_Finals-RR-Rafael_Nadal-Andy_Murray,1,F-DTM,17,1,0,0,1,10,7
20151118-M-Tour_Finals-RR-Rafael_Nadal-Andy_Murray,1,F-DTL,10,4,1,3,0,8,2
20151118-M-Tour_Finals-RR-Rafael_Nadal-Andy_Murray,1,F-IO,23,5,2,2,1,16,7
20151118-M-Tour_Finals-RR-Rafael_Nadal-Andy_Murray,1,F-II,4,1,0,1,0,3,1
20151118-M-Tour_Finals-RR-Rafael_Nadal-Andy_Murray,1,B-XC,58,6,0,3,3,38,20
20151118-M-Tour_Finals-RR-Rafael_Nadal-Andy_Murray,1,B-DTM,27,2,0,1,1,13,14
20151118-M-Tour_Finals-RR-Rafael_Nadal-Andy_Murray,1,B-DTL,9,0,0,0,0,6,3
20151118-M-Tour_Finals-RR-Rafael_Nadal-Andy_Murray,1,B-IO,2,1,1,0,0,1,1
20151118-M-Tour_Finals-RR-Rafael_Nadal-Andy_Murray,1,S-XC,6,0,0,0,0,2,4
20151118-M-Tour_Finals-RR-Rafael_Nadal-Andy_Murray,1,S-DTM,5,0,0,0,0,4,1
20151118-M-Tour_Finals-RR-Rafael_Nadal-Andy_Murray,1,S-DTL,5,0,0,0,0,5,0
20151118-M-Tour_Finals-RR-Rafael_Nadal-Andy_Murray,2,F-XC,90,8,0,5,3,30,60
20151118-M-Tour_Finals-RR-Rafael_Nadal-Andy_Murray,2,F-DTM,14,2,0,0,2,3,11
20151118-M-Tour_Finals-RR-Rafael_Nadal-Andy_Murray,2,F-DTL,18,8,2,2,4,10,8
20151118-M-Tour_Finals-RR-Rafael_Nadal-Andy_Murray,2,F-IO,9,3,0,1,2,3,6
20151118-M-Tour_Finals-RR-Rafael_Nadal-Andy_Murray,2,B-XC,27,6,2,2,2,8,19
20151118-M-Tour_Finals-RR-Rafael_Nadal-Andy_Murray,2,B-DTM,11,0,0,0,0,5,6
20151118-M-Tour_Finals-RR-Rafael_Nadal-Andy_Murray,2,B-DTL,19,7,1,0,6,5,14
20151118-M-Tour_Finals-RR-Rafael_Nadal-Andy_Murray,2,B-IO,10,4,1,1,2,5,5
20151118-M-Tour_Finals-RR-Rafael_Nadal-Andy_Murray,2,S-XC,3,0,0,0,0,0,3
20151118-M-Tour_Finals-RR-Rafael_Nadal-Andy_Murray,2,S-DTM,3,0,0,0,0,0,3
20151118-M-Tour_Finals-RR-Rafael_Nadal-Andy_Murray,2,S-DTL,5,0,0,0,0,1,4
20080420-M-Monte_Carlo_Masters-F-Rafael_Nadal-Roger_Federer,1,F-XC,104,11,3,5,3,71,33
20080420-M-Monte_Carlo_Masters-F-Rafael_Nadal-Roger_Federer,1,F-DTM,26,3,0,2,1,15,11
20080420-M-Monte_Carlo_Masters-F-Rafael_Nadal-Roger_Federer,1,F-DTL,6,3,3,0,0,5,1
20080420-M-Monte_Carlo_Masters-F-Rafael_Nadal-Roger_Federer,1,F-IO,14,7,0,2,5,8,6
20080420-M-Monte_Carlo_Masters-F-Rafael_Nadal-Roger_Federer,1,F-II,13,2,0,2,0,11,2
20080420-M-Monte_Carlo_Masters-F-Rafael_Nadal-Roger_Federer,1,B-XC,31,6,3,1,2,18,13
20080420-M-Monte_Carlo_Masters-F-Rafael_Nadal-Roger_Federer,1,B-DTM,38,3,0,1,2,21,17
20080420-M-Monte_Carlo_Masters-F-Rafael_Nadal-Roger_Federer,1,B-DTL,13,1,0,0,1,6,7
20080420-M-Monte_Carlo_Masters-F-Rafael_Nadal-Roger_Federer,1,B-IO,8,1,0,1,0,5,3
20080420-M-Monte_Carlo_Masters-F-Rafael_Nadal-Roger_Federer,1,S-XC,3,1,1,0,0,2,1
20080420-M-Monte_Carlo_Masters-F-Rafael_Nadal-Roger_Federer,1,S-DTM,7,0,0,0,0,2,5
20080420-M-Monte_Carlo_Masters-F-Rafael_Nadal-Roger_Federer,1,S-DTL,2,0,0,0,0,0,2
20080420-M-Monte_Carlo_Masters-F-Rafael_Nadal-Roger_Federer,1,S-IO,1,0,0,0,0,0,1
20080420-M-Monte_Carlo_Masters-F-Rafael_Nadal-Roger_Federer,2,F-XC,53,11,2,2,7,24,29
20080420-M-Monte_Carlo_Masters-F-Rafael_Nadal-Roger_Federer,2,F-DTM,29,3,0,1,2,8,21
20080420-M-Monte_Carlo_Masters-F-Rafael_Nadal-Roger_Federer,2,F-DTL,5,1,0,1,0,2,3
20080420-M-Monte_Carlo_Masters-F-Rafael_Nadal-Roger_Federer,2,F-IO,26,11,4,0,7,10,16
20080420-M-Monte_Carlo_Masters-F-Rafael_Nadal-Roger_Federer,2,F-II,18,4,0,1,3,9,9
20080420-M-Monte_Carlo_Masters-F-Rafael_Nadal-Roger_Federer,2,B-XC,35,8,1,3,4,13,22
20080420-M-Monte_Carlo_Masters-F-Rafael_Nadal-Roger_Federer,2,B-DTM,47,1,0,0,1,12,35
20080420-M-Monte_Carlo_Masters-F-Rafael_Nadal-Roger_Federer,2,B-DTL,19,4,0,0,4,6,13
20080420-M-Monte_Carlo_Masters-F-Rafael_Nadal-Roger_Federer,2,B-IO,8,1,0,0,1,2,6
20080420-M-Monte_Carlo_Masters-F-Rafael_Nadal-Roger_Federer,2,S-XC,2,0,0,0,0,1,1
20080420-M-Monte_Carlo_Masters-F-Rafael_Nadal-Roger_Federer,2,S-DTM,7,1,0,0,1,1,6
20080420-M-Monte_Carlo_Masters-F-Rafael_Nadal-Roger_Federer,2,S-DTL,11,0,0,0,0,5,6
20030316-M-Indian_Wells_Masters-F-Lleyton_Hewitt-Gustavo_Kuerten,1,F-XC,24,3,1,0,2,18,6
20030316-M-Indian_Wells_Masters-F-Lleyton_Hewitt-Gustavo_Kuerten,1,F-DTM,6,1,0,0,1,4,2
20030316-M-Indian_Wells_Masters-F-Lleyton_Hewitt-Gustavo_Kuerten,1,F-DTL,15,4,1,2,1,12,3
20030316-M-Indian_Wells_Masters-F-Lleyton_Hewitt-Gustavo_Kuerten,1,F-IO,17,4,4,0,0,13,4
20030316-M-Indian_Wells_Masters-F-Lleyton_Hewitt-Gustavo_Kuerten,1,F-II,6,4,1,0,3,3,3
20030316-M-Indian_Wells_Masters-F-Lleyton_Hewitt-Gustavo_Kuerten,1,B-XC,51,6,1,1,4,41,10
20030316-M-Indian_Wells_Masters-F-Lleyton_Hewitt-Gustavo_Kuerten,1,B-DTM,6,0,0,0,0,4,2
20030316-M-Indian_Wells_Masters-F-Lleyton_Hewitt-Gustavo_Kuerten,1,B-DTL,3,2,1,0,1,2,1
20030316-M-Indian_Wells_Masters-F-Lleyton_Hewitt-Gustavo_Kuerten,1,S-XC,9,0,0,0,0,9,0
20030316-M-Indian_Wells_Masters-F-Lleyton_Hewitt-Gustavo_Kuerten,1,S-DTM,1,0,0,0,0,1,0
20030316-M-Indian_Wells_Masters-F-Lleyton_Hewitt-Gustavo_Kuerten,2,F-XC,25,3,0,0,3,5,20
20030316-M-Indian_Wells_Masters-F-Lleyton_Hewitt-Gustavo_Kuerten,2,F-DTM,3,0,0,0,0,2,1
20030316-M-Indian_Wells_Masters-F-Lleyton_Hewitt-Gustavo_Kuerten,2,F-DTL,10,2,0,0,2,1,9
20030316-M-Indian_Wells_Masters-F-Lleyton_Hewitt-Gustavo_Kuerten,2,F-IO,15,10,2,2,6,5,10
20030316-M-Indian_Wells_Masters-F-Lleyton_Hewitt-Gustavo_Kuerten,2,F-II,3,0,0,0,0,1,2
20030316-M-Indian_Wells_Masters-F-Lleyton_Hewitt-Gustavo_Kuerten,2,B-XC,60,10,0,2,8,9,51
20030316-M-Indian_Wells_Masters-F-Lleyton_Hewitt-Gustavo_Kuerten,2,B-DTM,6,0,0,0,0,2,4
20030316-M-Indian_Wells_Masters-F-Lleyton_Hewitt-Gustavo_Kuerten,2,B-DTL,15,10,2,2,6,5,10
20030316-M-Indian_Wells_Masters-F-Lleyton_Hewitt-Gustavo_Kuerten,2,B-IO,2,2,1,0,1,1,1
20030316-M-Indian_Wells_Masters-F-Lleyton_Hewitt-Gustavo_Kuerten,2,S-XC,8,0,0,0,0,3,5
20070415-M-Monte_Carlo_Masters-F-Roger_Federer-Rafael_Nadal,1,F-XC,48,9,1,0,8,19,29
20070415-M-Monte_Carlo_Masters-F-Roger_Federer-Rafael_Nadal,1,F-DTM,36,3,0,0,3,14,22
20070415-M-Monte_Carlo_Masters-F-Roger_Federer-Rafael_Nadal,1,F-DTL,6,4,2,1,1,4,2
20070415-M-Monte_Carlo_Masters-F-Roger_Federer-Rafael_Nadal,1,F-IO,18,9,2,5,2,12,6
20070415-M-Monte_Carlo_Masters-F-Roger_Federer-Rafael_Nadal,1,F-II,6,2,1,0,1,3,3
20070415-M-Monte_Carlo_Masters-F-Roger_Federer-Rafael_Nadal,1,B-XC,25,5,0,0,5,6,19
20070415-M-Monte_Carlo_Masters-F-Roger_Federer-Rafael_Nadal,1,B-DTM,39,2,0,0,2,9,30
20070415-M-Monte_Carlo_Masters-F-Roger_Federer-Rafael_Nadal,1,B-DTL,16,2,1,0,1,9,7
20070415-M-Monte_Carlo_Masters-F-Roger_Federer-Rafael_Nadal,1,B-IO,4,0,0,0,0,2,2
20070415-M-Monte_Carlo_Masters-F-Roger_Federer-Rafael_Nadal,1,S-XC,3,0,0,0,0,0,3
20070415-M-Monte_Carlo_Masters-F-Roger_Federer-Rafael_Nadal,1,S-DTM,4,0,0,0,0,1,3
20070415-M-Monte_Carlo_Masters-F-Roger_Federer-Rafael_Nadal,1,S-DTL,8,3,1,0,2,3,5
20070415-M-Monte_Carlo_Masters-F-Roger_Federer-Rafael_Nadal,1,S-IO,1,0,0,0,0,1,0
20070415-M-Monte_Carlo_Masters-F-Roger_Federer-Rafael_Nadal,2,F-XC,69,5,2,2,1,51,18
20070415-M-Monte_Carlo_Masters-F-Roger_Federer-Rafael_Nadal,2,F-DTM,39,4,0,0,4,23,16
20070415-M-Monte_Carlo_Masters-F-Roger_Federer-Rafael_Nadal,2,F-DTL,7,5,5,0,0,5,2
20070415-M-Monte_Carlo_Masters-F-Roger_Federer-Rafael_Nadal,2,F-IO,18,8,1,2,5,7,11
20070415-M-Monte_Carlo_Masters-F-Roger_Federer-Rafael_Nadal,2,F-II,10,1,0,0,1,5,5
20070415-M-Monte_Carlo_Masters-F-Roger_Federer-Rafael_Nadal,2,B-XC,32,5,1,4,0,20,12
20070415-M-Monte_Carlo_Masters-F-Roger_Federer-Rafael_Nadal,2,B-DTM,29,4,0,0,4,13,16
20070415-M-Monte_Carlo_Masters-F-Roger_Federer-Rafael_Nadal,2,B-DTL,10,3,2,0,1,6,4
20070415-M-Monte_Carlo_Masters-F-Roger_Federer-Rafael_Nadal,2,B-IO,4,1,1,0,0,4,0
20070415-M-Monte_Carlo_Masters-F-Roger_Federer-Rafael_Nadal,2,S-XC,2,0,0,0,0,1,1
20070415-M-Monte_Carlo_Masters-F-Roger_Federer-Rafael_Nadal,2,S-DTL,2,0,0,0,0,1,1
20170219-M-Buenos_Aires-F-Alexandr_Dolgopolov-Kei_Nishikori,1,F-XC,14,6,2,2,2,6,8
20170219-M-Buenos_Aires-F-Alexandr_Dolgopolov-Kei_Nishikori,1,F-DTM,9,1,0,0,1,5,4
20170219-M-Buenos_Aires-F-Alexandr_Dolgopolov-Kei_Nishikori,1,F-DTL,12,3,1,1,1,5,7
20170219-M-Buenos_Aires-F-Alexandr_Dolgopolov-Kei_Nishikori,1,F-IO,13,7,6,1,0,9,4
20170219-M-Buenos_Aires-F-Alexandr_Dolgopolov-Kei_Nishikori,1,F-II,1,1,1,0,0,1,0
20170219-M-Buenos_Aires-F-Alexandr_Dolgopolov-Kei_Nishikori,1,B-XC,54,15,4,3,8,31,23
20170219-M-Buenos_Aires-F-Alexandr_Dolgopolov-Kei_Nishikori,1,B-DTM,28,6,1,1,4,13,15
20170219-M-Buenos_Aires-F-Alexandr_Dolgopolov-Kei_Nishikori,1,B-DTL,10,6,1,1,4,5,5
20170219-M-Buenos_Aires-F-Alexandr_Dolgopolov-Kei_Nishikori,1,B-IO,4,3,1,0,2,2,2
20170219-M-Buenos_Aires-F-Alexandr_Dolgopolov-Kei_Nishikori,1,S-XC,1,0,0,0,0,0,1
20170219-M-Buenos_Aires-F-Alexandr_Dolgopolov-Kei_Nishikori,1,S-DTM,3,0,0,0,0,1,2
20170219-M-Buenos_Aires-F-Alexandr_Dolgopolov-Kei_Nishikori,1,S-IO,1,0,0,0,0,1,0
20170219-M-Buenos_Aires-F-Alexandr_Dolgopolov-Kei_Nishikori,1,S-II,1,0,0,0,0,1,0
20170219-M-Buenos_Aires-F-Alexandr_Dolgopolov-Kei_Nishikori,2,F-XC,22,8,2,5,1,17,5
20170219-M-Buenos_Aires-F-Alexandr_Dolgopolov-Kei_Nishikori,2,F-DTM,13,0,0,0,0,6,7
20170219-M-Buenos_Aires-F-Alexandr_Dolgopolov-Kei_Nishikori,2,F-DTL,8,1,0,0,1,4,4
20170219-M-Buenos_Aires-F-Alexandr_Dolgopolov-Kei_Nishikori,2,F-IO,17,3,0,0,3,6,11
20170219-M-Buenos_Aires-F-Alexandr_Dolgopolov-Kei_Nishikori,2,F-II,1,0,0,0,0,0,1
20170219-M-Buenos_Aires-F-Alexandr_Dolgopolov-Kei_Nishikori,2,B-XC,45,7,1,4,2,25,20
20170219-M-Buenos_Aires-F-Alexandr_Dolgopolov-Kei_Nishikori,2,B-DTM,19,0,0,0,0,8,11
20170219-M-Buenos_Aires-F-Alexandr_Dolgopolov-Kei_Nishikori,2,B-DTL,14,8,2,2,4,6,8
20170219-M-Buenos_Aires-F-Alexandr_Dolgopolov-Kei_Nishikori,2,B-IO,1,1,0,0,1,0,1
20170219-M-Buenos_Aires-F-Alexandr_Dolgopolov-Kei_Nishikori,2,B-II,1,0,0,0,0,1,0
20170219-M-Buenos_Aires-F-Alexandr_Dolgopolov-Kei_Nishikori,2,S-XC,3,1,0,0,1,0,3
20170219-M-Buenos_Aires-F-Alexandr_Dolgopolov-Kei_Nishikori,2,S-DTM,3,1,0,0,1,1,2
20170219-M-Buenos_Aires-F-Alexandr_Dolgopolov-Kei_Nishikori,2,S-DTL,1,0,0,0,0,0,1
20150517-M-Rome_Masters-F-Novak_Djokovic-Roger_Federer,1,F-XC,24,9,6,2,0,21,3
20150517-M-Rome_Masters-F-Novak_Djokovic-Roger_Federer,1,F-DTM,10,1,0,0,1,7,3
20150517-M-Rome_Masters-F-Novak_Djokovic-Roger_Federer,1,F-DTL,7,0,0,0,0,5,2
20150517-M-Rome_Masters-F-Novak_Djokovic-Roger_Federer,1,F-IO,14,3,1,2,0,12,2
20150517-M-Rome_Masters-F-Novak_Djokovic-Roger_Federer,1,B-XC,24,1,1,0,0,21,3
20150517-M-Rome_Masters-F-Novak_Djokovic-Roger_Federer,1,B-DTM,13,1,0,0,1,9,4
20150517-M-Rome_Masters-F-Novak_Djokovic-Roger_Federer,1,B-DTL,5,1,1,0,0,3,2
20150517-M-Rome_Masters-F-Novak_Djokovic-Roger_Federer,1,B-IO,3,0,0,0,0,0,3
20150517-M-Rome_Masters-F-Novak_Djokovic-Roger_Federer,1,S-XC,1,0,0,0,0,0,1
20150517-M-Rome_Masters-F-Novak_Djokovic-Roger_Federer,1,S-DTM,2,1,0,1,0,1,1
20150517-M-Rome_Masters-F-Novak_Djokovic-Roger_Federer,2,F-XC,25,6,1,2,3,11,14
20150517-M-Rome_Masters-F-Novak_Djokovic-Roger_Federer,2,F-DTM,8,1,0,0,1,2,6
20150517-M-Rome_Masters-F-Novak_Djokovic-Roger_Federer,2,F-DTL,5,1,0,0,1,1,4
20150517-M-Rome_Masters-F-Novak_Djokovic-Roger_Federer,2,F-IO,13,5,3,1,1,9,4
20150517-M-Rome_Masters-F-Novak_Djokovic-Roger_Federer,2,B-XC,11,2,1,1,0,2,9
20150517-M-Rome_Masters-F-Novak_Djokovic-Roger_Federer,2,B-DTM,15,2,0,0,2,3,12
20150517-M-Rome_Masters-F-Novak_Djokovic-Roger_Federer,2,B-DTL,7,3,2,0,1,3,4
20150517-M-Rome_Masters-F-Novak_Djokovic-Roger_Federer,2,S-XC,10,0,0,0,0,3,7
20150517-M-Rome_Masters-F-Novak_Djokovic-Roger_Federer,2,S-DTM,5,0,0,0,0,0,5
20150517-M-Rome_Masters-F-Novak_Djokovic-Roger_Federer,2,S-DTL,2,1,0,0,1,0,2
20161017-M-Stockholm-F-Jack_Sock-Juan_Martin_Del_Potro,1,F-XC,9,3,0,1,2,2,7
20161017-M-Stockholm-F-Jack_Sock-Juan_Martin_Del_Potro,1,F-DTM,15,2,0,0,2,6,9
20161017-M-Stockholm-F-Jack_Sock-Juan_Martin_Del_Potro,1,F-DTL,3,2,1,0,1,1,2
20161017-M-Stockholm-F-Jack_Sock-Juan_Martin_Del_Potro,1,F-IO,34,6,2,0,4,16,18
20161017-M-Stockholm-F-Jack_Sock-Juan_Martin_Del_Potro,1,F-II,9,7,3,1,3,5,4
20161017-M-Stockholm-F-Jack_Sock-Juan_Martin_Del_Potro,1,B-XC,10,4,0,0,4,4,6
20161017-M-Stockholm-F-Jack_Sock-Juan_Martin_Del_Potro,1,B-DTM,7,2,0,0,2,0,7
20161017-M-Stockholm-F-Jack_Sock-Juan_Martin_Del_Potro,1,B-DTL,2,1,0,0,1,1,1
20161017-M-Stockholm-F-Jack_Sock-Juan_Martin_Del_Potro,1,S-XC,10,1,0,0,1,5,5
20161017-M-Stockholm-F-Jack_Sock-Juan_Martin_Del_Potro,1,S-DTM,7,0,0,0,0,1,6
20161017-M-Stockholm-F-Jack_Sock-Juan_Martin_Del_Potro,1,S-DTL,1,1,0,0,1,0,1
20161017-M-Stockholm-F-Jack_Sock-Juan_Martin_Del_Potro,2,F-XC,22,11,3,5,3,18,4
20161017-M-Stockholm-F-Jack_Sock-Juan_Martin_Del_Potro,2,F-DTM,6,1,1,0,0,5,1
20161017-M-Stockholm-F-Jack_Sock-Juan_Martin_Del_Potro,2,F-DTL,5,3,2,1,0,4,1
20161017-M-Stockholm-F-Jack_Sock-Juan_Martin_Del_Potro,2,F-IO,19,5,5,0,0,14,5
20161017-M-Stockholm-F-Jack_Sock-Juan_Martin_Del_Potro,2,F-II,5,0,0,0,0,4,1
20161017-M-Stockholm-F-Jack_Sock-Juan_Martin_Del_Potro,2,B-XC,23,2,1,1,0,11,12
20161017-M-Stockholm-F-Jack_Sock-Juan_Martin_Del_Potro,2,B-DTM,6,2,0,0,2,0,6
20161017-M-Stockholm-F-Jack_Sock-Juan_Martin_Del_Potro,2,B-DTL,3,2,1,0,1,1,2
20161017-M-Stockholm-F-Jack_Sock-Juan_Martin_Del_Potro,2,B-II,1,0,0,0,0,0,1
20161017-M-Stockholm-F-Jack_Sock-Juan_Martin_Del_Potro,2,S-XC,13,0,0,0,0,8,5
20161017-M-Stockholm-F-Jack_Sock-Juan_Martin_Del_Potro,2,S-DTM,4,0,0,0,0,1,3
20170127-M-Australian_Open-SF-Rafael_Nadal-Grigor_Dimitrov,1,F-XC,210,23,2,14,7,121,89
20170127-M-Australian_Open-SF-Rafael_Nadal-Grigor_Dimitrov,1,F-DTM,46,4,0,1,3,22,24
20170127-M-Australian_Open-SF-Rafael_Nadal-Grigor_Dimitrov,1,F-DTL,31,12,3,3,6,20,11
20170127-M-Australian_Open-SF-Rafael_Nadal-Grigor_Dimitrov,1,F-IO,54,24,9,6,9,33,21
20170127-M-Australian_Open-SF-Rafael_Nadal-Grigor_Dimitrov,1,F-II,19,4,0,2,2,13,6
20170127-M-Australian_Open-SF-Rafael_Nadal-Grigor_Dimitrov,1,B-XC,114,20,3,10,7,65,49
20170127-M-Australian_Open-SF-Rafael_Nadal-Grigor_Dimitrov,1,B-DTM,68,4,0,1,3,29,39
20170127-M-Australian_Open-SF-Rafael_Nadal-Grigor_Dimitrov,1,B-DTL,55,12,5,4,3,35,20
20170127-M-Australian_Open-SF-Rafael_Nadal-Grigor_Dimitrov,1,B-IO,6,0,0,0,0,6,0
20170127-M-Australian_Open-SF-Rafael_Nadal-Grigor_Dimitrov,1,S-XC,4,0,0,0,0,4,0
20170127-M-Australian_Open-SF-Rafael_Nadal-Grigor_Dimitrov,1,S-DTM,6,0,0,0,0,4,2
20170127-M-Australian_Open-SF-Rafael_Nadal-Grigor_Dimitrov,1,S-DTL,9,0,0,0,0,5,4
20170127-M-Australian_Open-SF-Rafael_Nadal-Grigor_Dimitrov,1,S-IO,1,0,0,0,0,1,0
20170127-M-Australian_Open-SF-Rafael_Nadal-Grigor_Dimitrov,2,F-XC,163,20,6,6,8,74,89
20170127-M-Australian_Open-SF-Rafael_Nadal-Grigor_Dimitrov,2,F-DTM,40,1,0,0,1,12,28
20170127-M-Australian_Open-SF-Rafael_Nadal-Grigor_Dimitrov,2,F-DTL,39,19,7,8,4,28,11
20170127-M-Australian_Open-SF-Rafael_Nadal-Grigor_Dimitrov,2,F-IO,87,28,13,7,8,50,37
20170127-M-Australian_Open-SF-Rafael_Nadal-Grigor_Dimitrov,2,F-II,28,6,1,3,2,17,11
20170127-M-Australian_Open-SF-Rafael_Nadal-Grigor_Dimitrov,2,B-XC,67,10,2,3,5,28,39
20170127-M-Australian_Open-SF-Rafael_Nadal-Grigor_Dimitrov,2,B-DTM,78,9,0,2,7,31,47
20170127-M-Australian_Open-SF-Rafael_Nadal-Grigor_Dimitrov,2,B-DTL,50,19,8,3,8,24,26
20170127-M-Australian_Open-SF-Rafael_Nadal-Grigor_Dimitrov,2,B-IO,3,3,0,2,1,2,1
20170127-M-Australian_Open-SF-Rafael_Nadal-Grigor_Dimitrov,2,S-XC,28,2,0,1,1,9,19
20170127-M-Australian_Open-SF-Rafael_Nadal-Grigor_Dimitrov,2,S-DTM,16,1,0,1,0,6,10
20170127-M-Australian_Open-SF-Rafael_Nadal-Grigor_Dimitrov,2,S-DTL,15,5,0,0,5,3,12
20170127-M-Australian_Open-SF-Rafael_Nadal-Grigor_Dimitrov,2,S-IO,2,1,0,0,1,0,2
20050403-M-Miami_Masters-F-Roger_Federer-Rafael_Nadal,1,F-XC,142,21,3,9,9,80,62
20050403-M-Miami_Masters-F-Roger_Federer-Rafael_Nadal,1,F-DTM,73,7,1,0,6,38,35
20050403-M-Miami_Masters-F-Roger_Federer-Rafael_Nadal,1,F-DTL,25,11,4,4,3,13,12
20050403-M-Miami_Masters-F-Roger_Federer-Rafael_Nadal,1,F-IO,62,23,8,8,7,40,22
20050403-M-Miami_Masters-F-Roger_Federer-Rafael_Nadal,1,F-II,8,4,2,0,2,4,4
20050403-M-Miami_Masters-F-Roger_Federer-Rafael_Nadal,1,B-XC,32,6,2,1,3,13,19
20050403-M-Miami_Masters-F-Roger_Federer-Rafael_Nadal,1,B-DTM,52,4,0,0,4,25,27
20050403-M-Miami_Masters-F-Roger_Federer-Rafael_Nadal,1,B-DTL,12,3,0,1,2,5,7
20050403-M-Miami_Masters-F-Roger_Federer-Rafael_Nadal,1,B-IO,11,3,0,0,3,5,6
20050403-M-Miami_Masters-F-Roger_Federer-Rafael_Nadal,1,S-XC,9,1,0,1,0,6,3
20050403-M-Miami_Masters-F-Roger_Federer-Rafael_Nadal,1,S-DTM,12,2,0,0,2,4,8
20050403-M-Miami_Masters-F-Roger_Federer-Rafael_Nadal,1,S-DTL,11,3,0,0,3,3,8
20050403-M-Miami_Masters-F-Roger_Federer-Rafael_Nadal,1,S-IO,4,1,0,0,1,0,4
20050403-M-Miami_Masters-F-Roger_Federer-Rafael_Nadal,2,F-XC,98,13,5,3,5,58,40
20050403-M-Miami_Masters-F-Roger_Federer-Rafael_Nadal,2,F-DTM,72,5,2,1,2,35,37
20050403-M-Miami_Masters-F-Roger_Federer-Rafael_Nadal,2,F-DTL,17,5,1,2,2,9,8
20050403-M-Miami_Masters-F-Roger_Federer-Rafael_Nadal,2,F-IO,40,15,4,4,7,21,19
20050403-M-Miami_Masters-F-Roger_Federer-Rafael_Nadal,2,F-II,10,2,1,1,0,10,0
20050403-M-Miami_Masters-F-Roger_Federer-Rafael_Nadal,2,B-XC,100,21,9,4,8,49,51
20050403-M-Miami_Masters-F-Roger_Federer-Rafael_Nadal,2,B-DTM,102,7,0,2,5,33,69
20050403-M-Miami_Masters-F-Roger_Federer-Rafael_Nadal,2,B-DTL,21,8,2,1,5,7,14
20050403-M-Miami_Masters-F-Roger_Federer-Rafael_Nadal,2,B-IO,11,2,1,0,1,8,3
20050403-M-Miami_Masters-F-Roger_Federer-Rafael_Nadal,2,S-XC,1,0,0,0,0,0,1
20050403-M-Miami_Masters-F-Roger_Federer-Rafael_Nadal,2,S-DTM,7,1,0,0,1,4,3
20050403-M-Miami_Masters-F-Roger_Federer-Rafael_Nadal,2,S-DTL,1,0,0,0,0,0,1
20080127-M-Australian_Open-SF-Novak_Djokovic-Roger_Federer,1,F-XC,65,20,9,9,2,41,24
20080127-M-Australian_Open-SF-Novak_Djokovic-Roger_Federer,1,F-DTM,19,1,0,0,1,11,8
20080127-M-Australian_Open-SF-Novak_Djokovic-Roger_Federer,1,F-DTL,11,2,1,1,0,6,5
20080127-M-Australian_Open-SF-Novak_Djokovic-Roger_Federer,1,F-IO,25,8,2,3,3,12,13
20080127-M-Australian_Open-SF-Novak_Djokovic-Roger_Federer,1,F-II,2,0,0,0,0,1,1
20080127-M-Australian_Open-SF-Novak_Djokovic-Roger_Federer,1,B-XC,85,9,1,3,5,40,45
20080127-M-Australian_Open-SF-Novak_Djokovic-Roger_Federer,1,B-DTM,29,3,0,1,2,9,20
20080127-M-Australian_Open-SF-Novak_Djokovic-Roger_Federer,1,B-DTL,18,7,3,1,3,10,8
20080127-M-Australian_Open-SF-Novak_Djokovic-Roger_Federer,1,B-IO,4,3,0,2,1,3,1
20080127-M-Australian_Open-SF-Novak_Djokovic-Roger_Federer,1,S-XC,3,1,0,0,1,1,2
20080127-M-Australian_Open-SF-Novak_Djokovic-Roger_Federer,1,S-DTM,1,0,0,0,0,0,1
20080127-M-Australian_Open-SF-Novak_Djokovic-Roger_Federer,2,F-XC,66,16,5,4,7,27,39
20080127-M-Australian_Open-SF-Novak_Djokovic-Roger_Federer,2,F-DTM,23,2,0,0,2,12,11
20080127-M-Australian_Open-SF-Novak_Djokovic-Roger_Federer,2,F-DTL,17,7,2,2,3,7,10
20080127-M-Australian_Open-SF-Novak_Djokovic-Roger_Federer,2,F-IO,20,6,2,2,2,15,5
20080127-M-Australian_Open-SF-Novak_Djokovic-Roger_Federer,2,F-II,5,0,0,0,0,3,2
20080127-M-Australian_Open-SF-Novak_Djokovic-Roger_Federer,2,B-XC,49,7,1,3,3,29,20
20080127-M-Australian_Open-SF-Novak_Djokovic-Roger_Federer,2,B-DTM,30,2,0,0,2,10,20
20080127-M-Australian_Open-SF-Novak_Djokovic-Roger_Federer,2,B-DTL,20,7,2,1,4,9,11
20080127-M-Australian_Open-SF-Novak_Djokovic-Roger_Federer,2,B-IO,4,3,1,1,1,3,1
20080127-M-Australian_Open-SF-Novak_Djokovic-Roger_Federer,2,S-XC,27,1,0,0,1,13,14
20080127-M-Australian_Open-SF-Novak_Djokovic-Roger_Federer,2,S-DTM,3,0,0,0,0,3,0
20080127-M-Australian_Open-SF-Novak_Djokovic-Roger_Federer,2,S-DTL,2,0,0,0,0,1,1
19901104-M-Paris_Masters-F-Boris_Becker-Stefan_Edberg,1,F-XC,3,0,0,0,0,3,0
19901104-M-Paris_Masters-F-Boris_Becker-Stefan_Edberg,1,F-DTL,2,0,0,0,0,0,2
19901104-M-Paris_Masters-F-Boris_Becker-Stefan_Edberg,1,F-IO,4,1,0,1,0,3,1
19901104-M-Paris_Masters-F-Boris_Becker-Stefan_Edberg,1,F-II,2,0,0,0,0,1,1
19901104-M-Paris_Masters-F-Boris_Becker-Stefan_Edberg,1,B-XC,6,2,0,0,2,1,5
19901104-M-Paris_Masters-F-Boris_Becker-Stefan_Edberg,1,B-DTL,2,1,0,0,1,0,2
19901104-M-Paris_Masters-F-Boris_Becker-Stefan_Edberg,1,S-XC,1,0,0,0,0,0,1
19901104-M-Paris_Masters-F-Boris_Becker-Stefan_Edberg,1,S-DTL,2,0,0,0,0,1,1
19901104-M-Paris_Masters-F-Boris_Becker-Stefan_Edberg,2,F-XC,4,1,0,1,0,2,2
19901104-M-Paris_Masters-F-Boris_Becker-Stefan_Edberg,2,F-DTM,1,1,1,0,0,1,0
19901104-M-Paris_Masters-F-Boris_Becker-Stefan_Edberg,2,F-DTL,4,0,0,0,0,1,3
19901104-M-Paris_Masters-F-Boris_Becker-Stefan_Edberg,2,B-XC,7,2,0,2,0,5,2
19901104-M-Paris_Masters-F-Boris_Becker-Stefan_Edberg,2,B-DTL,1,1,0,0,1,0,1
19901104-M-Paris_Masters-F-Boris_Becker-Stefan_Edberg,2,S-XC,4,0,0,0,0,2,2
19901104-M-Paris_Masters-F-Boris_Becker-Stefan_Edberg,2,S-DTM,1,0,0,0,0,0,1
19901104-M-Paris_Masters-F-Boris_Becker-Stefan_Edberg,2,S-DTL,1,1,1,0,0,1,0
20110507-M-Madrid_Masters-SF-Roger_Federer-Rafael_Nadal,1,F-XC,65,19,4,9,6,39,26
20110507-M-Madrid_Masters-SF-Roger_Federer-Rafael_Nadal,1,F-DTM,27,3,0,0,3,8,19
20110507-M-Madrid_Masters-SF-Roger_Federer-Rafael_Nadal,1,F-DTL,11,8,4,1,3,6,5
20110507-M-Madrid_Masters-SF-Roger_Federer-Rafael_Nadal,1,F-IO,28,17,8,4,5,18,10
20110507-M-Madrid_Masters-SF-Roger_Federer-Rafael_Nadal,1,F-II,12,4,2,1,1,7,5
20110507-M-Madrid_Masters-SF-Roger_Federer-Rafael_Nadal,1,B-XC,52,15,4,5,6,21,31
20110507-M-Madrid_Masters-SF-Roger_Federer-Rafael_Nadal,1,B-DTM,31,5,0,0,5,12,19
20110507-M-Madrid_Masters-SF-Roger_Federer-Rafael_Nadal,1,B-DTL,16,8,3,0,5,6,10
20110507-M-Madrid_Masters-SF-Roger_Federer-Rafael_Nadal,1,B-IO,3,1,0,0,1,0,3
20110507-M-Madrid_Masters-SF-Roger_Federer-Rafael_Nadal,1,S-XC,3,1,0,1,0,2,1
20110507-M-Madrid_Masters-SF-Roger_Federer-Rafael_Nadal,1,S-DTM,8,0,0,0,0,3,5
20110507-M-Madrid_Masters-SF-Roger_Federer-Rafael_Nadal,1,S-DTL,7,1,0,1,0,5,2
20110507-M-Madrid_Masters-SF-Roger_Federer-Rafael_Nadal,2,F-XC,84,9,5,2,2,54,30
20110507-M-Madrid_Masters-SF-Roger_Federer-Rafael_Nadal,2,F-DTM,28,1,0,1,0,13,15
20110507-M-Madrid_Masters-SF-Roger_Federer-Rafael_Nadal,2,F-DTL,13,4,1,2,1,6,7
20110507-M-Madrid_Masters-SF-Roger_Federer-Rafael_Nadal,2,F-IO,21,7,5,2,0,15,6
20110507-M-Madrid_Masters-SF-Roger_Federer-Rafael_Nadal,2,F-II,8,3,0,3,0,6,2
20110507-M-Madrid_Masters-SF-Roger_Federer-Rafael_Nadal,2,B-XC,33,13,3,6,4,18,15
20110507-M-Madrid_Masters-SF-Roger_Federer-Rafael_Nadal,2,B-DTM,41,3,1,1,1,20,21
20110507-M-Madrid_Masters-SF-Roger_Federer-Rafael_Nadal,2,B-DTL,16,3,1,0,2,7,9
20110507-M-Madrid_Masters-SF-Roger_Federer-Rafael_Nadal,2,B-IO,1,0,0,0,0,1,0
20110507-M-Madrid_Masters-SF-Roger_Federer-Rafael_Nadal,2,S-XC,1,1,1,0,0,1,0
20110507-M-Madrid_Masters-SF-Roger_Federer-Rafael_Nadal,2,S-DTM,5,0,0,0,0,1,4
20110507-M-Madrid_Masters-SF-Roger_Federer-Rafael_Nadal,2,S-DTL,2,0,0,0,0,1,1
20110507-M-Madrid_Masters-SF-Roger_Federer-Rafael_Nadal,2,S-IO,1,0,0,0,0,0,1
20070608-M-Roland_Garros-SF-Novak_Djokovic-Rafael_Nadal,1,F-XC,85,11,3,4,4,37,48
20070608-M-Roland_Garros-SF-Novak_Djokovic-Rafael_Nadal,1,F-DTM,25,2,0,0,2,9,16
20070608-M-Roland_Garros-SF-Novak_Djokovic-Rafael_Nadal,1,F-DTL,19,5,2,1,2,9,10
20070608-M-Roland_Garros-SF-Novak_Djokovic-Rafael_Nadal,1,F-IO,42,14,5,3,6,15,27
20070608-M-Roland_Garros-SF-Novak_Djokovic-Rafael_Nadal,1,F-II,3,2,1,0,1,1,2
20070608-M-Roland_Garros-SF-Novak_Djokovic-Rafael_Nadal,1,B-XC,59,15,3,4,8,27,32
20070608-M-Roland_Garros-SF-Novak_Djokovic-Rafael_Nadal,1,B-DTM,41,2,0,0,2,13,28
20070608-M-Roland_Garros-SF-Novak_Djokovic-Rafael_Nadal,1,B-DTL,45,11,0,4,7,16,29
20070608-M-Roland_Garros-SF-Novak_Djokovic-Rafael_Nadal,1,B-IO,24,5,0,1,4,9,15
20070608-M-Roland_Garros-SF-Novak_Djokovic-Rafael_Nadal,1,S-DTM,4,0,0,0,0,1,3
20070608-M-Roland_Garros-SF-Novak_Djokovic-Rafael_Nadal,1,S-DTL,3,0,0,0,0,3,0
20070608-M-Roland_Garros-SF-Novak_Djokovic-Rafael_Nadal,1,S-IO,2,0,0,0,0,1,1
20070608-M-Roland_Garros-SF-Novak_Djokovic-Rafael_Nadal,2,F-XC,94,13,7,4,2,58,36
20070608-M-Roland_Garros-SF-Novak_Djokovic-Rafael_Nadal,2,F-DTM,30,3,1,1,1,20,10
20070608-M-Roland_Garros-SF-Novak_Djokovic-Rafael_Nadal,2,F-DTL,13,5,3,1,1,8,5
20070608-M-Roland_Garros-SF-Novak_Djokovic-Rafael_Nadal,2,F-IO,36,12,7,1,4,23,13
20070608-M-Roland_Garros-SF-Novak_Djokovic-Rafael_Nadal,2,F-II,17,4,4,0,0,10,7
20070608-M-Roland_Garros-SF-Novak_Djokovic-Rafael_Nadal,2,B-XC,54,8,3,2,3,31,23
20070608-M-Roland_Garros-SF-Novak_Djokovic-Rafael_Nadal,2,B-DTM,33,1,0,1,0,24,9
20070608-M-Roland_Garros-SF-Novak_Djokovic-Rafael_Nadal,2,B-DTL,31,3,1,1,1,18,13
20070608-M-Roland_Garros-SF-Novak_Djokovic-Rafael_Nadal,2,B-IO,3,0,0,0,0,1,2
20070608-M-Roland_Garros-SF-Novak_Djokovic-Rafael_Nadal,2,S-XC,4,1,1,0,0,2,2
20070608-M-Roland_Garros-SF-Novak_Djokovic-Rafael_Nadal,2,S-DTM,14,1,0,1,0,8,6
20070608-M-Roland_Garros-SF-Novak_Djokovic-Rafael_Nadal,2,S-DTL,3,0,0,0,0,1,2
20070608-M-Roland_Garros-SF-Novak_Djokovic-Rafael_Nadal,2,S-IO,2,0,0,0,0,1,1
20130315-M-Indian_Wells_Masters-QF-Roger_Federer-Rafael_Nadal,1,F-XC,33,6,0,2,4,20,13
20130315-M-Indian_Wells_Masters-QF-Roger_Federer-Rafael_Nadal,1,F-DTM,20,3,0,1,2,8,12
20130315-M-Indian_Wells_Masters-QF-Roger_Federer-Rafael_Nadal,1,F-DTL,6,1,0,0,1,1,5
20130315-M-Indian_Wells_Masters-QF-Roger_Federer-Rafael_Nadal,1,F-IO,19,10,3,4,3,9,10
20130315-M-Indian_Wells_Masters-QF-Roger_Federer-Rafael_Nadal,1,F-II,3,1,0,0,1,0,3
20130315-M-Indian_Wells_Masters-QF-Roger_Federer-Rafael_Nadal,1,B-XC,18,9,0,2,7,6,12
20130315-M-Indian_Wells_Masters-QF-Roger_Federer-Rafael_Nadal,1,B-DTM,25,2,0,0,2,8,17
20130315-M-Indian_Wells_Masters-QF-Roger_Federer-Rafael_Nadal,1,B-DTL,9,5,0,2,3,2,7
20130315-M-Indian_Wells_Masters-QF-Roger_Federer-Rafael_Nadal,1,B-IO,6,2,1,0,1,1,5
20130315-M-Indian_Wells_Masters-QF-Roger_Federer-Rafael_Nadal,1,S-XC,2,1,0,0,1,0,2
20130315-M-Indian_Wells_Masters-QF-Roger_Federer-Rafael_Nadal,1,S-DTM,2,0,0,0,0,0,2
20130315-M-Indian_Wells_Masters-QF-Roger_Federer-Rafael_Nadal,1,S-DTL,3,0,0,0,0,0,3
20130315-M-Indian_Wells_Masters-QF-Roger_Federer-Rafael_Nadal,1,S-IO,2,0,0,0,0,2,0
20130315-M-Indian_Wells_Masters-QF-Roger_Federer-Rafael_Nadal,2,F-XC,38,9,6,2,1,28,10
20130315-M-Indian_Wells_Masters-QF-Roger_Federer-Rafael_Nadal,2,F-DTM,18,0,0,0,0,11,7
20130315-M-Indian_Wells_Masters-QF-Roger_Federer-Rafael_Nadal,2,F-DTL,2,2,1,0,1,1,1
20130315-M-Indian_Wells_Masters-QF-Roger_Federer-Rafael_Nadal,2,F-IO,8,2,2,0,0,5,3
20130315-M-Indian_Wells_Masters-QF-Roger_Federer-Rafael_Nadal,2,B-XC,31,14,7,3,4,20,11
20130315-M-Indian_Wells_Masters-QF-Roger_Federer-Rafael_Nadal,2,B-DTM,23,1,0,0,1,13,10
20130315-M-Indian_Wells_Masters-QF-Roger_Federer-Rafael_Nadal,2,B-DTL,10,2,1,0,1,7,3
20130315-M-Indian_Wells_Masters-QF-Roger_Federer-Rafael_Nadal,2,B-IO,6,2,1,0,1,5,1
20130315-M-Indian_Wells_Masters-QF-Roger_Federer-Rafael_Nadal,2,S-DTM,3,1,0,0,1,0,3
20130315-M-Indian_Wells_Masters-QF-Roger_Federer-Rafael_Nadal,2,S-DTL,3,1,0,0,1,0,3
20130315-M-Indian_Wells_Masters-QF-Roger_Federer-Rafael_Nadal,2,S-IO,1,0,0,0,0,1,0
20111110-M-Paris_Masters-R16-Richard_Gasquet-Roger_Federer,1,F-XC,21,14,2,6,6,9,12
20111110-M-Paris_Masters-R16-Richard_Gasquet-Roger_Federer,1,F-DTM,20,0,0,0,0,4,16
20111110-M-Paris_Masters-R16-Richard_Gasquet-Roger_Federer,1,F-DTL,5,1,0,1,0,2,3
20111110-M-Paris_Masters-R16-Richard_Gasquet-Roger_Federer,1,F-IO,4,1,1,0,0,1,3
20111110-M-Paris_Masters-R16-Richard_Gasquet-Roger_Federer,1,B-XC,44,6,1,1,4,12,32
20111110-M-Paris_Masters-R16-Richard_Gasquet-Roger_Federer,1,B-DTM,17,4,0,0,4,3,14
20111110-M-Paris_Masters-R16-Richard_Gasquet-Roger_Federer,1,B-DTL,8,4,0,1,3,3,5
20111110-M-Paris_Masters-R16-Richard_Gasquet-Roger_Federer,1,S-XC,2,1,0,0,1,0,2
20111110-M-Paris_Masters-R16-Richard_Gasquet-Roger_Federer,1,S-DTM,2,0,0,0,0,0,2
20111110-M-Paris_Masters-R16-Richard_Gasquet-Roger_Federer,2,F-XC,17,6,2,3,1,11,6
20111110-M-Paris_Masters-R16-Richard_Gasquet-Roger_Federer,2,F-DTM,12,1,0,1,0,10,2
20111110-M-Paris_Masters-R16-Richard_Gasquet-Roger_Federer,2,F-DTL,4,1,1,0,0,4,0
20111110-M-Paris_Masters-R16-Richard_Gasquet-Roger_Federer,2,F-IO,19,9,1,7,1,17,2
20111110-M-Paris_Masters-R16-Richard_Gasquet-Roger_Federer,2,F-II,5,1,0,1,0,4,1
20111110-M-Paris_Masters-R16-Richard_Gasquet-Roger_Federer,2,B-XC,18,4,0,2,2,13,5
20111110-M-Paris_Masters-R16-Richard_Gasquet-Roger_Federer,2,B-DTM,14,1,0,0,1,11,3
20111110-M-Paris_Masters-R16-Richard_Gasquet-Roger_Federer,2,B-DTL,3,1,0,0,1,2,1
20111110-M-Paris_Masters-R16-Richard_Gasquet-Roger_Federer,2,S-XC,9,0,0,0,0,7,2
20111110-M-Paris_Masters-R16-Richard_Gasquet-Roger_Federer,2,S-DTM,1,0,0,0,0,0,1
20111110-M-Paris_Masters-R16-Richard_Gasquet-Roger_Federer,2,S-DTL,5,1,0,1,0,4,1
20111110-M-Paris_Masters-R16-Richard_Gasquet-Roger_Federer,2,S-IO,1,0,0,0,0,0,1
20101107-M-Basel-F-Novak_Djokovic-Roger_Federer,1,F-XC,32,12,2,6,4,18,14
20101107-M-Basel-F-Novak_Djokovic-Roger_Federer,1,F-DTM,21,4,0,0,4,8,13
20101107-M-Basel-F-Novak_Djokovic-Roger_Federer,1,F-IO,19,7,0,2,5,7,12
20101107-M-Basel-F-Novak_Djokovic-Roger_Federer,1,F-II,2,0,0,0,0,0,2
20101107-M-Basel-F-Novak_Djokovic-Roger_Federer,1,B-XC,33,7,2,1,4,14,19
20101107-M-Basel-F-Novak_Djokovic-Roger_Federer,1,B-DTM,30,4,0,0,4,15,15
20101107-M-Basel-F-Novak_Djokovic-Roger_Federer,1,B-DTL,13,8,2,1,5,6,7
20101107-M-Basel-F-Novak_Djokovic-Roger_Federer,1,B-IO,6,1,0,1,0,2,4
20101107-M-Basel-F-Novak_Djokovic-Roger_Federer,1,S-XC,5,0,0,0,0,2,3
20101107-M-Basel-F-Novak_Djokovic-Roger_Federer,1,S-DTM,4,0,0,0,0,2,2
20101107-M-Basel-F-Novak_Djokovic-Roger_Federer,2,F-XC,20,6,2,3,1,12,8
20101107-M-Basel-F-Novak_Djokovic-Roger_Federer,2,F-DTM,50,5,0,0,5,28,22
20101107-M-Basel-F-Novak_Djokovic-Roger_Federer,2,F-DTL,5,2,0,1,1,3,2
20101107-M-Basel-F-Novak_Djokovic-Roger_Federer,2,F-IO,24,8,1,1,6,12,12
20101107-M-Basel-F-Novak_Djokovic-Roger_Federer,2,F-II,1,1,1,0,0,1,0
20101107-M-Basel-F-Novak_Djokovic-Roger_Federer,2,B-XC,16,5,0,2,3,8,8
20101107-M-Basel-F-Novak_Djokovic-Roger_Federer,2,B-DTM,23,1,0,0,1,12,11
20101107-M-Basel-F-Novak_Djokovic-Roger_Federer,2,B-DTL,5,4,1,0,3,2,3
20101107-M-Basel-F-Novak_Djokovic-Roger_Federer,2,B-IO,2,2,0,0,2,0,2
20101107-M-Basel-F-Novak_Djokovic-Roger_Federer,2,S-XC,10,0,0,0,0,7,3
20101107-M-Basel-F-Novak_Djokovic-Roger_Federer,2,S-DTM,4,0,0,0,0,2,2
20101107-M-Basel-F-Novak_Djokovic-Roger_Federer,2,S-DTL,2,2,1,1,0,2,0
20090515-M-Madrid_Masters-SF-Novak_Djokovic-Rafael_Nadal,1,F-XC,44,16,8,4,4,29,15
20090515-M-Madrid_Masters-SF-Novak_Djokovic-Rafael_Nadal,1,F-DTM,77,6,1,0,5,40,37
20090515-M-Madrid_Masters-SF-Novak_Djokovic-Rafael_Nadal,1,F-DTL,9,2,1,1,0,4,5
20090515-M-Madrid_Masters-SF-Novak_Djokovic-Rafael_Nadal,1,F-IO,129,12,1,5,6,71,58
20090515-M-Madrid_Masters-SF-Novak_Djokovic-Rafael_Nadal,1,F-II,13,4,0,3,1,7,6
20090515-M-Madrid_Masters-SF-Novak_Djokovic-Rafael_Nadal,1,B-XC,29,2,1,0,1,15,14
20090515-M-Madrid_Masters-SF-Novak_Djokovic-Rafael_Nadal,1,B-DTM,117,9,0,1,8,55,62
20090515-M-Madrid_Masters-SF-Novak_Djokovic-Rafael_Nadal,1,B-IO,87,9,4,2,3,43,44
20090515-M-Madrid_Masters-SF-Novak_Djokovic-Rafael_Nadal,1,B-II,42,7,2,1,4,25,17
20090515-M-Madrid_Masters-SF-Novak_Djokovic-Rafael_Nadal,1,S-DTM,9,0,0,0,0,5,4
20090515-M-Madrid_Masters-SF-Novak_Djokovic-Rafael_Nadal,1,S-IO,1,0,0,0,0,1,0
20090515-M-Madrid_Masters-SF-Novak_Djokovic-Rafael_Nadal,1,S-II,2,1,0,0,1,1,1
20090515-M-Madrid_Masters-SF-Novak_Djokovic-Rafael_Nadal,2,F-XC,53,14,8,2,4,32,21
20090515-M-Madrid_Masters-SF-Novak_Djokovic-Rafael_Nadal,2,F-DTM,117,8,0,2,6,58,59
20090515-M-Madrid_Masters-SF-Novak_Djokovic-Rafael_Nadal,2,F-DTL,15,5,2,2,1,11,4
20090515-M-Madrid_Masters-SF-Novak_Djokovic-Rafael_Nadal,2,F-IO,136,15,6,2,7,70,66
20090515-M-Madrid_Masters-SF-Novak_Djokovic-Rafael_Nadal,2,F-II,25,13,3,4,6,13,12
20090515-M-Madrid_Masters-SF-Novak_Djokovic-Rafael_Nadal,2,B-XC,10,1,0,1,0,5,5
20090515-M-Madrid_Masters-SF-Novak_Djokovic-Rafael_Nadal,2,B-DTM,62,4,0,1,3,26,36
20090515-M-Madrid_Masters-SF-Novak_Djokovic-Rafael_Nadal,2,B-IO,79,16,2,4,10,39,40
20090515-M-Madrid_Masters-SF-Novak_Djokovic-Rafael_Nadal,2,B-II,56,8,1,1,6,24,32
20090515-M-Madrid_Masters-SF-Novak_Djokovic-Rafael_Nadal,2,S-XC,3,0,0,0,0,1,2
20090515-M-Madrid_Masters-SF-Novak_Djokovic-Rafael_Nadal,2,S-DTM,7,1,0,0,1,2,5
20090515-M-Madrid_Masters-SF-Novak_Djokovic-Rafael_Nadal,2,S-IO,8,0,0,0,0,1,7
20090515-M-Madrid_Masters-SF-Novak_Djokovic-Rafael_Nadal,2,S-II,7,0,0,0,0,3,4
20150322-M-Indian_Wells_Masters-F-Novak_Djokovic-Roger_Federer,1,F-XC,53,16,6,6,4,33,20
20150322-M-Indian_Wells_Masters-F-Novak_Djokovic-Roger_Federer,1,F-DTM,34,2,0,0,2,18,16
20150322-M-Indian_Wells_Masters-F-Novak_Djokovic-Roger_Federer,1,F-DTL,7,0,0,0,0,4,3
20150322-M-Indian_Wells_Masters-F-Novak_Djokovic-Roger_Federer,1,F-IO,29,8,3,3,2,17,12
20150322-M-Indian_Wells_Masters-F-Novak_Djokovic-Roger_Federer,1,F-II,6,5,3,2,0,5,1
20150322-M-Indian_Wells_Masters-F-Novak_Djokovic-Roger_Federer,1,B-XC,96,13,3,2,8,56,40
20150322-M-Indian_Wells_Masters-F-Novak_Djokovic-Roger_Federer,1,B-DTM,37,4,0,2,2,15,22
20150322-M-Indian_Wells_Masters-F-Novak_Djokovic-Roger_Federer,1,B-DTL,11,7,2,2,3,6,5
20150322-M-Indian_Wells_Masters-F-Novak_Djokovic-Roger_Federer,1,B-IO,7,0,0,0,0,4,3
20150322-M-Indian_Wells_Masters-F-Novak_Djokovic-Roger_Federer,1,S-XC,4,1,0,0,1,1,3
20150322-M-Indian_Wells_Masters-F-Novak_Djokovic-Roger_Federer,1,S-DTM,2,0,0,0,0,0,2
20150322-M-Indian_Wells_Masters-F-Novak_Djokovic-Roger_Federer,1,S-DTL,2,0,0,0,0,1,1
20150322-M-Indian_Wells_Masters-F-Novak_Djokovic-Roger_Federer,2,F-XC,42,14,2,3,9,19,23
20150322-M-Indian_Wells_Masters-F-Novak_Djokovic-Roger_Federer,2,F-DTM,39,2,0,0,2,17,22
20150322-M-Indian_Wells_Masters-F-Novak_Djokovic-Roger_Federer,2,F-DTL,22,7,2,1,4,10,12
20150322-M-Indian_Wells_Masters-F-Novak_Djokovic-Roger_Federer,2,F-IO,31,6,0,1,5,12,19
20150322-M-Indian_Wells_Masters-F-Novak_Djokovic-Roger_Federer,2,F-II,7,3,1,1,1,3,4
20150322-M-Indian_Wells_Masters-F-Novak_Djokovic-Roger_Federer,2,B-XC,46,4,0,2,2,24,22
20150322-M-Indian_Wells_Masters-F-Novak_Djokovic-Roger_Federer,2,B-DTM,35,6,1,1,4,15,20
20150322-M-Indian_Wells_Masters-F-Novak_Djokovic-Roger_Federer,2,B-DTL,8,3,0,0,3,2,6
20150322-M-Indian_Wells_Masters-F-Novak_Djokovic-Roger_Federer,2,B-IO,4,2,0,1,1,2,2
20150322-M-Indian_Wells_Masters-F-Novak_Djokovic-Roger_Federer,2,S-XC,20,1,0,1,0,9,11
20150322-M-Indian_Wells_Masters-F-Novak_Djokovic-Roger_Federer,2,S-DTM,4,0,0,0,0,3,1
20150322-M-Indian_Wells_Masters-F-Novak_Djokovic-Roger_Federer,2,S-DTL,5,0,0,0,0,4,1
20170224-M-Marseille-QF-Lucas_Pouille-Daniil_Medvedev,1,F-XC,33,12,2,7,3,26,7
20170224-M-Marseille-QF-Lucas_Pouille-Daniil_Medvedev,1,F-DTM,9,2,0,1,1,7,2
20170224-M-Marseille-QF-Lucas_Pouille-Daniil_Medvedev,1,F-DTL,8,2,2,0,0,6,2
20170224-M-Marseille-QF-Lucas_Pouille-Daniil_Medvedev,1,F-IO,15,5,1,2,2,11,4
20170224-M-Marseille-QF-Lucas_Pouille-Daniil_Medvedev,1,F-II,1,0,0,0,0,1,0
20170224-M-Marseille-QF-Lucas_Pouille-Daniil_Medvedev,1,B-XC,21,1,0,0,1,19,2
20170224-M-Marseille-QF-Lucas_Pouille-Daniil_Medvedev,1,B-DTM,8,1,0,0,1,4,4
20170224-M-Marseille-QF-Lucas_Pouille-Daniil_Medvedev,1,B-DTL,5,3,1,0,2,3,2
20170224-M-Marseille-QF-Lucas_Pouille-Daniil_Medvedev,1,B-IO,1,1,0,0,1,0,1
20170224-M-Marseille-QF-Lucas_Pouille-Daniil_Medvedev,1,S-XC,7,1,0,0,1,5,2
20170224-M-Marseille-QF-Lucas_Pouille-Daniil_Medvedev,1,S-DTM,6,0,0,0,0,5,1
20170224-M-Marseille-QF-Lucas_Pouille-Daniil_Medvedev,1,S-DTL,3,1,0,1,0,3,0
20170224-M-Marseille-QF-Lucas_Pouille-Daniil_Medvedev,1,S-IO,1,0,0,0,0,0,1
20170224-M-Marseille-QF-Lucas_Pouille-Daniil_Medvedev,2,F-XC,18,5,2,0,3,4,14
20170224-M-Marseille-QF-Lucas_Pouille-Daniil_Medvedev,2,F-DTM,11,1,0,0,1,5,6
20170224-M-Marseille-QF-Lucas_Pouille-Daniil_Medvedev,2,F-DTL,16,5,1,1,3,5,11
20170224-M-Marseille-QF-Lucas_Pouille-Daniil_Medvedev,2,F-IO,18,10,3,1,6,6,12
20170224-M-Marseille-QF-Lucas_Pouille-Daniil_Medvedev,2,F-II,2,0,0,0,0,1,1
20170224-M-Marseille-QF-Lucas_Pouille-Daniil_Medvedev,2,B-XC,33,4,1,0,3,6,27
20170224-M-Marseille-QF-Lucas_Pouille-Daniil_Medvedev,2,B-DTM,9,2,0,0,2,1,8
20170224-M-Marseille-QF-Lucas_Pouille-Daniil_Medvedev,2,B-DTL,11,5,2,1,2,5,6
20170224-M-Marseille-QF-Lucas_Pouille-Daniil_Medvedev,2,B-IO,3,1,0,0,1,0,3
20170224-M-Marseille-QF-Lucas_Pouille-Daniil_Medvedev,2,S-XC,1,1,0,1,0,1,0
20170224-M-Marseille-QF-Lucas_Pouille-Daniil_Medvedev,2,S-DTM,2,0,0,0,0,0,2
20170224-M-Marseille-QF-Lucas_Pouille-Daniil_Medvedev,2,S-DTL,1,0,0,0,0,0,1
20100815-M-Canada_Masters-F-Roger_Federer-Andy_Murray,1,F-XC,31,7,3,0,4,15,16
20100815-M-Canada_Masters-F-Roger_Federer-Andy_Murray,1,F-DTM,21,3,0,1,2,9,12
20100815-M-Canada_Masters-F-Roger_Federer-Andy_Murray,1,F-DTL,8,2,1,0,1,4,4
20100815-M-Canada_Masters-F-Roger_Federer-Andy_Murray,1,F-IO,25,9,3,1,5,11,14
20100815-M-Canada_Masters-F-Roger_Federer-Andy_Murray,1,F-II,3,0,0,0,0,2,1
20100815-M-Canada_Masters-F-Roger_Federer-Andy_Murray,1,B-XC,21,7,0,1,6,9,12
20100815-M-Canada_Masters-F-Roger_Federer-Andy_Murray,1,B-DTM,23,2,1,0,1,9,14
20100815-M-Canada_Masters-F-Roger_Federer-Andy_Murray,1,B-DTL,5,2,0,2,0,2,3
20100815-M-Canada_Masters-F-Roger_Federer-Andy_Murray,1,B-IO,3,1,0,0,1,1,2
20100815-M-Canada_Masters-F-Roger_Federer-Andy_Murray,1,S-XC,16,2,0,0,2,9,7
20100815-M-Canada_Masters-F-Roger_Federer-Andy_Murray,1,S-DTM,11,1,0,0,1,3,8
20100815-M-Canada_Masters-F-Roger_Federer-Andy_Murray,1,S-DTL,5,0,0,0,0,2,3
20100815-M-Canada_Masters-F-Roger_Federer-Andy_Murray,2,F-XC,27,9,2,2,5,12,15
20100815-M-Canada_Masters-F-Roger_Federer-Andy_Murray,2,F-DTM,30,1,0,0,1,16,14
20100815-M-Canada_Masters-F-Roger_Federer-Andy_Murray,2,F-DTL,5,1,0,0,1,3,2
20100815-M-Canada_Masters-F-Roger_Federer-Andy_Murray,2,F-IO,28,8,3,1,4,14,14
20100815-M-Canada_Masters-F-Roger_Federer-Andy_Murray,2,F-II,4,1,0,1,0,3,1
20100815-M-Canada_Masters-F-Roger_Federer-Andy_Murray,2,B-XC,42,5,3,1,1,26,16
20100815-M-Canada_Masters-F-Roger_Federer-Andy_Murray,2,B-DTM,17,1,0,1,0,11,6
20100815-M-Canada_Masters-F-Roger_Federer-Andy_Murray,2,B-DTL,2,1,0,1,0,1,1
20100815-M-Canada_Masters-F-Roger_Federer-Andy_Murray,2,B-IO,5,4,2,1,1,4,1
20100815-M-Canada_Masters-F-Roger_Federer-Andy_Murray,2,S-XC,2,0,0,0,0,0,2
20100815-M-Canada_Masters-F-Roger_Federer-Andy_Murray,2,S-DTM,4,0,0,0,0,3,1
20100815-M-Canada_Masters-F-Roger_Federer-Andy_Murray,2,S-IO,1,0,0,0,0,1,0
20170225-M-Acapulco-F-Sam_Querrey-Rafael_Nadal,1,F-XC,30,7,3,2,2,18,12
20170225-M-Acapulco-F-Sam_Querrey-Rafael_Nadal,1,F-DTM,11,1,0,0,1,3,8
20170225-M-Acapulco-F-Sam_Querrey-Rafael_Nadal,1,F-DTL,14,10,5,1,4,6,8
20170225-M-Acapulco-F-Sam_Querrey-Rafael_Nadal,1,F-IO,21,8,5,0,3,12,9
20170225-M-Acapulco-F-Sam_Querrey-Rafael_Nadal,1,F-II,3,0,0,0,0,2,1
20170225-M-Acapulco-F-Sam_Querrey-Rafael_Nadal,1,B-XC,25,6,1,2,3,13,12
20170225-M-Acapulco-F-Sam_Querrey-Rafael_Nadal,1,B-DTM,12,2,0,0,2,5,7
20170225-M-Acapulco-F-Sam_Querrey-Rafael_Nadal,1,B-DTL,6,4,2,0,2,4,2
20170225-M-Acapulco-F-Sam_Querrey-Rafael_Nadal,1,B-IO,2,1,1,0,0,1,1
20170225-M-Acapulco-F-Sam_Querrey-Rafael_Nadal,1,S-XC,2,0,0,0,0,0,2
20170225-M-Acapulco-F-Sam_Querrey-Rafael_Nadal,1,S-DTM,5,0,0,0,0,0,5
20170225-M-Acapulco-F-Sam_Querrey-Rafael_Nadal,1,S-DTL,1,0,0,0,0,0,1
20170225-M-Acapulco-F-Sam_Querrey-Rafael_Nadal,2,F-XC,37,10,5,2,3,23,14
20170225-M-Acapulco-F-Sam_Querrey-Rafael_Nadal,2,F-DTM,11,0,0,0,0,4,7
20170225-M-Acapulco-F-Sam_Querrey-Rafael_Nadal,2,F-DTL,15,7,4,0,3,10,5
20170225-M-Acapulco-F-Sam_Querrey-Rafael_Nadal,2,F-IO,14,7,4,1,2,12,2
20170225-M-Acapulco-F-Sam_Querrey-Rafael_Nadal,2,F-II,2,0,0,0,0,1,1
20170225-M-Acapulco-F-Sam_Querrey-Rafael_Nadal,2,B-XC,16,4,1,1,2,8,8
20170225-M-Acapulco-F-Sam_Querrey-Rafael_Nadal,2,B-DTM,16,2,0,0,2,7,9
20170225-M-Acapulco-F-Sam_Querrey-Rafael_Nadal,2,B-DTL,9,2,1,0,1,5,4
20170225-M-Acapulco-F-Sam_Querrey-Rafael_Nadal,2,B-IO,5,0,0,0,0,3,2
20170225-M-Acapulco-F-Sam_Querrey-Rafael_Nadal,2,B-II,3,0,0,0,0,1,2
20170225-M-Acapulco-F-Sam_Querrey-Rafael_Nadal,2,S-XC,1,0,0,0,0,1,0
20170225-M-Acapulco-F-Sam_Querrey-Rafael_Nadal,2,S-DTM,1,0,0,0,0,0,1
20170225-M-Acapulco-F-Sam_Querrey-Rafael_Nadal,2,S-DTL,3,0,0,0,0,1,2
20041115-M-Masters_Cup-SF-Roger_Federer-Marat_Safin,1,F-XC,14,5,3,2,0,11,3
20041115-M-Masters_Cup-SF-Roger_Federer-Marat_Safin,1,F-DTM,29,1,0,0,1,15,14
20041115-M-Masters_Cup-SF-Roger_Federer-Marat_Safin,1,F-DTL,6,2,1,0,1,3,3
20041115-M-Masters_Cup-SF-Roger_Federer-Marat_Safin,1,F-IO,42,14,8,1,5,29,13
20041115-M-Masters_Cup-SF-Roger_Federer-Marat_Safin,1,F-II,6,2,1,1,0,4,2
20041115-M-Masters_Cup-SF-Roger_Federer-Marat_Safin,1,B-XC,2,1,0,0,1,1,1
20041115-M-Masters_Cup-SF-Roger_Federer-Marat_Safin,1,B-DTM,33,4,0,0,4,19,14
20041115-M-Masters_Cup-SF-Roger_Federer-Marat_Safin,1,B-DTL,1,0,0,0,0,0,1
20041115-M-Masters_Cup-SF-Roger_Federer-Marat_Safin,1,B-IO,31,10,2,2,6,13,18
20041115-M-Masters_Cup-SF-Roger_Federer-Marat_Safin,1,B-II,12,5,3,1,1,8,4
20041115-M-Masters_Cup-SF-Roger_Federer-Marat_Safin,1,S-XC,1,0,0,0,0,1,0
20041115-M-Masters_Cup-SF-Roger_Federer-Marat_Safin,1,S-DTM,14,0,0,0,0,10,4
20041115-M-Masters_Cup-SF-Roger_Federer-Marat_Safin,1,S-IO,13,0,0,0,0,8,5
20041115-M-Masters_Cup-SF-Roger_Federer-Marat_Safin,1,S-II,1,0,0,0,0,0,1
20041115-M-Masters_Cup-SF-Roger_Federer-Marat_Safin,2,F-XC,28,5,1,0,4,8,20
20041115-M-Masters_Cup-SF-Roger_Federer-Marat_Safin,2,F-DTM,23,3,1,0,2,8,15
20041115-M-Masters_Cup-SF-Roger_Federer-Marat_Safin,2,F-DTL,3,1,0,0,1,2,1
20041115-M-Masters_Cup-SF-Roger_Federer-Marat_Safin,2,F-IO,35,6,1,0,5,15,20
20041115-M-Masters_Cup-SF-Roger_Federer-Marat_Safin,2,F-II,15,3,1,1,1,7,8
20041115-M-Masters_Cup-SF-Roger_Federer-Marat_Safin,2,B-XC,5,4,2,0,2,3,2
20041115-M-Masters_Cup-SF-Roger_Federer-Marat_Safin,2,B-DTM,24,2,0,2,0,9,15
20041115-M-Masters_Cup-SF-Roger_Federer-Marat_Safin,2,B-DTL,1,0,0,0,0,0,1
20041115-M-Masters_Cup-SF-Roger_Federer-Marat_Safin,2,B-IO,52,11,3,2,6,27,25
20041115-M-Masters_Cup-SF-Roger_Federer-Marat_Safin,2,B-II,13,7,1,2,4,6,7
20041115-M-Masters_Cup-SF-Roger_Federer-Marat_Safin,2,S-DTM,1,0,0,0,0,1,0
20041115-M-Masters_Cup-SF-Roger_Federer-Marat_Safin,2,S-IO,7,1,0,0,1,4,3
20041115-M-Masters_Cup-SF-Roger_Federer-Marat_Safin,2,S-II,2,1,0,0,1,0,2
20130816-M-Cincinnati_Masters-QF-Rafael_Nadal-Roger_Federer,1,F-XC,61,12,3,4,5,38,23
20130816-M-Cincinnati_Masters-QF-Rafael_Nadal-Roger_Federer,1,F-DTM,32,3,0,0,3,15,17
20130816-M-Cincinnati_Masters-QF-Rafael_Nadal-Roger_Federer,1,F-DTL,12,10,6,2,2,10,2
20130816-M-Cincinnati_Masters-QF-Rafael_Nadal-Roger_Federer,1,F-IO,21,11,6,4,1,16,5
20130816-M-Cincinnati_Masters-QF-Rafael_Nadal-Roger_Federer,1,F-II,6,0,0,0,0,6,0
20130816-M-Cincinnati_Masters-QF-Rafael_Nadal-Roger_Federer,1,B-XC,31,11,0,2,9,9,22
20130816-M-Cincinnati_Masters-QF-Rafael_Nadal-Roger_Federer,1,B-DTM,29,1,0,0,1,9,20
20130816-M-Cincinnati_Masters-QF-Rafael_Nadal-Roger_Federer,1,B-DTL,13,2,1,0,1,9,4
20130816-M-Cincinnati_Masters-QF-Rafael_Nadal-Roger_Federer,1,B-IO,4,2,1,0,1,3,1
20130816-M-Cincinnati_Masters-QF-Rafael_Nadal-Roger_Federer,1,S-DTM,2,0,0,0,0,0,2
20130816-M-Cincinnati_Masters-QF-Rafael_Nadal-Roger_Federer,1,S-DTL,2,0,0,0,0,0,2
20130816-M-Cincinnati_Masters-QF-Rafael_Nadal-Roger_Federer,2,F-XC,55,11,4,4,3,37,18
20130816-M-Cincinnati_Masters-QF-Rafael_Nadal-Roger_Federer,2,F-DTM,30,4,1,0,3,15,15
20130816-M-Cincinnati_Masters-QF-Rafael_Nadal-Roger_Federer,2,F-DTL,4,4,2,0,2,2,2
20130816-M-Cincinnati_Masters-QF-Rafael_Nadal-Roger_Federer,2,F-IO,26,17,8,4,5,17,9
20130816-M-Cincinnati_Masters-QF-Rafael_Nadal-Roger_Federer,2,F-II,8,5,3,1,1,6,2
20130816-M-Cincinnati_Masters-QF-Rafael_Nadal-Roger_Federer,2,B-XC,25,8,1,0,7,9,16
20130816-M-Cincinnati_Masters-QF-Rafael_Nadal-Roger_Federer,2,B-DTM,34,3,1,0,2,13,21
20130816-M-Cincinnati_Masters-QF-Rafael_Nadal-Roger_Federer,2,B-DTL,9,5,0,0,5,0,9
20130816-M-Cincinnati_Masters-QF-Rafael_Nadal-Roger_Federer,2,B-IO,5,3,0,0,3,2,3
20130816-M-Cincinnati_Masters-QF-Rafael_Nadal-Roger_Federer,2,S-XC,5,2,0,1,1,2,3
20130816-M-Cincinnati_Masters-QF-Rafael_Nadal-Roger_Federer,2,S-DTM,5,0,0,0,0,1,4
20130816-M-Cincinnati_Masters-QF-Rafael_Nadal-Roger_Federer,2,S-DTL,4,1,0,0,1,0,4
20131105-M-Tour_Finals-RR-Novak_Djokovic-Roger_Federer,1,F-XC,44,18,5,7,6,27,17
20131105-M-Tour_Finals-RR-Novak_Djokovic-Roger_Federer,1,F-DTM,29,1,0,0,1,18,11
20131105-M-Tour_Finals-RR-Novak_Djokovic-Roger_Federer,1,F-DTL,14,4,2,0,2,7,7
20131105-M-Tour_Finals-RR-Novak_Djokovic-Roger_Federer,1,F-IO,34,5,1,2,2,20,14
20131105-M-Tour_Finals-RR-Novak_Djokovic-Roger_Federer,1,F-II,2,1,0,0,1,0,2
20131105-M-Tour_Finals-RR-Novak_Djokovic-Roger_Federer,1,B-XC,109,11,3,2,6,59,50
20131105-M-Tour_Finals-RR-Novak_Djokovic-Roger_Federer,1,B-DTM,40,1,0,0,1,28,12
20131105-M-Tour_Finals-RR-Novak_Djokovic-Roger_Federer,1,B-DTL,24,10,1,5,4,13,11
20131105-M-Tour_Finals-RR-Novak_Djokovic-Roger_Federer,1,B-IO,9,4,0,2,2,4,5
20131105-M-Tour_Finals-RR-Novak_Djokovic-Roger_Federer,1,B-II,1,0,0,0,0,1,0
20131105-M-Tour_Finals-RR-Novak_Djokovic-Roger_Federer,1,S-XC,5,1,1,0,0,2,3
20131105-M-Tour_Finals-RR-Novak_Djokovic-Roger_Federer,1,S-DTM,2,0,0,0,0,2,0
20131105-M-Tour_Finals-RR-Novak_Djokovic-Roger_Federer,1,S-DTL,1,0,0,0,0,0,1
20131105-M-Tour_Finals-RR-Novak_Djokovic-Roger_Federer,2,F-XC,55,12,2,4,6,24,31
20131105-M-Tour_Finals-RR-Novak_Djokovic-Roger_Federer,2,F-DTM,23,3,0,0,3,7,16
20131105-M-Tour_Finals-RR-Novak_Djokovic-Roger_Federer,2,F-DTL,16,2,1,1,0,7,9
20131105-M-Tour_Finals-RR-Novak_Djokovic-Roger_Federer,2,F-IO,34,10,3,2,5,15,19
20131105-M-Tour_Finals-RR-Novak_Djokovic-Roger_Federer,2,F-II,7,5,0,3,2,4,3
20131105-M-Tour_Finals-RR-Novak_Djokovic-Roger_Federer,2,B-XC,73,6,1,2,3,35,38
20131105-M-Tour_Finals-RR-Novak_Djokovic-Roger_Federer,2,B-DTM,38,5,0,0,5,14,24
20131105-M-Tour_Finals-RR-Novak_Djokovic-Roger_Federer,2,B-DTL,17,6,2,2,2,10,7
20131105-M-Tour_Finals-RR-Novak_Djokovic-Roger_Federer,2,B-IO,5,2,0,0,2,0,5
20131105-M-Tour_Finals-RR-Novak_Djokovic-Roger_Federer,2,S-XC,29,4,0,1,3,10,19
20131105-M-Tour_Finals-RR-Novak_Djokovic-Roger_Federer,2,S-DTM,7,0,0,0,0,4,3
20131105-M-Tour_Finals-RR-Novak_Djokovic-Roger_Federer,2,S-DTL,2,1,0,0,1,0,2
20120401-M-Miami_Masters-F-Novak_Djokovic-Andy_Murray,1,F-XC,61,10,2,4,4,29,32
20120401-M-Miami_Masters-F-Novak_Djokovic-Andy_Murray,1,F-DTM,72,5,0,2,3,30,42
20120401-M-Miami_Masters-F-Novak_Djokovic-Andy_Murray,1,F-DTL,5,1,0,1,0,4,1
20120401-M-Miami_Masters-F-Novak_Djokovic-Andy_Murray,1,F-IO,47,11,2,2,7,22,25
20120401-M-Miami_Masters-F-Novak_Djokovic-Andy_Murray,1,F-II,1,0,0,0,0,0,1
20120401-M-Miami_Masters-F-Novak_Djokovic-Andy_Murray,1,B-XC,43,6,2,2,2,22,21
20120401-M-Miami_Masters-F-Novak_Djokovic-Andy_Murray,1,B-DTM,73,6,0,1,5,34,39
20120401-M-Miami_Masters-F-Novak_Djokovic-Andy_Murray,1,B-DTL,17,9,0,1,8,7,10
20120401-M-Miami_Masters-F-Novak_Djokovic-Andy_Murray,1,B-IO,14,4,0,1,3,4,10
20120401-M-Miami_Masters-F-Novak_Djokovic-Andy_Murray,1,S-XC,6,0,0,0,0,0,6
20120401-M-Miami_Masters-F-Novak_Djokovic-Andy_Murray,1,S-DTM,7,1,0,0,1,1,6
20120401-M-Miami_Masters-F-Novak_Djokovic-Andy_Murray,1,S-DTL,2,0,0,0,0,2,0
20120401-M-Miami_Masters-F-Novak_Djokovic-Andy_Murray,2,F-XC,75,11,0,5,6,42,33
20120401-M-Miami_Masters-F-Novak_Djokovic-Andy_Murray,2,F-DTM,75,5,0,0,5,41,34
20120401-M-Miami_Masters-F-Novak_Djokovic-Andy_Murray,2,F-DTL,10,0,0,0,0,7,3
20120401-M-Miami_Masters-F-Novak_Djokovic-Andy_Murray,2,F-IO,30,6,2,1,3,16,14
20120401-M-Miami_Masters-F-Novak_Djokovic-Andy_Murray,2,F-II,1,1,1,0,0,1,0
20120401-M-Miami_Masters-F-Novak_Djokovic-Andy_Murray,2,B-XC,62,9,1,0,8,28,34
20120401-M-Miami_Masters-F-Novak_Djokovic-Andy_Murray,2,B-DTM,50,4,0,0,4,29,21
20120401-M-Miami_Masters-F-Novak_Djokovic-Andy_Murray,2,B-DTL,5,4,2,1,1,3,2
20120401-M-Miami_Masters-F-Novak_Djokovic-Andy_Murray,2,B-IO,11,2,0,0,2,5,6
20120401-M-Miami_Masters-F-Novak_Djokovic-Andy_Murray,2,S-XC,14,0,0,0,0,10,4
20120401-M-Miami_Masters-F-Novak_Djokovic-Andy_Murray,2,S-DTM,14,0,0,0,0,5,9
20120401-M-Miami_Masters-F-Novak_Djokovic-Andy_Murray,2,S-IO,1,1,0,0,1,0,1
20060816-M-Cincinnati_Masters-R32-Roger_Federer-Andy_Murray,1,F-XC,31,7,3,1,3,16,15
20060816-M-Cincinnati_Masters-R32-Roger_Federer-Andy_Murray,1,F-DTM,26,3,0,1,2,11,15
20060816-M-Cincinnati_Masters-R32-Roger_Federer-Andy_Murray,1,F-DTL,6,2,0,1,1,4,2
20060816-M-Cincinnati_Masters-R32-Roger_Federer-Andy_Murray,1,F-IO,28,10,4,3,3,15,13
20060816-M-Cincinnati_Masters-R32-Roger_Federer-Andy_Murray,1,F-II,4,1,0,0,1,3,1
20060816-M-Cincinnati_Masters-R32-Roger_Federer-Andy_Murray,1,B-XC,38,4,0,1,3,17,21
20060816-M-Cincinnati_Masters-R32-Roger_Federer-Andy_Murray,1,B-DTM,32,2,0,0,2,9,23
20060816-M-Cincinnati_Masters-R32-Roger_Federer-Andy_Murray,1,B-DTL,11,5,3,1,1,8,3
20060816-M-Cincinnati_Masters-R32-Roger_Federer-Andy_Murray,1,B-IO,1,0,0,0,0,0,1
20060816-M-Cincinnati_Masters-R32-Roger_Federer-Andy_Murray,1,S-XC,25,6,0,2,4,7,18
20060816-M-Cincinnati_Masters-R32-Roger_Federer-Andy_Murray,1,S-DTM,21,0,0,0,0,12,9
20060816-M-Cincinnati_Masters-R32-Roger_Federer-Andy_Murray,1,S-DTL,3,1,0,1,0,2,1
20060816-M-Cincinnati_Masters-R32-Roger_Federer-Andy_Murray,1,S-IO,1,0,0,0,0,0,1
20060816-M-Cincinnati_Masters-R32-Roger_Federer-Andy_Murray,2,F-XC,39,14,5,6,3,23,16
20060816-M-Cincinnati_Masters-R32-Roger_Federer-Andy_Murray,2,F-DTM,24,1,0,0,1,12,12
20060816-M-Cincinnati_Masters-R32-Roger_Federer-Andy_Murray,2,F-DTL,11,1,0,1,0,4,7
20060816-M-Cincinnati_Masters-R32-Roger_Federer-Andy_Murray,2,F-IO,29,3,2,0,1,18,11
20060816-M-Cincinnati_Masters-R32-Roger_Federer-Andy_Murray,2,F-II,2,1,0,0,1,0,2
20060816-M-Cincinnati_Masters-R32-Roger_Federer-Andy_Murray,2,B-XC,57,5,4,0,1,32,25
20060816-M-Cincinnati_Masters-R32-Roger_Federer-Andy_Murray,2,B-DTM,30,3,0,0,3,17,13
20060816-M-Cincinnati_Masters-R32-Roger_Federer-Andy_Murray,2,B-DTL,9,8,4,1,3,6,3
20060816-M-Cincinnati_Masters-R32-Roger_Federer-Andy_Murray,2,B-IO,5,3,1,1,1,3,2
20060816-M-Cincinnati_Masters-R32-Roger_Federer-Andy_Murray,2,S-XC,10,1,0,0,1,5,5
20060816-M-Cincinnati_Masters-R32-Roger_Federer-Andy_Murray,2,S-DTM,12,2,0,0,2,5,7
20060816-M-Cincinnati_Masters-R32-Roger_Federer-Andy_Murray,2,S-DTL,5,2,0,2,0,4,1
20060816-M-Cincinnati_Masters-R32-Roger_Federer-Andy_Murray,2,S-IO,1,0,0,0,0,1,0
20110403-M-Miami_Masters-F-Novak_Djokovic-Rafael_Nadal,1,F-XC,87,16,5,7,4,60,27
20110403-M-Miami_Masters-F-Novak_Djokovic-Rafael_Nadal,1,F-DTM,39,4,1,0,3,16,23
20110403-M-Miami_Masters-F-Novak_Djokovic-Rafael_Nadal,1,F-DTL,19,9,4,2,3,13,6
20110403-M-Miami_Masters-F-Novak_Djokovic-Rafael_Nadal,1,F-IO,42,19,6,6,7,22,20
20110403-M-Miami_Masters-F-Novak_Djokovic-Rafael_Nadal,1,F-II,4,0,0,0,0,3,1
20110403-M-Miami_Masters-F-Novak_Djokovic-Rafael_Nadal,1,B-XC,44,11,3,6,2,26,18
20110403-M-Miami_Masters-F-Novak_Djokovic-Rafael_Nadal,1,B-DTM,83,5,0,1,4,38,45
20110403-M-Miami_Masters-F-Novak_Djokovic-Rafael_Nadal,1,B-DTL,23,12,2,2,8,9,14
20110403-M-Miami_Masters-F-Novak_Djokovic-Rafael_Nadal,1,B-IO,16,1,1,0,0,10,6
20110403-M-Miami_Masters-F-Novak_Djokovic-Rafael_Nadal,1,S-XC,1,1,1,0,0,1,0
20110403-M-Miami_Masters-F-Novak_Djokovic-Rafael_Nadal,1,S-DTM,3,0,0,0,0,2,1
20110403-M-Miami_Masters-F-Novak_Djokovic-Rafael_Nadal,1,S-DTL,2,0,0,0,0,1,1
20110403-M-Miami_Masters-F-Novak_Djokovic-Rafael_Nadal,2,F-XC,85,8,2,3,3,42,43
20110403-M-Miami_Masters-F-Novak_Djokovic-Rafael_Nadal,2,F-DTM,67,3,0,1,2,40,27
20110403-M-Miami_Masters-F-Novak_Djokovic-Rafael_Nadal,2,F-DTL,19,5,2,2,1,8,11
20110403-M-Miami_Masters-F-Novak_Djokovic-Rafael_Nadal,2,F-IO,29,8,2,1,5,15,14
20110403-M-Miami_Masters-F-Novak_Djokovic-Rafael_Nadal,2,F-II,6,0,0,0,0,5,1
20110403-M-Miami_Masters-F-Novak_Djokovic-Rafael_Nadal,2,B-XC,44,5,2,1,2,16,28
20110403-M-Miami_Masters-F-Novak_Djokovic-Rafael_Nadal,2,B-DTM,46,3,0,0,3,13,33
20110403-M-Miami_Masters-F-Novak_Djokovic-Rafael_Nadal,2,B-DTL,13,2,2,0,0,6,7
20110403-M-Miami_Masters-F-Novak_Djokovic-Rafael_Nadal,2,B-IO,2,1,0,0,1,0,2
20110403-M-Miami_Masters-F-Novak_Djokovic-Rafael_Nadal,2,S-XC,7,0,0,0,0,2,5
20110403-M-Miami_Masters-F-Novak_Djokovic-Rafael_Nadal,2,S-DTM,25,3,0,0,3,7,18
20110403-M-Miami_Masters-F-Novak_Djokovic-Rafael_Nadal,2,S-DTL,7,0,0,0,0,3,4
20110403-M-Miami_Masters-F-Novak_Djokovic-Rafael_Nadal,2,S-IO,3,0,0,0,0,1,2
20110403-M-Miami_Masters-F-Novak_Djokovic-Rafael_Nadal,2,S-II,1,0,0,0,0,0,1
20170108-M-Chennai-F-Roberto_Bautista_Agut-Daniil_Medvedev,1,F-XC,30,4,1,3,0,21,9
20170108-M-Chennai-F-Roberto_Bautista_Agut-Daniil_Medvedev,1,F-DTM,9,2,0,0,2,5,4
20170108-M-Chennai-F-Roberto_Bautista_Agut-Daniil_Medvedev,1,F-DTL,9,3,1,2,0,6,3
20170108-M-Chennai-F-Roberto_Bautista_Agut-Daniil_Medvedev,1,F-IO,17,3,1,1,1,9,8
20170108-M-Chennai-F-Roberto_Bautista_Agut-Daniil_Medvedev,1,F-II,5,4,1,2,1,3,2
20170108-M-Chennai-F-Roberto_Bautista_Agut-Daniil_Medvedev,1,B-XC,14,0,0,0,0,11,3
20170108-M-Chennai-F-Roberto_Bautista_Agut-Daniil_Medvedev,1,B-DTM,29,3,1,1,1,21,8
20170108-M-Chennai-F-Roberto_Bautista_Agut-Daniil_Medvedev,1,B-DTL,5,1,0,1,0,2,3
20170108-M-Chennai-F-Roberto_Bautista_Agut-Daniil_Medvedev,1,B-IO,1,0,0,0,0,1,0
20170108-M-Chennai-F-Roberto_Bautista_Agut-Daniil_Medvedev,1,B-II,1,1,1,0,0,1,0
20170108-M-Chennai-F-Roberto_Bautista_Agut-Daniil_Medvedev,1,S-XC,8,2,0,2,0,6,2
20170108-M-Chennai-F-Roberto_Bautista_Agut-Daniil_Medvedev,1,S-DTM,8,1,0,0,1,3,5
20170108-M-Chennai-F-Roberto_Bautista_Agut-Daniil_Medvedev,2,F-XC,16,3,0,2,1,5,11
20170108-M-Chennai-F-Roberto_Bautista_Agut-Daniil_Medvedev,2,F-DTM,11,0,0,0,0,6,5
20170108-M-Chennai-F-Roberto_Bautista_Agut-Daniil_Medvedev,2,F-DTL,19,8,2,3,3,11,8
20170108-M-Chennai-F-Roberto_Bautista_Agut-Daniil_Medvedev,2,F-IO,17,4,2,0,2,8,9
20170108-M-Chennai-F-Roberto_Bautista_Agut-Daniil_Medvedev,2,B-XC,28,3,1,1,1,7,21
20170108-M-Chennai-F-Roberto_Bautista_Agut-Daniil_Medvedev,2,B-DTM,25,2,0,0,2,9,16
20170108-M-Chennai-F-Roberto_Bautista_Agut-Daniil_Medvedev,2,B-DTL,12,4,1,1,2,5,7
20170108-M-Chennai-F-Roberto_Bautista_Agut-Daniil_Medvedev,2,B-IO,7,3,0,0,3,3,4
20170108-M-Chennai-F-Roberto_Bautista_Agut-Daniil_Medvedev,2,B-II,1,0,0,0,0,1,0
20170108-M-Chennai-F-Roberto_Bautista_Agut-Daniil_Medvedev,2,S-XC,3,1,0,1,0,1,2
20170108-M-Chennai-F-Roberto_Bautista_Agut-Daniil_Medvedev,2,S-DTM,4,1,0,0,1,0,4
20170108-M-Chennai-F-Roberto_Bautista_Agut-Daniil_Medvedev,2,S-DTL,1,0,0,0,0,1,0
20080803-M-Cincinnati_Masters-F-Novak_Djokovic-Andy_Murray,1,F-XC,60,15,5,2,8,27,33
20080803-M-Cincinnati_Masters-F-Novak_Djokovic-Andy_Murray,1,F-DTM,46,1,0,0,1,23,23
20080803-M-Cincinnati_Masters-F-Novak_Djokovic-Andy_Murray,1,F-DTL,15,1,0,0,1,5,10
20080803-M-Cincinnati_Masters-F-Novak_Djokovic-Andy_Murray,1,F-IO,46,9,3,0,6,24,22
20080803-M-Cincinnati_Masters-F-Novak_Djokovic-Andy_Murray,1,F-II,4,3,1,2,0,3,1
20080803-M-Cincinnati_Masters-F-Novak_Djokovic-Andy_Murray,1,B-XC,41,10,3,2,5,23,18
20080803-M-Cincinnati_Masters-F-Novak_Djokovic-Andy_Murray,1,B-DTM,46,4,0,0,4,19,27
20080803-M-Cincinnati_Masters-F-Novak_Djokovic-Andy_Murray,1,B-DTL,14,7,2,0,5,2,12
20080803-M-Cincinnati_Masters-F-Novak_Djokovic-Andy_Murray,1,B-IO,8,3,1,0,2,2,6
20080803-M-Cincinnati_Masters-F-Novak_Djokovic-Andy_Murray,1,S-XC,1,0,0,0,0,1,0
20080803-M-Cincinnati_Masters-F-Novak_Djokovic-Andy_Murray,1,S-DTM,1,0,0,0,0,1,0
20080803-M-Cincinnati_Masters-F-Novak_Djokovic-Andy_Murray,1,S-DTL,3,0,0,0,0,2,1
20080803-M-Cincinnati_Masters-F-Novak_Djokovic-Andy_Murray,2,F-XC,57,11,2,5,4,34,23
20080803-M-Cincinnati_Masters-F-Novak_Djokovic-Andy_Murray,2,F-DTM,45,4,0,1,3,25,20
20080803-M-Cincinnati_Masters-F-Novak_Djokovic-Andy_Murray,2,F-DTL,21,4,2,1,1,15,6
20080803-M-Cincinnati_Masters-F-Novak_Djokovic-Andy_Murray,2,F-IO,23,6,1,2,3,12,11
20080803-M-Cincinnati_Masters-F-Novak_Djokovic-Andy_Murray,2,B-XC,39,8,2,2,4,19,20
20080803-M-Cincinnati_Masters-F-Novak_Djokovic-Andy_Murray,2,B-DTM,49,6,1,1,4,28,21
20080803-M-Cincinnati_Masters-F-Novak_Djokovic-Andy_Murray,2,B-DTL,10,6,1,4,1,6,4
20080803-M-Cincinnati_Masters-F-Novak_Djokovic-Andy_Murray,2,B-IO,9,2,0,0,2,4,5
20080803-M-Cincinnati_Masters-F-Novak_Djokovic-Andy_Murray,2,S-XC,17,0,0,0,0,6,11
20080803-M-Cincinnati_Masters-F-Novak_Djokovic-Andy_Murray,2,S-DTM,23,1,0,0,1,9,14
20080803-M-Cincinnati_Masters-F-Novak_Djokovic-Andy_Murray,2,S-DTL,1,0,0,0,0,0,1
20080803-M-Cincinnati_Masters-F-Novak_Djokovic-Andy_Murray,2,S-IO,2,0,0,0,0,1,1
20110508-M-Madrid_Masters-F-Novak_Djokovic-Rafael_Nadal,1,F-XC,91,8,1,4,3,53,38
20110508-M-Madrid_Masters-F-Novak_Djokovic-Rafael_Nadal,1,F-DTM,33,3,0,0,3,17,16
20110508-M-Madrid_Masters-F-Novak_Djokovic-Rafael_Nadal,1,F-DTL,16,6,3,1,2,11,5
20110508-M-Madrid_Masters-F-Novak_Djokovic-Rafael_Nadal,1,F-IO,28,10,2,5,3,18,10
20110508-M-Madrid_Masters-F-Novak_Djokovic-Rafael_Nadal,1,F-II,1,1,0,1,0,1,0
20110508-M-Madrid_Masters-F-Novak_Djokovic-Rafael_Nadal,1,B-XC,72,13,6,4,3,54,18
20110508-M-Madrid_Masters-F-Novak_Djokovic-Rafael_Nadal,1,B-DTM,59,3,1,1,1,37,22
20110508-M-Madrid_Masters-F-Novak_Djokovic-Rafael_Nadal,1,B-DTL,43,13,3,4,6,26,17
20110508-M-Madrid_Masters-F-Novak_Djokovic-Rafael_Nadal,1,B-IO,12,0,0,0,0,8,4
20110508-M-Madrid_Masters-F-Novak_Djokovic-Rafael_Nadal,1,S-DTM,1,0,0,0,0,0,1
20110508-M-Madrid_Masters-F-Novak_Djokovic-Rafael_Nadal,2,F-XC,115,13,3,4,6,38,77
20110508-M-Madrid_Masters-F-Novak_Djokovic-Rafael_Nadal,2,F-DTM,40,2,0,0,2,19,21
20110508-M-Madrid_Masters-F-Novak_Djokovic-Rafael_Nadal,2,F-DTL,11,4,2,1,1,4,7
20110508-M-Madrid_Masters-F-Novak_Djokovic-Rafael_Nadal,2,F-IO,33,3,1,2,0,21,12
20110508-M-Madrid_Masters-F-Novak_Djokovic-Rafael_Nadal,2,F-II,8,3,2,1,0,6,2
20110508-M-Madrid_Masters-F-Novak_Djokovic-Rafael_Nadal,2,B-XC,49,6,1,0,5,17,32
20110508-M-Madrid_Masters-F-Novak_Djokovic-Rafael_Nadal,2,B-DTM,51,5,0,1,4,13,38
20110508-M-Madrid_Masters-F-Novak_Djokovic-Rafael_Nadal,2,B-DTL,24,2,1,0,1,12,12
20110508-M-Madrid_Masters-F-Novak_Djokovic-Rafael_Nadal,2,B-IO,8,1,0,0,1,1,7
20110508-M-Madrid_Masters-F-Novak_Djokovic-Rafael_Nadal,2,S-XC,1,0,0,0,0,0,1
20110508-M-Madrid_Masters-F-Novak_Djokovic-Rafael_Nadal,2,S-DTM,6,0,0,0,0,1,5
20110508-M-Madrid_Masters-F-Novak_Djokovic-Rafael_Nadal,2,S-DTL,3,1,0,0,1,1,2
20110508-M-Madrid_Masters-F-Novak_Djokovic-Rafael_Nadal,2,S-IO,1,0,0,0,0,0,1
20170319-M-Indian_Wells_Masters-F-Roger_Federer-Stanislas_Wawrinka,1,F-XC,22,13,2,4,7,12,10
20170319-M-Indian_Wells_Masters-F-Roger_Federer-Stanislas_Wawrinka,1,F-DTM,18,1,0,1,0,11,7
20170319-M-Indian_Wells_Masters-F-Roger_Federer-Stanislas_Wawrinka,1,F-DTL,4,0,0,0,0,3,1
20170319-M-Indian_Wells_Masters-F-Roger_Federer-Stanislas_Wawrinka,1,F-IO,17,5,3,1,1,12,5
20170319-M-Indian_Wells_Masters-F-Roger_Federer-Stanislas_Wawrinka,1,F-II,4,1,0,0,1,2,2
20170319-M-Indian_Wells_Masters-F-Roger_Federer-Stanislas_Wawrinka,1,B-XC,18,6,1,2,3,15,3
20170319-M-Indian_Wells_Masters-F-Roger_Federer-Stanislas_Wawrinka,1,B-DTM,17,2,0,0,2,7,10
20170319-M-Indian_Wells_Masters-F-Roger_Federer-Stanislas_Wawrinka,1,B-DTL,3,3,1,0,2,1,2
20170319-M-Indian_Wells_Masters-F-Roger_Federer-Stanislas_Wawrinka,1,S-XC,6,0,0,0,0,4,2
20170319-M-Indian_Wells_Masters-F-Roger_Federer-Stanislas_Wawrinka,1,S-DTM,5,0,0,0,0,4,1
20170319-M-Indian_Wells_Masters-F-Roger_Federer-Stanislas_Wawrinka,1,S-DTL,3,0,0,0,0,2,1
20170319-M-Indian_Wells_Masters-F-Roger_Federer-Stanislas_Wawrinka,1,S-IO,1,0,0,0,0,1,0
20170319-M-Indian_Wells_Masters-F-Roger_Federer-Stanislas_Wawrinka,2,F-XC,27,11,5,4,2,19,8
20170319-M-Indian_Wells_Masters-F-Roger_Federer-Stanislas_Wawrinka,2,F-DTM,22,3,0,1,2,7,15
20170319-M-Indian_Wells_Masters-F-Roger_Federer-Stanislas_Wawrinka,2,F-DTL,7,3,2,0,1,2,5
20170319-M-Indian_Wells_Masters-F-Roger_Federer-Stanislas_Wawrinka,2,F-IO,9,3,1,0,2,3,6
20170319-M-Indian_Wells_Masters-F-Roger_Federer-Stanislas_Wawrinka,2,F-II,2,0,0,0,0,0,2
20170319-M-Indian_Wells_Masters-F-Roger_Federer-Stanislas_Wawrinka,2,B-XC,40,9,1,2,6,15,25
20170319-M-Indian_Wells_Masters-F-Roger_Federer-Stanislas_Wawrinka,2,B-DTM,15,4,0,0,4,3,12
20170319-M-Indian_Wells_Masters-F-Roger_Federer-Stanislas_Wawrinka,2,B-DTL,3,1,0,0,1,0,3
20170319-M-Indian_Wells_Masters-F-Roger_Federer-Stanislas_Wawrinka,2,S-XC,3,1,0,0,1,0,3
20170319-M-Indian_Wells_Masters-F-Roger_Federer-Stanislas_Wawrinka,2,S-DTM,2,0,0,0,0,0,2
20170319-M-Indian_Wells_Masters-F-Roger_Federer-Stanislas_Wawrinka,2,S-IO,1,0,0,0,0,0,1
20080304-M-Dubai-R32-Roger_Federer-Andy_Murray,1,F-XC,39,13,5,3,5,20,19
20080304-M-Dubai-R32-Roger_Federer-Andy_Murray,1,F-DTM,26,6,0,1,5,10,16
20080304-M-Dubai-R32-Roger_Federer-Andy_Murray,1,F-DTL,10,5,2,0,3,4,6
20080304-M-Dubai-R32-Roger_Federer-Andy_Murray,1,F-IO,17,8,4,3,1,14,3
20080304-M-Dubai-R32-Roger_Federer-Andy_Murray,1,F-II,3,1,0,1,0,1,2
20080304-M-Dubai-R32-Roger_Federer-Andy_Murray,1,B-XC,21,5,1,2,2,9,12
20080304-M-Dubai-R32-Roger_Federer-Andy_Murray,1,B-DTM,24,4,0,1,3,7,17
20080304-M-Dubai-R32-Roger_Federer-Andy_Murray,1,B-DTL,9,4,1,0,3,5,4
20080304-M-Dubai-R32-Roger_Federer-Andy_Murray,1,B-IO,3,0,0,0,0,2,1
20080304-M-Dubai-R32-Roger_Federer-Andy_Murray,1,S-XC,10,0,0,0,0,5,5
20080304-M-Dubai-R32-Roger_Federer-Andy_Murray,1,S-DTM,9,1,0,0,1,2,7
20080304-M-Dubai-R32-Roger_Federer-Andy_Murray,1,S-IO,2,1,0,0,1,0,2
20080304-M-Dubai-R32-Roger_Federer-Andy_Murray,2,F-XC,36,11,5,3,3,25,11
20080304-M-Dubai-R32-Roger_Federer-Andy_Murray,2,F-DTM,34,2,0,2,0,18,16
20080304-M-Dubai-R32-Roger_Federer-Andy_Murray,2,F-DTL,10,4,0,1,3,3,7
20080304-M-Dubai-R32-Roger_Federer-Andy_Murray,2,F-IO,18,5,2,2,1,11,7
20080304-M-Dubai-R32-Roger_Federer-Andy_Murray,2,F-II,3,2,0,1,1,1,2
20080304-M-Dubai-R32-Roger_Federer-Andy_Murray,2,B-XC,36,4,1,0,3,22,14
20080304-M-Dubai-R32-Roger_Federer-Andy_Murray,2,B-DTM,23,2,1,0,1,11,12
20080304-M-Dubai-R32-Roger_Federer-Andy_Murray,2,B-DTL,3,1,1,0,0,1,2
20080304-M-Dubai-R32-Roger_Federer-Andy_Murray,2,B-IO,5,2,0,2,0,4,1
20080304-M-Dubai-R32-Roger_Federer-Andy_Murray,2,S-XC,3,0,0,0,0,1,2
20080304-M-Dubai-R32-Roger_Federer-Andy_Murray,2,S-DTM,3,0,0,0,0,0,3
20080304-M-Dubai-R32-Roger_Federer-Andy_Murray,2,S-DTL,1,0,0,0,0,0,1
20080304-M-Dubai-R32-Roger_Federer-Andy_Murray,2,S-IO,2,0,0,0,0,2,0
20081018-M-Madrid_Masters-SF-Roger_Federer-Andy_Murray,1,F-XC,38,11,1,4,6,18,20
20081018-M-Madrid_Masters-SF-Roger_Federer-Andy_Murray,1,F-DTM,21,0,0,0,0,9,12
20081018-M-Madrid_Masters-SF-Roger_Federer-Andy_Murray,1,F-DTL,7,5,0,4,1,5,2
20081018-M-Madrid_Masters-SF-Roger_Federer-Andy_Murray,1,F-IO,25,11,3,3,5,14,11
20081018-M-Madrid_Masters-SF-Roger_Federer-Andy_Murray,1,F-II,7,4,1,1,2,4,3
20081018-M-Madrid_Masters-SF-Roger_Federer-Andy_Murray,1,B-XC,28,2,0,1,1,10,18
20081018-M-Madrid_Masters-SF-Roger_Federer-Andy_Murray,1,B-DTM,17,4,0,0,4,10,7
20081018-M-Madrid_Masters-SF-Roger_Federer-Andy_Murray,1,B-DTL,8,3,2,0,1,4,4
20081018-M-Madrid_Masters-SF-Roger_Federer-Andy_Murray,1,B-IO,2,2,0,1,1,1,1
20081018-M-Madrid_Masters-SF-Roger_Federer-Andy_Murray,1,S-XC,27,0,0,0,0,17,10
20081018-M-Madrid_Masters-SF-Roger_Federer-Andy_Murray,1,S-DTM,11,1,0,0,1,2,9
20081018-M-Madrid_Masters-SF-Roger_Federer-Andy_Murray,1,S-DTL,4,1,0,1,0,3,1
20081018-M-Madrid_Masters-SF-Roger_Federer-Andy_Murray,1,S-IO,1,0,0,0,0,0,1
20081018-M-Madrid_Masters-SF-Roger_Federer-Andy_Murray,2,F-XC,32,11,2,5,4,16,16
20081018-M-Madrid_Masters-SF-Roger_Federer-Andy_Murray,2,F-DTM,22,4,2,0,2,11,11
20081018-M-Madrid_Masters-SF-Roger_Federer-Andy_Murray,2,F-DTL,11,4,1,1,2,6,5
20081018-M-Madrid_Masters-SF-Roger_Federer-Andy_Murray,2,F-IO,19,6,2,2,2,12,7
20081018-M-Madrid_Masters-SF-Roger_Federer-Andy_Murray,2,F-II,2,1,0,0,1,1,1
20081018-M-Madrid_Masters-SF-Roger_Federer-Andy_Murray,2,B-XC,38,5,2,1,2,17,21
20081018-M-Madrid_Masters-SF-Roger_Federer-Andy_Murray,2,B-DTM,18,2,0,0,2,8,10
20081018-M-Madrid_Masters-SF-Roger_Federer-Andy_Murray,2,B-DTL,4,4,1,2,1,3,1
20081018-M-Madrid_Masters-SF-Roger_Federer-Andy_Murray,2,B-IO,9,4,1,0,3,4,5
20081018-M-Madrid_Masters-SF-Roger_Federer-Andy_Murray,2,S-XC,20,1,0,0,1,12,8
20081018-M-Madrid_Masters-SF-Roger_Federer-Andy_Murray,2,S-DTM,8,1,0,0,1,5,3
20081018-M-Madrid_Masters-SF-Roger_Federer-Andy_Murray,2,S-DTL,2,0,0,0,0,1,1
20081018-M-Madrid_Masters-SF-Roger_Federer-Andy_Murray,2,S-IO,2,1,0,1,0,2,0
19931118-M-Tour_Finals-RR-Pete_Sampras-Stefan_Edberg,1,F-XC,6,2,1,0,1,1,5
19931118-M-Tour_Finals-RR-Pete_Sampras-Stefan_Edberg,1,F-DTM,1,0,0,0,0,1,0
19931118-M-Tour_Finals-RR-Pete_Sampras-Stefan_Edberg,1,F-DTL,3,2,0,0,2,1,2
19931118-M-Tour_Finals-RR-Pete_Sampras-Stefan_Edberg,1,F-IO,3,1,0,0,1,1,2
19931118-M-Tour_Finals-RR-Pete_Sampras-Stefan_Edberg,1,B-XC,7,5,3,2,0,5,2
19931118-M-Tour_Finals-RR-Pete_Sampras-Stefan_Edberg,1,B-DTM,5,2,0,1,1,2,3
19931118-M-Tour_Finals-RR-Pete_Sampras-Stefan_Edberg,1,B-DTL,3,3,2,0,1,2,1
19931118-M-Tour_Finals-RR-Pete_Sampras-Stefan_Edberg,1,S-XC,1,0,0,0,0,0,1
19931118-M-Tour_Finals-RR-Pete_Sampras-Stefan_Edberg,1,S-DTM,1,0,0,0,0,0,1
19931118-M-Tour_Finals-RR-Pete_Sampras-Stefan_Edberg,1,S-DTL,1,0,0,0,0,0,1
19931118-M-Tour_Finals-RR-Pete_Sampras-Stefan_Edberg,2,F-XC,3,0,0,0,0,3,0
19931118-M-Tour_Finals-RR-Pete_Sampras-Stefan_Edberg,2,F-DTM,2,0,0,0,0,0,2
19931118-M-Tour_Finals-RR-Pete_Sampras-Stefan_Edberg,2,F-DTL,3,0,0,0,0,2,1
19931118-M-Tour_Finals-RR-Pete_Sampras-Stefan_Edberg,2,F-IO,1,1,0,1,0,1,0
19931118-M-Tour_Finals-RR-Pete_Sampras-Stefan_Edberg,2,B-XC,4,0,0,0,0,1,3
19931118-M-Tour_Finals-RR-Pete_Sampras-Stefan_Edberg,2,B-DTM,5,1,0,0,1,3,2
19931118-M-Tour_Finals-RR-Pete_Sampras-Stefan_Edberg,2,B-DTL,4,3,2,0,1,2,2
19931118-M-Tour_Finals-RR-Pete_Sampras-Stefan_Edberg,2,B-IO,1,1,0,1,0,1,0
19931118-M-Tour_Finals-RR-Pete_Sampras-Stefan_Edberg,2,S-XC,1,0,0,0,0,1,0
19931118-M-Tour_Finals-RR-Pete_Sampras-Stefan_Edberg,2,S-DTM,1,0,0,0,0,0,1
19931118-M-Tour_Finals-RR-Pete_Sampras-Stefan_Edberg,2,S-DTL,1,0,0,0,0,1,0
20111016-M-Shanghai_Masters-F-David_Ferrer-Andy_Murray,1,F-XC,49,8,1,1,6,17,32
20111016-M-Shanghai_Masters-F-David_Ferrer-Andy_Murray,1,F-DTM,48,3,0,0,3,21,27
20111016-M-Shanghai_Masters-F-David_Ferrer-Andy_Murray,1,F-DTL,17,4,0,1,3,4,13
20111016-M-Shanghai_Masters-F-David_Ferrer-Andy_Murray,1,F-IO,67,7,1,3,3,34,33
20111016-M-Shanghai_Masters-F-David_Ferrer-Andy_Murray,1,F-II,10,4,1,1,2,6,4
20111016-M-Shanghai_Masters-F-David_Ferrer-Andy_Murray,1,B-XC,56,5,1,0,4,24,32
20111016-M-Shanghai_Masters-F-David_Ferrer-Andy_Murray,1,B-DTM,51,7,0,1,6,24,27
20111016-M-Shanghai_Masters-F-David_Ferrer-Andy_Murray,1,B-DTL,7,2,1,0,1,1,6
20111016-M-Shanghai_Masters-F-David_Ferrer-Andy_Murray,1,S-XC,1,0,0,0,0,0,1
20111016-M-Shanghai_Masters-F-David_Ferrer-Andy_Murray,1,S-DTM,2,0,0,0,0,1,1
20111016-M-Shanghai_Masters-F-David_Ferrer-Andy_Murray,2,F-XC,49,4,0,0,4,29,20
20111016-M-Shanghai_Masters-F-David_Ferrer-Andy_Murray,2,F-DTM,33,2,0,0,2,17,16
20111016-M-Shanghai_Masters-F-David_Ferrer-Andy_Murray,2,F-DTL,9,4,3,1,0,8,1
20111016-M-Shanghai_Masters-F-David_Ferrer-Andy_Murray,2,F-IO,29,6,2,1,3,13,16
20111016-M-Shanghai_Masters-F-David_Ferrer-Andy_Murray,2,F-II,1,0,0,0,0,0,1
20111016-M-Shanghai_Masters-F-David_Ferrer-Andy_Murray,2,B-XC,76,13,3,3,7,42,34
20111016-M-Shanghai_Masters-F-David_Ferrer-Andy_Murray,2,B-DTM,36,5,0,1,4,20,16
20111016-M-Shanghai_Masters-F-David_Ferrer-Andy_Murray,2,B-DTL,12,5,0,1,4,6,6
20111016-M-Shanghai_Masters-F-David_Ferrer-Andy_Murray,2,B-IO,8,3,2,0,1,5,3
20111016-M-Shanghai_Masters-F-David_Ferrer-Andy_Murray,2,S-XC,14,1,0,0,1,10,4
20111016-M-Shanghai_Masters-F-David_Ferrer-Andy_Murray,2,S-DTM,22,1,0,1,0,11,11
20111016-M-Shanghai_Masters-F-David_Ferrer-Andy_Murray,2,S-DTL,3,0,0,0,0,2,1
20111016-M-Shanghai_Masters-F-David_Ferrer-Andy_Murray,2,S-IO,4,0,0,0,0,1,3
20100404-M-Miami_Masters-F-Tomas_Berdych-Andy_Roddick,1,F-XC,51,16,3,5,8,30,21
20100404-M-Miami_Masters-F-Tomas_Berdych-Andy_Roddick,1,F-DTM,25,2,0,0,2,12,13
20100404-M-Miami_Masters-F-Tomas_Berdych-Andy_Roddick,1,F-DTL,8,1,0,0,1,5,3
20100404-M-Miami_Masters-F-Tomas_Berdych-Andy_Roddick,1,F-IO,39,10,4,1,5,19,20
20100404-M-Miami_Masters-F-Tomas_Berdych-Andy_Roddick,1,F-II,4,1,1,0,0,4,0
20100404-M-Miami_Masters-F-Tomas_Berdych-Andy_Roddick,1,B-XC,35,7,2,2,3,20,15
20100404-M-Miami_Masters-F-Tomas_Berdych-Andy_Roddick,1,B-DTM,23,2,0,0,2,9,14
20100404-M-Miami_Masters-F-Tomas_Berdych-Andy_Roddick,1,B-DTL,5,2,1,0,1,2,3
20100404-M-Miami_Masters-F-Tomas_Berdych-Andy_Roddick,1,B-IO,4,1,0,1,0,3,1
20100404-M-Miami_Masters-F-Tomas_Berdych-Andy_Roddick,1,S-XC,20,2,0,1,1,12,8
20100404-M-Miami_Masters-F-Tomas_Berdych-Andy_Roddick,1,S-DTM,12,3,0,1,2,5,7
20100404-M-Miami_Masters-F-Tomas_Berdych-Andy_Roddick,1,S-DTL,3,0,0,0,0,1,2
20100404-M-Miami_Masters-F-Tomas_Berdych-Andy_Roddick,1,S-IO,1,0,0,0,0,1,0
20100404-M-Miami_Masters-F-Tomas_Berdych-Andy_Roddick,2,F-XC,38,6,1,0,5,16,22
20100404-M-Miami_Masters-F-Tomas_Berdych-Andy_Roddick,2,F-DTM,31,1,0,0,1,13,18
20100404-M-Miami_Masters-F-Tomas_Berdych-Andy_Roddick,2,F-DTL,4,0,0,0,0,2,2
20100404-M-Miami_Masters-F-Tomas_Berdych-Andy_Roddick,2,F-IO,26,7,3,3,1,16,10
20100404-M-Miami_Masters-F-Tomas_Berdych-Andy_Roddick,2,F-II,2,1,0,0,1,0,2
20100404-M-Miami_Masters-F-Tomas_Berdych-Andy_Roddick,2,B-XC,22,3,1,2,0,13,9
20100404-M-Miami_Masters-F-Tomas_Berdych-Andy_Roddick,2,B-DTM,20,1,0,0,1,13,7
20100404-M-Miami_Masters-F-Tomas_Berdych-Andy_Roddick,2,B-DTL,3,1,0,1,0,2,1
20100404-M-Miami_Masters-F-Tomas_Berdych-Andy_Roddick,2,B-IO,2,0,0,0,0,1,1
20100404-M-Miami_Masters-F-Tomas_Berdych-Andy_Roddick,2,S-XC,38,1,0,1,0,14,24
20100404-M-Miami_Masters-F-Tomas_Berdych-Andy_Roddick,2,S-DTM,20,0,0,0,0,13,7
20100404-M-Miami_Masters-F-Tomas_Berdych-Andy_Roddick,2,S-DTL,3,0,0,0,0,1,2
20100404-M-Miami_Masters-F-Tomas_Berdych-Andy_Roddick,2,S-IO,1,0,0,0,0,0,1
20080419-M-Monte_Carlo_Masters-SF-Roger_Federer-Novak_Djokovic,1,F-XC,39,6,4,1,1,26,13
20080419-M-Monte_Carlo_Masters-SF-Roger_Federer-Novak_Djokovic,1,F-DTM,27,1,1,0,0,15,12
20080419-M-Monte_Carlo_Masters-SF-Roger_Federer-Novak_Djokovic,1,F-DTL,12,7,4,1,2,7,5
20080419-M-Monte_Carlo_Masters-SF-Roger_Federer-Novak_Djokovic,1,F-IO,14,3,1,1,1,8,6
20080419-M-Monte_Carlo_Masters-SF-Roger_Federer-Novak_Djokovic,1,F-II,8,2,2,0,0,6,2
20080419-M-Monte_Carlo_Masters-SF-Roger_Federer-Novak_Djokovic,1,B-XC,22,4,3,0,1,13,9
20080419-M-Monte_Carlo_Masters-SF-Roger_Federer-Novak_Djokovic,1,B-DTM,27,1,0,0,1,10,17
20080419-M-Monte_Carlo_Masters-SF-Roger_Federer-Novak_Djokovic,1,B-DTL,9,6,1,2,3,3,6
20080419-M-Monte_Carlo_Masters-SF-Roger_Federer-Novak_Djokovic,1,B-IO,1,0,0,0,0,1,0
20080419-M-Monte_Carlo_Masters-SF-Roger_Federer-Novak_Djokovic,1,S-XC,8,0,0,0,0,3,5
20080419-M-Monte_Carlo_Masters-SF-Roger_Federer-Novak_Djokovic,1,S-DTM,6,1,0,0,1,4,2
20080419-M-Monte_Carlo_Masters-SF-Roger_Federer-Novak_Djokovic,1,S-DTL,2,0,0,0,0,0,2
20080419-M-Monte_Carlo_Masters-SF-Roger_Federer-Novak_Djokovic,2,F-XC,33,11,4,3,4,19,14
20080419-M-Monte_Carlo_Masters-SF-Roger_Federer-Novak_Djokovic,2,F-DTM,30,2,1,0,1,10,20
20080419-M-Monte_Carlo_Masters-SF-Roger_Federer-Novak_Djokovic,2,F-DTL,16,10,2,1,7,6,10
20080419-M-Monte_Carlo_Masters-SF-Roger_Federer-Novak_Djokovic,2,F-IO,17,3,2,1,0,13,4
20080419-M-Monte_Carlo_Masters-SF-Roger_Federer-Novak_Djokovic,2,F-II,3,1,0,0,1,0,3
20080419-M-Monte_Carlo_Masters-SF-Roger_Federer-Novak_Djokovic,2,B-XC,44,4,0,1,3,24,20
20080419-M-Monte_Carlo_Masters-SF-Roger_Federer-Novak_Djokovic,2,B-DTM,29,3,0,0,3,10,19
20080419-M-Monte_Carlo_Masters-SF-Roger_Federer-Novak_Djokovic,2,B-DTL,6,4,1,2,1,4,2
20080419-M-Monte_Carlo_Masters-SF-Roger_Federer-Novak_Djokovic,2,B-IO,6,1,0,1,0,3,3
20080419-M-Monte_Carlo_Masters-SF-Roger_Federer-Novak_Djokovic,2,S-XC,1,0,0,0,0,1,0
20080419-M-Monte_Carlo_Masters-SF-Roger_Federer-Novak_Djokovic,2,S-DTM,2,0,0,0,0,1,1
20080419-M-Monte_Carlo_Masters-SF-Roger_Federer-Novak_Djokovic,2,S-DTL,1,1,0,1,0,1,0
19941116-M-Tour_Finals-RR-Pete_Sampras-Stefan_Edberg,1,F-XC,11,4,1,3,0,10,1
19941116-M-Tour_Finals-RR-Pete_Sampras-Stefan_Edberg,1,F-DTM,1,0,0,0,0,0,1
19941116-M-Tour_Finals-RR-Pete_Sampras-Stefan_Edberg,1,F-DTL,3,3,3,0,0,3,0
19941116-M-Tour_Finals-RR-Pete_Sampras-Stefan_Edberg,1,F-IO,4,1,0,1,0,3,1
19941116-M-Tour_Finals-RR-Pete_Sampras-Stefan_Edberg,1,F-II,2,1,0,0,1,0,2
19941116-M-Tour_Finals-RR-Pete_Sampras-Stefan_Edberg,1,B-XC,19,7,4,2,1,13,6
19941116-M-Tour_Finals-RR-Pete_Sampras-Stefan_Edberg,1,B-DTM,10,0,0,0,0,6,4
19941116-M-Tour_Finals-RR-Pete_Sampras-Stefan_Edberg,1,B-DTL,9,5,1,2,2,4,5
19941116-M-Tour_Finals-RR-Pete_Sampras-Stefan_Edberg,1,B-IO,3,3,1,1,1,2,1
19941116-M-Tour_Finals-RR-Pete_Sampras-Stefan_Edberg,1,S-XC,1,0,0,0,0,0,1
19941116-M-Tour_Finals-RR-Pete_Sampras-Stefan_Edberg,1,S-DTM,1,1,0,0,1,0,1
19941116-M-Tour_Finals-RR-Pete_Sampras-Stefan_Edberg,1,S-DTL,1,0,0,0,0,0,1
19941116-M-Tour_Finals-RR-Pete_Sampras-Stefan_Edberg,2,F-XC,5,2,2,0,0,3,2
19941116-M-Tour_Finals-RR-Pete_Sampras-Stefan_Edberg,2,F-DTM,7,0,0,0,0,3,4
19941116-M-Tour_Finals-RR-Pete_Sampras-Stefan_Edberg,2,F-DTL,4,2,1,0,1,2,2
19941116-M-Tour_Finals-RR-Pete_Sampras-Stefan_Edberg,2,F-IO,2,2,1,0,1,1,1
19941116-M-Tour_Finals-RR-Pete_Sampras-Stefan_Edberg,2,B-XC,18,8,5,1,2,12,6
19941116-M-Tour_Finals-RR-Pete_Sampras-Stefan_Edberg,2,B-DTM,3,1,0,0,1,0,3
19941116-M-Tour_Finals-RR-Pete_Sampras-Stefan_Edberg,2,B-DTL,3,3,2,0,1,2,1
19941116-M-Tour_Finals-RR-Pete_Sampras-Stefan_Edberg,2,B-IO,6,5,1,2,2,3,3
19941116-M-Tour_Finals-RR-Pete_Sampras-Stefan_Edberg,2,S-XC,5,0,0,0,0,3,2
19941116-M-Tour_Finals-RR-Pete_Sampras-Stefan_Edberg,2,S-DTM,3,0,0,0,0,0,3
19941116-M-Tour_Finals-RR-Pete_Sampras-Stefan_Edberg,2,S-DTL,2,2,0,2,0,2,0
20110319-M-Indian_Wells_Masters-SF-Roger_Federer-Novak_Djokovic,1,F-XC,55,20,4,9,7,33,22
20110319-M-Indian_Wells_Masters-SF-Roger_Federer-Novak_Djokovic,1,F-DTM,47,5,2,1,2,25,22
20110319-M-Indian_Wells_Masters-SF-Roger_Federer-Novak_Djokovic,1,F-DTL,8,1,1,0,0,7,1
20110319-M-Indian_Wells_Masters-SF-Roger_Federer-Novak_Djokovic,1,F-IO,36,14,3,4,7,23,13
20110319-M-Indian_Wells_Masters-SF-Roger_Federer-Novak_Djokovic,1,F-II,10,4,1,0,3,4,6
20110319-M-Indian_Wells_Masters-SF-Roger_Federer-Novak_Djokovic,1,B-XC,42,4,0,1,3,19,23
20110319-M-Indian_Wells_Masters-SF-Roger_Federer-Novak_Djokovic,1,B-DTM,52,5,0,0,5,24,28
20110319-M-Indian_Wells_Masters-SF-Roger_Federer-Novak_Djokovic,1,B-DTL,11,6,1,2,3,5,6
20110319-M-Indian_Wells_Masters-SF-Roger_Federer-Novak_Djokovic,1,B-IO,5,1,0,0,1,1,4
20110319-M-Indian_Wells_Masters-SF-Roger_Federer-Novak_Djokovic,1,S-XC,14,0,0,0,0,11,3
20110319-M-Indian_Wells_Masters-SF-Roger_Federer-Novak_Djokovic,1,S-DTM,7,0,0,0,0,4,3
20110319-M-Indian_Wells_Masters-SF-Roger_Federer-Novak_Djokovic,1,S-DTL,4,0,0,0,0,0,4
20110319-M-Indian_Wells_Masters-SF-Roger_Federer-Novak_Djokovic,2,F-XC,59,15,4,7,4,33,26
20110319-M-Indian_Wells_Masters-SF-Roger_Federer-Novak_Djokovic,2,F-DTM,39,0,0,0,0,18,21
20110319-M-Indian_Wells_Masters-SF-Roger_Federer-Novak_Djokovic,2,F-DTL,9,1,0,1,0,7,2
20110319-M-Indian_Wells_Masters-SF-Roger_Federer-Novak_Djokovic,2,F-IO,41,8,2,0,6,14,27
20110319-M-Indian_Wells_Masters-SF-Roger_Federer-Novak_Djokovic,2,F-II,7,3,1,0,2,1,6
20110319-M-Indian_Wells_Masters-SF-Roger_Federer-Novak_Djokovic,2,B-XC,51,6,2,2,2,27,24
20110319-M-Indian_Wells_Masters-SF-Roger_Federer-Novak_Djokovic,2,B-DTM,46,5,0,1,4,14,32
20110319-M-Indian_Wells_Masters-SF-Roger_Federer-Novak_Djokovic,2,B-DTL,10,4,1,2,1,7,3
20110319-M-Indian_Wells_Masters-SF-Roger_Federer-Novak_Djokovic,2,B-IO,4,1,0,0,1,1,3
20110319-M-Indian_Wells_Masters-SF-Roger_Federer-Novak_Djokovic,2,S-XC,8,1,0,0,1,4,4
20110319-M-Indian_Wells_Masters-SF-Roger_Federer-Novak_Djokovic,2,S-DTM,4,0,0,0,0,1,3
20110319-M-Indian_Wells_Masters-SF-Roger_Federer-Novak_Djokovic,2,S-IO,1,0,0,0,0,1,0
20090412-M-Monte_Carlo_Masters-F-Novak_Djokovic-Rafael_Nadal,1,F-XC,91,8,2,3,3,48,43
20090412-M-Monte_Carlo_Masters-F-Novak_Djokovic-Rafael_Nadal,1,F-DTM,38,3,0,0,3,12,26
20090412-M-Monte_Carlo_Masters-F-Novak_Djokovic-Rafael_Nadal,1,F-DTL,25,11,3,0,8,10,15
20090412-M-Monte_Carlo_Masters-F-Novak_Djokovic-Rafael_Nadal,1,F-IO,41,11,6,1,4,21,20
20090412-M-Monte_Carlo_Masters-F-Novak_Djokovic-Rafael_Nadal,1,F-II,6,1,0,1,0,3,3
20090412-M-Monte_Carlo_Masters-F-Novak_Djokovic-Rafael_Nadal,1,B-XC,62,8,2,1,5,24,38
20090412-M-Monte_Carlo_Masters-F-Novak_Djokovic-Rafael_Nadal,1,B-DTM,64,8,0,0,8,28,36
20090412-M-Monte_Carlo_Masters-F-Novak_Djokovic-Rafael_Nadal,1,B-DTL,58,9,1,1,7,26,32
20090412-M-Monte_Carlo_Masters-F-Novak_Djokovic-Rafael_Nadal,1,B-IO,33,3,0,0,3,14,19
20090412-M-Monte_Carlo_Masters-F-Novak_Djokovic-Rafael_Nadal,1,B-II,2,0,0,0,0,2,0
20090412-M-Monte_Carlo_Masters-F-Novak_Djokovic-Rafael_Nadal,1,S-XC,1,0,0,0,0,0,1
20090412-M-Monte_Carlo_Masters-F-Novak_Djokovic-Rafael_Nadal,1,S-DTM,6,0,0,0,0,3,3
20090412-M-Monte_Carlo_Masters-F-Novak_Djokovic-Rafael_Nadal,1,S-DTL,4,0,0,0,0,1,3
20090412-M-Monte_Carlo_Masters-F-Novak_Djokovic-Rafael_Nadal,2,F-XC,124,14,6,3,5,75,49
20090412-M-Monte_Carlo_Masters-F-Novak_Djokovic-Rafael_Nadal,2,F-DTM,47,3,0,0,3,24,23
20090412-M-Monte_Carlo_Masters-F-Novak_Djokovic-Rafael_Nadal,2,F-DTL,22,7,3,2,2,13,9
20090412-M-Monte_Carlo_Masters-F-Novak_Djokovic-Rafael_Nadal,2,F-IO,48,9,3,1,5,21,27
20090412-M-Monte_Carlo_Masters-F-Novak_Djokovic-Rafael_Nadal,2,F-II,12,3,2,1,0,6,6
20090412-M-Monte_Carlo_Masters-F-Novak_Djokovic-Rafael_Nadal,2,B-XC,69,4,1,1,2,38,31
20090412-M-Monte_Carlo_Masters-F-Novak_Djokovic-Rafael_Nadal,2,B-DTM,39,5,0,0,5,19,20
20090412-M-Monte_Carlo_Masters-F-Novak_Djokovic-Rafael_Nadal,2,B-DTL,38,3,3,0,0,19,19
20090412-M-Monte_Carlo_Masters-F-Novak_Djokovic-Rafael_Nadal,2,B-IO,11,1,0,0,1,5,6
20090412-M-Monte_Carlo_Masters-F-Novak_Djokovic-Rafael_Nadal,2,B-II,1,0,0,0,0,0,1
20090412-M-Monte_Carlo_Masters-F-Novak_Djokovic-Rafael_Nadal,2,S-XC,2,0,0,0,0,1,1
20090412-M-Monte_Carlo_Masters-F-Novak_Djokovic-Rafael_Nadal,2,S-DTM,14,0,0,0,0,3,11
20090412-M-Monte_Carlo_Masters-F-Novak_Djokovic-Rafael_Nadal,2,S-DTL,11,0,0,0,0,6,5
20090412-M-Monte_Carlo_Masters-F-Novak_Djokovic-Rafael_Nadal,2,S-IO,1,0,0,0,0,1,0
20090913-M-US_Open-SF-Novak_Djokovic-Roger_Federer,1,F-XC,54,15,6,4,5,20,34
20090913-M-US_Open-SF-Novak_Djokovic-Roger_Federer,1,F-DTM,31,4,1,1,2,16,15
20090913-M-US_Open-SF-Novak_Djokovic-Roger_Federer,1,F-DTL,9,2,1,1,0,5,4
20090913-M-US_Open-SF-Novak_Djokovic-Roger_Federer,1,F-IO,30,7,3,3,1,17,13
20090913-M-US_Open-SF-Novak_Djokovic-Roger_Federer,1,F-II,4,3,0,1,2,1,3
20090913-M-US_Open-SF-Novak_Djokovic-Roger_Federer,1,B-XC,50,12,3,5,4,25,25
20090913-M-US_Open-SF-Novak_Djokovic-Roger_Federer,1,B-DTM,35,2,0,1,1,17,18
20090913-M-US_Open-SF-Novak_Djokovic-Roger_Federer,1,B-DTL,10,4,0,2,2,5,5
20090913-M-US_Open-SF-Novak_Djokovic-Roger_Federer,1,B-IO,8,6,2,2,2,5,3
20090913-M-US_Open-SF-Novak_Djokovic-Roger_Federer,1,S-XC,11,2,0,0,2,4,7
20090913-M-US_Open-SF-Novak_Djokovic-Roger_Federer,1,S-DTM,7,1,0,0,1,2,5
20090913-M-US_Open-SF-Novak_Djokovic-Roger_Federer,1,S-DTL,1,0,0,0,0,0,1
20090913-M-US_Open-SF-Novak_Djokovic-Roger_Federer,1,S-IO,3,0,0,0,0,0,3
20090913-M-US_Open-SF-Novak_Djokovic-Roger_Federer,2,F-XC,55,20,6,5,9,34,21
20090913-M-US_Open-SF-Novak_Djokovic-Roger_Federer,2,F-DTM,28,1,1,0,0,19,9
20090913-M-US_Open-SF-Novak_Djokovic-Roger_Federer,2,F-DTL,11,0,0,0,0,8,3
20090913-M-US_Open-SF-Novak_Djokovic-Roger_Federer,2,F-IO,36,12,8,2,2,24,12
20090913-M-US_Open-SF-Novak_Djokovic-Roger_Federer,2,F-II,2,1,0,1,0,1,1
20090913-M-US_Open-SF-Novak_Djokovic-Roger_Federer,2,B-XC,21,3,1,1,1,10,11
20090913-M-US_Open-SF-Novak_Djokovic-Roger_Federer,2,B-DTM,30,5,0,2,3,13,17
20090913-M-US_Open-SF-Novak_Djokovic-Roger_Federer,2,B-DTL,5,2,1,1,0,4,1
20090913-M-US_Open-SF-Novak_Djokovic-Roger_Federer,2,B-IO,4,1,0,0,1,2,2
20090913-M-US_Open-SF-Novak_Djokovic-Roger_Federer,2,S-XC,24,1,0,1,0,18,6
20090913-M-US_Open-SF-Novak_Djokovic-Roger_Federer,2,S-DTM,12,0,0,0,0,5,7
20090913-M-US_Open-SF-Novak_Djokovic-Roger_Federer,2,S-DTL,1,0,0,0,0,1,0
19740714-M-Bastad-F-Bjorn_Borg-Adriano_Panatta,1,F-XC,40,7,4,2,1,27,13
19740714-M-Bastad-F-Bjorn_Borg-Adriano_Panatta,1,F-DTM,40,0,0,0,0,26,14
19740714-M-Bastad-F-Bjorn_Borg-Adriano_Panatta,1,F-DTL,13,8,2,3,3,7,6
19740714-M-Bastad-F-Bjorn_Borg-Adriano_Panatta,1,F-IO,26,7,1,3,3,14,12
19740714-M-Bastad-F-Bjorn_Borg-Adriano_Panatta,1,F-II,5,1,0,1,0,3,2
19740714-M-Bastad-F-Bjorn_Borg-Adriano_Panatta,1,B-XC,60,12,7,3,2,42,18
19740714-M-Bastad-F-Bjorn_Borg-Adriano_Panatta,1,B-DTM,46,3,0,3,0,26,20
19740714-M-Bastad-F-Bjorn_Borg-Adriano_Panatta,1,B-DTL,23,14,5,3,6,13,10
19740714-M-Bastad-F-Bjorn_Borg-Adriano_Panatta,1,B-IO,9,1,0,1,0,7,2
19740714-M-Bastad-F-Bjorn_Borg-Adriano_Panatta,1,S-XC,11,2,1,1,0,9,2
19740714-M-Bastad-F-Bjorn_Borg-Adriano_Panatta,1,S-DTM,5,0,0,0,0,2,3
19740714-M-Bastad-F-Bjorn_Borg-Adriano_Panatta,1,S-DTL,6,0,0,0,0,6,0
19740714-M-Bastad-F-Bjorn_Borg-Adriano_Panatta,2,F-XC,44,22,8,4,10,20,24
19740714-M-Bastad-F-Bjorn_Borg-Adriano_Panatta,2,F-DTM,43,3,0,0,3,5,38
19740714-M-Bastad-F-Bjorn_Borg-Adriano_Panatta,2,F-DTL,15,2,0,1,1,6,9
19740714-M-Bastad-F-Bjorn_Borg-Adriano_Panatta,2,F-IO,14,2,0,2,0,8,6
19740714-M-Bastad-F-Bjorn_Borg-Adriano_Panatta,2,B-XC,18,5,2,2,1,8,10
19740714-M-Bastad-F-Bjorn_Borg-Adriano_Panatta,2,B-DTM,12,3,1,1,1,5,7
19740714-M-Bastad-F-Bjorn_Borg-Adriano_Panatta,2,B-DTL,4,3,0,2,1,2,2
19740714-M-Bastad-F-Bjorn_Borg-Adriano_Panatta,2,B-IO,2,2,1,0,1,1,1
19740714-M-Bastad-F-Bjorn_Borg-Adriano_Panatta,2,S-XC,70,9,0,3,6,23,47
19740714-M-Bastad-F-Bjorn_Borg-Adriano_Panatta,2,S-DTM,29,2,0,1,1,13,16
19740714-M-Bastad-F-Bjorn_Borg-Adriano_Panatta,2,S-DTL,7,1,0,1,0,4,3
19740714-M-Bastad-F-Bjorn_Borg-Adriano_Panatta,2,S-IO,8,2,0,2,0,6,2
20040509-M-Rome_Masters-F-Carlos_Moya-David_Nalbandian,1,F-XC,32,7,4,1,2,17,15
20040509-M-Rome_Masters-F-Carlos_Moya-David_Nalbandian,1,F-DTM,9,1,0,0,1,6,3
20040509-M-Rome_Masters-F-Carlos_Moya-David_Nalbandian,1,F-DTL,21,7,5,1,1,15,6
20040509-M-Rome_Masters-F-Carlos_Moya-David_Nalbandian,1,F-IO,27,9,5,2,2,17,10
20040509-M-Rome_Masters-F-Carlos_Moya-David_Nalbandian,1,F-II,22,7,1,3,3,14,8
20040509-M-Rome_Masters-F-Carlos_Moya-David_Nalbandian,1,B-XC,11,3,0,0,3,5,6
20040509-M-Rome_Masters-F-Carlos_Moya-David_Nalbandian,1,B-DTM,13,3,0,0,3,6,7
20040509-M-Rome_Masters-F-Carlos_Moya-David_Nalbandian,1,B-DTL,22,8,0,3,5,11,11
20040509-M-Rome_Masters-F-Carlos_Moya-David_Nalbandian,1,S-XC,16,1,0,0,1,8,8
20040509-M-Rome_Masters-F-Carlos_Moya-David_Nalbandian,1,S-DTM,8,0,0,0,0,5,3
20040509-M-Rome_Masters-F-Carlos_Moya-David_Nalbandian,1,S-DTL,10,0,0,0,0,3,7
20040509-M-Rome_Masters-F-Carlos_Moya-David_Nalbandian,2,F-XC,59,18,6,5,7,31,28
20040509-M-Rome_Masters-F-Carlos_Moya-David_Nalbandian,2,F-DTM,7,1,0,0,1,4,3
20040509-M-Rome_Masters-F-Carlos_Moya-David_Nalbandian,2,F-DTL,28,4,2,0,2,15,13
20040509-M-Rome_Masters-F-Carlos_Moya-David_Nalbandian,2,F-IO,25,4,0,2,2,8,17
20040509-M-Rome_Masters-F-Carlos_Moya-David_Nalbandian,2,F-II,3,3,0,0,3,0,3
20040509-M-Rome_Masters-F-Carlos_Moya-David_Nalbandian,2,B-XC,50,5,0,2,3,26,24
20040509-M-Rome_Masters-F-Carlos_Moya-David_Nalbandian,2,B-DTL,9,3,0,0,3,1,8
20040509-M-Rome_Masters-F-Carlos_Moya-David_Nalbandian,2,B-IO,1,0,0,0,0,1,0
20040509-M-Rome_Masters-F-Carlos_Moya-David_Nalbandian,2,S-XC,8,0,0,0,0,2,6
20040509-M-Rome_Masters-F-Carlos_Moya-David_Nalbandian,2,S-DTM,5,0,0,0,0,0,5
20040509-M-Rome_Masters-F-Carlos_Moya-David_Nalbandian,2,S-DTL,2,1,0,1,0,1,1
20110127-M-Australian_Open-SF-Novak_Djokovic-Roger_Federer,1,F-XC,97,27,9,14,4,58,39
20110127-M-Australian_Open-SF-Novak_Djokovic-Roger_Federer,1,F-DTM,45,0,0,0,0,30,15
20110127-M-Australian_Open-SF-Novak_Djokovic-Roger_Federer,1,F-DTL,34,3,2,0,1,20,14
20110127-M-Australian_Open-SF-Novak_Djokovic-Roger_Federer,1,F-IO,70,8,3,2,3,41,29
20110127-M-Australian_Open-SF-Novak_Djokovic-Roger_Federer,1,F-II,3,1,0,1,0,2,1
20110127-M-Australian_Open-SF-Novak_Djokovic-Roger_Federer,1,B-XC,132,10,2,4,4,83,49
20110127-M-Australian_Open-SF-Novak_Djokovic-Roger_Federer,1,B-DTM,53,1,0,0,1,25,28
20110127-M-Australian_Open-SF-Novak_Djokovic-Roger_Federer,1,B-DTL,21,7,1,2,4,8,13
20110127-M-Australian_Open-SF-Novak_Djokovic-Roger_Federer,1,B-IO,10,5,2,1,2,6,4
20110127-M-Australian_Open-SF-Novak_Djokovic-Roger_Federer,1,S-XC,4,0,0,0,0,1,3
20110127-M-Australian_Open-SF-Novak_Djokovic-Roger_Federer,1,S-DTM,1,0,0,0,0,0,1
20110127-M-Australian_Open-SF-Novak_Djokovic-Roger_Federer,1,S-DTL,1,0,0,0,0,0,1
20110127-M-Australian_Open-SF-Novak_Djokovic-Roger_Federer,2,F-XC,76,23,6,9,8,40,36
20110127-M-Australian_Open-SF-Novak_Djokovic-Roger_Federer,2,F-DTM,36,0,0,0,0,14,22
20110127-M-Australian_Open-SF-Novak_Djokovic-Roger_Federer,2,F-DTL,31,7,4,2,1,15,16
20110127-M-Australian_Open-SF-Novak_Djokovic-Roger_Federer,2,F-IO,44,9,2,3,4,14,30
20110127-M-Australian_Open-SF-Novak_Djokovic-Roger_Federer,2,F-II,9,2,0,0,2,3,6
20110127-M-Australian_Open-SF-Novak_Djokovic-Roger_Federer,2,B-XC,81,11,0,2,9,35,46
20110127-M-Australian_Open-SF-Novak_Djokovic-Roger_Federer,2,B-DTM,74,6,0,1,5,31,43
20110127-M-Australian_Open-SF-Novak_Djokovic-Roger_Federer,2,B-DTL,40,13,4,3,6,15,25
20110127-M-Australian_Open-SF-Novak_Djokovic-Roger_Federer,2,B-IO,4,2,1,1,0,3,1
20110127-M-Australian_Open-SF-Novak_Djokovic-Roger_Federer,2,S-XC,42,2,0,0,2,20,22
20110127-M-Australian_Open-SF-Novak_Djokovic-Roger_Federer,2,S-DTM,17,2,0,0,2,5,12
20110127-M-Australian_Open-SF-Novak_Djokovic-Roger_Federer,2,S-DTL,2,0,0,0,0,1,1
20070125-M-Australian_Open-SF-Andy_Roddick-Roger_Federer,1,F-XC,47,7,0,3,4,15,32
20070125-M-Australian_Open-SF-Andy_Roddick-Roger_Federer,1,F-DTM,17,0,0,0,0,5,12
20070125-M-Australian_Open-SF-Andy_Roddick-Roger_Federer,1,F-DTL,5,1,0,0,1,0,5
20070125-M-Australian_Open-SF-Andy_Roddick-Roger_Federer,1,F-IO,31,11,2,5,4,14,17
20070125-M-Australian_Open-SF-Andy_Roddick-Roger_Federer,1,F-II,4,0,0,0,0,1,3
20070125-M-Australian_Open-SF-Andy_Roddick-Roger_Federer,1,B-XC,23,4,0,0,4,9,14
20070125-M-Australian_Open-SF-Andy_Roddick-Roger_Federer,1,B-DTM,21,3,0,0,3,3,18
20070125-M-Australian_Open-SF-Andy_Roddick-Roger_Federer,1,B-DTL,1,0,0,0,0,0,1
20070125-M-Australian_Open-SF-Andy_Roddick-Roger_Federer,1,S-XC,4,1,0,0,1,1,3
20070125-M-Australian_Open-SF-Andy_Roddick-Roger_Federer,1,S-DTM,2,0,0,0,0,0,2
20070125-M-Australian_Open-SF-Andy_Roddick-Roger_Federer,1,S-DTL,1,0,0,0,0,0,1
20070125-M-Australian_Open-SF-Andy_Roddick-Roger_Federer,2,F-XC,39,14,6,6,2,32,7
20070125-M-Australian_Open-SF-Andy_Roddick-Roger_Federer,2,F-DTM,22,2,0,1,1,13,9
20070125-M-Australian_Open-SF-Andy_Roddick-Roger_Federer,2,F-DTL,11,5,3,0,2,7,4
20070125-M-Australian_Open-SF-Andy_Roddick-Roger_Federer,2,F-IO,16,7,3,1,3,11,5
20070125-M-Australian_Open-SF-Andy_Roddick-Roger_Federer,2,F-II,2,0,0,0,0,1,1
20070125-M-Australian_Open-SF-Andy_Roddick-Roger_Federer,2,B-XC,30,8,7,0,1,19,11
20070125-M-Australian_Open-SF-Andy_Roddick-Roger_Federer,2,B-DTM,12,1,0,1,0,10,2
20070125-M-Australian_Open-SF-Andy_Roddick-Roger_Federer,2,B-DTL,11,5,4,0,1,6,5
20070125-M-Australian_Open-SF-Andy_Roddick-Roger_Federer,2,B-IO,4,2,0,0,2,1,3
20070125-M-Australian_Open-SF-Andy_Roddick-Roger_Federer,2,S-XC,10,0,0,0,0,7,3
20070125-M-Australian_Open-SF-Andy_Roddick-Roger_Federer,2,S-DTM,7,0,0,0,0,7,0
20070125-M-Australian_Open-SF-Andy_Roddick-Roger_Federer,2,S-DTL,4,1,1,0,0,4,0
20070301-M-Dubai-QF-Roger_Federer-Novak_Djokovic,1,F-XC,41,19,4,7,8,28,13
20070301-M-Dubai-QF-Roger_Federer-Novak_Djokovic,1,F-DTM,29,2,1,0,1,13,16
20070301-M-Dubai-QF-Roger_Federer-Novak_Djokovic,1,F-DTL,11,6,3,1,2,5,6
20070301-M-Dubai-QF-Roger_Federer-Novak_Djokovic,1,F-IO,21,11,4,4,3,15,6
20070301-M-Dubai-QF-Roger_Federer-Novak_Djokovic,1,B-XC,26,3,0,2,1,11,15
20070301-M-Dubai-QF-Roger_Federer-Novak_Djokovic,1,B-DTM,43,3,1,0,2,19,24
20070301-M-Dubai-QF-Roger_Federer-Novak_Djokovic,1,B-DTL,10,7,0,2,5,3,7
20070301-M-Dubai-QF-Roger_Federer-Novak_Djokovic,1,B-IO,6,4,0,1,3,1,5
20070301-M-Dubai-QF-Roger_Federer-Novak_Djokovic,1,S-XC,18,0,0,0,0,5,13
20070301-M-Dubai-QF-Roger_Federer-Novak_Djokovic,1,S-DTM,9,1,0,0,1,4,5
20070301-M-Dubai-QF-Roger_Federer-Novak_Djokovic,1,S-DTL,2,0,0,0,0,1,1
20070301-M-Dubai-QF-Roger_Federer-Novak_Djokovic,2,F-XC,30,9,2,4,3,16,14
20070301-M-Dubai-QF-Roger_Federer-Novak_Djokovic,2,F-DTM,26,3,0,0,3,10,16
20070301-M-Dubai-QF-Roger_Federer-Novak_Djokovic,2,F-DTL,7,5,1,0,4,2,5
20070301-M-Dubai-QF-Roger_Federer-Novak_Djokovic,2,F-IO,24,8,1,1,6,13,11
20070301-M-Dubai-QF-Roger_Federer-Novak_Djokovic,2,F-II,1,0,0,0,0,0,1
20070301-M-Dubai-QF-Roger_Federer-Novak_Djokovic,2,B-XC,46,8,1,6,1,32,14
20070301-M-Dubai-QF-Roger_Federer-Novak_Djokovic,2,B-DTM,40,2,0,0,2,20,20
20070301-M-Dubai-QF-Roger_Federer-Novak_Djokovic,2,B-DTL,11,6,2,3,1,7,4
20070301-M-Dubai-QF-Roger_Federer-Novak_Djokovic,2,B-IO,9,4,0,2,2,4,5
20070301-M-Dubai-QF-Roger_Federer-Novak_Djokovic,2,S-XC,4,0,0,0,0,1,3
20070301-M-Dubai-QF-Roger_Federer-Novak_Djokovic,2,S-DTM,6,0,0,0,0,3,3
20070301-M-Dubai-QF-Roger_Federer-Novak_Djokovic,2,S-DTL,3,0,0,0,0,1,2
20070301-M-Dubai-QF-Roger_Federer-Novak_Djokovic,2,S-IO,1,1,0,0,1,0,1
20170418-M-Qingdao_CH-R32-Thomas_Fabbiano-Karim_Mohamed_Maamoun,1,F-XC,34,7,2,2,3,21,13
20170418-M-Qingdao_CH-R32-Thomas_Fabbiano-Karim_Mohamed_Maamoun,1,F-DTM,20,1,0,0,1,8,12
20170418-M-Qingdao_CH-R32-Thomas_Fabbiano-Karim_Mohamed_Maamoun,1,F-DTL,9,3,2,0,1,7,2
20170418-M-Qingdao_CH-R32-Thomas_Fabbiano-Karim_Mohamed_Maamoun,1,F-IO,41,8,3,2,3,27,14
20170418-M-Qingdao_CH-R32-Thomas_Fabbiano-Karim_Mohamed_Maamoun,1,F-II,4,2,1,1,0,4,0
20170418-M-Qingdao_CH-R32-Thomas_Fabbiano-Karim_Mohamed_Maamoun,1,B-XC,43,4,0,2,2,32,11
20170418-M-Qingdao_CH-R32-Thomas_Fabbiano-Karim_Mohamed_Maamoun,1,B-DTM,20,2,0,0,2,12,8
20170418-M-Qingdao_CH-R32-Thomas_Fabbiano-Karim_Mohamed_Maamoun,1,B-DTL,3,1,1,0,0,3,0
20170418-M-Qingdao_CH-R32-Thomas_Fabbiano-Karim_Mohamed_Maamoun,1,B-IO,2,0,0,0,0,2,0
20170418-M-Qingdao_CH-R32-Thomas_Fabbiano-Karim_Mohamed_Maamoun,1,S-XC,3,0,0,0,0,2,1
20170418-M-Qingdao_CH-R32-Thomas_Fabbiano-Karim_Mohamed_Maamoun,1,S-DTL,1,0,0,0,0,1,0
20170418-M-Qingdao_CH-R32-Thomas_Fabbiano-Karim_Mohamed_Maamoun,2,F-XC,25,8,2,2,4,14,11
20170418-M-Qingdao_CH-R32-Thomas_Fabbiano-Karim_Mohamed_Maamoun,2,F-DTM,30,3,1,0,2,9,21
20170418-M-Qingdao_CH-R32-Thomas_Fabbiano-Karim_Mohamed_Maamoun,2,F-DTL,4,1,0,0,1,0,4
20170418-M-Qingdao_CH-R32-Thomas_Fabbiano-Karim_Mohamed_Maamoun,2,F-IO,17,2,1,0,1,8,9
20170418-M-Qingdao_CH-R32-Thomas_Fabbiano-Karim_Mohamed_Maamoun,2,F-II,1,0,0,0,0,0,1
20170418-M-Qingdao_CH-R32-Thomas_Fabbiano-Karim_Mohamed_Maamoun,2,B-XC,54,10,2,0,8,13,41
20170418-M-Qingdao_CH-R32-Thomas_Fabbiano-Karim_Mohamed_Maamoun,2,B-DTM,38,1,0,0,1,18,20
20170418-M-Qingdao_CH-R32-Thomas_Fabbiano-Karim_Mohamed_Maamoun,2,B-DTL,5,1,0,0,1,1,4
20170418-M-Qingdao_CH-R32-Thomas_Fabbiano-Karim_Mohamed_Maamoun,2,S-XC,4,0,0,0,0,1,3
20170418-M-Qingdao_CH-R32-Thomas_Fabbiano-Karim_Mohamed_Maamoun,2,S-DTM,2,0,0,0,0,0,2
20170418-M-Qingdao_CH-R32-Thomas_Fabbiano-Karim_Mohamed_Maamoun,2,S-DTL,1,0,0,0,0,0,1
20110911-M-US_Open-SF-Andy_Murray-Rafael_Nadal,1,F-XC,147,24,6,6,12,63,84
20110911-M-US_Open-SF-Andy_Murray-Rafael_Nadal,1,F-DTM,55,5,0,1,4,25,30
20110911-M-US_Open-SF-Andy_Murray-Rafael_Nadal,1,F-DTL,13,9,4,1,4,5,8
20110911-M-US_Open-SF-Andy_Murray-Rafael_Nadal,1,F-IO,35,14,3,5,6,19,16
20110911-M-US_Open-SF-Andy_Murray-Rafael_Nadal,1,F-II,4,1,0,0,1,2,2
20110911-M-US_Open-SF-Andy_Murray-Rafael_Nadal,1,B-XC,52,14,4,5,5,23,29
20110911-M-US_Open-SF-Andy_Murray-Rafael_Nadal,1,B-DTM,64,5,0,1,4,24,40
20110911-M-US_Open-SF-Andy_Murray-Rafael_Nadal,1,B-DTL,22,8,1,3,4,10,12
20110911-M-US_Open-SF-Andy_Murray-Rafael_Nadal,1,B-IO,10,2,0,1,1,3,7
20110911-M-US_Open-SF-Andy_Murray-Rafael_Nadal,1,S-XC,2,0,0,0,0,0,2
20110911-M-US_Open-SF-Andy_Murray-Rafael_Nadal,1,S-DTM,8,0,0,0,0,2,6
20110911-M-US_Open-SF-Andy_Murray-Rafael_Nadal,1,S-DTL,7,2,0,0,2,2,5
20110911-M-US_Open-SF-Andy_Murray-Rafael_Nadal,1,S-IO,2,2,0,0,2,0,2
20110911-M-US_Open-SF-Andy_Murray-Rafael_Nadal,2,F-XC,69,13,4,6,3,46,23
20110911-M-US_Open-SF-Andy_Murray-Rafael_Nadal,2,F-DTM,57,1,0,0,1,32,25
20110911-M-US_Open-SF-Andy_Murray-Rafael_Nadal,2,F-DTL,16,9,5,4,0,12,4
20110911-M-US_Open-SF-Andy_Murray-Rafael_Nadal,2,F-IO,48,12,4,5,3,29,19
20110911-M-US_Open-SF-Andy_Murray-Rafael_Nadal,2,F-II,9,1,0,1,0,5,4
20110911-M-US_Open-SF-Andy_Murray-Rafael_Nadal,2,B-XC,39,6,1,1,4,24,15
20110911-M-US_Open-SF-Andy_Murray-Rafael_Nadal,2,B-DTM,84,6,0,0,6,52,32
20110911-M-US_Open-SF-Andy_Murray-Rafael_Nadal,2,B-DTL,19,4,1,2,1,13,6
20110911-M-US_Open-SF-Andy_Murray-Rafael_Nadal,2,B-IO,7,1,0,0,1,3,4
20110911-M-US_Open-SF-Andy_Murray-Rafael_Nadal,2,S-XC,7,0,0,0,0,2,5
20110911-M-US_Open-SF-Andy_Murray-Rafael_Nadal,2,S-DTM,42,1,0,0,1,20,22
20110911-M-US_Open-SF-Andy_Murray-Rafael_Nadal,2,S-DTL,12,0,0,0,0,6,6
20110911-M-US_Open-SF-Andy_Murray-Rafael_Nadal,2,S-IO,9,0,0,0,0,6,3
20140413-M-Monte_Carlo_Masters-SF-Novak_Djokovic-Roger_Federer,1,F-XC,31,9,4,3,2,17,14
20140413-M-Monte_Carlo_Masters-SF-Novak_Djokovic-Roger_Federer,1,F-DTM,14,2,0,0,2,2,12
20140413-M-Monte_Carlo_Masters-SF-Novak_Djokovic-Roger_Federer,1,F-DTL,14,4,0,0,4,6,8
20140413-M-Monte_Carlo_Masters-SF-Novak_Djokovic-Roger_Federer,1,F-IO,19,3,2,0,1,12,7
20140413-M-Monte_Carlo_Masters-SF-Novak_Djokovic-Roger_Federer,1,F-II,1,0,0,0,0,1,0
20140413-M-Monte_Carlo_Masters-SF-Novak_Djokovic-Roger_Federer,1,B-XC,33,5,0,0,5,14,19
20140413-M-Monte_Carlo_Masters-SF-Novak_Djokovic-Roger_Federer,1,B-DTM,40,4,0,0,4,15,25
20140413-M-Monte_Carlo_Masters-SF-Novak_Djokovic-Roger_Federer,1,B-DTL,9,3,1,0,2,4,5
20140413-M-Monte_Carlo_Masters-SF-Novak_Djokovic-Roger_Federer,1,B-IO,6,1,0,0,1,3,3
20140413-M-Monte_Carlo_Masters-SF-Novak_Djokovic-Roger_Federer,1,S-DTM,2,1,0,0,1,0,2
20140413-M-Monte_Carlo_Masters-SF-Novak_Djokovic-Roger_Federer,1,S-DTL,3,0,0,0,0,0,3
20140413-M-Monte_Carlo_Masters-SF-Novak_Djokovic-Roger_Federer,2,F-XC,34,7,2,2,3,20,14
20140413-M-Monte_Carlo_Masters-SF-Novak_Djokovic-Roger_Federer,2,F-DTM,15,4,0,0,4,7,8
20140413-M-Monte_Carlo_Masters-SF-Novak_Djokovic-Roger_Federer,2,F-DTL,7,2,0,0,2,4,3
20140413-M-Monte_Carlo_Masters-SF-Novak_Djokovic-Roger_Federer,2,F-IO,31,7,3,2,2,26,5
20140413-M-Monte_Carlo_Masters-SF-Novak_Djokovic-Roger_Federer,2,F-II,3,0,0,0,0,3,0
20140413-M-Monte_Carlo_Masters-SF-Novak_Djokovic-Roger_Federer,2,B-XC,21,3,1,1,1,10,11
20140413-M-Monte_Carlo_Masters-SF-Novak_Djokovic-Roger_Federer,2,B-DTM,31,2,0,0,2,14,17
20140413-M-Monte_Carlo_Masters-SF-Novak_Djokovic-Roger_Federer,2,B-DTL,5,2,0,1,1,4,1
20140413-M-Monte_Carlo_Masters-SF-Novak_Djokovic-Roger_Federer,2,B-IO,5,1,1,0,0,4,1
20140413-M-Monte_Carlo_Masters-SF-Novak_Djokovic-Roger_Federer,2,S-XC,6,0,0,0,0,3,3
20140413-M-Monte_Carlo_Masters-SF-Novak_Djokovic-Roger_Federer,2,S-DTM,5,0,0,0,0,1,4
20140413-M-Monte_Carlo_Masters-SF-Novak_Djokovic-Roger_Federer,2,S-DTL,2,0,0,0,0,0,2
20170423-M-Monte_Carlo_Masters-F-Rafael_Nadal-Albert_Ramos,1,F-XC,31,3,1,2,0,16,15
20170423-M-Monte_Carlo_Masters-F-Rafael_Nadal-Albert_Ramos,1,F-DTM,26,1,0,0,1,9,17
20170423-M-Monte_Carlo_Masters-F-Rafael_Nadal-Albert_Ramos,1,F-DTL,17,7,2,2,3,11,6
20170423-M-Monte_Carlo_Masters-F-Rafael_Nadal-Albert_Ramos,1,F-IO,30,9,3,4,2,16,14
20170423-M-Monte_Carlo_Masters-F-Rafael_Nadal-Albert_Ramos,1,F-II,3,2,0,0,2,0,3
20170423-M-Monte_Carlo_Masters-F-Rafael_Nadal-Albert_Ramos,1,B-XC,41,1,0,0,1,17,24
20170423-M-Monte_Carlo_Masters-F-Rafael_Nadal-Albert_Ramos,1,B-DTM,22,3,0,0,3,8,14
20170423-M-Monte_Carlo_Masters-F-Rafael_Nadal-Albert_Ramos,1,B-DTL,9,5,2,1,2,6,3
20170423-M-Monte_Carlo_Masters-F-Rafael_Nadal-Albert_Ramos,1,B-IO,3,2,0,1,1,1,2
20170423-M-Monte_Carlo_Masters-F-Rafael_Nadal-Albert_Ramos,1,S-XC,3,0,0,0,0,1,2
20170423-M-Monte_Carlo_Masters-F-Rafael_Nadal-Albert_Ramos,1,S-DTM,3,0,0,0,0,1,2
20170423-M-Monte_Carlo_Masters-F-Rafael_Nadal-Albert_Ramos,2,F-XC,43,5,2,0,3,25,18
20170423-M-Monte_Carlo_Masters-F-Rafael_Nadal-Albert_Ramos,2,F-DTM,25,3,1,0,2,13,12
20170423-M-Monte_Carlo_Masters-F-Rafael_Nadal-Albert_Ramos,2,F-DTL,6,1,0,0,1,2,4
20170423-M-Monte_Carlo_Masters-F-Rafael_Nadal-Albert_Ramos,2,F-IO,24,7,2,1,4,17,7
20170423-M-Monte_Carlo_Masters-F-Rafael_Nadal-Albert_Ramos,2,F-II,3,0,0,0,0,1,2
20170423-M-Monte_Carlo_Masters-F-Rafael_Nadal-Albert_Ramos,2,B-XC,53,6,0,2,4,30,23
20170423-M-Monte_Carlo_Masters-F-Rafael_Nadal-Albert_Ramos,2,B-DTM,30,2,0,0,2,15,15
20170423-M-Monte_Carlo_Masters-F-Rafael_Nadal-Albert_Ramos,2,B-DTL,5,3,2,0,1,2,3
20170423-M-Monte_Carlo_Masters-F-Rafael_Nadal-Albert_Ramos,2,B-IO,2,1,0,1,0,2,0
20170423-M-Monte_Carlo_Masters-F-Rafael_Nadal-Albert_Ramos,2,S-XC,2,1,0,0,1,0,2
20170423-M-Monte_Carlo_Masters-F-Rafael_Nadal-Albert_Ramos,2,S-DTM,4,0,0,0,0,1,3
20170401-M-Miami_Masters-SF-Roger_Federer-Nick_Kyrgios,1,F-XC,46,19,5,6,8,30,16
20170401-M-Miami_Masters-SF-Roger_Federer-Nick_Kyrgios,1,F-DTM,32,3,0,2,1,20,12
20170401-M-Miami_Masters-SF-Roger_Federer-Nick_Kyrgios,1,F-DTL,8,4,1,1,2,5,3
20170401-M-Miami_Masters-SF-Roger_Federer-Nick_Kyrgios,1,F-IO,43,20,11,4,5,32,11
20170401-M-Miami_Masters-SF-Roger_Federer-Nick_Kyrgios,1,F-II,10,3,1,1,1,6,4
20170401-M-Miami_Masters-SF-Roger_Federer-Nick_Kyrgios,1,B-XC,31,11,2,4,5,18,13
20170401-M-Miami_Masters-SF-Roger_Federer-Nick_Kyrgios,1,B-DTM,30,5,0,1,4,12,18
20170401-M-Miami_Masters-SF-Roger_Federer-Nick_Kyrgios,1,B-DTL,15,8,4,1,3,8,7
20170401-M-Miami_Masters-SF-Roger_Federer-Nick_Kyrgios,1,B-IO,6,3,2,0,1,5,1
20170401-M-Miami_Masters-SF-Roger_Federer-Nick_Kyrgios,1,S-XC,17,1,0,1,0,11,6
20170401-M-Miami_Masters-SF-Roger_Federer-Nick_Kyrgios,1,S-DTM,11,0,0,0,0,6,5
20170401-M-Miami_Masters-SF-Roger_Federer-Nick_Kyrgios,1,S-DTL,2,0,0,0,0,1,1
20170401-M-Miami_Masters-SF-Roger_Federer-Nick_Kyrgios,1,S-IO,1,0,0,0,0,0,1
20170401-M-Miami_Masters-SF-Roger_Federer-Nick_Kyrgios,2,F-XC,41,17,7,7,3,28,13
20170401-M-Miami_Masters-SF-Roger_Federer-Nick_Kyrgios,2,F-DTM,38,4,0,0,4,11,27
20170401-M-Miami_Masters-SF-Roger_Federer-Nick_Kyrgios,2,F-DTL,11,4,2,1,1,7,4
20170401-M-Miami_Masters-SF-Roger_Federer-Nick_Kyrgios,2,F-IO,29,7,3,1,3,15,14
20170401-M-Miami_Masters-SF-Roger_Federer-Nick_Kyrgios,2,F-II,4,3,1,0,2,1,3
20170401-M-Miami_Masters-SF-Roger_Federer-Nick_Kyrgios,2,B-XC,63,8,0,5,3,30,33
20170401-M-Miami_Masters-SF-Roger_Federer-Nick_Kyrgios,2,B-DTM,30,3,0,0,3,9,21
20170401-M-Miami_Masters-SF-Roger_Federer-Nick_Kyrgios,2,B-DTL,10,3,1,0,2,4,6
20170401-M-Miami_Masters-SF-Roger_Federer-Nick_Kyrgios,2,B-IO,4,3,0,1,2,1,3
20170401-M-Miami_Masters-SF-Roger_Federer-Nick_Kyrgios,2,S-XC,3,0,0,0,0,3,0
20170401-M-Miami_Masters-SF-Roger_Federer-Nick_Kyrgios,2,S-DTM,8,1,0,1,0,2,6
20170401-M-Miami_Masters-SF-Roger_Federer-Nick_Kyrgios,2,S-DTL,2,0,0,0,0,0,2
19901028-M-Stockholm-F-Stefan_Edberg-Boris_Becker,1,F-XC,2,0,0,0,0,0,2
19901028-M-Stockholm-F-Stefan_Edberg-Boris_Becker,1,F-DTM,5,1,1,0,0,2,3
19901028-M-Stockholm-F-Stefan_Edberg-Boris_Becker,1,F-DTL,4,0,0,0,0,1,3
19901028-M-Stockholm-F-Stefan_Edberg-Boris_Becker,1,F-IO,4,1,0,0,1,0,4
19901028-M-Stockholm-F-Stefan_Edberg-Boris_Becker,1,B-XC,11,1,0,0,1,1,10
19901028-M-Stockholm-F-Stefan_Edberg-Boris_Becker,1,B-DTM,8,2,0,1,1,3,5
19901028-M-Stockholm-F-Stefan_Edberg-Boris_Becker,1,B-DTL,3,1,0,0,1,0,3
19901028-M-Stockholm-F-Stefan_Edberg-Boris_Becker,1,B-IO,2,1,0,0,1,0,2
19901028-M-Stockholm-F-Stefan_Edberg-Boris_Becker,1,S-XC,2,0,0,0,0,0,2
19901028-M-Stockholm-F-Stefan_Edberg-Boris_Becker,1,S-DTM,2,0,0,0,0,0,2
19901028-M-Stockholm-F-Stefan_Edberg-Boris_Becker,2,F-XC,6,3,3,0,0,5,1
19901028-M-Stockholm-F-Stefan_Edberg-Boris_Becker,2,F-DTM,8,0,0,0,0,6,2
19901028-M-Stockholm-F-Stefan_Edberg-Boris_Becker,2,F-DTL,3,2,0,2,0,3,0
19901028-M-Stockholm-F-Stefan_Edberg-Boris_Becker,2,F-IO,6,2,1,1,0,5,1
19901028-M-Stockholm-F-Stefan_Edberg-Boris_Becker,2,B-XC,14,5,0,3,2,11,3
19901028-M-Stockholm-F-Stefan_Edberg-Boris_Becker,2,B-DTM,9,2,0,2,0,7,2
19901028-M-Stockholm-F-Stefan_Edberg-Boris_Becker,2,B-DTL,6,5,2,0,3,3,3
19901028-M-Stockholm-F-Stefan_Edberg-Boris_Becker,2,B-IO,5,3,2,0,1,3,2
19901028-M-Stockholm-F-Stefan_Edberg-Boris_Becker,2,S-XC,1,1,1,0,0,1,0
19901028-M-Stockholm-F-Stefan_Edberg-Boris_Becker,2,S-DTM,1,0,0,0,0,1,0
19901028-M-Stockholm-F-Stefan_Edberg-Boris_Becker,2,S-DTL,2,1,1,0,0,1,1
19890905-M-US_Open-R16-Jimmy_Connors-Stefan_Edberg,1,F-XC,40,7,3,1,3,20,20
19890905-M-US_Open-R16-Jimmy_Connors-Stefan_Edberg,1,F-DTM,23,2,0,0,2,10,13
19890905-M-US_Open-R16-Jimmy_Connors-Stefan_Edberg,1,F-DTL,11,2,0,0,2,5,6
19890905-M-US_Open-R16-Jimmy_Connors-Stefan_Edberg,1,F-IO,16,4,1,1,2,6,10
19890905-M-US_Open-R16-Jimmy_Connors-Stefan_Edberg,1,B-XC,32,5,0,1,4,15,17
19890905-M-US_Open-R16-Jimmy_Connors-Stefan_Edberg,1,B-DTM,32,1,0,1,0,24,8
19890905-M-US_Open-R16-Jimmy_Connors-Stefan_Edberg,1,B-DTL,7,3,0,1,2,3,4
19890905-M-US_Open-R16-Jimmy_Connors-Stefan_Edberg,1,B-IO,9,0,0,0,0,7,2
19890905-M-US_Open-R16-Jimmy_Connors-Stefan_Edberg,1,S-XC,2,0,0,0,0,1,1
19890905-M-US_Open-R16-Jimmy_Connors-Stefan_Edberg,1,S-DTM,3,0,0,0,0,2,1
19890905-M-US_Open-R16-Jimmy_Connors-Stefan_Edberg,1,S-DTL,1,1,0,1,0,1,0
19890905-M-US_Open-R16-Jimmy_Connors-Stefan_Edberg,1,S-IO,2,0,0,0,0,2,0
19890905-M-US_Open-R16-Jimmy_Connors-Stefan_Edberg,2,F-XC,43,8,3,1,4,22,21
19890905-M-US_Open-R16-Jimmy_Connors-Stefan_Edberg,2,F-DTM,35,1,0,0,1,14,21
19890905-M-US_Open-R16-Jimmy_Connors-Stefan_Edberg,2,F-DTL,12,5,3,0,2,7,5
19890905-M-US_Open-R16-Jimmy_Connors-Stefan_Edberg,2,F-IO,8,3,1,1,1,3,5
19890905-M-US_Open-R16-Jimmy_Connors-Stefan_Edberg,2,B-XC,17,5,1,0,4,9,8
19890905-M-US_Open-R16-Jimmy_Connors-Stefan_Edberg,2,B-DTM,12,5,0,1,4,4,8
19890905-M-US_Open-R16-Jimmy_Connors-Stefan_Edberg,2,B-DTL,3,1,0,0,1,1,2
19890905-M-US_Open-R16-Jimmy_Connors-Stefan_Edberg,2,B-IO,2,1,0,0,1,0,2
19890905-M-US_Open-R16-Jimmy_Connors-Stefan_Edberg,2,S-XC,16,3,0,0,3,6,10
19890905-M-US_Open-R16-Jimmy_Connors-Stefan_Edberg,2,S-DTM,17,2,0,0,2,7,10
19890905-M-US_Open-R16-Jimmy_Connors-Stefan_Edberg,2,S-DTL,2,0,0,0,0,1,1
19890905-M-US_Open-R16-Jimmy_Connors-Stefan_Edberg,2,S-IO,3,1,0,0,1,0,3
20170227-M-Dubai-F-Andy_Murray-Fernando_Verdasco,1,F-XC,29,7,3,2,2,24,5
20170227-M-Dubai-F-Andy_Murray-Fernando_Verdasco,1,F-DTM,11,2,0,0,2,6,5
20170227-M-Dubai-F-Andy_Murray-Fernando_Verdasco,1,F-DTL,5,0,0,0,0,5,0
20170227-M-Dubai-F-Andy_Murray-Fernando_Verdasco,1,F-IO,19,3,1,1,1,15,4
20170227-M-Dubai-F-Andy_Murray-Fernando_Verdasco,1,B-XC,29,8,2,1,5,19,10
20170227-M-Dubai-F-Andy_Murray-Fernando_Verdasco,1,B-DTM,18,3,0,0,3,8,10
20170227-M-Dubai-F-Andy_Murray-Fernando_Verdasco,1,B-DTL,6,1,1,0,0,4,2
20170227-M-Dubai-F-Andy_Murray-Fernando_Verdasco,1,B-IO,3,0,0,0,0,2,1
20170227-M-Dubai-F-Andy_Murray-Fernando_Verdasco,1,S-XC,2,1,0,0,1,1,1
20170227-M-Dubai-F-Andy_Murray-Fernando_Verdasco,1,S-DTM,6,0,0,0,0,3,3
20170227-M-Dubai-F-Andy_Murray-Fernando_Verdasco,1,S-DTL,2,0,0,0,0,0,2
20170227-M-Dubai-F-Andy_Murray-Fernando_Verdasco,2,F-XC,41,10,0,1,9,13,28
20170227-M-Dubai-F-Andy_Murray-Fernando_Verdasco,2,F-DTM,25,6,0,0,6,4,21
20170227-M-Dubai-F-Andy_Murray-Fernando_Verdasco,2,F-DTL,6,3,0,2,1,3,3
20170227-M-Dubai-F-Andy_Murray-Fernando_Verdasco,2,F-IO,13,4,2,0,2,6,7
20170227-M-Dubai-F-Andy_Murray-Fernando_Verdasco,2,F-II,3,0,0,0,0,2,1
20170227-M-Dubai-F-Andy_Murray-Fernando_Verdasco,2,B-XC,17,4,1,0,3,4,13
20170227-M-Dubai-F-Andy_Murray-Fernando_Verdasco,2,B-DTM,16,2,0,0,2,4,12
20170227-M-Dubai-F-Andy_Murray-Fernando_Verdasco,2,B-DTL,3,0,0,0,0,1,2
20170227-M-Dubai-F-Andy_Murray-Fernando_Verdasco,2,B-IO,6,1,1,0,0,5,1
20170227-M-Dubai-F-Andy_Murray-Fernando_Verdasco,2,S-XC,3,1,0,0,1,0,3
20170227-M-Dubai-F-Andy_Murray-Fernando_Verdasco,2,S-DTM,3,1,0,0,1,0,3
20170227-M-Dubai-F-Andy_Murray-Fernando_Verdasco,2,S-DTL,3,0,0,0,0,0,3
19870905-M-US_Open-R32-John_Mcenroe-Slobodan_Zivojinovic,1,F-XC,23,6,0,5,1,16,7
19870905-M-US_Open-R32-John_Mcenroe-Slobodan_Zivojinovic,1,F-DTM,11,0,0,0,0,8,3
19870905-M-US_Open-R32-John_Mcenroe-Slobodan_Zivojinovic,1,F-DTL,10,4,1,1,2,4,6
19870905-M-US_Open-R32-John_Mcenroe-Slobodan_Zivojinovic,1,F-IO,3,2,0,0,2,0,3
19870905-M-US_Open-R32-John_Mcenroe-Slobodan_Zivojinovic,1,B-XC,9,7,5,2,0,8,1
19870905-M-US_Open-R32-John_Mcenroe-Slobodan_Zivojinovic,1,B-DTM,11,0,0,0,0,5,6
19870905-M-US_Open-R32-John_Mcenroe-Slobodan_Zivojinovic,1,B-DTL,3,3,1,0,2,1,2
19870905-M-US_Open-R32-John_Mcenroe-Slobodan_Zivojinovic,1,B-IO,4,2,1,0,1,1,3
19870905-M-US_Open-R32-John_Mcenroe-Slobodan_Zivojinovic,1,B-II,2,0,0,0,0,1,1
19870905-M-US_Open-R32-John_Mcenroe-Slobodan_Zivojinovic,1,S-XC,4,1,1,0,0,3,1
19870905-M-US_Open-R32-John_Mcenroe-Slobodan_Zivojinovic,1,S-DTM,7,3,0,2,1,4,3
19870905-M-US_Open-R32-John_Mcenroe-Slobodan_Zivojinovic,1,S-DTL,1,1,0,1,0,1,0
19870905-M-US_Open-R32-John_Mcenroe-Slobodan_Zivojinovic,1,S-IO,1,0,0,0,0,1,0
19870905-M-US_Open-R32-John_Mcenroe-Slobodan_Zivojinovic,2,F-XC,22,7,2,0,5,7,15
19870905-M-US_Open-R32-John_Mcenroe-Slobodan_Zivojinovic,2,F-DTM,11,2,0,1,1,5,6
19870905-M-US_Open-R32-John_Mcenroe-Slobodan_Zivojinovic,2,F-DTL,7,3,0,1,2,1,6
19870905-M-US_Open-R32-John_Mcenroe-Slobodan_Zivojinovic,2,F-IO,14,10,5,2,3,7,7
19870905-M-US_Open-R32-John_Mcenroe-Slobodan_Zivojinovic,2,B-XC,5,1,1,0,0,1,4
19870905-M-US_Open-R32-John_Mcenroe-Slobodan_Zivojinovic,2,B-DTM,3,0,0,0,0,1,2
19870905-M-US_Open-R32-John_Mcenroe-Slobodan_Zivojinovic,2,B-DTL,4,4,1,1,2,2,2
19870905-M-US_Open-R32-John_Mcenroe-Slobodan_Zivojinovic,2,B-IO,1,1,1,0,0,1,0
19870905-M-US_Open-R32-John_Mcenroe-Slobodan_Zivojinovic,2,S-XC,10,0,0,0,0,6,4
19870905-M-US_Open-R32-John_Mcenroe-Slobodan_Zivojinovic,2,S-DTM,6,0,0,0,0,0,6
19870905-M-US_Open-R32-John_Mcenroe-Slobodan_Zivojinovic,2,S-DTL,6,3,0,2,1,4,2
19870905-M-US_Open-R32-John_Mcenroe-Slobodan_Zivojinovic,2,S-IO,5,2,2,0,0,3,2
20170510-M-Karshi_CH-R16-Sergiy_Stakhovsky-Karim_Mohamed_Maamoun,1,F-XC,13,2,0,1,1,6,7
20170510-M-Karshi_CH-R16-Sergiy_Stakhovsky-Karim_Mohamed_Maamoun,1,F-DTM,16,2,0,0,2,9,7
20170510-M-Karshi_CH-R16-Sergiy_Stakhovsky-Karim_Mohamed_Maamoun,1,F-DTL,6,4,1,0,3,2,4
20170510-M-Karshi_CH-R16-Sergiy_Stakhovsky-Karim_Mohamed_Maamoun,1,F-IO,3,0,0,0,0,3,0
20170510-M-Karshi_CH-R16-Sergiy_Stakhovsky-Karim_Mohamed_Maamoun,1,B-XC,18,5,1,1,3,14,4
20170510-M-Karshi_CH-R16-Sergiy_Stakhovsky-Karim_Mohamed_Maamoun,1,B-DTM,12,2,1,0,1,8,4
20170510-M-Karshi_CH-R16-Sergiy_Stakhovsky-Karim_Mohamed_Maamoun,1,B-DTL,6,5,3,1,1,5,1
20170510-M-Karshi_CH-R16-Sergiy_Stakhovsky-Karim_Mohamed_Maamoun,1,B-IO,3,2,0,1,1,1,2
20170510-M-Karshi_CH-R16-Sergiy_Stakhovsky-Karim_Mohamed_Maamoun,1,S-XC,13,1,0,0,1,5,8
20170510-M-Karshi_CH-R16-Sergiy_Stakhovsky-Karim_Mohamed_Maamoun,1,S-DTM,12,1,0,0,1,6,6
20170510-M-Karshi_CH-R16-Sergiy_Stakhovsky-Karim_Mohamed_Maamoun,1,S-DTL,2,0,0,0,0,2,0
20170510-M-Karshi_CH-R16-Sergiy_Stakhovsky-Karim_Mohamed_Maamoun,1,S-IO,2,1,0,1,0,1,1
20170510-M-Karshi_CH-R16-Sergiy_Stakhovsky-Karim_Mohamed_Maamoun,2,F-XC,28,9,1,2,6,16,12
20170510-M-Karshi_CH-R16-Sergiy_Stakhovsky-Karim_Mohamed_Maamoun,2,F-DTM,21,2,0,0,2,10,11
20170510-M-Karshi_CH-R16-Sergiy_Stakhovsky-Karim_Mohamed_Maamoun,2,F-DTL,4,1,0,0,1,1,3
20170510-M-Karshi_CH-R16-Sergiy_Stakhovsky-Karim_Mohamed_Maamoun,2,F-IO,12,4,1,1,2,5,7
20170510-M-Karshi_CH-R16-Sergiy_Stakhovsky-Karim_Mohamed_Maamoun,2,F-II,1,1,1,0,0,1,0
20170510-M-Karshi_CH-R16-Sergiy_Stakhovsky-Karim_Mohamed_Maamoun,2,B-XC,24,5,3,1,1,11,13
20170510-M-Karshi_CH-R16-Sergiy_Stakhovsky-Karim_Mohamed_Maamoun,2,B-DTM,22,6,0,1,5,7,15
20170510-M-Karshi_CH-R16-Sergiy_Stakhovsky-Karim_Mohamed_Maamoun,2,B-DTL,2,0,0,0,0,1,1
20170510-M-Karshi_CH-R16-Sergiy_Stakhovsky-Karim_Mohamed_Maamoun,2,B-IO,1,1,0,0,1,0,1
20170510-M-Karshi_CH-R16-Sergiy_Stakhovsky-Karim_Mohamed_Maamoun,2,B-II,1,0,0,0,0,1,0
20170510-M-Karshi_CH-R16-Sergiy_Stakhovsky-Karim_Mohamed_Maamoun,2,S-XC,7,0,0,0,0,3,4
20170510-M-Karshi_CH-R16-Sergiy_Stakhovsky-Karim_Mohamed_Maamoun,2,S-DTM,7,1,0,0,1,1,6
20170510-M-Karshi_CH-R16-Sergiy_Stakhovsky-Karim_Mohamed_Maamoun,2,S-DTL,1,0,0,0,0,0,1
20170508-M-Karshi_CH-R32-Dzmitry_Zhyrmont-Karim_Mohamed_Maamoun,1,F-XC,46,13,3,1,9,22,24
20170508-M-Karshi_CH-R32-Dzmitry_Zhyrmont-Karim_Mohamed_Maamoun,1,F-DTM,46,3,0,0,3,22,24
20170508-M-Karshi_CH-R32-Dzmitry_Zhyrmont-Karim_Mohamed_Maamoun,1,F-DTL,6,3,0,2,1,3,3
20170508-M-Karshi_CH-R32-Dzmitry_Zhyrmont-Karim_Mohamed_Maamoun,1,F-IO,16,7,2,2,3,11,5
20170508-M-Karshi_CH-R32-Dzmitry_Zhyrmont-Karim_Mohamed_Maamoun,1,F-II,2,1,1,0,0,1,1
20170508-M-Karshi_CH-R32-Dzmitry_Zhyrmont-Karim_Mohamed_Maamoun,1,B-XC,33,10,0,0,10,8,25
20170508-M-Karshi_CH-R32-Dzmitry_Zhyrmont-Karim_Mohamed_Maamoun,1,B-DTM,45,8,0,0,8,20,25
20170508-M-Karshi_CH-R32-Dzmitry_Zhyrmont-Karim_Mohamed_Maamoun,1,B-DTL,7,3,0,1,2,3,4
20170508-M-Karshi_CH-R32-Dzmitry_Zhyrmont-Karim_Mohamed_Maamoun,1,B-IO,9,2,0,0,2,3,6
20170508-M-Karshi_CH-R32-Dzmitry_Zhyrmont-Karim_Mohamed_Maamoun,1,S-XC,6,1,0,0,1,2,4
20170508-M-Karshi_CH-R32-Dzmitry_Zhyrmont-Karim_Mohamed_Maamoun,1,S-DTM,13,1,0,0,1,5,8
20170508-M-Karshi_CH-R32-Dzmitry_Zhyrmont-Karim_Mohamed_Maamoun,1,S-DTL,3,0,0,0,0,2,1
20170508-M-Karshi_CH-R32-Dzmitry_Zhyrmont-Karim_Mohamed_Maamoun,1,S-IO,2,0,0,0,0,1,1
20170508-M-Karshi_CH-R32-Dzmitry_Zhyrmont-Karim_Mohamed_Maamoun,1,S-II,1,0,0,0,0,0,1
20170508-M-Karshi_CH-R32-Dzmitry_Zhyrmont-Karim_Mohamed_Maamoun,2,F-XC,58,17,6,3,8,32,26
20170508-M-Karshi_CH-R32-Dzmitry_Zhyrmont-Karim_Mohamed_Maamoun,2,F-DTM,41,3,0,0,3,22,19
20170508-M-Karshi_CH-R32-Dzmitry_Zhyrmont-Karim_Mohamed_Maamoun,2,F-DTL,3,1,0,1,0,3,0
20170508-M-Karshi_CH-R32-Dzmitry_Zhyrmont-Karim_Mohamed_Maamoun,2,F-IO,25,5,1,1,3,14,11
20170508-M-Karshi_CH-R32-Dzmitry_Zhyrmont-Karim_Mohamed_Maamoun,2,F-II,1,0,0,0,0,1,0
20170508-M-Karshi_CH-R32-Dzmitry_Zhyrmont-Karim_Mohamed_Maamoun,2,B-XC,23,4,0,0,4,15,8
20170508-M-Karshi_CH-R32-Dzmitry_Zhyrmont-Karim_Mohamed_Maamoun,2,B-DTM,49,7,0,1,6,21,28
20170508-M-Karshi_CH-R32-Dzmitry_Zhyrmont-Karim_Mohamed_Maamoun,2,B-DTL,2,1,1,0,0,2,0
20170508-M-Karshi_CH-R32-Dzmitry_Zhyrmont-Karim_Mohamed_Maamoun,2,B-IO,2,0,0,0,0,1,1
20170508-M-Karshi_CH-R32-Dzmitry_Zhyrmont-Karim_Mohamed_Maamoun,2,S-XC,11,1,0,0,1,4,7
20170508-M-Karshi_CH-R32-Dzmitry_Zhyrmont-Karim_Mohamed_Maamoun,2,S-DTM,9,0,0,0,0,5,4
20170516-M-Samarkand_CH-R32-Sanjar_Fayziev-Karim_Mohamed_Maamoun,1,F-XC,18,7,1,2,4,8,10
20170516-M-Samarkand_CH-R32-Sanjar_Fayziev-Karim_Mohamed_Maamoun,1,F-DTM,27,3,0,0,3,12,15
20170516-M-Samarkand_CH-R32-Sanjar_Fayziev-Karim_Mohamed_Maamoun,1,F-DTL,2,0,0,0,0,0,2
20170516-M-Samarkand_CH-R32-Sanjar_Fayziev-Karim_Mohamed_Maamoun,1,F-IO,24,6,3,1,2,11,13
20170516-M-Samarkand_CH-R32-Sanjar_Fayziev-Karim_Mohamed_Maamoun,1,F-II,3,2,0,0,2,0,3
20170516-M-Samarkand_CH-R32-Sanjar_Fayziev-Karim_Mohamed_Maamoun,1,B-XC,14,0,0,0,0,10,4
20170516-M-Samarkand_CH-R32-Sanjar_Fayziev-Karim_Mohamed_Maamoun,1,B-DTM,26,1,0,0,1,6,20
20170516-M-Samarkand_CH-R32-Sanjar_Fayziev-Karim_Mohamed_Maamoun,1,B-DTL,10,5,0,1,4,4,6
20170516-M-Samarkand_CH-R32-Sanjar_Fayziev-Karim_Mohamed_Maamoun,1,B-IO,3,1,0,1,0,3,0
20170516-M-Samarkand_CH-R32-Sanjar_Fayziev-Karim_Mohamed_Maamoun,1,B-II,1,0,0,0,0,0,1
20170516-M-Samarkand_CH-R32-Sanjar_Fayziev-Karim_Mohamed_Maamoun,1,S-XC,4,0,0,0,0,1,3
20170516-M-Samarkand_CH-R32-Sanjar_Fayziev-Karim_Mohamed_Maamoun,1,S-DTM,7,1,0,0,1,3,4
20170516-M-Samarkand_CH-R32-Sanjar_Fayziev-Karim_Mohamed_Maamoun,1,S-DTL,3,0,0,0,0,3,0
20170516-M-Samarkand_CH-R32-Sanjar_Fayziev-Karim_Mohamed_Maamoun,2,F-XC,41,19,8,3,8,24,17
20170516-M-Samarkand_CH-R32-Sanjar_Fayziev-Karim_Mohamed_Maamoun,2,F-DTM,18,4,0,1,3,11,7
20170516-M-Samarkand_CH-R32-Sanjar_Fayziev-Karim_Mohamed_Maamoun,2,F-DTL,4,2,1,0,1,3,1
20170516-M-Samarkand_CH-R32-Sanjar_Fayziev-Karim_Mohamed_Maamoun,2,F-IO,24,4,4,0,0,14,10
20170516-M-Samarkand_CH-R32-Sanjar_Fayziev-Karim_Mohamed_Maamoun,2,F-II,3,3,2,0,1,2,1
20170516-M-Samarkand_CH-R32-Sanjar_Fayziev-Karim_Mohamed_Maamoun,2,B-XC,32,5,1,1,3,17,15
20170516-M-Samarkand_CH-R32-Sanjar_Fayziev-Karim_Mohamed_Maamoun,2,B-DTM,22,0,0,0,0,11,11
20170516-M-Samarkand_CH-R32-Sanjar_Fayziev-Karim_Mohamed_Maamoun,2,B-DTL,1,0,0,0,0,0,1
20170516-M-Samarkand_CH-R32-Sanjar_Fayziev-Karim_Mohamed_Maamoun,2,B-IO,2,0,0,0,0,1,1
20170516-M-Samarkand_CH-R32-Sanjar_Fayziev-Karim_Mohamed_Maamoun,2,S-XC,3,0,0,0,0,3,0
20170516-M-Samarkand_CH-R32-Sanjar_Fayziev-Karim_Mohamed_Maamoun,2,S-DTM,4,0,0,0,0,2,2
20170514-M-Madrid_Masters-F-Rafael_Nadal-Dominic_Thiem,1,F-XC,90,7,1,4,2,57,33
20170514-M-Madrid_Masters-F-Rafael_Nadal-Dominic_Thiem,1,F-DTM,23,3,0,1,2,12,11
20170514-M-Madrid_Masters-F-Rafael_Nadal-Dominic_Thiem,1,F-DTL,7,3,2,1,0,4,3
20170514-M-Madrid_Masters-F-Rafael_Nadal-Dominic_Thiem,1,F-IO,15,9,4,2,3,11,4
20170514-M-Madrid_Masters-F-Rafael_Nadal-Dominic_Thiem,1,F-II,8,1,0,1,0,5,3
20170514-M-Madrid_Masters-F-Rafael_Nadal-Dominic_Thiem,1,B-XC,52,12,5,4,3,37,15
20170514-M-Madrid_Masters-F-Rafael_Nadal-Dominic_Thiem,1,B-DTM,26,1,0,1,0,14,12
20170514-M-Madrid_Masters-F-Rafael_Nadal-Dominic_Thiem,1,B-DTL,11,2,1,0,1,7,4
20170514-M-Madrid_Masters-F-Rafael_Nadal-Dominic_Thiem,1,B-IO,2,0,0,0,0,1,1
20170514-M-Madrid_Masters-F-Rafael_Nadal-Dominic_Thiem,1,S-DTM,3,0,0,0,0,0,3
20170514-M-Madrid_Masters-F-Rafael_Nadal-Dominic_Thiem,1,S-DTL,1,0,0,0,0,1,0
20170514-M-Madrid_Masters-F-Rafael_Nadal-Dominic_Thiem,2,F-XC,66,13,5,5,3,28,38
20170514-M-Madrid_Masters-F-Rafael_Nadal-Dominic_Thiem,2,F-DTM,25,6,0,0,6,11,14
20170514-M-Madrid_Masters-F-Rafael_Nadal-Dominic_Thiem,2,F-DTL,11,5,1,1,3,4,7
20170514-M-Madrid_Masters-F-Rafael_Nadal-Dominic_Thiem,2,F-IO,32,16,6,4,6,17,15
20170514-M-Madrid_Masters-F-Rafael_Nadal-Dominic_Thiem,2,F-II,10,4,1,1,2,6,4
20170514-M-Madrid_Masters-F-Rafael_Nadal-Dominic_Thiem,2,B-XC,31,5,1,3,1,14,17
20170514-M-Madrid_Masters-F-Rafael_Nadal-Dominic_Thiem,2,B-DTM,41,1,0,1,0,14,27
20170514-M-Madrid_Masters-F-Rafael_Nadal-Dominic_Thiem,2,B-DTL,14,6,1,2,3,5,9
20170514-M-Madrid_Masters-F-Rafael_Nadal-Dominic_Thiem,2,S-XC,7,1,0,0,1,2,5
20170514-M-Madrid_Masters-F-Rafael_Nadal-Dominic_Thiem,2,S-DTM,11,0,0,0,0,5,6
20170514-M-Madrid_Masters-F-Rafael_Nadal-Dominic_Thiem,2,S-DTL,4,0,0,0,0,1,3
20170514-M-Madrid_Masters-F-Rafael_Nadal-Dominic_Thiem,2,S-IO,2,1,0,0,1,0,2
20170521-M-Rome_Masters-F-Novak_Djokovic-Alexander_Zverev,1,F-XC,33,9,4,3,2,18,15
20170521-M-Rome_Masters-F-Novak_Djokovic-Alexander_Zverev,1,F-DTM,26,2,1,0,1,14,12
20170521-M-Rome_Masters-F-Novak_Djokovic-Alexander_Zverev,1,F-DTL,10,2,0,1,1,5,5
20170521-M-Rome_Masters-F-Novak_Djokovic-Alexander_Zverev,1,F-IO,22,6,2,1,3,12,10
20170521-M-Rome_Masters-F-Novak_Djokovic-Alexander_Zverev,1,B-XC,20,5,0,0,5,7,13
20170521-M-Rome_Masters-F-Novak_Djokovic-Alexander_Zverev,1,B-DTM,37,6,0,0,6,17,20
20170521-M-Rome_Masters-F-Novak_Djokovic-Alexander_Zverev,1,B-DTL,7,3,1,2,0,5,2
20170521-M-Rome_Masters-F-Novak_Djokovic-Alexander_Zverev,1,B-IO,7,0,0,0,0,5,2
20170521-M-Rome_Masters-F-Novak_Djokovic-Alexander_Zverev,1,S-XC,1,0,0,0,0,0,1
20170521-M-Rome_Masters-F-Novak_Djokovic-Alexander_Zverev,1,S-DTM,5,0,0,0,0,0,5
20170521-M-Rome_Masters-F-Novak_Djokovic-Alexander_Zverev,2,F-XC,35,7,2,2,3,18,17
20170521-M-Rome_Masters-F-Novak_Djokovic-Alexander_Zverev,2,F-DTM,21,5,1,2,2,13,8
20170521-M-Rome_Masters-F-Novak_Djokovic-Alexander_Zverev,2,F-DTL,1,0,0,0,0,1,0
20170521-M-Rome_Masters-F-Novak_Djokovic-Alexander_Zverev,2,F-IO,10,7,2,1,4,4,6
20170521-M-Rome_Masters-F-Novak_Djokovic-Alexander_Zverev,2,B-XC,44,4,0,4,0,29,15
20170521-M-Rome_Masters-F-Novak_Djokovic-Alexander_Zverev,2,B-DTM,28,2,0,1,1,12,16
20170521-M-Rome_Masters-F-Novak_Djokovic-Alexander_Zverev,2,B-DTL,2,1,1,0,0,1,1
20170521-M-Rome_Masters-F-Novak_Djokovic-Alexander_Zverev,2,B-IO,6,3,1,0,2,1,5
20170521-M-Rome_Masters-F-Novak_Djokovic-Alexander_Zverev,2,S-DTM,5,1,0,0,1,1,4
20070330-M-Miami_Masters-SF-Novak_Djokovic-Andy_Murray,1,F-XC,23,5,2,1,2,17,6
20070330-M-Miami_Masters-SF-Novak_Djokovic-Andy_Murray,1,F-DTM,10,1,1,0,0,8,2
20070330-M-Miami_Masters-SF-Novak_Djokovic-Andy_Murray,1,F-DTL,11,1,0,0,1,8,3
20070330-M-Miami_Masters-SF-Novak_Djokovic-Andy_Murray,1,F-IO,9,1,1,0,0,8,1
20070330-M-Miami_Masters-SF-Novak_Djokovic-Andy_Murray,1,F-II,4,0,0,0,0,3,1
20070330-M-Miami_Masters-SF-Novak_Djokovic-Andy_Murray,1,B-XC,36,3,1,2,0,24,12
20070330-M-Miami_Masters-SF-Novak_Djokovic-Andy_Murray,1,B-DTM,22,1,0,0,1,15,7
20070330-M-Miami_Masters-SF-Novak_Djokovic-Andy_Murray,1,B-DTL,16,3,1,1,1,13,3
20070330-M-Miami_Masters-SF-Novak_Djokovic-Andy_Murray,1,B-IO,6,0,0,0,0,4,2
20070330-M-Miami_Masters-SF-Novak_Djokovic-Andy_Murray,1,S-XC,3,0,0,0,0,3,0
20070330-M-Miami_Masters-SF-Novak_Djokovic-Andy_Murray,1,S-DTL,1,0,0,0,0,1,0
20070330-M-Miami_Masters-SF-Novak_Djokovic-Andy_Murray,2,F-XC,39,11,1,2,8,10,29
20070330-M-Miami_Masters-SF-Novak_Djokovic-Andy_Murray,2,F-DTM,9,2,0,0,2,0,9
20070330-M-Miami_Masters-SF-Novak_Djokovic-Andy_Murray,2,F-DTL,19,4,1,1,2,6,13
20070330-M-Miami_Masters-SF-Novak_Djokovic-Andy_Murray,2,F-IO,16,2,0,1,1,6,10
20070330-M-Miami_Masters-SF-Novak_Djokovic-Andy_Murray,2,B-XC,44,8,1,1,6,11,33
20070330-M-Miami_Masters-SF-Novak_Djokovic-Andy_Murray,2,B-DTM,11,2,0,1,1,4,7
20070330-M-Miami_Masters-SF-Novak_Djokovic-Andy_Murray,2,B-DTL,7,4,0,1,3,1,6
20070330-M-Miami_Masters-SF-Novak_Djokovic-Andy_Murray,2,B-IO,2,1,0,1,0,1,1
20070330-M-Miami_Masters-SF-Novak_Djokovic-Andy_Murray,2,S-XC,12,0,0,0,0,2,10
20070330-M-Miami_Masters-SF-Novak_Djokovic-Andy_Murray,2,S-DTM,5,0,0,0,0,1,4
20070330-M-Miami_Masters-SF-Novak_Djokovic-Andy_Murray,2,S-DTL,3,1,0,0,1,0,3
19871108-M-Stockholm-F-Jonas_Svensson-Stefan_Edberg,1,F-XC,21,10,5,1,4,10,11
19871108-M-Stockholm-F-Jonas_Svensson-Stefan_Edberg,1,F-DTM,32,5,0,0,5,16,16
19871108-M-Stockholm-F-Jonas_Svensson-Stefan_Edberg,1,F-DTL,15,5,0,2,3,3,12
19871108-M-Stockholm-F-Jonas_Svensson-Stefan_Edberg,1,F-IO,17,6,2,2,2,11,6
19871108-M-Stockholm-F-Jonas_Svensson-Stefan_Edberg,1,F-II,3,0,0,0,0,1,2
19871108-M-Stockholm-F-Jonas_Svensson-Stefan_Edberg,1,B-XC,45,10,2,4,4,30,15
19871108-M-Stockholm-F-Jonas_Svensson-Stefan_Edberg,1,B-DTM,28,4,0,2,2,12,16
19871108-M-Stockholm-F-Jonas_Svensson-Stefan_Edberg,1,B-DTL,14,7,3,0,4,6,8
19871108-M-Stockholm-F-Jonas_Svensson-Stefan_Edberg,1,B-IO,14,5,5,0,0,9,5
19871108-M-Stockholm-F-Jonas_Svensson-Stefan_Edberg,1,S-XC,4,0,0,0,0,3,1
19871108-M-Stockholm-F-Jonas_Svensson-Stefan_Edberg,1,S-DTM,3,0,0,0,0,2,1
19871108-M-Stockholm-F-Jonas_Svensson-Stefan_Edberg,1,S-DTL,5,2,1,0,1,2,3
19871108-M-Stockholm-F-Jonas_Svensson-Stefan_Edberg,1,S-IO,1,0,0,0,0,1,0
19871108-M-Stockholm-F-Jonas_Svensson-Stefan_Edberg,2,F-XC,22,5,1,1,3,15,7
19871108-M-Stockholm-F-Jonas_Svensson-Stefan_Edberg,2,F-DTM,18,2,0,0,2,7,11
19871108-M-Stockholm-F-Jonas_Svensson-Stefan_Edberg,2,F-DTL,13,5,0,2,3,6,7
19871108-M-Stockholm-F-Jonas_Svensson-Stefan_Edberg,2,F-IO,7,2,1,1,0,3,4
19871108-M-Stockholm-F-Jonas_Svensson-Stefan_Edberg,2,B-XC,15,8,5,1,2,10,5
19871108-M-Stockholm-F-Jonas_Svensson-Stefan_Edberg,2,B-DTM,5,1,0,0,1,2,3
19871108-M-Stockholm-F-Jonas_Svensson-Stefan_Edberg,2,B-DTL,8,3,2,1,0,3,5
19871108-M-Stockholm-F-Jonas_Svensson-Stefan_Edberg,2,B-IO,2,1,0,0,1,1,1
19871108-M-Stockholm-F-Jonas_Svensson-Stefan_Edberg,2,S-XC,26,3,0,0,3,11,15
19871108-M-Stockholm-F-Jonas_Svensson-Stefan_Edberg,2,S-DTM,30,2,0,0,2,9,21
19871108-M-Stockholm-F-Jonas_Svensson-Stefan_Edberg,2,S-DTL,2,0,0,0,0,2,0
19871108-M-Stockholm-F-Jonas_Svensson-Stefan_Edberg,2,S-IO,3,1,0,0,1,2,1
20140810-M-Cincinnati_Masters-F-Roger_Federer-David_Ferrer,1,F-XC,24,10,3,2,5,12,12
20140810-M-Cincinnati_Masters-F-Roger_Federer-David_Ferrer,1,F-DTM,16,5,0,0,5,3,13
20140810-M-Cincinnati_Masters-F-Roger_Federer-David_Ferrer,1,F-DTL,9,2,0,0,2,2,7
20140810-M-Cincinnati_Masters-F-Roger_Federer-David_Ferrer,1,F-IO,19,5,4,1,0,15,4
20140810-M-Cincinnati_Masters-F-Roger_Federer-David_Ferrer,1,F-II,5,2,0,1,1,2,3
20140810-M-Cincinnati_Masters-F-Roger_Federer-David_Ferrer,1,B-XC,33,6,0,2,4,14,19
20140810-M-Cincinnati_Masters-F-Roger_Federer-David_Ferrer,1,B-DTM,24,5,0,1,4,7,17
20140810-M-Cincinnati_Masters-F-Roger_Federer-David_Ferrer,1,B-DTL,9,4,3,0,1,4,5
20140810-M-Cincinnati_Masters-F-Roger_Federer-David_Ferrer,1,B-IO,3,2,1,0,1,2,1
20140810-M-Cincinnati_Masters-F-Roger_Federer-David_Ferrer,1,S-XC,23,2,0,0,2,10,13
20140810-M-Cincinnati_Masters-F-Roger_Federer-David_Ferrer,1,S-DTM,9,1,0,1,0,2,7
20140810-M-Cincinnati_Masters-F-Roger_Federer-David_Ferrer,1,S-DTL,5,0,0,0,0,0,5
20140810-M-Cincinnati_Masters-F-Roger_Federer-David_Ferrer,1,S-IO,2,0,0,0,0,0,2
20140810-M-Cincinnati_Masters-F-Roger_Federer-David_Ferrer,2,F-XC,31,8,5,2,1,25,6
20140810-M-Cincinnati_Masters-F-Roger_Federer-David_Ferrer,2,F-DTM,14,1,0,0,1,7,7
20140810-M-Cincinnati_Masters-F-Roger_Federer-David_Ferrer,2,F-DTL,11,3,1,1,1,8,3
20140810-M-Cincinnati_Masters-F-Roger_Federer-David_Ferrer,2,F-IO,64,8,3,1,4,41,23
20140810-M-Cincinnati_Masters-F-Roger_Federer-David_Ferrer,2,F-II,5,2,0,0,2,2,3
20140810-M-Cincinnati_Masters-F-Roger_Federer-David_Ferrer,2,B-XC,39,7,3,1,3,18,21
20140810-M-Cincinnati_Masters-F-Roger_Federer-David_Ferrer,2,B-DTM,23,6,0,1,5,10,13
20140810-M-Cincinnati_Masters-F-Roger_Federer-David_Ferrer,2,B-DTL,9,5,2,1,2,6,3
20140810-M-Cincinnati_Masters-F-Roger_Federer-David_Ferrer,2,B-IO,1,1,1,0,0,1,0
20140810-M-Cincinnati_Masters-F-Roger_Federer-David_Ferrer,2,S-XC,1,0,0,0,0,1,0
20140810-M-Cincinnati_Masters-F-Roger_Federer-David_Ferrer,2,S-DTM,2,0,0,0,0,0,2
20140810-M-Cincinnati_Masters-F-Roger_Federer-David_Ferrer,2,S-DTL,1,0,0,0,0,1,0
19860608-M-Roland_Garros-F-Mikael_Pernfors-Ivan_Lendl,1,F-XC,60,8,3,3,2,28,32
19860608-M-Roland_Garros-F-Mikael_Pernfors-Ivan_Lendl,1,F-DTM,71,4,0,2,2,34,37
19860608-M-Roland_Garros-F-Mikael_Pernfors-Ivan_Lendl,1,F-DTL,17,4,0,2,2,8,9
19860608-M-Roland_Garros-F-Mikael_Pernfors-Ivan_Lendl,1,F-IO,54,7,1,0,6,25,29
19860608-M-Roland_Garros-F-Mikael_Pernfors-Ivan_Lendl,1,F-II,4,1,1,0,0,2,2
19860608-M-Roland_Garros-F-Mikael_Pernfors-Ivan_Lendl,1,B-XC,74,9,2,2,5,34,40
19860608-M-Roland_Garros-F-Mikael_Pernfors-Ivan_Lendl,1,B-DTM,86,4,0,1,3,29,57
19860608-M-Roland_Garros-F-Mikael_Pernfors-Ivan_Lendl,1,B-DTL,18,6,1,2,3,10,8
19860608-M-Roland_Garros-F-Mikael_Pernfors-Ivan_Lendl,1,B-IO,8,3,2,1,0,4,4
19860608-M-Roland_Garros-F-Mikael_Pernfors-Ivan_Lendl,1,S-XC,22,2,1,1,0,11,11
19860608-M-Roland_Garros-F-Mikael_Pernfors-Ivan_Lendl,1,S-DTM,17,3,1,0,2,9,8
19860608-M-Roland_Garros-F-Mikael_Pernfors-Ivan_Lendl,1,S-DTL,2,1,1,0,0,2,0
19860608-M-Roland_Garros-F-Mikael_Pernfors-Ivan_Lendl,2,F-XC,69,11,4,5,2,42,27
19860608-M-Roland_Garros-F-Mikael_Pernfors-Ivan_Lendl,2,F-DTM,65,1,0,0,1,37,28
19860608-M-Roland_Garros-F-Mikael_Pernfors-Ivan_Lendl,2,F-DTL,16,4,1,3,0,9,7
19860608-M-Roland_Garros-F-Mikael_Pernfors-Ivan_Lendl,2,F-IO,67,13,3,4,6,35,32
19860608-M-Roland_Garros-F-Mikael_Pernfors-Ivan_Lendl,2,F-II,6,3,0,1,2,4,2
19860608-M-Roland_Garros-F-Mikael_Pernfors-Ivan_Lendl,2,B-XC,79,2,0,1,1,45,34
19860608-M-Roland_Garros-F-Mikael_Pernfors-Ivan_Lendl,2,B-DTM,58,0,0,0,0,30,28
19860608-M-Roland_Garros-F-Mikael_Pernfors-Ivan_Lendl,2,B-DTL,9,5,3,1,1,8,1
19860608-M-Roland_Garros-F-Mikael_Pernfors-Ivan_Lendl,2,B-IO,11,4,3,1,0,8,3
19860608-M-Roland_Garros-F-Mikael_Pernfors-Ivan_Lendl,2,S-XC,17,0,0,0,0,9,8
19860608-M-Roland_Garros-F-Mikael_Pernfors-Ivan_Lendl,2,S-DTM,17,0,0,0,0,6,11
19860608-M-Roland_Garros-F-Mikael_Pernfors-Ivan_Lendl,2,S-DTL,9,0,0,0,0,5,4
19860608-M-Roland_Garros-F-Mikael_Pernfors-Ivan_Lendl,2,S-IO,1,0,0,0,0,0,1
20170611-M-Roland_Garros-F-Rafael_Nadal-Stanislas_Wawrinka,1,F-XC,23,10,6,2,2,19,4
20170611-M-Roland_Garros-F-Rafael_Nadal-Stanislas_Wawrinka,1,F-DTM,20,1,0,0,1,16,4
20170611-M-Roland_Garros-F-Rafael_Nadal-Stanislas_Wawrinka,1,F-DTL,3,1,0,1,0,3,0
20170611-M-Roland_Garros-F-Rafael_Nadal-Stanislas_Wawrinka,1,F-IO,67,8,3,3,2,45,22
20170611-M-Roland_Garros-F-Rafael_Nadal-Stanislas_Wawrinka,1,F-II,9,6,3,2,1,7,2
20170611-M-Roland_Garros-F-Rafael_Nadal-Stanislas_Wawrinka,1,B-XC,6,1,0,0,1,2,4
20170611-M-Roland_Garros-F-Rafael_Nadal-Stanislas_Wawrinka,1,B-DTM,52,2,0,1,1,29,23
20170611-M-Roland_Garros-F-Rafael_Nadal-Stanislas_Wawrinka,1,B-IO,51,11,2,8,1,41,10
20170611-M-Roland_Garros-F-Rafael_Nadal-Stanislas_Wawrinka,1,B-II,11,3,2,1,0,8,3
20170611-M-Roland_Garros-F-Rafael_Nadal-Stanislas_Wawrinka,1,S-DTM,6,0,0,0,0,4,2
20170611-M-Roland_Garros-F-Rafael_Nadal-Stanislas_Wawrinka,1,S-II,1,1,1,0,0,1,0
20170611-M-Roland_Garros-F-Rafael_Nadal-Stanislas_Wawrinka,2,F-XC,27,14,2,6,6,14,13
20170611-M-Roland_Garros-F-Rafael_Nadal-Stanislas_Wawrinka,2,F-DTM,47,3,1,0,2,12,35
20170611-M-Roland_Garros-F-Rafael_Nadal-Stanislas_Wawrinka,2,F-DTL,5,3,1,1,1,3,2
20170611-M-Roland_Garros-F-Rafael_Nadal-Stanislas_Wawrinka,2,F-IO,69,16,3,4,9,20,49
20170611-M-Roland_Garros-F-Rafael_Nadal-Stanislas_Wawrinka,2,F-II,9,6,2,1,3,4,5
20170611-M-Roland_Garros-F-Rafael_Nadal-Stanislas_Wawrinka,2,B-XC,8,3,1,1,1,3,5
20170611-M-Roland_Garros-F-Rafael_Nadal-Stanislas_Wawrinka,2,B-DTM,38,4,0,0,4,8,30
20170611-M-Roland_Garros-F-Rafael_Nadal-Stanislas_Wawrinka,2,B-IO,37,7,0,3,4,15,22
20170611-M-Roland_Garros-F-Rafael_Nadal-Stanislas_Wawrinka,2,B-II,12,1,0,0,1,4,8
20170611-M-Roland_Garros-F-Rafael_Nadal-Stanislas_Wawrinka,2,S-XC,1,0,0,0,0,1,0
20170611-M-Roland_Garros-F-Rafael_Nadal-Stanislas_Wawrinka,2,S-DTM,5,0,0,0,0,2,3
20170611-M-Roland_Garros-F-Rafael_Nadal-Stanislas_Wawrinka,2,S-IO,1,1,1,0,0,1,0
20170611-M-Roland_Garros-F-Rafael_Nadal-Stanislas_Wawrinka,2,S-II,1,0,0,0,0,0,1
20170206-M-Montpellier-F-Richard_Gasquet-Alexander_Zverev,1,F-XC,32,10,5,1,4,17,15
20170206-M-Montpellier-F-Richard_Gasquet-Alexander_Zverev,1,F-DTM,16,1,0,0,1,7,9
20170206-M-Montpellier-F-Richard_Gasquet-Alexander_Zverev,1,F-DTL,18,4,1,1,2,5,13
20170206-M-Montpellier-F-Richard_Gasquet-Alexander_Zverev,1,F-IO,18,1,0,1,0,14,4
20170206-M-Montpellier-F-Richard_Gasquet-Alexander_Zverev,1,F-II,1,1,0,0,1,0,1
20170206-M-Montpellier-F-Richard_Gasquet-Alexander_Zverev,1,B-XC,32,2,0,0,2,14,18
20170206-M-Montpellier-F-Richard_Gasquet-Alexander_Zverev,1,B-DTM,26,3,0,0,3,5,21
20170206-M-Montpellier-F-Richard_Gasquet-Alexander_Zverev,1,B-DTL,10,7,1,1,5,5,5
20170206-M-Montpellier-F-Richard_Gasquet-Alexander_Zverev,1,B-IO,9,0,0,0,0,1,8
20170206-M-Montpellier-F-Richard_Gasquet-Alexander_Zverev,1,S-XC,8,0,0,0,0,3,5
20170206-M-Montpellier-F-Richard_Gasquet-Alexander_Zverev,1,S-DTM,5,0,0,0,0,2,3
20170206-M-Montpellier-F-Richard_Gasquet-Alexander_Zverev,1,S-DTL,1,0,0,0,0,0,1
20170206-M-Montpellier-F-Richard_Gasquet-Alexander_Zverev,2,F-XC,39,6,2,1,3,25,14
20170206-M-Montpellier-F-Richard_Gasquet-Alexander_Zverev,2,F-DTM,13,1,0,0,1,6,7
20170206-M-Montpellier-F-Richard_Gasquet-Alexander_Zverev,2,F-DTL,7,4,1,1,2,3,4
20170206-M-Montpellier-F-Richard_Gasquet-Alexander_Zverev,2,F-IO,14,8,3,3,2,11,3
20170206-M-Montpellier-F-Richard_Gasquet-Alexander_Zverev,2,B-XC,53,11,2,3,6,30,23
20170206-M-Montpellier-F-Richard_Gasquet-Alexander_Zverev,2,B-DTM,36,3,0,0,3,20,16
20170206-M-Montpellier-F-Richard_Gasquet-Alexander_Zverev,2,B-DTL,16,7,4,0,3,7,9
20170206-M-Montpellier-F-Richard_Gasquet-Alexander_Zverev,2,B-IO,15,4,2,0,2,9,6
20170206-M-Montpellier-F-Richard_Gasquet-Alexander_Zverev,2,B-II,1,1,1,0,0,1,0
20170206-M-Montpellier-F-Richard_Gasquet-Alexander_Zverev,2,S-XC,3,1,0,0,1,1,2
20170206-M-Montpellier-F-Richard_Gasquet-Alexander_Zverev,2,S-DTL,1,0,0,0,0,1,0
20091115-M-Paris_Masters-F-Novak_Djokovic-Gael_Monfils,1,F-XC,77,26,7,15,4,53,24
20091115-M-Paris_Masters-F-Novak_Djokovic-Gael_Monfils,1,F-DTM,48,4,0,0,4,28,20
20091115-M-Paris_Masters-F-Novak_Djokovic-Gael_Monfils,1,F-DTL,14,4,1,2,1,7,7
20091115-M-Paris_Masters-F-Novak_Djokovic-Gael_Monfils,1,F-IO,49,16,4,7,5,35,14
20091115-M-Paris_Masters-F-Novak_Djokovic-Gael_Monfils,1,F-II,6,3,0,2,1,4,2
20091115-M-Paris_Masters-F-Novak_Djokovic-Gael_Monfils,1,B-XC,47,3,0,1,2,29,18
20091115-M-Paris_Masters-F-Novak_Djokovic-Gael_Monfils,1,B-DTM,46,2,0,0,2,24,22
20091115-M-Paris_Masters-F-Novak_Djokovic-Gael_Monfils,1,B-DTL,15,8,0,4,4,7,8
20091115-M-Paris_Masters-F-Novak_Djokovic-Gael_Monfils,1,B-IO,7,3,1,0,2,4,3
20091115-M-Paris_Masters-F-Novak_Djokovic-Gael_Monfils,1,S-XC,6,0,0,0,0,3,3
20091115-M-Paris_Masters-F-Novak_Djokovic-Gael_Monfils,1,S-DTM,2,0,0,0,0,1,1
20091115-M-Paris_Masters-F-Novak_Djokovic-Gael_Monfils,2,F-XC,51,10,3,2,5,21,30
20091115-M-Paris_Masters-F-Novak_Djokovic-Gael_Monfils,2,F-DTM,66,8,1,1,6,22,44
20091115-M-Paris_Masters-F-Novak_Djokovic-Gael_Monfils,2,F-DTL,9,1,0,0,1,6,3
20091115-M-Paris_Masters-F-Novak_Djokovic-Gael_Monfils,2,F-IO,24,5,2,2,1,13,11
20091115-M-Paris_Masters-F-Novak_Djokovic-Gael_Monfils,2,B-XC,52,4,0,1,3,22,30
20091115-M-Paris_Masters-F-Novak_Djokovic-Gael_Monfils,2,B-DTM,58,4,0,1,3,21,37
20091115-M-Paris_Masters-F-Novak_Djokovic-Gael_Monfils,2,B-DTL,11,3,2,1,0,6,5
20091115-M-Paris_Masters-F-Novak_Djokovic-Gael_Monfils,2,B-IO,5,2,1,0,1,2,3
20091115-M-Paris_Masters-F-Novak_Djokovic-Gael_Monfils,2,S-XC,7,1,0,0,1,1,6
20091115-M-Paris_Masters-F-Novak_Djokovic-Gael_Monfils,2,S-DTM,13,0,0,0,0,3,10
20091115-M-Paris_Masters-F-Novak_Djokovic-Gael_Monfils,2,S-DTL,3,0,0,0,0,0,3
19930702-M-Wimbledon-SF-Jim_Courier-Stefan_Edberg,1,F-XC,18,9,4,2,3,13,5
19930702-M-Wimbledon-SF-Jim_Courier-Stefan_Edberg,1,F-DTM,10,2,0,1,1,4,6
19930702-M-Wimbledon-SF-Jim_Courier-Stefan_Edberg,1,F-DTL,4,1,0,1,0,4,0
19930702-M-Wimbledon-SF-Jim_Courier-Stefan_Edberg,1,F-IO,13,5,2,1,2,5,8
19930702-M-Wimbledon-SF-Jim_Courier-Stefan_Edberg,1,F-II,2,1,0,1,0,2,0
19930702-M-Wimbledon-SF-Jim_Courier-Stefan_Edberg,1,B-XC,13,6,1,1,4,7,6
19930702-M-Wimbledon-SF-Jim_Courier-Stefan_Edberg,1,B-DTM,9,0,0,0,0,4,5
19930702-M-Wimbledon-SF-Jim_Courier-Stefan_Edberg,1,B-DTL,4,3,3,0,0,3,1
19930702-M-Wimbledon-SF-Jim_Courier-Stefan_Edberg,1,S-XC,5,3,2,0,1,4,1
19930702-M-Wimbledon-SF-Jim_Courier-Stefan_Edberg,1,S-DTM,9,1,0,0,1,5,4
19930702-M-Wimbledon-SF-Jim_Courier-Stefan_Edberg,2,F-XC,5,3,0,0,3,0,5
19930702-M-Wimbledon-SF-Jim_Courier-Stefan_Edberg,2,F-DTM,7,0,0,0,0,1,6
19930702-M-Wimbledon-SF-Jim_Courier-Stefan_Edberg,2,F-DTL,7,2,0,1,1,3,4
19930702-M-Wimbledon-SF-Jim_Courier-Stefan_Edberg,2,F-IO,1,0,0,0,0,0,1
19930702-M-Wimbledon-SF-Jim_Courier-Stefan_Edberg,2,B-XC,6,2,1,0,1,2,4
19930702-M-Wimbledon-SF-Jim_Courier-Stefan_Edberg,2,B-DTM,3,0,0,0,0,0,3
19930702-M-Wimbledon-SF-Jim_Courier-Stefan_Edberg,2,B-DTL,1,1,0,0,1,0,1
19930702-M-Wimbledon-SF-Jim_Courier-Stefan_Edberg,2,B-IO,3,2,0,1,1,2,1
19930702-M-Wimbledon-SF-Jim_Courier-Stefan_Edberg,2,S-XC,5,1,0,1,0,3,2
19930702-M-Wimbledon-SF-Jim_Courier-Stefan_Edberg,2,S-DTM,5,1,0,0,1,2,3
19930702-M-Wimbledon-SF-Jim_Courier-Stefan_Edberg,2,S-DTL,4,3,0,1,2,1,3
20060701-M-Wimbledon-R32-Rafael_Nadal-Andre_Agassi,1,F-XC,71,11,4,2,5,54,17
20060701-M-Wimbledon-R32-Rafael_Nadal-Andre_Agassi,1,F-DTM,12,2,0,0,2,9,3
20060701-M-Wimbledon-R32-Rafael_Nadal-Andre_Agassi,1,F-DTL,31,10,6,0,4,25,6
20060701-M-Wimbledon-R32-Rafael_Nadal-Andre_Agassi,1,F-IO,11,3,2,0,1,7,4
20060701-M-Wimbledon-R32-Rafael_Nadal-Andre_Agassi,1,F-II,1,0,0,0,0,1,0
20060701-M-Wimbledon-R32-Rafael_Nadal-Andre_Agassi,1,B-XC,35,6,2,0,4,23,12
20060701-M-Wimbledon-R32-Rafael_Nadal-Andre_Agassi,1,B-DTM,14,2,1,0,1,6,8
20060701-M-Wimbledon-R32-Rafael_Nadal-Andre_Agassi,1,B-DTL,17,7,3,3,1,11,6
20060701-M-Wimbledon-R32-Rafael_Nadal-Andre_Agassi,1,B-IO,3,1,1,0,0,3,0
20060701-M-Wimbledon-R32-Rafael_Nadal-Andre_Agassi,1,S-XC,10,0,0,0,0,5,5
20060701-M-Wimbledon-R32-Rafael_Nadal-Andre_Agassi,1,S-DTM,11,1,0,0,1,5,6
20060701-M-Wimbledon-R32-Rafael_Nadal-Andre_Agassi,1,S-DTL,4,0,0,0,0,1,3
20060701-M-Wimbledon-R32-Rafael_Nadal-Andre_Agassi,2,F-XC,74,9,4,1,4,35,39
20060701-M-Wimbledon-R32-Rafael_Nadal-Andre_Agassi,2,F-DTM,13,2,0,0,2,3,10
20060701-M-Wimbledon-R32-Rafael_Nadal-Andre_Agassi,2,F-DTL,20,10,0,1,9,5,15
20060701-M-Wimbledon-R32-Rafael_Nadal-Andre_Agassi,2,F-IO,12,1,0,1,0,6,6
20060701-M-Wimbledon-R32-Rafael_Nadal-Andre_Agassi,2,F-II,7,3,2,0,1,4,3
20060701-M-Wimbledon-R32-Rafael_Nadal-Andre_Agassi,2,B-XC,64,15,2,5,8,13,51
20060701-M-Wimbledon-R32-Rafael_Nadal-Andre_Agassi,2,B-DTM,14,4,0,1,3,4,10
20060701-M-Wimbledon-R32-Rafael_Nadal-Andre_Agassi,2,B-DTL,14,4,1,1,2,7,7
20060701-M-Wimbledon-R32-Rafael_Nadal-Andre_Agassi,2,B-IO,5,1,0,0,1,1,4
20060701-M-Wimbledon-R32-Rafael_Nadal-Andre_Agassi,2,S-XC,10,1,0,0,1,2,8
20060701-M-Wimbledon-R32-Rafael_Nadal-Andre_Agassi,2,S-DTM,1,1,0,0,1,0,1
20060701-M-Wimbledon-R32-Rafael_Nadal-Andre_Agassi,2,S-DTL,2,0,0,0,0,0,2
20130331-M-Miami_Masters-F-David_Ferrer-Andy_Murray,1,F-XC,70,12,1,3,8,27,43
20130331-M-Miami_Masters-F-David_Ferrer-Andy_Murray,1,F-DTM,76,2,0,0,2,33,43
20130331-M-Miami_Masters-F-David_Ferrer-Andy_Murray,1,F-DTL,17,5,2,0,3,8,9
20130331-M-Miami_Masters-F-David_Ferrer-Andy_Murray,1,F-IO,74,15,0,3,12,36,38
20130331-M-Miami_Masters-F-David_Ferrer-Andy_Murray,1,F-II,12,3,0,3,0,9,3
20130331-M-Miami_Masters-F-David_Ferrer-Andy_Murray,1,B-XC,98,12,0,3,9,30,68
20130331-M-Miami_Masters-F-David_Ferrer-Andy_Murray,1,B-DTM,74,5,0,1,4,34,40
20130331-M-Miami_Masters-F-David_Ferrer-Andy_Murray,1,B-DTL,7,3,0,1,2,4,3
20130331-M-Miami_Masters-F-David_Ferrer-Andy_Murray,1,B-IO,5,2,1,0,1,3,2
20130331-M-Miami_Masters-F-David_Ferrer-Andy_Murray,1,S-XC,9,2,0,0,2,5,4
20130331-M-Miami_Masters-F-David_Ferrer-Andy_Murray,1,S-DTM,5,1,0,0,1,2,3
20130331-M-Miami_Masters-F-David_Ferrer-Andy_Murray,1,S-DTL,3,2,0,2,0,2,1
20130331-M-Miami_Masters-F-David_Ferrer-Andy_Murray,2,F-XC,61,14,5,2,7,35,26
20130331-M-Miami_Masters-F-David_Ferrer-Andy_Murray,2,F-DTM,68,4,0,1,3,37,31
20130331-M-Miami_Masters-F-David_Ferrer-Andy_Murray,2,F-DTL,20,6,1,2,3,11,9
20130331-M-Miami_Masters-F-David_Ferrer-Andy_Murray,2,F-IO,56,4,1,0,3,37,19
20130331-M-Miami_Masters-F-David_Ferrer-Andy_Murray,2,F-II,5,1,1,0,0,2,3
20130331-M-Miami_Masters-F-David_Ferrer-Andy_Murray,2,B-XC,83,14,3,4,7,44,39
20130331-M-Miami_Masters-F-David_Ferrer-Andy_Murray,2,B-DTM,75,6,0,1,5,39,36
20130331-M-Miami_Masters-F-David_Ferrer-Andy_Murray,2,B-DTL,13,5,1,2,2,9,4
20130331-M-Miami_Masters-F-David_Ferrer-Andy_Murray,2,B-IO,16,4,1,0,3,9,7
20130331-M-Miami_Masters-F-David_Ferrer-Andy_Murray,2,S-XC,26,1,0,0,1,9,17
20130331-M-Miami_Masters-F-David_Ferrer-Andy_Murray,2,S-DTM,24,4,0,0,4,11,13
20130331-M-Miami_Masters-F-David_Ferrer-Andy_Murray,2,S-DTL,2,0,0,0,0,1,1
20130331-M-Miami_Masters-F-David_Ferrer-Andy_Murray,2,S-IO,2,1,0,0,1,0,2
20060419-M-Monte_Carlo_Masters-R64-Novak_Djokovic-Roger_Federer,1,F-XC,38,5,1,0,4,23,15
20060419-M-Monte_Carlo_Masters-R64-Novak_Djokovic-Roger_Federer,1,F-DTM,46,4,0,0,4,24,22
20060419-M-Monte_Carlo_Masters-R64-Novak_Djokovic-Roger_Federer,1,F-DTL,9,5,2,3,0,9,0
20060419-M-Monte_Carlo_Masters-R64-Novak_Djokovic-Roger_Federer,1,F-IO,30,12,1,5,6,13,17
20060419-M-Monte_Carlo_Masters-R64-Novak_Djokovic-Roger_Federer,1,F-II,1,0,0,0,0,1,0
20060419-M-Monte_Carlo_Masters-R64-Novak_Djokovic-Roger_Federer,1,B-XC,29,6,2,2,2,15,14
20060419-M-Monte_Carlo_Masters-R64-Novak_Djokovic-Roger_Federer,1,B-DTM,33,4,0,1,3,14,19
20060419-M-Monte_Carlo_Masters-R64-Novak_Djokovic-Roger_Federer,1,B-DTL,7,5,1,1,3,3,4
20060419-M-Monte_Carlo_Masters-R64-Novak_Djokovic-Roger_Federer,1,B-IO,11,4,2,2,0,7,4
20060419-M-Monte_Carlo_Masters-R64-Novak_Djokovic-Roger_Federer,1,S-XC,2,0,0,0,0,1,1
20060419-M-Monte_Carlo_Masters-R64-Novak_Djokovic-Roger_Federer,1,S-DTM,4,0,0,0,0,1,3
20060419-M-Monte_Carlo_Masters-R64-Novak_Djokovic-Roger_Federer,1,S-DTL,1,0,0,0,0,0,1
20060419-M-Monte_Carlo_Masters-R64-Novak_Djokovic-Roger_Federer,1,S-IO,1,1,0,0,1,0,1
20060419-M-Monte_Carlo_Masters-R64-Novak_Djokovic-Roger_Federer,2,F-XC,53,12,3,2,7,18,35
20060419-M-Monte_Carlo_Masters-R64-Novak_Djokovic-Roger_Federer,2,F-DTM,38,5,0,1,4,21,17
20060419-M-Monte_Carlo_Masters-R64-Novak_Djokovic-Roger_Federer,2,F-DTL,10,5,1,1,3,2,8
20060419-M-Monte_Carlo_Masters-R64-Novak_Djokovic-Roger_Federer,2,F-IO,19,10,6,1,3,14,5
20060419-M-Monte_Carlo_Masters-R64-Novak_Djokovic-Roger_Federer,2,F-II,1,0,0,0,0,1,0
20060419-M-Monte_Carlo_Masters-R64-Novak_Djokovic-Roger_Federer,2,B-XC,17,5,3,2,0,12,5
20060419-M-Monte_Carlo_Masters-R64-Novak_Djokovic-Roger_Federer,2,B-DTM,38,3,0,2,1,21,17
20060419-M-Monte_Carlo_Masters-R64-Novak_Djokovic-Roger_Federer,2,B-DTL,6,5,2,1,2,3,3
20060419-M-Monte_Carlo_Masters-R64-Novak_Djokovic-Roger_Federer,2,B-IO,3,1,1,0,0,2,1
20060419-M-Monte_Carlo_Masters-R64-Novak_Djokovic-Roger_Federer,2,S-XC,7,2,0,0,2,2,5
20060419-M-Monte_Carlo_Masters-R64-Novak_Djokovic-Roger_Federer,2,S-DTM,11,0,0,0,0,6,5
20060419-M-Monte_Carlo_Masters-R64-Novak_Djokovic-Roger_Federer,2,S-DTL,2,1,0,0,1,0,2
19960804-M-Olympics-F-Sergi_Bruguera-Andre_Agassi,1,F-XC,24,0,0,0,0,7,17
19960804-M-Olympics-F-Sergi_Bruguera-Andre_Agassi,1,F-DTM,15,1,0,0,1,4,11
19960804-M-Olympics-F-Sergi_Bruguera-Andre_Agassi,1,F-DTL,20,6,0,1,5,6,14
19960804-M-Olympics-F-Sergi_Bruguera-Andre_Agassi,1,F-IO,13,4,2,1,1,7,6
19960804-M-Olympics-F-Sergi_Bruguera-Andre_Agassi,1,B-XC,39,7,0,1,6,10,29
19960804-M-Olympics-F-Sergi_Bruguera-Andre_Agassi,1,B-DTM,17,0,0,0,0,6,11
19960804-M-Olympics-F-Sergi_Bruguera-Andre_Agassi,1,B-DTL,15,7,1,0,6,6,9
19960804-M-Olympics-F-Sergi_Bruguera-Andre_Agassi,1,B-IO,1,1,0,1,0,1,0
19960804-M-Olympics-F-Sergi_Bruguera-Andre_Agassi,1,S-XC,12,0,0,0,0,5,7
19960804-M-Olympics-F-Sergi_Bruguera-Andre_Agassi,1,S-DTM,3,0,0,0,0,2,1
19960804-M-Olympics-F-Sergi_Bruguera-Andre_Agassi,1,S-DTL,5,1,0,0,1,2,3
19960804-M-Olympics-F-Sergi_Bruguera-Andre_Agassi,2,F-XC,53,11,2,6,3,38,15
19960804-M-Olympics-F-Sergi_Bruguera-Andre_Agassi,2,F-DTM,4,1,0,0,1,2,2
19960804-M-Olympics-F-Sergi_Bruguera-Andre_Agassi,2,F-DTL,9,3,1,1,1,7,2
19960804-M-Olympics-F-Sergi_Bruguera-Andre_Agassi,2,F-IO,28,8,2,2,4,13,15
19960804-M-Olympics-F-Sergi_Bruguera-Andre_Agassi,2,F-II,2,1,1,0,0,1,1
19960804-M-Olympics-F-Sergi_Bruguera-Andre_Agassi,2,B-XC,52,10,2,4,4,37,15
19960804-M-Olympics-F-Sergi_Bruguera-Andre_Agassi,2,B-DTM,8,0,0,0,0,1,7
19960804-M-Olympics-F-Sergi_Bruguera-Andre_Agassi,2,B-DTL,13,5,2,2,1,10,3
19960804-M-Olympics-F-Sergi_Bruguera-Andre_Agassi,2,B-IO,1,0,0,0,0,1,0
19960804-M-Olympics-F-Sergi_Bruguera-Andre_Agassi,2,S-XC,6,0,0,0,0,5,1
19960804-M-Olympics-F-Sergi_Bruguera-Andre_Agassi,2,S-DTM,2,0,0,0,0,0,2
19901118-M-Tour_Finals-F-Andre_Agassi-Stefan_Edberg,1,F-XC,42,3,2,0,1,20,22
19901118-M-Tour_Finals-F-Andre_Agassi-Stefan_Edberg,1,F-DTM,29,3,0,0,3,11,18
19901118-M-Tour_Finals-F-Andre_Agassi-Stefan_Edberg,1,F-DTL,22,8,3,3,2,11,11
19901118-M-Tour_Finals-F-Andre_Agassi-Stefan_Edberg,1,F-IO,27,12,4,4,4,15,12
19901118-M-Tour_Finals-F-Andre_Agassi-Stefan_Edberg,1,F-II,4,1,0,1,0,1,3
19901118-M-Tour_Finals-F-Andre_Agassi-Stefan_Edberg,1,B-XC,94,18,4,5,9,53,41
19901118-M-Tour_Finals-F-Andre_Agassi-Stefan_Edberg,1,B-DTM,44,5,0,0,5,19,25
19901118-M-Tour_Finals-F-Andre_Agassi-Stefan_Edberg,1,B-DTL,25,10,4,1,5,11,14
19901118-M-Tour_Finals-F-Andre_Agassi-Stefan_Edberg,1,B-IO,4,2,1,0,1,1,3
19901118-M-Tour_Finals-F-Andre_Agassi-Stefan_Edberg,1,S-XC,5,0,0,0,0,1,4
19901118-M-Tour_Finals-F-Andre_Agassi-Stefan_Edberg,1,S-DTM,3,0,0,0,0,1,2
19901118-M-Tour_Finals-F-Andre_Agassi-Stefan_Edberg,2,F-XC,38,15,6,4,5,24,14
19901118-M-Tour_Finals-F-Andre_Agassi-Stefan_Edberg,2,F-DTM,30,2,0,0,2,10,20
19901118-M-Tour_Finals-F-Andre_Agassi-Stefan_Edberg,2,F-DTL,20,4,2,1,1,11,9
19901118-M-Tour_Finals-F-Andre_Agassi-Stefan_Edberg,2,F-IO,14,6,3,2,1,10,4
19901118-M-Tour_Finals-F-Andre_Agassi-Stefan_Edberg,2,B-XC,42,5,1,2,2,28,14
19901118-M-Tour_Finals-F-Andre_Agassi-Stefan_Edberg,2,B-DTM,20,3,0,0,3,12,8
19901118-M-Tour_Finals-F-Andre_Agassi-Stefan_Edberg,2,B-DTL,14,7,0,2,5,3,11
19901118-M-Tour_Finals-F-Andre_Agassi-Stefan_Edberg,2,B-IO,4,1,1,0,0,2,2
19901118-M-Tour_Finals-F-Andre_Agassi-Stefan_Edberg,2,S-XC,28,6,0,3,3,12,16
19901118-M-Tour_Finals-F-Andre_Agassi-Stefan_Edberg,2,S-DTM,13,0,0,0,0,3,10
19901118-M-Tour_Finals-F-Andre_Agassi-Stefan_Edberg,2,S-DTL,3,0,0,0,0,2,1
19901118-M-Tour_Finals-F-Andre_Agassi-Stefan_Edberg,2,S-IO,1,0,0,0,0,1,0
20081116-M-Tour_Finals-F-Novak_Djokovic-Nikolay_Davydenko,1,F-XC,34,11,4,6,1,27,7
20081116-M-Tour_Finals-F-Novak_Djokovic-Nikolay_Davydenko,1,F-DTM,27,0,0,0,0,21,6
20081116-M-Tour_Finals-F-Novak_Djokovic-Nikolay_Davydenko,1,F-DTL,8,1,0,0,1,6,2
20081116-M-Tour_Finals-F-Novak_Djokovic-Nikolay_Davydenko,1,F-IO,25,11,2,6,3,20,5
20081116-M-Tour_Finals-F-Novak_Djokovic-Nikolay_Davydenko,1,B-XC,38,8,4,1,3,27,11
20081116-M-Tour_Finals-F-Novak_Djokovic-Nikolay_Davydenko,1,B-DTM,24,0,0,0,0,16,8
20081116-M-Tour_Finals-F-Novak_Djokovic-Nikolay_Davydenko,1,B-DTL,5,4,0,4,0,5,0
20081116-M-Tour_Finals-F-Novak_Djokovic-Nikolay_Davydenko,1,B-IO,8,4,0,1,3,4,4
20081116-M-Tour_Finals-F-Novak_Djokovic-Nikolay_Davydenko,1,S-XC,3,0,0,0,0,2,1
20081116-M-Tour_Finals-F-Novak_Djokovic-Nikolay_Davydenko,1,S-DTM,7,0,0,0,0,5,2
20081116-M-Tour_Finals-F-Novak_Djokovic-Nikolay_Davydenko,1,S-IO,1,0,0,0,0,1,0
20081116-M-Tour_Finals-F-Novak_Djokovic-Nikolay_Davydenko,2,F-XC,43,11,1,5,5,13,30
20081116-M-Tour_Finals-F-Novak_Djokovic-Nikolay_Davydenko,2,F-DTM,24,1,0,0,1,7,17
20081116-M-Tour_Finals-F-Novak_Djokovic-Nikolay_Davydenko,2,F-DTL,8,1,0,0,1,1,7
20081116-M-Tour_Finals-F-Novak_Djokovic-Nikolay_Davydenko,2,F-IO,12,4,1,2,1,4,8
20081116-M-Tour_Finals-F-Novak_Djokovic-Nikolay_Davydenko,2,B-XC,35,6,0,1,5,14,21
20081116-M-Tour_Finals-F-Novak_Djokovic-Nikolay_Davydenko,2,B-DTM,41,5,0,1,4,6,35
20081116-M-Tour_Finals-F-Novak_Djokovic-Nikolay_Davydenko,2,B-DTL,4,3,0,0,3,1,3
20081116-M-Tour_Finals-F-Novak_Djokovic-Nikolay_Davydenko,2,B-IO,5,0,0,0,0,2,3
20081116-M-Tour_Finals-F-Novak_Djokovic-Nikolay_Davydenko,2,S-DTM,6,0,0,0,0,1,5
20081116-M-Tour_Finals-F-Novak_Djokovic-Nikolay_Davydenko,2,S-DTL,4,0,0,0,0,1,3
20121111-M-Tour_Finals-SF-Roger_Federer-Andy_Murray,1,F-XC,14,3,0,1,2,7,7
20121111-M-Tour_Finals-SF-Roger_Federer-Andy_Murray,1,F-DTM,12,1,0,0,1,4,8
20121111-M-Tour_Finals-SF-Roger_Federer-Andy_Murray,1,F-DTL,14,7,2,2,3,7,7
20121111-M-Tour_Finals-SF-Roger_Federer-Andy_Murray,1,F-IO,27,10,2,3,5,11,16
20121111-M-Tour_Finals-SF-Roger_Federer-Andy_Murray,1,F-II,8,7,1,3,3,4,4
20121111-M-Tour_Finals-SF-Roger_Federer-Andy_Murray,1,B-XC,32,5,1,0,4,18,14
20121111-M-Tour_Finals-SF-Roger_Federer-Andy_Murray,1,B-DTM,15,1,0,0,1,6,9
20121111-M-Tour_Finals-SF-Roger_Federer-Andy_Murray,1,B-DTL,10,3,1,2,0,4,6
20121111-M-Tour_Finals-SF-Roger_Federer-Andy_Murray,1,B-IO,1,0,0,0,0,1,0
20121111-M-Tour_Finals-SF-Roger_Federer-Andy_Murray,1,S-XC,18,0,0,0,0,10,8
20121111-M-Tour_Finals-SF-Roger_Federer-Andy_Murray,1,S-DTM,4,0,0,0,0,0,4
20121111-M-Tour_Finals-SF-Roger_Federer-Andy_Murray,2,F-XC,24,4,0,0,4,12,12
20121111-M-Tour_Finals-SF-Roger_Federer-Andy_Murray,2,F-DTM,2,0,0,0,0,2,0
20121111-M-Tour_Finals-SF-Roger_Federer-Andy_Murray,2,F-DTL,10,2,0,2,0,4,6
20121111-M-Tour_Finals-SF-Roger_Federer-Andy_Murray,2,F-IO,28,6,2,3,1,21,7
20121111-M-Tour_Finals-SF-Roger_Federer-Andy_Murray,2,F-II,2,1,0,0,1,1,1
20121111-M-Tour_Finals-SF-Roger_Federer-Andy_Murray,2,B-XC,63,14,1,3,10,28,35
20121111-M-Tour_Finals-SF-Roger_Federer-Andy_Murray,2,B-DTM,8,2,0,0,2,4,4
20121111-M-Tour_Finals-SF-Roger_Federer-Andy_Murray,2,B-DTL,8,5,1,1,3,4,4
20121111-M-Tour_Finals-SF-Roger_Federer-Andy_Murray,2,S-XC,11,1,0,0,1,6,5
20121111-M-Tour_Finals-SF-Roger_Federer-Andy_Murray,2,S-DTM,4,0,0,0,0,1,3
20121111-M-Tour_Finals-SF-Roger_Federer-Andy_Murray,2,S-DTL,1,0,0,0,0,1,0
20160629-M-Wimbledon-R64-Roger_Federer-Marcus_Willis,1,F-XC,23,4,3,0,1,18,5
20160629-M-Wimbledon-R64-Roger_Federer-Marcus_Willis,1,F-DTM,9,1,0,1,0,7,2
20160629-M-Wimbledon-R64-Roger_Federer-Marcus_Willis,1,F-DTL,8,6,4,2,0,8,0
20160629-M-Wimbledon-R64-Roger_Federer-Marcus_Willis,1,F-IO,20,10,4,2,4,12,8
20160629-M-Wimbledon-R64-Roger_Federer-Marcus_Willis,1,F-II,8,1,1,0,0,5,3
20160629-M-Wimbledon-R64-Roger_Federer-Marcus_Willis,1,B-XC,19,5,2,1,2,13,6
20160629-M-Wimbledon-R64-Roger_Federer-Marcus_Willis,1,B-DTM,10,1,0,0,1,6,4
20160629-M-Wimbledon-R64-Roger_Federer-Marcus_Willis,1,B-DTL,8,6,1,3,2,5,3
20160629-M-Wimbledon-R64-Roger_Federer-Marcus_Willis,1,S-XC,9,0,0,0,0,5,4
20160629-M-Wimbledon-R64-Roger_Federer-Marcus_Willis,1,S-DTM,6,0,0,0,0,3,3
20160629-M-Wimbledon-R64-Roger_Federer-Marcus_Willis,1,S-DTL,18,3,0,2,1,10,8
20160629-M-Wimbledon-R64-Roger_Federer-Marcus_Willis,1,S-IO,1,0,0,0,0,1,0
20160629-M-Wimbledon-R64-Roger_Federer-Marcus_Willis,2,F-XC,31,6,0,4,2,15,16
20160629-M-Wimbledon-R64-Roger_Federer-Marcus_Willis,2,F-DTM,3,1,0,0,1,1,2
20160629-M-Wimbledon-R64-Roger_Federer-Marcus_Willis,2,F-DTL,8,4,2,0,2,3,5
20160629-M-Wimbledon-R64-Roger_Federer-Marcus_Willis,2,F-IO,6,5,1,1,3,2,4
20160629-M-Wimbledon-R64-Roger_Federer-Marcus_Willis,2,F-II,1,0,0,0,0,0,1
20160629-M-Wimbledon-R64-Roger_Federer-Marcus_Willis,2,B-XC,11,7,2,1,4,3,8
20160629-M-Wimbledon-R64-Roger_Federer-Marcus_Willis,2,B-DTM,1,0,0,0,0,0,1
20160629-M-Wimbledon-R64-Roger_Federer-Marcus_Willis,2,B-DTL,4,0,0,0,0,1,3
20160629-M-Wimbledon-R64-Roger_Federer-Marcus_Willis,2,B-IO,11,4,1,1,2,6,5
20160629-M-Wimbledon-R64-Roger_Federer-Marcus_Willis,2,S-XC,1,0,0,0,0,0,1
20160629-M-Wimbledon-R64-Roger_Federer-Marcus_Willis,2,S-DTM,14,1,0,0,1,3,11
20160629-M-Wimbledon-R64-Roger_Federer-Marcus_Willis,2,S-DTL,17,2,0,1,1,8,9
20160629-M-Wimbledon-R64-Roger_Federer-Marcus_Willis,2,S-IO,10,0,0,0,0,2,8
20080615-M-Queens_Club-F-Novak_Djokovic-Rafael_Nadal,1,F-XC,51,10,7,1,2,27,24
20080615-M-Queens_Club-F-Novak_Djokovic-Rafael_Nadal,1,F-DTM,37,5,1,0,4,13,24
20080615-M-Queens_Club-F-Novak_Djokovic-Rafael_Nadal,1,F-DTL,13,7,3,1,3,7,6
20080615-M-Queens_Club-F-Novak_Djokovic-Rafael_Nadal,1,F-IO,32,10,4,3,3,20,12
20080615-M-Queens_Club-F-Novak_Djokovic-Rafael_Nadal,1,F-II,1,0,0,0,0,0,1
20080615-M-Queens_Club-F-Novak_Djokovic-Rafael_Nadal,1,B-XC,30,7,1,0,6,12,18
20080615-M-Queens_Club-F-Novak_Djokovic-Rafael_Nadal,1,B-DTM,25,3,0,1,2,12,13
20080615-M-Queens_Club-F-Novak_Djokovic-Rafael_Nadal,1,B-DTL,27,9,0,5,4,14,13
20080615-M-Queens_Club-F-Novak_Djokovic-Rafael_Nadal,1,B-IO,9,4,1,2,1,5,4
20080615-M-Queens_Club-F-Novak_Djokovic-Rafael_Nadal,1,S-XC,4,2,1,0,1,3,1
20080615-M-Queens_Club-F-Novak_Djokovic-Rafael_Nadal,1,S-DTM,3,0,0,0,0,0,3
20080615-M-Queens_Club-F-Novak_Djokovic-Rafael_Nadal,1,S-DTL,2,1,0,0,1,0,2
20080615-M-Queens_Club-F-Novak_Djokovic-Rafael_Nadal,2,F-XC,60,14,7,2,5,34,26
20080615-M-Queens_Club-F-Novak_Djokovic-Rafael_Nadal,2,F-DTM,19,2,0,0,2,6,13
20080615-M-Queens_Club-F-Novak_Djokovic-Rafael_Nadal,2,F-DTL,27,8,2,2,4,12,15
20080615-M-Queens_Club-F-Novak_Djokovic-Rafael_Nadal,2,F-IO,33,12,6,4,2,23,10
20080615-M-Queens_Club-F-Novak_Djokovic-Rafael_Nadal,2,F-II,4,1,0,0,1,2,2
20080615-M-Queens_Club-F-Novak_Djokovic-Rafael_Nadal,2,B-XC,30,3,0,1,2,20,10
20080615-M-Queens_Club-F-Novak_Djokovic-Rafael_Nadal,2,B-DTM,21,3,0,1,2,9,12
20080615-M-Queens_Club-F-Novak_Djokovic-Rafael_Nadal,2,B-DTL,5,3,0,1,2,2,3
20080615-M-Queens_Club-F-Novak_Djokovic-Rafael_Nadal,2,B-IO,4,0,0,0,0,3,1
20080615-M-Queens_Club-F-Novak_Djokovic-Rafael_Nadal,2,S-XC,6,0,0,0,0,1,5
20080615-M-Queens_Club-F-Novak_Djokovic-Rafael_Nadal,2,S-DTM,11,0,0,0,0,3,8
20080615-M-Queens_Club-F-Novak_Djokovic-Rafael_Nadal,2,S-DTL,10,0,0,0,0,5,5
20080615-M-Queens_Club-F-Novak_Djokovic-Rafael_Nadal,2,S-IO,4,0,0,0,0,2,2
19990425-M-Monte_Carlo_Masters-F-Marcelo_Rios-Gustavo_Kuerten,1,F-XC,31,7,1,1,5,7,24
19990425-M-Monte_Carlo_Masters-F-Marcelo_Rios-Gustavo_Kuerten,1,F-DTM,15,3,0,1,2,6,9
19990425-M-Monte_Carlo_Masters-F-Marcelo_Rios-Gustavo_Kuerten,1,F-DTL,6,3,2,0,1,3,3
19990425-M-Monte_Carlo_Masters-F-Marcelo_Rios-Gustavo_Kuerten,1,F-IO,15,10,4,1,5,6,9
19990425-M-Monte_Carlo_Masters-F-Marcelo_Rios-Gustavo_Kuerten,1,F-II,2,0,0,0,0,1,1
19990425-M-Monte_Carlo_Masters-F-Marcelo_Rios-Gustavo_Kuerten,1,B-XC,21,4,1,0,3,5,16
19990425-M-Monte_Carlo_Masters-F-Marcelo_Rios-Gustavo_Kuerten,1,B-DTM,12,2,0,0,2,2,10
19990425-M-Monte_Carlo_Masters-F-Marcelo_Rios-Gustavo_Kuerten,1,B-DTL,7,1,0,0,1,3,4
19990425-M-Monte_Carlo_Masters-F-Marcelo_Rios-Gustavo_Kuerten,1,B-IO,2,1,0,1,0,2,0
19990425-M-Monte_Carlo_Masters-F-Marcelo_Rios-Gustavo_Kuerten,1,S-DTM,2,0,0,0,0,0,2
19990425-M-Monte_Carlo_Masters-F-Marcelo_Rios-Gustavo_Kuerten,2,F-XC,20,2,1,1,0,14,6
19990425-M-Monte_Carlo_Masters-F-Marcelo_Rios-Gustavo_Kuerten,2,F-DTM,17,2,1,1,0,15,2
19990425-M-Monte_Carlo_Masters-F-Marcelo_Rios-Gustavo_Kuerten,2,F-DTL,4,3,3,0,0,4,0
19990425-M-Monte_Carlo_Masters-F-Marcelo_Rios-Gustavo_Kuerten,2,F-IO,8,5,1,4,0,7,1
19990425-M-Monte_Carlo_Masters-F-Marcelo_Rios-Gustavo_Kuerten,2,B-XC,23,5,2,1,2,17,6
19990425-M-Monte_Carlo_Masters-F-Marcelo_Rios-Gustavo_Kuerten,2,B-DTM,10,1,0,0,1,7,3
19990425-M-Monte_Carlo_Masters-F-Marcelo_Rios-Gustavo_Kuerten,2,B-DTL,2,0,0,0,0,2,0
19990425-M-Monte_Carlo_Masters-F-Marcelo_Rios-Gustavo_Kuerten,2,B-IO,3,1,0,0,1,1,2
19990425-M-Monte_Carlo_Masters-F-Marcelo_Rios-Gustavo_Kuerten,2,S-XC,2,1,0,1,0,1,1
19990425-M-Monte_Carlo_Masters-F-Marcelo_Rios-Gustavo_Kuerten,2,S-DTM,7,0,0,0,0,4,3
19990425-M-Monte_Carlo_Masters-F-Marcelo_Rios-Gustavo_Kuerten,2,S-DTL,2,0,0,0,0,1,1
20081019-M-Madrid_Masters-F-Gilles_Simon-Andy_Murray,1,F-XC,70,7,2,2,3,43,27
20081019-M-Madrid_Masters-F-Gilles_Simon-Andy_Murray,1,F-DTM,47,3,0,0,3,24,23
20081019-M-Madrid_Masters-F-Gilles_Simon-Andy_Murray,1,F-DTL,9,3,1,0,2,4,5
20081019-M-Madrid_Masters-F-Gilles_Simon-Andy_Murray,1,F-IO,25,7,3,1,3,13,12
20081019-M-Madrid_Masters-F-Gilles_Simon-Andy_Murray,1,F-II,7,4,0,1,3,4,3
20081019-M-Madrid_Masters-F-Gilles_Simon-Andy_Murray,1,B-XC,72,10,5,1,4,38,34
20081019-M-Madrid_Masters-F-Gilles_Simon-Andy_Murray,1,B-DTM,42,3,0,1,2,25,17
20081019-M-Madrid_Masters-F-Gilles_Simon-Andy_Murray,1,B-DTL,17,5,2,0,3,6,11
20081019-M-Madrid_Masters-F-Gilles_Simon-Andy_Murray,1,B-IO,4,0,0,0,0,3,1
20081019-M-Madrid_Masters-F-Gilles_Simon-Andy_Murray,1,S-DTM,1,0,0,0,0,0,1
20081019-M-Madrid_Masters-F-Gilles_Simon-Andy_Murray,2,F-XC,61,6,0,2,4,27,34
20081019-M-Madrid_Masters-F-Gilles_Simon-Andy_Murray,2,F-DTM,54,5,1,1,3,28,26
20081019-M-Madrid_Masters-F-Gilles_Simon-Andy_Murray,2,F-DTL,15,3,0,1,2,6,9
20081019-M-Madrid_Masters-F-Gilles_Simon-Andy_Murray,2,F-IO,19,6,1,4,1,14,5
20081019-M-Madrid_Masters-F-Gilles_Simon-Andy_Murray,2,B-XC,26,7,0,3,4,15,11
20081019-M-Madrid_Masters-F-Gilles_Simon-Andy_Murray,2,B-DTM,25,1,0,0,1,13,12
20081019-M-Madrid_Masters-F-Gilles_Simon-Andy_Murray,2,B-DTL,10,6,1,1,4,4,6
20081019-M-Madrid_Masters-F-Gilles_Simon-Andy_Murray,2,B-IO,6,1,1,0,0,3,3
20081019-M-Madrid_Masters-F-Gilles_Simon-Andy_Murray,2,S-XC,34,1,0,0,1,10,24
20081019-M-Madrid_Masters-F-Gilles_Simon-Andy_Murray,2,S-DTM,24,1,0,0,1,12,12
20081019-M-Madrid_Masters-F-Gilles_Simon-Andy_Murray,2,S-DTL,7,1,0,1,0,3,4
20081019-M-Madrid_Masters-F-Gilles_Simon-Andy_Murray,2,S-IO,6,0,0,0,0,2,4
20020519-M-Hamburg_Masters-F-Roger_Federer-Marat_Safin,1,F-XC,46,12,4,4,4,24,22
20020519-M-Hamburg_Masters-F-Roger_Federer-Marat_Safin,1,F-DTM,29,4,1,2,1,17,12
20020519-M-Hamburg_Masters-F-Roger_Federer-Marat_Safin,1,F-DTL,18,7,4,2,1,12,6
20020519-M-Hamburg_Masters-F-Roger_Federer-Marat_Safin,1,F-IO,19,4,1,1,2,12,7
20020519-M-Hamburg_Masters-F-Roger_Federer-Marat_Safin,1,F-II,2,1,0,0,1,1,1
20020519-M-Hamburg_Masters-F-Roger_Federer-Marat_Safin,1,B-XC,29,5,1,2,2,13,16
20020519-M-Hamburg_Masters-F-Roger_Federer-Marat_Safin,1,B-DTM,37,3,0,1,2,20,17
20020519-M-Hamburg_Masters-F-Roger_Federer-Marat_Safin,1,B-DTL,20,9,3,3,3,12,8
20020519-M-Hamburg_Masters-F-Roger_Federer-Marat_Safin,1,B-IO,5,3,1,1,1,3,2
20020519-M-Hamburg_Masters-F-Roger_Federer-Marat_Safin,1,S-XC,22,4,0,0,4,11,11
20020519-M-Hamburg_Masters-F-Roger_Federer-Marat_Safin,1,S-DTM,27,3,0,0,3,15,12
20020519-M-Hamburg_Masters-F-Roger_Federer-Marat_Safin,1,S-DTL,7,1,0,1,0,3,4
20020519-M-Hamburg_Masters-F-Roger_Federer-Marat_Safin,1,S-IO,2,1,0,1,0,2,0
20020519-M-Hamburg_Masters-F-Roger_Federer-Marat_Safin,2,F-XC,47,8,0,1,7,19,28
20020519-M-Hamburg_Masters-F-Roger_Federer-Marat_Safin,2,F-DTM,36,2,0,0,2,16,20
20020519-M-Hamburg_Masters-F-Roger_Federer-Marat_Safin,2,F-DTL,15,2,1,1,0,9,6
20020519-M-Hamburg_Masters-F-Roger_Federer-Marat_Safin,2,F-IO,20,5,2,1,2,7,13
20020519-M-Hamburg_Masters-F-Roger_Federer-Marat_Safin,2,B-XC,93,15,3,3,9,48,45
20020519-M-Hamburg_Masters-F-Roger_Federer-Marat_Safin,2,B-DTM,33,5,0,1,4,12,21
20020519-M-Hamburg_Masters-F-Roger_Federer-Marat_Safin,2,B-DTL,10,7,1,0,6,1,9
20020519-M-Hamburg_Masters-F-Roger_Federer-Marat_Safin,2,B-IO,4,1,1,0,0,3,1
20020519-M-Hamburg_Masters-F-Roger_Federer-Marat_Safin,2,S-XC,7,0,0,0,0,3,4
20020519-M-Hamburg_Masters-F-Roger_Federer-Marat_Safin,2,S-DTM,4,0,0,0,0,2,2
20020519-M-Hamburg_Masters-F-Roger_Federer-Marat_Safin,2,S-DTL,2,0,0,0,0,1,1
20020519-M-Hamburg_Masters-F-Roger_Federer-Marat_Safin,2,S-IO,1,1,0,1,0,1,0
20071021-M-Madrid_Masters-F-Roger_Federer-David_Nalbandian,1,F-XC,26,12,4,1,7,12,14
20071021-M-Madrid_Masters-F-Roger_Federer-David_Nalbandian,1,F-DTM,27,1,0,0,1,13,14
20071021-M-Madrid_Masters-F-Roger_Federer-David_Nalbandian,1,F-DTL,8,2,1,0,1,4,4
20071021-M-Madrid_Masters-F-Roger_Federer-David_Nalbandian,1,F-IO,20,10,1,4,5,13,7
20071021-M-Madrid_Masters-F-Roger_Federer-David_Nalbandian,1,F-II,2,1,0,1,0,2,0
20071021-M-Madrid_Masters-F-Roger_Federer-David_Nalbandian,1,B-XC,17,6,1,0,5,9,8
20071021-M-Madrid_Masters-F-Roger_Federer-David_Nalbandian,1,B-DTM,26,2,0,0,2,11,15
20071021-M-Madrid_Masters-F-Roger_Federer-David_Nalbandian,1,B-DTL,10,7,3,1,3,4,6
20071021-M-Madrid_Masters-F-Roger_Federer-David_Nalbandian,1,B-IO,5,2,1,0,1,3,2
20071021-M-Madrid_Masters-F-Roger_Federer-David_Nalbandian,1,S-XC,12,0,0,0,0,2,10
20071021-M-Madrid_Masters-F-Roger_Federer-David_Nalbandian,1,S-DTM,12,2,0,0,2,6,6
20071021-M-Madrid_Masters-F-Roger_Federer-David_Nalbandian,1,S-DTL,3,1,1,0,0,3,0
20071021-M-Madrid_Masters-F-Roger_Federer-David_Nalbandian,2,F-XC,33,8,3,2,3,17,16
20071021-M-Madrid_Masters-F-Roger_Federer-David_Nalbandian,2,F-DTM,23,1,0,0,1,11,12
20071021-M-Madrid_Masters-F-Roger_Federer-David_Nalbandian,2,F-DTL,3,1,1,0,0,2,1
20071021-M-Madrid_Masters-F-Roger_Federer-David_Nalbandian,2,F-IO,24,7,1,1,5,12,12
20071021-M-Madrid_Masters-F-Roger_Federer-David_Nalbandian,2,B-XC,35,5,0,2,3,19,16
20071021-M-Madrid_Masters-F-Roger_Federer-David_Nalbandian,2,B-DTM,24,3,1,0,2,10,14
20071021-M-Madrid_Masters-F-Roger_Federer-David_Nalbandian,2,B-DTL,9,4,0,0,4,1,8
20071021-M-Madrid_Masters-F-Roger_Federer-David_Nalbandian,2,B-IO,7,2,1,1,0,5,2
20071021-M-Madrid_Masters-F-Roger_Federer-David_Nalbandian,2,S-XC,2,0,0,0,0,1,1
20071021-M-Madrid_Masters-F-Roger_Federer-David_Nalbandian,2,S-DTL,1,0,0,0,0,1,0
20060326-M-Miami_Masters-F-Roger_Federer-Ivan_Ljubicic,1,F-XC,48,21,9,6,6,28,20
20060326-M-Miami_Masters-F-Roger_Federer-Ivan_Ljubicic,1,F-DTM,44,3,1,1,1,27,17
20060326-M-Miami_Masters-F-Roger_Federer-Ivan_Ljubicic,1,F-DTL,12,4,0,0,4,4,8
20060326-M-Miami_Masters-F-Roger_Federer-Ivan_Ljubicic,1,F-IO,33,12,6,5,1,26,7
20060326-M-Miami_Masters-F-Roger_Federer-Ivan_Ljubicic,1,F-II,8,2,0,1,1,5,3
20060326-M-Miami_Masters-F-Roger_Federer-Ivan_Ljubicic,1,B-XC,28,7,0,1,6,12,16
20060326-M-Miami_Masters-F-Roger_Federer-Ivan_Ljubicic,1,B-DTM,41,5,0,0,5,21,20
20060326-M-Miami_Masters-F-Roger_Federer-Ivan_Ljubicic,1,B-DTL,14,11,5,1,5,7,7
20060326-M-Miami_Masters-F-Roger_Federer-Ivan_Ljubicic,1,B-IO,4,2,1,0,1,3,1
20060326-M-Miami_Masters-F-Roger_Federer-Ivan_Ljubicic,1,S-XC,19,0,0,0,0,14,5
20060326-M-Miami_Masters-F-Roger_Federer-Ivan_Ljubicic,1,S-DTM,8,2,0,0,2,3,5
20060326-M-Miami_Masters-F-Roger_Federer-Ivan_Ljubicic,1,S-DTL,6,1,0,1,0,5,1
20060326-M-Miami_Masters-F-Roger_Federer-Ivan_Ljubicic,1,S-IO,1,1,0,0,1,0,1
20060326-M-Miami_Masters-F-Roger_Federer-Ivan_Ljubicic,2,F-XC,45,14,6,1,7,27,18
20060326-M-Miami_Masters-F-Roger_Federer-Ivan_Ljubicic,2,F-DTM,32,3,1,0,2,10,22
20060326-M-Miami_Masters-F-Roger_Federer-Ivan_Ljubicic,2,F-DTL,13,3,1,1,1,7,6
20060326-M-Miami_Masters-F-Roger_Federer-Ivan_Ljubicic,2,F-IO,27,1,0,0,1,9,18
20060326-M-Miami_Masters-F-Roger_Federer-Ivan_Ljubicic,2,F-II,3,1,0,0,1,0,3
20060326-M-Miami_Masters-F-Roger_Federer-Ivan_Ljubicic,2,B-XC,47,11,1,1,9,24,23
20060326-M-Miami_Masters-F-Roger_Federer-Ivan_Ljubicic,2,B-DTM,32,3,0,0,3,10,22
20060326-M-Miami_Masters-F-Roger_Federer-Ivan_Ljubicic,2,B-DTL,10,5,0,2,3,3,7
20060326-M-Miami_Masters-F-Roger_Federer-Ivan_Ljubicic,2,B-IO,14,5,0,1,4,6,8
20060326-M-Miami_Masters-F-Roger_Federer-Ivan_Ljubicic,2,S-XC,15,0,0,0,0,6,9
20060326-M-Miami_Masters-F-Roger_Federer-Ivan_Ljubicic,2,S-DTM,11,2,0,0,2,5,6
20170716-M-Wimbledon-F-Marin_Cilic-Roger_Federer,1,F-XC,14,7,2,3,2,10,4
20170716-M-Wimbledon-F-Marin_Cilic-Roger_Federer,1,F-DTM,7,1,0,0,1,2,5
20170716-M-Wimbledon-F-Marin_Cilic-Roger_Federer,1,F-DTL,2,1,0,1,0,2,0
20170716-M-Wimbledon-F-Marin_Cilic-Roger_Federer,1,F-IO,15,9,2,1,6,6,9
20170716-M-Wimbledon-F-Marin_Cilic-Roger_Federer,1,F-II,1,1,1,0,0,1,0
20170716-M-Wimbledon-F-Marin_Cilic-Roger_Federer,1,B-XC,27,8,0,3,5,14,13
20170716-M-Wimbledon-F-Marin_Cilic-Roger_Federer,1,B-DTM,9,3,0,2,1,6,3
20170716-M-Wimbledon-F-Marin_Cilic-Roger_Federer,1,B-DTL,3,2,1,0,1,1,2
20170716-M-Wimbledon-F-Marin_Cilic-Roger_Federer,1,B-IO,3,2,0,1,1,2,1
20170716-M-Wimbledon-F-Marin_Cilic-Roger_Federer,1,S-XC,4,0,0,0,0,2,2
20170716-M-Wimbledon-F-Marin_Cilic-Roger_Federer,1,S-DTM,1,0,0,0,0,0,1
20170716-M-Wimbledon-F-Marin_Cilic-Roger_Federer,2,F-XC,12,7,2,4,1,6,6
20170716-M-Wimbledon-F-Marin_Cilic-Roger_Federer,2,F-DTM,14,1,0,1,0,8,6
20170716-M-Wimbledon-F-Marin_Cilic-Roger_Federer,2,F-DTL,5,0,0,0,0,1,4
20170716-M-Wimbledon-F-Marin_Cilic-Roger_Federer,2,F-IO,5,3,1,1,1,4,1
20170716-M-Wimbledon-F-Marin_Cilic-Roger_Federer,2,F-II,1,1,1,0,0,1,0
20170716-M-Wimbledon-F-Marin_Cilic-Roger_Federer,2,B-XC,10,3,2,1,0,7,3
20170716-M-Wimbledon-F-Marin_Cilic-Roger_Federer,2,B-DTM,13,5,0,2,3,5,8
20170716-M-Wimbledon-F-Marin_Cilic-Roger_Federer,2,B-DTL,7,7,0,6,1,6,1
20170716-M-Wimbledon-F-Marin_Cilic-Roger_Federer,2,S-XC,3,1,0,1,0,1,2
20170716-M-Wimbledon-F-Marin_Cilic-Roger_Federer,2,S-DTM,3,0,0,0,0,0,3
20170716-M-Wimbledon-F-Marin_Cilic-Roger_Federer,2,S-DTL,2,1,1,0,0,1,1
20140611-M-Halle-R16-Pierre_Hugues_Herbert-Philipp_Kohlschreiber,1,F-XC,10,2,0,0,2,3,7
20140611-M-Halle-R16-Pierre_Hugues_Herbert-Philipp_Kohlschreiber,1,F-DTM,10,1,0,0,1,2,8
20140611-M-Halle-R16-Pierre_Hugues_Herbert-Philipp_Kohlschreiber,1,F-DTL,5,4,1,0,3,1,4
20140611-M-Halle-R16-Pierre_Hugues_Herbert-Philipp_Kohlschreiber,1,F-IO,6,3,0,1,2,3,3
20140611-M-Halle-R16-Pierre_Hugues_Herbert-Philipp_Kohlschreiber,1,F-II,3,1,1,0,0,2,1
20140611-M-Halle-R16-Pierre_Hugues_Herbert-Philipp_Kohlschreiber,1,B-XC,7,2,1,0,1,3,4
20140611-M-Halle-R16-Pierre_Hugues_Herbert-Philipp_Kohlschreiber,1,B-DTM,1,0,0,0,0,1,0
20140611-M-Halle-R16-Pierre_Hugues_Herbert-Philipp_Kohlschreiber,1,B-DTL,5,3,1,0,2,2,3
20140611-M-Halle-R16-Pierre_Hugues_Herbert-Philipp_Kohlschreiber,1,S-XC,10,1,0,0,1,2,8
20140611-M-Halle-R16-Pierre_Hugues_Herbert-Philipp_Kohlschreiber,1,S-DTM,1,0,0,0,0,0,1
20140611-M-Halle-R16-Pierre_Hugues_Herbert-Philipp_Kohlschreiber,2,F-XC,11,3,1,2,0,9,2
20140611-M-Halle-R16-Pierre_Hugues_Herbert-Philipp_Kohlschreiber,2,F-DTM,5,0,0,0,0,5,0
20140611-M-Halle-R16-Pierre_Hugues_Herbert-Philipp_Kohlschreiber,2,F-DTL,7,2,1,1,0,4,3
20140611-M-Halle-R16-Pierre_Hugues_Herbert-Philipp_Kohlschreiber,2,F-IO,9,3,2,0,1,7,2
20140611-M-Halle-R16-Pierre_Hugues_Herbert-Philipp_Kohlschreiber,2,F-II,1,0,0,0,0,1,0
20140611-M-Halle-R16-Pierre_Hugues_Herbert-Philipp_Kohlschreiber,2,B-XC,6,3,2,0,1,4,2
20140611-M-Halle-R16-Pierre_Hugues_Herbert-Philipp_Kohlschreiber,2,B-DTM,4,0,0,0,0,4,0
20140611-M-Halle-R16-Pierre_Hugues_Herbert-Philipp_Kohlschreiber,2,B-DTL,6,2,1,0,1,2,4
20140611-M-Halle-R16-Pierre_Hugues_Herbert-Philipp_Kohlschreiber,2,B-IO,2,1,0,1,0,1,1
20140611-M-Halle-R16-Pierre_Hugues_Herbert-Philipp_Kohlschreiber,2,S-XC,7,0,0,0,0,5,2
20140611-M-Halle-R16-Pierre_Hugues_Herbert-Philipp_Kohlschreiber,2,S-DTL,2,0,0,0,0,2,0
20170621-M-Queens_Club-R16-Tomas_Berdych-Denis_Shapovalov,1,F-XC,33,11,5,4,2,21,12
20170621-M-Queens_Club-R16-Tomas_Berdych-Denis_Shapovalov,1,F-DTM,13,2,0,1,1,10,3
20170621-M-Queens_Club-R16-Tomas_Berdych-Denis_Shapovalov,1,F-DTL,5,3,1,1,1,3,2
20170621-M-Queens_Club-R16-Tomas_Berdych-Denis_Shapovalov,1,F-IO,18,12,4,6,2,13,5
20170621-M-Queens_Club-R16-Tomas_Berdych-Denis_Shapovalov,1,F-II,3,2,2,0,0,2,1
20170621-M-Queens_Club-R16-Tomas_Berdych-Denis_Shapovalov,1,B-XC,9,4,1,3,0,8,1
20170621-M-Queens_Club-R16-Tomas_Berdych-Denis_Shapovalov,1,B-DTM,13,4,0,1,3,8,5
20170621-M-Queens_Club-R16-Tomas_Berdych-Denis_Shapovalov,1,B-DTL,7,1,0,1,0,5,2
20170621-M-Queens_Club-R16-Tomas_Berdych-Denis_Shapovalov,1,B-IO,3,0,0,0,0,2,1
20170621-M-Queens_Club-R16-Tomas_Berdych-Denis_Shapovalov,1,S-XC,1,0,0,0,0,0,1
20170621-M-Queens_Club-R16-Tomas_Berdych-Denis_Shapovalov,1,S-DTM,2,0,0,0,0,0,2
20170621-M-Queens_Club-R16-Tomas_Berdych-Denis_Shapovalov,1,S-DTL,5,2,0,2,0,2,3
20170621-M-Queens_Club-R16-Tomas_Berdych-Denis_Shapovalov,1,S-IO,1,0,0,0,0,1,0
20170621-M-Queens_Club-R16-Tomas_Berdych-Denis_Shapovalov,2,F-XC,26,8,3,3,2,13,13
20170621-M-Queens_Club-R16-Tomas_Berdych-Denis_Shapovalov,2,F-DTM,10,2,1,1,0,4,6
20170621-M-Queens_Club-R16-Tomas_Berdych-Denis_Shapovalov,2,F-DTL,7,6,4,0,2,4,3
20170621-M-Queens_Club-R16-Tomas_Berdych-Denis_Shapovalov,2,F-IO,14,10,6,1,3,9,5
20170621-M-Queens_Club-R16-Tomas_Berdych-Denis_Shapovalov,2,F-II,1,1,1,0,0,1,0
20170621-M-Queens_Club-R16-Tomas_Berdych-Denis_Shapovalov,2,B-XC,19,10,4,1,5,9,10
20170621-M-Queens_Club-R16-Tomas_Berdych-Denis_Shapovalov,2,B-DTM,14,3,0,1,2,6,8
20170621-M-Queens_Club-R16-Tomas_Berdych-Denis_Shapovalov,2,B-DTL,9,3,2,1,0,6,3
20170621-M-Queens_Club-R16-Tomas_Berdych-Denis_Shapovalov,2,B-IO,2,0,0,0,0,1,1
20170621-M-Queens_Club-R16-Tomas_Berdych-Denis_Shapovalov,2,S-XC,4,2,0,1,1,2,2
20170621-M-Queens_Club-R16-Tomas_Berdych-Denis_Shapovalov,2,S-DTM,3,0,0,0,0,0,3
20170621-M-Queens_Club-R16-Tomas_Berdych-Denis_Shapovalov,2,S-DTL,3,1,0,1,0,3,0
20050515-M-Hamburg_Masters-F-Roger_Federer-Richard_Gasquet,1,F-XC,47,16,5,6,5,28,19
20050515-M-Hamburg_Masters-F-Roger_Federer-Richard_Gasquet,1,F-DTM,24,2,0,0,2,13,11
20050515-M-Hamburg_Masters-F-Roger_Federer-Richard_Gasquet,1,F-DTL,7,4,0,1,3,3,4
20050515-M-Hamburg_Masters-F-Roger_Federer-Richard_Gasquet,1,F-IO,21,8,5,1,2,11,10
20050515-M-Hamburg_Masters-F-Roger_Federer-Richard_Gasquet,1,F-II,6,2,1,0,1,1,5
20050515-M-Hamburg_Masters-F-Roger_Federer-Richard_Gasquet,1,B-XC,35,4,0,1,3,16,19
20050515-M-Hamburg_Masters-F-Roger_Federer-Richard_Gasquet,1,B-DTM,38,5,0,0,5,21,17
20050515-M-Hamburg_Masters-F-Roger_Federer-Richard_Gasquet,1,B-DTL,10,5,1,1,3,6,4
20050515-M-Hamburg_Masters-F-Roger_Federer-Richard_Gasquet,1,S-XC,9,1,0,1,0,7,2
20050515-M-Hamburg_Masters-F-Roger_Federer-Richard_Gasquet,1,S-DTM,6,0,0,0,0,1,5
20050515-M-Hamburg_Masters-F-Roger_Federer-Richard_Gasquet,1,S-DTL,3,1,0,0,1,2,1
20050515-M-Hamburg_Masters-F-Roger_Federer-Richard_Gasquet,2,F-XC,31,8,2,0,6,14,17
20050515-M-Hamburg_Masters-F-Roger_Federer-Richard_Gasquet,2,F-DTM,33,3,1,0,2,19,14
20050515-M-Hamburg_Masters-F-Roger_Federer-Richard_Gasquet,2,F-DTL,11,4,1,2,1,5,6
20050515-M-Hamburg_Masters-F-Roger_Federer-Richard_Gasquet,2,F-IO,20,6,2,2,2,10,10
20050515-M-Hamburg_Masters-F-Roger_Federer-Richard_Gasquet,2,B-XC,70,13,2,4,7,38,32
20050515-M-Hamburg_Masters-F-Roger_Federer-Richard_Gasquet,2,B-DTM,21,1,0,0,1,8,13
20050515-M-Hamburg_Masters-F-Roger_Federer-Richard_Gasquet,2,B-DTL,10,6,2,1,3,5,5
20050515-M-Hamburg_Masters-F-Roger_Federer-Richard_Gasquet,2,B-IO,2,2,1,1,0,2,0
20050515-M-Hamburg_Masters-F-Roger_Federer-Richard_Gasquet,2,S-XC,4,0,0,0,0,1,3
20050515-M-Hamburg_Masters-F-Roger_Federer-Richard_Gasquet,2,S-DTM,3,0,0,0,0,3,0
20050515-M-Hamburg_Masters-F-Roger_Federer-Richard_Gasquet,2,S-DTL,4,1,0,1,0,4,0
20070325-M-Miami_Masters-F-Novak_Djokovic-Guillermo_Canas,1,F-XC,67,15,5,2,8,44,23
20070325-M-Miami_Masters-F-Novak_Djokovic-Guillermo_Canas,1,F-DTM,44,0,0,0,0,27,17
20070325-M-Miami_Masters-F-Novak_Djokovic-Guillermo_Canas,1,F-DTL,17,11,5,2,4,10,7
20070325-M-Miami_Masters-F-Novak_Djokovic-Guillermo_Canas,1,F-IO,48,6,4,0,2,32,16
20070325-M-Miami_Masters-F-Novak_Djokovic-Guillermo_Canas,1,F-II,3,1,0,1,0,2,1
20070325-M-Miami_Masters-F-Novak_Djokovic-Guillermo_Canas,1,B-XC,84,6,3,2,1,56,28
20070325-M-Miami_Masters-F-Novak_Djokovic-Guillermo_Canas,1,B-DTM,50,2,0,0,2,31,19
20070325-M-Miami_Masters-F-Novak_Djokovic-Guillermo_Canas,1,B-DTL,24,12,5,2,5,15,9
20070325-M-Miami_Masters-F-Novak_Djokovic-Guillermo_Canas,1,B-IO,7,3,0,2,1,4,3
20070325-M-Miami_Masters-F-Novak_Djokovic-Guillermo_Canas,1,S-XC,7,2,0,0,2,2,5
20070325-M-Miami_Masters-F-Novak_Djokovic-Guillermo_Canas,1,S-DTM,7,0,0,0,0,3,4
20070325-M-Miami_Masters-F-Novak_Djokovic-Guillermo_Canas,1,S-IO,1,0,0,0,0,1,0
20070325-M-Miami_Masters-F-Novak_Djokovic-Guillermo_Canas,2,F-XC,62,14,3,3,8,24,38
20070325-M-Miami_Masters-F-Novak_Djokovic-Guillermo_Canas,2,F-DTM,65,2,0,1,1,25,40
20070325-M-Miami_Masters-F-Novak_Djokovic-Guillermo_Canas,2,F-DTL,13,2,1,1,0,5,8
20070325-M-Miami_Masters-F-Novak_Djokovic-Guillermo_Canas,2,F-IO,54,6,2,1,3,19,35
20070325-M-Miami_Masters-F-Novak_Djokovic-Guillermo_Canas,2,F-II,9,2,1,1,0,6,3
20070325-M-Miami_Masters-F-Novak_Djokovic-Guillermo_Canas,2,B-XC,55,6,1,1,4,25,30
20070325-M-Miami_Masters-F-Novak_Djokovic-Guillermo_Canas,2,B-DTM,68,3,0,1,2,27,41
20070325-M-Miami_Masters-F-Novak_Djokovic-Guillermo_Canas,2,B-DTL,3,1,1,0,0,1,2
20070325-M-Miami_Masters-F-Novak_Djokovic-Guillermo_Canas,2,S-XC,8,1,1,0,0,2,6
20070325-M-Miami_Masters-F-Novak_Djokovic-Guillermo_Canas,2,S-DTM,9,1,0,0,1,3,6
20101112-M-Paris_Masters-F-Robin_Soderling-Gael_Monfils,1,F-XC,15,5,3,1,1,12,3
20101112-M-Paris_Masters-F-Robin_Soderling-Gael_Monfils,1,F-DTM,19,2,0,1,1,12,7
20101112-M-Paris_Masters-F-Robin_Soderling-Gael_Monfils,1,F-DTL,5,0,0,0,0,2,3
20101112-M-Paris_Masters-F-Robin_Soderling-Gael_Monfils,1,F-IO,38,14,4,6,4,25,13
20101112-M-Paris_Masters-F-Robin_Soderling-Gael_Monfils,1,F-II,1,0,0,0,0,0,1
20101112-M-Paris_Masters-F-Robin_Soderling-Gael_Monfils,1,B-XC,16,3,1,0,2,8,8
20101112-M-Paris_Masters-F-Robin_Soderling-Gael_Monfils,1,B-DTM,22,2,0,0,2,11,11
20101112-M-Paris_Masters-F-Robin_Soderling-Gael_Monfils,1,B-DTL,6,5,1,1,3,3,3
20101112-M-Paris_Masters-F-Robin_Soderling-Gael_Monfils,1,B-IO,5,3,0,3,0,4,1
20101112-M-Paris_Masters-F-Robin_Soderling-Gael_Monfils,2,F-XC,14,6,2,1,3,7,7
20101112-M-Paris_Masters-F-Robin_Soderling-Gael_Monfils,2,F-DTM,26,4,0,0,4,6,20
20101112-M-Paris_Masters-F-Robin_Soderling-Gael_Monfils,2,F-DTL,2,0,0,0,0,0,2
20101112-M-Paris_Masters-F-Robin_Soderling-Gael_Monfils,2,F-IO,4,0,0,0,0,0,4
20101112-M-Paris_Masters-F-Robin_Soderling-Gael_Monfils,2,B-XC,28,1,0,0,1,17,11
20101112-M-Paris_Masters-F-Robin_Soderling-Gael_Monfils,2,B-DTM,27,3,0,0,3,10,17
20101112-M-Paris_Masters-F-Robin_Soderling-Gael_Monfils,2,B-DTL,3,1,1,0,0,1,2
20101112-M-Paris_Masters-F-Robin_Soderling-Gael_Monfils,2,B-IO,2,1,0,1,0,1,1
20101112-M-Paris_Masters-F-Robin_Soderling-Gael_Monfils,2,S-XC,2,0,0,0,0,2,0
20101112-M-Paris_Masters-F-Robin_Soderling-Gael_Monfils,2,S-DTM,1,0,0,0,0,0,1
20101112-M-Paris_Masters-F-Robin_Soderling-Gael_Monfils,2,S-DTL,2,1,1,0,0,1,1
20170710-M-Wimbledon-R16-Grigor_Dimitrov-Roger_Federer,1,F-XC,31,9,4,2,3,16,15
20170710-M-Wimbledon-R16-Grigor_Dimitrov-Roger_Federer,1,F-DTM,11,0,0,0,0,5,6
20170710-M-Wimbledon-R16-Grigor_Dimitrov-Roger_Federer,1,F-DTL,7,4,2,0,2,3,4
20170710-M-Wimbledon-R16-Grigor_Dimitrov-Roger_Federer,1,F-IO,28,14,4,3,7,15,13
20170710-M-Wimbledon-R16-Grigor_Dimitrov-Roger_Federer,1,F-II,3,2,1,0,1,2,1
20170710-M-Wimbledon-R16-Grigor_Dimitrov-Roger_Federer,1,B-XC,18,8,2,0,6,7,11
20170710-M-Wimbledon-R16-Grigor_Dimitrov-Roger_Federer,1,B-DTM,13,4,0,0,4,5,8
20170710-M-Wimbledon-R16-Grigor_Dimitrov-Roger_Federer,1,B-DTL,4,3,3,0,0,3,1
20170710-M-Wimbledon-R16-Grigor_Dimitrov-Roger_Federer,1,S-XC,4,1,0,0,1,2,2
20170710-M-Wimbledon-R16-Grigor_Dimitrov-Roger_Federer,1,S-DTM,4,2,0,0,2,0,4
20170710-M-Wimbledon-R16-Grigor_Dimitrov-Roger_Federer,1,S-DTL,1,0,0,0,0,0,1
20170710-M-Wimbledon-R16-Grigor_Dimitrov-Roger_Federer,1,S-IO,1,0,0,0,0,0,1
20170710-M-Wimbledon-R16-Grigor_Dimitrov-Roger_Federer,2,F-XC,20,11,2,6,3,13,7
20170710-M-Wimbledon-R16-Grigor_Dimitrov-Roger_Federer,2,F-DTM,21,0,0,0,0,11,10
20170710-M-Wimbledon-R16-Grigor_Dimitrov-Roger_Federer,2,F-DTL,12,2,1,0,1,9,3
20170710-M-Wimbledon-R16-Grigor_Dimitrov-Roger_Federer,2,F-IO,10,3,0,1,2,4,6
20170710-M-Wimbledon-R16-Grigor_Dimitrov-Roger_Federer,2,F-II,3,2,1,1,0,2,1
20170710-M-Wimbledon-R16-Grigor_Dimitrov-Roger_Federer,2,B-XC,10,5,0,0,5,2,8
20170710-M-Wimbledon-R16-Grigor_Dimitrov-Roger_Federer,2,B-DTM,11,2,0,1,1,7,4
20170710-M-Wimbledon-R16-Grigor_Dimitrov-Roger_Federer,2,B-DTL,7,4,2,1,1,4,3
20170710-M-Wimbledon-R16-Grigor_Dimitrov-Roger_Federer,2,B-IO,2,2,1,0,1,1,1
20170710-M-Wimbledon-R16-Grigor_Dimitrov-Roger_Federer,2,S-XC,3,0,0,0,0,2,1
20170710-M-Wimbledon-R16-Grigor_Dimitrov-Roger_Federer,2,S-DTM,4,0,0,0,0,3,1
20170710-M-Wimbledon-R16-Grigor_Dimitrov-Roger_Federer,2,S-DTL,2,1,0,0,1,0,2
20100502-M-Rome_Masters-F-David_Ferrer-Rafael_Nadal,1,F-XC,67,12,3,3,6,22,45
20100502-M-Rome_Masters-F-David_Ferrer-Rafael_Nadal,1,F-DTM,30,3,0,1,2,7,23
20100502-M-Rome_Masters-F-David_Ferrer-Rafael_Nadal,1,F-DTL,4,0,0,0,0,1,3
20100502-M-Rome_Masters-F-David_Ferrer-Rafael_Nadal,1,F-IO,31,9,2,2,5,12,19
20100502-M-Rome_Masters-F-David_Ferrer-Rafael_Nadal,1,F-II,12,5,0,3,2,5,7
20100502-M-Rome_Masters-F-David_Ferrer-Rafael_Nadal,1,B-XC,50,8,3,3,2,17,33
20100502-M-Rome_Masters-F-David_Ferrer-Rafael_Nadal,1,B-DTM,39,0,0,0,0,21,18
20100502-M-Rome_Masters-F-David_Ferrer-Rafael_Nadal,1,B-DTL,9,3,0,1,2,2,7
20100502-M-Rome_Masters-F-David_Ferrer-Rafael_Nadal,1,B-IO,5,1,0,0,1,0,5
20100502-M-Rome_Masters-F-David_Ferrer-Rafael_Nadal,1,S-XC,2,0,0,0,0,0,2
20100502-M-Rome_Masters-F-David_Ferrer-Rafael_Nadal,1,S-DTM,3,0,0,0,0,0,3
20100502-M-Rome_Masters-F-David_Ferrer-Rafael_Nadal,1,S-DTL,3,1,0,0,1,1,2
20100502-M-Rome_Masters-F-David_Ferrer-Rafael_Nadal,2,F-XC,84,12,4,5,3,58,26
20100502-M-Rome_Masters-F-David_Ferrer-Rafael_Nadal,2,F-DTM,23,1,0,0,1,14,9
20100502-M-Rome_Masters-F-David_Ferrer-Rafael_Nadal,2,F-DTL,19,8,3,3,2,16,3
20100502-M-Rome_Masters-F-David_Ferrer-Rafael_Nadal,2,F-IO,15,5,3,1,1,7,8
20100502-M-Rome_Masters-F-David_Ferrer-Rafael_Nadal,2,F-II,4,0,0,0,0,3,1
20100502-M-Rome_Masters-F-David_Ferrer-Rafael_Nadal,2,B-XC,30,6,1,2,3,24,6
20100502-M-Rome_Masters-F-David_Ferrer-Rafael_Nadal,2,B-DTM,36,2,1,1,0,25,11
20100502-M-Rome_Masters-F-David_Ferrer-Rafael_Nadal,2,B-DTL,19,3,2,0,1,12,7
20100502-M-Rome_Masters-F-David_Ferrer-Rafael_Nadal,2,B-IO,5,0,0,0,0,3,2
20100502-M-Rome_Masters-F-David_Ferrer-Rafael_Nadal,2,S-XC,1,0,0,0,0,1,0
20100502-M-Rome_Masters-F-David_Ferrer-Rafael_Nadal,2,S-DTM,6,0,0,0,0,4,2
20100502-M-Rome_Masters-F-David_Ferrer-Rafael_Nadal,2,S-DTL,4,0,0,0,0,3,1
20100502-M-Rome_Masters-F-David_Ferrer-Rafael_Nadal,2,S-IO,2,0,0,0,0,1,1
20081102-M-Paris_Masters-F-Jo_Wilfried_Tsonga-David_Nalbandian,1,F-XC,28,10,3,5,2,18,10
20081102-M-Paris_Masters-F-Jo_Wilfried_Tsonga-David_Nalbandian,1,F-DTM,30,7,0,0,7,10,20
20081102-M-Paris_Masters-F-Jo_Wilfried_Tsonga-David_Nalbandian,1,F-DTL,8,5,0,0,5,2,6
20081102-M-Paris_Masters-F-Jo_Wilfried_Tsonga-David_Nalbandian,1,F-IO,18,9,3,2,4,13,5
20081102-M-Paris_Masters-F-Jo_Wilfried_Tsonga-David_Nalbandian,1,F-II,4,2,1,1,0,3,1
20081102-M-Paris_Masters-F-Jo_Wilfried_Tsonga-David_Nalbandian,1,B-XC,19,3,0,2,1,8,11
20081102-M-Paris_Masters-F-Jo_Wilfried_Tsonga-David_Nalbandian,1,B-DTM,23,3,0,0,3,9,14
20081102-M-Paris_Masters-F-Jo_Wilfried_Tsonga-David_Nalbandian,1,B-DTL,13,4,1,0,3,5,8
20081102-M-Paris_Masters-F-Jo_Wilfried_Tsonga-David_Nalbandian,1,B-IO,1,0,0,0,0,1,0
20081102-M-Paris_Masters-F-Jo_Wilfried_Tsonga-David_Nalbandian,1,S-XC,9,1,1,0,0,1,8
20081102-M-Paris_Masters-F-Jo_Wilfried_Tsonga-David_Nalbandian,1,S-DTM,3,0,0,0,0,1,2
20081102-M-Paris_Masters-F-Jo_Wilfried_Tsonga-David_Nalbandian,1,S-DTL,2,0,0,0,0,0,2
20081102-M-Paris_Masters-F-Jo_Wilfried_Tsonga-David_Nalbandian,1,S-IO,1,0,0,0,0,0,1
20081102-M-Paris_Masters-F-Jo_Wilfried_Tsonga-David_Nalbandian,2,F-XC,31,7,2,1,4,18,13
20081102-M-Paris_Masters-F-Jo_Wilfried_Tsonga-David_Nalbandian,2,F-DTM,28,0,0,0,0,15,13
20081102-M-Paris_Masters-F-Jo_Wilfried_Tsonga-David_Nalbandian,2,F-DTL,7,1,0,0,1,2,5
20081102-M-Paris_Masters-F-Jo_Wilfried_Tsonga-David_Nalbandian,2,F-IO,21,9,0,5,4,12,9
20081102-M-Paris_Masters-F-Jo_Wilfried_Tsonga-David_Nalbandian,2,F-II,1,0,0,0,0,1,0
20081102-M-Paris_Masters-F-Jo_Wilfried_Tsonga-David_Nalbandian,2,B-XC,32,5,1,2,2,24,8
20081102-M-Paris_Masters-F-Jo_Wilfried_Tsonga-David_Nalbandian,2,B-DTM,13,2,1,0,1,3,10
20081102-M-Paris_Masters-F-Jo_Wilfried_Tsonga-David_Nalbandian,2,B-DTL,11,5,2,2,1,7,4
20081102-M-Paris_Masters-F-Jo_Wilfried_Tsonga-David_Nalbandian,2,B-IO,4,2,0,1,1,2,2
20081102-M-Paris_Masters-F-Jo_Wilfried_Tsonga-David_Nalbandian,2,S-XC,3,1,1,0,0,1,2
20081102-M-Paris_Masters-F-Jo_Wilfried_Tsonga-David_Nalbandian,2,S-DTM,5,0,0,0,0,2,3
20021117-M-Masters_Cup-F-Lleyton_Hewitt-Juan_Carlos_Ferrero,1,F-XC,117,24,4,6,14,65,52
20021117-M-Masters_Cup-F-Lleyton_Hewitt-Juan_Carlos_Ferrero,1,F-DTM,50,3,0,1,2,25,25
20021117-M-Masters_Cup-F-Lleyton_Hewitt-Juan_Carlos_Ferrero,1,F-DTL,42,13,5,3,5,26,16
20021117-M-Masters_Cup-F-Lleyton_Hewitt-Juan_Carlos_Ferrero,1,F-IO,59,9,1,2,6,25,34
20021117-M-Masters_Cup-F-Lleyton_Hewitt-Juan_Carlos_Ferrero,1,F-II,6,4,1,1,2,3,3
20021117-M-Masters_Cup-F-Lleyton_Hewitt-Juan_Carlos_Ferrero,1,B-XC,158,18,1,6,11,87,71
20021117-M-Masters_Cup-F-Lleyton_Hewitt-Juan_Carlos_Ferrero,1,B-DTM,68,3,0,0,3,27,41
20021117-M-Masters_Cup-F-Lleyton_Hewitt-Juan_Carlos_Ferrero,1,B-DTL,8,6,2,1,3,3,5
20021117-M-Masters_Cup-F-Lleyton_Hewitt-Juan_Carlos_Ferrero,1,B-IO,10,9,2,3,4,5,5
20021117-M-Masters_Cup-F-Lleyton_Hewitt-Juan_Carlos_Ferrero,1,S-XC,18,0,0,0,0,10,8
20021117-M-Masters_Cup-F-Lleyton_Hewitt-Juan_Carlos_Ferrero,1,S-DTM,10,2,0,0,2,4,6
20021117-M-Masters_Cup-F-Lleyton_Hewitt-Juan_Carlos_Ferrero,1,S-DTL,2,0,0,0,0,0,2
20021117-M-Masters_Cup-F-Lleyton_Hewitt-Juan_Carlos_Ferrero,2,F-XC,83,11,2,6,3,37,46
20021117-M-Masters_Cup-F-Lleyton_Hewitt-Juan_Carlos_Ferrero,2,F-DTM,61,4,0,1,3,28,33
20021117-M-Masters_Cup-F-Lleyton_Hewitt-Juan_Carlos_Ferrero,2,F-DTL,34,7,3,0,4,18,16
20021117-M-Masters_Cup-F-Lleyton_Hewitt-Juan_Carlos_Ferrero,2,F-IO,52,15,6,5,4,29,23
20021117-M-Masters_Cup-F-Lleyton_Hewitt-Juan_Carlos_Ferrero,2,F-II,17,4,1,3,0,8,9
20021117-M-Masters_Cup-F-Lleyton_Hewitt-Juan_Carlos_Ferrero,2,B-XC,138,11,2,4,5,74,64
20021117-M-Masters_Cup-F-Lleyton_Hewitt-Juan_Carlos_Ferrero,2,B-DTM,88,5,0,0,5,35,53
20021117-M-Masters_Cup-F-Lleyton_Hewitt-Juan_Carlos_Ferrero,2,B-DTL,30,10,2,3,5,14,16
20021117-M-Masters_Cup-F-Lleyton_Hewitt-Juan_Carlos_Ferrero,2,B-IO,9,1,0,1,0,7,2
20021117-M-Masters_Cup-F-Lleyton_Hewitt-Juan_Carlos_Ferrero,2,S-XC,3,0,0,0,0,1,2
20021117-M-Masters_Cup-F-Lleyton_Hewitt-Juan_Carlos_Ferrero,2,S-DTM,9,0,0,0,0,4,5
20021117-M-Masters_Cup-F-Lleyton_Hewitt-Juan_Carlos_Ferrero,2,S-DTL,1,0,0,0,0,1,0
20030817-M-Cincinnati_Masters-F-Andy_Roddick-Mardy_Fish,1,F-XC,39,16,7,3,6,29,10
20030817-M-Cincinnati_Masters-F-Andy_Roddick-Mardy_Fish,1,F-DTM,28,7,0,1,6,14,14
20030817-M-Cincinnati_Masters-F-Andy_Roddick-Mardy_Fish,1,F-DTL,4,2,0,2,0,3,1
20030817-M-Cincinnati_Masters-F-Andy_Roddick-Mardy_Fish,1,F-IO,23,7,2,1,4,13,10
20030817-M-Cincinnati_Masters-F-Andy_Roddick-Mardy_Fish,1,F-II,3,1,0,1,0,3,0
20030817-M-Cincinnati_Masters-F-Andy_Roddick-Mardy_Fish,1,B-XC,11,4,3,0,1,7,4
20030817-M-Cincinnati_Masters-F-Andy_Roddick-Mardy_Fish,1,B-DTM,17,1,0,0,1,10,7
20030817-M-Cincinnati_Masters-F-Andy_Roddick-Mardy_Fish,1,B-DTL,9,2,0,1,1,2,7
20030817-M-Cincinnati_Masters-F-Andy_Roddick-Mardy_Fish,1,B-IO,6,2,0,2,0,5,1
20030817-M-Cincinnati_Masters-F-Andy_Roddick-Mardy_Fish,1,S-XC,2,1,0,1,0,1,1
20030817-M-Cincinnati_Masters-F-Andy_Roddick-Mardy_Fish,1,S-DTM,13,2,0,0,2,10,3
20030817-M-Cincinnati_Masters-F-Andy_Roddick-Mardy_Fish,1,S-DTL,5,1,0,1,0,4,1
20030817-M-Cincinnati_Masters-F-Andy_Roddick-Mardy_Fish,1,S-IO,1,1,0,0,1,0,1
20030817-M-Cincinnati_Masters-F-Andy_Roddick-Mardy_Fish,2,F-XC,31,8,2,1,5,10,21
20030817-M-Cincinnati_Masters-F-Andy_Roddick-Mardy_Fish,2,F-DTM,25,5,0,0,5,8,17
20030817-M-Cincinnati_Masters-F-Andy_Roddick-Mardy_Fish,2,F-DTL,9,2,0,0,2,1,8
20030817-M-Cincinnati_Masters-F-Andy_Roddick-Mardy_Fish,2,F-IO,22,10,2,2,6,9,13
20030817-M-Cincinnati_Masters-F-Andy_Roddick-Mardy_Fish,2,B-XC,22,8,1,2,5,9,13
20030817-M-Cincinnati_Masters-F-Andy_Roddick-Mardy_Fish,2,B-DTM,12,1,0,0,1,6,6
20030817-M-Cincinnati_Masters-F-Andy_Roddick-Mardy_Fish,2,B-DTL,8,7,3,1,3,5,3
20030817-M-Cincinnati_Masters-F-Andy_Roddick-Mardy_Fish,2,B-IO,7,2,1,0,1,3,4
20030817-M-Cincinnati_Masters-F-Andy_Roddick-Mardy_Fish,2,S-XC,2,0,0,0,0,0,2
20160509-M-Rome-R64-Alexander_Zverev-Grigor_Dimitrov,1,F-XC,18,4,2,2,0,15,3
20160509-M-Rome-R64-Alexander_Zverev-Grigor_Dimitrov,1,F-DTM,13,0,0,0,0,6,7
20160509-M-Rome-R64-Alexander_Zverev-Grigor_Dimitrov,1,F-DTL,7,2,0,1,1,4,3
20160509-M-Rome-R64-Alexander_Zverev-Grigor_Dimitrov,1,F-IO,12,5,1,2,2,8,4
20160509-M-Rome-R64-Alexander_Zverev-Grigor_Dimitrov,1,B-XC,36,2,0,0,2,19,17
20160509-M-Rome-R64-Alexander_Zverev-Grigor_Dimitrov,1,B-DTM,14,3,0,1,2,6,8
20160509-M-Rome-R64-Alexander_Zverev-Grigor_Dimitrov,1,B-DTL,8,3,1,2,0,4,4
20160509-M-Rome-R64-Alexander_Zverev-Grigor_Dimitrov,1,B-IO,4,2,1,1,0,3,1
20160509-M-Rome-R64-Alexander_Zverev-Grigor_Dimitrov,1,S-XC,1,0,0,0,0,0,1
20160509-M-Rome-R64-Alexander_Zverev-Grigor_Dimitrov,1,S-DTM,2,0,0,0,0,2,0
20160509-M-Rome-R64-Alexander_Zverev-Grigor_Dimitrov,2,F-XC,24,10,2,3,5,10,14
20160509-M-Rome-R64-Alexander_Zverev-Grigor_Dimitrov,2,F-DTM,11,1,0,0,1,3,8
20160509-M-Rome-R64-Alexander_Zverev-Grigor_Dimitrov,2,F-DTL,6,2,1,0,1,2,4
20160509-M-Rome-R64-Alexander_Zverev-Grigor_Dimitrov,2,F-IO,29,11,3,3,5,15,14
20160509-M-Rome-R64-Alexander_Zverev-Grigor_Dimitrov,2,F-II,2,0,0,0,0,0,2
20160509-M-Rome-R64-Alexander_Zverev-Grigor_Dimitrov,2,B-XC,20,7,1,1,5,10,10
20160509-M-Rome-R64-Alexander_Zverev-Grigor_Dimitrov,2,B-DTM,22,4,0,1,3,9,13
20160509-M-Rome-R64-Alexander_Zverev-Grigor_Dimitrov,2,B-DTL,4,3,1,1,1,3,1
20160509-M-Rome-R64-Alexander_Zverev-Grigor_Dimitrov,2,S-XC,6,0,0,0,0,1,5
20160509-M-Rome-R64-Alexander_Zverev-Grigor_Dimitrov,2,S-DTM,2,0,0,0,0,1,1
20160509-M-Rome-R64-Alexander_Zverev-Grigor_Dimitrov,2,S-DTL,1,1,0,0,1,0,1
20040328-M-Miami_Masters-F-Andy_Roddick-Guillermo_Coria,1,F-XC,67,12,3,4,5,34,33
20040328-M-Miami_Masters-F-Andy_Roddick-Guillermo_Coria,1,F-DTM,43,4,2,1,1,24,19
20040328-M-Miami_Masters-F-Andy_Roddick-Guillermo_Coria,1,F-DTL,8,3,2,0,1,7,1
20040328-M-Miami_Masters-F-Andy_Roddick-Guillermo_Coria,1,F-IO,27,10,4,2,4,10,17
20040328-M-Miami_Masters-F-Andy_Roddick-Guillermo_Coria,1,F-II,16,8,2,3,3,11,5
20040328-M-Miami_Masters-F-Andy_Roddick-Guillermo_Coria,1,B-XC,87,14,0,1,13,43,44
20040328-M-Miami_Masters-F-Andy_Roddick-Guillermo_Coria,1,B-DTM,25,0,0,0,0,10,15
20040328-M-Miami_Masters-F-Andy_Roddick-Guillermo_Coria,1,B-DTL,9,7,4,1,2,7,2
20040328-M-Miami_Masters-F-Andy_Roddick-Guillermo_Coria,1,B-IO,3,2,2,0,0,2,1
20040328-M-Miami_Masters-F-Andy_Roddick-Guillermo_Coria,1,S-XC,5,1,0,0,1,3,2
20040328-M-Miami_Masters-F-Andy_Roddick-Guillermo_Coria,1,S-DTM,8,1,0,0,1,4,4
20040328-M-Miami_Masters-F-Andy_Roddick-Guillermo_Coria,1,S-DTL,5,2,1,1,0,2,3
20040328-M-Miami_Masters-F-Andy_Roddick-Guillermo_Coria,2,F-XC,38,7,0,1,6,22,16
20040328-M-Miami_Masters-F-Andy_Roddick-Guillermo_Coria,2,F-DTM,64,3,0,0,3,33,31
20040328-M-Miami_Masters-F-Andy_Roddick-Guillermo_Coria,2,F-DTL,13,3,0,1,2,8,5
20040328-M-Miami_Masters-F-Andy_Roddick-Guillermo_Coria,2,F-IO,26,5,2,0,3,10,16
20040328-M-Miami_Masters-F-Andy_Roddick-Guillermo_Coria,2,F-II,3,1,0,0,1,0,3
20040328-M-Miami_Masters-F-Andy_Roddick-Guillermo_Coria,2,B-XC,85,8,1,0,7,39,46
20040328-M-Miami_Masters-F-Andy_Roddick-Guillermo_Coria,2,B-DTM,46,3,0,1,2,20,26
20040328-M-Miami_Masters-F-Andy_Roddick-Guillermo_Coria,2,B-DTL,11,5,4,0,1,6,5
20040328-M-Miami_Masters-F-Andy_Roddick-Guillermo_Coria,2,B-IO,7,1,0,1,0,5,2
20040328-M-Miami_Masters-F-Andy_Roddick-Guillermo_Coria,2,S-DTL,1,0,0,0,0,0,1
20070513-M-Rome_Masters-F-Fernando_Gonzalez-Rafael_Nadal,1,F-XC,25,7,1,1,5,12,13
20070513-M-Rome_Masters-F-Fernando_Gonzalez-Rafael_Nadal,1,F-DTM,21,2,0,1,1,7,14
20070513-M-Rome_Masters-F-Fernando_Gonzalez-Rafael_Nadal,1,F-DTL,10,8,3,1,4,5,5
20070513-M-Rome_Masters-F-Fernando_Gonzalez-Rafael_Nadal,1,F-IO,20,9,3,1,5,7,13
20070513-M-Rome_Masters-F-Fernando_Gonzalez-Rafael_Nadal,1,F-II,4,2,0,1,1,2,2
20070513-M-Rome_Masters-F-Fernando_Gonzalez-Rafael_Nadal,1,B-XC,12,2,1,0,1,5,7
20070513-M-Rome_Masters-F-Fernando_Gonzalez-Rafael_Nadal,1,B-DTM,15,1,0,0,1,5,10
20070513-M-Rome_Masters-F-Fernando_Gonzalez-Rafael_Nadal,1,B-DTL,4,2,0,0,2,1,3
20070513-M-Rome_Masters-F-Fernando_Gonzalez-Rafael_Nadal,1,B-IO,1,0,0,0,0,1,0
20070513-M-Rome_Masters-F-Fernando_Gonzalez-Rafael_Nadal,1,S-XC,7,1,0,0,1,2,5
20070513-M-Rome_Masters-F-Fernando_Gonzalez-Rafael_Nadal,1,S-DTM,10,1,0,0,1,4,6
20070513-M-Rome_Masters-F-Fernando_Gonzalez-Rafael_Nadal,1,S-DTL,2,0,0,0,0,0,2
20070513-M-Rome_Masters-F-Fernando_Gonzalez-Rafael_Nadal,1,S-IO,1,0,0,0,0,0,1
20070513-M-Rome_Masters-F-Fernando_Gonzalez-Rafael_Nadal,2,F-XC,43,7,4,1,2,29,14
20070513-M-Rome_Masters-F-Fernando_Gonzalez-Rafael_Nadal,2,F-DTM,18,2,0,1,1,11,7
20070513-M-Rome_Masters-F-Fernando_Gonzalez-Rafael_Nadal,2,F-DTL,7,2,0,2,0,5,2
20070513-M-Rome_Masters-F-Fernando_Gonzalez-Rafael_Nadal,2,F-IO,20,6,3,2,1,14,6
20070513-M-Rome_Masters-F-Fernando_Gonzalez-Rafael_Nadal,2,F-II,3,2,0,1,1,2,1
20070513-M-Rome_Masters-F-Fernando_Gonzalez-Rafael_Nadal,2,B-XC,5,1,0,0,1,2,3
20070513-M-Rome_Masters-F-Fernando_Gonzalez-Rafael_Nadal,2,B-DTM,13,2,0,0,2,7,6
20070513-M-Rome_Masters-F-Fernando_Gonzalez-Rafael_Nadal,2,B-DTL,4,0,0,0,0,3,1
20070513-M-Rome_Masters-F-Fernando_Gonzalez-Rafael_Nadal,2,B-IO,2,0,0,0,0,0,2
20070513-M-Rome_Masters-F-Fernando_Gonzalez-Rafael_Nadal,2,S-XC,1,1,0,1,0,1,0
20070513-M-Rome_Masters-F-Fernando_Gonzalez-Rafael_Nadal,2,S-DTM,1,0,0,0,0,0,1
20070513-M-Rome_Masters-F-Fernando_Gonzalez-Rafael_Nadal,2,S-DTL,4,0,0,0,0,3,1
19980329-M-Miami_Masters-F-Marcelo_Rios-Andre_Agassi,1,F-XC,49,11,4,3,4,31,18
19980329-M-Miami_Masters-F-Marcelo_Rios-Andre_Agassi,1,F-DTM,14,1,0,0,1,7,7
19980329-M-Miami_Masters-F-Marcelo_Rios-Andre_Agassi,1,F-DTL,13,7,5,1,1,11,2
19980329-M-Miami_Masters-F-Marcelo_Rios-Andre_Agassi,1,F-IO,18,11,8,2,1,17,1
19980329-M-Miami_Masters-F-Marcelo_Rios-Andre_Agassi,1,F-II,5,4,3,1,0,5,0
19980329-M-Miami_Masters-F-Marcelo_Rios-Andre_Agassi,1,B-XC,45,10,5,2,3,31,14
19980329-M-Miami_Masters-F-Marcelo_Rios-Andre_Agassi,1,B-DTM,32,3,0,1,2,16,16
19980329-M-Miami_Masters-F-Marcelo_Rios-Andre_Agassi,1,B-DTL,14,2,0,0,2,9,5
19980329-M-Miami_Masters-F-Marcelo_Rios-Andre_Agassi,1,B-IO,9,1,0,0,1,5,4
19980329-M-Miami_Masters-F-Marcelo_Rios-Andre_Agassi,1,S-XC,3,0,0,0,0,2,1
19980329-M-Miami_Masters-F-Marcelo_Rios-Andre_Agassi,1,S-DTM,4,0,0,0,0,2,2
19980329-M-Miami_Masters-F-Marcelo_Rios-Andre_Agassi,1,S-DTL,2,0,0,0,0,1,1
19980329-M-Miami_Masters-F-Marcelo_Rios-Andre_Agassi,1,S-IO,1,0,0,0,0,0,1
19980329-M-Miami_Masters-F-Marcelo_Rios-Andre_Agassi,2,F-XC,64,16,3,6,7,31,33
19980329-M-Miami_Masters-F-Marcelo_Rios-Andre_Agassi,2,F-DTM,13,2,0,0,2,3,10
19980329-M-Miami_Masters-F-Marcelo_Rios-Andre_Agassi,2,F-DTL,9,3,0,2,1,4,5
19980329-M-Miami_Masters-F-Marcelo_Rios-Andre_Agassi,2,F-IO,13,4,2,2,0,8,5
19980329-M-Miami_Masters-F-Marcelo_Rios-Andre_Agassi,2,F-II,5,1,0,0,1,1,4
19980329-M-Miami_Masters-F-Marcelo_Rios-Andre_Agassi,2,B-XC,46,15,4,5,6,23,23
19980329-M-Miami_Masters-F-Marcelo_Rios-Andre_Agassi,2,B-DTM,23,3,0,0,3,5,18
19980329-M-Miami_Masters-F-Marcelo_Rios-Andre_Agassi,2,B-DTL,23,4,0,0,4,6,17
19980329-M-Miami_Masters-F-Marcelo_Rios-Andre_Agassi,2,B-IO,10,4,1,1,2,3,7
19980329-M-Miami_Masters-F-Marcelo_Rios-Andre_Agassi,2,S-XC,3,1,1,0,0,2,1
19980329-M-Miami_Masters-F-Marcelo_Rios-Andre_Agassi,2,S-DTM,2,0,0,0,0,1,1
19980329-M-Miami_Masters-F-Marcelo_Rios-Andre_Agassi,2,S-DTL,6,0,0,0,0,2,4
20170124-M-Australian_Open-QF-Roger_Federer-Mischa_Zverev,1,F-XC,34,12,9,0,3,20,14
20170124-M-Australian_Open-QF-Roger_Federer-Mischa_Zverev,1,F-DTM,5,0,0,0,0,2,3
20170124-M-Australian_Open-QF-Roger_Federer-Mischa_Zverev,1,F-DTL,16,6,4,2,0,10,6
20170124-M-Australian_Open-QF-Roger_Federer-Mischa_Zverev,1,F-IO,23,12,11,0,1,16,7
20170124-M-Australian_Open-QF-Roger_Federer-Mischa_Zverev,1,F-II,6,0,0,0,0,3,3
20170124-M-Australian_Open-QF-Roger_Federer-Mischa_Zverev,1,B-XC,17,11,6,3,2,13,4
20170124-M-Australian_Open-QF-Roger_Federer-Mischa_Zverev,1,B-DTM,10,3,0,3,0,5,5
20170124-M-Australian_Open-QF-Roger_Federer-Mischa_Zverev,1,B-DTL,13,9,5,3,1,9,4
20170124-M-Australian_Open-QF-Roger_Federer-Mischa_Zverev,1,B-IO,5,1,1,0,0,3,2
20170124-M-Australian_Open-QF-Roger_Federer-Mischa_Zverev,1,S-XC,3,3,1,1,1,2,1
20170124-M-Australian_Open-QF-Roger_Federer-Mischa_Zverev,1,S-DTM,1,0,0,0,0,0,1
20170124-M-Australian_Open-QF-Roger_Federer-Mischa_Zverev,1,S-DTL,4,0,0,0,0,1,3
20170124-M-Australian_Open-QF-Roger_Federer-Mischa_Zverev,2,F-XC,7,2,1,0,1,3,4
20170124-M-Australian_Open-QF-Roger_Federer-Mischa_Zverev,2,F-DTM,4,1,0,1,0,2,2
20170124-M-Australian_Open-QF-Roger_Federer-Mischa_Zverev,2,F-DTL,7,3,1,1,1,5,2
20170124-M-Australian_Open-QF-Roger_Federer-Mischa_Zverev,2,F-IO,2,1,0,0,1,0,2
20170124-M-Australian_Open-QF-Roger_Federer-Mischa_Zverev,2,B-XC,7,3,1,2,0,5,2
20170124-M-Australian_Open-QF-Roger_Federer-Mischa_Zverev,2,B-DTM,7,0,0,0,0,3,4
20170124-M-Australian_Open-QF-Roger_Federer-Mischa_Zverev,2,B-DTL,5,2,0,1,1,4,1
20170124-M-Australian_Open-QF-Roger_Federer-Mischa_Zverev,2,S-XC,5,0,0,0,0,2,3
20170124-M-Australian_Open-QF-Roger_Federer-Mischa_Zverev,2,S-DTM,8,1,0,0,1,4,4
20170124-M-Australian_Open-QF-Roger_Federer-Mischa_Zverev,2,S-DTL,4,0,0,0,0,2,2
20170124-M-Australian_Open-QF-Roger_Federer-Mischa_Zverev,2,S-IO,1,0,0,0,0,0,1
20110417-M-Monte_Carlo-F-David_Ferrer-Rafael_Nadal,1,F-XC,102,7,2,2,3,56,46
20110417-M-Monte_Carlo-F-David_Ferrer-Rafael_Nadal,1,F-DTM,61,2,0,0,2,22,39
20110417-M-Monte_Carlo-F-David_Ferrer-Rafael_Nadal,1,F-DTL,11,4,1,0,3,6,5
20110417-M-Monte_Carlo-F-David_Ferrer-Rafael_Nadal,1,F-IO,36,16,7,1,8,15,21
20110417-M-Monte_Carlo-F-David_Ferrer-Rafael_Nadal,1,F-II,10,1,0,0,1,7,3
20110417-M-Monte_Carlo-F-David_Ferrer-Rafael_Nadal,1,B-XC,76,11,0,5,6,37,39
20110417-M-Monte_Carlo-F-David_Ferrer-Rafael_Nadal,1,B-DTM,60,5,0,0,5,25,35
20110417-M-Monte_Carlo-F-David_Ferrer-Rafael_Nadal,1,B-DTL,19,5,0,2,3,8,11
20110417-M-Monte_Carlo-F-David_Ferrer-Rafael_Nadal,1,B-IO,9,2,0,0,2,6,3
20110417-M-Monte_Carlo-F-David_Ferrer-Rafael_Nadal,1,S-DTM,6,0,0,0,0,0,6
20110417-M-Monte_Carlo-F-David_Ferrer-Rafael_Nadal,1,S-DTL,1,0,0,0,0,0,1
20110417-M-Monte_Carlo-F-David_Ferrer-Rafael_Nadal,1,S-II,1,0,0,0,0,1,0
20110417-M-Monte_Carlo-F-David_Ferrer-Rafael_Nadal,2,F-XC,116,8,3,2,3,72,44
20110417-M-Monte_Carlo-F-David_Ferrer-Rafael_Nadal,2,F-DTM,39,1,0,0,1,23,16
20110417-M-Monte_Carlo-F-David_Ferrer-Rafael_Nadal,2,F-DTL,30,10,5,1,4,17,13
20110417-M-Monte_Carlo-F-David_Ferrer-Rafael_Nadal,2,F-IO,26,8,4,1,3,12,14
20110417-M-Monte_Carlo-F-David_Ferrer-Rafael_Nadal,2,F-II,11,2,0,1,1,6,5
20110417-M-Monte_Carlo-F-David_Ferrer-Rafael_Nadal,2,B-XC,54,11,1,4,6,28,26
20110417-M-Monte_Carlo-F-David_Ferrer-Rafael_Nadal,2,B-DTM,79,6,1,0,5,36,43
20110417-M-Monte_Carlo-F-David_Ferrer-Rafael_Nadal,2,B-DTL,20,2,1,0,1,9,11
20110417-M-Monte_Carlo-F-David_Ferrer-Rafael_Nadal,2,B-IO,14,2,0,0,2,9,5
20110417-M-Monte_Carlo-F-David_Ferrer-Rafael_Nadal,2,S-XC,2,0,0,0,0,1,1
20110417-M-Monte_Carlo-F-David_Ferrer-Rafael_Nadal,2,S-DTM,4,0,0,0,0,2,2
20110417-M-Monte_Carlo-F-David_Ferrer-Rafael_Nadal,2,S-DTL,2,0,0,0,0,0,2
20110417-M-Monte_Carlo-F-David_Ferrer-Rafael_Nadal,2,S-IO,2,0,0,0,0,0,2
20030518-M-Hamburg_Masters-F-Guillermo_Coria-Agustin_Calleri,1,F-XC,20,7,5,2,0,12,8
20030518-M-Hamburg_Masters-F-Guillermo_Coria-Agustin_Calleri,1,F-DTM,56,2,0,0,2,37,19
20030518-M-Hamburg_Masters-F-Guillermo_Coria-Agustin_Calleri,1,F-DTL,11,3,1,2,0,6,5
20030518-M-Hamburg_Masters-F-Guillermo_Coria-Agustin_Calleri,1,F-IO,22,5,2,1,2,19,3
20030518-M-Hamburg_Masters-F-Guillermo_Coria-Agustin_Calleri,1,F-II,2,1,0,1,0,2,0
20030518-M-Hamburg_Masters-F-Guillermo_Coria-Agustin_Calleri,1,B-XC,105,6,1,1,4,67,38
20030518-M-Hamburg_Masters-F-Guillermo_Coria-Agustin_Calleri,1,B-DTM,29,1,0,0,1,23,6
20030518-M-Hamburg_Masters-F-Guillermo_Coria-Agustin_Calleri,1,B-DTL,7,4,1,2,1,4,3
20030518-M-Hamburg_Masters-F-Guillermo_Coria-Agustin_Calleri,1,B-IO,3,0,0,0,0,3,0
20030518-M-Hamburg_Masters-F-Guillermo_Coria-Agustin_Calleri,1,S-XC,6,1,1,0,0,4,2
20030518-M-Hamburg_Masters-F-Guillermo_Coria-Agustin_Calleri,1,S-DTM,4,0,0,0,0,1,3
20030518-M-Hamburg_Masters-F-Guillermo_Coria-Agustin_Calleri,1,S-IO,1,0,0,0,0,0,1
20030518-M-Hamburg_Masters-F-Guillermo_Coria-Agustin_Calleri,2,F-XC,37,9,2,3,4,15,22
20030518-M-Hamburg_Masters-F-Guillermo_Coria-Agustin_Calleri,2,F-DTM,22,3,0,0,3,5,17
20030518-M-Hamburg_Masters-F-Guillermo_Coria-Agustin_Calleri,2,F-DTL,5,2,1,1,0,5,0
20030518-M-Hamburg_Masters-F-Guillermo_Coria-Agustin_Calleri,2,F-IO,37,17,6,3,8,16,21
20030518-M-Hamburg_Masters-F-Guillermo_Coria-Agustin_Calleri,2,F-II,5,3,0,0,3,1,4
20030518-M-Hamburg_Masters-F-Guillermo_Coria-Agustin_Calleri,2,B-XC,88,11,0,2,9,29,59
20030518-M-Hamburg_Masters-F-Guillermo_Coria-Agustin_Calleri,2,B-DTM,36,4,1,0,3,11,25
20030518-M-Hamburg_Masters-F-Guillermo_Coria-Agustin_Calleri,2,B-DTL,26,15,3,6,6,13,13
20030518-M-Hamburg_Masters-F-Guillermo_Coria-Agustin_Calleri,2,B-IO,10,5,1,0,4,4,6
20030518-M-Hamburg_Masters-F-Guillermo_Coria-Agustin_Calleri,2,S-XC,4,0,0,0,0,1,3
20030518-M-Hamburg_Masters-F-Guillermo_Coria-Agustin_Calleri,2,S-DTM,6,0,0,0,0,1,5
20030518-M-Hamburg_Masters-F-Guillermo_Coria-Agustin_Calleri,2,S-DTL,2,0,0,0,0,0,2
20170724-M-Bastad-F-Alexandr_Dolgopolov-David_Ferrer,1,F-XC,25,7,2,2,3,12,13
20170724-M-Bastad-F-Alexandr_Dolgopolov-David_Ferrer,1,F-DTM,7,0,0,0,0,1,6
20170724-M-Bastad-F-Alexandr_Dolgopolov-David_Ferrer,1,F-DTL,22,9,5,1,3,11,11
20170724-M-Bastad-F-Alexandr_Dolgopolov-David_Ferrer,1,F-IO,26,8,2,1,5,12,14
20170724-M-Bastad-F-Alexandr_Dolgopolov-David_Ferrer,1,F-II,1,0,0,0,0,1,0
20170724-M-Bastad-F-Alexandr_Dolgopolov-David_Ferrer,1,B-XC,49,14,4,4,6,22,27
20170724-M-Bastad-F-Alexandr_Dolgopolov-David_Ferrer,1,B-DTM,41,5,0,0,5,21,20
20170724-M-Bastad-F-Alexandr_Dolgopolov-David_Ferrer,1,B-DTL,13,8,4,1,3,9,4
20170724-M-Bastad-F-Alexandr_Dolgopolov-David_Ferrer,1,B-IO,5,2,2,0,0,3,2
20170724-M-Bastad-F-Alexandr_Dolgopolov-David_Ferrer,1,S-XC,7,0,0,0,0,2,5
20170724-M-Bastad-F-Alexandr_Dolgopolov-David_Ferrer,1,S-DTM,6,0,0,0,0,2,4
20170724-M-Bastad-F-Alexandr_Dolgopolov-David_Ferrer,1,S-DTL,1,1,0,0,1,0,1
20170724-M-Bastad-F-Alexandr_Dolgopolov-David_Ferrer,1,S-IO,2,0,0,0,0,2,0
20170724-M-Bastad-F-Alexandr_Dolgopolov-David_Ferrer,2,F-XC,41,9,4,4,1,24,17
20170724-M-Bastad-F-Alexandr_Dolgopolov-David_Ferrer,2,F-DTM,20,4,0,0,4,6,14
20170724-M-Bastad-F-Alexandr_Dolgopolov-David_Ferrer,2,F-DTL,3,0,0,0,0,1,2
20170724-M-Bastad-F-Alexandr_Dolgopolov-David_Ferrer,2,F-IO,29,6,1,2,3,17,12
20170724-M-Bastad-F-Alexandr_Dolgopolov-David_Ferrer,2,F-II,4,3,1,2,0,4,0
20170724-M-Bastad-F-Alexandr_Dolgopolov-David_Ferrer,2,B-XC,48,3,0,0,3,27,21
20170724-M-Bastad-F-Alexandr_Dolgopolov-David_Ferrer,2,B-DTM,29,0,0,0,0,12,17
20170724-M-Bastad-F-Alexandr_Dolgopolov-David_Ferrer,2,B-DTL,3,3,0,2,1,2,1
20170724-M-Bastad-F-Alexandr_Dolgopolov-David_Ferrer,2,B-IO,3,1,0,1,0,2,1
20170724-M-Bastad-F-Alexandr_Dolgopolov-David_Ferrer,2,S-XC,6,0,0,0,0,3,3
20170724-M-Bastad-F-Alexandr_Dolgopolov-David_Ferrer,2,S-DTM,3,0,0,0,0,1,2
20170804-M-Kitzbuhel-SF-Fabio_Fognini-Philipp_Kohlschreiber,1,F-XC,19,11,6,3,2,13,6
20170804-M-Kitzbuhel-SF-Fabio_Fognini-Philipp_Kohlschreiber,1,F-DTM,7,2,1,0,1,2,5
20170804-M-Kitzbuhel-SF-Fabio_Fognini-Philipp_Kohlschreiber,1,F-DTL,7,2,0,1,1,3,4
20170804-M-Kitzbuhel-SF-Fabio_Fognini-Philipp_Kohlschreiber,1,F-IO,16,11,2,1,8,7,9
20170804-M-Kitzbuhel-SF-Fabio_Fognini-Philipp_Kohlschreiber,1,F-II,3,2,2,0,0,2,1
20170804-M-Kitzbuhel-SF-Fabio_Fognini-Philipp_Kohlschreiber,1,B-XC,21,3,0,1,2,7,14
20170804-M-Kitzbuhel-SF-Fabio_Fognini-Philipp_Kohlschreiber,1,B-DTM,19,3,0,0,3,9,10
20170804-M-Kitzbuhel-SF-Fabio_Fognini-Philipp_Kohlschreiber,1,B-DTL,10,2,0,0,2,5,5
20170804-M-Kitzbuhel-SF-Fabio_Fognini-Philipp_Kohlschreiber,1,B-IO,3,2,1,0,1,2,1
20170804-M-Kitzbuhel-SF-Fabio_Fognini-Philipp_Kohlschreiber,1,S-XC,2,1,0,0,1,0,2
20170804-M-Kitzbuhel-SF-Fabio_Fognini-Philipp_Kohlschreiber,1,S-DTM,3,0,0,0,0,1,2
20170804-M-Kitzbuhel-SF-Fabio_Fognini-Philipp_Kohlschreiber,1,S-IO,1,0,0,0,0,0,1
20170804-M-Kitzbuhel-SF-Fabio_Fognini-Philipp_Kohlschreiber,2,F-XC,24,7,2,2,3,15,9
20170804-M-Kitzbuhel-SF-Fabio_Fognini-Philipp_Kohlschreiber,2,F-DTM,11,1,0,0,1,5,6
20170804-M-Kitzbuhel-SF-Fabio_Fognini-Philipp_Kohlschreiber,2,F-DTL,9,3,2,0,1,6,3
20170804-M-Kitzbuhel-SF-Fabio_Fognini-Philipp_Kohlschreiber,2,F-IO,24,7,2,2,3,16,8
20170804-M-Kitzbuhel-SF-Fabio_Fognini-Philipp_Kohlschreiber,2,F-II,2,1,0,1,0,1,1
20170804-M-Kitzbuhel-SF-Fabio_Fognini-Philipp_Kohlschreiber,2,B-XC,14,5,0,2,3,7,7
20170804-M-Kitzbuhel-SF-Fabio_Fognini-Philipp_Kohlschreiber,2,B-DTM,8,1,0,0,1,4,4
20170804-M-Kitzbuhel-SF-Fabio_Fognini-Philipp_Kohlschreiber,2,B-DTL,1,0,0,0,0,0,1
20170804-M-Kitzbuhel-SF-Fabio_Fognini-Philipp_Kohlschreiber,2,S-XC,9,1,0,0,1,7,2
20170804-M-Kitzbuhel-SF-Fabio_Fognini-Philipp_Kohlschreiber,2,S-DTL,2,0,0,0,0,0,2
20170805-M-Kitzbuhel-F-Philipp_Kohlschreiber-Joao_Sousa,1,F-XC,31,9,5,2,2,21,10
20170805-M-Kitzbuhel-F-Philipp_Kohlschreiber-Joao_Sousa,1,F-DTM,16,3,0,1,2,8,8
20170805-M-Kitzbuhel-F-Philipp_Kohlschreiber-Joao_Sousa,1,F-DTL,8,0,0,0,0,5,3
20170805-M-Kitzbuhel-F-Philipp_Kohlschreiber-Joao_Sousa,1,F-IO,21,8,3,4,1,11,10
20170805-M-Kitzbuhel-F-Philipp_Kohlschreiber-Joao_Sousa,1,F-II,5,2,1,0,1,1,4
20170805-M-Kitzbuhel-F-Philipp_Kohlschreiber-Joao_Sousa,1,B-XC,25,5,0,2,3,13,12
20170805-M-Kitzbuhel-F-Philipp_Kohlschreiber-Joao_Sousa,1,B-DTM,12,1,0,0,1,7,5
20170805-M-Kitzbuhel-F-Philipp_Kohlschreiber-Joao_Sousa,1,B-DTL,6,3,0,1,2,3,3
20170805-M-Kitzbuhel-F-Philipp_Kohlschreiber-Joao_Sousa,1,B-IO,1,0,0,0,0,0,1
20170805-M-Kitzbuhel-F-Philipp_Kohlschreiber-Joao_Sousa,1,S-XC,11,2,0,0,2,2,9
20170805-M-Kitzbuhel-F-Philipp_Kohlschreiber-Joao_Sousa,1,S-DTM,4,1,0,1,0,1,3
20170805-M-Kitzbuhel-F-Philipp_Kohlschreiber-Joao_Sousa,1,S-DTL,1,0,0,0,0,1,0
20170805-M-Kitzbuhel-F-Philipp_Kohlschreiber-Joao_Sousa,2,F-XC,33,9,0,5,4,16,17
20170805-M-Kitzbuhel-F-Philipp_Kohlschreiber-Joao_Sousa,2,F-DTM,13,0,0,0,0,3,10
20170805-M-Kitzbuhel-F-Philipp_Kohlschreiber-Joao_Sousa,2,F-DTL,11,4,0,3,1,6,5
20170805-M-Kitzbuhel-F-Philipp_Kohlschreiber-Joao_Sousa,2,F-IO,27,2,1,0,1,14,13
20170805-M-Kitzbuhel-F-Philipp_Kohlschreiber-Joao_Sousa,2,F-II,7,5,3,1,1,5,2
20170805-M-Kitzbuhel-F-Philipp_Kohlschreiber-Joao_Sousa,2,B-XC,16,3,0,0,3,10,6
20170805-M-Kitzbuhel-F-Philipp_Kohlschreiber-Joao_Sousa,2,B-DTM,17,4,0,0,4,7,10
20170805-M-Kitzbuhel-F-Philipp_Kohlschreiber-Joao_Sousa,2,B-DTL,1,0,0,0,0,1,0
20170805-M-Kitzbuhel-F-Philipp_Kohlschreiber-Joao_Sousa,2,S-XC,8,1,0,0,1,5,3
20170805-M-Kitzbuhel-F-Philipp_Kohlschreiber-Joao_Sousa,2,S-DTM,5,1,0,1,0,3,2
20170805-M-Kitzbuhel-F-Philipp_Kohlschreiber-Joao_Sousa,2,S-DTL,1,0,0,0,0,1,0
20170805-M-Kitzbuhel-F-Philipp_Kohlschreiber-Joao_Sousa,2,S-II,1,0,0,0,0,1,0
20170531-M-Roland_Garros-R64-Sergiy_Stakhovsky-David_Goffin,1,F-XC,57,10,1,2,7,22,35
20170531-M-Roland_Garros-R64-Sergiy_Stakhovsky-David_Goffin,1,F-DTM,23,2,0,0,2,6,17
20170531-M-Roland_Garros-R64-Sergiy_Stakhovsky-David_Goffin,1,F-DTL,30,8,0,4,4,15,15
20170531-M-Roland_Garros-R64-Sergiy_Stakhovsky-David_Goffin,1,F-IO,13,5,1,2,2,8,5
20170531-M-Roland_Garros-R64-Sergiy_Stakhovsky-David_Goffin,1,B-XC,46,8,2,2,4,17,29
20170531-M-Roland_Garros-R64-Sergiy_Stakhovsky-David_Goffin,1,B-DTM,36,4,0,0,4,8,28
20170531-M-Roland_Garros-R64-Sergiy_Stakhovsky-David_Goffin,1,B-DTL,19,7,1,2,4,7,12
20170531-M-Roland_Garros-R64-Sergiy_Stakhovsky-David_Goffin,1,B-IO,6,3,1,1,1,4,2
20170531-M-Roland_Garros-R64-Sergiy_Stakhovsky-David_Goffin,1,S-XC,28,4,1,1,2,12,16
20170531-M-Roland_Garros-R64-Sergiy_Stakhovsky-David_Goffin,1,S-DTM,11,3,0,0,3,2,9
20170531-M-Roland_Garros-R64-Sergiy_Stakhovsky-David_Goffin,1,S-DTL,12,3,0,0,3,2,10
20170531-M-Roland_Garros-R64-Sergiy_Stakhovsky-David_Goffin,1,S-IO,1,0,0,0,0,1,0
20170531-M-Roland_Garros-R64-Sergiy_Stakhovsky-David_Goffin,2,F-XC,87,15,7,5,3,61,26
20170531-M-Roland_Garros-R64-Sergiy_Stakhovsky-David_Goffin,2,F-DTM,24,0,0,0,0,14,10
20170531-M-Roland_Garros-R64-Sergiy_Stakhovsky-David_Goffin,2,F-DTL,35,11,2,4,5,19,16
20170531-M-Roland_Garros-R64-Sergiy_Stakhovsky-David_Goffin,2,F-IO,32,3,2,0,1,24,8
20170531-M-Roland_Garros-R64-Sergiy_Stakhovsky-David_Goffin,2,F-II,12,3,2,1,0,8,4
20170531-M-Roland_Garros-R64-Sergiy_Stakhovsky-David_Goffin,2,B-XC,55,12,4,2,6,38,17
20170531-M-Roland_Garros-R64-Sergiy_Stakhovsky-David_Goffin,2,B-DTM,24,0,0,0,0,11,13
20170531-M-Roland_Garros-R64-Sergiy_Stakhovsky-David_Goffin,2,B-DTL,23,9,7,1,1,14,9
20170531-M-Roland_Garros-R64-Sergiy_Stakhovsky-David_Goffin,2,B-IO,4,2,2,0,0,3,1
20170531-M-Roland_Garros-R64-Sergiy_Stakhovsky-David_Goffin,2,B-II,1,1,1,0,0,1,0
20170531-M-Roland_Garros-R64-Sergiy_Stakhovsky-David_Goffin,2,S-XC,6,0,0,0,0,3,3
20170531-M-Roland_Garros-R64-Sergiy_Stakhovsky-David_Goffin,2,S-DTM,2,0,0,0,0,0,2
20170531-M-Roland_Garros-R64-Sergiy_Stakhovsky-David_Goffin,2,S-IO,1,1,1,0,0,1,0
20170531-M-Roland_Garros-R64-Sergiy_Stakhovsky-David_Goffin,2,S-II,1,0,0,0,0,0,1
20170530-M-Roland_Garros-R128-Nick_Kyrgios-Philipp_Kohlschreiber,1,F-XC,23,11,4,3,4,16,7
20170530-M-Roland_Garros-R128-Nick_Kyrgios-Philipp_Kohlschreiber,1,F-DTM,13,1,0,0,1,8,5
20170530-M-Roland_Garros-R128-Nick_Kyrgios-Philipp_Kohlschreiber,1,F-DTL,3,0,0,0,0,1,2
20170530-M-Roland_Garros-R128-Nick_Kyrgios-Philipp_Kohlschreiber,1,F-IO,20,4,1,0,3,9,11
20170530-M-Roland_Garros-R128-Nick_Kyrgios-Philipp_Kohlschreiber,1,F-II,2,2,1,1,0,2,0
20170530-M-Roland_Garros-R128-Nick_Kyrgios-Philipp_Kohlschreiber,1,B-XC,31,9,1,1,7,17,14
20170530-M-Roland_Garros-R128-Nick_Kyrgios-Philipp_Kohlschreiber,1,B-DTM,18,2,1,0,1,10,8
20170530-M-Roland_Garros-R128-Nick_Kyrgios-Philipp_Kohlschreiber,1,B-DTL,4,1,0,0,1,2,2
20170530-M-Roland_Garros-R128-Nick_Kyrgios-Philipp_Kohlschreiber,1,S-XC,1,1,0,0,1,0,1
20170530-M-Roland_Garros-R128-Nick_Kyrgios-Philipp_Kohlschreiber,1,S-DTM,1,0,0,0,0,0,1
20170530-M-Roland_Garros-R128-Nick_Kyrgios-Philipp_Kohlschreiber,2,F-XC,19,6,2,1,3,11,8
20170530-M-Roland_Garros-R128-Nick_Kyrgios-Philipp_Kohlschreiber,2,F-DTM,17,3,0,1,2,9,8
20170530-M-Roland_Garros-R128-Nick_Kyrgios-Philipp_Kohlschreiber,2,F-DTL,8,2,1,1,0,3,5
20170530-M-Roland_Garros-R128-Nick_Kyrgios-Philipp_Kohlschreiber,2,F-IO,17,6,3,1,2,8,9
20170530-M-Roland_Garros-R128-Nick_Kyrgios-Philipp_Kohlschreiber,2,F-II,3,1,1,0,0,2,1
20170530-M-Roland_Garros-R128-Nick_Kyrgios-Philipp_Kohlschreiber,2,B-XC,36,15,5,1,9,16,20
20170530-M-Roland_Garros-R128-Nick_Kyrgios-Philipp_Kohlschreiber,2,B-DTM,14,3,0,1,2,7,7
20170530-M-Roland_Garros-R128-Nick_Kyrgios-Philipp_Kohlschreiber,2,B-DTL,3,2,2,0,0,3,0
20170530-M-Roland_Garros-R128-Nick_Kyrgios-Philipp_Kohlschreiber,2,B-IO,2,1,1,0,0,1,1
20170530-M-Roland_Garros-R128-Nick_Kyrgios-Philipp_Kohlschreiber,2,S-XC,12,1,0,0,1,5,7
20170530-M-Roland_Garros-R128-Nick_Kyrgios-Philipp_Kohlschreiber,2,S-DTM,2,0,0,0,0,1,1
20170530-M-Roland_Garros-R128-Nick_Kyrgios-Philipp_Kohlschreiber,2,S-IO,1,1,0,0,1,0,1
20050117-M-Australian_Open-R128-Novak_Djokovic-Marat_Safin,1,F-XC,28,7,0,1,6,4,24
20050117-M-Australian_Open-R128-Novak_Djokovic-Marat_Safin,1,F-DTM,23,1,0,0,1,8,15
20050117-M-Australian_Open-R128-Novak_Djokovic-Marat_Safin,1,F-DTL,19,4,0,1,3,6,13
20050117-M-Australian_Open-R128-Novak_Djokovic-Marat_Safin,1,F-IO,15,5,0,0,5,4,11
20050117-M-Australian_Open-R128-Novak_Djokovic-Marat_Safin,1,F-II,2,0,0,0,0,2,0
20050117-M-Australian_Open-R128-Novak_Djokovic-Marat_Safin,1,B-XC,27,3,0,2,1,11,16
20050117-M-Australian_Open-R128-Novak_Djokovic-Marat_Safin,1,B-DTM,19,2,0,0,2,7,12
20050117-M-Australian_Open-R128-Novak_Djokovic-Marat_Safin,1,B-DTL,17,6,1,3,2,6,11
20050117-M-Australian_Open-R128-Novak_Djokovic-Marat_Safin,1,B-IO,3,0,0,0,0,2,1
20050117-M-Australian_Open-R128-Novak_Djokovic-Marat_Safin,1,S-XC,1,0,0,0,0,1,0
20050117-M-Australian_Open-R128-Novak_Djokovic-Marat_Safin,1,S-DTL,1,1,0,0,1,0,1
20050117-M-Australian_Open-R128-Novak_Djokovic-Marat_Safin,2,F-XC,43,11,2,7,2,34,9
20050117-M-Australian_Open-R128-Novak_Djokovic-Marat_Safin,2,F-DTM,16,0,0,0,0,9,7
20050117-M-Australian_Open-R128-Novak_Djokovic-Marat_Safin,2,F-DTL,3,3,1,0,2,1,2
20050117-M-Australian_Open-R128-Novak_Djokovic-Marat_Safin,2,F-IO,12,5,2,1,2,9,3
20050117-M-Australian_Open-R128-Novak_Djokovic-Marat_Safin,2,F-II,2,1,0,0,1,1,1
20050117-M-Australian_Open-R128-Novak_Djokovic-Marat_Safin,2,B-XC,34,10,0,5,5,17,17
20050117-M-Australian_Open-R128-Novak_Djokovic-Marat_Safin,2,B-DTM,10,0,0,0,0,7,3
20050117-M-Australian_Open-R128-Novak_Djokovic-Marat_Safin,2,B-DTL,4,2,0,2,0,4,0
20050117-M-Australian_Open-R128-Novak_Djokovic-Marat_Safin,2,B-IO,5,2,0,0,2,3,2
20050117-M-Australian_Open-R128-Novak_Djokovic-Marat_Safin,2,S-XC,4,2,0,2,0,3,1
20050117-M-Australian_Open-R128-Novak_Djokovic-Marat_Safin,2,S-DTM,6,0,0,0,0,4,2
20050117-M-Australian_Open-R128-Novak_Djokovic-Marat_Safin,2,S-DTL,4,0,0,0,0,2,2
20050117-M-Australian_Open-R128-Novak_Djokovic-Marat_Safin,2,S-IO,2,1,0,0,1,1,1
20121008-M-Shanghai_Masters-F-Novak_Djokovic-Andy_Murray,1,F-XC,57,15,7,3,5,37,20
20121008-M-Shanghai_Masters-F-Novak_Djokovic-Andy_Murray,1,F-DTM,64,4,0,0,4,36,28
20121008-M-Shanghai_Masters-F-Novak_Djokovic-Andy_Murray,1,F-DTL,20,4,0,2,2,15,5
20121008-M-Shanghai_Masters-F-Novak_Djokovic-Andy_Murray,1,F-IO,39,11,6,1,4,24,15
20121008-M-Shanghai_Masters-F-Novak_Djokovic-Andy_Murray,1,F-II,6,1,0,0,1,0,6
20121008-M-Shanghai_Masters-F-Novak_Djokovic-Andy_Murray,1,B-XC,73,7,1,2,4,40,33
20121008-M-Shanghai_Masters-F-Novak_Djokovic-Andy_Murray,1,B-DTM,81,2,0,0,2,35,46
20121008-M-Shanghai_Masters-F-Novak_Djokovic-Andy_Murray,1,B-DTL,18,5,2,0,3,8,10
20121008-M-Shanghai_Masters-F-Novak_Djokovic-Andy_Murray,1,B-IO,14,2,0,0,2,7,7
20121008-M-Shanghai_Masters-F-Novak_Djokovic-Andy_Murray,1,S-XC,17,0,0,0,0,7,10
20121008-M-Shanghai_Masters-F-Novak_Djokovic-Andy_Murray,1,S-DTM,21,1,0,0,1,14,7
20121008-M-Shanghai_Masters-F-Novak_Djokovic-Andy_Murray,1,S-DTL,5,0,0,0,0,3,2
20121008-M-Shanghai_Masters-F-Novak_Djokovic-Andy_Murray,1,S-IO,1,1,0,0,1,0,1
20121008-M-Shanghai_Masters-F-Novak_Djokovic-Andy_Murray,2,F-XC,79,16,4,6,6,35,44
20121008-M-Shanghai_Masters-F-Novak_Djokovic-Andy_Murray,2,F-DTM,42,2,0,0,2,20,22
20121008-M-Shanghai_Masters-F-Novak_Djokovic-Andy_Murray,2,F-DTL,18,5,1,0,4,8,10
20121008-M-Shanghai_Masters-F-Novak_Djokovic-Andy_Murray,2,F-IO,63,22,4,8,10,29,34
20121008-M-Shanghai_Masters-F-Novak_Djokovic-Andy_Murray,2,B-XC,74,16,3,4,9,38,36
20121008-M-Shanghai_Masters-F-Novak_Djokovic-Andy_Murray,2,B-DTM,80,7,0,0,7,33,47
20121008-M-Shanghai_Masters-F-Novak_Djokovic-Andy_Murray,2,B-DTL,6,1,0,0,1,1,5
20121008-M-Shanghai_Masters-F-Novak_Djokovic-Andy_Murray,2,B-IO,9,1,1,0,0,4,5
20121008-M-Shanghai_Masters-F-Novak_Djokovic-Andy_Murray,2,S-XC,32,2,0,0,2,20,12
20121008-M-Shanghai_Masters-F-Novak_Djokovic-Andy_Murray,2,S-DTM,26,2,0,0,2,6,20
20121008-M-Shanghai_Masters-F-Novak_Djokovic-Andy_Murray,2,S-DTL,2,0,0,0,0,0,2
20121008-M-Shanghai_Masters-F-Novak_Djokovic-Andy_Murray,2,S-IO,3,1,0,0,1,1,2
20170910-M-US_Open-F-Kevin_Anderson-Rafael_Nadal,1,F-XC,51,7,2,1,4,26,25
20170910-M-US_Open-F-Kevin_Anderson-Rafael_Nadal,1,F-DTM,36,4,0,0,4,6,30
20170910-M-US_Open-F-Kevin_Anderson-Rafael_Nadal,1,F-DTL,6,4,2,1,1,3,3
20170910-M-US_Open-F-Kevin_Anderson-Rafael_Nadal,1,F-IO,35,13,3,4,6,21,14
20170910-M-US_Open-F-Kevin_Anderson-Rafael_Nadal,1,F-II,3,3,1,0,2,1,2
20170910-M-US_Open-F-Kevin_Anderson-Rafael_Nadal,1,B-XC,30,6,1,1,4,12,18
20170910-M-US_Open-F-Kevin_Anderson-Rafael_Nadal,1,B-DTM,28,6,0,0,6,6,22
20170910-M-US_Open-F-Kevin_Anderson-Rafael_Nadal,1,B-DTL,10,6,1,1,4,4,6
20170910-M-US_Open-F-Kevin_Anderson-Rafael_Nadal,1,B-IO,3,1,0,0,1,1,2
20170910-M-US_Open-F-Kevin_Anderson-Rafael_Nadal,1,S-DTM,2,0,0,0,0,0,2
20170910-M-US_Open-F-Kevin_Anderson-Rafael_Nadal,2,F-XC,55,8,4,1,3,35,20
20170910-M-US_Open-F-Kevin_Anderson-Rafael_Nadal,2,F-DTM,27,2,0,1,1,16,11
20170910-M-US_Open-F-Kevin_Anderson-Rafael_Nadal,2,F-DTL,11,4,3,0,1,9,2
20170910-M-US_Open-F-Kevin_Anderson-Rafael_Nadal,2,F-IO,15,4,1,1,2,12,3
20170910-M-US_Open-F-Kevin_Anderson-Rafael_Nadal,2,F-II,1,0,0,0,0,0,1
20170910-M-US_Open-F-Kevin_Anderson-Rafael_Nadal,2,B-XC,23,9,5,4,0,18,5
20170910-M-US_Open-F-Kevin_Anderson-Rafael_Nadal,2,B-DTM,26,0,0,0,0,11,15
20170910-M-US_Open-F-Kevin_Anderson-Rafael_Nadal,2,B-DTL,4,4,2,0,2,2,2
20170910-M-US_Open-F-Kevin_Anderson-Rafael_Nadal,2,S-XC,2,0,0,0,0,1,1
20170910-M-US_Open-F-Kevin_Anderson-Rafael_Nadal,2,S-DTM,15,0,0,0,0,6,9
20170910-M-US_Open-F-Kevin_Anderson-Rafael_Nadal,2,S-DTL,6,0,0,0,0,5,1
20170910-M-US_Open-F-Kevin_Anderson-Rafael_Nadal,2,S-IO,5,1,0,0,1,3,2
20170921-M-Metz-R16-Benoit_Paire-Marcel_Granollers,1,F-XC,27,11,2,4,5,15,12
20170921-M-Metz-R16-Benoit_Paire-Marcel_Granollers,1,F-DTM,10,0,0,0,0,9,1
20170921-M-Metz-R16-Benoit_Paire-Marcel_Granollers,1,F-DTL,17,6,3,2,1,12,5
20170921-M-Metz-R16-Benoit_Paire-Marcel_Granollers,1,F-IO,3,2,1,1,0,3,0
20170921-M-Metz-R16-Benoit_Paire-Marcel_Granollers,1,F-II,1,0,0,0,0,1,0
20170921-M-Metz-R16-Benoit_Paire-Marcel_Granollers,1,B-XC,29,5,3,1,1,17,12
20170921-M-Metz-R16-Benoit_Paire-Marcel_Granollers,1,B-DTM,5,1,0,0,1,2,3
20170921-M-Metz-R16-Benoit_Paire-Marcel_Granollers,1,B-DTL,6,4,2,1,1,5,1
20170921-M-Metz-R16-Benoit_Paire-Marcel_Granollers,1,S-XC,2,0,0,0,0,1,1
20170921-M-Metz-R16-Benoit_Paire-Marcel_Granollers,1,S-DTL,1,0,0,0,0,1,0
20170921-M-Metz-R16-Benoit_Paire-Marcel_Granollers,2,F-XC,33,5,0,2,3,12,21
20170921-M-Metz-R16-Benoit_Paire-Marcel_Granollers,2,F-DTM,4,0,0,0,0,1,3
20170921-M-Metz-R16-Benoit_Paire-Marcel_Granollers,2,F-DTL,2,1,0,0,1,0,2
20170921-M-Metz-R16-Benoit_Paire-Marcel_Granollers,2,F-IO,3,1,0,0,1,0,3
20170921-M-Metz-R16-Benoit_Paire-Marcel_Granollers,2,B-XC,23,4,0,2,2,10,13
20170921-M-Metz-R16-Benoit_Paire-Marcel_Granollers,2,B-DTM,10,0,0,0,0,6,4
20170921-M-Metz-R16-Benoit_Paire-Marcel_Granollers,2,B-DTL,5,0,0,0,0,0,5
20170921-M-Metz-R16-Benoit_Paire-Marcel_Granollers,2,B-IO,2,0,0,0,0,1,1
20170921-M-Metz-R16-Benoit_Paire-Marcel_Granollers,2,S-XC,4,0,0,0,0,0,4
20170921-M-Metz-R16-Benoit_Paire-Marcel_Granollers,2,S-DTM,2,0,0,0,0,1,1
20170921-M-Metz-R16-Benoit_Paire-Marcel_Granollers,2,S-DTL,3,0,0,0,0,2,1
20170921-M-Metz-R16-Benoit_Paire-Marcel_Granollers,2,S-IO,1,0,0,0,0,0,1
20150111-M-Brisbane-F-Milos_Raonic-Roger_Federer,1,F-XC,23,8,4,4,0,14,9
20150111-M-Brisbane-F-Milos_Raonic-Roger_Federer,1,F-DTM,10,1,0,0,1,2,8
20150111-M-Brisbane-F-Milos_Raonic-Roger_Federer,1,F-DTL,10,5,2,1,2,7,3
20150111-M-Brisbane-F-Milos_Raonic-Roger_Federer,1,F-IO,50,15,2,9,4,32,18
20150111-M-Brisbane-F-Milos_Raonic-Roger_Federer,1,F-II,17,11,3,2,6,8,9
20150111-M-Brisbane-F-Milos_Raonic-Roger_Federer,1,B-XC,15,5,2,2,1,9,6
20150111-M-Brisbane-F-Milos_Raonic-Roger_Federer,1,B-DTM,11,6,0,1,5,4,7
20150111-M-Brisbane-F-Milos_Raonic-Roger_Federer,1,B-DTL,12,8,3,2,3,5,7
20150111-M-Brisbane-F-Milos_Raonic-Roger_Federer,1,B-IO,1,1,1,0,0,1,0
20150111-M-Brisbane-F-Milos_Raonic-Roger_Federer,1,S-XC,8,0,0,0,0,3,5
20150111-M-Brisbane-F-Milos_Raonic-Roger_Federer,1,S-DTM,1,0,0,0,0,0,1
20150111-M-Brisbane-F-Milos_Raonic-Roger_Federer,2,F-XC,18,5,1,3,1,10,8
20150111-M-Brisbane-F-Milos_Raonic-Roger_Federer,2,F-DTM,15,1,1,0,0,8,7
20150111-M-Brisbane-F-Milos_Raonic-Roger_Federer,2,F-DTL,14,4,2,2,0,10,4
20150111-M-Brisbane-F-Milos_Raonic-Roger_Federer,2,F-IO,13,2,1,1,0,10,3
20150111-M-Brisbane-F-Milos_Raonic-Roger_Federer,2,F-II,5,3,3,0,0,4,1
20150111-M-Brisbane-F-Milos_Raonic-Roger_Federer,2,B-XC,29,5,0,1,4,13,16
20150111-M-Brisbane-F-Milos_Raonic-Roger_Federer,2,B-DTM,10,1,0,1,0,3,7
20150111-M-Brisbane-F-Milos_Raonic-Roger_Federer,2,B-DTL,12,4,1,1,2,5,7
20150111-M-Brisbane-F-Milos_Raonic-Roger_Federer,2,B-IO,1,0,0,0,0,1,0
20150111-M-Brisbane-F-Milos_Raonic-Roger_Federer,2,S-XC,12,1,0,0,1,4,8
20150111-M-Brisbane-F-Milos_Raonic-Roger_Federer,2,S-DTM,3,0,0,0,0,0,3
20150111-M-Brisbane-F-Milos_Raonic-Roger_Federer,2,S-DTL,4,2,1,1,0,3,1
19930128-M-Australian_Open-SF-Pete_Sampras-Stefan_Edberg,1,F-XC,12,7,1,1,5,3,9
19930128-M-Australian_Open-SF-Pete_Sampras-Stefan_Edberg,1,F-DTM,3,1,0,0,1,1,2
19930128-M-Australian_Open-SF-Pete_Sampras-Stefan_Edberg,1,F-DTL,10,8,4,1,3,6,4
19930128-M-Australian_Open-SF-Pete_Sampras-Stefan_Edberg,1,F-IO,8,2,2,0,0,2,6
19930128-M-Australian_Open-SF-Pete_Sampras-Stefan_Edberg,1,F-II,2,0,0,0,0,0,2
19930128-M-Australian_Open-SF-Pete_Sampras-Stefan_Edberg,1,B-XC,11,5,2,1,2,5,6
19930128-M-Australian_Open-SF-Pete_Sampras-Stefan_Edberg,1,B-DTM,6,1,0,1,0,1,5
19930128-M-Australian_Open-SF-Pete_Sampras-Stefan_Edberg,1,B-DTL,7,4,2,0,2,2,5
19930128-M-Australian_Open-SF-Pete_Sampras-Stefan_Edberg,1,B-IO,1,1,0,1,0,1,0
19930128-M-Australian_Open-SF-Pete_Sampras-Stefan_Edberg,1,S-XC,3,2,0,1,1,1,2
19930128-M-Australian_Open-SF-Pete_Sampras-Stefan_Edberg,1,S-DTM,2,0,0,0,0,1,1
19930128-M-Australian_Open-SF-Pete_Sampras-Stefan_Edberg,1,S-DTL,9,3,0,1,2,3,6
19930128-M-Australian_Open-SF-Pete_Sampras-Stefan_Edberg,1,S-IO,1,0,0,0,0,0,1
19930128-M-Australian_Open-SF-Pete_Sampras-Stefan_Edberg,2,F-XC,10,6,3,1,2,6,4
19930128-M-Australian_Open-SF-Pete_Sampras-Stefan_Edberg,2,F-DTM,4,1,0,1,0,3,1
19930128-M-Australian_Open-SF-Pete_Sampras-Stefan_Edberg,2,F-DTL,14,4,3,1,0,12,2
19930128-M-Australian_Open-SF-Pete_Sampras-Stefan_Edberg,2,F-IO,3,1,0,0,1,1,2
19930128-M-Australian_Open-SF-Pete_Sampras-Stefan_Edberg,2,B-XC,13,6,0,4,2,11,2
19930128-M-Australian_Open-SF-Pete_Sampras-Stefan_Edberg,2,B-DTM,2,2,0,1,1,1,1
19930128-M-Australian_Open-SF-Pete_Sampras-Stefan_Edberg,2,B-DTL,5,3,2,0,1,3,2
19930128-M-Australian_Open-SF-Pete_Sampras-Stefan_Edberg,2,B-IO,2,1,1,0,0,1,1
19930128-M-Australian_Open-SF-Pete_Sampras-Stefan_Edberg,2,S-XC,10,0,0,0,0,6,4
19930128-M-Australian_Open-SF-Pete_Sampras-Stefan_Edberg,2,S-DTM,1,1,0,0,1,0,1
19930128-M-Australian_Open-SF-Pete_Sampras-Stefan_Edberg,2,S-DTL,1,1,0,0,1,0,1
20140113-M-Australian_Open-R128-Ricardas_Berankis-Alexandr_Dolgopolov,1,F-XC,31,10,5,2,3,14,17
20140113-M-Australian_Open-R128-Ricardas_Berankis-Alexandr_Dolgopolov,1,F-DTM,13,0,0,0,0,9,4
20140113-M-Australian_Open-R128-Ricardas_Berankis-Alexandr_Dolgopolov,1,F-DTL,14,4,1,1,2,6,8
20140113-M-Australian_Open-R128-Ricardas_Berankis-Alexandr_Dolgopolov,1,F-IO,20,9,2,4,3,11,9
20140113-M-Australian_Open-R128-Ricardas_Berankis-Alexandr_Dolgopolov,1,F-II,4,1,0,0,1,3,1
20140113-M-Australian_Open-R128-Ricardas_Berankis-Alexandr_Dolgopolov,1,B-XC,38,9,0,6,3,25,13
20140113-M-Australian_Open-R128-Ricardas_Berankis-Alexandr_Dolgopolov,1,B-DTM,22,3,0,0,3,13,9
20140113-M-Australian_Open-R128-Ricardas_Berankis-Alexandr_Dolgopolov,1,B-DTL,6,4,0,1,3,3,3
20140113-M-Australian_Open-R128-Ricardas_Berankis-Alexandr_Dolgopolov,1,B-IO,2,1,1,0,0,2,0
20140113-M-Australian_Open-R128-Ricardas_Berankis-Alexandr_Dolgopolov,1,S-XC,2,0,0,0,0,1,1
20140113-M-Australian_Open-R128-Ricardas_Berankis-Alexandr_Dolgopolov,1,S-DTM,3,0,0,0,0,0,3
20140113-M-Australian_Open-R128-Ricardas_Berankis-Alexandr_Dolgopolov,1,S-DTL,2,0,0,0,0,1,1
20140113-M-Australian_Open-R128-Ricardas_Berankis-Alexandr_Dolgopolov,1,S-IO,1,0,0,0,0,0,1
20140113-M-Australian_Open-R128-Ricardas_Berankis-Alexandr_Dolgopolov,2,F-XC,35,10,5,4,1,22,13
20140113-M-Australian_Open-R128-Ricardas_Berankis-Alexandr_Dolgopolov,2,F-DTM,9,0,0,0,0,6,3
20140113-M-Australian_Open-R128-Ricardas_Berankis-Alexandr_Dolgopolov,2,F-DTL,21,9,6,1,2,10,11
20140113-M-Australian_Open-R128-Ricardas_Berankis-Alexandr_Dolgopolov,2,F-IO,15,4,1,0,3,3,12
20140113-M-Australian_Open-R128-Ricardas_Berankis-Alexandr_Dolgopolov,2,F-II,1,0,0,0,0,1,0
20140113-M-Australian_Open-R128-Ricardas_Berankis-Alexandr_Dolgopolov,2,B-XC,29,12,6,4,2,18,11
20140113-M-Australian_Open-R128-Ricardas_Berankis-Alexandr_Dolgopolov,2,B-DTM,24,1,0,0,1,12,12
20140113-M-Australian_Open-R128-Ricardas_Berankis-Alexandr_Dolgopolov,2,B-DTL,8,3,1,2,0,5,3
20140113-M-Australian_Open-R128-Ricardas_Berankis-Alexandr_Dolgopolov,2,S-XC,7,0,0,0,0,2,5
20140113-M-Australian_Open-R128-Ricardas_Berankis-Alexandr_Dolgopolov,2,S-DTM,6,1,0,0,1,1,5
20140113-M-Australian_Open-R128-Ricardas_Berankis-Alexandr_Dolgopolov,2,S-DTL,5,2,0,0,2,2,3
20140113-M-Australian_Open-R128-Ricardas_Berankis-Alexandr_Dolgopolov,2,S-IO,3,1,0,0,1,1,2
19960119-M-Australian_Open-R32-Mark_Philippoussis-Pete_Sampras,1,F-XC,26,8,4,4,0,19,7
19960119-M-Australian_Open-R32-Mark_Philippoussis-Pete_Sampras,1,F-DTM,9,1,0,0,1,6,3
19960119-M-Australian_Open-R32-Mark_Philippoussis-Pete_Sampras,1,F-DTL,12,6,4,2,0,11,1
19960119-M-Australian_Open-R32-Mark_Philippoussis-Pete_Sampras,1,F-IO,16,6,2,2,2,13,3
19960119-M-Australian_Open-R32-Mark_Philippoussis-Pete_Sampras,1,F-II,9,5,1,2,2,5,4
19960119-M-Australian_Open-R32-Mark_Philippoussis-Pete_Sampras,1,B-XC,22,9,4,3,2,14,8
19960119-M-Australian_Open-R32-Mark_Philippoussis-Pete_Sampras,1,B-DTM,3,0,0,0,0,1,2
19960119-M-Australian_Open-R32-Mark_Philippoussis-Pete_Sampras,1,B-DTL,11,7,4,2,1,7,4
19960119-M-Australian_Open-R32-Mark_Philippoussis-Pete_Sampras,1,S-XC,5,0,0,0,0,3,2
19960119-M-Australian_Open-R32-Mark_Philippoussis-Pete_Sampras,1,S-DTM,4,0,0,0,0,2,2
19960119-M-Australian_Open-R32-Mark_Philippoussis-Pete_Sampras,1,S-DTL,1,0,0,0,0,0,1
19960119-M-Australian_Open-R32-Mark_Philippoussis-Pete_Sampras,2,F-XC,35,16,8,6,2,18,17
19960119-M-Australian_Open-R32-Mark_Philippoussis-Pete_Sampras,2,F-DTM,1,0,0,0,0,0,1
19960119-M-Australian_Open-R32-Mark_Philippoussis-Pete_Sampras,2,F-DTL,8,4,1,0,3,3,5
19960119-M-Australian_Open-R32-Mark_Philippoussis-Pete_Sampras,2,F-IO,6,1,0,1,0,4,2
19960119-M-Australian_Open-R32-Mark_Philippoussis-Pete_Sampras,2,F-II,2,0,0,0,0,0,2
19960119-M-Australian_Open-R32-Mark_Philippoussis-Pete_Sampras,2,B-XC,31,1,0,0,1,10,21
19960119-M-Australian_Open-R32-Mark_Philippoussis-Pete_Sampras,2,B-DTM,6,1,0,0,1,2,4
19960119-M-Australian_Open-R32-Mark_Philippoussis-Pete_Sampras,2,B-DTL,13,9,3,2,4,5,8
19960119-M-Australian_Open-R32-Mark_Philippoussis-Pete_Sampras,2,S-XC,3,1,0,0,1,0,3
19960119-M-Australian_Open-R32-Mark_Philippoussis-Pete_Sampras,2,S-DTM,2,0,0,0,0,1,1
19960119-M-Australian_Open-R32-Mark_Philippoussis-Pete_Sampras,2,S-DTL,1,0,0,0,0,1,0
20030706-M-Wimbledon-F-Roger_Federer-Mark_Philippoussis,1,F-XC,12,9,5,4,0,12,0
20030706-M-Wimbledon-F-Roger_Federer-Mark_Philippoussis,1,F-DTM,5,0,0,0,0,3,2
20030706-M-Wimbledon-F-Roger_Federer-Mark_Philippoussis,1,F-DTL,3,1,1,0,0,2,1
20030706-M-Wimbledon-F-Roger_Federer-Mark_Philippoussis,1,F-IO,8,3,2,1,0,7,1
20030706-M-Wimbledon-F-Roger_Federer-Mark_Philippoussis,1,F-II,2,2,1,1,0,2,0
20030706-M-Wimbledon-F-Roger_Federer-Mark_Philippoussis,1,B-XC,11,4,1,1,2,7,4
20030706-M-Wimbledon-F-Roger_Federer-Mark_Philippoussis,1,B-DTM,4,0,0,0,0,3,1
20030706-M-Wimbledon-F-Roger_Federer-Mark_Philippoussis,1,B-DTL,5,4,2,2,0,5,0
20030706-M-Wimbledon-F-Roger_Federer-Mark_Philippoussis,1,S-XC,3,1,1,0,0,2,1
20030706-M-Wimbledon-F-Roger_Federer-Mark_Philippoussis,1,S-DTM,3,0,0,0,0,1,2
20030706-M-Wimbledon-F-Roger_Federer-Mark_Philippoussis,1,S-DTL,3,1,0,1,0,2,1
20030706-M-Wimbledon-F-Roger_Federer-Mark_Philippoussis,2,F-XC,9,3,0,1,2,1,8
20030706-M-Wimbledon-F-Roger_Federer-Mark_Philippoussis,2,F-DTM,5,2,2,0,0,2,3
20030706-M-Wimbledon-F-Roger_Federer-Mark_Philippoussis,2,F-DTL,2,0,0,0,0,1,1
20030706-M-Wimbledon-F-Roger_Federer-Mark_Philippoussis,2,F-IO,3,1,0,0,1,1,2
20030706-M-Wimbledon-F-Roger_Federer-Mark_Philippoussis,2,B-XC,9,2,1,0,1,4,5
20030706-M-Wimbledon-F-Roger_Federer-Mark_Philippoussis,2,B-DTM,2,0,0,0,0,0,2
20030706-M-Wimbledon-F-Roger_Federer-Mark_Philippoussis,2,B-IO,1,1,0,0,1,0,1
20030706-M-Wimbledon-F-Roger_Federer-Mark_Philippoussis,2,S-XC,3,0,0,0,0,0,3
20030706-M-Wimbledon-F-Roger_Federer-Mark_Philippoussis,2,S-DTM,2,0,0,0,0,0,2
20030706-M-Wimbledon-F-Roger_Federer-Mark_Philippoussis,2,S-DTL,3,0,0,0,0,0,3
20170619-M-Halle-F-Alexander_Zverev-Roger_Federer,1,F-XC,9,4,2,0,2,4,5
20170619-M-Halle-F-Alexander_Zverev-Roger_Federer,1,F-DTM,2,0,0,0,0,0,2
20170619-M-Halle-F-Alexander_Zverev-Roger_Federer,1,F-DTL,6,3,0,0,3,0,6
20170619-M-Halle-F-Alexander_Zverev-Roger_Federer,1,F-IO,15,7,3,0,4,5,10
20170619-M-Halle-F-Alexander_Zverev-Roger_Federer,1,B-XC,13,3,0,0,3,3,10
20170619-M-Halle-F-Alexander_Zverev-Roger_Federer,1,B-DTM,9,0,0,0,0,2,7
20170619-M-Halle-F-Alexander_Zverev-Roger_Federer,1,B-DTL,2,1,1,0,0,1,1
20170619-M-Halle-F-Alexander_Zverev-Roger_Federer,1,B-IO,2,1,0,0,1,0,2
20170619-M-Halle-F-Alexander_Zverev-Roger_Federer,1,S-DTM,3,1,0,1,0,1,2
20170619-M-Halle-F-Alexander_Zverev-Roger_Federer,1,S-DTL,2,0,0,0,0,0,2
20170619-M-Halle-F-Alexander_Zverev-Roger_Federer,2,F-XC,8,4,0,2,2,5,3
20170619-M-Halle-F-Alexander_Zverev-Roger_Federer,2,F-DTM,10,3,0,1,2,5,5
20170619-M-Halle-F-Alexander_Zverev-Roger_Federer,2,F-IO,6,4,3,0,1,5,1
20170619-M-Halle-F-Alexander_Zverev-Roger_Federer,2,F-II,2,1,1,0,0,1,1
20170619-M-Halle-F-Alexander_Zverev-Roger_Federer,2,B-XC,1,0,0,0,0,1,0
20170619-M-Halle-F-Alexander_Zverev-Roger_Federer,2,B-DTM,4,1,0,1,0,3,1
20170619-M-Halle-F-Alexander_Zverev-Roger_Federer,2,B-DTL,5,1,0,1,0,4,1
20170619-M-Halle-F-Alexander_Zverev-Roger_Federer,2,B-IO,1,0,0,0,0,1,0
20170619-M-Halle-F-Alexander_Zverev-Roger_Federer,2,S-XC,4,0,0,0,0,4,0
20170619-M-Halle-F-Alexander_Zverev-Roger_Federer,2,S-DTM,7,2,0,0,2,5,2
20170619-M-Halle-F-Alexander_Zverev-Roger_Federer,2,S-DTL,1,0,0,0,0,0,1
20170619-M-Halle-F-Alexander_Zverev-Roger_Federer,2,S-IO,1,1,0,0,1,0,1
19940128-M-Australian_Open-SF-Pete_Sampras-Jim_Courier,1,F-XC,15,8,6,2,0,11,4
19940128-M-Australian_Open-SF-Pete_Sampras-Jim_Courier,1,F-DTM,12,1,0,1,0,7,5
19940128-M-Australian_Open-SF-Pete_Sampras-Jim_Courier,1,F-DTL,12,4,1,2,1,8,4
19940128-M-Australian_Open-SF-Pete_Sampras-Jim_Courier,1,F-IO,22,6,0,6,0,18,4
19940128-M-Australian_Open-SF-Pete_Sampras-Jim_Courier,1,F-II,2,1,1,0,0,2,0
19940128-M-Australian_Open-SF-Pete_Sampras-Jim_Courier,1,B-XC,18,3,2,0,1,9,9
19940128-M-Australian_Open-SF-Pete_Sampras-Jim_Courier,1,B-DTM,20,2,0,0,2,7,13
19940128-M-Australian_Open-SF-Pete_Sampras-Jim_Courier,1,B-DTL,8,2,1,0,1,5,3
19940128-M-Australian_Open-SF-Pete_Sampras-Jim_Courier,1,B-IO,2,0,0,0,0,1,1
19940128-M-Australian_Open-SF-Pete_Sampras-Jim_Courier,1,S-XC,11,3,0,1,2,6,5
19940128-M-Australian_Open-SF-Pete_Sampras-Jim_Courier,1,S-DTM,3,0,0,0,0,2,1
19940128-M-Australian_Open-SF-Pete_Sampras-Jim_Courier,1,S-DTL,3,2,1,1,0,2,1
19940128-M-Australian_Open-SF-Pete_Sampras-Jim_Courier,1,S-IO,1,0,0,0,0,1,0
19940128-M-Australian_Open-SF-Pete_Sampras-Jim_Courier,2,F-XC,23,6,2,2,2,11,12
19940128-M-Australian_Open-SF-Pete_Sampras-Jim_Courier,2,F-DTM,13,3,0,1,2,2,11
19940128-M-Australian_Open-SF-Pete_Sampras-Jim_Courier,2,F-DTL,5,1,0,1,0,2,3
19940128-M-Australian_Open-SF-Pete_Sampras-Jim_Courier,2,F-IO,36,11,1,6,4,26,10
19940128-M-Australian_Open-SF-Pete_Sampras-Jim_Courier,2,F-II,3,1,0,1,0,2,1
19940128-M-Australian_Open-SF-Pete_Sampras-Jim_Courier,2,B-XC,16,1,0,0,1,4,12
19940128-M-Australian_Open-SF-Pete_Sampras-Jim_Courier,2,B-DTM,14,0,0,0,0,1,13
19940128-M-Australian_Open-SF-Pete_Sampras-Jim_Courier,2,B-DTL,8,7,3,1,3,5,3
19940128-M-Australian_Open-SF-Pete_Sampras-Jim_Courier,2,B-IO,2,1,0,1,0,1,1
19940128-M-Australian_Open-SF-Pete_Sampras-Jim_Courier,2,S-XC,11,2,0,2,0,4,7
19940128-M-Australian_Open-SF-Pete_Sampras-Jim_Courier,2,S-DTM,4,0,0,0,0,3,1
19940128-M-Australian_Open-SF-Pete_Sampras-Jim_Courier,2,S-DTL,2,0,0,0,0,0,2
19980913-M-US_Open-F-Patrick_Rafter-Mark_Philippoussis,1,F-XC,7,5,4,1,0,6,1
19980913-M-US_Open-F-Patrick_Rafter-Mark_Philippoussis,1,F-DTM,2,0,0,0,0,1,1
19980913-M-US_Open-F-Patrick_Rafter-Mark_Philippoussis,1,F-DTL,1,0,0,0,0,1,0
19980913-M-US_Open-F-Patrick_Rafter-Mark_Philippoussis,1,F-IO,1,1,1,0,0,1,0
19980913-M-US_Open-F-Patrick_Rafter-Mark_Philippoussis,1,B-XC,3,3,3,0,0,3,0
19980913-M-US_Open-F-Patrick_Rafter-Mark_Philippoussis,1,B-DTM,2,1,1,0,0,1,1
19980913-M-US_Open-F-Patrick_Rafter-Mark_Philippoussis,1,B-DTL,2,1,1,0,0,1,1
19980913-M-US_Open-F-Patrick_Rafter-Mark_Philippoussis,1,B-IO,2,2,1,0,1,1,1
19980913-M-US_Open-F-Patrick_Rafter-Mark_Philippoussis,1,S-XC,1,0,0,0,0,1,0
19980913-M-US_Open-F-Patrick_Rafter-Mark_Philippoussis,1,S-DTM,6,0,0,0,0,4,2
19980913-M-US_Open-F-Patrick_Rafter-Mark_Philippoussis,1,S-DTL,1,1,1,0,0,1,0
19980913-M-US_Open-F-Patrick_Rafter-Mark_Philippoussis,1,S-IO,1,1,0,1,0,1,0
19980913-M-US_Open-F-Patrick_Rafter-Mark_Philippoussis,2,F-XC,7,4,0,3,1,4,3
19980913-M-US_Open-F-Patrick_Rafter-Mark_Philippoussis,2,F-DTM,6,3,1,1,1,3,3
19980913-M-US_Open-F-Patrick_Rafter-Mark_Philippoussis,2,F-DTL,1,1,0,1,0,1,0
19980913-M-US_Open-F-Patrick_Rafter-Mark_Philippoussis,2,F-IO,1,1,0,0,1,0,1
19980913-M-US_Open-F-Patrick_Rafter-Mark_Philippoussis,2,B-XC,4,2,1,1,0,2,2
19980913-M-US_Open-F-Patrick_Rafter-Mark_Philippoussis,2,B-DTM,1,1,1,0,0,1,0
19980913-M-US_Open-F-Patrick_Rafter-Mark_Philippoussis,2,B-DTL,2,2,1,0,1,1,1
19980913-M-US_Open-F-Patrick_Rafter-Mark_Philippoussis,2,B-IO,1,1,0,0,1,0,1
19980913-M-US_Open-F-Patrick_Rafter-Mark_Philippoussis,2,S-XC,1,0,0,0,0,0,1
20140420-M-Monte_Carlo_Masters-F-Stanislas_Wawrinka-Roger_Federer,1,F-XC,41,8,2,3,3,25,16
20140420-M-Monte_Carlo_Masters-F-Stanislas_Wawrinka-Roger_Federer,1,F-DTM,35,3,1,0,2,20,15
20140420-M-Monte_Carlo_Masters-F-Stanislas_Wawrinka-Roger_Federer,1,F-DTL,11,6,1,1,4,5,6
20140420-M-Monte_Carlo_Masters-F-Stanislas_Wawrinka-Roger_Federer,1,F-IO,26,7,2,2,3,15,11
20140420-M-Monte_Carlo_Masters-F-Stanislas_Wawrinka-Roger_Federer,1,F-II,7,4,0,3,1,4,3
20140420-M-Monte_Carlo_Masters-F-Stanislas_Wawrinka-Roger_Federer,1,B-XC,69,14,3,6,5,45,24
20140420-M-Monte_Carlo_Masters-F-Stanislas_Wawrinka-Roger_Federer,1,B-DTM,20,2,0,0,2,12,8
20140420-M-Monte_Carlo_Masters-F-Stanislas_Wawrinka-Roger_Federer,1,B-DTL,14,7,4,1,2,9,5
20140420-M-Monte_Carlo_Masters-F-Stanislas_Wawrinka-Roger_Federer,1,B-IO,5,3,0,1,2,3,2
20140420-M-Monte_Carlo_Masters-F-Stanislas_Wawrinka-Roger_Federer,1,S-XC,5,1,1,0,0,3,2
20140420-M-Monte_Carlo_Masters-F-Stanislas_Wawrinka-Roger_Federer,1,S-DTM,2,0,0,0,0,1,1
20140420-M-Monte_Carlo_Masters-F-Stanislas_Wawrinka-Roger_Federer,1,S-DTL,3,0,0,0,0,1,2
20140420-M-Monte_Carlo_Masters-F-Stanislas_Wawrinka-Roger_Federer,2,F-XC,43,9,3,3,3,21,22
20140420-M-Monte_Carlo_Masters-F-Stanislas_Wawrinka-Roger_Federer,2,F-DTM,36,5,0,0,5,10,26
20140420-M-Monte_Carlo_Masters-F-Stanislas_Wawrinka-Roger_Federer,2,F-DTL,15,4,0,3,1,7,8
20140420-M-Monte_Carlo_Masters-F-Stanislas_Wawrinka-Roger_Federer,2,F-IO,31,7,1,3,3,15,16
20140420-M-Monte_Carlo_Masters-F-Stanislas_Wawrinka-Roger_Federer,2,F-II,7,3,1,1,1,4,3
20140420-M-Monte_Carlo_Masters-F-Stanislas_Wawrinka-Roger_Federer,2,B-XC,40,13,2,4,7,17,23
20140420-M-Monte_Carlo_Masters-F-Stanislas_Wawrinka-Roger_Federer,2,B-DTM,29,3,1,1,1,12,17
20140420-M-Monte_Carlo_Masters-F-Stanislas_Wawrinka-Roger_Federer,2,B-DTL,9,6,1,1,4,4,5
20140420-M-Monte_Carlo_Masters-F-Stanislas_Wawrinka-Roger_Federer,2,B-IO,1,1,0,0,1,0,1
20140420-M-Monte_Carlo_Masters-F-Stanislas_Wawrinka-Roger_Federer,2,S-XC,12,0,0,0,0,3,9
20140420-M-Monte_Carlo_Masters-F-Stanislas_Wawrinka-Roger_Federer,2,S-DTM,9,1,0,0,1,4,5
20140420-M-Monte_Carlo_Masters-F-Stanislas_Wawrinka-Roger_Federer,2,S-IO,1,0,0,0,0,1,0
20150419-M-Monte_Carlo_Masters-F-Novak_Djokovic-Tomas_Berdych,1,F-XC,71,23,10,5,8,36,35
20150419-M-Monte_Carlo_Masters-F-Novak_Djokovic-Tomas_Berdych,1,F-DTM,44,3,1,0,2,23,21
20150419-M-Monte_Carlo_Masters-F-Novak_Djokovic-Tomas_Berdych,1,F-DTL,14,4,1,0,3,6,8
20150419-M-Monte_Carlo_Masters-F-Novak_Djokovic-Tomas_Berdych,1,F-IO,19,4,0,1,3,9,10
20150419-M-Monte_Carlo_Masters-F-Novak_Djokovic-Tomas_Berdych,1,F-II,4,1,0,1,0,4,0
20150419-M-Monte_Carlo_Masters-F-Novak_Djokovic-Tomas_Berdych,1,B-XC,78,7,0,1,6,37,41
20150419-M-Monte_Carlo_Masters-F-Novak_Djokovic-Tomas_Berdych,1,B-DTM,56,5,0,1,4,28,28
20150419-M-Monte_Carlo_Masters-F-Novak_Djokovic-Tomas_Berdych,1,B-DTL,18,4,3,0,1,9,9
20150419-M-Monte_Carlo_Masters-F-Novak_Djokovic-Tomas_Berdych,1,B-IO,10,2,0,0,2,5,5
20150419-M-Monte_Carlo_Masters-F-Novak_Djokovic-Tomas_Berdych,1,S-XC,10,0,0,0,0,5,5
20150419-M-Monte_Carlo_Masters-F-Novak_Djokovic-Tomas_Berdych,1,S-DTM,14,3,0,0,3,2,12
20150419-M-Monte_Carlo_Masters-F-Novak_Djokovic-Tomas_Berdych,1,S-DTL,1,0,0,0,0,0,1
20150419-M-Monte_Carlo_Masters-F-Novak_Djokovic-Tomas_Berdych,1,S-IO,1,1,0,0,1,0,1
20150419-M-Monte_Carlo_Masters-F-Novak_Djokovic-Tomas_Berdych,2,F-XC,74,14,4,1,9,42,32
20150419-M-Monte_Carlo_Masters-F-Novak_Djokovic-Tomas_Berdych,2,F-DTM,40,3,0,0,3,14,26
20150419-M-Monte_Carlo_Masters-F-Novak_Djokovic-Tomas_Berdych,2,F-DTL,13,4,0,0,4,5,8
20150419-M-Monte_Carlo_Masters-F-Novak_Djokovic-Tomas_Berdych,2,F-IO,40,13,1,1,11,17,23
20150419-M-Monte_Carlo_Masters-F-Novak_Djokovic-Tomas_Berdych,2,F-II,6,2,1,1,0,5,1
20150419-M-Monte_Carlo_Masters-F-Novak_Djokovic-Tomas_Berdych,2,B-XC,98,15,2,1,12,49,49
20150419-M-Monte_Carlo_Masters-F-Novak_Djokovic-Tomas_Berdych,2,B-DTM,40,3,0,0,3,20,20
20150419-M-Monte_Carlo_Masters-F-Novak_Djokovic-Tomas_Berdych,2,B-DTL,17,7,4,0,3,10,7
20150419-M-Monte_Carlo_Masters-F-Novak_Djokovic-Tomas_Berdych,2,B-IO,10,3,1,1,1,6,4
20150419-M-Monte_Carlo_Masters-F-Novak_Djokovic-Tomas_Berdych,2,S-XC,14,3,0,1,2,7,7
20150419-M-Monte_Carlo_Masters-F-Novak_Djokovic-Tomas_Berdych,2,S-DTM,6,0,0,0,0,3,3
20150419-M-Monte_Carlo_Masters-F-Novak_Djokovic-Tomas_Berdych,2,S-DTL,1,0,0,0,0,1,0
20150419-M-Monte_Carlo_Masters-F-Novak_Djokovic-Tomas_Berdych,2,S-IO,2,0,0,0,0,1,1
20080511-M-Rome_Masters-F-Novak_Djokovic-Stanislas_Wawrinka,1,F-XC,45,6,2,2,2,25,20
20080511-M-Rome_Masters-F-Novak_Djokovic-Stanislas_Wawrinka,1,F-DTM,38,1,0,0,1,22,16
20080511-M-Rome_Masters-F-Novak_Djokovic-Stanislas_Wawrinka,1,F-DTL,11,3,1,0,2,4,7
20080511-M-Rome_Masters-F-Novak_Djokovic-Stanislas_Wawrinka,1,F-IO,27,9,6,2,1,19,8
20080511-M-Rome_Masters-F-Novak_Djokovic-Stanislas_Wawrinka,1,F-II,6,2,1,0,1,2,4
20080511-M-Rome_Masters-F-Novak_Djokovic-Stanislas_Wawrinka,1,B-XC,52,6,2,0,4,30,22
20080511-M-Rome_Masters-F-Novak_Djokovic-Stanislas_Wawrinka,1,B-DTM,38,1,0,0,1,22,16
20080511-M-Rome_Masters-F-Novak_Djokovic-Stanislas_Wawrinka,1,B-DTL,18,8,1,3,4,11,7
20080511-M-Rome_Masters-F-Novak_Djokovic-Stanislas_Wawrinka,1,B-IO,3,2,0,0,2,0,3
20080511-M-Rome_Masters-F-Novak_Djokovic-Stanislas_Wawrinka,1,S-XC,2,0,0,0,0,1,1
20080511-M-Rome_Masters-F-Novak_Djokovic-Stanislas_Wawrinka,1,S-DTM,3,0,0,0,0,2,1
20080511-M-Rome_Masters-F-Novak_Djokovic-Stanislas_Wawrinka,2,F-XC,61,14,2,4,8,32,29
20080511-M-Rome_Masters-F-Novak_Djokovic-Stanislas_Wawrinka,2,F-DTM,34,6,1,0,5,12,22
20080511-M-Rome_Masters-F-Novak_Djokovic-Stanislas_Wawrinka,2,F-DTL,8,2,1,0,1,3,5
20080511-M-Rome_Masters-F-Novak_Djokovic-Stanislas_Wawrinka,2,F-IO,23,6,2,1,3,10,13
20080511-M-Rome_Masters-F-Novak_Djokovic-Stanislas_Wawrinka,2,F-II,1,1,0,1,0,1,0
20080511-M-Rome_Masters-F-Novak_Djokovic-Stanislas_Wawrinka,2,B-XC,71,6,2,0,4,34,37
20080511-M-Rome_Masters-F-Novak_Djokovic-Stanislas_Wawrinka,2,B-DTM,27,4,0,0,4,9,18
20080511-M-Rome_Masters-F-Novak_Djokovic-Stanislas_Wawrinka,2,B-DTL,6,2,0,1,1,4,2
20080511-M-Rome_Masters-F-Novak_Djokovic-Stanislas_Wawrinka,2,B-IO,4,2,0,0,2,2,2
20080511-M-Rome_Masters-F-Novak_Djokovic-Stanislas_Wawrinka,2,S-XC,14,0,0,0,0,6,8
20080511-M-Rome_Masters-F-Novak_Djokovic-Stanislas_Wawrinka,2,S-DTM,6,0,0,0,0,1,5
20080511-M-Rome_Masters-F-Novak_Djokovic-Stanislas_Wawrinka,2,S-DTL,1,1,1,0,0,1,0
20171015-M-Shanghai_Masters-F-Rafael_Nadal-Roger_Federer,1,F-XC,24,4,2,1,1,11,13
20171015-M-Shanghai_Masters-F-Rafael_Nadal-Roger_Federer,1,F-DTM,10,0,0,0,0,3,7
20171015-M-Shanghai_Masters-F-Rafael_Nadal-Roger_Federer,1,F-DTL,4,1,0,1,0,2,2
20171015-M-Shanghai_Masters-F-Rafael_Nadal-Roger_Federer,1,F-IO,8,3,0,0,3,3,5
20171015-M-Shanghai_Masters-F-Rafael_Nadal-Roger_Federer,1,B-XC,24,7,0,3,4,10,14
20171015-M-Shanghai_Masters-F-Rafael_Nadal-Roger_Federer,1,B-DTM,15,3,0,0,3,3,12
20171015-M-Shanghai_Masters-F-Rafael_Nadal-Roger_Federer,1,B-DTL,7,4,0,1,3,2,5
20171015-M-Shanghai_Masters-F-Rafael_Nadal-Roger_Federer,1,B-IO,8,4,0,2,2,5,3
20171015-M-Shanghai_Masters-F-Rafael_Nadal-Roger_Federer,1,S-DTM,4,0,0,0,0,1,3
20171015-M-Shanghai_Masters-F-Rafael_Nadal-Roger_Federer,1,S-DTL,1,0,0,0,0,0,1
20171015-M-Shanghai_Masters-F-Rafael_Nadal-Roger_Federer,1,S-IO,1,0,0,0,0,0,1
20171015-M-Shanghai_Masters-F-Rafael_Nadal-Roger_Federer,2,F-XC,22,5,5,0,0,17,5
20171015-M-Shanghai_Masters-F-Rafael_Nadal-Roger_Federer,2,F-DTM,17,1,0,0,1,8,9
20171015-M-Shanghai_Masters-F-Rafael_Nadal-Roger_Federer,2,F-DTL,3,2,1,0,1,2,1
20171015-M-Shanghai_Masters-F-Rafael_Nadal-Roger_Federer,2,F-IO,11,3,2,0,1,7,4
20171015-M-Shanghai_Masters-F-Rafael_Nadal-Roger_Federer,2,F-II,4,1,0,1,0,2,2
20171015-M-Shanghai_Masters-F-Rafael_Nadal-Roger_Federer,2,B-XC,9,4,3,0,1,5,4
20171015-M-Shanghai_Masters-F-Rafael_Nadal-Roger_Federer,2,B-DTM,15,1,0,0,1,10,5
20171015-M-Shanghai_Masters-F-Rafael_Nadal-Roger_Federer,2,B-DTL,3,2,2,0,0,3,0
20171015-M-Shanghai_Masters-F-Rafael_Nadal-Roger_Federer,2,B-IO,1,1,0,0,1,0,1
20171015-M-Shanghai_Masters-F-Rafael_Nadal-Roger_Federer,2,S-XC,1,0,0,0,0,0,1
20171015-M-Shanghai_Masters-F-Rafael_Nadal-Roger_Federer,2,S-DTM,5,0,0,0,0,3,2
20171015-M-Shanghai_Masters-F-Rafael_Nadal-Roger_Federer,2,S-DTL,2,1,0,0,1,1,1
20061105-M-Paris_Masters-F-Nikolay_Davydenko-Dominik_Hrbaty,1,F-XC,41,14,5,4,5,27,14
20061105-M-Paris_Masters-F-Nikolay_Davydenko-Dominik_Hrbaty,1,F-DTM,25,4,0,2,2,14,11
20061105-M-Paris_Masters-F-Nikolay_Davydenko-Dominik_Hrbaty,1,F-DTL,15,10,3,2,5,9,6
20061105-M-Paris_Masters-F-Nikolay_Davydenko-Dominik_Hrbaty,1,F-IO,20,10,4,3,3,14,6
20061105-M-Paris_Masters-F-Nikolay_Davydenko-Dominik_Hrbaty,1,B-XC,32,7,2,2,3,20,12
20061105-M-Paris_Masters-F-Nikolay_Davydenko-Dominik_Hrbaty,1,B-DTM,49,5,0,0,5,25,24
20061105-M-Paris_Masters-F-Nikolay_Davydenko-Dominik_Hrbaty,1,B-DTL,9,5,1,2,2,6,3
20061105-M-Paris_Masters-F-Nikolay_Davydenko-Dominik_Hrbaty,1,B-IO,1,1,1,0,0,1,0
20061105-M-Paris_Masters-F-Nikolay_Davydenko-Dominik_Hrbaty,1,S-XC,6,0,0,0,0,4,2
20061105-M-Paris_Masters-F-Nikolay_Davydenko-Dominik_Hrbaty,1,S-DTM,3,0,0,0,0,0,3
20061105-M-Paris_Masters-F-Nikolay_Davydenko-Dominik_Hrbaty,2,F-XC,39,7,1,2,4,16,23
20061105-M-Paris_Masters-F-Nikolay_Davydenko-Dominik_Hrbaty,2,F-DTM,28,5,0,0,5,8,20
20061105-M-Paris_Masters-F-Nikolay_Davydenko-Dominik_Hrbaty,2,F-DTL,10,3,1,0,2,3,7
20061105-M-Paris_Masters-F-Nikolay_Davydenko-Dominik_Hrbaty,2,F-IO,13,3,0,1,2,5,8
20061105-M-Paris_Masters-F-Nikolay_Davydenko-Dominik_Hrbaty,2,F-II,1,0,0,0,0,0,1
20061105-M-Paris_Masters-F-Nikolay_Davydenko-Dominik_Hrbaty,2,B-XC,53,6,0,2,4,22,31
20061105-M-Paris_Masters-F-Nikolay_Davydenko-Dominik_Hrbaty,2,B-DTM,32,6,0,0,6,12,20
20061105-M-Paris_Masters-F-Nikolay_Davydenko-Dominik_Hrbaty,2,B-DTL,4,3,1,0,2,2,2
20061105-M-Paris_Masters-F-Nikolay_Davydenko-Dominik_Hrbaty,2,B-IO,7,2,1,0,1,3,4
20061105-M-Paris_Masters-F-Nikolay_Davydenko-Dominik_Hrbaty,2,S-DTM,1,0,0,0,0,1,0
20061105-M-Paris_Masters-F-Nikolay_Davydenko-Dominik_Hrbaty,2,S-DTL,3,0,0,0,0,2,1
20031019-M-Madrid_Masters-F-Juan_Carlos_Ferrero-Nicolas_Massu,1,F-XC,56,13,4,4,5,40,16
20031019-M-Madrid_Masters-F-Juan_Carlos_Ferrero-Nicolas_Massu,1,F-DTM,33,1,0,0,1,17,16
20031019-M-Madrid_Masters-F-Juan_Carlos_Ferrero-Nicolas_Massu,1,F-DTL,15,1,1,0,0,13,2
20031019-M-Madrid_Masters-F-Juan_Carlos_Ferrero-Nicolas_Massu,1,F-IO,41,6,2,0,4,26,15
20031019-M-Madrid_Masters-F-Juan_Carlos_Ferrero-Nicolas_Massu,1,F-II,6,4,0,2,2,4,2
20031019-M-Madrid_Masters-F-Juan_Carlos_Ferrero-Nicolas_Massu,1,B-XC,94,7,0,2,5,52,42
20031019-M-Madrid_Masters-F-Juan_Carlos_Ferrero-Nicolas_Massu,1,B-DTM,29,2,0,0,2,18,11
20031019-M-Madrid_Masters-F-Juan_Carlos_Ferrero-Nicolas_Massu,1,B-DTL,14,6,0,2,4,7,7
20031019-M-Madrid_Masters-F-Juan_Carlos_Ferrero-Nicolas_Massu,1,B-IO,5,3,2,0,1,3,2
20031019-M-Madrid_Masters-F-Juan_Carlos_Ferrero-Nicolas_Massu,1,S-XC,1,0,0,0,0,0,1
20031019-M-Madrid_Masters-F-Juan_Carlos_Ferrero-Nicolas_Massu,1,S-DTM,4,0,0,0,0,2,2
20031019-M-Madrid_Masters-F-Juan_Carlos_Ferrero-Nicolas_Massu,1,S-DTL,1,1,1,0,0,1,0
20031019-M-Madrid_Masters-F-Juan_Carlos_Ferrero-Nicolas_Massu,2,F-XC,46,13,2,5,6,19,27
20031019-M-Madrid_Masters-F-Juan_Carlos_Ferrero-Nicolas_Massu,2,F-DTM,46,5,0,0,5,14,32
20031019-M-Madrid_Masters-F-Juan_Carlos_Ferrero-Nicolas_Massu,2,F-DTL,15,4,0,0,4,6,9
20031019-M-Madrid_Masters-F-Juan_Carlos_Ferrero-Nicolas_Massu,2,F-IO,62,9,3,3,3,25,37
20031019-M-Madrid_Masters-F-Juan_Carlos_Ferrero-Nicolas_Massu,2,F-II,6,3,0,1,2,3,3
20031019-M-Madrid_Masters-F-Juan_Carlos_Ferrero-Nicolas_Massu,2,B-XC,55,5,1,1,3,24,31
20031019-M-Madrid_Masters-F-Juan_Carlos_Ferrero-Nicolas_Massu,2,B-DTM,60,3,0,0,3,18,42
20031019-M-Madrid_Masters-F-Juan_Carlos_Ferrero-Nicolas_Massu,2,B-DTL,8,5,0,1,4,4,4
20031019-M-Madrid_Masters-F-Juan_Carlos_Ferrero-Nicolas_Massu,2,B-IO,2,1,0,0,1,1,1
20031019-M-Madrid_Masters-F-Juan_Carlos_Ferrero-Nicolas_Massu,2,S-XC,8,2,0,0,2,2,6
20031019-M-Madrid_Masters-F-Juan_Carlos_Ferrero-Nicolas_Massu,2,S-DTM,4,0,0,0,0,2,2
20031019-M-Madrid_Masters-F-Juan_Carlos_Ferrero-Nicolas_Massu,2,S-DTL,2,0,0,0,0,1,1
20060521-M-Hamburg_Masters-F-Tommy_Robredo-Radek_Stepanek,1,F-XC,16,3,0,2,1,12,4
20060521-M-Hamburg_Masters-F-Tommy_Robredo-Radek_Stepanek,1,F-DTM,32,1,0,1,0,24,8
20060521-M-Hamburg_Masters-F-Tommy_Robredo-Radek_Stepanek,1,F-DTL,6,2,2,0,0,4,2
20060521-M-Hamburg_Masters-F-Tommy_Robredo-Radek_Stepanek,1,F-IO,45,8,3,4,1,38,7
20060521-M-Hamburg_Masters-F-Tommy_Robredo-Radek_Stepanek,1,F-II,10,3,1,2,0,10,0
20060521-M-Hamburg_Masters-F-Tommy_Robredo-Radek_Stepanek,1,B-XC,34,8,4,1,3,23,11
20060521-M-Hamburg_Masters-F-Tommy_Robredo-Radek_Stepanek,1,B-DTM,46,4,0,0,4,27,19
20060521-M-Hamburg_Masters-F-Tommy_Robredo-Radek_Stepanek,1,B-DTL,15,8,6,1,1,10,5
20060521-M-Hamburg_Masters-F-Tommy_Robredo-Radek_Stepanek,1,B-IO,1,1,0,0,1,0,1
20060521-M-Hamburg_Masters-F-Tommy_Robredo-Radek_Stepanek,1,S-XC,4,0,0,0,0,1,3
20060521-M-Hamburg_Masters-F-Tommy_Robredo-Radek_Stepanek,1,S-DTM,4,0,0,0,0,0,4
20060521-M-Hamburg_Masters-F-Tommy_Robredo-Radek_Stepanek,1,S-DTL,3,1,1,0,0,3,0
20060521-M-Hamburg_Masters-F-Tommy_Robredo-Radek_Stepanek,1,S-IO,1,0,0,0,0,1,0
20060521-M-Hamburg_Masters-F-Tommy_Robredo-Radek_Stepanek,2,F-XC,11,8,2,2,4,4,7
20060521-M-Hamburg_Masters-F-Tommy_Robredo-Radek_Stepanek,2,F-DTM,15,3,0,0,3,0,15
20060521-M-Hamburg_Masters-F-Tommy_Robredo-Radek_Stepanek,2,F-DTL,10,2,1,0,1,2,8
20060521-M-Hamburg_Masters-F-Tommy_Robredo-Radek_Stepanek,2,F-IO,8,3,0,2,1,4,4
20060521-M-Hamburg_Masters-F-Tommy_Robredo-Radek_Stepanek,2,B-XC,63,16,2,1,13,16,47
20060521-M-Hamburg_Masters-F-Tommy_Robredo-Radek_Stepanek,2,B-DTM,27,3,1,0,2,5,22
20060521-M-Hamburg_Masters-F-Tommy_Robredo-Radek_Stepanek,2,B-DTL,11,6,1,2,3,4,7
20060521-M-Hamburg_Masters-F-Tommy_Robredo-Radek_Stepanek,2,B-IO,9,3,0,0,3,4,5
20060521-M-Hamburg_Masters-F-Tommy_Robredo-Radek_Stepanek,2,S-XC,10,0,0,0,0,3,7
20060521-M-Hamburg_Masters-F-Tommy_Robredo-Radek_Stepanek,2,S-DTM,5,0,0,0,0,1,4
20060521-M-Hamburg_Masters-F-Tommy_Robredo-Radek_Stepanek,2,S-DTL,1,0,0,0,0,0,1
20030810-M-Canada_Masters-F-Andy_Roddick-David_Nalbandian,1,F-XC,24,4,2,0,2,13,11
20030810-M-Canada_Masters-F-Andy_Roddick-David_Nalbandian,1,F-DTM,17,3,1,0,2,12,5
20030810-M-Canada_Masters-F-Andy_Roddick-David_Nalbandian,1,F-DTL,5,2,0,0,2,2,3
20030810-M-Canada_Masters-F-Andy_Roddick-David_Nalbandian,1,F-IO,10,7,1,3,3,7,3
20030810-M-Canada_Masters-F-Andy_Roddick-David_Nalbandian,1,F-II,2,1,0,1,0,1,1
20030810-M-Canada_Masters-F-Andy_Roddick-David_Nalbandian,1,B-XC,22,2,1,0,1,16,6
20030810-M-Canada_Masters-F-Andy_Roddick-David_Nalbandian,1,B-DTM,23,0,0,0,0,11,12
20030810-M-Canada_Masters-F-Andy_Roddick-David_Nalbandian,1,B-DTL,4,0,0,0,0,3,1
20030810-M-Canada_Masters-F-Andy_Roddick-David_Nalbandian,1,B-IO,4,0,0,0,0,4,0
20030810-M-Canada_Masters-F-Andy_Roddick-David_Nalbandian,1,S-XC,4,0,0,0,0,2,2
20030810-M-Canada_Masters-F-Andy_Roddick-David_Nalbandian,1,S-DTM,5,1,0,0,1,2,3
20030810-M-Canada_Masters-F-Andy_Roddick-David_Nalbandian,1,S-IO,1,1,0,1,0,1,0
20030810-M-Canada_Masters-F-Andy_Roddick-David_Nalbandian,2,F-XC,30,10,0,3,7,13,17
20030810-M-Canada_Masters-F-Andy_Roddick-David_Nalbandian,2,F-DTM,12,1,0,0,1,3,9
20030810-M-Canada_Masters-F-Andy_Roddick-David_Nalbandian,2,F-DTL,14,5,2,1,2,6,8
20030810-M-Canada_Masters-F-Andy_Roddick-David_Nalbandian,2,F-IO,16,4,2,0,2,8,8
20030810-M-Canada_Masters-F-Andy_Roddick-David_Nalbandian,2,F-II,2,1,0,0,1,0,2
20030810-M-Canada_Masters-F-Andy_Roddick-David_Nalbandian,2,B-XC,32,7,0,0,7,10,22
20030810-M-Canada_Masters-F-Andy_Roddick-David_Nalbandian,2,B-DTM,14,0,0,0,0,4,10
20030810-M-Canada_Masters-F-Andy_Roddick-David_Nalbandian,2,B-DTL,5,4,1,0,3,2,3
20030810-M-Canada_Masters-F-Andy_Roddick-David_Nalbandian,2,B-IO,3,2,0,0,2,1,2
20030810-M-Canada_Masters-F-Andy_Roddick-David_Nalbandian,2,S-XC,5,2,0,1,1,2,3
20030810-M-Canada_Masters-F-Andy_Roddick-David_Nalbandian,2,S-DTM,1,1,0,0,1,0,1
20020804-M-Canada_Masters-F-Andy_Roddick-Guillermo_Canas,1,F-XC,14,4,2,0,2,3,11
20020804-M-Canada_Masters-F-Andy_Roddick-Guillermo_Canas,1,F-DTM,9,3,0,0,3,1,8
20020804-M-Canada_Masters-F-Andy_Roddick-Guillermo_Canas,1,F-DTL,6,4,1,1,2,2,4
20020804-M-Canada_Masters-F-Andy_Roddick-Guillermo_Canas,1,F-IO,15,7,2,3,2,11,4
20020804-M-Canada_Masters-F-Andy_Roddick-Guillermo_Canas,1,F-II,1,1,1,0,0,1,0
20020804-M-Canada_Masters-F-Andy_Roddick-Guillermo_Canas,1,B-XC,36,5,0,0,5,12,24
20020804-M-Canada_Masters-F-Andy_Roddick-Guillermo_Canas,1,B-DTM,15,1,0,0,1,6,9
20020804-M-Canada_Masters-F-Andy_Roddick-Guillermo_Canas,1,B-DTL,4,3,1,0,2,1,3
20020804-M-Canada_Masters-F-Andy_Roddick-Guillermo_Canas,1,B-IO,2,0,0,0,0,0,2
20020804-M-Canada_Masters-F-Andy_Roddick-Guillermo_Canas,1,S-XC,5,0,0,0,0,3,2
20020804-M-Canada_Masters-F-Andy_Roddick-Guillermo_Canas,1,S-DTM,4,0,0,0,0,0,4
20020804-M-Canada_Masters-F-Andy_Roddick-Guillermo_Canas,1,S-DTL,2,1,0,0,1,0,2
20020804-M-Canada_Masters-F-Andy_Roddick-Guillermo_Canas,2,F-XC,16,5,4,0,1,14,2
20020804-M-Canada_Masters-F-Andy_Roddick-Guillermo_Canas,2,F-DTM,8,0,0,0,0,7,1
20020804-M-Canada_Masters-F-Andy_Roddick-Guillermo_Canas,2,F-DTL,6,2,1,1,0,6,0
20020804-M-Canada_Masters-F-Andy_Roddick-Guillermo_Canas,2,F-IO,36,3,1,1,1,24,12
20020804-M-Canada_Masters-F-Andy_Roddick-Guillermo_Canas,2,F-II,5,1,0,1,0,3,2
20020804-M-Canada_Masters-F-Andy_Roddick-Guillermo_Canas,2,B-XC,21,1,0,0,1,12,9
20020804-M-Canada_Masters-F-Andy_Roddick-Guillermo_Canas,2,B-DTM,6,0,0,0,0,2,4
20020804-M-Canada_Masters-F-Andy_Roddick-Guillermo_Canas,2,B-DTL,5,4,0,2,2,3,2
20020804-M-Canada_Masters-F-Andy_Roddick-Guillermo_Canas,2,S-XC,6,0,0,0,0,2,4
20020804-M-Canada_Masters-F-Andy_Roddick-Guillermo_Canas,2,S-DTM,7,1,0,0,1,3,4
20020317-M-Indian_Wells_Masters-F-Tim_Henman-Lleyton_Hewitt,1,F-XC,27,2,0,0,2,12,15
20020317-M-Indian_Wells_Masters-F-Tim_Henman-Lleyton_Hewitt,1,F-DTM,27,4,0,0,4,8,19
20020317-M-Indian_Wells_Masters-F-Tim_Henman-Lleyton_Hewitt,1,F-DTL,11,3,0,0,3,3,8
20020317-M-Indian_Wells_Masters-F-Tim_Henman-Lleyton_Hewitt,1,F-IO,15,4,0,0,4,5,10
20020317-M-Indian_Wells_Masters-F-Tim_Henman-Lleyton_Hewitt,1,F-II,6,4,0,1,3,2,4
20020317-M-Indian_Wells_Masters-F-Tim_Henman-Lleyton_Hewitt,1,B-XC,13,3,1,0,2,3,10
20020317-M-Indian_Wells_Masters-F-Tim_Henman-Lleyton_Hewitt,1,B-DTM,7,1,0,0,1,4,3
20020317-M-Indian_Wells_Masters-F-Tim_Henman-Lleyton_Hewitt,1,B-DTL,5,1,0,0,1,1,4
20020317-M-Indian_Wells_Masters-F-Tim_Henman-Lleyton_Hewitt,1,S-XC,34,2,0,0,2,10,24
20020317-M-Indian_Wells_Masters-F-Tim_Henman-Lleyton_Hewitt,1,S-DTM,28,2,0,0,2,11,17
20020317-M-Indian_Wells_Masters-F-Tim_Henman-Lleyton_Hewitt,1,S-DTL,10,1,0,0,1,2,8
20020317-M-Indian_Wells_Masters-F-Tim_Henman-Lleyton_Hewitt,1,S-IO,1,0,0,0,0,0,1
20020317-M-Indian_Wells_Masters-F-Tim_Henman-Lleyton_Hewitt,2,F-XC,47,10,4,3,3,32,15
20020317-M-Indian_Wells_Masters-F-Tim_Henman-Lleyton_Hewitt,2,F-DTM,26,5,0,2,3,15,11
20020317-M-Indian_Wells_Masters-F-Tim_Henman-Lleyton_Hewitt,2,F-DTL,11,4,2,1,1,6,5
20020317-M-Indian_Wells_Masters-F-Tim_Henman-Lleyton_Hewitt,2,F-IO,36,1,0,0,1,23,13
20020317-M-Indian_Wells_Masters-F-Tim_Henman-Lleyton_Hewitt,2,F-II,3,1,0,1,0,3,0
20020317-M-Indian_Wells_Masters-F-Tim_Henman-Lleyton_Hewitt,2,B-XC,47,6,2,0,4,33,14
20020317-M-Indian_Wells_Masters-F-Tim_Henman-Lleyton_Hewitt,2,B-DTM,17,3,0,1,2,9,8
20020317-M-Indian_Wells_Masters-F-Tim_Henman-Lleyton_Hewitt,2,B-DTL,2,1,1,0,0,2,0
20020317-M-Indian_Wells_Masters-F-Tim_Henman-Lleyton_Hewitt,2,B-IO,2,1,0,0,1,1,1
20020317-M-Indian_Wells_Masters-F-Tim_Henman-Lleyton_Hewitt,2,S-XC,5,0,0,0,0,3,2
20020317-M-Indian_Wells_Masters-F-Tim_Henman-Lleyton_Hewitt,2,S-DTM,1,0,0,0,0,0,1
20020317-M-Indian_Wells_Masters-F-Tim_Henman-Lleyton_Hewitt,2,S-DTL,1,0,0,0,0,0,1
20020512-M-Rome_Masters-F-Tommy_Haas-Andre_Agassi,1,F-XC,51,8,1,3,4,19,32
20020512-M-Rome_Masters-F-Tommy_Haas-Andre_Agassi,1,F-DTM,17,1,0,0,1,5,12
20020512-M-Rome_Masters-F-Tommy_Haas-Andre_Agassi,1,F-DTL,12,9,1,3,5,5,7
20020512-M-Rome_Masters-F-Tommy_Haas-Andre_Agassi,1,F-IO,16,6,1,3,2,9,7
20020512-M-Rome_Masters-F-Tommy_Haas-Andre_Agassi,1,F-II,10,6,3,2,1,8,2
20020512-M-Rome_Masters-F-Tommy_Haas-Andre_Agassi,1,B-XC,50,7,2,0,5,21,29
20020512-M-Rome_Masters-F-Tommy_Haas-Andre_Agassi,1,B-DTM,30,6,0,0,5,10,20
20020512-M-Rome_Masters-F-Tommy_Haas-Andre_Agassi,1,B-DTL,17,9,4,1,4,7,10
20020512-M-Rome_Masters-F-Tommy_Haas-Andre_Agassi,1,B-IO,5,2,0,1,1,2,3
20020512-M-Rome_Masters-F-Tommy_Haas-Andre_Agassi,1,S-XC,11,0,0,0,0,3,8
20020512-M-Rome_Masters-F-Tommy_Haas-Andre_Agassi,1,S-DTM,16,1,0,0,1,3,13
20020512-M-Rome_Masters-F-Tommy_Haas-Andre_Agassi,1,S-DTL,2,0,0,0,0,0,2
20020512-M-Rome_Masters-F-Tommy_Haas-Andre_Agassi,1,S-IO,1,1,0,0,1,0,1
20020512-M-Rome_Masters-F-Tommy_Haas-Andre_Agassi,2,F-XC,58,11,2,6,3,36,22
20020512-M-Rome_Masters-F-Tommy_Haas-Andre_Agassi,2,F-DTM,27,1,0,0,1,13,14
20020512-M-Rome_Masters-F-Tommy_Haas-Andre_Agassi,2,F-DTL,19,5,3,1,1,13,6
20020512-M-Rome_Masters-F-Tommy_Haas-Andre_Agassi,2,F-IO,16,2,1,0,1,9,7
20020512-M-Rome_Masters-F-Tommy_Haas-Andre_Agassi,2,F-II,8,4,2,1,1,6,2
20020512-M-Rome_Masters-F-Tommy_Haas-Andre_Agassi,2,B-XC,75,9,4,1,4,46,29
20020512-M-Rome_Masters-F-Tommy_Haas-Andre_Agassi,2,B-DTM,16,1,0,1,0,10,6
20020512-M-Rome_Masters-F-Tommy_Haas-Andre_Agassi,2,B-DTL,8,4,1,1,2,5,3
20020512-M-Rome_Masters-F-Tommy_Haas-Andre_Agassi,2,B-IO,3,0,0,0,0,2,1
20020512-M-Rome_Masters-F-Tommy_Haas-Andre_Agassi,2,S-XC,6,0,0,0,0,4,2
20020512-M-Rome_Masters-F-Tommy_Haas-Andre_Agassi,2,S-DTM,1,0,0,0,0,1,0
20020512-M-Rome_Masters-F-Tommy_Haas-Andre_Agassi,2,S-DTL,1,0,0,0,0,0,1
20010325-M-Miami_Masters-F-Jan_Michael_Gambill-Andre_Agassi,1,F-XC,35,11,3,2,6,14,21
20010325-M-Miami_Masters-F-Jan_Michael_Gambill-Andre_Agassi,1,F-DTM,35,1,0,0,1,17,18
20010325-M-Miami_Masters-F-Jan_Michael_Gambill-Andre_Agassi,1,F-DTL,6,2,0,0,2,3,3
20010325-M-Miami_Masters-F-Jan_Michael_Gambill-Andre_Agassi,1,F-IO,17,6,0,1,5,7,10
20010325-M-Miami_Masters-F-Jan_Michael_Gambill-Andre_Agassi,1,F-II,1,1,1,0,0,1,0
20010325-M-Miami_Masters-F-Jan_Michael_Gambill-Andre_Agassi,1,B-XC,71,11,5,0,6,27,44
20010325-M-Miami_Masters-F-Jan_Michael_Gambill-Andre_Agassi,1,B-DTM,40,2,0,0,2,12,28
20010325-M-Miami_Masters-F-Jan_Michael_Gambill-Andre_Agassi,1,B-DTL,5,4,1,1,2,2,3
20010325-M-Miami_Masters-F-Jan_Michael_Gambill-Andre_Agassi,1,B-IO,5,2,0,0,2,2,3
20010325-M-Miami_Masters-F-Jan_Michael_Gambill-Andre_Agassi,1,S-XC,2,0,0,0,0,0,2
20010325-M-Miami_Masters-F-Jan_Michael_Gambill-Andre_Agassi,1,S-DTM,4,0,0,0,0,0,4
20010325-M-Miami_Masters-F-Jan_Michael_Gambill-Andre_Agassi,2,F-XC,52,15,6,5,4,33,19
20010325-M-Miami_Masters-F-Jan_Michael_Gambill-Andre_Agassi,2,F-DTM,17,2,0,0,2,8,9
20010325-M-Miami_Masters-F-Jan_Michael_Gambill-Andre_Agassi,2,F-DTL,15,4,2,1,1,10,5
20010325-M-Miami_Masters-F-Jan_Michael_Gambill-Andre_Agassi,2,F-IO,19,8,1,2,5,11,8
20010325-M-Miami_Masters-F-Jan_Michael_Gambill-Andre_Agassi,2,F-II,5,1,0,1,0,3,2
20010325-M-Miami_Masters-F-Jan_Michael_Gambill-Andre_Agassi,2,B-XC,70,5,2,0,3,46,24
20010325-M-Miami_Masters-F-Jan_Michael_Gambill-Andre_Agassi,2,B-DTM,27,1,0,0,1,14,13
20010325-M-Miami_Masters-F-Jan_Michael_Gambill-Andre_Agassi,2,B-DTL,13,4,3,1,0,9,4
20010325-M-Miami_Masters-F-Jan_Michael_Gambill-Andre_Agassi,2,B-IO,3,2,1,1,0,3,0
20010325-M-Miami_Masters-F-Jan_Michael_Gambill-Andre_Agassi,2,S-XC,4,0,0,0,0,3,1
20010325-M-Miami_Masters-F-Jan_Michael_Gambill-Andre_Agassi,2,S-DTM,4,0,0,0,0,2,2
20011118-M-Masters_Cup-F-Sebastien_Grosjean-Lleyton_Hewitt,1,F-XC,26,8,4,2,2,17,9
20011118-M-Masters_Cup-F-Sebastien_Grosjean-Lleyton_Hewitt,1,F-DTM,23,2,0,0,2,4,19
20011118-M-Masters_Cup-F-Sebastien_Grosjean-Lleyton_Hewitt,1,F-DTL,12,2,1,0,1,7,5
20011118-M-Masters_Cup-F-Sebastien_Grosjean-Lleyton_Hewitt,1,F-IO,49,17,5,2,10,23,26
20011118-M-Masters_Cup-F-Sebastien_Grosjean-Lleyton_Hewitt,1,F-II,11,5,3,0,2,7,4
20011118-M-Masters_Cup-F-Sebastien_Grosjean-Lleyton_Hewitt,1,B-XC,31,1,1,0,0,13,18
20011118-M-Masters_Cup-F-Sebastien_Grosjean-Lleyton_Hewitt,1,B-DTM,28,4,0,1,3,10,18
20011118-M-Masters_Cup-F-Sebastien_Grosjean-Lleyton_Hewitt,1,B-DTL,13,10,1,0,9,2,11
20011118-M-Masters_Cup-F-Sebastien_Grosjean-Lleyton_Hewitt,1,B-IO,7,4,1,0,3,2,5
20011118-M-Masters_Cup-F-Sebastien_Grosjean-Lleyton_Hewitt,1,S-XC,12,1,0,0,1,4,8
20011118-M-Masters_Cup-F-Sebastien_Grosjean-Lleyton_Hewitt,1,S-DTM,10,2,0,0,2,5,5
20011118-M-Masters_Cup-F-Sebastien_Grosjean-Lleyton_Hewitt,1,S-IO,2,0,0,0,0,2,0
20011118-M-Masters_Cup-F-Sebastien_Grosjean-Lleyton_Hewitt,2,F-XC,33,9,0,2,7,15,18
20011118-M-Masters_Cup-F-Sebastien_Grosjean-Lleyton_Hewitt,2,F-DTM,14,1,0,0,1,8,6
20011118-M-Masters_Cup-F-Sebastien_Grosjean-Lleyton_Hewitt,2,F-DTL,9,2,1,0,1,6,3
20011118-M-Masters_Cup-F-Sebastien_Grosjean-Lleyton_Hewitt,2,F-IO,33,10,2,6,2,21,12
20011118-M-Masters_Cup-F-Sebastien_Grosjean-Lleyton_Hewitt,2,F-II,3,1,0,1,0,2,1
20011118-M-Masters_Cup-F-Sebastien_Grosjean-Lleyton_Hewitt,2,B-XC,70,9,3,3,3,44,26
20011118-M-Masters_Cup-F-Sebastien_Grosjean-Lleyton_Hewitt,2,B-DTM,28,3,0,1,2,15,13
20011118-M-Masters_Cup-F-Sebastien_Grosjean-Lleyton_Hewitt,2,B-DTL,3,3,1,0,2,1,2
20011118-M-Masters_Cup-F-Sebastien_Grosjean-Lleyton_Hewitt,2,B-IO,5,2,0,0,2,3,2
20011118-M-Masters_Cup-F-Sebastien_Grosjean-Lleyton_Hewitt,2,S-XC,11,2,0,0,2,5,6
20011118-M-Masters_Cup-F-Sebastien_Grosjean-Lleyton_Hewitt,2,S-DTM,7,0,0,0,0,2,5
20011118-M-Masters_Cup-F-Sebastien_Grosjean-Lleyton_Hewitt,2,S-IO,1,1,0,1,0,1,0
20070126-M-Australian_Open-SF-Tommy_Haas-Fernando_Gonzalez,1,F-XC,25,7,2,2,3,14,11
20070126-M-Australian_Open-SF-Tommy_Haas-Fernando_Gonzalez,1,F-DTM,8,0,0,0,0,2,6
20070126-M-Australian_Open-SF-Tommy_Haas-Fernando_Gonzalez,1,F-DTL,9,0,0,0,0,4,5
20070126-M-Australian_Open-SF-Tommy_Haas-Fernando_Gonzalez,1,F-IO,29,4,1,0,3,10,19
20070126-M-Australian_Open-SF-Tommy_Haas-Fernando_Gonzalez,1,F-II,13,7,3,3,1,7,6
20070126-M-Australian_Open-SF-Tommy_Haas-Fernando_Gonzalez,1,B-XC,43,7,2,1,4,16,27
20070126-M-Australian_Open-SF-Tommy_Haas-Fernando_Gonzalez,1,B-DTM,12,0,0,0,0,2,10
20070126-M-Australian_Open-SF-Tommy_Haas-Fernando_Gonzalez,1,B-DTL,17,8,6,1,1,11,6
20070126-M-Australian_Open-SF-Tommy_Haas-Fernando_Gonzalez,1,B-IO,1,1,0,0,1,0,1
20070126-M-Australian_Open-SF-Tommy_Haas-Fernando_Gonzalez,1,S-XC,14,1,0,1,0,3,11
20070126-M-Australian_Open-SF-Tommy_Haas-Fernando_Gonzalez,1,S-DTM,1,0,0,0,0,0,1
20070126-M-Australian_Open-SF-Tommy_Haas-Fernando_Gonzalez,1,S-DTL,5,1,0,0,1,1,4
20070126-M-Australian_Open-SF-Tommy_Haas-Fernando_Gonzalez,2,F-XC,25,6,5,1,0,18,7
20070126-M-Australian_Open-SF-Tommy_Haas-Fernando_Gonzalez,2,F-DTM,9,2,2,0,0,5,4
20070126-M-Australian_Open-SF-Tommy_Haas-Fernando_Gonzalez,2,F-DTL,10,5,4,0,1,6,4
20070126-M-Australian_Open-SF-Tommy_Haas-Fernando_Gonzalez,2,F-IO,38,8,5,3,0,32,6
20070126-M-Australian_Open-SF-Tommy_Haas-Fernando_Gonzalez,2,F-II,9,3,3,0,0,8,1
20070126-M-Australian_Open-SF-Tommy_Haas-Fernando_Gonzalez,2,B-XC,8,5,4,1,0,6,2
20070126-M-Australian_Open-SF-Tommy_Haas-Fernando_Gonzalez,2,B-DTM,8,0,0,0,0,5,3
20070126-M-Australian_Open-SF-Tommy_Haas-Fernando_Gonzalez,2,B-DTL,3,3,1,1,1,2,1
20070126-M-Australian_Open-SF-Tommy_Haas-Fernando_Gonzalez,2,B-IO,2,1,1,0,0,2,0
20070126-M-Australian_Open-SF-Tommy_Haas-Fernando_Gonzalez,2,S-XC,48,0,0,0,0,30,18
20070126-M-Australian_Open-SF-Tommy_Haas-Fernando_Gonzalez,2,S-DTM,6,0,0,0,0,4,2
20070126-M-Australian_Open-SF-Tommy_Haas-Fernando_Gonzalez,2,S-DTL,7,0,0,0,0,4,3
19950124-M-Australian_Open-QF-Jim_Courier-Pete_Sampras,1,F-XC,52,13,5,4,4,27,25
19950124-M-Australian_Open-QF-Jim_Courier-Pete_Sampras,1,F-DTM,27,2,0,0,2,17,10
19950124-M-Australian_Open-QF-Jim_Courier-Pete_Sampras,1,F-DTL,47,8,3,2,3,26,21
19950124-M-Australian_Open-QF-Jim_Courier-Pete_Sampras,1,F-IO,200,23,4,8,11,145,55
19950124-M-Australian_Open-QF-Jim_Courier-Pete_Sampras,1,F-II,27,15,7,4,4,20,7
19950124-M-Australian_Open-QF-Jim_Courier-Pete_Sampras,1,B-XC,108,9,2,2,5,59,49
19950124-M-Australian_Open-QF-Jim_Courier-Pete_Sampras,1,B-DTM,20,3,0,2,1,9,11
19950124-M-Australian_Open-QF-Jim_Courier-Pete_Sampras,1,B-DTL,18,12,7,0,5,7,11
19950124-M-Australian_Open-QF-Jim_Courier-Pete_Sampras,1,B-IO,1,1,1,0,0,1,0
19950124-M-Australian_Open-QF-Jim_Courier-Pete_Sampras,1,S-XC,21,3,0,0,3,11,10
19950124-M-Australian_Open-QF-Jim_Courier-Pete_Sampras,1,S-DTM,5,0,0,0,0,1,4
19950124-M-Australian_Open-QF-Jim_Courier-Pete_Sampras,1,S-DTL,3,1,0,0,1,1,2
19950124-M-Australian_Open-QF-Jim_Courier-Pete_Sampras,2,F-XC,33,10,1,3,6,17,16
19950124-M-Australian_Open-QF-Jim_Courier-Pete_Sampras,2,F-DTM,13,0,0,0,0,3,10
19950124-M-Australian_Open-QF-Jim_Courier-Pete_Sampras,2,F-DTL,27,9,4,3,2,17,10
19950124-M-Australian_Open-QF-Jim_Courier-Pete_Sampras,2,F-IO,67,17,3,6,8,34,33
19950124-M-Australian_Open-QF-Jim_Courier-Pete_Sampras,2,F-II,18,9,1,3,5,8,10
19950124-M-Australian_Open-QF-Jim_Courier-Pete_Sampras,2,B-XC,140,9,0,1,8,53,87
19950124-M-Australian_Open-QF-Jim_Courier-Pete_Sampras,2,B-DTM,38,1,0,0,1,9,29
19950124-M-Australian_Open-QF-Jim_Courier-Pete_Sampras,2,B-DTL,43,14,4,2,8,19,24
19950124-M-Australian_Open-QF-Jim_Courier-Pete_Sampras,2,B-IO,3,2,1,0,1,1,2
19950124-M-Australian_Open-QF-Jim_Courier-Pete_Sampras,2,S-XC,44,5,0,1,4,14,30
19950124-M-Australian_Open-QF-Jim_Courier-Pete_Sampras,2,S-DTM,19,0,0,0,0,6,13
19950124-M-Australian_Open-QF-Jim_Courier-Pete_Sampras,2,S-DTL,19,5,1,0,4,5,14
19950124-M-Australian_Open-QF-Jim_Courier-Pete_Sampras,2,S-IO,1,0,0,0,0,1,0
20010805-M-Canada_Masters-F-Patrick_Rafter-Andrei_Pavel,1,F-XC,11,5,0,2,3,5,6
20010805-M-Canada_Masters-F-Patrick_Rafter-Andrei_Pavel,1,F-DTM,10,1,0,0,1,3,7
20010805-M-Canada_Masters-F-Patrick_Rafter-Andrei_Pavel,1,F-DTL,3,2,0,0,2,0,3
20010805-M-Canada_Masters-F-Patrick_Rafter-Andrei_Pavel,1,F-IO,2,2,0,1,1,1,1
20010805-M-Canada_Masters-F-Patrick_Rafter-Andrei_Pavel,1,F-II,1,0,0,0,0,1,0
20010805-M-Canada_Masters-F-Patrick_Rafter-Andrei_Pavel,1,B-XC,5,1,0,0,1,3,2
20010805-M-Canada_Masters-F-Patrick_Rafter-Andrei_Pavel,1,B-DTM,3,1,0,0,1,1,2
20010805-M-Canada_Masters-F-Patrick_Rafter-Andrei_Pavel,1,S-XC,11,1,1,0,0,5,6
20010805-M-Canada_Masters-F-Patrick_Rafter-Andrei_Pavel,1,S-DTM,7,1,0,0,1,2,5
20010805-M-Canada_Masters-F-Patrick_Rafter-Andrei_Pavel,1,S-DTL,4,1,0,0,1,2,2
20010805-M-Canada_Masters-F-Patrick_Rafter-Andrei_Pavel,2,F-XC,18,6,2,1,3,12,6
20010805-M-Canada_Masters-F-Patrick_Rafter-Andrei_Pavel,2,F-DTM,11,1,0,0,1,5,6
20010805-M-Canada_Masters-F-Patrick_Rafter-Andrei_Pavel,2,F-DTL,6,5,3,0,2,4,2
20010805-M-Canada_Masters-F-Patrick_Rafter-Andrei_Pavel,2,F-IO,8,2,1,0,1,4,4
20010805-M-Canada_Masters-F-Patrick_Rafter-Andrei_Pavel,2,F-II,1,1,0,0,1,0,1
20010805-M-Canada_Masters-F-Patrick_Rafter-Andrei_Pavel,2,B-XC,23,4,1,2,1,13,10
20010805-M-Canada_Masters-F-Patrick_Rafter-Andrei_Pavel,2,B-DTM,13,5,2,1,2,8,5
20010805-M-Canada_Masters-F-Patrick_Rafter-Andrei_Pavel,2,B-DTL,6,5,2,1,2,3,3
20010805-M-Canada_Masters-F-Patrick_Rafter-Andrei_Pavel,2,B-IO,5,3,2,0,1,3,2
20010805-M-Canada_Masters-F-Patrick_Rafter-Andrei_Pavel,2,S-XC,2,1,0,1,0,2,0
19880427-M-Hamburg-R32-Boris_Becker-Mansour_Bahrami,1,F-XC,15,5,3,1,1,11,4
19880427-M-Hamburg-R32-Boris_Becker-Mansour_Bahrami,1,F-DTM,4,2,0,1,1,2,2
19880427-M-Hamburg-R32-Boris_Becker-Mansour_Bahrami,1,F-DTL,3,1,0,1,0,2,1
19880427-M-Hamburg-R32-Boris_Becker-Mansour_Bahrami,1,F-IO,7,4,2,1,1,5,2
19880427-M-Hamburg-R32-Boris_Becker-Mansour_Bahrami,1,F-II,1,0,0,0,0,1,0
19880427-M-Hamburg-R32-Boris_Becker-Mansour_Bahrami,1,B-XC,12,3,2,1,0,9,3
19880427-M-Hamburg-R32-Boris_Becker-Mansour_Bahrami,1,B-DTM,3,2,1,0,1,2,1
19880427-M-Hamburg-R32-Boris_Becker-Mansour_Bahrami,1,B-DTL,7,6,5,1,0,6,1
19880427-M-Hamburg-R32-Boris_Becker-Mansour_Bahrami,1,S-XC,9,1,0,1,0,7,2
19880427-M-Hamburg-R32-Boris_Becker-Mansour_Bahrami,1,S-DTM,2,0,0,0,0,1,1
19880427-M-Hamburg-R32-Boris_Becker-Mansour_Bahrami,1,S-DTL,3,0,0,0,0,1,2
19880427-M-Hamburg-R32-Boris_Becker-Mansour_Bahrami,2,F-XC,9,4,4,0,0,6,3
19880427-M-Hamburg-R32-Boris_Becker-Mansour_Bahrami,2,F-DTM,2,0,0,0,0,2,0
19880427-M-Hamburg-R32-Boris_Becker-Mansour_Bahrami,2,F-DTL,4,0,0,0,0,2,2
19880427-M-Hamburg-R32-Boris_Becker-Mansour_Bahrami,2,F-IO,1,0,0,0,0,0,1
19880427-M-Hamburg-R32-Boris_Becker-Mansour_Bahrami,2,F-II,3,1,0,0,1,1,2
19880427-M-Hamburg-R32-Boris_Becker-Mansour_Bahrami,2,B-XC,3,1,0,0,1,1,2
19880427-M-Hamburg-R32-Boris_Becker-Mansour_Bahrami,2,B-DTM,2,0,0,0,0,0,2
19880427-M-Hamburg-R32-Boris_Becker-Mansour_Bahrami,2,B-DTL,1,1,1,0,0,1,0
19880427-M-Hamburg-R32-Boris_Becker-Mansour_Bahrami,2,S-XC,18,0,0,0,0,7,11
19880427-M-Hamburg-R32-Boris_Becker-Mansour_Bahrami,2,S-DTM,3,1,1,0,0,3,0
19880427-M-Hamburg-R32-Boris_Becker-Mansour_Bahrami,2,S-DTL,1,1,0,1,0,1,0
19970803-M-Canada_Masters-F-Chris_Woodruff-Gustavo_Kuerten,1,F-XC,37,9,2,4,3,24,13
19970803-M-Canada_Masters-F-Chris_Woodruff-Gustavo_Kuerten,1,F-DTM,24,1,0,1,0,15,9
19970803-M-Canada_Masters-F-Chris_Woodruff-Gustavo_Kuerten,1,F-DTL,11,6,4,2,0,7,4
19970803-M-Canada_Masters-F-Chris_Woodruff-Gustavo_Kuerten,1,F-IO,7,6,5,1,0,7,0
19970803-M-Canada_Masters-F-Chris_Woodruff-Gustavo_Kuerten,1,F-II,3,3,1,1,1,2,1
19970803-M-Canada_Masters-F-Chris_Woodruff-Gustavo_Kuerten,1,B-XC,19,3,2,1,0,15,4
19970803-M-Canada_Masters-F-Chris_Woodruff-Gustavo_Kuerten,1,B-DTM,21,1,0,0,1,10,11
19970803-M-Canada_Masters-F-Chris_Woodruff-Gustavo_Kuerten,1,B-DTL,8,5,3,0,2,4,4
19970803-M-Canada_Masters-F-Chris_Woodruff-Gustavo_Kuerten,1,B-IO,5,2,1,1,0,5,0
19970803-M-Canada_Masters-F-Chris_Woodruff-Gustavo_Kuerten,1,S-XC,1,0,0,0,0,1,0
19970803-M-Canada_Masters-F-Chris_Woodruff-Gustavo_Kuerten,1,S-DTM,3,0,0,0,0,1,2
19970803-M-Canada_Masters-F-Chris_Woodruff-Gustavo_Kuerten,2,F-XC,35,10,3,5,2,18,17
19970803-M-Canada_Masters-F-Chris_Woodruff-Gustavo_Kuerten,2,F-DTM,25,3,0,0,3,5,20
19970803-M-Canada_Masters-F-Chris_Woodruff-Gustavo_Kuerten,2,F-DTL,3,2,0,0,2,0,3
19970803-M-Canada_Masters-F-Chris_Woodruff-Gustavo_Kuerten,2,F-IO,14,8,3,3,2,10,4
19970803-M-Canada_Masters-F-Chris_Woodruff-Gustavo_Kuerten,2,B-XC,20,2,0,1,1,9,11
19970803-M-Canada_Masters-F-Chris_Woodruff-Gustavo_Kuerten,2,B-DTM,20,0,0,0,0,7,13
19970803-M-Canada_Masters-F-Chris_Woodruff-Gustavo_Kuerten,2,B-DTL,6,3,0,0,3,1,5
19970803-M-Canada_Masters-F-Chris_Woodruff-Gustavo_Kuerten,2,B-IO,2,2,1,0,1,1,1
19970803-M-Canada_Masters-F-Chris_Woodruff-Gustavo_Kuerten,2,S-XC,3,1,0,0,1,0,3
19970803-M-Canada_Masters-F-Chris_Woodruff-Gustavo_Kuerten,2,S-DTM,5,0,0,0,0,3,2
19970803-M-Canada_Masters-F-Chris_Woodruff-Gustavo_Kuerten,2,S-DTL,1,0,0,0,0,0,1
19940127-M-Australian_Open-SF-Todd_Martin-Stefan_Edberg,1,F-XC,33,17,11,1,5,20,13
19940127-M-Australian_Open-SF-Todd_Martin-Stefan_Edberg,1,F-DTM,7,1,0,1,0,2,5
19940127-M-Australian_Open-SF-Todd_Martin-Stefan_Edberg,1,F-DTL,7,4,2,0,2,4,3
19940127-M-Australian_Open-SF-Todd_Martin-Stefan_Edberg,1,F-IO,9,4,3,0,1,6,3
19940127-M-Australian_Open-SF-Todd_Martin-Stefan_Edberg,1,F-II,1,0,0,0,0,0,1
19940127-M-Australian_Open-SF-Todd_Martin-Stefan_Edberg,1,B-XC,31,9,5,4,0,16,15
19940127-M-Australian_Open-SF-Todd_Martin-Stefan_Edberg,1,B-DTM,7,0,0,0,0,4,3
19940127-M-Australian_Open-SF-Todd_Martin-Stefan_Edberg,1,B-DTL,21,10,4,3,3,15,6
19940127-M-Australian_Open-SF-Todd_Martin-Stefan_Edberg,1,B-IO,2,1,0,0,1,0,2
19940127-M-Australian_Open-SF-Todd_Martin-Stefan_Edberg,1,S-XC,7,1,0,0,1,6,1
19940127-M-Australian_Open-SF-Todd_Martin-Stefan_Edberg,1,S-DTM,4,0,0,0,0,2,2
19940127-M-Australian_Open-SF-Todd_Martin-Stefan_Edberg,1,S-DTL,3,1,0,1,0,3,0
19940127-M-Australian_Open-SF-Todd_Martin-Stefan_Edberg,1,S-IO,3,1,0,0,1,1,2
19940127-M-Australian_Open-SF-Todd_Martin-Stefan_Edberg,2,F-XC,26,3,1,0,2,13,13
19940127-M-Australian_Open-SF-Todd_Martin-Stefan_Edberg,2,F-DTM,6,3,0,1,2,1,5
19940127-M-Australian_Open-SF-Todd_Martin-Stefan_Edberg,2,F-DTL,7,0,0,0,0,0,7
19940127-M-Australian_Open-SF-Todd_Martin-Stefan_Edberg,2,F-IO,1,0,0,0,0,1,0
19940127-M-Australian_Open-SF-Todd_Martin-Stefan_Edberg,2,B-XC,18,2,1,0,1,6,12
19940127-M-Australian_Open-SF-Todd_Martin-Stefan_Edberg,2,B-DTM,4,0,0,0,0,2,2
19940127-M-Australian_Open-SF-Todd_Martin-Stefan_Edberg,2,B-DTL,5,4,2,0,2,2,3
19940127-M-Australian_Open-SF-Todd_Martin-Stefan_Edberg,2,B-IO,3,3,1,0,2,1,2
19940127-M-Australian_Open-SF-Todd_Martin-Stefan_Edberg,2,S-XC,5,0,0,0,0,2,3
19940127-M-Australian_Open-SF-Todd_Martin-Stefan_Edberg,2,S-DTM,5,0,0,0,0,2,3
19940127-M-Australian_Open-SF-Todd_Martin-Stefan_Edberg,2,S-DTL,3,0,0,0,0,1,2
20010318-M-Indian_Wells_Masters-F-Pete_Sampras-Andre_Agassi,1,F-XC,22,9,0,3,6,9,13
20010318-M-Indian_Wells_Masters-F-Pete_Sampras-Andre_Agassi,1,F-DTM,12,3,0,0,3,2,10
20010318-M-Indian_Wells_Masters-F-Pete_Sampras-Andre_Agassi,1,F-DTL,5,2,0,1,1,3,2
20010318-M-Indian_Wells_Masters-F-Pete_Sampras-Andre_Agassi,1,F-IO,14,7,2,2,3,9,5
20010318-M-Indian_Wells_Masters-F-Pete_Sampras-Andre_Agassi,1,F-II,3,2,1,0,1,2,1
20010318-M-Indian_Wells_Masters-F-Pete_Sampras-Andre_Agassi,1,B-XC,38,6,0,1,5,11,27
20010318-M-Indian_Wells_Masters-F-Pete_Sampras-Andre_Agassi,1,B-DTM,13,3,0,0,3,4,9
20010318-M-Indian_Wells_Masters-F-Pete_Sampras-Andre_Agassi,1,B-DTL,15,12,4,3,5,8,7
20010318-M-Indian_Wells_Masters-F-Pete_Sampras-Andre_Agassi,1,B-IO,2,1,1,0,0,2,0
20010318-M-Indian_Wells_Masters-F-Pete_Sampras-Andre_Agassi,1,S-XC,25,2,0,1,1,5,20
20010318-M-Indian_Wells_Masters-F-Pete_Sampras-Andre_Agassi,1,S-DTM,8,2,0,0,2,0,8
20010318-M-Indian_Wells_Masters-F-Pete_Sampras-Andre_Agassi,1,S-DTL,5,1,0,0,1,2,3
20010318-M-Indian_Wells_Masters-F-Pete_Sampras-Andre_Agassi,2,F-XC,25,7,1,2,4,17,8
20010318-M-Indian_Wells_Masters-F-Pete_Sampras-Andre_Agassi,2,F-DTM,18,1,0,0,1,12,6
20010318-M-Indian_Wells_Masters-F-Pete_Sampras-Andre_Agassi,2,F-DTL,9,5,1,3,1,6,3
20010318-M-Indian_Wells_Masters-F-Pete_Sampras-Andre_Agassi,2,F-IO,19,3,3,0,0,15,4
20010318-M-Indian_Wells_Masters-F-Pete_Sampras-Andre_Agassi,2,F-II,3,2,1,0,1,2,1
20010318-M-Indian_Wells_Masters-F-Pete_Sampras-Andre_Agassi,2,B-XC,96,8,5,2,1,67,29
20010318-M-Indian_Wells_Masters-F-Pete_Sampras-Andre_Agassi,2,B-DTM,14,1,0,0,1,7,7
20010318-M-Indian_Wells_Masters-F-Pete_Sampras-Andre_Agassi,2,B-DTL,12,7,3,2,2,7,5
20010318-M-Indian_Wells_Masters-F-Pete_Sampras-Andre_Agassi,2,B-IO,1,1,1,0,0,1,0
20010318-M-Indian_Wells_Masters-F-Pete_Sampras-Andre_Agassi,2,S-XC,2,1,1,0,0,2,0
20010318-M-Indian_Wells_Masters-F-Pete_Sampras-Andre_Agassi,2,S-DTM,2,0,0,0,0,0,2
20010318-M-Indian_Wells_Masters-F-Pete_Sampras-Andre_Agassi,2,S-DTL,1,1,0,0,1,0,1
19981108-M-Paris_Masters-F-Pete_Sampras-Greg_Rusedski,1,F-XC,14,3,1,0,2,7,7
19981108-M-Paris_Masters-F-Pete_Sampras-Greg_Rusedski,1,F-DTM,2,0,0,0,0,1,1
19981108-M-Paris_Masters-F-Pete_Sampras-Greg_Rusedski,1,F-DTL,7,4,2,2,0,5,2
19981108-M-Paris_Masters-F-Pete_Sampras-Greg_Rusedski,1,F-IO,8,5,2,2,1,6,2
19981108-M-Paris_Masters-F-Pete_Sampras-Greg_Rusedski,1,F-II,2,1,0,0,1,0,2
19981108-M-Paris_Masters-F-Pete_Sampras-Greg_Rusedski,1,B-XC,22,4,1,0,3,3,19
19981108-M-Paris_Masters-F-Pete_Sampras-Greg_Rusedski,1,B-DTM,7,1,0,0,1,1,6
19981108-M-Paris_Masters-F-Pete_Sampras-Greg_Rusedski,1,B-DTL,8,2,0,0,2,2,6
19981108-M-Paris_Masters-F-Pete_Sampras-Greg_Rusedski,1,B-IO,4,1,1,0,0,1,3
19981108-M-Paris_Masters-F-Pete_Sampras-Greg_Rusedski,1,S-XC,7,2,0,0,2,2,5
19981108-M-Paris_Masters-F-Pete_Sampras-Greg_Rusedski,1,S-DTM,3,0,0,0,0,0,3
19981108-M-Paris_Masters-F-Pete_Sampras-Greg_Rusedski,1,S-DTL,4,2,0,0,2,1,3
19981108-M-Paris_Masters-F-Pete_Sampras-Greg_Rusedski,2,F-XC,27,5,1,3,1,24,3
19981108-M-Paris_Masters-F-Pete_Sampras-Greg_Rusedski,2,F-DTM,7,0,0,0,0,3,4
19981108-M-Paris_Masters-F-Pete_Sampras-Greg_Rusedski,2,F-DTL,11,3,2,0,1,6,5
19981108-M-Paris_Masters-F-Pete_Sampras-Greg_Rusedski,2,F-IO,9,6,5,1,0,6,3
19981108-M-Paris_Masters-F-Pete_Sampras-Greg_Rusedski,2,F-II,2,0,0,0,0,1,1
19981108-M-Paris_Masters-F-Pete_Sampras-Greg_Rusedski,2,B-XC,2,1,1,0,0,1,1
19981108-M-Paris_Masters-F-Pete_Sampras-Greg_Rusedski,2,B-DTM,2,0,0,0,0,0,2
19981108-M-Paris_Masters-F-Pete_Sampras-Greg_Rusedski,2,B-DTL,5,3,2,0,1,3,2
19981108-M-Paris_Masters-F-Pete_Sampras-Greg_Rusedski,2,B-IO,1,1,1,0,0,1,0
19981108-M-Paris_Masters-F-Pete_Sampras-Greg_Rusedski,2,S-XC,3,1,0,0,1,1,2
19981108-M-Paris_Masters-F-Pete_Sampras-Greg_Rusedski,2,S-DTM,15,1,0,0,1,8,7
19981108-M-Paris_Masters-F-Pete_Sampras-Greg_Rusedski,2,S-DTL,16,4,0,1,3,11,5
19981108-M-Paris_Masters-F-Pete_Sampras-Greg_Rusedski,2,S-IO,4,0,0,0,0,4,0
20171029-M-Basel-F-Juan_Martin_Del_Potro-Roger_Federer,1,F-XC,55,15,6,4,5,28,27
20171029-M-Basel-F-Juan_Martin_Del_Potro-Roger_Federer,1,F-DTM,43,4,0,0,4,23,20
20171029-M-Basel-F-Juan_Martin_Del_Potro-Roger_Federer,1,F-DTL,8,4,3,1,0,6,2
20171029-M-Basel-F-Juan_Martin_Del_Potro-Roger_Federer,1,F-IO,44,11,4,4,3,29,15
20171029-M-Basel-F-Juan_Martin_Del_Potro-Roger_Federer,1,F-II,2,1,1,0,0,2,0
20171029-M-Basel-F-Juan_Martin_Del_Potro-Roger_Federer,1,B-XC,34,3,0,0,3,22,12
20171029-M-Basel-F-Juan_Martin_Del_Potro-Roger_Federer,1,B-DTM,17,2,1,0,1,10,7
20171029-M-Basel-F-Juan_Martin_Del_Potro-Roger_Federer,1,B-DTL,10,5,1,2,2,5,5
20171029-M-Basel-F-Juan_Martin_Del_Potro-Roger_Federer,1,S-XC,20,0,0,0,0,4,16
20171029-M-Basel-F-Juan_Martin_Del_Potro-Roger_Federer,1,S-DTM,5,0,0,0,0,2,3
20171029-M-Basel-F-Juan_Martin_Del_Potro-Roger_Federer,1,S-DTL,9,2,0,0,2,5,4
20171029-M-Basel-F-Juan_Martin_Del_Potro-Roger_Federer,2,F-XC,50,23,11,3,9,29,21
20171029-M-Basel-F-Juan_Martin_Del_Potro-Roger_Federer,2,F-DTM,33,4,1,1,2,19,14
20171029-M-Basel-F-Juan_Martin_Del_Potro-Roger_Federer,2,F-DTL,17,8,5,1,2,8,9
20171029-M-Basel-F-Juan_Martin_Del_Potro-Roger_Federer,2,F-IO,42,11,3,4,4,24,18
20171029-M-Basel-F-Juan_Martin_Del_Potro-Roger_Federer,2,F-II,14,5,2,2,1,10,4
20171029-M-Basel-F-Juan_Martin_Del_Potro-Roger_Federer,2,B-XC,23,3,1,0,2,7,16
20171029-M-Basel-F-Juan_Martin_Del_Potro-Roger_Federer,2,B-DTM,32,5,1,0,4,8,24
20171029-M-Basel-F-Juan_Martin_Del_Potro-Roger_Federer,2,B-DTL,12,7,2,0,5,3,9
20171029-M-Basel-F-Juan_Martin_Del_Potro-Roger_Federer,2,B-IO,2,1,0,0,1,0,2
20171029-M-Basel-F-Juan_Martin_Del_Potro-Roger_Federer,2,S-XC,10,1,0,1,0,7,3
20171029-M-Basel-F-Juan_Martin_Del_Potro-Roger_Federer,2,S-DTM,10,0,0,0,0,5,5
20171029-M-Basel-F-Juan_Martin_Del_Potro-Roger_Federer,2,S-DTL,3,0,0,0,0,2,1
20141029-M-Paris_Masters-R16-Grigor_Dimitrov-Andy_Murray,1,F-XC,22,6,1,2,3,7,15
20141029-M-Paris_Masters-R16-Grigor_Dimitrov-Andy_Murray,1,F-DTM,11,1,0,0,1,3,8
20141029-M-Paris_Masters-R16-Grigor_Dimitrov-Andy_Murray,1,F-DTL,6,2,0,2,0,5,1
20141029-M-Paris_Masters-R16-Grigor_Dimitrov-Andy_Murray,1,F-IO,36,13,6,1,6,13,23
20141029-M-Paris_Masters-R16-Grigor_Dimitrov-Andy_Murray,1,F-II,7,3,0,1,2,3,4
20141029-M-Paris_Masters-R16-Grigor_Dimitrov-Andy_Murray,1,B-XC,30,4,0,0,4,7,23
20141029-M-Paris_Masters-R16-Grigor_Dimitrov-Andy_Murray,1,B-DTM,8,2,0,0,2,1,7
20141029-M-Paris_Masters-R16-Grigor_Dimitrov-Andy_Murray,1,B-DTL,8,2,0,0,2,0,8
20141029-M-Paris_Masters-R16-Grigor_Dimitrov-Andy_Murray,1,S-XC,16,0,0,0,0,4,12
20141029-M-Paris_Masters-R16-Grigor_Dimitrov-Andy_Murray,1,S-DTM,3,0,0,0,0,2,1
20141029-M-Paris_Masters-R16-Grigor_Dimitrov-Andy_Murray,1,S-DTL,3,1,0,0,1,1,2
20141029-M-Paris_Masters-R16-Grigor_Dimitrov-Andy_Murray,2,F-XC,18,5,2,1,2,13,5
20141029-M-Paris_Masters-R16-Grigor_Dimitrov-Andy_Murray,2,F-DTM,11,1,1,0,0,10,1
20141029-M-Paris_Masters-R16-Grigor_Dimitrov-Andy_Murray,2,F-DTL,9,1,1,0,0,8,1
20141029-M-Paris_Masters-R16-Grigor_Dimitrov-Andy_Murray,2,F-IO,10,1,0,0,1,6,4
20141029-M-Paris_Masters-R16-Grigor_Dimitrov-Andy_Murray,2,F-II,1,1,0,1,0,1,0
20141029-M-Paris_Masters-R16-Grigor_Dimitrov-Andy_Murray,2,B-XC,49,3,0,0,3,33,16
20141029-M-Paris_Masters-R16-Grigor_Dimitrov-Andy_Murray,2,B-DTM,19,0,0,0,0,16,3
20141029-M-Paris_Masters-R16-Grigor_Dimitrov-Andy_Murray,2,B-DTL,5,4,2,2,0,5,0
20141029-M-Paris_Masters-R16-Grigor_Dimitrov-Andy_Murray,2,B-IO,2,1,0,0,1,1,1
20141029-M-Paris_Masters-R16-Grigor_Dimitrov-Andy_Murray,2,S-XC,12,1,0,0,1,8,4
20141029-M-Paris_Masters-R16-Grigor_Dimitrov-Andy_Murray,2,S-DTL,3,0,0,0,0,1,2
20171105-M-Paris_Masters-F-Filip_Krajinovic-Jack_Sock,1,F-XC,41,12,4,2,6,20,21
20171105-M-Paris_Masters-F-Filip_Krajinovic-Jack_Sock,1,F-DTM,25,1,0,0,1,8,17
20171105-M-Paris_Masters-F-Filip_Krajinovic-Jack_Sock,1,F-DTL,13,4,1,1,2,8,5
20171105-M-Paris_Masters-F-Filip_Krajinovic-Jack_Sock,1,F-IO,25,12,4,3,5,13,12
20171105-M-Paris_Masters-F-Filip_Krajinovic-Jack_Sock,1,F-II,1,0,0,0,0,1,0
20171105-M-Paris_Masters-F-Filip_Krajinovic-Jack_Sock,1,B-XC,38,8,0,2,5,14,24
20171105-M-Paris_Masters-F-Filip_Krajinovic-Jack_Sock,1,B-DTM,30,4,0,0,4,8,22
20171105-M-Paris_Masters-F-Filip_Krajinovic-Jack_Sock,1,B-DTL,16,8,0,2,6,4,12
20171105-M-Paris_Masters-F-Filip_Krajinovic-Jack_Sock,1,B-IO,8,1,0,0,1,5,3
20171105-M-Paris_Masters-F-Filip_Krajinovic-Jack_Sock,1,S-XC,8,0,0,0,0,2,6
20171105-M-Paris_Masters-F-Filip_Krajinovic-Jack_Sock,1,S-DTM,3,0,0,0,0,0,3
20171105-M-Paris_Masters-F-Filip_Krajinovic-Jack_Sock,1,S-DTL,3,1,0,0,1,0,3
20171105-M-Paris_Masters-F-Filip_Krajinovic-Jack_Sock,2,F-XC,33,9,5,1,3,23,10
20171105-M-Paris_Masters-F-Filip_Krajinovic-Jack_Sock,2,F-DTM,38,3,1,0,2,17,21
20171105-M-Paris_Masters-F-Filip_Krajinovic-Jack_Sock,2,F-DTL,12,5,1,1,3,8,4
20171105-M-Paris_Masters-F-Filip_Krajinovic-Jack_Sock,2,F-IO,51,21,12,3,6,43,8
20171105-M-Paris_Masters-F-Filip_Krajinovic-Jack_Sock,2,F-II,4,3,1,0,2,2,2
20171105-M-Paris_Masters-F-Filip_Krajinovic-Jack_Sock,2,B-XC,5,1,1,0,0,3,2
20171105-M-Paris_Masters-F-Filip_Krajinovic-Jack_Sock,2,B-DTM,10,0,0,0,0,5,5
20171105-M-Paris_Masters-F-Filip_Krajinovic-Jack_Sock,2,B-DTL,4,2,1,0,1,3,1
20171105-M-Paris_Masters-F-Filip_Krajinovic-Jack_Sock,2,S-XC,14,2,1,0,1,7,7
20171105-M-Paris_Masters-F-Filip_Krajinovic-Jack_Sock,2,S-DTM,15,1,0,0,1,4,11
20171105-M-Paris_Masters-F-Filip_Krajinovic-Jack_Sock,2,S-DTL,5,0,0,0,0,1,4
20171105-M-Paris_Masters-F-Filip_Krajinovic-Jack_Sock,2,S-IO,2,0,0,0,0,1,1
20051023-M-Madrid_Masters-F-Ivan_Ljubicic-Rafael_Nadal,1,F-XC,84,14,1,3,10,35,49
20051023-M-Madrid_Masters-F-Ivan_Ljubicic-Rafael_Nadal,1,F-DTM,26,4,1,0,3,12,14
20051023-M-Madrid_Masters-F-Ivan_Ljubicic-Rafael_Nadal,1,F-DTL,18,12,5,1,6,10,8
20051023-M-Madrid_Masters-F-Ivan_Ljubicic-Rafael_Nadal,1,F-IO,28,15,5,5,5,19,9
20051023-M-Madrid_Masters-F-Ivan_Ljubicic-Rafael_Nadal,1,F-II,1,1,0,0,1,0,1
20051023-M-Madrid_Masters-F-Ivan_Ljubicic-Rafael_Nadal,1,B-XC,72,20,4,4,12,36,36
20051023-M-Madrid_Masters-F-Ivan_Ljubicic-Rafael_Nadal,1,B-DTM,38,2,0,0,2,16,22
20051023-M-Madrid_Masters-F-Ivan_Ljubicic-Rafael_Nadal,1,B-DTL,22,8,3,1,4,14,8
20051023-M-Madrid_Masters-F-Ivan_Ljubicic-Rafael_Nadal,1,B-IO,8,3,2,1,0,7,1
20051023-M-Madrid_Masters-F-Ivan_Ljubicic-Rafael_Nadal,1,S-XC,11,2,0,1,1,5,6
20051023-M-Madrid_Masters-F-Ivan_Ljubicic-Rafael_Nadal,1,S-DTM,10,1,0,0,1,5,5
20051023-M-Madrid_Masters-F-Ivan_Ljubicic-Rafael_Nadal,1,S-DTL,7,1,0,0,1,3,4
20051023-M-Madrid_Masters-F-Ivan_Ljubicic-Rafael_Nadal,1,S-IO,1,0,0,0,0,1,0
20051023-M-Madrid_Masters-F-Ivan_Ljubicic-Rafael_Nadal,1,S-II,1,0,0,0,0,1,0
20051023-M-Madrid_Masters-F-Ivan_Ljubicic-Rafael_Nadal,2,F-XC,89,9,3,1,5,43,46
20051023-M-Madrid_Masters-F-Ivan_Ljubicic-Rafael_Nadal,2,F-DTM,55,1,0,0,1,26,29
20051023-M-Madrid_Masters-F-Ivan_Ljubicic-Rafael_Nadal,2,F-DTL,16,5,3,2,0,11,5
20051023-M-Madrid_Masters-F-Ivan_Ljubicic-Rafael_Nadal,2,F-IO,53,20,4,11,5,37,16
20051023-M-Madrid_Masters-F-Ivan_Ljubicic-Rafael_Nadal,2,F-II,17,5,3,1,1,10,7
20051023-M-Madrid_Masters-F-Ivan_Ljubicic-Rafael_Nadal,2,B-XC,45,8,4,2,2,22,23
20051023-M-Madrid_Masters-F-Ivan_Ljubicic-Rafael_Nadal,2,B-DTM,35,3,0,1,2,12,23
20051023-M-Madrid_Masters-F-Ivan_Ljubicic-Rafael_Nadal,2,B-DTL,18,6,1,2,3,8,10
20051023-M-Madrid_Masters-F-Ivan_Ljubicic-Rafael_Nadal,2,B-IO,6,1,0,1,0,3,3
20051023-M-Madrid_Masters-F-Ivan_Ljubicic-Rafael_Nadal,2,S-DTM,7,0,0,0,0,2,5
20051023-M-Madrid_Masters-F-Ivan_Ljubicic-Rafael_Nadal,2,S-DTL,2,0,0,0,0,2,0
19900325-M-Miami_Masters-F-Andre_Agassi-Stefan_Edberg,1,F-XC,57,9,5,2,2,35,22
19900325-M-Miami_Masters-F-Andre_Agassi-Stefan_Edberg,1,F-DTM,23,2,0,0,2,15,8
19900325-M-Miami_Masters-F-Andre_Agassi-Stefan_Edberg,1,F-DTL,11,4,2,0,2,5,6
19900325-M-Miami_Masters-F-Andre_Agassi-Stefan_Edberg,1,F-IO,11,2,1,0,1,5,6
19900325-M-Miami_Masters-F-Andre_Agassi-Stefan_Edberg,1,F-II,1,0,0,0,0,1,0
19900325-M-Miami_Masters-F-Andre_Agassi-Stefan_Edberg,1,B-XC,84,11,2,5,4,59,25
19900325-M-Miami_Masters-F-Andre_Agassi-Stefan_Edberg,1,B-DTM,33,2,0,0,2,20,13
19900325-M-Miami_Masters-F-Andre_Agassi-Stefan_Edberg,1,B-DTL,30,13,7,4,2,21,9
19900325-M-Miami_Masters-F-Andre_Agassi-Stefan_Edberg,1,B-IO,11,3,1,2,0,9,2
19900325-M-Miami_Masters-F-Andre_Agassi-Stefan_Edberg,1,S-XC,1,0,0,0,0,1,0
19900325-M-Miami_Masters-F-Andre_Agassi-Stefan_Edberg,1,S-DTM,1,0,0,0,0,1,0
19900325-M-Miami_Masters-F-Andre_Agassi-Stefan_Edberg,1,S-DTL,3,1,0,0,1,0,3
19900325-M-Miami_Masters-F-Andre_Agassi-Stefan_Edberg,1,S-IO,1,1,1,0,0,1,0
19900325-M-Miami_Masters-F-Andre_Agassi-Stefan_Edberg,2,F-XC,43,14,1,3,10,17,26
19900325-M-Miami_Masters-F-Andre_Agassi-Stefan_Edberg,2,F-DTM,27,3,0,0,3,10,17
19900325-M-Miami_Masters-F-Andre_Agassi-Stefan_Edberg,2,F-DTL,22,5,1,1,3,10,12
19900325-M-Miami_Masters-F-Andre_Agassi-Stefan_Edberg,2,F-IO,15,1,0,0,1,4,11
19900325-M-Miami_Masters-F-Andre_Agassi-Stefan_Edberg,2,B-XC,33,6,1,2,3,9,24
19900325-M-Miami_Masters-F-Andre_Agassi-Stefan_Edberg,2,B-DTM,22,2,0,0,2,6,16
19900325-M-Miami_Masters-F-Andre_Agassi-Stefan_Edberg,2,B-DTL,6,3,1,1,1,3,3
19900325-M-Miami_Masters-F-Andre_Agassi-Stefan_Edberg,2,B-IO,3,1,0,1,0,2,1
19900325-M-Miami_Masters-F-Andre_Agassi-Stefan_Edberg,2,S-XC,28,6,0,0,6,11,17
19900325-M-Miami_Masters-F-Andre_Agassi-Stefan_Edberg,2,S-DTM,7,0,0,0,0,1,6
19900325-M-Miami_Masters-F-Andre_Agassi-Stefan_Edberg,2,S-DTL,10,4,0,0,4,3,7
19900325-M-Miami_Masters-F-Andre_Agassi-Stefan_Edberg,2,S-IO,3,0,0,0,0,1,2
19961124-M-Tour_Finals-F-Boris_Becker-Pete_Sampras,1,F-XC,32,8,2,3,3,11,21
19961124-M-Tour_Finals-F-Boris_Becker-Pete_Sampras,1,F-DTM,13,3,1,1,1,10,3
19961124-M-Tour_Finals-F-Boris_Becker-Pete_Sampras,1,F-DTL,10,4,2,0,2,4,6
19961124-M-Tour_Finals-F-Boris_Becker-Pete_Sampras,1,F-IO,17,4,2,1,1,13,4
19961124-M-Tour_Finals-F-Boris_Becker-Pete_Sampras,1,F-II,1,1,0,1,0,1,0
19961124-M-Tour_Finals-F-Boris_Becker-Pete_Sampras,1,B-XC,34,9,2,3,4,18,16
19961124-M-Tour_Finals-F-Boris_Becker-Pete_Sampras,1,B-DTM,17,3,0,1,2,7,10
19961124-M-Tour_Finals-F-Boris_Becker-Pete_Sampras,1,B-DTL,23,10,4,0,6,6,17
19961124-M-Tour_Finals-F-Boris_Becker-Pete_Sampras,1,B-IO,4,3,1,0,2,2,2
19961124-M-Tour_Finals-F-Boris_Becker-Pete_Sampras,1,S-XC,6,1,0,0,1,3,3
19961124-M-Tour_Finals-F-Boris_Becker-Pete_Sampras,1,S-DTM,3,0,0,0,0,0,3
19961124-M-Tour_Finals-F-Boris_Becker-Pete_Sampras,1,S-DTL,3,1,0,1,0,1,2
19961124-M-Tour_Finals-F-Boris_Becker-Pete_Sampras,1,S-IO,1,1,0,1,0,1,0
19961124-M-Tour_Finals-F-Boris_Becker-Pete_Sampras,2,F-XC,25,14,4,6,4,18,7
19961124-M-Tour_Finals-F-Boris_Becker-Pete_Sampras,2,F-DTM,13,3,0,1,2,7,6
19961124-M-Tour_Finals-F-Boris_Becker-Pete_Sampras,2,F-DTL,17,8,5,1,2,11,6
19961124-M-Tour_Finals-F-Boris_Becker-Pete_Sampras,2,F-IO,17,5,3,0,2,9,8
19961124-M-Tour_Finals-F-Boris_Becker-Pete_Sampras,2,F-II,6,3,1,0,2,2,4
19961124-M-Tour_Finals-F-Boris_Becker-Pete_Sampras,2,B-XC,50,12,0,5,7,29,21
19961124-M-Tour_Finals-F-Boris_Becker-Pete_Sampras,2,B-DTM,13,1,0,0,1,5,8
19961124-M-Tour_Finals-F-Boris_Becker-Pete_Sampras,2,B-DTL,15,9,4,1,4,6,9
19961124-M-Tour_Finals-F-Boris_Becker-Pete_Sampras,2,B-IO,6,5,3,0,2,3,3
19961124-M-Tour_Finals-F-Boris_Becker-Pete_Sampras,2,S-XC,2,1,0,0,1,1,1
19961124-M-Tour_Finals-F-Boris_Becker-Pete_Sampras,2,S-DTM,4,0,0,0,0,0,4
19961124-M-Tour_Finals-F-Boris_Becker-Pete_Sampras,2,S-DTL,2,0,0,0,0,2,0
19750101-M-Australian_Open-F-Jimmy_Connors-John_Newcombe,1,F-XC,21,7,1,0,6,10,11
19750101-M-Australian_Open-F-Jimmy_Connors-John_Newcombe,1,F-DTM,3,1,0,0,1,1,2
19750101-M-Australian_Open-F-Jimmy_Connors-John_Newcombe,1,F-DTL,3,0,0,0,0,2,1
19750101-M-Australian_Open-F-Jimmy_Connors-John_Newcombe,1,F-II,1,0,0,0,0,0,1
19750101-M-Australian_Open-F-Jimmy_Connors-John_Newcombe,1,B-XC,10,7,3,3,1,8,2
19750101-M-Australian_Open-F-Jimmy_Connors-John_Newcombe,1,B-DTM,9,3,1,0,2,4,5
19750101-M-Australian_Open-F-Jimmy_Connors-John_Newcombe,1,B-DTL,5,4,1,2,1,4,1
19750101-M-Australian_Open-F-Jimmy_Connors-John_Newcombe,1,B-IO,2,1,0,0,1,0,2
19750101-M-Australian_Open-F-Jimmy_Connors-John_Newcombe,1,S-XC,3,1,0,1,0,2,1
19750101-M-Australian_Open-F-Jimmy_Connors-John_Newcombe,1,S-DTM,1,0,0,0,0,1,0
19750101-M-Australian_Open-F-Jimmy_Connors-John_Newcombe,1,S-DTL,3,1,1,0,0,3,0
19750101-M-Australian_Open-F-Jimmy_Connors-John_Newcombe,1,S-IO,4,0,0,0,0,3,1
19750101-M-Australian_Open-F-Jimmy_Connors-John_Newcombe,2,F-XC,5,3,2,0,1,2,3
19750101-M-Australian_Open-F-Jimmy_Connors-John_Newcombe,2,F-DTM,1,0,0,0,0,0,1
19750101-M-Australian_Open-F-Jimmy_Connors-John_Newcombe,2,F-DTL,3,1,0,1,0,2,1
19750101-M-Australian_Open-F-Jimmy_Connors-John_Newcombe,2,F-IO,4,2,0,2,0,3,1
19750101-M-Australian_Open-F-Jimmy_Connors-John_Newcombe,2,B-XC,5,2,0,1,1,1,4
19750101-M-Australian_Open-F-Jimmy_Connors-John_Newcombe,2,B-DTM,1,0,0,0,0,0,1
19750101-M-Australian_Open-F-Jimmy_Connors-John_Newcombe,2,B-DTL,3,1,1,0,0,1,2
19750101-M-Australian_Open-F-Jimmy_Connors-John_Newcombe,2,S-XC,12,1,0,1,0,4,8
19750101-M-Australian_Open-F-Jimmy_Connors-John_Newcombe,2,S-DTM,6,0,0,0,0,3,3
19750101-M-Australian_Open-F-Jimmy_Connors-John_Newcombe,2,S-DTL,4,0,0,0,0,2,2
19750101-M-Australian_Open-F-Jimmy_Connors-John_Newcombe,2,S-IO,2,0,0,0,0,0,2
19911027-M-Stockholm-F-Boris_Becker-Stefan_Edberg,1,F-XC,20,4,3,1,0,12,8
19911027-M-Stockholm-F-Boris_Becker-Stefan_Edberg,1,F-DTM,1,0,0,0,0,1,0
19911027-M-Stockholm-F-Boris_Becker-Stefan_Edberg,1,F-DTL,6,5,2,0,3,3,3
19911027-M-Stockholm-F-Boris_Becker-Stefan_Edberg,1,F-IO,8,2,2,0,0,6,2
19911027-M-Stockholm-F-Boris_Becker-Stefan_Edberg,1,B-XC,13,5,1,0,4,3,10
19911027-M-Stockholm-F-Boris_Becker-Stefan_Edberg,1,B-DTM,14,1,0,0,1,4,10
19911027-M-Stockholm-F-Boris_Becker-Stefan_Edberg,1,B-DTL,10,6,2,2,2,4,6
19911027-M-Stockholm-F-Boris_Becker-Stefan_Edberg,1,B-IO,5,4,2,0,2,2,3
19911027-M-Stockholm-F-Boris_Becker-Stefan_Edberg,1,S-XC,4,0,0,0,0,0,4
19911027-M-Stockholm-F-Boris_Becker-Stefan_Edberg,1,S-DTM,1,0,0,0,0,1,0
19911027-M-Stockholm-F-Boris_Becker-Stefan_Edberg,1,S-DTL,7,0,0,0,0,1,6
19911027-M-Stockholm-F-Boris_Becker-Stefan_Edberg,1,S-IO,1,1,0,1,0,1,0
19911027-M-Stockholm-F-Boris_Becker-Stefan_Edberg,2,F-XC,12,4,0,2,2,5,7
19911027-M-Stockholm-F-Boris_Becker-Stefan_Edberg,2,F-DTM,5,0,0,0,0,2,3
19911027-M-Stockholm-F-Boris_Becker-Stefan_Edberg,2,F-DTL,6,3,1,1,1,4,2
19911027-M-Stockholm-F-Boris_Becker-Stefan_Edberg,2,F-IO,3,0,0,0,0,2,1
19911027-M-Stockholm-F-Boris_Becker-Stefan_Edberg,2,B-XC,8,4,1,3,0,6,2
19911027-M-Stockholm-F-Boris_Becker-Stefan_Edberg,2,B-DTM,6,0,0,0,0,2,4
19911027-M-Stockholm-F-Boris_Becker-Stefan_Edberg,2,B-DTL,12,7,6,0,1,8,4
19911027-M-Stockholm-F-Boris_Becker-Stefan_Edberg,2,B-IO,5,4,1,1,2,3,2
19911027-M-Stockholm-F-Boris_Becker-Stefan_Edberg,2,S-XC,6,1,0,1,0,3,3
19911027-M-Stockholm-F-Boris_Becker-Stefan_Edberg,2,S-DTM,6,1,0,0,1,3,3
19911027-M-Stockholm-F-Boris_Becker-Stefan_Edberg,2,S-DTL,3,3,2,1,0,3,0
20170212-M-Sofia-F-Grigor_Dimitrov-David_Goffin,1,F-XC,31,8,5,2,1,20,11
20170212-M-Sofia-F-Grigor_Dimitrov-David_Goffin,1,F-DTM,24,1,0,0,1,11,13
20170212-M-Sofia-F-Grigor_Dimitrov-David_Goffin,1,F-DTL,11,2,0,2,0,8,3
20170212-M-Sofia-F-Grigor_Dimitrov-David_Goffin,1,F-IO,25,6,0,2,4,14,11
20170212-M-Sofia-F-Grigor_Dimitrov-David_Goffin,1,F-II,4,1,1,0,0,1,3
20170212-M-Sofia-F-Grigor_Dimitrov-David_Goffin,1,B-XC,19,3,0,1,2,14,5
20170212-M-Sofia-F-Grigor_Dimitrov-David_Goffin,1,B-DTM,10,3,0,1,2,5,5
20170212-M-Sofia-F-Grigor_Dimitrov-David_Goffin,1,B-DTL,3,2,1,0,1,2,1
20170212-M-Sofia-F-Grigor_Dimitrov-David_Goffin,1,B-IO,1,0,0,0,0,1,0
20170212-M-Sofia-F-Grigor_Dimitrov-David_Goffin,1,S-XC,25,4,0,1,3,16,9
20170212-M-Sofia-F-Grigor_Dimitrov-David_Goffin,1,S-DTM,15,0,0,0,0,6,9
20170212-M-Sofia-F-Grigor_Dimitrov-David_Goffin,1,S-DTL,8,1,0,0,1,6,2
20170212-M-Sofia-F-Grigor_Dimitrov-David_Goffin,1,S-IO,1,0,0,0,0,1,0
20170212-M-Sofia-F-Grigor_Dimitrov-David_Goffin,2,F-XC,37,7,1,2,4,16,21
20170212-M-Sofia-F-Grigor_Dimitrov-David_Goffin,2,F-DTM,14,2,0,0,2,4,10
20170212-M-Sofia-F-Grigor_Dimitrov-David_Goffin,2,F-DTL,17,3,1,0,2,5,12
20170212-M-Sofia-F-Grigor_Dimitrov-David_Goffin,2,F-IO,28,9,2,4,3,17,11
20170212-M-Sofia-F-Grigor_Dimitrov-David_Goffin,2,F-II,4,2,0,2,0,2,2
20170212-M-Sofia-F-Grigor_Dimitrov-David_Goffin,2,B-XC,48,11,2,2,7,15,33
20170212-M-Sofia-F-Grigor_Dimitrov-David_Goffin,2,B-DTM,14,3,0,1,2,2,12
20170212-M-Sofia-F-Grigor_Dimitrov-David_Goffin,2,B-DTL,13,8,2,1,5,5,8
20170212-M-Sofia-F-Grigor_Dimitrov-David_Goffin,2,B-II,1,0,0,0,0,1,0
20170212-M-Sofia-F-Grigor_Dimitrov-David_Goffin,2,S-XC,2,1,0,0,1,0,2
20170212-M-Sofia-F-Grigor_Dimitrov-David_Goffin,2,S-DTM,1,0,0,0,0,0,1
20170212-M-Sofia-F-Grigor_Dimitrov-David_Goffin,2,S-DTL,2,1,1,0,0,1,1
20171119-M-Tour_Finals-F-Grigor_Dimitrov-David_Goffin,1,F-XC,44,13,2,7,4,27,17
20171119-M-Tour_Finals-F-Grigor_Dimitrov-David_Goffin,1,F-DTM,43,3,0,0,3,22,21
20171119-M-Tour_Finals-F-Grigor_Dimitrov-David_Goffin,1,F-DTL,23,6,2,2,2,16,7
20171119-M-Tour_Finals-F-Grigor_Dimitrov-David_Goffin,1,F-IO,37,6,1,2,3,23,14
20171119-M-Tour_Finals-F-Grigor_Dimitrov-David_Goffin,1,F-II,6,1,0,1,0,3,3
20171119-M-Tour_Finals-F-Grigor_Dimitrov-David_Goffin,1,B-XC,14,3,2,0,1,9,5
20171119-M-Tour_Finals-F-Grigor_Dimitrov-David_Goffin,1,B-DTM,16,2,0,1,1,10,6
20171119-M-Tour_Finals-F-Grigor_Dimitrov-David_Goffin,1,B-DTL,8,4,0,2,2,6,2
20171119-M-Tour_Finals-F-Grigor_Dimitrov-David_Goffin,1,S-XC,27,3,0,1,2,12,15
20171119-M-Tour_Finals-F-Grigor_Dimitrov-David_Goffin,1,S-DTM,24,1,1,0,0,13,11
20171119-M-Tour_Finals-F-Grigor_Dimitrov-David_Goffin,1,S-DTL,14,2,0,1,1,6,8
20171119-M-Tour_Finals-F-Grigor_Dimitrov-David_Goffin,2,F-XC,63,17,5,8,4,29,34
20171119-M-Tour_Finals-F-Grigor_Dimitrov-David_Goffin,2,F-DTM,27,7,0,0,7,10,17
20171119-M-Tour_Finals-F-Grigor_Dimitrov-David_Goffin,2,F-DTL,20,5,2,2,1,14,6
20171119-M-Tour_Finals-F-Grigor_Dimitrov-David_Goffin,2,F-IO,37,11,4,1,6,17,20
20171119-M-Tour_Finals-F-Grigor_Dimitrov-David_Goffin,2,F-II,9,4,1,1,2,4,5
20171119-M-Tour_Finals-F-Grigor_Dimitrov-David_Goffin,2,B-XC,64,12,5,3,4,31,33
20171119-M-Tour_Finals-F-Grigor_Dimitrov-David_Goffin,2,B-DTM,22,3,0,0,3,7,15
20171119-M-Tour_Finals-F-Grigor_Dimitrov-David_Goffin,2,B-DTL,11,5,0,0,5,3,8
20171119-M-Tour_Finals-F-Grigor_Dimitrov-David_Goffin,2,B-IO,3,2,0,0,2,0,3
20171119-M-Tour_Finals-F-Grigor_Dimitrov-David_Goffin,2,S-XC,5,0,0,0,0,2,3
20171119-M-Tour_Finals-F-Grigor_Dimitrov-David_Goffin,2,S-DTM,4,1,0,0,1,0,4
20171119-M-Tour_Finals-F-Grigor_Dimitrov-David_Goffin,2,S-DTL,1,0,0,0,0,0,1
20171119-M-Tour_Finals-F-Grigor_Dimitrov-David_Goffin,2,S-IO,1,0,0,0,0,0,1
20020811-M-Cincinnati_Masters-F-Carlos_Moya-Lleyton_Hewitt,1,F-XC,63,12,1,3,8,27,36
20020811-M-Cincinnati_Masters-F-Carlos_Moya-Lleyton_Hewitt,1,F-DTM,53,5,1,2,2,27,26
20020811-M-Cincinnati_Masters-F-Carlos_Moya-Lleyton_Hewitt,1,F-DTL,22,5,2,1,2,10,12
20020811-M-Cincinnati_Masters-F-Carlos_Moya-Lleyton_Hewitt,1,F-IO,65,17,3,5,9,32,33
20020811-M-Cincinnati_Masters-F-Carlos_Moya-Lleyton_Hewitt,1,F-II,14,10,3,3,4,8,6
20020811-M-Cincinnati_Masters-F-Carlos_Moya-Lleyton_Hewitt,1,B-XC,15,1,1,0,0,6,9
20020811-M-Cincinnati_Masters-F-Carlos_Moya-Lleyton_Hewitt,1,B-DTM,13,5,0,0,5,5,8
20020811-M-Cincinnati_Masters-F-Carlos_Moya-Lleyton_Hewitt,1,B-DTL,9,5,3,1,1,7,2
20020811-M-Cincinnati_Masters-F-Carlos_Moya-Lleyton_Hewitt,1,B-IO,1,0,0,0,0,1,0
20020811-M-Cincinnati_Masters-F-Carlos_Moya-Lleyton_Hewitt,1,S-XC,5,1,0,0,1,3,2
20020811-M-Cincinnati_Masters-F-Carlos_Moya-Lleyton_Hewitt,1,S-DTM,9,1,0,0,1,6,3
20020811-M-Cincinnati_Masters-F-Carlos_Moya-Lleyton_Hewitt,1,S-IO,1,1,0,0,1,0,1
20020811-M-Cincinnati_Masters-F-Carlos_Moya-Lleyton_Hewitt,2,F-XC,64,9,1,1,7,27,37
20020811-M-Cincinnati_Masters-F-Carlos_Moya-Lleyton_Hewitt,2,F-DTM,42,5,0,0,5,24,18
20020811-M-Cincinnati_Masters-F-Carlos_Moya-Lleyton_Hewitt,2,F-DTL,13,5,2,1,2,4,9
20020811-M-Cincinnati_Masters-F-Carlos_Moya-Lleyton_Hewitt,2,F-IO,20,3,2,1,0,9,11
20020811-M-Cincinnati_Masters-F-Carlos_Moya-Lleyton_Hewitt,2,F-II,2,1,1,0,0,2,0
20020811-M-Cincinnati_Masters-F-Carlos_Moya-Lleyton_Hewitt,2,B-XC,67,7,3,0,4,36,31
20020811-M-Cincinnati_Masters-F-Carlos_Moya-Lleyton_Hewitt,2,B-DTM,26,3,0,0,3,13,13
20020811-M-Cincinnati_Masters-F-Carlos_Moya-Lleyton_Hewitt,2,B-DTL,7,3,2,0,1,3,4
20020811-M-Cincinnati_Masters-F-Carlos_Moya-Lleyton_Hewitt,2,B-IO,1,0,0,0,0,0,1
20020811-M-Cincinnati_Masters-F-Carlos_Moya-Lleyton_Hewitt,2,S-XC,11,1,0,0,1,4,7
20020811-M-Cincinnati_Masters-F-Carlos_Moya-Lleyton_Hewitt,2,S-DTM,2,0,0,0,0,1,1
20020811-M-Cincinnati_Masters-F-Carlos_Moya-Lleyton_Hewitt,2,S-DTL,4,1,0,1,0,3,1
20050417-M-Monte_Carlo_Masters-F-Rafael_Nadal-Guillermo_Coria,1,F-XC,222,15,1,6,8,127,95
20050417-M-Monte_Carlo_Masters-F-Rafael_Nadal-Guillermo_Coria,1,F-DTM,75,4,0,0,4,39,36
20050417-M-Monte_Carlo_Masters-F-Rafael_Nadal-Guillermo_Coria,1,F-DTL,32,15,6,6,3,21,11
20050417-M-Monte_Carlo_Masters-F-Rafael_Nadal-Guillermo_Coria,1,F-IO,53,11,4,2,5,27,26
20050417-M-Monte_Carlo_Masters-F-Rafael_Nadal-Guillermo_Coria,1,F-II,41,6,2,0,4,24,17
20050417-M-Monte_Carlo_Masters-F-Rafael_Nadal-Guillermo_Coria,1,B-XC,123,11,0,5,6,64,59
20050417-M-Monte_Carlo_Masters-F-Rafael_Nadal-Guillermo_Coria,1,B-DTM,119,3,0,1,2,58,61
20050417-M-Monte_Carlo_Masters-F-Rafael_Nadal-Guillermo_Coria,1,B-DTL,41,4,0,0,4,20,21
20050417-M-Monte_Carlo_Masters-F-Rafael_Nadal-Guillermo_Coria,1,B-IO,16,3,1,1,1,8,8
20050417-M-Monte_Carlo_Masters-F-Rafael_Nadal-Guillermo_Coria,1,S-XC,3,1,1,0,0,3,0
20050417-M-Monte_Carlo_Masters-F-Rafael_Nadal-Guillermo_Coria,1,S-DTM,4,0,0,0,0,1,3
20050417-M-Monte_Carlo_Masters-F-Rafael_Nadal-Guillermo_Coria,1,S-DTL,13,1,0,1,0,9,4
20050417-M-Monte_Carlo_Masters-F-Rafael_Nadal-Guillermo_Coria,2,F-XC,169,20,6,2,12,87,82
20050417-M-Monte_Carlo_Masters-F-Rafael_Nadal-Guillermo_Coria,2,F-DTM,55,3,0,0,3,30,25
20050417-M-Monte_Carlo_Masters-F-Rafael_Nadal-Guillermo_Coria,2,F-DTL,33,11,2,2,7,15,18
20050417-M-Monte_Carlo_Masters-F-Rafael_Nadal-Guillermo_Coria,2,F-IO,68,12,5,5,2,30,38
20050417-M-Monte_Carlo_Masters-F-Rafael_Nadal-Guillermo_Coria,2,F-II,24,6,0,1,5,10,14
20050417-M-Monte_Carlo_Masters-F-Rafael_Nadal-Guillermo_Coria,2,B-XC,107,10,0,1,9,45,62
20050417-M-Monte_Carlo_Masters-F-Rafael_Nadal-Guillermo_Coria,2,B-DTM,129,2,0,0,2,52,77
20050417-M-Monte_Carlo_Masters-F-Rafael_Nadal-Guillermo_Coria,2,B-DTL,95,16,4,4,8,41,54
20050417-M-Monte_Carlo_Masters-F-Rafael_Nadal-Guillermo_Coria,2,B-IO,22,1,0,0,1,9,13
20050417-M-Monte_Carlo_Masters-F-Rafael_Nadal-Guillermo_Coria,2,S-XC,4,0,0,0,0,2,2
20050417-M-Monte_Carlo_Masters-F-Rafael_Nadal-Guillermo_Coria,2,S-DTM,6,0,0,0,0,4,2
20050417-M-Monte_Carlo_Masters-F-Rafael_Nadal-Guillermo_Coria,2,S-DTL,3,0,0,0,0,1,2
20050417-M-Monte_Carlo_Masters-F-Rafael_Nadal-Guillermo_Coria,2,S-IO,1,1,1,0,0,1,0
19910125-M-Australian_Open-SF-Stefan_Edberg-Ivan_Lendl,1,F-XC,45,14,1,6,7,22,23
19910125-M-Australian_Open-SF-Stefan_Edberg-Ivan_Lendl,1,F-DTM,21,1,0,0,1,4,17
19910125-M-Australian_Open-SF-Stefan_Edberg-Ivan_Lendl,1,F-DTL,43,5,2,1,2,23,20
19910125-M-Australian_Open-SF-Stefan_Edberg-Ivan_Lendl,1,F-IO,26,2,0,2,0,15,11
19910125-M-Australian_Open-SF-Stefan_Edberg-Ivan_Lendl,1,B-XC,42,5,0,2,3,22,20
19910125-M-Australian_Open-SF-Stefan_Edberg-Ivan_Lendl,1,B-DTM,18,4,0,0,4,10,8
19910125-M-Australian_Open-SF-Stefan_Edberg-Ivan_Lendl,1,B-DTL,10,6,3,1,2,5,5
19910125-M-Australian_Open-SF-Stefan_Edberg-Ivan_Lendl,1,B-IO,5,2,1,1,0,5,0
19910125-M-Australian_Open-SF-Stefan_Edberg-Ivan_Lendl,1,S-XC,56,4,0,0,4,26,30
19910125-M-Australian_Open-SF-Stefan_Edberg-Ivan_Lendl,1,S-DTM,13,0,0,0,0,3,10
19910125-M-Australian_Open-SF-Stefan_Edberg-Ivan_Lendl,1,S-DTL,11,3,1,0,2,4,7
19910125-M-Australian_Open-SF-Stefan_Edberg-Ivan_Lendl,2,F-XC,56,13,6,6,1,36,20
19910125-M-Australian_Open-SF-Stefan_Edberg-Ivan_Lendl,2,F-DTM,25,2,0,0,2,12,13
19910125-M-Australian_Open-SF-Stefan_Edberg-Ivan_Lendl,2,F-DTL,26,5,1,2,2,15,11
19910125-M-Australian_Open-SF-Stefan_Edberg-Ivan_Lendl,2,F-IO,36,8,2,3,3,21,15
19910125-M-Australian_Open-SF-Stefan_Edberg-Ivan_Lendl,2,F-II,12,4,1,2,1,8,4
19910125-M-Australian_Open-SF-Stefan_Edberg-Ivan_Lendl,2,B-XC,80,17,8,5,4,49,31
19910125-M-Australian_Open-SF-Stefan_Edberg-Ivan_Lendl,2,B-DTM,29,0,0,0,0,12,17
19910125-M-Australian_Open-SF-Stefan_Edberg-Ivan_Lendl,2,B-DTL,38,16,6,3,7,17,21
19910125-M-Australian_Open-SF-Stefan_Edberg-Ivan_Lendl,2,B-IO,10,4,1,0,3,4,6
19910125-M-Australian_Open-SF-Stefan_Edberg-Ivan_Lendl,2,S-XC,26,3,0,1,2,12,14
19910125-M-Australian_Open-SF-Stefan_Edberg-Ivan_Lendl,2,S-DTM,13,1,0,0,1,2,11
19910125-M-Australian_Open-SF-Stefan_Edberg-Ivan_Lendl,2,S-DTL,21,4,1,0,3,12,9
19910125-M-Australian_Open-SF-Stefan_Edberg-Ivan_Lendl,2,S-IO,4,2,0,0,2,1,3
19970323-M-Miami_Masters-F-Sergi_Bruguera-Thomas_Muster,1,F-XC,87,11,5,1,5,50,37
19970323-M-Miami_Masters-F-Sergi_Bruguera-Thomas_Muster,1,F-DTM,28,0,0,0,0,11,17
19970323-M-Miami_Masters-F-Sergi_Bruguera-Thomas_Muster,1,F-DTL,9,2,1,0,1,5,4
19970323-M-Miami_Masters-F-Sergi_Bruguera-Thomas_Muster,1,F-IO,33,8,2,0,6,17,16
19970323-M-Miami_Masters-F-Sergi_Bruguera-Thomas_Muster,1,F-II,8,2,1,0,1,5,3
19970323-M-Miami_Masters-F-Sergi_Bruguera-Thomas_Muster,1,B-XC,42,10,1,3,6,18,24
19970323-M-Miami_Masters-F-Sergi_Bruguera-Thomas_Muster,1,B-DTM,33,4,0,0,4,17,16
19970323-M-Miami_Masters-F-Sergi_Bruguera-Thomas_Muster,1,B-DTL,22,10,1,1,8,8,14
19970323-M-Miami_Masters-F-Sergi_Bruguera-Thomas_Muster,1,B-IO,12,0,0,0,0,6,6
19970323-M-Miami_Masters-F-Sergi_Bruguera-Thomas_Muster,1,S-XC,3,2,1,0,1,2,1
19970323-M-Miami_Masters-F-Sergi_Bruguera-Thomas_Muster,1,S-DTM,6,1,0,0,1,3,3
19970323-M-Miami_Masters-F-Sergi_Bruguera-Thomas_Muster,1,S-IO,1,0,0,0,0,0,1
19970323-M-Miami_Masters-F-Sergi_Bruguera-Thomas_Muster,2,F-XC,24,9,2,3,4,14,10
19970323-M-Miami_Masters-F-Sergi_Bruguera-Thomas_Muster,2,F-DTM,33,4,0,0,4,19,14
19970323-M-Miami_Masters-F-Sergi_Bruguera-Thomas_Muster,2,F-DTL,9,1,1,0,0,6,3
19970323-M-Miami_Masters-F-Sergi_Bruguera-Thomas_Muster,2,F-IO,73,6,2,3,1,40,33
19970323-M-Miami_Masters-F-Sergi_Bruguera-Thomas_Muster,2,F-II,19,10,4,1,5,9,10
19970323-M-Miami_Masters-F-Sergi_Bruguera-Thomas_Muster,2,B-XC,6,0,0,0,0,4,2
19970323-M-Miami_Masters-F-Sergi_Bruguera-Thomas_Muster,2,B-DTM,51,5,0,2,3,26,25
19970323-M-Miami_Masters-F-Sergi_Bruguera-Thomas_Muster,2,B-IO,31,5,0,1,4,12,19
19970323-M-Miami_Masters-F-Sergi_Bruguera-Thomas_Muster,2,B-II,8,2,0,1,1,4,4
19970323-M-Miami_Masters-F-Sergi_Bruguera-Thomas_Muster,2,S-XC,1,0,0,0,0,1,0
19970323-M-Miami_Masters-F-Sergi_Bruguera-Thomas_Muster,2,S-DTM,12,1,0,0,1,5,7
19970323-M-Miami_Masters-F-Sergi_Bruguera-Thomas_Muster,2,S-IO,3,1,0,0,1,2,1
19970323-M-Miami_Masters-F-Sergi_Bruguera-Thomas_Muster,2,S-II,2,0,0,0,0,1,1
19920122-M-Australian_Open-QF-Stefan_Edberg-Ivan_Lendl,1,F-XC,19,6,1,3,2,8,11
19920122-M-Australian_Open-QF-Stefan_Edberg-Ivan_Lendl,1,F-DTM,12,0,0,0,0,7,5
19920122-M-Australian_Open-QF-Stefan_Edberg-Ivan_Lendl,1,F-DTL,29,6,0,4,2,12,17
19920122-M-Australian_Open-QF-Stefan_Edberg-Ivan_Lendl,1,F-IO,8,0,0,0,0,4,4
19920122-M-Australian_Open-QF-Stefan_Edberg-Ivan_Lendl,1,B-XC,27,4,0,1,3,15,12
19920122-M-Australian_Open-QF-Stefan_Edberg-Ivan_Lendl,1,B-DTM,3,0,0,0,0,1,2
19920122-M-Australian_Open-QF-Stefan_Edberg-Ivan_Lendl,1,B-DTL,10,8,3,4,1,9,1
19920122-M-Australian_Open-QF-Stefan_Edberg-Ivan_Lendl,1,B-IO,2,2,0,0,2,0,2
19920122-M-Australian_Open-QF-Stefan_Edberg-Ivan_Lendl,1,S-XC,28,1,0,0,1,10,18
19920122-M-Australian_Open-QF-Stefan_Edberg-Ivan_Lendl,1,S-DTM,9,1,0,0,1,2,7
19920122-M-Australian_Open-QF-Stefan_Edberg-Ivan_Lendl,1,S-DTL,8,6,1,2,3,3,5
19920122-M-Australian_Open-QF-Stefan_Edberg-Ivan_Lendl,2,F-XC,43,13,5,3,5,24,19
19920122-M-Australian_Open-QF-Stefan_Edberg-Ivan_Lendl,2,F-DTM,4,0,0,0,0,0,4
19920122-M-Australian_Open-QF-Stefan_Edberg-Ivan_Lendl,2,F-DTL,14,7,3,1,3,6,8
19920122-M-Australian_Open-QF-Stefan_Edberg-Ivan_Lendl,2,F-IO,24,4,0,3,1,14,10
19920122-M-Australian_Open-QF-Stefan_Edberg-Ivan_Lendl,2,F-II,7,3,1,1,1,5,2
19920122-M-Australian_Open-QF-Stefan_Edberg-Ivan_Lendl,2,B-XC,43,9,5,2,2,24,19
19920122-M-Australian_Open-QF-Stefan_Edberg-Ivan_Lendl,2,B-DTM,11,0,0,0,0,5,6
19920122-M-Australian_Open-QF-Stefan_Edberg-Ivan_Lendl,2,B-DTL,24,9,7,1,1,15,9
19920122-M-Australian_Open-QF-Stefan_Edberg-Ivan_Lendl,2,B-IO,4,1,1,0,0,2,2
19920122-M-Australian_Open-QF-Stefan_Edberg-Ivan_Lendl,2,B-II,1,0,0,0,0,0,1
19920122-M-Australian_Open-QF-Stefan_Edberg-Ivan_Lendl,2,S-XC,26,5,1,1,3,14,12
19920122-M-Australian_Open-QF-Stefan_Edberg-Ivan_Lendl,2,S-DTM,10,1,0,0,1,5,5
19920122-M-Australian_Open-QF-Stefan_Edberg-Ivan_Lendl,2,S-DTL,15,1,0,0,1,6,9
19920122-M-Australian_Open-QF-Stefan_Edberg-Ivan_Lendl,2,S-IO,1,0,0,0,0,1,0
20150219-M-Rio_de_Janeiro-R16-Rafael_Nadal-Pablo_Carreno_Busta,1,B-XC,1,1,0,0,1,0,1
20150219-M-Rio_de_Janeiro-R16-Rafael_Nadal-Pablo_Carreno_Busta,2,F-XC,1,1,1,0,0,1,0
20150219-M-Rio_de_Janeiro-R16-Rafael_Nadal-Pablo_Carreno_Busta,2,F-IO,1,1,1,0,0,1,0
20150219-M-Rio_de_Janeiro-R16-Rafael_Nadal-Pablo_Carreno_Busta,2,B-DTL,1,1,1,0,0,1,0
19950319-M-Miami_Masters-F-Pete_Sampras-Andre_Agassi,1,F-XC,35,14,4,4,6,18,17
19950319-M-Miami_Masters-F-Pete_Sampras-Andre_Agassi,1,F-DTM,13,1,0,1,0,4,9
19950319-M-Miami_Masters-F-Pete_Sampras-Andre_Agassi,1,F-DTL,16,11,3,1,7,6,10
19950319-M-Miami_Masters-F-Pete_Sampras-Andre_Agassi,1,F-IO,30,6,2,2,2,17,13
19950319-M-Miami_Masters-F-Pete_Sampras-Andre_Agassi,1,F-II,7,5,0,2,3,3,4
19950319-M-Miami_Masters-F-Pete_Sampras-Andre_Agassi,1,B-XC,47,2,2,0,0,22,25
19950319-M-Miami_Masters-F-Pete_Sampras-Andre_Agassi,1,B-DTM,20,3,0,0,3,8,12
19950319-M-Miami_Masters-F-Pete_Sampras-Andre_Agassi,1,B-DTL,9,5,1,1,3,4,5
19950319-M-Miami_Masters-F-Pete_Sampras-Andre_Agassi,1,B-IO,2,1,0,0,1,0,2
19950319-M-Miami_Masters-F-Pete_Sampras-Andre_Agassi,1,S-XC,17,0,0,0,0,7,10
19950319-M-Miami_Masters-F-Pete_Sampras-Andre_Agassi,1,S-DTM,9,0,0,0,0,2,7
19950319-M-Miami_Masters-F-Pete_Sampras-Andre_Agassi,1,S-DTL,5,0,0,0,0,1,4
19950319-M-Miami_Masters-F-Pete_Sampras-Andre_Agassi,2,F-XC,37,11,4,5,2,25,12
19950319-M-Miami_Masters-F-Pete_Sampras-Andre_Agassi,2,F-DTM,13,2,0,0,2,6,7
19950319-M-Miami_Masters-F-Pete_Sampras-Andre_Agassi,2,F-DTL,17,3,2,1,0,13,4
19950319-M-Miami_Masters-F-Pete_Sampras-Andre_Agassi,2,F-IO,59,19,7,5,7,36,23
19950319-M-Miami_Masters-F-Pete_Sampras-Andre_Agassi,2,F-II,7,5,2,1,2,3,4
19950319-M-Miami_Masters-F-Pete_Sampras-Andre_Agassi,2,B-XC,66,9,0,3,6,37,29
19950319-M-Miami_Masters-F-Pete_Sampras-Andre_Agassi,2,B-DTM,19,4,0,0,4,10,9
19950319-M-Miami_Masters-F-Pete_Sampras-Andre_Agassi,2,B-DTL,19,9,4,3,2,12,7
19950319-M-Miami_Masters-F-Pete_Sampras-Andre_Agassi,2,S-XC,2,0,0,0,0,0,2
19950319-M-Miami_Masters-F-Pete_Sampras-Andre_Agassi,2,S-DTL,1,0,0,0,0,1,0
19921122-M-Tour_Finals-F-Jim_Courier-Boris_Becker,1,F-XC,16,7,3,3,1,10,6
19921122-M-Tour_Finals-F-Jim_Courier-Boris_Becker,1,F-DTM,8,1,0,0,1,5,3
19921122-M-Tour_Finals-F-Jim_Courier-Boris_Becker,1,F-DTL,7,2,2,0,0,3,4
19921122-M-Tour_Finals-F-Jim_Courier-Boris_Becker,1,F-IO,14,4,3,1,0,11,3
19921122-M-Tour_Finals-F-Jim_Courier-Boris_Becker,1,F-II,1,0,0,0,0,1,0
19921122-M-Tour_Finals-F-Jim_Courier-Boris_Becker,1,B-XC,13,2,2,0,0,8,5
19921122-M-Tour_Finals-F-Jim_Courier-Boris_Becker,1,B-DTM,10,4,0,3,1,4,6
19921122-M-Tour_Finals-F-Jim_Courier-Boris_Becker,1,B-DTL,5,2,2,0,0,3,2
19921122-M-Tour_Finals-F-Jim_Courier-Boris_Becker,1,S-XC,10,2,0,0,2,2,8
19921122-M-Tour_Finals-F-Jim_Courier-Boris_Becker,1,S-DTM,1,0,0,0,0,1,0
19921122-M-Tour_Finals-F-Jim_Courier-Boris_Becker,1,S-IO,1,1,1,0,0,1,0
19921122-M-Tour_Finals-F-Jim_Courier-Boris_Becker,2,F-XC,14,7,4,1,2,9,5
19921122-M-Tour_Finals-F-Jim_Courier-Boris_Becker,2,F-DTM,5,0,0,0,0,2,3
19921122-M-Tour_Finals-F-Jim_Courier-Boris_Becker,2,F-DTL,3,0,0,0,0,2,1
19921122-M-Tour_Finals-F-Jim_Courier-Boris_Becker,2,F-IO,12,5,1,1,3,5,7
19921122-M-Tour_Finals-F-Jim_Courier-Boris_Becker,2,B-XC,14,3,1,1,1,9,5
19921122-M-Tour_Finals-F-Jim_Courier-Boris_Becker,2,B-DTM,5,0,0,0,0,2,3
19921122-M-Tour_Finals-F-Jim_Courier-Boris_Becker,2,B-DTL,7,4,2,0,2,3,4
19921122-M-Tour_Finals-F-Jim_Courier-Boris_Becker,2,B-IO,4,1,0,1,0,3,1
19921122-M-Tour_Finals-F-Jim_Courier-Boris_Becker,2,S-XC,3,2,0,1,1,1,2
19921122-M-Tour_Finals-F-Jim_Courier-Boris_Becker,2,S-DTM,3,0,0,0,0,1,2
19921122-M-Tour_Finals-F-Jim_Courier-Boris_Becker,2,S-DTL,1,0,0,0,0,0,1
20070305-M-Indian_Wells-SF-Andy_Murray-Novak_Djokovic,1,F-XC,13,5,2,0,3,5,8
20070305-M-Indian_Wells-SF-Andy_Murray-Novak_Djokovic,1,F-DTM,13,0,0,0,0,4,9
20070305-M-Indian_Wells-SF-Andy_Murray-Novak_Djokovic,1,F-DTL,6,2,2,0,0,3,3
20070305-M-Indian_Wells-SF-Andy_Murray-Novak_Djokovic,1,F-IO,9,1,1,0,0,5,4
20070305-M-Indian_Wells-SF-Andy_Murray-Novak_Djokovic,1,B-XC,17,2,0,1,1,8,9
20070305-M-Indian_Wells-SF-Andy_Murray-Novak_Djokovic,1,B-DTM,20,6,0,0,6,4,16
20070305-M-Indian_Wells-SF-Andy_Murray-Novak_Djokovic,1,B-DTL,6,4,0,1,3,1,5
20070305-M-Indian_Wells-SF-Andy_Murray-Novak_Djokovic,1,B-IO,2,1,0,0,1,1,1
20070305-M-Indian_Wells-SF-Andy_Murray-Novak_Djokovic,1,S-XC,13,2,0,0,2,4,9
20070305-M-Indian_Wells-SF-Andy_Murray-Novak_Djokovic,1,S-DTM,3,0,0,0,0,1,2
20070305-M-Indian_Wells-SF-Andy_Murray-Novak_Djokovic,1,S-DTL,1,0,0,0,0,0,1
20070305-M-Indian_Wells-SF-Andy_Murray-Novak_Djokovic,2,F-XC,14,5,2,2,1,8,6
20070305-M-Indian_Wells-SF-Andy_Murray-Novak_Djokovic,2,F-DTM,9,2,0,0,2,4,5
20070305-M-Indian_Wells-SF-Andy_Murray-Novak_Djokovic,2,F-DTL,3,0,0,0,0,2,1
20070305-M-Indian_Wells-SF-Andy_Murray-Novak_Djokovic,2,F-IO,17,7,3,1,3,11,6
20070305-M-Indian_Wells-SF-Andy_Murray-Novak_Djokovic,2,B-XC,27,1,0,0,1,19,8
20070305-M-Indian_Wells-SF-Andy_Murray-Novak_Djokovic,2,B-DTM,14,3,0,0,3,8,6
20070305-M-Indian_Wells-SF-Andy_Murray-Novak_Djokovic,2,B-DTL,9,2,1,1,0,6,3
20070305-M-Indian_Wells-SF-Andy_Murray-Novak_Djokovic,2,B-IO,5,1,0,1,0,4,1
20070305-M-Indian_Wells-SF-Andy_Murray-Novak_Djokovic,2,S-DTM,1,0,0,0,0,1,0
20070305-M-Indian_Wells-SF-Andy_Murray-Novak_Djokovic,2,S-DTL,1,1,0,0,1,0,1
20170925-M-Chengdu-F-Denis_Istomin-Marcos_Baghdatis,1,F-XC,6,1,0,1,0,3,3
20170925-M-Chengdu-F-Denis_Istomin-Marcos_Baghdatis,1,F-DTM,1,0,0,0,0,1,0
20170925-M-Chengdu-F-Denis_Istomin-Marcos_Baghdatis,1,F-DTL,4,2,1,0,1,1,3
20170925-M-Chengdu-F-Denis_Istomin-Marcos_Baghdatis,1,F-IO,4,1,0,1,0,3,1
20170925-M-Chengdu-F-Denis_Istomin-Marcos_Baghdatis,1,F-II,1,1,0,0,1,0,1
20170925-M-Chengdu-F-Denis_Istomin-Marcos_Baghdatis,1,B-XC,6,2,0,1,1,3,3
20170925-M-Chengdu-F-Denis_Istomin-Marcos_Baghdatis,1,B-DTM,9,1,0,0,1,3,6
20170925-M-Chengdu-F-Denis_Istomin-Marcos_Baghdatis,1,B-DTL,3,0,0,0,0,3,0
20170925-M-Chengdu-F-Denis_Istomin-Marcos_Baghdatis,1,B-IO,1,1,1,0,0,1,0
20170925-M-Chengdu-F-Denis_Istomin-Marcos_Baghdatis,1,S-XC,3,0,0,0,0,2,1
20170925-M-Chengdu-F-Denis_Istomin-Marcos_Baghdatis,2,F-XC,9,0,0,0,0,5,4
20170925-M-Chengdu-F-Denis_Istomin-Marcos_Baghdatis,2,F-DTM,4,1,0,0,1,2,2
20170925-M-Chengdu-F-Denis_Istomin-Marcos_Baghdatis,2,F-DTL,3,1,0,0,1,1,2
20170925-M-Chengdu-F-Denis_Istomin-Marcos_Baghdatis,2,F-IO,2,0,0,0,0,1,1
20170925-M-Chengdu-F-Denis_Istomin-Marcos_Baghdatis,2,B-XC,2,0,0,0,0,1,1
20170925-M-Chengdu-F-Denis_Istomin-Marcos_Baghdatis,2,B-DTM,6,0,0,0,0,5,1
20170925-M-Chengdu-F-Denis_Istomin-Marcos_Baghdatis,2,B-DTL,2,1,0,0,1,0,2
20170925-M-Chengdu-F-Denis_Istomin-Marcos_Baghdatis,2,S-XC,4,0,0,0,0,3,1
20170925-M-Chengdu-F-Denis_Istomin-Marcos_Baghdatis,2,S-DTM,3,0,0,0,0,0,3
19940731-M-Canada_Masters-F-Jason_Stoltenberg-Andre_Agassi,1,F-XC,24,6,2,1,3,10,14
19940731-M-Canada_Masters-F-Jason_Stoltenberg-Andre_Agassi,1,F-DTM,21,1,0,0,1,11,10
19940731-M-Canada_Masters-F-Jason_Stoltenberg-Andre_Agassi,1,F-DTL,9,2,0,2,0,7,2
19940731-M-Canada_Masters-F-Jason_Stoltenberg-Andre_Agassi,1,F-IO,6,1,0,0,1,5,1
19940731-M-Canada_Masters-F-Jason_Stoltenberg-Andre_Agassi,1,B-XC,56,8,2,1,5,31,25
19940731-M-Canada_Masters-F-Jason_Stoltenberg-Andre_Agassi,1,B-DTM,18,2,0,0,2,10,8
19940731-M-Canada_Masters-F-Jason_Stoltenberg-Andre_Agassi,1,B-DTL,11,9,2,2,5,6,5
19940731-M-Canada_Masters-F-Jason_Stoltenberg-Andre_Agassi,1,B-IO,7,2,0,0,2,2,5
19940731-M-Canada_Masters-F-Jason_Stoltenberg-Andre_Agassi,1,S-XC,15,1,0,0,1,7,8
19940731-M-Canada_Masters-F-Jason_Stoltenberg-Andre_Agassi,1,S-DTM,6,1,0,0,1,1,5
19940731-M-Canada_Masters-F-Jason_Stoltenberg-Andre_Agassi,1,S-DTL,1,1,0,0,1,0,1
19940731-M-Canada_Masters-F-Jason_Stoltenberg-Andre_Agassi,2,F-XC,24,3,2,1,0,14,10
19940731-M-Canada_Masters-F-Jason_Stoltenberg-Andre_Agassi,2,F-DTM,23,1,0,0,1,14,9
19940731-M-Canada_Masters-F-Jason_Stoltenberg-Andre_Agassi,2,F-DTL,6,1,0,0,1,2,4
19940731-M-Canada_Masters-F-Jason_Stoltenberg-Andre_Agassi,2,F-IO,16,7,2,2,3,10,6
19940731-M-Canada_Masters-F-Jason_Stoltenberg-Andre_Agassi,2,F-II,10,7,1,4,2,6,4
19940731-M-Canada_Masters-F-Jason_Stoltenberg-Andre_Agassi,2,B-XC,63,11,3,2,6,29,34
19940731-M-Canada_Masters-F-Jason_Stoltenberg-Andre_Agassi,2,B-DTM,23,1,0,1,0,10,13
19940731-M-Canada_Masters-F-Jason_Stoltenberg-Andre_Agassi,2,B-DTL,12,3,2,1,0,6,6
19940731-M-Canada_Masters-F-Jason_Stoltenberg-Andre_Agassi,2,B-IO,4,1,1,0,0,3,1
19940731-M-Canada_Masters-F-Jason_Stoltenberg-Andre_Agassi,2,S-XC,9,2,2,0,0,5,4
19940731-M-Canada_Masters-F-Jason_Stoltenberg-Andre_Agassi,2,S-DTM,5,1,0,0,1,0,5
19940731-M-Canada_Masters-F-Jason_Stoltenberg-Andre_Agassi,2,S-DTL,1,0,0,0,0,0,1
19930321-M-Miami_Masters-F-Pete_Sampras-Malivai_Washington,1,F-XC,23,14,4,5,5,15,8
19930321-M-Miami_Masters-F-Pete_Sampras-Malivai_Washington,1,F-DTM,11,1,0,0,1,6,5
19930321-M-Miami_Masters-F-Pete_Sampras-Malivai_Washington,1,F-DTL,8,5,2,1,2,4,4
19930321-M-Miami_Masters-F-Pete_Sampras-Malivai_Washington,1,F-IO,22,5,0,1,4,13,9
19930321-M-Miami_Masters-F-Pete_Sampras-Malivai_Washington,1,F-II,4,2,0,0,2,2,2
19930321-M-Miami_Masters-F-Pete_Sampras-Malivai_Washington,1,B-XC,16,4,2,0,2,9,7
19930321-M-Miami_Masters-F-Pete_Sampras-Malivai_Washington,1,B-DTM,5,0,0,0,0,4,1
19930321-M-Miami_Masters-F-Pete_Sampras-Malivai_Washington,1,B-DTL,2,2,1,0,1,1,1
19930321-M-Miami_Masters-F-Pete_Sampras-Malivai_Washington,1,B-IO,1,1,0,0,1,0,1
19930321-M-Miami_Masters-F-Pete_Sampras-Malivai_Washington,1,S-XC,1,0,0,0,0,1,0
19930321-M-Miami_Masters-F-Pete_Sampras-Malivai_Washington,1,S-DTM,1,0,0,0,0,0,1
19930321-M-Miami_Masters-F-Pete_Sampras-Malivai_Washington,1,S-DTL,1,0,0,0,0,0,1
19930321-M-Miami_Masters-F-Pete_Sampras-Malivai_Washington,2,F-XC,20,10,1,5,4,11,9
19930321-M-Miami_Masters-F-Pete_Sampras-Malivai_Washington,2,F-DTM,9,0,0,0,0,5,4
19930321-M-Miami_Masters-F-Pete_Sampras-Malivai_Washington,2,F-DTL,3,2,2,0,0,2,1
19930321-M-Miami_Masters-F-Pete_Sampras-Malivai_Washington,2,F-IO,6,1,0,0,1,0,6
19930321-M-Miami_Masters-F-Pete_Sampras-Malivai_Washington,2,F-II,1,1,0,0,1,0,1
19930321-M-Miami_Masters-F-Pete_Sampras-Malivai_Washington,2,B-XC,12,1,0,0,1,4,8
19930321-M-Miami_Masters-F-Pete_Sampras-Malivai_Washington,2,B-DTM,10,0,0,0,0,4,6
19930321-M-Miami_Masters-F-Pete_Sampras-Malivai_Washington,2,B-DTL,2,0,0,0,0,1,1
19930321-M-Miami_Masters-F-Pete_Sampras-Malivai_Washington,2,B-IO,3,2,0,0,2,0,3
19930321-M-Miami_Masters-F-Pete_Sampras-Malivai_Washington,2,S-XC,13,3,0,0,3,4,9
19930321-M-Miami_Masters-F-Pete_Sampras-Malivai_Washington,2,S-DTM,8,1,0,0,1,2,6
19930321-M-Miami_Masters-F-Pete_Sampras-Malivai_Washington,2,S-DTL,7,0,0,0,0,0,7
19930321-M-Miami_Masters-F-Pete_Sampras-Malivai_Washington,2,S-IO,1,0,0,0,0,0,1
19941106-M-Paris_Masters-F-Andre_Agassi-Marc_Rosset,1,F-XC,64,16,6,8,2,44,20
19941106-M-Paris_Masters-F-Andre_Agassi-Marc_Rosset,1,F-DTM,22,0,0,0,0,11,11
19941106-M-Paris_Masters-F-Andre_Agassi-Marc_Rosset,1,F-DTL,25,7,2,3,2,18,7
19941106-M-Paris_Masters-F-Andre_Agassi-Marc_Rosset,1,F-IO,23,5,2,2,1,13,10
19941106-M-Paris_Masters-F-Andre_Agassi-Marc_Rosset,1,F-II,7,3,0,1,2,4,3
19941106-M-Paris_Masters-F-Andre_Agassi-Marc_Rosset,1,B-XC,95,13,2,3,8,57,38
19941106-M-Paris_Masters-F-Andre_Agassi-Marc_Rosset,1,B-DTM,36,2,0,1,1,17,19
19941106-M-Paris_Masters-F-Andre_Agassi-Marc_Rosset,1,B-DTL,21,5,1,1,3,12,9
19941106-M-Paris_Masters-F-Andre_Agassi-Marc_Rosset,1,B-IO,8,2,0,2,0,4,4
19941106-M-Paris_Masters-F-Andre_Agassi-Marc_Rosset,1,S-XC,6,0,0,0,0,4,2
19941106-M-Paris_Masters-F-Andre_Agassi-Marc_Rosset,1,S-DTM,3,0,0,0,0,0,3
19941106-M-Paris_Masters-F-Andre_Agassi-Marc_Rosset,1,S-IO,1,1,0,0,1,0,1
19941106-M-Paris_Masters-F-Andre_Agassi-Marc_Rosset,2,F-XC,69,25,10,5,10,32,37
19941106-M-Paris_Masters-F-Andre_Agassi-Marc_Rosset,2,F-DTM,43,1,0,0,1,16,27
19941106-M-Paris_Masters-F-Andre_Agassi-Marc_Rosset,2,F-DTL,14,4,2,2,0,9,5
19941106-M-Paris_Masters-F-Andre_Agassi-Marc_Rosset,2,F-IO,29,12,2,3,7,14,15
19941106-M-Paris_Masters-F-Andre_Agassi-Marc_Rosset,2,F-II,14,7,3,1,3,8,6
19941106-M-Paris_Masters-F-Andre_Agassi-Marc_Rosset,2,B-XC,43,4,0,1,3,14,29
19941106-M-Paris_Masters-F-Andre_Agassi-Marc_Rosset,2,B-DTM,22,2,0,0,2,8,14
19941106-M-Paris_Masters-F-Andre_Agassi-Marc_Rosset,2,B-DTL,7,2,1,1,0,6,1
19941106-M-Paris_Masters-F-Andre_Agassi-Marc_Rosset,2,B-IO,2,1,0,0,1,1,1
19941106-M-Paris_Masters-F-Andre_Agassi-Marc_Rosset,2,S-XC,32,4,0,1,3,12,20
19941106-M-Paris_Masters-F-Andre_Agassi-Marc_Rosset,2,S-DTM,25,2,0,0,2,11,14
19941106-M-Paris_Masters-F-Andre_Agassi-Marc_Rosset,2,S-DTL,3,1,0,0,1,2,1
20170430-M-Budapest-F-Lucas_Pouille-Aljaz_Bedene,1,F-XC,27,9,4,1,4,16,11
20170430-M-Budapest-F-Lucas_Pouille-Aljaz_Bedene,1,F-DTM,8,1,0,0,1,4,4
20170430-M-Budapest-F-Lucas_Pouille-Aljaz_Bedene,1,F-DTL,10,4,0,1,3,3,7
20170430-M-Budapest-F-Lucas_Pouille-Aljaz_Bedene,1,F-IO,17,4,2,1,1,9,8
20170430-M-Budapest-F-Lucas_Pouille-Aljaz_Bedene,1,F-II,2,1,0,1,0,2,0
20170430-M-Budapest-F-Lucas_Pouille-Aljaz_Bedene,1,B-XC,27,2,1,1,0,13,14
20170430-M-Budapest-F-Lucas_Pouille-Aljaz_Bedene,1,B-DTM,18,0,0,0,0,9,9
20170430-M-Budapest-F-Lucas_Pouille-Aljaz_Bedene,1,B-DTL,7,3,2,0,1,3,4
20170430-M-Budapest-F-Lucas_Pouille-Aljaz_Bedene,1,B-IO,4,1,0,0,1,2,2
20170430-M-Budapest-F-Lucas_Pouille-Aljaz_Bedene,1,S-XC,4,0,0,0,0,1,3
20170430-M-Budapest-F-Lucas_Pouille-Aljaz_Bedene,1,S-DTM,6,2,0,1,1,2,4
20170430-M-Budapest-F-Lucas_Pouille-Aljaz_Bedene,1,S-DTL,1,0,0,0,0,0,1
20170430-M-Budapest-F-Lucas_Pouille-Aljaz_Bedene,2,F-XC,31,7,1,1,5,13,18
20170430-M-Budapest-F-Lucas_Pouille-Aljaz_Bedene,2,F-DTM,18,2,1,0,1,7,11
20170430-M-Budapest-F-Lucas_Pouille-Aljaz_Bedene,2,F-DTL,6,1,0,1,0,5,1
20170430-M-Budapest-F-Lucas_Pouille-Aljaz_Bedene,2,F-IO,25,6,3,0,3,13,12
20170430-M-Budapest-F-Lucas_Pouille-Aljaz_Bedene,2,F-II,2,1,1,0,0,1,1
20170430-M-Budapest-F-Lucas_Pouille-Aljaz_Bedene,2,B-XC,24,1,0,0,1,12,12
20170430-M-Budapest-F-Lucas_Pouille-Aljaz_Bedene,2,B-DTM,21,3,0,0,3,10,11
20170430-M-Budapest-F-Lucas_Pouille-Aljaz_Bedene,2,B-DTL,1,0,0,0,0,1,0
20170430-M-Budapest-F-Lucas_Pouille-Aljaz_Bedene,2,B-IO,2,1,0,0,1,1,1
20170430-M-Budapest-F-Lucas_Pouille-Aljaz_Bedene,2,S-XC,3,1,0,1,0,1,2
20170430-M-Budapest-F-Lucas_Pouille-Aljaz_Bedene,2,S-DTM,2,1,0,0,1,0,2
20170430-M-Budapest-F-Lucas_Pouille-Aljaz_Bedene,2,S-DTL,2,0,0,0,0,2,0
20170430-M-Budapest-F-Lucas_Pouille-Aljaz_Bedene,2,S-IO,1,1,0,1,0,1,0
19940515-M-Rome_Masters-F-Pete_Sampras-Boris_Becker,1,F-XC,29,12,5,4,3,20,9
19940515-M-Rome_Masters-F-Pete_Sampras-Boris_Becker,1,F-DTM,3,0,0,0,0,1,2
19940515-M-Rome_Masters-F-Pete_Sampras-Boris_Becker,1,F-DTL,13,4,3,0,1,9,4
19940515-M-Rome_Masters-F-Pete_Sampras-Boris_Becker,1,F-IO,29,6,2,1,3,15,14
19940515-M-Rome_Masters-F-Pete_Sampras-Boris_Becker,1,F-II,5,4,1,0,3,1,4
19940515-M-Rome_Masters-F-Pete_Sampras-Boris_Becker,1,B-XC,27,3,0,0,3,14,13
19940515-M-Rome_Masters-F-Pete_Sampras-Boris_Becker,1,B-DTM,8,0,0,0,0,5,3
19940515-M-Rome_Masters-F-Pete_Sampras-Boris_Becker,1,B-DTL,10,7,6,0,1,7,3
19940515-M-Rome_Masters-F-Pete_Sampras-Boris_Becker,1,S-XC,8,2,1,0,1,6,2
19940515-M-Rome_Masters-F-Pete_Sampras-Boris_Becker,1,S-DTL,5,1,0,0,1,2,3
19940515-M-Rome_Masters-F-Pete_Sampras-Boris_Becker,1,S-IO,1,0,0,0,0,1,0
19940515-M-Rome_Masters-F-Pete_Sampras-Boris_Becker,2,F-XC,19,8,2,3,3,9,10
19940515-M-Rome_Masters-F-Pete_Sampras-Boris_Becker,2,F-DTM,6,1,0,0,1,1,5
19940515-M-Rome_Masters-F-Pete_Sampras-Boris_Becker,2,F-DTL,6,2,0,0,2,3,3
19940515-M-Rome_Masters-F-Pete_Sampras-Boris_Becker,2,F-IO,13,7,1,4,2,8,5
19940515-M-Rome_Masters-F-Pete_Sampras-Boris_Becker,2,F-II,2,0,0,0,0,0,2
19940515-M-Rome_Masters-F-Pete_Sampras-Boris_Becker,2,B-XC,18,9,0,3,6,8,10
19940515-M-Rome_Masters-F-Pete_Sampras-Boris_Becker,2,B-DTM,11,3,0,0,3,7,4
19940515-M-Rome_Masters-F-Pete_Sampras-Boris_Becker,2,B-DTL,13,5,1,1,3,6,7
19940515-M-Rome_Masters-F-Pete_Sampras-Boris_Becker,2,B-IO,2,1,0,0,1,1,1
19940515-M-Rome_Masters-F-Pete_Sampras-Boris_Becker,2,S-XC,28,1,0,0,1,7,21
19940515-M-Rome_Masters-F-Pete_Sampras-Boris_Becker,2,S-DTM,1,0,0,0,0,0,1
19940515-M-Rome_Masters-F-Pete_Sampras-Boris_Becker,2,S-DTL,4,1,0,0,1,2,2
20030511-M-Rome_Masters-F-Felix_Mantilla-Roger_Federer,1,F-XC,45,8,1,4,3,25,20
20030511-M-Rome_Masters-F-Felix_Mantilla-Roger_Federer,1,F-DTM,51,3,0,1,2,30,21
20030511-M-Rome_Masters-F-Felix_Mantilla-Roger_Federer,1,F-DTL,17,5,2,0,3,6,11
20030511-M-Rome_Masters-F-Felix_Mantilla-Roger_Federer,1,F-IO,63,7,1,3,3,41,22
20030511-M-Rome_Masters-F-Felix_Mantilla-Roger_Federer,1,F-II,7,2,0,1,1,4,3
20030511-M-Rome_Masters-F-Felix_Mantilla-Roger_Federer,1,B-XC,82,5,0,1,4,37,45
20030511-M-Rome_Masters-F-Felix_Mantilla-Roger_Federer,1,B-DTM,51,6,0,0,6,20,31
20030511-M-Rome_Masters-F-Felix_Mantilla-Roger_Federer,1,B-DTL,18,8,2,2,4,9,9
20030511-M-Rome_Masters-F-Felix_Mantilla-Roger_Federer,1,B-IO,2,0,0,0,0,1,1
20030511-M-Rome_Masters-F-Felix_Mantilla-Roger_Federer,1,S-XC,20,3,0,2,1,11,9
20030511-M-Rome_Masters-F-Felix_Mantilla-Roger_Federer,1,S-DTM,11,0,0,0,0,6,5
20030511-M-Rome_Masters-F-Felix_Mantilla-Roger_Federer,1,S-DTL,5,0,0,0,0,0,5
20030511-M-Rome_Masters-F-Felix_Mantilla-Roger_Federer,2,F-XC,75,24,7,8,9,43,32
20030511-M-Rome_Masters-F-Felix_Mantilla-Roger_Federer,2,F-DTM,23,3,0,0,3,10,13
20030511-M-Rome_Masters-F-Felix_Mantilla-Roger_Federer,2,F-DTL,22,7,2,2,3,11,11
20030511-M-Rome_Masters-F-Felix_Mantilla-Roger_Federer,2,F-IO,60,17,6,3,8,34,26
20030511-M-Rome_Masters-F-Felix_Mantilla-Roger_Federer,2,F-II,23,14,2,4,8,9,14
20030511-M-Rome_Masters-F-Felix_Mantilla-Roger_Federer,2,B-XC,48,7,1,1,5,26,22
20030511-M-Rome_Masters-F-Felix_Mantilla-Roger_Federer,2,B-DTM,40,7,0,0,7,16,24
20030511-M-Rome_Masters-F-Felix_Mantilla-Roger_Federer,2,B-DTL,21,8,3,1,4,9,12
20030511-M-Rome_Masters-F-Felix_Mantilla-Roger_Federer,2,B-IO,6,3,1,0,2,1,5
20030511-M-Rome_Masters-F-Felix_Mantilla-Roger_Federer,2,S-XC,30,6,1,1,4,12,18
20030511-M-Rome_Masters-F-Felix_Mantilla-Roger_Federer,2,S-DTM,13,2,0,0,2,3,10
20030511-M-Rome_Masters-F-Felix_Mantilla-Roger_Federer,2,S-DTL,5,1,1,0,0,5,0
20030511-M-Rome_Masters-F-Felix_Mantilla-Roger_Federer,2,S-IO,2,2,0,0,2,0,2
19941030-M-Stockholm-F-Boris_Becker-Goran_Ivanisevic,1,F-XC,12,5,3,2,0,8,4
19941030-M-Stockholm-F-Boris_Becker-Goran_Ivanisevic,1,F-DTM,4,1,0,1,0,2,2
19941030-M-Stockholm-F-Boris_Becker-Goran_Ivanisevic,1,F-IO,7,7,4,3,0,7,0
19941030-M-Stockholm-F-Boris_Becker-Goran_Ivanisevic,1,B-XC,5,4,2,0,2,3,2
19941030-M-Stockholm-F-Boris_Becker-Goran_Ivanisevic,1,B-DTM,7,2,0,0,2,2,5
19941030-M-Stockholm-F-Boris_Becker-Goran_Ivanisevic,1,B-DTL,3,2,1,1,0,2,1
19941030-M-Stockholm-F-Boris_Becker-Goran_Ivanisevic,1,S-XC,5,1,0,1,0,3,2
19941030-M-Stockholm-F-Boris_Becker-Goran_Ivanisevic,1,S-DTL,2,0,0,0,0,0,2
19941030-M-Stockholm-F-Boris_Becker-Goran_Ivanisevic,1,S-IO,1,0,0,0,0,1,0
19941030-M-Stockholm-F-Boris_Becker-Goran_Ivanisevic,2,F-XC,7,5,1,1,3,3,4
19941030-M-Stockholm-F-Boris_Becker-Goran_Ivanisevic,2,F-DTM,8,3,0,0,3,2,6
19941030-M-Stockholm-F-Boris_Becker-Goran_Ivanisevic,2,F-DTL,2,1,0,0,1,0,2
19941030-M-Stockholm-F-Boris_Becker-Goran_Ivanisevic,2,F-IO,2,1,0,0,1,0,2
19941030-M-Stockholm-F-Boris_Becker-Goran_Ivanisevic,2,F-II,1,1,0,1,0,1,0
19941030-M-Stockholm-F-Boris_Becker-Goran_Ivanisevic,2,B-XC,5,3,2,1,0,3,2
19941030-M-Stockholm-F-Boris_Becker-Goran_Ivanisevic,2,B-DTM,5,0,0,0,0,1,4
19941030-M-Stockholm-F-Boris_Becker-Goran_Ivanisevic,2,B-DTL,4,2,1,0,1,1,3
19941030-M-Stockholm-F-Boris_Becker-Goran_Ivanisevic,2,B-IO,3,2,1,0,1,2,1
19941030-M-Stockholm-F-Boris_Becker-Goran_Ivanisevic,2,S-XC,3,0,0,0,0,0,3
19941030-M-Stockholm-F-Boris_Becker-Goran_Ivanisevic,2,S-DTM,3,0,0,0,0,0,3
19941030-M-Stockholm-F-Boris_Becker-Goran_Ivanisevic,2,S-DTL,3,0,0,0,0,0,3
19941030-M-Stockholm-F-Boris_Becker-Goran_Ivanisevic,2,S-IO,1,0,0,0,0,1,0
20070812-M-Canada_Masters-F-Novak_Djokovic-Roger_Federer,1,F-XC,39,12,3,4,5,21,18
20070812-M-Canada_Masters-F-Novak_Djokovic-Roger_Federer,1,F-DTM,36,3,0,0,3,15,21
20070812-M-Canada_Masters-F-Novak_Djokovic-Roger_Federer,1,F-DTL,5,2,2,0,0,3,2
20070812-M-Canada_Masters-F-Novak_Djokovic-Roger_Federer,1,F-IO,30,7,4,1,2,21,9
20070812-M-Canada_Masters-F-Novak_Djokovic-Roger_Federer,1,F-II,4,2,2,0,0,4,0
20070812-M-Canada_Masters-F-Novak_Djokovic-Roger_Federer,1,B-XC,50,6,0,3,3,28,22
20070812-M-Canada_Masters-F-Novak_Djokovic-Roger_Federer,1,B-DTM,53,6,0,1,5,30,23
20070812-M-Canada_Masters-F-Novak_Djokovic-Roger_Federer,1,B-DTL,7,3,2,1,0,5,2
20070812-M-Canada_Masters-F-Novak_Djokovic-Roger_Federer,1,B-IO,6,1,0,1,0,4,2
20070812-M-Canada_Masters-F-Novak_Djokovic-Roger_Federer,1,S-XC,3,0,0,0,0,1,2
20070812-M-Canada_Masters-F-Novak_Djokovic-Roger_Federer,1,S-DTM,8,0,0,0,0,2,6
20070812-M-Canada_Masters-F-Novak_Djokovic-Roger_Federer,1,S-DTL,1,1,0,1,0,1,0
20070812-M-Canada_Masters-F-Novak_Djokovic-Roger_Federer,1,S-IO,1,0,0,0,0,1,0
20070812-M-Canada_Masters-F-Novak_Djokovic-Roger_Federer,2,F-XC,49,15,5,4,6,28,21
20070812-M-Canada_Masters-F-Novak_Djokovic-Roger_Federer,2,F-DTM,44,7,2,0,5,19,25
20070812-M-Canada_Masters-F-Novak_Djokovic-Roger_Federer,2,F-DTL,8,5,2,0,3,5,3
20070812-M-Canada_Masters-F-Novak_Djokovic-Roger_Federer,2,F-IO,22,6,4,1,1,14,8
20070812-M-Canada_Masters-F-Novak_Djokovic-Roger_Federer,2,F-II,3,2,1,0,1,2,1
20070812-M-Canada_Masters-F-Novak_Djokovic-Roger_Federer,2,B-XC,35,11,0,1,10,14,21
20070812-M-Canada_Masters-F-Novak_Djokovic-Roger_Federer,2,B-DTM,46,3,1,1,1,16,30
20070812-M-Canada_Masters-F-Novak_Djokovic-Roger_Federer,2,B-DTL,7,6,1,0,5,2,5
20070812-M-Canada_Masters-F-Novak_Djokovic-Roger_Federer,2,B-IO,2,1,0,0,1,0,2
20070812-M-Canada_Masters-F-Novak_Djokovic-Roger_Federer,2,S-XC,12,2,0,1,1,6,6
20070812-M-Canada_Masters-F-Novak_Djokovic-Roger_Federer,2,S-DTM,25,1,0,0,1,7,18
20070812-M-Canada_Masters-F-Novak_Djokovic-Roger_Federer,2,S-DTL,2,0,0,0,0,2,0
20090816-M-Cincinnati_Masters-F-Roger_Federer-Novak_Djokovic,1,F-XC,39,13,4,4,5,26,13
20090816-M-Cincinnati_Masters-F-Roger_Federer-Novak_Djokovic,1,F-DTM,37,3,0,2,1,24,13
20090816-M-Cincinnati_Masters-F-Roger_Federer-Novak_Djokovic,1,F-DTL,5,1,1,0,0,3,2
20090816-M-Cincinnati_Masters-F-Roger_Federer-Novak_Djokovic,1,F-IO,16,6,4,1,1,9,7
20090816-M-Cincinnati_Masters-F-Roger_Federer-Novak_Djokovic,1,F-II,5,2,0,1,1,3,2
20090816-M-Cincinnati_Masters-F-Roger_Federer-Novak_Djokovic,1,B-XC,20,2,0,0,2,11,9
20090816-M-Cincinnati_Masters-F-Roger_Federer-Novak_Djokovic,1,B-DTM,24,4,0,0,4,10,14
20090816-M-Cincinnati_Masters-F-Roger_Federer-Novak_Djokovic,1,B-DTL,2,1,0,0,1,1,1
20090816-M-Cincinnati_Masters-F-Roger_Federer-Novak_Djokovic,1,B-IO,4,3,2,1,0,3,1
20090816-M-Cincinnati_Masters-F-Roger_Federer-Novak_Djokovic,1,S-XC,21,1,0,0,1,13,8
20090816-M-Cincinnati_Masters-F-Roger_Federer-Novak_Djokovic,1,S-DTM,4,1,0,0,1,3,1
20090816-M-Cincinnati_Masters-F-Roger_Federer-Novak_Djokovic,1,S-DTL,1,0,0,0,0,1,0
20090816-M-Cincinnati_Masters-F-Roger_Federer-Novak_Djokovic,1,S-IO,1,0,0,0,0,0,1
20090816-M-Cincinnati_Masters-F-Roger_Federer-Novak_Djokovic,2,F-XC,38,7,3,1,3,15,23
20090816-M-Cincinnati_Masters-F-Roger_Federer-Novak_Djokovic,2,F-DTM,25,3,0,0,3,5,20
20090816-M-Cincinnati_Masters-F-Roger_Federer-Novak_Djokovic,2,F-DTL,4,3,2,0,1,2,2
20090816-M-Cincinnati_Masters-F-Roger_Federer-Novak_Djokovic,2,F-IO,11,2,0,1,1,5,6
20090816-M-Cincinnati_Masters-F-Roger_Federer-Novak_Djokovic,2,F-II,6,1,0,0,1,2,4
20090816-M-Cincinnati_Masters-F-Roger_Federer-Novak_Djokovic,2,B-XC,40,5,0,2,3,19,21
20090816-M-Cincinnati_Masters-F-Roger_Federer-Novak_Djokovic,2,B-DTM,35,4,0,0,4,14,21
20090816-M-Cincinnati_Masters-F-Roger_Federer-Novak_Djokovic,2,B-DTL,11,6,1,3,2,5,6
20090816-M-Cincinnati_Masters-F-Roger_Federer-Novak_Djokovic,2,B-IO,6,3,0,1,2,2,4
20090816-M-Cincinnati_Masters-F-Roger_Federer-Novak_Djokovic,2,S-XC,5,0,0,0,0,2,3
20090816-M-Cincinnati_Masters-F-Roger_Federer-Novak_Djokovic,2,S-DTM,7,1,0,0,1,4,3
20090816-M-Cincinnati_Masters-F-Roger_Federer-Novak_Djokovic,2,S-DTL,2,0,0,0,0,1,1
20100509-M-Madrid_Masters-F-Roger_Federer-Rafael_Nadal,1,F-XC,59,11,4,3,4,35,24
20100509-M-Madrid_Masters-F-Roger_Federer-Rafael_Nadal,1,F-DTM,37,9,1,0,8,17,20
20100509-M-Madrid_Masters-F-Roger_Federer-Rafael_Nadal,1,F-DTL,1,0,0,0,0,0,1
20100509-M-Madrid_Masters-F-Roger_Federer-Rafael_Nadal,1,F-IO,23,10,5,3,2,14,9
20100509-M-Madrid_Masters-F-Roger_Federer-Rafael_Nadal,1,F-II,4,3,1,0,2,2,2
20100509-M-Madrid_Masters-F-Roger_Federer-Rafael_Nadal,1,B-XC,39,10,3,3,4,21,18
20100509-M-Madrid_Masters-F-Roger_Federer-Rafael_Nadal,1,B-DTM,37,5,0,0,5,14,23
20100509-M-Madrid_Masters-F-Roger_Federer-Rafael_Nadal,1,B-DTL,17,6,2,1,3,9,8
20100509-M-Madrid_Masters-F-Roger_Federer-Rafael_Nadal,1,B-IO,5,2,0,1,1,3,2
20100509-M-Madrid_Masters-F-Roger_Federer-Rafael_Nadal,1,S-XC,4,0,0,0,0,1,3
20100509-M-Madrid_Masters-F-Roger_Federer-Rafael_Nadal,1,S-DTM,7,0,0,0,0,5,2
20100509-M-Madrid_Masters-F-Roger_Federer-Rafael_Nadal,1,S-DTL,3,1,0,0,1,0,3
20100509-M-Madrid_Masters-F-Roger_Federer-Rafael_Nadal,2,F-XC,89,11,2,2,7,47,42
20100509-M-Madrid_Masters-F-Roger_Federer-Rafael_Nadal,2,F-DTM,22,2,0,1,1,9,13
20100509-M-Madrid_Masters-F-Roger_Federer-Rafael_Nadal,2,F-DTL,7,3,2,0,1,3,4
20100509-M-Madrid_Masters-F-Roger_Federer-Rafael_Nadal,2,F-IO,18,8,5,1,2,11,7
20100509-M-Madrid_Masters-F-Roger_Federer-Rafael_Nadal,2,F-II,7,2,1,0,1,3,4
20100509-M-Madrid_Masters-F-Roger_Federer-Rafael_Nadal,2,B-XC,30,16,6,3,7,15,15
20100509-M-Madrid_Masters-F-Roger_Federer-Rafael_Nadal,2,B-DTM,44,4,0,1,3,17,27
20100509-M-Madrid_Masters-F-Roger_Federer-Rafael_Nadal,2,B-DTL,17,3,1,0,2,7,10
20100509-M-Madrid_Masters-F-Roger_Federer-Rafael_Nadal,2,B-IO,4,2,0,1,1,2,2
20100509-M-Madrid_Masters-F-Roger_Federer-Rafael_Nadal,2,S-DTM,2,0,0,0,0,0,2
20120512-M-Madrid_Masters-F-Tomas_Berdych-Roger_Federer,1,F-XC,27,13,7,2,4,14,13
20120512-M-Madrid_Masters-F-Tomas_Berdych-Roger_Federer,1,F-DTM,29,6,1,3,2,18,11
20120512-M-Madrid_Masters-F-Tomas_Berdych-Roger_Federer,1,F-DTL,8,3,1,1,1,4,4
20120512-M-Madrid_Masters-F-Tomas_Berdych-Roger_Federer,1,F-IO,33,11,8,0,3,24,9
20120512-M-Madrid_Masters-F-Tomas_Berdych-Roger_Federer,1,F-II,1,1,0,1,0,1,0
20120512-M-Madrid_Masters-F-Tomas_Berdych-Roger_Federer,1,B-XC,25,4,1,2,1,16,9
20120512-M-Madrid_Masters-F-Tomas_Berdych-Roger_Federer,1,B-DTM,31,2,1,1,0,16,15
20120512-M-Madrid_Masters-F-Tomas_Berdych-Roger_Federer,1,B-DTL,7,4,2,0,2,2,5
20120512-M-Madrid_Masters-F-Tomas_Berdych-Roger_Federer,1,B-IO,5,2,0,1,1,2,3
20120512-M-Madrid_Masters-F-Tomas_Berdych-Roger_Federer,1,S-XC,2,0,0,0,0,1,1
20120512-M-Madrid_Masters-F-Tomas_Berdych-Roger_Federer,1,S-DTM,5,1,0,0,1,3,2
20120512-M-Madrid_Masters-F-Tomas_Berdych-Roger_Federer,2,F-XC,38,14,5,7,2,26,12
20120512-M-Madrid_Masters-F-Tomas_Berdych-Roger_Federer,2,F-DTM,39,8,2,1,5,13,26
20120512-M-Madrid_Masters-F-Tomas_Berdych-Roger_Federer,2,F-DTL,5,2,2,0,0,4,1
20120512-M-Madrid_Masters-F-Tomas_Berdych-Roger_Federer,2,F-IO,13,7,4,1,2,8,5
20120512-M-Madrid_Masters-F-Tomas_Berdych-Roger_Federer,2,B-XC,23,5,3,1,1,13,10
20120512-M-Madrid_Masters-F-Tomas_Berdych-Roger_Federer,2,B-DTM,28,5,0,0,5,5,23
20120512-M-Madrid_Masters-F-Tomas_Berdych-Roger_Federer,2,B-DTL,8,4,2,2,0,5,3
20120512-M-Madrid_Masters-F-Tomas_Berdych-Roger_Federer,2,B-IO,2,1,0,0,1,1,1
20120512-M-Madrid_Masters-F-Tomas_Berdych-Roger_Federer,2,S-XC,6,0,0,0,0,0,6
20120512-M-Madrid_Masters-F-Tomas_Berdych-Roger_Federer,2,S-DTM,9,0,0,0,0,3,6
20120512-M-Madrid_Masters-F-Tomas_Berdych-Roger_Federer,2,S-DTL,2,1,1,0,0,2,0
20120510-M-Madrid_Masters-R16-Roger_Federer-Richard_Gasquet,1,F-XC,12,8,3,2,3,7,5
20120510-M-Madrid_Masters-R16-Roger_Federer-Richard_Gasquet,1,F-DTM,6,1,1,0,0,3,3
20120510-M-Madrid_Masters-R16-Roger_Federer-Richard_Gasquet,1,F-DTL,4,1,0,0,1,1,3
20120510-M-Madrid_Masters-R16-Roger_Federer-Richard_Gasquet,1,F-IO,26,6,2,1,3,16,10
20120510-M-Madrid_Masters-R16-Roger_Federer-Richard_Gasquet,1,F-II,4,1,1,0,0,3,1
20120510-M-Madrid_Masters-R16-Roger_Federer-Richard_Gasquet,1,B-XC,15,4,1,1,2,6,9
20120510-M-Madrid_Masters-R16-Roger_Federer-Richard_Gasquet,1,B-DTM,6,1,0,1,0,3,3
20120510-M-Madrid_Masters-R16-Roger_Federer-Richard_Gasquet,1,B-DTL,8,4,1,1,2,4,4
20120510-M-Madrid_Masters-R16-Roger_Federer-Richard_Gasquet,1,B-IO,1,1,1,0,0,1,0
20120510-M-Madrid_Masters-R16-Roger_Federer-Richard_Gasquet,1,S-XC,1,0,0,0,0,1,0
20120510-M-Madrid_Masters-R16-Roger_Federer-Richard_Gasquet,2,F-XC,7,2,1,0,1,4,3
20120510-M-Madrid_Masters-R16-Roger_Federer-Richard_Gasquet,2,F-DTM,7,0,0,0,0,2,5
20120510-M-Madrid_Masters-R16-Roger_Federer-Richard_Gasquet,2,F-DTL,4,2,0,1,1,3,1
20120510-M-Madrid_Masters-R16-Roger_Federer-Richard_Gasquet,2,F-IO,5,1,1,0,0,3,2
20120510-M-Madrid_Masters-R16-Roger_Federer-Richard_Gasquet,2,B-XC,21,5,0,1,4,12,9
20120510-M-Madrid_Masters-R16-Roger_Federer-Richard_Gasquet,2,B-DTM,16,0,0,0,0,6,10
20120510-M-Madrid_Masters-R16-Roger_Federer-Richard_Gasquet,2,B-DTL,5,2,1,0,1,3,2
20120510-M-Madrid_Masters-R16-Roger_Federer-Richard_Gasquet,2,B-IO,1,1,1,0,0,1,0
20120510-M-Madrid_Masters-R16-Roger_Federer-Richard_Gasquet,2,S-XC,5,0,0,0,0,1,4
20120510-M-Madrid_Masters-R16-Roger_Federer-Richard_Gasquet,2,S-DTM,5,0,0,0,0,1,4
20130519-M-Rome_Masters-F-Roger_Federer-Rafael_Nadal,1,F-XC,34,6,0,3,3,17,17
20130519-M-Rome_Masters-F-Roger_Federer-Rafael_Nadal,1,F-DTM,21,5,0,0,5,5,16
20130519-M-Rome_Masters-F-Roger_Federer-Rafael_Nadal,1,F-DTL,3,1,0,0,1,0,3
20130519-M-Rome_Masters-F-Roger_Federer-Rafael_Nadal,1,F-IO,10,6,1,2,3,4,6
20130519-M-Rome_Masters-F-Roger_Federer-Rafael_Nadal,1,F-II,4,1,0,0,1,1,3
20130519-M-Rome_Masters-F-Roger_Federer-Rafael_Nadal,1,B-XC,11,7,1,1,5,4,7
20130519-M-Rome_Masters-F-Roger_Federer-Rafael_Nadal,1,B-DTM,20,3,0,0,3,6,14
20130519-M-Rome_Masters-F-Roger_Federer-Rafael_Nadal,1,B-DTL,8,5,1,0,4,2,6
20130519-M-Rome_Masters-F-Roger_Federer-Rafael_Nadal,1,B-IO,5,2,0,1,1,1,4
20130519-M-Rome_Masters-F-Roger_Federer-Rafael_Nadal,1,S-XC,5,0,0,0,0,1,4
20130519-M-Rome_Masters-F-Roger_Federer-Rafael_Nadal,1,S-DTM,1,0,0,0,0,0,1
20130519-M-Rome_Masters-F-Roger_Federer-Rafael_Nadal,1,S-DTL,3,0,0,0,0,0,3
20130519-M-Rome_Masters-F-Roger_Federer-Rafael_Nadal,2,F-XC,36,3,1,1,1,27,9
20130519-M-Rome_Masters-F-Roger_Federer-Rafael_Nadal,2,F-DTM,13,1,0,0,1,7,6
20130519-M-Rome_Masters-F-Roger_Federer-Rafael_Nadal,2,F-DTL,1,1,0,1,0,1,0
20130519-M-Rome_Masters-F-Roger_Federer-Rafael_Nadal,2,F-IO,9,3,1,1,1,5,4
20130519-M-Rome_Masters-F-Roger_Federer-Rafael_Nadal,2,F-II,1,1,1,0,0,1,0
20130519-M-Rome_Masters-F-Roger_Federer-Rafael_Nadal,2,B-XC,20,2,1,1,0,14,6
20130519-M-Rome_Masters-F-Roger_Federer-Rafael_Nadal,2,B-DTM,19,1,0,0,1,10,9
20130519-M-Rome_Masters-F-Roger_Federer-Rafael_Nadal,2,B-DTL,6,4,2,1,1,4,2
20130519-M-Rome_Masters-F-Roger_Federer-Rafael_Nadal,2,B-IO,3,1,0,1,0,3,0
20130519-M-Rome_Masters-F-Roger_Federer-Rafael_Nadal,2,S-XC,1,1,1,0,0,1,0
20130519-M-Rome_Masters-F-Roger_Federer-Rafael_Nadal,2,S-DTM,3,0,0,0,0,1,2
20130519-M-Rome_Masters-F-Roger_Federer-Rafael_Nadal,2,S-DTL,5,0,0,0,0,3,2
20150822-M-Cincinnati_Masters-QF-Roger_Federer-Feliciano_Lopez,1,F-XC,16,3,0,0,3,12,4
20150822-M-Cincinnati_Masters-QF-Roger_Federer-Feliciano_Lopez,1,F-DTM,14,2,0,0,2,11,3
20150822-M-Cincinnati_Masters-QF-Roger_Federer-Feliciano_Lopez,1,F-DTL,7,4,4,0,0,5,2
20150822-M-Cincinnati_Masters-QF-Roger_Federer-Feliciano_Lopez,1,F-IO,13,7,4,0,3,9,4
20150822-M-Cincinnati_Masters-QF-Roger_Federer-Feliciano_Lopez,1,F-II,8,2,0,2,0,7,1
20150822-M-Cincinnati_Masters-QF-Roger_Federer-Feliciano_Lopez,1,B-XC,9,5,2,1,2,5,4
20150822-M-Cincinnati_Masters-QF-Roger_Federer-Feliciano_Lopez,1,B-DTM,5,1,0,0,1,2,3
20150822-M-Cincinnati_Masters-QF-Roger_Federer-Feliciano_Lopez,1,B-DTL,2,1,0,1,0,1,1
20150822-M-Cincinnati_Masters-QF-Roger_Federer-Feliciano_Lopez,1,B-IO,1,0,0,0,0,1,0
20150822-M-Cincinnati_Masters-QF-Roger_Federer-Feliciano_Lopez,1,S-XC,2,0,0,0,0,2,0
20150822-M-Cincinnati_Masters-QF-Roger_Federer-Feliciano_Lopez,1,S-DTM,2,0,0,0,0,1,1
20150822-M-Cincinnati_Masters-QF-Roger_Federer-Feliciano_Lopez,1,S-DTL,4,0,0,0,0,3,1
20150822-M-Cincinnati_Masters-QF-Roger_Federer-Feliciano_Lopez,1,S-IO,2,0,0,0,0,2,0
20150822-M-Cincinnati_Masters-QF-Roger_Federer-Feliciano_Lopez,2,F-XC,21,4,2,1,1,8,13
20150822-M-Cincinnati_Masters-QF-Roger_Federer-Feliciano_Lopez,2,F-DTM,4,1,0,0,1,0,4
20150822-M-Cincinnati_Masters-QF-Roger_Federer-Feliciano_Lopez,2,F-DTL,4,1,0,0,1,0,4
20150822-M-Cincinnati_Masters-QF-Roger_Federer-Feliciano_Lopez,2,F-IO,7,4,0,1,3,1,6
20150822-M-Cincinnati_Masters-QF-Roger_Federer-Feliciano_Lopez,2,B-XC,9,3,1,0,2,2,7
20150822-M-Cincinnati_Masters-QF-Roger_Federer-Feliciano_Lopez,2,B-DTM,9,2,0,0,2,0,9
20150822-M-Cincinnati_Masters-QF-Roger_Federer-Feliciano_Lopez,2,B-DTL,1,1,1,0,0,1,0
20150822-M-Cincinnati_Masters-QF-Roger_Federer-Feliciano_Lopez,2,B-IO,1,0,0,0,0,1,0
20150822-M-Cincinnati_Masters-QF-Roger_Federer-Feliciano_Lopez,2,S-XC,6,1,0,0,1,2,4
20150822-M-Cincinnati_Masters-QF-Roger_Federer-Feliciano_Lopez,2,S-DTM,4,1,0,0,1,1,3
20150822-M-Cincinnati_Masters-QF-Roger_Federer-Feliciano_Lopez,2,S-DTL,7,1,0,0,1,3,4
20150822-M-Cincinnati_Masters-QF-Roger_Federer-Feliciano_Lopez,2,S-IO,3,0,0,0,0,1,2
20150822-M-Cincinnati_Masters-SF-Andy_Murray-Roger_Federer,1,F-XC,25,6,3,2,1,13,12
20150822-M-Cincinnati_Masters-SF-Andy_Murray-Roger_Federer,1,F-DTM,22,1,0,0,1,7,15
20150822-M-Cincinnati_Masters-SF-Andy_Murray-Roger_Federer,1,F-DTL,12,2,1,1,0,5,7
20150822-M-Cincinnati_Masters-SF-Andy_Murray-Roger_Federer,1,F-IO,23,3,1,0,2,13,10
20150822-M-Cincinnati_Masters-SF-Andy_Murray-Roger_Federer,1,F-II,2,0,0,0,0,1,1
20150822-M-Cincinnati_Masters-SF-Andy_Murray-Roger_Federer,1,B-XC,45,9,2,2,5,24,21
20150822-M-Cincinnati_Masters-SF-Andy_Murray-Roger_Federer,1,B-DTM,20,6,0,1,5,5,15
20150822-M-Cincinnati_Masters-SF-Andy_Murray-Roger_Federer,1,B-DTL,8,4,1,0,3,3,5
20150822-M-Cincinnati_Masters-SF-Andy_Murray-Roger_Federer,1,B-IO,2,2,1,0,1,1,1
20150822-M-Cincinnati_Masters-SF-Andy_Murray-Roger_Federer,1,S-XC,4,1,0,0,1,0,4
20150822-M-Cincinnati_Masters-SF-Andy_Murray-Roger_Federer,1,S-DTM,7,0,0,0,0,1,6
20150822-M-Cincinnati_Masters-SF-Andy_Murray-Roger_Federer,1,S-DTL,4,0,0,0,0,0,4
20150822-M-Cincinnati_Masters-SF-Andy_Murray-Roger_Federer,2,F-XC,24,7,4,2,1,18,6
20150822-M-Cincinnati_Masters-SF-Andy_Murray-Roger_Federer,2,F-DTM,11,1,1,0,0,8,3
20150822-M-Cincinnati_Masters-SF-Andy_Murray-Roger_Federer,2,F-DTL,8,2,0,1,1,3,5
20150822-M-Cincinnati_Masters-SF-Andy_Murray-Roger_Federer,2,F-IO,22,6,3,2,1,19,3
20150822-M-Cincinnati_Masters-SF-Andy_Murray-Roger_Federer,2,F-II,5,4,2,1,1,4,1
20150822-M-Cincinnati_Masters-SF-Andy_Murray-Roger_Federer,2,B-XC,23,4,0,0,4,13,10
20150822-M-Cincinnati_Masters-SF-Andy_Murray-Roger_Federer,2,B-DTM,29,3,0,0,3,9,20
20150822-M-Cincinnati_Masters-SF-Andy_Murray-Roger_Federer,2,B-DTL,6,4,3,0,1,4,2
20150822-M-Cincinnati_Masters-SF-Andy_Murray-Roger_Federer,2,B-IO,4,2,1,0,1,2,2
20150822-M-Cincinnati_Masters-SF-Andy_Murray-Roger_Federer,2,S-XC,13,1,0,0,1,7,6
20150822-M-Cincinnati_Masters-SF-Andy_Murray-Roger_Federer,2,S-DTM,11,0,0,0,0,6,5
20150822-M-Cincinnati_Masters-SF-Andy_Murray-Roger_Federer,2,S-DTL,2,0,0,0,0,1,1
20150823-M-Cincinnati_Masters-F-Novak_Djokovic-Roger_Federer,1,F-XC,39,9,4,4,1,22,17
20150823-M-Cincinnati_Masters-F-Novak_Djokovic-Roger_Federer,1,F-DTM,20,1,0,0,1,8,12
20150823-M-Cincinnati_Masters-F-Novak_Djokovic-Roger_Federer,1,F-DTL,11,6,2,1,3,6,5
20150823-M-Cincinnati_Masters-F-Novak_Djokovic-Roger_Federer,1,F-IO,14,3,1,0,2,9,5
20150823-M-Cincinnati_Masters-F-Novak_Djokovic-Roger_Federer,1,B-XC,41,2,1,1,0,30,11
20150823-M-Cincinnati_Masters-F-Novak_Djokovic-Roger_Federer,1,B-DTM,28,5,0,2,3,14,14
20150823-M-Cincinnati_Masters-F-Novak_Djokovic-Roger_Federer,1,B-DTL,12,6,2,1,3,7,5
20150823-M-Cincinnati_Masters-F-Novak_Djokovic-Roger_Federer,1,B-IO,9,5,1,2,2,4,5
20150823-M-Cincinnati_Masters-F-Novak_Djokovic-Roger_Federer,1,S-XC,4,0,0,0,0,1,3
20150823-M-Cincinnati_Masters-F-Novak_Djokovic-Roger_Federer,1,S-DTM,3,0,0,0,0,1,2
20150823-M-Cincinnati_Masters-F-Novak_Djokovic-Roger_Federer,2,F-XC,28,9,3,2,4,18,10
20150823-M-Cincinnati_Masters-F-Novak_Djokovic-Roger_Federer,2,F-DTM,23,1,0,0,1,13,10
20150823-M-Cincinnati_Masters-F-Novak_Djokovic-Roger_Federer,2,F-DTL,11,3,0,0,3,4,7
20150823-M-Cincinnati_Masters-F-Novak_Djokovic-Roger_Federer,2,F-IO,14,6,4,2,0,11,3
20150823-M-Cincinnati_Masters-F-Novak_Djokovic-Roger_Federer,2,F-II,1,0,0,0,0,1,0
20150823-M-Cincinnati_Masters-F-Novak_Djokovic-Roger_Federer,2,B-XC,24,3,1,1,1,9,15
20150823-M-Cincinnati_Masters-F-Novak_Djokovic-Roger_Federer,2,B-DTM,23,2,0,0,2,7,16
20150823-M-Cincinnati_Masters-F-Novak_Djokovic-Roger_Federer,2,B-DTL,6,3,1,1,1,4,2
20150823-M-Cincinnati_Masters-F-Novak_Djokovic-Roger_Federer,2,B-IO,3,1,0,1,0,1,2
20150823-M-Cincinnati_Masters-F-Novak_Djokovic-Roger_Federer,2,S-XC,18,2,0,0,2,4,14
20150823-M-Cincinnati_Masters-F-Novak_Djokovic-Roger_Federer,2,S-DTM,5,0,0,0,0,4,1
20150823-M-Cincinnati_Masters-F-Novak_Djokovic-Roger_Federer,2,S-DTL,3,0,0,0,0,0,3
20150823-M-Cincinnati_Masters-F-Novak_Djokovic-Roger_Federer,2,S-IO,1,0,0,0,0,0,1
20150318-M-Indian_Wells_Masters-R16-Roger_Federer-Jack_Sock,1,F-XC,23,11,2,4,5,15,8
20150318-M-Indian_Wells_Masters-R16-Roger_Federer-Jack_Sock,1,F-DTM,6,0,0,0,0,2,4
20150318-M-Indian_Wells_Masters-R16-Roger_Federer-Jack_Sock,1,F-DTL,5,1,0,1,0,4,1
20150318-M-Indian_Wells_Masters-R16-Roger_Federer-Jack_Sock,1,F-IO,14,8,5,0,3,9,5
20150318-M-Indian_Wells_Masters-R16-Roger_Federer-Jack_Sock,1,F-II,5,2,0,1,1,3,2
20150318-M-Indian_Wells_Masters-R16-Roger_Federer-Jack_Sock,1,B-XC,14,3,2,1,0,9,5
20150318-M-Indian_Wells_Masters-R16-Roger_Federer-Jack_Sock,1,B-DTM,10,2,0,0,2,3,7
20150318-M-Indian_Wells_Masters-R16-Roger_Federer-Jack_Sock,1,B-DTL,8,4,3,0,1,7,1
20150318-M-Indian_Wells_Masters-R16-Roger_Federer-Jack_Sock,1,B-IO,1,1,0,0,1,0,1
20150318-M-Indian_Wells_Masters-R16-Roger_Federer-Jack_Sock,1,S-XC,6,1,0,0,1,2,4
20150318-M-Indian_Wells_Masters-R16-Roger_Federer-Jack_Sock,1,S-DTM,2,0,0,0,0,1,1
20150318-M-Indian_Wells_Masters-R16-Roger_Federer-Jack_Sock,2,F-XC,15,3,1,0,2,6,9
20150318-M-Indian_Wells_Masters-R16-Roger_Federer-Jack_Sock,2,F-DTM,12,1,0,0,1,9,3
20150318-M-Indian_Wells_Masters-R16-Roger_Federer-Jack_Sock,2,F-DTL,6,1,0,0,1,0,6
20150318-M-Indian_Wells_Masters-R16-Roger_Federer-Jack_Sock,2,F-IO,37,11,3,3,5,20,17
20150318-M-Indian_Wells_Masters-R16-Roger_Federer-Jack_Sock,2,F-II,9,5,1,2,2,5,4
20150318-M-Indian_Wells_Masters-R16-Roger_Federer-Jack_Sock,2,B-XC,3,0,0,0,0,1,2
20150318-M-Indian_Wells_Masters-R16-Roger_Federer-Jack_Sock,2,B-DTM,3,0,0,0,0,1,2
20150318-M-Indian_Wells_Masters-R16-Roger_Federer-Jack_Sock,2,B-DTL,1,1,0,0,1,0,1
20150318-M-Indian_Wells_Masters-R16-Roger_Federer-Jack_Sock,2,S-XC,5,0,0,0,0,2,3
20150318-M-Indian_Wells_Masters-R16-Roger_Federer-Jack_Sock,2,S-DTM,4,1,0,0,1,1,3
20150318-M-Indian_Wells_Masters-R16-Roger_Federer-Jack_Sock,2,S-DTL,1,0,0,0,0,1,0
20150318-M-Indian_Wells_Masters-R16-Roger_Federer-Jack_Sock,2,S-IO,1,0,0,0,0,0,1
20151105-M-Paris_Masters-R16-John_Isner-Roger_Federer,1,F-XC,16,9,3,1,5,8,8
20151105-M-Paris_Masters-R16-John_Isner-Roger_Federer,1,F-DTM,19,6,1,0,5,7,12
20151105-M-Paris_Masters-R16-John_Isner-Roger_Federer,1,F-DTL,6,2,0,1,1,2,4
20151105-M-Paris_Masters-R16-John_Isner-Roger_Federer,1,F-IO,21,9,3,1,5,11,10
20151105-M-Paris_Masters-R16-John_Isner-Roger_Federer,1,F-II,8,5,2,0,3,4,4
20151105-M-Paris_Masters-R16-John_Isner-Roger_Federer,1,B-XC,16,4,1,2,1,7,9
20151105-M-Paris_Masters-R16-John_Isner-Roger_Federer,1,B-DTM,17,1,0,0,1,5,12
20151105-M-Paris_Masters-R16-John_Isner-Roger_Federer,1,B-DTL,4,2,1,0,1,1,3
20151105-M-Paris_Masters-R16-John_Isner-Roger_Federer,1,S-XC,17,1,0,0,1,8,9
20151105-M-Paris_Masters-R16-John_Isner-Roger_Federer,1,S-DTM,12,0,0,0,0,2,10
20151105-M-Paris_Masters-R16-John_Isner-Roger_Federer,1,S-DTL,1,0,0,0,0,0,1
20151105-M-Paris_Masters-R16-John_Isner-Roger_Federer,2,F-XC,29,13,6,5,2,20,9
20151105-M-Paris_Masters-R16-John_Isner-Roger_Federer,2,F-DTM,24,3,0,1,2,14,10
20151105-M-Paris_Masters-R16-John_Isner-Roger_Federer,2,F-DTL,6,1,0,1,0,3,3
20151105-M-Paris_Masters-R16-John_Isner-Roger_Federer,2,F-IO,34,10,4,4,2,26,8
20151105-M-Paris_Masters-R16-John_Isner-Roger_Federer,2,F-II,7,3,1,1,1,6,1
20151105-M-Paris_Masters-R16-John_Isner-Roger_Federer,2,B-XC,17,4,1,0,3,9,8
20151105-M-Paris_Masters-R16-John_Isner-Roger_Federer,2,B-DTM,17,4,1,0,3,6,11
20151105-M-Paris_Masters-R16-John_Isner-Roger_Federer,2,B-DTL,7,4,1,1,2,2,5
20151105-M-Paris_Masters-R16-John_Isner-Roger_Federer,2,S-XC,11,2,0,2,0,9,2
20151105-M-Paris_Masters-R16-John_Isner-Roger_Federer,2,S-DTM,4,1,0,0,1,1,3
20151105-M-Paris_Masters-R16-John_Isner-Roger_Federer,2,S-DTL,1,0,0,0,0,0,1
20151104-M-Paris_Masters-R32-Andreas_Seppi-Roger_Federer,1,F-XC,11,3,1,1,1,3,8
20151104-M-Paris_Masters-R32-Andreas_Seppi-Roger_Federer,1,F-DTM,9,0,0,0,0,1,8
20151104-M-Paris_Masters-R32-Andreas_Seppi-Roger_Federer,1,F-DTL,2,0,0,0,0,0,2
20151104-M-Paris_Masters-R32-Andreas_Seppi-Roger_Federer,1,F-IO,7,2,0,1,1,3,4
20151104-M-Paris_Masters-R32-Andreas_Seppi-Roger_Federer,1,F-II,2,2,1,0,1,1,1
20151104-M-Paris_Masters-R32-Andreas_Seppi-Roger_Federer,1,B-XC,19,4,1,0,3,5,14
20151104-M-Paris_Masters-R32-Andreas_Seppi-Roger_Federer,1,B-DTM,14,3,0,0,3,2,12
20151104-M-Paris_Masters-R32-Andreas_Seppi-Roger_Federer,1,B-DTL,1,0,0,0,0,0,1
20151104-M-Paris_Masters-R32-Andreas_Seppi-Roger_Federer,1,B-IO,1,0,0,0,0,0,1
20151104-M-Paris_Masters-R32-Andreas_Seppi-Roger_Federer,1,S-XC,5,0,0,0,0,1,4
20151104-M-Paris_Masters-R32-Andreas_Seppi-Roger_Federer,1,S-DTM,4,0,0,0,0,1,3
20151104-M-Paris_Masters-R32-Andreas_Seppi-Roger_Federer,1,S-DTL,2,1,0,0,1,0,2
20151104-M-Paris_Masters-R32-Andreas_Seppi-Roger_Federer,1,S-IO,1,0,0,0,0,0,1
20151104-M-Paris_Masters-R32-Andreas_Seppi-Roger_Federer,2,F-XC,12,6,4,2,0,11,1
20151104-M-Paris_Masters-R32-Andreas_Seppi-Roger_Federer,2,F-DTM,12,2,0,0,2,9,3
20151104-M-Paris_Masters-R32-Andreas_Seppi-Roger_Federer,2,F-DTL,4,1,1,0,0,4,0
20151104-M-Paris_Masters-R32-Andreas_Seppi-Roger_Federer,2,F-IO,14,4,3,0,1,10,4
20151104-M-Paris_Masters-R32-Andreas_Seppi-Roger_Federer,2,F-II,3,2,2,0,0,3,0
20151104-M-Paris_Masters-R32-Andreas_Seppi-Roger_Federer,2,B-XC,10,2,0,1,1,7,3
20151104-M-Paris_Masters-R32-Andreas_Seppi-Roger_Federer,2,B-DTM,7,1,0,0,1,6,1
20151104-M-Paris_Masters-R32-Andreas_Seppi-Roger_Federer,2,B-DTL,6,2,2,0,0,5,1
20151104-M-Paris_Masters-R32-Andreas_Seppi-Roger_Federer,2,B-IO,1,1,1,0,0,1,0
20151104-M-Paris_Masters-R32-Andreas_Seppi-Roger_Federer,2,S-XC,9,3,0,1,2,6,3
20151104-M-Paris_Masters-R32-Andreas_Seppi-Roger_Federer,2,S-DTM,2,0,0,0,0,2,0
20090504-M-Rome_Masters-F-Novak_Djokovic-Rafael_Nadal,1,F-XC,45,4,2,2,0,25,20
20090504-M-Rome_Masters-F-Novak_Djokovic-Rafael_Nadal,1,F-DTM,40,3,0,0,3,17,23
20090504-M-Rome_Masters-F-Novak_Djokovic-Rafael_Nadal,1,F-DTL,14,9,2,2,5,5,9
20090504-M-Rome_Masters-F-Novak_Djokovic-Rafael_Nadal,1,F-IO,32,14,5,3,6,18,14
20090504-M-Rome_Masters-F-Novak_Djokovic-Rafael_Nadal,1,F-II,1,0,0,0,0,0,1
20090504-M-Rome_Masters-F-Novak_Djokovic-Rafael_Nadal,1,B-XC,53,7,5,0,2,24,29
20090504-M-Rome_Masters-F-Novak_Djokovic-Rafael_Nadal,1,B-DTM,67,7,0,2,5,23,44
20090504-M-Rome_Masters-F-Novak_Djokovic-Rafael_Nadal,1,B-DTL,30,10,2,1,7,9,21
20090504-M-Rome_Masters-F-Novak_Djokovic-Rafael_Nadal,1,B-IO,9,1,1,0,0,5,4
20090504-M-Rome_Masters-F-Novak_Djokovic-Rafael_Nadal,1,S-DTM,2,0,0,0,0,0,2
20090504-M-Rome_Masters-F-Novak_Djokovic-Rafael_Nadal,1,S-DTL,2,1,0,0,1,1,1
20090504-M-Rome_Masters-F-Novak_Djokovic-Rafael_Nadal,2,F-XC,103,5,4,1,0,68,35
20090504-M-Rome_Masters-F-Novak_Djokovic-Rafael_Nadal,2,F-DTM,46,4,1,0,3,23,23
20090504-M-Rome_Masters-F-Novak_Djokovic-Rafael_Nadal,2,F-DTL,11,6,3,3,0,9,2
20090504-M-Rome_Masters-F-Novak_Djokovic-Rafael_Nadal,2,F-IO,27,9,3,2,4,17,10
20090504-M-Rome_Masters-F-Novak_Djokovic-Rafael_Nadal,2,F-II,8,1,0,0,1,5,3
20090504-M-Rome_Masters-F-Novak_Djokovic-Rafael_Nadal,2,B-XC,26,4,2,1,1,16,10
20090504-M-Rome_Masters-F-Novak_Djokovic-Rafael_Nadal,2,B-DTM,35,5,1,1,3,18,17
20090504-M-Rome_Masters-F-Novak_Djokovic-Rafael_Nadal,2,B-DTL,18,4,1,1,2,12,6
20090504-M-Rome_Masters-F-Novak_Djokovic-Rafael_Nadal,2,B-IO,9,0,0,0,0,5,4
20090504-M-Rome_Masters-F-Novak_Djokovic-Rafael_Nadal,2,S-XC,2,0,0,0,0,0,2
20090504-M-Rome_Masters-F-Novak_Djokovic-Rafael_Nadal,2,S-DTM,5,0,0,0,0,1,4
20090504-M-Rome_Masters-F-Novak_Djokovic-Rafael_Nadal,2,S-DTL,1,0,0,0,0,1,0
20090504-M-Rome_Masters-F-Novak_Djokovic-Rafael_Nadal,2,S-IO,1,0,0,0,0,1,0
20170904-M-Alphen_Aan_Den_Rijn_CH-R32-Yannick_Maden-Karim_Mohamed_Maamoun,1,F-XC,28,3,0,1,2,20,8
20170904-M-Alphen_Aan_Den_Rijn_CH-R32-Yannick_Maden-Karim_Mohamed_Maamoun,1,F-DTM,21,0,0,0,0,15,6
20170904-M-Alphen_Aan_Den_Rijn_CH-R32-Yannick_Maden-Karim_Mohamed_Maamoun,1,F-DTL,6,1,0,1,0,4,2
20170904-M-Alphen_Aan_Den_Rijn_CH-R32-Yannick_Maden-Karim_Mohamed_Maamoun,1,F-IO,15,3,2,0,1,11,4
20170904-M-Alphen_Aan_Den_Rijn_CH-R32-Yannick_Maden-Karim_Mohamed_Maamoun,1,F-II,2,0,0,0,0,1,1
20170904-M-Alphen_Aan_Den_Rijn_CH-R32-Yannick_Maden-Karim_Mohamed_Maamoun,1,B-XC,66,6,2,0,4,45,21
20170904-M-Alphen_Aan_Den_Rijn_CH-R32-Yannick_Maden-Karim_Mohamed_Maamoun,1,B-DTM,33,0,0,0,0,24,9
20170904-M-Alphen_Aan_Den_Rijn_CH-R32-Yannick_Maden-Karim_Mohamed_Maamoun,1,B-DTL,14,6,3,1,2,9,5
20170904-M-Alphen_Aan_Den_Rijn_CH-R32-Yannick_Maden-Karim_Mohamed_Maamoun,1,B-IO,3,2,2,0,0,3,0
20170904-M-Alphen_Aan_Den_Rijn_CH-R32-Yannick_Maden-Karim_Mohamed_Maamoun,2,F-XC,40,11,1,0,10,10,30
20170904-M-Alphen_Aan_Den_Rijn_CH-R32-Yannick_Maden-Karim_Mohamed_Maamoun,2,F-DTM,11,2,0,0,2,1,10
20170904-M-Alphen_Aan_Den_Rijn_CH-R32-Yannick_Maden-Karim_Mohamed_Maamoun,2,F-DTL,13,6,2,1,3,7,6
20170904-M-Alphen_Aan_Den_Rijn_CH-R32-Yannick_Maden-Karim_Mohamed_Maamoun,2,F-IO,20,6,1,0,5,6,14
20170904-M-Alphen_Aan_Den_Rijn_CH-R32-Yannick_Maden-Karim_Mohamed_Maamoun,2,F-II,5,3,2,1,0,3,2
20170904-M-Alphen_Aan_Den_Rijn_CH-R32-Yannick_Maden-Karim_Mohamed_Maamoun,2,B-XC,53,5,0,0,5,13,40
20170904-M-Alphen_Aan_Den_Rijn_CH-R32-Yannick_Maden-Karim_Mohamed_Maamoun,2,B-DTM,36,2,0,0,2,7,29
20170904-M-Alphen_Aan_Den_Rijn_CH-R32-Yannick_Maden-Karim_Mohamed_Maamoun,2,B-DTL,7,5,2,0,3,3,4
20170904-M-Alphen_Aan_Den_Rijn_CH-R32-Yannick_Maden-Karim_Mohamed_Maamoun,2,S-XC,5,0,0,0,0,1,4
20170904-M-Alphen_Aan_Den_Rijn_CH-R32-Yannick_Maden-Karim_Mohamed_Maamoun,2,S-DTM,4,0,0,0,0,2,2
20171030-M-Eckental_CH-R32-Karim_Mohamed_Maamoun-Mirza_Basic,1,F-XC,31,15,6,2,7,14,17
20171030-M-Eckental_CH-R32-Karim_Mohamed_Maamoun-Mirza_Basic,1,F-DTM,42,8,1,3,4,19,23
20171030-M-Eckental_CH-R32-Karim_Mohamed_Maamoun-Mirza_Basic,1,F-DTL,5,4,1,1,2,2,3
20171030-M-Eckental_CH-R32-Karim_Mohamed_Maamoun-Mirza_Basic,1,F-IO,24,6,0,3,3,13,11
20171030-M-Eckental_CH-R32-Karim_Mohamed_Maamoun-Mirza_Basic,1,B-XC,30,7,0,2,5,13,17
20171030-M-Eckental_CH-R32-Karim_Mohamed_Maamoun-Mirza_Basic,1,B-DTM,53,5,0,0,5,17,36
20171030-M-Eckental_CH-R32-Karim_Mohamed_Maamoun-Mirza_Basic,1,B-DTL,4,1,0,1,0,1,3
20171030-M-Eckental_CH-R32-Karim_Mohamed_Maamoun-Mirza_Basic,1,B-IO,5,1,0,1,0,4,1
20171030-M-Eckental_CH-R32-Karim_Mohamed_Maamoun-Mirza_Basic,1,S-XC,11,0,0,0,0,6,5
20171030-M-Eckental_CH-R32-Karim_Mohamed_Maamoun-Mirza_Basic,1,S-DTM,13,1,0,0,1,5,8
20171030-M-Eckental_CH-R32-Karim_Mohamed_Maamoun-Mirza_Basic,1,S-DTL,2,0,0,0,0,1,1
20171030-M-Eckental_CH-R32-Karim_Mohamed_Maamoun-Mirza_Basic,1,S-IO,1,1,0,0,1,0,1
20171030-M-Eckental_CH-R32-Karim_Mohamed_Maamoun-Mirza_Basic,2,F-XC,34,10,4,2,4,18,16
20171030-M-Eckental_CH-R32-Karim_Mohamed_Maamoun-Mirza_Basic,2,F-DTM,32,2,1,0,1,19,13
20171030-M-Eckental_CH-R32-Karim_Mohamed_Maamoun-Mirza_Basic,2,F-DTL,7,1,0,1,0,4,3
20171030-M-Eckental_CH-R32-Karim_Mohamed_Maamoun-Mirza_Basic,2,F-IO,18,2,0,0,2,9,9
20171030-M-Eckental_CH-R32-Karim_Mohamed_Maamoun-Mirza_Basic,2,F-II,1,1,1,0,0,1,0
20171030-M-Eckental_CH-R32-Karim_Mohamed_Maamoun-Mirza_Basic,2,B-XC,22,4,1,0,3,11,11
20171030-M-Eckental_CH-R32-Karim_Mohamed_Maamoun-Mirza_Basic,2,B-DTM,35,1,0,0,1,20,15
20171030-M-Eckental_CH-R32-Karim_Mohamed_Maamoun-Mirza_Basic,2,B-DTL,5,4,1,3,0,4,1
20171030-M-Eckental_CH-R32-Karim_Mohamed_Maamoun-Mirza_Basic,2,B-IO,1,1,0,1,0,1,0
20171030-M-Eckental_CH-R32-Karim_Mohamed_Maamoun-Mirza_Basic,2,S-XC,13,1,0,0,1,6,7
20171030-M-Eckental_CH-R32-Karim_Mohamed_Maamoun-Mirza_Basic,2,S-DTM,18,0,0,0,0,11,7
20171030-M-Eckental_CH-R32-Karim_Mohamed_Maamoun-Mirza_Basic,2,S-DTL,3,2,0,0,2,0,3
20171030-M-Eckental_CH-R32-Karim_Mohamed_Maamoun-Mirza_Basic,2,S-IO,1,0,0,0,0,1,0
20170915-M-Istanbul_CH-QF-Altug_Celikbilek-Karim_Mohamed_Maamoun,1,F-XC,14,2,0,1,1,6,8
20170915-M-Istanbul_CH-QF-Altug_Celikbilek-Karim_Mohamed_Maamoun,1,F-DTM,39,4,1,0,3,23,16
20170915-M-Istanbul_CH-QF-Altug_Celikbilek-Karim_Mohamed_Maamoun,1,F-DTL,5,2,0,0,2,2,3
20170915-M-Istanbul_CH-QF-Altug_Celikbilek-Karim_Mohamed_Maamoun,1,F-IO,23,8,0,2,6,9,14
20170915-M-Istanbul_CH-QF-Altug_Celikbilek-Karim_Mohamed_Maamoun,1,B-XC,37,4,0,0,4,23,14
20170915-M-Istanbul_CH-QF-Altug_Celikbilek-Karim_Mohamed_Maamoun,1,B-DTM,25,2,0,1,1,17,8
20170915-M-Istanbul_CH-QF-Altug_Celikbilek-Karim_Mohamed_Maamoun,1,B-DTL,7,4,2,0,2,4,3
20170915-M-Istanbul_CH-QF-Altug_Celikbilek-Karim_Mohamed_Maamoun,1,B-IO,2,1,0,0,1,0,2
20170915-M-Istanbul_CH-QF-Altug_Celikbilek-Karim_Mohamed_Maamoun,1,B-II,1,0,0,0,0,1,0
20170915-M-Istanbul_CH-QF-Altug_Celikbilek-Karim_Mohamed_Maamoun,1,S-XC,7,0,0,0,0,6,1
20170915-M-Istanbul_CH-QF-Altug_Celikbilek-Karim_Mohamed_Maamoun,1,S-DTM,10,1,0,0,1,2,8
20170915-M-Istanbul_CH-QF-Altug_Celikbilek-Karim_Mohamed_Maamoun,1,S-IO,1,0,0,0,0,1,0
20170915-M-Istanbul_CH-QF-Altug_Celikbilek-Karim_Mohamed_Maamoun,2,F-XC,31,10,6,3,1,18,13
20170915-M-Istanbul_CH-QF-Altug_Celikbilek-Karim_Mohamed_Maamoun,2,F-DTM,34,4,0,0,4,11,23
20170915-M-Istanbul_CH-QF-Altug_Celikbilek-Karim_Mohamed_Maamoun,2,F-DTL,7,4,1,1,2,4,3
20170915-M-Istanbul_CH-QF-Altug_Celikbilek-Karim_Mohamed_Maamoun,2,F-IO,20,4,1,2,1,11,9
20170915-M-Istanbul_CH-QF-Altug_Celikbilek-Karim_Mohamed_Maamoun,2,F-II,1,0,0,0,0,1,0
20170915-M-Istanbul_CH-QF-Altug_Celikbilek-Karim_Mohamed_Maamoun,2,B-XC,48,9,2,0,7,14,34
20170915-M-Istanbul_CH-QF-Altug_Celikbilek-Karim_Mohamed_Maamoun,2,B-DTM,26,2,0,0,2,11,15
20170915-M-Istanbul_CH-QF-Altug_Celikbilek-Karim_Mohamed_Maamoun,2,B-DTL,5,3,1,1,1,3,2
20170915-M-Istanbul_CH-QF-Altug_Celikbilek-Karim_Mohamed_Maamoun,2,S-XC,4,0,0,0,0,2,2
20170915-M-Istanbul_CH-QF-Altug_Celikbilek-Karim_Mohamed_Maamoun,2,S-DTM,6,1,0,0,1,2,4
20170915-M-Istanbul_CH-QF-Altug_Celikbilek-Karim_Mohamed_Maamoun,2,S-DTL,2,0,0,0,0,1,1
20170913-M-Istanbul_CH-R16-Karim_Mohamed_Maamoun-Uladzimir_Ignatik,1,F-XC,33,9,5,3,1,26,7
20170913-M-Istanbul_CH-R16-Karim_Mohamed_Maamoun-Uladzimir_Ignatik,1,F-DTM,34,3,0,0,3,18,16
20170913-M-Istanbul_CH-R16-Karim_Mohamed_Maamoun-Uladzimir_Ignatik,1,F-DTL,4,2,1,0,1,2,2
20170913-M-Istanbul_CH-R16-Karim_Mohamed_Maamoun-Uladzimir_Ignatik,1,F-IO,19,3,0,1,2,16,3
20170913-M-Istanbul_CH-R16-Karim_Mohamed_Maamoun-Uladzimir_Ignatik,1,B-XC,25,2,1,0,1,20,5
20170913-M-Istanbul_CH-R16-Karim_Mohamed_Maamoun-Uladzimir_Ignatik,1,B-DTM,28,4,1,0,3,14,14
20170913-M-Istanbul_CH-R16-Karim_Mohamed_Maamoun-Uladzimir_Ignatik,1,B-DTL,3,2,2,0,0,3,0
20170913-M-Istanbul_CH-R16-Karim_Mohamed_Maamoun-Uladzimir_Ignatik,1,B-IO,1,1,0,0,1,0,1
20170913-M-Istanbul_CH-R16-Karim_Mohamed_Maamoun-Uladzimir_Ignatik,1,S-XC,5,3,0,0,3,1,4
20170913-M-Istanbul_CH-R16-Karim_Mohamed_Maamoun-Uladzimir_Ignatik,1,S-DTM,7,0,0,0,0,6,1
20170913-M-Istanbul_CH-R16-Karim_Mohamed_Maamoun-Uladzimir_Ignatik,1,S-II,1,1,0,0,1,0,1
20170913-M-Istanbul_CH-R16-Karim_Mohamed_Maamoun-Uladzimir_Ignatik,2,F-XC,20,6,0,2,4,9,11
20170913-M-Istanbul_CH-R16-Karim_Mohamed_Maamoun-Uladzimir_Ignatik,2,F-DTM,22,4,0,0,4,5,17
20170913-M-Istanbul_CH-R16-Karim_Mohamed_Maamoun-Uladzimir_Ignatik,2,F-DTL,7,6,2,0,4,2,5
20170913-M-Istanbul_CH-R16-Karim_Mohamed_Maamoun-Uladzimir_Ignatik,2,F-IO,18,4,1,0,3,5,13
20170913-M-Istanbul_CH-R16-Karim_Mohamed_Maamoun-Uladzimir_Ignatik,2,B-XC,27,7,1,1,5,5,22
20170913-M-Istanbul_CH-R16-Karim_Mohamed_Maamoun-Uladzimir_Ignatik,2,B-DTM,31,3,0,0,3,13,18
20170913-M-Istanbul_CH-R16-Karim_Mohamed_Maamoun-Uladzimir_Ignatik,2,B-DTL,7,5,2,0,3,2,5
20170913-M-Istanbul_CH-R16-Karim_Mohamed_Maamoun-Uladzimir_Ignatik,2,B-IO,6,6,3,0,3,3,3
20170913-M-Istanbul_CH-R16-Karim_Mohamed_Maamoun-Uladzimir_Ignatik,2,S-XC,9,0,0,0,0,2,7
20170913-M-Istanbul_CH-R16-Karim_Mohamed_Maamoun-Uladzimir_Ignatik,2,S-DTM,6,0,0,0,0,1,5
20170913-M-Istanbul_CH-R16-Karim_Mohamed_Maamoun-Uladzimir_Ignatik,2,S-DTL,2,0,0,0,0,0,2
20170916-M-Istanbul_CH-SF-Malek_Jaziri-Karim_Mohamed_Maamoun,1,F-XC,39,11,3,6,2,24,15
20170916-M-Istanbul_CH-SF-Malek_Jaziri-Karim_Mohamed_Maamoun,1,F-DTM,49,1,0,0,1,19,30
20170916-M-Istanbul_CH-SF-Malek_Jaziri-Karim_Mohamed_Maamoun,1,F-DTL,11,4,2,1,1,5,6
20170916-M-Istanbul_CH-SF-Malek_Jaziri-Karim_Mohamed_Maamoun,1,F-IO,27,7,1,2,4,17,10
20170916-M-Istanbul_CH-SF-Malek_Jaziri-Karim_Mohamed_Maamoun,1,F-II,2,1,1,0,0,2,0
20170916-M-Istanbul_CH-SF-Malek_Jaziri-Karim_Mohamed_Maamoun,1,B-XC,34,3,0,1,2,13,21
20170916-M-Istanbul_CH-SF-Malek_Jaziri-Karim_Mohamed_Maamoun,1,B-DTM,41,5,0,0,5,13,28
20170916-M-Istanbul_CH-SF-Malek_Jaziri-Karim_Mohamed_Maamoun,1,B-DTL,5,3,1,0,2,3,2
20170916-M-Istanbul_CH-SF-Malek_Jaziri-Karim_Mohamed_Maamoun,1,S-XC,51,2,0,0,2,27,24
20170916-M-Istanbul_CH-SF-Malek_Jaziri-Karim_Mohamed_Maamoun,1,S-DTM,28,1,0,0,1,10,18
20170916-M-Istanbul_CH-SF-Malek_Jaziri-Karim_Mohamed_Maamoun,1,S-DTL,3,1,0,0,1,0,3
20170916-M-Istanbul_CH-SF-Malek_Jaziri-Karim_Mohamed_Maamoun,2,F-XC,40,18,5,4,9,26,14
20170916-M-Istanbul_CH-SF-Malek_Jaziri-Karim_Mohamed_Maamoun,2,F-DTM,52,3,0,0,3,30,22
20170916-M-Istanbul_CH-SF-Malek_Jaziri-Karim_Mohamed_Maamoun,2,F-DTL,6,4,0,0,4,0,6
20170916-M-Istanbul_CH-SF-Malek_Jaziri-Karim_Mohamed_Maamoun,2,F-IO,46,11,5,4,2,32,14
20170916-M-Istanbul_CH-SF-Malek_Jaziri-Karim_Mohamed_Maamoun,2,F-II,1,0,0,0,0,1,0
20170916-M-Istanbul_CH-SF-Malek_Jaziri-Karim_Mohamed_Maamoun,2,B-XC,76,8,1,2,5,40,36
20170916-M-Istanbul_CH-SF-Malek_Jaziri-Karim_Mohamed_Maamoun,2,B-DTM,42,3,0,1,2,19,23
20170916-M-Istanbul_CH-SF-Malek_Jaziri-Karim_Mohamed_Maamoun,2,B-DTL,5,3,1,0,2,2,3
20170916-M-Istanbul_CH-SF-Malek_Jaziri-Karim_Mohamed_Maamoun,2,B-IO,3,2,1,1,0,3,0
20170916-M-Istanbul_CH-SF-Malek_Jaziri-Karim_Mohamed_Maamoun,2,S-XC,7,0,0,0,0,2,5
20170916-M-Istanbul_CH-SF-Malek_Jaziri-Karim_Mohamed_Maamoun,2,S-DTM,6,0,0,0,0,2,4
20170916-M-Istanbul_CH-SF-Malek_Jaziri-Karim_Mohamed_Maamoun,2,S-DTL,2,1,1,0,0,1,1
20170919-M-Izmir_CH-R32-Malek_Jaziri-Karim_Mohamed_Maamoun,1,F-XC,30,15,2,4,9,16,14
20170919-M-Izmir_CH-R32-Malek_Jaziri-Karim_Mohamed_Maamoun,1,F-DTM,36,4,0,0,4,17,19
20170919-M-Izmir_CH-R32-Malek_Jaziri-Karim_Mohamed_Maamoun,1,F-DTL,11,1,0,0,1,6,5
20170919-M-Izmir_CH-R32-Malek_Jaziri-Karim_Mohamed_Maamoun,1,F-IO,17,3,0,0,3,9,8
20170919-M-Izmir_CH-R32-Malek_Jaziri-Karim_Mohamed_Maamoun,1,F-II,1,0,0,0,0,0,1
20170919-M-Izmir_CH-R32-Malek_Jaziri-Karim_Mohamed_Maamoun,1,B-XC,21,4,1,1,2,9,12
20170919-M-Izmir_CH-R32-Malek_Jaziri-Karim_Mohamed_Maamoun,1,B-DTM,20,2,0,0,2,3,17
20170919-M-Izmir_CH-R32-Malek_Jaziri-Karim_Mohamed_Maamoun,1,B-DTL,6,4,2,0,2,3,3
20170919-M-Izmir_CH-R32-Malek_Jaziri-Karim_Mohamed_Maamoun,1,S-XC,50,3,0,0,3,26,24
20170919-M-Izmir_CH-R32-Malek_Jaziri-Karim_Mohamed_Maamoun,1,S-DTM,22,1,0,0,1,12,10
20170919-M-Izmir_CH-R32-Malek_Jaziri-Karim_Mohamed_Maamoun,1,S-DTL,4,0,0,0,0,2,2
20170919-M-Izmir_CH-R32-Malek_Jaziri-Karim_Mohamed_Maamoun,1,S-IO,1,0,0,0,0,1,0
20170919-M-Izmir_CH-R32-Malek_Jaziri-Karim_Mohamed_Maamoun,2,F-XC,29,7,2,2,3,12,17
20170919-M-Izmir_CH-R32-Malek_Jaziri-Karim_Mohamed_Maamoun,2,F-DTM,29,7,0,1,6,12,17
20170919-M-Izmir_CH-R32-Malek_Jaziri-Karim_Mohamed_Maamoun,2,F-DTL,3,1,0,0,1,1,2
20170919-M-Izmir_CH-R32-Malek_Jaziri-Karim_Mohamed_Maamoun,2,F-IO,28,6,1,2,3,22,6
20170919-M-Izmir_CH-R32-Malek_Jaziri-Karim_Mohamed_Maamoun,2,F-II,5,2,1,0,1,2,3
20170919-M-Izmir_CH-R32-Malek_Jaziri-Karim_Mohamed_Maamoun,2,B-XC,57,10,1,3,6,28,29
20170919-M-Izmir_CH-R32-Malek_Jaziri-Karim_Mohamed_Maamoun,2,B-DTM,37,3,0,0,3,15,22
20170919-M-Izmir_CH-R32-Malek_Jaziri-Karim_Mohamed_Maamoun,2,B-DTL,9,3,1,1,1,5,4
20170919-M-Izmir_CH-R32-Malek_Jaziri-Karim_Mohamed_Maamoun,2,B-IO,3,3,1,1,1,2,1
20170919-M-Izmir_CH-R32-Malek_Jaziri-Karim_Mohamed_Maamoun,2,S-XC,14,0,0,0,0,8,6
20170919-M-Izmir_CH-R32-Malek_Jaziri-Karim_Mohamed_Maamoun,2,S-DTM,7,0,0,0,0,2,5
20170919-M-Izmir_CH-R32-Malek_Jaziri-Karim_Mohamed_Maamoun,2,S-DTL,4,2,0,0,2,1,3
20170921-M-Izmir_CH-R16-Aleksandr_Nedovyesov-Karim_Mohamed_Maamoun,1,F-XC,27,13,3,4,6,18,9
20170921-M-Izmir_CH-R16-Aleksandr_Nedovyesov-Karim_Mohamed_Maamoun,1,F-DTM,40,6,0,1,5,13,27
20170921-M-Izmir_CH-R16-Aleksandr_Nedovyesov-Karim_Mohamed_Maamoun,1,F-DTL,5,2,0,1,1,3,2
20170921-M-Izmir_CH-R16-Aleksandr_Nedovyesov-Karim_Mohamed_Maamoun,1,F-IO,15,8,3,2,3,9,6
20170921-M-Izmir_CH-R16-Aleksandr_Nedovyesov-Karim_Mohamed_Maamoun,1,F-II,2,1,1,0,0,2,0
20170921-M-Izmir_CH-R16-Aleksandr_Nedovyesov-Karim_Mohamed_Maamoun,1,B-XC,17,4,2,0,2,7,10
20170921-M-Izmir_CH-R16-Aleksandr_Nedovyesov-Karim_Mohamed_Maamoun,1,B-DTM,25,2,0,0,2,11,14
20170921-M-Izmir_CH-R16-Aleksandr_Nedovyesov-Karim_Mohamed_Maamoun,1,B-DTL,4,2,0,0,2,0,4
20170921-M-Izmir_CH-R16-Aleksandr_Nedovyesov-Karim_Mohamed_Maamoun,1,B-IO,2,0,0,0,0,0,2
20170921-M-Izmir_CH-R16-Aleksandr_Nedovyesov-Karim_Mohamed_Maamoun,1,S-XC,25,2,0,0,2,7,18
20170921-M-Izmir_CH-R16-Aleksandr_Nedovyesov-Karim_Mohamed_Maamoun,1,S-DTM,18,0,0,0,0,11,7
20170921-M-Izmir_CH-R16-Aleksandr_Nedovyesov-Karim_Mohamed_Maamoun,1,S-DTL,3,1,0,0,1,2,1
20170921-M-Izmir_CH-R16-Aleksandr_Nedovyesov-Karim_Mohamed_Maamoun,2,F-XC,27,11,1,3,7,14,13
20170921-M-Izmir_CH-R16-Aleksandr_Nedovyesov-Karim_Mohamed_Maamoun,2,F-DTM,43,3,0,1,2,21,22
20170921-M-Izmir_CH-R16-Aleksandr_Nedovyesov-Karim_Mohamed_Maamoun,2,F-DTL,1,1,0,0,1,0,1
20170921-M-Izmir_CH-R16-Aleksandr_Nedovyesov-Karim_Mohamed_Maamoun,2,F-IO,25,7,0,0,7,10,15
20170921-M-Izmir_CH-R16-Aleksandr_Nedovyesov-Karim_Mohamed_Maamoun,2,F-II,1,0,0,0,0,1,0
20170921-M-Izmir_CH-R16-Aleksandr_Nedovyesov-Karim_Mohamed_Maamoun,2,B-XC,32,6,0,3,3,20,12
20170921-M-Izmir_CH-R16-Aleksandr_Nedovyesov-Karim_Mohamed_Maamoun,2,B-DTM,39,2,0,0,2,21,18
20170921-M-Izmir_CH-R16-Aleksandr_Nedovyesov-Karim_Mohamed_Maamoun,2,B-DTL,1,1,0,0,1,0,1
20170921-M-Izmir_CH-R16-Aleksandr_Nedovyesov-Karim_Mohamed_Maamoun,2,B-IO,3,2,1,1,0,2,1
20170921-M-Izmir_CH-R16-Aleksandr_Nedovyesov-Karim_Mohamed_Maamoun,2,S-XC,8,0,0,0,0,7,1
20170921-M-Izmir_CH-R16-Aleksandr_Nedovyesov-Karim_Mohamed_Maamoun,2,S-DTM,5,0,0,0,0,2,3
20170921-M-Izmir_CH-R16-Aleksandr_Nedovyesov-Karim_Mohamed_Maamoun,2,S-DTL,2,0,0,0,0,1,1
20170921-M-Izmir_CH-R16-Aleksandr_Nedovyesov-Karim_Mohamed_Maamoun,2,S-IO,1,1,0,0,1,0,1
20170818-M-Meerbusch_CH-QF-Jeremy_Jahn-Karim_Mohamed_Maamoun,1,F-XC,41,11,2,1,8,16,25
20170818-M-Meerbusch_CH-QF-Jeremy_Jahn-Karim_Mohamed_Maamoun,1,F-DTM,32,4,0,1,3,12,20
20170818-M-Meerbusch_CH-QF-Jeremy_Jahn-Karim_Mohamed_Maamoun,1,F-DTL,8,4,2,0,2,6,2
20170818-M-Meerbusch_CH-QF-Jeremy_Jahn-Karim_Mohamed_Maamoun,1,F-IO,37,12,1,3,8,22,15
20170818-M-Meerbusch_CH-QF-Jeremy_Jahn-Karim_Mohamed_Maamoun,1,F-II,4,3,2,0,1,2,2
20170818-M-Meerbusch_CH-QF-Jeremy_Jahn-Karim_Mohamed_Maamoun,1,B-XC,52,11,3,0,8,20,32
20170818-M-Meerbusch_CH-QF-Jeremy_Jahn-Karim_Mohamed_Maamoun,1,B-DTM,17,1,0,0,1,5,12
20170818-M-Meerbusch_CH-QF-Jeremy_Jahn-Karim_Mohamed_Maamoun,1,B-DTL,4,3,0,1,2,2,2
20170818-M-Meerbusch_CH-QF-Jeremy_Jahn-Karim_Mohamed_Maamoun,1,B-IO,1,1,1,0,0,1,0
20170818-M-Meerbusch_CH-QF-Jeremy_Jahn-Karim_Mohamed_Maamoun,1,S-XC,8,2,0,0,2,2,6
20170818-M-Meerbusch_CH-QF-Jeremy_Jahn-Karim_Mohamed_Maamoun,1,S-DTM,4,1,0,0,1,1,3
20170818-M-Meerbusch_CH-QF-Jeremy_Jahn-Karim_Mohamed_Maamoun,1,S-DTL,2,0,0,0,0,1,1
20170818-M-Meerbusch_CH-QF-Jeremy_Jahn-Karim_Mohamed_Maamoun,2,F-XC,38,13,5,3,5,23,15
20170818-M-Meerbusch_CH-QF-Jeremy_Jahn-Karim_Mohamed_Maamoun,2,F-DTM,22,3,0,0,3,11,11
20170818-M-Meerbusch_CH-QF-Jeremy_Jahn-Karim_Mohamed_Maamoun,2,F-DTL,7,5,2,1,2,5,2
20170818-M-Meerbusch_CH-QF-Jeremy_Jahn-Karim_Mohamed_Maamoun,2,F-IO,13,2,1,1,0,13,0
20170818-M-Meerbusch_CH-QF-Jeremy_Jahn-Karim_Mohamed_Maamoun,2,F-II,1,1,0,0,1,0,1
20170818-M-Meerbusch_CH-QF-Jeremy_Jahn-Karim_Mohamed_Maamoun,2,B-XC,46,3,0,1,2,25,21
20170818-M-Meerbusch_CH-QF-Jeremy_Jahn-Karim_Mohamed_Maamoun,2,B-DTM,34,4,0,0,4,15,19
20170818-M-Meerbusch_CH-QF-Jeremy_Jahn-Karim_Mohamed_Maamoun,2,B-DTL,6,5,2,0,3,3,3
20170818-M-Meerbusch_CH-QF-Jeremy_Jahn-Karim_Mohamed_Maamoun,2,B-IO,4,1,0,1,0,3,1
20170818-M-Meerbusch_CH-QF-Jeremy_Jahn-Karim_Mohamed_Maamoun,2,S-XC,16,3,0,0,3,7,9
20170818-M-Meerbusch_CH-QF-Jeremy_Jahn-Karim_Mohamed_Maamoun,2,S-DTM,5,0,0,0,0,2,3
20170818-M-Meerbusch_CH-QF-Jeremy_Jahn-Karim_Mohamed_Maamoun,2,S-DTL,2,0,0,0,0,2,0
20171113-M-Pune_CH-R32-N_Sriram_Balaji-Karim_Mohamed_Maamoun,1,F-XC,15,6,2,1,3,10,5
20171113-M-Pune_CH-R32-N_Sriram_Balaji-Karim_Mohamed_Maamoun,1,F-DTM,17,2,0,0,2,14,3
20171113-M-Pune_CH-R32-N_Sriram_Balaji-Karim_Mohamed_Maamoun,1,F-DTL,1,0,0,0,0,1,0
20171113-M-Pune_CH-R32-N_Sriram_Balaji-Karim_Mohamed_Maamoun,1,F-IO,1,0,0,0,0,1,0
20171113-M-Pune_CH-R32-N_Sriram_Balaji-Karim_Mohamed_Maamoun,1,B-XC,29,2,2,0,0,26,3
20171113-M-Pune_CH-R32-N_Sriram_Balaji-Karim_Mohamed_Maamoun,1,B-DTM,20,2,0,0,2,15,5
20171113-M-Pune_CH-R32-N_Sriram_Balaji-Karim_Mohamed_Maamoun,1,B-DTL,6,4,1,1,2,4,2
20171113-M-Pune_CH-R32-N_Sriram_Balaji-Karim_Mohamed_Maamoun,1,B-IO,1,0,0,0,0,0,1
20171113-M-Pune_CH-R32-N_Sriram_Balaji-Karim_Mohamed_Maamoun,1,S-XC,3,0,0,0,0,3,0
20171113-M-Pune_CH-R32-N_Sriram_Balaji-Karim_Mohamed_Maamoun,1,S-DTM,4,0,0,0,0,2,2
20171113-M-Pune_CH-R32-N_Sriram_Balaji-Karim_Mohamed_Maamoun,2,F-XC,18,10,4,1,5,11,7
20171113-M-Pune_CH-R32-N_Sriram_Balaji-Karim_Mohamed_Maamoun,2,F-DTM,30,2,1,0,1,4,26
20171113-M-Pune_CH-R32-N_Sriram_Balaji-Karim_Mohamed_Maamoun,2,F-DTL,1,0,0,0,0,1,0
20171113-M-Pune_CH-R32-N_Sriram_Balaji-Karim_Mohamed_Maamoun,2,F-IO,15,5,1,2,2,5,10
20171113-M-Pune_CH-R32-N_Sriram_Balaji-Karim_Mohamed_Maamoun,2,B-XC,26,9,0,0,9,4,22
20171113-M-Pune_CH-R32-N_Sriram_Balaji-Karim_Mohamed_Maamoun,2,B-DTM,12,3,0,0,3,1,11
20171113-M-Pune_CH-R32-N_Sriram_Balaji-Karim_Mohamed_Maamoun,2,B-DTL,2,1,0,0,1,0,2
20171113-M-Pune_CH-R32-N_Sriram_Balaji-Karim_Mohamed_Maamoun,2,B-IO,4,3,0,2,1,2,2
20171113-M-Pune_CH-R32-N_Sriram_Balaji-Karim_Mohamed_Maamoun,2,S-XC,4,1,0,0,1,1,3
20171113-M-Pune_CH-R32-N_Sriram_Balaji-Karim_Mohamed_Maamoun,2,S-DTM,4,0,0,0,0,0,4
20170517-M-Samarkand_CH-R16-Karim_Mohamed_Maamoun-Nikola_Milojevic,1,F-XC,46,25,7,5,13,23,23
20170517-M-Samarkand_CH-R16-Karim_Mohamed_Maamoun-Nikola_Milojevic,1,F-DTM,86,10,0,2,8,44,42
20170517-M-Samarkand_CH-R16-Karim_Mohamed_Maamoun-Nikola_Milojevic,1,F-DTL,6,5,1,1,3,3,3
20170517-M-Samarkand_CH-R16-Karim_Mohamed_Maamoun-Nikola_Milojevic,1,F-IO,46,11,4,1,6,20,26
20170517-M-Samarkand_CH-R16-Karim_Mohamed_Maamoun-Nikola_Milojevic,1,F-II,2,1,1,0,0,2,0
20170517-M-Samarkand_CH-R16-Karim_Mohamed_Maamoun-Nikola_Milojevic,1,B-XC,67,6,0,1,5,32,35
20170517-M-Samarkand_CH-R16-Karim_Mohamed_Maamoun-Nikola_Milojevic,1,B-DTM,98,9,0,0,9,41,57
20170517-M-Samarkand_CH-R16-Karim_Mohamed_Maamoun-Nikola_Milojevic,1,B-DTL,5,3,3,0,0,5,0
20170517-M-Samarkand_CH-R16-Karim_Mohamed_Maamoun-Nikola_Milojevic,1,B-IO,4,2,1,0,1,2,2
20170517-M-Samarkand_CH-R16-Karim_Mohamed_Maamoun-Nikola_Milojevic,1,S-XC,15,2,0,1,1,6,9
20170517-M-Samarkand_CH-R16-Karim_Mohamed_Maamoun-Nikola_Milojevic,1,S-DTM,16,3,0,0,3,5,11
20170517-M-Samarkand_CH-R16-Karim_Mohamed_Maamoun-Nikola_Milojevic,1,S-DTL,3,0,0,0,0,2,1
20170517-M-Samarkand_CH-R16-Karim_Mohamed_Maamoun-Nikola_Milojevic,2,F-XC,46,22,7,4,11,25,21
20170517-M-Samarkand_CH-R16-Karim_Mohamed_Maamoun-Nikola_Milojevic,2,F-DTM,76,9,0,3,6,32,44
20170517-M-Samarkand_CH-R16-Karim_Mohamed_Maamoun-Nikola_Milojevic,2,F-DTL,5,2,1,0,1,3,2
20170517-M-Samarkand_CH-R16-Karim_Mohamed_Maamoun-Nikola_Milojevic,2,F-IO,54,11,3,5,3,33,21
20170517-M-Samarkand_CH-R16-Karim_Mohamed_Maamoun-Nikola_Milojevic,2,F-II,1,0,0,0,0,1,0
20170517-M-Samarkand_CH-R16-Karim_Mohamed_Maamoun-Nikola_Milojevic,2,B-XC,83,9,1,1,7,43,40
20170517-M-Samarkand_CH-R16-Karim_Mohamed_Maamoun-Nikola_Milojevic,2,B-DTM,95,11,0,0,11,42,53
20170517-M-Samarkand_CH-R16-Karim_Mohamed_Maamoun-Nikola_Milojevic,2,B-DTL,10,5,2,1,2,4,6
20170517-M-Samarkand_CH-R16-Karim_Mohamed_Maamoun-Nikola_Milojevic,2,B-IO,14,4,1,0,3,9,5
20170517-M-Samarkand_CH-R16-Karim_Mohamed_Maamoun-Nikola_Milojevic,2,S-XC,4,0,0,0,0,2,2
20170517-M-Samarkand_CH-R16-Karim_Mohamed_Maamoun-Nikola_Milojevic,2,S-DTM,3,0,0,0,0,3,0
20170517-M-Samarkand_CH-R16-Karim_Mohamed_Maamoun-Nikola_Milojevic,2,S-DTL,2,1,0,0,1,0,2
20170517-M-Samarkand_CH-R16-Karim_Mohamed_Maamoun-Nikola_Milojevic,2,S-IO,2,1,0,0,1,1,1
20170517-M-Samarkand_CH-R16-Karim_Mohamed_Maamoun-Nikola_Milojevic,2,S-II,1,0,0,0,0,0,1
20170803-M-Segovia_CH-R16-Karim_Mohamed_Maamoun-Alex_De_Minaur,1,F-XC,27,11,3,3,5,16,11
20170803-M-Segovia_CH-R16-Karim_Mohamed_Maamoun-Alex_De_Minaur,1,F-DTM,54,6,2,0,4,34,20
20170803-M-Segovia_CH-R16-Karim_Mohamed_Maamoun-Alex_De_Minaur,1,F-DTL,1,0,0,0,0,0,1
20170803-M-Segovia_CH-R16-Karim_Mohamed_Maamoun-Alex_De_Minaur,1,F-IO,21,2,0,1,1,12,9
20170803-M-Segovia_CH-R16-Karim_Mohamed_Maamoun-Alex_De_Minaur,1,F-II,1,0,0,0,0,1,0
20170803-M-Segovia_CH-R16-Karim_Mohamed_Maamoun-Alex_De_Minaur,1,B-XC,42,16,3,0,13,16,26
20170803-M-Segovia_CH-R16-Karim_Mohamed_Maamoun-Alex_De_Minaur,1,B-DTM,50,14,0,2,12,25,25
20170803-M-Segovia_CH-R16-Karim_Mohamed_Maamoun-Alex_De_Minaur,1,B-DTL,1,1,0,1,0,1,0
20170803-M-Segovia_CH-R16-Karim_Mohamed_Maamoun-Alex_De_Minaur,1,B-IO,5,3,1,0,2,2,3
20170803-M-Segovia_CH-R16-Karim_Mohamed_Maamoun-Alex_De_Minaur,1,S-XC,4,0,0,0,0,2,2
20170803-M-Segovia_CH-R16-Karim_Mohamed_Maamoun-Alex_De_Minaur,1,S-DTM,7,0,0,0,0,2,5
20170803-M-Segovia_CH-R16-Karim_Mohamed_Maamoun-Alex_De_Minaur,1,S-IO,1,0,0,0,0,0,1
20170803-M-Segovia_CH-R16-Karim_Mohamed_Maamoun-Alex_De_Minaur,1,S-II,1,0,0,0,0,1,0
20170803-M-Segovia_CH-R16-Karim_Mohamed_Maamoun-Alex_De_Minaur,2,F-XC,13,5,2,2,1,9,4
20170803-M-Segovia_CH-R16-Karim_Mohamed_Maamoun-Alex_De_Minaur,2,F-DTM,50,7,0,1,6,19,31
20170803-M-Segovia_CH-R16-Karim_Mohamed_Maamoun-Alex_De_Minaur,2,F-DTL,6,3,0,0,3,3,3
20170803-M-Segovia_CH-R16-Karim_Mohamed_Maamoun-Alex_De_Minaur,2,F-IO,13,5,2,0,3,6,7
20170803-M-Segovia_CH-R16-Karim_Mohamed_Maamoun-Alex_De_Minaur,2,B-XC,24,6,1,0,5,14,10
20170803-M-Segovia_CH-R16-Karim_Mohamed_Maamoun-Alex_De_Minaur,2,B-DTM,60,10,0,1,9,25,35
20170803-M-Segovia_CH-R16-Karim_Mohamed_Maamoun-Alex_De_Minaur,2,B-DTL,7,6,1,1,4,2,5
20170803-M-Segovia_CH-R16-Karim_Mohamed_Maamoun-Alex_De_Minaur,2,B-IO,1,0,0,0,0,1,0
20170803-M-Segovia_CH-R16-Karim_Mohamed_Maamoun-Alex_De_Minaur,2,S-XC,5,0,0,0,0,1,4
20170803-M-Segovia_CH-R16-Karim_Mohamed_Maamoun-Alex_De_Minaur,2,S-DTM,9,2,1,0,1,6,3
20170803-M-Segovia_CH-R16-Karim_Mohamed_Maamoun-Alex_De_Minaur,2,S-DTL,2,0,0,0,0,2,0
20170803-M-Segovia_CH-R16-Karim_Mohamed_Maamoun-Alex_De_Minaur,2,S-II,1,0,0,0,0,1,0
19851207-M-Australian_Open-SF-Stefan_Edberg-Ivan_Lendl,1,F-XC,9,7,2,2,3,6,3
19851207-M-Australian_Open-SF-Stefan_Edberg-Ivan_Lendl,1,F-DTM,6,1,0,0,1,1,5
19851207-M-Australian_Open-SF-Stefan_Edberg-Ivan_Lendl,1,F-DTL,13,8,4,4,0,9,4
19851207-M-Australian_Open-SF-Stefan_Edberg-Ivan_Lendl,1,F-IO,7,3,2,1,0,4,3
19851207-M-Australian_Open-SF-Stefan_Edberg-Ivan_Lendl,1,F-II,1,1,1,0,0,1,0
19851207-M-Australian_Open-SF-Stefan_Edberg-Ivan_Lendl,1,B-XC,19,9,5,0,4,10,9
19851207-M-Australian_Open-SF-Stefan_Edberg-Ivan_Lendl,1,B-DTM,5,2,0,1,1,1,4
19851207-M-Australian_Open-SF-Stefan_Edberg-Ivan_Lendl,1,B-DTL,12,5,2,2,1,6,6
19851207-M-Australian_Open-SF-Stefan_Edberg-Ivan_Lendl,1,B-IO,4,3,3,0,0,3,1
19851207-M-Australian_Open-SF-Stefan_Edberg-Ivan_Lendl,1,S-XC,11,1,1,0,0,6,5
19851207-M-Australian_Open-SF-Stefan_Edberg-Ivan_Lendl,1,S-DTM,3,0,0,0,0,0,3
19851207-M-Australian_Open-SF-Stefan_Edberg-Ivan_Lendl,1,S-DTL,3,1,1,0,0,1,2
19851207-M-Australian_Open-SF-Stefan_Edberg-Ivan_Lendl,2,F-XC,18,9,4,4,1,13,5
19851207-M-Australian_Open-SF-Stefan_Edberg-Ivan_Lendl,2,F-DTM,6,2,0,1,1,2,4
19851207-M-Australian_Open-SF-Stefan_Edberg-Ivan_Lendl,2,F-DTL,5,2,1,1,0,3,2
19851207-M-Australian_Open-SF-Stefan_Edberg-Ivan_Lendl,2,F-IO,9,2,0,1,1,5,4
19851207-M-Australian_Open-SF-Stefan_Edberg-Ivan_Lendl,2,F-II,2,1,0,0,1,0,2
19851207-M-Australian_Open-SF-Stefan_Edberg-Ivan_Lendl,2,B-XC,16,6,2,3,1,8,8
19851207-M-Australian_Open-SF-Stefan_Edberg-Ivan_Lendl,2,B-DTM,3,2,1,1,0,2,1
19851207-M-Australian_Open-SF-Stefan_Edberg-Ivan_Lendl,2,B-DTL,8,6,2,1,3,5,3
19851207-M-Australian_Open-SF-Stefan_Edberg-Ivan_Lendl,2,S-XC,12,3,1,0,2,7,5
19851207-M-Australian_Open-SF-Stefan_Edberg-Ivan_Lendl,2,S-DTM,4,2,0,0,2,2,2
19851207-M-Australian_Open-SF-Stefan_Edberg-Ivan_Lendl,2,S-DTL,7,4,1,0,3,2,5
19851207-M-Australian_Open-SF-Stefan_Edberg-Ivan_Lendl,2,S-IO,1,0,0,0,0,1,0
19961027-M-Stuttgart_Masters-F-Pete_Sampras-Boris_Becker,1,F-XC,25,11,1,4,6,13,12
19961027-M-Stuttgart_Masters-F-Pete_Sampras-Boris_Becker,1,F-DTM,6,1,0,0,1,3,3
19961027-M-Stuttgart_Masters-F-Pete_Sampras-Boris_Becker,1,F-DTL,13,5,1,1,3,4,9
19961027-M-Stuttgart_Masters-F-Pete_Sampras-Boris_Becker,1,F-IO,7,4,2,1,1,5,2
19961027-M-Stuttgart_Masters-F-Pete_Sampras-Boris_Becker,1,F-II,2,1,0,0,1,0,2
19961027-M-Stuttgart_Masters-F-Pete_Sampras-Boris_Becker,1,B-XC,35,10,3,2,5,14,21
19961027-M-Stuttgart_Masters-F-Pete_Sampras-Boris_Becker,1,B-DTM,12,1,0,1,0,4,8
19961027-M-Stuttgart_Masters-F-Pete_Sampras-Boris_Becker,1,B-DTL,12,6,3,0,3,5,7
19961027-M-Stuttgart_Masters-F-Pete_Sampras-Boris_Becker,1,S-XC,6,1,0,0,1,4,2
19961027-M-Stuttgart_Masters-F-Pete_Sampras-Boris_Becker,1,S-DTM,4,0,0,0,0,3,1
19961027-M-Stuttgart_Masters-F-Pete_Sampras-Boris_Becker,1,S-DTL,3,0,0,0,0,0,3
19961027-M-Stuttgart_Masters-F-Pete_Sampras-Boris_Becker,2,F-XC,19,7,2,3,2,11,8
19961027-M-Stuttgart_Masters-F-Pete_Sampras-Boris_Becker,2,F-DTM,9,1,1,0,0,6,3
19961027-M-Stuttgart_Masters-F-Pete_Sampras-Boris_Becker,2,F-DTL,11,4,2,1,1,6,5
19961027-M-Stuttgart_Masters-F-Pete_Sampras-Boris_Becker,2,F-IO,16,4,2,0,2,10,6
19961027-M-Stuttgart_Masters-F-Pete_Sampras-Boris_Becker,2,B-XC,20,2,1,1,0,12,8
19961027-M-Stuttgart_Masters-F-Pete_Sampras-Boris_Becker,2,B-DTM,6,1,0,0,1,5,1
19961027-M-Stuttgart_Masters-F-Pete_Sampras-Boris_Becker,2,B-DTL,13,7,5,0,2,7,6
19961027-M-Stuttgart_Masters-F-Pete_Sampras-Boris_Becker,2,B-IO,6,2,1,1,0,4,2
19961027-M-Stuttgart_Masters-F-Pete_Sampras-Boris_Becker,2,S-XC,5,0,0,0,0,5,0
19961027-M-Stuttgart_Masters-F-Pete_Sampras-Boris_Becker,2,S-DTM,2,0,0,0,0,0,2
19961027-M-Stuttgart_Masters-F-Pete_Sampras-Boris_Becker,2,S-DTL,1,0,0,0,0,0,1
20170819-M-Meerbusch_CH-SF-Andreas_Haider_Maurer-Karim_Mohamed_Maamoun,1,F-XC,21,7,2,3,2,11,10
20170819-M-Meerbusch_CH-SF-Andreas_Haider_Maurer-Karim_Mohamed_Maamoun,1,F-DTM,59,3,1,0,2,34,25
20170819-M-Meerbusch_CH-SF-Andreas_Haider_Maurer-Karim_Mohamed_Maamoun,1,F-DTL,5,1,1,0,0,4,1
20170819-M-Meerbusch_CH-SF-Andreas_Haider_Maurer-Karim_Mohamed_Maamoun,1,F-IO,50,9,4,1,4,29,21
20170819-M-Meerbusch_CH-SF-Andreas_Haider_Maurer-Karim_Mohamed_Maamoun,1,F-II,3,1,1,0,0,3,0
20170819-M-Meerbusch_CH-SF-Andreas_Haider_Maurer-Karim_Mohamed_Maamoun,1,B-XC,57,10,1,4,5,31,26
20170819-M-Meerbusch_CH-SF-Andreas_Haider_Maurer-Karim_Mohamed_Maamoun,1,B-DTM,61,5,0,0,5,21,40
20170819-M-Meerbusch_CH-SF-Andreas_Haider_Maurer-Karim_Mohamed_Maamoun,1,B-DTL,6,5,0,1,4,1,5
20170819-M-Meerbusch_CH-SF-Andreas_Haider_Maurer-Karim_Mohamed_Maamoun,1,B-IO,2,0,0,0,0,1,1
20170819-M-Meerbusch_CH-SF-Andreas_Haider_Maurer-Karim_Mohamed_Maamoun,1,S-XC,14,3,0,2,1,9,5
20170819-M-Meerbusch_CH-SF-Andreas_Haider_Maurer-Karim_Mohamed_Maamoun,1,S-DTM,11,1,0,0,1,2,9
20170819-M-Meerbusch_CH-SF-Andreas_Haider_Maurer-Karim_Mohamed_Maamoun,1,S-DTL,4,1,0,0,1,2,2
20170819-M-Meerbusch_CH-SF-Andreas_Haider_Maurer-Karim_Mohamed_Maamoun,2,F-XC,45,23,7,8,8,26,19
20170819-M-Meerbusch_CH-SF-Andreas_Haider_Maurer-Karim_Mohamed_Maamoun,2,F-DTM,49,2,0,0,2,17,32
20170819-M-Meerbusch_CH-SF-Andreas_Haider_Maurer-Karim_Mohamed_Maamoun,2,F-DTL,6,4,1,1,2,2,4
20170819-M-Meerbusch_CH-SF-Andreas_Haider_Maurer-Karim_Mohamed_Maamoun,2,F-IO,38,5,3,2,0,31,7
20170819-M-Meerbusch_CH-SF-Andreas_Haider_Maurer-Karim_Mohamed_Maamoun,2,F-II,3,2,2,0,0,2,1
20170819-M-Meerbusch_CH-SF-Andreas_Haider_Maurer-Karim_Mohamed_Maamoun,2,B-XC,59,10,2,1,7,34,25
20170819-M-Meerbusch_CH-SF-Andreas_Haider_Maurer-Karim_Mohamed_Maamoun,2,B-DTM,81,7,0,0,7,28,53
20170819-M-Meerbusch_CH-SF-Andreas_Haider_Maurer-Karim_Mohamed_Maamoun,2,B-DTL,8,5,4,0,1,4,4
20170819-M-Meerbusch_CH-SF-Andreas_Haider_Maurer-Karim_Mohamed_Maamoun,2,B-IO,8,2,1,0,1,5,3
20170819-M-Meerbusch_CH-SF-Andreas_Haider_Maurer-Karim_Mohamed_Maamoun,2,S-XC,15,3,0,1,2,3,12
20170819-M-Meerbusch_CH-SF-Andreas_Haider_Maurer-Karim_Mohamed_Maamoun,2,S-DTM,9,1,0,0,1,3,6
20170819-M-Meerbusch_CH-SF-Andreas_Haider_Maurer-Karim_Mohamed_Maamoun,2,S-DTL,2,1,1,0,0,1,1
20170819-M-Meerbusch_CH-SF-Andreas_Haider_Maurer-Karim_Mohamed_Maamoun,2,S-II,2,0,0,0,0,1,1
20170817-M-Meerbusch_CH-R16-Marc_Sieber-Karim_Mohamed_Maamoun,1,F-XC,37,7,1,0,6,14,23
20170817-M-Meerbusch_CH-R16-Marc_Sieber-Karim_Mohamed_Maamoun,1,F-DTM,14,0,0,0,0,6,8
20170817-M-Meerbusch_CH-R16-Marc_Sieber-Karim_Mohamed_Maamoun,1,F-DTL,15,2,0,0,2,9,6
20170817-M-Meerbusch_CH-R16-Marc_Sieber-Karim_Mohamed_Maamoun,1,F-IO,29,2,0,1,1,15,14
20170817-M-Meerbusch_CH-R16-Marc_Sieber-Karim_Mohamed_Maamoun,1,F-II,5,1,1,0,0,5,0
20170817-M-Meerbusch_CH-R16-Marc_Sieber-Karim_Mohamed_Maamoun,1,B-XC,25,11,3,2,6,9,16
20170817-M-Meerbusch_CH-R16-Marc_Sieber-Karim_Mohamed_Maamoun,1,B-DTM,29,4,0,0,4,12,17
20170817-M-Meerbusch_CH-R16-Marc_Sieber-Karim_Mohamed_Maamoun,1,B-DTL,17,7,3,1,3,8,9
20170817-M-Meerbusch_CH-R16-Marc_Sieber-Karim_Mohamed_Maamoun,1,B-IO,5,2,0,0,2,1,4
20170817-M-Meerbusch_CH-R16-Marc_Sieber-Karim_Mohamed_Maamoun,1,S-XC,4,1,0,0,1,1,3
20170817-M-Meerbusch_CH-R16-Marc_Sieber-Karim_Mohamed_Maamoun,1,S-DTM,6,1,0,0,1,2,4
20170817-M-Meerbusch_CH-R16-Marc_Sieber-Karim_Mohamed_Maamoun,1,S-DTL,8,0,0,0,0,5,3
20170817-M-Meerbusch_CH-R16-Marc_Sieber-Karim_Mohamed_Maamoun,1,S-IO,1,0,0,0,0,0,1
20170817-M-Meerbusch_CH-R16-Marc_Sieber-Karim_Mohamed_Maamoun,2,F-XC,51,8,1,3,4,31,20
20170817-M-Meerbusch_CH-R16-Marc_Sieber-Karim_Mohamed_Maamoun,2,F-DTM,20,1,0,0,1,10,10
20170817-M-Meerbusch_CH-R16-Marc_Sieber-Karim_Mohamed_Maamoun,2,F-DTL,7,6,4,0,2,5,2
20170817-M-Meerbusch_CH-R16-Marc_Sieber-Karim_Mohamed_Maamoun,2,F-IO,8,2,1,1,0,5,3
20170817-M-Meerbusch_CH-R16-Marc_Sieber-Karim_Mohamed_Maamoun,2,F-II,3,0,0,0,0,2,1
20170817-M-Meerbusch_CH-R16-Marc_Sieber-Karim_Mohamed_Maamoun,2,B-XC,32,4,2,0,2,21,11
20170817-M-Meerbusch_CH-R16-Marc_Sieber-Karim_Mohamed_Maamoun,2,B-DTM,23,3,0,0,3,12,11
20170817-M-Meerbusch_CH-R16-Marc_Sieber-Karim_Mohamed_Maamoun,2,B-DTL,13,2,2,0,0,4,9
20170817-M-Meerbusch_CH-R16-Marc_Sieber-Karim_Mohamed_Maamoun,2,B-IO,5,0,0,0,0,4,1
20170817-M-Meerbusch_CH-R16-Marc_Sieber-Karim_Mohamed_Maamoun,2,S-XC,5,0,0,0,0,3,2
20170817-M-Meerbusch_CH-R16-Marc_Sieber-Karim_Mohamed_Maamoun,2,S-DTM,4,0,0,0,0,2,2
20170817-M-Meerbusch_CH-R16-Marc_Sieber-Karim_Mohamed_Maamoun,2,S-DTL,1,0,0,0,0,0,1
20170817-M-Meerbusch_CH-R16-Marc_Sieber-Karim_Mohamed_Maamoun,2,S-IO,1,0,0,0,0,1,0
20070510-M-Rome_Masters-R16-Roger_Federer-Filippo_Volandri,1,F-XC,47,12,2,2,8,21,26
20070510-M-Rome_Masters-R16-Roger_Federer-Filippo_Volandri,1,F-DTM,15,0,0,0,0,4,11
20070510-M-Rome_Masters-R16-Roger_Federer-Filippo_Volandri,1,F-DTL,19,7,0,1,6,10,9
20070510-M-Rome_Masters-R16-Roger_Federer-Filippo_Volandri,1,F-IO,18,5,1,2,2,10,8
20070510-M-Rome_Masters-R16-Roger_Federer-Filippo_Volandri,1,F-II,4,1,0,0,1,1,3
20070510-M-Rome_Masters-R16-Roger_Federer-Filippo_Volandri,1,B-XC,35,3,1,0,2,18,17
20070510-M-Rome_Masters-R16-Roger_Federer-Filippo_Volandri,1,B-DTM,15,5,0,0,5,1,14
20070510-M-Rome_Masters-R16-Roger_Federer-Filippo_Volandri,1,B-DTL,19,5,1,0,4,6,13
20070510-M-Rome_Masters-R16-Roger_Federer-Filippo_Volandri,1,B-IO,2,2,0,1,1,1,1
20070510-M-Rome_Masters-R16-Roger_Federer-Filippo_Volandri,1,S-XC,9,2,0,0,2,3,6
20070510-M-Rome_Masters-R16-Roger_Federer-Filippo_Volandri,1,S-DTL,2,2,1,0,1,1,1
20070510-M-Rome_Masters-R16-Roger_Federer-Filippo_Volandri,2,F-XC,61,13,2,7,4,40,21
20070510-M-Rome_Masters-R16-Roger_Federer-Filippo_Volandri,2,F-DTM,7,0,0,0,0,5,2
20070510-M-Rome_Masters-R16-Roger_Federer-Filippo_Volandri,2,F-DTL,9,3,1,0,2,4,5
20070510-M-Rome_Masters-R16-Roger_Federer-Filippo_Volandri,2,F-IO,33,7,1,4,2,25,8
20070510-M-Rome_Masters-R16-Roger_Federer-Filippo_Volandri,2,F-II,8,2,0,1,1,5,3
20070510-M-Rome_Masters-R16-Roger_Federer-Filippo_Volandri,2,B-XC,46,6,1,0,5,21,25
20070510-M-Rome_Masters-R16-Roger_Federer-Filippo_Volandri,2,B-DTM,13,1,0,0,1,4,9
20070510-M-Rome_Masters-R16-Roger_Federer-Filippo_Volandri,2,B-DTL,4,0,0,0,0,2,2
20070510-M-Rome_Masters-R16-Roger_Federer-Filippo_Volandri,2,B-IO,1,1,1,0,0,1,0
20070510-M-Rome_Masters-R16-Roger_Federer-Filippo_Volandri,2,S-XC,3,0,0,0,0,2,1
20070510-M-Rome_Masters-R16-Roger_Federer-Filippo_Volandri,2,S-DTM,1,0,0,0,0,0,1
20070510-M-Rome_Masters-R16-Roger_Federer-Filippo_Volandri,2,S-DTL,1,0,0,0,0,0,1
19950522-M-Rome_Masters-F-Sergi_Bruguera-Thomas_Muster,1,F-XC,165,10,2,1,7,82,83
19950522-M-Rome_Masters-F-Sergi_Bruguera-Thomas_Muster,1,F-DTM,10,0,0,0,0,4,6
19950522-M-Rome_Masters-F-Sergi_Bruguera-Thomas_Muster,1,F-DTL,37,4,0,1,3,19,18
19950522-M-Rome_Masters-F-Sergi_Bruguera-Thomas_Muster,1,F-IO,45,10,4,2,4,26,19
19950522-M-Rome_Masters-F-Sergi_Bruguera-Thomas_Muster,1,F-II,30,6,4,1,1,22,8
19950522-M-Rome_Masters-F-Sergi_Bruguera-Thomas_Muster,1,B-XC,135,15,3,3,9,57,78
19950522-M-Rome_Masters-F-Sergi_Bruguera-Thomas_Muster,1,B-DTM,58,4,0,0,4,19,39
19950522-M-Rome_Masters-F-Sergi_Bruguera-Thomas_Muster,1,B-DTL,103,14,2,3,9,48,55
19950522-M-Rome_Masters-F-Sergi_Bruguera-Thomas_Muster,1,B-IO,12,2,0,1,1,5,7
19950522-M-Rome_Masters-F-Sergi_Bruguera-Thomas_Muster,1,S-XC,5,2,0,0,2,0,5
19950522-M-Rome_Masters-F-Sergi_Bruguera-Thomas_Muster,1,S-DTM,6,0,0,0,0,2,4
19950522-M-Rome_Masters-F-Sergi_Bruguera-Thomas_Muster,1,S-DTL,26,1,0,0,1,6,20
19950522-M-Rome_Masters-F-Sergi_Bruguera-Thomas_Muster,2,F-XC,207,9,1,4,4,123,84
19950522-M-Rome_Masters-F-Sergi_Bruguera-Thomas_Muster,2,F-DTM,34,2,0,0,2,19,15
19950522-M-Rome_Masters-F-Sergi_Bruguera-Thomas_Muster,2,F-DTL,41,16,5,5,6,22,19
19950522-M-Rome_Masters-F-Sergi_Bruguera-Thomas_Muster,2,F-IO,68,24,8,6,10,39,29
19950522-M-Rome_Masters-F-Sergi_Bruguera-Thomas_Muster,2,F-II,53,4,1,2,1,34,19
19950522-M-Rome_Masters-F-Sergi_Bruguera-Thomas_Muster,2,B-XC,96,21,4,6,11,51,45
19950522-M-Rome_Masters-F-Sergi_Bruguera-Thomas_Muster,2,B-DTM,45,2,0,0,2,22,23
19950522-M-Rome_Masters-F-Sergi_Bruguera-Thomas_Muster,2,B-DTL,64,6,2,0,4,30,34
19950522-M-Rome_Masters-F-Sergi_Bruguera-Thomas_Muster,2,B-IO,4,0,0,0,0,2,2
19950522-M-Rome_Masters-F-Sergi_Bruguera-Thomas_Muster,2,S-XC,10,1,0,0,1,0,10
19950522-M-Rome_Masters-F-Sergi_Bruguera-Thomas_Muster,2,S-DTM,9,4,1,0,3,4,5
19950522-M-Rome_Masters-F-Sergi_Bruguera-Thomas_Muster,2,S-DTL,12,0,0,0,0,6,6
19920823-M-New_Haven-SF-Ivan_Lendl-Stefan_Edberg,1,F-XC,15,3,1,1,1,4,11
19920823-M-New_Haven-SF-Ivan_Lendl-Stefan_Edberg,1,F-DTM,2,1,0,1,0,1,1
19920823-M-New_Haven-SF-Ivan_Lendl-Stefan_Edberg,1,F-DTL,5,2,2,0,0,4,1
19920823-M-New_Haven-SF-Ivan_Lendl-Stefan_Edberg,1,F-IO,9,1,0,1,0,5,4
19920823-M-New_Haven-SF-Ivan_Lendl-Stefan_Edberg,1,F-II,8,6,2,1,3,3,5
19920823-M-New_Haven-SF-Ivan_Lendl-Stefan_Edberg,1,B-XC,11,6,2,3,1,5,6
19920823-M-New_Haven-SF-Ivan_Lendl-Stefan_Edberg,1,B-DTM,3,1,0,1,0,1,2
19920823-M-New_Haven-SF-Ivan_Lendl-Stefan_Edberg,1,B-DTL,6,2,1,0,1,1,5
19920823-M-New_Haven-SF-Ivan_Lendl-Stefan_Edberg,1,S-XC,9,1,0,1,0,2,7
19920823-M-New_Haven-SF-Ivan_Lendl-Stefan_Edberg,1,S-DTM,2,0,0,0,0,1,1
19920823-M-New_Haven-SF-Ivan_Lendl-Stefan_Edberg,1,S-DTL,7,2,0,0,2,2,5
19920823-M-New_Haven-SF-Ivan_Lendl-Stefan_Edberg,2,F-XC,9,4,3,0,1,6,3
19920823-M-New_Haven-SF-Ivan_Lendl-Stefan_Edberg,2,F-DTM,3,0,0,0,0,3,0
19920823-M-New_Haven-SF-Ivan_Lendl-Stefan_Edberg,2,F-DTL,7,4,0,3,1,4,3
19920823-M-New_Haven-SF-Ivan_Lendl-Stefan_Edberg,2,F-IO,2,1,0,1,0,2,0
19920823-M-New_Haven-SF-Ivan_Lendl-Stefan_Edberg,2,B-XC,5,2,1,1,0,5,0
19920823-M-New_Haven-SF-Ivan_Lendl-Stefan_Edberg,2,B-DTL,2,1,0,0,1,1,1
19920823-M-New_Haven-SF-Ivan_Lendl-Stefan_Edberg,2,B-IO,1,0,0,0,0,1,0
19920823-M-New_Haven-SF-Ivan_Lendl-Stefan_Edberg,2,S-XC,11,1,0,0,1,7,4
19920823-M-New_Haven-SF-Ivan_Lendl-Stefan_Edberg,2,S-DTM,4,0,0,0,0,2,2
19920823-M-New_Haven-SF-Ivan_Lendl-Stefan_Edberg,2,S-DTL,3,0,0,0,0,2,1
20051106-M-Paris_Masters-F-Tomas_Berdych-Ivan_Ljubicic,1,F-XC,50,22,9,5,8,32,18
20051106-M-Paris_Masters-F-Tomas_Berdych-Ivan_Ljubicic,1,F-DTM,18,4,0,1,3,8,10
20051106-M-Paris_Masters-F-Tomas_Berdych-Ivan_Ljubicic,1,F-DTL,10,5,0,2,3,4,6
20051106-M-Paris_Masters-F-Tomas_Berdych-Ivan_Ljubicic,1,F-IO,42,17,6,3,8,27,15
20051106-M-Paris_Masters-F-Tomas_Berdych-Ivan_Ljubicic,1,F-II,9,5,2,2,1,6,3
20051106-M-Paris_Masters-F-Tomas_Berdych-Ivan_Ljubicic,1,B-XC,39,9,1,3,5,21,18
20051106-M-Paris_Masters-F-Tomas_Berdych-Ivan_Ljubicic,1,B-DTM,13,3,0,1,2,5,8
20051106-M-Paris_Masters-F-Tomas_Berdych-Ivan_Ljubicic,1,B-DTL,10,3,1,1,1,9,1
20051106-M-Paris_Masters-F-Tomas_Berdych-Ivan_Ljubicic,1,B-IO,8,3,2,0,1,4,4
20051106-M-Paris_Masters-F-Tomas_Berdych-Ivan_Ljubicic,1,S-XC,5,1,0,0,1,4,1
20051106-M-Paris_Masters-F-Tomas_Berdych-Ivan_Ljubicic,1,S-DTL,2,0,0,0,0,1,1
20051106-M-Paris_Masters-F-Tomas_Berdych-Ivan_Ljubicic,2,F-XC,43,17,7,4,6,25,18
20051106-M-Paris_Masters-F-Tomas_Berdych-Ivan_Ljubicic,2,F-DTM,27,3,0,0,3,8,19
20051106-M-Paris_Masters-F-Tomas_Berdych-Ivan_Ljubicic,2,F-DTL,10,5,0,0,5,3,7
20051106-M-Paris_Masters-F-Tomas_Berdych-Ivan_Ljubicic,2,F-IO,12,3,2,1,0,6,6
20051106-M-Paris_Masters-F-Tomas_Berdych-Ivan_Ljubicic,2,F-II,1,1,0,0,1,0,1
20051106-M-Paris_Masters-F-Tomas_Berdych-Ivan_Ljubicic,2,B-XC,23,8,3,3,2,11,12
20051106-M-Paris_Masters-F-Tomas_Berdych-Ivan_Ljubicic,2,B-DTM,10,1,0,0,1,5,5
20051106-M-Paris_Masters-F-Tomas_Berdych-Ivan_Ljubicic,2,B-DTL,6,5,0,2,3,2,4
20051106-M-Paris_Masters-F-Tomas_Berdych-Ivan_Ljubicic,2,B-IO,4,3,1,1,1,3,1
20051106-M-Paris_Masters-F-Tomas_Berdych-Ivan_Ljubicic,2,S-XC,24,2,0,1,1,10,14
20051106-M-Paris_Masters-F-Tomas_Berdych-Ivan_Ljubicic,2,S-DTM,18,1,1,0,0,8,10
20051106-M-Paris_Masters-F-Tomas_Berdych-Ivan_Ljubicic,2,S-DTL,3,1,0,0,1,0,3
20051106-M-Paris_Masters-F-Tomas_Berdych-Ivan_Ljubicic,2,S-IO,2,0,0,0,0,1,1
19991128-M-Tour_Finals-F-Pete_Sampras-Andre_Agassi,1,F-XC,6,4,2,2,0,6,0
19991128-M-Tour_Finals-F-Pete_Sampras-Andre_Agassi,1,F-DTM,2,1,0,0,1,0,2
19991128-M-Tour_Finals-F-Pete_Sampras-Andre_Agassi,1,F-DTL,1,1,0,0,1,0,1
19991128-M-Tour_Finals-F-Pete_Sampras-Andre_Agassi,1,F-IO,3,1,1,0,0,1,2
19991128-M-Tour_Finals-F-Pete_Sampras-Andre_Agassi,1,B-XC,8,5,2,0,3,2,6
19991128-M-Tour_Finals-F-Pete_Sampras-Andre_Agassi,1,B-DTM,5,1,0,0,1,1,4
19991128-M-Tour_Finals-F-Pete_Sampras-Andre_Agassi,1,B-DTL,1,1,1,0,0,1,0
19991128-M-Tour_Finals-F-Pete_Sampras-Andre_Agassi,1,B-IO,3,3,1,0,2,1,2
19991128-M-Tour_Finals-F-Pete_Sampras-Andre_Agassi,1,S-XC,1,0,0,0,0,0,1
19991128-M-Tour_Finals-F-Pete_Sampras-Andre_Agassi,1,S-DTM,5,1,0,0,1,0,5
19991128-M-Tour_Finals-F-Pete_Sampras-Andre_Agassi,1,S-DTL,2,1,0,0,1,0,2
19991128-M-Tour_Finals-F-Pete_Sampras-Andre_Agassi,2,F-XC,9,6,0,2,4,4,5
19991128-M-Tour_Finals-F-Pete_Sampras-Andre_Agassi,2,F-DTM,7,2,0,0,2,3,4
19991128-M-Tour_Finals-F-Pete_Sampras-Andre_Agassi,2,F-DTL,6,3,1,1,1,3,3
19991128-M-Tour_Finals-F-Pete_Sampras-Andre_Agassi,2,F-IO,11,4,0,0,4,7,4
19991128-M-Tour_Finals-F-Pete_Sampras-Andre_Agassi,2,B-XC,16,7,2,1,4,10,6
19991128-M-Tour_Finals-F-Pete_Sampras-Andre_Agassi,2,B-DTM,12,2,0,0,2,4,8
19991128-M-Tour_Finals-F-Pete_Sampras-Andre_Agassi,2,B-DTL,7,5,2,1,2,4,3
19991128-M-Tour_Finals-F-Pete_Sampras-Andre_Agassi,2,B-IO,4,4,1,0,3,1,3
19991128-M-Tour_Finals-F-Pete_Sampras-Andre_Agassi,2,S-XC,2,0,0,0,0,2,0
19991128-M-Tour_Finals-F-Pete_Sampras-Andre_Agassi,2,S-DTM,1,0,0,0,0,1,0
19991128-M-Tour_Finals-F-Pete_Sampras-Andre_Agassi,2,S-DTL,1,0,0,0,0,1,0
19991128-M-Tour_Finals-F-Pete_Sampras-Andre_Agassi,2,S-IO,1,1,1,0,0,1,0
19871025-M-Tokyo_Indoor-F-Stefan_Edberg-Ivan_Lendl,1,F-XC,16,6,0,2,4,7,9
19871025-M-Tokyo_Indoor-F-Stefan_Edberg-Ivan_Lendl,1,F-DTM,6,0,0,0,0,1,5
19871025-M-Tokyo_Indoor-F-Stefan_Edberg-Ivan_Lendl,1,F-DTL,18,2,0,0,2,9,9
19871025-M-Tokyo_Indoor-F-Stefan_Edberg-Ivan_Lendl,1,F-IO,6,1,1,0,0,4,2
19871025-M-Tokyo_Indoor-F-Stefan_Edberg-Ivan_Lendl,1,B-XC,33,11,2,4,5,15,18
19871025-M-Tokyo_Indoor-F-Stefan_Edberg-Ivan_Lendl,1,B-DTM,9,4,0,0,4,2,7
19871025-M-Tokyo_Indoor-F-Stefan_Edberg-Ivan_Lendl,1,B-DTL,9,2,1,1,0,6,3
19871025-M-Tokyo_Indoor-F-Stefan_Edberg-Ivan_Lendl,1,B-IO,3,3,0,0,3,0,3
19871025-M-Tokyo_Indoor-F-Stefan_Edberg-Ivan_Lendl,1,S-XC,32,1,0,0,1,13,19
19871025-M-Tokyo_Indoor-F-Stefan_Edberg-Ivan_Lendl,1,S-DTM,3,0,0,0,0,3,0
19871025-M-Tokyo_Indoor-F-Stefan_Edberg-Ivan_Lendl,1,S-DTL,1,0,0,0,0,0,1
19871025-M-Tokyo_Indoor-F-Stefan_Edberg-Ivan_Lendl,2,F-XC,20,4,3,0,1,13,7
19871025-M-Tokyo_Indoor-F-Stefan_Edberg-Ivan_Lendl,2,F-DTM,10,1,0,1,0,5,5
19871025-M-Tokyo_Indoor-F-Stefan_Edberg-Ivan_Lendl,2,F-DTL,10,5,1,2,2,6,4
19871025-M-Tokyo_Indoor-F-Stefan_Edberg-Ivan_Lendl,2,F-IO,20,1,0,0,1,9,11
19871025-M-Tokyo_Indoor-F-Stefan_Edberg-Ivan_Lendl,2,F-II,4,1,0,0,1,1,3
19871025-M-Tokyo_Indoor-F-Stefan_Edberg-Ivan_Lendl,2,B-XC,48,10,6,1,3,27,21
19871025-M-Tokyo_Indoor-F-Stefan_Edberg-Ivan_Lendl,2,B-DTM,11,0,0,0,0,7,4
19871025-M-Tokyo_Indoor-F-Stefan_Edberg-Ivan_Lendl,2,B-DTL,14,4,2,0,2,8,6
19871025-M-Tokyo_Indoor-F-Stefan_Edberg-Ivan_Lendl,2,B-IO,8,2,2,0,0,6,2
19871025-M-Tokyo_Indoor-F-Stefan_Edberg-Ivan_Lendl,2,S-XC,23,2,1,0,1,14,9
19871025-M-Tokyo_Indoor-F-Stefan_Edberg-Ivan_Lendl,2,S-DTM,4,0,0,0,0,2,2
19871025-M-Tokyo_Indoor-F-Stefan_Edberg-Ivan_Lendl,2,S-DTL,8,2,0,1,1,4,4
19871025-M-Tokyo_Indoor-F-Stefan_Edberg-Ivan_Lendl,2,S-IO,2,0,0,0,0,0,2
19940313-M-Miami_Masters-F-Andre_Agassi-Pete_Sampras,1,F-XC,27,5,1,3,1,16,11
19940313-M-Miami_Masters-F-Andre_Agassi-Pete_Sampras,1,F-DTM,27,2,0,0,2,14,13
19940313-M-Miami_Masters-F-Andre_Agassi-Pete_Sampras,1,F-DTL,10,1,0,1,0,3,7
19940313-M-Miami_Masters-F-Andre_Agassi-Pete_Sampras,1,F-IO,41,4,1,1,2,23,18
19940313-M-Miami_Masters-F-Andre_Agassi-Pete_Sampras,1,F-II,7,2,2,0,0,3,4
19940313-M-Miami_Masters-F-Andre_Agassi-Pete_Sampras,1,B-XC,56,6,2,2,2,28,28
19940313-M-Miami_Masters-F-Andre_Agassi-Pete_Sampras,1,B-DTM,24,1,0,0,1,6,18
19940313-M-Miami_Masters-F-Andre_Agassi-Pete_Sampras,1,B-DTL,26,13,4,4,5,15,11
19940313-M-Miami_Masters-F-Andre_Agassi-Pete_Sampras,1,B-IO,3,1,1,0,0,2,1
19940313-M-Miami_Masters-F-Andre_Agassi-Pete_Sampras,1,S-XC,2,0,0,0,0,0,2
19940313-M-Miami_Masters-F-Andre_Agassi-Pete_Sampras,1,S-DTM,4,0,0,0,0,1,3
19940313-M-Miami_Masters-F-Andre_Agassi-Pete_Sampras,1,S-DTL,2,0,0,0,0,1,1
19940313-M-Miami_Masters-F-Andre_Agassi-Pete_Sampras,2,F-XC,44,20,7,5,8,24,20
19940313-M-Miami_Masters-F-Andre_Agassi-Pete_Sampras,2,F-DTM,17,2,0,0,2,7,10
19940313-M-Miami_Masters-F-Andre_Agassi-Pete_Sampras,2,F-DTL,13,7,2,3,2,7,6
19940313-M-Miami_Masters-F-Andre_Agassi-Pete_Sampras,2,F-IO,24,9,4,1,4,17,7
19940313-M-Miami_Masters-F-Andre_Agassi-Pete_Sampras,2,F-II,6,4,3,0,1,5,1
19940313-M-Miami_Masters-F-Andre_Agassi-Pete_Sampras,2,B-XC,44,5,1,3,1,24,20
19940313-M-Miami_Masters-F-Andre_Agassi-Pete_Sampras,2,B-DTM,22,3,0,0,3,8,14
19940313-M-Miami_Masters-F-Andre_Agassi-Pete_Sampras,2,B-DTL,13,4,0,0,4,4,9
19940313-M-Miami_Masters-F-Andre_Agassi-Pete_Sampras,2,B-IO,3,1,0,0,1,1,2
19940313-M-Miami_Masters-F-Andre_Agassi-Pete_Sampras,2,S-XC,22,2,1,0,1,11,11
19940313-M-Miami_Masters-F-Andre_Agassi-Pete_Sampras,2,S-DTM,12,1,0,0,1,6,6
19940313-M-Miami_Masters-F-Andre_Agassi-Pete_Sampras,2,S-DTL,1,0,0,0,0,0,1
19931121-M-Tour_Finals-F-Pete_Sampras-Michael_Stich,1,F-XC,34,10,0,3,7,13,21
19931121-M-Tour_Finals-F-Pete_Sampras-Michael_Stich,1,F-DTM,8,0,0,0,0,4,4
19931121-M-Tour_Finals-F-Pete_Sampras-Michael_Stich,1,F-DTL,13,6,3,2,1,7,6
19931121-M-Tour_Finals-F-Pete_Sampras-Michael_Stich,1,F-IO,19,9,3,4,2,12,7
19931121-M-Tour_Finals-F-Pete_Sampras-Michael_Stich,1,F-II,2,1,0,0,1,0,2
19931121-M-Tour_Finals-F-Pete_Sampras-Michael_Stich,1,B-XC,21,6,2,1,3,10,11
19931121-M-Tour_Finals-F-Pete_Sampras-Michael_Stich,1,B-DTM,12,0,0,0,0,5,7
19931121-M-Tour_Finals-F-Pete_Sampras-Michael_Stich,1,B-DTL,6,5,1,1,3,2,4
19931121-M-Tour_Finals-F-Pete_Sampras-Michael_Stich,1,B-IO,2,0,0,0,0,0,2
19931121-M-Tour_Finals-F-Pete_Sampras-Michael_Stich,1,S-XC,9,0,0,0,0,5,4
19931121-M-Tour_Finals-F-Pete_Sampras-Michael_Stich,1,S-DTM,11,0,0,0,0,8,3
19931121-M-Tour_Finals-F-Pete_Sampras-Michael_Stich,1,S-DTL,4,0,0,0,0,3,1
19931121-M-Tour_Finals-F-Pete_Sampras-Michael_Stich,2,F-XC,21,8,1,5,2,11,10
19931121-M-Tour_Finals-F-Pete_Sampras-Michael_Stich,2,F-DTM,14,0,0,0,0,5,9
19931121-M-Tour_Finals-F-Pete_Sampras-Michael_Stich,2,F-DTL,7,4,2,1,1,4,3
19931121-M-Tour_Finals-F-Pete_Sampras-Michael_Stich,2,F-IO,8,2,0,1,1,4,4
19931121-M-Tour_Finals-F-Pete_Sampras-Michael_Stich,2,F-II,2,1,0,1,0,2,0
19931121-M-Tour_Finals-F-Pete_Sampras-Michael_Stich,2,B-XC,23,5,3,1,1,11,12
19931121-M-Tour_Finals-F-Pete_Sampras-Michael_Stich,2,B-DTM,18,3,0,1,2,6,12
19931121-M-Tour_Finals-F-Pete_Sampras-Michael_Stich,2,B-DTL,8,5,1,1,3,4,4
19931121-M-Tour_Finals-F-Pete_Sampras-Michael_Stich,2,B-IO,8,5,2,1,2,5,3
19931121-M-Tour_Finals-F-Pete_Sampras-Michael_Stich,2,S-XC,14,2,0,0,2,7,7
19931121-M-Tour_Finals-F-Pete_Sampras-Michael_Stich,2,S-DTM,8,0,0,0,0,3,5
19931121-M-Tour_Finals-F-Pete_Sampras-Michael_Stich,2,S-DTL,5,2,0,0,2,1,4
19931121-M-Tour_Finals-F-Pete_Sampras-Michael_Stich,2,S-IO,1,1,0,0,1,0,1
19931121-M-Tour_Finals-F-Pete_Sampras-Michael_Stich,2,S-II,1,0,0,0,0,1,0
19971102-M-Paris_Masters-F-Pete_Sampras-Jonas_Bjorkman,1,F-XC,13,7,2,1,4,5,8
19971102-M-Paris_Masters-F-Pete_Sampras-Jonas_Bjorkman,1,F-DTM,10,2,0,1,1,5,5
19971102-M-Paris_Masters-F-Pete_Sampras-Jonas_Bjorkman,1,F-DTL,6,3,0,2,1,3,3
19971102-M-Paris_Masters-F-Pete_Sampras-Jonas_Bjorkman,1,F-IO,11,3,1,2,0,9,2
19971102-M-Paris_Masters-F-Pete_Sampras-Jonas_Bjorkman,1,F-II,6,4,0,2,2,2,4
19971102-M-Paris_Masters-F-Pete_Sampras-Jonas_Bjorkman,1,B-XC,24,6,1,3,2,12,12
19971102-M-Paris_Masters-F-Pete_Sampras-Jonas_Bjorkman,1,B-DTM,15,2,0,0,2,6,9
19971102-M-Paris_Masters-F-Pete_Sampras-Jonas_Bjorkman,1,B-DTL,9,7,3,0,4,5,4
19971102-M-Paris_Masters-F-Pete_Sampras-Jonas_Bjorkman,1,B-IO,3,0,0,0,0,3,0
19971102-M-Paris_Masters-F-Pete_Sampras-Jonas_Bjorkman,1,S-XC,5,0,0,0,0,3,2
19971102-M-Paris_Masters-F-Pete_Sampras-Jonas_Bjorkman,1,S-DTM,4,0,0,0,0,2,2
19971102-M-Paris_Masters-F-Pete_Sampras-Jonas_Bjorkman,1,S-DTL,3,2,1,0,1,1,2
19971102-M-Paris_Masters-F-Pete_Sampras-Jonas_Bjorkman,2,F-XC,10,4,2,0,2,6,4
19971102-M-Paris_Masters-F-Pete_Sampras-Jonas_Bjorkman,2,F-DTM,6,2,1,0,1,2,4
19971102-M-Paris_Masters-F-Pete_Sampras-Jonas_Bjorkman,2,F-DTL,8,3,2,0,1,6,2
19971102-M-Paris_Masters-F-Pete_Sampras-Jonas_Bjorkman,2,F-IO,7,0,0,0,0,4,3
19971102-M-Paris_Masters-F-Pete_Sampras-Jonas_Bjorkman,2,B-XC,44,8,3,1,4,22,22
19971102-M-Paris_Masters-F-Pete_Sampras-Jonas_Bjorkman,2,B-DTM,12,1,0,0,1,1,11
19971102-M-Paris_Masters-F-Pete_Sampras-Jonas_Bjorkman,2,B-DTL,10,6,2,2,2,6,4
19971102-M-Paris_Masters-F-Pete_Sampras-Jonas_Bjorkman,2,B-IO,3,0,0,0,0,2,1
19971102-M-Paris_Masters-F-Pete_Sampras-Jonas_Bjorkman,2,S-XC,9,1,0,0,1,3,6
19971102-M-Paris_Masters-F-Pete_Sampras-Jonas_Bjorkman,2,S-DTM,2,1,0,0,1,0,2
19910811-M-Cincinnati_Masters-F-Pete_Sampras-Guy_Forget,1,F-XC,35,7,1,3,3,25,10
19910811-M-Cincinnati_Masters-F-Pete_Sampras-Guy_Forget,1,F-DTM,6,0,0,0,0,3,3
19910811-M-Cincinnati_Masters-F-Pete_Sampras-Guy_Forget,1,F-DTL,4,3,0,0,3,1,3
19910811-M-Cincinnati_Masters-F-Pete_Sampras-Guy_Forget,1,F-IO,11,4,3,1,0,10,1
19910811-M-Cincinnati_Masters-F-Pete_Sampras-Guy_Forget,1,F-II,6,2,2,0,0,6,0
19910811-M-Cincinnati_Masters-F-Pete_Sampras-Guy_Forget,1,B-XC,18,6,1,1,4,10,8
19910811-M-Cincinnati_Masters-F-Pete_Sampras-Guy_Forget,1,B-DTM,21,1,0,1,0,11,10
19910811-M-Cincinnati_Masters-F-Pete_Sampras-Guy_Forget,1,B-DTL,9,4,1,1,2,4,5
19910811-M-Cincinnati_Masters-F-Pete_Sampras-Guy_Forget,1,B-IO,4,1,0,1,0,2,2
19910811-M-Cincinnati_Masters-F-Pete_Sampras-Guy_Forget,1,S-XC,4,0,0,0,0,2,2
19910811-M-Cincinnati_Masters-F-Pete_Sampras-Guy_Forget,1,S-DTM,4,1,0,1,0,4,0
19910811-M-Cincinnati_Masters-F-Pete_Sampras-Guy_Forget,1,S-DTL,4,0,0,0,0,3,1
19910811-M-Cincinnati_Masters-F-Pete_Sampras-Guy_Forget,2,F-XC,32,6,2,1,3,17,15
19910811-M-Cincinnati_Masters-F-Pete_Sampras-Guy_Forget,2,F-DTM,7,2,0,1,1,1,6
19910811-M-Cincinnati_Masters-F-Pete_Sampras-Guy_Forget,2,F-DTL,7,4,2,1,1,3,4
19910811-M-Cincinnati_Masters-F-Pete_Sampras-Guy_Forget,2,F-IO,11,5,2,1,2,6,5
19910811-M-Cincinnati_Masters-F-Pete_Sampras-Guy_Forget,2,F-II,5,1,0,0,1,2,3
19910811-M-Cincinnati_Masters-F-Pete_Sampras-Guy_Forget,2,B-XC,22,6,4,1,1,15,7
19910811-M-Cincinnati_Masters-F-Pete_Sampras-Guy_Forget,2,B-DTM,15,1,0,1,0,4,11
19910811-M-Cincinnati_Masters-F-Pete_Sampras-Guy_Forget,2,B-DTL,6,2,0,0,2,0,6
19910811-M-Cincinnati_Masters-F-Pete_Sampras-Guy_Forget,2,B-IO,5,0,0,0,0,1,4
19910811-M-Cincinnati_Masters-F-Pete_Sampras-Guy_Forget,2,S-XC,5,0,0,0,0,0,5
19910811-M-Cincinnati_Masters-F-Pete_Sampras-Guy_Forget,2,S-DTM,5,0,0,0,0,1,4
19910811-M-Cincinnati_Masters-F-Pete_Sampras-Guy_Forget,2,S-DTL,8,0,0,0,0,3,5
19910811-M-Cincinnati_Masters-F-Pete_Sampras-Guy_Forget,2,S-IO,4,1,0,0,1,0,4
20171014-M-Shanghai_Masters-SF-Juan_Martin_Del_Potro-Roger_Federer,1,F-XC,36,16,6,4,6,15,21
20171014-M-Shanghai_Masters-SF-Juan_Martin_Del_Potro-Roger_Federer,1,F-DTM,24,4,1,0,3,12,12
20171014-M-Shanghai_Masters-SF-Juan_Martin_Del_Potro-Roger_Federer,1,F-DTL,10,2,0,1,1,6,4
20171014-M-Shanghai_Masters-SF-Juan_Martin_Del_Potro-Roger_Federer,1,F-IO,34,8,3,1,4,19,15
20171014-M-Shanghai_Masters-SF-Juan_Martin_Del_Potro-Roger_Federer,1,F-II,4,1,0,1,0,2,2
20171014-M-Shanghai_Masters-SF-Juan_Martin_Del_Potro-Roger_Federer,1,B-XC,25,3,0,1,2,12,13
20171014-M-Shanghai_Masters-SF-Juan_Martin_Del_Potro-Roger_Federer,1,B-DTM,17,2,0,1,1,7,10
20171014-M-Shanghai_Masters-SF-Juan_Martin_Del_Potro-Roger_Federer,1,B-DTL,13,8,1,2,5,5,8
20171014-M-Shanghai_Masters-SF-Juan_Martin_Del_Potro-Roger_Federer,1,B-IO,1,1,0,0,1,0,1
20171014-M-Shanghai_Masters-SF-Juan_Martin_Del_Potro-Roger_Federer,1,S-XC,17,4,1,0,3,9,8
20171014-M-Shanghai_Masters-SF-Juan_Martin_Del_Potro-Roger_Federer,1,S-DTM,10,4,0,0,4,3,7
20171014-M-Shanghai_Masters-SF-Juan_Martin_Del_Potro-Roger_Federer,1,S-IO,1,0,0,0,0,0,1
20171014-M-Shanghai_Masters-SF-Juan_Martin_Del_Potro-Roger_Federer,2,F-XC,22,9,6,3,0,18,4
20171014-M-Shanghai_Masters-SF-Juan_Martin_Del_Potro-Roger_Federer,2,F-DTM,27,4,1,0,3,15,12
20171014-M-Shanghai_Masters-SF-Juan_Martin_Del_Potro-Roger_Federer,2,F-DTL,7,1,1,0,0,6,1
20171014-M-Shanghai_Masters-SF-Juan_Martin_Del_Potro-Roger_Federer,2,F-IO,29,7,3,1,3,15,14
20171014-M-Shanghai_Masters-SF-Juan_Martin_Del_Potro-Roger_Federer,2,F-II,5,2,1,1,0,2,3
20171014-M-Shanghai_Masters-SF-Juan_Martin_Del_Potro-Roger_Federer,2,B-XC,24,1,1,0,0,14,10
20171014-M-Shanghai_Masters-SF-Juan_Martin_Del_Potro-Roger_Federer,2,B-DTM,14,3,0,0,3,6,8
20171014-M-Shanghai_Masters-SF-Juan_Martin_Del_Potro-Roger_Federer,2,B-DTL,7,3,2,0,1,4,3
20171014-M-Shanghai_Masters-SF-Juan_Martin_Del_Potro-Roger_Federer,2,B-IO,4,2,0,0,2,0,4
20171014-M-Shanghai_Masters-SF-Juan_Martin_Del_Potro-Roger_Federer,2,S-XC,14,2,0,0,2,5,9
20171014-M-Shanghai_Masters-SF-Juan_Martin_Del_Potro-Roger_Federer,2,S-DTM,9,0,0,0,0,4,5
20171014-M-Shanghai_Masters-SF-Juan_Martin_Del_Potro-Roger_Federer,2,S-DTL,2,1,0,0,1,0,2
20171014-M-Shanghai_Masters-SF-Juan_Martin_Del_Potro-Roger_Federer,2,S-IO,1,0,0,0,0,1,0
20180116-M-Australian_Open-R128-Roger_Federer-Aljaz_Bedene,1,F-XC,34,16,2,9,5,22,12
20180116-M-Australian_Open-R128-Roger_Federer-Aljaz_Bedene,1,F-DTM,8,2,0,2,0,5,3
20180116-M-Australian_Open-R128-Roger_Federer-Aljaz_Bedene,1,F-DTL,20,10,2,2,6,9,11
20180116-M-Australian_Open-R128-Roger_Federer-Aljaz_Bedene,1,F-IO,12,5,3,0,2,6,6
20180116-M-Australian_Open-R128-Roger_Federer-Aljaz_Bedene,1,F-II,6,3,3,0,0,5,1
20180116-M-Australian_Open-R128-Roger_Federer-Aljaz_Bedene,1,B-XC,17,1,0,0,1,6,11
20180116-M-Australian_Open-R128-Roger_Federer-Aljaz_Bedene,1,B-DTM,16,4,0,2,2,6,10
20180116-M-Australian_Open-R128-Roger_Federer-Aljaz_Bedene,1,B-DTL,9,6,2,0,4,3,6
20180116-M-Australian_Open-R128-Roger_Federer-Aljaz_Bedene,1,B-IO,1,0,0,0,0,0,1
20180116-M-Australian_Open-R128-Roger_Federer-Aljaz_Bedene,1,B-II,1,0,0,0,0,0,1
20180116-M-Australian_Open-R128-Roger_Federer-Aljaz_Bedene,1,S-XC,15,1,0,0,1,5,10
20180116-M-Australian_Open-R128-Roger_Federer-Aljaz_Bedene,1,S-DTM,4,0,0,0,0,3,1
20180116-M-Australian_Open-R128-Roger_Federer-Aljaz_Bedene,1,S-DTL,2,0,0,0,0,1,1
20180116-M-Australian_Open-R128-Roger_Federer-Aljaz_Bedene,2,F-XC,40,13,4,5,4,23,17
20180116-M-Australian_Open-R128-Roger_Federer-Aljaz_Bedene,2,F-DTM,15,2,0,0,2,7,8
20180116-M-Australian_Open-R128-Roger_Federer-Aljaz_Bedene,2,F-DTL,4,0,0,0,0,2,2
20180116-M-Australian_Open-R128-Roger_Federer-Aljaz_Bedene,2,F-IO,36,6,1,2,3,20,16
20180116-M-Australian_Open-R128-Roger_Federer-Aljaz_Bedene,2,F-II,8,5,4,0,1,5,3
20180116-M-Australian_Open-R128-Roger_Federer-Aljaz_Bedene,2,B-XC,20,2,0,2,0,13,7
20180116-M-Australian_Open-R128-Roger_Federer-Aljaz_Bedene,2,B-DTM,8,2,0,0,2,3,5
20180116-M-Australian_Open-R128-Roger_Federer-Aljaz_Bedene,2,B-DTL,6,3,3,0,0,5,1
20180116-M-Australian_Open-R128-Roger_Federer-Aljaz_Bedene,2,B-IO,3,2,0,0,2,0,3
20180116-M-Australian_Open-R128-Roger_Federer-Aljaz_Bedene,2,S-XC,7,1,0,0,1,3,4
20180116-M-Australian_Open-R128-Roger_Federer-Aljaz_Bedene,2,S-DTM,1,0,0,0,0,1,0
20180116-M-Australian_Open-R128-Roger_Federer-Aljaz_Bedene,2,S-DTL,3,1,0,1,0,3,0
20180120-M-Australian_Open-R32-Roger_Federer-Richard_Gasquet,1,F-XC,31,11,3,2,6,16,15
20180120-M-Australian_Open-R32-Roger_Federer-Richard_Gasquet,1,F-DTM,10,1,0,0,1,6,4
20180120-M-Australian_Open-R32-Roger_Federer-Richard_Gasquet,1,F-DTL,12,2,1,0,1,7,5
20180120-M-Australian_Open-R32-Roger_Federer-Richard_Gasquet,1,F-IO,19,6,3,2,1,7,12
20180120-M-Australian_Open-R32-Roger_Federer-Richard_Gasquet,1,F-II,14,10,3,5,2,11,3
20180120-M-Australian_Open-R32-Roger_Federer-Richard_Gasquet,1,B-XC,43,11,1,1,9,19,24
20180120-M-Australian_Open-R32-Roger_Federer-Richard_Gasquet,1,B-DTM,17,2,0,0,2,6,11
20180120-M-Australian_Open-R32-Roger_Federer-Richard_Gasquet,1,B-DTL,14,7,5,1,1,9,5
20180120-M-Australian_Open-R32-Roger_Federer-Richard_Gasquet,1,B-IO,4,1,0,1,0,4,0
20180120-M-Australian_Open-R32-Roger_Federer-Richard_Gasquet,1,S-XC,8,0,0,0,0,5,3
20180120-M-Australian_Open-R32-Roger_Federer-Richard_Gasquet,1,S-DTL,5,0,0,0,0,2,3
20180120-M-Australian_Open-R32-Roger_Federer-Richard_Gasquet,2,F-XC,24,9,3,1,5,8,16
20180120-M-Australian_Open-R32-Roger_Federer-Richard_Gasquet,2,F-DTM,18,3,0,1,2,6,12
20180120-M-Australian_Open-R32-Roger_Federer-Richard_Gasquet,2,F-DTL,20,5,3,0,2,12,8
20180120-M-Australian_Open-R32-Roger_Federer-Richard_Gasquet,2,F-IO,11,4,1,2,1,8,3
20180120-M-Australian_Open-R32-Roger_Federer-Richard_Gasquet,2,B-XC,70,9,2,4,3,36,34
20180120-M-Australian_Open-R32-Roger_Federer-Richard_Gasquet,2,B-DTM,10,2,1,0,1,5,5
20180120-M-Australian_Open-R32-Roger_Federer-Richard_Gasquet,2,B-DTL,12,6,4,2,0,8,4
20180120-M-Australian_Open-R32-Roger_Federer-Richard_Gasquet,2,B-IO,3,1,1,0,0,1,2
20180120-M-Australian_Open-R32-Roger_Federer-Richard_Gasquet,2,S-XC,4,0,0,0,0,2,2
20180120-M-Australian_Open-R32-Roger_Federer-Richard_Gasquet,2,S-DTM,1,0,0,0,0,0,1
20180120-M-Australian_Open-R32-Roger_Federer-Richard_Gasquet,2,S-DTL,2,0,0,0,0,2,0
20180118-M-Australian_Open-R64-Jan_Lennard_Struff-Roger_Federer,1,F-XC,27,8,3,2,3,18,9
20180118-M-Australian_Open-R64-Jan_Lennard_Struff-Roger_Federer,1,F-DTM,9,1,0,0,1,6,3
20180118-M-Australian_Open-R64-Jan_Lennard_Struff-Roger_Federer,1,F-DTL,12,4,3,1,0,8,4
20180118-M-Australian_Open-R64-Jan_Lennard_Struff-Roger_Federer,1,F-IO,22,12,5,4,3,15,7
20180118-M-Australian_Open-R64-Jan_Lennard_Struff-Roger_Federer,1,F-II,3,3,1,1,1,2,1
20180118-M-Australian_Open-R64-Jan_Lennard_Struff-Roger_Federer,1,B-XC,49,12,0,4,8,29,20
20180118-M-Australian_Open-R64-Jan_Lennard_Struff-Roger_Federer,1,B-DTM,13,2,0,0,2,9,4
20180118-M-Australian_Open-R64-Jan_Lennard_Struff-Roger_Federer,1,B-DTL,8,5,2,1,2,5,3
20180118-M-Australian_Open-R64-Jan_Lennard_Struff-Roger_Federer,1,B-IO,4,3,1,2,0,4,0
20180118-M-Australian_Open-R64-Jan_Lennard_Struff-Roger_Federer,1,S-XC,10,0,0,0,0,8,2
20180118-M-Australian_Open-R64-Jan_Lennard_Struff-Roger_Federer,1,S-DTM,3,0,0,0,0,1,2
20180118-M-Australian_Open-R64-Jan_Lennard_Struff-Roger_Federer,2,F-XC,33,15,6,3,6,19,14
20180118-M-Australian_Open-R64-Jan_Lennard_Struff-Roger_Federer,2,F-DTM,16,2,0,1,1,4,12
20180118-M-Australian_Open-R64-Jan_Lennard_Struff-Roger_Federer,2,F-DTL,10,5,3,2,0,6,4
20180118-M-Australian_Open-R64-Jan_Lennard_Struff-Roger_Federer,2,F-IO,22,5,2,3,0,8,14
20180118-M-Australian_Open-R64-Jan_Lennard_Struff-Roger_Federer,2,F-II,10,3,0,2,1,5,5
20180118-M-Australian_Open-R64-Jan_Lennard_Struff-Roger_Federer,2,B-XC,25,5,1,0,4,10,15
20180118-M-Australian_Open-R64-Jan_Lennard_Struff-Roger_Federer,2,B-DTM,17,4,1,1,2,7,10
20180118-M-Australian_Open-R64-Jan_Lennard_Struff-Roger_Federer,2,B-DTL,9,5,3,0,2,6,3
20180118-M-Australian_Open-R64-Jan_Lennard_Struff-Roger_Federer,2,S-XC,9,0,0,0,0,2,7
20180118-M-Australian_Open-R64-Jan_Lennard_Struff-Roger_Federer,2,S-DTM,6,1,0,0,1,2,4
20180118-M-Australian_Open-R64-Jan_Lennard_Struff-Roger_Federer,2,S-DTL,1,0,0,0,0,0,1
20180128-M-Australian_Open-F-Marin_Cilic-Roger_Federer,1,F-XC,51,20,6,4,10,26,25
20180128-M-Australian_Open-F-Marin_Cilic-Roger_Federer,1,F-DTM,15,1,0,0,1,9,6
20180128-M-Australian_Open-F-Marin_Cilic-Roger_Federer,1,F-DTL,21,5,0,2,3,8,13
20180128-M-Australian_Open-F-Marin_Cilic-Roger_Federer,1,F-IO,43,12,4,3,5,27,16
20180128-M-Australian_Open-F-Marin_Cilic-Roger_Federer,1,F-II,11,4,2,0,2,5,6
20180128-M-Australian_Open-F-Marin_Cilic-Roger_Federer,1,B-XC,68,18,0,2,16,28,40
20180128-M-Australian_Open-F-Marin_Cilic-Roger_Federer,1,B-DTM,17,3,0,0,3,4,13
20180128-M-Australian_Open-F-Marin_Cilic-Roger_Federer,1,B-DTL,20,9,2,2,5,11,9
20180128-M-Australian_Open-F-Marin_Cilic-Roger_Federer,1,B-IO,2,2,1,0,1,1,1
20180128-M-Australian_Open-F-Marin_Cilic-Roger_Federer,1,S-XC,7,2,0,0,2,1,6
20180128-M-Australian_Open-F-Marin_Cilic-Roger_Federer,1,S-DTM,1,0,0,0,0,0,1
20180128-M-Australian_Open-F-Marin_Cilic-Roger_Federer,2,F-XC,38,9,1,4,4,23,15
20180128-M-Australian_Open-F-Marin_Cilic-Roger_Federer,2,F-DTM,27,4,0,0,4,9,18
20180128-M-Australian_Open-F-Marin_Cilic-Roger_Federer,2,F-DTL,7,0,0,0,0,4,3
20180128-M-Australian_Open-F-Marin_Cilic-Roger_Federer,2,F-IO,28,11,2,5,4,15,13
20180128-M-Australian_Open-F-Marin_Cilic-Roger_Federer,2,F-II,9,4,2,1,1,5,4
20180128-M-Australian_Open-F-Marin_Cilic-Roger_Federer,2,B-XC,48,10,1,2,7,29,19
20180128-M-Australian_Open-F-Marin_Cilic-Roger_Federer,2,B-DTM,19,1,0,0,1,10,9
20180128-M-Australian_Open-F-Marin_Cilic-Roger_Federer,2,B-DTL,10,8,1,0,7,2,8
20180128-M-Australian_Open-F-Marin_Cilic-Roger_Federer,2,S-XC,25,0,0,0,0,11,14
20180128-M-Australian_Open-F-Marin_Cilic-Roger_Federer,2,S-DTM,9,0,0,0,0,2,7
20180128-M-Australian_Open-F-Marin_Cilic-Roger_Federer,2,S-DTL,1,0,0,0,0,0,1
19921108-M-Paris_Masters-F-Guy_Forget-Boris_Becker,1,F-XC,12,2,2,0,0,7,5
19921108-M-Paris_Masters-F-Guy_Forget-Boris_Becker,1,F-DTM,10,0,0,0,0,3,7
19921108-M-Paris_Masters-F-Guy_Forget-Boris_Becker,1,F-DTL,3,1,0,0,1,0,3
19921108-M-Paris_Masters-F-Guy_Forget-Boris_Becker,1,F-IO,8,5,4,0,1,5,3
19921108-M-Paris_Masters-F-Guy_Forget-Boris_Becker,1,F-II,1,1,1,0,0,1,0
19921108-M-Paris_Masters-F-Guy_Forget-Boris_Becker,1,B-XC,10,4,0,1,3,2,8
19921108-M-Paris_Masters-F-Guy_Forget-Boris_Becker,1,B-DTM,7,0,0,0,0,0,7
19921108-M-Paris_Masters-F-Guy_Forget-Boris_Becker,1,B-DTL,8,5,0,0,5,1,7
19921108-M-Paris_Masters-F-Guy_Forget-Boris_Becker,1,B-IO,2,1,0,0,1,0,2
19921108-M-Paris_Masters-F-Guy_Forget-Boris_Becker,1,S-XC,1,0,0,0,0,0,1
19921108-M-Paris_Masters-F-Guy_Forget-Boris_Becker,1,S-DTM,5,1,0,0,1,2,3
19921108-M-Paris_Masters-F-Guy_Forget-Boris_Becker,1,S-DTL,8,1,0,0,1,3,5
19921108-M-Paris_Masters-F-Guy_Forget-Boris_Becker,2,F-XC,16,2,0,2,0,12,4
19921108-M-Paris_Masters-F-Guy_Forget-Boris_Becker,2,F-DTM,5,0,0,0,0,5,0
19921108-M-Paris_Masters-F-Guy_Forget-Boris_Becker,2,F-DTL,5,4,3,0,1,3,2
19921108-M-Paris_Masters-F-Guy_Forget-Boris_Becker,2,F-IO,2,0,0,0,0,1,1
19921108-M-Paris_Masters-F-Guy_Forget-Boris_Becker,2,B-XC,12,6,2,1,3,7,5
19921108-M-Paris_Masters-F-Guy_Forget-Boris_Becker,2,B-DTM,4,1,0,1,0,1,3
19921108-M-Paris_Masters-F-Guy_Forget-Boris_Becker,2,B-DTL,9,3,1,0,2,5,4
19921108-M-Paris_Masters-F-Guy_Forget-Boris_Becker,2,B-IO,8,3,1,0,2,6,2
19921108-M-Paris_Masters-F-Guy_Forget-Boris_Becker,2,S-XC,2,0,0,0,0,0,2
19921108-M-Paris_Masters-F-Guy_Forget-Boris_Becker,2,S-DTM,1,0,0,0,0,0,1
19921108-M-Paris_Masters-F-Guy_Forget-Boris_Becker,2,S-DTL,1,0,0,0,0,1,0
20180126-M-Australian_Open-SF-Hyeon_Chung-Roger_Federer,1,F-XC,19,8,2,1,5,7,12
20180126-M-Australian_Open-SF-Hyeon_Chung-Roger_Federer,1,F-DTM,10,1,0,0,1,5,5
20180126-M-Australian_Open-SF-Hyeon_Chung-Roger_Federer,1,F-DTL,1,0,0,0,0,0,1
20180126-M-Australian_Open-SF-Hyeon_Chung-Roger_Federer,1,F-IO,7,4,2,0,2,5,2
20180126-M-Australian_Open-SF-Hyeon_Chung-Roger_Federer,1,F-II,1,1,1,0,0,1,0
20180126-M-Australian_Open-SF-Hyeon_Chung-Roger_Federer,1,B-XC,23,7,0,0,7,7,16
20180126-M-Australian_Open-SF-Hyeon_Chung-Roger_Federer,1,B-DTM,23,3,0,0,3,8,15
20180126-M-Australian_Open-SF-Hyeon_Chung-Roger_Federer,1,B-DTL,3,0,0,0,0,1,2
20180126-M-Australian_Open-SF-Hyeon_Chung-Roger_Federer,1,B-IO,1,0,0,0,0,1,0
20180126-M-Australian_Open-SF-Hyeon_Chung-Roger_Federer,1,S-XC,2,0,0,0,0,1,1
20180126-M-Australian_Open-SF-Hyeon_Chung-Roger_Federer,1,S-DTM,4,1,0,0,1,1,3
20180126-M-Australian_Open-SF-Hyeon_Chung-Roger_Federer,1,S-DTL,2,2,0,0,2,0,2
20180126-M-Australian_Open-SF-Hyeon_Chung-Roger_Federer,2,F-XC,18,11,6,1,4,11,7
20180126-M-Australian_Open-SF-Hyeon_Chung-Roger_Federer,2,F-DTM,20,2,0,0,2,11,9
20180126-M-Australian_Open-SF-Hyeon_Chung-Roger_Federer,2,F-DTL,6,2,2,0,0,4,2
20180126-M-Australian_Open-SF-Hyeon_Chung-Roger_Federer,2,F-IO,7,0,0,0,0,6,1
20180126-M-Australian_Open-SF-Hyeon_Chung-Roger_Federer,2,F-II,1,0,0,0,0,0,1
20180126-M-Australian_Open-SF-Hyeon_Chung-Roger_Federer,2,B-XC,7,1,0,0,1,4,3
20180126-M-Australian_Open-SF-Hyeon_Chung-Roger_Federer,2,B-DTM,7,4,1,0,3,3,4
20180126-M-Australian_Open-SF-Hyeon_Chung-Roger_Federer,2,B-DTL,4,3,1,0,2,2,2
20180126-M-Australian_Open-SF-Hyeon_Chung-Roger_Federer,2,B-IO,2,1,1,0,0,2,0
20180126-M-Australian_Open-SF-Hyeon_Chung-Roger_Federer,2,S-XC,5,0,0,0,0,1,4
20180126-M-Australian_Open-SF-Hyeon_Chung-Roger_Federer,2,S-DTM,6,0,0,0,0,4,2
20180126-M-Australian_Open-SF-Hyeon_Chung-Roger_Federer,2,S-DTL,2,0,0,0,0,2,0
19950730-M-Canada_Masters-F-Pete_Sampras-Andre_Agassi,1,F-XC,28,11,3,2,6,14,14
19950730-M-Canada_Masters-F-Pete_Sampras-Andre_Agassi,1,F-DTM,10,0,0,0,0,3,7
19950730-M-Canada_Masters-F-Pete_Sampras-Andre_Agassi,1,F-DTL,10,6,4,1,1,6,4
19950730-M-Canada_Masters-F-Pete_Sampras-Andre_Agassi,1,F-IO,20,6,4,0,2,14,6
19950730-M-Canada_Masters-F-Pete_Sampras-Andre_Agassi,1,F-II,4,1,0,0,1,2,2
19950730-M-Canada_Masters-F-Pete_Sampras-Andre_Agassi,1,B-XC,72,7,0,0,7,29,43
19950730-M-Canada_Masters-F-Pete_Sampras-Andre_Agassi,1,B-DTM,22,0,0,0,0,13,9
19950730-M-Canada_Masters-F-Pete_Sampras-Andre_Agassi,1,B-DTL,8,4,1,0,3,3,5
19950730-M-Canada_Masters-F-Pete_Sampras-Andre_Agassi,1,B-IO,1,1,1,0,0,1,0
19950730-M-Canada_Masters-F-Pete_Sampras-Andre_Agassi,1,S-XC,15,0,0,0,0,7,8
19950730-M-Canada_Masters-F-Pete_Sampras-Andre_Agassi,1,S-DTM,8,0,0,0,0,5,3
19950730-M-Canada_Masters-F-Pete_Sampras-Andre_Agassi,1,S-DTL,13,6,2,0,4,3,10
19950730-M-Canada_Masters-F-Pete_Sampras-Andre_Agassi,1,S-IO,2,0,0,0,0,0,2
19950730-M-Canada_Masters-F-Pete_Sampras-Andre_Agassi,2,F-XC,39,13,6,3,4,27,12
19950730-M-Canada_Masters-F-Pete_Sampras-Andre_Agassi,2,F-DTM,18,2,0,0,2,8,10
19950730-M-Canada_Masters-F-Pete_Sampras-Andre_Agassi,2,F-DTL,12,2,0,2,0,6,6
19950730-M-Canada_Masters-F-Pete_Sampras-Andre_Agassi,2,F-IO,39,10,4,1,5,21,18
19950730-M-Canada_Masters-F-Pete_Sampras-Andre_Agassi,2,F-II,8,5,3,2,0,7,1
19950730-M-Canada_Masters-F-Pete_Sampras-Andre_Agassi,2,B-XC,93,11,1,7,3,55,38
19950730-M-Canada_Masters-F-Pete_Sampras-Andre_Agassi,2,B-DTM,16,0,0,0,0,5,11
19950730-M-Canada_Masters-F-Pete_Sampras-Andre_Agassi,2,B-DTL,7,4,1,0,3,2,5
19950730-M-Canada_Masters-F-Pete_Sampras-Andre_Agassi,2,B-IO,2,0,0,0,0,1,1
19950730-M-Canada_Masters-F-Pete_Sampras-Andre_Agassi,2,S-XC,1,0,0,0,0,0,1
19950730-M-Canada_Masters-F-Pete_Sampras-Andre_Agassi,2,S-DTM,1,0,0,0,0,0,1
19950730-M-Canada_Masters-F-Pete_Sampras-Andre_Agassi,2,S-DTL,1,0,0,0,0,0,1
20140103-M-Brisbane-QF-Marin_Cilic-Kei_Nishikori,1,F-XC,36,16,4,1,11,16,20
20140103-M-Brisbane-QF-Marin_Cilic-Kei_Nishikori,1,F-DTM,19,4,0,0,4,4,15
20140103-M-Brisbane-QF-Marin_Cilic-Kei_Nishikori,1,F-DTL,6,4,1,0,3,2,4
20140103-M-Brisbane-QF-Marin_Cilic-Kei_Nishikori,1,F-IO,27,12,4,1,6,15,12
20140103-M-Brisbane-QF-Marin_Cilic-Kei_Nishikori,1,F-II,1,1,0,0,1,0,1
20140103-M-Brisbane-QF-Marin_Cilic-Kei_Nishikori,1,B-XC,42,9,2,0,6,23,19
20140103-M-Brisbane-QF-Marin_Cilic-Kei_Nishikori,1,B-DTM,52,9,0,0,9,22,30
20140103-M-Brisbane-QF-Marin_Cilic-Kei_Nishikori,1,B-DTL,7,5,2,1,2,5,2
20140103-M-Brisbane-QF-Marin_Cilic-Kei_Nishikori,1,B-IO,8,2,0,0,2,3,5
20140103-M-Brisbane-QF-Marin_Cilic-Kei_Nishikori,1,S-XC,15,1,0,0,1,5,10
20140103-M-Brisbane-QF-Marin_Cilic-Kei_Nishikori,1,S-DTM,14,2,0,0,2,3,11
20140103-M-Brisbane-QF-Marin_Cilic-Kei_Nishikori,1,S-IO,2,0,0,0,0,1,1
20140103-M-Brisbane-QF-Marin_Cilic-Kei_Nishikori,2,F-XC,36,16,5,4,7,25,11
20140103-M-Brisbane-QF-Marin_Cilic-Kei_Nishikori,2,F-DTM,38,6,0,0,6,18,20
20140103-M-Brisbane-QF-Marin_Cilic-Kei_Nishikori,2,F-DTL,7,2,1,0,1,4,3
20140103-M-Brisbane-QF-Marin_Cilic-Kei_Nishikori,2,F-IO,20,7,2,2,3,15,5
20140103-M-Brisbane-QF-Marin_Cilic-Kei_Nishikori,2,B-XC,60,5,1,1,3,27,33
20140103-M-Brisbane-QF-Marin_Cilic-Kei_Nishikori,2,B-DTM,43,5,0,1,4,23,20
20140103-M-Brisbane-QF-Marin_Cilic-Kei_Nishikori,2,B-DTL,10,3,2,0,2,3,7
20140103-M-Brisbane-QF-Marin_Cilic-Kei_Nishikori,2,B-IO,3,3,2,0,1,2,1
20140103-M-Brisbane-QF-Marin_Cilic-Kei_Nishikori,2,B-II,2,1,0,1,0,2,0
20140103-M-Brisbane-QF-Marin_Cilic-Kei_Nishikori,2,S-XC,7,0,0,0,0,2,5
20140103-M-Brisbane-QF-Marin_Cilic-Kei_Nishikori,2,S-DTM,3,0,0,0,0,0,3
20140103-M-Brisbane-QF-Marin_Cilic-Kei_Nishikori,2,S-DTL,1,0,0,0,0,0,1
19951119-M-Tour_Finals-F-Michael_Chang-Boris_Becker,1,F-XC,21,7,3,3,1,16,5
19951119-M-Tour_Finals-F-Michael_Chang-Boris_Becker,1,F-DTM,16,1,0,0,1,10,6
19951119-M-Tour_Finals-F-Michael_Chang-Boris_Becker,1,F-DTL,6,3,2,1,0,5,1
19951119-M-Tour_Finals-F-Michael_Chang-Boris_Becker,1,F-IO,19,8,4,2,2,12,7
19951119-M-Tour_Finals-F-Michael_Chang-Boris_Becker,1,F-II,6,3,2,0,1,3,3
19951119-M-Tour_Finals-F-Michael_Chang-Boris_Becker,1,B-XC,17,2,0,1,1,8,9
19951119-M-Tour_Finals-F-Michael_Chang-Boris_Becker,1,B-DTM,17,2,1,0,1,8,9
19951119-M-Tour_Finals-F-Michael_Chang-Boris_Becker,1,B-DTL,3,1,0,0,1,1,2
19951119-M-Tour_Finals-F-Michael_Chang-Boris_Becker,1,B-IO,2,0,0,0,0,1,1
19951119-M-Tour_Finals-F-Michael_Chang-Boris_Becker,1,S-XC,4,0,0,0,0,1,3
19951119-M-Tour_Finals-F-Michael_Chang-Boris_Becker,1,S-DTM,4,0,0,0,0,2,2
19951119-M-Tour_Finals-F-Michael_Chang-Boris_Becker,1,S-DTL,1,0,0,0,0,0,1
19951119-M-Tour_Finals-F-Michael_Chang-Boris_Becker,2,F-XC,14,6,4,1,1,6,8
19951119-M-Tour_Finals-F-Michael_Chang-Boris_Becker,2,F-DTM,11,2,0,0,2,4,7
19951119-M-Tour_Finals-F-Michael_Chang-Boris_Becker,2,F-DTL,5,3,1,0,2,2,3
19951119-M-Tour_Finals-F-Michael_Chang-Boris_Becker,2,F-IO,13,3,1,2,0,10,3
19951119-M-Tour_Finals-F-Michael_Chang-Boris_Becker,2,B-XC,9,2,1,0,1,2,7
19951119-M-Tour_Finals-F-Michael_Chang-Boris_Becker,2,B-DTM,9,0,0,0,0,5,4
19951119-M-Tour_Finals-F-Michael_Chang-Boris_Becker,2,B-DTL,5,4,2,1,1,4,1
19951119-M-Tour_Finals-F-Michael_Chang-Boris_Becker,2,B-IO,4,3,0,1,2,2,2
19951119-M-Tour_Finals-F-Michael_Chang-Boris_Becker,2,S-XC,8,2,0,0,2,3,5
19951119-M-Tour_Finals-F-Michael_Chang-Boris_Becker,2,S-DTM,1,0,0,0,0,0,1
19951119-M-Tour_Finals-F-Michael_Chang-Boris_Becker,2,S-DTL,1,0,0,0,0,0,1
19951119-M-Tour_Finals-F-Michael_Chang-Boris_Becker,2,S-IO,1,1,1,0,0,1,0
20001203-M-Tour_Finals-F-Andre_Agassi-Gustavo_Kuerten,1,F-XC,56,9,1,4,4,26,30
20001203-M-Tour_Finals-F-Andre_Agassi-Gustavo_Kuerten,1,F-DTM,19,1,0,0,1,9,10
20001203-M-Tour_Finals-F-Andre_Agassi-Gustavo_Kuerten,1,F-DTL,9,2,0,0,2,4,5
20001203-M-Tour_Finals-F-Andre_Agassi-Gustavo_Kuerten,1,F-IO,22,3,1,0,2,13,9
20001203-M-Tour_Finals-F-Andre_Agassi-Gustavo_Kuerten,1,F-II,7,2,1,1,0,4,3
20001203-M-Tour_Finals-F-Andre_Agassi-Gustavo_Kuerten,1,B-XC,74,11,0,0,11,25,49
20001203-M-Tour_Finals-F-Andre_Agassi-Gustavo_Kuerten,1,B-DTM,21,3,0,1,2,8,13
20001203-M-Tour_Finals-F-Andre_Agassi-Gustavo_Kuerten,1,B-DTL,12,4,0,2,2,7,5
20001203-M-Tour_Finals-F-Andre_Agassi-Gustavo_Kuerten,1,B-IO,2,0,0,0,0,2,0
20001203-M-Tour_Finals-F-Andre_Agassi-Gustavo_Kuerten,1,S-XC,4,0,0,0,0,2,2
20001203-M-Tour_Finals-F-Andre_Agassi-Gustavo_Kuerten,1,S-DTM,7,0,0,0,0,2,5
20001203-M-Tour_Finals-F-Andre_Agassi-Gustavo_Kuerten,1,S-DTL,2,0,0,0,0,1,1
20001203-M-Tour_Finals-F-Andre_Agassi-Gustavo_Kuerten,2,F-XC,42,10,4,1,5,23,19
20001203-M-Tour_Finals-F-Andre_Agassi-Gustavo_Kuerten,2,F-DTM,29,2,1,0,1,16,13
20001203-M-Tour_Finals-F-Andre_Agassi-Gustavo_Kuerten,2,F-DTL,17,6,1,2,3,6,11
20001203-M-Tour_Finals-F-Andre_Agassi-Gustavo_Kuerten,2,F-IO,21,6,2,1,3,13,8
20001203-M-Tour_Finals-F-Andre_Agassi-Gustavo_Kuerten,2,B-XC,66,10,2,0,8,40,26
20001203-M-Tour_Finals-F-Andre_Agassi-Gustavo_Kuerten,2,B-DTM,23,7,0,1,6,10,13
20001203-M-Tour_Finals-F-Andre_Agassi-Gustavo_Kuerten,2,B-DTL,20,14,8,0,6,11,9
20001203-M-Tour_Finals-F-Andre_Agassi-Gustavo_Kuerten,2,B-IO,6,5,1,1,3,3,3
20001203-M-Tour_Finals-F-Andre_Agassi-Gustavo_Kuerten,2,S-XC,11,0,0,0,0,7,4
20001203-M-Tour_Finals-F-Andre_Agassi-Gustavo_Kuerten,2,S-DTM,5,0,0,0,0,1,4
20001203-M-Tour_Finals-F-Andre_Agassi-Gustavo_Kuerten,2,S-DTL,1,0,0,0,0,0,1
20001119-M-Paris_Masters-F-Mark_Philippoussis-Marat_Safin,1,F-XC,41,20,7,6,7,26,15
20001119-M-Paris_Masters-F-Mark_Philippoussis-Marat_Safin,1,F-DTM,23,1,0,0,1,9,14
20001119-M-Paris_Masters-F-Mark_Philippoussis-Marat_Safin,1,F-DTL,10,3,2,1,0,8,2
20001119-M-Paris_Masters-F-Mark_Philippoussis-Marat_Safin,1,F-IO,25,5,1,2,2,16,9
20001119-M-Paris_Masters-F-Mark_Philippoussis-Marat_Safin,1,F-II,1,0,0,0,0,1,0
20001119-M-Paris_Masters-F-Mark_Philippoussis-Marat_Safin,1,B-XC,42,11,2,4,5,21,21
20001119-M-Paris_Masters-F-Mark_Philippoussis-Marat_Safin,1,B-DTM,40,0,0,0,0,21,19
20001119-M-Paris_Masters-F-Mark_Philippoussis-Marat_Safin,1,B-DTL,10,4,0,0,4,5,5
20001119-M-Paris_Masters-F-Mark_Philippoussis-Marat_Safin,1,B-IO,2,1,1,0,0,1,1
20001119-M-Paris_Masters-F-Mark_Philippoussis-Marat_Safin,1,S-XC,10,1,0,0,1,4,6
20001119-M-Paris_Masters-F-Mark_Philippoussis-Marat_Safin,1,S-DTM,22,1,0,0,1,10,12
20001119-M-Paris_Masters-F-Mark_Philippoussis-Marat_Safin,1,S-DTL,5,2,1,0,1,3,2
20001119-M-Paris_Masters-F-Mark_Philippoussis-Marat_Safin,2,F-XC,39,12,6,4,2,22,17
20001119-M-Paris_Masters-F-Mark_Philippoussis-Marat_Safin,2,F-DTM,25,2,0,0,2,8,17
20001119-M-Paris_Masters-F-Mark_Philippoussis-Marat_Safin,2,F-DTL,11,3,1,1,1,6,5
20001119-M-Paris_Masters-F-Mark_Philippoussis-Marat_Safin,2,F-IO,25,10,3,4,3,17,8
20001119-M-Paris_Masters-F-Mark_Philippoussis-Marat_Safin,2,F-II,1,1,0,1,0,1,0
20001119-M-Paris_Masters-F-Mark_Philippoussis-Marat_Safin,2,B-XC,86,14,1,4,9,39,47
20001119-M-Paris_Masters-F-Mark_Philippoussis-Marat_Safin,2,B-DTM,37,4,0,2,2,15,22
20001119-M-Paris_Masters-F-Mark_Philippoussis-Marat_Safin,2,B-DTL,15,14,8,1,5,9,6
20001119-M-Paris_Masters-F-Mark_Philippoussis-Marat_Safin,2,B-IO,8,5,2,2,1,6,2
20001119-M-Paris_Masters-F-Mark_Philippoussis-Marat_Safin,2,S-XC,4,0,0,0,0,2,2
20001119-M-Paris_Masters-F-Mark_Philippoussis-Marat_Safin,2,S-DTM,5,2,0,0,2,0,5
20001119-M-Paris_Masters-F-Mark_Philippoussis-Marat_Safin,2,S-DTL,2,2,1,0,1,1,1
20180217-M-Chennai_CH-R32-Jordan_Thompson-Karim_Mohamed_Maamoun,1,F-XC,13,7,2,3,2,9,4
20180217-M-Chennai_CH-R32-Jordan_Thompson-Karim_Mohamed_Maamoun,1,F-DTM,28,3,0,2,1,16,12
20180217-M-Chennai_CH-R32-Jordan_Thompson-Karim_Mohamed_Maamoun,1,F-DTL,3,2,0,2,0,2,1
20180217-M-Chennai_CH-R32-Jordan_Thompson-Karim_Mohamed_Maamoun,1,F-IO,26,3,1,0,2,13,13
20180217-M-Chennai_CH-R32-Jordan_Thompson-Karim_Mohamed_Maamoun,1,B-XC,26,5,1,0,4,11,15
20180217-M-Chennai_CH-R32-Jordan_Thompson-Karim_Mohamed_Maamoun,1,B-DTM,46,5,1,1,3,19,27
20180217-M-Chennai_CH-R32-Jordan_Thompson-Karim_Mohamed_Maamoun,1,B-DTL,9,6,3,2,1,7,2
20180217-M-Chennai_CH-R32-Jordan_Thompson-Karim_Mohamed_Maamoun,1,B-IO,3,1,0,0,1,2,1
20180217-M-Chennai_CH-R32-Jordan_Thompson-Karim_Mohamed_Maamoun,1,S-XC,7,1,0,0,1,4,3
20180217-M-Chennai_CH-R32-Jordan_Thompson-Karim_Mohamed_Maamoun,1,S-DTM,6,0,0,0,0,4,2
20180217-M-Chennai_CH-R32-Jordan_Thompson-Karim_Mohamed_Maamoun,1,S-IO,1,0,0,0,0,1,0
20180217-M-Chennai_CH-R32-Jordan_Thompson-Karim_Mohamed_Maamoun,2,F-XC,32,11,5,3,3,17,15
20180217-M-Chennai_CH-R32-Jordan_Thompson-Karim_Mohamed_Maamoun,2,F-DTM,31,2,0,1,1,13,18
20180217-M-Chennai_CH-R32-Jordan_Thompson-Karim_Mohamed_Maamoun,2,F-DTL,3,1,0,0,1,1,2
20180217-M-Chennai_CH-R32-Jordan_Thompson-Karim_Mohamed_Maamoun,2,F-IO,30,7,3,1,3,15,15
20180217-M-Chennai_CH-R32-Jordan_Thompson-Karim_Mohamed_Maamoun,2,F-II,3,3,1,1,1,2,1
20180217-M-Chennai_CH-R32-Jordan_Thompson-Karim_Mohamed_Maamoun,2,B-XC,26,5,1,2,2,14,12
20180217-M-Chennai_CH-R32-Jordan_Thompson-Karim_Mohamed_Maamoun,2,B-DTM,38,9,0,1,8,17,21
20180217-M-Chennai_CH-R32-Jordan_Thompson-Karim_Mohamed_Maamoun,2,B-DTL,2,1,1,0,0,2,0
20180217-M-Chennai_CH-R32-Jordan_Thompson-Karim_Mohamed_Maamoun,2,B-IO,4,3,0,0,3,0,4
20180217-M-Chennai_CH-R32-Jordan_Thompson-Karim_Mohamed_Maamoun,2,S-XC,8,1,0,0,1,3,5
20180217-M-Chennai_CH-R32-Jordan_Thompson-Karim_Mohamed_Maamoun,2,S-DTM,4,1,0,0,1,1,3
20180217-M-Chennai_CH-R32-Jordan_Thompson-Karim_Mohamed_Maamoun,2,S-DTL,1,1,1,0,0,1,0
20180117-M-Koblenz_CH-R32-Christopher_Heyman-Karim_Mohamed_Maamoun,1,F-XC,34,5,1,2,2,19,15
20180117-M-Koblenz_CH-R32-Christopher_Heyman-Karim_Mohamed_Maamoun,1,F-DTM,31,3,0,0,3,14,17
20180117-M-Koblenz_CH-R32-Christopher_Heyman-Karim_Mohamed_Maamoun,1,F-DTL,8,4,3,1,0,7,1
20180117-M-Koblenz_CH-R32-Christopher_Heyman-Karim_Mohamed_Maamoun,1,F-IO,11,5,0,3,2,8,3
20180117-M-Koblenz_CH-R32-Christopher_Heyman-Karim_Mohamed_Maamoun,1,F-II,5,3,2,1,0,5,0
20180117-M-Koblenz_CH-R32-Christopher_Heyman-Karim_Mohamed_Maamoun,1,B-XC,8,1,1,0,0,6,2
20180117-M-Koblenz_CH-R32-Christopher_Heyman-Karim_Mohamed_Maamoun,1,B-DTM,18,1,0,0,1,9,9
20180117-M-Koblenz_CH-R32-Christopher_Heyman-Karim_Mohamed_Maamoun,1,B-DTL,4,1,0,0,1,0,4
20180117-M-Koblenz_CH-R32-Christopher_Heyman-Karim_Mohamed_Maamoun,1,B-IO,2,0,0,0,0,1,1
20180117-M-Koblenz_CH-R32-Christopher_Heyman-Karim_Mohamed_Maamoun,1,S-XC,1,0,0,0,0,0,1
20180117-M-Koblenz_CH-R32-Christopher_Heyman-Karim_Mohamed_Maamoun,1,S-DTM,6,0,0,0,0,5,1
20180117-M-Koblenz_CH-R32-Christopher_Heyman-Karim_Mohamed_Maamoun,1,S-DTL,7,1,0,0,1,4,3
20180117-M-Koblenz_CH-R32-Christopher_Heyman-Karim_Mohamed_Maamoun,1,S-IO,1,0,0,0,0,1,0
20180117-M-Koblenz_CH-R32-Christopher_Heyman-Karim_Mohamed_Maamoun,2,F-XC,29,6,4,0,2,14,15
20180117-M-Koblenz_CH-R32-Christopher_Heyman-Karim_Mohamed_Maamoun,2,F-DTM,24,3,0,0,3,10,14
20180117-M-Koblenz_CH-R32-Christopher_Heyman-Karim_Mohamed_Maamoun,2,F-DTL,2,2,2,0,0,2,0
20180117-M-Koblenz_CH-R32-Christopher_Heyman-Karim_Mohamed_Maamoun,2,F-IO,13,6,1,1,4,7,6
20180117-M-Koblenz_CH-R32-Christopher_Heyman-Karim_Mohamed_Maamoun,2,F-II,2,2,1,0,1,1,1
20180117-M-Koblenz_CH-R32-Christopher_Heyman-Karim_Mohamed_Maamoun,2,B-XC,21,7,0,1,6,8,13
20180117-M-Koblenz_CH-R32-Christopher_Heyman-Karim_Mohamed_Maamoun,2,B-DTM,31,0,0,0,0,15,16
20180117-M-Koblenz_CH-R32-Christopher_Heyman-Karim_Mohamed_Maamoun,2,B-DTL,8,4,0,0,4,2,6
20180117-M-Koblenz_CH-R32-Christopher_Heyman-Karim_Mohamed_Maamoun,2,B-IO,5,1,1,0,0,4,1
20180117-M-Koblenz_CH-R32-Christopher_Heyman-Karim_Mohamed_Maamoun,2,S-XC,2,1,0,0,1,0,2
20180117-M-Koblenz_CH-R32-Christopher_Heyman-Karim_Mohamed_Maamoun,2,S-DTM,7,2,0,2,0,4,3
20180117-M-Koblenz_CH-R32-Christopher_Heyman-Karim_Mohamed_Maamoun,2,S-DTL,2,0,0,0,0,0,2
20000326-M-Miami_Masters-F-Pete_Sampras-Gustavo_Kuerten,1,F-XC,7,5,1,0,4,2,5
20000326-M-Miami_Masters-F-Pete_Sampras-Gustavo_Kuerten,1,F-DTM,7,1,0,0,1,4,3
20000326-M-Miami_Masters-F-Pete_Sampras-Gustavo_Kuerten,1,F-DTL,4,2,2,0,0,4,0
20000326-M-Miami_Masters-F-Pete_Sampras-Gustavo_Kuerten,1,F-IO,9,3,0,0,3,5,4
20000326-M-Miami_Masters-F-Pete_Sampras-Gustavo_Kuerten,1,F-II,4,3,1,1,1,3,1
20000326-M-Miami_Masters-F-Pete_Sampras-Gustavo_Kuerten,1,B-XC,20,3,2,0,1,11,9
20000326-M-Miami_Masters-F-Pete_Sampras-Gustavo_Kuerten,1,B-DTM,2,0,0,0,0,1,1
20000326-M-Miami_Masters-F-Pete_Sampras-Gustavo_Kuerten,1,B-DTL,9,7,0,3,4,4,5
20000326-M-Miami_Masters-F-Pete_Sampras-Gustavo_Kuerten,1,B-IO,1,1,0,0,1,0,1
20000326-M-Miami_Masters-F-Pete_Sampras-Gustavo_Kuerten,1,S-XC,15,2,0,1,1,10,5
20000326-M-Miami_Masters-F-Pete_Sampras-Gustavo_Kuerten,1,S-DTM,3,0,0,0,0,3,0
20000326-M-Miami_Masters-F-Pete_Sampras-Gustavo_Kuerten,1,S-DTL,3,2,0,1,1,1,2
20000326-M-Miami_Masters-F-Pete_Sampras-Gustavo_Kuerten,2,F-XC,26,15,8,3,4,13,13
20000326-M-Miami_Masters-F-Pete_Sampras-Gustavo_Kuerten,2,F-DTM,8,0,0,0,0,2,6
20000326-M-Miami_Masters-F-Pete_Sampras-Gustavo_Kuerten,2,F-DTL,9,3,1,0,2,2,7
20000326-M-Miami_Masters-F-Pete_Sampras-Gustavo_Kuerten,2,F-IO,15,5,2,2,1,9,6
20000326-M-Miami_Masters-F-Pete_Sampras-Gustavo_Kuerten,2,F-II,3,3,0,2,1,2,1
20000326-M-Miami_Masters-F-Pete_Sampras-Gustavo_Kuerten,2,B-XC,54,13,4,3,6,24,30
20000326-M-Miami_Masters-F-Pete_Sampras-Gustavo_Kuerten,2,B-DTM,20,3,0,1,2,6,14
20000326-M-Miami_Masters-F-Pete_Sampras-Gustavo_Kuerten,2,B-DTL,10,7,1,3,3,7,3
20000326-M-Miami_Masters-F-Pete_Sampras-Gustavo_Kuerten,2,B-IO,5,5,3,1,1,4,1
20000326-M-Miami_Masters-F-Pete_Sampras-Gustavo_Kuerten,2,S-XC,4,0,0,0,0,2,2
20000326-M-Miami_Masters-F-Pete_Sampras-Gustavo_Kuerten,2,S-DTM,3,0,0,0,0,0,3
20000326-M-Miami_Masters-F-Pete_Sampras-Gustavo_Kuerten,2,S-DTL,1,0,0,0,0,0,1
20000326-M-Miami_Masters-F-Pete_Sampras-Gustavo_Kuerten,2,S-IO,1,0,0,0,0,0,1
19941120-M-Tour_Finals-F-Pete_Sampras-Boris_Becker,1,F-XC,13,3,1,1,1,8,5
19941120-M-Tour_Finals-F-Pete_Sampras-Boris_Becker,1,F-DTM,6,1,1,0,0,3,3
19941120-M-Tour_Finals-F-Pete_Sampras-Boris_Becker,1,F-DTL,7,4,2,1,1,6,1
19941120-M-Tour_Finals-F-Pete_Sampras-Boris_Becker,1,F-IO,10,4,2,0,2,7,3
19941120-M-Tour_Finals-F-Pete_Sampras-Boris_Becker,1,F-II,1,1,1,0,0,1,0
19941120-M-Tour_Finals-F-Pete_Sampras-Boris_Becker,1,B-XC,22,8,3,3,2,15,7
19941120-M-Tour_Finals-F-Pete_Sampras-Boris_Becker,1,B-DTM,7,0,0,0,0,4,3
19941120-M-Tour_Finals-F-Pete_Sampras-Boris_Becker,1,B-DTL,11,10,7,0,3,7,4
19941120-M-Tour_Finals-F-Pete_Sampras-Boris_Becker,1,B-IO,3,2,1,1,0,3,0
19941120-M-Tour_Finals-F-Pete_Sampras-Boris_Becker,1,S-XC,3,1,1,0,0,2,1
19941120-M-Tour_Finals-F-Pete_Sampras-Boris_Becker,1,S-DTM,3,1,1,0,0,2,1
19941120-M-Tour_Finals-F-Pete_Sampras-Boris_Becker,2,F-XC,8,4,2,0,2,4,4
19941120-M-Tour_Finals-F-Pete_Sampras-Boris_Becker,2,F-DTM,6,0,0,0,0,3,3
19941120-M-Tour_Finals-F-Pete_Sampras-Boris_Becker,2,F-DTL,8,3,0,0,3,1,7
19941120-M-Tour_Finals-F-Pete_Sampras-Boris_Becker,2,F-IO,3,3,0,0,3,0,3
19941120-M-Tour_Finals-F-Pete_Sampras-Boris_Becker,2,B-XC,11,0,0,0,0,4,7
19941120-M-Tour_Finals-F-Pete_Sampras-Boris_Becker,2,B-DTM,7,0,0,0,0,2,5
19941120-M-Tour_Finals-F-Pete_Sampras-Boris_Becker,2,B-DTL,4,1,0,0,1,0,4
19941120-M-Tour_Finals-F-Pete_Sampras-Boris_Becker,2,B-IO,1,0,0,0,0,0,1
19941120-M-Tour_Finals-F-Pete_Sampras-Boris_Becker,2,S-XC,4,1,0,1,0,2,2
19941120-M-Tour_Finals-F-Pete_Sampras-Boris_Becker,2,S-DTM,2,0,0,0,0,0,2
19941120-M-Tour_Finals-F-Pete_Sampras-Boris_Becker,2,S-DTL,2,1,0,1,0,2,0
19971116-M-Tour_Finals-F-Pete_Sampras-Yevgeny_Kafelnikov,1,F-XC,21,12,5,4,3,16,5
19971116-M-Tour_Finals-F-Pete_Sampras-Yevgeny_Kafelnikov,1,F-DTM,5,0,0,0,0,4,1
19971116-M-Tour_Finals-F-Pete_Sampras-Yevgeny_Kafelnikov,1,F-DTL,5,2,2,0,0,4,1
19971116-M-Tour_Finals-F-Pete_Sampras-Yevgeny_Kafelnikov,1,F-IO,11,4,2,1,1,9,2
19971116-M-Tour_Finals-F-Pete_Sampras-Yevgeny_Kafelnikov,1,F-II,6,5,3,1,1,5,1
19971116-M-Tour_Finals-F-Pete_Sampras-Yevgeny_Kafelnikov,1,B-XC,31,6,0,4,2,19,12
19971116-M-Tour_Finals-F-Pete_Sampras-Yevgeny_Kafelnikov,1,B-DTM,16,5,0,0,5,6,10
19971116-M-Tour_Finals-F-Pete_Sampras-Yevgeny_Kafelnikov,1,B-DTL,7,3,2,0,1,5,2
19971116-M-Tour_Finals-F-Pete_Sampras-Yevgeny_Kafelnikov,1,B-IO,1,0,0,0,0,0,1
19971116-M-Tour_Finals-F-Pete_Sampras-Yevgeny_Kafelnikov,1,S-XC,11,0,0,0,0,4,7
19971116-M-Tour_Finals-F-Pete_Sampras-Yevgeny_Kafelnikov,1,S-DTM,4,0,0,0,0,2,2
19971116-M-Tour_Finals-F-Pete_Sampras-Yevgeny_Kafelnikov,1,S-DTL,1,1,0,0,1,0,1
19971116-M-Tour_Finals-F-Pete_Sampras-Yevgeny_Kafelnikov,2,F-XC,24,9,1,4,4,7,17
19971116-M-Tour_Finals-F-Pete_Sampras-Yevgeny_Kafelnikov,2,F-DTM,6,0,0,0,0,1,5
19971116-M-Tour_Finals-F-Pete_Sampras-Yevgeny_Kafelnikov,2,F-DTL,9,1,1,0,0,5,4
19971116-M-Tour_Finals-F-Pete_Sampras-Yevgeny_Kafelnikov,2,F-IO,21,5,0,4,1,11,10
19971116-M-Tour_Finals-F-Pete_Sampras-Yevgeny_Kafelnikov,2,B-XC,36,6,0,2,4,17,19
19971116-M-Tour_Finals-F-Pete_Sampras-Yevgeny_Kafelnikov,2,B-DTM,7,1,0,0,1,4,3
19971116-M-Tour_Finals-F-Pete_Sampras-Yevgeny_Kafelnikov,2,B-DTL,9,5,2,0,3,4,5
19971116-M-Tour_Finals-F-Pete_Sampras-Yevgeny_Kafelnikov,2,B-IO,3,2,0,0,2,1,2
19971116-M-Tour_Finals-F-Pete_Sampras-Yevgeny_Kafelnikov,2,S-XC,10,1,0,1,0,1,9
19971116-M-Tour_Finals-F-Pete_Sampras-Yevgeny_Kafelnikov,2,S-DTM,3,0,0,0,0,0,3
19971116-M-Tour_Finals-F-Pete_Sampras-Yevgeny_Kafelnikov,2,S-DTL,1,0,0,0,0,0,1
19980816-M-Cincinnati_Masters-F-Pete_Sampras-Patrick_Rafter,1,F-XC,1,1,1,0,0,1,0
19980816-M-Cincinnati_Masters-F-Pete_Sampras-Patrick_Rafter,1,F-DTM,2,0,0,0,0,0,2
19980816-M-Cincinnati_Masters-F-Pete_Sampras-Patrick_Rafter,1,F-DTL,1,1,1,0,0,1,0
19980816-M-Cincinnati_Masters-F-Pete_Sampras-Patrick_Rafter,1,F-IO,3,3,2,0,1,2,1
19980816-M-Cincinnati_Masters-F-Pete_Sampras-Patrick_Rafter,1,F-II,2,1,0,0,1,1,1
19980816-M-Cincinnati_Masters-F-Pete_Sampras-Patrick_Rafter,1,B-XC,4,1,0,1,0,2,2
19980816-M-Cincinnati_Masters-F-Pete_Sampras-Patrick_Rafter,1,B-DTM,2,1,0,0,1,1,1
19980816-M-Cincinnati_Masters-F-Pete_Sampras-Patrick_Rafter,1,B-DTL,2,1,0,0,1,0,2
19980816-M-Cincinnati_Masters-F-Pete_Sampras-Patrick_Rafter,1,B-IO,1,1,0,0,1,0,1
19980816-M-Cincinnati_Masters-F-Pete_Sampras-Patrick_Rafter,1,S-XC,3,1,0,0,1,1,2
19980816-M-Cincinnati_Masters-F-Pete_Sampras-Patrick_Rafter,1,S-DTM,1,0,0,0,0,0,1
19980816-M-Cincinnati_Masters-F-Pete_Sampras-Patrick_Rafter,2,F-XC,1,1,0,0,1,0,1
19980816-M-Cincinnati_Masters-F-Pete_Sampras-Patrick_Rafter,2,F-DTL,2,2,2,0,0,2,0
19980816-M-Cincinnati_Masters-F-Pete_Sampras-Patrick_Rafter,2,B-XC,7,2,1,0,1,4,3
19980816-M-Cincinnati_Masters-F-Pete_Sampras-Patrick_Rafter,2,B-DTL,1,1,1,0,0,1,0
19980816-M-Cincinnati_Masters-F-Pete_Sampras-Patrick_Rafter,2,B-IO,1,0,0,0,0,1,0
19980816-M-Cincinnati_Masters-F-Pete_Sampras-Patrick_Rafter,2,S-XC,2,2,0,2,0,2,0
19980816-M-Cincinnati_Masters-F-Pete_Sampras-Patrick_Rafter,2,S-DTM,1,0,0,0,0,1,0
19980816-M-Cincinnati_Masters-F-Pete_Sampras-Patrick_Rafter,2,S-DTL,2,0,0,0,0,2,0
19980816-M-Cincinnati_Masters-F-Pete_Sampras-Patrick_Rafter,2,S-IO,1,0,0,0,0,1,0
19980809-M-Canada_Masters-F-Patrick_Rafter-Richard_Krajicek,1,F-XC,7,4,1,2,1,5,2
19980809-M-Canada_Masters-F-Patrick_Rafter-Richard_Krajicek,1,F-DTM,1,0,0,0,0,0,1
19980809-M-Canada_Masters-F-Patrick_Rafter-Richard_Krajicek,1,F-DTL,6,1,1,0,0,4,2
19980809-M-Canada_Masters-F-Patrick_Rafter-Richard_Krajicek,1,F-IO,3,2,2,0,0,3,0
19980809-M-Canada_Masters-F-Patrick_Rafter-Richard_Krajicek,1,B-XC,3,2,2,0,0,2,1
19980809-M-Canada_Masters-F-Patrick_Rafter-Richard_Krajicek,1,B-DTL,2,1,0,0,1,1,1
19980809-M-Canada_Masters-F-Patrick_Rafter-Richard_Krajicek,1,B-IO,2,1,1,0,0,1,1
19980809-M-Canada_Masters-F-Patrick_Rafter-Richard_Krajicek,1,S-XC,5,1,1,0,0,2,3
19980809-M-Canada_Masters-F-Patrick_Rafter-Richard_Krajicek,2,F-XC,6,3,1,0,2,3,3
19980809-M-Canada_Masters-F-Patrick_Rafter-Richard_Krajicek,2,F-IO,1,0,0,0,0,1,0
19980809-M-Canada_Masters-F-Patrick_Rafter-Richard_Krajicek,2,F-II,1,1,1,0,0,1,0
19980809-M-Canada_Masters-F-Patrick_Rafter-Richard_Krajicek,2,B-XC,2,2,0,0,2,0,2
19980809-M-Canada_Masters-F-Patrick_Rafter-Richard_Krajicek,2,B-DTM,2,1,0,1,0,1,1
19980809-M-Canada_Masters-F-Patrick_Rafter-Richard_Krajicek,2,B-DTL,3,2,0,2,0,3,0
19980809-M-Canada_Masters-F-Patrick_Rafter-Richard_Krajicek,2,S-XC,3,0,0,0,0,2,1
19980809-M-Canada_Masters-F-Patrick_Rafter-Richard_Krajicek,2,S-DTM,1,0,0,0,0,1,0
19980809-M-Canada_Masters-F-Patrick_Rafter-Richard_Krajicek,2,S-DTL,3,1,1,0,0,2,1
19980809-M-Canada_Masters-F-Patrick_Rafter-Richard_Krajicek,2,S-IO,1,0,0,0,0,0,1
19960707-M-Wimbledon-F-Richard_Krajicek-Malivai_Washington,1,F-XC,14,5,2,2,1,8,6
19960707-M-Wimbledon-F-Richard_Krajicek-Malivai_Washington,1,F-DTM,5,0,0,0,0,4,1
19960707-M-Wimbledon-F-Richard_Krajicek-Malivai_Washington,1,F-DTL,10,5,5,0,0,8,2
19960707-M-Wimbledon-F-Richard_Krajicek-Malivai_Washington,1,F-IO,10,6,5,1,0,9,1
19960707-M-Wimbledon-F-Richard_Krajicek-Malivai_Washington,1,F-II,3,1,1,0,0,3,0
19960707-M-Wimbledon-F-Richard_Krajicek-Malivai_Washington,1,B-XC,3,1,0,0,1,0,3
19960707-M-Wimbledon-F-Richard_Krajicek-Malivai_Washington,1,B-DTM,3,0,0,0,0,0,3
19960707-M-Wimbledon-F-Richard_Krajicek-Malivai_Washington,1,B-DTL,3,0,0,0,0,2,1
19960707-M-Wimbledon-F-Richard_Krajicek-Malivai_Washington,1,B-IO,2,2,1,0,1,1,1
19960707-M-Wimbledon-F-Richard_Krajicek-Malivai_Washington,1,S-XC,5,0,0,0,0,4,1
19960707-M-Wimbledon-F-Richard_Krajicek-Malivai_Washington,1,S-DTM,4,2,0,1,1,1,3
19960707-M-Wimbledon-F-Richard_Krajicek-Malivai_Washington,2,F-XC,16,5,0,2,3,6,10
19960707-M-Wimbledon-F-Richard_Krajicek-Malivai_Washington,2,F-DTM,2,0,0,0,0,0,2
19960707-M-Wimbledon-F-Richard_Krajicek-Malivai_Washington,2,F-DTL,6,3,1,1,1,4,2
19960707-M-Wimbledon-F-Richard_Krajicek-Malivai_Washington,2,F-IO,3,1,1,0,0,1,2
19960707-M-Wimbledon-F-Richard_Krajicek-Malivai_Washington,2,F-II,2,2,1,0,1,1,1
19960707-M-Wimbledon-F-Richard_Krajicek-Malivai_Washington,2,B-XC,15,6,2,1,3,8,7
19960707-M-Wimbledon-F-Richard_Krajicek-Malivai_Washington,2,B-DTM,10,2,0,1,1,3,7
19960707-M-Wimbledon-F-Richard_Krajicek-Malivai_Washington,2,B-DTL,5,2,2,0,0,3,2
19960707-M-Wimbledon-F-Richard_Krajicek-Malivai_Washington,2,S-XC,3,0,0,0,0,1,2
19960707-M-Wimbledon-F-Richard_Krajicek-Malivai_Washington,2,S-DTM,6,0,0,0,0,2,4
19960707-M-Wimbledon-F-Richard_Krajicek-Malivai_Washington,2,S-IO,4,1,1,0,0,2,2
19950813-M-Cincinnati_Masters-F-Michael_Chang-Andre_Agassi,1,F-XC,10,3,2,1,0,6,4
19950813-M-Cincinnati_Masters-F-Michael_Chang-Andre_Agassi,1,F-DTM,12,0,0,0,0,7,5
19950813-M-Cincinnati_Masters-F-Michael_Chang-Andre_Agassi,1,F-DTL,19,7,2,2,3,11,8
19950813-M-Cincinnati_Masters-F-Michael_Chang-Andre_Agassi,1,F-IO,16,6,1,0,5,6,10
19950813-M-Cincinnati_Masters-F-Michael_Chang-Andre_Agassi,1,F-II,3,2,1,0,1,1,2
19950813-M-Cincinnati_Masters-F-Michael_Chang-Andre_Agassi,1,B-XC,43,2,0,0,2,14,29
19950813-M-Cincinnati_Masters-F-Michael_Chang-Andre_Agassi,1,B-DTM,18,1,0,0,1,8,10
19950813-M-Cincinnati_Masters-F-Michael_Chang-Andre_Agassi,1,B-DTL,17,8,3,1,4,9,8
19950813-M-Cincinnati_Masters-F-Michael_Chang-Andre_Agassi,1,B-IO,3,2,1,0,1,2,1
19950813-M-Cincinnati_Masters-F-Michael_Chang-Andre_Agassi,1,S-XC,7,1,0,0,1,5,2
19950813-M-Cincinnati_Masters-F-Michael_Chang-Andre_Agassi,1,S-DTL,1,0,0,0,0,0,1
19950813-M-Cincinnati_Masters-F-Michael_Chang-Andre_Agassi,2,F-XC,33,8,4,1,3,15,18
19950813-M-Cincinnati_Masters-F-Michael_Chang-Andre_Agassi,2,F-DTM,10,0,0,0,0,3,7
19950813-M-Cincinnati_Masters-F-Michael_Chang-Andre_Agassi,2,F-DTL,6,5,2,2,1,5,1
19950813-M-Cincinnati_Masters-F-Michael_Chang-Andre_Agassi,2,F-IO,30,11,3,4,4,12,18
19950813-M-Cincinnati_Masters-F-Michael_Chang-Andre_Agassi,2,F-II,7,5,2,1,2,3,4
19950813-M-Cincinnati_Masters-F-Michael_Chang-Andre_Agassi,2,B-XC,44,4,1,1,2,29,15
19950813-M-Cincinnati_Masters-F-Michael_Chang-Andre_Agassi,2,B-DTM,9,0,0,0,0,5,4
19950813-M-Cincinnati_Masters-F-Michael_Chang-Andre_Agassi,2,B-DTL,10,6,1,1,4,4,6
19950813-M-Cincinnati_Masters-F-Michael_Chang-Andre_Agassi,2,B-IO,2,1,1,0,0,1,1
19950813-M-Cincinnati_Masters-F-Michael_Chang-Andre_Agassi,2,S-XC,3,1,0,0,1,2,1
19950813-M-Cincinnati_Masters-F-Michael_Chang-Andre_Agassi,2,S-DTL,1,0,0,0,0,0,1
20180215-M-Rotterdam-R16-Roger_Federer-Philipp_Kohlschreiber,1,F-XC,35,14,5,2,7,18,17
20180215-M-Rotterdam-R16-Roger_Federer-Philipp_Kohlschreiber,1,F-DTM,18,1,0,1,0,8,10
20180215-M-Rotterdam-R16-Roger_Federer-Philipp_Kohlschreiber,1,F-DTL,10,1,1,0,0,5,5
20180215-M-Rotterdam-R16-Roger_Federer-Philipp_Kohlschreiber,1,F-IO,24,15,6,4,5,14,10
20180215-M-Rotterdam-R16-Roger_Federer-Philipp_Kohlschreiber,1,F-II,5,3,1,2,0,4,1
20180215-M-Rotterdam-R16-Roger_Federer-Philipp_Kohlschreiber,1,B-XC,25,4,0,1,3,16,9
20180215-M-Rotterdam-R16-Roger_Federer-Philipp_Kohlschreiber,1,B-DTM,18,1,0,0,1,6,12
20180215-M-Rotterdam-R16-Roger_Federer-Philipp_Kohlschreiber,1,B-DTL,6,3,1,0,2,2,4
20180215-M-Rotterdam-R16-Roger_Federer-Philipp_Kohlschreiber,1,B-IO,1,1,0,0,1,0,1
20180215-M-Rotterdam-R16-Roger_Federer-Philipp_Kohlschreiber,1,S-XC,6,0,0,0,0,3,3
20180215-M-Rotterdam-R16-Roger_Federer-Philipp_Kohlschreiber,1,S-DTM,5,0,0,0,0,0,5
20180215-M-Rotterdam-R16-Roger_Federer-Philipp_Kohlschreiber,1,S-DTL,2,1,0,0,1,0,2
20180215-M-Rotterdam-R16-Roger_Federer-Philipp_Kohlschreiber,2,F-XC,27,11,4,5,2,20,7
20180215-M-Rotterdam-R16-Roger_Federer-Philipp_Kohlschreiber,2,F-DTM,30,4,0,2,2,13,17
20180215-M-Rotterdam-R16-Roger_Federer-Philipp_Kohlschreiber,2,F-DTL,11,2,2,0,0,6,5
20180215-M-Rotterdam-R16-Roger_Federer-Philipp_Kohlschreiber,2,F-IO,23,7,6,1,0,18,5
20180215-M-Rotterdam-R16-Roger_Federer-Philipp_Kohlschreiber,2,F-II,2,2,1,0,1,1,1
20180215-M-Rotterdam-R16-Roger_Federer-Philipp_Kohlschreiber,2,B-XC,30,7,1,3,3,18,12
20180215-M-Rotterdam-R16-Roger_Federer-Philipp_Kohlschreiber,2,B-DTM,16,1,0,0,1,9,7
20180215-M-Rotterdam-R16-Roger_Federer-Philipp_Kohlschreiber,2,B-DTL,6,2,0,0,2,1,5
20180215-M-Rotterdam-R16-Roger_Federer-Philipp_Kohlschreiber,2,B-IO,5,1,0,0,1,3,2
20180215-M-Rotterdam-R16-Roger_Federer-Philipp_Kohlschreiber,2,S-XC,6,0,0,0,0,2,4
20180215-M-Rotterdam-R16-Roger_Federer-Philipp_Kohlschreiber,2,S-DTM,8,1,0,0,1,3,5
20180215-M-Rotterdam-R16-Roger_Federer-Philipp_Kohlschreiber,2,S-DTL,1,0,0,0,0,0,1
20180215-M-Rotterdam-R16-Roger_Federer-Philipp_Kohlschreiber,2,S-IO,1,0,0,0,0,1,0
19990516-M-Rome_Masters-F-Patrick_Rafter-Gustavo_Kuerten,1,F-XC,16,4,2,1,1,9,7
19990516-M-Rome_Masters-F-Patrick_Rafter-Gustavo_Kuerten,1,F-DTM,13,1,1,0,0,8,5
19990516-M-Rome_Masters-F-Patrick_Rafter-Gustavo_Kuerten,1,F-DTL,7,2,0,0,2,2,5
19990516-M-Rome_Masters-F-Patrick_Rafter-Gustavo_Kuerten,1,F-IO,4,1,0,0,1,1,3
19990516-M-Rome_Masters-F-Patrick_Rafter-Gustavo_Kuerten,1,B-XC,5,1,0,1,0,3,2
19990516-M-Rome_Masters-F-Patrick_Rafter-Gustavo_Kuerten,1,B-DTM,10,1,0,0,1,5,5
19990516-M-Rome_Masters-F-Patrick_Rafter-Gustavo_Kuerten,1,B-IO,2,1,0,0,1,0,2
19990516-M-Rome_Masters-F-Patrick_Rafter-Gustavo_Kuerten,1,S-XC,24,4,1,1,2,11,13
19990516-M-Rome_Masters-F-Patrick_Rafter-Gustavo_Kuerten,1,S-DTM,8,1,0,0,1,4,4
19990516-M-Rome_Masters-F-Patrick_Rafter-Gustavo_Kuerten,1,S-DTL,1,0,0,0,0,0,1
19990516-M-Rome_Masters-F-Patrick_Rafter-Gustavo_Kuerten,1,S-IO,1,1,0,1,0,1,0
19990516-M-Rome_Masters-F-Patrick_Rafter-Gustavo_Kuerten,2,F-XC,17,4,2,2,0,8,9
19990516-M-Rome_Masters-F-Patrick_Rafter-Gustavo_Kuerten,2,F-DTM,10,0,0,0,0,8,2
19990516-M-Rome_Masters-F-Patrick_Rafter-Gustavo_Kuerten,2,F-DTL,10,3,1,0,2,5,5
19990516-M-Rome_Masters-F-Patrick_Rafter-Gustavo_Kuerten,2,F-IO,10,4,1,1,2,6,4
19990516-M-Rome_Masters-F-Patrick_Rafter-Gustavo_Kuerten,2,F-II,5,2,1,1,0,3,2
19990516-M-Rome_Masters-F-Patrick_Rafter-Gustavo_Kuerten,2,B-XC,22,8,3,2,3,12,10
19990516-M-Rome_Masters-F-Patrick_Rafter-Gustavo_Kuerten,2,B-DTM,12,1,0,1,0,3,9
19990516-M-Rome_Masters-F-Patrick_Rafter-Gustavo_Kuerten,2,B-DTL,16,11,7,0,4,11,5
19990516-M-Rome_Masters-F-Patrick_Rafter-Gustavo_Kuerten,2,B-IO,11,5,3,0,2,5,6
19990516-M-Rome_Masters-F-Patrick_Rafter-Gustavo_Kuerten,2,S-XC,2,0,0,0,0,2,0
19990516-M-Rome_Masters-F-Patrick_Rafter-Gustavo_Kuerten,2,S-DTM,2,0,0,0,0,2,0
19990516-M-Rome_Masters-F-Patrick_Rafter-Gustavo_Kuerten,2,S-DTL,4,0,0,0,0,3,1
19960811-M-Cincinnati_Masters-F-Michael_Chang-Andre_Agassi,1,F-XC,26,5,5,0,0,17,9
19960811-M-Cincinnati_Masters-F-Michael_Chang-Andre_Agassi,1,F-DTM,33,2,0,1,1,16,17
19960811-M-Cincinnati_Masters-F-Michael_Chang-Andre_Agassi,1,F-DTL,20,9,2,3,4,11,9
19960811-M-Cincinnati_Masters-F-Michael_Chang-Andre_Agassi,1,F-IO,17,7,5,2,0,12,5
19960811-M-Cincinnati_Masters-F-Michael_Chang-Andre_Agassi,1,F-II,1,0,0,0,0,1,0
19960811-M-Cincinnati_Masters-F-Michael_Chang-Andre_Agassi,1,B-XC,39,4,0,1,3,19,20
19960811-M-Cincinnati_Masters-F-Michael_Chang-Andre_Agassi,1,B-DTM,22,1,0,0,1,14,8
19960811-M-Cincinnati_Masters-F-Michael_Chang-Andre_Agassi,1,B-DTL,14,7,3,3,1,9,5
19960811-M-Cincinnati_Masters-F-Michael_Chang-Andre_Agassi,1,B-IO,2,1,0,0,1,0,2
19960811-M-Cincinnati_Masters-F-Michael_Chang-Andre_Agassi,1,S-XC,18,2,0,2,0,13,5
19960811-M-Cincinnati_Masters-F-Michael_Chang-Andre_Agassi,1,S-DTM,3,1,0,0,1,0,3
19960811-M-Cincinnati_Masters-F-Michael_Chang-Andre_Agassi,1,S-DTL,1,0,0,0,0,0,1
19960811-M-Cincinnati_Masters-F-Michael_Chang-Andre_Agassi,2,F-XC,42,14,6,4,4,26,16
19960811-M-Cincinnati_Masters-F-Michael_Chang-Andre_Agassi,2,F-DTM,12,1,0,1,0,5,7
19960811-M-Cincinnati_Masters-F-Michael_Chang-Andre_Agassi,2,F-DTL,10,2,1,0,1,7,3
19960811-M-Cincinnati_Masters-F-Michael_Chang-Andre_Agassi,2,F-IO,27,13,4,4,5,13,14
19960811-M-Cincinnati_Masters-F-Michael_Chang-Andre_Agassi,2,F-II,6,2,1,0,1,3,3
19960811-M-Cincinnati_Masters-F-Michael_Chang-Andre_Agassi,2,B-XC,55,11,1,4,6,22,33
19960811-M-Cincinnati_Masters-F-Michael_Chang-Andre_Agassi,2,B-DTM,17,1,0,0,1,6,11
19960811-M-Cincinnati_Masters-F-Michael_Chang-Andre_Agassi,2,B-DTL,10,6,2,2,2,6,4
19960811-M-Cincinnati_Masters-F-Michael_Chang-Andre_Agassi,2,B-IO,3,0,0,0,0,0,3
19960811-M-Cincinnati_Masters-F-Michael_Chang-Andre_Agassi,2,B-II,1,0,0,0,0,0,1
19960811-M-Cincinnati_Masters-F-Michael_Chang-Andre_Agassi,2,S-XC,5,0,0,0,0,2,3
19960811-M-Cincinnati_Masters-F-Michael_Chang-Andre_Agassi,2,S-DTM,2,1,0,0,1,1,1
19960811-M-Cincinnati_Masters-F-Michael_Chang-Andre_Agassi,2,S-DTL,1,0,0,0,0,0,1
20180225-M-Delray_Beach-F-Francis_Tiafoe-Peter_Gojowczyk,1,F-XC,14,3,2,0,1,9,5
20180225-M-Delray_Beach-F-Francis_Tiafoe-Peter_Gojowczyk,1,F-DTM,8,3,0,1,2,4,4
20180225-M-Delray_Beach-F-Francis_Tiafoe-Peter_Gojowczyk,1,F-DTL,1,0,0,0,0,0,1
20180225-M-Delray_Beach-F-Francis_Tiafoe-Peter_Gojowczyk,1,F-IO,5,0,0,0,0,5,0
20180225-M-Delray_Beach-F-Francis_Tiafoe-Peter_Gojowczyk,1,F-II,1,1,1,0,0,1,0
20180225-M-Delray_Beach-F-Francis_Tiafoe-Peter_Gojowczyk,1,B-XC,14,1,0,0,1,9,5
20180225-M-Delray_Beach-F-Francis_Tiafoe-Peter_Gojowczyk,1,B-DTM,10,0,0,0,0,7,3
20180225-M-Delray_Beach-F-Francis_Tiafoe-Peter_Gojowczyk,1,B-DTL,3,1,0,0,1,1,2
20180225-M-Delray_Beach-F-Francis_Tiafoe-Peter_Gojowczyk,1,S-XC,6,1,0,0,1,3,3
20180225-M-Delray_Beach-F-Francis_Tiafoe-Peter_Gojowczyk,1,S-DTM,7,0,0,0,0,2,5
20180225-M-Delray_Beach-F-Francis_Tiafoe-Peter_Gojowczyk,2,F-XC,13,2,1,0,1,8,5
20180225-M-Delray_Beach-F-Francis_Tiafoe-Peter_Gojowczyk,2,F-DTM,11,4,0,1,3,2,9
20180225-M-Delray_Beach-F-Francis_Tiafoe-Peter_Gojowczyk,2,F-DTL,4,1,0,0,1,3,1
20180225-M-Delray_Beach-F-Francis_Tiafoe-Peter_Gojowczyk,2,F-IO,12,5,1,1,3,6,6
20180225-M-Delray_Beach-F-Francis_Tiafoe-Peter_Gojowczyk,2,F-II,2,2,0,1,1,1,1
20180225-M-Delray_Beach-F-Francis_Tiafoe-Peter_Gojowczyk,2,B-XC,18,6,2,0,4,6,12
20180225-M-Delray_Beach-F-Francis_Tiafoe-Peter_Gojowczyk,2,B-DTM,10,5,0,0,5,2,8
20180225-M-Delray_Beach-F-Francis_Tiafoe-Peter_Gojowczyk,2,B-DTL,6,5,2,0,3,3,3
20180225-M-Delray_Beach-F-Francis_Tiafoe-Peter_Gojowczyk,2,B-IO,3,2,1,0,1,1,2
20180225-M-Delray_Beach-F-Francis_Tiafoe-Peter_Gojowczyk,2,S-XC,4,0,0,0,0,1,3
20180225-M-Delray_Beach-F-Francis_Tiafoe-Peter_Gojowczyk,2,S-DTM,1,0,0,0,0,0,1
20180225-M-Marseille-F-Lucas_Pouille-Karen_Khachanov,1,F-XC,40,15,5,6,4,27,13
20180225-M-Marseille-F-Lucas_Pouille-Karen_Khachanov,1,F-DTM,10,1,0,1,0,4,6
20180225-M-Marseille-F-Lucas_Pouille-Karen_Khachanov,1,F-DTL,6,4,2,1,1,5,1
20180225-M-Marseille-F-Lucas_Pouille-Karen_Khachanov,1,F-IO,21,9,3,3,3,14,7
20180225-M-Marseille-F-Lucas_Pouille-Karen_Khachanov,1,F-II,4,3,2,0,1,3,1
20180225-M-Marseille-F-Lucas_Pouille-Karen_Khachanov,1,B-XC,28,10,1,2,7,12,16
20180225-M-Marseille-F-Lucas_Pouille-Karen_Khachanov,1,B-DTM,15,2,0,0,2,4,11
20180225-M-Marseille-F-Lucas_Pouille-Karen_Khachanov,1,B-DTL,7,3,0,1,2,4,3
20180225-M-Marseille-F-Lucas_Pouille-Karen_Khachanov,1,B-IO,6,3,2,1,0,5,1
20180225-M-Marseille-F-Lucas_Pouille-Karen_Khachanov,1,S-XC,7,0,0,0,0,4,3
20180225-M-Marseille-F-Lucas_Pouille-Karen_Khachanov,1,S-DTM,14,1,0,0,1,7,7
20180225-M-Marseille-F-Lucas_Pouille-Karen_Khachanov,1,S-DTL,5,1,0,1,0,2,3
20180225-M-Marseille-F-Lucas_Pouille-Karen_Khachanov,1,S-IO,1,0,0,0,0,1,0
20180225-M-Marseille-F-Lucas_Pouille-Karen_Khachanov,2,F-XC,27,9,2,5,2,13,14
20180225-M-Marseille-F-Lucas_Pouille-Karen_Khachanov,2,F-DTM,18,4,0,3,1,9,9
20180225-M-Marseille-F-Lucas_Pouille-Karen_Khachanov,2,F-DTL,15,6,1,3,2,10,5
20180225-M-Marseille-F-Lucas_Pouille-Karen_Khachanov,2,F-IO,28,7,4,2,1,14,14
20180225-M-Marseille-F-Lucas_Pouille-Karen_Khachanov,2,F-II,1,0,0,0,0,0,1
20180225-M-Marseille-F-Lucas_Pouille-Karen_Khachanov,2,B-XC,27,4,2,2,0,17,10
20180225-M-Marseille-F-Lucas_Pouille-Karen_Khachanov,2,B-DTM,12,1,0,0,1,5,7
20180225-M-Marseille-F-Lucas_Pouille-Karen_Khachanov,2,B-DTL,7,3,2,0,1,4,3
20180225-M-Marseille-F-Lucas_Pouille-Karen_Khachanov,2,B-IO,3,0,0,0,0,2,1
20180225-M-Marseille-F-Lucas_Pouille-Karen_Khachanov,2,S-XC,1,0,0,0,0,0,1
20180225-M-Marseille-F-Lucas_Pouille-Karen_Khachanov,2,S-DTM,4,1,0,0,1,1,3
19911103-M-Paris_Masters-F-Pete_Sampras-Guy_Forget,1,F-XC,73,16,3,6,7,47,26
19911103-M-Paris_Masters-F-Pete_Sampras-Guy_Forget,1,F-DTM,14,1,0,0,1,5,9
19911103-M-Paris_Masters-F-Pete_Sampras-Guy_Forget,1,F-DTL,13,7,1,3,3,5,8
19911103-M-Paris_Masters-F-Pete_Sampras-Guy_Forget,1,F-IO,22,7,2,3,2,13,9
19911103-M-Paris_Masters-F-Pete_Sampras-Guy_Forget,1,F-II,4,3,0,0,3,1,3
19911103-M-Paris_Masters-F-Pete_Sampras-Guy_Forget,1,B-XC,29,13,2,4,7,14,15
19911103-M-Paris_Masters-F-Pete_Sampras-Guy_Forget,1,B-DTM,36,2,0,1,1,16,20
19911103-M-Paris_Masters-F-Pete_Sampras-Guy_Forget,1,B-DTL,27,10,4,1,5,15,12
19911103-M-Paris_Masters-F-Pete_Sampras-Guy_Forget,1,B-IO,18,7,4,0,3,9,9
19911103-M-Paris_Masters-F-Pete_Sampras-Guy_Forget,1,S-XC,8,1,0,0,1,4,4
19911103-M-Paris_Masters-F-Pete_Sampras-Guy_Forget,1,S-DTM,19,1,0,0,1,6,13
19911103-M-Paris_Masters-F-Pete_Sampras-Guy_Forget,1,S-DTL,16,1,0,0,1,7,9
19911103-M-Paris_Masters-F-Pete_Sampras-Guy_Forget,1,S-IO,7,0,0,0,0,3,4
19911103-M-Paris_Masters-F-Pete_Sampras-Guy_Forget,2,F-XC,73,9,2,2,5,42,31
19911103-M-Paris_Masters-F-Pete_Sampras-Guy_Forget,2,F-DTM,29,5,0,0,5,12,17
19911103-M-Paris_Masters-F-Pete_Sampras-Guy_Forget,2,F-DTL,13,9,9,0,0,11,2
19911103-M-Paris_Masters-F-Pete_Sampras-Guy_Forget,2,F-IO,23,8,4,1,3,10,13
19911103-M-Paris_Masters-F-Pete_Sampras-Guy_Forget,2,F-II,3,0,0,0,0,1,2
19911103-M-Paris_Masters-F-Pete_Sampras-Guy_Forget,2,B-XC,42,15,4,6,5,22,20
19911103-M-Paris_Masters-F-Pete_Sampras-Guy_Forget,2,B-DTM,42,5,1,1,3,19,23
19911103-M-Paris_Masters-F-Pete_Sampras-Guy_Forget,2,B-DTL,14,5,1,1,3,6,8
19911103-M-Paris_Masters-F-Pete_Sampras-Guy_Forget,2,B-IO,15,3,1,0,2,6,9
19911103-M-Paris_Masters-F-Pete_Sampras-Guy_Forget,2,B-II,1,1,0,0,1,0,1
19911103-M-Paris_Masters-F-Pete_Sampras-Guy_Forget,2,S-XC,12,0,0,0,0,3,9
19911103-M-Paris_Masters-F-Pete_Sampras-Guy_Forget,2,S-DTM,20,2,0,0,2,6,14
19911103-M-Paris_Masters-F-Pete_Sampras-Guy_Forget,2,S-DTL,11,0,0,0,0,4,7
19911103-M-Paris_Masters-F-Pete_Sampras-Guy_Forget,2,S-IO,4,1,0,0,1,2,2
20060831-M-US_Open-R64-Marcos_Baghdatis-Andre_Agassi,1,F-XC,87,22,9,6,7,44,43
20060831-M-US_Open-R64-Marcos_Baghdatis-Andre_Agassi,1,F-DTM,42,5,0,3,2,19,23
20060831-M-US_Open-R64-Marcos_Baghdatis-Andre_Agassi,1,F-DTL,37,12,6,3,3,18,19
20060831-M-US_Open-R64-Marcos_Baghdatis-Andre_Agassi,1,F-IO,64,16,7,6,3,41,23
20060831-M-US_Open-R64-Marcos_Baghdatis-Andre_Agassi,1,F-II,10,2,2,0,0,5,5
20060831-M-US_Open-R64-Marcos_Baghdatis-Andre_Agassi,1,B-XC,161,14,2,1,11,86,75
20060831-M-US_Open-R64-Marcos_Baghdatis-Andre_Agassi,1,B-DTM,70,6,0,2,4,35,35
20060831-M-US_Open-R64-Marcos_Baghdatis-Andre_Agassi,1,B-DTL,53,27,7,6,14,25,28
20060831-M-US_Open-R64-Marcos_Baghdatis-Andre_Agassi,1,B-IO,21,7,1,0,6,7,14
20060831-M-US_Open-R64-Marcos_Baghdatis-Andre_Agassi,1,S-XC,20,0,0,0,0,9,11
20060831-M-US_Open-R64-Marcos_Baghdatis-Andre_Agassi,1,S-DTM,13,2,0,0,2,2,11
20060831-M-US_Open-R64-Marcos_Baghdatis-Andre_Agassi,1,S-DTL,4,1,0,0,1,2,2
20060831-M-US_Open-R64-Marcos_Baghdatis-Andre_Agassi,2,F-XC,110,20,2,12,6,64,46
20060831-M-US_Open-R64-Marcos_Baghdatis-Andre_Agassi,2,F-DTM,51,2,0,2,0,20,31
20060831-M-US_Open-R64-Marcos_Baghdatis-Andre_Agassi,2,F-DTL,24,8,1,5,2,15,9
20060831-M-US_Open-R64-Marcos_Baghdatis-Andre_Agassi,2,F-IO,32,6,1,4,1,23,9
20060831-M-US_Open-R64-Marcos_Baghdatis-Andre_Agassi,2,F-II,4,2,1,1,0,3,1
20060831-M-US_Open-R64-Marcos_Baghdatis-Andre_Agassi,2,B-XC,208,27,2,12,13,106,102
20060831-M-US_Open-R64-Marcos_Baghdatis-Andre_Agassi,2,B-DTM,73,3,0,1,2,34,39
20060831-M-US_Open-R64-Marcos_Baghdatis-Andre_Agassi,2,B-DTL,21,12,6,5,1,15,6
20060831-M-US_Open-R64-Marcos_Baghdatis-Andre_Agassi,2,B-IO,9,4,1,2,1,6,3
20060831-M-US_Open-R64-Marcos_Baghdatis-Andre_Agassi,2,S-XC,41,1,0,0,1,11,30
20060831-M-US_Open-R64-Marcos_Baghdatis-Andre_Agassi,2,S-DTM,4,0,0,0,0,1,3
20060831-M-US_Open-R64-Marcos_Baghdatis-Andre_Agassi,2,S-DTL,4,0,0,0,0,1,3
19951105-M-Paris_Masters-F-Pete_Sampras-Boris_Becker,1,F-XC,42,16,5,6,5,21,21
19951105-M-Paris_Masters-F-Pete_Sampras-Boris_Becker,1,F-DTM,7,0,0,0,0,1,6
19951105-M-Paris_Masters-F-Pete_Sampras-Boris_Becker,1,F-DTL,7,3,2,1,0,3,4
19951105-M-Paris_Masters-F-Pete_Sampras-Boris_Becker,1,F-IO,14,8,2,4,2,8,6
19951105-M-Paris_Masters-F-Pete_Sampras-Boris_Becker,1,F-II,2,2,1,0,1,1,1
19951105-M-Paris_Masters-F-Pete_Sampras-Boris_Becker,1,B-XC,44,13,3,6,4,21,23
19951105-M-Paris_Masters-F-Pete_Sampras-Boris_Becker,1,B-DTM,12,2,0,0,2,1,11
19951105-M-Paris_Masters-F-Pete_Sampras-Boris_Becker,1,B-DTL,19,11,5,2,4,9,10
19951105-M-Paris_Masters-F-Pete_Sampras-Boris_Becker,1,B-IO,4,2,1,0,1,1,3
19951105-M-Paris_Masters-F-Pete_Sampras-Boris_Becker,1,S-XC,3,0,0,0,0,1,2
19951105-M-Paris_Masters-F-Pete_Sampras-Boris_Becker,1,S-DTM,3,0,0,0,0,2,1
19951105-M-Paris_Masters-F-Pete_Sampras-Boris_Becker,1,S-DTL,2,0,0,0,0,0,2
19951105-M-Paris_Masters-F-Pete_Sampras-Boris_Becker,2,F-XC,23,11,4,2,5,16,7
19951105-M-Paris_Masters-F-Pete_Sampras-Boris_Becker,2,F-DTM,10,0,0,0,0,9,1
19951105-M-Paris_Masters-F-Pete_Sampras-Boris_Becker,2,F-DTL,21,6,2,2,2,12,9
19951105-M-Paris_Masters-F-Pete_Sampras-Boris_Becker,2,F-IO,17,2,1,0,1,10,7
19951105-M-Paris_Masters-F-Pete_Sampras-Boris_Becker,2,B-XC,24,3,1,1,1,17,7
19951105-M-Paris_Masters-F-Pete_Sampras-Boris_Becker,2,B-DTM,9,1,0,0,1,3,6
19951105-M-Paris_Masters-F-Pete_Sampras-Boris_Becker,2,B-DTL,16,6,3,1,2,7,9
19951105-M-Paris_Masters-F-Pete_Sampras-Boris_Becker,2,B-IO,4,1,0,1,0,2,2
19951105-M-Paris_Masters-F-Pete_Sampras-Boris_Becker,2,S-XC,4,0,0,0,0,3,1
19951105-M-Paris_Masters-F-Pete_Sampras-Boris_Becker,2,S-DTM,1,0,0,0,0,1,0
19951105-M-Paris_Masters-F-Pete_Sampras-Boris_Becker,2,S-DTL,5,1,0,0,1,2,3
20180228-M-Dubai-R16-Karen_Khachanov-Lucas_Pouille,1,F-XC,26,7,2,1,4,13,13
20180228-M-Dubai-R16-Karen_Khachanov-Lucas_Pouille,1,F-DTM,15,1,0,0,1,2,13
20180228-M-Dubai-R16-Karen_Khachanov-Lucas_Pouille,1,F-DTL,11,4,1,1,2,6,5
20180228-M-Dubai-R16-Karen_Khachanov-Lucas_Pouille,1,F-IO,24,9,0,5,4,16,8
20180228-M-Dubai-R16-Karen_Khachanov-Lucas_Pouille,1,B-XC,20,3,0,1,2,9,11
20180228-M-Dubai-R16-Karen_Khachanov-Lucas_Pouille,1,B-DTM,22,2,0,0,2,7,15
20180228-M-Dubai-R16-Karen_Khachanov-Lucas_Pouille,1,B-DTL,7,3,1,1,1,4,3
20180228-M-Dubai-R16-Karen_Khachanov-Lucas_Pouille,1,B-IO,2,1,0,1,0,2,0
20180228-M-Dubai-R16-Karen_Khachanov-Lucas_Pouille,1,S-XC,4,0,0,0,0,0,4
20180228-M-Dubai-R16-Karen_Khachanov-Lucas_Pouille,1,S-DTM,1,0,0,0,0,0,1
20180228-M-Dubai-R16-Karen_Khachanov-Lucas_Pouille,2,F-XC,29,13,5,5,3,20,9
20180228-M-Dubai-R16-Karen_Khachanov-Lucas_Pouille,2,F-DTM,21,2,0,1,1,11,10
20180228-M-Dubai-R16-Karen_Khachanov-Lucas_Pouille,2,F-DTL,3,2,0,1,1,2,1
20180228-M-Dubai-R16-Karen_Khachanov-Lucas_Pouille,2,F-IO,28,14,5,4,5,20,8
20180228-M-Dubai-R16-Karen_Khachanov-Lucas_Pouille,2,F-II,1,0,0,0,0,1,0
20180228-M-Dubai-R16-Karen_Khachanov-Lucas_Pouille,2,B-XC,12,4,0,2,2,5,7
20180228-M-Dubai-R16-Karen_Khachanov-Lucas_Pouille,2,B-DTM,14,2,0,0,2,6,8
20180228-M-Dubai-R16-Karen_Khachanov-Lucas_Pouille,2,B-DTL,10,7,0,0,7,1,9
20180228-M-Dubai-R16-Karen_Khachanov-Lucas_Pouille,2,B-IO,2,0,0,0,0,2,0
20180228-M-Dubai-R16-Karen_Khachanov-Lucas_Pouille,2,S-XC,8,2,1,1,0,5,3
20180228-M-Dubai-R16-Karen_Khachanov-Lucas_Pouille,2,S-DTM,6,1,0,0,1,3,3
20180228-M-Dubai-R16-Karen_Khachanov-Lucas_Pouille,2,S-DTL,2,0,0,0,0,2,0
20180228-M-Dubai-R16-Karen_Khachanov-Lucas_Pouille,2,S-IO,2,0,0,0,0,1,1
19981129-M-Tour_Finals-F-Alex_Corretja-Carlos_Moya,1,F-XC,88,22,4,7,11,42,46
19981129-M-Tour_Finals-F-Alex_Corretja-Carlos_Moya,1,F-DTM,68,3,0,0,3,30,38
19981129-M-Tour_Finals-F-Alex_Corretja-Carlos_Moya,1,F-DTL,49,13,5,1,7,24,25
19981129-M-Tour_Finals-F-Alex_Corretja-Carlos_Moya,1,F-IO,80,13,3,6,4,43,37
19981129-M-Tour_Finals-F-Alex_Corretja-Carlos_Moya,1,F-II,19,4,1,1,2,8,11
19981129-M-Tour_Finals-F-Alex_Corretja-Carlos_Moya,1,B-XC,136,11,0,4,7,73,63
19981129-M-Tour_Finals-F-Alex_Corretja-Carlos_Moya,1,B-DTM,38,4,1,1,2,18,20
19981129-M-Tour_Finals-F-Alex_Corretja-Carlos_Moya,1,B-DTL,28,9,7,0,2,20,8
19981129-M-Tour_Finals-F-Alex_Corretja-Carlos_Moya,1,B-IO,9,2,1,0,1,4,5
19981129-M-Tour_Finals-F-Alex_Corretja-Carlos_Moya,1,S-XC,30,1,0,0,1,12,18
19981129-M-Tour_Finals-F-Alex_Corretja-Carlos_Moya,1,S-DTM,16,1,0,0,1,6,10
19981129-M-Tour_Finals-F-Alex_Corretja-Carlos_Moya,1,S-DTL,8,3,0,0,3,4,4
19981129-M-Tour_Finals-F-Alex_Corretja-Carlos_Moya,1,S-IO,4,0,0,0,0,4,0
19981129-M-Tour_Finals-F-Alex_Corretja-Carlos_Moya,2,F-XC,91,20,3,9,8,50,41
19981129-M-Tour_Finals-F-Alex_Corretja-Carlos_Moya,2,F-DTM,64,3,0,0,3,34,30
19981129-M-Tour_Finals-F-Alex_Corretja-Carlos_Moya,2,F-DTL,26,4,1,0,3,12,14
19981129-M-Tour_Finals-F-Alex_Corretja-Carlos_Moya,2,F-IO,66,14,5,4,5,40,26
19981129-M-Tour_Finals-F-Alex_Corretja-Carlos_Moya,2,F-II,21,6,2,1,3,9,12
19981129-M-Tour_Finals-F-Alex_Corretja-Carlos_Moya,2,B-XC,148,15,3,5,7,72,76
19981129-M-Tour_Finals-F-Alex_Corretja-Carlos_Moya,2,B-DTM,77,10,0,2,8,34,43
19981129-M-Tour_Finals-F-Alex_Corretja-Carlos_Moya,2,B-DTL,30,14,5,3,6,16,14
19981129-M-Tour_Finals-F-Alex_Corretja-Carlos_Moya,2,B-IO,5,2,0,0,2,2,3
19981129-M-Tour_Finals-F-Alex_Corretja-Carlos_Moya,2,S-XC,14,1,0,0,1,1,13
19981129-M-Tour_Finals-F-Alex_Corretja-Carlos_Moya,2,S-DTM,5,0,0,0,0,2,3
19981129-M-Tour_Finals-F-Alex_Corretja-Carlos_Moya,2,S-DTL,2,1,1,0,0,2,0
19950312-M-Indian_Wells_Masters-F-Pete_Sampras-Andre_Agassi,1,F-XC,34,12,7,1,4,21,13
19950312-M-Indian_Wells_Masters-F-Pete_Sampras-Andre_Agassi,1,F-DTM,11,3,0,0,3,1,10
19950312-M-Indian_Wells_Masters-F-Pete_Sampras-Andre_Agassi,1,F-DTL,11,6,2,4,0,9,2
19950312-M-Indian_Wells_Masters-F-Pete_Sampras-Andre_Agassi,1,F-IO,10,2,0,1,1,4,6
19950312-M-Indian_Wells_Masters-F-Pete_Sampras-Andre_Agassi,1,F-II,3,2,0,2,0,2,1
19950312-M-Indian_Wells_Masters-F-Pete_Sampras-Andre_Agassi,1,B-XC,54,8,2,1,5,23,31
19950312-M-Indian_Wells_Masters-F-Pete_Sampras-Andre_Agassi,1,B-DTM,23,3,0,0,3,12,11
19950312-M-Indian_Wells_Masters-F-Pete_Sampras-Andre_Agassi,1,B-DTL,15,7,2,1,4,7,8
19950312-M-Indian_Wells_Masters-F-Pete_Sampras-Andre_Agassi,1,B-IO,5,2,0,0,2,1,4
19950312-M-Indian_Wells_Masters-F-Pete_Sampras-Andre_Agassi,1,S-XC,9,1,0,0,1,3,6
19950312-M-Indian_Wells_Masters-F-Pete_Sampras-Andre_Agassi,1,S-DTM,8,0,0,0,0,5,3
19950312-M-Indian_Wells_Masters-F-Pete_Sampras-Andre_Agassi,1,S-DTL,4,0,0,0,0,2,2
19950312-M-Indian_Wells_Masters-F-Pete_Sampras-Andre_Agassi,2,F-XC,30,5,2,2,1,13,17
19950312-M-Indian_Wells_Masters-F-Pete_Sampras-Andre_Agassi,2,F-DTM,25,1,0,0,1,14,11
19950312-M-Indian_Wells_Masters-F-Pete_Sampras-Andre_Agassi,2,F-DTL,16,3,1,1,1,8,8
19950312-M-Indian_Wells_Masters-F-Pete_Sampras-Andre_Agassi,2,F-IO,37,9,5,2,2,20,17
19950312-M-Indian_Wells_Masters-F-Pete_Sampras-Andre_Agassi,2,F-II,13,11,3,3,5,8,5
19950312-M-Indian_Wells_Masters-F-Pete_Sampras-Andre_Agassi,2,B-XC,54,7,2,0,5,29,25
19950312-M-Indian_Wells_Masters-F-Pete_Sampras-Andre_Agassi,2,B-DTM,6,1,0,0,1,3,3
19950312-M-Indian_Wells_Masters-F-Pete_Sampras-Andre_Agassi,2,B-DTL,16,8,3,2,3,10,6
19950312-M-Indian_Wells_Masters-F-Pete_Sampras-Andre_Agassi,2,B-IO,8,5,2,1,2,4,4
19950312-M-Indian_Wells_Masters-F-Pete_Sampras-Andre_Agassi,2,S-XC,4,0,0,0,0,2,2
19950312-M-Indian_Wells_Masters-F-Pete_Sampras-Andre_Agassi,2,S-DTM,1,0,0,0,0,0,1
19900513-M-Hamburg_Masters-F-Juan_Aguilera-Boris_Becker,1,F-XC,54,9,6,1,2,38,16
19900513-M-Hamburg_Masters-F-Juan_Aguilera-Boris_Becker,1,F-DTM,62,1,0,0,1,37,25
19900513-M-Hamburg_Masters-F-Juan_Aguilera-Boris_Becker,1,F-DTL,39,8,3,0,5,18,21
19900513-M-Hamburg_Masters-F-Juan_Aguilera-Boris_Becker,1,F-IO,34,1,0,1,0,20,14
19900513-M-Hamburg_Masters-F-Juan_Aguilera-Boris_Becker,1,F-II,1,0,0,0,0,1,0
19900513-M-Hamburg_Masters-F-Juan_Aguilera-Boris_Becker,1,B-XC,25,5,0,2,3,16,9
19900513-M-Hamburg_Masters-F-Juan_Aguilera-Boris_Becker,1,B-DTM,15,1,0,1,0,8,7
19900513-M-Hamburg_Masters-F-Juan_Aguilera-Boris_Becker,1,B-DTL,15,9,5,0,4,11,4
19900513-M-Hamburg_Masters-F-Juan_Aguilera-Boris_Becker,1,B-IO,8,5,2,1,2,5,3
19900513-M-Hamburg_Masters-F-Juan_Aguilera-Boris_Becker,1,S-XC,225,2,0,2,0,148,77
19900513-M-Hamburg_Masters-F-Juan_Aguilera-Boris_Becker,1,S-DTM,83,0,0,0,0,55,28
19900513-M-Hamburg_Masters-F-Juan_Aguilera-Boris_Becker,1,S-DTL,12,1,0,0,1,5,7
19900513-M-Hamburg_Masters-F-Juan_Aguilera-Boris_Becker,1,S-IO,8,1,1,0,0,6,2
19900513-M-Hamburg_Masters-F-Juan_Aguilera-Boris_Becker,1,S-II,1,0,0,0,0,0,1
19900513-M-Hamburg_Masters-F-Juan_Aguilera-Boris_Becker,2,F-XC,68,9,3,0,6,32,36
19900513-M-Hamburg_Masters-F-Juan_Aguilera-Boris_Becker,2,F-DTM,41,4,0,0,4,10,31
19900513-M-Hamburg_Masters-F-Juan_Aguilera-Boris_Becker,2,F-DTL,13,7,0,1,6,5,8
19900513-M-Hamburg_Masters-F-Juan_Aguilera-Boris_Becker,2,F-IO,66,6,0,1,5,23,43
19900513-M-Hamburg_Masters-F-Juan_Aguilera-Boris_Becker,2,F-II,9,0,0,0,0,4,5
19900513-M-Hamburg_Masters-F-Juan_Aguilera-Boris_Becker,2,B-XC,81,5,1,1,3,27,54
19900513-M-Hamburg_Masters-F-Juan_Aguilera-Boris_Becker,2,B-DTM,61,2,0,0,2,19,42
19900513-M-Hamburg_Masters-F-Juan_Aguilera-Boris_Becker,2,B-DTL,30,11,2,1,8,8,22
19900513-M-Hamburg_Masters-F-Juan_Aguilera-Boris_Becker,2,B-IO,12,2,0,0,2,4,8
19900513-M-Hamburg_Masters-F-Juan_Aguilera-Boris_Becker,2,S-XC,85,3,0,0,3,30,55
19900513-M-Hamburg_Masters-F-Juan_Aguilera-Boris_Becker,2,S-DTM,76,1,0,0,1,23,53
19900513-M-Hamburg_Masters-F-Juan_Aguilera-Boris_Becker,2,S-DTL,20,0,0,0,0,10,10
19900513-M-Hamburg_Masters-F-Juan_Aguilera-Boris_Becker,2,S-IO,5,0,0,0,0,2,3
19900812-M-Cincinnati_Masters-F-Brad_Gilbert-Stefan_Edberg,1,F-XC,9,6,4,0,2,5,4
19900812-M-Cincinnati_Masters-F-Brad_Gilbert-Stefan_Edberg,1,F-DTM,5,1,0,0,1,0,5
19900812-M-Cincinnati_Masters-F-Brad_Gilbert-Stefan_Edberg,1,F-DTL,2,0,0,0,0,1,1
19900812-M-Cincinnati_Masters-F-Brad_Gilbert-Stefan_Edberg,1,F-IO,11,2,0,1,1,5,6
19900812-M-Cincinnati_Masters-F-Brad_Gilbert-Stefan_Edberg,1,F-II,1,0,0,0,0,0,1
19900812-M-Cincinnati_Masters-F-Brad_Gilbert-Stefan_Edberg,1,B-XC,12,4,2,0,2,3,9
19900812-M-Cincinnati_Masters-F-Brad_Gilbert-Stefan_Edberg,1,B-DTM,9,2,0,0,2,1,8
19900812-M-Cincinnati_Masters-F-Brad_Gilbert-Stefan_Edberg,1,B-DTL,5,1,0,0,1,0,5
19900812-M-Cincinnati_Masters-F-Brad_Gilbert-Stefan_Edberg,1,B-IO,2,0,0,0,0,1,1
19900812-M-Cincinnati_Masters-F-Brad_Gilbert-Stefan_Edberg,1,S-XC,1,0,0,0,0,1,0
19900812-M-Cincinnati_Masters-F-Brad_Gilbert-Stefan_Edberg,2,F-XC,3,2,0,2,0,3,0
19900812-M-Cincinnati_Masters-F-Brad_Gilbert-Stefan_Edberg,2,F-DTM,3,0,0,0,0,2,1
19900812-M-Cincinnati_Masters-F-Brad_Gilbert-Stefan_Edberg,2,F-DTL,3,1,0,0,1,2,1
19900812-M-Cincinnati_Masters-F-Brad_Gilbert-Stefan_Edberg,2,F-IO,5,1,0,0,1,4,1
19900812-M-Cincinnati_Masters-F-Brad_Gilbert-Stefan_Edberg,2,F-II,1,0,0,0,0,0,1
19900812-M-Cincinnati_Masters-F-Brad_Gilbert-Stefan_Edberg,2,B-XC,11,1,0,1,0,9,2
19900812-M-Cincinnati_Masters-F-Brad_Gilbert-Stefan_Edberg,2,B-DTM,2,0,0,0,0,1,1
19900812-M-Cincinnati_Masters-F-Brad_Gilbert-Stefan_Edberg,2,B-DTL,4,2,1,0,1,3,1
19900812-M-Cincinnati_Masters-F-Brad_Gilbert-Stefan_Edberg,2,B-IO,1,0,0,0,0,1,0
19900812-M-Cincinnati_Masters-F-Brad_Gilbert-Stefan_Edberg,2,S-XC,3,1,0,0,1,2,1
19900812-M-Cincinnati_Masters-F-Brad_Gilbert-Stefan_Edberg,2,S-DTM,1,0,0,0,0,1,0
19900812-M-Cincinnati_Masters-F-Brad_Gilbert-Stefan_Edberg,2,S-DTL,2,1,1,0,0,2,0
19900311-M-Indian_Wells_Masters-F-Andre_Agassi-Stefan_Edberg,1,F-XC,104,28,8,9,11,62,42
19900311-M-Indian_Wells_Masters-F-Andre_Agassi-Stefan_Edberg,1,F-DTM,37,2,0,0,2,18,19
19900311-M-Indian_Wells_Masters-F-Andre_Agassi-Stefan_Edberg,1,F-DTL,29,14,4,7,3,16,13
19900311-M-Indian_Wells_Masters-F-Andre_Agassi-Stefan_Edberg,1,F-IO,19,7,4,2,1,11,8
19900311-M-Indian_Wells_Masters-F-Andre_Agassi-Stefan_Edberg,1,F-II,5,0,0,0,0,3,2
19900311-M-Indian_Wells_Masters-F-Andre_Agassi-Stefan_Edberg,1,B-XC,139,30,13,6,11,87,52
19900311-M-Indian_Wells_Masters-F-Andre_Agassi-Stefan_Edberg,1,B-DTM,59,3,0,0,3,23,36
19900311-M-Indian_Wells_Masters-F-Andre_Agassi-Stefan_Edberg,1,B-DTL,48,13,6,6,1,26,22
19900311-M-Indian_Wells_Masters-F-Andre_Agassi-Stefan_Edberg,1,B-IO,25,3,3,0,0,14,11
19900311-M-Indian_Wells_Masters-F-Andre_Agassi-Stefan_Edberg,1,S-XC,3,1,0,1,0,3,0
19900311-M-Indian_Wells_Masters-F-Andre_Agassi-Stefan_Edberg,1,S-DTM,4,0,0,0,0,2,2
19900311-M-Indian_Wells_Masters-F-Andre_Agassi-Stefan_Edberg,1,S-DTL,2,0,0,0,0,0,2
19900311-M-Indian_Wells_Masters-F-Andre_Agassi-Stefan_Edberg,2,F-XC,65,12,5,1,6,32,33
19900311-M-Indian_Wells_Masters-F-Andre_Agassi-Stefan_Edberg,2,F-DTM,63,0,0,0,0,29,34
19900311-M-Indian_Wells_Masters-F-Andre_Agassi-Stefan_Edberg,2,F-DTL,32,4,1,0,3,10,22
19900311-M-Indian_Wells_Masters-F-Andre_Agassi-Stefan_Edberg,2,F-IO,24,2,0,0,2,12,12
19900311-M-Indian_Wells_Masters-F-Andre_Agassi-Stefan_Edberg,2,B-XC,58,10,0,5,5,20,38
19900311-M-Indian_Wells_Masters-F-Andre_Agassi-Stefan_Edberg,2,B-DTM,39,2,0,2,0,20,19
19900311-M-Indian_Wells_Masters-F-Andre_Agassi-Stefan_Edberg,2,B-DTL,26,12,2,3,7,10,16
19900311-M-Indian_Wells_Masters-F-Andre_Agassi-Stefan_Edberg,2,B-IO,2,1,0,0,1,1,1
19900311-M-Indian_Wells_Masters-F-Andre_Agassi-Stefan_Edberg,2,S-XC,34,5,1,2,2,18,16
19900311-M-Indian_Wells_Masters-F-Andre_Agassi-Stefan_Edberg,2,S-DTM,24,1,0,0,1,11,13
19900311-M-Indian_Wells_Masters-F-Andre_Agassi-Stefan_Edberg,2,S-DTL,5,1,0,1,0,2,3
19900311-M-Indian_Wells_Masters-F-Andre_Agassi-Stefan_Edberg,2,S-IO,1,1,0,1,0,1,0
19911117-M-Tour_Finals-F-Pete_Sampras-Jim_Courier,1,F-XC,27,9,3,4,2,16,11
19911117-M-Tour_Finals-F-Pete_Sampras-Jim_Courier,1,F-DTM,12,2,0,2,0,7,5
19911117-M-Tour_Finals-F-Pete_Sampras-Jim_Courier,1,F-DTL,12,7,4,1,2,9,3
19911117-M-Tour_Finals-F-Pete_Sampras-Jim_Courier,1,F-IO,24,10,5,2,3,13,11
19911117-M-Tour_Finals-F-Pete_Sampras-Jim_Courier,1,F-II,5,3,1,1,1,2,3
19911117-M-Tour_Finals-F-Pete_Sampras-Jim_Courier,1,B-XC,70,10,6,2,2,47,23
19911117-M-Tour_Finals-F-Pete_Sampras-Jim_Courier,1,B-DTM,33,6,0,1,5,17,16
19911117-M-Tour_Finals-F-Pete_Sampras-Jim_Courier,1,B-DTL,16,7,4,0,3,10,6
19911117-M-Tour_Finals-F-Pete_Sampras-Jim_Courier,1,B-IO,6,4,2,0,2,3,3
19911117-M-Tour_Finals-F-Pete_Sampras-Jim_Courier,1,S-XC,15,1,0,0,1,6,9
19911117-M-Tour_Finals-F-Pete_Sampras-Jim_Courier,1,S-DTM,10,1,0,1,0,7,3
19911117-M-Tour_Finals-F-Pete_Sampras-Jim_Courier,1,S-DTL,4,3,0,2,1,3,1
19911117-M-Tour_Finals-F-Pete_Sampras-Jim_Courier,2,F-XC,34,13,4,7,2,23,11
19911117-M-Tour_Finals-F-Pete_Sampras-Jim_Courier,2,F-DTM,32,3,0,0,3,9,23
19911117-M-Tour_Finals-F-Pete_Sampras-Jim_Courier,2,F-DTL,11,4,3,1,0,7,4
19911117-M-Tour_Finals-F-Pete_Sampras-Jim_Courier,2,F-IO,82,15,4,3,8,30,52
19911117-M-Tour_Finals-F-Pete_Sampras-Jim_Courier,2,F-II,10,6,2,2,2,7,3
19911117-M-Tour_Finals-F-Pete_Sampras-Jim_Courier,2,B-XC,32,4,1,0,3,15,17
19911117-M-Tour_Finals-F-Pete_Sampras-Jim_Courier,2,B-DTM,13,4,0,2,2,6,7
19911117-M-Tour_Finals-F-Pete_Sampras-Jim_Courier,2,B-DTL,9,7,5,1,1,6,3
19911117-M-Tour_Finals-F-Pete_Sampras-Jim_Courier,2,B-IO,1,1,0,0,1,0,1
19911117-M-Tour_Finals-F-Pete_Sampras-Jim_Courier,2,S-XC,26,0,0,0,0,13,13
19911117-M-Tour_Finals-F-Pete_Sampras-Jim_Courier,2,S-DTM,7,0,0,0,0,3,4
19911117-M-Tour_Finals-F-Pete_Sampras-Jim_Courier,2,S-DTL,6,2,0,2,0,2,4
20180124-M-Australian_Open-QF-Tomas_Berdych-Roger_Federer,1,F-XC,50,11,3,7,1,24,26
20180124-M-Australian_Open-QF-Tomas_Berdych-Roger_Federer,1,F-DTM,10,0,0,0,0,4,6
20180124-M-Australian_Open-QF-Tomas_Berdych-Roger_Federer,1,F-DTL,18,3,0,2,1,8,10
20180124-M-Australian_Open-QF-Tomas_Berdych-Roger_Federer,1,F-IO,42,10,1,4,5,17,25
20180124-M-Australian_Open-QF-Tomas_Berdych-Roger_Federer,1,F-II,3,2,0,1,1,1,2
20180124-M-Australian_Open-QF-Tomas_Berdych-Roger_Federer,1,B-XC,39,3,0,0,3,18,21
20180124-M-Australian_Open-QF-Tomas_Berdych-Roger_Federer,1,B-DTM,9,1,0,0,1,6,3
20180124-M-Australian_Open-QF-Tomas_Berdych-Roger_Federer,1,B-DTL,16,9,2,3,4,7,9
20180124-M-Australian_Open-QF-Tomas_Berdych-Roger_Federer,1,B-IO,4,1,0,1,0,2,2
20180124-M-Australian_Open-QF-Tomas_Berdych-Roger_Federer,1,S-XC,14,0,0,0,0,1,13
20180124-M-Australian_Open-QF-Tomas_Berdych-Roger_Federer,1,S-DTM,5,0,0,0,0,4,1
20180124-M-Australian_Open-QF-Tomas_Berdych-Roger_Federer,1,S-DTL,5,0,0,0,0,0,5
20180124-M-Australian_Open-QF-Tomas_Berdych-Roger_Federer,2,F-XC,49,15,6,2,7,28,21
20180124-M-Australian_Open-QF-Tomas_Berdych-Roger_Federer,2,F-DTM,24,2,0,0,2,17,7
20180124-M-Australian_Open-QF-Tomas_Berdych-Roger_Federer,2,F-DTL,15,6,3,1,2,10,5
20180124-M-Australian_Open-QF-Tomas_Berdych-Roger_Federer,2,F-IO,18,5,2,3,0,11,7
20180124-M-Australian_Open-QF-Tomas_Berdych-Roger_Federer,2,F-II,12,8,4,3,1,11,1
20180124-M-Australian_Open-QF-Tomas_Berdych-Roger_Federer,2,B-XC,30,8,2,2,4,18,12
20180124-M-Australian_Open-QF-Tomas_Berdych-Roger_Federer,2,B-DTM,16,2,1,0,1,8,8
20180124-M-Australian_Open-QF-Tomas_Berdych-Roger_Federer,2,B-DTL,15,10,3,2,5,6,9
20180124-M-Australian_Open-QF-Tomas_Berdych-Roger_Federer,2,B-IO,3,1,1,0,0,3,0
20180124-M-Australian_Open-QF-Tomas_Berdych-Roger_Federer,2,S-XC,25,0,0,0,0,18,7
20180124-M-Australian_Open-QF-Tomas_Berdych-Roger_Federer,2,S-DTM,4,0,0,0,0,2,2
20180124-M-Australian_Open-QF-Tomas_Berdych-Roger_Federer,2,S-DTL,6,0,0,0,0,3,3
20180122-M-Australian_Open-R16-Roger_Federer-Marton_Fucsovics,1,F-XC,42,9,1,5,3,27,15
20180122-M-Australian_Open-R16-Roger_Federer-Marton_Fucsovics,1,F-DTM,20,2,0,0,2,12,8
20180122-M-Australian_Open-R16-Roger_Federer-Marton_Fucsovics,1,F-DTL,15,6,2,3,1,9,6
20180122-M-Australian_Open-R16-Roger_Federer-Marton_Fucsovics,1,F-IO,25,5,2,2,1,18,7
20180122-M-Australian_Open-R16-Roger_Federer-Marton_Fucsovics,1,F-II,7,3,2,0,1,4,3
20180122-M-Australian_Open-R16-Roger_Federer-Marton_Fucsovics,1,B-XC,38,7,0,5,2,22,16
20180122-M-Australian_Open-R16-Roger_Federer-Marton_Fucsovics,1,B-DTM,18,2,0,1,1,11,7
20180122-M-Australian_Open-R16-Roger_Federer-Marton_Fucsovics,1,B-DTL,10,3,0,0,3,4,6
20180122-M-Australian_Open-R16-Roger_Federer-Marton_Fucsovics,1,B-IO,3,1,0,1,0,3,0
20180122-M-Australian_Open-R16-Roger_Federer-Marton_Fucsovics,1,S-XC,21,2,0,0,2,13,8
20180122-M-Australian_Open-R16-Roger_Federer-Marton_Fucsovics,1,S-DTM,5,0,0,0,0,1,4
20180122-M-Australian_Open-R16-Roger_Federer-Marton_Fucsovics,1,S-DTL,4,3,1,1,1,3,1
20180122-M-Australian_Open-R16-Roger_Federer-Marton_Fucsovics,2,F-XC,44,9,5,1,3,21,23
20180122-M-Australian_Open-R16-Roger_Federer-Marton_Fucsovics,2,F-DTM,23,1,0,1,0,12,11
20180122-M-Australian_Open-R16-Roger_Federer-Marton_Fucsovics,2,F-DTL,22,3,0,0,3,9,13
20180122-M-Australian_Open-R16-Roger_Federer-Marton_Fucsovics,2,F-IO,36,6,0,3,3,17,19
20180122-M-Australian_Open-R16-Roger_Federer-Marton_Fucsovics,2,F-II,8,5,3,0,2,5,3
20180122-M-Australian_Open-R16-Roger_Federer-Marton_Fucsovics,2,B-XC,29,7,1,0,6,13,16
20180122-M-Australian_Open-R16-Roger_Federer-Marton_Fucsovics,2,B-DTM,18,2,1,0,1,6,12
20180122-M-Australian_Open-R16-Roger_Federer-Marton_Fucsovics,2,B-DTL,8,5,2,0,3,3,5
20180122-M-Australian_Open-R16-Roger_Federer-Marton_Fucsovics,2,B-IO,3,2,0,1,1,1,2
20180122-M-Australian_Open-R16-Roger_Federer-Marton_Fucsovics,2,S-XC,25,6,1,2,3,10,15
20180122-M-Australian_Open-R16-Roger_Federer-Marton_Fucsovics,2,S-DTM,9,0,0,0,0,3,6
20180122-M-Australian_Open-R16-Roger_Federer-Marton_Fucsovics,2,S-DTL,3,0,0,0,0,1,2
20180122-M-Australian_Open-R16-Roger_Federer-Marton_Fucsovics,2,S-IO,1,1,0,0,1,0,1
20180123-M-Australian_Open-QF-Rafael_Nadal-Marin_Cilic,1,F-XC,78,13,1,6,6,44,34
20180123-M-Australian_Open-QF-Rafael_Nadal-Marin_Cilic,1,F-DTM,22,2,0,0,2,12,10
20180123-M-Australian_Open-QF-Rafael_Nadal-Marin_Cilic,1,F-DTL,21,10,9,0,1,14,7
20180123-M-Australian_Open-QF-Rafael_Nadal-Marin_Cilic,1,F-IO,32,11,5,4,2,19,13
20180123-M-Australian_Open-QF-Rafael_Nadal-Marin_Cilic,1,F-II,6,0,0,0,0,4,2
20180123-M-Australian_Open-QF-Rafael_Nadal-Marin_Cilic,1,B-XC,61,13,6,3,4,33,28
20180123-M-Australian_Open-QF-Rafael_Nadal-Marin_Cilic,1,B-DTM,31,3,0,0,3,14,17
20180123-M-Australian_Open-QF-Rafael_Nadal-Marin_Cilic,1,B-DTL,22,6,1,2,3,13,9
20180123-M-Australian_Open-QF-Rafael_Nadal-Marin_Cilic,1,S-XC,12,1,0,0,1,5,7
20180123-M-Australian_Open-QF-Rafael_Nadal-Marin_Cilic,1,S-DTM,6,1,0,0,1,3,3
20180123-M-Australian_Open-QF-Rafael_Nadal-Marin_Cilic,1,S-DTL,19,1,0,0,1,7,12
20180123-M-Australian_Open-QF-Rafael_Nadal-Marin_Cilic,2,F-XC,100,21,5,5,11,45,55
20180123-M-Australian_Open-QF-Rafael_Nadal-Marin_Cilic,2,F-DTM,18,1,0,0,1,12,6
20180123-M-Australian_Open-QF-Rafael_Nadal-Marin_Cilic,2,F-DTL,27,18,10,3,5,20,7
20180123-M-Australian_Open-QF-Rafael_Nadal-Marin_Cilic,2,F-IO,25,17,7,1,9,13,12
20180123-M-Australian_Open-QF-Rafael_Nadal-Marin_Cilic,2,F-II,18,5,1,2,2,8,10
20180123-M-Australian_Open-QF-Rafael_Nadal-Marin_Cilic,2,B-XC,46,17,8,3,6,23,23
20180123-M-Australian_Open-QF-Rafael_Nadal-Marin_Cilic,2,B-DTM,32,7,1,0,6,9,23
20180123-M-Australian_Open-QF-Rafael_Nadal-Marin_Cilic,2,B-DTL,27,8,3,0,5,11,16
20180123-M-Australian_Open-QF-Rafael_Nadal-Marin_Cilic,2,B-IO,6,4,1,0,3,1,5
20180123-M-Australian_Open-QF-Rafael_Nadal-Marin_Cilic,2,S-XC,1,0,0,0,0,1,0
20180123-M-Australian_Open-QF-Rafael_Nadal-Marin_Cilic,2,S-DTM,3,0,0,0,0,0,3
20180123-M-Australian_Open-QF-Rafael_Nadal-Marin_Cilic,2,S-DTL,4,0,0,0,0,2,2
19920426-M-Monte_Carlo_Masters-F-Aaron_Krickstein-Thomas_Muster,1,F-XC,80,2,2,0,0,31,49
19920426-M-Monte_Carlo_Masters-F-Aaron_Krickstein-Thomas_Muster,1,F-DTM,47,1,0,0,1,20,27
19920426-M-Monte_Carlo_Masters-F-Aaron_Krickstein-Thomas_Muster,1,F-DTL,13,4,2,0,2,7,6
19920426-M-Monte_Carlo_Masters-F-Aaron_Krickstein-Thomas_Muster,1,F-IO,35,8,0,4,4,18,17
19920426-M-Monte_Carlo_Masters-F-Aaron_Krickstein-Thomas_Muster,1,F-II,13,4,0,0,4,5,8
19920426-M-Monte_Carlo_Masters-F-Aaron_Krickstein-Thomas_Muster,1,B-XC,78,8,0,0,8,34,44
19920426-M-Monte_Carlo_Masters-F-Aaron_Krickstein-Thomas_Muster,1,B-DTM,65,2,0,0,2,27,38
19920426-M-Monte_Carlo_Masters-F-Aaron_Krickstein-Thomas_Muster,1,B-DTL,14,5,2,0,3,3,11
19920426-M-Monte_Carlo_Masters-F-Aaron_Krickstein-Thomas_Muster,1,B-IO,6,2,0,0,2,2,4
19920426-M-Monte_Carlo_Masters-F-Aaron_Krickstein-Thomas_Muster,1,S-XC,12,1,0,0,1,3,9
19920426-M-Monte_Carlo_Masters-F-Aaron_Krickstein-Thomas_Muster,1,S-DTM,10,1,0,0,1,1,9
19920426-M-Monte_Carlo_Masters-F-Aaron_Krickstein-Thomas_Muster,1,S-DTL,11,4,2,0,2,8,3
19920426-M-Monte_Carlo_Masters-F-Aaron_Krickstein-Thomas_Muster,1,S-IO,1,0,0,0,0,1,0
19920426-M-Monte_Carlo_Masters-F-Aaron_Krickstein-Thomas_Muster,2,F-XC,146,7,1,4,2,79,67
19920426-M-Monte_Carlo_Masters-F-Aaron_Krickstein-Thomas_Muster,2,F-DTM,54,2,0,1,1,37,17
19920426-M-Monte_Carlo_Masters-F-Aaron_Krickstein-Thomas_Muster,2,F-DTL,24,10,4,2,4,16,8
19920426-M-Monte_Carlo_Masters-F-Aaron_Krickstein-Thomas_Muster,2,F-IO,37,17,8,5,4,25,12
19920426-M-Monte_Carlo_Masters-F-Aaron_Krickstein-Thomas_Muster,2,F-II,10,1,0,1,0,6,4
19920426-M-Monte_Carlo_Masters-F-Aaron_Krickstein-Thomas_Muster,2,B-XC,31,7,1,1,5,12,19
19920426-M-Monte_Carlo_Masters-F-Aaron_Krickstein-Thomas_Muster,2,B-DTM,45,5,0,0,5,29,16
19920426-M-Monte_Carlo_Masters-F-Aaron_Krickstein-Thomas_Muster,2,B-DTL,19,7,2,0,5,11,8
19920426-M-Monte_Carlo_Masters-F-Aaron_Krickstein-Thomas_Muster,2,B-IO,5,1,0,0,1,4,1
19920426-M-Monte_Carlo_Masters-F-Aaron_Krickstein-Thomas_Muster,2,S-XC,3,0,0,0,0,0,3
19920426-M-Monte_Carlo_Masters-F-Aaron_Krickstein-Thomas_Muster,2,S-DTM,15,0,0,0,0,8,7
19920426-M-Monte_Carlo_Masters-F-Aaron_Krickstein-Thomas_Muster,2,S-DTL,5,1,0,0,1,1,4
19920726-M-Canada_Masters-F-Andre_Agassi-Ivan_Lendl,1,F-XC,21,5,5,0,0,12,9
19920726-M-Canada_Masters-F-Andre_Agassi-Ivan_Lendl,1,F-DTM,25,4,0,2,2,8,17
19920726-M-Canada_Masters-F-Andre_Agassi-Ivan_Lendl,1,F-DTL,3,0,0,0,0,2,1
19920726-M-Canada_Masters-F-Andre_Agassi-Ivan_Lendl,1,F-IO,25,6,1,4,1,19,6
19920726-M-Canada_Masters-F-Andre_Agassi-Ivan_Lendl,1,F-II,7,4,1,1,2,4,3
19920726-M-Canada_Masters-F-Andre_Agassi-Ivan_Lendl,1,B-XC,92,10,2,2,5,48,44
19920726-M-Canada_Masters-F-Andre_Agassi-Ivan_Lendl,1,B-DTM,17,2,0,1,1,12,5
19920726-M-Canada_Masters-F-Andre_Agassi-Ivan_Lendl,1,B-DTL,19,10,2,1,7,9,10
19920726-M-Canada_Masters-F-Andre_Agassi-Ivan_Lendl,1,B-IO,4,2,1,0,1,1,3
19920726-M-Canada_Masters-F-Andre_Agassi-Ivan_Lendl,1,S-XC,5,0,0,0,0,1,4
19920726-M-Canada_Masters-F-Andre_Agassi-Ivan_Lendl,1,S-DTM,4,0,0,0,0,2,2
19920726-M-Canada_Masters-F-Andre_Agassi-Ivan_Lendl,1,S-DTL,1,0,0,0,0,0,1
19920726-M-Canada_Masters-F-Andre_Agassi-Ivan_Lendl,2,F-XC,28,10,4,3,3,18,10
19920726-M-Canada_Masters-F-Andre_Agassi-Ivan_Lendl,2,F-DTM,23,2,0,1,1,12,11
19920726-M-Canada_Masters-F-Andre_Agassi-Ivan_Lendl,2,F-DTL,7,3,0,0,3,1,6
19920726-M-Canada_Masters-F-Andre_Agassi-Ivan_Lendl,2,F-IO,21,5,2,2,1,10,11
19920726-M-Canada_Masters-F-Andre_Agassi-Ivan_Lendl,2,F-II,8,5,3,1,1,4,4
19920726-M-Canada_Masters-F-Andre_Agassi-Ivan_Lendl,2,B-XC,22,4,1,1,2,10,12
19920726-M-Canada_Masters-F-Andre_Agassi-Ivan_Lendl,2,B-DTM,16,2,0,1,1,6,10
19920726-M-Canada_Masters-F-Andre_Agassi-Ivan_Lendl,2,B-DTL,9,8,4,0,4,5,4
19920726-M-Canada_Masters-F-Andre_Agassi-Ivan_Lendl,2,B-IO,1,0,0,0,0,1,0
19920726-M-Canada_Masters-F-Andre_Agassi-Ivan_Lendl,2,S-XC,54,5,0,0,5,18,36
19920726-M-Canada_Masters-F-Andre_Agassi-Ivan_Lendl,2,S-DTM,32,0,0,0,0,17,15
19920726-M-Canada_Masters-F-Andre_Agassi-Ivan_Lendl,2,S-DTL,6,1,1,0,0,4,2
19920726-M-Canada_Masters-F-Andre_Agassi-Ivan_Lendl,2,S-IO,1,1,0,0,1,0,1
19920510-M-Hamburg_Masters-F-Stefan_Edberg-Michael_Stich,1,F-XC,14,3,0,1,2,3,11
19920510-M-Hamburg_Masters-F-Stefan_Edberg-Michael_Stich,1,F-DTM,9,2,0,0,2,3,6
19920510-M-Hamburg_Masters-F-Stefan_Edberg-Michael_Stich,1,F-DTL,17,6,1,3,2,7,10
19920510-M-Hamburg_Masters-F-Stefan_Edberg-Michael_Stich,1,F-IO,6,1,0,1,0,4,2
19920510-M-Hamburg_Masters-F-Stefan_Edberg-Michael_Stich,1,B-XC,33,4,1,1,2,11,22
19920510-M-Hamburg_Masters-F-Stefan_Edberg-Michael_Stich,1,B-DTM,20,1,0,0,1,9,11
19920510-M-Hamburg_Masters-F-Stefan_Edberg-Michael_Stich,1,B-DTL,11,7,5,1,1,9,2
19920510-M-Hamburg_Masters-F-Stefan_Edberg-Michael_Stich,1,B-IO,7,4,0,0,4,1,6
19920510-M-Hamburg_Masters-F-Stefan_Edberg-Michael_Stich,1,S-XC,14,2,1,0,1,10,4
19920510-M-Hamburg_Masters-F-Stefan_Edberg-Michael_Stich,1,S-DTM,3,0,0,0,0,1,2
19920510-M-Hamburg_Masters-F-Stefan_Edberg-Michael_Stich,1,S-DTL,2,1,0,1,0,1,1
19920510-M-Hamburg_Masters-F-Stefan_Edberg-Michael_Stich,1,S-II,1,0,0,0,0,0,1
19920510-M-Hamburg_Masters-F-Stefan_Edberg-Michael_Stich,2,F-XC,17,5,2,1,2,10,7
19920510-M-Hamburg_Masters-F-Stefan_Edberg-Michael_Stich,2,F-DTM,8,0,0,0,0,2,6
19920510-M-Hamburg_Masters-F-Stefan_Edberg-Michael_Stich,2,F-DTL,6,2,1,0,1,3,3
19920510-M-Hamburg_Masters-F-Stefan_Edberg-Michael_Stich,2,F-IO,9,3,1,0,2,4,5
19920510-M-Hamburg_Masters-F-Stefan_Edberg-Michael_Stich,2,B-XC,22,6,3,3,0,15,7
19920510-M-Hamburg_Masters-F-Stefan_Edberg-Michael_Stich,2,B-DTM,19,3,0,0,3,7,12
19920510-M-Hamburg_Masters-F-Stefan_Edberg-Michael_Stich,2,B-DTL,15,5,3,2,0,10,5
19920510-M-Hamburg_Masters-F-Stefan_Edberg-Michael_Stich,2,B-IO,3,3,1,1,1,2,1
19920510-M-Hamburg_Masters-F-Stefan_Edberg-Michael_Stich,2,S-XC,12,1,1,0,0,8,4
19920510-M-Hamburg_Masters-F-Stefan_Edberg-Michael_Stich,2,S-DTM,13,1,0,0,1,7,6
19920510-M-Hamburg_Masters-F-Stefan_Edberg-Michael_Stich,2,S-DTL,8,1,0,0,1,4,4
19920510-M-Hamburg_Masters-F-Stefan_Edberg-Michael_Stich,2,S-IO,2,0,0,0,0,2,0
19981101-M-Stuttgart_Masters-F-Yevgeny_Kafelnikov-Richard_Krajicek,1,F-XC,9,7,2,2,3,4,5
19981101-M-Stuttgart_Masters-F-Yevgeny_Kafelnikov-Richard_Krajicek,1,F-DTM,14,3,1,1,1,8,6
19981101-M-Stuttgart_Masters-F-Yevgeny_Kafelnikov-Richard_Krajicek,1,F-DTL,4,2,2,0,0,3,1
19981101-M-Stuttgart_Masters-F-Yevgeny_Kafelnikov-Richard_Krajicek,1,F-IO,9,2,0,1,1,5,4
19981101-M-Stuttgart_Masters-F-Yevgeny_Kafelnikov-Richard_Krajicek,1,F-II,1,0,0,0,0,1,0
19981101-M-Stuttgart_Masters-F-Yevgeny_Kafelnikov-Richard_Krajicek,1,B-XC,23,4,1,2,1,8,15
19981101-M-Stuttgart_Masters-F-Yevgeny_Kafelnikov-Richard_Krajicek,1,B-DTM,5,1,0,0,1,1,4
19981101-M-Stuttgart_Masters-F-Yevgeny_Kafelnikov-Richard_Krajicek,1,B-DTL,6,2,0,1,1,3,3
19981101-M-Stuttgart_Masters-F-Yevgeny_Kafelnikov-Richard_Krajicek,1,B-IO,1,1,0,0,1,0,1
19981101-M-Stuttgart_Masters-F-Yevgeny_Kafelnikov-Richard_Krajicek,1,S-XC,3,1,0,1,0,2,1
19981101-M-Stuttgart_Masters-F-Yevgeny_Kafelnikov-Richard_Krajicek,1,S-DTM,3,1,0,1,0,3,0
19981101-M-Stuttgart_Masters-F-Yevgeny_Kafelnikov-Richard_Krajicek,1,S-IO,1,1,0,0,1,0,1
19981101-M-Stuttgart_Masters-F-Yevgeny_Kafelnikov-Richard_Krajicek,2,F-XC,5,3,0,1,2,2,3
19981101-M-Stuttgart_Masters-F-Yevgeny_Kafelnikov-Richard_Krajicek,2,F-DTM,5,0,0,0,0,2,3
19981101-M-Stuttgart_Masters-F-Yevgeny_Kafelnikov-Richard_Krajicek,2,F-IO,6,4,0,1,3,2,4
19981101-M-Stuttgart_Masters-F-Yevgeny_Kafelnikov-Richard_Krajicek,2,B-XC,2,0,0,0,0,1,1
19981101-M-Stuttgart_Masters-F-Yevgeny_Kafelnikov-Richard_Krajicek,2,B-DTM,4,1,0,1,0,3,1
19981101-M-Stuttgart_Masters-F-Yevgeny_Kafelnikov-Richard_Krajicek,2,B-DTL,1,1,1,0,0,1,0
19981101-M-Stuttgart_Masters-F-Yevgeny_Kafelnikov-Richard_Krajicek,2,S-XC,13,3,0,0,3,7,6
19981101-M-Stuttgart_Masters-F-Yevgeny_Kafelnikov-Richard_Krajicek,2,S-DTM,7,1,1,0,0,5,2
19981101-M-Stuttgart_Masters-F-Yevgeny_Kafelnikov-Richard_Krajicek,2,S-DTL,6,0,0,0,0,3,3
19910728-M-Canada_Masters-F-Petr_Korda-Andrei_Chesnokov,1,F-XC,74,17,6,4,7,40,34
19910728-M-Canada_Masters-F-Petr_Korda-Andrei_Chesnokov,1,F-DTM,38,3,0,1,2,16,22
19910728-M-Canada_Masters-F-Petr_Korda-Andrei_Chesnokov,1,F-DTL,13,10,2,3,5,8,5
19910728-M-Canada_Masters-F-Petr_Korda-Andrei_Chesnokov,1,F-IO,29,14,8,1,5,13,16
19910728-M-Canada_Masters-F-Petr_Korda-Andrei_Chesnokov,1,F-II,2,0,0,0,0,1,1
19910728-M-Canada_Masters-F-Petr_Korda-Andrei_Chesnokov,1,B-XC,33,10,3,1,6,20,13
19910728-M-Canada_Masters-F-Petr_Korda-Andrei_Chesnokov,1,B-DTM,27,2,1,0,1,16,11
19910728-M-Canada_Masters-F-Petr_Korda-Andrei_Chesnokov,1,B-DTL,9,5,2,0,3,4,5
19910728-M-Canada_Masters-F-Petr_Korda-Andrei_Chesnokov,1,B-IO,12,1,0,0,1,8,4
19910728-M-Canada_Masters-F-Petr_Korda-Andrei_Chesnokov,1,S-XC,18,2,1,1,0,15,3
19910728-M-Canada_Masters-F-Petr_Korda-Andrei_Chesnokov,1,S-DTM,15,1,0,0,1,10,5
19910728-M-Canada_Masters-F-Petr_Korda-Andrei_Chesnokov,1,S-DTL,5,2,0,0,2,2,3
19910728-M-Canada_Masters-F-Petr_Korda-Andrei_Chesnokov,1,S-IO,1,0,0,0,0,0,1
19910728-M-Canada_Masters-F-Petr_Korda-Andrei_Chesnokov,2,F-XC,55,5,1,1,3,21,34
19910728-M-Canada_Masters-F-Petr_Korda-Andrei_Chesnokov,2,F-DTM,40,3,0,1,2,15,25
19910728-M-Canada_Masters-F-Petr_Korda-Andrei_Chesnokov,2,F-DTL,9,4,3,0,1,4,5
19910728-M-Canada_Masters-F-Petr_Korda-Andrei_Chesnokov,2,F-IO,13,6,2,2,2,9,4
19910728-M-Canada_Masters-F-Petr_Korda-Andrei_Chesnokov,2,B-XC,42,9,3,4,2,20,22
19910728-M-Canada_Masters-F-Petr_Korda-Andrei_Chesnokov,2,B-DTM,59,5,0,2,3,31,28
19910728-M-Canada_Masters-F-Petr_Korda-Andrei_Chesnokov,2,B-DTL,14,6,1,1,4,6,8
19910728-M-Canada_Masters-F-Petr_Korda-Andrei_Chesnokov,2,B-IO,17,6,1,2,3,7,10
19910728-M-Canada_Masters-F-Petr_Korda-Andrei_Chesnokov,2,S-DTM,7,1,0,0,1,1,6
19910728-M-Canada_Masters-F-Petr_Korda-Andrei_Chesnokov,2,S-DTL,8,2,0,2,0,3,5
19910728-M-Canada_Masters-F-Petr_Korda-Andrei_Chesnokov,2,S-IO,2,0,0,0,0,1,1
20180318-M-Indian_Wells_Masters-F-Roger_Federer-Juan_Martin_Del_Potro,1,F-XC,48,19,6,3,10,26,22
20180318-M-Indian_Wells_Masters-F-Roger_Federer-Juan_Martin_Del_Potro,1,F-DTM,28,3,0,0,3,14,14
20180318-M-Indian_Wells_Masters-F-Roger_Federer-Juan_Martin_Del_Potro,1,F-DTL,15,6,3,1,2,10,5
20180318-M-Indian_Wells_Masters-F-Roger_Federer-Juan_Martin_Del_Potro,1,F-IO,36,14,8,3,3,21,15
20180318-M-Indian_Wells_Masters-F-Roger_Federer-Juan_Martin_Del_Potro,1,F-II,11,6,3,0,3,5,6
20180318-M-Indian_Wells_Masters-F-Roger_Federer-Juan_Martin_Del_Potro,1,B-XC,36,2,0,0,2,16,20
20180318-M-Indian_Wells_Masters-F-Roger_Federer-Juan_Martin_Del_Potro,1,B-DTM,30,6,0,3,3,15,15
20180318-M-Indian_Wells_Masters-F-Roger_Federer-Juan_Martin_Del_Potro,1,B-DTL,15,6,3,0,3,6,9
20180318-M-Indian_Wells_Masters-F-Roger_Federer-Juan_Martin_Del_Potro,1,B-IO,2,1,0,0,1,0,2
20180318-M-Indian_Wells_Masters-F-Roger_Federer-Juan_Martin_Del_Potro,1,S-XC,11,0,0,0,0,7,4
20180318-M-Indian_Wells_Masters-F-Roger_Federer-Juan_Martin_Del_Potro,1,S-DTM,5,0,0,0,0,2,3
20180318-M-Indian_Wells_Masters-F-Roger_Federer-Juan_Martin_Del_Potro,1,S-DTL,5,2,0,1,1,2,3
20180318-M-Indian_Wells_Masters-F-Roger_Federer-Juan_Martin_Del_Potro,2,F-XC,49,18,8,4,6,25,24
20180318-M-Indian_Wells_Masters-F-Roger_Federer-Juan_Martin_Del_Potro,2,F-DTM,29,3,0,0,3,16,13
20180318-M-Indian_Wells_Masters-F-Roger_Federer-Juan_Martin_Del_Potro,2,F-DTL,12,6,4,1,1,8,4
20180318-M-Indian_Wells_Masters-F-Roger_Federer-Juan_Martin_Del_Potro,2,F-IO,40,13,4,4,5,24,16
20180318-M-Indian_Wells_Masters-F-Roger_Federer-Juan_Martin_Del_Potro,2,F-II,9,5,4,1,0,6,3
20180318-M-Indian_Wells_Masters-F-Roger_Federer-Juan_Martin_Del_Potro,2,B-XC,44,4,1,1,2,23,21
20180318-M-Indian_Wells_Masters-F-Roger_Federer-Juan_Martin_Del_Potro,2,B-DTM,18,1,0,0,1,6,12
20180318-M-Indian_Wells_Masters-F-Roger_Federer-Juan_Martin_Del_Potro,2,B-DTL,9,6,2,4,0,7,2
20180318-M-Indian_Wells_Masters-F-Roger_Federer-Juan_Martin_Del_Potro,2,B-IO,2,0,0,0,0,2,0
20180318-M-Indian_Wells_Masters-F-Roger_Federer-Juan_Martin_Del_Potro,2,S-XC,24,1,0,0,1,12,12
20180318-M-Indian_Wells_Masters-F-Roger_Federer-Juan_Martin_Del_Potro,2,S-DTM,12,1,0,0,1,2,10
20180318-M-Indian_Wells_Masters-F-Roger_Federer-Juan_Martin_Del_Potro,2,S-DTL,3,0,0,0,0,2,1
20180318-M-Indian_Wells_Masters-F-Roger_Federer-Juan_Martin_Del_Potro,2,S-IO,1,0,0,0,0,0,1
19980315-M-Indian_Wells_Masters-F-Marcelo_Rios-Greg_Rusedski,1,F-XC,40,24,9,7,8,21,19
19980315-M-Indian_Wells_Masters-F-Marcelo_Rios-Greg_Rusedski,1,F-DTM,18,2,1,0,1,11,7
19980315-M-Indian_Wells_Masters-F-Marcelo_Rios-Greg_Rusedski,1,F-DTL,8,4,2,0,2,5,3
19980315-M-Indian_Wells_Masters-F-Marcelo_Rios-Greg_Rusedski,1,F-IO,45,9,2,4,3,26,19
19980315-M-Indian_Wells_Masters-F-Marcelo_Rios-Greg_Rusedski,1,F-II,2,1,0,0,1,1,1
19980315-M-Indian_Wells_Masters-F-Marcelo_Rios-Greg_Rusedski,1,B-XC,50,11,5,5,1,37,13
19980315-M-Indian_Wells_Masters-F-Marcelo_Rios-Greg_Rusedski,1,B-DTM,20,1,0,1,0,17,3
19980315-M-Indian_Wells_Masters-F-Marcelo_Rios-Greg_Rusedski,1,B-DTL,10,5,5,0,0,7,3
19980315-M-Indian_Wells_Masters-F-Marcelo_Rios-Greg_Rusedski,1,B-IO,4,3,2,0,1,3,1
19980315-M-Indian_Wells_Masters-F-Marcelo_Rios-Greg_Rusedski,1,S-XC,4,0,0,0,0,2,2
19980315-M-Indian_Wells_Masters-F-Marcelo_Rios-Greg_Rusedski,1,S-DTM,2,0,0,0,0,1,1
19980315-M-Indian_Wells_Masters-F-Marcelo_Rios-Greg_Rusedski,1,S-DTL,2,1,0,1,0,2,0
19980315-M-Indian_Wells_Masters-F-Marcelo_Rios-Greg_Rusedski,2,F-XC,11,6,2,2,2,8,3
19980315-M-Indian_Wells_Masters-F-Marcelo_Rios-Greg_Rusedski,2,F-DTM,6,0,0,0,0,1,5
19980315-M-Indian_Wells_Masters-F-Marcelo_Rios-Greg_Rusedski,2,F-DTL,5,0,0,0,0,0,5
19980315-M-Indian_Wells_Masters-F-Marcelo_Rios-Greg_Rusedski,2,F-IO,9,1,1,0,0,1,8
19980315-M-Indian_Wells_Masters-F-Marcelo_Rios-Greg_Rusedski,2,F-II,1,1,0,0,1,0,1
19980315-M-Indian_Wells_Masters-F-Marcelo_Rios-Greg_Rusedski,2,B-XC,4,1,0,1,0,2,2
19980315-M-Indian_Wells_Masters-F-Marcelo_Rios-Greg_Rusedski,2,B-DTM,15,4,0,0,4,6,9
19980315-M-Indian_Wells_Masters-F-Marcelo_Rios-Greg_Rusedski,2,B-DTL,3,1,1,0,0,2,1
19980315-M-Indian_Wells_Masters-F-Marcelo_Rios-Greg_Rusedski,2,B-IO,1,1,0,0,1,0,1
19980315-M-Indian_Wells_Masters-F-Marcelo_Rios-Greg_Rusedski,2,S-XC,38,6,1,0,5,14,24
19980315-M-Indian_Wells_Masters-F-Marcelo_Rios-Greg_Rusedski,2,S-DTM,22,1,0,0,1,9,13
19980315-M-Indian_Wells_Masters-F-Marcelo_Rios-Greg_Rusedski,2,S-DTL,9,3,0,0,3,2,7
19980315-M-Indian_Wells_Masters-F-Marcelo_Rios-Greg_Rusedski,2,S-IO,6,3,0,0,3,0,6
19900429-M-Monte_Carlo_Masters-F-Andrei_Chesnokov-Thomas_Muster,1,F-XC,147,8,0,6,2,95,52
19900429-M-Monte_Carlo_Masters-F-Andrei_Chesnokov-Thomas_Muster,1,F-DTM,74,2,0,0,2,29,45
19900429-M-Monte_Carlo_Masters-F-Andrei_Chesnokov-Thomas_Muster,1,F-DTL,19,4,0,1,3,5,14
19900429-M-Monte_Carlo_Masters-F-Andrei_Chesnokov-Thomas_Muster,1,F-IO,36,8,4,1,3,25,11
19900429-M-Monte_Carlo_Masters-F-Andrei_Chesnokov-Thomas_Muster,1,F-II,2,0,0,0,0,2,0
19900429-M-Monte_Carlo_Masters-F-Andrei_Chesnokov-Thomas_Muster,1,B-XC,162,11,5,0,6,89,73
19900429-M-Monte_Carlo_Masters-F-Andrei_Chesnokov-Thomas_Muster,1,B-DTM,156,6,0,3,3,90,66
19900429-M-Monte_Carlo_Masters-F-Andrei_Chesnokov-Thomas_Muster,1,B-DTL,40,6,1,3,2,25,15
19900429-M-Monte_Carlo_Masters-F-Andrei_Chesnokov-Thomas_Muster,1,B-IO,30,5,0,1,4,17,13
19900429-M-Monte_Carlo_Masters-F-Andrei_Chesnokov-Thomas_Muster,1,B-II,2,0,0,0,0,1,1
19900429-M-Monte_Carlo_Masters-F-Andrei_Chesnokov-Thomas_Muster,1,S-XC,2,0,0,0,0,2,0
19900429-M-Monte_Carlo_Masters-F-Andrei_Chesnokov-Thomas_Muster,1,S-DTM,22,0,0,0,0,8,14
19900429-M-Monte_Carlo_Masters-F-Andrei_Chesnokov-Thomas_Muster,1,S-DTL,3,1,0,1,0,2,1
19900429-M-Monte_Carlo_Masters-F-Andrei_Chesnokov-Thomas_Muster,1,S-IO,3,2,0,1,1,1,2
19900429-M-Monte_Carlo_Masters-F-Andrei_Chesnokov-Thomas_Muster,2,F-XC,248,24,3,10,11,121,127
19900429-M-Monte_Carlo_Masters-F-Andrei_Chesnokov-Thomas_Muster,2,F-DTM,98,2,0,0,2,36,62
19900429-M-Monte_Carlo_Masters-F-Andrei_Chesnokov-Thomas_Muster,2,F-DTL,51,9,0,1,8,20,31
19900429-M-Monte_Carlo_Masters-F-Andrei_Chesnokov-Thomas_Muster,2,F-IO,72,16,2,3,11,42,30
19900429-M-Monte_Carlo_Masters-F-Andrei_Chesnokov-Thomas_Muster,2,F-II,23,3,0,2,1,13,10
19900429-M-Monte_Carlo_Masters-F-Andrei_Chesnokov-Thomas_Muster,2,B-XC,68,12,0,4,8,25,43
19900429-M-Monte_Carlo_Masters-F-Andrei_Chesnokov-Thomas_Muster,2,B-DTM,91,3,0,0,3,33,58
19900429-M-Monte_Carlo_Masters-F-Andrei_Chesnokov-Thomas_Muster,2,B-DTL,25,2,0,0,2,9,16
19900429-M-Monte_Carlo_Masters-F-Andrei_Chesnokov-Thomas_Muster,2,B-IO,8,3,0,1,2,2,6
19900429-M-Monte_Carlo_Masters-F-Andrei_Chesnokov-Thomas_Muster,2,S-DTM,7,2,0,0,2,0,7
19900429-M-Monte_Carlo_Masters-F-Andrei_Chesnokov-Thomas_Muster,2,S-DTL,1,0,0,0,0,1,0
19900429-M-Monte_Carlo_Masters-F-Andrei_Chesnokov-Thomas_Muster,2,S-IO,1,1,0,1,0,1,0
19920517-M-Rome_Masters-F-Jim_Courier-Carlos_Costa,1,F-XC,52,11,3,3,5,29,23
19920517-M-Rome_Masters-F-Jim_Courier-Carlos_Costa,1,F-DTM,47,5,0,0,5,26,21
19920517-M-Rome_Masters-F-Jim_Courier-Carlos_Costa,1,F-DTL,13,7,0,2,5,6,7
19920517-M-Rome_Masters-F-Jim_Courier-Carlos_Costa,1,F-IO,49,13,1,6,6,25,24
19920517-M-Rome_Masters-F-Jim_Courier-Carlos_Costa,1,F-II,12,7,2,4,1,10,2
19920517-M-Rome_Masters-F-Jim_Courier-Carlos_Costa,1,B-XC,32,5,1,1,3,16,16
19920517-M-Rome_Masters-F-Jim_Courier-Carlos_Costa,1,B-DTM,28,3,0,1,2,16,12
19920517-M-Rome_Masters-F-Jim_Courier-Carlos_Costa,1,B-DTL,3,2,0,2,0,3,0
19920517-M-Rome_Masters-F-Jim_Courier-Carlos_Costa,1,S-XC,11,0,0,0,0,3,8
19920517-M-Rome_Masters-F-Jim_Courier-Carlos_Costa,1,S-DTM,9,0,0,0,0,5,4
19920517-M-Rome_Masters-F-Jim_Courier-Carlos_Costa,1,S-DTL,2,1,0,1,0,2,0
19920517-M-Rome_Masters-F-Jim_Courier-Carlos_Costa,1,S-IO,1,0,0,0,0,1,0
19920517-M-Rome_Masters-F-Jim_Courier-Carlos_Costa,2,F-XC,33,6,3,0,3,16,17
19920517-M-Rome_Masters-F-Jim_Courier-Carlos_Costa,2,F-DTM,54,6,1,0,5,19,35
19920517-M-Rome_Masters-F-Jim_Courier-Carlos_Costa,2,F-DTL,19,4,1,3,0,11,8
19920517-M-Rome_Masters-F-Jim_Courier-Carlos_Costa,2,F-IO,21,4,1,2,1,10,11
19920517-M-Rome_Masters-F-Jim_Courier-Carlos_Costa,2,F-II,3,2,0,1,1,1,2
19920517-M-Rome_Masters-F-Jim_Courier-Carlos_Costa,2,B-XC,49,4,0,0,4,24,25
19920517-M-Rome_Masters-F-Jim_Courier-Carlos_Costa,2,B-DTM,29,3,0,0,3,10,19
19920517-M-Rome_Masters-F-Jim_Courier-Carlos_Costa,2,B-DTL,14,3,0,1,2,8,6
19920517-M-Rome_Masters-F-Jim_Courier-Carlos_Costa,2,B-IO,10,7,0,3,4,6,4
19920517-M-Rome_Masters-F-Jim_Courier-Carlos_Costa,2,S-XC,8,1,0,0,1,2,6
19920517-M-Rome_Masters-F-Jim_Courier-Carlos_Costa,2,S-DTM,6,1,0,0,1,2,4
19920517-M-Rome_Masters-F-Jim_Courier-Carlos_Costa,2,S-DTL,5,1,1,0,0,4,1
19841209-M-Australian_Open-F-Mats_Wilander-Kevin_Curren,1,F-XC,8,5,5,0,0,5,3
19841209-M-Australian_Open-F-Mats_Wilander-Kevin_Curren,1,F-DTM,13,1,1,0,0,7,6
19841209-M-Australian_Open-F-Mats_Wilander-Kevin_Curren,1,F-DTL,15,9,5,4,0,11,4
19841209-M-Australian_Open-F-Mats_Wilander-Kevin_Curren,1,F-IO,19,10,4,5,1,13,6
19841209-M-Australian_Open-F-Mats_Wilander-Kevin_Curren,1,B-XC,14,4,0,1,3,5,9
19841209-M-Australian_Open-F-Mats_Wilander-Kevin_Curren,1,B-DTM,14,1,0,1,0,8,6
19841209-M-Australian_Open-F-Mats_Wilander-Kevin_Curren,1,B-DTL,13,8,5,0,3,6,7
19841209-M-Australian_Open-F-Mats_Wilander-Kevin_Curren,1,B-IO,3,0,0,0,0,0,3
19841209-M-Australian_Open-F-Mats_Wilander-Kevin_Curren,1,S-XC,8,1,0,1,0,6,2
19841209-M-Australian_Open-F-Mats_Wilander-Kevin_Curren,1,S-DTM,3,1,0,0,1,1,2
19841209-M-Australian_Open-F-Mats_Wilander-Kevin_Curren,1,S-DTL,2,0,0,0,0,1,1
19841209-M-Australian_Open-F-Mats_Wilander-Kevin_Curren,2,F-XC,9,4,2,0,2,4,5
19841209-M-Australian_Open-F-Mats_Wilander-Kevin_Curren,2,F-DTM,7,3,1,1,1,4,3
19841209-M-Australian_Open-F-Mats_Wilander-Kevin_Curren,2,F-DTL,2,1,1,0,0,2,0
19841209-M-Australian_Open-F-Mats_Wilander-Kevin_Curren,2,F-IO,12,9,3,0,6,5,7
19841209-M-Australian_Open-F-Mats_Wilander-Kevin_Curren,2,B-XC,4,3,2,1,0,4,0
19841209-M-Australian_Open-F-Mats_Wilander-Kevin_Curren,2,B-DTM,6,1,0,0,1,0,6
19841209-M-Australian_Open-F-Mats_Wilander-Kevin_Curren,2,B-DTL,5,4,1,1,2,2,3
19841209-M-Australian_Open-F-Mats_Wilander-Kevin_Curren,2,B-IO,5,5,2,0,3,2,3
19841209-M-Australian_Open-F-Mats_Wilander-Kevin_Curren,2,S-XC,20,5,1,3,1,12,8
19841209-M-Australian_Open-F-Mats_Wilander-Kevin_Curren,2,S-DTM,12,1,0,0,1,6,6
19841209-M-Australian_Open-F-Mats_Wilander-Kevin_Curren,2,S-DTL,3,1,0,1,0,3,0
19841209-M-Australian_Open-F-Mats_Wilander-Kevin_Curren,2,S-IO,2,1,0,1,0,1,1
19910512-M-Hamburg_Masters-F-Karel_Novacek-Magnus_Gustafsson,1,F-XC,66,22,5,6,11,34,32
19910512-M-Hamburg_Masters-F-Karel_Novacek-Magnus_Gustafsson,1,F-DTM,36,1,0,0,1,13,23
19910512-M-Hamburg_Masters-F-Karel_Novacek-Magnus_Gustafsson,1,F-DTL,19,2,2,0,0,13,6
19910512-M-Hamburg_Masters-F-Karel_Novacek-Magnus_Gustafsson,1,F-IO,53,11,4,2,5,31,22
19910512-M-Hamburg_Masters-F-Karel_Novacek-Magnus_Gustafsson,1,F-II,6,5,0,1,4,2,4
19910512-M-Hamburg_Masters-F-Karel_Novacek-Magnus_Gustafsson,1,B-XC,71,14,4,5,5,46,25
19910512-M-Hamburg_Masters-F-Karel_Novacek-Magnus_Gustafsson,1,B-DTM,28,2,0,1,1,16,12
19910512-M-Hamburg_Masters-F-Karel_Novacek-Magnus_Gustafsson,1,B-DTL,6,3,0,0,3,2,4
19910512-M-Hamburg_Masters-F-Karel_Novacek-Magnus_Gustafsson,1,B-IO,5,4,2,2,0,4,1
19910512-M-Hamburg_Masters-F-Karel_Novacek-Magnus_Gustafsson,1,S-XC,16,1,0,0,1,7,9
19910512-M-Hamburg_Masters-F-Karel_Novacek-Magnus_Gustafsson,1,S-DTM,6,1,0,0,1,2,4
19910512-M-Hamburg_Masters-F-Karel_Novacek-Magnus_Gustafsson,1,S-IO,1,0,0,0,0,0,1
19910512-M-Hamburg_Masters-F-Karel_Novacek-Magnus_Gustafsson,2,F-XC,52,19,4,8,7,27,25
19910512-M-Hamburg_Masters-F-Karel_Novacek-Magnus_Gustafsson,2,F-DTM,70,5,0,0,5,31,39
19910512-M-Hamburg_Masters-F-Karel_Novacek-Magnus_Gustafsson,2,F-DTL,23,9,3,5,1,13,10
19910512-M-Hamburg_Masters-F-Karel_Novacek-Magnus_Gustafsson,2,F-IO,72,33,12,5,16,33,39
19910512-M-Hamburg_Masters-F-Karel_Novacek-Magnus_Gustafsson,2,F-II,31,13,6,3,4,16,15
19910512-M-Hamburg_Masters-F-Karel_Novacek-Magnus_Gustafsson,2,B-XC,24,4,1,2,1,11,13
19910512-M-Hamburg_Masters-F-Karel_Novacek-Magnus_Gustafsson,2,B-DTM,37,4,0,0,4,14,23
19910512-M-Hamburg_Masters-F-Karel_Novacek-Magnus_Gustafsson,2,B-DTL,6,2,2,0,0,4,2
19910512-M-Hamburg_Masters-F-Karel_Novacek-Magnus_Gustafsson,2,S-XC,5,1,1,0,0,2,3
19910512-M-Hamburg_Masters-F-Karel_Novacek-Magnus_Gustafsson,2,S-DTM,13,1,0,0,1,3,10
19910512-M-Hamburg_Masters-F-Karel_Novacek-Magnus_Gustafsson,2,S-DTL,4,1,0,1,0,2,2
19910310-M-Indian_Wells_Masters-F-Jim_Courier-Guy_Forget,1,F-XC,84,12,4,3,5,51,33
19910310-M-Indian_Wells_Masters-F-Jim_Courier-Guy_Forget,1,F-DTM,32,1,0,1,0,17,15
19910310-M-Indian_Wells_Masters-F-Jim_Courier-Guy_Forget,1,F-DTL,6,4,1,2,1,3,3
19910310-M-Indian_Wells_Masters-F-Jim_Courier-Guy_Forget,1,F-IO,26,9,2,4,3,14,12
19910310-M-Indian_Wells_Masters-F-Jim_Courier-Guy_Forget,1,F-II,7,1,0,1,0,3,4
19910310-M-Indian_Wells_Masters-F-Jim_Courier-Guy_Forget,1,B-XC,26,5,0,2,3,11,15
19910310-M-Indian_Wells_Masters-F-Jim_Courier-Guy_Forget,1,B-DTM,27,1,0,0,1,14,13
19910310-M-Indian_Wells_Masters-F-Jim_Courier-Guy_Forget,1,B-DTL,15,4,1,1,2,8,7
19910310-M-Indian_Wells_Masters-F-Jim_Courier-Guy_Forget,1,B-IO,6,1,1,0,0,6,0
19910310-M-Indian_Wells_Masters-F-Jim_Courier-Guy_Forget,1,S-XC,14,1,0,1,0,7,7
19910310-M-Indian_Wells_Masters-F-Jim_Courier-Guy_Forget,1,S-DTM,25,2,0,0,2,9,16
19910310-M-Indian_Wells_Masters-F-Jim_Courier-Guy_Forget,1,S-DTL,13,2,0,2,0,8,5
19910310-M-Indian_Wells_Masters-F-Jim_Courier-Guy_Forget,1,S-IO,1,1,0,0,1,0,1
19910310-M-Indian_Wells_Masters-F-Jim_Courier-Guy_Forget,2,F-XC,64,9,2,4,3,38,26
19910310-M-Indian_Wells_Masters-F-Jim_Courier-Guy_Forget,2,F-DTM,34,6,1,1,4,12,22
19910310-M-Indian_Wells_Masters-F-Jim_Courier-Guy_Forget,2,F-DTL,18,8,3,4,1,13,5
19910310-M-Indian_Wells_Masters-F-Jim_Courier-Guy_Forget,2,F-IO,22,10,3,2,5,15,7
19910310-M-Indian_Wells_Masters-F-Jim_Courier-Guy_Forget,2,F-II,9,2,0,1,1,7,2
19910310-M-Indian_Wells_Masters-F-Jim_Courier-Guy_Forget,2,B-XC,23,5,1,2,2,13,10
19910310-M-Indian_Wells_Masters-F-Jim_Courier-Guy_Forget,2,B-DTM,52,4,0,0,4,13,39
19910310-M-Indian_Wells_Masters-F-Jim_Courier-Guy_Forget,2,B-DTL,17,7,3,0,4,6,11
19910310-M-Indian_Wells_Masters-F-Jim_Courier-Guy_Forget,2,B-IO,6,3,0,0,3,3,3
19910310-M-Indian_Wells_Masters-F-Jim_Courier-Guy_Forget,2,S-XC,11,1,0,0,1,5,6
19910310-M-Indian_Wells_Masters-F-Jim_Courier-Guy_Forget,2,S-DTM,15,4,0,0,4,3,12
19910310-M-Indian_Wells_Masters-F-Jim_Courier-Guy_Forget,2,S-DTL,14,0,0,0,0,9,5
19910310-M-Indian_Wells_Masters-F-Jim_Courier-Guy_Forget,2,S-IO,4,0,0,0,0,2,2
20170318-M-Drummondville_CH-SF-Denis_Shapovalov-Felix_Auger_Aliassime,1,F-XC,35,10,1,4,5,24,11
20170318-M-Drummondville_CH-SF-Denis_Shapovalov-Felix_Auger_Aliassime,1,F-DTM,17,2,0,0,2,12,5
20170318-M-Drummondville_CH-SF-Denis_Shapovalov-Felix_Auger_Aliassime,1,F-DTL,12,6,1,3,2,7,5
20170318-M-Drummondville_CH-SF-Denis_Shapovalov-Felix_Auger_Aliassime,1,F-IO,13,5,4,0,1,9,4
20170318-M-Drummondville_CH-SF-Denis_Shapovalov-Felix_Auger_Aliassime,1,F-II,4,3,0,1,2,2,2
20170318-M-Drummondville_CH-SF-Denis_Shapovalov-Felix_Auger_Aliassime,1,B-XC,13,4,0,1,3,6,7
20170318-M-Drummondville_CH-SF-Denis_Shapovalov-Felix_Auger_Aliassime,1,B-DTM,11,0,0,0,0,10,1
20170318-M-Drummondville_CH-SF-Denis_Shapovalov-Felix_Auger_Aliassime,1,B-DTL,12,3,1,1,1,9,3
20170318-M-Drummondville_CH-SF-Denis_Shapovalov-Felix_Auger_Aliassime,1,B-IO,2,1,0,0,1,0,2
20170318-M-Drummondville_CH-SF-Denis_Shapovalov-Felix_Auger_Aliassime,1,S-XC,3,0,0,0,0,2,1
20170318-M-Drummondville_CH-SF-Denis_Shapovalov-Felix_Auger_Aliassime,1,S-DTL,1,0,0,0,0,1,0
20170318-M-Drummondville_CH-SF-Denis_Shapovalov-Felix_Auger_Aliassime,2,F-XC,30,9,1,2,6,10,20
20170318-M-Drummondville_CH-SF-Denis_Shapovalov-Felix_Auger_Aliassime,2,F-DTM,12,2,0,1,1,2,10
20170318-M-Drummondville_CH-SF-Denis_Shapovalov-Felix_Auger_Aliassime,2,F-DTL,13,4,3,0,1,6,7
20170318-M-Drummondville_CH-SF-Denis_Shapovalov-Felix_Auger_Aliassime,2,F-IO,15,9,1,2,6,5,10
20170318-M-Drummondville_CH-SF-Denis_Shapovalov-Felix_Auger_Aliassime,2,B-XC,22,5,2,1,2,10,12
20170318-M-Drummondville_CH-SF-Denis_Shapovalov-Felix_Auger_Aliassime,2,B-DTM,16,2,0,0,2,5,11
20170318-M-Drummondville_CH-SF-Denis_Shapovalov-Felix_Auger_Aliassime,2,B-DTL,11,3,0,1,2,2,9
20170318-M-Drummondville_CH-SF-Denis_Shapovalov-Felix_Auger_Aliassime,2,B-IO,2,0,0,0,0,0,2
20170318-M-Drummondville_CH-SF-Denis_Shapovalov-Felix_Auger_Aliassime,2,S-XC,1,0,0,0,0,0,1
20170318-M-Drummondville_CH-SF-Denis_Shapovalov-Felix_Auger_Aliassime,2,S-DTM,1,0,0,0,0,0,1
20170318-M-Drummondville_CH-SF-Denis_Shapovalov-Felix_Auger_Aliassime,2,S-DTL,2,0,0,0,0,1,1
20170318-M-Drummondville_CH-SF-Denis_Shapovalov-Felix_Auger_Aliassime,2,S-IO,1,1,0,0,1,0,1
20170226-M-Delray_Beach-SF-Milos_Raonic-Juan_Martin_Del_Potro,1,F-XC,18,7,2,2,3,8,10
20170226-M-Delray_Beach-SF-Milos_Raonic-Juan_Martin_Del_Potro,1,F-DTM,8,1,0,0,1,2,6
20170226-M-Delray_Beach-SF-Milos_Raonic-Juan_Martin_Del_Potro,1,F-DTL,11,4,1,1,2,5,6
20170226-M-Delray_Beach-SF-Milos_Raonic-Juan_Martin_Del_Potro,1,F-IO,49,16,5,4,7,26,23
20170226-M-Delray_Beach-SF-Milos_Raonic-Juan_Martin_Del_Potro,1,F-II,14,5,1,0,4,5,9
20170226-M-Delray_Beach-SF-Milos_Raonic-Juan_Martin_Del_Potro,1,B-XC,4,1,0,1,0,2,2
20170226-M-Delray_Beach-SF-Milos_Raonic-Juan_Martin_Del_Potro,1,B-DTM,1,0,0,0,0,1,0
20170226-M-Delray_Beach-SF-Milos_Raonic-Juan_Martin_Del_Potro,1,B-DTL,1,1,1,0,0,1,0
20170226-M-Delray_Beach-SF-Milos_Raonic-Juan_Martin_Del_Potro,1,S-XC,11,1,0,0,1,4,7
20170226-M-Delray_Beach-SF-Milos_Raonic-Juan_Martin_Del_Potro,1,S-DTM,2,0,0,0,0,2,0
20170226-M-Delray_Beach-SF-Milos_Raonic-Juan_Martin_Del_Potro,1,S-DTL,7,0,0,0,0,5,2
20170226-M-Delray_Beach-SF-Milos_Raonic-Juan_Martin_Del_Potro,2,F-XC,27,8,2,2,4,16,11
20170226-M-Delray_Beach-SF-Milos_Raonic-Juan_Martin_Del_Potro,2,F-DTM,10,2,0,0,2,6,4
20170226-M-Delray_Beach-SF-Milos_Raonic-Juan_Martin_Del_Potro,2,F-DTL,5,1,0,1,0,1,4
20170226-M-Delray_Beach-SF-Milos_Raonic-Juan_Martin_Del_Potro,2,F-IO,18,5,2,2,1,11,7
20170226-M-Delray_Beach-SF-Milos_Raonic-Juan_Martin_Del_Potro,2,F-II,3,2,2,0,0,3,0
20170226-M-Delray_Beach-SF-Milos_Raonic-Juan_Martin_Del_Potro,2,B-XC,17,1,0,0,1,8,9
20170226-M-Delray_Beach-SF-Milos_Raonic-Juan_Martin_Del_Potro,2,B-DTM,11,1,0,0,1,4,7
20170226-M-Delray_Beach-SF-Milos_Raonic-Juan_Martin_Del_Potro,2,B-DTL,5,3,1,2,0,4,1
20170226-M-Delray_Beach-SF-Milos_Raonic-Juan_Martin_Del_Potro,2,S-XC,25,2,0,0,2,14,11
20170226-M-Delray_Beach-SF-Milos_Raonic-Juan_Martin_Del_Potro,2,S-DTM,5,1,0,0,1,2,3
20170226-M-Delray_Beach-SF-Milos_Raonic-Juan_Martin_Del_Potro,2,S-DTL,4,2,1,0,1,1,3
20170226-M-Delray_Beach-SF-Milos_Raonic-Juan_Martin_Del_Potro,2,S-IO,1,0,0,0,0,0,1
19910428-M-Monte_Carlo_Masters-F-Sergi_Bruguera-Boris_Becker,1,F-XC,68,15,7,4,4,41,27
19910428-M-Monte_Carlo_Masters-F-Sergi_Bruguera-Boris_Becker,1,F-DTM,64,2,1,0,1,33,31
19910428-M-Monte_Carlo_Masters-F-Sergi_Bruguera-Boris_Becker,1,F-DTL,58,10,3,2,5,30,28
19910428-M-Monte_Carlo_Masters-F-Sergi_Bruguera-Boris_Becker,1,F-IO,56,10,3,6,1,37,19
19910428-M-Monte_Carlo_Masters-F-Sergi_Bruguera-Boris_Becker,1,F-II,11,2,1,1,0,7,4
19910428-M-Monte_Carlo_Masters-F-Sergi_Bruguera-Boris_Becker,1,B-XC,160,10,2,2,6,84,76
19910428-M-Monte_Carlo_Masters-F-Sergi_Bruguera-Boris_Becker,1,B-DTM,85,5,0,2,3,37,48
19910428-M-Monte_Carlo_Masters-F-Sergi_Bruguera-Boris_Becker,1,B-DTL,41,19,5,8,6,24,17
19910428-M-Monte_Carlo_Masters-F-Sergi_Bruguera-Boris_Becker,1,B-IO,11,7,2,0,5,5,6
19910428-M-Monte_Carlo_Masters-F-Sergi_Bruguera-Boris_Becker,1,S-XC,38,1,1,0,0,21,17
19910428-M-Monte_Carlo_Masters-F-Sergi_Bruguera-Boris_Becker,1,S-DTM,16,1,0,1,0,8,8
19910428-M-Monte_Carlo_Masters-F-Sergi_Bruguera-Boris_Becker,1,S-DTL,16,3,0,2,1,6,10
19910428-M-Monte_Carlo_Masters-F-Sergi_Bruguera-Boris_Becker,1,S-IO,1,1,1,0,0,1,0
19910428-M-Monte_Carlo_Masters-F-Sergi_Bruguera-Boris_Becker,2,F-XC,107,26,6,13,7,56,51
19910428-M-Monte_Carlo_Masters-F-Sergi_Bruguera-Boris_Becker,2,F-DTM,49,8,1,2,5,22,27
19910428-M-Monte_Carlo_Masters-F-Sergi_Bruguera-Boris_Becker,2,F-DTL,33,14,4,2,8,16,17
19910428-M-Monte_Carlo_Masters-F-Sergi_Bruguera-Boris_Becker,2,F-IO,69,19,6,7,6,39,30
19910428-M-Monte_Carlo_Masters-F-Sergi_Bruguera-Boris_Becker,2,F-II,7,1,1,0,0,4,3
19910428-M-Monte_Carlo_Masters-F-Sergi_Bruguera-Boris_Becker,2,B-XC,56,4,1,1,2,28,28
19910428-M-Monte_Carlo_Masters-F-Sergi_Bruguera-Boris_Becker,2,B-DTM,34,5,1,1,3,15,19
19910428-M-Monte_Carlo_Masters-F-Sergi_Bruguera-Boris_Becker,2,B-DTL,35,11,3,2,6,18,17
19910428-M-Monte_Carlo_Masters-F-Sergi_Bruguera-Boris_Becker,2,B-IO,5,1,1,0,0,3,2
19910428-M-Monte_Carlo_Masters-F-Sergi_Bruguera-Boris_Becker,2,S-XC,140,11,1,2,8,70,70
19910428-M-Monte_Carlo_Masters-F-Sergi_Bruguera-Boris_Becker,2,S-DTM,43,2,0,1,1,17,26
19910428-M-Monte_Carlo_Masters-F-Sergi_Bruguera-Boris_Becker,2,S-DTL,21,2,1,1,0,7,14
19910428-M-Monte_Carlo_Masters-F-Sergi_Bruguera-Boris_Becker,2,S-IO,8,1,0,0,1,4,4
20180401-M-Miami_Masters-F-John_Isner-Alexander_Zverev,1,F-XC,18,5,3,1,1,10,8
20180401-M-Miami_Masters-F-John_Isner-Alexander_Zverev,1,F-DTM,13,3,0,0,3,7,6
20180401-M-Miami_Masters-F-John_Isner-Alexander_Zverev,1,F-DTL,18,8,3,2,3,11,7
20180401-M-Miami_Masters-F-John_Isner-Alexander_Zverev,1,F-IO,48,20,5,4,11,20,28
20180401-M-Miami_Masters-F-John_Isner-Alexander_Zverev,1,F-II,6,4,2,0,2,3,3
20180401-M-Miami_Masters-F-John_Isner-Alexander_Zverev,1,B-XC,19,7,3,0,4,11,8
20180401-M-Miami_Masters-F-John_Isner-Alexander_Zverev,1,B-DTM,19,0,0,0,0,4,15
20180401-M-Miami_Masters-F-John_Isner-Alexander_Zverev,1,B-DTL,8,3,1,0,2,4,4
20180401-M-Miami_Masters-F-John_Isner-Alexander_Zverev,1,B-IO,1,0,0,0,0,1,0
20180401-M-Miami_Masters-F-John_Isner-Alexander_Zverev,1,S-XC,2,0,0,0,0,1,1
20180401-M-Miami_Masters-F-John_Isner-Alexander_Zverev,1,S-DTM,4,0,0,0,0,1,3
20180401-M-Miami_Masters-F-John_Isner-Alexander_Zverev,2,F-XC,26,9,4,3,2,17,9
20180401-M-Miami_Masters-F-John_Isner-Alexander_Zverev,2,F-DTM,14,0,0,0,0,8,6
20180401-M-Miami_Masters-F-John_Isner-Alexander_Zverev,2,F-DTL,4,1,0,0,1,0,4
20180401-M-Miami_Masters-F-John_Isner-Alexander_Zverev,2,F-IO,14,3,1,0,2,8,6
20180401-M-Miami_Masters-F-John_Isner-Alexander_Zverev,2,F-II,1,1,1,0,0,1,0
20180401-M-Miami_Masters-F-John_Isner-Alexander_Zverev,2,B-XC,69,14,0,4,10,36,33
20180401-M-Miami_Masters-F-John_Isner-Alexander_Zverev,2,B-DTM,17,3,0,2,1,11,6
20180401-M-Miami_Masters-F-John_Isner-Alexander_Zverev,2,B-DTL,3,1,0,0,1,2,1
20180401-M-Miami_Masters-F-John_Isner-Alexander_Zverev,2,B-IO,1,0,0,0,0,1,0
20180401-M-Miami_Masters-F-John_Isner-Alexander_Zverev,2,S-XC,6,0,0,0,0,4,2
20180401-M-Miami_Masters-F-John_Isner-Alexander_Zverev,2,S-DTM,5,0,0,0,0,4,1
20180401-M-Miami_Masters-F-John_Isner-Alexander_Zverev,2,S-DTL,1,0,0,0,0,0,1
20180401-M-Miami_Masters-F-John_Isner-Alexander_Zverev,2,S-IO,1,0,0,0,0,0,1
19990509-M-Hamburg_Masters-F-Marcelo_Rios-Mariano_Zabaleta,1,F-XC,167,24,3,13,8,100,67
19990509-M-Hamburg_Masters-F-Marcelo_Rios-Mariano_Zabaleta,1,F-DTM,40,2,0,1,1,26,14
19990509-M-Hamburg_Masters-F-Marcelo_Rios-Mariano_Zabaleta,1,F-DTL,14,6,4,0,2,8,6
19990509-M-Hamburg_Masters-F-Marcelo_Rios-Mariano_Zabaleta,1,F-IO,42,22,8,4,10,23,19
19990509-M-Hamburg_Masters-F-Marcelo_Rios-Mariano_Zabaleta,1,F-II,5,2,2,0,0,4,1
19990509-M-Hamburg_Masters-F-Marcelo_Rios-Mariano_Zabaleta,1,B-XC,90,28,11,7,10,50,40
19990509-M-Hamburg_Masters-F-Marcelo_Rios-Mariano_Zabaleta,1,B-DTM,71,3,0,0,3,36,35
19990509-M-Hamburg_Masters-F-Marcelo_Rios-Mariano_Zabaleta,1,B-DTL,58,17,3,4,10,30,28
19990509-M-Hamburg_Masters-F-Marcelo_Rios-Mariano_Zabaleta,1,B-IO,22,1,0,1,0,13,9
19990509-M-Hamburg_Masters-F-Marcelo_Rios-Mariano_Zabaleta,1,S-XC,7,0,0,0,0,3,4
19990509-M-Hamburg_Masters-F-Marcelo_Rios-Mariano_Zabaleta,1,S-DTM,6,0,0,0,0,4,2
19990509-M-Hamburg_Masters-F-Marcelo_Rios-Mariano_Zabaleta,1,S-DTL,7,0,0,0,0,5,2
19990509-M-Hamburg_Masters-F-Marcelo_Rios-Mariano_Zabaleta,1,S-IO,1,0,0,0,0,1,0
19990509-M-Hamburg_Masters-F-Marcelo_Rios-Mariano_Zabaleta,2,F-XC,92,14,5,5,4,44,48
19990509-M-Hamburg_Masters-F-Marcelo_Rios-Mariano_Zabaleta,2,F-DTM,35,3,1,0,2,17,18
19990509-M-Hamburg_Masters-F-Marcelo_Rios-Mariano_Zabaleta,2,F-DTL,36,16,5,2,9,12,24
19990509-M-Hamburg_Masters-F-Marcelo_Rios-Mariano_Zabaleta,2,F-IO,49,18,8,4,6,25,24
19990509-M-Hamburg_Masters-F-Marcelo_Rios-Mariano_Zabaleta,2,F-II,27,10,1,2,7,10,17
19990509-M-Hamburg_Masters-F-Marcelo_Rios-Mariano_Zabaleta,2,B-XC,127,39,3,7,29,46,81
19990509-M-Hamburg_Masters-F-Marcelo_Rios-Mariano_Zabaleta,2,B-DTM,76,4,0,2,2,35,41
19990509-M-Hamburg_Masters-F-Marcelo_Rios-Mariano_Zabaleta,2,B-DTL,55,16,4,3,9,27,28
19990509-M-Hamburg_Masters-F-Marcelo_Rios-Mariano_Zabaleta,2,B-IO,16,3,0,1,2,7,9
19990509-M-Hamburg_Masters-F-Marcelo_Rios-Mariano_Zabaleta,2,S-XC,7,1,1,0,0,3,4
19990509-M-Hamburg_Masters-F-Marcelo_Rios-Mariano_Zabaleta,2,S-DTM,6,1,0,0,1,1,5
19990509-M-Hamburg_Masters-F-Marcelo_Rios-Mariano_Zabaleta,2,S-DTL,6,0,0,0,0,2,4
20180106-M-Brisbane-SF-Grigor_Dimitrov-Nick_Kyrgios,1,F-XC,29,6,4,1,1,23,6
20180106-M-Brisbane-SF-Grigor_Dimitrov-Nick_Kyrgios,1,F-DTM,5,0,0,0,0,3,2
20180106-M-Brisbane-SF-Grigor_Dimitrov-Nick_Kyrgios,1,F-DTL,17,11,8,3,0,16,1
20180106-M-Brisbane-SF-Grigor_Dimitrov-Nick_Kyrgios,1,F-IO,21,10,4,1,5,13,8
20180106-M-Brisbane-SF-Grigor_Dimitrov-Nick_Kyrgios,1,F-II,8,2,1,0,1,5,3
20180106-M-Brisbane-SF-Grigor_Dimitrov-Nick_Kyrgios,1,B-XC,15,0,0,0,0,9,6
20180106-M-Brisbane-SF-Grigor_Dimitrov-Nick_Kyrgios,1,B-DTM,10,2,0,0,2,6,4
20180106-M-Brisbane-SF-Grigor_Dimitrov-Nick_Kyrgios,1,B-DTL,8,4,1,1,2,6,2
20180106-M-Brisbane-SF-Grigor_Dimitrov-Nick_Kyrgios,1,S-XC,14,3,0,0,3,7,7
20180106-M-Brisbane-SF-Grigor_Dimitrov-Nick_Kyrgios,1,S-DTM,4,0,0,0,0,2,2
20180106-M-Brisbane-SF-Grigor_Dimitrov-Nick_Kyrgios,1,S-DTL,3,1,0,0,1,2,1
20180106-M-Brisbane-SF-Grigor_Dimitrov-Nick_Kyrgios,2,F-XC,27,8,1,3,4,5,22
20180106-M-Brisbane-SF-Grigor_Dimitrov-Nick_Kyrgios,2,F-DTM,8,3,0,0,3,2,6
20180106-M-Brisbane-SF-Grigor_Dimitrov-Nick_Kyrgios,2,F-DTL,5,0,0,0,0,2,3
20180106-M-Brisbane-SF-Grigor_Dimitrov-Nick_Kyrgios,2,F-IO,16,2,1,1,0,7,9
20180106-M-Brisbane-SF-Grigor_Dimitrov-Nick_Kyrgios,2,F-II,2,0,0,0,0,1,1
20180106-M-Brisbane-SF-Grigor_Dimitrov-Nick_Kyrgios,2,B-XC,29,2,1,0,1,10,19
20180106-M-Brisbane-SF-Grigor_Dimitrov-Nick_Kyrgios,2,B-DTM,6,0,0,0,0,3,3
20180106-M-Brisbane-SF-Grigor_Dimitrov-Nick_Kyrgios,2,B-DTL,4,3,0,1,2,1,3
20180106-M-Brisbane-SF-Grigor_Dimitrov-Nick_Kyrgios,2,B-IO,3,2,1,0,1,1,2
20180106-M-Brisbane-SF-Grigor_Dimitrov-Nick_Kyrgios,2,S-XC,5,1,0,0,1,2,3
20180106-M-Brisbane-SF-Grigor_Dimitrov-Nick_Kyrgios,2,S-DTM,2,0,0,0,0,0,2
20180106-M-Brisbane-SF-Grigor_Dimitrov-Nick_Kyrgios,2,S-DTL,1,1,0,0,1,0,1
20180107-M-Brisbane-F-Ryan_Harrison-Nick_Kyrgios,1,F-XC,14,2,1,0,1,7,7
20180107-M-Brisbane-F-Ryan_Harrison-Nick_Kyrgios,1,F-DTM,9,3,0,0,3,2,7
20180107-M-Brisbane-F-Ryan_Harrison-Nick_Kyrgios,1,F-DTL,9,3,0,2,1,4,5
20180107-M-Brisbane-F-Ryan_Harrison-Nick_Kyrgios,1,F-IO,9,3,0,1,2,5,4
20180107-M-Brisbane-F-Ryan_Harrison-Nick_Kyrgios,1,F-II,4,3,1,0,2,2,2
20180107-M-Brisbane-F-Ryan_Harrison-Nick_Kyrgios,1,B-XC,8,1,1,0,0,5,3
20180107-M-Brisbane-F-Ryan_Harrison-Nick_Kyrgios,1,B-DTM,14,5,0,1,4,6,8
20180107-M-Brisbane-F-Ryan_Harrison-Nick_Kyrgios,1,B-DTL,5,2,2,0,0,5,0
20180107-M-Brisbane-F-Ryan_Harrison-Nick_Kyrgios,1,B-IO,3,0,0,0,0,1,2
20180107-M-Brisbane-F-Ryan_Harrison-Nick_Kyrgios,1,S-XC,6,0,0,0,0,5,1
20180107-M-Brisbane-F-Ryan_Harrison-Nick_Kyrgios,1,S-DTM,9,0,0,0,0,0,9
20180107-M-Brisbane-F-Ryan_Harrison-Nick_Kyrgios,1,S-DTL,2,0,0,0,0,1,1
20180107-M-Brisbane-F-Ryan_Harrison-Nick_Kyrgios,1,S-IO,3,1,0,1,0,3,0
20180107-M-Brisbane-F-Ryan_Harrison-Nick_Kyrgios,2,F-XC,22,7,2,3,2,14,8
20180107-M-Brisbane-F-Ryan_Harrison-Nick_Kyrgios,2,F-DTM,6,1,0,0,1,1,5
20180107-M-Brisbane-F-Ryan_Harrison-Nick_Kyrgios,2,F-DTL,11,2,1,0,1,7,4
20180107-M-Brisbane-F-Ryan_Harrison-Nick_Kyrgios,2,F-IO,12,4,1,1,2,6,6
20180107-M-Brisbane-F-Ryan_Harrison-Nick_Kyrgios,2,F-II,2,2,2,0,0,2,0
20180107-M-Brisbane-F-Ryan_Harrison-Nick_Kyrgios,2,B-XC,19,2,1,1,0,11,8
20180107-M-Brisbane-F-Ryan_Harrison-Nick_Kyrgios,2,B-DTM,5,1,0,0,1,2,3
20180107-M-Brisbane-F-Ryan_Harrison-Nick_Kyrgios,2,B-DTL,2,2,0,0,2,0,2
20180107-M-Brisbane-F-Ryan_Harrison-Nick_Kyrgios,2,B-IO,2,1,1,0,0,1,1
20180107-M-Brisbane-F-Ryan_Harrison-Nick_Kyrgios,2,B-II,1,1,0,0,1,0,1
20180107-M-Brisbane-F-Ryan_Harrison-Nick_Kyrgios,2,S-XC,1,0,0,0,0,0,1
20180107-M-Brisbane-F-Ryan_Harrison-Nick_Kyrgios,2,S-DTM,2,0,0,0,0,1,1
20120319-M-Indian_Wells_Masters-F-Roger_Federer-John_Isner,1,F-XC,26,11,7,2,2,20,6
20120319-M-Indian_Wells_Masters-F-Roger_Federer-John_Isner,1,F-DTM,14,3,0,2,1,11,3
20120319-M-Indian_Wells_Masters-F-Roger_Federer-John_Isner,1,F-DTL,8,4,1,1,2,4,4
20120319-M-Indian_Wells_Masters-F-Roger_Federer-John_Isner,1,F-IO,40,9,6,1,2,33,7
20120319-M-Indian_Wells_Masters-F-Roger_Federer-John_Isner,1,F-II,8,2,1,0,1,5,3
20120319-M-Indian_Wells_Masters-F-Roger_Federer-John_Isner,1,B-XC,11,3,1,0,2,4,7
20120319-M-Indian_Wells_Masters-F-Roger_Federer-John_Isner,1,B-DTM,13,3,0,1,2,5,8
20120319-M-Indian_Wells_Masters-F-Roger_Federer-John_Isner,1,B-DTL,4,2,1,0,1,3,1
20120319-M-Indian_Wells_Masters-F-Roger_Federer-John_Isner,1,B-II,3,0,0,0,0,3,0
20120319-M-Indian_Wells_Masters-F-Roger_Federer-John_Isner,1,S-XC,1,0,0,0,0,1,0
20120319-M-Indian_Wells_Masters-F-Roger_Federer-John_Isner,1,S-DTM,1,0,0,0,0,1,0
20120319-M-Indian_Wells_Masters-F-Roger_Federer-John_Isner,1,S-DTL,1,1,0,0,1,0,1
20120319-M-Indian_Wells_Masters-F-Roger_Federer-John_Isner,2,F-XC,13,3,2,1,1,5,8
20120319-M-Indian_Wells_Masters-F-Roger_Federer-John_Isner,2,F-DTM,11,2,0,0,2,2,9
20120319-M-Indian_Wells_Masters-F-Roger_Federer-John_Isner,2,F-DTL,14,4,1,0,3,5,9
20120319-M-Indian_Wells_Masters-F-Roger_Federer-John_Isner,2,F-IO,32,11,3,1,7,15,17
20120319-M-Indian_Wells_Masters-F-Roger_Federer-John_Isner,2,F-II,9,1,0,1,0,4,5
20120319-M-Indian_Wells_Masters-F-Roger_Federer-John_Isner,2,B-XC,18,5,0,2,3,7,11
20120319-M-Indian_Wells_Masters-F-Roger_Federer-John_Isner,2,B-DTM,16,3,0,0,3,2,14
20120319-M-Indian_Wells_Masters-F-Roger_Federer-John_Isner,2,B-DTL,9,3,0,1,2,5,4
20120319-M-Indian_Wells_Masters-F-Roger_Federer-John_Isner,2,B-IO,1,0,0,0,0,1,0
20120319-M-Indian_Wells_Masters-F-Roger_Federer-John_Isner,2,B-II,1,0,0,0,0,1,0
20120319-M-Indian_Wells_Masters-F-Roger_Federer-John_Isner,2,S-XC,4,1,0,0,1,0,4
20120319-M-Indian_Wells_Masters-F-Roger_Federer-John_Isner,2,S-DTM,3,0,0,0,0,1,2
20120319-M-Indian_Wells_Masters-F-Roger_Federer-John_Isner,2,S-IO,1,1,0,0,1,0,1
19940508-M-Hamburg_Masters-F-Yevgeny_Kafelnikov-Andrei_Medvedev,1,F-XC,135,26,7,10,9,75,60
19940508-M-Hamburg_Masters-F-Yevgeny_Kafelnikov-Andrei_Medvedev,1,F-DTM,61,3,0,0,3,28,33
19940508-M-Hamburg_Masters-F-Yevgeny_Kafelnikov-Andrei_Medvedev,1,F-DTL,17,4,3,0,1,12,5
19940508-M-Hamburg_Masters-F-Yevgeny_Kafelnikov-Andrei_Medvedev,1,F-IO,62,11,2,1,8,28,34
19940508-M-Hamburg_Masters-F-Yevgeny_Kafelnikov-Andrei_Medvedev,1,F-II,7,2,0,2,0,4,3
19940508-M-Hamburg_Masters-F-Yevgeny_Kafelnikov-Andrei_Medvedev,1,B-XC,86,13,0,4,9,43,43
19940508-M-Hamburg_Masters-F-Yevgeny_Kafelnikov-Andrei_Medvedev,1,B-DTM,57,3,0,0,3,32,25
19940508-M-Hamburg_Masters-F-Yevgeny_Kafelnikov-Andrei_Medvedev,1,B-DTL,13,9,3,2,4,7,6
19940508-M-Hamburg_Masters-F-Yevgeny_Kafelnikov-Andrei_Medvedev,1,B-IO,15,4,2,0,2,9,6
19940508-M-Hamburg_Masters-F-Yevgeny_Kafelnikov-Andrei_Medvedev,1,S-XC,6,0,0,0,0,2,4
19940508-M-Hamburg_Masters-F-Yevgeny_Kafelnikov-Andrei_Medvedev,1,S-DTM,11,1,0,0,1,2,9
19940508-M-Hamburg_Masters-F-Yevgeny_Kafelnikov-Andrei_Medvedev,1,S-DTL,2,0,0,0,0,0,2
19940508-M-Hamburg_Masters-F-Yevgeny_Kafelnikov-Andrei_Medvedev,1,S-IO,3,0,0,0,0,1,2
19940508-M-Hamburg_Masters-F-Yevgeny_Kafelnikov-Andrei_Medvedev,2,F-XC,80,17,6,5,6,40,40
19940508-M-Hamburg_Masters-F-Yevgeny_Kafelnikov-Andrei_Medvedev,2,F-DTM,87,6,0,0,6,40,47
19940508-M-Hamburg_Masters-F-Yevgeny_Kafelnikov-Andrei_Medvedev,2,F-DTL,30,15,3,2,10,17,13
19940508-M-Hamburg_Masters-F-Yevgeny_Kafelnikov-Andrei_Medvedev,2,F-IO,23,9,3,1,5,11,12
19940508-M-Hamburg_Masters-F-Yevgeny_Kafelnikov-Andrei_Medvedev,2,F-II,2,1,1,0,0,2,0
19940508-M-Hamburg_Masters-F-Yevgeny_Kafelnikov-Andrei_Medvedev,2,B-XC,54,10,3,2,5,27,27
19940508-M-Hamburg_Masters-F-Yevgeny_Kafelnikov-Andrei_Medvedev,2,B-DTM,84,6,0,1,5,33,51
19940508-M-Hamburg_Masters-F-Yevgeny_Kafelnikov-Andrei_Medvedev,2,B-DTL,22,11,6,0,5,14,8
19940508-M-Hamburg_Masters-F-Yevgeny_Kafelnikov-Andrei_Medvedev,2,B-IO,6,4,1,1,2,2,4
19940508-M-Hamburg_Masters-F-Yevgeny_Kafelnikov-Andrei_Medvedev,2,S-XC,35,1,0,0,1,20,15
19940508-M-Hamburg_Masters-F-Yevgeny_Kafelnikov-Andrei_Medvedev,2,S-DTM,48,1,0,0,1,30,18
19940508-M-Hamburg_Masters-F-Yevgeny_Kafelnikov-Andrei_Medvedev,2,S-DTL,5,0,0,0,0,2,3
19940508-M-Hamburg_Masters-F-Yevgeny_Kafelnikov-Andrei_Medvedev,2,S-IO,1,0,0,0,0,0,1
19970518-M-Rome_Masters-F-Alex_Corretja-Marcelo_Rios,1,F-XC,115,12,1,6,5,76,39
19970518-M-Rome_Masters-F-Alex_Corretja-Marcelo_Rios,1,F-DTM,50,3,0,1,2,27,23
19970518-M-Rome_Masters-F-Alex_Corretja-Marcelo_Rios,1,F-DTL,17,7,4,0,3,10,7
19970518-M-Rome_Masters-F-Alex_Corretja-Marcelo_Rios,1,F-IO,33,7,3,2,2,20,13
19970518-M-Rome_Masters-F-Alex_Corretja-Marcelo_Rios,1,F-II,21,1,0,1,0,12,9
19970518-M-Rome_Masters-F-Alex_Corretja-Marcelo_Rios,1,B-XC,43,11,3,4,4,24,19
19970518-M-Rome_Masters-F-Alex_Corretja-Marcelo_Rios,1,B-DTM,50,1,0,0,1,27,23
19970518-M-Rome_Masters-F-Alex_Corretja-Marcelo_Rios,1,B-DTL,22,5,0,4,1,13,9
19970518-M-Rome_Masters-F-Alex_Corretja-Marcelo_Rios,1,B-IO,11,1,0,0,1,7,4
19970518-M-Rome_Masters-F-Alex_Corretja-Marcelo_Rios,1,S-XC,14,1,0,1,0,8,6
19970518-M-Rome_Masters-F-Alex_Corretja-Marcelo_Rios,1,S-DTM,6,0,0,0,0,0,6
19970518-M-Rome_Masters-F-Alex_Corretja-Marcelo_Rios,1,S-DTL,8,3,0,1,2,2,6
19970518-M-Rome_Masters-F-Alex_Corretja-Marcelo_Rios,1,S-IO,2,0,0,0,0,1,1
19970518-M-Rome_Masters-F-Alex_Corretja-Marcelo_Rios,2,F-XC,97,17,2,4,11,47,50
19970518-M-Rome_Masters-F-Alex_Corretja-Marcelo_Rios,2,F-DTM,34,3,0,0,3,15,19
19970518-M-Rome_Masters-F-Alex_Corretja-Marcelo_Rios,2,F-DTL,15,6,2,0,4,4,11
19970518-M-Rome_Masters-F-Alex_Corretja-Marcelo_Rios,2,F-IO,31,16,13,1,2,20,11
19970518-M-Rome_Masters-F-Alex_Corretja-Marcelo_Rios,2,F-II,4,1,1,0,0,3,1
19970518-M-Rome_Masters-F-Alex_Corretja-Marcelo_Rios,2,B-XC,113,27,8,2,17,46,67
19970518-M-Rome_Masters-F-Alex_Corretja-Marcelo_Rios,2,B-DTM,50,3,0,1,2,24,26
19970518-M-Rome_Masters-F-Alex_Corretja-Marcelo_Rios,2,B-DTL,37,11,2,2,7,14,23
19970518-M-Rome_Masters-F-Alex_Corretja-Marcelo_Rios,2,B-IO,13,2,0,1,1,4,9
19970518-M-Rome_Masters-F-Alex_Corretja-Marcelo_Rios,2,S-XC,4,1,0,1,0,1,3
19970518-M-Rome_Masters-F-Alex_Corretja-Marcelo_Rios,2,S-DTM,6,0,0,0,0,1,5
19970518-M-Rome_Masters-F-Alex_Corretja-Marcelo_Rios,2,S-DTL,5,0,0,0,0,0,5
19950430-M-Monte_Carlo_Masters-F-Boris_Becker-Thomas_Muster,1,F-XC,47,5,3,1,1,26,21
19950430-M-Monte_Carlo_Masters-F-Boris_Becker-Thomas_Muster,1,F-DTM,12,5,0,0,5,1,11
19950430-M-Monte_Carlo_Masters-F-Boris_Becker-Thomas_Muster,1,F-DTL,5,2,2,0,0,2,3
19950430-M-Monte_Carlo_Masters-F-Boris_Becker-Thomas_Muster,1,F-IO,19,10,4,2,4,12,7
19950430-M-Monte_Carlo_Masters-F-Boris_Becker-Thomas_Muster,1,F-II,3,0,0,0,0,3,0
19950430-M-Monte_Carlo_Masters-F-Boris_Becker-Thomas_Muster,1,B-XC,28,10,0,1,9,6,22
19950430-M-Monte_Carlo_Masters-F-Boris_Becker-Thomas_Muster,1,B-DTM,19,5,0,0,5,8,11
19950430-M-Monte_Carlo_Masters-F-Boris_Becker-Thomas_Muster,1,B-DTL,20,5,1,0,4,9,11
19950430-M-Monte_Carlo_Masters-F-Boris_Becker-Thomas_Muster,1,B-IO,10,1,0,0,1,4,6
19950430-M-Monte_Carlo_Masters-F-Boris_Becker-Thomas_Muster,1,S-XC,23,1,1,0,0,15,8
19950430-M-Monte_Carlo_Masters-F-Boris_Becker-Thomas_Muster,1,S-DTM,7,0,0,0,0,4,3
19950430-M-Monte_Carlo_Masters-F-Boris_Becker-Thomas_Muster,1,S-DTL,8,2,0,0,2,3,5
19950430-M-Monte_Carlo_Masters-F-Boris_Becker-Thomas_Muster,1,S-IO,2,0,0,0,0,0,2
19950430-M-Monte_Carlo_Masters-F-Boris_Becker-Thomas_Muster,2,F-XC,81,11,2,6,3,48,33
19950430-M-Monte_Carlo_Masters-F-Boris_Becker-Thomas_Muster,2,F-DTM,32,2,0,2,0,20,12
19950430-M-Monte_Carlo_Masters-F-Boris_Becker-Thomas_Muster,2,F-DTL,24,10,5,3,2,14,10
19950430-M-Monte_Carlo_Masters-F-Boris_Becker-Thomas_Muster,2,F-IO,19,5,2,2,1,14,5
19950430-M-Monte_Carlo_Masters-F-Boris_Becker-Thomas_Muster,2,F-II,12,1,0,1,0,6,6
19950430-M-Monte_Carlo_Masters-F-Boris_Becker-Thomas_Muster,2,B-XC,39,24,10,7,7,24,15
19950430-M-Monte_Carlo_Masters-F-Boris_Becker-Thomas_Muster,2,B-DTM,38,3,0,0,3,16,22
19950430-M-Monte_Carlo_Masters-F-Boris_Becker-Thomas_Muster,2,B-DTL,28,10,2,2,6,12,16
19950430-M-Monte_Carlo_Masters-F-Boris_Becker-Thomas_Muster,2,B-IO,4,3,1,1,1,2,2
19950430-M-Monte_Carlo_Masters-F-Boris_Becker-Thomas_Muster,2,B-II,1,1,0,1,0,1,0
19950430-M-Monte_Carlo_Masters-F-Boris_Becker-Thomas_Muster,2,S-XC,4,1,0,1,0,2,2
19950430-M-Monte_Carlo_Masters-F-Boris_Becker-Thomas_Muster,2,S-DTM,2,0,0,0,0,1,1
19950430-M-Monte_Carlo_Masters-F-Boris_Becker-Thomas_Muster,2,S-DTL,1,0,0,0,0,1,0
19950430-M-Monte_Carlo_Masters-F-Boris_Becker-Thomas_Muster,2,S-IO,2,2,1,0,1,1,1
20120512-M-Madrid_Masters-SF-Tomas_Berdych-Juan_Martin_Del_Potro,1,F-XC,32,15,7,3,5,17,15
20120512-M-Madrid_Masters-SF-Tomas_Berdych-Juan_Martin_Del_Potro,1,F-DTM,16,0,0,0,0,7,9
20120512-M-Madrid_Masters-SF-Tomas_Berdych-Juan_Martin_Del_Potro,1,F-DTL,16,5,2,1,2,9,7
20120512-M-Madrid_Masters-SF-Tomas_Berdych-Juan_Martin_Del_Potro,1,F-IO,25,7,4,2,1,16,9
20120512-M-Madrid_Masters-SF-Tomas_Berdych-Juan_Martin_Del_Potro,1,F-II,4,4,2,2,0,4,0
20120512-M-Madrid_Masters-SF-Tomas_Berdych-Juan_Martin_Del_Potro,1,B-XC,32,6,1,1,4,15,17
20120512-M-Madrid_Masters-SF-Tomas_Berdych-Juan_Martin_Del_Potro,1,B-DTM,21,3,0,1,2,5,16
20120512-M-Madrid_Masters-SF-Tomas_Berdych-Juan_Martin_Del_Potro,1,B-DTL,14,2,1,0,1,6,8
20120512-M-Madrid_Masters-SF-Tomas_Berdych-Juan_Martin_Del_Potro,1,B-IO,4,2,0,1,1,1,3
20120512-M-Madrid_Masters-SF-Tomas_Berdych-Juan_Martin_Del_Potro,1,S-XC,11,0,0,0,0,3,8
20120512-M-Madrid_Masters-SF-Tomas_Berdych-Juan_Martin_Del_Potro,1,S-DTM,5,0,0,0,0,2,3
20120512-M-Madrid_Masters-SF-Tomas_Berdych-Juan_Martin_Del_Potro,1,S-DTL,2,0,0,0,0,0,2
20120512-M-Madrid_Masters-SF-Tomas_Berdych-Juan_Martin_Del_Potro,2,F-XC,37,12,7,3,2,23,14
20120512-M-Madrid_Masters-SF-Tomas_Berdych-Juan_Martin_Del_Potro,2,F-DTM,21,3,0,2,1,11,10
20120512-M-Madrid_Masters-SF-Tomas_Berdych-Juan_Martin_Del_Potro,2,F-DTL,10,4,4,0,0,9,1
20120512-M-Madrid_Masters-SF-Tomas_Berdych-Juan_Martin_Del_Potro,2,F-IO,14,5,4,1,0,14,0
20120512-M-Madrid_Masters-SF-Tomas_Berdych-Juan_Martin_Del_Potro,2,F-II,4,1,0,1,0,3,1
20120512-M-Madrid_Masters-SF-Tomas_Berdych-Juan_Martin_Del_Potro,2,B-XC,56,11,2,2,7,28,28
20120512-M-Madrid_Masters-SF-Tomas_Berdych-Juan_Martin_Del_Potro,2,B-DTM,21,2,0,0,2,10,11
20120512-M-Madrid_Masters-SF-Tomas_Berdych-Juan_Martin_Del_Potro,2,B-DTL,3,1,1,0,0,2,1
20120512-M-Madrid_Masters-SF-Tomas_Berdych-Juan_Martin_Del_Potro,2,B-IO,4,3,2,1,0,4,0
20120512-M-Madrid_Masters-SF-Tomas_Berdych-Juan_Martin_Del_Potro,2,S-XC,5,0,0,0,0,2,3
20120512-M-Madrid_Masters-SF-Tomas_Berdych-Juan_Martin_Del_Potro,2,S-DTM,8,0,0,0,0,2,6
20120512-M-Madrid_Masters-SF-Tomas_Berdych-Juan_Martin_Del_Potro,2,S-DTL,1,0,0,0,0,0,1
20170121-M-Australian_Open-R32-Rafael_Nadal-Alexander_Zverev,1,F-XC,119,10,4,5,1,71,48
20170121-M-Australian_Open-R32-Rafael_Nadal-Alexander_Zverev,1,F-DTM,41,4,0,0,4,19,22
20170121-M-Australian_Open-R32-Rafael_Nadal-Alexander_Zverev,1,F-DTL,29,6,3,1,2,16,13
20170121-M-Australian_Open-R32-Rafael_Nadal-Alexander_Zverev,1,F-IO,67,24,9,5,10,40,27
20170121-M-Australian_Open-R32-Rafael_Nadal-Alexander_Zverev,1,F-II,10,1,0,0,1,5,5
20170121-M-Australian_Open-R32-Rafael_Nadal-Alexander_Zverev,1,B-XC,56,6,1,2,3,34,22
20170121-M-Australian_Open-R32-Rafael_Nadal-Alexander_Zverev,1,B-DTM,44,3,0,1,2,20,24
20170121-M-Australian_Open-R32-Rafael_Nadal-Alexander_Zverev,1,B-DTL,18,9,1,1,7,9,9
20170121-M-Australian_Open-R32-Rafael_Nadal-Alexander_Zverev,1,B-IO,4,0,0,0,0,4,0
20170121-M-Australian_Open-R32-Rafael_Nadal-Alexander_Zverev,1,S-XC,2,0,0,0,0,2,0
20170121-M-Australian_Open-R32-Rafael_Nadal-Alexander_Zverev,1,S-DTM,30,1,0,0,1,19,11
20170121-M-Australian_Open-R32-Rafael_Nadal-Alexander_Zverev,1,S-DTL,27,3,0,1,2,18,9
20170121-M-Australian_Open-R32-Rafael_Nadal-Alexander_Zverev,1,S-IO,5,0,0,0,0,5,0
20170121-M-Australian_Open-R32-Rafael_Nadal-Alexander_Zverev,2,F-XC,112,24,2,5,16,51,61
20170121-M-Australian_Open-R32-Rafael_Nadal-Alexander_Zverev,2,F-DTM,56,6,0,0,6,16,40
20170121-M-Australian_Open-R32-Rafael_Nadal-Alexander_Zverev,2,F-DTL,19,14,3,2,9,8,11
20170121-M-Australian_Open-R32-Rafael_Nadal-Alexander_Zverev,2,F-IO,39,23,8,7,8,24,15
20170121-M-Australian_Open-R32-Rafael_Nadal-Alexander_Zverev,2,F-II,8,3,1,1,1,4,4
20170121-M-Australian_Open-R32-Rafael_Nadal-Alexander_Zverev,2,B-XC,115,23,5,5,13,51,64
20170121-M-Australian_Open-R32-Rafael_Nadal-Alexander_Zverev,2,B-DTM,54,3,0,0,3,27,27
20170121-M-Australian_Open-R32-Rafael_Nadal-Alexander_Zverev,2,B-DTL,38,6,3,0,3,12,26
20170121-M-Australian_Open-R32-Rafael_Nadal-Alexander_Zverev,2,B-IO,31,7,3,2,2,17,14
20170121-M-Australian_Open-R32-Rafael_Nadal-Alexander_Zverev,2,S-XC,1,0,0,0,0,0,1
20170121-M-Australian_Open-R32-Rafael_Nadal-Alexander_Zverev,2,S-DTM,5,1,0,0,1,0,5
20170121-M-Australian_Open-R32-Rafael_Nadal-Alexander_Zverev,2,S-DTL,1,1,0,0,1,0,1
20170121-M-Australian_Open-R32-Rafael_Nadal-Alexander_Zverev,2,S-IO,1,0,0,0,0,1,0
20180121-M-Australian_Open-R16-Grigor_Dimitrov-Nick_Kyrgios,1,F-XC,75,22,15,2,5,52,23
20180121-M-Australian_Open-R16-Grigor_Dimitrov-Nick_Kyrgios,1,F-DTM,28,0,0,0,0,14,14
20180121-M-Australian_Open-R16-Grigor_Dimitrov-Nick_Kyrgios,1,F-DTL,20,8,3,2,3,12,8
20180121-M-Australian_Open-R16-Grigor_Dimitrov-Nick_Kyrgios,1,F-IO,49,9,4,2,3,24,25
20180121-M-Australian_Open-R16-Grigor_Dimitrov-Nick_Kyrgios,1,F-II,19,8,4,3,1,12,7
20180121-M-Australian_Open-R16-Grigor_Dimitrov-Nick_Kyrgios,1,B-XC,28,3,0,1,2,19,9
20180121-M-Australian_Open-R16-Grigor_Dimitrov-Nick_Kyrgios,1,B-DTM,32,6,0,1,5,14,18
20180121-M-Australian_Open-R16-Grigor_Dimitrov-Nick_Kyrgios,1,B-DTL,10,7,5,0,2,8,2
20180121-M-Australian_Open-R16-Grigor_Dimitrov-Nick_Kyrgios,1,S-XC,28,1,0,0,1,11,17
20180121-M-Australian_Open-R16-Grigor_Dimitrov-Nick_Kyrgios,1,S-DTM,29,1,0,0,1,15,14
20180121-M-Australian_Open-R16-Grigor_Dimitrov-Nick_Kyrgios,1,S-DTL,9,4,0,0,4,3,6
20180121-M-Australian_Open-R16-Grigor_Dimitrov-Nick_Kyrgios,1,S-IO,1,0,0,0,0,0,1
20180121-M-Australian_Open-R16-Grigor_Dimitrov-Nick_Kyrgios,2,F-XC,72,26,8,5,13,33,39
20180121-M-Australian_Open-R16-Grigor_Dimitrov-Nick_Kyrgios,2,F-DTM,22,3,0,0,3,8,14
20180121-M-Australian_Open-R16-Grigor_Dimitrov-Nick_Kyrgios,2,F-DTL,25,5,2,0,3,10,15
20180121-M-Australian_Open-R16-Grigor_Dimitrov-Nick_Kyrgios,2,F-IO,40,8,1,3,4,22,18
20180121-M-Australian_Open-R16-Grigor_Dimitrov-Nick_Kyrgios,2,F-II,8,5,3,0,2,5,3
20180121-M-Australian_Open-R16-Grigor_Dimitrov-Nick_Kyrgios,2,B-XC,80,17,5,3,9,36,44
20180121-M-Australian_Open-R16-Grigor_Dimitrov-Nick_Kyrgios,2,B-DTM,18,3,0,0,3,7,11
20180121-M-Australian_Open-R16-Grigor_Dimitrov-Nick_Kyrgios,2,B-DTL,21,8,4,0,4,11,10
20180121-M-Australian_Open-R16-Grigor_Dimitrov-Nick_Kyrgios,2,B-IO,11,4,0,1,3,3,8
20180121-M-Australian_Open-R16-Grigor_Dimitrov-Nick_Kyrgios,2,S-XC,16,0,0,0,0,10,6
20180121-M-Australian_Open-R16-Grigor_Dimitrov-Nick_Kyrgios,2,S-DTM,5,0,0,0,0,3,2
20180121-M-Australian_Open-R16-Grigor_Dimitrov-Nick_Kyrgios,2,S-DTL,1,0,0,0,0,1,0
20180121-M-Australian_Open-R16-Grigor_Dimitrov-Nick_Kyrgios,2,S-IO,1,0,0,0,0,1,0
20180408-M-Davis_Cup_World_Group_QF-RR-David_Ferrer-Philipp_Kohlschreiber,1,F-XC,95,20,7,11,2,62,33
20180408-M-Davis_Cup_World_Group_QF-RR-David_Ferrer-Philipp_Kohlschreiber,1,F-DTM,71,4,1,2,1,37,34
20180408-M-Davis_Cup_World_Group_QF-RR-David_Ferrer-Philipp_Kohlschreiber,1,F-DTL,52,13,3,3,7,26,26
20180408-M-Davis_Cup_World_Group_QF-RR-David_Ferrer-Philipp_Kohlschreiber,1,F-IO,86,18,8,5,5,47,39
20180408-M-Davis_Cup_World_Group_QF-RR-David_Ferrer-Philipp_Kohlschreiber,1,F-II,15,7,4,2,1,10,5
20180408-M-Davis_Cup_World_Group_QF-RR-David_Ferrer-Philipp_Kohlschreiber,1,B-XC,110,14,4,4,6,63,47
20180408-M-Davis_Cup_World_Group_QF-RR-David_Ferrer-Philipp_Kohlschreiber,1,B-DTM,48,5,0,1,4,24,24
20180408-M-Davis_Cup_World_Group_QF-RR-David_Ferrer-Philipp_Kohlschreiber,1,B-DTL,15,8,3,1,4,9,6
20180408-M-Davis_Cup_World_Group_QF-RR-David_Ferrer-Philipp_Kohlschreiber,1,B-IO,7,2,0,0,2,2,5
20180408-M-Davis_Cup_World_Group_QF-RR-David_Ferrer-Philipp_Kohlschreiber,1,B-II,1,1,0,1,0,1,0
20180408-M-Davis_Cup_World_Group_QF-RR-David_Ferrer-Philipp_Kohlschreiber,1,S-XC,10,2,0,0,2,4,6
20180408-M-Davis_Cup_World_Group_QF-RR-David_Ferrer-Philipp_Kohlschreiber,1,S-DTM,7,0,0,0,0,4,3
20180408-M-Davis_Cup_World_Group_QF-RR-David_Ferrer-Philipp_Kohlschreiber,1,S-DTL,2,0,0,0,0,2,0
20180408-M-Davis_Cup_World_Group_QF-RR-David_Ferrer-Philipp_Kohlschreiber,1,S-II,1,0,0,0,0,1,0
20180408-M-Davis_Cup_World_Group_QF-RR-David_Ferrer-Philipp_Kohlschreiber,2,F-XC,103,20,7,8,5,58,45
20180408-M-Davis_Cup_World_Group_QF-RR-David_Ferrer-Philipp_Kohlschreiber,2,F-DTM,50,4,1,0,3,20,30
20180408-M-Davis_Cup_World_Group_QF-RR-David_Ferrer-Philipp_Kohlschreiber,2,F-DTL,26,5,2,3,0,15,11
20180408-M-Davis_Cup_World_Group_QF-RR-David_Ferrer-Philipp_Kohlschreiber,2,F-IO,63,20,8,8,4,37,26
20180408-M-Davis_Cup_World_Group_QF-RR-David_Ferrer-Philipp_Kohlschreiber,2,F-II,19,6,2,1,3,8,11
20180408-M-Davis_Cup_World_Group_QF-RR-David_Ferrer-Philipp_Kohlschreiber,2,B-XC,114,19,1,7,11,55,59
20180408-M-Davis_Cup_World_Group_QF-RR-David_Ferrer-Philipp_Kohlschreiber,2,B-DTM,58,6,0,2,4,26,32
20180408-M-Davis_Cup_World_Group_QF-RR-David_Ferrer-Philipp_Kohlschreiber,2,B-DTL,23,16,9,1,6,15,8
20180408-M-Davis_Cup_World_Group_QF-RR-David_Ferrer-Philipp_Kohlschreiber,2,B-IO,8,3,1,0,2,2,6
20180408-M-Davis_Cup_World_Group_QF-RR-David_Ferrer-Philipp_Kohlschreiber,2,S-XC,35,6,0,3,3,11,24
20180408-M-Davis_Cup_World_Group_QF-RR-David_Ferrer-Philipp_Kohlschreiber,2,S-DTM,16,0,0,0,0,9,7
20180408-M-Davis_Cup_World_Group_QF-RR-David_Ferrer-Philipp_Kohlschreiber,2,S-DTL,7,1,0,0,1,2,5
20060618-M-Halle-F-Roger_Federer-Tomas_Berdych,1,F-XC,26,10,5,3,2,21,5
20060618-M-Halle-F-Roger_Federer-Tomas_Berdych,1,F-DTM,21,3,0,2,1,14,7
20060618-M-Halle-F-Roger_Federer-Tomas_Berdych,1,F-DTL,8,3,2,1,0,6,2
20060618-M-Halle-F-Roger_Federer-Tomas_Berdych,1,F-IO,16,5,3,0,2,11,5
20060618-M-Halle-F-Roger_Federer-Tomas_Berdych,1,F-II,2,2,1,1,0,2,0
20060618-M-Halle-F-Roger_Federer-Tomas_Berdych,1,B-XC,12,5,1,2,2,5,7
20060618-M-Halle-F-Roger_Federer-Tomas_Berdych,1,B-DTM,14,2,0,1,1,8,6
20060618-M-Halle-F-Roger_Federer-Tomas_Berdych,1,B-DTL,6,5,3,1,1,4,2
20060618-M-Halle-F-Roger_Federer-Tomas_Berdych,1,B-IO,3,3,2,0,1,2,1
20060618-M-Halle-F-Roger_Federer-Tomas_Berdych,1,S-XC,12,2,0,1,1,10,2
20060618-M-Halle-F-Roger_Federer-Tomas_Berdych,1,S-DTM,11,1,0,0,1,5,6
20060618-M-Halle-F-Roger_Federer-Tomas_Berdych,1,S-DTL,2,1,0,0,1,1,1
20060618-M-Halle-F-Roger_Federer-Tomas_Berdych,2,F-XC,27,6,2,1,3,8,19
20060618-M-Halle-F-Roger_Federer-Tomas_Berdych,2,F-DTM,15,1,0,0,1,4,11
20060618-M-Halle-F-Roger_Federer-Tomas_Berdych,2,F-DTL,8,4,0,0,4,1,7
20060618-M-Halle-F-Roger_Federer-Tomas_Berdych,2,F-IO,24,7,2,1,4,11,13
20060618-M-Halle-F-Roger_Federer-Tomas_Berdych,2,F-II,1,0,0,0,0,0,1
20060618-M-Halle-F-Roger_Federer-Tomas_Berdych,2,B-XC,27,4,0,3,1,11,16
20060618-M-Halle-F-Roger_Federer-Tomas_Berdych,2,B-DTM,14,1,0,0,1,7,7
20060618-M-Halle-F-Roger_Federer-Tomas_Berdych,2,B-DTL,2,2,1,0,1,1,1
20060618-M-Halle-F-Roger_Federer-Tomas_Berdych,2,B-IO,1,1,0,1,0,1,0
20060618-M-Halle-F-Roger_Federer-Tomas_Berdych,2,S-XC,5,0,0,0,0,0,5
20060618-M-Halle-F-Roger_Federer-Tomas_Berdych,2,S-DTM,3,0,0,0,0,0,3
20060618-M-Halle-F-Roger_Federer-Tomas_Berdych,2,S-DTL,2,1,0,0,1,0,2
20040306-M-Dubai-F-Roger_Federer-Feliciano_Lopez,1,F-XC,45,5,1,4,0,30,15
20040306-M-Dubai-F-Roger_Federer-Feliciano_Lopez,1,F-DTM,10,5,0,1,4,3,7
20040306-M-Dubai-F-Roger_Federer-Feliciano_Lopez,1,F-DTL,9,4,1,2,1,5,4
20040306-M-Dubai-F-Roger_Federer-Feliciano_Lopez,1,F-IO,8,5,2,1,2,4,4
20040306-M-Dubai-F-Roger_Federer-Feliciano_Lopez,1,F-II,5,0,0,0,0,5,0
20040306-M-Dubai-F-Roger_Federer-Feliciano_Lopez,1,B-XC,7,3,1,2,0,7,0
20040306-M-Dubai-F-Roger_Federer-Feliciano_Lopez,1,B-DTM,21,3,0,1,2,13,8
20040306-M-Dubai-F-Roger_Federer-Feliciano_Lopez,1,B-DTL,8,2,0,0,2,3,5
20040306-M-Dubai-F-Roger_Federer-Feliciano_Lopez,1,B-IO,4,0,0,0,0,3,1
20040306-M-Dubai-F-Roger_Federer-Feliciano_Lopez,1,S-XC,1,1,0,1,0,1,0
20040306-M-Dubai-F-Roger_Federer-Feliciano_Lopez,1,S-DTM,10,0,0,0,0,6,4
20040306-M-Dubai-F-Roger_Federer-Feliciano_Lopez,1,S-DTL,5,2,0,1,1,3,2
20040306-M-Dubai-F-Roger_Federer-Feliciano_Lopez,2,F-XC,42,9,3,2,4,20,22
20040306-M-Dubai-F-Roger_Federer-Feliciano_Lopez,2,F-DTM,12,1,0,0,1,3,9
20040306-M-Dubai-F-Roger_Federer-Feliciano_Lopez,2,F-DTL,2,2,1,0,1,1,1
20040306-M-Dubai-F-Roger_Federer-Feliciano_Lopez,2,F-IO,22,13,7,2,4,14,8
20040306-M-Dubai-F-Roger_Federer-Feliciano_Lopez,2,F-II,9,4,1,1,2,4,5
20040306-M-Dubai-F-Roger_Federer-Feliciano_Lopez,2,B-XC,14,8,2,0,6,5,9
20040306-M-Dubai-F-Roger_Federer-Feliciano_Lopez,2,B-DTM,29,5,0,0,5,7,22
20040306-M-Dubai-F-Roger_Federer-Feliciano_Lopez,2,B-DTL,2,1,1,0,0,1,1
20040306-M-Dubai-F-Roger_Federer-Feliciano_Lopez,2,S-XC,1,0,0,0,0,0,1
20040306-M-Dubai-F-Roger_Federer-Feliciano_Lopez,2,S-DTM,7,0,0,0,0,3,4
20040306-M-Dubai-F-Roger_Federer-Feliciano_Lopez,2,S-DTL,10,0,0,0,0,2,8
19960428-M-Monte_Carlo_Masters-F-Albert_Costa-Thomas_Muster,1,F-XC,200,26,9,8,9,107,93
19960428-M-Monte_Carlo_Masters-F-Albert_Costa-Thomas_Muster,1,F-DTM,58,3,0,0,3,19,39
19960428-M-Monte_Carlo_Masters-F-Albert_Costa-Thomas_Muster,1,F-DTL,26,6,4,1,1,16,10
19960428-M-Monte_Carlo_Masters-F-Albert_Costa-Thomas_Muster,1,F-IO,77,30,16,2,12,43,34
19960428-M-Monte_Carlo_Masters-F-Albert_Costa-Thomas_Muster,1,F-II,27,7,5,0,2,16,11
19960428-M-Monte_Carlo_Masters-F-Albert_Costa-Thomas_Muster,1,B-XC,121,21,4,3,14,47,74
19960428-M-Monte_Carlo_Masters-F-Albert_Costa-Thomas_Muster,1,B-DTM,74,6,0,1,5,25,49
19960428-M-Monte_Carlo_Masters-F-Albert_Costa-Thomas_Muster,1,B-DTL,34,14,7,2,5,19,15
19960428-M-Monte_Carlo_Masters-F-Albert_Costa-Thomas_Muster,1,B-IO,8,2,0,0,2,2,6
19960428-M-Monte_Carlo_Masters-F-Albert_Costa-Thomas_Muster,1,S-XC,11,1,1,0,0,6,5
19960428-M-Monte_Carlo_Masters-F-Albert_Costa-Thomas_Muster,1,S-DTM,6,0,0,0,0,5,1
19960428-M-Monte_Carlo_Masters-F-Albert_Costa-Thomas_Muster,1,S-DTL,10,1,0,1,0,5,5
19960428-M-Monte_Carlo_Masters-F-Albert_Costa-Thomas_Muster,2,F-XC,198,17,3,9,5,112,86
19960428-M-Monte_Carlo_Masters-F-Albert_Costa-Thomas_Muster,2,F-DTM,51,3,0,0,3,27,24
19960428-M-Monte_Carlo_Masters-F-Albert_Costa-Thomas_Muster,2,F-DTL,36,11,5,5,1,22,14
19960428-M-Monte_Carlo_Masters-F-Albert_Costa-Thomas_Muster,2,F-IO,61,20,6,6,8,33,28
19960428-M-Monte_Carlo_Masters-F-Albert_Costa-Thomas_Muster,2,F-II,21,3,0,1,2,8,13
19960428-M-Monte_Carlo_Masters-F-Albert_Costa-Thomas_Muster,2,B-XC,73,15,5,6,4,36,37
19960428-M-Monte_Carlo_Masters-F-Albert_Costa-Thomas_Muster,2,B-DTM,108,9,0,0,9,58,50
19960428-M-Monte_Carlo_Masters-F-Albert_Costa-Thomas_Muster,2,B-DTL,36,6,1,3,2,17,19
19960428-M-Monte_Carlo_Masters-F-Albert_Costa-Thomas_Muster,2,B-IO,5,2,1,1,0,4,1
19960428-M-Monte_Carlo_Masters-F-Albert_Costa-Thomas_Muster,2,S-XC,10,0,0,0,0,6,4
19960428-M-Monte_Carlo_Masters-F-Albert_Costa-Thomas_Muster,2,S-DTM,29,1,0,0,1,15,14
19960428-M-Monte_Carlo_Masters-F-Albert_Costa-Thomas_Muster,2,S-DTL,15,3,0,3,0,12,3
20180415-M-Houston-F-Steve_Johnson-Tennys_Sandgren,1,F-XC,55,16,7,5,4,28,27
20180415-M-Houston-F-Steve_Johnson-Tennys_Sandgren,1,F-DTM,21,1,0,0,1,11,10
20180415-M-Houston-F-Steve_Johnson-Tennys_Sandgren,1,F-DTL,22,5,2,1,2,11,11
20180415-M-Houston-F-Steve_Johnson-Tennys_Sandgren,1,F-IO,43,14,6,5,3,28,15
20180415-M-Houston-F-Steve_Johnson-Tennys_Sandgren,1,F-II,19,6,1,4,1,12,7
20180415-M-Houston-F-Steve_Johnson-Tennys_Sandgren,1,B-XC,3,0,0,0,0,1,2
20180415-M-Houston-F-Steve_Johnson-Tennys_Sandgren,1,B-DTM,1,0,0,0,0,1,0
20180415-M-Houston-F-Steve_Johnson-Tennys_Sandgren,1,B-DTL,3,1,1,0,0,2,1
20180415-M-Houston-F-Steve_Johnson-Tennys_Sandgren,1,S-XC,68,2,0,1,1,33,35
20180415-M-Houston-F-Steve_Johnson-Tennys_Sandgren,1,S-DTM,13,0,0,0,0,6,7
20180415-M-Houston-F-Steve_Johnson-Tennys_Sandgren,1,S-DTL,9,2,0,1,1,5,4
20180415-M-Houston-F-Steve_Johnson-Tennys_Sandgren,1,S-IO,1,0,0,0,0,0,1
20180415-M-Houston-F-Steve_Johnson-Tennys_Sandgren,2,F-XC,58,13,1,9,3,33,25
20180415-M-Houston-F-Steve_Johnson-Tennys_Sandgren,2,F-DTM,25,1,1,0,0,16,9
20180415-M-Houston-F-Steve_Johnson-Tennys_Sandgren,2,F-DTL,9,4,0,1,3,2,7
20180415-M-Houston-F-Steve_Johnson-Tennys_Sandgren,2,F-IO,56,11,1,4,6,28,28
20180415-M-Houston-F-Steve_Johnson-Tennys_Sandgren,2,F-II,7,5,1,1,3,4,3
20180415-M-Houston-F-Steve_Johnson-Tennys_Sandgren,2,B-XC,53,9,0,4,5,25,28
20180415-M-Houston-F-Steve_Johnson-Tennys_Sandgren,2,B-DTM,14,0,0,0,0,11,3
20180415-M-Houston-F-Steve_Johnson-Tennys_Sandgren,2,B-DTL,9,7,5,0,2,6,3
20180415-M-Houston-F-Steve_Johnson-Tennys_Sandgren,2,B-II,1,1,1,0,0,1,0
20180415-M-Houston-F-Steve_Johnson-Tennys_Sandgren,2,S-XC,29,3,0,0,3,10,19
20180415-M-Houston-F-Steve_Johnson-Tennys_Sandgren,2,S-DTM,8,2,1,0,1,3,5
20180415-M-Houston-F-Steve_Johnson-Tennys_Sandgren,2,S-DTL,5,1,0,0,1,3,2
20180415-M-Houston-F-Steve_Johnson-Tennys_Sandgren,2,S-IO,1,0,0,0,0,1,0
19891203-M-Tour_Finals-F-Stefan_Edberg-Boris_Becker,1,F-XC,23,6,1,2,3,10,13
19891203-M-Tour_Finals-F-Stefan_Edberg-Boris_Becker,1,F-DTM,13,0,0,0,0,6,7
19891203-M-Tour_Finals-F-Stefan_Edberg-Boris_Becker,1,F-DTL,12,1,0,0,1,5,7
19891203-M-Tour_Finals-F-Stefan_Edberg-Boris_Becker,1,F-IO,7,1,1,0,0,7,0
19891203-M-Tour_Finals-F-Stefan_Edberg-Boris_Becker,1,B-XC,35,9,3,1,5,22,13
19891203-M-Tour_Finals-F-Stefan_Edberg-Boris_Becker,1,B-DTM,10,1,0,0,1,6,4
19891203-M-Tour_Finals-F-Stefan_Edberg-Boris_Becker,1,B-DTL,11,6,2,3,1,8,3
19891203-M-Tour_Finals-F-Stefan_Edberg-Boris_Becker,1,B-IO,5,1,1,0,0,1,4
19891203-M-Tour_Finals-F-Stefan_Edberg-Boris_Becker,1,S-XC,5,0,0,0,0,3,2
19891203-M-Tour_Finals-F-Stefan_Edberg-Boris_Becker,1,S-DTM,3,0,0,0,0,0,3
19891203-M-Tour_Finals-F-Stefan_Edberg-Boris_Becker,1,S-DTL,1,0,0,0,0,1,0
19891203-M-Tour_Finals-F-Stefan_Edberg-Boris_Becker,2,F-XC,27,6,3,0,3,16,11
19891203-M-Tour_Finals-F-Stefan_Edberg-Boris_Becker,2,F-DTM,6,1,0,1,0,4,2
19891203-M-Tour_Finals-F-Stefan_Edberg-Boris_Becker,2,F-DTL,9,5,4,0,1,6,3
19891203-M-Tour_Finals-F-Stefan_Edberg-Boris_Becker,2,F-IO,16,2,1,0,1,9,7
19891203-M-Tour_Finals-F-Stefan_Edberg-Boris_Becker,2,F-II,1,0,0,0,0,0,1
19891203-M-Tour_Finals-F-Stefan_Edberg-Boris_Becker,2,B-XC,33,13,3,4,6,14,19
19891203-M-Tour_Finals-F-Stefan_Edberg-Boris_Becker,2,B-DTM,27,1,0,1,0,11,16
19891203-M-Tour_Finals-F-Stefan_Edberg-Boris_Becker,2,B-DTL,18,9,1,5,3,9,9
19891203-M-Tour_Finals-F-Stefan_Edberg-Boris_Becker,2,B-IO,1,0,0,0,0,1,0
19891203-M-Tour_Finals-F-Stefan_Edberg-Boris_Becker,2,S-XC,9,3,0,0,3,1,8
19891203-M-Tour_Finals-F-Stefan_Edberg-Boris_Becker,2,S-DTM,7,0,0,0,0,0,7
19891203-M-Tour_Finals-F-Stefan_Edberg-Boris_Becker,2,S-DTL,3,1,0,0,1,1,2
19891203-M-Tour_Finals-F-Stefan_Edberg-Boris_Becker,2,S-IO,1,0,0,0,0,1,0
19870607-M-Roland_Garros-F-Mats_Wilander-Ivan_Lendl,1,F-XC,82,6,1,3,2,42,40
19870607-M-Roland_Garros-F-Mats_Wilander-Ivan_Lendl,1,F-DTM,135,3,0,1,2,76,59
19870607-M-Roland_Garros-F-Mats_Wilander-Ivan_Lendl,1,F-DTL,47,6,2,2,2,25,22
19870607-M-Roland_Garros-F-Mats_Wilander-Ivan_Lendl,1,F-IO,61,3,0,1,2,34,27
19870607-M-Roland_Garros-F-Mats_Wilander-Ivan_Lendl,1,F-II,9,0,0,0,0,5,4
19870607-M-Roland_Garros-F-Mats_Wilander-Ivan_Lendl,1,B-XC,320,5,1,1,3,170,150
19870607-M-Roland_Garros-F-Mats_Wilander-Ivan_Lendl,1,B-DTM,104,3,0,0,3,47,57
19870607-M-Roland_Garros-F-Mats_Wilander-Ivan_Lendl,1,B-DTL,47,14,7,3,4,34,13
19870607-M-Roland_Garros-F-Mats_Wilander-Ivan_Lendl,1,B-IO,14,2,1,1,0,10,4
19870607-M-Roland_Garros-F-Mats_Wilander-Ivan_Lendl,1,S-XC,39,2,0,1,1,23,16
19870607-M-Roland_Garros-F-Mats_Wilander-Ivan_Lendl,1,S-DTM,17,0,0,0,0,8,9
19870607-M-Roland_Garros-F-Mats_Wilander-Ivan_Lendl,1,S-DTL,5,1,0,1,0,3,2
19870607-M-Roland_Garros-F-Mats_Wilander-Ivan_Lendl,1,S-IO,1,0,0,0,0,1,0
19870607-M-Roland_Garros-F-Mats_Wilander-Ivan_Lendl,2,F-XC,141,17,4,3,10,63,78
19870607-M-Roland_Garros-F-Mats_Wilander-Ivan_Lendl,2,F-DTM,73,1,0,0,1,32,41
19870607-M-Roland_Garros-F-Mats_Wilander-Ivan_Lendl,2,F-DTL,23,8,1,3,4,11,12
19870607-M-Roland_Garros-F-Mats_Wilander-Ivan_Lendl,2,F-IO,107,15,8,3,4,55,52
19870607-M-Roland_Garros-F-Mats_Wilander-Ivan_Lendl,2,F-II,10,3,1,1,1,5,5
19870607-M-Roland_Garros-F-Mats_Wilander-Ivan_Lendl,2,B-XC,272,10,0,0,10,125,147
19870607-M-Roland_Garros-F-Mats_Wilander-Ivan_Lendl,2,B-DTM,96,3,0,1,2,40,56
19870607-M-Roland_Garros-F-Mats_Wilander-Ivan_Lendl,2,B-DTL,21,13,4,3,6,11,10
19870607-M-Roland_Garros-F-Mats_Wilander-Ivan_Lendl,2,B-IO,19,5,2,1,2,12,7
19870607-M-Roland_Garros-F-Mats_Wilander-Ivan_Lendl,2,S-XC,81,3,0,1,2,36,45
19870607-M-Roland_Garros-F-Mats_Wilander-Ivan_Lendl,2,S-DTM,49,1,0,0,1,18,31
19870607-M-Roland_Garros-F-Mats_Wilander-Ivan_Lendl,2,S-DTL,6,2,2,0,0,5,1
19870607-M-Roland_Garros-F-Mats_Wilander-Ivan_Lendl,2,S-IO,5,0,0,0,0,1,4
19931107-M-Paris_Masters-F-Andrei_Medvedev-Goran_Ivanisevic,1,F-XC,20,3,0,1,2,5,15
19931107-M-Paris_Masters-F-Andrei_Medvedev-Goran_Ivanisevic,1,F-DTM,26,4,0,2,2,14,12
19931107-M-Paris_Masters-F-Andrei_Medvedev-Goran_Ivanisevic,1,F-DTL,1,1,1,0,0,1,0
19931107-M-Paris_Masters-F-Andrei_Medvedev-Goran_Ivanisevic,1,F-IO,9,4,0,1,3,4,5
19931107-M-Paris_Masters-F-Andrei_Medvedev-Goran_Ivanisevic,1,F-II,1,0,0,0,0,0,1
19931107-M-Paris_Masters-F-Andrei_Medvedev-Goran_Ivanisevic,1,B-XC,51,8,1,2,5,21,30
19931107-M-Paris_Masters-F-Andrei_Medvedev-Goran_Ivanisevic,1,B-DTM,28,5,0,1,4,12,16
19931107-M-Paris_Masters-F-Andrei_Medvedev-Goran_Ivanisevic,1,B-DTL,14,8,1,3,4,6,8
19931107-M-Paris_Masters-F-Andrei_Medvedev-Goran_Ivanisevic,1,B-IO,5,3,1,2,0,4,1
19931107-M-Paris_Masters-F-Andrei_Medvedev-Goran_Ivanisevic,1,S-DTM,1,0,0,0,0,1,0
19931107-M-Paris_Masters-F-Andrei_Medvedev-Goran_Ivanisevic,1,S-IO,1,0,0,0,0,0,1
19931107-M-Paris_Masters-F-Andrei_Medvedev-Goran_Ivanisevic,2,F-XC,46,15,7,3,5,27,19
19931107-M-Paris_Masters-F-Andrei_Medvedev-Goran_Ivanisevic,2,F-DTM,31,2,0,2,0,19,12
19931107-M-Paris_Masters-F-Andrei_Medvedev-Goran_Ivanisevic,2,F-DTL,4,3,0,1,2,1,3
19931107-M-Paris_Masters-F-Andrei_Medvedev-Goran_Ivanisevic,2,F-IO,13,9,2,0,7,4,9
19931107-M-Paris_Masters-F-Andrei_Medvedev-Goran_Ivanisevic,2,B-XC,3,1,1,0,0,1,2
19931107-M-Paris_Masters-F-Andrei_Medvedev-Goran_Ivanisevic,2,B-DTM,11,1,0,0,1,7,4
19931107-M-Paris_Masters-F-Andrei_Medvedev-Goran_Ivanisevic,2,B-DTL,7,2,1,1,0,6,1
19931107-M-Paris_Masters-F-Andrei_Medvedev-Goran_Ivanisevic,2,B-IO,3,0,0,0,0,2,1
19931107-M-Paris_Masters-F-Andrei_Medvedev-Goran_Ivanisevic,2,S-XC,2,2,0,0,2,0,2
19931107-M-Paris_Masters-F-Andrei_Medvedev-Goran_Ivanisevic,2,S-DTM,11,0,0,0,0,7,4
19931107-M-Paris_Masters-F-Andrei_Medvedev-Goran_Ivanisevic,2,S-DTL,4,0,0,0,0,3,1
19931107-M-Paris_Masters-F-Andrei_Medvedev-Goran_Ivanisevic,2,S-IO,4,1,0,0,1,2,2
20120608-M-Roland_Garros-SF-Novak_Djokovic-Roger_Federer,1,F-XC,48,13,7,5,1,35,13
20120608-M-Roland_Garros-SF-Novak_Djokovic-Roger_Federer,1,F-DTM,33,1,0,0,1,19,14
20120608-M-Roland_Garros-SF-Novak_Djokovic-Roger_Federer,1,F-DTL,14,2,0,0,2,8,6
20120608-M-Roland_Garros-SF-Novak_Djokovic-Roger_Federer,1,F-IO,32,7,3,2,2,21,11
20120608-M-Roland_Garros-SF-Novak_Djokovic-Roger_Federer,1,F-II,2,1,0,0,1,1,1
20120608-M-Roland_Garros-SF-Novak_Djokovic-Roger_Federer,1,B-XC,102,7,2,2,3,57,45
20120608-M-Roland_Garros-SF-Novak_Djokovic-Roger_Federer,1,B-DTM,37,3,0,0,3,21,16
20120608-M-Roland_Garros-SF-Novak_Djokovic-Roger_Federer,1,B-DTL,21,3,2,0,1,10,11
20120608-M-Roland_Garros-SF-Novak_Djokovic-Roger_Federer,1,B-IO,8,1,0,0,1,7,1
20120608-M-Roland_Garros-SF-Novak_Djokovic-Roger_Federer,1,S-XC,3,0,0,0,0,2,1
20120608-M-Roland_Garros-SF-Novak_Djokovic-Roger_Federer,1,S-DTM,5,1,1,0,0,2,3
20120608-M-Roland_Garros-SF-Novak_Djokovic-Roger_Federer,1,S-DTL,1,0,0,0,0,0,1
20120608-M-Roland_Garros-SF-Novak_Djokovic-Roger_Federer,2,F-XC,53,16,7,1,8,19,34
20120608-M-Roland_Garros-SF-Novak_Djokovic-Roger_Federer,2,F-DTM,46,8,0,0,8,14,32
20120608-M-Roland_Garros-SF-Novak_Djokovic-Roger_Federer,2,F-DTL,18,10,3,2,5,11,7
20120608-M-Roland_Garros-SF-Novak_Djokovic-Roger_Federer,2,F-IO,47,12,1,6,5,25,22
20120608-M-Roland_Garros-SF-Novak_Djokovic-Roger_Federer,2,F-II,5,1,0,0,1,1,4
20120608-M-Roland_Garros-SF-Novak_Djokovic-Roger_Federer,2,B-XC,68,10,1,2,7,31,37
20120608-M-Roland_Garros-SF-Novak_Djokovic-Roger_Federer,2,B-DTM,39,4,0,1,3,12,27
20120608-M-Roland_Garros-SF-Novak_Djokovic-Roger_Federer,2,B-DTL,21,7,2,0,5,9,12
20120608-M-Roland_Garros-SF-Novak_Djokovic-Roger_Federer,2,B-IO,3,2,1,0,1,1,2
20120608-M-Roland_Garros-SF-Novak_Djokovic-Roger_Federer,2,S-XC,16,0,0,0,0,5,11
20120608-M-Roland_Garros-SF-Novak_Djokovic-Roger_Federer,2,S-DTM,12,1,0,0,1,2,10
19990815-M-Cincinnati_Masters-F-Patrick_Rafter-Pete_Sampras,1,F-IO,2,2,1,0,1,1,1
19990815-M-Cincinnati_Masters-F-Patrick_Rafter-Pete_Sampras,1,B-XC,3,1,0,1,0,2,1
19990815-M-Cincinnati_Masters-F-Patrick_Rafter-Pete_Sampras,1,B-DTM,1,0,0,0,0,0,1
19990815-M-Cincinnati_Masters-F-Patrick_Rafter-Pete_Sampras,1,B-IO,1,1,0,0,1,0,1
19990815-M-Cincinnati_Masters-F-Patrick_Rafter-Pete_Sampras,1,S-XC,1,1,0,1,0,1,0
19990815-M-Cincinnati_Masters-F-Patrick_Rafter-Pete_Sampras,1,S-DTL,1,0,0,0,0,0,1
19990815-M-Cincinnati_Masters-F-Patrick_Rafter-Pete_Sampras,2,F-XC,2,1,0,0,1,1,1
19990815-M-Cincinnati_Masters-F-Patrick_Rafter-Pete_Sampras,2,F-DTL,3,2,2,0,0,2,1
19990815-M-Cincinnati_Masters-F-Patrick_Rafter-Pete_Sampras,2,F-IO,1,1,0,1,0,1,0
19990815-M-Cincinnati_Masters-F-Patrick_Rafter-Pete_Sampras,2,B-XC,5,2,0,2,0,3,2
19990815-M-Cincinnati_Masters-F-Patrick_Rafter-Pete_Sampras,2,B-DTL,6,6,2,0,4,2,4
19990815-M-Cincinnati_Masters-F-Patrick_Rafter-Pete_Sampras,2,S-DTL,1,1,1,0,0,1,0
20140411-M-Houston-QF-Donald_Young-Fernando_Verdasco,1,F-XC,28,7,1,2,4,16,12
20140411-M-Houston-QF-Donald_Young-Fernando_Verdasco,1,F-DTM,13,0,0,0,0,7,6
20140411-M-Houston-QF-Donald_Young-Fernando_Verdasco,1,F-DTL,15,6,2,2,2,10,5
20140411-M-Houston-QF-Donald_Young-Fernando_Verdasco,1,F-IO,16,3,0,1,2,9,7
20140411-M-Houston-QF-Donald_Young-Fernando_Verdasco,1,F-II,8,4,2,2,0,6,2
20140411-M-Houston-QF-Donald_Young-Fernando_Verdasco,1,B-XC,28,6,3,2,1,15,13
20140411-M-Houston-QF-Donald_Young-Fernando_Verdasco,1,B-DTM,14,1,0,0,1,5,9
20140411-M-Houston-QF-Donald_Young-Fernando_Verdasco,1,B-DTL,10,2,1,0,1,3,7
20140411-M-Houston-QF-Donald_Young-Fernando_Verdasco,1,B-IO,2,0,0,0,0,1,1
20140411-M-Houston-QF-Donald_Young-Fernando_Verdasco,1,S-XC,2,0,0,0,0,1,1
20140411-M-Houston-QF-Donald_Young-Fernando_Verdasco,1,S-DTM,2,0,0,0,0,0,2
20140411-M-Houston-QF-Donald_Young-Fernando_Verdasco,2,F-XC,36,13,4,6,3,19,17
20140411-M-Houston-QF-Donald_Young-Fernando_Verdasco,2,F-DTM,8,0,0,0,0,4,4
20140411-M-Houston-QF-Donald_Young-Fernando_Verdasco,2,F-DTL,16,5,4,1,0,12,4
20140411-M-Houston-QF-Donald_Young-Fernando_Verdasco,2,F-IO,31,10,2,5,3,18,13
20140411-M-Houston-QF-Donald_Young-Fernando_Verdasco,2,F-II,5,4,0,2,2,2,3
20140411-M-Houston-QF-Donald_Young-Fernando_Verdasco,2,B-XC,27,7,3,2,2,15,12
20140411-M-Houston-QF-Donald_Young-Fernando_Verdasco,2,B-DTM,6,0,0,0,0,4,2
20140411-M-Houston-QF-Donald_Young-Fernando_Verdasco,2,B-DTL,7,5,1,2,2,3,4
20140411-M-Houston-QF-Donald_Young-Fernando_Verdasco,2,S-XC,8,1,0,0,1,3,5
20140411-M-Houston-QF-Donald_Young-Fernando_Verdasco,2,S-DTM,2,0,0,0,0,1,1
20140411-M-Houston-QF-Donald_Young-Fernando_Verdasco,2,S-DTL,2,1,0,1,0,1,1
19930307-M-Indian_Wells_Masters-F-Jim_Courier-Wayne_Ferreira,1,F-XC,32,9,0,7,2,27,5
19930307-M-Indian_Wells_Masters-F-Jim_Courier-Wayne_Ferreira,1,F-DTM,20,2,1,0,1,12,8
19930307-M-Indian_Wells_Masters-F-Jim_Courier-Wayne_Ferreira,1,F-DTL,7,1,1,0,0,6,1
19930307-M-Indian_Wells_Masters-F-Jim_Courier-Wayne_Ferreira,1,F-IO,32,7,2,5,0,28,4
19930307-M-Indian_Wells_Masters-F-Jim_Courier-Wayne_Ferreira,1,F-II,3,0,0,0,0,3,0
19930307-M-Indian_Wells_Masters-F-Jim_Courier-Wayne_Ferreira,1,B-XC,36,3,0,2,1,23,13
19930307-M-Indian_Wells_Masters-F-Jim_Courier-Wayne_Ferreira,1,B-DTM,12,3,0,1,2,5,7
19930307-M-Indian_Wells_Masters-F-Jim_Courier-Wayne_Ferreira,1,B-DTL,1,1,0,0,1,0,1
19930307-M-Indian_Wells_Masters-F-Jim_Courier-Wayne_Ferreira,1,S-XC,10,1,0,1,0,6,4
19930307-M-Indian_Wells_Masters-F-Jim_Courier-Wayne_Ferreira,1,S-DTM,6,0,0,0,0,6,0
19930307-M-Indian_Wells_Masters-F-Jim_Courier-Wayne_Ferreira,2,F-XC,23,7,1,1,5,5,18
19930307-M-Indian_Wells_Masters-F-Jim_Courier-Wayne_Ferreira,2,F-DTM,17,1,0,0,1,5,12
19930307-M-Indian_Wells_Masters-F-Jim_Courier-Wayne_Ferreira,2,F-DTL,9,1,0,1,0,1,8
19930307-M-Indian_Wells_Masters-F-Jim_Courier-Wayne_Ferreira,2,F-IO,23,8,3,0,5,12,11
19930307-M-Indian_Wells_Masters-F-Jim_Courier-Wayne_Ferreira,2,F-II,4,1,1,0,0,2,2
19930307-M-Indian_Wells_Masters-F-Jim_Courier-Wayne_Ferreira,2,B-XC,33,4,0,0,4,10,23
19930307-M-Indian_Wells_Masters-F-Jim_Courier-Wayne_Ferreira,2,B-DTM,22,6,0,0,6,2,20
19930307-M-Indian_Wells_Masters-F-Jim_Courier-Wayne_Ferreira,2,B-DTL,10,7,1,1,5,3,7
19930307-M-Indian_Wells_Masters-F-Jim_Courier-Wayne_Ferreira,2,B-IO,3,1,0,0,1,0,3
19930307-M-Indian_Wells_Masters-F-Jim_Courier-Wayne_Ferreira,2,S-XC,9,0,0,0,0,3,6
19930307-M-Indian_Wells_Masters-F-Jim_Courier-Wayne_Ferreira,2,S-DTM,8,1,1,0,0,1,7
19930307-M-Indian_Wells_Masters-F-Jim_Courier-Wayne_Ferreira,2,S-DTL,4,1,0,0,1,0,4
20000213-M-Marseille-F-Marc_Rosset-Roger_Federer,1,F-XC,16,1,0,0,1,6,10
20000213-M-Marseille-F-Marc_Rosset-Roger_Federer,1,F-DTM,9,0,0,0,0,6,3
20000213-M-Marseille-F-Marc_Rosset-Roger_Federer,1,F-DTL,5,3,1,0,2,3,2
20000213-M-Marseille-F-Marc_Rosset-Roger_Federer,1,F-IO,10,5,1,0,4,6,4
20000213-M-Marseille-F-Marc_Rosset-Roger_Federer,1,F-II,3,1,0,0,1,0,3
20000213-M-Marseille-F-Marc_Rosset-Roger_Federer,1,B-XC,7,2,1,0,1,3,4
20000213-M-Marseille-F-Marc_Rosset-Roger_Federer,1,B-DTM,6,0,0,0,0,2,4
20000213-M-Marseille-F-Marc_Rosset-Roger_Federer,1,B-DTL,2,2,2,0,0,2,0
20000213-M-Marseille-F-Marc_Rosset-Roger_Federer,1,S-XC,22,1,0,0,1,7,15
20000213-M-Marseille-F-Marc_Rosset-Roger_Federer,1,S-DTM,7,0,0,0,0,5,2
20000213-M-Marseille-F-Marc_Rosset-Roger_Federer,1,S-DTL,2,1,0,1,0,1,1
20000213-M-Marseille-F-Marc_Rosset-Roger_Federer,2,F-XC,19,5,2,1,2,11,8
20000213-M-Marseille-F-Marc_Rosset-Roger_Federer,2,F-DTM,16,2,0,0,2,9,7
20000213-M-Marseille-F-Marc_Rosset-Roger_Federer,2,F-DTL,5,3,0,0,3,0,5
20000213-M-Marseille-F-Marc_Rosset-Roger_Federer,2,F-IO,24,5,3,0,2,15,9
20000213-M-Marseille-F-Marc_Rosset-Roger_Federer,2,F-II,9,3,0,1,2,3,6
20000213-M-Marseille-F-Marc_Rosset-Roger_Federer,2,B-XC,14,3,2,1,0,10,4
20000213-M-Marseille-F-Marc_Rosset-Roger_Federer,2,B-DTM,7,0,0,0,0,6,1
20000213-M-Marseille-F-Marc_Rosset-Roger_Federer,2,B-DTL,6,4,1,1,2,3,3
20000213-M-Marseille-F-Marc_Rosset-Roger_Federer,2,B-IO,4,4,3,0,1,3,1
20000213-M-Marseille-F-Marc_Rosset-Roger_Federer,2,S-XC,7,0,0,0,0,2,5
20000213-M-Marseille-F-Marc_Rosset-Roger_Federer,2,S-DTM,2,0,0,0,0,1,1
20000213-M-Marseille-F-Marc_Rosset-Roger_Federer,2,S-DTL,2,0,0,0,0,0,2
20000213-M-Marseille-F-Marc_Rosset-Roger_Federer,2,S-IO,1,1,0,0,1,0,1
19990314-M-Indian_Wells_Masters-F-Carlos_Moya-Mark_Philippoussis,1,F-XC,43,18,5,7,6,27,16
19990314-M-Indian_Wells_Masters-F-Carlos_Moya-Mark_Philippoussis,1,F-DTM,41,2,0,1,1,21,20
19990314-M-Indian_Wells_Masters-F-Carlos_Moya-Mark_Philippoussis,1,F-DTL,12,6,3,3,0,11,1
19990314-M-Indian_Wells_Masters-F-Carlos_Moya-Mark_Philippoussis,1,F-IO,86,9,3,3,3,55,31
19990314-M-Indian_Wells_Masters-F-Carlos_Moya-Mark_Philippoussis,1,F-II,11,5,2,1,2,5,6
19990314-M-Indian_Wells_Masters-F-Carlos_Moya-Mark_Philippoussis,1,B-XC,26,8,1,0,7,14,12
19990314-M-Indian_Wells_Masters-F-Carlos_Moya-Mark_Philippoussis,1,B-DTM,12,3,0,1,2,7,5
19990314-M-Indian_Wells_Masters-F-Carlos_Moya-Mark_Philippoussis,1,B-DTL,6,4,1,1,2,4,2
19990314-M-Indian_Wells_Masters-F-Carlos_Moya-Mark_Philippoussis,1,B-IO,4,1,1,0,0,3,1
19990314-M-Indian_Wells_Masters-F-Carlos_Moya-Mark_Philippoussis,1,S-XC,8,0,0,0,0,5,3
19990314-M-Indian_Wells_Masters-F-Carlos_Moya-Mark_Philippoussis,1,S-DTM,9,0,0,0,0,5,4
19990314-M-Indian_Wells_Masters-F-Carlos_Moya-Mark_Philippoussis,1,S-DTL,5,1,0,1,0,5,0
19990314-M-Indian_Wells_Masters-F-Carlos_Moya-Mark_Philippoussis,2,F-XC,27,10,5,2,3,16,11
19990314-M-Indian_Wells_Masters-F-Carlos_Moya-Mark_Philippoussis,2,F-DTM,17,2,1,0,1,6,11
19990314-M-Indian_Wells_Masters-F-Carlos_Moya-Mark_Philippoussis,2,F-DTL,11,6,0,2,4,5,6
19990314-M-Indian_Wells_Masters-F-Carlos_Moya-Mark_Philippoussis,2,F-IO,26,9,2,3,4,10,16
19990314-M-Indian_Wells_Masters-F-Carlos_Moya-Mark_Philippoussis,2,F-II,5,5,1,0,4,1,4
19990314-M-Indian_Wells_Masters-F-Carlos_Moya-Mark_Philippoussis,2,B-XC,51,10,3,2,5,23,28
19990314-M-Indian_Wells_Masters-F-Carlos_Moya-Mark_Philippoussis,2,B-DTM,19,4,1,1,2,7,12
19990314-M-Indian_Wells_Masters-F-Carlos_Moya-Mark_Philippoussis,2,B-DTL,12,7,1,1,5,3,9
19990314-M-Indian_Wells_Masters-F-Carlos_Moya-Mark_Philippoussis,2,B-IO,3,3,2,0,1,2,1
19990314-M-Indian_Wells_Masters-F-Carlos_Moya-Mark_Philippoussis,2,S-XC,26,4,0,0,4,9,17
19990314-M-Indian_Wells_Masters-F-Carlos_Moya-Mark_Philippoussis,2,S-DTM,7,0,0,0,0,4,3
19990314-M-Indian_Wells_Masters-F-Carlos_Moya-Mark_Philippoussis,2,S-DTL,6,1,0,0,1,0,6
19990314-M-Indian_Wells_Masters-F-Carlos_Moya-Mark_Philippoussis,2,S-IO,1,0,0,0,0,1,0
20070303-M-Dubai-F-Roger_Federer-Mikhail_Youzhny,1,F-XC,18,2,0,2,0,11,7
20070303-M-Dubai-F-Roger_Federer-Mikhail_Youzhny,1,F-DTM,13,0,0,0,0,9,4
20070303-M-Dubai-F-Roger_Federer-Mikhail_Youzhny,1,F-DTL,7,2,1,0,1,5,2
20070303-M-Dubai-F-Roger_Federer-Mikhail_Youzhny,1,F-IO,15,6,3,2,1,10,5
20070303-M-Dubai-F-Roger_Federer-Mikhail_Youzhny,1,F-II,2,1,0,0,1,1,1
20070303-M-Dubai-F-Roger_Federer-Mikhail_Youzhny,1,B-XC,34,5,0,2,3,21,13
20070303-M-Dubai-F-Roger_Federer-Mikhail_Youzhny,1,B-DTM,20,1,0,0,1,9,11
20070303-M-Dubai-F-Roger_Federer-Mikhail_Youzhny,1,B-DTL,9,5,0,3,2,4,5
20070303-M-Dubai-F-Roger_Federer-Mikhail_Youzhny,1,B-IO,5,2,2,0,0,4,1
20070303-M-Dubai-F-Roger_Federer-Mikhail_Youzhny,1,S-XC,10,0,0,0,0,3,7
20070303-M-Dubai-F-Roger_Federer-Mikhail_Youzhny,1,S-DTM,13,1,0,0,1,8,5
20070303-M-Dubai-F-Roger_Federer-Mikhail_Youzhny,1,S-DTL,4,4,0,2,2,2,2
20070303-M-Dubai-F-Roger_Federer-Mikhail_Youzhny,2,F-XC,15,3,1,1,1,8,7
20070303-M-Dubai-F-Roger_Federer-Mikhail_Youzhny,2,F-DTM,17,1,0,1,0,6,11
20070303-M-Dubai-F-Roger_Federer-Mikhail_Youzhny,2,F-DTL,7,2,0,0,2,3,4
20070303-M-Dubai-F-Roger_Federer-Mikhail_Youzhny,2,F-IO,27,2,0,1,1,17,10
20070303-M-Dubai-F-Roger_Federer-Mikhail_Youzhny,2,B-XC,42,9,0,3,6,20,22
20070303-M-Dubai-F-Roger_Federer-Mikhail_Youzhny,2,B-DTM,18,3,0,1,2,4,14
20070303-M-Dubai-F-Roger_Federer-Mikhail_Youzhny,2,B-DTL,7,2,2,0,0,4,3
20070303-M-Dubai-F-Roger_Federer-Mikhail_Youzhny,2,B-IO,4,0,0,0,0,1,3
20070303-M-Dubai-F-Roger_Federer-Mikhail_Youzhny,2,S-XC,12,1,1,0,0,2,10
20070303-M-Dubai-F-Roger_Federer-Mikhail_Youzhny,2,S-DTM,6,1,0,0,1,2,4
20070303-M-Dubai-F-Roger_Federer-Mikhail_Youzhny,2,S-DTL,4,1,0,0,1,1,3
20091108-M-Basel-F-Roger_Federer-Novak_Djokovic,1,F-XC,51,17,2,7,8,27,24
20091108-M-Basel-F-Roger_Federer-Novak_Djokovic,1,F-DTM,33,3,0,0,3,14,19
20091108-M-Basel-F-Roger_Federer-Novak_Djokovic,1,F-DTL,8,3,0,0,3,5,3
20091108-M-Basel-F-Roger_Federer-Novak_Djokovic,1,F-IO,40,13,2,3,8,16,24
20091108-M-Basel-F-Roger_Federer-Novak_Djokovic,1,F-II,8,0,0,0,0,3,5
20091108-M-Basel-F-Roger_Federer-Novak_Djokovic,1,B-XC,44,7,2,1,4,20,24
20091108-M-Basel-F-Roger_Federer-Novak_Djokovic,1,B-DTM,23,3,0,0,3,9,14
20091108-M-Basel-F-Roger_Federer-Novak_Djokovic,1,B-DTL,3,2,0,0,2,1,2
20091108-M-Basel-F-Roger_Federer-Novak_Djokovic,1,B-IO,3,1,0,0,1,1,2
20091108-M-Basel-F-Roger_Federer-Novak_Djokovic,1,S-XC,27,0,0,0,0,13,14
20091108-M-Basel-F-Roger_Federer-Novak_Djokovic,1,S-DTM,20,2,0,0,2,4,16
20091108-M-Basel-F-Roger_Federer-Novak_Djokovic,1,S-DTL,4,0,0,0,0,2,2
20091108-M-Basel-F-Roger_Federer-Novak_Djokovic,2,F-XC,47,12,2,4,6,22,25
20091108-M-Basel-F-Roger_Federer-Novak_Djokovic,2,F-DTM,36,5,0,1,4,21,15
20091108-M-Basel-F-Roger_Federer-Novak_Djokovic,2,F-DTL,11,1,1,0,0,8,3
20091108-M-Basel-F-Roger_Federer-Novak_Djokovic,2,F-IO,41,6,0,2,4,26,15
20091108-M-Basel-F-Roger_Federer-Novak_Djokovic,2,F-II,4,3,2,0,1,3,1
20091108-M-Basel-F-Roger_Federer-Novak_Djokovic,2,B-XC,56,5,2,1,2,27,29
20091108-M-Basel-F-Roger_Federer-Novak_Djokovic,2,B-DTM,28,3,0,1,2,16,12
20091108-M-Basel-F-Roger_Federer-Novak_Djokovic,2,B-DTL,12,4,1,1,2,7,5
20091108-M-Basel-F-Roger_Federer-Novak_Djokovic,2,B-IO,8,4,0,2,2,4,4
20091108-M-Basel-F-Roger_Federer-Novak_Djokovic,2,S-XC,15,1,0,0,1,7,8
20091108-M-Basel-F-Roger_Federer-Novak_Djokovic,2,S-DTM,6,0,0,0,0,3,3
20091108-M-Basel-F-Roger_Federer-Novak_Djokovic,2,S-DTL,2,1,0,1,0,2,0
20140615-M-Halle-F-Roger_Federer-Alejandro_Falla,1,F-XC,33,7,3,3,1,20,13
20140615-M-Halle-F-Roger_Federer-Alejandro_Falla,1,F-DTM,15,1,0,0,1,6,9
20140615-M-Halle-F-Roger_Federer-Alejandro_Falla,1,F-DTL,7,3,1,1,1,6,1
20140615-M-Halle-F-Roger_Federer-Alejandro_Falla,1,F-IO,17,13,5,4,4,13,4
20140615-M-Halle-F-Roger_Federer-Alejandro_Falla,1,F-II,3,1,0,0,1,1,2
20140615-M-Halle-F-Roger_Federer-Alejandro_Falla,1,B-XC,27,3,1,1,1,15,12
20140615-M-Halle-F-Roger_Federer-Alejandro_Falla,1,B-DTM,27,6,1,0,5,10,17
20140615-M-Halle-F-Roger_Federer-Alejandro_Falla,1,B-DTL,7,3,1,1,1,5,2
20140615-M-Halle-F-Roger_Federer-Alejandro_Falla,1,B-IO,2,0,0,0,0,1,1
20140615-M-Halle-F-Roger_Federer-Alejandro_Falla,1,S-XC,11,1,0,1,0,6,5
20140615-M-Halle-F-Roger_Federer-Alejandro_Falla,1,S-DTM,13,0,0,0,0,5,8
20140615-M-Halle-F-Roger_Federer-Alejandro_Falla,1,S-DTL,4,1,0,1,0,4,0
20140615-M-Halle-F-Roger_Federer-Alejandro_Falla,1,S-IO,1,0,0,0,0,1,0
20140615-M-Halle-F-Roger_Federer-Alejandro_Falla,2,F-XC,57,13,2,2,9,24,33
20140615-M-Halle-F-Roger_Federer-Alejandro_Falla,2,F-DTM,14,0,0,0,0,6,8
20140615-M-Halle-F-Roger_Federer-Alejandro_Falla,2,F-DTL,8,2,0,1,1,4,4
20140615-M-Halle-F-Roger_Federer-Alejandro_Falla,2,F-IO,6,1,0,1,0,5,1
20140615-M-Halle-F-Roger_Federer-Alejandro_Falla,2,B-XC,23,5,2,2,1,10,13
20140615-M-Halle-F-Roger_Federer-Alejandro_Falla,2,B-DTM,21,1,0,0,1,8,13
20140615-M-Halle-F-Roger_Federer-Alejandro_Falla,2,B-DTL,14,5,0,1,4,5,9
20140615-M-Halle-F-Roger_Federer-Alejandro_Falla,2,B-IO,12,3,2,1,0,10,2
20140615-M-Halle-F-Roger_Federer-Alejandro_Falla,2,S-XC,2,1,0,1,0,1,1
20140615-M-Halle-F-Roger_Federer-Alejandro_Falla,2,S-DTM,3,0,0,0,0,2,1
20140615-M-Halle-F-Roger_Federer-Alejandro_Falla,2,S-DTL,5,0,0,0,0,1,4
19931031-M-Stockholm_Masters-F-Michael_Stich-Goran_Ivanisevic,1,F-XC,10,6,2,3,1,6,4
19931031-M-Stockholm_Masters-F-Michael_Stich-Goran_Ivanisevic,1,F-DTM,5,1,1,0,0,3,2
19931031-M-Stockholm_Masters-F-Michael_Stich-Goran_Ivanisevic,1,F-DTL,4,3,2,1,0,4,0
19931031-M-Stockholm_Masters-F-Michael_Stich-Goran_Ivanisevic,1,F-IO,1,0,0,0,0,1,0
19931031-M-Stockholm_Masters-F-Michael_Stich-Goran_Ivanisevic,1,B-XC,3,3,2,0,1,2,1
19931031-M-Stockholm_Masters-F-Michael_Stich-Goran_Ivanisevic,1,B-DTM,4,3,0,2,1,2,2
19931031-M-Stockholm_Masters-F-Michael_Stich-Goran_Ivanisevic,1,B-DTL,4,3,0,0,3,0,4
19931031-M-Stockholm_Masters-F-Michael_Stich-Goran_Ivanisevic,1,B-IO,2,2,0,1,1,1,1
19931031-M-Stockholm_Masters-F-Michael_Stich-Goran_Ivanisevic,1,S-XC,2,0,0,0,0,1,1
19931031-M-Stockholm_Masters-F-Michael_Stich-Goran_Ivanisevic,1,S-DTM,2,0,0,0,0,1,1
19931031-M-Stockholm_Masters-F-Michael_Stich-Goran_Ivanisevic,1,S-DTL,2,0,0,0,0,1,1
19931031-M-Stockholm_Masters-F-Michael_Stich-Goran_Ivanisevic,1,S-IO,1,1,0,0,1,0,1
19931031-M-Stockholm_Masters-F-Michael_Stich-Goran_Ivanisevic,2,F-XC,14,10,4,2,4,7,7
19931031-M-Stockholm_Masters-F-Michael_Stich-Goran_Ivanisevic,2,F-DTM,5,0,0,0,0,1,4
19931031-M-Stockholm_Masters-F-Michael_Stich-Goran_Ivanisevic,2,F-DTL,1,1,0,0,1,0,1
19931031-M-Stockholm_Masters-F-Michael_Stich-Goran_Ivanisevic,2,F-IO,6,5,3,1,1,5,1
19931031-M-Stockholm_Masters-F-Michael_Stich-Goran_Ivanisevic,2,F-II,1,0,0,0,0,0,1
19931031-M-Stockholm_Masters-F-Michael_Stich-Goran_Ivanisevic,2,B-XC,4,3,1,1,1,2,2
19931031-M-Stockholm_Masters-F-Michael_Stich-Goran_Ivanisevic,2,B-DTM,2,0,0,0,0,0,2
19931031-M-Stockholm_Masters-F-Michael_Stich-Goran_Ivanisevic,2,B-DTL,10,4,2,1,1,5,5
19931031-M-Stockholm_Masters-F-Michael_Stich-Goran_Ivanisevic,2,B-IO,1,1,0,0,1,0,1
19931031-M-Stockholm_Masters-F-Michael_Stich-Goran_Ivanisevic,2,S-XC,2,0,0,0,0,0,2
19931031-M-Stockholm_Masters-F-Michael_Stich-Goran_Ivanisevic,2,S-DTM,2,0,0,0,0,1,1
19931031-M-Stockholm_Masters-F-Michael_Stich-Goran_Ivanisevic,2,S-DTL,1,0,0,0,0,0,1
19931031-M-Stockholm_Masters-F-Michael_Stich-Goran_Ivanisevic,2,S-IO,1,0,0,0,0,1,0
20120617-M-Halle-F-Tommy_Haas-Roger_Federer,1,F-XC,35,9,1,2,6,18,17
20120617-M-Halle-F-Tommy_Haas-Roger_Federer,1,F-DTM,19,0,0,0,0,6,13
20120617-M-Halle-F-Tommy_Haas-Roger_Federer,1,F-DTL,5,1,0,0,1,2,3
20120617-M-Halle-F-Tommy_Haas-Roger_Federer,1,F-IO,13,3,1,2,0,9,4
20120617-M-Halle-F-Tommy_Haas-Roger_Federer,1,F-II,2,1,0,1,0,1,1
20120617-M-Halle-F-Tommy_Haas-Roger_Federer,1,B-XC,18,3,2,1,0,11,7
20120617-M-Halle-F-Tommy_Haas-Roger_Federer,1,B-DTM,24,2,0,2,0,14,10
20120617-M-Halle-F-Tommy_Haas-Roger_Federer,1,B-DTL,10,6,2,3,1,7,3
20120617-M-Halle-F-Tommy_Haas-Roger_Federer,1,B-IO,3,0,0,0,0,3,0
20120617-M-Halle-F-Tommy_Haas-Roger_Federer,1,S-XC,5,2,0,0,2,0,5
20120617-M-Halle-F-Tommy_Haas-Roger_Federer,1,S-DTM,4,1,0,0,1,2,2
20120617-M-Halle-F-Tommy_Haas-Roger_Federer,1,S-DTL,1,0,0,0,0,0,1
20120617-M-Halle-F-Tommy_Haas-Roger_Federer,2,F-XC,44,15,4,5,6,27,17
20120617-M-Halle-F-Tommy_Haas-Roger_Federer,2,F-DTM,23,3,0,0,3,5,18
20120617-M-Halle-F-Tommy_Haas-Roger_Federer,2,F-DTL,7,2,2,0,0,5,2
20120617-M-Halle-F-Tommy_Haas-Roger_Federer,2,F-IO,28,10,2,2,6,14,14
20120617-M-Halle-F-Tommy_Haas-Roger_Federer,2,F-II,3,0,0,0,0,2,1
20120617-M-Halle-F-Tommy_Haas-Roger_Federer,2,B-XC,17,9,4,2,3,10,7
20120617-M-Halle-F-Tommy_Haas-Roger_Federer,2,B-DTM,6,0,0,0,0,4,2
20120617-M-Halle-F-Tommy_Haas-Roger_Federer,2,B-DTL,6,3,0,2,1,3,3
20120617-M-Halle-F-Tommy_Haas-Roger_Federer,2,S-XC,8,2,0,0,2,3,5
20120617-M-Halle-F-Tommy_Haas-Roger_Federer,2,S-DTM,3,0,0,0,0,1,2
20120617-M-Halle-F-Tommy_Haas-Roger_Federer,2,S-DTL,4,0,0,0,0,1,3
19941119-M-Tour_Finals-SF-Pete_Sampras-Andre_Agassi,1,F-XC,31,7,2,2,3,15,16
19941119-M-Tour_Finals-SF-Pete_Sampras-Andre_Agassi,1,F-DTM,7,2,0,0,2,2,5
19941119-M-Tour_Finals-SF-Pete_Sampras-Andre_Agassi,1,F-DTL,20,9,6,2,1,12,8
19941119-M-Tour_Finals-SF-Pete_Sampras-Andre_Agassi,1,F-IO,13,4,3,0,1,9,4
19941119-M-Tour_Finals-SF-Pete_Sampras-Andre_Agassi,1,F-II,4,1,0,0,1,3,1
19941119-M-Tour_Finals-SF-Pete_Sampras-Andre_Agassi,1,B-XC,56,9,0,2,7,28,28
19941119-M-Tour_Finals-SF-Pete_Sampras-Andre_Agassi,1,B-DTM,20,1,0,0,1,9,11
19941119-M-Tour_Finals-SF-Pete_Sampras-Andre_Agassi,1,B-DTL,15,4,1,0,3,5,10
19941119-M-Tour_Finals-SF-Pete_Sampras-Andre_Agassi,1,B-IO,1,0,0,0,0,0,1
19941119-M-Tour_Finals-SF-Pete_Sampras-Andre_Agassi,1,S-XC,22,4,0,1,3,15,7
19941119-M-Tour_Finals-SF-Pete_Sampras-Andre_Agassi,1,S-DTM,3,0,0,0,0,1,2
19941119-M-Tour_Finals-SF-Pete_Sampras-Andre_Agassi,1,S-DTL,3,1,1,0,0,1,2
19941119-M-Tour_Finals-SF-Pete_Sampras-Andre_Agassi,2,F-XC,42,10,2,4,4,22,20
19941119-M-Tour_Finals-SF-Pete_Sampras-Andre_Agassi,2,F-DTM,17,4,1,1,2,8,9
19941119-M-Tour_Finals-SF-Pete_Sampras-Andre_Agassi,2,F-DTL,17,4,0,2,2,11,6
19941119-M-Tour_Finals-SF-Pete_Sampras-Andre_Agassi,2,F-IO,17,3,1,0,2,9,8
19941119-M-Tour_Finals-SF-Pete_Sampras-Andre_Agassi,2,F-II,2,0,0,0,0,2,0
19941119-M-Tour_Finals-SF-Pete_Sampras-Andre_Agassi,2,B-XC,80,7,1,1,5,37,43
19941119-M-Tour_Finals-SF-Pete_Sampras-Andre_Agassi,2,B-DTM,10,2,0,0,2,2,8
19941119-M-Tour_Finals-SF-Pete_Sampras-Andre_Agassi,2,B-DTL,20,11,5,3,3,11,9
19941119-M-Tour_Finals-SF-Pete_Sampras-Andre_Agassi,2,B-IO,3,1,0,1,0,2,1
19941119-M-Tour_Finals-SF-Pete_Sampras-Andre_Agassi,2,S-XC,7,1,0,0,1,3,4
19941119-M-Tour_Finals-SF-Pete_Sampras-Andre_Agassi,2,S-DTM,3,0,0,0,0,2,1
19941119-M-Tour_Finals-SF-Pete_Sampras-Andre_Agassi,2,S-DTL,1,0,0,0,0,0,1
20121028-M-Basel-F-Roger_Federer-Juan_Martin_Del_Potro,1,F-XC,32,11,3,1,7,13,19
20121028-M-Basel-F-Roger_Federer-Juan_Martin_Del_Potro,1,F-DTM,31,6,1,1,4,7,24
20121028-M-Basel-F-Roger_Federer-Juan_Martin_Del_Potro,1,F-DTL,7,0,0,0,0,5,2
20121028-M-Basel-F-Roger_Federer-Juan_Martin_Del_Potro,1,F-IO,40,14,5,3,6,21,19
20121028-M-Basel-F-Roger_Federer-Juan_Martin_Del_Potro,1,F-II,9,4,1,0,3,3,6
20121028-M-Basel-F-Roger_Federer-Juan_Martin_Del_Potro,1,B-XC,40,7,1,1,5,14,26
20121028-M-Basel-F-Roger_Federer-Juan_Martin_Del_Potro,1,B-DTM,31,5,0,1,4,7,24
20121028-M-Basel-F-Roger_Federer-Juan_Martin_Del_Potro,1,B-DTL,13,5,2,1,2,6,7
20121028-M-Basel-F-Roger_Federer-Juan_Martin_Del_Potro,1,B-IO,1,0,0,0,0,0,1
20121028-M-Basel-F-Roger_Federer-Juan_Martin_Del_Potro,1,S-XC,24,1,0,1,0,11,13
20121028-M-Basel-F-Roger_Federer-Juan_Martin_Del_Potro,1,S-DTM,8,0,0,0,0,2,6
20121028-M-Basel-F-Roger_Federer-Juan_Martin_Del_Potro,1,S-DTL,3,0,0,0,0,0,3
20121028-M-Basel-F-Roger_Federer-Juan_Martin_Del_Potro,2,F-XC,40,18,8,7,3,30,10
20121028-M-Basel-F-Roger_Federer-Juan_Martin_Del_Potro,2,F-DTM,29,2,0,0,2,18,11
20121028-M-Basel-F-Roger_Federer-Juan_Martin_Del_Potro,2,F-DTL,11,5,2,1,2,8,3
20121028-M-Basel-F-Roger_Federer-Juan_Martin_Del_Potro,2,F-IO,43,9,6,1,2,31,12
20121028-M-Basel-F-Roger_Federer-Juan_Martin_Del_Potro,2,F-II,6,4,2,0,2,4,2
20121028-M-Basel-F-Roger_Federer-Juan_Martin_Del_Potro,2,B-XC,75,3,0,2,1,49,26
20121028-M-Basel-F-Roger_Federer-Juan_Martin_Del_Potro,2,B-DTM,23,1,0,0,1,15,8
20121028-M-Basel-F-Roger_Federer-Juan_Martin_Del_Potro,2,B-DTL,7,4,2,0,2,2,5
20121028-M-Basel-F-Roger_Federer-Juan_Martin_Del_Potro,2,B-IO,2,1,0,0,1,1,1
20121028-M-Basel-F-Roger_Federer-Juan_Martin_Del_Potro,2,S-XC,11,2,1,0,1,6,5
20121028-M-Basel-F-Roger_Federer-Juan_Martin_Del_Potro,2,S-DTM,4,0,0,0,0,2,2
20121028-M-Basel-F-Roger_Federer-Juan_Martin_Del_Potro,2,S-DTL,2,1,0,0,1,0,2
19921101-M-Stockholm_Masters-F-Guy_Forget-Goran_Ivanisevic,1,F-XC,33,10,3,6,1,22,11
19921101-M-Stockholm_Masters-F-Guy_Forget-Goran_Ivanisevic,1,F-DTM,29,4,0,1,3,14,15
19921101-M-Stockholm_Masters-F-Guy_Forget-Goran_Ivanisevic,1,F-DTL,5,1,0,0,1,2,3
19921101-M-Stockholm_Masters-F-Guy_Forget-Goran_Ivanisevic,1,F-IO,21,2,1,1,0,11,10
19921101-M-Stockholm_Masters-F-Guy_Forget-Goran_Ivanisevic,1,F-II,4,0,0,0,0,3,1
19921101-M-Stockholm_Masters-F-Guy_Forget-Goran_Ivanisevic,1,B-XC,20,6,3,0,3,11,9
19921101-M-Stockholm_Masters-F-Guy_Forget-Goran_Ivanisevic,1,B-DTM,11,1,0,0,1,6,5
19921101-M-Stockholm_Masters-F-Guy_Forget-Goran_Ivanisevic,1,B-DTL,7,4,1,0,3,1,6
19921101-M-Stockholm_Masters-F-Guy_Forget-Goran_Ivanisevic,1,B-IO,1,0,0,0,0,0,1
19921101-M-Stockholm_Masters-F-Guy_Forget-Goran_Ivanisevic,1,S-XC,34,2,1,0,1,12,22
19921101-M-Stockholm_Masters-F-Guy_Forget-Goran_Ivanisevic,1,S-DTM,23,3,0,0,3,9,14
19921101-M-Stockholm_Masters-F-Guy_Forget-Goran_Ivanisevic,1,S-DTL,12,2,0,1,1,5,7
19921101-M-Stockholm_Masters-F-Guy_Forget-Goran_Ivanisevic,1,S-IO,3,0,0,0,0,1,2
19921101-M-Stockholm_Masters-F-Guy_Forget-Goran_Ivanisevic,2,F-XC,25,9,3,1,5,12,13
19921101-M-Stockholm_Masters-F-Guy_Forget-Goran_Ivanisevic,2,F-DTM,32,3,0,0,3,14,18
19921101-M-Stockholm_Masters-F-Guy_Forget-Goran_Ivanisevic,2,F-DTL,11,1,1,0,0,5,6
19921101-M-Stockholm_Masters-F-Guy_Forget-Goran_Ivanisevic,2,F-IO,21,6,2,2,2,15,6
19921101-M-Stockholm_Masters-F-Guy_Forget-Goran_Ivanisevic,2,B-XC,18,5,2,2,1,12,6
19921101-M-Stockholm_Masters-F-Guy_Forget-Goran_Ivanisevic,2,B-DTM,20,0,0,0,0,8,12
19921101-M-Stockholm_Masters-F-Guy_Forget-Goran_Ivanisevic,2,B-DTL,5,5,1,1,3,2,3
19921101-M-Stockholm_Masters-F-Guy_Forget-Goran_Ivanisevic,2,B-IO,3,2,2,0,0,2,1
19921101-M-Stockholm_Masters-F-Guy_Forget-Goran_Ivanisevic,2,S-XC,26,4,0,0,4,13,13
19921101-M-Stockholm_Masters-F-Guy_Forget-Goran_Ivanisevic,2,S-DTM,16,4,0,0,4,8,8
19921101-M-Stockholm_Masters-F-Guy_Forget-Goran_Ivanisevic,2,S-DTL,2,1,0,0,1,0,2
19921101-M-Stockholm_Masters-F-Guy_Forget-Goran_Ivanisevic,2,S-IO,2,0,0,0,0,1,1
20180501-M-Munich-R32-Ivo_Karlovic-Philipp_Kohlschreiber,1,F-XC,10,4,1,2,1,8,2
20180501-M-Munich-R32-Ivo_Karlovic-Philipp_Kohlschreiber,1,F-DTM,3,2,0,0,2,1,2
20180501-M-Munich-R32-Ivo_Karlovic-Philipp_Kohlschreiber,1,F-DTL,1,0,0,0,0,0,1
20180501-M-Munich-R32-Ivo_Karlovic-Philipp_Kohlschreiber,1,F-IO,5,3,3,0,0,4,1
20180501-M-Munich-R32-Ivo_Karlovic-Philipp_Kohlschreiber,1,S-XC,5,1,0,0,1,2,3
20180501-M-Munich-R32-Ivo_Karlovic-Philipp_Kohlschreiber,1,S-DTM,5,2,0,0,2,1,4
20180501-M-Munich-R32-Ivo_Karlovic-Philipp_Kohlschreiber,1,S-DTL,2,2,0,1,1,1,1
20180501-M-Munich-R32-Ivo_Karlovic-Philipp_Kohlschreiber,2,F-XC,20,11,7,1,3,14,6
20180501-M-Munich-R32-Ivo_Karlovic-Philipp_Kohlschreiber,2,F-DTM,5,0,0,0,0,0,5
20180501-M-Munich-R32-Ivo_Karlovic-Philipp_Kohlschreiber,2,F-DTL,7,4,4,0,0,5,2
20180501-M-Munich-R32-Ivo_Karlovic-Philipp_Kohlschreiber,2,F-IO,11,5,3,2,0,8,3
20180501-M-Munich-R32-Ivo_Karlovic-Philipp_Kohlschreiber,2,F-II,1,1,0,0,1,0,1
20180501-M-Munich-R32-Ivo_Karlovic-Philipp_Kohlschreiber,2,B-XC,2,0,0,0,0,2,0
20180501-M-Munich-R32-Ivo_Karlovic-Philipp_Kohlschreiber,2,B-DTM,1,0,0,0,0,0,1
20180501-M-Munich-R32-Ivo_Karlovic-Philipp_Kohlschreiber,2,B-DTL,2,1,1,0,0,2,0
20180501-M-Munich-R32-Ivo_Karlovic-Philipp_Kohlschreiber,2,B-IO,2,2,0,0,2,0,2
20180501-M-Munich-R32-Ivo_Karlovic-Philipp_Kohlschreiber,2,S-XC,2,0,0,0,0,0,2
20180501-M-Munich-R32-Ivo_Karlovic-Philipp_Kohlschreiber,2,S-DTL,1,0,0,0,0,0,1
20180501-M-Munich-R32-Ivo_Karlovic-Philipp_Kohlschreiber,2,S-IO,1,0,0,0,0,1,0
20180503-M-Munich-R16-Mischa_Zverev-Philipp_Kohlschreiber,1,F-XC,22,7,3,1,3,10,12
20180503-M-Munich-R16-Mischa_Zverev-Philipp_Kohlschreiber,1,F-DTM,14,2,0,0,2,4,10
20180503-M-Munich-R16-Mischa_Zverev-Philipp_Kohlschreiber,1,F-DTL,6,4,2,2,0,6,0
20180503-M-Munich-R16-Mischa_Zverev-Philipp_Kohlschreiber,1,F-IO,8,4,3,0,1,4,4
20180503-M-Munich-R16-Mischa_Zverev-Philipp_Kohlschreiber,1,B-XC,24,4,0,2,2,7,17
20180503-M-Munich-R16-Mischa_Zverev-Philipp_Kohlschreiber,1,B-DTM,20,4,0,0,4,6,14
20180503-M-Munich-R16-Mischa_Zverev-Philipp_Kohlschreiber,1,B-DTL,7,3,1,1,1,3,4
20180503-M-Munich-R16-Mischa_Zverev-Philipp_Kohlschreiber,1,B-IO,8,3,1,0,2,2,6
20180503-M-Munich-R16-Mischa_Zverev-Philipp_Kohlschreiber,1,B-II,1,1,0,0,1,0,1
20180503-M-Munich-R16-Mischa_Zverev-Philipp_Kohlschreiber,1,S-XC,3,1,0,1,0,2,1
20180503-M-Munich-R16-Mischa_Zverev-Philipp_Kohlschreiber,1,S-DTM,3,1,0,1,0,1,2
20180503-M-Munich-R16-Mischa_Zverev-Philipp_Kohlschreiber,1,S-DTL,2,0,0,0,0,0,2
20180503-M-Munich-R16-Mischa_Zverev-Philipp_Kohlschreiber,1,S-IO,2,0,0,0,0,0,2
20180503-M-Munich-R16-Mischa_Zverev-Philipp_Kohlschreiber,2,F-XC,31,7,4,1,2,20,11
20180503-M-Munich-R16-Mischa_Zverev-Philipp_Kohlschreiber,2,F-DTM,12,0,0,0,0,7,5
20180503-M-Munich-R16-Mischa_Zverev-Philipp_Kohlschreiber,2,F-DTL,15,8,5,1,2,11,4
20180503-M-Munich-R16-Mischa_Zverev-Philipp_Kohlschreiber,2,F-IO,12,6,5,1,0,11,1
20180503-M-Munich-R16-Mischa_Zverev-Philipp_Kohlschreiber,2,F-II,3,0,0,0,0,3,0
20180503-M-Munich-R16-Mischa_Zverev-Philipp_Kohlschreiber,2,B-XC,16,5,1,2,2,9,7
20180503-M-Munich-R16-Mischa_Zverev-Philipp_Kohlschreiber,2,B-DTM,10,2,1,0,1,8,2
20180503-M-Munich-R16-Mischa_Zverev-Philipp_Kohlschreiber,2,B-DTL,5,3,2,1,0,5,0
20180503-M-Munich-R16-Mischa_Zverev-Philipp_Kohlschreiber,2,B-IO,1,0,0,0,0,1,0
20180503-M-Munich-R16-Mischa_Zverev-Philipp_Kohlschreiber,2,B-II,1,0,0,0,0,0,1
20180503-M-Munich-R16-Mischa_Zverev-Philipp_Kohlschreiber,2,S-XC,4,0,0,0,0,1,3
20180503-M-Munich-R16-Mischa_Zverev-Philipp_Kohlschreiber,2,S-DTM,1,0,0,0,0,0,1
20180503-M-Munich-R16-Mischa_Zverev-Philipp_Kohlschreiber,2,S-DTL,2,0,0,0,0,2,0
20180506-M-Munich-F-Philipp_Kohlschreiber-Alexander_Zverev,1,F-XC,35,8,2,2,4,18,17
20180506-M-Munich-F-Philipp_Kohlschreiber-Alexander_Zverev,1,F-DTM,12,1,0,0,1,6,6
20180506-M-Munich-F-Philipp_Kohlschreiber-Alexander_Zverev,1,F-DTL,12,4,3,0,1,7,5
20180506-M-Munich-F-Philipp_Kohlschreiber-Alexander_Zverev,1,F-IO,22,2,1,0,1,10,12
20180506-M-Munich-F-Philipp_Kohlschreiber-Alexander_Zverev,1,F-II,2,1,1,0,0,2,0
20180506-M-Munich-F-Philipp_Kohlschreiber-Alexander_Zverev,1,B-XC,29,3,0,1,2,12,17
20180506-M-Munich-F-Philipp_Kohlschreiber-Alexander_Zverev,1,B-DTM,12,2,0,0,2,3,9
20180506-M-Munich-F-Philipp_Kohlschreiber-Alexander_Zverev,1,B-DTL,3,1,0,0,1,2,1
20180506-M-Munich-F-Philipp_Kohlschreiber-Alexander_Zverev,1,B-IO,2,1,1,0,0,1,1
20180506-M-Munich-F-Philipp_Kohlschreiber-Alexander_Zverev,1,S-XC,4,0,0,0,0,3,1
20180506-M-Munich-F-Philipp_Kohlschreiber-Alexander_Zverev,1,S-DTM,2,0,0,0,0,1,1
20180506-M-Munich-F-Philipp_Kohlschreiber-Alexander_Zverev,2,F-XC,26,6,2,1,3,12,14
20180506-M-Munich-F-Philipp_Kohlschreiber-Alexander_Zverev,2,F-DTM,11,1,0,0,1,7,4
20180506-M-Munich-F-Philipp_Kohlschreiber-Alexander_Zverev,2,F-DTL,14,3,1,1,1,7,7
20180506-M-Munich-F-Philipp_Kohlschreiber-Alexander_Zverev,2,F-IO,8,2,1,1,0,5,3
20180506-M-Munich-F-Philipp_Kohlschreiber-Alexander_Zverev,2,F-II,1,1,1,0,0,1,0
20180506-M-Munich-F-Philipp_Kohlschreiber-Alexander_Zverev,2,B-XC,36,4,1,1,2,19,17
20180506-M-Munich-F-Philipp_Kohlschreiber-Alexander_Zverev,2,B-DTM,16,4,1,1,2,11,5
20180506-M-Munich-F-Philipp_Kohlschreiber-Alexander_Zverev,2,B-DTL,11,6,3,1,2,5,6
20180506-M-Munich-F-Philipp_Kohlschreiber-Alexander_Zverev,2,B-IO,2,1,1,0,0,2,0
20180506-M-Munich-F-Philipp_Kohlschreiber-Alexander_Zverev,2,S-XC,4,0,0,0,0,1,3
20180506-M-Munich-F-Philipp_Kohlschreiber-Alexander_Zverev,2,S-DTL,2,0,0,0,0,0,2
20180506-M-Munich-F-Philipp_Kohlschreiber-Alexander_Zverev,2,S-IO,1,0,0,0,0,0,1
20100613-M-Halle-F-Roger_Federer-Lleyton_Hewitt,1,F-XC,57,19,4,6,9,30,27
20100613-M-Halle-F-Roger_Federer-Lleyton_Hewitt,1,F-DTM,38,4,0,0,4,14,24
20100613-M-Halle-F-Roger_Federer-Lleyton_Hewitt,1,F-DTL,21,10,1,3,6,10,11
20100613-M-Halle-F-Roger_Federer-Lleyton_Hewitt,1,F-IO,38,13,2,4,7,16,22
20100613-M-Halle-F-Roger_Federer-Lleyton_Hewitt,1,F-II,9,3,0,3,0,6,3
20100613-M-Halle-F-Roger_Federer-Lleyton_Hewitt,1,B-XC,44,7,1,3,3,21,23
20100613-M-Halle-F-Roger_Federer-Lleyton_Hewitt,1,B-DTM,25,2,0,1,1,9,16
20100613-M-Halle-F-Roger_Federer-Lleyton_Hewitt,1,B-DTL,16,12,3,3,6,9,7
20100613-M-Halle-F-Roger_Federer-Lleyton_Hewitt,1,B-IO,1,0,0,0,0,0,1
20100613-M-Halle-F-Roger_Federer-Lleyton_Hewitt,1,S-XC,34,3,0,0,3,12,22
20100613-M-Halle-F-Roger_Federer-Lleyton_Hewitt,1,S-DTM,24,0,0,0,0,8,16
20100613-M-Halle-F-Roger_Federer-Lleyton_Hewitt,1,S-DTL,9,0,0,0,0,2,7
20100613-M-Halle-F-Roger_Federer-Lleyton_Hewitt,1,S-IO,1,0,0,0,0,1,0
20100613-M-Halle-F-Roger_Federer-Lleyton_Hewitt,2,F-XC,61,11,3,5,3,35,26
20100613-M-Halle-F-Roger_Federer-Lleyton_Hewitt,2,F-DTM,23,3,0,1,2,12,11
20100613-M-Halle-F-Roger_Federer-Lleyton_Hewitt,2,F-DTL,24,9,4,2,3,11,13
20100613-M-Halle-F-Roger_Federer-Lleyton_Hewitt,2,F-IO,44,12,4,2,6,28,16
20100613-M-Halle-F-Roger_Federer-Lleyton_Hewitt,2,F-II,2,1,1,0,0,2,0
20100613-M-Halle-F-Roger_Federer-Lleyton_Hewitt,2,B-XC,74,6,1,3,2,46,28
20100613-M-Halle-F-Roger_Federer-Lleyton_Hewitt,2,B-DTM,29,2,0,0,2,16,13
20100613-M-Halle-F-Roger_Federer-Lleyton_Hewitt,2,B-DTL,10,2,0,1,1,5,5
20100613-M-Halle-F-Roger_Federer-Lleyton_Hewitt,2,B-IO,12,2,0,1,1,6,6
20100613-M-Halle-F-Roger_Federer-Lleyton_Hewitt,2,S-XC,19,1,1,0,0,11,8
20100613-M-Halle-F-Roger_Federer-Lleyton_Hewitt,2,S-DTM,5,0,0,0,0,4,1
20100613-M-Halle-F-Roger_Federer-Lleyton_Hewitt,2,S-DTL,2,0,0,0,0,1,1
20100613-M-Halle-F-Roger_Federer-Lleyton_Hewitt,2,S-IO,2,0,0,0,0,1,1
20180505-M-Munich-SF-Maximilian_Marterer-Philipp_Kohlschreiber,1,F-XC,27,7,1,3,3,12,15
20180505-M-Munich-SF-Maximilian_Marterer-Philipp_Kohlschreiber,1,F-DTM,7,1,0,0,1,4,3
20180505-M-Munich-SF-Maximilian_Marterer-Philipp_Kohlschreiber,1,F-DTL,3,1,0,0,1,1,2
20180505-M-Munich-SF-Maximilian_Marterer-Philipp_Kohlschreiber,1,F-IO,11,5,2,1,2,6,5
20180505-M-Munich-SF-Maximilian_Marterer-Philipp_Kohlschreiber,1,F-II,7,2,1,1,0,6,1
20180505-M-Munich-SF-Maximilian_Marterer-Philipp_Kohlschreiber,1,B-XC,37,4,0,0,4,16,21
20180505-M-Munich-SF-Maximilian_Marterer-Philipp_Kohlschreiber,1,B-DTM,13,2,0,0,2,3,10
20180505-M-Munich-SF-Maximilian_Marterer-Philipp_Kohlschreiber,1,B-DTL,7,4,0,0,4,2,5
20180505-M-Munich-SF-Maximilian_Marterer-Philipp_Kohlschreiber,1,B-IO,1,0,0,0,0,1,0
20180505-M-Munich-SF-Maximilian_Marterer-Philipp_Kohlschreiber,1,S-XC,1,0,0,0,0,0,1
20180505-M-Munich-SF-Maximilian_Marterer-Philipp_Kohlschreiber,1,S-DTM,1,0,0,0,0,1,0
20180505-M-Munich-SF-Maximilian_Marterer-Philipp_Kohlschreiber,1,S-DTL,4,0,0,0,0,2,2
20180505-M-Munich-SF-Maximilian_Marterer-Philipp_Kohlschreiber,2,F-XC,44,5,0,3,2,26,18
20180505-M-Munich-SF-Maximilian_Marterer-Philipp_Kohlschreiber,2,F-DTM,10,1,0,0,1,6,4
20180505-M-Munich-SF-Maximilian_Marterer-Philipp_Kohlschreiber,2,F-DTL,11,5,4,0,1,6,5
20180505-M-Munich-SF-Maximilian_Marterer-Philipp_Kohlschreiber,2,F-IO,10,5,3,0,2,8,2
20180505-M-Munich-SF-Maximilian_Marterer-Philipp_Kohlschreiber,2,F-II,3,1,0,0,1,2,1
20180505-M-Munich-SF-Maximilian_Marterer-Philipp_Kohlschreiber,2,B-XC,13,4,2,0,2,7,6
20180505-M-Munich-SF-Maximilian_Marterer-Philipp_Kohlschreiber,2,B-DTM,11,1,0,0,1,3,8
20180505-M-Munich-SF-Maximilian_Marterer-Philipp_Kohlschreiber,2,B-DTL,7,2,1,0,1,6,1
20180505-M-Munich-SF-Maximilian_Marterer-Philipp_Kohlschreiber,2,B-IO,1,0,0,0,0,0,1
20180505-M-Munich-SF-Maximilian_Marterer-Philipp_Kohlschreiber,2,S-XC,1,0,0,0,0,1,0
20180505-M-Munich-SF-Maximilian_Marterer-Philipp_Kohlschreiber,2,S-DTM,2,0,0,0,0,1,1
20180505-M-Munich-SF-Maximilian_Marterer-Philipp_Kohlschreiber,2,S-DTL,6,0,0,0,0,2,4
20180504-M-Munich-QF-Roberto_Bautista_Agut-Philipp_Kohlschreiber,1,F-XC,25,5,1,1,3,8,17
20180504-M-Munich-QF-Roberto_Bautista_Agut-Philipp_Kohlschreiber,1,F-DTM,16,0,0,0,0,7,9
20180504-M-Munich-QF-Roberto_Bautista_Agut-Philipp_Kohlschreiber,1,F-DTL,11,1,1,0,0,4,7
20180504-M-Munich-QF-Roberto_Bautista_Agut-Philipp_Kohlschreiber,1,F-IO,26,6,2,4,0,15,11
20180504-M-Munich-QF-Roberto_Bautista_Agut-Philipp_Kohlschreiber,1,F-II,6,5,2,0,3,3,3
20180504-M-Munich-QF-Roberto_Bautista_Agut-Philipp_Kohlschreiber,1,B-XC,38,7,2,1,4,13,25
20180504-M-Munich-QF-Roberto_Bautista_Agut-Philipp_Kohlschreiber,1,B-DTM,23,1,0,0,1,11,12
20180504-M-Munich-QF-Roberto_Bautista_Agut-Philipp_Kohlschreiber,1,B-DTL,6,1,0,0,1,2,4
20180504-M-Munich-QF-Roberto_Bautista_Agut-Philipp_Kohlschreiber,1,S-XC,9,1,0,1,0,3,6
20180504-M-Munich-QF-Roberto_Bautista_Agut-Philipp_Kohlschreiber,1,S-DTM,2,0,0,0,0,0,2
20180504-M-Munich-QF-Roberto_Bautista_Agut-Philipp_Kohlschreiber,2,F-XC,32,14,5,4,5,20,12
20180504-M-Munich-QF-Roberto_Bautista_Agut-Philipp_Kohlschreiber,2,F-DTM,13,0,0,0,0,8,5
20180504-M-Munich-QF-Roberto_Bautista_Agut-Philipp_Kohlschreiber,2,F-DTL,16,1,1,0,0,12,4
20180504-M-Munich-QF-Roberto_Bautista_Agut-Philipp_Kohlschreiber,2,F-IO,42,8,4,3,1,28,14
20180504-M-Munich-QF-Roberto_Bautista_Agut-Philipp_Kohlschreiber,2,F-II,7,1,0,0,1,4,3
20180504-M-Munich-QF-Roberto_Bautista_Agut-Philipp_Kohlschreiber,2,B-XC,25,4,0,1,3,13,12
20180504-M-Munich-QF-Roberto_Bautista_Agut-Philipp_Kohlschreiber,2,B-DTM,12,1,1,0,0,6,6
20180504-M-Munich-QF-Roberto_Bautista_Agut-Philipp_Kohlschreiber,2,B-DTL,3,1,1,0,0,2,1
20180504-M-Munich-QF-Roberto_Bautista_Agut-Philipp_Kohlschreiber,2,B-IO,3,0,0,0,0,3,0
20180504-M-Munich-QF-Roberto_Bautista_Agut-Philipp_Kohlschreiber,2,S-XC,12,0,0,0,0,9,3
20180504-M-Munich-QF-Roberto_Bautista_Agut-Philipp_Kohlschreiber,2,S-DTM,3,0,0,0,0,2,1
20180504-M-Munich-QF-Roberto_Bautista_Agut-Philipp_Kohlschreiber,2,S-DTL,1,0,0,0,0,0,1
20030504-M-Munich-F-Roger_Federer-Jarkko_Nieminen,1,F-XC,52,7,4,2,1,32,20
20030504-M-Munich-F-Roger_Federer-Jarkko_Nieminen,1,F-DTM,14,0,0,0,0,7,7
20030504-M-Munich-F-Roger_Federer-Jarkko_Nieminen,1,F-DTL,15,5,4,1,0,12,3
20030504-M-Munich-F-Roger_Federer-Jarkko_Nieminen,1,F-IO,24,9,6,0,3,15,9
20030504-M-Munich-F-Roger_Federer-Jarkko_Nieminen,1,F-II,8,1,0,0,1,6,2
20030504-M-Munich-F-Roger_Federer-Jarkko_Nieminen,1,B-XC,8,0,0,0,0,4,4
20030504-M-Munich-F-Roger_Federer-Jarkko_Nieminen,1,B-DTM,9,2,0,0,2,7,2
20030504-M-Munich-F-Roger_Federer-Jarkko_Nieminen,1,B-DTL,5,0,0,0,0,5,0
20030504-M-Munich-F-Roger_Federer-Jarkko_Nieminen,1,S-XC,1,0,0,0,0,0,1
20030504-M-Munich-F-Roger_Federer-Jarkko_Nieminen,1,S-DTM,5,0,0,0,0,2,3
20030504-M-Munich-F-Roger_Federer-Jarkko_Nieminen,1,S-DTL,2,0,0,0,0,0,2
20030504-M-Munich-F-Roger_Federer-Jarkko_Nieminen,2,F-XC,29,4,1,1,2,11,18
20030504-M-Munich-F-Roger_Federer-Jarkko_Nieminen,2,F-DTM,17,0,0,0,0,4,13
20030504-M-Munich-F-Roger_Federer-Jarkko_Nieminen,2,F-DTL,8,1,1,0,0,5,3
20030504-M-Munich-F-Roger_Federer-Jarkko_Nieminen,2,F-IO,11,5,0,3,2,5,6
20030504-M-Munich-F-Roger_Federer-Jarkko_Nieminen,2,F-II,2,0,0,0,0,2,0
20030504-M-Munich-F-Roger_Federer-Jarkko_Nieminen,2,B-XC,16,4,1,0,3,4,12
20030504-M-Munich-F-Roger_Federer-Jarkko_Nieminen,2,B-DTM,41,6,1,2,3,17,24
20030504-M-Munich-F-Roger_Federer-Jarkko_Nieminen,2,B-DTL,16,5,2,0,3,4,12
20030504-M-Munich-F-Roger_Federer-Jarkko_Nieminen,2,B-IO,4,0,0,0,0,2,2
20030504-M-Munich-F-Roger_Federer-Jarkko_Nieminen,2,S-XC,1,0,0,0,0,0,1
20030504-M-Munich-F-Roger_Federer-Jarkko_Nieminen,2,S-DTM,3,0,0,0,0,2,1
20030504-M-Munich-F-Roger_Federer-Jarkko_Nieminen,2,S-DTL,1,0,0,0,0,0,1
20030504-M-Munich-F-Roger_Federer-Jarkko_Nieminen,2,S-IO,1,0,0,0,0,1,0
20020203-M-Milan-F-Roger_Federer-Davide_Sanguinetti,1,F-XC,47,15,6,7,2,24,23
20020203-M-Milan-F-Roger_Federer-Davide_Sanguinetti,1,F-DTM,21,5,0,1,4,9,12
20020203-M-Milan-F-Roger_Federer-Davide_Sanguinetti,1,F-DTL,19,5,0,3,2,10,9
20020203-M-Milan-F-Roger_Federer-Davide_Sanguinetti,1,F-IO,28,7,3,2,2,14,14
20020203-M-Milan-F-Roger_Federer-Davide_Sanguinetti,1,F-II,2,0,0,0,0,1,1
20020203-M-Milan-F-Roger_Federer-Davide_Sanguinetti,1,B-XC,39,7,3,2,2,24,15
20020203-M-Milan-F-Roger_Federer-Davide_Sanguinetti,1,B-DTM,36,7,0,0,7,15,21
20020203-M-Milan-F-Roger_Federer-Davide_Sanguinetti,1,B-DTL,18,6,3,0,3,9,9
20020203-M-Milan-F-Roger_Federer-Davide_Sanguinetti,1,B-IO,2,0,0,0,0,1,1
20020203-M-Milan-F-Roger_Federer-Davide_Sanguinetti,1,S-XC,7,1,0,0,1,2,5
20020203-M-Milan-F-Roger_Federer-Davide_Sanguinetti,1,S-DTM,7,0,0,0,0,3,4
20020203-M-Milan-F-Roger_Federer-Davide_Sanguinetti,1,S-DTL,6,0,0,0,0,1,5
20020203-M-Milan-F-Roger_Federer-Davide_Sanguinetti,2,F-XC,48,10,5,3,2,25,23
20020203-M-Milan-F-Roger_Federer-Davide_Sanguinetti,2,F-DTM,26,1,0,0,1,14,12
20020203-M-Milan-F-Roger_Federer-Davide_Sanguinetti,2,F-DTL,13,6,2,2,2,9,4
20020203-M-Milan-F-Roger_Federer-Davide_Sanguinetti,2,F-IO,14,3,0,1,2,6,8
20020203-M-Milan-F-Roger_Federer-Davide_Sanguinetti,2,F-II,4,1,0,0,1,2,2
20020203-M-Milan-F-Roger_Federer-Davide_Sanguinetti,2,B-XC,89,20,6,6,8,47,42
20020203-M-Milan-F-Roger_Federer-Davide_Sanguinetti,2,B-DTM,15,0,0,0,0,8,7
20020203-M-Milan-F-Roger_Federer-Davide_Sanguinetti,2,B-DTL,5,1,1,0,0,4,1
20020203-M-Milan-F-Roger_Federer-Davide_Sanguinetti,2,B-IO,4,2,1,0,1,2,2
20020203-M-Milan-F-Roger_Federer-Davide_Sanguinetti,2,S-DTM,5,0,0,0,0,1,4
20020203-M-Milan-F-Roger_Federer-Davide_Sanguinetti,2,S-DTL,3,0,0,0,0,2,1
19930801-M-Canada_Masters-F-Todd_Martin-Mikael_Pernfors,1,F-XC,38,10,3,4,3,17,21
19930801-M-Canada_Masters-F-Todd_Martin-Mikael_Pernfors,1,F-DTM,18,2,1,0,1,6,12
19930801-M-Canada_Masters-F-Todd_Martin-Mikael_Pernfors,1,F-DTL,6,2,0,0,2,2,4
19930801-M-Canada_Masters-F-Todd_Martin-Mikael_Pernfors,1,F-IO,15,8,3,1,4,7,8
19930801-M-Canada_Masters-F-Todd_Martin-Mikael_Pernfors,1,F-II,1,1,0,1,0,1,0
19930801-M-Canada_Masters-F-Todd_Martin-Mikael_Pernfors,1,B-XC,51,9,0,3,6,19,32
19930801-M-Canada_Masters-F-Todd_Martin-Mikael_Pernfors,1,B-DTM,15,0,0,0,0,6,9
19930801-M-Canada_Masters-F-Todd_Martin-Mikael_Pernfors,1,B-DTL,13,7,2,1,4,5,8
19930801-M-Canada_Masters-F-Todd_Martin-Mikael_Pernfors,1,B-IO,6,2,0,1,1,4,2
19930801-M-Canada_Masters-F-Todd_Martin-Mikael_Pernfors,1,S-XC,10,2,0,1,1,3,7
19930801-M-Canada_Masters-F-Todd_Martin-Mikael_Pernfors,1,S-DTM,4,1,0,0,1,1,3
19930801-M-Canada_Masters-F-Todd_Martin-Mikael_Pernfors,1,S-DTL,5,2,0,2,0,4,1
19930801-M-Canada_Masters-F-Todd_Martin-Mikael_Pernfors,2,F-XC,22,8,0,5,3,15,7
19930801-M-Canada_Masters-F-Todd_Martin-Mikael_Pernfors,2,F-DTM,29,0,0,0,0,13,16
19930801-M-Canada_Masters-F-Todd_Martin-Mikael_Pernfors,2,F-DTL,21,9,6,1,2,12,9
19930801-M-Canada_Masters-F-Todd_Martin-Mikael_Pernfors,2,F-IO,40,7,1,2,4,25,15
19930801-M-Canada_Masters-F-Todd_Martin-Mikael_Pernfors,2,F-II,7,0,0,0,0,4,3
19930801-M-Canada_Masters-F-Todd_Martin-Mikael_Pernfors,2,B-XC,15,1,0,0,1,11,4
19930801-M-Canada_Masters-F-Todd_Martin-Mikael_Pernfors,2,B-DTM,12,0,0,0,0,6,6
19930801-M-Canada_Masters-F-Todd_Martin-Mikael_Pernfors,2,B-DTL,5,4,2,2,0,5,0
19930801-M-Canada_Masters-F-Todd_Martin-Mikael_Pernfors,2,B-IO,1,1,1,0,0,1,0
19930801-M-Canada_Masters-F-Todd_Martin-Mikael_Pernfors,2,S-XC,15,1,0,0,1,5,10
19930801-M-Canada_Masters-F-Todd_Martin-Mikael_Pernfors,2,S-DTM,7,1,0,1,0,4,3
19930801-M-Canada_Masters-F-Todd_Martin-Mikael_Pernfors,2,S-DTL,1,0,0,0,0,0,1
20180412-M-Marrakech-R16-Joao_Sousa-Mirza_Basic,1,F-XC,69,23,4,11,8,38,31
20180412-M-Marrakech-R16-Joao_Sousa-Mirza_Basic,1,F-DTM,20,1,0,0,1,9,11
20180412-M-Marrakech-R16-Joao_Sousa-Mirza_Basic,1,F-DTL,26,4,0,1,3,10,16
20180412-M-Marrakech-R16-Joao_Sousa-Mirza_Basic,1,F-IO,49,16,2,8,6,30,19
20180412-M-Marrakech-R16-Joao_Sousa-Mirza_Basic,1,F-II,18,6,3,1,2,8,10
20180412-M-Marrakech-R16-Joao_Sousa-Mirza_Basic,1,B-XC,24,4,1,1,2,11,13
20180412-M-Marrakech-R16-Joao_Sousa-Mirza_Basic,1,B-DTM,17,0,0,0,0,9,8
20180412-M-Marrakech-R16-Joao_Sousa-Mirza_Basic,1,B-DTL,9,1,0,0,1,3,6
20180412-M-Marrakech-R16-Joao_Sousa-Mirza_Basic,1,S-XC,3,1,0,0,1,1,2
20180412-M-Marrakech-R16-Joao_Sousa-Mirza_Basic,1,S-DTM,6,1,0,1,0,2,4
20180412-M-Marrakech-R16-Joao_Sousa-Mirza_Basic,1,S-DTL,6,0,0,0,0,2,4
20180412-M-Marrakech-R16-Joao_Sousa-Mirza_Basic,2,F-XC,61,12,1,5,6,35,26
20180412-M-Marrakech-R16-Joao_Sousa-Mirza_Basic,2,F-DTM,17,0,0,0,0,3,14
20180412-M-Marrakech-R16-Joao_Sousa-Mirza_Basic,2,F-DTL,22,5,2,1,2,12,10
20180412-M-Marrakech-R16-Joao_Sousa-Mirza_Basic,2,F-IO,33,2,0,2,0,20,13
20180412-M-Marrakech-R16-Joao_Sousa-Mirza_Basic,2,F-II,3,1,0,0,1,1,2
20180412-M-Marrakech-R16-Joao_Sousa-Mirza_Basic,2,B-XC,36,4,0,0,4,17,19
20180412-M-Marrakech-R16-Joao_Sousa-Mirza_Basic,2,B-DTM,9,1,0,1,0,4,5
20180412-M-Marrakech-R16-Joao_Sousa-Mirza_Basic,2,B-DTL,12,5,2,1,2,6,6
20180412-M-Marrakech-R16-Joao_Sousa-Mirza_Basic,2,B-IO,3,0,0,0,0,2,1
20180412-M-Marrakech-R16-Joao_Sousa-Mirza_Basic,2,S-XC,17,1,0,0,1,9,8
20180412-M-Marrakech-R16-Joao_Sousa-Mirza_Basic,2,S-DTM,9,0,0,0,0,3,6
20180412-M-Marrakech-R16-Joao_Sousa-Mirza_Basic,2,S-DTL,7,1,0,1,0,5,2
20021013-M-Vienna-F-Roger_Federer-Jiri_Novak,1,F-XC,52,9,6,1,2,36,16
20021013-M-Vienna-F-Roger_Federer-Jiri_Novak,1,F-DTM,22,0,0,0,0,10,12
20021013-M-Vienna-F-Roger_Federer-Jiri_Novak,1,F-DTL,27,11,6,1,4,20,7
20021013-M-Vienna-F-Roger_Federer-Jiri_Novak,1,F-IO,21,7,3,3,1,15,6
20021013-M-Vienna-F-Roger_Federer-Jiri_Novak,1,F-II,5,3,0,2,1,4,1
20021013-M-Vienna-F-Roger_Federer-Jiri_Novak,1,B-XC,23,8,4,1,3,16,7
20021013-M-Vienna-F-Roger_Federer-Jiri_Novak,1,B-DTM,28,1,0,1,0,10,18
20021013-M-Vienna-F-Roger_Federer-Jiri_Novak,1,B-DTL,18,6,3,1,2,10,8
20021013-M-Vienna-F-Roger_Federer-Jiri_Novak,1,B-IO,1,0,0,0,0,0,1
20021013-M-Vienna-F-Roger_Federer-Jiri_Novak,1,S-XC,37,3,1,0,2,21,16
20021013-M-Vienna-F-Roger_Federer-Jiri_Novak,1,S-DTM,18,0,0,0,0,12,6
20021013-M-Vienna-F-Roger_Federer-Jiri_Novak,1,S-DTL,17,4,1,0,3,11,6
20021013-M-Vienna-F-Roger_Federer-Jiri_Novak,1,S-IO,2,1,0,0,1,1,1
20021013-M-Vienna-F-Roger_Federer-Jiri_Novak,2,F-XC,76,14,1,5,8,31,45
20021013-M-Vienna-F-Roger_Federer-Jiri_Novak,2,F-DTM,24,1,1,0,0,11,13
20021013-M-Vienna-F-Roger_Federer-Jiri_Novak,2,F-DTL,25,7,2,1,4,10,15
20021013-M-Vienna-F-Roger_Federer-Jiri_Novak,2,F-IO,36,10,2,7,1,22,14
20021013-M-Vienna-F-Roger_Federer-Jiri_Novak,2,F-II,2,0,0,0,0,1,1
20021013-M-Vienna-F-Roger_Federer-Jiri_Novak,2,B-XC,74,13,1,4,8,31,43
20021013-M-Vienna-F-Roger_Federer-Jiri_Novak,2,B-DTM,24,4,0,1,3,9,15
20021013-M-Vienna-F-Roger_Federer-Jiri_Novak,2,B-DTL,11,3,1,1,1,4,7
20021013-M-Vienna-F-Roger_Federer-Jiri_Novak,2,B-IO,6,2,0,1,1,4,2
20021013-M-Vienna-F-Roger_Federer-Jiri_Novak,2,S-XC,3,0,0,0,0,0,3
20021013-M-Vienna-F-Roger_Federer-Jiri_Novak,2,S-DTM,7,1,0,0,1,0,7
20021013-M-Vienna-F-Roger_Federer-Jiri_Novak,2,S-DTL,3,0,0,0,0,0,3
20021013-M-Vienna-F-Roger_Federer-Jiri_Novak,2,S-IO,1,0,0,0,0,1,0
20030216-M-Marseille-F-Jonas_Bjorkman-Roger_Federer,1,F-XC,12,3,1,1,1,4,8
20030216-M-Marseille-F-Jonas_Bjorkman-Roger_Federer,1,F-DTM,13,1,0,1,0,2,11
20030216-M-Marseille-F-Jonas_Bjorkman-Roger_Federer,1,F-DTL,11,3,0,1,2,3,8
20030216-M-Marseille-F-Jonas_Bjorkman-Roger_Federer,1,F-IO,9,2,0,0,2,3,6
20030216-M-Marseille-F-Jonas_Bjorkman-Roger_Federer,1,B-XC,21,3,0,0,3,10,11
20030216-M-Marseille-F-Jonas_Bjorkman-Roger_Federer,1,B-DTM,7,1,0,0,1,1,6
20030216-M-Marseille-F-Jonas_Bjorkman-Roger_Federer,1,B-DTL,4,1,1,0,0,2,2
20030216-M-Marseille-F-Jonas_Bjorkman-Roger_Federer,1,B-IO,4,1,0,0,1,1,3
20030216-M-Marseille-F-Jonas_Bjorkman-Roger_Federer,1,S-XC,3,0,0,0,0,1,2
20030216-M-Marseille-F-Jonas_Bjorkman-Roger_Federer,2,F-XC,24,8,1,4,3,18,6
20030216-M-Marseille-F-Jonas_Bjorkman-Roger_Federer,2,F-DTM,10,0,0,0,0,5,5
20030216-M-Marseille-F-Jonas_Bjorkman-Roger_Federer,2,F-DTL,7,2,2,0,0,5,2
20030216-M-Marseille-F-Jonas_Bjorkman-Roger_Federer,2,F-IO,11,5,3,1,1,9,2
20030216-M-Marseille-F-Jonas_Bjorkman-Roger_Federer,2,F-II,1,1,1,0,0,1,0
20030216-M-Marseille-F-Jonas_Bjorkman-Roger_Federer,2,B-XC,22,8,0,3,5,8,14
20030216-M-Marseille-F-Jonas_Bjorkman-Roger_Federer,2,B-DTM,15,1,0,1,0,10,5
20030216-M-Marseille-F-Jonas_Bjorkman-Roger_Federer,2,B-DTL,15,6,4,2,0,11,4
20030216-M-Marseille-F-Jonas_Bjorkman-Roger_Federer,2,B-IO,4,0,0,0,0,2,2
20030216-M-Marseille-F-Jonas_Bjorkman-Roger_Federer,2,S-XC,4,1,0,0,1,3,1
20030216-M-Marseille-F-Jonas_Bjorkman-Roger_Federer,2,S-DTM,8,1,0,1,0,6,2
20030216-M-Marseille-F-Jonas_Bjorkman-Roger_Federer,2,S-DTL,3,0,0,0,0,3,0
20031012-M-Vienna-F-Roger_Federer-Carlos_Moya,1,F-XC,40,16,4,8,4,31,9
20031012-M-Vienna-F-Roger_Federer-Carlos_Moya,1,F-DTM,17,2,0,0,2,7,10
20031012-M-Vienna-F-Roger_Federer-Carlos_Moya,1,F-DTL,8,1,0,0,1,5,3
20031012-M-Vienna-F-Roger_Federer-Carlos_Moya,1,F-IO,28,10,4,4,2,21,7
20031012-M-Vienna-F-Roger_Federer-Carlos_Moya,1,F-II,4,2,1,1,0,4,0
20031012-M-Vienna-F-Roger_Federer-Carlos_Moya,1,B-XC,20,4,2,0,2,12,8
20031012-M-Vienna-F-Roger_Federer-Carlos_Moya,1,B-DTM,9,4,1,0,3,6,3
20031012-M-Vienna-F-Roger_Federer-Carlos_Moya,1,B-DTL,5,1,0,0,1,3,2
20031012-M-Vienna-F-Roger_Federer-Carlos_Moya,1,B-IO,2,1,0,0,1,1,1
20031012-M-Vienna-F-Roger_Federer-Carlos_Moya,1,S-XC,9,1,0,0,1,4,5
20031012-M-Vienna-F-Roger_Federer-Carlos_Moya,1,S-DTM,5,1,0,0,1,1,4
20031012-M-Vienna-F-Roger_Federer-Carlos_Moya,1,S-DTL,4,0,0,0,0,2,2
20031012-M-Vienna-F-Roger_Federer-Carlos_Moya,2,F-XC,29,7,3,1,3,10,19
20031012-M-Vienna-F-Roger_Federer-Carlos_Moya,2,F-DTM,22,5,0,0,5,4,18
20031012-M-Vienna-F-Roger_Federer-Carlos_Moya,2,F-DTL,12,5,2,0,3,3,9
20031012-M-Vienna-F-Roger_Federer-Carlos_Moya,2,F-IO,33,7,0,3,4,16,17
20031012-M-Vienna-F-Roger_Federer-Carlos_Moya,2,F-II,3,0,0,0,0,1,2
20031012-M-Vienna-F-Roger_Federer-Carlos_Moya,2,B-XC,15,4,1,0,3,8,7
20031012-M-Vienna-F-Roger_Federer-Carlos_Moya,2,B-DTM,14,1,0,0,1,4,10
20031012-M-Vienna-F-Roger_Federer-Carlos_Moya,2,B-DTL,11,4,1,1,2,5,6
20031012-M-Vienna-F-Roger_Federer-Carlos_Moya,2,B-IO,1,0,0,0,0,1,0
20031012-M-Vienna-F-Roger_Federer-Carlos_Moya,2,S-XC,13,1,0,0,1,4,9
20031012-M-Vienna-F-Roger_Federer-Carlos_Moya,2,S-DTM,2,1,0,0,1,0,2
20031012-M-Vienna-F-Roger_Federer-Carlos_Moya,2,S-DTL,1,0,0,0,0,0,1
20180513-M-Madrid_Masters-F-Dominic_Thiem-Alexander_Zverev,1,F-XC,38,7,2,2,3,23,15
20180513-M-Madrid_Masters-F-Dominic_Thiem-Alexander_Zverev,1,F-DTM,13,0,0,0,0,3,10
20180513-M-Madrid_Masters-F-Dominic_Thiem-Alexander_Zverev,1,F-DTL,8,5,2,1,2,4,4
20180513-M-Madrid_Masters-F-Dominic_Thiem-Alexander_Zverev,1,F-IO,15,7,2,2,3,8,7
20180513-M-Madrid_Masters-F-Dominic_Thiem-Alexander_Zverev,1,F-II,6,4,1,1,2,3,3
20180513-M-Madrid_Masters-F-Dominic_Thiem-Alexander_Zverev,1,B-XC,19,3,0,2,1,11,8
20180513-M-Madrid_Masters-F-Dominic_Thiem-Alexander_Zverev,1,B-DTM,8,0,0,0,0,6,2
20180513-M-Madrid_Masters-F-Dominic_Thiem-Alexander_Zverev,1,B-DTL,3,2,1,1,0,2,1
20180513-M-Madrid_Masters-F-Dominic_Thiem-Alexander_Zverev,1,B-IO,1,1,1,0,0,1,0
20180513-M-Madrid_Masters-F-Dominic_Thiem-Alexander_Zverev,1,S-XC,11,1,0,0,1,5,6
20180513-M-Madrid_Masters-F-Dominic_Thiem-Alexander_Zverev,1,S-DTM,7,1,0,0,1,5,2
20180513-M-Madrid_Masters-F-Dominic_Thiem-Alexander_Zverev,1,S-DTL,2,0,0,0,0,0,2
20180513-M-Madrid_Masters-F-Dominic_Thiem-Alexander_Zverev,1,S-IO,1,0,0,0,0,1,0
20180513-M-Madrid_Masters-F-Dominic_Thiem-Alexander_Zverev,2,F-XC,25,4,2,1,1,13,12
20180513-M-Madrid_Masters-F-Dominic_Thiem-Alexander_Zverev,2,F-DTM,28,2,0,1,1,13,15
20180513-M-Madrid_Masters-F-Dominic_Thiem-Alexander_Zverev,2,F-DTL,8,2,0,0,2,4,4
20180513-M-Madrid_Masters-F-Dominic_Thiem-Alexander_Zverev,2,F-IO,12,4,0,2,2,4,8
20180513-M-Madrid_Masters-F-Dominic_Thiem-Alexander_Zverev,2,F-II,4,3,1,1,1,2,2
20180513-M-Madrid_Masters-F-Dominic_Thiem-Alexander_Zverev,2,B-XC,33,6,0,4,2,19,14
20180513-M-Madrid_Masters-F-Dominic_Thiem-Alexander_Zverev,2,B-DTM,9,0,0,0,0,5,4
20180513-M-Madrid_Masters-F-Dominic_Thiem-Alexander_Zverev,2,B-DTL,2,1,1,0,0,2,0
20180513-M-Madrid_Masters-F-Dominic_Thiem-Alexander_Zverev,2,B-IO,1,1,1,0,0,1,0
20180513-M-Madrid_Masters-F-Dominic_Thiem-Alexander_Zverev,2,S-XC,2,0,0,0,0,1,1
20180513-M-Madrid_Masters-F-Dominic_Thiem-Alexander_Zverev,2,S-DTL,1,1,0,0,1,0,1
20180513-M-Madrid_Masters-F-Dominic_Thiem-Alexander_Zverev,2,S-IO,1,0,0,0,0,1,0
20180511-M-Madrid_Masters-QF-Rafael_Nadal-Dominic_Thiem,1,F-XC,53,9,2,1,6,21,32
20180511-M-Madrid_Masters-QF-Rafael_Nadal-Dominic_Thiem,1,F-DTM,19,3,0,0,3,8,11
20180511-M-Madrid_Masters-QF-Rafael_Nadal-Dominic_Thiem,1,F-DTL,8,4,2,0,2,3,5
20180511-M-Madrid_Masters-QF-Rafael_Nadal-Dominic_Thiem,1,F-IO,20,8,2,4,2,13,7
20180511-M-Madrid_Masters-QF-Rafael_Nadal-Dominic_Thiem,1,F-II,10,2,0,2,0,5,5
20180511-M-Madrid_Masters-QF-Rafael_Nadal-Dominic_Thiem,1,B-XC,46,7,1,2,4,15,31
20180511-M-Madrid_Masters-QF-Rafael_Nadal-Dominic_Thiem,1,B-DTM,31,5,0,0,5,6,25
20180511-M-Madrid_Masters-QF-Rafael_Nadal-Dominic_Thiem,1,B-DTL,20,3,0,0,3,6,14
20180511-M-Madrid_Masters-QF-Rafael_Nadal-Dominic_Thiem,1,B-IO,2,0,0,0,0,1,1
20180511-M-Madrid_Masters-QF-Rafael_Nadal-Dominic_Thiem,1,S-DTL,1,0,0,0,0,0,1
20180511-M-Madrid_Masters-QF-Rafael_Nadal-Dominic_Thiem,1,S-IO,1,0,0,0,0,1,0
20180511-M-Madrid_Masters-QF-Rafael_Nadal-Dominic_Thiem,2,F-XC,67,6,2,2,2,46,21
20180511-M-Madrid_Masters-QF-Rafael_Nadal-Dominic_Thiem,2,F-DTM,29,4,0,0,4,16,13
20180511-M-Madrid_Masters-QF-Rafael_Nadal-Dominic_Thiem,2,F-DTL,6,4,2,1,1,5,1
20180511-M-Madrid_Masters-QF-Rafael_Nadal-Dominic_Thiem,2,F-IO,30,18,14,1,3,22,8
20180511-M-Madrid_Masters-QF-Rafael_Nadal-Dominic_Thiem,2,F-II,7,2,0,1,1,5,2
20180511-M-Madrid_Masters-QF-Rafael_Nadal-Dominic_Thiem,2,B-XC,14,3,3,0,0,10,4
20180511-M-Madrid_Masters-QF-Rafael_Nadal-Dominic_Thiem,2,B-DTM,25,3,0,1,2,12,13
20180511-M-Madrid_Masters-QF-Rafael_Nadal-Dominic_Thiem,2,B-DTL,17,6,2,1,3,12,5
20180511-M-Madrid_Masters-QF-Rafael_Nadal-Dominic_Thiem,2,B-IO,2,1,0,0,1,0,2
20180511-M-Madrid_Masters-QF-Rafael_Nadal-Dominic_Thiem,2,S-XC,2,0,0,0,0,2,0
20180511-M-Madrid_Masters-QF-Rafael_Nadal-Dominic_Thiem,2,S-DTM,5,0,0,0,0,0,5
20180511-M-Madrid_Masters-QF-Rafael_Nadal-Dominic_Thiem,2,S-DTL,3,1,0,0,1,1,2
20061029-M-Basel-F-Roger_Federer-Fernando_Gonzalez,1,F-XC,29,11,2,5,4,20,9
20061029-M-Basel-F-Roger_Federer-Fernando_Gonzalez,1,F-DTM,14,0,0,0,0,7,7
20061029-M-Basel-F-Roger_Federer-Fernando_Gonzalez,1,F-DTL,10,1,1,0,0,10,0
20061029-M-Basel-F-Roger_Federer-Fernando_Gonzalez,1,F-IO,20,9,3,2,4,14,6
20061029-M-Basel-F-Roger_Federer-Fernando_Gonzalez,1,F-II,8,3,3,0,0,5,3
20061029-M-Basel-F-Roger_Federer-Fernando_Gonzalez,1,B-XC,24,6,1,1,4,14,10
20061029-M-Basel-F-Roger_Federer-Fernando_Gonzalez,1,B-DTM,10,0,0,0,0,8,2
20061029-M-Basel-F-Roger_Federer-Fernando_Gonzalez,1,B-DTL,16,9,5,1,3,11,5
20061029-M-Basel-F-Roger_Federer-Fernando_Gonzalez,1,B-IO,2,1,1,0,0,1,1
20061029-M-Basel-F-Roger_Federer-Fernando_Gonzalez,1,S-XC,11,1,0,0,1,3,8
20061029-M-Basel-F-Roger_Federer-Fernando_Gonzalez,1,S-DTM,7,1,0,1,0,5,2
20061029-M-Basel-F-Roger_Federer-Fernando_Gonzalez,1,S-DTL,8,3,0,2,1,5,3
20061029-M-Basel-F-Roger_Federer-Fernando_Gonzalez,2,F-XC,35,11,2,2,7,10,25
20061029-M-Basel-F-Roger_Federer-Fernando_Gonzalez,2,F-DTM,15,2,0,2,0,7,8
20061029-M-Basel-F-Roger_Federer-Fernando_Gonzalez,2,F-DTL,13,3,0,1,2,6,7
20061029-M-Basel-F-Roger_Federer-Fernando_Gonzalez,2,F-IO,25,12,5,3,4,16,9
20061029-M-Basel-F-Roger_Federer-Fernando_Gonzalez,2,F-II,3,3,2,0,1,2,1
20061029-M-Basel-F-Roger_Federer-Fernando_Gonzalez,2,B-XC,22,5,2,2,1,10,12
20061029-M-Basel-F-Roger_Federer-Fernando_Gonzalez,2,B-DTM,13,1,0,0,1,3,10
20061029-M-Basel-F-Roger_Federer-Fernando_Gonzalez,2,B-DTL,5,3,1,1,1,2,3
20061029-M-Basel-F-Roger_Federer-Fernando_Gonzalez,2,B-IO,1,0,0,0,0,1,0
20061029-M-Basel-F-Roger_Federer-Fernando_Gonzalez,2,S-XC,26,2,0,1,1,8,18
20061029-M-Basel-F-Roger_Federer-Fernando_Gonzalez,2,S-DTM,8,2,0,0,2,2,6
20061029-M-Basel-F-Roger_Federer-Fernando_Gonzalez,2,S-DTL,2,0,0,0,0,1,1
20180426-M-Barcelona-R16-Pablo_Carreno_Busta-Adrian_Mannarino,1,F-XC,103,14,6,4,4,56,47
20180426-M-Barcelona-R16-Pablo_Carreno_Busta-Adrian_Mannarino,1,F-DTM,18,1,0,1,0,13,5
20180426-M-Barcelona-R16-Pablo_Carreno_Busta-Adrian_Mannarino,1,F-DTL,39,15,8,0,7,26,13
20180426-M-Barcelona-R16-Pablo_Carreno_Busta-Adrian_Mannarino,1,F-IO,32,8,3,3,2,19,13
20180426-M-Barcelona-R16-Pablo_Carreno_Busta-Adrian_Mannarino,1,F-II,9,2,1,0,1,5,4
20180426-M-Barcelona-R16-Pablo_Carreno_Busta-Adrian_Mannarino,1,B-XC,143,15,1,6,8,76,67
20180426-M-Barcelona-R16-Pablo_Carreno_Busta-Adrian_Mannarino,1,B-DTM,62,2,0,1,1,30,32
20180426-M-Barcelona-R16-Pablo_Carreno_Busta-Adrian_Mannarino,1,B-DTL,33,15,3,4,8,20,13
20180426-M-Barcelona-R16-Pablo_Carreno_Busta-Adrian_Mannarino,1,B-IO,3,0,0,0,0,3,0
20180426-M-Barcelona-R16-Pablo_Carreno_Busta-Adrian_Mannarino,1,S-XC,10,1,0,0,1,7,3
20180426-M-Barcelona-R16-Pablo_Carreno_Busta-Adrian_Mannarino,1,S-DTM,5,0,0,0,0,2,3
20180426-M-Barcelona-R16-Pablo_Carreno_Busta-Adrian_Mannarino,1,S-DTL,4,1,0,1,0,2,2
20180426-M-Barcelona-R16-Pablo_Carreno_Busta-Adrian_Mannarino,1,S-IO,2,0,0,0,0,1,1
20180426-M-Barcelona-R16-Pablo_Carreno_Busta-Adrian_Mannarino,2,F-XC,216,24,1,7,16,98,118
20180426-M-Barcelona-R16-Pablo_Carreno_Busta-Adrian_Mannarino,2,F-DTM,27,1,0,0,1,12,15
20180426-M-Barcelona-R16-Pablo_Carreno_Busta-Adrian_Mannarino,2,F-DTL,16,6,5,1,0,8,8
20180426-M-Barcelona-R16-Pablo_Carreno_Busta-Adrian_Mannarino,2,F-IO,8,1,0,1,0,6,2
20180426-M-Barcelona-R16-Pablo_Carreno_Busta-Adrian_Mannarino,2,F-II,2,2,0,0,2,0,2
20180426-M-Barcelona-R16-Pablo_Carreno_Busta-Adrian_Mannarino,2,B-XC,106,11,3,2,6,42,64
20180426-M-Barcelona-R16-Pablo_Carreno_Busta-Adrian_Mannarino,2,B-DTM,24,3,0,0,3,11,13
20180426-M-Barcelona-R16-Pablo_Carreno_Busta-Adrian_Mannarino,2,B-DTL,21,6,2,2,2,11,10
20180426-M-Barcelona-R16-Pablo_Carreno_Busta-Adrian_Mannarino,2,B-IO,18,1,0,0,1,4,14
20180426-M-Barcelona-R16-Pablo_Carreno_Busta-Adrian_Mannarino,2,B-II,2,0,0,0,0,1,1
20180426-M-Barcelona-R16-Pablo_Carreno_Busta-Adrian_Mannarino,2,S-XC,1,0,0,0,0,0,1
20180426-M-Barcelona-R16-Pablo_Carreno_Busta-Adrian_Mannarino,2,S-DTM,2,0,0,0,0,1,1
20180426-M-Barcelona-R16-Pablo_Carreno_Busta-Adrian_Mannarino,2,S-DTL,9,2,0,2,0,7,2
20180426-M-Barcelona-R16-Pablo_Carreno_Busta-Adrian_Mannarino,2,S-IO,1,0,0,0,0,1,0
20180425-M-Barcelona-R32-Pablo_Carreno_Busta-Benoit_Paire,1,F-XC,24,5,2,2,1,13,11
20180425-M-Barcelona-R32-Pablo_Carreno_Busta-Benoit_Paire,1,F-DTM,8,0,0,0,0,4,4
20180425-M-Barcelona-R32-Pablo_Carreno_Busta-Benoit_Paire,1,F-DTL,6,6,1,4,1,5,1
20180425-M-Barcelona-R32-Pablo_Carreno_Busta-Benoit_Paire,1,F-IO,16,5,2,2,1,11,5
20180425-M-Barcelona-R32-Pablo_Carreno_Busta-Benoit_Paire,1,F-II,4,1,0,1,0,3,1
20180425-M-Barcelona-R32-Pablo_Carreno_Busta-Benoit_Paire,1,B-XC,24,6,1,2,3,13,11
20180425-M-Barcelona-R32-Pablo_Carreno_Busta-Benoit_Paire,1,B-DTM,7,0,0,0,0,5,2
20180425-M-Barcelona-R32-Pablo_Carreno_Busta-Benoit_Paire,1,B-DTL,8,1,1,0,0,3,5
20180425-M-Barcelona-R32-Pablo_Carreno_Busta-Benoit_Paire,1,B-II,1,0,0,0,0,1,0
20180425-M-Barcelona-R32-Pablo_Carreno_Busta-Benoit_Paire,1,S-DTM,1,0,0,0,0,0,1
20180425-M-Barcelona-R32-Pablo_Carreno_Busta-Benoit_Paire,1,S-DTL,1,1,0,1,0,1,0
20180425-M-Barcelona-R32-Pablo_Carreno_Busta-Benoit_Paire,1,S-IO,1,0,0,0,0,1,0
20180425-M-Barcelona-R32-Pablo_Carreno_Busta-Benoit_Paire,2,F-XC,20,5,2,1,2,12,8
20180425-M-Barcelona-R32-Pablo_Carreno_Busta-Benoit_Paire,2,F-DTM,15,2,0,1,1,6,9
20180425-M-Barcelona-R32-Pablo_Carreno_Busta-Benoit_Paire,2,F-DTL,11,4,2,1,1,9,2
20180425-M-Barcelona-R32-Pablo_Carreno_Busta-Benoit_Paire,2,F-IO,5,1,0,0,1,0,5
20180425-M-Barcelona-R32-Pablo_Carreno_Busta-Benoit_Paire,2,B-XC,15,5,1,3,1,9,6
20180425-M-Barcelona-R32-Pablo_Carreno_Busta-Benoit_Paire,2,B-DTM,8,0,0,0,0,3,5
20180425-M-Barcelona-R32-Pablo_Carreno_Busta-Benoit_Paire,2,B-DTL,8,5,2,3,0,5,3
20180425-M-Barcelona-R32-Pablo_Carreno_Busta-Benoit_Paire,2,B-IO,3,2,1,0,1,1,2
20180425-M-Barcelona-R32-Pablo_Carreno_Busta-Benoit_Paire,2,B-II,1,0,0,0,0,0,1
20180425-M-Barcelona-R32-Pablo_Carreno_Busta-Benoit_Paire,2,S-XC,2,0,0,0,0,0,2
20180425-M-Barcelona-R32-Pablo_Carreno_Busta-Benoit_Paire,2,S-DTM,4,0,0,0,0,1,3
20180425-M-Barcelona-R32-Pablo_Carreno_Busta-Benoit_Paire,2,S-DTL,2,1,0,0,1,0,2
20060107-M-Doha-F-Roger_Federer-Gael_Monfils,1,F-XC,53,12,2,3,7,26,27
20060107-M-Doha-F-Roger_Federer-Gael_Monfils,1,F-DTM,31,3,0,1,2,16,15
20060107-M-Doha-F-Roger_Federer-Gael_Monfils,1,F-DTL,10,3,2,1,0,6,4
20060107-M-Doha-F-Roger_Federer-Gael_Monfils,1,F-IO,37,8,4,3,1,19,18
20060107-M-Doha-F-Roger_Federer-Gael_Monfils,1,F-II,8,2,1,0,1,6,2
20060107-M-Doha-F-Roger_Federer-Gael_Monfils,1,B-XC,48,4,1,1,2,23,25
20060107-M-Doha-F-Roger_Federer-Gael_Monfils,1,B-DTM,19,2,0,0,2,10,9
20060107-M-Doha-F-Roger_Federer-Gael_Monfils,1,B-DTL,9,2,0,1,1,5,4
20060107-M-Doha-F-Roger_Federer-Gael_Monfils,1,B-IO,2,0,0,0,0,1,1
20060107-M-Doha-F-Roger_Federer-Gael_Monfils,1,S-XC,43,6,0,4,2,23,20
20060107-M-Doha-F-Roger_Federer-Gael_Monfils,1,S-DTM,9,1,0,0,1,4,5
20060107-M-Doha-F-Roger_Federer-Gael_Monfils,1,S-DTL,4,0,0,0,0,2,2
20060107-M-Doha-F-Roger_Federer-Gael_Monfils,1,S-IO,3,1,0,1,0,2,1
20060107-M-Doha-F-Roger_Federer-Gael_Monfils,2,F-XC,38,7,3,3,1,17,21
20060107-M-Doha-F-Roger_Federer-Gael_Monfils,2,F-DTM,52,2,0,1,1,27,25
20060107-M-Doha-F-Roger_Federer-Gael_Monfils,2,F-DTL,7,3,3,0,0,4,3
20060107-M-Doha-F-Roger_Federer-Gael_Monfils,2,F-IO,36,3,0,0,3,13,23
20060107-M-Doha-F-Roger_Federer-Gael_Monfils,2,F-II,7,1,0,1,0,2,5
20060107-M-Doha-F-Roger_Federer-Gael_Monfils,2,B-XC,73,4,1,1,2,43,30
20060107-M-Doha-F-Roger_Federer-Gael_Monfils,2,B-DTM,45,0,0,0,0,22,23
20060107-M-Doha-F-Roger_Federer-Gael_Monfils,2,B-DTL,8,0,0,0,0,5,3
20060107-M-Doha-F-Roger_Federer-Gael_Monfils,2,B-IO,3,3,0,0,3,0,3
20060107-M-Doha-F-Roger_Federer-Gael_Monfils,2,S-XC,9,2,1,0,1,4,5
20060107-M-Doha-F-Roger_Federer-Gael_Monfils,2,S-DTM,3,0,0,0,0,0,3
20160504-M-Madrid_Masters-R32-Novak_Djokovic-Borna_Coric,1,F-XC,28,7,5,1,1,23,5
20160504-M-Madrid_Masters-R32-Novak_Djokovic-Borna_Coric,1,F-DTM,14,1,0,0,1,9,5
20160504-M-Madrid_Masters-R32-Novak_Djokovic-Borna_Coric,1,F-DTL,15,5,1,2,2,10,5
20160504-M-Madrid_Masters-R32-Novak_Djokovic-Borna_Coric,1,F-IO,16,6,0,4,2,13,3
20160504-M-Madrid_Masters-R32-Novak_Djokovic-Borna_Coric,1,F-II,1,1,1,0,0,1,0
20160504-M-Madrid_Masters-R32-Novak_Djokovic-Borna_Coric,1,B-XC,37,3,2,1,0,31,6
20160504-M-Madrid_Masters-R32-Novak_Djokovic-Borna_Coric,1,B-DTM,21,1,0,1,0,11,10
20160504-M-Madrid_Masters-R32-Novak_Djokovic-Borna_Coric,1,B-DTL,9,1,0,1,0,6,3
20160504-M-Madrid_Masters-R32-Novak_Djokovic-Borna_Coric,1,B-IO,6,1,1,0,0,5,1
20160504-M-Madrid_Masters-R32-Novak_Djokovic-Borna_Coric,1,S-XC,4,0,0,0,0,3,1
20160504-M-Madrid_Masters-R32-Novak_Djokovic-Borna_Coric,1,S-DTM,2,0,0,0,0,1,1
20160504-M-Madrid_Masters-R32-Novak_Djokovic-Borna_Coric,2,F-XC,36,5,0,2,3,13,23
20160504-M-Madrid_Masters-R32-Novak_Djokovic-Borna_Coric,2,F-DTM,11,0,0,0,0,4,7
20160504-M-Madrid_Masters-R32-Novak_Djokovic-Borna_Coric,2,F-DTL,15,2,1,0,1,3,12
20160504-M-Madrid_Masters-R32-Novak_Djokovic-Borna_Coric,2,F-IO,24,6,2,1,3,13,11
20160504-M-Madrid_Masters-R32-Novak_Djokovic-Borna_Coric,2,F-II,4,3,1,0,2,1,3
20160504-M-Madrid_Masters-R32-Novak_Djokovic-Borna_Coric,2,B-XC,34,5,0,2,3,7,27
20160504-M-Madrid_Masters-R32-Novak_Djokovic-Borna_Coric,2,B-DTM,18,2,0,0,2,4,14
20160504-M-Madrid_Masters-R32-Novak_Djokovic-Borna_Coric,2,B-DTL,11,6,0,1,5,2,9
20160504-M-Madrid_Masters-R32-Novak_Djokovic-Borna_Coric,2,S-XC,3,0,0,0,0,1,2
20160504-M-Madrid_Masters-R32-Novak_Djokovic-Borna_Coric,2,S-DTM,4,1,0,0,1,1,3
20040711-M-Gstaad-F-Roger_Federer-Igor_Andreev,1,F-XC,40,16,6,6,4,28,12
20040711-M-Gstaad-F-Roger_Federer-Igor_Andreev,1,F-DTM,21,8,0,2,6,10,11
20040711-M-Gstaad-F-Roger_Federer-Igor_Andreev,1,F-DTL,8,4,2,1,1,5,3
20040711-M-Gstaad-F-Roger_Federer-Igor_Andreev,1,F-IO,22,6,1,3,2,15,7
20040711-M-Gstaad-F-Roger_Federer-Igor_Andreev,1,F-II,7,4,0,1,3,4,3
20040711-M-Gstaad-F-Roger_Federer-Igor_Andreev,1,B-XC,29,1,0,0,1,15,14
20040711-M-Gstaad-F-Roger_Federer-Igor_Andreev,1,B-DTM,12,2,0,1,1,9,3
20040711-M-Gstaad-F-Roger_Federer-Igor_Andreev,1,B-DTL,9,5,1,0,4,4,5
20040711-M-Gstaad-F-Roger_Federer-Igor_Andreev,1,S-XC,13,2,0,1,1,8,5
20040711-M-Gstaad-F-Roger_Federer-Igor_Andreev,1,S-DTM,5,0,0,0,0,2,3
20040711-M-Gstaad-F-Roger_Federer-Igor_Andreev,1,S-DTL,2,2,0,2,0,2,0
20040711-M-Gstaad-F-Roger_Federer-Igor_Andreev,2,F-XC,31,13,4,4,5,13,18
20040711-M-Gstaad-F-Roger_Federer-Igor_Andreev,2,F-DTM,25,3,0,0,3,6,19
20040711-M-Gstaad-F-Roger_Federer-Igor_Andreev,2,F-DTL,6,2,1,0,1,2,4
20040711-M-Gstaad-F-Roger_Federer-Igor_Andreev,2,F-IO,38,11,2,3,6,20,18
20040711-M-Gstaad-F-Roger_Federer-Igor_Andreev,2,F-II,5,3,1,0,2,2,3
20040711-M-Gstaad-F-Roger_Federer-Igor_Andreev,2,B-XC,27,5,1,1,3,12,15
20040711-M-Gstaad-F-Roger_Federer-Igor_Andreev,2,B-DTM,23,3,2,0,1,13,10
20040711-M-Gstaad-F-Roger_Federer-Igor_Andreev,2,B-DTL,7,5,1,1,3,3,4
20040711-M-Gstaad-F-Roger_Federer-Igor_Andreev,2,B-IO,2,1,0,0,1,0,2
20040711-M-Gstaad-F-Roger_Federer-Igor_Andreev,2,S-XC,12,3,0,2,1,5,7
20040711-M-Gstaad-F-Roger_Federer-Igor_Andreev,2,S-DTM,5,1,0,0,1,1,4
20180427-M-Barcelona-QF-Grigor_Dimitrov-Pablo_Carreno_Busta,1,F-XC,28,8,5,2,1,16,12
20180427-M-Barcelona-QF-Grigor_Dimitrov-Pablo_Carreno_Busta,1,F-DTM,20,0,0,0,0,6,14
20180427-M-Barcelona-QF-Grigor_Dimitrov-Pablo_Carreno_Busta,1,F-DTL,8,2,1,1,0,4,4
20180427-M-Barcelona-QF-Grigor_Dimitrov-Pablo_Carreno_Busta,1,F-IO,37,7,3,3,1,19,18
20180427-M-Barcelona-QF-Grigor_Dimitrov-Pablo_Carreno_Busta,1,F-II,10,4,2,1,1,5,5
20180427-M-Barcelona-QF-Grigor_Dimitrov-Pablo_Carreno_Busta,1,B-XC,48,7,2,1,4,18,30
20180427-M-Barcelona-QF-Grigor_Dimitrov-Pablo_Carreno_Busta,1,B-DTM,9,0,0,0,0,2,7
20180427-M-Barcelona-QF-Grigor_Dimitrov-Pablo_Carreno_Busta,1,B-DTL,6,1,1,0,0,3,3
20180427-M-Barcelona-QF-Grigor_Dimitrov-Pablo_Carreno_Busta,1,S-XC,24,2,0,0,2,11,13
20180427-M-Barcelona-QF-Grigor_Dimitrov-Pablo_Carreno_Busta,1,S-DTM,4,0,0,0,0,0,4
20180427-M-Barcelona-QF-Grigor_Dimitrov-Pablo_Carreno_Busta,1,S-DTL,3,1,0,0,1,1,2
20180427-M-Barcelona-QF-Grigor_Dimitrov-Pablo_Carreno_Busta,1,S-IO,2,0,0,0,0,2,0
20180427-M-Barcelona-QF-Grigor_Dimitrov-Pablo_Carreno_Busta,2,F-XC,36,14,4,5,5,23,13
20180427-M-Barcelona-QF-Grigor_Dimitrov-Pablo_Carreno_Busta,2,F-DTM,18,0,0,0,0,11,7
20180427-M-Barcelona-QF-Grigor_Dimitrov-Pablo_Carreno_Busta,2,F-DTL,12,2,0,0,2,4,8
20180427-M-Barcelona-QF-Grigor_Dimitrov-Pablo_Carreno_Busta,2,F-IO,34,7,2,4,1,20,14
20180427-M-Barcelona-QF-Grigor_Dimitrov-Pablo_Carreno_Busta,2,F-II,7,4,1,1,2,3,4
20180427-M-Barcelona-QF-Grigor_Dimitrov-Pablo_Carreno_Busta,2,B-XC,65,5,1,1,3,45,20
20180427-M-Barcelona-QF-Grigor_Dimitrov-Pablo_Carreno_Busta,2,B-DTM,14,1,0,1,0,2,12
20180427-M-Barcelona-QF-Grigor_Dimitrov-Pablo_Carreno_Busta,2,B-DTL,10,5,3,2,0,7,3
20180427-M-Barcelona-QF-Grigor_Dimitrov-Pablo_Carreno_Busta,2,S-XC,7,2,1,0,1,6,1
20180427-M-Barcelona-QF-Grigor_Dimitrov-Pablo_Carreno_Busta,2,S-DTM,1,0,0,0,0,1,0
20180428-M-Barcelona-SF-Stefanos_Tsitsipas-Pablo_Carreno_Busta,1,F-XC,48,16,4,4,8,30,18
20180428-M-Barcelona-SF-Stefanos_Tsitsipas-Pablo_Carreno_Busta,1,F-DTM,22,0,0,0,0,10,12
20180428-M-Barcelona-SF-Stefanos_Tsitsipas-Pablo_Carreno_Busta,1,F-DTL,17,3,1,1,1,9,8
20180428-M-Barcelona-SF-Stefanos_Tsitsipas-Pablo_Carreno_Busta,1,F-IO,36,10,4,3,3,27,9
20180428-M-Barcelona-SF-Stefanos_Tsitsipas-Pablo_Carreno_Busta,1,F-II,14,2,0,1,1,4,10
20180428-M-Barcelona-SF-Stefanos_Tsitsipas-Pablo_Carreno_Busta,1,B-XC,69,5,0,2,3,31,38
20180428-M-Barcelona-SF-Stefanos_Tsitsipas-Pablo_Carreno_Busta,1,B-DTM,20,3,0,1,2,9,11
20180428-M-Barcelona-SF-Stefanos_Tsitsipas-Pablo_Carreno_Busta,1,B-DTL,9,4,1,1,2,4,5
20180428-M-Barcelona-SF-Stefanos_Tsitsipas-Pablo_Carreno_Busta,1,S-XC,4,0,0,0,0,4,0
20180428-M-Barcelona-SF-Stefanos_Tsitsipas-Pablo_Carreno_Busta,1,S-DTM,2,0,0,0,0,2,0
20180428-M-Barcelona-SF-Stefanos_Tsitsipas-Pablo_Carreno_Busta,2,F-XC,58,13,3,3,7,28,30
20180428-M-Barcelona-SF-Stefanos_Tsitsipas-Pablo_Carreno_Busta,2,F-DTM,15,2,0,1,1,5,10
20180428-M-Barcelona-SF-Stefanos_Tsitsipas-Pablo_Carreno_Busta,2,F-DTL,15,2,2,0,0,6,9
20180428-M-Barcelona-SF-Stefanos_Tsitsipas-Pablo_Carreno_Busta,2,F-IO,31,6,2,3,1,19,12
20180428-M-Barcelona-SF-Stefanos_Tsitsipas-Pablo_Carreno_Busta,2,F-II,10,4,0,1,3,6,4
20180428-M-Barcelona-SF-Stefanos_Tsitsipas-Pablo_Carreno_Busta,2,B-XC,79,6,0,2,4,40,39
20180428-M-Barcelona-SF-Stefanos_Tsitsipas-Pablo_Carreno_Busta,2,B-DTM,14,0,0,0,0,5,9
20180428-M-Barcelona-SF-Stefanos_Tsitsipas-Pablo_Carreno_Busta,2,B-DTL,9,4,2,0,2,5,4
20180428-M-Barcelona-SF-Stefanos_Tsitsipas-Pablo_Carreno_Busta,2,S-XC,2,0,0,0,0,0,2
20180428-M-Barcelona-SF-Stefanos_Tsitsipas-Pablo_Carreno_Busta,2,S-DTM,1,0,0,0,0,0,1
20180428-M-Barcelona-SF-Stefanos_Tsitsipas-Pablo_Carreno_Busta,2,S-DTL,2,0,0,0,0,0,2
20011028-M-Basel-F-Tim_Henman-Roger_Federer,1,F-XC,16,8,4,1,3,11,5
20011028-M-Basel-F-Tim_Henman-Roger_Federer,1,F-DTM,12,0,0,0,0,4,8
20011028-M-Basel-F-Tim_Henman-Roger_Federer,1,F-DTL,7,0,0,0,0,4,3
20011028-M-Basel-F-Tim_Henman-Roger_Federer,1,F-IO,14,4,1,1,2,9,5
20011028-M-Basel-F-Tim_Henman-Roger_Federer,1,F-II,4,2,0,1,1,1,3
20011028-M-Basel-F-Tim_Henman-Roger_Federer,1,B-XC,9,4,1,0,3,3,6
20011028-M-Basel-F-Tim_Henman-Roger_Federer,1,B-DTM,10,2,0,1,1,6,4
20011028-M-Basel-F-Tim_Henman-Roger_Federer,1,B-DTL,2,0,0,0,0,1,1
20011028-M-Basel-F-Tim_Henman-Roger_Federer,1,S-XC,22,3,0,3,0,11,11
20011028-M-Basel-F-Tim_Henman-Roger_Federer,1,S-DTM,6,0,0,0,0,5,1
20011028-M-Basel-F-Tim_Henman-Roger_Federer,1,S-DTL,2,0,0,0,0,0,2
20011028-M-Basel-F-Tim_Henman-Roger_Federer,2,F-XC,23,6,0,3,3,8,15
20011028-M-Basel-F-Tim_Henman-Roger_Federer,2,F-DTM,17,2,1,1,0,9,8
20011028-M-Basel-F-Tim_Henman-Roger_Federer,2,F-DTL,7,5,2,1,2,4,3
20011028-M-Basel-F-Tim_Henman-Roger_Federer,2,F-IO,24,6,1,2,3,13,11
20011028-M-Basel-F-Tim_Henman-Roger_Federer,2,F-II,6,1,0,1,0,4,2
20011028-M-Basel-F-Tim_Henman-Roger_Federer,2,B-XC,26,8,1,1,6,11,15
20011028-M-Basel-F-Tim_Henman-Roger_Federer,2,B-DTM,18,4,0,2,2,7,11
20011028-M-Basel-F-Tim_Henman-Roger_Federer,2,B-DTL,7,5,1,1,3,3,4
20011028-M-Basel-F-Tim_Henman-Roger_Federer,2,B-IO,1,1,0,0,1,0,1
20011028-M-Basel-F-Tim_Henman-Roger_Federer,2,S-XC,6,0,0,0,0,2,4
20011028-M-Basel-F-Tim_Henman-Roger_Federer,2,S-DTM,1,0,0,0,0,0,1
20180330-M-Miami_Masters-SF-John_Isner-Juan_Martin_Del_Potro,1,F-XC,10,4,3,0,1,7,3
20180330-M-Miami_Masters-SF-John_Isner-Juan_Martin_Del_Potro,1,F-DTM,5,1,0,0,1,2,3
20180330-M-Miami_Masters-SF-John_Isner-Juan_Martin_Del_Potro,1,F-DTL,11,5,0,2,3,4,7
20180330-M-Miami_Masters-SF-John_Isner-Juan_Martin_Del_Potro,1,F-IO,30,13,7,3,3,16,14
20180330-M-Miami_Masters-SF-John_Isner-Juan_Martin_Del_Potro,1,F-II,7,5,4,0,1,5,2
20180330-M-Miami_Masters-SF-John_Isner-Juan_Martin_Del_Potro,1,B-XC,9,2,0,0,2,4,5
20180330-M-Miami_Masters-SF-John_Isner-Juan_Martin_Del_Potro,1,B-DTM,3,0,0,0,0,1,2
20180330-M-Miami_Masters-SF-John_Isner-Juan_Martin_Del_Potro,1,B-DTL,10,8,2,0,6,3,7
20180330-M-Miami_Masters-SF-John_Isner-Juan_Martin_Del_Potro,1,B-IO,1,0,0,0,0,0,1
20180330-M-Miami_Masters-SF-John_Isner-Juan_Martin_Del_Potro,1,S-XC,1,1,0,0,1,0,1
20180330-M-Miami_Masters-SF-John_Isner-Juan_Martin_Del_Potro,1,S-DTM,1,0,0,0,0,0,1
20180330-M-Miami_Masters-SF-John_Isner-Juan_Martin_Del_Potro,2,F-XC,14,6,1,4,1,9,5
20180330-M-Miami_Masters-SF-John_Isner-Juan_Martin_Del_Potro,2,F-DTM,11,2,0,1,1,5,6
20180330-M-Miami_Masters-SF-John_Isner-Juan_Martin_Del_Potro,2,F-DTL,1,0,0,0,0,1,0
20180330-M-Miami_Masters-SF-John_Isner-Juan_Martin_Del_Potro,2,F-IO,4,0,0,0,0,2,2
20180330-M-Miami_Masters-SF-John_Isner-Juan_Martin_Del_Potro,2,F-II,3,1,0,1,0,2,1
20180330-M-Miami_Masters-SF-John_Isner-Juan_Martin_Del_Potro,2,B-XC,7,2,0,0,2,4,3
20180330-M-Miami_Masters-SF-John_Isner-Juan_Martin_Del_Potro,2,B-DTM,6,1,0,1,0,4,2
20180330-M-Miami_Masters-SF-John_Isner-Juan_Martin_Del_Potro,2,B-DTL,5,3,3,0,0,4,1
20180330-M-Miami_Masters-SF-John_Isner-Juan_Martin_Del_Potro,2,S-XC,22,0,0,0,0,14,8
20180330-M-Miami_Masters-SF-John_Isner-Juan_Martin_Del_Potro,2,S-DTM,5,0,0,0,0,2,3
20180519-M-Rome_Masters-SF-Rafael_Nadal-Novak_Djokovic,1,F-XC,79,7,3,1,3,51,28
20180519-M-Rome_Masters-SF-Rafael_Nadal-Novak_Djokovic,1,F-DTM,9,0,0,0,0,5,4
20180519-M-Rome_Masters-SF-Rafael_Nadal-Novak_Djokovic,1,F-DTL,16,7,2,3,2,10,6
20180519-M-Rome_Masters-SF-Rafael_Nadal-Novak_Djokovic,1,F-IO,19,9,6,1,2,13,6
20180519-M-Rome_Masters-SF-Rafael_Nadal-Novak_Djokovic,1,F-II,5,0,0,0,0,3,2
20180519-M-Rome_Masters-SF-Rafael_Nadal-Novak_Djokovic,1,B-XC,48,8,1,4,3,31,17
20180519-M-Rome_Masters-SF-Rafael_Nadal-Novak_Djokovic,1,B-DTM,8,2,0,1,1,5,3
20180519-M-Rome_Masters-SF-Rafael_Nadal-Novak_Djokovic,1,B-DTL,19,4,2,0,2,11,8
20180519-M-Rome_Masters-SF-Rafael_Nadal-Novak_Djokovic,1,B-IO,4,1,0,1,0,4,0
20180519-M-Rome_Masters-SF-Rafael_Nadal-Novak_Djokovic,1,S-XC,4,1,1,0,0,2,2
20180519-M-Rome_Masters-SF-Rafael_Nadal-Novak_Djokovic,1,S-DTM,4,0,0,0,0,2,2
20180519-M-Rome_Masters-SF-Rafael_Nadal-Novak_Djokovic,1,S-DTL,6,0,0,0,0,1,5
20180519-M-Rome_Masters-SF-Rafael_Nadal-Novak_Djokovic,2,F-XC,44,4,2,1,1,22,22
20180519-M-Rome_Masters-SF-Rafael_Nadal-Novak_Djokovic,2,F-DTM,16,1,0,0,1,5,11
20180519-M-Rome_Masters-SF-Rafael_Nadal-Novak_Djokovic,2,F-DTL,18,2,1,0,1,8,10
20180519-M-Rome_Masters-SF-Rafael_Nadal-Novak_Djokovic,2,F-IO,22,8,2,3,3,10,12
20180519-M-Rome_Masters-SF-Rafael_Nadal-Novak_Djokovic,2,F-II,6,4,3,1,0,4,2
20180519-M-Rome_Masters-SF-Rafael_Nadal-Novak_Djokovic,2,B-XC,50,8,3,2,3,20,30
20180519-M-Rome_Masters-SF-Rafael_Nadal-Novak_Djokovic,2,B-DTM,17,3,0,0,3,4,13
20180519-M-Rome_Masters-SF-Rafael_Nadal-Novak_Djokovic,2,B-DTL,40,10,2,1,7,15,25
20180519-M-Rome_Masters-SF-Rafael_Nadal-Novak_Djokovic,2,B-IO,1,0,0,0,0,1,0
20180519-M-Rome_Masters-SF-Rafael_Nadal-Novak_Djokovic,2,S-DTM,3,0,0,0,0,0,3
20180519-M-Rome_Masters-SF-Rafael_Nadal-Novak_Djokovic,2,S-DTL,1,0,0,0,0,1,0
19920815-M-Cincinnati_Masters-SF-Michael_Chang-Ivan_Lendl,1,F-XC,18,2,0,1,1,8,10
19920815-M-Cincinnati_Masters-SF-Michael_Chang-Ivan_Lendl,1,F-DTM,11,0,0,0,0,5,6
19920815-M-Cincinnati_Masters-SF-Michael_Chang-Ivan_Lendl,1,F-DTL,23,5,2,1,2,9,14
19920815-M-Cincinnati_Masters-SF-Michael_Chang-Ivan_Lendl,1,F-IO,30,3,0,0,3,9,21
19920815-M-Cincinnati_Masters-SF-Michael_Chang-Ivan_Lendl,1,F-II,20,7,1,3,3,8,12
19920815-M-Cincinnati_Masters-SF-Michael_Chang-Ivan_Lendl,1,B-XC,90,7,0,3,4,36,54
19920815-M-Cincinnati_Masters-SF-Michael_Chang-Ivan_Lendl,1,B-DTM,9,1,0,0,1,4,5
19920815-M-Cincinnati_Masters-SF-Michael_Chang-Ivan_Lendl,1,B-DTL,13,5,0,2,3,9,4
19920815-M-Cincinnati_Masters-SF-Michael_Chang-Ivan_Lendl,1,B-IO,1,1,0,1,0,1,0
19920815-M-Cincinnati_Masters-SF-Michael_Chang-Ivan_Lendl,1,S-XC,4,1,0,0,1,0,4
19920815-M-Cincinnati_Masters-SF-Michael_Chang-Ivan_Lendl,1,S-DTM,1,0,0,0,0,0,1
19920815-M-Cincinnati_Masters-SF-Michael_Chang-Ivan_Lendl,1,S-DTL,2,1,0,0,1,1,1
19920815-M-Cincinnati_Masters-SF-Michael_Chang-Ivan_Lendl,2,F-XC,35,6,1,1,4,18,17
19920815-M-Cincinnati_Masters-SF-Michael_Chang-Ivan_Lendl,2,F-DTM,4,0,0,0,0,3,1
19920815-M-Cincinnati_Masters-SF-Michael_Chang-Ivan_Lendl,2,F-DTL,14,4,1,1,2,7,7
19920815-M-Cincinnati_Masters-SF-Michael_Chang-Ivan_Lendl,2,F-IO,19,4,1,3,0,13,6
19920815-M-Cincinnati_Masters-SF-Michael_Chang-Ivan_Lendl,2,F-II,9,6,3,0,3,5,4
19920815-M-Cincinnati_Masters-SF-Michael_Chang-Ivan_Lendl,2,B-XC,27,3,2,0,1,19,8
19920815-M-Cincinnati_Masters-SF-Michael_Chang-Ivan_Lendl,2,B-DTM,2,0,0,0,0,1,1
19920815-M-Cincinnati_Masters-SF-Michael_Chang-Ivan_Lendl,2,B-DTL,8,4,1,1,2,3,5
19920815-M-Cincinnati_Masters-SF-Michael_Chang-Ivan_Lendl,2,B-IO,1,0,0,0,0,1,0
19920815-M-Cincinnati_Masters-SF-Michael_Chang-Ivan_Lendl,2,S-XC,91,3,0,1,2,53,38
19920815-M-Cincinnati_Masters-SF-Michael_Chang-Ivan_Lendl,2,S-DTM,10,2,0,0,2,5,5
19920815-M-Cincinnati_Masters-SF-Michael_Chang-Ivan_Lendl,2,S-DTL,3,0,0,0,0,1,2
19920815-M-Cincinnati_Masters-SF-Pete_Sampras-Stefan_Edberg,1,F-XC,5,1,0,1,0,2,3
19920815-M-Cincinnati_Masters-SF-Pete_Sampras-Stefan_Edberg,1,F-DTM,3,1,0,1,0,2,1
19920815-M-Cincinnati_Masters-SF-Pete_Sampras-Stefan_Edberg,1,F-DTL,3,1,0,1,0,2,1
19920815-M-Cincinnati_Masters-SF-Pete_Sampras-Stefan_Edberg,1,F-IO,8,2,0,1,1,5,3
19920815-M-Cincinnati_Masters-SF-Pete_Sampras-Stefan_Edberg,1,B-XC,8,2,0,0,2,2,6
19920815-M-Cincinnati_Masters-SF-Pete_Sampras-Stefan_Edberg,1,B-DTM,5,1,0,0,1,2,3
19920815-M-Cincinnati_Masters-SF-Pete_Sampras-Stefan_Edberg,1,B-DTL,3,2,0,1,1,1,2
19920815-M-Cincinnati_Masters-SF-Pete_Sampras-Stefan_Edberg,1,B-IO,2,2,1,1,0,2,0
19920815-M-Cincinnati_Masters-SF-Pete_Sampras-Stefan_Edberg,1,S-XC,4,2,1,1,0,3,1
19920815-M-Cincinnati_Masters-SF-Pete_Sampras-Stefan_Edberg,1,S-DTL,2,1,1,0,0,1,1
19920815-M-Cincinnati_Masters-SF-Pete_Sampras-Stefan_Edberg,2,F-XC,6,1,1,0,0,4,2
19920815-M-Cincinnati_Masters-SF-Pete_Sampras-Stefan_Edberg,2,F-DTM,2,0,0,0,0,1,1
19920815-M-Cincinnati_Masters-SF-Pete_Sampras-Stefan_Edberg,2,F-DTL,5,1,0,0,1,2,3
19920815-M-Cincinnati_Masters-SF-Pete_Sampras-Stefan_Edberg,2,F-IO,5,1,0,1,0,2,3
19920815-M-Cincinnati_Masters-SF-Pete_Sampras-Stefan_Edberg,2,B-XC,10,2,2,0,0,7,3
19920815-M-Cincinnati_Masters-SF-Pete_Sampras-Stefan_Edberg,2,B-DTM,4,1,0,0,1,0,4
19920815-M-Cincinnati_Masters-SF-Pete_Sampras-Stefan_Edberg,2,B-DTL,7,6,3,1,2,4,3
19920815-M-Cincinnati_Masters-SF-Pete_Sampras-Stefan_Edberg,2,B-IO,1,0,0,0,0,1,0
19920815-M-Cincinnati_Masters-SF-Pete_Sampras-Stefan_Edberg,2,S-XC,4,0,0,0,0,1,3
19920815-M-Cincinnati_Masters-SF-Pete_Sampras-Stefan_Edberg,2,S-DTM,1,0,0,0,0,0,1
19920816-M-Cincinnati_Masters-F-Pete_Sampras-Ivan_Lendl,1,F-XC,16,5,0,1,4,9,7
19920816-M-Cincinnati_Masters-F-Pete_Sampras-Ivan_Lendl,1,F-DTM,8,1,0,1,0,3,5
19920816-M-Cincinnati_Masters-F-Pete_Sampras-Ivan_Lendl,1,F-DTL,6,3,1,1,1,4,2
19920816-M-Cincinnati_Masters-F-Pete_Sampras-Ivan_Lendl,1,F-IO,31,8,3,1,4,14,17
19920816-M-Cincinnati_Masters-F-Pete_Sampras-Ivan_Lendl,1,F-II,4,2,1,0,1,2,2
19920816-M-Cincinnati_Masters-F-Pete_Sampras-Ivan_Lendl,1,B-XC,30,3,2,0,1,14,16
19920816-M-Cincinnati_Masters-F-Pete_Sampras-Ivan_Lendl,1,B-DTM,12,0,0,0,0,3,9
19920816-M-Cincinnati_Masters-F-Pete_Sampras-Ivan_Lendl,1,B-DTL,4,3,1,0,2,1,3
19920816-M-Cincinnati_Masters-F-Pete_Sampras-Ivan_Lendl,1,B-IO,1,0,0,0,0,0,1
19920816-M-Cincinnati_Masters-F-Pete_Sampras-Ivan_Lendl,1,S-XC,8,1,0,0,1,5,3
19920816-M-Cincinnati_Masters-F-Pete_Sampras-Ivan_Lendl,1,S-DTM,3,0,0,0,0,2,1
19920816-M-Cincinnati_Masters-F-Pete_Sampras-Ivan_Lendl,1,S-DTL,3,2,1,0,1,1,2
19920816-M-Cincinnati_Masters-F-Pete_Sampras-Ivan_Lendl,2,F-XC,29,12,2,4,6,13,16
19920816-M-Cincinnati_Masters-F-Pete_Sampras-Ivan_Lendl,2,F-DTM,10,1,0,0,1,4,6
19920816-M-Cincinnati_Masters-F-Pete_Sampras-Ivan_Lendl,2,F-DTL,10,4,2,1,1,7,3
19920816-M-Cincinnati_Masters-F-Pete_Sampras-Ivan_Lendl,2,F-IO,26,5,1,2,2,12,14
19920816-M-Cincinnati_Masters-F-Pete_Sampras-Ivan_Lendl,2,F-II,5,3,0,0,3,2,3
19920816-M-Cincinnati_Masters-F-Pete_Sampras-Ivan_Lendl,2,B-XC,25,5,0,0,5,13,12
19920816-M-Cincinnati_Masters-F-Pete_Sampras-Ivan_Lendl,2,B-DTM,7,0,0,0,0,1,6
19920816-M-Cincinnati_Masters-F-Pete_Sampras-Ivan_Lendl,2,B-DTL,7,5,4,0,1,4,3
19920816-M-Cincinnati_Masters-F-Pete_Sampras-Ivan_Lendl,2,S-XC,24,1,0,0,1,16,8
19920816-M-Cincinnati_Masters-F-Pete_Sampras-Ivan_Lendl,2,S-DTM,3,0,0,0,0,1,2
19920816-M-Cincinnati_Masters-F-Pete_Sampras-Ivan_Lendl,2,S-DTL,7,3,1,1,1,3,4
19930814-M-Cincinnati_Masters-SF-Michael_Chang-Andre_Agassi,1,F-XC,69,11,7,1,3,43,26
19930814-M-Cincinnati_Masters-SF-Michael_Chang-Andre_Agassi,1,F-DTM,10,1,0,0,1,6,4
19930814-M-Cincinnati_Masters-SF-Michael_Chang-Andre_Agassi,1,F-DTL,16,11,6,1,4,11,5
19930814-M-Cincinnati_Masters-SF-Michael_Chang-Andre_Agassi,1,F-IO,8,1,0,1,0,6,2
19930814-M-Cincinnati_Masters-SF-Michael_Chang-Andre_Agassi,1,F-II,6,3,1,2,0,5,1
19930814-M-Cincinnati_Masters-SF-Michael_Chang-Andre_Agassi,1,B-XC,38,8,0,2,6,22,16
19930814-M-Cincinnati_Masters-SF-Michael_Chang-Andre_Agassi,1,B-DTM,20,1,0,0,1,9,11
19930814-M-Cincinnati_Masters-SF-Michael_Chang-Andre_Agassi,1,B-DTL,19,4,1,1,2,11,8
19930814-M-Cincinnati_Masters-SF-Michael_Chang-Andre_Agassi,1,B-IO,6,1,0,0,1,1,5
19930814-M-Cincinnati_Masters-SF-Michael_Chang-Andre_Agassi,1,B-II,1,1,1,0,0,1,0
19930814-M-Cincinnati_Masters-SF-Michael_Chang-Andre_Agassi,1,S-XC,2,0,0,0,0,1,1
19930814-M-Cincinnati_Masters-SF-Michael_Chang-Andre_Agassi,1,S-DTM,3,0,0,0,0,1,2
19930814-M-Cincinnati_Masters-SF-Michael_Chang-Andre_Agassi,1,S-DTL,2,0,0,0,0,1,1
19930814-M-Cincinnati_Masters-SF-Michael_Chang-Andre_Agassi,2,F-XC,66,10,3,4,3,30,36
19930814-M-Cincinnati_Masters-SF-Michael_Chang-Andre_Agassi,2,F-DTM,14,0,0,0,0,6,8
19930814-M-Cincinnati_Masters-SF-Michael_Chang-Andre_Agassi,2,F-DTL,33,9,2,2,5,15,18
19930814-M-Cincinnati_Masters-SF-Michael_Chang-Andre_Agassi,2,F-IO,18,5,0,2,3,8,10
19930814-M-Cincinnati_Masters-SF-Michael_Chang-Andre_Agassi,2,F-II,5,4,0,2,2,2,3
19930814-M-Cincinnati_Masters-SF-Michael_Chang-Andre_Agassi,2,B-XC,32,1,0,0,1,12,20
19930814-M-Cincinnati_Masters-SF-Michael_Chang-Andre_Agassi,2,B-DTM,8,0,0,0,0,3,5
19930814-M-Cincinnati_Masters-SF-Michael_Chang-Andre_Agassi,2,B-DTL,13,3,1,0,2,2,11
19930814-M-Cincinnati_Masters-SF-Michael_Chang-Andre_Agassi,2,S-XC,5,2,0,0,2,1,4
19930814-M-Cincinnati_Masters-SF-Michael_Chang-Andre_Agassi,2,S-DTM,1,0,0,0,0,0,1
19930814-M-Cincinnati_Masters-SF-Michael_Chang-Andre_Agassi,2,S-DTL,2,1,1,0,0,1,1
19930815-M-Cincinnati_Masters-F-Stefan_Edberg-Michael_Chang,1,F-XC,13,5,2,1,2,6,7
19930815-M-Cincinnati_Masters-F-Stefan_Edberg-Michael_Chang,1,F-DTM,5,1,0,0,1,3,2
19930815-M-Cincinnati_Masters-F-Stefan_Edberg-Michael_Chang,1,F-DTL,10,3,0,0,3,3,7
19930815-M-Cincinnati_Masters-F-Stefan_Edberg-Michael_Chang,1,F-IO,4,1,1,0,0,1,3
19930815-M-Cincinnati_Masters-F-Stefan_Edberg-Michael_Chang,1,B-XC,13,4,2,1,1,7,6
19930815-M-Cincinnati_Masters-F-Stefan_Edberg-Michael_Chang,1,B-DTM,2,0,0,0,0,1,1
19930815-M-Cincinnati_Masters-F-Stefan_Edberg-Michael_Chang,1,B-DTL,3,2,1,0,1,2,1
19930815-M-Cincinnati_Masters-F-Stefan_Edberg-Michael_Chang,1,B-IO,5,3,0,0,3,2,3
19930815-M-Cincinnati_Masters-F-Stefan_Edberg-Michael_Chang,1,S-XC,10,2,0,0,2,2,8
19930815-M-Cincinnati_Masters-F-Stefan_Edberg-Michael_Chang,1,S-DTM,5,1,0,0,1,2,3
19930815-M-Cincinnati_Masters-F-Stefan_Edberg-Michael_Chang,1,S-DTL,2,1,0,1,0,1,1
19930815-M-Cincinnati_Masters-F-Stefan_Edberg-Michael_Chang,2,F-XC,25,9,5,0,4,13,12
19930815-M-Cincinnati_Masters-F-Stefan_Edberg-Michael_Chang,2,F-DTM,11,0,0,0,0,7,4
19930815-M-Cincinnati_Masters-F-Stefan_Edberg-Michael_Chang,2,F-DTL,11,5,2,3,0,6,5
19930815-M-Cincinnati_Masters-F-Stefan_Edberg-Michael_Chang,2,F-IO,16,6,2,2,2,12,4
19930815-M-Cincinnati_Masters-F-Stefan_Edberg-Michael_Chang,2,B-XC,24,5,2,1,2,10,14
19930815-M-Cincinnati_Masters-F-Stefan_Edberg-Michael_Chang,2,B-DTM,13,1,0,0,1,8,5
19930815-M-Cincinnati_Masters-F-Stefan_Edberg-Michael_Chang,2,B-DTL,12,2,0,1,1,5,7
19930815-M-Cincinnati_Masters-F-Stefan_Edberg-Michael_Chang,2,B-IO,5,2,0,0,2,2,3
19930815-M-Cincinnati_Masters-F-Stefan_Edberg-Michael_Chang,2,S-XC,2,1,0,0,1,0,2
19930815-M-Cincinnati_Masters-F-Stefan_Edberg-Michael_Chang,2,S-DTM,1,0,0,0,0,1,0
19930815-M-Cincinnati_Masters-F-Stefan_Edberg-Michael_Chang,2,S-DTL,2,0,0,0,0,2,0
19930814-M-Cincinnati_Masters-SF-Stefan_Edberg-Pete_Sampras,1,F-XC,2,1,0,0,1,1,1
19930814-M-Cincinnati_Masters-SF-Stefan_Edberg-Pete_Sampras,1,F-DTM,2,1,0,0,1,0,2
19930814-M-Cincinnati_Masters-SF-Stefan_Edberg-Pete_Sampras,1,F-DTL,3,1,0,1,0,3,0
19930814-M-Cincinnati_Masters-SF-Stefan_Edberg-Pete_Sampras,1,F-IO,1,1,1,0,0,1,0
19930814-M-Cincinnati_Masters-SF-Stefan_Edberg-Pete_Sampras,1,B-XC,8,4,1,1,2,5,3
19930814-M-Cincinnati_Masters-SF-Stefan_Edberg-Pete_Sampras,1,B-DTM,2,0,0,0,0,1,1
19930814-M-Cincinnati_Masters-SF-Stefan_Edberg-Pete_Sampras,1,B-DTL,4,3,2,0,1,2,2
19930814-M-Cincinnati_Masters-SF-Stefan_Edberg-Pete_Sampras,1,B-IO,1,1,0,1,0,1,0
19930814-M-Cincinnati_Masters-SF-Stefan_Edberg-Pete_Sampras,1,S-XC,2,1,0,0,1,1,1
19930814-M-Cincinnati_Masters-SF-Stefan_Edberg-Pete_Sampras,1,S-DTM,1,1,0,0,1,0,1
19930814-M-Cincinnati_Masters-SF-Stefan_Edberg-Pete_Sampras,1,S-DTL,2,0,0,0,0,1,1
19930814-M-Cincinnati_Masters-SF-Stefan_Edberg-Pete_Sampras,2,F-XC,10,7,4,2,1,8,2
19930814-M-Cincinnati_Masters-SF-Stefan_Edberg-Pete_Sampras,2,F-DTM,5,1,0,1,0,3,2
19930814-M-Cincinnati_Masters-SF-Stefan_Edberg-Pete_Sampras,2,F-DTL,2,1,1,0,0,2,0
19930814-M-Cincinnati_Masters-SF-Stefan_Edberg-Pete_Sampras,2,F-IO,3,2,0,1,1,2,1
19930814-M-Cincinnati_Masters-SF-Stefan_Edberg-Pete_Sampras,2,B-XC,13,5,2,1,2,4,9
19930814-M-Cincinnati_Masters-SF-Stefan_Edberg-Pete_Sampras,2,B-DTM,4,0,0,0,0,0,4
19930814-M-Cincinnati_Masters-SF-Stefan_Edberg-Pete_Sampras,2,B-DTL,6,6,3,0,3,3,3
19930814-M-Cincinnati_Masters-SF-Stefan_Edberg-Pete_Sampras,2,B-IO,4,3,1,1,1,2,2
19930814-M-Cincinnati_Masters-SF-Stefan_Edberg-Pete_Sampras,2,S-XC,1,0,0,0,0,0,1
19930814-M-Cincinnati_Masters-SF-Stefan_Edberg-Pete_Sampras,2,S-DTM,1,0,0,0,0,0,1
19930814-M-Cincinnati_Masters-SF-Stefan_Edberg-Pete_Sampras,2,S-DTL,2,1,0,0,1,0,2
19980802-M-Kitzbuhel-SF-Andrea_Gaudenzi-Francisco_Clavet,1,F-XC,59,5,3,0,2,31,28
19980802-M-Kitzbuhel-SF-Andrea_Gaudenzi-Francisco_Clavet,1,F-DTM,17,1,0,0,1,6,11
19980802-M-Kitzbuhel-SF-Andrea_Gaudenzi-Francisco_Clavet,1,F-DTL,9,3,2,1,0,8,1
19980802-M-Kitzbuhel-SF-Andrea_Gaudenzi-Francisco_Clavet,1,F-IO,34,13,1,7,5,20,14
19980802-M-Kitzbuhel-SF-Andrea_Gaudenzi-Francisco_Clavet,1,F-II,8,0,0,0,0,4,4
19980802-M-Kitzbuhel-SF-Andrea_Gaudenzi-Francisco_Clavet,1,B-XC,55,6,0,2,4,29,26
19980802-M-Kitzbuhel-SF-Andrea_Gaudenzi-Francisco_Clavet,1,B-DTM,32,2,0,0,2,14,18
19980802-M-Kitzbuhel-SF-Andrea_Gaudenzi-Francisco_Clavet,1,B-DTL,38,15,3,2,10,16,22
19980802-M-Kitzbuhel-SF-Andrea_Gaudenzi-Francisco_Clavet,1,B-IO,3,0,0,0,0,2,1
19980802-M-Kitzbuhel-SF-Andrea_Gaudenzi-Francisco_Clavet,1,S-DTL,6,0,0,0,0,4,2
19980802-M-Kitzbuhel-SF-Andrea_Gaudenzi-Francisco_Clavet,1,S-IO,2,1,0,1,0,2,0
19980802-M-Kitzbuhel-SF-Andrea_Gaudenzi-Francisco_Clavet,2,F-XC,78,8,1,2,5,37,41
19980802-M-Kitzbuhel-SF-Andrea_Gaudenzi-Francisco_Clavet,2,F-DTM,33,2,0,1,1,18,15
19980802-M-Kitzbuhel-SF-Andrea_Gaudenzi-Francisco_Clavet,2,F-DTL,13,5,3,1,1,7,6
19980802-M-Kitzbuhel-SF-Andrea_Gaudenzi-Francisco_Clavet,2,F-IO,21,6,1,1,4,7,14
19980802-M-Kitzbuhel-SF-Andrea_Gaudenzi-Francisco_Clavet,2,F-II,4,1,0,1,0,3,1
19980802-M-Kitzbuhel-SF-Andrea_Gaudenzi-Francisco_Clavet,2,B-XC,26,5,2,1,2,12,14
19980802-M-Kitzbuhel-SF-Andrea_Gaudenzi-Francisco_Clavet,2,B-DTM,48,2,0,1,1,28,20
19980802-M-Kitzbuhel-SF-Andrea_Gaudenzi-Francisco_Clavet,2,B-DTL,21,1,0,0,1,9,12
19980802-M-Kitzbuhel-SF-Andrea_Gaudenzi-Francisco_Clavet,2,B-IO,12,1,0,0,1,8,4
19980802-M-Kitzbuhel-SF-Andrea_Gaudenzi-Francisco_Clavet,2,S-XC,4,2,1,1,0,3,1
19980802-M-Kitzbuhel-SF-Andrea_Gaudenzi-Francisco_Clavet,2,S-DTM,1,0,0,0,0,0,1
19980802-M-Kitzbuhel-SF-Andrea_Gaudenzi-Francisco_Clavet,2,S-DTL,4,0,0,0,0,2,2
20180520-M-Rome_Masters-F-Rafael_Nadal-Alexander_Zverev,1,F-XC,73,6,0,2,4,42,31
20180520-M-Rome_Masters-F-Rafael_Nadal-Alexander_Zverev,1,F-DTM,20,0,0,0,0,9,11
20180520-M-Rome_Masters-F-Rafael_Nadal-Alexander_Zverev,1,F-DTL,9,3,1,0,2,4,5
20180520-M-Rome_Masters-F-Rafael_Nadal-Alexander_Zverev,1,F-IO,19,9,4,1,4,11,8
20180520-M-Rome_Masters-F-Rafael_Nadal-Alexander_Zverev,1,F-II,10,2,0,1,1,5,5
20180520-M-Rome_Masters-F-Rafael_Nadal-Alexander_Zverev,1,B-XC,71,11,1,6,4,42,29
20180520-M-Rome_Masters-F-Rafael_Nadal-Alexander_Zverev,1,B-DTM,26,2,0,1,1,12,14
20180520-M-Rome_Masters-F-Rafael_Nadal-Alexander_Zverev,1,B-DTL,12,4,2,2,0,8,4
20180520-M-Rome_Masters-F-Rafael_Nadal-Alexander_Zverev,1,B-IO,3,1,0,1,0,2,1
20180520-M-Rome_Masters-F-Rafael_Nadal-Alexander_Zverev,1,S-XC,7,0,0,0,0,5,2
20180520-M-Rome_Masters-F-Rafael_Nadal-Alexander_Zverev,1,S-DTM,9,0,0,0,0,6,3
20180520-M-Rome_Masters-F-Rafael_Nadal-Alexander_Zverev,1,S-DTL,5,0,0,0,0,3,2
20180520-M-Rome_Masters-F-Rafael_Nadal-Alexander_Zverev,1,S-IO,2,0,0,0,0,2,0
20180520-M-Rome_Masters-F-Rafael_Nadal-Alexander_Zverev,2,F-XC,89,8,1,3,4,43,46
20180520-M-Rome_Masters-F-Rafael_Nadal-Alexander_Zverev,2,F-DTM,24,1,0,0,1,10,14
20180520-M-Rome_Masters-F-Rafael_Nadal-Alexander_Zverev,2,F-DTL,17,7,2,0,5,7,10
20180520-M-Rome_Masters-F-Rafael_Nadal-Alexander_Zverev,2,F-IO,14,6,2,2,2,6,8
20180520-M-Rome_Masters-F-Rafael_Nadal-Alexander_Zverev,2,F-II,4,2,0,1,1,1,3
20180520-M-Rome_Masters-F-Rafael_Nadal-Alexander_Zverev,2,B-XC,43,6,1,1,4,22,21
20180520-M-Rome_Masters-F-Rafael_Nadal-Alexander_Zverev,2,B-DTM,29,3,0,2,1,9,20
20180520-M-Rome_Masters-F-Rafael_Nadal-Alexander_Zverev,2,B-DTL,20,6,3,2,1,10,10
20180520-M-Rome_Masters-F-Rafael_Nadal-Alexander_Zverev,2,B-IO,12,0,0,0,0,6,6
20180520-M-Rome_Masters-F-Rafael_Nadal-Alexander_Zverev,2,S-XC,1,1,0,1,0,1,0
20180520-M-Rome_Masters-F-Rafael_Nadal-Alexander_Zverev,2,S-DTM,1,0,0,0,0,0,1
20180520-M-Rome_Masters-F-Rafael_Nadal-Alexander_Zverev,2,S-DTL,1,0,0,0,0,0,1
20081114-M-Masters_Cup-RR-Roger_Federer-Andy_Murray,1,F-XC,53,16,2,3,11,22,31
20081114-M-Masters_Cup-RR-Roger_Federer-Andy_Murray,1,F-DTM,37,2,1,0,1,21,16
20081114-M-Masters_Cup-RR-Roger_Federer-Andy_Murray,1,F-DTL,28,8,1,2,5,16,12
20081114-M-Masters_Cup-RR-Roger_Federer-Andy_Murray,1,F-IO,33,8,4,1,3,18,15
20081114-M-Masters_Cup-RR-Roger_Federer-Andy_Murray,1,F-II,10,5,1,2,2,6,4
20081114-M-Masters_Cup-RR-Roger_Federer-Andy_Murray,1,B-XC,74,10,2,2,6,32,42
20081114-M-Masters_Cup-RR-Roger_Federer-Andy_Murray,1,B-DTM,35,2,0,0,2,11,24
20081114-M-Masters_Cup-RR-Roger_Federer-Andy_Murray,1,B-DTL,27,8,3,1,4,11,16
20081114-M-Masters_Cup-RR-Roger_Federer-Andy_Murray,1,B-IO,9,2,0,2,0,4,5
20081114-M-Masters_Cup-RR-Roger_Federer-Andy_Murray,1,S-XC,65,0,0,0,0,29,36
20081114-M-Masters_Cup-RR-Roger_Federer-Andy_Murray,1,S-DTM,20,1,0,0,1,5,15
20081114-M-Masters_Cup-RR-Roger_Federer-Andy_Murray,1,S-DTL,9,1,0,1,0,2,7
20081114-M-Masters_Cup-RR-Roger_Federer-Andy_Murray,2,F-XC,63,12,3,6,3,34,29
20081114-M-Masters_Cup-RR-Roger_Federer-Andy_Murray,2,F-DTM,46,4,0,2,2,25,21
20081114-M-Masters_Cup-RR-Roger_Federer-Andy_Murray,2,F-DTL,26,4,0,2,2,14,12
20081114-M-Masters_Cup-RR-Roger_Federer-Andy_Murray,2,F-IO,46,4,1,3,0,26,20
20081114-M-Masters_Cup-RR-Roger_Federer-Andy_Murray,2,F-II,8,5,2,1,2,5,3
20081114-M-Masters_Cup-RR-Roger_Federer-Andy_Murray,2,B-XC,115,14,5,4,5,71,44
20081114-M-Masters_Cup-RR-Roger_Federer-Andy_Murray,2,B-DTM,35,1,0,0,1,12,23
20081114-M-Masters_Cup-RR-Roger_Federer-Andy_Murray,2,B-DTL,21,8,1,4,3,11,10
20081114-M-Masters_Cup-RR-Roger_Federer-Andy_Murray,2,B-IO,6,2,0,0,2,4,2
20081114-M-Masters_Cup-RR-Roger_Federer-Andy_Murray,2,S-XC,30,3,0,2,1,16,14
20081114-M-Masters_Cup-RR-Roger_Federer-Andy_Murray,2,S-DTM,6,0,0,0,0,3,3
20081114-M-Masters_Cup-RR-Roger_Federer-Andy_Murray,2,S-DTL,9,1,0,0,1,2,7
20081114-M-Masters_Cup-RR-Roger_Federer-Andy_Murray,2,S-IO,3,0,0,0,0,2,1
19930509-M-Hamburg_Masters-F-Michael_Stich-Andrei_Chesnokov,1,F-XC,37,11,0,3,8,11,26
19930509-M-Hamburg_Masters-F-Michael_Stich-Andrei_Chesnokov,1,F-DTM,46,6,1,0,5,19,27
19930509-M-Hamburg_Masters-F-Michael_Stich-Andrei_Chesnokov,1,F-DTL,14,5,1,0,4,5,9
19930509-M-Hamburg_Masters-F-Michael_Stich-Andrei_Chesnokov,1,F-IO,16,8,2,1,5,5,11
19930509-M-Hamburg_Masters-F-Michael_Stich-Andrei_Chesnokov,1,B-XC,13,4,2,0,2,6,7
19930509-M-Hamburg_Masters-F-Michael_Stich-Andrei_Chesnokov,1,B-DTM,19,7,1,3,3,9,10
19930509-M-Hamburg_Masters-F-Michael_Stich-Andrei_Chesnokov,1,B-DTL,3,2,0,1,1,1,2
19930509-M-Hamburg_Masters-F-Michael_Stich-Andrei_Chesnokov,1,B-IO,3,3,1,1,1,2,1
19930509-M-Hamburg_Masters-F-Michael_Stich-Andrei_Chesnokov,1,S-XC,21,1,0,0,1,10,11
19930509-M-Hamburg_Masters-F-Michael_Stich-Andrei_Chesnokov,1,S-DTM,13,2,0,0,2,5,8
19930509-M-Hamburg_Masters-F-Michael_Stich-Andrei_Chesnokov,1,S-DTL,1,0,0,0,0,0,1
19930509-M-Hamburg_Masters-F-Michael_Stich-Andrei_Chesnokov,1,S-IO,2,2,0,2,0,2,0
19930509-M-Hamburg_Masters-F-Michael_Stich-Andrei_Chesnokov,2,F-XC,42,13,7,5,1,30,12
19930509-M-Hamburg_Masters-F-Michael_Stich-Andrei_Chesnokov,2,F-DTM,33,4,0,3,1,18,15
19930509-M-Hamburg_Masters-F-Michael_Stich-Andrei_Chesnokov,2,F-DTL,14,7,1,5,1,9,5
19930509-M-Hamburg_Masters-F-Michael_Stich-Andrei_Chesnokov,2,F-IO,20,7,3,0,4,7,13
19930509-M-Hamburg_Masters-F-Michael_Stich-Andrei_Chesnokov,2,B-XC,49,18,6,7,5,31,18
19930509-M-Hamburg_Masters-F-Michael_Stich-Andrei_Chesnokov,2,B-DTM,56,4,0,2,2,39,17
19930509-M-Hamburg_Masters-F-Michael_Stich-Andrei_Chesnokov,2,B-DTL,23,10,3,5,2,15,8
19930509-M-Hamburg_Masters-F-Michael_Stich-Andrei_Chesnokov,2,B-IO,20,7,2,2,3,12,8
19930509-M-Hamburg_Masters-F-Michael_Stich-Andrei_Chesnokov,2,S-XC,1,0,0,0,0,0,1
19930509-M-Hamburg_Masters-F-Michael_Stich-Andrei_Chesnokov,2,S-DTM,2,0,0,0,0,2,0
19930509-M-Hamburg_Masters-F-Michael_Stich-Andrei_Chesnokov,2,S-DTL,5,0,0,0,0,2,3
19930509-M-Hamburg_Masters-F-Michael_Stich-Andrei_Chesnokov,2,S-IO,2,0,0,0,0,2,0
20070122-M-Australian_Open-R16-Roger_Federer-Novak_Djokovic,1,F-XC,51,19,12,4,3,34,17
20070122-M-Australian_Open-R16-Roger_Federer-Novak_Djokovic,1,F-DTM,26,4,2,0,2,14,12
20070122-M-Australian_Open-R16-Roger_Federer-Novak_Djokovic,1,F-DTL,15,5,1,2,2,7,8
20070122-M-Australian_Open-R16-Roger_Federer-Novak_Djokovic,1,F-IO,17,7,4,0,3,9,8
20070122-M-Australian_Open-R16-Roger_Federer-Novak_Djokovic,1,F-II,2,1,1,0,0,2,0
20070122-M-Australian_Open-R16-Roger_Federer-Novak_Djokovic,1,B-XC,29,6,2,1,3,10,19
20070122-M-Australian_Open-R16-Roger_Federer-Novak_Djokovic,1,B-DTM,28,2,0,0,2,14,14
20070122-M-Australian_Open-R16-Roger_Federer-Novak_Djokovic,1,B-DTL,13,3,0,0,3,8,5
20070122-M-Australian_Open-R16-Roger_Federer-Novak_Djokovic,1,B-IO,5,3,2,0,1,4,1
20070122-M-Australian_Open-R16-Roger_Federer-Novak_Djokovic,1,S-XC,11,0,0,0,0,2,9
20070122-M-Australian_Open-R16-Roger_Federer-Novak_Djokovic,1,S-DTM,11,0,0,0,0,8,3
20070122-M-Australian_Open-R16-Roger_Federer-Novak_Djokovic,1,S-DTL,1,0,0,0,0,1,0
20070122-M-Australian_Open-R16-Roger_Federer-Novak_Djokovic,1,S-IO,2,0,0,0,0,1,1
20070122-M-Australian_Open-R16-Roger_Federer-Novak_Djokovic,2,F-XC,45,7,0,2,5,21,24
20070122-M-Australian_Open-R16-Roger_Federer-Novak_Djokovic,2,F-DTM,25,4,0,1,3,9,16
20070122-M-Australian_Open-R16-Roger_Federer-Novak_Djokovic,2,F-DTL,13,3,1,0,2,5,8
20070122-M-Australian_Open-R16-Roger_Federer-Novak_Djokovic,2,F-IO,30,9,1,4,4,13,17
20070122-M-Australian_Open-R16-Roger_Federer-Novak_Djokovic,2,F-II,4,3,0,2,1,2,2
20070122-M-Australian_Open-R16-Roger_Federer-Novak_Djokovic,2,B-XC,42,8,2,2,4,26,16
20070122-M-Australian_Open-R16-Roger_Federer-Novak_Djokovic,2,B-DTM,37,2,0,0,2,17,20
20070122-M-Australian_Open-R16-Roger_Federer-Novak_Djokovic,2,B-DTL,10,4,2,1,1,7,3
20070122-M-Australian_Open-R16-Roger_Federer-Novak_Djokovic,2,B-IO,4,1,1,0,0,2,2
20070122-M-Australian_Open-R16-Roger_Federer-Novak_Djokovic,2,S-XC,4,0,0,0,0,2,2
20070122-M-Australian_Open-R16-Roger_Federer-Novak_Djokovic,2,S-DTM,2,0,0,0,0,1,1
20070122-M-Australian_Open-R16-Roger_Federer-Novak_Djokovic,2,S-DTL,1,0,0,0,0,1,0
20070122-M-Australian_Open-R16-Roger_Federer-Novak_Djokovic,2,S-IO,1,0,0,0,0,0,1
20150321-M-Indian_Wells_Masters-SF-Novak_Djokovic-Andy_Murray,1,F-XC,33,7,1,3,3,18,15
20150321-M-Indian_Wells_Masters-SF-Novak_Djokovic-Andy_Murray,1,F-DTM,30,2,0,0,2,14,16
20150321-M-Indian_Wells_Masters-SF-Novak_Djokovic-Andy_Murray,1,F-DTL,10,0,0,0,0,5,5
20150321-M-Indian_Wells_Masters-SF-Novak_Djokovic-Andy_Murray,1,F-IO,27,12,4,4,4,15,12
20150321-M-Indian_Wells_Masters-SF-Novak_Djokovic-Andy_Murray,1,F-II,1,0,0,0,0,0,1
20150321-M-Indian_Wells_Masters-SF-Novak_Djokovic-Andy_Murray,1,B-XC,49,10,1,5,4,30,19
20150321-M-Indian_Wells_Masters-SF-Novak_Djokovic-Andy_Murray,1,B-DTM,38,2,0,0,2,15,23
20150321-M-Indian_Wells_Masters-SF-Novak_Djokovic-Andy_Murray,1,B-DTL,13,5,1,1,3,7,6
20150321-M-Indian_Wells_Masters-SF-Novak_Djokovic-Andy_Murray,1,B-IO,7,1,0,1,0,7,0
20150321-M-Indian_Wells_Masters-SF-Novak_Djokovic-Andy_Murray,1,S-XC,8,0,0,0,0,5,3
20150321-M-Indian_Wells_Masters-SF-Novak_Djokovic-Andy_Murray,1,S-DTM,9,0,0,0,0,4,5
20150321-M-Indian_Wells_Masters-SF-Novak_Djokovic-Andy_Murray,1,S-IO,1,0,0,0,0,0,1
20150321-M-Indian_Wells_Masters-SF-Novak_Djokovic-Andy_Murray,2,F-XC,48,9,0,3,6,21,27
20150321-M-Indian_Wells_Masters-SF-Novak_Djokovic-Andy_Murray,2,F-DTM,17,4,1,1,2,10,7
20150321-M-Indian_Wells_Masters-SF-Novak_Djokovic-Andy_Murray,2,F-DTL,16,2,0,1,1,6,10
20150321-M-Indian_Wells_Masters-SF-Novak_Djokovic-Andy_Murray,2,F-IO,29,6,2,1,3,16,13
20150321-M-Indian_Wells_Masters-SF-Novak_Djokovic-Andy_Murray,2,F-II,4,1,0,1,0,2,2
20150321-M-Indian_Wells_Masters-SF-Novak_Djokovic-Andy_Murray,2,B-XC,39,7,0,3,4,20,19
20150321-M-Indian_Wells_Masters-SF-Novak_Djokovic-Andy_Murray,2,B-DTM,31,3,0,0,3,12,19
20150321-M-Indian_Wells_Masters-SF-Novak_Djokovic-Andy_Murray,2,B-DTL,9,3,2,0,1,5,4
20150321-M-Indian_Wells_Masters-SF-Novak_Djokovic-Andy_Murray,2,B-IO,9,2,0,0,2,5,4
20150321-M-Indian_Wells_Masters-SF-Novak_Djokovic-Andy_Murray,2,S-XC,13,0,0,0,0,6,7
20150321-M-Indian_Wells_Masters-SF-Novak_Djokovic-Andy_Murray,2,S-DTM,7,0,0,0,0,4,3
20150321-M-Indian_Wells_Masters-SF-Novak_Djokovic-Andy_Murray,2,S-DTL,1,0,0,0,0,0,1
20150321-M-Indian_Wells_Masters-SF-Novak_Djokovic-Andy_Murray,2,S-IO,1,0,0,0,0,1,0
20110504-M-Madrid_Masters-R32-Novak_Djokovic-Kevin_Anderson,1,F-XC,50,12,7,1,4,37,13
20110504-M-Madrid_Masters-R32-Novak_Djokovic-Kevin_Anderson,1,F-DTM,25,1,0,1,0,22,3
20110504-M-Madrid_Masters-R32-Novak_Djokovic-Kevin_Anderson,1,F-DTL,17,6,2,1,3,8,9
20110504-M-Madrid_Masters-R32-Novak_Djokovic-Kevin_Anderson,1,F-IO,27,4,2,2,0,16,11
20110504-M-Madrid_Masters-R32-Novak_Djokovic-Kevin_Anderson,1,F-II,2,2,1,1,0,2,0
20110504-M-Madrid_Masters-R32-Novak_Djokovic-Kevin_Anderson,1,B-XC,32,1,0,1,0,26,6
20110504-M-Madrid_Masters-R32-Novak_Djokovic-Kevin_Anderson,1,B-DTM,20,0,0,0,0,13,7
20110504-M-Madrid_Masters-R32-Novak_Djokovic-Kevin_Anderson,1,B-DTL,8,4,1,1,2,6,2
20110504-M-Madrid_Masters-R32-Novak_Djokovic-Kevin_Anderson,1,B-IO,9,2,0,0,2,6,3
20110504-M-Madrid_Masters-R32-Novak_Djokovic-Kevin_Anderson,1,S-XC,2,0,0,0,0,2,0
20110504-M-Madrid_Masters-R32-Novak_Djokovic-Kevin_Anderson,2,F-XC,42,6,1,3,2,12,30
20110504-M-Madrid_Masters-R32-Novak_Djokovic-Kevin_Anderson,2,F-DTM,29,4,0,0,4,7,22
20110504-M-Madrid_Masters-R32-Novak_Djokovic-Kevin_Anderson,2,F-DTL,14,6,1,1,4,3,11
20110504-M-Madrid_Masters-R32-Novak_Djokovic-Kevin_Anderson,2,F-IO,19,9,1,5,3,9,10
20110504-M-Madrid_Masters-R32-Novak_Djokovic-Kevin_Anderson,2,F-II,5,0,0,0,0,1,4
20110504-M-Madrid_Masters-R32-Novak_Djokovic-Kevin_Anderson,2,B-XC,31,4,0,0,4,10,21
20110504-M-Madrid_Masters-R32-Novak_Djokovic-Kevin_Anderson,2,B-DTM,34,1,0,0,1,11,23
20110504-M-Madrid_Masters-R32-Novak_Djokovic-Kevin_Anderson,2,B-DTL,13,7,3,2,2,6,7
20110504-M-Madrid_Masters-R32-Novak_Djokovic-Kevin_Anderson,2,B-IO,5,1,0,0,1,1,4
20110504-M-Madrid_Masters-R32-Novak_Djokovic-Kevin_Anderson,2,S-XC,3,0,0,0,0,1,2
20110504-M-Madrid_Masters-R32-Novak_Djokovic-Kevin_Anderson,2,S-DTM,6,0,0,0,0,1,5
20110504-M-Madrid_Masters-R32-Novak_Djokovic-Kevin_Anderson,2,S-DTL,1,0,0,0,0,0,1
20091129-M-Tour_Finals-F-Nikolay_Davydenko-Juan_Martin_Del_Potro,1,F-XC,30,7,5,2,0,23,7
20091129-M-Tour_Finals-F-Nikolay_Davydenko-Juan_Martin_Del_Potro,1,F-DTM,32,1,0,0,1,22,10
20091129-M-Tour_Finals-F-Nikolay_Davydenko-Juan_Martin_Del_Potro,1,F-DTL,5,2,1,1,0,3,2
20091129-M-Tour_Finals-F-Nikolay_Davydenko-Juan_Martin_Del_Potro,1,F-IO,21,5,2,0,3,17,4
20091129-M-Tour_Finals-F-Nikolay_Davydenko-Juan_Martin_Del_Potro,1,F-II,3,2,1,0,1,1,2
20091129-M-Tour_Finals-F-Nikolay_Davydenko-Juan_Martin_Del_Potro,1,B-XC,19,5,2,0,3,14,5
20091129-M-Tour_Finals-F-Nikolay_Davydenko-Juan_Martin_Del_Potro,1,B-DTM,37,3,1,1,1,26,11
20091129-M-Tour_Finals-F-Nikolay_Davydenko-Juan_Martin_Del_Potro,1,B-DTL,6,1,1,0,0,3,3
20091129-M-Tour_Finals-F-Nikolay_Davydenko-Juan_Martin_Del_Potro,1,B-IO,3,1,1,0,0,2,1
20091129-M-Tour_Finals-F-Nikolay_Davydenko-Juan_Martin_Del_Potro,1,S-XC,1,0,0,0,0,1,0
20091129-M-Tour_Finals-F-Nikolay_Davydenko-Juan_Martin_Del_Potro,1,S-DTM,3,0,0,0,0,1,2
20091129-M-Tour_Finals-F-Nikolay_Davydenko-Juan_Martin_Del_Potro,1,S-IO,1,0,0,0,0,1,0
20091129-M-Tour_Finals-F-Nikolay_Davydenko-Juan_Martin_Del_Potro,2,F-XC,29,7,3,1,3,11,18
20091129-M-Tour_Finals-F-Nikolay_Davydenko-Juan_Martin_Del_Potro,2,F-DTM,31,3,0,0,3,10,21
20091129-M-Tour_Finals-F-Nikolay_Davydenko-Juan_Martin_Del_Potro,2,F-DTL,3,2,1,0,1,2,1
20091129-M-Tour_Finals-F-Nikolay_Davydenko-Juan_Martin_Del_Potro,2,F-IO,20,9,4,2,3,12,8
20091129-M-Tour_Finals-F-Nikolay_Davydenko-Juan_Martin_Del_Potro,2,B-XC,17,3,0,2,1,5,12
20091129-M-Tour_Finals-F-Nikolay_Davydenko-Juan_Martin_Del_Potro,2,B-DTM,40,4,0,0,4,5,35
20091129-M-Tour_Finals-F-Nikolay_Davydenko-Juan_Martin_Del_Potro,2,B-DTL,3,2,0,0,2,1,2
20091129-M-Tour_Finals-F-Nikolay_Davydenko-Juan_Martin_Del_Potro,2,B-IO,4,3,0,1,2,2,2
20091129-M-Tour_Finals-F-Nikolay_Davydenko-Juan_Martin_Del_Potro,2,S-XC,9,1,0,0,1,3,6
20091129-M-Tour_Finals-F-Nikolay_Davydenko-Juan_Martin_Del_Potro,2,S-DTM,6,0,0,0,0,1,5
20140815-M-Cincinnati_Masters-QF-Andy_Murray-Roger_Federer,1,F-XC,26,8,1,4,3,13,13
20140815-M-Cincinnati_Masters-QF-Andy_Murray-Roger_Federer,1,F-DTM,20,1,0,0,1,11,9
20140815-M-Cincinnati_Masters-QF-Andy_Murray-Roger_Federer,1,F-DTL,16,2,2,0,0,9,7
20140815-M-Cincinnati_Masters-QF-Andy_Murray-Roger_Federer,1,F-IO,41,10,1,2,7,23,18
20140815-M-Cincinnati_Masters-QF-Andy_Murray-Roger_Federer,1,F-II,5,3,2,1,0,4,1
20140815-M-Cincinnati_Masters-QF-Andy_Murray-Roger_Federer,1,B-XC,53,7,2,1,4,18,35
20140815-M-Cincinnati_Masters-QF-Andy_Murray-Roger_Federer,1,B-DTM,23,1,0,0,1,10,13
20140815-M-Cincinnati_Masters-QF-Andy_Murray-Roger_Federer,1,B-DTL,9,5,1,0,4,3,6
20140815-M-Cincinnati_Masters-QF-Andy_Murray-Roger_Federer,1,B-IO,5,1,0,0,1,2,3
20140815-M-Cincinnati_Masters-QF-Andy_Murray-Roger_Federer,1,S-XC,14,1,0,0,1,3,11
20140815-M-Cincinnati_Masters-QF-Andy_Murray-Roger_Federer,1,S-DTM,5,0,0,0,0,4,1
20140815-M-Cincinnati_Masters-QF-Andy_Murray-Roger_Federer,1,S-DTL,1,0,0,0,0,1,0
20140815-M-Cincinnati_Masters-QF-Andy_Murray-Roger_Federer,1,S-IO,1,0,0,0,0,1,0
20140815-M-Cincinnati_Masters-QF-Andy_Murray-Roger_Federer,2,F-XC,20,2,0,1,1,8,12
20140815-M-Cincinnati_Masters-QF-Andy_Murray-Roger_Federer,2,F-DTM,27,2,0,1,1,12,15
20140815-M-Cincinnati_Masters-QF-Andy_Murray-Roger_Federer,2,F-DTL,6,3,2,1,0,5,1
20140815-M-Cincinnati_Masters-QF-Andy_Murray-Roger_Federer,2,F-IO,19,5,2,0,3,11,8
20140815-M-Cincinnati_Masters-QF-Andy_Murray-Roger_Federer,2,F-II,5,4,1,1,2,2,3
20140815-M-Cincinnati_Masters-QF-Andy_Murray-Roger_Federer,2,B-XC,36,6,1,0,5,21,15
20140815-M-Cincinnati_Masters-QF-Andy_Murray-Roger_Federer,2,B-DTM,26,4,0,1,3,12,14
20140815-M-Cincinnati_Masters-QF-Andy_Murray-Roger_Federer,2,B-DTL,6,1,0,1,0,4,2
20140815-M-Cincinnati_Masters-QF-Andy_Murray-Roger_Federer,2,B-IO,1,1,0,1,0,1,0
20140815-M-Cincinnati_Masters-QF-Andy_Murray-Roger_Federer,2,S-XC,29,3,2,0,1,13,16
20140815-M-Cincinnati_Masters-QF-Andy_Murray-Roger_Federer,2,S-DTM,7,1,0,0,1,3,4
20140815-M-Cincinnati_Masters-QF-Andy_Murray-Roger_Federer,2,S-DTL,6,1,0,1,0,5,1
20140815-M-Cincinnati_Masters-QF-Andy_Murray-Roger_Federer,2,S-IO,2,0,0,0,0,2,0
20091114-M-Paris_Masters-SF-Novak_Djokovic-Rafael_Nadal,1,F-XC,27,3,1,2,0,20,7
20091114-M-Paris_Masters-SF-Novak_Djokovic-Rafael_Nadal,1,F-DTM,11,1,0,0,1,5,6
20091114-M-Paris_Masters-SF-Novak_Djokovic-Rafael_Nadal,1,F-DTL,7,4,3,1,0,6,1
20091114-M-Paris_Masters-SF-Novak_Djokovic-Rafael_Nadal,1,F-IO,27,16,9,4,3,20,7
20091114-M-Paris_Masters-SF-Novak_Djokovic-Rafael_Nadal,1,F-II,2,0,0,0,0,2,0
20091114-M-Paris_Masters-SF-Novak_Djokovic-Rafael_Nadal,1,B-XC,26,5,2,1,2,13,13
20091114-M-Paris_Masters-SF-Novak_Djokovic-Rafael_Nadal,1,B-DTM,17,1,0,0,1,9,8
20091114-M-Paris_Masters-SF-Novak_Djokovic-Rafael_Nadal,1,B-DTL,16,4,2,1,1,11,5
20091114-M-Paris_Masters-SF-Novak_Djokovic-Rafael_Nadal,1,B-IO,2,0,0,0,0,2,0
20091114-M-Paris_Masters-SF-Novak_Djokovic-Rafael_Nadal,1,S-DTL,5,0,0,0,0,1,4
20091114-M-Paris_Masters-SF-Novak_Djokovic-Rafael_Nadal,2,F-XC,41,0,0,0,0,19,22
20091114-M-Paris_Masters-SF-Novak_Djokovic-Rafael_Nadal,2,F-DTM,15,1,0,0,1,6,9
20091114-M-Paris_Masters-SF-Novak_Djokovic-Rafael_Nadal,2,F-DTL,4,0,0,0,0,1,3
20091114-M-Paris_Masters-SF-Novak_Djokovic-Rafael_Nadal,2,F-IO,8,2,0,1,1,5,3
20091114-M-Paris_Masters-SF-Novak_Djokovic-Rafael_Nadal,2,F-II,3,0,0,0,0,1,2
20091114-M-Paris_Masters-SF-Novak_Djokovic-Rafael_Nadal,2,B-XC,13,4,2,0,2,4,9
20091114-M-Paris_Masters-SF-Novak_Djokovic-Rafael_Nadal,2,B-DTM,19,1,0,0,1,6,13
20091114-M-Paris_Masters-SF-Novak_Djokovic-Rafael_Nadal,2,B-DTL,10,3,2,1,0,4,6
20091114-M-Paris_Masters-SF-Novak_Djokovic-Rafael_Nadal,2,B-IO,3,1,1,0,0,2,1
20091114-M-Paris_Masters-SF-Novak_Djokovic-Rafael_Nadal,2,S-XC,3,0,0,0,0,1,2
20091114-M-Paris_Masters-SF-Novak_Djokovic-Rafael_Nadal,2,S-DTM,6,0,0,0,0,3,3
20091114-M-Paris_Masters-SF-Novak_Djokovic-Rafael_Nadal,2,S-DTL,6,0,0,0,0,3,3
20091114-M-Paris_Masters-SF-Novak_Djokovic-Rafael_Nadal,2,S-IO,2,0,0,0,0,1,1
19920912-M-US_Open-SF-Michael_Chang-Stefan_Edberg,1,F-XC,58,15,7,6,2,35,23
19920912-M-US_Open-SF-Michael_Chang-Stefan_Edberg,1,F-DTM,21,1,0,0,1,6,15
19920912-M-US_Open-SF-Michael_Chang-Stefan_Edberg,1,F-DTL,20,8,1,3,4,9,11
19920912-M-US_Open-SF-Michael_Chang-Stefan_Edberg,1,F-IO,23,7,4,2,1,17,6
19920912-M-US_Open-SF-Michael_Chang-Stefan_Edberg,1,F-II,1,0,0,0,0,1,0
19920912-M-US_Open-SF-Michael_Chang-Stefan_Edberg,1,B-XC,126,39,8,14,17,61,65
19920912-M-US_Open-SF-Michael_Chang-Stefan_Edberg,1,B-DTM,43,2,0,1,1,16,27
19920912-M-US_Open-SF-Michael_Chang-Stefan_Edberg,1,B-DTL,44,13,5,8,0,27,17
19920912-M-US_Open-SF-Michael_Chang-Stefan_Edberg,1,B-IO,13,3,2,0,1,6,7
19920912-M-US_Open-SF-Michael_Chang-Stefan_Edberg,1,S-XC,5,1,0,0,1,1,4
19920912-M-US_Open-SF-Michael_Chang-Stefan_Edberg,1,S-DTM,5,0,0,0,0,1,4
19920912-M-US_Open-SF-Michael_Chang-Stefan_Edberg,1,S-DTL,5,2,1,0,1,2,3
19920912-M-US_Open-SF-Michael_Chang-Stefan_Edberg,2,F-XC,23,2,1,0,1,10,13
19920912-M-US_Open-SF-Michael_Chang-Stefan_Edberg,2,F-DTM,20,2,0,0,2,12,8
19920912-M-US_Open-SF-Michael_Chang-Stefan_Edberg,2,F-DTL,29,7,1,2,4,13,16
19920912-M-US_Open-SF-Michael_Chang-Stefan_Edberg,2,F-IO,17,3,0,2,1,10,7
19920912-M-US_Open-SF-Michael_Chang-Stefan_Edberg,2,B-XC,24,11,2,5,4,13,11
19920912-M-US_Open-SF-Michael_Chang-Stefan_Edberg,2,B-DTM,15,0,0,0,0,6,9
19920912-M-US_Open-SF-Michael_Chang-Stefan_Edberg,2,B-DTL,12,8,2,2,4,5,7
19920912-M-US_Open-SF-Michael_Chang-Stefan_Edberg,2,B-IO,1,0,0,0,0,1,0
19920912-M-US_Open-SF-Michael_Chang-Stefan_Edberg,2,S-XC,58,3,0,2,1,30,28
19920912-M-US_Open-SF-Michael_Chang-Stefan_Edberg,2,S-DTM,9,0,0,0,0,2,7
19920912-M-US_Open-SF-Michael_Chang-Stefan_Edberg,2,S-DTL,8,1,0,0,1,4,4
19920912-M-US_Open-SF-Michael_Chang-Stefan_Edberg,2,S-IO,5,1,0,0,1,2,3
20180528-M-Roland_Garros-R128-Borna_Coric-Philipp_Kohlschreiber,1,F-XC,33,9,7,0,2,18,15
20180528-M-Roland_Garros-R128-Borna_Coric-Philipp_Kohlschreiber,1,F-DTM,10,1,0,0,1,6,4
20180528-M-Roland_Garros-R128-Borna_Coric-Philipp_Kohlschreiber,1,F-DTL,26,9,2,1,6,9,17
20180528-M-Roland_Garros-R128-Borna_Coric-Philipp_Kohlschreiber,1,F-IO,40,12,7,1,4,24,16
20180528-M-Roland_Garros-R128-Borna_Coric-Philipp_Kohlschreiber,1,F-II,8,7,4,2,1,7,1
20180528-M-Roland_Garros-R128-Borna_Coric-Philipp_Kohlschreiber,1,B-XC,71,13,2,2,9,39,32
20180528-M-Roland_Garros-R128-Borna_Coric-Philipp_Kohlschreiber,1,B-DTM,15,1,0,0,1,6,9
20180528-M-Roland_Garros-R128-Borna_Coric-Philipp_Kohlschreiber,1,B-DTL,9,5,1,2,2,6,3
20180528-M-Roland_Garros-R128-Borna_Coric-Philipp_Kohlschreiber,1,B-IO,1,1,0,0,1,0,1
20180528-M-Roland_Garros-R128-Borna_Coric-Philipp_Kohlschreiber,1,S-XC,5,0,0,0,0,0,5
20180528-M-Roland_Garros-R128-Borna_Coric-Philipp_Kohlschreiber,1,S-DTM,4,0,0,0,0,1,3
20180528-M-Roland_Garros-R128-Borna_Coric-Philipp_Kohlschreiber,2,F-XC,37,12,2,4,6,19,18
20180528-M-Roland_Garros-R128-Borna_Coric-Philipp_Kohlschreiber,2,F-DTM,16,2,0,0,2,6,10
20180528-M-Roland_Garros-R128-Borna_Coric-Philipp_Kohlschreiber,2,F-DTL,16,4,1,2,1,13,3
20180528-M-Roland_Garros-R128-Borna_Coric-Philipp_Kohlschreiber,2,F-IO,28,9,1,3,5,16,12
20180528-M-Roland_Garros-R128-Borna_Coric-Philipp_Kohlschreiber,2,F-II,9,7,4,1,2,6,3
20180528-M-Roland_Garros-R128-Borna_Coric-Philipp_Kohlschreiber,2,B-XC,50,13,4,3,6,25,25
20180528-M-Roland_Garros-R128-Borna_Coric-Philipp_Kohlschreiber,2,B-DTM,26,2,0,0,2,13,13
20180528-M-Roland_Garros-R128-Borna_Coric-Philipp_Kohlschreiber,2,B-DTL,13,7,2,1,4,7,6
20180528-M-Roland_Garros-R128-Borna_Coric-Philipp_Kohlschreiber,2,S-XC,19,2,0,1,1,6,13
20180528-M-Roland_Garros-R128-Borna_Coric-Philipp_Kohlschreiber,2,S-DTM,5,0,0,0,0,1,4
20180528-M-Roland_Garros-R128-Borna_Coric-Philipp_Kohlschreiber,2,S-DTL,1,0,0,0,0,0,1
20090404-M-Miami_Masters-SF-Roger_Federer-Novak_Djokovic,1,F-XC,45,11,3,2,6,17,28
20090404-M-Miami_Masters-SF-Roger_Federer-Novak_Djokovic,1,F-DTM,44,9,0,0,9,13,31
20090404-M-Miami_Masters-SF-Roger_Federer-Novak_Djokovic,1,F-DTL,9,6,0,1,5,2,7
20090404-M-Miami_Masters-SF-Roger_Federer-Novak_Djokovic,1,F-IO,26,8,3,2,3,10,16
20090404-M-Miami_Masters-SF-Roger_Federer-Novak_Djokovic,1,F-II,8,2,1,0,1,2,6
20090404-M-Miami_Masters-SF-Roger_Federer-Novak_Djokovic,1,B-XC,24,4,0,0,4,8,16
20090404-M-Miami_Masters-SF-Roger_Federer-Novak_Djokovic,1,B-DTM,25,2,0,0,2,9,16
20090404-M-Miami_Masters-SF-Roger_Federer-Novak_Djokovic,1,B-DTL,4,2,0,1,1,2,2
20090404-M-Miami_Masters-SF-Roger_Federer-Novak_Djokovic,1,B-IO,3,0,0,0,0,2,1
20090404-M-Miami_Masters-SF-Roger_Federer-Novak_Djokovic,1,S-XC,19,3,0,0,3,4,15
20090404-M-Miami_Masters-SF-Roger_Federer-Novak_Djokovic,1,S-DTM,8,0,0,0,0,2,6
20090404-M-Miami_Masters-SF-Roger_Federer-Novak_Djokovic,1,S-DTL,1,0,0,0,0,0,1
20090404-M-Miami_Masters-SF-Roger_Federer-Novak_Djokovic,2,F-XC,47,11,2,4,5,30,17
20090404-M-Miami_Masters-SF-Roger_Federer-Novak_Djokovic,2,F-DTM,28,3,0,0,3,15,13
20090404-M-Miami_Masters-SF-Roger_Federer-Novak_Djokovic,2,F-DTL,4,0,0,0,0,2,2
20090404-M-Miami_Masters-SF-Roger_Federer-Novak_Djokovic,2,F-IO,23,7,4,1,2,18,5
20090404-M-Miami_Masters-SF-Roger_Federer-Novak_Djokovic,2,F-II,3,1,1,0,0,3,0
20090404-M-Miami_Masters-SF-Roger_Federer-Novak_Djokovic,2,B-XC,36,7,2,1,4,24,12
20090404-M-Miami_Masters-SF-Roger_Federer-Novak_Djokovic,2,B-DTM,38,2,0,1,1,22,16
20090404-M-Miami_Masters-SF-Roger_Federer-Novak_Djokovic,2,B-DTL,10,5,0,2,3,7,3
20090404-M-Miami_Masters-SF-Roger_Federer-Novak_Djokovic,2,B-IO,6,4,0,2,2,4,2
20090404-M-Miami_Masters-SF-Roger_Federer-Novak_Djokovic,2,S-XC,14,2,0,0,2,10,4
20090404-M-Miami_Masters-SF-Roger_Federer-Novak_Djokovic,2,S-DTM,3,1,0,1,0,3,0
20090404-M-Miami_Masters-SF-Roger_Federer-Novak_Djokovic,2,S-DTL,1,0,0,0,0,0,1
20090404-M-Miami_Masters-SF-Roger_Federer-Novak_Djokovic,2,S-IO,1,0,0,0,0,0,1
20140903-M-US_Open-QF-Novak_Djokovic-Andy_Murray,1,F-XC,64,12,6,3,3,37,27
20140903-M-US_Open-QF-Novak_Djokovic-Andy_Murray,1,F-DTM,65,7,0,1,6,20,45
20140903-M-US_Open-QF-Novak_Djokovic-Andy_Murray,1,F-DTL,27,8,0,4,4,15,12
20140903-M-US_Open-QF-Novak_Djokovic-Andy_Murray,1,F-IO,64,14,4,4,6,31,33
20140903-M-US_Open-QF-Novak_Djokovic-Andy_Murray,1,F-II,13,2,1,0,1,4,9
20140903-M-US_Open-QF-Novak_Djokovic-Andy_Murray,1,B-XC,66,10,3,4,3,42,24
20140903-M-US_Open-QF-Novak_Djokovic-Andy_Murray,1,B-DTM,75,8,0,1,7,35,40
20140903-M-US_Open-QF-Novak_Djokovic-Andy_Murray,1,B-DTL,23,4,0,0,4,14,9
20140903-M-US_Open-QF-Novak_Djokovic-Andy_Murray,1,B-IO,6,2,0,0,2,2,4
20140903-M-US_Open-QF-Novak_Djokovic-Andy_Murray,1,S-XC,30,3,0,1,2,16,14
20140903-M-US_Open-QF-Novak_Djokovic-Andy_Murray,1,S-DTM,15,0,0,0,0,5,10
20140903-M-US_Open-QF-Novak_Djokovic-Andy_Murray,1,S-DTL,4,1,0,0,1,2,2
20140903-M-US_Open-QF-Novak_Djokovic-Andy_Murray,1,S-IO,2,0,0,0,0,2,0
20140903-M-US_Open-QF-Novak_Djokovic-Andy_Murray,2,F-XC,113,37,9,12,16,63,50
20140903-M-US_Open-QF-Novak_Djokovic-Andy_Murray,2,F-DTM,42,4,0,1,3,21,21
20140903-M-US_Open-QF-Novak_Djokovic-Andy_Murray,2,F-DTL,12,4,2,1,1,3,9
20140903-M-US_Open-QF-Novak_Djokovic-Andy_Murray,2,F-IO,41,11,7,1,3,22,19
20140903-M-US_Open-QF-Novak_Djokovic-Andy_Murray,2,F-II,4,2,1,0,1,2,2
20140903-M-US_Open-QF-Novak_Djokovic-Andy_Murray,2,B-XC,75,15,2,2,11,34,41
20140903-M-US_Open-QF-Novak_Djokovic-Andy_Murray,2,B-DTM,54,3,0,0,3,31,23
20140903-M-US_Open-QF-Novak_Djokovic-Andy_Murray,2,B-DTL,11,8,2,1,5,4,7
20140903-M-US_Open-QF-Novak_Djokovic-Andy_Murray,2,B-IO,11,3,0,0,3,5,6
20140903-M-US_Open-QF-Novak_Djokovic-Andy_Murray,2,S-XC,58,1,0,0,1,26,32
20140903-M-US_Open-QF-Novak_Djokovic-Andy_Murray,2,S-DTM,29,1,0,0,1,16,13
20140903-M-US_Open-QF-Novak_Djokovic-Andy_Murray,2,S-DTL,1,0,0,0,0,0,1
20140903-M-US_Open-QF-Novak_Djokovic-Andy_Murray,2,S-IO,5,0,0,0,0,4,1
20010225-M-Rotterdam-F-Roger_Federer-Nicolas_Escude,1,F-XC,50,13,2,4,7,26,24
20010225-M-Rotterdam-F-Roger_Federer-Nicolas_Escude,1,F-DTM,37,3,0,0,3,22,15
20010225-M-Rotterdam-F-Roger_Federer-Nicolas_Escude,1,F-DTL,28,6,2,3,1,13,15
20010225-M-Rotterdam-F-Roger_Federer-Nicolas_Escude,1,F-IO,44,12,4,5,3,26,18
20010225-M-Rotterdam-F-Roger_Federer-Nicolas_Escude,1,F-II,12,6,3,1,2,7,5
20010225-M-Rotterdam-F-Roger_Federer-Nicolas_Escude,1,B-XC,30,2,0,0,2,18,12
20010225-M-Rotterdam-F-Roger_Federer-Nicolas_Escude,1,B-DTM,37,3,0,0,3,13,24
20010225-M-Rotterdam-F-Roger_Federer-Nicolas_Escude,1,B-DTL,15,8,2,2,4,9,6
20010225-M-Rotterdam-F-Roger_Federer-Nicolas_Escude,1,B-IO,2,1,0,1,0,2,0
20010225-M-Rotterdam-F-Roger_Federer-Nicolas_Escude,1,S-XC,34,2,0,0,2,19,15
20010225-M-Rotterdam-F-Roger_Federer-Nicolas_Escude,1,S-DTM,23,2,0,0,2,12,11
20010225-M-Rotterdam-F-Roger_Federer-Nicolas_Escude,1,S-DTL,10,1,0,0,1,5,5
20010225-M-Rotterdam-F-Roger_Federer-Nicolas_Escude,1,S-IO,4,1,0,0,1,2,2
20010225-M-Rotterdam-F-Roger_Federer-Nicolas_Escude,2,F-XC,61,12,1,4,7,30,31
20010225-M-Rotterdam-F-Roger_Federer-Nicolas_Escude,2,F-DTM,43,4,0,1,3,14,29
20010225-M-Rotterdam-F-Roger_Federer-Nicolas_Escude,2,F-DTL,12,4,1,2,1,6,6
20010225-M-Rotterdam-F-Roger_Federer-Nicolas_Escude,2,F-IO,8,2,1,1,0,4,4
20010225-M-Rotterdam-F-Roger_Federer-Nicolas_Escude,2,F-II,1,0,0,0,0,1,0
20010225-M-Rotterdam-F-Roger_Federer-Nicolas_Escude,2,B-XC,111,10,2,0,8,57,54
20010225-M-Rotterdam-F-Roger_Federer-Nicolas_Escude,2,B-DTM,40,7,0,2,5,14,26
20010225-M-Rotterdam-F-Roger_Federer-Nicolas_Escude,2,B-DTL,14,6,2,2,2,6,8
20010225-M-Rotterdam-F-Roger_Federer-Nicolas_Escude,2,B-IO,9,3,0,0,3,3,6
20010225-M-Rotterdam-F-Roger_Federer-Nicolas_Escude,2,S-XC,7,0,0,0,0,3,4
20010225-M-Rotterdam-F-Roger_Federer-Nicolas_Escude,2,S-DTM,6,0,0,0,0,2,4
20010225-M-Rotterdam-F-Roger_Federer-Nicolas_Escude,2,S-DTL,1,1,1,0,0,1,0
20010225-M-Rotterdam-F-Roger_Federer-Nicolas_Escude,2,S-II,1,1,0,1,0,1,0
20050220-M-Rotterdam-F-Roger_Federer-Ivan_Ljubicic,1,F-XC,40,16,5,6,5,28,12
20050220-M-Rotterdam-F-Roger_Federer-Ivan_Ljubicic,1,F-DTM,25,4,1,0,3,15,10
20050220-M-Rotterdam-F-Roger_Federer-Ivan_Ljubicic,1,F-DTL,15,3,1,2,0,10,5
20050220-M-Rotterdam-F-Roger_Federer-Ivan_Ljubicic,1,F-IO,39,13,3,4,6,21,18
20050220-M-Rotterdam-F-Roger_Federer-Ivan_Ljubicic,1,F-II,11,4,2,0,2,7,4
20050220-M-Rotterdam-F-Roger_Federer-Ivan_Ljubicic,1,B-XC,57,9,4,2,3,28,29
20050220-M-Rotterdam-F-Roger_Federer-Ivan_Ljubicic,1,B-DTM,30,2,1,0,1,18,12
20050220-M-Rotterdam-F-Roger_Federer-Ivan_Ljubicic,1,B-DTL,14,8,1,2,5,5,9
20050220-M-Rotterdam-F-Roger_Federer-Ivan_Ljubicic,1,B-IO,3,1,0,0,1,1,2
20050220-M-Rotterdam-F-Roger_Federer-Ivan_Ljubicic,1,S-XC,25,0,0,0,0,13,12
20050220-M-Rotterdam-F-Roger_Federer-Ivan_Ljubicic,1,S-DTM,11,1,0,0,1,1,10
20050220-M-Rotterdam-F-Roger_Federer-Ivan_Ljubicic,1,S-DTL,6,1,1,0,0,5,1
20050220-M-Rotterdam-F-Roger_Federer-Ivan_Ljubicic,2,F-XC,46,15,3,5,7,18,28
20050220-M-Rotterdam-F-Roger_Federer-Ivan_Ljubicic,2,F-DTM,35,0,0,0,0,13,22
20050220-M-Rotterdam-F-Roger_Federer-Ivan_Ljubicic,2,F-DTL,10,1,0,0,1,5,5
20050220-M-Rotterdam-F-Roger_Federer-Ivan_Ljubicic,2,F-IO,33,7,1,2,4,11,22
20050220-M-Rotterdam-F-Roger_Federer-Ivan_Ljubicic,2,F-II,1,0,0,0,0,0,1
20050220-M-Rotterdam-F-Roger_Federer-Ivan_Ljubicic,2,B-XC,78,5,2,2,1,51,27
20050220-M-Rotterdam-F-Roger_Federer-Ivan_Ljubicic,2,B-DTM,28,4,0,0,4,7,21
20050220-M-Rotterdam-F-Roger_Federer-Ivan_Ljubicic,2,B-DTL,15,7,1,3,3,7,8
20050220-M-Rotterdam-F-Roger_Federer-Ivan_Ljubicic,2,B-IO,7,3,1,1,1,4,3
20050220-M-Rotterdam-F-Roger_Federer-Ivan_Ljubicic,2,S-XC,25,1,0,1,0,12,13
20050220-M-Rotterdam-F-Roger_Federer-Ivan_Ljubicic,2,S-DTM,7,1,0,0,1,4,3
19960616-M-Queens_Club-F-Stefan_Edberg-Boris_Becker,1,F-XC,4,2,1,0,1,1,3
19960616-M-Queens_Club-F-Stefan_Edberg-Boris_Becker,1,F-DTM,2,0,0,0,0,0,2
19960616-M-Queens_Club-F-Stefan_Edberg-Boris_Becker,1,F-DTL,5,2,1,1,0,2,3
19960616-M-Queens_Club-F-Stefan_Edberg-Boris_Becker,1,F-IO,3,1,0,0,1,1,2
19960616-M-Queens_Club-F-Stefan_Edberg-Boris_Becker,1,B-XC,4,0,0,0,0,0,4
19960616-M-Queens_Club-F-Stefan_Edberg-Boris_Becker,1,B-DTM,3,0,0,0,0,0,3
19960616-M-Queens_Club-F-Stefan_Edberg-Boris_Becker,1,B-DTL,6,6,1,1,4,2,4
19960616-M-Queens_Club-F-Stefan_Edberg-Boris_Becker,1,B-IO,1,1,0,0,1,0,1
19960616-M-Queens_Club-F-Stefan_Edberg-Boris_Becker,1,S-XC,2,0,0,0,0,0,2
19960616-M-Queens_Club-F-Stefan_Edberg-Boris_Becker,2,F-XC,5,4,3,1,0,5,0
19960616-M-Queens_Club-F-Stefan_Edberg-Boris_Becker,2,F-DTM,2,0,0,0,0,1,1
19960616-M-Queens_Club-F-Stefan_Edberg-Boris_Becker,2,F-DTL,2,2,1,1,0,2,0
19960616-M-Queens_Club-F-Stefan_Edberg-Boris_Becker,2,B-XC,2,2,1,0,1,1,1
19960616-M-Queens_Club-F-Stefan_Edberg-Boris_Becker,2,B-DTM,3,0,0,0,0,2,1
19960616-M-Queens_Club-F-Stefan_Edberg-Boris_Becker,2,B-DTL,3,2,2,0,0,2,1
19960616-M-Queens_Club-F-Stefan_Edberg-Boris_Becker,2,S-XC,2,0,0,0,0,1,1
20141004-M-Beijing-SF-Novak_Djokovic-Andy_Murray,1,F-XC,37,2,2,0,0,26,11
20141004-M-Beijing-SF-Novak_Djokovic-Andy_Murray,1,F-DTM,32,1,0,0,1,24,8
20141004-M-Beijing-SF-Novak_Djokovic-Andy_Murray,1,F-DTL,21,6,1,2,3,13,8
20141004-M-Beijing-SF-Novak_Djokovic-Andy_Murray,1,F-IO,27,7,0,2,5,19,8
20141004-M-Beijing-SF-Novak_Djokovic-Andy_Murray,1,F-II,7,3,1,2,0,4,3
20141004-M-Beijing-SF-Novak_Djokovic-Andy_Murray,1,B-XC,74,3,0,1,2,44,30
20141004-M-Beijing-SF-Novak_Djokovic-Andy_Murray,1,B-DTM,42,6,0,3,3,22,20
20141004-M-Beijing-SF-Novak_Djokovic-Andy_Murray,1,B-DTL,18,7,1,2,4,12,6
20141004-M-Beijing-SF-Novak_Djokovic-Andy_Murray,1,B-IO,9,2,0,1,1,7,2
20141004-M-Beijing-SF-Novak_Djokovic-Andy_Murray,1,S-XC,15,2,0,1,1,11,4
20141004-M-Beijing-SF-Novak_Djokovic-Andy_Murray,1,S-DTM,10,1,0,0,1,7,3
20141004-M-Beijing-SF-Novak_Djokovic-Andy_Murray,1,S-DTL,1,0,0,0,0,0,1
20141004-M-Beijing-SF-Novak_Djokovic-Andy_Murray,1,S-IO,1,0,0,0,0,0,1
20141004-M-Beijing-SF-Novak_Djokovic-Andy_Murray,2,F-XC,47,4,0,1,3,16,31
20141004-M-Beijing-SF-Novak_Djokovic-Andy_Murray,2,F-DTM,27,0,0,0,0,11,16
20141004-M-Beijing-SF-Novak_Djokovic-Andy_Murray,2,F-DTL,14,0,0,0,0,3,11
20141004-M-Beijing-SF-Novak_Djokovic-Andy_Murray,2,F-IO,29,2,0,0,2,11,18
20141004-M-Beijing-SF-Novak_Djokovic-Andy_Murray,2,F-II,4,1,1,0,0,1,3
20141004-M-Beijing-SF-Novak_Djokovic-Andy_Murray,2,B-XC,84,10,1,2,7,36,48
20141004-M-Beijing-SF-Novak_Djokovic-Andy_Murray,2,B-DTM,31,3,0,0,3,4,27
20141004-M-Beijing-SF-Novak_Djokovic-Andy_Murray,2,B-DTL,9,4,1,2,1,6,3
20141004-M-Beijing-SF-Novak_Djokovic-Andy_Murray,2,B-IO,8,2,0,0,2,2,6
20141004-M-Beijing-SF-Novak_Djokovic-Andy_Murray,2,S-XC,16,0,0,0,0,4,12
20141004-M-Beijing-SF-Novak_Djokovic-Andy_Murray,2,S-DTM,8,0,0,0,0,2,6
20141004-M-Beijing-SF-Novak_Djokovic-Andy_Murray,2,S-DTL,4,0,0,0,0,1,3
20050612-M-Halle-F-Roger_Federer-Marat_Safin,1,F-XC,27,10,5,4,1,20,7
20050612-M-Halle-F-Roger_Federer-Marat_Safin,1,F-DTM,19,1,0,0,1,13,6
20050612-M-Halle-F-Roger_Federer-Marat_Safin,1,F-DTL,9,3,1,1,1,2,7
20050612-M-Halle-F-Roger_Federer-Marat_Safin,1,F-IO,8,3,0,2,1,3,5
20050612-M-Halle-F-Roger_Federer-Marat_Safin,1,F-II,2,1,0,0,1,0,2
20050612-M-Halle-F-Roger_Federer-Marat_Safin,1,B-XC,16,4,0,1,3,9,7
20050612-M-Halle-F-Roger_Federer-Marat_Safin,1,B-DTM,15,2,0,0,2,7,8
20050612-M-Halle-F-Roger_Federer-Marat_Safin,1,B-DTL,5,2,2,0,0,2,3
20050612-M-Halle-F-Roger_Federer-Marat_Safin,1,B-IO,1,0,0,0,0,0,1
20050612-M-Halle-F-Roger_Federer-Marat_Safin,1,S-XC,9,0,0,0,0,6,3
20050612-M-Halle-F-Roger_Federer-Marat_Safin,1,S-DTM,10,1,0,0,1,4,6
20050612-M-Halle-F-Roger_Federer-Marat_Safin,1,S-DTL,4,0,0,0,0,2,2
20050612-M-Halle-F-Roger_Federer-Marat_Safin,1,S-IO,2,0,0,0,0,2,0
20050612-M-Halle-F-Roger_Federer-Marat_Safin,2,F-XC,31,13,2,4,7,14,17
20050612-M-Halle-F-Roger_Federer-Marat_Safin,2,F-DTM,17,3,0,1,2,8,9
20050612-M-Halle-F-Roger_Federer-Marat_Safin,2,F-DTL,8,2,0,1,1,3,5
20050612-M-Halle-F-Roger_Federer-Marat_Safin,2,F-IO,14,9,1,3,5,6,8
20050612-M-Halle-F-Roger_Federer-Marat_Safin,2,F-II,1,1,0,0,1,0,1
20050612-M-Halle-F-Roger_Federer-Marat_Safin,2,B-XC,24,9,2,3,4,14,10
20050612-M-Halle-F-Roger_Federer-Marat_Safin,2,B-DTM,28,6,0,2,4,11,17
20050612-M-Halle-F-Roger_Federer-Marat_Safin,2,B-DTL,8,3,0,1,2,4,4
20050612-M-Halle-F-Roger_Federer-Marat_Safin,2,B-IO,1,0,0,0,0,1,0
20050612-M-Halle-F-Roger_Federer-Marat_Safin,2,S-XC,5,0,0,0,0,4,1
20050612-M-Halle-F-Roger_Federer-Marat_Safin,2,S-DTM,2,0,0,0,0,1,1
20050612-M-Halle-F-Roger_Federer-Marat_Safin,2,S-IO,1,0,0,0,0,1,0
20050226-M-Dubai-F-Roger_Federer-Ivan_Ljubicic,1,F-XC,35,11,5,4,2,20,15
20050226-M-Dubai-F-Roger_Federer-Ivan_Ljubicic,1,F-DTM,29,3,0,1,2,14,15
20050226-M-Dubai-F-Roger_Federer-Ivan_Ljubicic,1,F-DTL,4,0,0,0,0,3,1
20050226-M-Dubai-F-Roger_Federer-Ivan_Ljubicic,1,F-IO,30,9,1,5,3,19,11
20050226-M-Dubai-F-Roger_Federer-Ivan_Ljubicic,1,F-II,10,3,0,2,1,6,4
20050226-M-Dubai-F-Roger_Federer-Ivan_Ljubicic,1,B-XC,28,1,0,1,0,17,11
20050226-M-Dubai-F-Roger_Federer-Ivan_Ljubicic,1,B-DTM,16,1,0,0,1,9,7
20050226-M-Dubai-F-Roger_Federer-Ivan_Ljubicic,1,B-DTL,8,6,4,1,1,5,3
20050226-M-Dubai-F-Roger_Federer-Ivan_Ljubicic,1,B-IO,1,0,0,0,0,1,0
20050226-M-Dubai-F-Roger_Federer-Ivan_Ljubicic,1,S-XC,17,3,0,0,3,9,8
20050226-M-Dubai-F-Roger_Federer-Ivan_Ljubicic,1,S-DTM,11,0,0,0,0,9,2
20050226-M-Dubai-F-Roger_Federer-Ivan_Ljubicic,1,S-IO,1,0,0,0,0,1,0
20050226-M-Dubai-F-Roger_Federer-Ivan_Ljubicic,2,F-XC,28,13,2,4,7,10,18
20050226-M-Dubai-F-Roger_Federer-Ivan_Ljubicic,2,F-DTM,27,1,0,0,1,14,13
20050226-M-Dubai-F-Roger_Federer-Ivan_Ljubicic,2,F-DTL,11,2,0,2,0,7,4
20050226-M-Dubai-F-Roger_Federer-Ivan_Ljubicic,2,F-IO,26,8,1,2,5,13,13
20050226-M-Dubai-F-Roger_Federer-Ivan_Ljubicic,2,F-II,1,1,0,0,1,0,1
20050226-M-Dubai-F-Roger_Federer-Ivan_Ljubicic,2,B-XC,58,9,2,1,6,17,41
20050226-M-Dubai-F-Roger_Federer-Ivan_Ljubicic,2,B-DTM,27,6,0,1,5,9,18
20050226-M-Dubai-F-Roger_Federer-Ivan_Ljubicic,2,B-DTL,11,8,4,2,2,7,4
20050226-M-Dubai-F-Roger_Federer-Ivan_Ljubicic,2,B-IO,7,2,2,0,0,3,4
20050226-M-Dubai-F-Roger_Federer-Ivan_Ljubicic,2,S-XC,18,3,1,0,2,8,10
20050226-M-Dubai-F-Roger_Federer-Ivan_Ljubicic,2,S-DTM,5,0,0,0,0,1,4
20030301-M-Dubai-F-Roger_Federer-Jiri_Novak,1,F-XC,40,10,2,7,1,24,16
20030301-M-Dubai-F-Roger_Federer-Jiri_Novak,1,F-DTM,25,5,0,0,5,10,15
20030301-M-Dubai-F-Roger_Federer-Jiri_Novak,1,F-DTL,18,8,2,4,2,11,7
20030301-M-Dubai-F-Roger_Federer-Jiri_Novak,1,F-IO,23,11,5,4,2,16,7
20030301-M-Dubai-F-Roger_Federer-Jiri_Novak,1,F-II,2,1,0,0,1,0,2
20030301-M-Dubai-F-Roger_Federer-Jiri_Novak,1,B-XC,23,3,1,1,1,17,6
20030301-M-Dubai-F-Roger_Federer-Jiri_Novak,1,B-DTM,34,3,0,1,2,21,13
20030301-M-Dubai-F-Roger_Federer-Jiri_Novak,1,B-DTL,15,8,5,0,3,10,5
20030301-M-Dubai-F-Roger_Federer-Jiri_Novak,1,B-IO,2,0,0,0,0,2,0
20030301-M-Dubai-F-Roger_Federer-Jiri_Novak,1,S-XC,23,0,0,0,0,15,8
20030301-M-Dubai-F-Roger_Federer-Jiri_Novak,1,S-DTM,12,0,0,0,0,8,4
20030301-M-Dubai-F-Roger_Federer-Jiri_Novak,1,S-DTL,6,0,0,0,0,6,0
20030301-M-Dubai-F-Roger_Federer-Jiri_Novak,1,S-IO,2,0,0,0,0,1,1
20030301-M-Dubai-F-Roger_Federer-Jiri_Novak,2,F-XC,37,10,3,2,5,21,16
20030301-M-Dubai-F-Roger_Federer-Jiri_Novak,2,F-DTM,26,1,0,0,1,10,16
20030301-M-Dubai-F-Roger_Federer-Jiri_Novak,2,F-DTL,17,6,0,4,2,7,10
20030301-M-Dubai-F-Roger_Federer-Jiri_Novak,2,F-IO,20,6,0,2,4,4,16
20030301-M-Dubai-F-Roger_Federer-Jiri_Novak,2,F-II,2,1,1,0,0,1,1
20030301-M-Dubai-F-Roger_Federer-Jiri_Novak,2,B-XC,66,9,1,4,4,26,40
20030301-M-Dubai-F-Roger_Federer-Jiri_Novak,2,B-DTM,33,3,0,0,3,11,22
20030301-M-Dubai-F-Roger_Federer-Jiri_Novak,2,B-DTL,13,4,2,1,1,6,7
20030301-M-Dubai-F-Roger_Federer-Jiri_Novak,2,B-IO,9,1,0,0,1,5,4
20030301-M-Dubai-F-Roger_Federer-Jiri_Novak,2,S-XC,5,1,1,0,0,1,4
20030301-M-Dubai-F-Roger_Federer-Jiri_Novak,2,S-DTM,1,0,0,0,0,0,1
20030713-M-Gstaad-F-Roger_Federer-Jiri_Novak,1,F-XC,53,17,5,4,8,28,25
20030713-M-Gstaad-F-Roger_Federer-Jiri_Novak,1,F-DTM,31,4,0,2,2,16,15
20030713-M-Gstaad-F-Roger_Federer-Jiri_Novak,1,F-DTL,10,2,1,1,0,4,6
20030713-M-Gstaad-F-Roger_Federer-Jiri_Novak,1,F-IO,31,11,3,3,5,17,14
20030713-M-Gstaad-F-Roger_Federer-Jiri_Novak,1,F-II,4,0,0,0,0,2,2
20030713-M-Gstaad-F-Roger_Federer-Jiri_Novak,1,B-XC,19,6,0,1,5,7,12
20030713-M-Gstaad-F-Roger_Federer-Jiri_Novak,1,B-DTM,20,3,0,0,3,6,14
20030713-M-Gstaad-F-Roger_Federer-Jiri_Novak,1,B-DTL,11,5,2,1,2,5,6
20030713-M-Gstaad-F-Roger_Federer-Jiri_Novak,1,B-IO,1,1,0,0,1,0,1
20030713-M-Gstaad-F-Roger_Federer-Jiri_Novak,1,S-XC,25,1,0,0,1,12,13
20030713-M-Gstaad-F-Roger_Federer-Jiri_Novak,1,S-DTM,11,0,0,0,0,4,7
20030713-M-Gstaad-F-Roger_Federer-Jiri_Novak,1,S-DTL,2,0,0,0,0,0,2
20030713-M-Gstaad-F-Roger_Federer-Jiri_Novak,1,S-IO,1,0,0,0,0,1,0
20030713-M-Gstaad-F-Roger_Federer-Jiri_Novak,2,F-XC,43,16,2,6,8,22,21
20030713-M-Gstaad-F-Roger_Federer-Jiri_Novak,2,F-DTM,43,4,0,1,3,21,22
20030713-M-Gstaad-F-Roger_Federer-Jiri_Novak,2,F-DTL,17,6,1,2,3,9,8
20030713-M-Gstaad-F-Roger_Federer-Jiri_Novak,2,F-IO,41,16,3,6,7,23,18
20030713-M-Gstaad-F-Roger_Federer-Jiri_Novak,2,F-II,2,2,1,0,1,1,1
20030713-M-Gstaad-F-Roger_Federer-Jiri_Novak,2,B-XC,54,9,2,4,3,33,21
20030713-M-Gstaad-F-Roger_Federer-Jiri_Novak,2,B-DTM,26,4,1,1,2,12,14
20030713-M-Gstaad-F-Roger_Federer-Jiri_Novak,2,B-DTL,20,12,4,2,6,10,10
20030713-M-Gstaad-F-Roger_Federer-Jiri_Novak,2,B-IO,12,7,2,2,3,9,3
20030713-M-Gstaad-F-Roger_Federer-Jiri_Novak,2,S-XC,6,0,0,0,0,2,4
20030713-M-Gstaad-F-Roger_Federer-Jiri_Novak,2,S-DTM,2,0,0,0,0,0,2
20030713-M-Gstaad-F-Roger_Federer-Jiri_Novak,2,S-DTL,1,0,0,0,0,0,1
20180604-M-Roland_Garros-R16-John_Isner-Juan_Martin_Del_Potro,1,F-XC,10,5,1,2,2,6,4
20180604-M-Roland_Garros-R16-John_Isner-Juan_Martin_Del_Potro,1,F-DTM,9,0,0,0,0,2,7
20180604-M-Roland_Garros-R16-John_Isner-Juan_Martin_Del_Potro,1,F-DTL,15,2,0,1,1,6,9
20180604-M-Roland_Garros-R16-John_Isner-Juan_Martin_Del_Potro,1,F-IO,39,25,5,4,16,14,25
20180604-M-Roland_Garros-R16-John_Isner-Juan_Martin_Del_Potro,1,F-II,4,4,1,2,1,3,1
20180604-M-Roland_Garros-R16-John_Isner-Juan_Martin_Del_Potro,1,B-XC,20,4,1,0,3,8,12
20180604-M-Roland_Garros-R16-John_Isner-Juan_Martin_Del_Potro,1,B-DTM,7,1,0,0,1,1,6
20180604-M-Roland_Garros-R16-John_Isner-Juan_Martin_Del_Potro,1,B-DTL,6,4,3,0,1,4,2
20180604-M-Roland_Garros-R16-John_Isner-Juan_Martin_Del_Potro,1,S-XC,5,1,0,0,1,0,5
20180604-M-Roland_Garros-R16-John_Isner-Juan_Martin_Del_Potro,1,S-DTM,1,0,0,0,0,0,1
20180604-M-Roland_Garros-R16-John_Isner-Juan_Martin_Del_Potro,2,F-XC,19,5,3,1,1,13,6
20180604-M-Roland_Garros-R16-John_Isner-Juan_Martin_Del_Potro,2,F-DTM,6,2,0,0,2,3,3
20180604-M-Roland_Garros-R16-John_Isner-Juan_Martin_Del_Potro,2,F-DTL,3,1,1,0,0,2,1
20180604-M-Roland_Garros-R16-John_Isner-Juan_Martin_Del_Potro,2,F-IO,26,7,5,1,1,21,5
20180604-M-Roland_Garros-R16-John_Isner-Juan_Martin_Del_Potro,2,F-II,3,2,1,0,1,2,1
20180604-M-Roland_Garros-R16-John_Isner-Juan_Martin_Del_Potro,2,B-XC,32,3,1,0,2,21,11
20180604-M-Roland_Garros-R16-John_Isner-Juan_Martin_Del_Potro,2,B-DTM,8,2,0,0,2,3,5
20180604-M-Roland_Garros-R16-John_Isner-Juan_Martin_Del_Potro,2,B-DTL,3,2,2,0,0,3,0
20180604-M-Roland_Garros-R16-John_Isner-Juan_Martin_Del_Potro,2,S-XC,11,2,1,0,1,5,6
20180604-M-Roland_Garros-R16-John_Isner-Juan_Martin_Del_Potro,2,S-DTL,1,0,0,0,0,0,1
20180605-M-Roland_Garros-QF-Alexander_Zverev-Dominic_Thiem,1,F-XC,46,8,1,1,6,15,31
20180605-M-Roland_Garros-QF-Alexander_Zverev-Dominic_Thiem,1,F-DTM,24,5,1,1,3,10,14
20180605-M-Roland_Garros-QF-Alexander_Zverev-Dominic_Thiem,1,F-DTL,24,5,1,1,3,9,15
20180605-M-Roland_Garros-QF-Alexander_Zverev-Dominic_Thiem,1,F-IO,22,6,0,0,6,5,17
20180605-M-Roland_Garros-QF-Alexander_Zverev-Dominic_Thiem,1,F-II,2,1,0,0,1,0,2
20180605-M-Roland_Garros-QF-Alexander_Zverev-Dominic_Thiem,1,B-XC,67,13,2,3,8,27,40
20180605-M-Roland_Garros-QF-Alexander_Zverev-Dominic_Thiem,1,B-DTM,9,1,0,0,1,5,4
20180605-M-Roland_Garros-QF-Alexander_Zverev-Dominic_Thiem,1,B-DTL,17,9,1,2,6,8,9
20180605-M-Roland_Garros-QF-Alexander_Zverev-Dominic_Thiem,1,B-IO,1,0,0,0,0,0,1
20180605-M-Roland_Garros-QF-Alexander_Zverev-Dominic_Thiem,1,B-II,1,0,0,0,0,1,0
20180605-M-Roland_Garros-QF-Alexander_Zverev-Dominic_Thiem,1,S-XC,6,1,0,0,1,2,4
20180605-M-Roland_Garros-QF-Alexander_Zverev-Dominic_Thiem,1,S-DTL,6,2,1,1,0,4,2
20180605-M-Roland_Garros-QF-Alexander_Zverev-Dominic_Thiem,1,S-IO,2,1,0,1,0,2,0
20180605-M-Roland_Garros-QF-Alexander_Zverev-Dominic_Thiem,2,F-XC,61,10,4,4,2,39,22
20180605-M-Roland_Garros-QF-Alexander_Zverev-Dominic_Thiem,2,F-DTM,14,0,0,0,0,8,6
20180605-M-Roland_Garros-QF-Alexander_Zverev-Dominic_Thiem,2,F-DTL,4,0,0,0,0,3,1
20180605-M-Roland_Garros-QF-Alexander_Zverev-Dominic_Thiem,2,F-IO,27,4,3,0,1,17,10
20180605-M-Roland_Garros-QF-Alexander_Zverev-Dominic_Thiem,2,F-II,8,4,0,4,0,7,1
20180605-M-Roland_Garros-QF-Alexander_Zverev-Dominic_Thiem,2,B-XC,39,7,3,2,2,22,17
20180605-M-Roland_Garros-QF-Alexander_Zverev-Dominic_Thiem,2,B-DTM,14,0,0,0,0,7,7
20180605-M-Roland_Garros-QF-Alexander_Zverev-Dominic_Thiem,2,B-DTL,3,2,1,0,1,2,1
20180605-M-Roland_Garros-QF-Alexander_Zverev-Dominic_Thiem,2,B-IO,2,0,0,0,0,2,0
20180605-M-Roland_Garros-QF-Alexander_Zverev-Dominic_Thiem,2,S-XC,31,3,0,0,3,20,11
20180605-M-Roland_Garros-QF-Alexander_Zverev-Dominic_Thiem,2,S-DTM,5,0,0,0,0,3,2
20180605-M-Roland_Garros-QF-Alexander_Zverev-Dominic_Thiem,2,S-DTL,2,0,0,0,0,2,0
20060723-M-Amersfoort-F-Novak_Djokovic-Nicolas_Massu,1,F-XC,47,19,7,4,8,29,18
20060723-M-Amersfoort-F-Novak_Djokovic-Nicolas_Massu,1,F-DTM,20,0,0,0,0,13,7
20060723-M-Amersfoort-F-Novak_Djokovic-Nicolas_Massu,1,F-DTL,7,1,0,1,0,6,1
20060723-M-Amersfoort-F-Novak_Djokovic-Nicolas_Massu,1,F-IO,28,8,3,1,4,19,9
20060723-M-Amersfoort-F-Novak_Djokovic-Nicolas_Massu,1,F-II,6,2,0,1,1,5,1
20060723-M-Amersfoort-F-Novak_Djokovic-Nicolas_Massu,1,B-XC,49,5,0,3,2,30,19
20060723-M-Amersfoort-F-Novak_Djokovic-Nicolas_Massu,1,B-DTM,25,4,0,1,3,14,11
20060723-M-Amersfoort-F-Novak_Djokovic-Nicolas_Massu,1,B-DTL,10,4,1,0,3,7,3
20060723-M-Amersfoort-F-Novak_Djokovic-Nicolas_Massu,1,B-IO,3,1,1,0,0,3,0
20060723-M-Amersfoort-F-Novak_Djokovic-Nicolas_Massu,1,S-DTM,1,0,0,0,0,0,1
20060723-M-Amersfoort-F-Novak_Djokovic-Nicolas_Massu,2,F-XC,39,8,3,4,1,19,20
20060723-M-Amersfoort-F-Novak_Djokovic-Nicolas_Massu,2,F-DTM,35,4,0,0,4,9,26
20060723-M-Amersfoort-F-Novak_Djokovic-Nicolas_Massu,2,F-DTL,14,6,4,1,1,5,9
20060723-M-Amersfoort-F-Novak_Djokovic-Nicolas_Massu,2,F-IO,40,6,2,1,3,16,24
20060723-M-Amersfoort-F-Novak_Djokovic-Nicolas_Massu,2,F-II,7,4,3,0,1,4,3
20060723-M-Amersfoort-F-Novak_Djokovic-Nicolas_Massu,2,B-XC,17,3,1,0,2,7,10
20060723-M-Amersfoort-F-Novak_Djokovic-Nicolas_Massu,2,B-DTM,19,2,0,0,2,6,13
20060723-M-Amersfoort-F-Novak_Djokovic-Nicolas_Massu,2,B-DTL,2,2,0,1,1,1,1
20060723-M-Amersfoort-F-Novak_Djokovic-Nicolas_Massu,2,S-XC,13,1,0,0,1,6,7
20060723-M-Amersfoort-F-Novak_Djokovic-Nicolas_Massu,2,S-DTM,14,1,0,0,1,2,12
20060723-M-Amersfoort-F-Novak_Djokovic-Nicolas_Massu,2,S-DTL,4,1,1,0,0,1,3
20000928-M-Olympics-F-Yevgeny_Kafelnikov-Tommy_Haas,1,F-XC,86,23,5,6,12,42,44
20000928-M-Olympics-F-Yevgeny_Kafelnikov-Tommy_Haas,1,F-DTM,15,0,0,0,0,8,7
20000928-M-Olympics-F-Yevgeny_Kafelnikov-Tommy_Haas,1,F-DTL,27,9,4,3,2,19,8
20000928-M-Olympics-F-Yevgeny_Kafelnikov-Tommy_Haas,1,F-IO,54,10,0,4,6,26,28
20000928-M-Olympics-F-Yevgeny_Kafelnikov-Tommy_Haas,1,F-II,9,6,1,1,4,4,5
20000928-M-Olympics-F-Yevgeny_Kafelnikov-Tommy_Haas,1,B-XC,133,18,1,7,10,77,56
20000928-M-Olympics-F-Yevgeny_Kafelnikov-Tommy_Haas,1,B-DTM,21,0,0,0,0,12,9
20000928-M-Olympics-F-Yevgeny_Kafelnikov-Tommy_Haas,1,B-DTL,16,10,1,5,4,8,8
20000928-M-Olympics-F-Yevgeny_Kafelnikov-Tommy_Haas,1,B-IO,8,2,0,1,1,3,5
20000928-M-Olympics-F-Yevgeny_Kafelnikov-Tommy_Haas,1,S-XC,22,2,1,0,1,13,9
20000928-M-Olympics-F-Yevgeny_Kafelnikov-Tommy_Haas,1,S-DTM,3,0,0,0,0,2,1
20000928-M-Olympics-F-Yevgeny_Kafelnikov-Tommy_Haas,1,S-DTL,2,1,0,1,0,2,0
20000928-M-Olympics-F-Yevgeny_Kafelnikov-Tommy_Haas,2,F-XC,63,21,4,6,11,34,29
20000928-M-Olympics-F-Yevgeny_Kafelnikov-Tommy_Haas,2,F-DTM,23,1,0,1,0,12,11
20000928-M-Olympics-F-Yevgeny_Kafelnikov-Tommy_Haas,2,F-DTL,36,11,7,2,2,22,14
20000928-M-Olympics-F-Yevgeny_Kafelnikov-Tommy_Haas,2,F-IO,39,10,4,0,6,18,21
20000928-M-Olympics-F-Yevgeny_Kafelnikov-Tommy_Haas,2,F-II,8,5,3,0,2,4,4
20000928-M-Olympics-F-Yevgeny_Kafelnikov-Tommy_Haas,2,B-XC,79,14,1,6,7,35,44
20000928-M-Olympics-F-Yevgeny_Kafelnikov-Tommy_Haas,2,B-DTM,47,5,0,0,5,14,33
20000928-M-Olympics-F-Yevgeny_Kafelnikov-Tommy_Haas,2,B-DTL,36,18,7,4,7,19,17
20000928-M-Olympics-F-Yevgeny_Kafelnikov-Tommy_Haas,2,B-IO,5,3,1,0,2,2,3
20000928-M-Olympics-F-Yevgeny_Kafelnikov-Tommy_Haas,2,S-XC,41,1,1,0,0,18,23
20000928-M-Olympics-F-Yevgeny_Kafelnikov-Tommy_Haas,2,S-DTM,13,0,0,0,0,4,9
20000928-M-Olympics-F-Yevgeny_Kafelnikov-Tommy_Haas,2,S-DTL,5,1,0,0,1,2,3
20090110-M-Doha-F-Andy_Roddick-Andy_Murray,1,F-XC,31,4,1,2,1,13,18
20090110-M-Doha-F-Andy_Roddick-Andy_Murray,1,F-DTM,8,0,0,0,0,3,5
20090110-M-Doha-F-Andy_Roddick-Andy_Murray,1,F-DTL,9,1,0,0,1,3,6
20090110-M-Doha-F-Andy_Roddick-Andy_Murray,1,F-IO,24,6,1,1,4,9,15
20090110-M-Doha-F-Andy_Roddick-Andy_Murray,1,F-II,7,0,0,0,0,3,4
20090110-M-Doha-F-Andy_Roddick-Andy_Murray,1,B-XC,35,4,1,1,2,13,22
20090110-M-Doha-F-Andy_Roddick-Andy_Murray,1,B-DTM,19,0,0,0,0,6,13
20090110-M-Doha-F-Andy_Roddick-Andy_Murray,1,B-DTL,10,4,2,1,1,6,4
20090110-M-Doha-F-Andy_Roddick-Andy_Murray,1,B-IO,4,0,0,0,0,1,3
20090110-M-Doha-F-Andy_Roddick-Andy_Murray,1,S-XC,7,0,0,0,0,1,6
20090110-M-Doha-F-Andy_Roddick-Andy_Murray,1,S-DTM,4,0,0,0,0,4,0
20090110-M-Doha-F-Andy_Roddick-Andy_Murray,1,S-DTL,7,0,0,0,0,3,4
20090110-M-Doha-F-Andy_Roddick-Andy_Murray,1,S-IO,1,0,0,0,0,0,1
20090110-M-Doha-F-Andy_Roddick-Andy_Murray,2,F-XC,35,10,6,3,1,20,15
20090110-M-Doha-F-Andy_Roddick-Andy_Murray,2,F-DTM,16,0,0,0,0,10,6
20090110-M-Doha-F-Andy_Roddick-Andy_Murray,2,F-DTL,16,1,0,0,1,9,7
20090110-M-Doha-F-Andy_Roddick-Andy_Murray,2,F-IO,8,1,1,0,0,3,5
20090110-M-Doha-F-Andy_Roddick-Andy_Murray,2,F-II,1,0,0,0,0,1,0
20090110-M-Doha-F-Andy_Roddick-Andy_Murray,2,B-XC,41,7,3,3,1,24,17
20090110-M-Doha-F-Andy_Roddick-Andy_Murray,2,B-DTM,15,2,0,1,1,11,4
20090110-M-Doha-F-Andy_Roddick-Andy_Murray,2,B-DTL,5,5,4,1,0,5,0
20090110-M-Doha-F-Andy_Roddick-Andy_Murray,2,B-IO,3,1,0,0,1,1,2
20090110-M-Doha-F-Andy_Roddick-Andy_Murray,2,S-XC,24,0,0,0,0,15,9
20090110-M-Doha-F-Andy_Roddick-Andy_Murray,2,S-DTM,12,0,0,0,0,10,2
20090110-M-Doha-F-Andy_Roddick-Andy_Murray,2,S-DTL,3,1,0,0,1,2,1
20090110-M-Doha-F-Andy_Roddick-Andy_Murray,2,S-IO,2,0,0,0,0,2,0
20180605-M-Roland_Garros-QF-Marco_Cecchinato-Novak_Djokovic,1,F-XC,63,17,4,3,10,27,36
20180605-M-Roland_Garros-QF-Marco_Cecchinato-Novak_Djokovic,1,F-DTM,22,1,1,0,0,8,14
20180605-M-Roland_Garros-QF-Marco_Cecchinato-Novak_Djokovic,1,F-DTL,17,7,4,2,1,13,4
20180605-M-Roland_Garros-QF-Marco_Cecchinato-Novak_Djokovic,1,F-IO,61,13,5,3,5,40,21
20180605-M-Roland_Garros-QF-Marco_Cecchinato-Novak_Djokovic,1,F-II,15,6,4,1,1,9,6
20180605-M-Roland_Garros-QF-Marco_Cecchinato-Novak_Djokovic,1,B-XC,100,10,2,1,7,62,38
20180605-M-Roland_Garros-QF-Marco_Cecchinato-Novak_Djokovic,1,B-DTM,39,3,0,1,2,23,16
20180605-M-Roland_Garros-QF-Marco_Cecchinato-Novak_Djokovic,1,B-DTL,26,13,6,2,5,16,10
20180605-M-Roland_Garros-QF-Marco_Cecchinato-Novak_Djokovic,1,B-IO,1,0,0,0,0,0,1
20180605-M-Roland_Garros-QF-Marco_Cecchinato-Novak_Djokovic,1,S-XC,24,3,0,1,2,8,16
20180605-M-Roland_Garros-QF-Marco_Cecchinato-Novak_Djokovic,1,S-DTM,7,0,0,0,0,2,5
20180605-M-Roland_Garros-QF-Marco_Cecchinato-Novak_Djokovic,1,S-DTL,5,2,1,1,0,4,1
20180605-M-Roland_Garros-QF-Marco_Cecchinato-Novak_Djokovic,2,F-XC,76,21,6,9,6,42,34
20180605-M-Roland_Garros-QF-Marco_Cecchinato-Novak_Djokovic,2,F-DTM,22,0,0,0,0,10,12
20180605-M-Roland_Garros-QF-Marco_Cecchinato-Novak_Djokovic,2,F-DTL,25,3,1,0,2,15,10
20180605-M-Roland_Garros-QF-Marco_Cecchinato-Novak_Djokovic,2,F-IO,58,10,2,5,3,25,33
20180605-M-Roland_Garros-QF-Marco_Cecchinato-Novak_Djokovic,2,F-II,14,6,2,2,2,8,6
20180605-M-Roland_Garros-QF-Marco_Cecchinato-Novak_Djokovic,2,B-XC,134,16,0,3,13,52,82
20180605-M-Roland_Garros-QF-Marco_Cecchinato-Novak_Djokovic,2,B-DTM,24,2,0,0,2,14,10
20180605-M-Roland_Garros-QF-Marco_Cecchinato-Novak_Djokovic,2,B-DTL,30,21,5,4,12,14,16
20180605-M-Roland_Garros-QF-Marco_Cecchinato-Novak_Djokovic,2,B-IO,1,0,0,0,0,1,0
20180605-M-Roland_Garros-QF-Marco_Cecchinato-Novak_Djokovic,2,S-XC,5,2,1,1,0,3,2
20180605-M-Roland_Garros-QF-Marco_Cecchinato-Novak_Djokovic,2,S-DTM,4,0,0,0,0,0,4
20180605-M-Roland_Garros-QF-Marco_Cecchinato-Novak_Djokovic,2,S-DTL,2,0,0,0,0,0,2
20121007-M-Beijing-F-Novak_Djokovic-Jo_Wilfried_Tsonga,1,F-XC,29,7,3,2,2,21,8
20121007-M-Beijing-F-Novak_Djokovic-Jo_Wilfried_Tsonga,1,F-DTM,16,1,1,0,0,7,9
20121007-M-Beijing-F-Novak_Djokovic-Jo_Wilfried_Tsonga,1,F-DTL,3,1,0,1,0,1,2
20121007-M-Beijing-F-Novak_Djokovic-Jo_Wilfried_Tsonga,1,F-IO,26,7,3,1,3,18,8
20121007-M-Beijing-F-Novak_Djokovic-Jo_Wilfried_Tsonga,1,F-II,7,5,0,2,3,3,4
20121007-M-Beijing-F-Novak_Djokovic-Jo_Wilfried_Tsonga,1,B-XC,45,5,1,3,1,23,22
20121007-M-Beijing-F-Novak_Djokovic-Jo_Wilfried_Tsonga,1,B-DTM,19,2,0,0,2,6,13
20121007-M-Beijing-F-Novak_Djokovic-Jo_Wilfried_Tsonga,1,B-DTL,6,4,1,1,2,2,4
20121007-M-Beijing-F-Novak_Djokovic-Jo_Wilfried_Tsonga,1,B-IO,4,1,0,0,1,2,2
20121007-M-Beijing-F-Novak_Djokovic-Jo_Wilfried_Tsonga,1,S-XC,6,1,0,0,1,3,3
20121007-M-Beijing-F-Novak_Djokovic-Jo_Wilfried_Tsonga,1,S-DTM,2,0,0,0,0,1,1
20121007-M-Beijing-F-Novak_Djokovic-Jo_Wilfried_Tsonga,1,S-DTL,1,0,0,0,0,1,0
20121007-M-Beijing-F-Novak_Djokovic-Jo_Wilfried_Tsonga,2,F-XC,21,13,2,4,7,9,12
20121007-M-Beijing-F-Novak_Djokovic-Jo_Wilfried_Tsonga,2,F-DTM,19,1,0,0,1,5,14
20121007-M-Beijing-F-Novak_Djokovic-Jo_Wilfried_Tsonga,2,F-DTL,9,1,0,0,1,3,6
20121007-M-Beijing-F-Novak_Djokovic-Jo_Wilfried_Tsonga,2,F-IO,28,6,2,2,2,17,11
20121007-M-Beijing-F-Novak_Djokovic-Jo_Wilfried_Tsonga,2,F-II,4,0,0,0,0,2,2
20121007-M-Beijing-F-Novak_Djokovic-Jo_Wilfried_Tsonga,2,B-XC,18,3,0,0,3,6,12
20121007-M-Beijing-F-Novak_Djokovic-Jo_Wilfried_Tsonga,2,B-DTM,10,2,0,0,2,5,5
20121007-M-Beijing-F-Novak_Djokovic-Jo_Wilfried_Tsonga,2,B-DTL,9,4,0,0,4,3,6
20121007-M-Beijing-F-Novak_Djokovic-Jo_Wilfried_Tsonga,2,S-XC,26,0,0,0,0,12,14
20121007-M-Beijing-F-Novak_Djokovic-Jo_Wilfried_Tsonga,2,S-DTM,7,0,0,0,0,6,1
20121007-M-Beijing-F-Novak_Djokovic-Jo_Wilfried_Tsonga,2,S-DTL,2,0,0,0,0,1,1
20090601-M-Roland_Garros-R16-Roger_Federer-Tommy_Haas,1,F-XC,65,20,8,6,6,42,23
20090601-M-Roland_Garros-R16-Roger_Federer-Tommy_Haas,1,F-DTM,47,6,1,1,4,19,28
20090601-M-Roland_Garros-R16-Roger_Federer-Tommy_Haas,1,F-DTL,13,7,3,1,3,6,7
20090601-M-Roland_Garros-R16-Roger_Federer-Tommy_Haas,1,F-IO,58,25,9,6,10,32,26
20090601-M-Roland_Garros-R16-Roger_Federer-Tommy_Haas,1,F-II,8,2,0,2,0,7,1
20090601-M-Roland_Garros-R16-Roger_Federer-Tommy_Haas,1,B-XC,25,7,2,0,5,10,15
20090601-M-Roland_Garros-R16-Roger_Federer-Tommy_Haas,1,B-DTM,22,2,0,0,2,12,10
20090601-M-Roland_Garros-R16-Roger_Federer-Tommy_Haas,1,B-DTL,10,4,3,1,0,9,1
20090601-M-Roland_Garros-R16-Roger_Federer-Tommy_Haas,1,B-IO,3,2,0,0,2,0,3
20090601-M-Roland_Garros-R16-Roger_Federer-Tommy_Haas,1,S-XC,12,1,1,0,0,9,3
20090601-M-Roland_Garros-R16-Roger_Federer-Tommy_Haas,1,S-DTM,6,1,0,0,1,3,3
20090601-M-Roland_Garros-R16-Roger_Federer-Tommy_Haas,1,S-DTL,2,0,0,0,0,2,0
20090601-M-Roland_Garros-R16-Roger_Federer-Tommy_Haas,2,F-XC,55,16,6,3,7,28,27
20090601-M-Roland_Garros-R16-Roger_Federer-Tommy_Haas,2,F-DTM,46,5,0,1,4,21,25
20090601-M-Roland_Garros-R16-Roger_Federer-Tommy_Haas,2,F-DTL,12,4,0,1,3,4,8
20090601-M-Roland_Garros-R16-Roger_Federer-Tommy_Haas,2,F-IO,33,11,4,3,4,17,16
20090601-M-Roland_Garros-R16-Roger_Federer-Tommy_Haas,2,F-II,1,0,0,0,0,0,1
20090601-M-Roland_Garros-R16-Roger_Federer-Tommy_Haas,2,B-XC,40,8,2,2,4,22,18
20090601-M-Roland_Garros-R16-Roger_Federer-Tommy_Haas,2,B-DTM,35,2,0,0,2,21,14
20090601-M-Roland_Garros-R16-Roger_Federer-Tommy_Haas,2,B-DTL,12,9,4,2,3,8,4
20090601-M-Roland_Garros-R16-Roger_Federer-Tommy_Haas,2,B-IO,5,4,1,0,3,1,4
20090601-M-Roland_Garros-R16-Roger_Federer-Tommy_Haas,2,S-XC,15,1,0,0,1,4,11
20090601-M-Roland_Garros-R16-Roger_Federer-Tommy_Haas,2,S-DTM,10,0,0,0,0,3,7
20090601-M-Roland_Garros-R16-Roger_Federer-Tommy_Haas,2,S-DTL,3,0,0,0,0,2,1
20070107-M-Adelaide-F-Chris_Guccione-Novak_Djokovic,1,F-XC,12,3,1,1,1,7,5
20070107-M-Adelaide-F-Chris_Guccione-Novak_Djokovic,1,F-DTM,11,0,0,0,0,7,4
20070107-M-Adelaide-F-Chris_Guccione-Novak_Djokovic,1,F-DTL,5,4,1,1,2,2,3
20070107-M-Adelaide-F-Chris_Guccione-Novak_Djokovic,1,F-IO,10,5,4,0,1,8,2
20070107-M-Adelaide-F-Chris_Guccione-Novak_Djokovic,1,B-XC,10,4,1,0,3,4,6
20070107-M-Adelaide-F-Chris_Guccione-Novak_Djokovic,1,B-DTM,12,3,0,0,3,5,7
20070107-M-Adelaide-F-Chris_Guccione-Novak_Djokovic,1,B-DTL,3,1,1,0,0,2,1
20070107-M-Adelaide-F-Chris_Guccione-Novak_Djokovic,1,B-IO,3,1,1,0,0,1,2
20070107-M-Adelaide-F-Chris_Guccione-Novak_Djokovic,1,S-XC,4,2,0,1,1,1,3
20070107-M-Adelaide-F-Chris_Guccione-Novak_Djokovic,1,S-DTM,6,0,0,0,0,3,3
20070107-M-Adelaide-F-Chris_Guccione-Novak_Djokovic,1,S-DTL,2,0,0,0,0,2,0
20070107-M-Adelaide-F-Chris_Guccione-Novak_Djokovic,1,S-IO,3,1,0,1,0,1,2
20070107-M-Adelaide-F-Chris_Guccione-Novak_Djokovic,2,F-XC,34,10,5,4,1,23,11
20070107-M-Adelaide-F-Chris_Guccione-Novak_Djokovic,2,F-DTM,22,2,0,1,1,10,12
20070107-M-Adelaide-F-Chris_Guccione-Novak_Djokovic,2,F-DTL,7,6,3,2,1,5,2
20070107-M-Adelaide-F-Chris_Guccione-Novak_Djokovic,2,F-IO,19,7,2,2,3,9,10
20070107-M-Adelaide-F-Chris_Guccione-Novak_Djokovic,2,B-XC,12,7,5,2,0,10,2
20070107-M-Adelaide-F-Chris_Guccione-Novak_Djokovic,2,B-DTM,26,2,0,0,2,9,17
20070107-M-Adelaide-F-Chris_Guccione-Novak_Djokovic,2,B-DTL,6,5,5,0,0,5,1
20070107-M-Adelaide-F-Chris_Guccione-Novak_Djokovic,2,B-IO,8,2,1,0,1,4,4
20070107-M-Adelaide-F-Chris_Guccione-Novak_Djokovic,2,S-XC,1,0,0,0,0,0,1
20070107-M-Adelaide-F-Chris_Guccione-Novak_Djokovic,2,S-DTM,1,0,0,0,0,0,1
20070107-M-Adelaide-F-Chris_Guccione-Novak_Djokovic,2,S-DTL,3,1,0,0,1,1,2
20041026-M-St_Petersburg-R32-Sargis_Sargsian-Irakli_Labadze,1,F-XC,34,4,0,1,3,20,14
20041026-M-St_Petersburg-R32-Sargis_Sargsian-Irakli_Labadze,1,F-DTM,24,5,1,0,4,14,10
20041026-M-St_Petersburg-R32-Sargis_Sargsian-Irakli_Labadze,1,F-DTL,4,2,0,1,1,1,3
20041026-M-St_Petersburg-R32-Sargis_Sargsian-Irakli_Labadze,1,F-IO,4,1,0,1,0,3,1
20041026-M-St_Petersburg-R32-Sargis_Sargsian-Irakli_Labadze,1,B-XC,31,13,2,4,7,15,16
20041026-M-St_Petersburg-R32-Sargis_Sargsian-Irakli_Labadze,1,B-DTM,30,0,0,0,0,14,16
20041026-M-St_Petersburg-R32-Sargis_Sargsian-Irakli_Labadze,1,B-DTL,8,2,1,1,0,3,5
20041026-M-St_Petersburg-R32-Sargis_Sargsian-Irakli_Labadze,1,B-IO,10,2,0,1,1,5,5
20041026-M-St_Petersburg-R32-Sargis_Sargsian-Irakli_Labadze,1,S-XC,6,1,0,1,0,5,1
20041026-M-St_Petersburg-R32-Sargis_Sargsian-Irakli_Labadze,1,S-DTM,5,0,0,0,0,0,5
20041026-M-St_Petersburg-R32-Sargis_Sargsian-Irakli_Labadze,1,S-DTL,3,0,0,0,0,1,2
20041026-M-St_Petersburg-R32-Sargis_Sargsian-Irakli_Labadze,1,S-IO,2,1,0,1,0,1,1
20041026-M-St_Petersburg-R32-Sargis_Sargsian-Irakli_Labadze,2,F-XC,37,5,1,1,3,20,17
20041026-M-St_Petersburg-R32-Sargis_Sargsian-Irakli_Labadze,2,F-DTM,18,2,0,0,2,4,14
20041026-M-St_Petersburg-R32-Sargis_Sargsian-Irakli_Labadze,2,F-DTL,12,10,4,2,4,8,4
20041026-M-St_Petersburg-R32-Sargis_Sargsian-Irakli_Labadze,2,F-IO,16,9,3,3,3,10,6
20041026-M-St_Petersburg-R32-Sargis_Sargsian-Irakli_Labadze,2,F-II,3,1,0,0,1,1,2
20041026-M-St_Petersburg-R32-Sargis_Sargsian-Irakli_Labadze,2,B-XC,19,3,1,1,1,9,10
20041026-M-St_Petersburg-R32-Sargis_Sargsian-Irakli_Labadze,2,B-DTM,20,2,0,0,2,9,11
20041026-M-St_Petersburg-R32-Sargis_Sargsian-Irakli_Labadze,2,B-DTL,13,6,0,2,4,5,8
20041026-M-St_Petersburg-R32-Sargis_Sargsian-Irakli_Labadze,2,B-IO,9,1,0,0,1,6,3
20041026-M-St_Petersburg-R32-Sargis_Sargsian-Irakli_Labadze,2,S-XC,10,0,0,0,0,7,3
20041026-M-St_Petersburg-R32-Sargis_Sargsian-Irakli_Labadze,2,S-DTM,5,0,0,0,0,0,5
20041026-M-St_Petersburg-R32-Sargis_Sargsian-Irakli_Labadze,2,S-DTL,5,0,0,0,0,3,2
20041026-M-St_Petersburg-R32-Sargis_Sargsian-Irakli_Labadze,2,S-IO,1,1,0,1,0,1,0
20180531-M-Roland_Garros-R64-Marton_Fucsovics-Kyle_Edmund,1,F-XC,43,13,5,5,3,25,18
20180531-M-Roland_Garros-R64-Marton_Fucsovics-Kyle_Edmund,1,F-DTM,16,3,1,0,2,6,10
20180531-M-Roland_Garros-R64-Marton_Fucsovics-Kyle_Edmund,1,F-DTL,13,2,0,1,1,6,7
20180531-M-Roland_Garros-R64-Marton_Fucsovics-Kyle_Edmund,1,F-IO,25,10,3,0,7,12,13
20180531-M-Roland_Garros-R64-Marton_Fucsovics-Kyle_Edmund,1,F-II,10,6,4,0,2,6,4
20180531-M-Roland_Garros-R64-Marton_Fucsovics-Kyle_Edmund,1,B-XC,28,5,0,1,4,13,15
20180531-M-Roland_Garros-R64-Marton_Fucsovics-Kyle_Edmund,1,B-DTM,26,5,0,0,5,9,17
20180531-M-Roland_Garros-R64-Marton_Fucsovics-Kyle_Edmund,1,B-DTL,8,5,3,1,1,6,2
20180531-M-Roland_Garros-R64-Marton_Fucsovics-Kyle_Edmund,1,B-IO,1,1,0,0,1,0,1
20180531-M-Roland_Garros-R64-Marton_Fucsovics-Kyle_Edmund,1,S-XC,15,1,0,0,1,5,10
20180531-M-Roland_Garros-R64-Marton_Fucsovics-Kyle_Edmund,1,S-DTM,5,1,0,0,1,2,3
20180531-M-Roland_Garros-R64-Marton_Fucsovics-Kyle_Edmund,2,F-XC,36,14,4,8,2,25,11
20180531-M-Roland_Garros-R64-Marton_Fucsovics-Kyle_Edmund,2,F-DTM,18,2,0,0,2,10,8
20180531-M-Roland_Garros-R64-Marton_Fucsovics-Kyle_Edmund,2,F-DTL,16,5,1,0,4,8,8
20180531-M-Roland_Garros-R64-Marton_Fucsovics-Kyle_Edmund,2,F-IO,40,14,4,6,4,23,17
20180531-M-Roland_Garros-R64-Marton_Fucsovics-Kyle_Edmund,2,F-II,6,2,2,0,0,3,3
20180531-M-Roland_Garros-R64-Marton_Fucsovics-Kyle_Edmund,2,B-XC,39,7,2,2,3,23,16
20180531-M-Roland_Garros-R64-Marton_Fucsovics-Kyle_Edmund,2,B-DTM,18,2,0,0,2,6,12
20180531-M-Roland_Garros-R64-Marton_Fucsovics-Kyle_Edmund,2,B-DTL,12,6,4,0,2,7,5
20180531-M-Roland_Garros-R64-Marton_Fucsovics-Kyle_Edmund,2,B-IO,6,3,1,0,2,3,3
20180531-M-Roland_Garros-R64-Marton_Fucsovics-Kyle_Edmund,2,S-XC,7,0,0,0,0,3,4
20180531-M-Roland_Garros-R64-Marton_Fucsovics-Kyle_Edmund,2,S-DTL,2,0,0,0,0,1,1
20180608-M-Roland_Garros-SF-Rafael_Nadal-Juan_Martin_Del_Potro,1,F-XC,81,9,4,3,2,46,35
20180608-M-Roland_Garros-SF-Rafael_Nadal-Juan_Martin_Del_Potro,1,F-DTM,13,0,0,0,0,5,8
20180608-M-Roland_Garros-SF-Rafael_Nadal-Juan_Martin_Del_Potro,1,F-DTL,26,10,5,1,4,13,13
20180608-M-Roland_Garros-SF-Rafael_Nadal-Juan_Martin_Del_Potro,1,F-IO,23,8,6,1,1,18,5
20180608-M-Roland_Garros-SF-Rafael_Nadal-Juan_Martin_Del_Potro,1,F-II,7,1,1,0,0,6,1
20180608-M-Roland_Garros-SF-Rafael_Nadal-Juan_Martin_Del_Potro,1,B-XC,45,12,5,2,5,27,18
20180608-M-Roland_Garros-SF-Rafael_Nadal-Juan_Martin_Del_Potro,1,B-DTM,9,0,0,0,0,5,4
20180608-M-Roland_Garros-SF-Rafael_Nadal-Juan_Martin_Del_Potro,1,B-DTL,24,4,4,0,0,16,8
20180608-M-Roland_Garros-SF-Rafael_Nadal-Juan_Martin_Del_Potro,1,B-IO,4,0,0,0,0,4,0
20180608-M-Roland_Garros-SF-Rafael_Nadal-Juan_Martin_Del_Potro,1,S-DTM,6,0,0,0,0,3,3
20180608-M-Roland_Garros-SF-Rafael_Nadal-Juan_Martin_Del_Potro,1,S-DTL,3,0,0,0,0,1,2
20180608-M-Roland_Garros-SF-Rafael_Nadal-Juan_Martin_Del_Potro,1,S-IO,1,0,0,0,0,1,0
20180608-M-Roland_Garros-SF-Rafael_Nadal-Juan_Martin_Del_Potro,2,F-XC,64,12,2,3,7,28,36
20180608-M-Roland_Garros-SF-Rafael_Nadal-Juan_Martin_Del_Potro,2,F-DTM,18,1,0,0,1,5,13
20180608-M-Roland_Garros-SF-Rafael_Nadal-Juan_Martin_Del_Potro,2,F-DTL,8,6,2,2,2,5,3
20180608-M-Roland_Garros-SF-Rafael_Nadal-Juan_Martin_Del_Potro,2,F-IO,29,10,4,1,5,17,12
20180608-M-Roland_Garros-SF-Rafael_Nadal-Juan_Martin_Del_Potro,2,F-II,9,6,1,3,2,4,5
20180608-M-Roland_Garros-SF-Rafael_Nadal-Juan_Martin_Del_Potro,2,B-XC,52,8,0,3,5,23,29
20180608-M-Roland_Garros-SF-Rafael_Nadal-Juan_Martin_Del_Potro,2,B-DTM,21,1,0,1,0,7,14
20180608-M-Roland_Garros-SF-Rafael_Nadal-Juan_Martin_Del_Potro,2,B-DTL,25,7,1,2,4,9,16
20180608-M-Roland_Garros-SF-Rafael_Nadal-Juan_Martin_Del_Potro,2,B-IO,2,0,0,0,0,1,1
20180608-M-Roland_Garros-SF-Rafael_Nadal-Juan_Martin_Del_Potro,2,S-XC,4,0,0,0,0,2,2
20180608-M-Roland_Garros-SF-Rafael_Nadal-Juan_Martin_Del_Potro,2,S-DTM,2,0,0,0,0,1,1
20180608-M-Roland_Garros-SF-Rafael_Nadal-Juan_Martin_Del_Potro,2,S-DTL,2,1,0,1,0,1,1
20180608-M-Roland_Garros-SF-Rafael_Nadal-Juan_Martin_Del_Potro,2,S-IO,1,1,0,1,0,1,0
20180610-M-Roland_Garros-F-Rafael_Nadal-Dominic_Thiem,1,F-XC,110,11,4,3,4,69,41
20180610-M-Roland_Garros-F-Rafael_Nadal-Dominic_Thiem,1,F-DTM,8,1,0,0,1,5,3
20180610-M-Roland_Garros-F-Rafael_Nadal-Dominic_Thiem,1,F-DTL,17,8,3,3,2,11,6
20180610-M-Roland_Garros-F-Rafael_Nadal-Dominic_Thiem,1,F-IO,21,5,4,0,1,16,5
20180610-M-Roland_Garros-F-Rafael_Nadal-Dominic_Thiem,1,F-II,14,4,2,1,1,11,3
20180610-M-Roland_Garros-F-Rafael_Nadal-Dominic_Thiem,1,B-XC,57,14,2,7,5,38,19
20180610-M-Roland_Garros-F-Rafael_Nadal-Dominic_Thiem,1,B-DTM,26,1,0,0,1,15,11
20180610-M-Roland_Garros-F-Rafael_Nadal-Dominic_Thiem,1,B-DTL,40,6,2,1,3,26,14
20180610-M-Roland_Garros-F-Rafael_Nadal-Dominic_Thiem,1,B-IO,5,1,0,1,0,4,1
20180610-M-Roland_Garros-F-Rafael_Nadal-Dominic_Thiem,1,B-II,1,0,0,0,0,0,1
20180610-M-Roland_Garros-F-Rafael_Nadal-Dominic_Thiem,1,S-XC,1,0,0,0,0,0,1
20180610-M-Roland_Garros-F-Rafael_Nadal-Dominic_Thiem,1,S-DTM,3,0,0,0,0,0,3
20180610-M-Roland_Garros-F-Rafael_Nadal-Dominic_Thiem,1,S-DTL,6,2,1,1,0,3,3
20180610-M-Roland_Garros-F-Rafael_Nadal-Dominic_Thiem,1,S-IO,1,0,0,0,0,1,0
20180610-M-Roland_Garros-F-Rafael_Nadal-Dominic_Thiem,2,F-XC,90,12,6,2,4,38,52
20180610-M-Roland_Garros-F-Rafael_Nadal-Dominic_Thiem,2,F-DTM,15,0,0,0,0,6,9
20180610-M-Roland_Garros-F-Rafael_Nadal-Dominic_Thiem,2,F-DTL,14,6,1,2,3,8,6
20180610-M-Roland_Garros-F-Rafael_Nadal-Dominic_Thiem,2,F-IO,40,12,4,5,3,20,20
20180610-M-Roland_Garros-F-Rafael_Nadal-Dominic_Thiem,2,F-II,17,7,2,2,3,10,7
20180610-M-Roland_Garros-F-Rafael_Nadal-Dominic_Thiem,2,B-XC,56,9,2,1,6,18,38
20180610-M-Roland_Garros-F-Rafael_Nadal-Dominic_Thiem,2,B-DTM,38,2,0,1,1,12,26
20180610-M-Roland_Garros-F-Rafael_Nadal-Dominic_Thiem,2,B-DTL,33,11,3,1,7,11,22
20180610-M-Roland_Garros-F-Rafael_Nadal-Dominic_Thiem,2,B-IO,5,2,0,0,2,0,5
20180610-M-Roland_Garros-F-Rafael_Nadal-Dominic_Thiem,2,S-XC,12,2,0,0,2,3,9
20180610-M-Roland_Garros-F-Rafael_Nadal-Dominic_Thiem,2,S-DTM,1,0,0,0,0,0,1
20180610-M-Roland_Garros-F-Rafael_Nadal-Dominic_Thiem,2,S-DTL,3,1,0,0,1,1,2
20180610-M-Roland_Garros-F-Rafael_Nadal-Dominic_Thiem,2,S-IO,1,0,0,0,0,1,0
20090228-M-Dubai-F-Novak_Djokovic-David_Ferrer,1,F-XC,59,9,2,4,3,32,27
20090228-M-Dubai-F-Novak_Djokovic-David_Ferrer,1,F-DTM,36,0,0,0,0,17,19
20090228-M-Dubai-F-Novak_Djokovic-David_Ferrer,1,F-DTL,20,7,3,1,3,11,9
20090228-M-Dubai-F-Novak_Djokovic-David_Ferrer,1,F-IO,27,7,3,3,1,18,9
20090228-M-Dubai-F-Novak_Djokovic-David_Ferrer,1,F-II,6,3,1,0,2,3,3
20090228-M-Dubai-F-Novak_Djokovic-David_Ferrer,1,B-XC,55,7,1,1,5,26,29
20090228-M-Dubai-F-Novak_Djokovic-David_Ferrer,1,B-DTM,50,4,0,1,3,23,27
20090228-M-Dubai-F-Novak_Djokovic-David_Ferrer,1,B-DTL,9,4,0,0,4,2,7
20090228-M-Dubai-F-Novak_Djokovic-David_Ferrer,1,B-IO,9,5,0,2,3,3,6
20090228-M-Dubai-F-Novak_Djokovic-David_Ferrer,1,S-XC,17,0,0,0,0,10,7
20090228-M-Dubai-F-Novak_Djokovic-David_Ferrer,1,S-DTM,5,0,0,0,0,4,1
20090228-M-Dubai-F-Novak_Djokovic-David_Ferrer,1,S-DTL,4,0,0,0,0,2,2
20090228-M-Dubai-F-Novak_Djokovic-David_Ferrer,2,F-XC,57,6,2,3,1,31,26
20090228-M-Dubai-F-Novak_Djokovic-David_Ferrer,2,F-DTM,49,3,0,0,3,22,27
20090228-M-Dubai-F-Novak_Djokovic-David_Ferrer,2,F-DTL,17,5,3,0,2,10,7
20090228-M-Dubai-F-Novak_Djokovic-David_Ferrer,2,F-IO,51,8,0,1,7,25,26
20090228-M-Dubai-F-Novak_Djokovic-David_Ferrer,2,F-II,11,4,0,4,0,8,3
20090228-M-Dubai-F-Novak_Djokovic-David_Ferrer,2,B-XC,50,4,0,0,4,24,26
20090228-M-Dubai-F-Novak_Djokovic-David_Ferrer,2,B-DTM,41,1,0,0,1,18,23
20090228-M-Dubai-F-Novak_Djokovic-David_Ferrer,2,B-DTL,8,2,0,1,1,4,4
20090228-M-Dubai-F-Novak_Djokovic-David_Ferrer,2,B-IO,1,0,0,0,0,0,1
20090228-M-Dubai-F-Novak_Djokovic-David_Ferrer,2,S-XC,3,0,0,0,0,2,1
20090228-M-Dubai-F-Novak_Djokovic-David_Ferrer,2,S-DTM,3,0,0,0,0,0,3
20090228-M-Dubai-F-Novak_Djokovic-David_Ferrer,2,S-DTL,2,0,0,0,0,1,1
19870823-M-Cincinnati-F-Boris_Becker-Stefan_Edberg,1,F-XC,16,3,2,1,0,9,7
19870823-M-Cincinnati-F-Boris_Becker-Stefan_Edberg,1,F-DTM,8,2,0,1,1,4,4
19870823-M-Cincinnati-F-Boris_Becker-Stefan_Edberg,1,F-DTL,6,0,0,0,0,0,6
19870823-M-Cincinnati-F-Boris_Becker-Stefan_Edberg,1,F-IO,9,0,0,0,0,5,4
19870823-M-Cincinnati-F-Boris_Becker-Stefan_Edberg,1,F-II,1,0,0,0,0,0,1
19870823-M-Cincinnati-F-Boris_Becker-Stefan_Edberg,1,B-XC,8,2,0,1,1,3,5
19870823-M-Cincinnati-F-Boris_Becker-Stefan_Edberg,1,B-DTM,6,0,0,0,0,0,6
19870823-M-Cincinnati-F-Boris_Becker-Stefan_Edberg,1,B-DTL,7,2,2,0,0,4,3
19870823-M-Cincinnati-F-Boris_Becker-Stefan_Edberg,1,B-IO,4,1,1,0,0,2,2
19870823-M-Cincinnati-F-Boris_Becker-Stefan_Edberg,1,S-XC,1,0,0,0,0,0,1
19870823-M-Cincinnati-F-Boris_Becker-Stefan_Edberg,1,S-DTM,4,1,0,0,1,0,4
19870823-M-Cincinnati-F-Boris_Becker-Stefan_Edberg,1,S-IO,2,0,0,0,0,1,1
19870823-M-Cincinnati-F-Boris_Becker-Stefan_Edberg,2,F-XC,8,4,2,0,2,5,3
19870823-M-Cincinnati-F-Boris_Becker-Stefan_Edberg,2,F-DTM,6,0,0,0,0,2,4
19870823-M-Cincinnati-F-Boris_Becker-Stefan_Edberg,2,F-DTL,6,1,1,0,0,5,1
19870823-M-Cincinnati-F-Boris_Becker-Stefan_Edberg,2,F-IO,2,1,0,1,0,2,0
19870823-M-Cincinnati-F-Boris_Becker-Stefan_Edberg,2,F-II,1,1,1,0,0,1,0
19870823-M-Cincinnati-F-Boris_Becker-Stefan_Edberg,2,B-XC,6,4,3,1,0,6,0
19870823-M-Cincinnati-F-Boris_Becker-Stefan_Edberg,2,B-DTM,3,2,0,0,2,1,2
19870823-M-Cincinnati-F-Boris_Becker-Stefan_Edberg,2,B-DTL,4,2,1,1,0,2,2
19870823-M-Cincinnati-F-Boris_Becker-Stefan_Edberg,2,B-IO,1,1,0,0,1,0,1
19870823-M-Cincinnati-F-Boris_Becker-Stefan_Edberg,2,S-XC,8,0,0,0,0,4,4
19870823-M-Cincinnati-F-Boris_Becker-Stefan_Edberg,2,S-DTM,4,0,0,0,0,3,1
19870823-M-Cincinnati-F-Boris_Becker-Stefan_Edberg,2,S-DTL,3,0,0,0,0,2,1
19900616-M-Queens_Club-SF-Stefan_Edberg-Boris_Becker,1,F-XC,1,0,0,0,0,1,0
19900616-M-Queens_Club-SF-Stefan_Edberg-Boris_Becker,1,F-DTM,1,0,0,0,0,0,1
19900616-M-Queens_Club-SF-Stefan_Edberg-Boris_Becker,1,F-DTL,2,2,0,1,1,1,1
19900616-M-Queens_Club-SF-Stefan_Edberg-Boris_Becker,1,B-XC,3,2,1,1,0,2,1
19900616-M-Queens_Club-SF-Stefan_Edberg-Boris_Becker,1,B-DTL,2,1,0,0,1,0,2
19900616-M-Queens_Club-SF-Stefan_Edberg-Boris_Becker,1,B-IO,2,1,0,0,1,0,2
19900616-M-Queens_Club-SF-Stefan_Edberg-Boris_Becker,1,B-II,1,1,1,0,0,1,0
19900616-M-Queens_Club-SF-Stefan_Edberg-Boris_Becker,1,S-XC,1,0,0,0,0,0,1
19900616-M-Queens_Club-SF-Stefan_Edberg-Boris_Becker,2,F-XC,5,3,3,0,0,4,1
19900616-M-Queens_Club-SF-Stefan_Edberg-Boris_Becker,2,F-DTM,4,1,0,0,1,1,3
19900616-M-Queens_Club-SF-Stefan_Edberg-Boris_Becker,2,F-DTL,5,3,2,1,0,4,1
19900616-M-Queens_Club-SF-Stefan_Edberg-Boris_Becker,2,F-IO,3,1,0,0,1,1,2
19900616-M-Queens_Club-SF-Stefan_Edberg-Boris_Becker,2,B-XC,1,1,0,0,1,0,1
19900616-M-Queens_Club-SF-Stefan_Edberg-Boris_Becker,2,B-DTL,5,4,3,1,0,4,1
19900616-M-Queens_Club-SF-Stefan_Edberg-Boris_Becker,2,S-DTM,1,0,0,0,0,0,1
20180608-M-Roland_Garros-SF-Marco_Cecchinato-Dominic_Thiem,1,F-XC,46,13,4,5,4,24,22
20180608-M-Roland_Garros-SF-Marco_Cecchinato-Dominic_Thiem,1,F-DTM,27,1,0,0,1,12,15
20180608-M-Roland_Garros-SF-Marco_Cecchinato-Dominic_Thiem,1,F-DTL,8,3,1,0,2,3,5
20180608-M-Roland_Garros-SF-Marco_Cecchinato-Dominic_Thiem,1,F-IO,24,6,4,1,1,12,12
20180608-M-Roland_Garros-SF-Marco_Cecchinato-Dominic_Thiem,1,F-II,16,8,2,1,5,8,8
20180608-M-Roland_Garros-SF-Marco_Cecchinato-Dominic_Thiem,1,B-XC,33,1,0,0,1,14,19
20180608-M-Roland_Garros-SF-Marco_Cecchinato-Dominic_Thiem,1,B-DTM,18,2,0,0,2,5,13
20180608-M-Roland_Garros-SF-Marco_Cecchinato-Dominic_Thiem,1,B-DTL,6,4,0,1,3,2,4
20180608-M-Roland_Garros-SF-Marco_Cecchinato-Dominic_Thiem,1,S-XC,19,1,0,0,1,5,14
20180608-M-Roland_Garros-SF-Marco_Cecchinato-Dominic_Thiem,1,S-DTM,1,0,0,0,0,1,0
20180608-M-Roland_Garros-SF-Marco_Cecchinato-Dominic_Thiem,1,S-DTL,3,0,0,0,0,0,3
20180608-M-Roland_Garros-SF-Marco_Cecchinato-Dominic_Thiem,2,F-XC,62,20,4,10,6,43,19
20180608-M-Roland_Garros-SF-Marco_Cecchinato-Dominic_Thiem,2,F-DTM,13,2,0,1,1,5,8
20180608-M-Roland_Garros-SF-Marco_Cecchinato-Dominic_Thiem,2,F-DTL,11,3,1,0,2,5,6
20180608-M-Roland_Garros-SF-Marco_Cecchinato-Dominic_Thiem,2,F-IO,42,6,1,3,2,29,13
20180608-M-Roland_Garros-SF-Marco_Cecchinato-Dominic_Thiem,2,F-II,15,10,4,5,1,12,3
20180608-M-Roland_Garros-SF-Marco_Cecchinato-Dominic_Thiem,2,B-XC,36,3,1,0,2,20,16
20180608-M-Roland_Garros-SF-Marco_Cecchinato-Dominic_Thiem,2,B-DTM,9,0,0,0,0,2,7
20180608-M-Roland_Garros-SF-Marco_Cecchinato-Dominic_Thiem,2,B-DTL,9,8,3,2,3,5,4
20180608-M-Roland_Garros-SF-Marco_Cecchinato-Dominic_Thiem,2,S-XC,13,1,0,0,1,6,7
20180608-M-Roland_Garros-SF-Marco_Cecchinato-Dominic_Thiem,2,S-DTM,5,1,0,0,1,2,3
20180602-M-Roland_Garros-R32-Gael_Monfils-David_Goffin,1,F-XC,109,23,5,11,7,60,49
20180602-M-Roland_Garros-R32-Gael_Monfils-David_Goffin,1,F-DTM,67,7,1,0,6,32,35
20180602-M-Roland_Garros-R32-Gael_Monfils-David_Goffin,1,F-DTL,25,12,4,4,4,14,11
20180602-M-Roland_Garros-R32-Gael_Monfils-David_Goffin,1,F-IO,43,10,1,2,7,22,21
20180602-M-Roland_Garros-R32-Gael_Monfils-David_Goffin,1,F-II,7,5,3,1,1,4,3
20180602-M-Roland_Garros-R32-Gael_Monfils-David_Goffin,1,B-XC,145,17,4,3,10,75,70
20180602-M-Roland_Garros-R32-Gael_Monfils-David_Goffin,1,B-DTM,89,11,2,0,9,39,50
20180602-M-Roland_Garros-R32-Gael_Monfils-David_Goffin,1,B-DTL,26,13,5,2,6,14,12
20180602-M-Roland_Garros-R32-Gael_Monfils-David_Goffin,1,B-IO,7,2,0,0,2,5,2
20180602-M-Roland_Garros-R32-Gael_Monfils-David_Goffin,1,S-XC,11,2,0,0,2,3,8
20180602-M-Roland_Garros-R32-Gael_Monfils-David_Goffin,1,S-DTM,7,0,0,0,0,2,5
20180602-M-Roland_Garros-R32-Gael_Monfils-David_Goffin,1,S-DTL,4,1,1,0,0,2,2
20180602-M-Roland_Garros-R32-Gael_Monfils-David_Goffin,2,F-XC,136,28,8,6,14,65,71
20180602-M-Roland_Garros-R32-Gael_Monfils-David_Goffin,2,F-DTM,58,4,0,2,2,20,38
20180602-M-Roland_Garros-R32-Gael_Monfils-David_Goffin,2,F-DTL,47,10,6,3,1,29,18
20180602-M-Roland_Garros-R32-Gael_Monfils-David_Goffin,2,F-IO,53,12,6,2,4,32,21
20180602-M-Roland_Garros-R32-Gael_Monfils-David_Goffin,2,F-II,18,5,2,1,2,12,6
20180602-M-Roland_Garros-R32-Gael_Monfils-David_Goffin,2,B-XC,143,20,5,5,10,77,66
20180602-M-Roland_Garros-R32-Gael_Monfils-David_Goffin,2,B-DTM,49,6,1,0,5,19,30
20180602-M-Roland_Garros-R32-Gael_Monfils-David_Goffin,2,B-DTL,23,12,3,2,7,9,14
20180602-M-Roland_Garros-R32-Gael_Monfils-David_Goffin,2,B-IO,8,4,1,0,3,5,3
20180602-M-Roland_Garros-R32-Gael_Monfils-David_Goffin,2,S-XC,15,3,1,1,1,8,7
20180602-M-Roland_Garros-R32-Gael_Monfils-David_Goffin,2,S-DTM,2,0,0,0,0,1,1
20180602-M-Roland_Garros-R32-Gael_Monfils-David_Goffin,2,S-IO,1,0,0,0,0,0,1
19861026-M-Tokyo_Indoor-F-Stefan_Edberg-Boris_Becker,1,F-XC,7,4,4,0,0,7,0
19861026-M-Tokyo_Indoor-F-Stefan_Edberg-Boris_Becker,1,F-DTM,7,0,0,0,0,3,4
19861026-M-Tokyo_Indoor-F-Stefan_Edberg-Boris_Becker,1,F-DTL,1,1,0,1,0,1,0
19861026-M-Tokyo_Indoor-F-Stefan_Edberg-Boris_Becker,1,F-IO,2,0,0,0,0,2,0
19861026-M-Tokyo_Indoor-F-Stefan_Edberg-Boris_Becker,1,B-XC,14,5,2,0,3,6,8
19861026-M-Tokyo_Indoor-F-Stefan_Edberg-Boris_Becker,1,B-DTM,2,1,0,1,0,2,0
19861026-M-Tokyo_Indoor-F-Stefan_Edberg-Boris_Becker,1,B-DTL,5,2,2,0,0,3,2
19861026-M-Tokyo_Indoor-F-Stefan_Edberg-Boris_Becker,1,B-IO,4,3,0,1,2,1,3
19861026-M-Tokyo_Indoor-F-Stefan_Edberg-Boris_Becker,1,S-XC,5,0,0,0,0,0,5
19861026-M-Tokyo_Indoor-F-Stefan_Edberg-Boris_Becker,1,S-DTM,2,0,0,0,0,1,1
19861026-M-Tokyo_Indoor-F-Stefan_Edberg-Boris_Becker,1,S-DTL,3,2,1,0,1,2,1
19861026-M-Tokyo_Indoor-F-Stefan_Edberg-Boris_Becker,2,F-XC,6,2,1,0,1,3,3
19861026-M-Tokyo_Indoor-F-Stefan_Edberg-Boris_Becker,2,F-DTM,5,0,0,0,0,0,5
19861026-M-Tokyo_Indoor-F-Stefan_Edberg-Boris_Becker,2,F-DTL,4,3,1,2,0,4,0
19861026-M-Tokyo_Indoor-F-Stefan_Edberg-Boris_Becker,2,F-IO,6,3,0,1,2,3,3
19861026-M-Tokyo_Indoor-F-Stefan_Edberg-Boris_Becker,2,F-II,1,0,0,0,0,0,1
19861026-M-Tokyo_Indoor-F-Stefan_Edberg-Boris_Becker,2,B-XC,5,1,0,1,0,5,0
19861026-M-Tokyo_Indoor-F-Stefan_Edberg-Boris_Becker,2,B-DTM,5,2,0,1,1,3,2
19861026-M-Tokyo_Indoor-F-Stefan_Edberg-Boris_Becker,2,B-DTL,5,4,0,2,2,3,2
19861026-M-Tokyo_Indoor-F-Stefan_Edberg-Boris_Becker,2,B-IO,1,0,0,0,0,0,1
19861026-M-Tokyo_Indoor-F-Stefan_Edberg-Boris_Becker,2,S-XC,6,0,0,0,0,3,3
19861026-M-Tokyo_Indoor-F-Stefan_Edberg-Boris_Becker,2,S-DTM,5,0,0,0,0,2,3
19861026-M-Tokyo_Indoor-F-Stefan_Edberg-Boris_Becker,2,S-DTL,3,0,0,0,0,2,1
20080322-M-Indian_Wells_Masters-SF-Novak_Djokovic-Rafael_Nadal,1,F-XC,41,4,0,4,0,29,12
20080322-M-Indian_Wells_Masters-SF-Novak_Djokovic-Rafael_Nadal,1,F-DTM,25,3,0,0,3,13,12
20080322-M-Indian_Wells_Masters-SF-Novak_Djokovic-Rafael_Nadal,1,F-DTL,10,4,1,1,2,4,6
20080322-M-Indian_Wells_Masters-SF-Novak_Djokovic-Rafael_Nadal,1,F-IO,28,13,5,1,7,11,17
20080322-M-Indian_Wells_Masters-SF-Novak_Djokovic-Rafael_Nadal,1,F-II,3,1,0,1,0,2,1
20080322-M-Indian_Wells_Masters-SF-Novak_Djokovic-Rafael_Nadal,1,B-XC,20,4,3,1,0,13,7
20080322-M-Indian_Wells_Masters-SF-Novak_Djokovic-Rafael_Nadal,1,B-DTM,30,2,0,0,2,18,12
20080322-M-Indian_Wells_Masters-SF-Novak_Djokovic-Rafael_Nadal,1,B-DTL,20,3,2,0,1,12,8
20080322-M-Indian_Wells_Masters-SF-Novak_Djokovic-Rafael_Nadal,1,B-IO,7,1,0,0,1,4,3
20080322-M-Indian_Wells_Masters-SF-Novak_Djokovic-Rafael_Nadal,1,B-II,1,0,0,0,0,0,1
20080322-M-Indian_Wells_Masters-SF-Novak_Djokovic-Rafael_Nadal,1,S-DTM,1,0,0,0,0,1,0
20080322-M-Indian_Wells_Masters-SF-Novak_Djokovic-Rafael_Nadal,2,F-XC,46,7,2,3,2,22,24
20080322-M-Indian_Wells_Masters-SF-Novak_Djokovic-Rafael_Nadal,2,F-DTM,25,2,0,0,2,11,14
20080322-M-Indian_Wells_Masters-SF-Novak_Djokovic-Rafael_Nadal,2,F-DTL,12,5,1,2,2,6,6
20080322-M-Indian_Wells_Masters-SF-Novak_Djokovic-Rafael_Nadal,2,F-IO,23,9,2,4,3,11,12
20080322-M-Indian_Wells_Masters-SF-Novak_Djokovic-Rafael_Nadal,2,F-II,1,0,0,0,0,0,1
20080322-M-Indian_Wells_Masters-SF-Novak_Djokovic-Rafael_Nadal,2,B-XC,35,4,0,0,4,14,21
20080322-M-Indian_Wells_Masters-SF-Novak_Djokovic-Rafael_Nadal,2,B-DTM,24,2,0,0,2,10,14
20080322-M-Indian_Wells_Masters-SF-Novak_Djokovic-Rafael_Nadal,2,B-DTL,6,2,0,0,2,2,4
20080322-M-Indian_Wells_Masters-SF-Novak_Djokovic-Rafael_Nadal,2,B-IO,5,1,0,0,1,1,4
20080322-M-Indian_Wells_Masters-SF-Novak_Djokovic-Rafael_Nadal,2,S-XC,1,0,0,0,0,0,1
20080322-M-Indian_Wells_Masters-SF-Novak_Djokovic-Rafael_Nadal,2,S-DTM,7,0,0,0,0,4,3
20080322-M-Indian_Wells_Masters-SF-Novak_Djokovic-Rafael_Nadal,2,S-DTL,4,0,0,0,0,2,2
20080322-M-Indian_Wells_Masters-SF-Novak_Djokovic-Rafael_Nadal,2,S-IO,2,0,0,0,0,0,2
20180617-M-Stuttgart-F-Milos_Raonic-Roger_Federer,1,F-XC,16,5,2,2,1,12,4
20180617-M-Stuttgart-F-Milos_Raonic-Roger_Federer,1,F-DTM,6,0,0,0,0,4,2
20180617-M-Stuttgart-F-Milos_Raonic-Roger_Federer,1,F-DTL,1,1,0,1,0,1,0
20180617-M-Stuttgart-F-Milos_Raonic-Roger_Federer,1,F-IO,15,7,3,1,3,10,5
20180617-M-Stuttgart-F-Milos_Raonic-Roger_Federer,1,F-II,1,1,0,1,0,1,0
20180617-M-Stuttgart-F-Milos_Raonic-Roger_Federer,1,B-XC,7,1,0,0,1,2,5
20180617-M-Stuttgart-F-Milos_Raonic-Roger_Federer,1,B-DTM,8,4,1,0,3,2,6
20180617-M-Stuttgart-F-Milos_Raonic-Roger_Federer,1,B-DTL,4,4,0,1,3,1,3
20180617-M-Stuttgart-F-Milos_Raonic-Roger_Federer,1,S-XC,7,1,0,0,1,2,5
20180617-M-Stuttgart-F-Milos_Raonic-Roger_Federer,1,S-DTM,3,1,0,0,1,2,1
20180617-M-Stuttgart-F-Milos_Raonic-Roger_Federer,1,S-DTL,3,0,0,0,0,2,1
20180617-M-Stuttgart-F-Milos_Raonic-Roger_Federer,2,F-XC,13,9,6,1,2,8,5
20180617-M-Stuttgart-F-Milos_Raonic-Roger_Federer,2,F-DTM,17,3,1,1,1,8,9
20180617-M-Stuttgart-F-Milos_Raonic-Roger_Federer,2,F-DTL,5,3,3,0,0,4,1
20180617-M-Stuttgart-F-Milos_Raonic-Roger_Federer,2,F-IO,15,3,1,0,2,9,6
20180617-M-Stuttgart-F-Milos_Raonic-Roger_Federer,2,F-II,1,0,0,0,0,0,1
20180617-M-Stuttgart-F-Milos_Raonic-Roger_Federer,2,B-XC,9,1,0,1,0,3,6
20180617-M-Stuttgart-F-Milos_Raonic-Roger_Federer,2,B-DTM,5,2,0,1,1,2,3
20180617-M-Stuttgart-F-Milos_Raonic-Roger_Federer,2,B-DTL,2,0,0,0,0,0,2
20180617-M-Stuttgart-F-Milos_Raonic-Roger_Federer,2,S-XC,2,0,0,0,0,1,1
20180617-M-Stuttgart-F-Milos_Raonic-Roger_Federer,2,S-DTM,2,0,0,0,0,1,1
20180617-M-Stuttgart-F-Milos_Raonic-Roger_Federer,2,S-DTL,4,1,0,1,0,3,1
19910907-M-US_Open-SF-Ivan_Lendl-Stefan_Edberg,1,F-XC,27,4,2,1,1,15,12
19910907-M-US_Open-SF-Ivan_Lendl-Stefan_Edberg,1,F-DTM,11,0,0,0,0,4,7
19910907-M-US_Open-SF-Ivan_Lendl-Stefan_Edberg,1,F-DTL,10,3,1,2,0,5,5
19910907-M-US_Open-SF-Ivan_Lendl-Stefan_Edberg,1,F-IO,20,2,0,2,0,13,7
19910907-M-US_Open-SF-Ivan_Lendl-Stefan_Edberg,1,F-II,5,2,0,1,1,2,3
19910907-M-US_Open-SF-Ivan_Lendl-Stefan_Edberg,1,B-XC,14,4,1,2,1,5,9
19910907-M-US_Open-SF-Ivan_Lendl-Stefan_Edberg,1,B-DTM,8,1,0,0,1,4,4
19910907-M-US_Open-SF-Ivan_Lendl-Stefan_Edberg,1,B-DTL,15,4,0,2,2,4,11
19910907-M-US_Open-SF-Ivan_Lendl-Stefan_Edberg,1,B-IO,3,1,1,0,0,2,1
19910907-M-US_Open-SF-Ivan_Lendl-Stefan_Edberg,1,S-XC,10,1,0,0,1,5,5
19910907-M-US_Open-SF-Ivan_Lendl-Stefan_Edberg,1,S-DTM,7,1,0,0,1,3,4
19910907-M-US_Open-SF-Ivan_Lendl-Stefan_Edberg,1,S-DTL,16,5,1,1,3,4,12
19910907-M-US_Open-SF-Ivan_Lendl-Stefan_Edberg,1,S-IO,2,1,0,0,1,1,1
19910907-M-US_Open-SF-Ivan_Lendl-Stefan_Edberg,2,F-XC,19,4,1,1,2,11,8
19910907-M-US_Open-SF-Ivan_Lendl-Stefan_Edberg,2,F-DTM,14,0,0,0,0,4,10
19910907-M-US_Open-SF-Ivan_Lendl-Stefan_Edberg,2,F-DTL,18,2,1,0,1,13,5
19910907-M-US_Open-SF-Ivan_Lendl-Stefan_Edberg,2,F-IO,6,2,0,1,1,3,3
19910907-M-US_Open-SF-Ivan_Lendl-Stefan_Edberg,2,B-XC,11,1,0,1,0,6,5
19910907-M-US_Open-SF-Ivan_Lendl-Stefan_Edberg,2,B-DTM,3,0,0,0,0,1,2
19910907-M-US_Open-SF-Ivan_Lendl-Stefan_Edberg,2,B-DTL,6,3,1,1,1,2,4
19910907-M-US_Open-SF-Ivan_Lendl-Stefan_Edberg,2,B-IO,2,0,0,0,0,2,0
19910907-M-US_Open-SF-Ivan_Lendl-Stefan_Edberg,2,S-XC,24,2,0,2,0,14,10
20180617-M-s_Hertogenbosch-F-Richard_Gasquet-Jeremy_Chardy,1,F-XC,30,12,6,2,4,20,10
20180617-M-s_Hertogenbosch-F-Richard_Gasquet-Jeremy_Chardy,1,F-DTM,21,4,1,0,3,9,12
20180617-M-s_Hertogenbosch-F-Richard_Gasquet-Jeremy_Chardy,1,F-DTL,9,0,0,0,0,8,1
20180617-M-s_Hertogenbosch-F-Richard_Gasquet-Jeremy_Chardy,1,F-IO,7,0,0,0,0,5,2
20180617-M-s_Hertogenbosch-F-Richard_Gasquet-Jeremy_Chardy,1,F-II,2,2,0,0,2,0,2
20180617-M-s_Hertogenbosch-F-Richard_Gasquet-Jeremy_Chardy,1,B-XC,30,3,2,0,1,19,11
20180617-M-s_Hertogenbosch-F-Richard_Gasquet-Jeremy_Chardy,1,B-DTM,11,1,0,0,1,7,4
20180617-M-s_Hertogenbosch-F-Richard_Gasquet-Jeremy_Chardy,1,B-DTL,6,4,1,0,3,2,4
20180617-M-s_Hertogenbosch-F-Richard_Gasquet-Jeremy_Chardy,1,S-XC,10,2,0,1,1,4,6
20180617-M-s_Hertogenbosch-F-Richard_Gasquet-Jeremy_Chardy,1,S-DTM,5,0,0,0,0,2,3
20180617-M-s_Hertogenbosch-F-Richard_Gasquet-Jeremy_Chardy,1,S-DTL,1,1,1,0,0,1,0
20180617-M-s_Hertogenbosch-F-Richard_Gasquet-Jeremy_Chardy,2,F-XC,33,7,1,2,4,11,22
20180617-M-s_Hertogenbosch-F-Richard_Gasquet-Jeremy_Chardy,2,F-DTM,11,0,0,0,0,6,5
20180617-M-s_Hertogenbosch-F-Richard_Gasquet-Jeremy_Chardy,2,F-DTL,12,6,2,0,4,5,7
20180617-M-s_Hertogenbosch-F-Richard_Gasquet-Jeremy_Chardy,2,F-IO,34,12,4,7,1,22,12
20180617-M-s_Hertogenbosch-F-Richard_Gasquet-Jeremy_Chardy,2,F-II,5,3,0,0,3,1,4
20180617-M-s_Hertogenbosch-F-Richard_Gasquet-Jeremy_Chardy,2,B-XC,14,5,0,0,5,4,10
20180617-M-s_Hertogenbosch-F-Richard_Gasquet-Jeremy_Chardy,2,B-DTM,9,0,0,0,0,3,6
20180617-M-s_Hertogenbosch-F-Richard_Gasquet-Jeremy_Chardy,2,B-DTL,9,5,0,1,4,2,7
20180617-M-s_Hertogenbosch-F-Richard_Gasquet-Jeremy_Chardy,2,S-XC,6,1,0,1,0,3,3
20180617-M-s_Hertogenbosch-F-Richard_Gasquet-Jeremy_Chardy,2,S-DTM,9,1,0,0,1,3,6
20180617-M-s_Hertogenbosch-F-Richard_Gasquet-Jeremy_Chardy,2,S-DTL,8,1,0,0,1,2,6
20180617-M-s_Hertogenbosch-F-Richard_Gasquet-Jeremy_Chardy,2,S-IO,1,0,0,0,0,0,1
19870222-M-Indian_Wells-F-Stefan_Edberg-Boris_Becker,1,F-XC,16,7,2,2,3,10,6
19870222-M-Indian_Wells-F-Stefan_Edberg-Boris_Becker,1,F-DTM,13,0,0,0,0,7,6
19870222-M-Indian_Wells-F-Stefan_Edberg-Boris_Becker,1,F-DTL,9,4,1,0,3,3,6
19870222-M-Indian_Wells-F-Stefan_Edberg-Boris_Becker,1,F-IO,1,0,0,0,0,1,0
19870222-M-Indian_Wells-F-Stefan_Edberg-Boris_Becker,1,B-XC,26,6,1,1,4,16,10
19870222-M-Indian_Wells-F-Stefan_Edberg-Boris_Becker,1,B-DTM,11,3,0,1,2,4,7
19870222-M-Indian_Wells-F-Stefan_Edberg-Boris_Becker,1,B-DTL,7,6,1,2,3,3,4
19870222-M-Indian_Wells-F-Stefan_Edberg-Boris_Becker,1,B-IO,5,1,1,0,0,2,3
19870222-M-Indian_Wells-F-Stefan_Edberg-Boris_Becker,1,S-XC,20,4,1,1,2,16,4
19870222-M-Indian_Wells-F-Stefan_Edberg-Boris_Becker,1,S-DTM,10,0,0,0,0,6,4
19870222-M-Indian_Wells-F-Stefan_Edberg-Boris_Becker,1,S-DTL,4,1,0,0,1,2,2
19870222-M-Indian_Wells-F-Stefan_Edberg-Boris_Becker,1,S-IO,1,0,0,0,0,1,0
19870222-M-Indian_Wells-F-Stefan_Edberg-Boris_Becker,2,F-XC,22,11,3,2,6,11,11
19870222-M-Indian_Wells-F-Stefan_Edberg-Boris_Becker,2,F-DTM,4,1,0,1,0,1,3
19870222-M-Indian_Wells-F-Stefan_Edberg-Boris_Becker,2,F-DTL,3,1,0,1,0,2,1
19870222-M-Indian_Wells-F-Stefan_Edberg-Boris_Becker,2,F-IO,11,5,1,4,0,7,4
19870222-M-Indian_Wells-F-Stefan_Edberg-Boris_Becker,2,B-XC,25,8,0,5,3,11,14
19870222-M-Indian_Wells-F-Stefan_Edberg-Boris_Becker,2,B-DTM,17,3,0,0,3,2,15
19870222-M-Indian_Wells-F-Stefan_Edberg-Boris_Becker,2,B-DTL,7,3,0,2,1,4,3
19870222-M-Indian_Wells-F-Stefan_Edberg-Boris_Becker,2,B-IO,5,3,2,0,1,4,1
19870222-M-Indian_Wells-F-Stefan_Edberg-Boris_Becker,2,B-II,1,1,1,0,0,1,0
19870222-M-Indian_Wells-F-Stefan_Edberg-Boris_Becker,2,S-XC,12,2,0,0,2,3,9
19870222-M-Indian_Wells-F-Stefan_Edberg-Boris_Becker,2,S-DTM,3,1,0,0,1,1,2
19870222-M-Indian_Wells-F-Stefan_Edberg-Boris_Becker,2,S-DTL,5,1,0,0,1,2,3
19870222-M-Indian_Wells-F-Stefan_Edberg-Boris_Becker,2,S-IO,1,0,0,0,0,0,1
19891105-M-Paris_Masters-F-Stefan_Edberg-Boris_Becker,1,F-XC,10,4,0,1,3,4,6
19891105-M-Paris_Masters-F-Stefan_Edberg-Boris_Becker,1,F-DTM,7,1,0,0,1,1,6
19891105-M-Paris_Masters-F-Stefan_Edberg-Boris_Becker,1,F-DTL,4,0,0,0,0,1,3
19891105-M-Paris_Masters-F-Stefan_Edberg-Boris_Becker,1,F-IO,3,1,0,0,1,1,2
19891105-M-Paris_Masters-F-Stefan_Edberg-Boris_Becker,1,B-XC,24,4,1,1,2,14,10
19891105-M-Paris_Masters-F-Stefan_Edberg-Boris_Becker,1,B-DTM,6,0,0,0,0,3,3
19891105-M-Paris_Masters-F-Stefan_Edberg-Boris_Becker,1,B-DTL,11,5,2,1,2,5,6
19891105-M-Paris_Masters-F-Stefan_Edberg-Boris_Becker,1,B-IO,5,4,1,1,2,3,2
19891105-M-Paris_Masters-F-Stefan_Edberg-Boris_Becker,1,S-XC,4,0,0,0,0,0,4
19891105-M-Paris_Masters-F-Stefan_Edberg-Boris_Becker,1,S-DTM,2,0,0,0,0,0,2
19891105-M-Paris_Masters-F-Stefan_Edberg-Boris_Becker,1,S-DTL,2,0,0,0,0,0,2
19891105-M-Paris_Masters-F-Stefan_Edberg-Boris_Becker,2,F-XC,21,6,3,0,3,13,8
19891105-M-Paris_Masters-F-Stefan_Edberg-Boris_Becker,2,F-DTM,4,0,0,0,0,1,3
19891105-M-Paris_Masters-F-Stefan_Edberg-Boris_Becker,2,F-DTL,8,6,2,3,1,6,2
19891105-M-Paris_Masters-F-Stefan_Edberg-Boris_Becker,2,F-IO,16,6,1,3,2,13,3
19891105-M-Paris_Masters-F-Stefan_Edberg-Boris_Becker,2,F-II,1,0,0,0,0,1,0
19891105-M-Paris_Masters-F-Stefan_Edberg-Boris_Becker,2,B-XC,9,3,1,1,1,5,4
19891105-M-Paris_Masters-F-Stefan_Edberg-Boris_Becker,2,B-DTM,10,0,0,0,0,5,5
19891105-M-Paris_Masters-F-Stefan_Edberg-Boris_Becker,2,B-DTL,3,3,1,0,2,1,2
19891105-M-Paris_Masters-F-Stefan_Edberg-Boris_Becker,2,B-IO,5,2,2,0,0,5,0
19891105-M-Paris_Masters-F-Stefan_Edberg-Boris_Becker,2,S-XC,9,0,0,0,0,3,6
19891105-M-Paris_Masters-F-Stefan_Edberg-Boris_Becker,2,S-DTM,3,0,0,0,0,1,2
19891105-M-Paris_Masters-F-Stefan_Edberg-Boris_Becker,2,S-DTL,5,1,0,0,1,1,4
19861109-M-Stockholm-F-Mats_Wilander-Stefan_Edberg,1,F-XC,29,2,0,0,2,12,17
19861109-M-Stockholm-F-Mats_Wilander-Stefan_Edberg,1,F-DTM,18,1,0,0,1,5,13
19861109-M-Stockholm-F-Mats_Wilander-Stefan_Edberg,1,F-DTL,9,4,0,3,1,6,3
19861109-M-Stockholm-F-Mats_Wilander-Stefan_Edberg,1,F-IO,5,2,0,0,2,2,3
19861109-M-Stockholm-F-Mats_Wilander-Stefan_Edberg,1,B-XC,12,2,0,1,1,3,9
19861109-M-Stockholm-F-Mats_Wilander-Stefan_Edberg,1,B-DTM,8,1,0,0,1,2,6
19861109-M-Stockholm-F-Mats_Wilander-Stefan_Edberg,1,B-DTL,4,2,0,1,1,2,2
19861109-M-Stockholm-F-Mats_Wilander-Stefan_Edberg,1,B-IO,5,4,1,2,1,4,1
19861109-M-Stockholm-F-Mats_Wilander-Stefan_Edberg,1,S-XC,4,0,0,0,0,1,3
19861109-M-Stockholm-F-Mats_Wilander-Stefan_Edberg,1,S-DTM,10,1,0,0,1,3,7
19861109-M-Stockholm-F-Mats_Wilander-Stefan_Edberg,1,S-DTL,8,0,0,0,0,3,5
19861109-M-Stockholm-F-Mats_Wilander-Stefan_Edberg,1,S-IO,3,0,0,0,0,1,2
19861109-M-Stockholm-F-Mats_Wilander-Stefan_Edberg,2,F-XC,34,9,4,2,3,18,16
19861109-M-Stockholm-F-Mats_Wilander-Stefan_Edberg,2,F-DTM,12,0,0,0,0,7,5
19861109-M-Stockholm-F-Mats_Wilander-Stefan_Edberg,2,F-DTL,10,2,0,1,1,7,3
19861109-M-Stockholm-F-Mats_Wilander-Stefan_Edberg,2,F-IO,7,3,1,0,2,4,3
19861109-M-Stockholm-F-Mats_Wilander-Stefan_Edberg,2,B-XC,14,6,2,1,3,10,4
19861109-M-Stockholm-F-Mats_Wilander-Stefan_Edberg,2,B-DTM,7,1,0,0,1,2,5
19861109-M-Stockholm-F-Mats_Wilander-Stefan_Edberg,2,B-DTL,2,1,0,1,0,2,0
19861109-M-Stockholm-F-Mats_Wilander-Stefan_Edberg,2,B-IO,2,2,2,0,0,2,0
19861109-M-Stockholm-F-Mats_Wilander-Stefan_Edberg,2,S-XC,8,0,0,0,0,7,1
19861109-M-Stockholm-F-Mats_Wilander-Stefan_Edberg,2,S-DTL,2,0,0,0,0,2,0
20180428-M-Budapest-SF-John_Millman-Aljaz_Bedene,1,F-XC,133,25,6,9,10,79,54
20180428-M-Budapest-SF-John_Millman-Aljaz_Bedene,1,F-DTM,51,3,0,1,2,29,22
20180428-M-Budapest-SF-John_Millman-Aljaz_Bedene,1,F-DTL,16,7,1,1,5,6,10
20180428-M-Budapest-SF-John_Millman-Aljaz_Bedene,1,F-IO,48,13,7,0,6,23,25
20180428-M-Budapest-SF-John_Millman-Aljaz_Bedene,1,F-II,6,2,1,1,0,5,1
20180428-M-Budapest-SF-John_Millman-Aljaz_Bedene,1,B-XC,141,9,2,2,5,83,58
20180428-M-Budapest-SF-John_Millman-Aljaz_Bedene,1,B-DTM,78,7,1,1,4,41,37
20180428-M-Budapest-SF-John_Millman-Aljaz_Bedene,1,B-DTL,18,11,8,1,2,12,6
20180428-M-Budapest-SF-John_Millman-Aljaz_Bedene,1,B-IO,7,2,1,0,1,2,5
20180428-M-Budapest-SF-John_Millman-Aljaz_Bedene,1,S-XC,6,0,0,0,0,3,3
20180428-M-Budapest-SF-John_Millman-Aljaz_Bedene,1,S-DTM,6,0,0,0,0,2,4
20180428-M-Budapest-SF-John_Millman-Aljaz_Bedene,1,S-DTL,3,0,0,0,0,1,2
20180428-M-Budapest-SF-John_Millman-Aljaz_Bedene,1,S-IO,2,0,0,0,0,1,1
20180428-M-Budapest-SF-John_Millman-Aljaz_Bedene,2,F-XC,104,21,5,4,12,52,52
20180428-M-Budapest-SF-John_Millman-Aljaz_Bedene,2,F-DTM,82,2,0,0,2,29,53
20180428-M-Budapest-SF-John_Millman-Aljaz_Bedene,2,F-DTL,25,9,3,3,3,17,8
20180428-M-Budapest-SF-John_Millman-Aljaz_Bedene,2,F-IO,91,17,4,6,7,43,48
20180428-M-Budapest-SF-John_Millman-Aljaz_Bedene,2,F-II,8,1,0,0,1,5,3
20180428-M-Budapest-SF-John_Millman-Aljaz_Bedene,2,B-XC,83,10,1,3,6,36,47
20180428-M-Budapest-SF-John_Millman-Aljaz_Bedene,2,B-DTM,63,0,0,0,0,27,36
20180428-M-Budapest-SF-John_Millman-Aljaz_Bedene,2,B-DTL,14,5,4,0,1,7,7
20180428-M-Budapest-SF-John_Millman-Aljaz_Bedene,2,B-IO,1,1,0,0,1,0,1
20180428-M-Budapest-SF-John_Millman-Aljaz_Bedene,2,S-XC,5,0,0,0,0,2,3
20180428-M-Budapest-SF-John_Millman-Aljaz_Bedene,2,S-DTM,8,0,0,0,0,3,5
20180428-M-Budapest-SF-John_Millman-Aljaz_Bedene,2,S-DTL,3,0,0,0,0,0,3
20180428-M-Budapest-SF-John_Millman-Aljaz_Bedene,2,S-IO,2,0,0,0,0,2,0
20090321-M-Indian_Wells_Masters-SF-Roger_Federer-Andy_Murray,1,F-XC,30,10,3,3,4,17,13
20090321-M-Indian_Wells_Masters-SF-Roger_Federer-Andy_Murray,1,F-DTM,17,1,0,0,1,9,8
20090321-M-Indian_Wells_Masters-SF-Roger_Federer-Andy_Murray,1,F-DTL,8,4,1,0,3,2,6
20090321-M-Indian_Wells_Masters-SF-Roger_Federer-Andy_Murray,1,F-IO,30,9,3,2,4,19,11
20090321-M-Indian_Wells_Masters-SF-Roger_Federer-Andy_Murray,1,F-II,10,6,3,0,3,5,5
20090321-M-Indian_Wells_Masters-SF-Roger_Federer-Andy_Murray,1,B-XC,35,11,0,1,10,13,22
20090321-M-Indian_Wells_Masters-SF-Roger_Federer-Andy_Murray,1,B-DTM,23,2,1,0,1,10,13
20090321-M-Indian_Wells_Masters-SF-Roger_Federer-Andy_Murray,1,B-DTL,16,8,2,0,6,3,13
20090321-M-Indian_Wells_Masters-SF-Roger_Federer-Andy_Murray,1,B-IO,1,1,0,0,1,0,1
20090321-M-Indian_Wells_Masters-SF-Roger_Federer-Andy_Murray,1,S-XC,39,0,0,0,0,17,22
20090321-M-Indian_Wells_Masters-SF-Roger_Federer-Andy_Murray,1,S-DTM,7,2,0,0,2,3,4
20090321-M-Indian_Wells_Masters-SF-Roger_Federer-Andy_Murray,1,S-DTL,7,1,1,0,0,1,6
20090321-M-Indian_Wells_Masters-SF-Roger_Federer-Andy_Murray,1,S-IO,1,1,0,0,1,0,1
20090321-M-Indian_Wells_Masters-SF-Roger_Federer-Andy_Murray,2,F-XC,30,10,4,3,3,16,14
20090321-M-Indian_Wells_Masters-SF-Roger_Federer-Andy_Murray,2,F-DTM,23,1,0,0,1,11,12
20090321-M-Indian_Wells_Masters-SF-Roger_Federer-Andy_Murray,2,F-DTL,11,2,1,0,1,10,1
20090321-M-Indian_Wells_Masters-SF-Roger_Federer-Andy_Murray,2,F-IO,32,4,0,2,2,16,16
20090321-M-Indian_Wells_Masters-SF-Roger_Federer-Andy_Murray,2,F-II,4,2,1,0,1,2,2
20090321-M-Indian_Wells_Masters-SF-Roger_Federer-Andy_Murray,2,B-XC,62,6,2,1,3,35,27
20090321-M-Indian_Wells_Masters-SF-Roger_Federer-Andy_Murray,2,B-DTM,20,0,0,0,0,11,9
20090321-M-Indian_Wells_Masters-SF-Roger_Federer-Andy_Murray,2,B-DTL,6,3,0,1,2,3,3
20090321-M-Indian_Wells_Masters-SF-Roger_Federer-Andy_Murray,2,B-IO,1,1,1,0,0,1,0
20090321-M-Indian_Wells_Masters-SF-Roger_Federer-Andy_Murray,2,S-XC,16,0,0,0,0,11,5
20090321-M-Indian_Wells_Masters-SF-Roger_Federer-Andy_Murray,2,S-DTM,4,1,0,0,1,1,3
20090321-M-Indian_Wells_Masters-SF-Roger_Federer-Andy_Murray,2,S-DTL,1,1,0,0,1,0,1
20090321-M-Indian_Wells_Masters-SF-Roger_Federer-Andy_Murray,2,S-IO,2,0,0,0,0,2,0
20090321-M-Indian_Wells_Masters-SF-Roger_Federer-Andy_Murray,2,S-II,1,0,0,0,0,0,1
20180621-M-Queens_Club-R16-Novak_Djokovic-Grigor_Dimitrov,1,F-XC,16,3,1,1,1,11,5
20180621-M-Queens_Club-R16-Novak_Djokovic-Grigor_Dimitrov,1,F-DTM,17,1,0,1,0,7,10
20180621-M-Queens_Club-R16-Novak_Djokovic-Grigor_Dimitrov,1,F-DTL,7,2,1,1,0,4,3
20180621-M-Queens_Club-R16-Novak_Djokovic-Grigor_Dimitrov,1,F-IO,8,0,0,0,0,6,2
20180621-M-Queens_Club-R16-Novak_Djokovic-Grigor_Dimitrov,1,F-II,1,0,0,0,0,0,1
20180621-M-Queens_Club-R16-Novak_Djokovic-Grigor_Dimitrov,1,B-XC,14,2,1,1,0,7,7
20180621-M-Queens_Club-R16-Novak_Djokovic-Grigor_Dimitrov,1,B-DTM,23,2,0,0,2,8,15
20180621-M-Queens_Club-R16-Novak_Djokovic-Grigor_Dimitrov,1,B-DTL,2,1,0,1,0,2,0
20180621-M-Queens_Club-R16-Novak_Djokovic-Grigor_Dimitrov,1,B-IO,1,0,0,0,0,0,1
20180621-M-Queens_Club-R16-Novak_Djokovic-Grigor_Dimitrov,1,S-XC,9,2,0,0,2,6,3
20180621-M-Queens_Club-R16-Novak_Djokovic-Grigor_Dimitrov,1,S-DTM,2,0,0,0,0,1,1
20180621-M-Queens_Club-R16-Novak_Djokovic-Grigor_Dimitrov,1,S-DTL,1,0,0,0,0,1,0
20180621-M-Queens_Club-R16-Novak_Djokovic-Grigor_Dimitrov,2,F-XC,24,7,1,3,3,12,12
20180621-M-Queens_Club-R16-Novak_Djokovic-Grigor_Dimitrov,2,F-DTM,19,4,1,0,3,8,11
20180621-M-Queens_Club-R16-Novak_Djokovic-Grigor_Dimitrov,2,F-DTL,7,2,1,1,0,4,3
20180621-M-Queens_Club-R16-Novak_Djokovic-Grigor_Dimitrov,2,F-IO,14,6,1,1,4,9,5
20180621-M-Queens_Club-R16-Novak_Djokovic-Grigor_Dimitrov,2,F-II,2,1,0,0,1,0,2
20180621-M-Queens_Club-R16-Novak_Djokovic-Grigor_Dimitrov,2,B-XC,5,1,0,1,0,3,2
20180621-M-Queens_Club-R16-Novak_Djokovic-Grigor_Dimitrov,2,B-DTM,9,2,0,0,2,4,5
20180621-M-Queens_Club-R16-Novak_Djokovic-Grigor_Dimitrov,2,B-DTL,4,2,0,0,2,2,2
20180621-M-Queens_Club-R16-Novak_Djokovic-Grigor_Dimitrov,2,B-IO,3,1,0,0,1,2,1
20180621-M-Queens_Club-R16-Novak_Djokovic-Grigor_Dimitrov,2,S-XC,9,0,0,0,0,2,7
20180621-M-Queens_Club-R16-Novak_Djokovic-Grigor_Dimitrov,2,S-DTM,15,2,0,0,2,7,8
20180621-M-Queens_Club-R16-Novak_Djokovic-Grigor_Dimitrov,2,S-DTL,2,0,0,0,0,1,1
20180621-M-Queens_Club-R16-Novak_Djokovic-Grigor_Dimitrov,2,S-IO,1,1,0,0,1,0,1
20180622-M-Queens_Club-QF-Novak_Djokovic-Adrian_Mannarino,1,F-XC,26,6,1,4,1,18,8
20180622-M-Queens_Club-QF-Novak_Djokovic-Adrian_Mannarino,1,F-DTM,27,1,0,0,1,10,17
20180622-M-Queens_Club-QF-Novak_Djokovic-Adrian_Mannarino,1,F-DTL,14,3,2,0,1,5,9
20180622-M-Queens_Club-QF-Novak_Djokovic-Adrian_Mannarino,1,F-IO,17,7,3,2,2,11,6
20180622-M-Queens_Club-QF-Novak_Djokovic-Adrian_Mannarino,1,B-XC,17,4,0,3,1,11,6
20180622-M-Queens_Club-QF-Novak_Djokovic-Adrian_Mannarino,1,B-DTM,16,2,0,0,2,7,9
20180622-M-Queens_Club-QF-Novak_Djokovic-Adrian_Mannarino,1,B-DTL,10,7,0,3,4,4,6
20180622-M-Queens_Club-QF-Novak_Djokovic-Adrian_Mannarino,1,B-IO,9,1,0,1,0,4,5
20180622-M-Queens_Club-QF-Novak_Djokovic-Adrian_Mannarino,1,S-XC,5,0,0,0,0,1,4
20180622-M-Queens_Club-QF-Novak_Djokovic-Adrian_Mannarino,1,S-DTM,17,0,0,0,0,9,8
20180622-M-Queens_Club-QF-Novak_Djokovic-Adrian_Mannarino,1,S-DTL,4,2,0,0,2,0,4
20180622-M-Queens_Club-QF-Novak_Djokovic-Adrian_Mannarino,1,S-IO,11,1,0,1,0,5,6
20180622-M-Queens_Club-QF-Novak_Djokovic-Adrian_Mannarino,2,F-XC,27,7,1,1,5,12,15
20180622-M-Queens_Club-QF-Novak_Djokovic-Adrian_Mannarino,2,F-DTM,43,4,1,0,3,23,20
20180622-M-Queens_Club-QF-Novak_Djokovic-Adrian_Mannarino,2,F-DTL,3,2,1,1,0,2,1
20180622-M-Queens_Club-QF-Novak_Djokovic-Adrian_Mannarino,2,F-IO,8,4,0,0,4,3,5
20180622-M-Queens_Club-QF-Novak_Djokovic-Adrian_Mannarino,2,B-XC,39,5,0,2,3,20,19
20180622-M-Queens_Club-QF-Novak_Djokovic-Adrian_Mannarino,2,B-DTM,39,2,0,0,2,17,22
20180622-M-Queens_Club-QF-Novak_Djokovic-Adrian_Mannarino,2,B-DTL,6,2,2,0,0,4,2
20180622-M-Queens_Club-QF-Novak_Djokovic-Adrian_Mannarino,2,B-IO,13,4,1,1,2,9,4
20180622-M-Queens_Club-QF-Novak_Djokovic-Adrian_Mannarino,2,S-XC,1,0,0,0,0,1,0
20180622-M-Queens_Club-QF-Novak_Djokovic-Adrian_Mannarino,2,S-DTM,2,0,0,0,0,1,1
20180622-M-Queens_Club-QF-Novak_Djokovic-Adrian_Mannarino,2,S-DTL,4,1,0,0,1,2,2
20180622-M-Queens_Club-QF-Novak_Djokovic-Adrian_Mannarino,2,S-IO,2,0,0,0,0,0,2
20180624-M-Halle-F-Borna_Coric-Roger_Federer,1,F-XC,38,9,2,4,3,24,14
20180624-M-Halle-F-Borna_Coric-Roger_Federer,1,F-DTM,13,1,0,1,0,10,3
20180624-M-Halle-F-Borna_Coric-Roger_Federer,1,F-DTL,12,0,0,0,0,7,5
20180624-M-Halle-F-Borna_Coric-Roger_Federer,1,F-IO,38,10,0,3,7,21,17
20180624-M-Halle-F-Borna_Coric-Roger_Federer,1,F-II,6,5,1,3,1,5,1
20180624-M-Halle-F-Borna_Coric-Roger_Federer,1,B-XC,57,5,1,2,2,38,19
20180624-M-Halle-F-Borna_Coric-Roger_Federer,1,B-DTM,20,2,0,1,1,15,5
20180624-M-Halle-F-Borna_Coric-Roger_Federer,1,B-DTL,5,2,0,1,1,3,2
20180624-M-Halle-F-Borna_Coric-Roger_Federer,1,B-IO,5,1,1,0,0,4,1
20180624-M-Halle-F-Borna_Coric-Roger_Federer,1,S-XC,4,0,0,0,0,2,2
20180624-M-Halle-F-Borna_Coric-Roger_Federer,1,S-DTL,1,0,0,0,0,1,0
20180624-M-Halle-F-Borna_Coric-Roger_Federer,2,F-XC,31,8,6,1,1,15,16
20180624-M-Halle-F-Borna_Coric-Roger_Federer,2,F-DTM,18,6,0,2,4,5,13
20180624-M-Halle-F-Borna_Coric-Roger_Federer,2,F-DTL,11,1,0,0,1,3,8
20180624-M-Halle-F-Borna_Coric-Roger_Federer,2,F-IO,13,4,1,1,2,4,9
20180624-M-Halle-F-Borna_Coric-Roger_Federer,2,F-II,4,0,0,0,0,3,1
20180624-M-Halle-F-Borna_Coric-Roger_Federer,2,B-XC,21,9,3,3,3,10,11
20180624-M-Halle-F-Borna_Coric-Roger_Federer,2,B-DTM,25,2,0,0,2,8,17
20180624-M-Halle-F-Borna_Coric-Roger_Federer,2,B-DTL,5,2,0,0,2,1,4
20180624-M-Halle-F-Borna_Coric-Roger_Federer,2,S-XC,24,1,0,0,1,7,17
20180624-M-Halle-F-Borna_Coric-Roger_Federer,2,S-DTM,15,0,0,0,0,3,12
20180624-M-Halle-F-Borna_Coric-Roger_Federer,2,S-DTL,8,2,0,1,1,3,5
20180624-M-Queens_Club-F-Novak_Djokovic-Marin_Cilic,1,F-XC,37,5,2,1,2,15,22
20180624-M-Queens_Club-F-Novak_Djokovic-Marin_Cilic,1,F-DTM,36,2,1,0,1,13,23
20180624-M-Queens_Club-F-Novak_Djokovic-Marin_Cilic,1,F-DTL,18,4,0,1,3,7,11
20180624-M-Queens_Club-F-Novak_Djokovic-Marin_Cilic,1,F-IO,11,3,2,0,1,4,7
20180624-M-Queens_Club-F-Novak_Djokovic-Marin_Cilic,1,F-II,1,1,0,0,1,0,1
20180624-M-Queens_Club-F-Novak_Djokovic-Marin_Cilic,1,B-XC,47,7,0,2,5,17,30
20180624-M-Queens_Club-F-Novak_Djokovic-Marin_Cilic,1,B-DTM,24,1,1,0,0,13,11
20180624-M-Queens_Club-F-Novak_Djokovic-Marin_Cilic,1,B-DTL,9,4,3,1,0,7,2
20180624-M-Queens_Club-F-Novak_Djokovic-Marin_Cilic,1,B-IO,5,2,1,0,1,3,2
20180624-M-Queens_Club-F-Novak_Djokovic-Marin_Cilic,1,S-XC,15,0,0,0,0,9,6
20180624-M-Queens_Club-F-Novak_Djokovic-Marin_Cilic,1,S-DTM,6,0,0,0,0,2,4
20180624-M-Queens_Club-F-Novak_Djokovic-Marin_Cilic,1,S-DTL,5,1,0,0,1,1,4
20180624-M-Queens_Club-F-Novak_Djokovic-Marin_Cilic,2,F-XC,64,20,8,5,7,42,22
20180624-M-Queens_Club-F-Novak_Djokovic-Marin_Cilic,2,F-DTM,18,2,0,0,2,7,11
20180624-M-Queens_Club-F-Novak_Djokovic-Marin_Cilic,2,F-DTL,16,10,8,0,2,12,4
20180624-M-Queens_Club-F-Novak_Djokovic-Marin_Cilic,2,F-IO,19,11,5,2,4,10,9
20180624-M-Queens_Club-F-Novak_Djokovic-Marin_Cilic,2,F-II,3,1,1,0,0,3,0
20180624-M-Queens_Club-F-Novak_Djokovic-Marin_Cilic,2,B-XC,49,14,2,3,9,25,24
20180624-M-Queens_Club-F-Novak_Djokovic-Marin_Cilic,2,B-DTM,25,2,0,0,2,19,6
20180624-M-Queens_Club-F-Novak_Djokovic-Marin_Cilic,2,B-DTL,15,10,6,1,3,10,5
20180624-M-Queens_Club-F-Novak_Djokovic-Marin_Cilic,2,B-IO,5,2,1,0,1,3,2
20180624-M-Queens_Club-F-Novak_Djokovic-Marin_Cilic,2,S-XC,23,3,1,1,1,15,8
20180624-M-Queens_Club-F-Novak_Djokovic-Marin_Cilic,2,S-DTM,7,0,0,0,0,3,4
20180624-M-Queens_Club-F-Novak_Djokovic-Marin_Cilic,2,S-DTL,3,2,1,0,1,1,2
20180624-M-Queens_Club-F-Novak_Djokovic-Marin_Cilic,2,S-IO,3,3,1,1,1,2,1
19901007-M-Sydney_Indoor-F-Boris_Becker-Stefan_Edberg,1,F-XC,9,1,1,0,0,5,4
19901007-M-Sydney_Indoor-F-Boris_Becker-Stefan_Edberg,1,F-DTM,2,0,0,0,0,1,1
19901007-M-Sydney_Indoor-F-Boris_Becker-Stefan_Edberg,1,F-DTL,6,2,1,0,1,2,4
19901007-M-Sydney_Indoor-F-Boris_Becker-Stefan_Edberg,1,F-IO,8,5,1,3,1,5,3
19901007-M-Sydney_Indoor-F-Boris_Becker-Stefan_Edberg,1,B-XC,11,2,1,0,1,4,7
19901007-M-Sydney_Indoor-F-Boris_Becker-Stefan_Edberg,1,B-DTM,5,0,0,0,0,3,2
19901007-M-Sydney_Indoor-F-Boris_Becker-Stefan_Edberg,1,B-DTL,8,6,4,0,2,4,4
19901007-M-Sydney_Indoor-F-Boris_Becker-Stefan_Edberg,1,B-IO,1,1,1,0,0,1,0
19901007-M-Sydney_Indoor-F-Boris_Becker-Stefan_Edberg,1,S-XC,3,0,0,0,0,2,1
19901007-M-Sydney_Indoor-F-Boris_Becker-Stefan_Edberg,1,S-DTM,2,0,0,0,0,2,0
19901007-M-Sydney_Indoor-F-Boris_Becker-Stefan_Edberg,1,S-DTL,3,1,1,0,0,2,1
19901007-M-Sydney_Indoor-F-Boris_Becker-Stefan_Edberg,2,F-XC,6,3,2,0,1,4,2
19901007-M-Sydney_Indoor-F-Boris_Becker-Stefan_Edberg,2,F-DTM,2,0,0,0,0,1,1
19901007-M-Sydney_Indoor-F-Boris_Becker-Stefan_Edberg,2,F-DTL,4,2,1,0,1,2,2
19901007-M-Sydney_Indoor-F-Boris_Becker-Stefan_Edberg,2,F-IO,2,0,0,0,0,1,1
19901007-M-Sydney_Indoor-F-Boris_Becker-Stefan_Edberg,2,B-XC,17,5,1,1,3,6,11
19901007-M-Sydney_Indoor-F-Boris_Becker-Stefan_Edberg,2,B-DTM,5,1,0,1,0,2,3
19901007-M-Sydney_Indoor-F-Boris_Becker-Stefan_Edberg,2,B-DTL,9,4,1,0,3,5,4
19901007-M-Sydney_Indoor-F-Boris_Becker-Stefan_Edberg,2,B-IO,1,0,0,0,0,0,1
19901007-M-Sydney_Indoor-F-Boris_Becker-Stefan_Edberg,2,S-XC,4,0,0,0,0,4,0
19901007-M-Sydney_Indoor-F-Boris_Becker-Stefan_Edberg,2,S-DTM,2,0,0,0,0,2,0
19950929-M-Basel-QF-Stefan_Edberg-Boris_Becker,1,F-XC,8,2,1,0,1,5,3
19950929-M-Basel-QF-Stefan_Edberg-Boris_Becker,1,F-DTM,2,0,0,0,0,1,1
19950929-M-Basel-QF-Stefan_Edberg-Boris_Becker,1,F-DTL,3,1,1,0,0,2,1
19950929-M-Basel-QF-Stefan_Edberg-Boris_Becker,1,F-IO,2,0,0,0,0,1,1
19950929-M-Basel-QF-Stefan_Edberg-Boris_Becker,1,B-XC,5,5,1,1,3,2,3
19950929-M-Basel-QF-Stefan_Edberg-Boris_Becker,1,B-DTM,2,0,0,0,0,2,0
19950929-M-Basel-QF-Stefan_Edberg-Boris_Becker,1,B-IO,2,2,1,1,0,2,0
19950929-M-Basel-QF-Stefan_Edberg-Boris_Becker,1,S-XC,2,0,0,0,0,0,2
19950929-M-Basel-QF-Stefan_Edberg-Boris_Becker,1,S-DTM,1,0,0,0,0,0,1
19950929-M-Basel-QF-Stefan_Edberg-Boris_Becker,2,F-XC,5,3,2,1,0,3,2
19950929-M-Basel-QF-Stefan_Edberg-Boris_Becker,2,F-DTM,2,0,0,0,0,0,2
19950929-M-Basel-QF-Stefan_Edberg-Boris_Becker,2,F-DTL,6,4,1,1,2,4,2
19950929-M-Basel-QF-Stefan_Edberg-Boris_Becker,2,F-IO,2,0,0,0,0,1,1
19950929-M-Basel-QF-Stefan_Edberg-Boris_Becker,2,B-XC,3,2,1,0,1,2,1
19950929-M-Basel-QF-Stefan_Edberg-Boris_Becker,2,B-DTM,5,0,0,0,0,4,1
19950929-M-Basel-QF-Stefan_Edberg-Boris_Becker,2,B-DTL,10,1,1,0,0,3,7
19950929-M-Basel-QF-Stefan_Edberg-Boris_Becker,2,B-IO,1,1,0,0,1,0,1
19950929-M-Basel-QF-Stefan_Edberg-Boris_Becker,2,S-XC,1,1,0,1,0,1,0
19950929-M-Basel-QF-Stefan_Edberg-Boris_Becker,2,S-DTL,1,1,0,1,0,1,0
19900805-M-Los_Angeles-F-Michael_Chang-Stefan_Edberg,1,F-XC,51,13,6,1,6,30,21
19900805-M-Los_Angeles-F-Michael_Chang-Stefan_Edberg,1,F-DTM,12,0,0,0,0,4,8
19900805-M-Los_Angeles-F-Michael_Chang-Stefan_Edberg,1,F-DTL,16,5,0,4,1,10,6
19900805-M-Los_Angeles-F-Michael_Chang-Stefan_Edberg,1,F-IO,3,2,1,0,1,2,1
19900805-M-Los_Angeles-F-Michael_Chang-Stefan_Edberg,1,F-II,2,0,0,0,0,2,0
19900805-M-Los_Angeles-F-Michael_Chang-Stefan_Edberg,1,B-XC,51,8,2,5,1,25,26
19900805-M-Los_Angeles-F-Michael_Chang-Stefan_Edberg,1,B-DTM,45,1,0,1,0,18,27
19900805-M-Los_Angeles-F-Michael_Chang-Stefan_Edberg,1,B-DTL,28,8,3,2,3,15,13
19900805-M-Los_Angeles-F-Michael_Chang-Stefan_Edberg,1,B-IO,2,0,0,0,0,1,1
19900805-M-Los_Angeles-F-Michael_Chang-Stefan_Edberg,1,S-XC,1,0,0,0,0,1,0
19900805-M-Los_Angeles-F-Michael_Chang-Stefan_Edberg,1,S-DTM,1,0,0,0,0,0,1
19900805-M-Los_Angeles-F-Michael_Chang-Stefan_Edberg,2,F-XC,51,11,3,5,3,23,28
19900805-M-Los_Angeles-F-Michael_Chang-Stefan_Edberg,2,F-DTM,19,1,0,0,1,10,9
19900805-M-Los_Angeles-F-Michael_Chang-Stefan_Edberg,2,F-DTL,19,5,0,3,2,8,11
19900805-M-Los_Angeles-F-Michael_Chang-Stefan_Edberg,2,F-IO,19,6,1,3,2,14,5
19900805-M-Los_Angeles-F-Michael_Chang-Stefan_Edberg,2,F-II,1,0,0,0,0,1,0
19900805-M-Los_Angeles-F-Michael_Chang-Stefan_Edberg,2,B-XC,39,8,0,0,8,19,20
19900805-M-Los_Angeles-F-Michael_Chang-Stefan_Edberg,2,B-DTM,8,0,0,0,0,5,3
19900805-M-Los_Angeles-F-Michael_Chang-Stefan_Edberg,2,B-DTL,9,7,4,1,2,6,3
19900805-M-Los_Angeles-F-Michael_Chang-Stefan_Edberg,2,S-XC,17,0,0,0,0,7,10
19900805-M-Los_Angeles-F-Michael_Chang-Stefan_Edberg,2,S-DTL,2,0,0,0,0,2,0
19900805-M-Los_Angeles-F-Michael_Chang-Stefan_Edberg,2,S-II,1,0,0,0,0,1,0
19900127-M-Australian_Open-SF-Mats_Wilander-Stefan_Edberg,1,F-XC,20,3,2,1,0,13,7
19900127-M-Australian_Open-SF-Mats_Wilander-Stefan_Edberg,1,F-DTM,21,4,0,1,3,7,14
19900127-M-Australian_Open-SF-Mats_Wilander-Stefan_Edberg,1,F-DTL,10,0,0,0,0,4,6
19900127-M-Australian_Open-SF-Mats_Wilander-Stefan_Edberg,1,F-IO,17,3,1,0,2,5,12
19900127-M-Australian_Open-SF-Mats_Wilander-Stefan_Edberg,1,F-II,2,0,0,0,0,0,2
19900127-M-Australian_Open-SF-Mats_Wilander-Stefan_Edberg,1,B-XC,18,3,0,1,2,5,13
19900127-M-Australian_Open-SF-Mats_Wilander-Stefan_Edberg,1,B-DTM,18,0,0,0,0,5,13
19900127-M-Australian_Open-SF-Mats_Wilander-Stefan_Edberg,1,B-DTL,17,4,1,0,3,1,16
19900127-M-Australian_Open-SF-Mats_Wilander-Stefan_Edberg,1,B-IO,3,2,2,0,0,3,0
19900127-M-Australian_Open-SF-Mats_Wilander-Stefan_Edberg,1,S-XC,12,0,0,0,0,5,7
19900127-M-Australian_Open-SF-Mats_Wilander-Stefan_Edberg,1,S-DTM,8,0,0,0,0,1,7
19900127-M-Australian_Open-SF-Mats_Wilander-Stefan_Edberg,1,S-DTL,8,1,0,0,1,4,4
19900127-M-Australian_Open-SF-Mats_Wilander-Stefan_Edberg,1,S-IO,2,0,0,0,0,0,2
19900127-M-Australian_Open-SF-Mats_Wilander-Stefan_Edberg,2,F-XC,25,10,1,3,6,16,9
19900127-M-Australian_Open-SF-Mats_Wilander-Stefan_Edberg,2,F-DTM,8,0,0,0,0,2,6
19900127-M-Australian_Open-SF-Mats_Wilander-Stefan_Edberg,2,F-DTL,11,1,1,0,0,9,2
19900127-M-Australian_Open-SF-Mats_Wilander-Stefan_Edberg,2,F-IO,3,0,0,0,0,3,0
19900127-M-Australian_Open-SF-Mats_Wilander-Stefan_Edberg,2,B-XC,33,4,2,0,2,24,9
19900127-M-Australian_Open-SF-Mats_Wilander-Stefan_Edberg,2,B-DTM,8,0,0,0,0,6,2
19900127-M-Australian_Open-SF-Mats_Wilander-Stefan_Edberg,2,B-DTL,3,1,1,0,0,2,1
19900127-M-Australian_Open-SF-Mats_Wilander-Stefan_Edberg,2,B-IO,3,1,0,0,1,2,1
19900127-M-Australian_Open-SF-Mats_Wilander-Stefan_Edberg,2,S-XC,18,1,0,0,1,12,6
19900127-M-Australian_Open-SF-Mats_Wilander-Stefan_Edberg,2,S-DTM,5,1,0,0,1,1,4
19900127-M-Australian_Open-SF-Mats_Wilander-Stefan_Edberg,2,S-DTL,2,1,0,0,1,0,2
19900127-M-Australian_Open-SF-Mats_Wilander-Stefan_Edberg,2,S-IO,1,0,0,0,0,1,0
19921031-M-Stockholm_Masters-SF-Stefan_Edberg-Goran_Ivanisevic,1,F-XC,7,3,2,1,0,5,2
19921031-M-Stockholm_Masters-SF-Stefan_Edberg-Goran_Ivanisevic,1,F-DTM,1,0,0,0,0,0,1
19921031-M-Stockholm_Masters-SF-Stefan_Edberg-Goran_Ivanisevic,1,F-DTL,1,0,0,0,0,0,1
19921031-M-Stockholm_Masters-SF-Stefan_Edberg-Goran_Ivanisevic,1,F-IO,2,1,0,0,1,0,2
19921031-M-Stockholm_Masters-SF-Stefan_Edberg-Goran_Ivanisevic,1,B-XC,4,1,0,0,1,3,1
19921031-M-Stockholm_Masters-SF-Stefan_Edberg-Goran_Ivanisevic,1,B-DTM,2,1,0,0,1,0,2
19921031-M-Stockholm_Masters-SF-Stefan_Edberg-Goran_Ivanisevic,1,B-DTL,1,0,0,0,0,0,1
19921031-M-Stockholm_Masters-SF-Stefan_Edberg-Goran_Ivanisevic,1,B-IO,1,1,1,0,0,1,0
19921031-M-Stockholm_Masters-SF-Stefan_Edberg-Goran_Ivanisevic,1,S-XC,1,0,0,0,0,1,0
19921031-M-Stockholm_Masters-SF-Stefan_Edberg-Goran_Ivanisevic,1,S-DTL,1,0,0,0,0,1,0
19921031-M-Stockholm_Masters-SF-Stefan_Edberg-Goran_Ivanisevic,2,F-XC,9,4,1,1,2,6,3
19921031-M-Stockholm_Masters-SF-Stefan_Edberg-Goran_Ivanisevic,2,F-DTM,4,2,0,0,2,0,4
19921031-M-Stockholm_Masters-SF-Stefan_Edberg-Goran_Ivanisevic,2,F-DTL,3,0,0,0,0,1,2
19921031-M-Stockholm_Masters-SF-Stefan_Edberg-Goran_Ivanisevic,2,F-IO,1,0,0,0,0,1,0
19921031-M-Stockholm_Masters-SF-Stefan_Edberg-Goran_Ivanisevic,2,B-XC,4,3,2,0,1,3,1
19921031-M-Stockholm_Masters-SF-Stefan_Edberg-Goran_Ivanisevic,2,B-DTM,1,0,0,0,0,1,0
19921031-M-Stockholm_Masters-SF-Stefan_Edberg-Goran_Ivanisevic,2,B-DTL,2,1,0,0,1,0,2
19921031-M-Stockholm_Masters-SF-Stefan_Edberg-Goran_Ivanisevic,2,B-IO,2,2,0,0,2,0,2
19921031-M-Stockholm_Masters-SF-Stefan_Edberg-Goran_Ivanisevic,2,S-XC,1,1,0,1,0,1,0
19921031-M-Stockholm_Masters-SF-Stefan_Edberg-Goran_Ivanisevic,2,S-DTM,1,0,0,0,0,0,1
19921031-M-Stockholm_Masters-SF-Stefan_Edberg-Goran_Ivanisevic,2,S-DTL,5,1,1,0,0,3,2
19921031-M-Stockholm_Masters-SF-Stefan_Edberg-Goran_Ivanisevic,2,S-IO,1,0,0,0,0,1,0
19940424-M-Monte_Carlo_Masters-F-Sergi_Bruguera-Andrei_Medvedev,1,F-XC,47,12,3,4,5,24,23
19940424-M-Monte_Carlo_Masters-F-Sergi_Bruguera-Andrei_Medvedev,1,F-DTM,37,0,0,0,0,11,26
19940424-M-Monte_Carlo_Masters-F-Sergi_Bruguera-Andrei_Medvedev,1,F-DTL,20,4,3,0,1,10,10
19940424-M-Monte_Carlo_Masters-F-Sergi_Bruguera-Andrei_Medvedev,1,F-IO,44,9,2,4,3,26,18
19940424-M-Monte_Carlo_Masters-F-Sergi_Bruguera-Andrei_Medvedev,1,F-II,16,4,1,2,1,6,10
19940424-M-Monte_Carlo_Masters-F-Sergi_Bruguera-Andrei_Medvedev,1,B-XC,73,8,0,1,7,35,38
19940424-M-Monte_Carlo_Masters-F-Sergi_Bruguera-Andrei_Medvedev,1,B-DTM,25,1,0,0,1,9,16
19940424-M-Monte_Carlo_Masters-F-Sergi_Bruguera-Andrei_Medvedev,1,B-DTL,18,6,1,1,4,9,9
19940424-M-Monte_Carlo_Masters-F-Sergi_Bruguera-Andrei_Medvedev,1,B-IO,4,3,0,2,1,2,2
19940424-M-Monte_Carlo_Masters-F-Sergi_Bruguera-Andrei_Medvedev,1,S-XC,8,0,0,0,0,5,3
19940424-M-Monte_Carlo_Masters-F-Sergi_Bruguera-Andrei_Medvedev,1,S-DTM,13,1,0,0,1,4,9
19940424-M-Monte_Carlo_Masters-F-Sergi_Bruguera-Andrei_Medvedev,1,S-DTL,3,1,0,0,1,0,3
19940424-M-Monte_Carlo_Masters-F-Sergi_Bruguera-Andrei_Medvedev,2,F-XC,60,13,7,3,3,43,17
19940424-M-Monte_Carlo_Masters-F-Sergi_Bruguera-Andrei_Medvedev,2,F-DTM,35,8,0,2,6,15,20
19940424-M-Monte_Carlo_Masters-F-Sergi_Bruguera-Andrei_Medvedev,2,F-DTL,16,10,2,3,5,8,8
19940424-M-Monte_Carlo_Masters-F-Sergi_Bruguera-Andrei_Medvedev,2,F-IO,30,9,4,2,3,21,9
19940424-M-Monte_Carlo_Masters-F-Sergi_Bruguera-Andrei_Medvedev,2,F-II,11,3,2,1,0,7,4
19940424-M-Monte_Carlo_Masters-F-Sergi_Bruguera-Andrei_Medvedev,2,B-XC,91,13,5,2,6,50,41
19940424-M-Monte_Carlo_Masters-F-Sergi_Bruguera-Andrei_Medvedev,2,B-DTM,31,3,0,1,2,13,18
19940424-M-Monte_Carlo_Masters-F-Sergi_Bruguera-Andrei_Medvedev,2,B-DTL,18,12,3,4,5,10,8
19940424-M-Monte_Carlo_Masters-F-Sergi_Bruguera-Andrei_Medvedev,2,B-IO,4,1,0,0,1,3,1
19940424-M-Monte_Carlo_Masters-F-Sergi_Bruguera-Andrei_Medvedev,2,S-XC,12,0,0,0,0,3,9
19940424-M-Monte_Carlo_Masters-F-Sergi_Bruguera-Andrei_Medvedev,2,S-DTM,5,0,0,0,0,2,3
19940424-M-Monte_Carlo_Masters-F-Sergi_Bruguera-Andrei_Medvedev,2,S-DTL,1,0,0,0,0,0,1
19930424-M-Monte_Carlo_Masters-SF-Cedric_Pioline-Stefan_Edberg,1,F-XC,22,8,4,1,3,16,6
19930424-M-Monte_Carlo_Masters-SF-Cedric_Pioline-Stefan_Edberg,1,F-DTM,34,2,0,0,2,18,16
19930424-M-Monte_Carlo_Masters-SF-Cedric_Pioline-Stefan_Edberg,1,F-DTL,8,2,2,0,0,6,2
19930424-M-Monte_Carlo_Masters-SF-Cedric_Pioline-Stefan_Edberg,1,F-IO,13,5,1,2,2,7,6
19930424-M-Monte_Carlo_Masters-SF-Cedric_Pioline-Stefan_Edberg,1,F-II,1,1,0,0,1,0,1
19930424-M-Monte_Carlo_Masters-SF-Cedric_Pioline-Stefan_Edberg,1,B-XC,23,9,2,4,3,15,8
19930424-M-Monte_Carlo_Masters-SF-Cedric_Pioline-Stefan_Edberg,1,B-DTM,58,3,0,0,3,33,25
19930424-M-Monte_Carlo_Masters-SF-Cedric_Pioline-Stefan_Edberg,1,B-DTL,6,2,0,1,1,3,3
19930424-M-Monte_Carlo_Masters-SF-Cedric_Pioline-Stefan_Edberg,1,B-IO,2,0,0,0,0,1,1
19930424-M-Monte_Carlo_Masters-SF-Cedric_Pioline-Stefan_Edberg,1,S-XC,5,1,0,1,0,5,0
19930424-M-Monte_Carlo_Masters-SF-Cedric_Pioline-Stefan_Edberg,1,S-DTM,8,1,0,0,1,3,5
19930424-M-Monte_Carlo_Masters-SF-Cedric_Pioline-Stefan_Edberg,1,S-DTL,3,0,0,0,0,3,0
19930424-M-Monte_Carlo_Masters-SF-Cedric_Pioline-Stefan_Edberg,1,S-IO,2,0,0,0,0,2,0
19930424-M-Monte_Carlo_Masters-SF-Cedric_Pioline-Stefan_Edberg,2,F-XC,28,5,2,0,3,8,20
19930424-M-Monte_Carlo_Masters-SF-Cedric_Pioline-Stefan_Edberg,2,F-DTM,32,3,0,0,3,18,14
19930424-M-Monte_Carlo_Masters-SF-Cedric_Pioline-Stefan_Edberg,2,F-DTL,7,1,0,0,1,1,6
19930424-M-Monte_Carlo_Masters-SF-Cedric_Pioline-Stefan_Edberg,2,F-IO,28,2,0,0,2,10,18
19930424-M-Monte_Carlo_Masters-SF-Cedric_Pioline-Stefan_Edberg,2,B-XC,17,3,0,2,1,6,11
19930424-M-Monte_Carlo_Masters-SF-Cedric_Pioline-Stefan_Edberg,2,B-DTM,17,1,0,0,1,8,9
19930424-M-Monte_Carlo_Masters-SF-Cedric_Pioline-Stefan_Edberg,2,B-DTL,3,0,0,0,0,2,1
19930424-M-Monte_Carlo_Masters-SF-Cedric_Pioline-Stefan_Edberg,2,B-IO,2,1,0,1,0,2,0
19930424-M-Monte_Carlo_Masters-SF-Cedric_Pioline-Stefan_Edberg,2,S-XC,11,0,0,0,0,4,7
19930424-M-Monte_Carlo_Masters-SF-Cedric_Pioline-Stefan_Edberg,2,S-DTM,17,3,0,0,3,7,10
19930424-M-Monte_Carlo_Masters-SF-Cedric_Pioline-Stefan_Edberg,2,S-DTL,4,1,0,0,1,1,3
20180619-M-Halle-R32-Roger_Federer-Aljaz_Bedene,1,F-XC,20,9,2,3,4,9,11
20180619-M-Halle-R32-Roger_Federer-Aljaz_Bedene,1,F-DTM,12,0,0,0,0,6,6
20180619-M-Halle-R32-Roger_Federer-Aljaz_Bedene,1,F-DTL,8,1,0,0,1,3,5
20180619-M-Halle-R32-Roger_Federer-Aljaz_Bedene,1,F-IO,16,8,3,2,3,12,4
20180619-M-Halle-R32-Roger_Federer-Aljaz_Bedene,1,B-XC,10,2,0,1,1,5,5
20180619-M-Halle-R32-Roger_Federer-Aljaz_Bedene,1,B-DTM,12,1,0,0,1,6,6
20180619-M-Halle-R32-Roger_Federer-Aljaz_Bedene,1,B-DTL,5,4,1,1,2,3,2
20180619-M-Halle-R32-Roger_Federer-Aljaz_Bedene,1,S-XC,9,1,0,0,1,6,3
20180619-M-Halle-R32-Roger_Federer-Aljaz_Bedene,1,S-DTM,10,0,0,0,0,2,8
20180619-M-Halle-R32-Roger_Federer-Aljaz_Bedene,1,S-DTL,3,1,0,1,0,2,1
20180619-M-Halle-R32-Roger_Federer-Aljaz_Bedene,2,F-XC,21,9,3,2,4,13,8
20180619-M-Halle-R32-Roger_Federer-Aljaz_Bedene,2,F-DTM,12,1,0,0,1,6,6
20180619-M-Halle-R32-Roger_Federer-Aljaz_Bedene,2,F-DTL,2,2,0,1,1,1,1
20180619-M-Halle-R32-Roger_Federer-Aljaz_Bedene,2,F-IO,18,5,1,2,2,10,8
20180619-M-Halle-R32-Roger_Federer-Aljaz_Bedene,2,F-II,3,0,0,0,0,1,2
20180619-M-Halle-R32-Roger_Federer-Aljaz_Bedene,2,B-XC,14,3,0,0,3,5,9
20180619-M-Halle-R32-Roger_Federer-Aljaz_Bedene,2,B-DTM,26,2,1,0,1,12,14
20180619-M-Halle-R32-Roger_Federer-Aljaz_Bedene,2,B-IO,3,0,0,0,0,2,1
20180619-M-Halle-R32-Roger_Federer-Aljaz_Bedene,2,B-II,1,0,0,0,0,0,1
20180619-M-Halle-R32-Roger_Federer-Aljaz_Bedene,2,S-XC,1,0,0,0,0,1,0
20180619-M-Halle-R32-Roger_Federer-Aljaz_Bedene,2,S-DTM,6,0,0,0,0,2,4
20180619-M-Halle-R32-Roger_Federer-Aljaz_Bedene,2,S-DTL,2,1,0,0,1,1,1
20180622-M-Halle-QF-Matthew_Ebden-Roger_Federer,1,F-XC,11,5,0,0,5,3,8
20180622-M-Halle-QF-Matthew_Ebden-Roger_Federer,1,F-DTM,12,2,1,0,1,6,6
20180622-M-Halle-QF-Matthew_Ebden-Roger_Federer,1,F-DTL,9,3,0,1,2,5,4
20180622-M-Halle-QF-Matthew_Ebden-Roger_Federer,1,F-IO,26,4,1,1,2,20,6
20180622-M-Halle-QF-Matthew_Ebden-Roger_Federer,1,F-II,1,0,0,0,0,0,1
20180622-M-Halle-QF-Matthew_Ebden-Roger_Federer,1,B-XC,4,1,1,0,0,1,3
20180622-M-Halle-QF-Matthew_Ebden-Roger_Federer,1,B-DTM,14,0,0,0,0,5,9
20180622-M-Halle-QF-Matthew_Ebden-Roger_Federer,1,B-IO,1,1,0,0,1,0,1
20180622-M-Halle-QF-Matthew_Ebden-Roger_Federer,1,S-XC,1,0,0,0,0,1,0
20180622-M-Halle-QF-Matthew_Ebden-Roger_Federer,1,S-DTM,1,0,0,0,0,1,0
20180622-M-Halle-QF-Matthew_Ebden-Roger_Federer,1,S-IO,1,1,0,0,1,0,1
20180622-M-Halle-QF-Matthew_Ebden-Roger_Federer,2,F-XC,21,7,3,3,1,16,5
20180622-M-Halle-QF-Matthew_Ebden-Roger_Federer,2,F-DTM,21,1,0,0,1,11,10
20180622-M-Halle-QF-Matthew_Ebden-Roger_Federer,2,F-DTL,3,2,1,0,1,2,1
20180622-M-Halle-QF-Matthew_Ebden-Roger_Federer,2,F-IO,7,4,1,0,3,3,4
20180622-M-Halle-QF-Matthew_Ebden-Roger_Federer,2,B-XC,17,9,5,1,3,11,6
20180622-M-Halle-QF-Matthew_Ebden-Roger_Federer,2,B-DTM,25,6,0,0,6,9,16
20180622-M-Halle-QF-Matthew_Ebden-Roger_Federer,2,B-DTL,2,1,0,0,1,0,2
20180622-M-Halle-QF-Matthew_Ebden-Roger_Federer,2,B-IO,2,2,2,0,0,2,0
20180622-M-Halle-QF-Matthew_Ebden-Roger_Federer,2,S-XC,6,2,0,0,2,1,5
20180622-M-Halle-QF-Matthew_Ebden-Roger_Federer,2,S-DTM,10,1,0,0,1,1,9
20180622-M-Halle-QF-Matthew_Ebden-Roger_Federer,2,S-DTL,2,0,0,0,0,0,2
20180622-M-Halle-QF-Matthew_Ebden-Roger_Federer,2,S-IO,1,0,0,0,0,0,1
20180623-M-Halle-SF-Roger_Federer-Denis_Kudla,1,F-XC,25,13,1,9,3,19,6
20180623-M-Halle-SF-Roger_Federer-Denis_Kudla,1,F-DTM,25,4,0,0,4,10,15
20180623-M-Halle-SF-Roger_Federer-Denis_Kudla,1,F-DTL,4,2,1,1,0,4,0
20180623-M-Halle-SF-Roger_Federer-Denis_Kudla,1,F-IO,13,5,3,0,2,8,5
20180623-M-Halle-SF-Roger_Federer-Denis_Kudla,1,F-II,1,1,0,0,1,0,1
20180623-M-Halle-SF-Roger_Federer-Denis_Kudla,1,B-XC,14,6,0,2,4,7,7
20180623-M-Halle-SF-Roger_Federer-Denis_Kudla,1,B-DTM,16,4,0,0,4,8,8
20180623-M-Halle-SF-Roger_Federer-Denis_Kudla,1,B-DTL,2,1,0,0,1,1,1
20180623-M-Halle-SF-Roger_Federer-Denis_Kudla,1,B-IO,3,2,2,0,0,2,1
20180623-M-Halle-SF-Roger_Federer-Denis_Kudla,1,B-II,1,1,0,1,0,1,0
20180623-M-Halle-SF-Roger_Federer-Denis_Kudla,1,S-XC,3,1,0,0,1,1,2
20180623-M-Halle-SF-Roger_Federer-Denis_Kudla,1,S-DTM,10,0,0,0,0,6,4
20180623-M-Halle-SF-Roger_Federer-Denis_Kudla,1,S-IO,1,1,0,0,1,0,1
20180623-M-Halle-SF-Roger_Federer-Denis_Kudla,2,F-XC,16,6,3,0,3,7,9
20180623-M-Halle-SF-Roger_Federer-Denis_Kudla,2,F-DTM,20,2,0,1,1,10,10
20180623-M-Halle-SF-Roger_Federer-Denis_Kudla,2,F-DTL,5,2,0,0,2,2,3
20180623-M-Halle-SF-Roger_Federer-Denis_Kudla,2,F-IO,12,5,2,2,1,8,4
20180623-M-Halle-SF-Roger_Federer-Denis_Kudla,2,B-XC,20,7,1,2,4,9,11
20180623-M-Halle-SF-Roger_Federer-Denis_Kudla,2,B-DTM,21,0,0,0,0,11,10
20180623-M-Halle-SF-Roger_Federer-Denis_Kudla,2,B-DTL,5,5,2,2,1,4,1
20180623-M-Halle-SF-Roger_Federer-Denis_Kudla,2,B-IO,5,3,0,1,2,3,2
20180623-M-Halle-SF-Roger_Federer-Denis_Kudla,2,S-XC,1,0,0,0,0,0,1
20180623-M-Halle-SF-Roger_Federer-Denis_Kudla,2,S-DTM,5,0,0,0,0,1,4
20180623-M-Halle-SF-Roger_Federer-Denis_Kudla,2,S-DTL,2,0,0,0,0,1,1
20180623-M-Halle-SF-Roger_Federer-Denis_Kudla,2,S-IO,2,1,0,0,1,0,2
20180623-M-Halle-SF-Roger_Federer-Denis_Kudla,2,S-II,1,0,0,0,0,1,0
20180621-M-Halle-R16-Roger_Federer-Benoit_Paire,1,F-XC,11,4,0,2,2,5,6
20180621-M-Halle-R16-Roger_Federer-Benoit_Paire,1,F-DTM,23,2,1,0,1,10,13
20180621-M-Halle-R16-Roger_Federer-Benoit_Paire,1,F-DTL,6,2,1,0,1,4,2
20180621-M-Halle-R16-Roger_Federer-Benoit_Paire,1,F-IO,16,8,4,2,2,11,5
20180621-M-Halle-R16-Roger_Federer-Benoit_Paire,1,F-II,6,4,2,0,2,4,2
20180621-M-Halle-R16-Roger_Federer-Benoit_Paire,1,B-XC,16,2,1,1,0,8,8
20180621-M-Halle-R16-Roger_Federer-Benoit_Paire,1,B-DTM,20,4,1,0,3,10,10
20180621-M-Halle-R16-Roger_Federer-Benoit_Paire,1,B-DTL,5,3,0,1,2,3,2
20180621-M-Halle-R16-Roger_Federer-Benoit_Paire,1,B-IO,4,2,1,1,0,3,1
20180621-M-Halle-R16-Roger_Federer-Benoit_Paire,1,S-XC,8,2,0,1,1,4,4
20180621-M-Halle-R16-Roger_Federer-Benoit_Paire,1,S-DTM,15,2,0,1,1,4,11
20180621-M-Halle-R16-Roger_Federer-Benoit_Paire,1,S-DTL,7,0,0,0,0,5,2
20180621-M-Halle-R16-Roger_Federer-Benoit_Paire,1,S-IO,1,0,0,0,0,1,0
20180621-M-Halle-R16-Roger_Federer-Benoit_Paire,2,F-XC,19,9,3,1,5,11,8
20180621-M-Halle-R16-Roger_Federer-Benoit_Paire,2,F-DTM,23,8,0,1,7,7,16
20180621-M-Halle-R16-Roger_Federer-Benoit_Paire,2,F-DTL,4,2,1,0,1,1,3
20180621-M-Halle-R16-Roger_Federer-Benoit_Paire,2,F-IO,14,7,1,1,5,5,9
20180621-M-Halle-R16-Roger_Federer-Benoit_Paire,2,B-XC,40,11,5,2,4,22,18
20180621-M-Halle-R16-Roger_Federer-Benoit_Paire,2,B-DTM,19,2,1,1,0,9,10
20180621-M-Halle-R16-Roger_Federer-Benoit_Paire,2,B-DTL,6,4,2,0,2,3,3
20180621-M-Halle-R16-Roger_Federer-Benoit_Paire,2,B-IO,13,7,6,0,1,11,2
20180621-M-Halle-R16-Roger_Federer-Benoit_Paire,2,S-XC,1,1,0,0,1,0,1
20180621-M-Halle-R16-Roger_Federer-Benoit_Paire,2,S-DTM,4,0,0,0,0,0,4
20180621-M-Halle-R16-Roger_Federer-Benoit_Paire,2,S-DTL,1,0,0,0,0,1,0
19931107-M-Paris_Masters-SF-Stefan_Edberg-Goran_Ivanisevic,1,F-XC,5,3,1,0,2,1,4
19931107-M-Paris_Masters-SF-Stefan_Edberg-Goran_Ivanisevic,1,F-DTM,1,0,0,0,0,0,1
19931107-M-Paris_Masters-SF-Stefan_Edberg-Goran_Ivanisevic,1,F-DTL,1,0,0,0,0,1,0
19931107-M-Paris_Masters-SF-Stefan_Edberg-Goran_Ivanisevic,1,F-IO,3,1,1,0,0,1,2
19931107-M-Paris_Masters-SF-Stefan_Edberg-Goran_Ivanisevic,1,B-XC,3,1,1,0,0,1,2
19931107-M-Paris_Masters-SF-Stefan_Edberg-Goran_Ivanisevic,1,B-DTM,6,0,0,0,0,0,6
19931107-M-Paris_Masters-SF-Stefan_Edberg-Goran_Ivanisevic,1,B-DTL,2,1,0,0,1,1,1
19931107-M-Paris_Masters-SF-Stefan_Edberg-Goran_Ivanisevic,1,S-DTM,2,0,0,0,0,0,2
19931107-M-Paris_Masters-SF-Stefan_Edberg-Goran_Ivanisevic,1,S-DTL,1,0,0,0,0,0,1
19931107-M-Paris_Masters-SF-Stefan_Edberg-Goran_Ivanisevic,2,F-XC,13,7,3,0,4,5,8
19931107-M-Paris_Masters-SF-Stefan_Edberg-Goran_Ivanisevic,2,F-DTM,5,0,0,0,0,4,1
19931107-M-Paris_Masters-SF-Stefan_Edberg-Goran_Ivanisevic,2,F-DTL,5,3,2,1,0,3,2
19931107-M-Paris_Masters-SF-Stefan_Edberg-Goran_Ivanisevic,2,F-IO,2,2,1,0,1,1,1
19931107-M-Paris_Masters-SF-Stefan_Edberg-Goran_Ivanisevic,2,B-XC,1,1,0,1,0,1,0
19931107-M-Paris_Masters-SF-Stefan_Edberg-Goran_Ivanisevic,2,B-DTM,5,2,0,0,2,2,3
19931107-M-Paris_Masters-SF-Stefan_Edberg-Goran_Ivanisevic,2,B-DTL,2,1,1,0,0,2,0
19931107-M-Paris_Masters-SF-Stefan_Edberg-Goran_Ivanisevic,2,B-IO,1,0,0,0,0,0,1
19931107-M-Paris_Masters-SF-Stefan_Edberg-Goran_Ivanisevic,2,S-XC,4,0,0,0,0,1,3
19931107-M-Paris_Masters-SF-Stefan_Edberg-Goran_Ivanisevic,2,S-DTM,2,0,0,0,0,1,1
19931107-M-Paris_Masters-SF-Stefan_Edberg-Goran_Ivanisevic,2,S-DTL,1,0,0,0,0,0,1
20051120-M-Masters_Cup-SF-Roger_Federer-Gaston_Gaudio,1,F-XC,24,8,4,2,2,18,6
20051120-M-Masters_Cup-SF-Roger_Federer-Gaston_Gaudio,1,F-DTM,4,0,0,0,0,2,2
20051120-M-Masters_Cup-SF-Roger_Federer-Gaston_Gaudio,1,F-DTL,7,3,1,0,2,5,2
20051120-M-Masters_Cup-SF-Roger_Federer-Gaston_Gaudio,1,F-IO,11,4,3,0,1,8,3
20051120-M-Masters_Cup-SF-Roger_Federer-Gaston_Gaudio,1,F-II,2,1,0,0,1,1,1
20051120-M-Masters_Cup-SF-Roger_Federer-Gaston_Gaudio,1,B-XC,20,4,0,1,3,12,8
20051120-M-Masters_Cup-SF-Roger_Federer-Gaston_Gaudio,1,B-DTM,12,1,0,0,1,7,5
20051120-M-Masters_Cup-SF-Roger_Federer-Gaston_Gaudio,1,B-DTL,8,3,0,1,2,4,4
20051120-M-Masters_Cup-SF-Roger_Federer-Gaston_Gaudio,1,S-XC,9,1,0,0,1,4,5
20051120-M-Masters_Cup-SF-Roger_Federer-Gaston_Gaudio,1,S-DTM,3,1,0,0,1,1,2
20051120-M-Masters_Cup-SF-Roger_Federer-Gaston_Gaudio,1,S-DTL,7,1,0,1,0,4,3
20051120-M-Masters_Cup-SF-Roger_Federer-Gaston_Gaudio,2,F-XC,23,3,0,1,2,6,17
20051120-M-Masters_Cup-SF-Roger_Federer-Gaston_Gaudio,2,F-DTM,4,0,0,0,0,0,4
20051120-M-Masters_Cup-SF-Roger_Federer-Gaston_Gaudio,2,F-DTL,13,1,0,0,1,4,9
20051120-M-Masters_Cup-SF-Roger_Federer-Gaston_Gaudio,2,F-IO,14,3,0,1,2,7,7
20051120-M-Masters_Cup-SF-Roger_Federer-Gaston_Gaudio,2,F-II,1,0,0,0,0,0,1
20051120-M-Masters_Cup-SF-Roger_Federer-Gaston_Gaudio,2,B-XC,20,2,0,0,2,8,12
20051120-M-Masters_Cup-SF-Roger_Federer-Gaston_Gaudio,2,B-DTM,10,1,0,0,1,4,6
20051120-M-Masters_Cup-SF-Roger_Federer-Gaston_Gaudio,2,B-DTL,6,3,2,1,0,4,2
20051120-M-Masters_Cup-SF-Roger_Federer-Gaston_Gaudio,2,B-IO,1,0,0,0,0,1,0
20051120-M-Masters_Cup-SF-Roger_Federer-Gaston_Gaudio,2,S-XC,11,1,0,0,1,3,8
20051120-M-Masters_Cup-SF-Roger_Federer-Gaston_Gaudio,2,S-DTL,2,1,0,0,1,0,2
19930502-M-Madrid-F-Stefan_Edberg-Sergi_Bruguera,1,F-XC,27,11,2,2,7,15,12
19930502-M-Madrid-F-Stefan_Edberg-Sergi_Bruguera,1,F-DTM,13,0,0,0,0,8,5
19930502-M-Madrid-F-Stefan_Edberg-Sergi_Bruguera,1,F-DTL,9,2,0,0,2,5,4
19930502-M-Madrid-F-Stefan_Edberg-Sergi_Bruguera,1,F-IO,11,1,0,0,1,4,7
19930502-M-Madrid-F-Stefan_Edberg-Sergi_Bruguera,1,F-II,1,0,0,0,0,1,0
19930502-M-Madrid-F-Stefan_Edberg-Sergi_Bruguera,1,B-XC,15,1,0,0,1,11,4
19930502-M-Madrid-F-Stefan_Edberg-Sergi_Bruguera,1,B-DTM,9,1,0,0,1,4,5
19930502-M-Madrid-F-Stefan_Edberg-Sergi_Bruguera,1,B-DTL,4,2,0,1,1,1,3
19930502-M-Madrid-F-Stefan_Edberg-Sergi_Bruguera,1,B-IO,1,1,0,0,1,0,1
19930502-M-Madrid-F-Stefan_Edberg-Sergi_Bruguera,1,S-XC,38,4,0,3,1,25,13
19930502-M-Madrid-F-Stefan_Edberg-Sergi_Bruguera,1,S-DTM,16,0,0,0,0,8,8
19930502-M-Madrid-F-Stefan_Edberg-Sergi_Bruguera,1,S-DTL,11,4,0,1,3,3,8
19930502-M-Madrid-F-Stefan_Edberg-Sergi_Bruguera,2,F-XC,24,7,3,1,3,11,13
19930502-M-Madrid-F-Stefan_Edberg-Sergi_Bruguera,2,F-DTM,23,4,1,0,3,9,14
19930502-M-Madrid-F-Stefan_Edberg-Sergi_Bruguera,2,F-DTL,13,3,1,0,2,5,8
19930502-M-Madrid-F-Stefan_Edberg-Sergi_Bruguera,2,F-IO,16,2,1,1,0,10,6
19930502-M-Madrid-F-Stefan_Edberg-Sergi_Bruguera,2,F-II,3,1,0,0,1,0,3
19930502-M-Madrid-F-Stefan_Edberg-Sergi_Bruguera,2,B-XC,40,6,2,1,3,15,25
19930502-M-Madrid-F-Stefan_Edberg-Sergi_Bruguera,2,B-DTM,33,2,0,1,1,16,17
19930502-M-Madrid-F-Stefan_Edberg-Sergi_Bruguera,2,B-DTL,26,11,4,1,6,10,16
19930502-M-Madrid-F-Stefan_Edberg-Sergi_Bruguera,2,B-IO,10,1,1,0,0,5,5
19930502-M-Madrid-F-Stefan_Edberg-Sergi_Bruguera,2,S-XC,9,2,0,1,1,4,5
19930502-M-Madrid-F-Stefan_Edberg-Sergi_Bruguera,2,S-DTM,6,1,0,0,1,2,4
19930502-M-Madrid-F-Stefan_Edberg-Sergi_Bruguera,2,S-DTL,4,0,0,0,0,0,4
19930502-M-Madrid-F-Stefan_Edberg-Sergi_Bruguera,2,S-IO,1,1,0,0,1,0,1
20040808-M-Cincinnati_Masters-F-Andre_Agassi-Lleyton_Hewitt,1,F-XC,37,5,0,1,4,17,20
20040808-M-Cincinnati_Masters-F-Andre_Agassi-Lleyton_Hewitt,1,F-DTM,27,1,0,0,1,10,17
20040808-M-Cincinnati_Masters-F-Andre_Agassi-Lleyton_Hewitt,1,F-DTL,16,6,2,0,4,5,11
20040808-M-Cincinnati_Masters-F-Andre_Agassi-Lleyton_Hewitt,1,F-IO,17,3,0,1,2,11,6
20040808-M-Cincinnati_Masters-F-Andre_Agassi-Lleyton_Hewitt,1,F-II,4,1,1,0,0,2,2
20040808-M-Cincinnati_Masters-F-Andre_Agassi-Lleyton_Hewitt,1,B-XC,110,11,1,4,6,67,43
20040808-M-Cincinnati_Masters-F-Andre_Agassi-Lleyton_Hewitt,1,B-DTM,30,1,0,0,1,17,13
20040808-M-Cincinnati_Masters-F-Andre_Agassi-Lleyton_Hewitt,1,B-DTL,10,8,2,4,2,7,3
20040808-M-Cincinnati_Masters-F-Andre_Agassi-Lleyton_Hewitt,1,B-IO,3,1,0,1,0,2,1
20040808-M-Cincinnati_Masters-F-Andre_Agassi-Lleyton_Hewitt,1,S-XC,10,1,0,0,1,6,4
20040808-M-Cincinnati_Masters-F-Andre_Agassi-Lleyton_Hewitt,1,S-DTM,4,0,0,0,0,0,4
20040808-M-Cincinnati_Masters-F-Andre_Agassi-Lleyton_Hewitt,2,F-XC,36,6,1,3,2,24,12
20040808-M-Cincinnati_Masters-F-Andre_Agassi-Lleyton_Hewitt,2,F-DTM,19,3,0,0,3,9,10
20040808-M-Cincinnati_Masters-F-Andre_Agassi-Lleyton_Hewitt,2,F-DTL,12,4,1,1,2,5,7
20040808-M-Cincinnati_Masters-F-Andre_Agassi-Lleyton_Hewitt,2,F-IO,18,6,2,2,2,11,7
20040808-M-Cincinnati_Masters-F-Andre_Agassi-Lleyton_Hewitt,2,F-II,5,0,0,0,0,2,3
20040808-M-Cincinnati_Masters-F-Andre_Agassi-Lleyton_Hewitt,2,B-XC,106,10,0,3,7,44,62
20040808-M-Cincinnati_Masters-F-Andre_Agassi-Lleyton_Hewitt,2,B-DTM,41,0,0,0,0,13,28
20040808-M-Cincinnati_Masters-F-Andre_Agassi-Lleyton_Hewitt,2,B-DTL,11,8,3,1,4,6,5
20040808-M-Cincinnati_Masters-F-Andre_Agassi-Lleyton_Hewitt,2,B-IO,8,4,1,1,2,4,4
20040808-M-Cincinnati_Masters-F-Andre_Agassi-Lleyton_Hewitt,2,S-XC,13,3,0,0,3,6,7
20040808-M-Cincinnati_Masters-F-Andre_Agassi-Lleyton_Hewitt,2,S-DTM,2,0,0,0,0,2,0
20040808-M-Cincinnati_Masters-F-Andre_Agassi-Lleyton_Hewitt,2,S-IO,1,1,1,0,0,1,0
19940306-M-Indian_Wells_Masters-F-Pete_Sampras-Petr_Korda,1,F-XC,46,11,3,2,6,21,25
19940306-M-Indian_Wells_Masters-F-Pete_Sampras-Petr_Korda,1,F-DTM,22,2,0,0,2,12,10
19940306-M-Indian_Wells_Masters-F-Pete_Sampras-Petr_Korda,1,F-DTL,20,10,2,2,6,7,13
19940306-M-Indian_Wells_Masters-F-Pete_Sampras-Petr_Korda,1,F-IO,21,8,5,2,1,15,6
19940306-M-Indian_Wells_Masters-F-Pete_Sampras-Petr_Korda,1,F-II,3,0,0,0,0,1,2
19940306-M-Indian_Wells_Masters-F-Pete_Sampras-Petr_Korda,1,B-XC,19,5,2,0,3,9,10
19940306-M-Indian_Wells_Masters-F-Pete_Sampras-Petr_Korda,1,B-DTM,35,0,0,0,0,18,17
19940306-M-Indian_Wells_Masters-F-Pete_Sampras-Petr_Korda,1,B-DTL,18,7,1,0,6,4,14
19940306-M-Indian_Wells_Masters-F-Pete_Sampras-Petr_Korda,1,B-IO,5,1,0,1,0,2,3
19940306-M-Indian_Wells_Masters-F-Pete_Sampras-Petr_Korda,1,S-XC,8,1,0,0,1,6,2
19940306-M-Indian_Wells_Masters-F-Pete_Sampras-Petr_Korda,1,S-DTM,13,0,0,0,0,6,7
19940306-M-Indian_Wells_Masters-F-Pete_Sampras-Petr_Korda,1,S-DTL,8,2,0,1,1,3,5
19940306-M-Indian_Wells_Masters-F-Pete_Sampras-Petr_Korda,1,S-IO,3,0,0,0,0,0,3
19940306-M-Indian_Wells_Masters-F-Pete_Sampras-Petr_Korda,2,F-XC,64,19,6,5,8,34,30
19940306-M-Indian_Wells_Masters-F-Pete_Sampras-Petr_Korda,2,F-DTM,20,1,0,0,1,9,11
19940306-M-Indian_Wells_Masters-F-Pete_Sampras-Petr_Korda,2,F-DTL,15,10,3,3,4,9,6
19940306-M-Indian_Wells_Masters-F-Pete_Sampras-Petr_Korda,2,F-IO,23,13,4,3,6,10,13
19940306-M-Indian_Wells_Masters-F-Pete_Sampras-Petr_Korda,2,B-XC,50,25,5,7,13,28,22
19940306-M-Indian_Wells_Masters-F-Pete_Sampras-Petr_Korda,2,B-DTM,31,2,0,0,2,21,10
19940306-M-Indian_Wells_Masters-F-Pete_Sampras-Petr_Korda,2,B-DTL,20,6,3,0,3,13,7
19940306-M-Indian_Wells_Masters-F-Pete_Sampras-Petr_Korda,2,B-IO,15,1,0,0,1,6,9
19940306-M-Indian_Wells_Masters-F-Pete_Sampras-Petr_Korda,2,S-XC,10,1,0,0,1,7,3
19940306-M-Indian_Wells_Masters-F-Pete_Sampras-Petr_Korda,2,S-DTM,23,3,0,0,3,7,16
19940306-M-Indian_Wells_Masters-F-Pete_Sampras-Petr_Korda,2,S-DTL,6,1,0,0,1,4,2
19940306-M-Indian_Wells_Masters-F-Pete_Sampras-Petr_Korda,2,S-IO,3,1,0,0,1,1,2
19871206-M-Masters-F-Mats_Wilander-Ivan_Lendl,1,F-XC,23,4,0,2,2,13,10
19871206-M-Masters-F-Mats_Wilander-Ivan_Lendl,1,F-DTM,44,0,0,0,0,23,21
19871206-M-Masters-F-Mats_Wilander-Ivan_Lendl,1,F-DTL,28,1,0,0,1,11,17
19871206-M-Masters-F-Mats_Wilander-Ivan_Lendl,1,F-IO,11,0,0,0,0,4,7
19871206-M-Masters-F-Mats_Wilander-Ivan_Lendl,1,B-XC,172,7,1,3,3,76,96
19871206-M-Masters-F-Mats_Wilander-Ivan_Lendl,1,B-DTM,46,1,0,0,1,21,25
19871206-M-Masters-F-Mats_Wilander-Ivan_Lendl,1,B-DTL,34,5,0,1,4,13,21
19871206-M-Masters-F-Mats_Wilander-Ivan_Lendl,1,B-IO,18,5,0,5,0,10,8
19871206-M-Masters-F-Mats_Wilander-Ivan_Lendl,1,S-XC,33,4,0,2,2,17,16
19871206-M-Masters-F-Mats_Wilander-Ivan_Lendl,1,S-DTM,16,0,0,0,0,6,10
19871206-M-Masters-F-Mats_Wilander-Ivan_Lendl,1,S-DTL,9,1,0,0,1,2,7
19871206-M-Masters-F-Mats_Wilander-Ivan_Lendl,1,S-IO,2,0,0,0,0,2,0
19871206-M-Masters-F-Mats_Wilander-Ivan_Lendl,2,F-XC,58,11,7,2,2,33,25
19871206-M-Masters-F-Mats_Wilander-Ivan_Lendl,2,F-DTM,24,0,0,0,0,9,15
19871206-M-Masters-F-Mats_Wilander-Ivan_Lendl,2,F-DTL,22,5,3,0,2,9,13
19871206-M-Masters-F-Mats_Wilander-Ivan_Lendl,2,F-IO,37,6,4,2,0,25,12
19871206-M-Masters-F-Mats_Wilander-Ivan_Lendl,2,F-II,3,1,0,0,1,2,1
19871206-M-Masters-F-Mats_Wilander-Ivan_Lendl,2,B-XC,119,9,3,4,2,73,46
19871206-M-Masters-F-Mats_Wilander-Ivan_Lendl,2,B-DTM,38,0,0,0,0,22,16
19871206-M-Masters-F-Mats_Wilander-Ivan_Lendl,2,B-DTL,19,12,7,1,4,10,9
19871206-M-Masters-F-Mats_Wilander-Ivan_Lendl,2,B-IO,8,5,2,1,2,5,3
19871206-M-Masters-F-Mats_Wilander-Ivan_Lendl,2,S-XC,75,2,0,0,2,38,37
19871206-M-Masters-F-Mats_Wilander-Ivan_Lendl,2,S-DTM,47,0,0,0,0,28,19
19871206-M-Masters-F-Mats_Wilander-Ivan_Lendl,2,S-DTL,10,1,0,0,1,4,6
19871206-M-Masters-F-Mats_Wilander-Ivan_Lendl,2,S-IO,4,0,0,0,0,2,2
20090823-M-Cincinnati_Masters-SF-Roger_Federer-Andy_Murray,1,F-XC,22,8,4,2,2,12,10
20090823-M-Cincinnati_Masters-SF-Roger_Federer-Andy_Murray,1,F-DTM,22,4,1,0,3,4,18
20090823-M-Cincinnati_Masters-SF-Roger_Federer-Andy_Murray,1,F-DTL,5,2,2,0,0,5,0
20090823-M-Cincinnati_Masters-SF-Roger_Federer-Andy_Murray,1,F-IO,20,10,3,2,5,9,11
20090823-M-Cincinnati_Masters-SF-Roger_Federer-Andy_Murray,1,F-II,1,0,0,0,0,1,0
20090823-M-Cincinnati_Masters-SF-Roger_Federer-Andy_Murray,1,B-XC,12,2,1,0,1,5,7
20090823-M-Cincinnati_Masters-SF-Roger_Federer-Andy_Murray,1,B-DTM,22,3,0,1,2,8,14
20090823-M-Cincinnati_Masters-SF-Roger_Federer-Andy_Murray,1,B-DTL,8,2,1,0,1,1,7
20090823-M-Cincinnati_Masters-SF-Roger_Federer-Andy_Murray,1,B-IO,3,2,0,1,1,2,1
20090823-M-Cincinnati_Masters-SF-Roger_Federer-Andy_Murray,1,S-XC,9,0,0,0,0,1,8
20090823-M-Cincinnati_Masters-SF-Roger_Federer-Andy_Murray,1,S-DTM,7,0,0,0,0,3,4
20090823-M-Cincinnati_Masters-SF-Roger_Federer-Andy_Murray,1,S-DTL,3,0,0,0,0,2,1
20090823-M-Cincinnati_Masters-SF-Roger_Federer-Andy_Murray,2,F-XC,20,4,1,1,2,12,8
20090823-M-Cincinnati_Masters-SF-Roger_Federer-Andy_Murray,2,F-DTM,19,3,0,0,3,12,7
20090823-M-Cincinnati_Masters-SF-Roger_Federer-Andy_Murray,2,F-DTL,8,3,1,1,1,6,2
20090823-M-Cincinnati_Masters-SF-Roger_Federer-Andy_Murray,2,F-IO,23,5,2,2,1,20,3
20090823-M-Cincinnati_Masters-SF-Roger_Federer-Andy_Murray,2,F-II,2,1,1,0,0,2,0
20090823-M-Cincinnati_Masters-SF-Roger_Federer-Andy_Murray,2,B-XC,26,5,2,0,3,15,11
20090823-M-Cincinnati_Masters-SF-Roger_Federer-Andy_Murray,2,B-DTM,24,3,0,0,3,11,13
20090823-M-Cincinnati_Masters-SF-Roger_Federer-Andy_Murray,2,B-DTL,10,5,1,4,0,7,3
20090823-M-Cincinnati_Masters-SF-Roger_Federer-Andy_Murray,2,B-IO,3,0,0,0,0,3,0
20090823-M-Cincinnati_Masters-SF-Roger_Federer-Andy_Murray,2,S-XC,2,0,0,0,0,2,0
20090823-M-Cincinnati_Masters-SF-Roger_Federer-Andy_Murray,2,S-DTM,2,0,0,0,0,1,1
20090823-M-Cincinnati_Masters-SF-Roger_Federer-Andy_Murray,2,S-IO,1,0,0,0,0,0,1
19901006-M-Sydney_Indoor-SF-Stefan_Edberg-Ivan_Lendl,1,F-XC,18,4,2,1,1,8,10
19901006-M-Sydney_Indoor-SF-Stefan_Edberg-Ivan_Lendl,1,F-DTM,11,2,1,0,1,4,7
19901006-M-Sydney_Indoor-SF-Stefan_Edberg-Ivan_Lendl,1,F-DTL,22,4,1,0,3,12,10
19901006-M-Sydney_Indoor-SF-Stefan_Edberg-Ivan_Lendl,1,F-IO,11,2,0,2,0,3,8
19901006-M-Sydney_Indoor-SF-Stefan_Edberg-Ivan_Lendl,1,B-XC,22,1,0,0,1,8,14
19901006-M-Sydney_Indoor-SF-Stefan_Edberg-Ivan_Lendl,1,B-DTM,5,0,0,0,0,1,4
19901006-M-Sydney_Indoor-SF-Stefan_Edberg-Ivan_Lendl,1,B-DTL,8,3,1,1,1,2,6
19901006-M-Sydney_Indoor-SF-Stefan_Edberg-Ivan_Lendl,1,B-IO,1,1,0,1,0,1,0
19901006-M-Sydney_Indoor-SF-Stefan_Edberg-Ivan_Lendl,1,S-XC,16,2,1,0,1,7,9
19901006-M-Sydney_Indoor-SF-Stefan_Edberg-Ivan_Lendl,1,S-DTM,1,0,0,0,0,0,1
19901006-M-Sydney_Indoor-SF-Stefan_Edberg-Ivan_Lendl,2,F-XC,24,4,2,1,1,17,7
19901006-M-Sydney_Indoor-SF-Stefan_Edberg-Ivan_Lendl,2,F-DTM,4,0,0,0,0,1,3
19901006-M-Sydney_Indoor-SF-Stefan_Edberg-Ivan_Lendl,2,F-DTL,11,6,4,2,0,9,2
19901006-M-Sydney_Indoor-SF-Stefan_Edberg-Ivan_Lendl,2,F-IO,15,5,2,3,0,13,2
19901006-M-Sydney_Indoor-SF-Stefan_Edberg-Ivan_Lendl,2,F-II,7,2,0,1,1,3,4
19901006-M-Sydney_Indoor-SF-Stefan_Edberg-Ivan_Lendl,2,B-XC,15,2,0,1,1,10,5
19901006-M-Sydney_Indoor-SF-Stefan_Edberg-Ivan_Lendl,2,B-DTM,13,2,0,0,2,5,8
19901006-M-Sydney_Indoor-SF-Stefan_Edberg-Ivan_Lendl,2,B-DTL,10,5,2,3,0,8,2
19901006-M-Sydney_Indoor-SF-Stefan_Edberg-Ivan_Lendl,2,B-IO,4,0,0,0,0,1,3
19901006-M-Sydney_Indoor-SF-Stefan_Edberg-Ivan_Lendl,2,S-XC,17,5,1,2,2,11,6
19901006-M-Sydney_Indoor-SF-Stefan_Edberg-Ivan_Lendl,2,S-DTM,8,1,1,0,0,6,2
19901006-M-Sydney_Indoor-SF-Stefan_Edberg-Ivan_Lendl,2,S-DTL,15,3,0,0,3,4,11
19901006-M-Sydney_Indoor-SF-Stefan_Edberg-Ivan_Lendl,2,S-IO,1,0,0,0,0,0,1
19920724-M-Canada_Masters-SF-Ivan_Lendl-Wally_Masur,1,F-XC,30,12,6,4,2,17,13
19920724-M-Canada_Masters-SF-Ivan_Lendl-Wally_Masur,1,F-DTM,4,0,0,0,0,2,2
19920724-M-Canada_Masters-SF-Ivan_Lendl-Wally_Masur,1,F-DTL,13,8,6,1,1,10,3
19920724-M-Canada_Masters-SF-Ivan_Lendl-Wally_Masur,1,F-IO,20,4,3,1,0,15,5
19920724-M-Canada_Masters-SF-Ivan_Lendl-Wally_Masur,1,F-II,3,0,0,0,0,1,2
19920724-M-Canada_Masters-SF-Ivan_Lendl-Wally_Masur,1,B-XC,23,2,0,0,2,11,12
19920724-M-Canada_Masters-SF-Ivan_Lendl-Wally_Masur,1,B-DTL,14,6,3,0,3,8,6
19920724-M-Canada_Masters-SF-Ivan_Lendl-Wally_Masur,1,B-IO,3,1,1,0,0,3,0
19920724-M-Canada_Masters-SF-Ivan_Lendl-Wally_Masur,1,S-XC,21,1,0,0,1,8,13
19920724-M-Canada_Masters-SF-Ivan_Lendl-Wally_Masur,1,S-DTM,2,0,0,0,0,1,1
19920724-M-Canada_Masters-SF-Ivan_Lendl-Wally_Masur,1,S-DTL,4,0,0,0,0,0,4
19920724-M-Canada_Masters-SF-Ivan_Lendl-Wally_Masur,2,F-XC,13,2,0,1,1,8,5
19920724-M-Canada_Masters-SF-Ivan_Lendl-Wally_Masur,2,F-DTM,7,1,1,0,0,2,5
19920724-M-Canada_Masters-SF-Ivan_Lendl-Wally_Masur,2,F-DTL,16,1,0,1,0,11,5
19920724-M-Canada_Masters-SF-Ivan_Lendl-Wally_Masur,2,F-IO,16,1,0,0,1,6,10
19920724-M-Canada_Masters-SF-Ivan_Lendl-Wally_Masur,2,F-II,7,3,0,1,2,3,4
19920724-M-Canada_Masters-SF-Ivan_Lendl-Wally_Masur,2,B-XC,23,1,0,0,1,8,15
19920724-M-Canada_Masters-SF-Ivan_Lendl-Wally_Masur,2,B-DTM,4,0,0,0,0,2,2
19920724-M-Canada_Masters-SF-Ivan_Lendl-Wally_Masur,2,B-DTL,4,3,2,0,1,2,2
19920724-M-Canada_Masters-SF-Ivan_Lendl-Wally_Masur,2,S-XC,16,1,0,0,1,12,4
19920724-M-Canada_Masters-SF-Ivan_Lendl-Wally_Masur,2,S-DTM,2,0,0,0,0,0,2
19920724-M-Canada_Masters-SF-Ivan_Lendl-Wally_Masur,2,S-DTL,8,0,0,0,0,3,5
19920724-M-Canada_Masters-SF-Ivan_Lendl-Wally_Masur,2,S-IO,1,0,0,0,0,0,1
19921031-M-Stockholm_Masters-SF-Guy_Forget-Pete_Sampras,1,F-XC,32,6,0,3,3,16,16
19921031-M-Stockholm_Masters-SF-Guy_Forget-Pete_Sampras,1,F-DTM,1,0,0,0,0,0,1
19921031-M-Stockholm_Masters-SF-Guy_Forget-Pete_Sampras,1,F-DTL,5,2,0,1,1,2,3
19921031-M-Stockholm_Masters-SF-Guy_Forget-Pete_Sampras,1,F-IO,5,2,2,0,0,5,0
19921031-M-Stockholm_Masters-SF-Guy_Forget-Pete_Sampras,1,B-XC,16,4,1,3,0,13,3
19921031-M-Stockholm_Masters-SF-Guy_Forget-Pete_Sampras,1,B-DTM,7,1,0,1,0,4,3
19921031-M-Stockholm_Masters-SF-Guy_Forget-Pete_Sampras,1,B-DTL,10,1,0,1,0,6,4
19921031-M-Stockholm_Masters-SF-Guy_Forget-Pete_Sampras,1,B-IO,6,1,0,0,1,4,2
19921031-M-Stockholm_Masters-SF-Guy_Forget-Pete_Sampras,1,S-XC,14,1,1,0,0,7,7
19921031-M-Stockholm_Masters-SF-Guy_Forget-Pete_Sampras,1,S-DTM,8,0,0,0,0,5,3
19921031-M-Stockholm_Masters-SF-Guy_Forget-Pete_Sampras,1,S-DTL,21,0,0,0,0,10,11
19921031-M-Stockholm_Masters-SF-Guy_Forget-Pete_Sampras,1,S-IO,1,0,0,0,0,1,0
19921031-M-Stockholm_Masters-SF-Guy_Forget-Pete_Sampras,2,F-XC,34,6,3,1,2,14,20
19921031-M-Stockholm_Masters-SF-Guy_Forget-Pete_Sampras,2,F-DTM,1,0,0,0,0,0,1
19921031-M-Stockholm_Masters-SF-Guy_Forget-Pete_Sampras,2,F-DTL,15,6,2,1,3,9,6
19921031-M-Stockholm_Masters-SF-Guy_Forget-Pete_Sampras,2,F-IO,4,1,0,1,0,1,3
19921031-M-Stockholm_Masters-SF-Guy_Forget-Pete_Sampras,2,F-II,5,1,0,0,1,3,2
19921031-M-Stockholm_Masters-SF-Guy_Forget-Pete_Sampras,2,B-XC,11,4,3,0,1,7,4
19921031-M-Stockholm_Masters-SF-Guy_Forget-Pete_Sampras,2,B-DTM,11,1,0,0,1,4,7
19921031-M-Stockholm_Masters-SF-Guy_Forget-Pete_Sampras,2,B-DTL,24,6,2,0,4,9,15
19921031-M-Stockholm_Masters-SF-Guy_Forget-Pete_Sampras,2,B-IO,5,0,0,0,0,2,3
19921031-M-Stockholm_Masters-SF-Guy_Forget-Pete_Sampras,2,S-XC,7,0,0,0,0,3,4
19921031-M-Stockholm_Masters-SF-Guy_Forget-Pete_Sampras,2,S-DTM,1,0,0,0,0,0,1
19921031-M-Stockholm_Masters-SF-Guy_Forget-Pete_Sampras,2,S-DTL,8,1,0,1,0,6,2
19921031-M-Stockholm_Masters-SF-Guy_Forget-Pete_Sampras,2,S-IO,3,1,0,1,0,1,2
20100110-M-Doha-F-Rafael_Nadal-Nikolay_Davydenko,1,F-XC,113,13,2,7,4,61,52
20100110-M-Doha-F-Rafael_Nadal-Nikolay_Davydenko,1,F-DTM,23,1,0,1,0,14,9
20100110-M-Doha-F-Rafael_Nadal-Nikolay_Davydenko,1,F-DTL,25,6,1,3,2,13,12
20100110-M-Doha-F-Rafael_Nadal-Nikolay_Davydenko,1,F-IO,36,7,2,3,2,22,14
20100110-M-Doha-F-Rafael_Nadal-Nikolay_Davydenko,1,F-II,12,4,2,2,0,8,4
20100110-M-Doha-F-Rafael_Nadal-Nikolay_Davydenko,1,B-XC,72,17,4,7,6,40,32
20100110-M-Doha-F-Rafael_Nadal-Nikolay_Davydenko,1,B-DTM,30,0,0,0,0,19,11
20100110-M-Doha-F-Rafael_Nadal-Nikolay_Davydenko,1,B-DTL,32,5,1,2,2,14,18
20100110-M-Doha-F-Rafael_Nadal-Nikolay_Davydenko,1,B-IO,1,0,0,0,0,1,0
20100110-M-Doha-F-Rafael_Nadal-Nikolay_Davydenko,1,S-XC,8,0,0,0,0,0,8
20100110-M-Doha-F-Rafael_Nadal-Nikolay_Davydenko,1,S-DTM,10,0,0,0,0,6,4
20100110-M-Doha-F-Rafael_Nadal-Nikolay_Davydenko,1,S-DTL,22,2,0,2,0,11,11
20100110-M-Doha-F-Rafael_Nadal-Nikolay_Davydenko,1,S-IO,1,1,0,0,1,0,1
20100110-M-Doha-F-Rafael_Nadal-Nikolay_Davydenko,2,F-XC,115,14,6,4,4,59,56
20100110-M-Doha-F-Rafael_Nadal-Nikolay_Davydenko,2,F-DTM,13,2,0,0,2,3,10
20100110-M-Doha-F-Rafael_Nadal-Nikolay_Davydenko,2,F-DTL,32,17,8,3,6,18,14
20100110-M-Doha-F-Rafael_Nadal-Nikolay_Davydenko,2,F-IO,21,5,3,1,1,11,10
20100110-M-Doha-F-Rafael_Nadal-Nikolay_Davydenko,2,F-II,6,1,1,0,0,4,2
20100110-M-Doha-F-Rafael_Nadal-Nikolay_Davydenko,2,B-XC,89,14,4,3,7,38,51
20100110-M-Doha-F-Rafael_Nadal-Nikolay_Davydenko,2,B-DTM,42,1,0,0,1,23,19
20100110-M-Doha-F-Rafael_Nadal-Nikolay_Davydenko,2,B-DTL,52,12,4,3,5,26,26
20100110-M-Doha-F-Rafael_Nadal-Nikolay_Davydenko,2,B-IO,8,0,0,0,0,2,6
20100110-M-Doha-F-Rafael_Nadal-Nikolay_Davydenko,2,S-DTM,1,0,0,0,0,1,0
20100110-M-Doha-F-Rafael_Nadal-Nikolay_Davydenko,2,S-DTL,1,0,0,0,0,0,1
20100110-M-Doha-F-Rafael_Nadal-Nikolay_Davydenko,2,S-IO,1,0,0,0,0,0,1
19861207-M-Masters-F-Boris_Becker-Ivan_Lendl,1,F-XC,33,9,0,2,7,14,19
19861207-M-Masters-F-Boris_Becker-Ivan_Lendl,1,F-DTM,10,0,0,0,0,3,7
19861207-M-Masters-F-Boris_Becker-Ivan_Lendl,1,F-DTL,19,5,2,1,2,8,11
19861207-M-Masters-F-Boris_Becker-Ivan_Lendl,1,F-IO,26,5,0,3,2,15,11
19861207-M-Masters-F-Boris_Becker-Ivan_Lendl,1,F-II,1,1,0,0,1,0,1
19861207-M-Masters-F-Boris_Becker-Ivan_Lendl,1,B-XC,41,8,1,1,6,13,28
19861207-M-Masters-F-Boris_Becker-Ivan_Lendl,1,B-DTM,18,2,0,0,2,4,14
19861207-M-Masters-F-Boris_Becker-Ivan_Lendl,1,B-DTL,10,5,0,0,5,1,9
19861207-M-Masters-F-Boris_Becker-Ivan_Lendl,1,B-IO,4,2,0,1,1,2,2
19861207-M-Masters-F-Boris_Becker-Ivan_Lendl,1,S-XC,54,6,0,2,4,18,36
19861207-M-Masters-F-Boris_Becker-Ivan_Lendl,1,S-DTM,18,2,0,0,2,6,12
19861207-M-Masters-F-Boris_Becker-Ivan_Lendl,1,S-DTL,1,0,0,0,0,0,1
19861207-M-Masters-F-Boris_Becker-Ivan_Lendl,2,F-XC,27,10,4,3,3,18,9
19861207-M-Masters-F-Boris_Becker-Ivan_Lendl,2,F-DTM,20,4,1,2,1,13,7
19861207-M-Masters-F-Boris_Becker-Ivan_Lendl,2,F-DTL,12,2,1,1,0,9,3
19861207-M-Masters-F-Boris_Becker-Ivan_Lendl,2,F-IO,24,6,4,2,0,19,5
19861207-M-Masters-F-Boris_Becker-Ivan_Lendl,2,F-II,3,3,1,0,2,1,2
19861207-M-Masters-F-Boris_Becker-Ivan_Lendl,2,B-XC,35,5,2,1,2,28,7
19861207-M-Masters-F-Boris_Becker-Ivan_Lendl,2,B-DTM,17,0,0,0,0,10,7
19861207-M-Masters-F-Boris_Becker-Ivan_Lendl,2,B-DTL,12,8,6,1,1,9,3
19861207-M-Masters-F-Boris_Becker-Ivan_Lendl,2,B-IO,1,1,0,0,1,0,1
19861207-M-Masters-F-Boris_Becker-Ivan_Lendl,2,S-XC,41,0,0,0,0,30,11
19861207-M-Masters-F-Boris_Becker-Ivan_Lendl,2,S-DTM,36,2,1,0,1,19,17
19861207-M-Masters-F-Boris_Becker-Ivan_Lendl,2,S-DTL,12,1,0,1,0,7,5
19861207-M-Masters-F-Boris_Becker-Ivan_Lendl,2,S-IO,6,0,0,0,0,3,3
19930516-M-Rome_Masters-F-Jim_Courier-Goran_Ivanisevic,1,F-XC,75,13,2,4,7,41,34
19930516-M-Rome_Masters-F-Jim_Courier-Goran_Ivanisevic,1,F-DTM,34,2,0,1,1,23,11
19930516-M-Rome_Masters-F-Jim_Courier-Goran_Ivanisevic,1,F-DTL,3,1,1,0,0,2,1
19930516-M-Rome_Masters-F-Jim_Courier-Goran_Ivanisevic,1,F-IO,27,8,1,5,2,17,10
19930516-M-Rome_Masters-F-Jim_Courier-Goran_Ivanisevic,1,F-II,18,3,0,2,1,12,6
19930516-M-Rome_Masters-F-Jim_Courier-Goran_Ivanisevic,1,B-XC,18,4,1,1,2,10,8
19930516-M-Rome_Masters-F-Jim_Courier-Goran_Ivanisevic,1,B-DTM,27,1,0,0,1,14,13
19930516-M-Rome_Masters-F-Jim_Courier-Goran_Ivanisevic,1,B-DTL,3,1,0,1,0,2,1
19930516-M-Rome_Masters-F-Jim_Courier-Goran_Ivanisevic,1,B-IO,3,1,1,0,0,1,2
19930516-M-Rome_Masters-F-Jim_Courier-Goran_Ivanisevic,1,S-XC,6,2,0,2,0,3,3
19930516-M-Rome_Masters-F-Jim_Courier-Goran_Ivanisevic,1,S-DTM,5,0,0,0,0,4,1
19930516-M-Rome_Masters-F-Jim_Courier-Goran_Ivanisevic,1,S-DTL,2,0,0,0,0,1,1
19930516-M-Rome_Masters-F-Jim_Courier-Goran_Ivanisevic,1,S-IO,2,0,0,0,0,0,2
19930516-M-Rome_Masters-F-Jim_Courier-Goran_Ivanisevic,2,F-XC,60,10,1,3,6,26,34
19930516-M-Rome_Masters-F-Jim_Courier-Goran_Ivanisevic,2,F-DTM,32,2,0,0,2,12,20
19930516-M-Rome_Masters-F-Jim_Courier-Goran_Ivanisevic,2,F-DTL,7,2,2,0,0,4,3
19930516-M-Rome_Masters-F-Jim_Courier-Goran_Ivanisevic,2,F-IO,16,10,4,2,4,7,9
19930516-M-Rome_Masters-F-Jim_Courier-Goran_Ivanisevic,2,B-XC,18,6,4,0,2,13,5
19930516-M-Rome_Masters-F-Jim_Courier-Goran_Ivanisevic,2,B-DTM,53,8,0,0,8,19,34
19930516-M-Rome_Masters-F-Jim_Courier-Goran_Ivanisevic,2,B-DTL,14,4,0,2,2,8,6
19930516-M-Rome_Masters-F-Jim_Courier-Goran_Ivanisevic,2,B-IO,10,3,1,1,1,4,6
19930516-M-Rome_Masters-F-Jim_Courier-Goran_Ivanisevic,2,S-XC,4,1,0,0,1,0,4
19930516-M-Rome_Masters-F-Jim_Courier-Goran_Ivanisevic,2,S-DTM,8,1,0,0,1,2,6
19930516-M-Rome_Masters-F-Jim_Courier-Goran_Ivanisevic,2,S-DTL,4,1,0,0,1,1,3
20180715-M-Wimbledon-F-Kevin_Anderson-Novak_Djokovic,1,F-XC,51,15,1,4,10,21,30
20180715-M-Wimbledon-F-Kevin_Anderson-Novak_Djokovic,1,F-DTM,28,2,0,0,2,9,19
20180715-M-Wimbledon-F-Kevin_Anderson-Novak_Djokovic,1,F-DTL,5,1,1,0,0,4,1
20180715-M-Wimbledon-F-Kevin_Anderson-Novak_Djokovic,1,F-IO,31,16,3,5,8,16,15
20180715-M-Wimbledon-F-Kevin_Anderson-Novak_Djokovic,1,F-II,3,1,1,0,0,1,2
20180715-M-Wimbledon-F-Kevin_Anderson-Novak_Djokovic,1,B-XC,35,5,0,1,4,11,24
20180715-M-Wimbledon-F-Kevin_Anderson-Novak_Djokovic,1,B-DTM,24,5,0,1,4,6,18
20180715-M-Wimbledon-F-Kevin_Anderson-Novak_Djokovic,1,B-DTL,6,4,1,1,2,3,3
20180715-M-Wimbledon-F-Kevin_Anderson-Novak_Djokovic,1,B-IO,3,2,1,0,1,2,1
20180715-M-Wimbledon-F-Kevin_Anderson-Novak_Djokovic,1,S-XC,12,2,1,0,1,4,8
20180715-M-Wimbledon-F-Kevin_Anderson-Novak_Djokovic,1,S-DTM,9,0,0,0,0,1,8
20180715-M-Wimbledon-F-Kevin_Anderson-Novak_Djokovic,1,S-IO,1,0,0,0,0,1,0
20180715-M-Wimbledon-F-Kevin_Anderson-Novak_Djokovic,2,F-XC,34,10,1,7,2,24,10
20180715-M-Wimbledon-F-Kevin_Anderson-Novak_Djokovic,2,F-DTM,24,0,0,0,0,15,9
20180715-M-Wimbledon-F-Kevin_Anderson-Novak_Djokovic,2,F-DTL,16,5,1,2,2,10,6
20180715-M-Wimbledon-F-Kevin_Anderson-Novak_Djokovic,2,F-IO,20,4,2,0,2,13,7
20180715-M-Wimbledon-F-Kevin_Anderson-Novak_Djokovic,2,F-II,1,1,1,0,0,1,0
20180715-M-Wimbledon-F-Kevin_Anderson-Novak_Djokovic,2,B-XC,34,6,2,1,3,24,10
20180715-M-Wimbledon-F-Kevin_Anderson-Novak_Djokovic,2,B-DTM,25,3,0,2,1,13,12
20180715-M-Wimbledon-F-Kevin_Anderson-Novak_Djokovic,2,B-DTL,15,5,2,2,1,10,5
20180715-M-Wimbledon-F-Kevin_Anderson-Novak_Djokovic,2,S-XC,11,1,0,0,1,5,6
20180715-M-Wimbledon-F-Kevin_Anderson-Novak_Djokovic,2,S-DTM,10,0,0,0,0,7,3
20180715-M-Wimbledon-F-Kevin_Anderson-Novak_Djokovic,2,S-IO,3,0,0,0,0,3,0
19810118-M-Masters-F-Ivan_Lendl-Bjorn_Borg,1,F-XC,61,6,1,1,4,23,38
19810118-M-Masters-F-Ivan_Lendl-Bjorn_Borg,1,F-DTM,34,1,0,0,1,11,23
19810118-M-Masters-F-Ivan_Lendl-Bjorn_Borg,1,F-DTL,17,4,0,3,1,10,7
19810118-M-Masters-F-Ivan_Lendl-Bjorn_Borg,1,F-IO,46,18,6,3,9,18,28
19810118-M-Masters-F-Ivan_Lendl-Bjorn_Borg,1,F-II,13,4,2,0,2,7,6
19810118-M-Masters-F-Ivan_Lendl-Bjorn_Borg,1,B-XC,189,10,0,1,9,68,121
19810118-M-Masters-F-Ivan_Lendl-Bjorn_Borg,1,B-DTM,37,3,0,0,3,14,23
19810118-M-Masters-F-Ivan_Lendl-Bjorn_Borg,1,B-DTL,21,8,2,1,5,7,14
19810118-M-Masters-F-Ivan_Lendl-Bjorn_Borg,1,S-XC,28,1,0,0,1,10,18
19810118-M-Masters-F-Ivan_Lendl-Bjorn_Borg,1,S-DTM,14,1,0,0,1,5,9
19810118-M-Masters-F-Ivan_Lendl-Bjorn_Borg,1,S-DTL,7,1,0,0,1,0,7
19810118-M-Masters-F-Ivan_Lendl-Bjorn_Borg,2,F-XC,66,10,3,2,5,38,28
19810118-M-Masters-F-Ivan_Lendl-Bjorn_Borg,2,F-DTM,41,1,0,0,1,26,15
19810118-M-Masters-F-Ivan_Lendl-Bjorn_Borg,2,F-DTL,33,3,1,0,2,23,10
19810118-M-Masters-F-Ivan_Lendl-Bjorn_Borg,2,F-IO,42,7,2,2,3,30,12
19810118-M-Masters-F-Ivan_Lendl-Bjorn_Borg,2,F-II,10,1,0,0,1,6,4
19810118-M-Masters-F-Ivan_Lendl-Bjorn_Borg,2,B-XC,211,8,2,2,4,136,75
19810118-M-Masters-F-Ivan_Lendl-Bjorn_Borg,2,B-DTM,23,2,0,0,2,16,7
19810118-M-Masters-F-Ivan_Lendl-Bjorn_Borg,2,B-DTL,16,6,3,0,3,9,7
19810118-M-Masters-F-Ivan_Lendl-Bjorn_Borg,2,S-XC,9,0,0,0,0,3,6
19810118-M-Masters-F-Ivan_Lendl-Bjorn_Borg,2,S-DTM,6,0,0,0,0,1,5
19810118-M-Masters-F-Ivan_Lendl-Bjorn_Borg,2,S-DTL,1,0,0,0,0,0,1
20100903-M-US_Open-SF-Novak_Djokovic-Roger_Federer,1,F-XC,62,17,5,9,3,43,19
20100903-M-US_Open-SF-Novak_Djokovic-Roger_Federer,1,F-DTM,65,2,0,0,2,32,33
20100903-M-US_Open-SF-Novak_Djokovic-Roger_Federer,1,F-DTL,21,6,1,2,3,13,8
20100903-M-US_Open-SF-Novak_Djokovic-Roger_Federer,1,F-IO,58,8,4,3,1,42,16
20100903-M-US_Open-SF-Novak_Djokovic-Roger_Federer,1,F-II,10,3,0,2,1,6,4
20100903-M-US_Open-SF-Novak_Djokovic-Roger_Federer,1,B-XC,113,17,4,7,6,62,51
20100903-M-US_Open-SF-Novak_Djokovic-Roger_Federer,1,B-DTM,56,4,1,0,3,27,29
20100903-M-US_Open-SF-Novak_Djokovic-Roger_Federer,1,B-DTL,27,10,2,3,5,16,11
20100903-M-US_Open-SF-Novak_Djokovic-Roger_Federer,1,B-IO,13,7,1,4,2,10,3
20100903-M-US_Open-SF-Novak_Djokovic-Roger_Federer,1,S-XC,10,1,0,0,1,6,4
20100903-M-US_Open-SF-Novak_Djokovic-Roger_Federer,1,S-DTM,6,2,0,0,2,1,5
20100903-M-US_Open-SF-Novak_Djokovic-Roger_Federer,1,S-DTL,3,1,0,0,1,2,1
20100903-M-US_Open-SF-Novak_Djokovic-Roger_Federer,2,F-XC,84,28,5,10,13,37,47
20100903-M-US_Open-SF-Novak_Djokovic-Roger_Federer,2,F-DTM,64,11,0,0,11,22,42
20100903-M-US_Open-SF-Novak_Djokovic-Roger_Federer,2,F-DTL,27,9,2,4,3,10,17
20100903-M-US_Open-SF-Novak_Djokovic-Roger_Federer,2,F-IO,59,21,6,8,7,36,23
20100903-M-US_Open-SF-Novak_Djokovic-Roger_Federer,2,F-II,12,5,1,1,3,6,6
20100903-M-US_Open-SF-Novak_Djokovic-Roger_Federer,2,B-XC,67,8,0,5,3,36,31
20100903-M-US_Open-SF-Novak_Djokovic-Roger_Federer,2,B-DTM,64,7,0,0,7,20,44
20100903-M-US_Open-SF-Novak_Djokovic-Roger_Federer,2,B-DTL,22,7,1,1,5,8,14
20100903-M-US_Open-SF-Novak_Djokovic-Roger_Federer,2,B-IO,4,1,0,0,1,1,3
20100903-M-US_Open-SF-Novak_Djokovic-Roger_Federer,2,S-XC,38,3,0,0,3,15,23
20100903-M-US_Open-SF-Novak_Djokovic-Roger_Federer,2,S-DTM,13,0,0,0,0,6,7
20100903-M-US_Open-SF-Novak_Djokovic-Roger_Federer,2,S-IO,1,0,0,0,0,0,1
20010827-M-US_Open-R128-Mike_Bryan-Andre_Agassi,1,F-XC,13,2,0,0,2,6,7
20010827-M-US_Open-R128-Mike_Bryan-Andre_Agassi,1,F-DTM,15,1,0,1,0,6,9
20010827-M-US_Open-R128-Mike_Bryan-Andre_Agassi,1,F-DTL,3,1,0,0,1,0,3
20010827-M-US_Open-R128-Mike_Bryan-Andre_Agassi,1,F-IO,9,4,1,0,3,4,5
20010827-M-US_Open-R128-Mike_Bryan-Andre_Agassi,1,F-II,1,0,0,0,0,0,1
20010827-M-US_Open-R128-Mike_Bryan-Andre_Agassi,1,B-XC,7,0,0,0,0,3,4
20010827-M-US_Open-R128-Mike_Bryan-Andre_Agassi,1,B-DTM,5,1,0,0,1,2,3
20010827-M-US_Open-R128-Mike_Bryan-Andre_Agassi,1,B-DTL,4,2,0,0,2,0,4
20010827-M-US_Open-R128-Mike_Bryan-Andre_Agassi,1,S-XC,5,0,0,0,0,2,3
20010827-M-US_Open-R128-Mike_Bryan-Andre_Agassi,1,S-DTM,9,0,0,0,0,3,6
20010827-M-US_Open-R128-Mike_Bryan-Andre_Agassi,1,S-IO,1,0,0,0,0,0,1
20010827-M-US_Open-R128-Mike_Bryan-Andre_Agassi,2,F-XC,28,10,3,6,1,22,6
20010827-M-US_Open-R128-Mike_Bryan-Andre_Agassi,2,F-DTM,7,0,0,0,0,3,4
20010827-M-US_Open-R128-Mike_Bryan-Andre_Agassi,2,F-DTL,7,2,1,0,1,3,4
20010827-M-US_Open-R128-Mike_Bryan-Andre_Agassi,2,F-IO,11,3,1,0,2,6,5
20010827-M-US_Open-R128-Mike_Bryan-Andre_Agassi,2,F-II,2,1,1,0,0,1,1
20010827-M-US_Open-R128-Mike_Bryan-Andre_Agassi,2,B-XC,21,6,2,0,4,12,9
20010827-M-US_Open-R128-Mike_Bryan-Andre_Agassi,2,B-DTM,7,1,0,0,1,3,4
20010827-M-US_Open-R128-Mike_Bryan-Andre_Agassi,2,B-DTL,8,5,4,0,1,6,2
20010827-M-US_Open-R128-Mike_Bryan-Andre_Agassi,2,B-IO,3,2,1,0,1,1,2
20010827-M-US_Open-R128-Mike_Bryan-Andre_Agassi,2,S-XC,2,0,0,0,0,2,0
20010827-M-US_Open-R128-Mike_Bryan-Andre_Agassi,2,S-DTL,1,0,0,0,0,0,1
20180729-M-Atlanta-F-John_Isner-Ryan_Harrison,1,F-XC,32,20,5,1,14,10,22
20180729-M-Atlanta-F-John_Isner-Ryan_Harrison,1,F-DTM,12,1,0,0,1,4,8
20180729-M-Atlanta-F-John_Isner-Ryan_Harrison,1,F-DTL,5,5,2,0,3,2,3
20180729-M-Atlanta-F-John_Isner-Ryan_Harrison,1,F-IO,21,13,8,1,4,16,5
20180729-M-Atlanta-F-John_Isner-Ryan_Harrison,1,F-II,2,0,0,0,0,2,0
20180729-M-Atlanta-F-John_Isner-Ryan_Harrison,1,B-XC,7,3,1,0,2,3,4
20180729-M-Atlanta-F-John_Isner-Ryan_Harrison,1,B-DTM,10,2,0,0,2,3,7
20180729-M-Atlanta-F-John_Isner-Ryan_Harrison,1,B-DTL,3,3,1,1,1,2,1
20180729-M-Atlanta-F-John_Isner-Ryan_Harrison,1,B-IO,2,1,0,0,1,0,2
20180729-M-Atlanta-F-John_Isner-Ryan_Harrison,1,B-II,1,0,0,0,0,1,0
20180729-M-Atlanta-F-John_Isner-Ryan_Harrison,1,S-XC,2,0,0,0,0,1,1
20180729-M-Atlanta-F-John_Isner-Ryan_Harrison,1,S-DTM,4,0,0,0,0,2,2
20180729-M-Atlanta-F-John_Isner-Ryan_Harrison,2,F-XC,19,5,2,1,2,13,6
20180729-M-Atlanta-F-John_Isner-Ryan_Harrison,2,F-DTM,10,1,0,0,1,6,4
20180729-M-Atlanta-F-John_Isner-Ryan_Harrison,2,F-DTL,3,1,0,1,0,1,2
20180729-M-Atlanta-F-John_Isner-Ryan_Harrison,2,F-IO,21,9,0,5,4,12,9
20180729-M-Atlanta-F-John_Isner-Ryan_Harrison,2,B-XC,14,5,2,1,2,6,8
20180729-M-Atlanta-F-John_Isner-Ryan_Harrison,2,B-DTM,12,2,0,0,2,6,6
20180729-M-Atlanta-F-John_Isner-Ryan_Harrison,2,B-DTL,4,2,2,0,0,3,1
20180729-M-Atlanta-F-John_Isner-Ryan_Harrison,2,B-IO,1,0,0,0,0,1,0
20180729-M-Atlanta-F-John_Isner-Ryan_Harrison,2,S-XC,5,1,1,0,0,3,2
20180729-M-Atlanta-F-John_Isner-Ryan_Harrison,2,S-DTM,3,0,0,0,0,0,3
20180729-M-Atlanta-F-John_Isner-Ryan_Harrison,2,S-DTL,1,0,0,0,0,0,1
20110115-M-Sydney-F-Gilles_Simon-Viktor_Troicki,1,F-XC,70,15,4,2,9,40,30
20110115-M-Sydney-F-Gilles_Simon-Viktor_Troicki,1,F-DTM,43,1,0,0,1,28,15
20110115-M-Sydney-F-Gilles_Simon-Viktor_Troicki,1,F-DTL,27,5,4,0,1,20,7
20110115-M-Sydney-F-Gilles_Simon-Viktor_Troicki,1,F-IO,29,5,2,1,2,16,13
20110115-M-Sydney-F-Gilles_Simon-Viktor_Troicki,1,F-II,4,3,2,0,1,3,1
20110115-M-Sydney-F-Gilles_Simon-Viktor_Troicki,1,B-XC,64,6,1,3,2,36,28
20110115-M-Sydney-F-Gilles_Simon-Viktor_Troicki,1,B-DTM,44,2,0,0,2,24,20
20110115-M-Sydney-F-Gilles_Simon-Viktor_Troicki,1,B-DTL,23,9,4,2,3,14,9
20110115-M-Sydney-F-Gilles_Simon-Viktor_Troicki,1,B-IO,3,1,0,0,1,2,1
20110115-M-Sydney-F-Gilles_Simon-Viktor_Troicki,1,S-DTM,1,0,0,0,0,0,1
20110115-M-Sydney-F-Gilles_Simon-Viktor_Troicki,2,F-XC,80,11,3,2,6,31,49
20110115-M-Sydney-F-Gilles_Simon-Viktor_Troicki,2,F-DTM,26,1,0,0,1,12,14
20110115-M-Sydney-F-Gilles_Simon-Viktor_Troicki,2,F-DTL,21,6,1,3,2,7,14
20110115-M-Sydney-F-Gilles_Simon-Viktor_Troicki,2,F-IO,28,7,0,2,5,14,14
20110115-M-Sydney-F-Gilles_Simon-Viktor_Troicki,2,F-II,6,3,1,0,2,2,4
20110115-M-Sydney-F-Gilles_Simon-Viktor_Troicki,2,B-XC,66,12,2,3,7,28,38
20110115-M-Sydney-F-Gilles_Simon-Viktor_Troicki,2,B-DTM,29,0,0,0,0,11,18
20110115-M-Sydney-F-Gilles_Simon-Viktor_Troicki,2,B-DTL,20,9,3,3,3,9,11
20110115-M-Sydney-F-Gilles_Simon-Viktor_Troicki,2,B-IO,9,2,0,0,2,1,8
20110115-M-Sydney-F-Gilles_Simon-Viktor_Troicki,2,S-XC,3,0,0,0,0,1,2
20110115-M-Sydney-F-Gilles_Simon-Viktor_Troicki,2,S-DTM,4,0,0,0,0,2,2
20110115-M-Sydney-F-Gilles_Simon-Viktor_Troicki,2,S-DTL,3,0,0,0,0,0,3
20180718-M-Bastad-R16-Matteo_Berrettini-Henri_Laaksonen,1,F-XC,20,7,1,4,2,7,13
20180718-M-Bastad-R16-Matteo_Berrettini-Henri_Laaksonen,1,F-DTM,4,0,0,0,0,1,3
20180718-M-Bastad-R16-Matteo_Berrettini-Henri_Laaksonen,1,F-DTL,7,1,0,0,1,1,6
20180718-M-Bastad-R16-Matteo_Berrettini-Henri_Laaksonen,1,F-IO,12,5,1,0,4,4,8
20180718-M-Bastad-R16-Matteo_Berrettini-Henri_Laaksonen,1,F-II,1,1,0,0,1,0,1
20180718-M-Bastad-R16-Matteo_Berrettini-Henri_Laaksonen,1,B-XC,10,2,0,0,2,4,6
20180718-M-Bastad-R16-Matteo_Berrettini-Henri_Laaksonen,1,B-DTM,4,0,0,0,0,1,3
20180718-M-Bastad-R16-Matteo_Berrettini-Henri_Laaksonen,1,B-DTL,3,2,2,0,0,2,1
20180718-M-Bastad-R16-Matteo_Berrettini-Henri_Laaksonen,1,B-IO,1,1,1,0,0,1,0
20180718-M-Bastad-R16-Matteo_Berrettini-Henri_Laaksonen,1,S-XC,10,3,0,0,3,2,8
20180718-M-Bastad-R16-Matteo_Berrettini-Henri_Laaksonen,1,S-DTM,7,0,0,0,0,1,6
20180718-M-Bastad-R16-Matteo_Berrettini-Henri_Laaksonen,1,S-DTL,2,0,0,0,0,1,1
20180718-M-Bastad-R16-Matteo_Berrettini-Henri_Laaksonen,2,F-XC,34,15,8,6,1,29,5
20180718-M-Bastad-R16-Matteo_Berrettini-Henri_Laaksonen,2,F-DTM,10,0,0,0,0,6,4
20180718-M-Bastad-R16-Matteo_Berrettini-Henri_Laaksonen,2,F-DTL,5,1,0,1,0,5,0
20180718-M-Bastad-R16-Matteo_Berrettini-Henri_Laaksonen,2,F-IO,17,7,1,2,4,10,7
20180718-M-Bastad-R16-Matteo_Berrettini-Henri_Laaksonen,2,F-II,3,2,0,1,1,2,1
20180718-M-Bastad-R16-Matteo_Berrettini-Henri_Laaksonen,2,B-XC,9,1,0,0,1,6,3
20180718-M-Bastad-R16-Matteo_Berrettini-Henri_Laaksonen,2,B-DTM,9,4,0,0,4,3,6
20180718-M-Bastad-R16-Matteo_Berrettini-Henri_Laaksonen,2,B-DTL,4,2,1,0,1,1,3
20180718-M-Bastad-R16-Matteo_Berrettini-Henri_Laaksonen,2,S-XC,3,0,0,0,0,3,0
20180718-M-Bastad-R16-Matteo_Berrettini-Henri_Laaksonen,2,S-DTM,6,0,0,0,0,5,1
20180722-M-Bastad-F-Fabio_Fognini-Richard_Gasquet,1,F-XC,35,6,2,2,2,19,16
20180722-M-Bastad-F-Fabio_Fognini-Richard_Gasquet,1,F-DTM,33,4,0,0,4,16,17
20180722-M-Bastad-F-Fabio_Fognini-Richard_Gasquet,1,F-DTL,11,5,2,1,2,7,4
20180722-M-Bastad-F-Fabio_Fognini-Richard_Gasquet,1,F-IO,37,10,3,5,2,22,15
20180722-M-Bastad-F-Fabio_Fognini-Richard_Gasquet,1,F-II,6,2,1,0,1,4,2
20180722-M-Bastad-F-Fabio_Fognini-Richard_Gasquet,1,B-XC,59,8,1,1,6,25,34
20180722-M-Bastad-F-Fabio_Fognini-Richard_Gasquet,1,B-DTM,45,4,1,0,3,20,25
20180722-M-Bastad-F-Fabio_Fognini-Richard_Gasquet,1,B-DTL,14,7,2,2,3,7,7
20180722-M-Bastad-F-Fabio_Fognini-Richard_Gasquet,1,B-IO,10,3,0,1,2,5,5
20180722-M-Bastad-F-Fabio_Fognini-Richard_Gasquet,1,S-XC,6,0,0,0,0,1,5
20180722-M-Bastad-F-Fabio_Fognini-Richard_Gasquet,1,S-DTM,5,0,0,0,0,1,4
20180722-M-Bastad-F-Fabio_Fognini-Richard_Gasquet,2,F-XC,36,8,2,0,6,19,17
20180722-M-Bastad-F-Fabio_Fognini-Richard_Gasquet,2,F-DTM,31,6,0,0,6,11,20
20180722-M-Bastad-F-Fabio_Fognini-Richard_Gasquet,2,F-DTL,13,1,0,0,1,8,5
20180722-M-Bastad-F-Fabio_Fognini-Richard_Gasquet,2,F-IO,21,3,1,1,1,14,7
20180722-M-Bastad-F-Fabio_Fognini-Richard_Gasquet,2,F-II,3,1,1,0,0,3,0
20180722-M-Bastad-F-Fabio_Fognini-Richard_Gasquet,2,B-XC,79,7,1,2,4,39,40
20180722-M-Bastad-F-Fabio_Fognini-Richard_Gasquet,2,B-DTM,36,1,0,0,1,20,16
20180722-M-Bastad-F-Fabio_Fognini-Richard_Gasquet,2,B-DTL,10,7,3,2,2,7,3
20180722-M-Bastad-F-Fabio_Fognini-Richard_Gasquet,2,B-IO,7,1,1,0,0,7,0
20180722-M-Bastad-F-Fabio_Fognini-Richard_Gasquet,2,S-XC,8,1,0,1,0,4,4
20180722-M-Bastad-F-Fabio_Fognini-Richard_Gasquet,2,S-DTM,2,0,0,0,0,1,1
20180722-M-Bastad-F-Fabio_Fognini-Richard_Gasquet,2,S-DTL,2,1,0,0,1,1,1
19840115-M-Masters-F-John_Mcenroe-Ivan_Lendl,1,F-XC,9,2,0,0,2,2,7
19840115-M-Masters-F-John_Mcenroe-Ivan_Lendl,1,F-DTM,8,1,0,1,0,2,6
19840115-M-Masters-F-John_Mcenroe-Ivan_Lendl,1,F-DTL,5,1,1,0,0,3,2
19840115-M-Masters-F-John_Mcenroe-Ivan_Lendl,1,F-IO,2,1,0,0,1,0,2
19840115-M-Masters-F-John_Mcenroe-Ivan_Lendl,1,B-XC,5,1,0,0,1,3,2
19840115-M-Masters-F-John_Mcenroe-Ivan_Lendl,1,B-DTM,4,1,0,0,1,0,4
19840115-M-Masters-F-John_Mcenroe-Ivan_Lendl,1,B-DTL,2,0,0,0,0,1,1
19840115-M-Masters-F-John_Mcenroe-Ivan_Lendl,1,B-IO,2,1,0,0,1,0,2
19840115-M-Masters-F-John_Mcenroe-Ivan_Lendl,1,S-XC,1,0,0,0,0,0,1
19840115-M-Masters-F-John_Mcenroe-Ivan_Lendl,1,S-DTM,4,1,0,0,1,1,3
19840115-M-Masters-F-John_Mcenroe-Ivan_Lendl,1,S-DTL,3,0,0,0,0,1,2
19840115-M-Masters-F-John_Mcenroe-Ivan_Lendl,1,S-IO,2,0,0,0,0,0,2
19840115-M-Masters-F-John_Mcenroe-Ivan_Lendl,2,F-XC,16,4,2,2,0,11,5
19840115-M-Masters-F-John_Mcenroe-Ivan_Lendl,2,F-DTM,6,1,0,0,1,5,1
19840115-M-Masters-F-John_Mcenroe-Ivan_Lendl,2,F-DTL,6,3,1,1,1,3,3
19840115-M-Masters-F-John_Mcenroe-Ivan_Lendl,2,F-IO,9,3,3,0,0,7,2
19840115-M-Masters-F-John_Mcenroe-Ivan_Lendl,2,B-XC,18,5,3,1,1,10,8
19840115-M-Masters-F-John_Mcenroe-Ivan_Lendl,2,B-DTM,9,1,0,0,1,5,4
19840115-M-Masters-F-John_Mcenroe-Ivan_Lendl,2,B-DTL,14,3,2,0,1,7,7
19840115-M-Masters-F-John_Mcenroe-Ivan_Lendl,2,B-IO,5,1,0,0,1,4,1
19840115-M-Masters-F-John_Mcenroe-Ivan_Lendl,2,S-XC,5,1,0,0,1,3,2
19840115-M-Masters-F-John_Mcenroe-Ivan_Lendl,2,S-DTM,4,0,0,0,0,2,2
19840115-M-Masters-F-John_Mcenroe-Ivan_Lendl,2,S-DTL,1,1,0,1,0,1,0
20170614-M-Stuttgart-R16-Tommy_Haas-Roger_Federer,1,F-XC,27,7,1,1,5,16,11
20170614-M-Stuttgart-R16-Tommy_Haas-Roger_Federer,1,F-DTM,10,1,0,1,0,4,6
20170614-M-Stuttgart-R16-Tommy_Haas-Roger_Federer,1,F-DTL,9,4,1,0,3,2,7
20170614-M-Stuttgart-R16-Tommy_Haas-Roger_Federer,1,F-IO,24,6,0,2,4,13,11
20170614-M-Stuttgart-R16-Tommy_Haas-Roger_Federer,1,F-II,3,3,2,1,0,3,0
20170614-M-Stuttgart-R16-Tommy_Haas-Roger_Federer,1,B-XC,25,10,5,3,2,16,9
20170614-M-Stuttgart-R16-Tommy_Haas-Roger_Federer,1,B-DTM,13,1,0,0,1,8,5
20170614-M-Stuttgart-R16-Tommy_Haas-Roger_Federer,1,B-DTL,8,3,2,0,1,4,4
20170614-M-Stuttgart-R16-Tommy_Haas-Roger_Federer,1,B-IO,5,2,0,1,1,3,2
20170614-M-Stuttgart-R16-Tommy_Haas-Roger_Federer,1,S-XC,17,3,0,0,3,7,10
20170614-M-Stuttgart-R16-Tommy_Haas-Roger_Federer,1,S-DTM,2,0,0,0,0,0,2
20170614-M-Stuttgart-R16-Tommy_Haas-Roger_Federer,1,S-DTL,2,1,1,0,0,2,0
20170614-M-Stuttgart-R16-Tommy_Haas-Roger_Federer,2,F-XC,20,9,2,5,2,13,7
20170614-M-Stuttgart-R16-Tommy_Haas-Roger_Federer,2,F-DTM,18,1,0,0,1,8,10
20170614-M-Stuttgart-R16-Tommy_Haas-Roger_Federer,2,F-DTL,12,3,1,1,1,4,8
20170614-M-Stuttgart-R16-Tommy_Haas-Roger_Federer,2,F-IO,20,8,4,2,2,13,7
20170614-M-Stuttgart-R16-Tommy_Haas-Roger_Federer,2,F-II,6,3,2,1,0,5,1
20170614-M-Stuttgart-R16-Tommy_Haas-Roger_Federer,2,B-XC,12,3,2,0,1,5,7
20170614-M-Stuttgart-R16-Tommy_Haas-Roger_Federer,2,B-DTM,8,3,0,0,3,2,6
20170614-M-Stuttgart-R16-Tommy_Haas-Roger_Federer,2,B-DTL,8,7,0,3,4,4,4
20170614-M-Stuttgart-R16-Tommy_Haas-Roger_Federer,2,B-IO,1,1,0,0,1,0,1
20170614-M-Stuttgart-R16-Tommy_Haas-Roger_Federer,2,S-XC,18,2,0,0,2,9,9
20170614-M-Stuttgart-R16-Tommy_Haas-Roger_Federer,2,S-DTM,4,0,0,0,0,0,4
20170614-M-Stuttgart-R16-Tommy_Haas-Roger_Federer,2,S-DTL,3,0,0,0,0,1,2
20180704-M-Wimbledon-R64-Lukas_Lacko-Roger_Federer,1,F-XC,18,4,1,1,2,8,10
20180704-M-Wimbledon-R64-Lukas_Lacko-Roger_Federer,1,F-DTM,8,2,0,0,2,1,7
20180704-M-Wimbledon-R64-Lukas_Lacko-Roger_Federer,1,F-DTL,12,3,0,0,3,3,9
20180704-M-Wimbledon-R64-Lukas_Lacko-Roger_Federer,1,F-IO,33,9,2,2,5,15,18
20180704-M-Wimbledon-R64-Lukas_Lacko-Roger_Federer,1,F-II,1,1,1,0,0,1,0
20180704-M-Wimbledon-R64-Lukas_Lacko-Roger_Federer,1,B-XC,20,2,0,0,2,5,15
20180704-M-Wimbledon-R64-Lukas_Lacko-Roger_Federer,1,B-DTM,8,0,0,0,0,2,6
20180704-M-Wimbledon-R64-Lukas_Lacko-Roger_Federer,1,B-DTL,9,4,1,1,2,2,7
20180704-M-Wimbledon-R64-Lukas_Lacko-Roger_Federer,1,S-XC,6,1,0,1,0,3,3
20180704-M-Wimbledon-R64-Lukas_Lacko-Roger_Federer,1,S-DTM,4,0,0,0,0,0,4
20180704-M-Wimbledon-R64-Lukas_Lacko-Roger_Federer,1,S-DTL,4,0,0,0,0,2,2
20180704-M-Wimbledon-R64-Lukas_Lacko-Roger_Federer,2,F-XC,22,12,7,2,3,17,5
20180704-M-Wimbledon-R64-Lukas_Lacko-Roger_Federer,2,F-DTM,3,1,0,0,1,2,1
20180704-M-Wimbledon-R64-Lukas_Lacko-Roger_Federer,2,F-DTL,12,7,4,1,2,9,3
20180704-M-Wimbledon-R64-Lukas_Lacko-Roger_Federer,2,F-IO,14,8,5,1,2,11,3
20180704-M-Wimbledon-R64-Lukas_Lacko-Roger_Federer,2,F-II,5,5,4,1,0,5,0
20180704-M-Wimbledon-R64-Lukas_Lacko-Roger_Federer,2,B-XC,21,2,0,2,0,15,6
20180704-M-Wimbledon-R64-Lukas_Lacko-Roger_Federer,2,B-DTM,10,0,0,0,0,5,5
20180704-M-Wimbledon-R64-Lukas_Lacko-Roger_Federer,2,B-DTL,7,6,3,1,2,5,2
20180704-M-Wimbledon-R64-Lukas_Lacko-Roger_Federer,2,B-IO,1,1,0,0,1,0,1
20180704-M-Wimbledon-R64-Lukas_Lacko-Roger_Federer,2,S-XC,12,0,0,0,0,4,8
20180704-M-Wimbledon-R64-Lukas_Lacko-Roger_Federer,2,S-DTM,4,0,0,0,0,2,2
20180704-M-Wimbledon-R64-Lukas_Lacko-Roger_Federer,2,S-DTL,8,1,0,0,1,7,1
20180702-M-Wimbledon-R128-Dusan_Lajovic-Roger_Federer,1,F-XC,30,11,2,2,7,13,17
20180702-M-Wimbledon-R128-Dusan_Lajovic-Roger_Federer,1,F-DTM,7,0,0,0,0,2,5
20180702-M-Wimbledon-R128-Dusan_Lajovic-Roger_Federer,1,F-DTL,9,5,1,1,3,5,4
20180702-M-Wimbledon-R128-Dusan_Lajovic-Roger_Federer,1,F-IO,24,8,1,2,5,12,12
20180702-M-Wimbledon-R128-Dusan_Lajovic-Roger_Federer,1,F-II,4,2,1,0,1,2,2
20180702-M-Wimbledon-R128-Dusan_Lajovic-Roger_Federer,1,B-XC,17,5,2,0,3,10,7
20180702-M-Wimbledon-R128-Dusan_Lajovic-Roger_Federer,1,B-DTM,4,1,0,0,1,1,3
20180702-M-Wimbledon-R128-Dusan_Lajovic-Roger_Federer,1,B-DTL,7,2,1,0,1,2,5
20180702-M-Wimbledon-R128-Dusan_Lajovic-Roger_Federer,1,B-IO,1,0,0,0,0,1,0
20180702-M-Wimbledon-R128-Dusan_Lajovic-Roger_Federer,1,S-XC,7,1,0,0,1,1,6
20180702-M-Wimbledon-R128-Dusan_Lajovic-Roger_Federer,1,S-DTM,4,0,0,0,0,2,2
20180702-M-Wimbledon-R128-Dusan_Lajovic-Roger_Federer,1,S-DTL,4,2,0,0,2,1,3
20180702-M-Wimbledon-R128-Dusan_Lajovic-Roger_Federer,2,F-XC,18,9,4,3,2,11,7
20180702-M-Wimbledon-R128-Dusan_Lajovic-Roger_Federer,2,F-DTM,5,1,0,0,1,4,1
20180702-M-Wimbledon-R128-Dusan_Lajovic-Roger_Federer,2,F-DTL,17,8,5,2,1,13,4
20180702-M-Wimbledon-R128-Dusan_Lajovic-Roger_Federer,2,F-IO,13,5,2,0,3,6,7
20180702-M-Wimbledon-R128-Dusan_Lajovic-Roger_Federer,2,F-II,5,3,3,0,0,4,1
20180702-M-Wimbledon-R128-Dusan_Lajovic-Roger_Federer,2,B-XC,14,8,2,1,5,6,8
20180702-M-Wimbledon-R128-Dusan_Lajovic-Roger_Federer,2,B-DTM,8,1,0,1,0,5,3
20180702-M-Wimbledon-R128-Dusan_Lajovic-Roger_Federer,2,B-DTL,3,2,0,0,2,0,3
20180702-M-Wimbledon-R128-Dusan_Lajovic-Roger_Federer,2,B-IO,1,0,0,0,0,1,0
20180702-M-Wimbledon-R128-Dusan_Lajovic-Roger_Federer,2,S-XC,11,1,0,0,1,5,6
20180702-M-Wimbledon-R128-Dusan_Lajovic-Roger_Federer,2,S-DTM,1,0,0,0,0,1,0
20180702-M-Wimbledon-R128-Dusan_Lajovic-Roger_Federer,2,S-DTL,1,0,0,0,0,1,0
20180706-M-Wimbledon-R32-Roger_Federer-Jan_Lennard_Struff,1,F-XC,21,9,5,1,3,9,12
20180706-M-Wimbledon-R32-Roger_Federer-Jan_Lennard_Struff,1,F-DTM,5,1,0,0,1,1,4
20180706-M-Wimbledon-R32-Roger_Federer-Jan_Lennard_Struff,1,F-DTL,10,5,3,1,1,9,1
20180706-M-Wimbledon-R32-Roger_Federer-Jan_Lennard_Struff,1,F-IO,19,7,5,1,1,14,5
20180706-M-Wimbledon-R32-Roger_Federer-Jan_Lennard_Struff,1,F-II,3,2,0,1,1,2,1
20180706-M-Wimbledon-R32-Roger_Federer-Jan_Lennard_Struff,1,B-XC,18,5,1,2,2,11,7
20180706-M-Wimbledon-R32-Roger_Federer-Jan_Lennard_Struff,1,B-DTM,11,2,0,1,1,7,4
20180706-M-Wimbledon-R32-Roger_Federer-Jan_Lennard_Struff,1,B-DTL,7,4,3,0,1,6,1
20180706-M-Wimbledon-R32-Roger_Federer-Jan_Lennard_Struff,1,B-IO,1,0,0,0,0,1,0
20180706-M-Wimbledon-R32-Roger_Federer-Jan_Lennard_Struff,1,S-XC,14,2,0,1,1,9,5
20180706-M-Wimbledon-R32-Roger_Federer-Jan_Lennard_Struff,1,S-DTM,1,0,0,0,0,1,0
20180706-M-Wimbledon-R32-Roger_Federer-Jan_Lennard_Struff,1,S-DTL,2,0,0,0,0,2,0
20180706-M-Wimbledon-R32-Roger_Federer-Jan_Lennard_Struff,1,S-IO,1,0,0,0,0,1,0
20180706-M-Wimbledon-R32-Roger_Federer-Jan_Lennard_Struff,2,F-XC,23,6,2,2,2,13,10
20180706-M-Wimbledon-R32-Roger_Federer-Jan_Lennard_Struff,2,F-DTM,9,1,0,1,0,6,3
20180706-M-Wimbledon-R32-Roger_Federer-Jan_Lennard_Struff,2,F-DTL,10,4,3,1,0,4,6
20180706-M-Wimbledon-R32-Roger_Federer-Jan_Lennard_Struff,2,F-IO,13,5,1,1,3,5,8
20180706-M-Wimbledon-R32-Roger_Federer-Jan_Lennard_Struff,2,F-II,1,1,0,0,1,0,1
20180706-M-Wimbledon-R32-Roger_Federer-Jan_Lennard_Struff,2,B-XC,40,7,1,0,6,12,28
20180706-M-Wimbledon-R32-Roger_Federer-Jan_Lennard_Struff,2,B-DTM,7,2,0,0,2,4,3
20180706-M-Wimbledon-R32-Roger_Federer-Jan_Lennard_Struff,2,B-DTL,10,7,2,2,3,5,5
20180706-M-Wimbledon-R32-Roger_Federer-Jan_Lennard_Struff,2,B-IO,2,0,0,0,0,1,1
20180706-M-Wimbledon-R32-Roger_Federer-Jan_Lennard_Struff,2,S-XC,3,0,0,0,0,1,2
20180706-M-Wimbledon-R32-Roger_Federer-Jan_Lennard_Struff,2,S-DTM,1,0,0,0,0,0,1
20180706-M-Wimbledon-R32-Roger_Federer-Jan_Lennard_Struff,2,S-DTL,2,1,0,0,1,0,2
20180607-M-Roland_Garros-QF-Marin_Cilic-Juan_Martin_Del_Potro,1,F-XC,60,36,15,7,14,33,27
20180607-M-Roland_Garros-QF-Marin_Cilic-Juan_Martin_Del_Potro,1,F-DTM,10,2,0,0,2,4,6
20180607-M-Roland_Garros-QF-Marin_Cilic-Juan_Martin_Del_Potro,1,F-DTL,27,10,2,2,6,10,17
20180607-M-Roland_Garros-QF-Marin_Cilic-Juan_Martin_Del_Potro,1,F-IO,72,15,2,5,8,34,38
20180607-M-Roland_Garros-QF-Marin_Cilic-Juan_Martin_Del_Potro,1,F-II,18,8,1,2,5,9,9
20180607-M-Roland_Garros-QF-Marin_Cilic-Juan_Martin_Del_Potro,1,B-XC,87,22,1,4,17,28,59
20180607-M-Roland_Garros-QF-Marin_Cilic-Juan_Martin_Del_Potro,1,B-DTM,14,4,0,0,4,3,11
20180607-M-Roland_Garros-QF-Marin_Cilic-Juan_Martin_Del_Potro,1,B-DTL,23,10,3,2,5,10,13
20180607-M-Roland_Garros-QF-Marin_Cilic-Juan_Martin_Del_Potro,1,B-IO,3,3,1,1,1,2,1
20180607-M-Roland_Garros-QF-Marin_Cilic-Juan_Martin_Del_Potro,1,S-XC,1,0,0,0,0,0,1
20180607-M-Roland_Garros-QF-Marin_Cilic-Juan_Martin_Del_Potro,1,S-DTL,1,0,0,0,0,1,0
20180607-M-Roland_Garros-QF-Marin_Cilic-Juan_Martin_Del_Potro,2,F-XC,36,11,1,5,5,17,19
20180607-M-Roland_Garros-QF-Marin_Cilic-Juan_Martin_Del_Potro,2,F-DTM,20,4,0,2,2,10,10
20180607-M-Roland_Garros-QF-Marin_Cilic-Juan_Martin_Del_Potro,2,F-DTL,8,2,1,0,1,6,2
20180607-M-Roland_Garros-QF-Marin_Cilic-Juan_Martin_Del_Potro,2,F-IO,26,5,1,3,1,16,10
20180607-M-Roland_Garros-QF-Marin_Cilic-Juan_Martin_Del_Potro,2,F-II,6,0,0,0,0,4,2
20180607-M-Roland_Garros-QF-Marin_Cilic-Juan_Martin_Del_Potro,2,B-XC,70,6,0,0,6,42,28
20180607-M-Roland_Garros-QF-Marin_Cilic-Juan_Martin_Del_Potro,2,B-DTM,23,1,0,0,1,12,11
20180607-M-Roland_Garros-QF-Marin_Cilic-Juan_Martin_Del_Potro,2,B-DTL,18,10,3,5,2,13,5
20180607-M-Roland_Garros-QF-Marin_Cilic-Juan_Martin_Del_Potro,2,B-IO,2,1,1,0,0,2,0
20180607-M-Roland_Garros-QF-Marin_Cilic-Juan_Martin_Del_Potro,2,S-XC,45,2,0,0,2,25,20
20180607-M-Roland_Garros-QF-Marin_Cilic-Juan_Martin_Del_Potro,2,S-DTM,6,1,0,0,1,4,2
20180607-M-Roland_Garros-QF-Marin_Cilic-Juan_Martin_Del_Potro,2,S-DTL,3,0,0,0,0,0,3
20180607-M-Roland_Garros-QF-Marin_Cilic-Juan_Martin_Del_Potro,2,S-IO,1,0,0,0,0,1,0
20040807-M-Cincinnati_Masters-SF-Lleyton_Hewitt-Tommy_Robredo,1,F-XC,29,7,0,4,3,18,11
20040807-M-Cincinnati_Masters-SF-Lleyton_Hewitt-Tommy_Robredo,1,F-DTM,5,0,0,0,0,4,1
20040807-M-Cincinnati_Masters-SF-Lleyton_Hewitt-Tommy_Robredo,1,F-DTL,10,4,1,0,3,5,5
20040807-M-Cincinnati_Masters-SF-Lleyton_Hewitt-Tommy_Robredo,1,F-IO,11,3,1,2,0,10,1
20040807-M-Cincinnati_Masters-SF-Lleyton_Hewitt-Tommy_Robredo,1,F-II,3,1,1,0,0,3,0
20040807-M-Cincinnati_Masters-SF-Lleyton_Hewitt-Tommy_Robredo,1,B-XC,18,1,0,1,0,11,7
20040807-M-Cincinnati_Masters-SF-Lleyton_Hewitt-Tommy_Robredo,1,B-DTM,4,0,0,0,0,0,4
20040807-M-Cincinnati_Masters-SF-Lleyton_Hewitt-Tommy_Robredo,1,B-DTL,1,1,0,0,1,0,1
20040807-M-Cincinnati_Masters-SF-Lleyton_Hewitt-Tommy_Robredo,1,B-IO,1,1,1,0,0,1,0
20040807-M-Cincinnati_Masters-SF-Lleyton_Hewitt-Tommy_Robredo,1,S-XC,5,0,0,0,0,3,2
20040807-M-Cincinnati_Masters-SF-Lleyton_Hewitt-Tommy_Robredo,1,S-DTM,1,0,0,0,0,1,0
20040807-M-Cincinnati_Masters-SF-Lleyton_Hewitt-Tommy_Robredo,1,S-DTL,1,1,0,1,0,1,0
20040807-M-Cincinnati_Masters-SF-Lleyton_Hewitt-Tommy_Robredo,2,F-XC,20,5,1,1,3,9,11
20040807-M-Cincinnati_Masters-SF-Lleyton_Hewitt-Tommy_Robredo,2,F-DTM,9,3,1,1,1,4,5
20040807-M-Cincinnati_Masters-SF-Lleyton_Hewitt-Tommy_Robredo,2,F-DTL,10,5,2,0,3,4,6
20040807-M-Cincinnati_Masters-SF-Lleyton_Hewitt-Tommy_Robredo,2,F-IO,19,5,2,1,2,11,8
20040807-M-Cincinnati_Masters-SF-Lleyton_Hewitt-Tommy_Robredo,2,F-II,3,0,0,0,0,0,3
20040807-M-Cincinnati_Masters-SF-Lleyton_Hewitt-Tommy_Robredo,2,B-XC,5,1,0,0,1,2,3
20040807-M-Cincinnati_Masters-SF-Lleyton_Hewitt-Tommy_Robredo,2,B-DTM,15,0,0,0,0,1,14
20040807-M-Cincinnati_Masters-SF-Lleyton_Hewitt-Tommy_Robredo,2,B-DTL,4,2,0,0,2,2,2
20040807-M-Cincinnati_Masters-SF-Lleyton_Hewitt-Tommy_Robredo,2,B-IO,2,0,0,0,0,1,1
20040807-M-Cincinnati_Masters-SF-Lleyton_Hewitt-Tommy_Robredo,2,S-XC,2,0,0,0,0,1,1
20040807-M-Cincinnati_Masters-SF-Lleyton_Hewitt-Tommy_Robredo,2,S-DTM,2,0,0,0,0,2,0
20170119-M-Australian_Open-R64-Novak_Djokovic-Denis_Istomin,1,F-XC,123,20,6,8,6,71,52
20170119-M-Australian_Open-R64-Novak_Djokovic-Denis_Istomin,1,F-DTM,49,1,0,1,0,31,18
20170119-M-Australian_Open-R64-Novak_Djokovic-Denis_Istomin,1,F-DTL,61,18,5,5,8,34,27
20170119-M-Australian_Open-R64-Novak_Djokovic-Denis_Istomin,1,F-IO,71,16,3,5,8,40,31
20170119-M-Australian_Open-R64-Novak_Djokovic-Denis_Istomin,1,F-II,5,3,3,0,0,5,0
20170119-M-Australian_Open-R64-Novak_Djokovic-Denis_Istomin,1,B-XC,107,11,3,4,4,68,39
20170119-M-Australian_Open-R64-Novak_Djokovic-Denis_Istomin,1,B-DTM,63,5,0,1,4,33,30
20170119-M-Australian_Open-R64-Novak_Djokovic-Denis_Istomin,1,B-DTL,54,22,6,4,12,28,26
20170119-M-Australian_Open-R64-Novak_Djokovic-Denis_Istomin,1,B-IO,18,4,1,2,1,10,8
20170119-M-Australian_Open-R64-Novak_Djokovic-Denis_Istomin,1,S-XC,36,2,0,2,0,22,14
20170119-M-Australian_Open-R64-Novak_Djokovic-Denis_Istomin,1,S-DTM,12,0,0,0,0,11,1
20170119-M-Australian_Open-R64-Novak_Djokovic-Denis_Istomin,1,S-DTL,10,4,1,1,2,7,3
20170119-M-Australian_Open-R64-Novak_Djokovic-Denis_Istomin,2,F-XC,115,17,9,2,6,55,60
20170119-M-Australian_Open-R64-Novak_Djokovic-Denis_Istomin,2,F-DTM,49,3,0,1,2,20,29
20170119-M-Australian_Open-R64-Novak_Djokovic-Denis_Istomin,2,F-DTL,50,17,8,2,7,23,27
20170119-M-Australian_Open-R64-Novak_Djokovic-Denis_Istomin,2,F-IO,57,9,6,1,2,29,28
20170119-M-Australian_Open-R64-Novak_Djokovic-Denis_Istomin,2,F-II,4,3,1,2,0,3,1
20170119-M-Australian_Open-R64-Novak_Djokovic-Denis_Istomin,2,B-XC,126,14,2,3,9,48,78
20170119-M-Australian_Open-R64-Novak_Djokovic-Denis_Istomin,2,B-DTM,76,6,0,1,5,30,46
20170119-M-Australian_Open-R64-Novak_Djokovic-Denis_Istomin,2,B-DTL,59,20,6,6,8,30,29
20170119-M-Australian_Open-R64-Novak_Djokovic-Denis_Istomin,2,B-IO,21,6,0,2,4,9,12
20170119-M-Australian_Open-R64-Novak_Djokovic-Denis_Istomin,2,S-XC,32,1,0,0,1,11,21
20170119-M-Australian_Open-R64-Novak_Djokovic-Denis_Istomin,2,S-DTM,10,0,0,0,0,3,7
20170119-M-Australian_Open-R64-Novak_Djokovic-Denis_Istomin,2,S-DTL,3,0,0,0,0,1,2
20011117-M-Masters_Cup-SF-Juan_Carlos_Ferrero-Lleyton_Hewitt,1,F-XC,22,6,0,2,4,8,14
20011117-M-Masters_Cup-SF-Juan_Carlos_Ferrero-Lleyton_Hewitt,1,F-DTM,16,0,0,0,0,5,11
20011117-M-Masters_Cup-SF-Juan_Carlos_Ferrero-Lleyton_Hewitt,1,F-DTL,19,4,1,1,2,7,12
20011117-M-Masters_Cup-SF-Juan_Carlos_Ferrero-Lleyton_Hewitt,1,F-IO,13,3,0,1,2,4,9
20011117-M-Masters_Cup-SF-Juan_Carlos_Ferrero-Lleyton_Hewitt,1,F-II,5,2,1,0,1,1,4
20011117-M-Masters_Cup-SF-Juan_Carlos_Ferrero-Lleyton_Hewitt,1,B-XC,69,10,2,1,7,22,47
20011117-M-Masters_Cup-SF-Juan_Carlos_Ferrero-Lleyton_Hewitt,1,B-DTM,24,1,0,0,1,6,18
20011117-M-Masters_Cup-SF-Juan_Carlos_Ferrero-Lleyton_Hewitt,1,B-DTL,26,11,5,1,5,13,13
20011117-M-Masters_Cup-SF-Juan_Carlos_Ferrero-Lleyton_Hewitt,1,B-IO,4,2,2,0,0,2,2
20011117-M-Masters_Cup-SF-Juan_Carlos_Ferrero-Lleyton_Hewitt,1,S-XC,1,0,0,0,0,1,0
20011117-M-Masters_Cup-SF-Juan_Carlos_Ferrero-Lleyton_Hewitt,1,S-DTM,3,0,0,0,0,0,3
20011117-M-Masters_Cup-SF-Juan_Carlos_Ferrero-Lleyton_Hewitt,2,F-XC,48,12,4,2,6,32,16
20011117-M-Masters_Cup-SF-Juan_Carlos_Ferrero-Lleyton_Hewitt,2,F-DTM,9,1,1,0,0,6,3
20011117-M-Masters_Cup-SF-Juan_Carlos_Ferrero-Lleyton_Hewitt,2,F-DTL,6,0,0,0,0,4,2
20011117-M-Masters_Cup-SF-Juan_Carlos_Ferrero-Lleyton_Hewitt,2,F-IO,16,0,0,0,0,10,6
20011117-M-Masters_Cup-SF-Juan_Carlos_Ferrero-Lleyton_Hewitt,2,F-II,2,1,1,0,0,1,1
20011117-M-Masters_Cup-SF-Juan_Carlos_Ferrero-Lleyton_Hewitt,2,B-XC,73,5,0,3,2,52,21
20011117-M-Masters_Cup-SF-Juan_Carlos_Ferrero-Lleyton_Hewitt,2,B-DTM,23,3,0,1,2,15,8
20011117-M-Masters_Cup-SF-Juan_Carlos_Ferrero-Lleyton_Hewitt,2,B-DTL,5,2,0,1,1,3,2
20011117-M-Masters_Cup-SF-Juan_Carlos_Ferrero-Lleyton_Hewitt,2,B-IO,5,2,0,0,2,2,3
20011117-M-Masters_Cup-SF-Juan_Carlos_Ferrero-Lleyton_Hewitt,2,S-XC,11,3,0,1,2,7,4
20011117-M-Masters_Cup-SF-Juan_Carlos_Ferrero-Lleyton_Hewitt,2,S-DTM,1,0,0,0,0,0,1
20011117-M-Masters_Cup-SF-Juan_Carlos_Ferrero-Lleyton_Hewitt,2,S-IO,1,0,0,0,0,1,0
20041120-M-Masters_Cup-SF-Lleyton_Hewitt-Andy_Roddick,1,F-XC,17,3,1,1,1,14,3
20041120-M-Masters_Cup-SF-Lleyton_Hewitt-Andy_Roddick,1,F-DTM,13,0,0,0,0,11,2
20041120-M-Masters_Cup-SF-Lleyton_Hewitt-Andy_Roddick,1,F-DTL,15,2,2,0,0,12,3
20041120-M-Masters_Cup-SF-Lleyton_Hewitt-Andy_Roddick,1,F-IO,17,6,2,3,1,14,3
20041120-M-Masters_Cup-SF-Lleyton_Hewitt-Andy_Roddick,1,B-XC,30,3,1,1,1,23,7
20041120-M-Masters_Cup-SF-Lleyton_Hewitt-Andy_Roddick,1,B-DTM,24,1,0,1,0,18,6
20041120-M-Masters_Cup-SF-Lleyton_Hewitt-Andy_Roddick,1,B-DTL,7,3,2,1,0,4,3
20041120-M-Masters_Cup-SF-Lleyton_Hewitt-Andy_Roddick,1,B-IO,4,2,1,1,0,3,1
20041120-M-Masters_Cup-SF-Lleyton_Hewitt-Andy_Roddick,1,S-XC,4,0,0,0,0,4,0
20041120-M-Masters_Cup-SF-Lleyton_Hewitt-Andy_Roddick,1,S-DTM,2,1,0,0,1,0,2
20041120-M-Masters_Cup-SF-Lleyton_Hewitt-Andy_Roddick,1,S-DTL,1,0,0,0,0,1,0
20041120-M-Masters_Cup-SF-Lleyton_Hewitt-Andy_Roddick,2,F-XC,32,6,0,2,4,7,25
20041120-M-Masters_Cup-SF-Lleyton_Hewitt-Andy_Roddick,2,F-DTM,11,1,0,0,1,4,7
20041120-M-Masters_Cup-SF-Lleyton_Hewitt-Andy_Roddick,2,F-DTL,4,2,1,0,1,2,2
20041120-M-Masters_Cup-SF-Lleyton_Hewitt-Andy_Roddick,2,F-IO,20,7,2,2,3,7,13
20041120-M-Masters_Cup-SF-Lleyton_Hewitt-Andy_Roddick,2,F-II,4,3,0,1,2,1,3
20041120-M-Masters_Cup-SF-Lleyton_Hewitt-Andy_Roddick,2,B-XC,31,7,1,1,5,8,23
20041120-M-Masters_Cup-SF-Lleyton_Hewitt-Andy_Roddick,2,B-DTM,15,0,0,0,0,4,11
20041120-M-Masters_Cup-SF-Lleyton_Hewitt-Andy_Roddick,2,B-DTL,3,2,0,0,2,0,3
20041120-M-Masters_Cup-SF-Lleyton_Hewitt-Andy_Roddick,2,B-IO,2,0,0,0,0,0,2
20041120-M-Masters_Cup-SF-Lleyton_Hewitt-Andy_Roddick,2,B-II,1,0,0,0,0,0,1
20041120-M-Masters_Cup-SF-Lleyton_Hewitt-Andy_Roddick,2,S-XC,8,1,0,0,1,0,8
20041120-M-Masters_Cup-SF-Lleyton_Hewitt-Andy_Roddick,2,S-DTM,2,0,0,0,0,2,0
20041120-M-Masters_Cup-SF-Lleyton_Hewitt-Andy_Roddick,2,S-DTL,1,0,0,0,0,0,1
20041120-M-Masters_Cup-SF-Lleyton_Hewitt-Andy_Roddick,2,S-IO,1,0,0,0,0,1,0
20180805-M-Washington-F-Alex_De_Minaur-Alexander_Zverev,1,F-XC,16,6,2,1,3,6,10
20180805-M-Washington-F-Alex_De_Minaur-Alexander_Zverev,1,F-DTM,13,3,0,1,2,3,10
20180805-M-Washington-F-Alex_De_Minaur-Alexander_Zverev,1,F-DTL,6,1,0,0,1,5,1
20180805-M-Washington-F-Alex_De_Minaur-Alexander_Zverev,1,F-IO,19,8,2,0,6,10,9
20180805-M-Washington-F-Alex_De_Minaur-Alexander_Zverev,1,F-II,3,2,2,0,0,3,0
20180805-M-Washington-F-Alex_De_Minaur-Alexander_Zverev,1,B-XC,31,4,1,1,2,15,16
20180805-M-Washington-F-Alex_De_Minaur-Alexander_Zverev,1,B-DTM,19,3,0,0,3,5,14
20180805-M-Washington-F-Alex_De_Minaur-Alexander_Zverev,1,B-DTL,5,1,0,0,1,2,3
20180805-M-Washington-F-Alex_De_Minaur-Alexander_Zverev,1,B-IO,1,0,0,0,0,1,0
20180805-M-Washington-F-Alex_De_Minaur-Alexander_Zverev,1,S-XC,1,0,0,0,0,0,1
20180805-M-Washington-F-Alex_De_Minaur-Alexander_Zverev,1,S-DTM,1,0,0,0,0,1,0
20180805-M-Washington-F-Alex_De_Minaur-Alexander_Zverev,2,F-XC,15,5,1,2,2,8,7
20180805-M-Washington-F-Alex_De_Minaur-Alexander_Zverev,2,F-DTM,10,0,0,0,0,8,2
20180805-M-Washington-F-Alex_De_Minaur-Alexander_Zverev,2,F-DTL,6,2,2,0,0,5,1
20180805-M-Washington-F-Alex_De_Minaur-Alexander_Zverev,2,F-IO,12,6,0,4,2,9,3
20180805-M-Washington-F-Alex_De_Minaur-Alexander_Zverev,2,F-II,1,0,0,0,0,1,0
20180805-M-Washington-F-Alex_De_Minaur-Alexander_Zverev,2,B-XC,33,8,1,3,4,18,15
20180805-M-Washington-F-Alex_De_Minaur-Alexander_Zverev,2,B-DTM,5,0,0,0,0,4,1
20180805-M-Washington-F-Alex_De_Minaur-Alexander_Zverev,2,B-DTL,12,7,3,1,3,6,6
20180805-M-Washington-F-Alex_De_Minaur-Alexander_Zverev,2,B-IO,4,1,1,0,0,3,1
20180805-M-Washington-F-Alex_De_Minaur-Alexander_Zverev,2,S-XC,4,0,0,0,0,2,2
20180805-M-Washington-F-Alex_De_Minaur-Alexander_Zverev,2,S-DTM,2,1,0,0,1,1,1
20180805-M-Washington-F-Alex_De_Minaur-Alexander_Zverev,2,S-DTL,4,1,0,0,1,0,4
20050128-M-Australian_Open-SF-Andy_Roddick-Lleyton_Hewitt,1,F-XC,65,18,6,4,8,26,39
20050128-M-Australian_Open-SF-Andy_Roddick-Lleyton_Hewitt,1,F-DTM,21,2,0,1,1,9,12
20050128-M-Australian_Open-SF-Andy_Roddick-Lleyton_Hewitt,1,F-DTL,28,13,3,3,7,11,17
20050128-M-Australian_Open-SF-Andy_Roddick-Lleyton_Hewitt,1,F-IO,48,16,6,4,6,21,27
20050128-M-Australian_Open-SF-Andy_Roddick-Lleyton_Hewitt,1,F-II,9,4,3,0,1,4,5
20050128-M-Australian_Open-SF-Andy_Roddick-Lleyton_Hewitt,1,B-XC,44,6,1,3,2,14,30
20050128-M-Australian_Open-SF-Andy_Roddick-Lleyton_Hewitt,1,B-DTM,16,0,0,0,0,4,12
20050128-M-Australian_Open-SF-Andy_Roddick-Lleyton_Hewitt,1,B-DTL,19,7,2,1,4,6,13
20050128-M-Australian_Open-SF-Andy_Roddick-Lleyton_Hewitt,1,B-IO,4,2,0,0,2,0,4
20050128-M-Australian_Open-SF-Andy_Roddick-Lleyton_Hewitt,1,S-XC,28,2,0,0,2,8,20
20050128-M-Australian_Open-SF-Andy_Roddick-Lleyton_Hewitt,1,S-DTM,8,2,0,0,2,3,5
20050128-M-Australian_Open-SF-Andy_Roddick-Lleyton_Hewitt,1,S-DTL,11,1,0,1,0,4,7
20050128-M-Australian_Open-SF-Andy_Roddick-Lleyton_Hewitt,1,S-IO,4,0,0,0,0,1,3
20050128-M-Australian_Open-SF-Andy_Roddick-Lleyton_Hewitt,2,F-XC,68,17,7,4,6,48,20
20050128-M-Australian_Open-SF-Andy_Roddick-Lleyton_Hewitt,2,F-DTM,17,1,0,1,0,8,9
20050128-M-Australian_Open-SF-Andy_Roddick-Lleyton_Hewitt,2,F-DTL,30,5,4,0,1,22,8
20050128-M-Australian_Open-SF-Andy_Roddick-Lleyton_Hewitt,2,F-IO,25,6,3,0,3,15,10
20050128-M-Australian_Open-SF-Andy_Roddick-Lleyton_Hewitt,2,F-II,3,3,2,0,1,2,1
20050128-M-Australian_Open-SF-Andy_Roddick-Lleyton_Hewitt,2,B-XC,86,6,3,1,2,59,27
20050128-M-Australian_Open-SF-Andy_Roddick-Lleyton_Hewitt,2,B-DTM,30,0,0,0,0,22,8
20050128-M-Australian_Open-SF-Andy_Roddick-Lleyton_Hewitt,2,B-DTL,10,3,3,0,0,7,3
20050128-M-Australian_Open-SF-Andy_Roddick-Lleyton_Hewitt,2,B-IO,10,5,2,1,2,6,4
20050128-M-Australian_Open-SF-Andy_Roddick-Lleyton_Hewitt,2,S-XC,9,0,0,0,0,7,2
20050128-M-Australian_Open-SF-Andy_Roddick-Lleyton_Hewitt,2,S-DTM,3,0,0,0,0,1,2
20050128-M-Australian_Open-SF-Andy_Roddick-Lleyton_Hewitt,2,S-DTL,5,0,0,0,0,3,2
20180819-M-Cincinnati_Masters-F-Roger_Federer-Novak_Djokovic,1,F-XC,30,7,0,0,7,9,21
20180819-M-Cincinnati_Masters-F-Roger_Federer-Novak_Djokovic,1,F-DTM,10,1,0,0,1,4,6
20180819-M-Cincinnati_Masters-F-Roger_Federer-Novak_Djokovic,1,F-DTL,12,5,1,1,3,6,6
20180819-M-Cincinnati_Masters-F-Roger_Federer-Novak_Djokovic,1,F-IO,15,5,1,1,3,10,5
20180819-M-Cincinnati_Masters-F-Roger_Federer-Novak_Djokovic,1,F-II,2,0,0,0,0,0,2
20180819-M-Cincinnati_Masters-F-Roger_Federer-Novak_Djokovic,1,B-XC,16,4,1,1,2,9,7
20180819-M-Cincinnati_Masters-F-Roger_Federer-Novak_Djokovic,1,B-DTM,13,1,0,0,1,3,10
20180819-M-Cincinnati_Masters-F-Roger_Federer-Novak_Djokovic,1,B-DTL,11,5,1,1,3,5,6
20180819-M-Cincinnati_Masters-F-Roger_Federer-Novak_Djokovic,1,S-XC,10,0,0,0,0,6,4
20180819-M-Cincinnati_Masters-F-Roger_Federer-Novak_Djokovic,1,S-DTM,2,0,0,0,0,0,2
20180819-M-Cincinnati_Masters-F-Roger_Federer-Novak_Djokovic,1,S-DTL,1,0,0,0,0,0,1
20180819-M-Cincinnati_Masters-F-Roger_Federer-Novak_Djokovic,2,F-XC,30,5,2,2,1,24,6
20180819-M-Cincinnati_Masters-F-Roger_Federer-Novak_Djokovic,2,F-DTM,8,1,0,1,0,6,2
20180819-M-Cincinnati_Masters-F-Roger_Federer-Novak_Djokovic,2,F-DTL,13,2,0,1,1,8,5
20180819-M-Cincinnati_Masters-F-Roger_Federer-Novak_Djokovic,2,F-IO,13,3,1,0,2,5,8
20180819-M-Cincinnati_Masters-F-Roger_Federer-Novak_Djokovic,2,F-II,2,0,0,0,0,0,2
20180819-M-Cincinnati_Masters-F-Roger_Federer-Novak_Djokovic,2,B-XC,29,8,0,1,7,11,18
20180819-M-Cincinnati_Masters-F-Roger_Federer-Novak_Djokovic,2,B-DTM,10,2,0,2,0,6,4
20180819-M-Cincinnati_Masters-F-Roger_Federer-Novak_Djokovic,2,B-DTL,10,4,1,0,3,3,7
20180819-M-Cincinnati_Masters-F-Roger_Federer-Novak_Djokovic,2,B-IO,3,1,1,0,0,2,1
20180819-M-Cincinnati_Masters-F-Roger_Federer-Novak_Djokovic,2,S-XC,2,0,0,0,0,2,0
20180819-M-Cincinnati_Masters-F-Roger_Federer-Novak_Djokovic,2,S-DTL,1,0,0,0,0,1,0
20180711-M-Wimbledon-QF-Kevin_Anderson-Roger_Federer,1,F-XC,77,25,8,5,12,41,36
20180711-M-Wimbledon-QF-Kevin_Anderson-Roger_Federer,1,F-DTM,21,0,0,0,0,12,9
20180711-M-Wimbledon-QF-Kevin_Anderson-Roger_Federer,1,F-DTL,15,6,0,1,5,4,11
20180711-M-Wimbledon-QF-Kevin_Anderson-Roger_Federer,1,F-IO,47,19,9,6,4,28,19
20180711-M-Wimbledon-QF-Kevin_Anderson-Roger_Federer,1,F-II,8,6,3,2,1,6,2
20180711-M-Wimbledon-QF-Kevin_Anderson-Roger_Federer,1,B-XC,68,18,4,4,10,29,39
20180711-M-Wimbledon-QF-Kevin_Anderson-Roger_Federer,1,B-DTM,21,3,0,1,2,7,14
20180711-M-Wimbledon-QF-Kevin_Anderson-Roger_Federer,1,B-DTL,10,4,0,0,4,3,7
20180711-M-Wimbledon-QF-Kevin_Anderson-Roger_Federer,1,B-IO,12,2,0,0,2,6,6
20180711-M-Wimbledon-QF-Kevin_Anderson-Roger_Federer,1,S-XC,19,2,0,0,2,5,14
20180711-M-Wimbledon-QF-Kevin_Anderson-Roger_Federer,1,S-DTM,11,0,0,0,0,4,7
20180711-M-Wimbledon-QF-Kevin_Anderson-Roger_Federer,1,S-DTL,5,3,1,0,2,2,3
20180711-M-Wimbledon-QF-Kevin_Anderson-Roger_Federer,1,S-IO,1,0,0,0,0,0,1
20180711-M-Wimbledon-QF-Kevin_Anderson-Roger_Federer,2,F-XC,65,29,4,4,21,28,37
20180711-M-Wimbledon-QF-Kevin_Anderson-Roger_Federer,2,F-DTM,34,4,0,0,4,13,21
20180711-M-Wimbledon-QF-Kevin_Anderson-Roger_Federer,2,F-DTL,32,11,5,4,2,20,12
20180711-M-Wimbledon-QF-Kevin_Anderson-Roger_Federer,2,F-IO,45,16,3,5,8,25,20
20180711-M-Wimbledon-QF-Kevin_Anderson-Roger_Federer,2,F-II,13,9,3,4,2,8,5
20180711-M-Wimbledon-QF-Kevin_Anderson-Roger_Federer,2,B-XC,29,7,1,1,5,19,10
20180711-M-Wimbledon-QF-Kevin_Anderson-Roger_Federer,2,B-DTM,25,2,0,0,2,12,13
20180711-M-Wimbledon-QF-Kevin_Anderson-Roger_Federer,2,B-DTL,18,9,4,1,4,12,6
20180711-M-Wimbledon-QF-Kevin_Anderson-Roger_Federer,2,B-IO,2,1,0,1,0,2,0
20180711-M-Wimbledon-QF-Kevin_Anderson-Roger_Federer,2,S-XC,17,1,0,0,1,10,7
20180711-M-Wimbledon-QF-Kevin_Anderson-Roger_Federer,2,S-DTM,7,0,0,0,0,2,5
20180711-M-Wimbledon-QF-Kevin_Anderson-Roger_Federer,2,S-DTL,8,2,1,0,1,5,3
20180713-M-Wimbledon-SF-Kevin_Anderson-John_Isner,1,F-XC,86,30,16,7,7,63,23
20180713-M-Wimbledon-SF-Kevin_Anderson-John_Isner,1,F-DTM,19,2,1,1,0,10,9
20180713-M-Wimbledon-SF-Kevin_Anderson-John_Isner,1,F-DTL,13,6,2,2,2,9,4
20180713-M-Wimbledon-SF-Kevin_Anderson-John_Isner,1,F-IO,61,21,10,9,2,47,14
20180713-M-Wimbledon-SF-Kevin_Anderson-John_Isner,1,F-II,11,7,5,1,1,6,5
20180713-M-Wimbledon-SF-Kevin_Anderson-John_Isner,1,B-XC,59,15,3,7,5,35,24
20180713-M-Wimbledon-SF-Kevin_Anderson-John_Isner,1,B-DTM,26,3,0,0,3,16,10
20180713-M-Wimbledon-SF-Kevin_Anderson-John_Isner,1,B-DTL,13,7,5,0,2,9,4
20180713-M-Wimbledon-SF-Kevin_Anderson-John_Isner,1,B-IO,6,1,1,0,0,4,2
20180713-M-Wimbledon-SF-Kevin_Anderson-John_Isner,1,S-XC,26,3,0,1,2,15,11
20180713-M-Wimbledon-SF-Kevin_Anderson-John_Isner,1,S-DTM,7,0,0,0,0,2,5
20180713-M-Wimbledon-SF-Kevin_Anderson-John_Isner,1,S-DTL,2,0,0,0,0,1,1
20180713-M-Wimbledon-SF-Kevin_Anderson-John_Isner,2,F-XC,66,25,12,6,7,34,32
20180713-M-Wimbledon-SF-Kevin_Anderson-John_Isner,2,F-DTM,29,7,1,0,6,8,21
20180713-M-Wimbledon-SF-Kevin_Anderson-John_Isner,2,F-DTL,38,23,6,3,14,14,24
20180713-M-Wimbledon-SF-Kevin_Anderson-John_Isner,2,F-IO,59,24,5,10,9,32,27
20180713-M-Wimbledon-SF-Kevin_Anderson-John_Isner,2,F-II,8,3,2,0,1,4,4
20180713-M-Wimbledon-SF-Kevin_Anderson-John_Isner,2,B-XC,27,5,1,1,3,10,17
20180713-M-Wimbledon-SF-Kevin_Anderson-John_Isner,2,B-DTM,29,1,0,0,1,10,19
20180713-M-Wimbledon-SF-Kevin_Anderson-John_Isner,2,B-DTL,18,7,4,0,3,9,9
20180713-M-Wimbledon-SF-Kevin_Anderson-John_Isner,2,B-IO,3,2,0,0,2,1,2
20180713-M-Wimbledon-SF-Kevin_Anderson-John_Isner,2,S-XC,19,3,0,0,3,6,13
20180713-M-Wimbledon-SF-Kevin_Anderson-John_Isner,2,S-DTM,13,0,0,0,0,2,11
20180713-M-Wimbledon-SF-Kevin_Anderson-John_Isner,2,S-DTL,3,1,0,0,1,2,1
20180713-M-Wimbledon-SF-Rafael_Nadal-Novak_Djokovic,1,F-XC,159,17,4,4,9,77,82
20180713-M-Wimbledon-SF-Rafael_Nadal-Novak_Djokovic,1,F-DTM,22,2,1,0,1,9,13
20180713-M-Wimbledon-SF-Rafael_Nadal-Novak_Djokovic,1,F-DTL,49,24,11,6,7,28,21
20180713-M-Wimbledon-SF-Rafael_Nadal-Novak_Djokovic,1,F-IO,70,16,9,1,6,40,30
20180713-M-Wimbledon-SF-Rafael_Nadal-Novak_Djokovic,1,F-II,16,4,1,1,2,8,8
20180713-M-Wimbledon-SF-Rafael_Nadal-Novak_Djokovic,1,B-XC,98,16,2,4,10,44,54
20180713-M-Wimbledon-SF-Rafael_Nadal-Novak_Djokovic,1,B-DTM,39,3,0,0,3,15,24
20180713-M-Wimbledon-SF-Rafael_Nadal-Novak_Djokovic,1,B-DTL,48,13,3,3,7,26,22
20180713-M-Wimbledon-SF-Rafael_Nadal-Novak_Djokovic,1,B-IO,4,2,1,1,0,4,0
20180713-M-Wimbledon-SF-Rafael_Nadal-Novak_Djokovic,1,S-XC,18,0,0,0,0,7,11
20180713-M-Wimbledon-SF-Rafael_Nadal-Novak_Djokovic,1,S-DTM,21,0,0,0,0,10,11
20180713-M-Wimbledon-SF-Rafael_Nadal-Novak_Djokovic,1,S-DTL,34,0,0,0,0,15,19
20180713-M-Wimbledon-SF-Rafael_Nadal-Novak_Djokovic,1,S-IO,4,0,0,0,0,3,1
20180713-M-Wimbledon-SF-Rafael_Nadal-Novak_Djokovic,2,F-XC,165,23,5,12,6,95,70
20180713-M-Wimbledon-SF-Rafael_Nadal-Novak_Djokovic,2,F-DTM,23,2,0,1,1,9,14
20180713-M-Wimbledon-SF-Rafael_Nadal-Novak_Djokovic,2,F-DTL,43,18,7,4,7,26,17
20180713-M-Wimbledon-SF-Rafael_Nadal-Novak_Djokovic,2,F-IO,51,17,4,6,7,27,24
20180713-M-Wimbledon-SF-Rafael_Nadal-Novak_Djokovic,2,F-II,11,3,2,0,1,6,5
20180713-M-Wimbledon-SF-Rafael_Nadal-Novak_Djokovic,2,B-XC,119,15,6,6,3,66,53
20180713-M-Wimbledon-SF-Rafael_Nadal-Novak_Djokovic,2,B-DTM,42,1,0,0,1,16,26
20180713-M-Wimbledon-SF-Rafael_Nadal-Novak_Djokovic,2,B-DTL,86,17,5,3,9,49,37
20180713-M-Wimbledon-SF-Rafael_Nadal-Novak_Djokovic,2,B-IO,18,3,1,1,1,9,9
20180713-M-Wimbledon-SF-Rafael_Nadal-Novak_Djokovic,2,S-XC,3,1,0,0,1,0,3
20180713-M-Wimbledon-SF-Rafael_Nadal-Novak_Djokovic,2,S-DTM,5,0,0,0,0,1,4
20180713-M-Wimbledon-SF-Rafael_Nadal-Novak_Djokovic,2,S-DTL,8,1,0,0,1,3,5
20180713-M-Wimbledon-SF-Rafael_Nadal-Novak_Djokovic,2,S-IO,1,0,0,0,0,1,0
20180711-M-Wimbledon-QF-Novak_Djokovic-Kei_Nishikori,1,F-XC,58,8,3,2,3,37,21
20180711-M-Wimbledon-QF-Novak_Djokovic-Kei_Nishikori,1,F-DTM,15,4,0,0,4,6,9
20180711-M-Wimbledon-QF-Novak_Djokovic-Kei_Nishikori,1,F-DTL,32,7,3,2,2,23,9
20180711-M-Wimbledon-QF-Novak_Djokovic-Kei_Nishikori,1,F-IO,23,7,4,1,2,16,7
20180711-M-Wimbledon-QF-Novak_Djokovic-Kei_Nishikori,1,F-II,4,2,1,0,1,3,1
20180711-M-Wimbledon-QF-Novak_Djokovic-Kei_Nishikori,1,B-XC,62,11,3,5,3,45,17
20180711-M-Wimbledon-QF-Novak_Djokovic-Kei_Nishikori,1,B-DTM,31,4,0,2,2,19,12
20180711-M-Wimbledon-QF-Novak_Djokovic-Kei_Nishikori,1,B-DTL,26,14,4,3,7,15,11
20180711-M-Wimbledon-QF-Novak_Djokovic-Kei_Nishikori,1,B-IO,3,1,0,0,1,1,2
20180711-M-Wimbledon-QF-Novak_Djokovic-Kei_Nishikori,1,S-XC,25,1,0,0,1,15,10
20180711-M-Wimbledon-QF-Novak_Djokovic-Kei_Nishikori,1,S-DTM,6,0,0,0,0,4,2
20180711-M-Wimbledon-QF-Novak_Djokovic-Kei_Nishikori,1,S-DTL,3,1,1,0,0,3,0
20180711-M-Wimbledon-QF-Novak_Djokovic-Kei_Nishikori,2,F-XC,62,16,4,1,11,25,37
20180711-M-Wimbledon-QF-Novak_Djokovic-Kei_Nishikori,2,F-DTM,17,1,0,0,1,8,9
20180711-M-Wimbledon-QF-Novak_Djokovic-Kei_Nishikori,2,F-DTL,20,8,4,2,2,11,9
20180711-M-Wimbledon-QF-Novak_Djokovic-Kei_Nishikori,2,F-IO,25,6,0,2,4,7,18
20180711-M-Wimbledon-QF-Novak_Djokovic-Kei_Nishikori,2,F-II,1,0,0,0,0,0,1
20180711-M-Wimbledon-QF-Novak_Djokovic-Kei_Nishikori,2,B-XC,89,17,4,2,11,26,63
20180711-M-Wimbledon-QF-Novak_Djokovic-Kei_Nishikori,2,B-DTM,20,2,0,1,1,3,17
20180711-M-Wimbledon-QF-Novak_Djokovic-Kei_Nishikori,2,B-DTL,20,8,2,2,4,10,10
20180711-M-Wimbledon-QF-Novak_Djokovic-Kei_Nishikori,2,B-IO,11,5,2,0,3,7,4
20180711-M-Wimbledon-QF-Novak_Djokovic-Kei_Nishikori,2,S-XC,21,3,0,0,3,8,13
20180711-M-Wimbledon-QF-Novak_Djokovic-Kei_Nishikori,2,S-DTM,2,0,0,0,0,1,1
20180711-M-Wimbledon-QF-Novak_Djokovic-Kei_Nishikori,2,S-DTL,4,0,0,0,0,2,2
20180711-M-Wimbledon-QF-Novak_Djokovic-Kei_Nishikori,2,S-IO,1,0,0,0,0,1,0
20180709-M-Wimbledon-R16-Adrian_Mannarino-Roger_Federer,1,F-XC,83,7,1,1,5,43,40
20180709-M-Wimbledon-R16-Adrian_Mannarino-Roger_Federer,1,F-DTM,19,4,1,0,3,6,13
20180709-M-Wimbledon-R16-Adrian_Mannarino-Roger_Federer,1,F-DTL,9,2,1,1,0,4,5
20180709-M-Wimbledon-R16-Adrian_Mannarino-Roger_Federer,1,F-IO,14,4,0,0,4,2,12
20180709-M-Wimbledon-R16-Adrian_Mannarino-Roger_Federer,1,F-II,2,0,0,0,0,2,0
20180709-M-Wimbledon-R16-Adrian_Mannarino-Roger_Federer,1,B-XC,47,10,2,3,5,29,18
20180709-M-Wimbledon-R16-Adrian_Mannarino-Roger_Federer,1,B-DTM,19,4,0,1,3,11,8
20180709-M-Wimbledon-R16-Adrian_Mannarino-Roger_Federer,1,B-DTL,16,6,2,2,2,7,9
20180709-M-Wimbledon-R16-Adrian_Mannarino-Roger_Federer,1,B-IO,11,1,0,0,1,5,6
20180709-M-Wimbledon-R16-Adrian_Mannarino-Roger_Federer,1,S-XC,1,1,0,0,1,0,1
20180709-M-Wimbledon-R16-Adrian_Mannarino-Roger_Federer,1,S-DTM,4,0,0,0,0,1,3
20180709-M-Wimbledon-R16-Adrian_Mannarino-Roger_Federer,1,S-DTL,6,1,0,0,1,1,5
20180709-M-Wimbledon-R16-Adrian_Mannarino-Roger_Federer,1,S-IO,2,0,0,0,0,1,1
20180709-M-Wimbledon-R16-Adrian_Mannarino-Roger_Federer,2,F-XC,57,13,3,5,5,29,28
20180709-M-Wimbledon-R16-Adrian_Mannarino-Roger_Federer,2,F-DTM,14,0,0,0,0,7,7
20180709-M-Wimbledon-R16-Adrian_Mannarino-Roger_Federer,2,F-DTL,22,9,6,0,3,10,12
20180709-M-Wimbledon-R16-Adrian_Mannarino-Roger_Federer,2,F-IO,22,7,3,2,2,13,9
20180709-M-Wimbledon-R16-Adrian_Mannarino-Roger_Federer,2,F-II,8,3,0,0,3,2,6
20180709-M-Wimbledon-R16-Adrian_Mannarino-Roger_Federer,2,B-XC,18,7,3,2,2,11,7
20180709-M-Wimbledon-R16-Adrian_Mannarino-Roger_Federer,2,B-DTM,20,3,0,1,2,12,8
20180709-M-Wimbledon-R16-Adrian_Mannarino-Roger_Federer,2,B-DTL,15,4,1,1,2,7,8
20180709-M-Wimbledon-R16-Adrian_Mannarino-Roger_Federer,2,B-IO,1,1,0,0,1,0,1
20180709-M-Wimbledon-R16-Adrian_Mannarino-Roger_Federer,2,S-XC,30,2,0,0,2,12,18
20180709-M-Wimbledon-R16-Adrian_Mannarino-Roger_Federer,2,S-DTM,8,1,0,0,1,4,4
20180709-M-Wimbledon-R16-Adrian_Mannarino-Roger_Federer,2,S-DTL,10,1,1,0,0,6,4
20180711-M-Wimbledon-QF-Rafael_Nadal-Juan_Martin_Del_Potro,1,F-XC,135,14,1,4,9,81,54
20180711-M-Wimbledon-QF-Rafael_Nadal-Juan_Martin_Del_Potro,1,F-DTM,19,2,0,0,2,9,10
20180711-M-Wimbledon-QF-Rafael_Nadal-Juan_Martin_Del_Potro,1,F-DTL,36,21,12,5,4,26,10
20180711-M-Wimbledon-QF-Rafael_Nadal-Juan_Martin_Del_Potro,1,F-IO,64,18,8,3,7,37,27
20180711-M-Wimbledon-QF-Rafael_Nadal-Juan_Martin_Del_Potro,1,F-II,27,6,1,3,2,18,9
20180711-M-Wimbledon-QF-Rafael_Nadal-Juan_Martin_Del_Potro,1,B-XC,59,13,6,3,4,39,20
20180711-M-Wimbledon-QF-Rafael_Nadal-Juan_Martin_Del_Potro,1,B-DTM,18,0,0,0,0,8,10
20180711-M-Wimbledon-QF-Rafael_Nadal-Juan_Martin_Del_Potro,1,B-DTL,41,8,3,1,4,26,15
20180711-M-Wimbledon-QF-Rafael_Nadal-Juan_Martin_Del_Potro,1,B-IO,5,0,0,0,0,3,2
20180711-M-Wimbledon-QF-Rafael_Nadal-Juan_Martin_Del_Potro,1,S-XC,11,1,0,0,1,2,9
20180711-M-Wimbledon-QF-Rafael_Nadal-Juan_Martin_Del_Potro,1,S-DTM,10,0,0,0,0,4,6
20180711-M-Wimbledon-QF-Rafael_Nadal-Juan_Martin_Del_Potro,1,S-DTL,20,1,0,1,0,13,7
20180711-M-Wimbledon-QF-Rafael_Nadal-Juan_Martin_Del_Potro,1,S-IO,2,0,0,0,0,0,2
20180711-M-Wimbledon-QF-Rafael_Nadal-Juan_Martin_Del_Potro,2,F-XC,94,17,7,0,10,40,54
20180711-M-Wimbledon-QF-Rafael_Nadal-Juan_Martin_Del_Potro,2,F-DTM,23,3,1,1,1,10,13
20180711-M-Wimbledon-QF-Rafael_Nadal-Juan_Martin_Del_Potro,2,F-DTL,34,19,12,1,6,17,17
20180711-M-Wimbledon-QF-Rafael_Nadal-Juan_Martin_Del_Potro,2,F-IO,51,19,5,8,6,28,23
20180711-M-Wimbledon-QF-Rafael_Nadal-Juan_Martin_Del_Potro,2,F-II,26,10,3,4,3,16,10
20180711-M-Wimbledon-QF-Rafael_Nadal-Juan_Martin_Del_Potro,2,B-XC,41,6,1,0,5,17,24
20180711-M-Wimbledon-QF-Rafael_Nadal-Juan_Martin_Del_Potro,2,B-DTM,43,5,0,1,4,16,27
20180711-M-Wimbledon-QF-Rafael_Nadal-Juan_Martin_Del_Potro,2,B-DTL,36,5,2,0,3,13,23
20180711-M-Wimbledon-QF-Rafael_Nadal-Juan_Martin_Del_Potro,2,B-IO,12,1,0,0,1,6,6
20180711-M-Wimbledon-QF-Rafael_Nadal-Juan_Martin_Del_Potro,2,S-XC,35,0,0,0,0,11,24
20180711-M-Wimbledon-QF-Rafael_Nadal-Juan_Martin_Del_Potro,2,S-DTM,14,0,0,0,0,4,10
20180711-M-Wimbledon-QF-Rafael_Nadal-Juan_Martin_Del_Potro,2,S-DTL,21,1,0,0,1,8,13
20180711-M-Wimbledon-QF-Rafael_Nadal-Juan_Martin_Del_Potro,2,S-IO,4,0,0,0,0,2,2
20180711-M-Wimbledon-QF-Rafael_Nadal-Juan_Martin_Del_Potro,2,S-II,1,0,0,0,0,0,1
20180928-M-Shenzhen-QF-Alex_De_Minaur-Damir_Dzumhur,1,F-XC,37,10,6,1,3,23,14
20180928-M-Shenzhen-QF-Alex_De_Minaur-Damir_Dzumhur,1,F-DTM,33,3,0,1,2,13,20
20180928-M-Shenzhen-QF-Alex_De_Minaur-Damir_Dzumhur,1,F-DTL,12,6,1,2,3,6,6
20180928-M-Shenzhen-QF-Alex_De_Minaur-Damir_Dzumhur,1,F-IO,41,6,0,2,4,17,24
20180928-M-Shenzhen-QF-Alex_De_Minaur-Damir_Dzumhur,1,F-II,5,2,0,2,0,2,3
20180928-M-Shenzhen-QF-Alex_De_Minaur-Damir_Dzumhur,1,B-XC,70,4,0,1,3,32,38
20180928-M-Shenzhen-QF-Alex_De_Minaur-Damir_Dzumhur,1,B-DTM,79,4,0,0,4,40,39
20180928-M-Shenzhen-QF-Alex_De_Minaur-Damir_Dzumhur,1,B-DTL,11,2,0,1,1,5,6
20180928-M-Shenzhen-QF-Alex_De_Minaur-Damir_Dzumhur,1,B-IO,3,0,0,0,0,1,2
20180928-M-Shenzhen-QF-Alex_De_Minaur-Damir_Dzumhur,1,S-XC,32,1,0,0,1,7,25
20180928-M-Shenzhen-QF-Alex_De_Minaur-Damir_Dzumhur,1,S-DTM,20,1,0,0,1,8,12
20180928-M-Shenzhen-QF-Alex_De_Minaur-Damir_Dzumhur,1,S-DTL,4,0,0,0,0,2,2
20180928-M-Shenzhen-QF-Alex_De_Minaur-Damir_Dzumhur,2,F-XC,29,5,1,1,3,17,12
20180928-M-Shenzhen-QF-Alex_De_Minaur-Damir_Dzumhur,2,F-DTM,22,1,0,0,1,10,12
20180928-M-Shenzhen-QF-Alex_De_Minaur-Damir_Dzumhur,2,F-DTL,18,5,1,1,3,7,11
20180928-M-Shenzhen-QF-Alex_De_Minaur-Damir_Dzumhur,2,F-IO,27,6,1,1,4,10,17
20180928-M-Shenzhen-QF-Alex_De_Minaur-Damir_Dzumhur,2,F-II,2,1,0,0,1,0,2
20180928-M-Shenzhen-QF-Alex_De_Minaur-Damir_Dzumhur,2,B-XC,99,8,1,0,7,55,44
20180928-M-Shenzhen-QF-Alex_De_Minaur-Damir_Dzumhur,2,B-DTM,46,5,0,0,5,24,22
20180928-M-Shenzhen-QF-Alex_De_Minaur-Damir_Dzumhur,2,B-DTL,11,6,4,1,1,8,3
20180928-M-Shenzhen-QF-Alex_De_Minaur-Damir_Dzumhur,2,B-IO,14,5,2,0,3,5,9
20180928-M-Shenzhen-QF-Alex_De_Minaur-Damir_Dzumhur,2,S-XC,43,2,0,1,1,29,14
20180928-M-Shenzhen-QF-Alex_De_Minaur-Damir_Dzumhur,2,S-DTM,16,0,0,0,0,10,6
20180928-M-Shenzhen-QF-Alex_De_Minaur-Damir_Dzumhur,2,S-DTL,7,1,1,0,0,5,2
20180928-M-Shenzhen-QF-Alex_De_Minaur-Damir_Dzumhur,2,S-IO,4,0,0,0,0,3,1
20180811-M-Canada_Masters-SF-Rafael_Nadal-Karen_Khachanov,1,F-XC,50,5,2,1,2,28,22
20180811-M-Canada_Masters-SF-Rafael_Nadal-Karen_Khachanov,1,F-DTM,10,2,0,1,1,6,4
20180811-M-Canada_Masters-SF-Rafael_Nadal-Karen_Khachanov,1,F-DTL,16,8,5,0,3,9,7
20180811-M-Canada_Masters-SF-Rafael_Nadal-Karen_Khachanov,1,F-IO,18,10,4,4,2,16,2
20180811-M-Canada_Masters-SF-Rafael_Nadal-Karen_Khachanov,1,F-II,4,2,0,1,1,3,1
20180811-M-Canada_Masters-SF-Rafael_Nadal-Karen_Khachanov,1,B-XC,15,2,1,0,1,4,11
20180811-M-Canada_Masters-SF-Rafael_Nadal-Karen_Khachanov,1,B-DTM,10,0,0,0,0,5,5
20180811-M-Canada_Masters-SF-Rafael_Nadal-Karen_Khachanov,1,B-DTL,3,0,0,0,0,1,2
20180811-M-Canada_Masters-SF-Rafael_Nadal-Karen_Khachanov,1,B-IO,1,1,0,0,1,0,1
20180811-M-Canada_Masters-SF-Rafael_Nadal-Karen_Khachanov,1,S-XC,4,1,1,0,0,2,2
20180811-M-Canada_Masters-SF-Rafael_Nadal-Karen_Khachanov,1,S-DTM,5,0,0,0,0,3,2
20180811-M-Canada_Masters-SF-Rafael_Nadal-Karen_Khachanov,1,S-DTL,5,0,0,0,0,2,3
20180811-M-Canada_Masters-SF-Rafael_Nadal-Karen_Khachanov,1,S-IO,2,0,0,0,0,1,1
20180811-M-Canada_Masters-SF-Rafael_Nadal-Karen_Khachanov,2,F-XC,36,8,2,2,4,22,14
20180811-M-Canada_Masters-SF-Rafael_Nadal-Karen_Khachanov,2,F-DTM,17,2,0,1,1,9,8
20180811-M-Canada_Masters-SF-Rafael_Nadal-Karen_Khachanov,2,F-DTL,7,6,2,1,3,3,4
20180811-M-Canada_Masters-SF-Rafael_Nadal-Karen_Khachanov,2,F-IO,27,10,3,1,6,13,14
20180811-M-Canada_Masters-SF-Rafael_Nadal-Karen_Khachanov,2,F-II,5,1,0,1,0,2,3
20180811-M-Canada_Masters-SF-Rafael_Nadal-Karen_Khachanov,2,B-XC,32,10,1,4,5,14,18
20180811-M-Canada_Masters-SF-Rafael_Nadal-Karen_Khachanov,2,B-DTM,8,0,0,0,0,2,6
20180811-M-Canada_Masters-SF-Rafael_Nadal-Karen_Khachanov,2,B-DTL,12,7,2,2,3,5,7
20180811-M-Canada_Masters-SF-Rafael_Nadal-Karen_Khachanov,2,B-IO,4,3,2,0,1,3,1
20180811-M-Canada_Masters-SF-Rafael_Nadal-Karen_Khachanov,2,S-XC,2,1,0,1,0,1,1
20180811-M-Canada_Masters-SF-Rafael_Nadal-Karen_Khachanov,2,S-DTM,2,0,0,0,0,1,1
19860114-M-Masters-F-Boris_Becker-Ivan_Lendl,1,F-XC,23,4,1,2,1,10,13
19860114-M-Masters-F-Boris_Becker-Ivan_Lendl,1,F-DTM,15,3,0,0,3,3,12
19860114-M-Masters-F-Boris_Becker-Ivan_Lendl,1,F-DTL,10,7,2,0,5,4,6
19860114-M-Masters-F-Boris_Becker-Ivan_Lendl,1,F-IO,23,10,4,1,5,12,11
19860114-M-Masters-F-Boris_Becker-Ivan_Lendl,1,F-II,2,1,1,0,0,2,0
19860114-M-Masters-F-Boris_Becker-Ivan_Lendl,1,B-XC,27,5,0,1,4,7,20
19860114-M-Masters-F-Boris_Becker-Ivan_Lendl,1,B-DTM,17,2,0,0,2,4,13
19860114-M-Masters-F-Boris_Becker-Ivan_Lendl,1,B-DTL,12,6,1,0,5,4,8
19860114-M-Masters-F-Boris_Becker-Ivan_Lendl,1,B-IO,1,1,0,0,1,0,1
19860114-M-Masters-F-Boris_Becker-Ivan_Lendl,1,S-XC,10,2,0,1,1,4,6
19860114-M-Masters-F-Boris_Becker-Ivan_Lendl,1,S-DTM,6,0,0,0,0,2,4
19860114-M-Masters-F-Boris_Becker-Ivan_Lendl,1,S-DTL,1,0,0,0,0,0,1
19860114-M-Masters-F-Boris_Becker-Ivan_Lendl,1,S-II,1,0,0,0,0,1,0
19860114-M-Masters-F-Boris_Becker-Ivan_Lendl,2,F-XC,23,6,3,1,2,16,7
19860114-M-Masters-F-Boris_Becker-Ivan_Lendl,2,F-DTM,16,1,0,1,0,8,8
19860114-M-Masters-F-Boris_Becker-Ivan_Lendl,2,F-DTL,13,5,1,1,3,8,5
19860114-M-Masters-F-Boris_Becker-Ivan_Lendl,2,F-IO,26,5,0,5,0,21,5
19860114-M-Masters-F-Boris_Becker-Ivan_Lendl,2,F-II,5,2,1,0,1,3,2
19860114-M-Masters-F-Boris_Becker-Ivan_Lendl,2,B-XC,35,10,4,2,4,22,13
19860114-M-Masters-F-Boris_Becker-Ivan_Lendl,2,B-DTM,12,2,0,1,1,8,4
19860114-M-Masters-F-Boris_Becker-Ivan_Lendl,2,B-DTL,15,6,3,1,2,8,7
19860114-M-Masters-F-Boris_Becker-Ivan_Lendl,2,B-IO,2,0,0,0,0,2,0
19860114-M-Masters-F-Boris_Becker-Ivan_Lendl,2,S-XC,18,1,0,1,0,13,5
19860114-M-Masters-F-Boris_Becker-Ivan_Lendl,2,S-DTM,10,1,0,0,1,5,5
19860114-M-Masters-F-Boris_Becker-Ivan_Lendl,2,S-DTL,3,2,0,2,0,3,0
19860114-M-Masters-F-Boris_Becker-Ivan_Lendl,2,S-IO,1,0,0,0,0,1,0
20080105-M-Doha-F-Stanislas_Wawrinka-Andy_Murray,1,F-XC,91,21,4,5,12,40,51
20080105-M-Doha-F-Stanislas_Wawrinka-Andy_Murray,1,F-DTM,43,1,0,0,1,10,33
20080105-M-Doha-F-Stanislas_Wawrinka-Andy_Murray,1,F-DTL,17,9,2,3,4,11,6
20080105-M-Doha-F-Stanislas_Wawrinka-Andy_Murray,1,F-IO,26,9,3,3,3,14,12
20080105-M-Doha-F-Stanislas_Wawrinka-Andy_Murray,1,F-II,14,4,0,2,2,8,6
20080105-M-Doha-F-Stanislas_Wawrinka-Andy_Murray,1,B-XC,86,12,3,3,6,42,44
20080105-M-Doha-F-Stanislas_Wawrinka-Andy_Murray,1,B-DTM,45,0,0,0,0,23,22
20080105-M-Doha-F-Stanislas_Wawrinka-Andy_Murray,1,B-DTL,27,4,0,0,4,12,15
20080105-M-Doha-F-Stanislas_Wawrinka-Andy_Murray,1,B-IO,12,1,1,0,0,6,6
20080105-M-Doha-F-Stanislas_Wawrinka-Andy_Murray,1,S-XC,15,0,0,0,0,3,12
20080105-M-Doha-F-Stanislas_Wawrinka-Andy_Murray,1,S-DTM,17,1,0,0,1,5,12
20080105-M-Doha-F-Stanislas_Wawrinka-Andy_Murray,1,S-DTL,10,1,0,1,0,6,4
20080105-M-Doha-F-Stanislas_Wawrinka-Andy_Murray,1,S-IO,1,0,0,0,0,0,1
20080105-M-Doha-F-Stanislas_Wawrinka-Andy_Murray,2,F-XC,83,17,7,3,7,51,32
20080105-M-Doha-F-Stanislas_Wawrinka-Andy_Murray,2,F-DTM,63,3,0,0,3,30,33
20080105-M-Doha-F-Stanislas_Wawrinka-Andy_Murray,2,F-DTL,35,6,2,2,2,24,11
20080105-M-Doha-F-Stanislas_Wawrinka-Andy_Murray,2,F-IO,38,4,1,2,1,21,17
20080105-M-Doha-F-Stanislas_Wawrinka-Andy_Murray,2,F-II,3,1,0,0,1,1,2
20080105-M-Doha-F-Stanislas_Wawrinka-Andy_Murray,2,B-XC,65,4,2,1,1,37,28
20080105-M-Doha-F-Stanislas_Wawrinka-Andy_Murray,2,B-DTM,38,5,0,0,5,19,19
20080105-M-Doha-F-Stanislas_Wawrinka-Andy_Murray,2,B-DTL,9,5,0,2,3,5,4
20080105-M-Doha-F-Stanislas_Wawrinka-Andy_Murray,2,B-IO,3,0,0,0,0,3,0
20080105-M-Doha-F-Stanislas_Wawrinka-Andy_Murray,2,S-XC,22,0,0,0,0,11,11
20080105-M-Doha-F-Stanislas_Wawrinka-Andy_Murray,2,S-DTM,15,0,0,0,0,9,6
20080105-M-Doha-F-Stanislas_Wawrinka-Andy_Murray,2,S-DTL,2,0,0,0,0,1,1
20080105-M-Doha-F-Stanislas_Wawrinka-Andy_Murray,2,S-IO,1,0,0,0,0,0,1
20180901-M-US_Open-R32-Roger_Federer-Nick_Kyrgios,1,F-XC,30,8,4,1,3,21,9
20180901-M-US_Open-R32-Roger_Federer-Nick_Kyrgios,1,F-DTM,13,2,1,1,0,9,4
20180901-M-US_Open-R32-Roger_Federer-Nick_Kyrgios,1,F-DTL,20,9,5,1,3,16,4
20180901-M-US_Open-R32-Roger_Federer-Nick_Kyrgios,1,F-IO,15,7,5,1,1,9,6
20180901-M-US_Open-R32-Roger_Federer-Nick_Kyrgios,1,F-II,5,3,1,0,2,1,4
20180901-M-US_Open-R32-Roger_Federer-Nick_Kyrgios,1,B-XC,12,5,2,0,3,8,4
20180901-M-US_Open-R32-Roger_Federer-Nick_Kyrgios,1,B-DTM,14,4,0,0,4,8,6
20180901-M-US_Open-R32-Roger_Federer-Nick_Kyrgios,1,B-DTL,12,5,3,1,1,8,4
20180901-M-US_Open-R32-Roger_Federer-Nick_Kyrgios,1,B-IO,2,2,2,0,0,2,0
20180901-M-US_Open-R32-Roger_Federer-Nick_Kyrgios,1,S-XC,6,0,0,0,0,2,4
20180901-M-US_Open-R32-Roger_Federer-Nick_Kyrgios,1,S-DTM,4,1,1,0,0,4,0
20180901-M-US_Open-R32-Roger_Federer-Nick_Kyrgios,1,S-DTL,7,2,1,0,1,4,3
20180901-M-US_Open-R32-Roger_Federer-Nick_Kyrgios,2,F-XC,34,8,0,3,5,9,25
20180901-M-US_Open-R32-Roger_Federer-Nick_Kyrgios,2,F-DTM,4,0,0,0,0,0,4
20180901-M-US_Open-R32-Roger_Federer-Nick_Kyrgios,2,F-DTL,12,2,2,0,0,7,5
20180901-M-US_Open-R32-Roger_Federer-Nick_Kyrgios,2,F-IO,11,4,2,0,2,5,6
20180901-M-US_Open-R32-Roger_Federer-Nick_Kyrgios,2,F-II,2,0,0,0,0,1,1
20180901-M-US_Open-R32-Roger_Federer-Nick_Kyrgios,2,B-XC,34,11,2,2,7,14,20
20180901-M-US_Open-R32-Roger_Federer-Nick_Kyrgios,2,B-DTM,7,2,0,0,2,1,6
20180901-M-US_Open-R32-Roger_Federer-Nick_Kyrgios,2,B-DTL,10,4,1,1,2,4,6
20180901-M-US_Open-R32-Roger_Federer-Nick_Kyrgios,2,B-IO,2,1,0,0,1,0,2
20180901-M-US_Open-R32-Roger_Federer-Nick_Kyrgios,2,S-XC,7,1,0,0,1,2,5
20180901-M-US_Open-R32-Roger_Federer-Nick_Kyrgios,2,S-DTM,1,0,0,0,0,0,1
20180901-M-US_Open-R32-Roger_Federer-Nick_Kyrgios,2,S-IO,1,0,0,0,0,0,1
20180828-M-US_Open-R128-Yoshihito_Nishioka-Roger_Federer,1,F-XC,54,12,2,4,6,19,35
20180828-M-US_Open-R128-Yoshihito_Nishioka-Roger_Federer,1,F-DTM,16,1,0,0,1,3,13
20180828-M-US_Open-R128-Yoshihito_Nishioka-Roger_Federer,1,F-DTL,10,4,2,1,1,5,5
20180828-M-US_Open-R128-Yoshihito_Nishioka-Roger_Federer,1,F-IO,7,3,1,2,0,5,2
20180828-M-US_Open-R128-Yoshihito_Nishioka-Roger_Federer,1,F-II,1,0,0,0,0,1,0
20180828-M-US_Open-R128-Yoshihito_Nishioka-Roger_Federer,1,B-XC,52,16,8,1,7,21,31
20180828-M-US_Open-R128-Yoshihito_Nishioka-Roger_Federer,1,B-DTM,16,2,0,0,2,5,11
20180828-M-US_Open-R128-Yoshihito_Nishioka-Roger_Federer,1,B-DTL,18,7,1,4,2,12,6
20180828-M-US_Open-R128-Yoshihito_Nishioka-Roger_Federer,1,B-IO,6,1,0,0,1,3,3
20180828-M-US_Open-R128-Yoshihito_Nishioka-Roger_Federer,1,S-DTM,4,0,0,0,0,1,3
20180828-M-US_Open-R128-Yoshihito_Nishioka-Roger_Federer,1,S-DTL,2,0,0,0,0,0,2
20180828-M-US_Open-R128-Yoshihito_Nishioka-Roger_Federer,1,S-IO,4,1,0,0,1,3,1
20180828-M-US_Open-R128-Yoshihito_Nishioka-Roger_Federer,2,F-XC,40,7,4,1,2,25,15
20180828-M-US_Open-R128-Yoshihito_Nishioka-Roger_Federer,2,F-DTM,12,2,0,0,2,9,3
20180828-M-US_Open-R128-Yoshihito_Nishioka-Roger_Federer,2,F-DTL,19,7,3,1,3,14,5
20180828-M-US_Open-R128-Yoshihito_Nishioka-Roger_Federer,2,F-IO,17,7,3,2,2,12,5
20180828-M-US_Open-R128-Yoshihito_Nishioka-Roger_Federer,2,F-II,5,3,0,1,2,2,3
20180828-M-US_Open-R128-Yoshihito_Nishioka-Roger_Federer,2,B-XC,21,10,2,3,5,8,13
20180828-M-US_Open-R128-Yoshihito_Nishioka-Roger_Federer,2,B-DTM,6,0,0,0,0,4,2
20180828-M-US_Open-R128-Yoshihito_Nishioka-Roger_Federer,2,B-DTL,10,4,0,2,2,5,5
20180828-M-US_Open-R128-Yoshihito_Nishioka-Roger_Federer,2,B-IO,4,3,2,0,1,2,2
20180828-M-US_Open-R128-Yoshihito_Nishioka-Roger_Federer,2,S-XC,4,0,0,0,0,4,0
20180828-M-US_Open-R128-Yoshihito_Nishioka-Roger_Federer,2,S-DTM,9,0,0,0,0,5,4
20180828-M-US_Open-R128-Yoshihito_Nishioka-Roger_Federer,2,S-DTL,8,1,0,1,0,6,2
20180828-M-US_Open-R128-Yoshihito_Nishioka-Roger_Federer,2,S-IO,1,0,0,0,0,1,0
20180830-M-US_Open-R64-Benoit_Paire-Roger_Federer,1,F-XC,22,8,1,3,4,9,13
20180830-M-US_Open-R64-Benoit_Paire-Roger_Federer,1,F-DTM,19,1,0,0,1,7,12
20180830-M-US_Open-R64-Benoit_Paire-Roger_Federer,1,F-DTL,12,4,2,0,2,7,5
20180830-M-US_Open-R64-Benoit_Paire-Roger_Federer,1,F-IO,16,3,0,0,3,6,10
20180830-M-US_Open-R64-Benoit_Paire-Roger_Federer,1,B-XC,40,13,5,3,5,16,24
20180830-M-US_Open-R64-Benoit_Paire-Roger_Federer,1,B-DTM,9,2,0,0,2,1,8
20180830-M-US_Open-R64-Benoit_Paire-Roger_Federer,1,B-DTL,8,6,3,0,3,4,4
20180830-M-US_Open-R64-Benoit_Paire-Roger_Federer,1,B-IO,9,2,1,1,0,4,5
20180830-M-US_Open-R64-Benoit_Paire-Roger_Federer,1,S-XC,3,1,0,0,1,1,2
20180830-M-US_Open-R64-Benoit_Paire-Roger_Federer,1,S-DTM,1,0,0,0,0,0,1
20180830-M-US_Open-R64-Benoit_Paire-Roger_Federer,1,S-DTL,3,0,0,0,0,0,3
20180830-M-US_Open-R64-Benoit_Paire-Roger_Federer,1,S-IO,2,0,0,0,0,1,1
20180830-M-US_Open-R64-Benoit_Paire-Roger_Federer,2,F-XC,23,6,3,1,2,15,8
20180830-M-US_Open-R64-Benoit_Paire-Roger_Federer,2,F-DTM,10,0,0,0,0,8,2
20180830-M-US_Open-R64-Benoit_Paire-Roger_Federer,2,F-DTL,17,11,3,4,4,10,7
20180830-M-US_Open-R64-Benoit_Paire-Roger_Federer,2,F-IO,20,7,1,2,4,15,5
20180830-M-US_Open-R64-Benoit_Paire-Roger_Federer,2,F-II,11,6,2,1,3,6,5
20180830-M-US_Open-R64-Benoit_Paire-Roger_Federer,2,B-XC,30,10,1,4,5,19,11
20180830-M-US_Open-R64-Benoit_Paire-Roger_Federer,2,B-DTM,13,2,0,1,1,7,6
20180830-M-US_Open-R64-Benoit_Paire-Roger_Federer,2,B-DTL,10,3,0,1,2,5,5
20180830-M-US_Open-R64-Benoit_Paire-Roger_Federer,2,B-IO,1,0,0,0,0,0,1
20180830-M-US_Open-R64-Benoit_Paire-Roger_Federer,2,S-XC,9,1,1,0,0,5,4
20180830-M-US_Open-R64-Benoit_Paire-Roger_Federer,2,S-DTM,6,1,0,0,1,3,3
20180830-M-US_Open-R64-Benoit_Paire-Roger_Federer,2,S-DTL,5,0,0,0,0,2,3
20180903-M-US_Open-R16-Roger_Federer-John_Millman,1,F-XC,70,21,5,7,9,39,31
20180903-M-US_Open-R16-Roger_Federer-John_Millman,1,F-DTM,25,4,0,0,4,10,15
20180903-M-US_Open-R16-Roger_Federer-John_Millman,1,F-DTL,23,10,4,3,3,11,12
20180903-M-US_Open-R16-Roger_Federer-John_Millman,1,F-IO,36,11,0,5,6,17,19
20180903-M-US_Open-R16-Roger_Federer-John_Millman,1,F-II,12,5,1,2,2,6,6
20180903-M-US_Open-R16-Roger_Federer-John_Millman,1,B-XC,34,9,1,1,7,13,21
20180903-M-US_Open-R16-Roger_Federer-John_Millman,1,B-DTM,15,2,0,0,2,5,10
20180903-M-US_Open-R16-Roger_Federer-John_Millman,1,B-DTL,12,5,1,1,3,9,3
20180903-M-US_Open-R16-Roger_Federer-John_Millman,1,B-IO,1,0,0,0,0,1,0
20180903-M-US_Open-R16-Roger_Federer-John_Millman,1,S-XC,16,5,1,0,4,5,11
20180903-M-US_Open-R16-Roger_Federer-John_Millman,1,S-DTM,8,1,1,0,0,6,2
20180903-M-US_Open-R16-Roger_Federer-John_Millman,1,S-DTL,7,1,0,0,1,2,5
20180903-M-US_Open-R16-Roger_Federer-John_Millman,1,S-IO,3,0,0,0,0,2,1
20180903-M-US_Open-R16-Roger_Federer-John_Millman,2,F-XC,73,16,7,4,5,38,35
20180903-M-US_Open-R16-Roger_Federer-John_Millman,2,F-DTM,26,1,0,0,1,11,15
20180903-M-US_Open-R16-Roger_Federer-John_Millman,2,F-DTL,28,14,10,1,3,16,12
20180903-M-US_Open-R16-Roger_Federer-John_Millman,2,F-IO,17,3,1,1,1,8,9
20180903-M-US_Open-R16-Roger_Federer-John_Millman,2,F-II,3,3,1,1,1,2,1
20180903-M-US_Open-R16-Roger_Federer-John_Millman,2,B-XC,88,17,4,4,9,52,36
20180903-M-US_Open-R16-Roger_Federer-John_Millman,2,B-DTM,34,2,0,1,1,19,15
20180903-M-US_Open-R16-Roger_Federer-John_Millman,2,B-DTL,24,14,11,2,1,17,7
20180903-M-US_Open-R16-Roger_Federer-John_Millman,2,B-IO,3,1,0,0,1,1,2
20180903-M-US_Open-R16-Roger_Federer-John_Millman,2,S-XC,3,0,0,0,0,2,1
20180903-M-US_Open-R16-Roger_Federer-John_Millman,2,S-DTL,3,1,1,0,0,1,2
20180831-M-US_Open-R32-Rafael_Nadal-Karen_Khachanov,1,F-XC,157,22,6,6,10,88,69
20180831-M-US_Open-R32-Rafael_Nadal-Karen_Khachanov,1,F-DTM,22,0,0,0,0,11,11
20180831-M-US_Open-R32-Rafael_Nadal-Karen_Khachanov,1,F-DTL,59,34,15,7,12,37,22
20180831-M-US_Open-R32-Rafael_Nadal-Karen_Khachanov,1,F-IO,46,14,5,4,5,19,27
20180831-M-US_Open-R32-Rafael_Nadal-Karen_Khachanov,1,F-II,11,3,2,1,0,5,6
20180831-M-US_Open-R32-Rafael_Nadal-Karen_Khachanov,1,B-XC,83,10,0,3,7,43,40
20180831-M-US_Open-R32-Rafael_Nadal-Karen_Khachanov,1,B-DTM,30,3,0,1,2,14,16
20180831-M-US_Open-R32-Rafael_Nadal-Karen_Khachanov,1,B-DTL,28,8,2,2,4,16,12
20180831-M-US_Open-R32-Rafael_Nadal-Karen_Khachanov,1,B-IO,7,2,0,0,2,2,5
20180831-M-US_Open-R32-Rafael_Nadal-Karen_Khachanov,1,S-XC,18,2,0,2,0,10,8
20180831-M-US_Open-R32-Rafael_Nadal-Karen_Khachanov,1,S-DTM,21,0,0,0,0,10,11
20180831-M-US_Open-R32-Rafael_Nadal-Karen_Khachanov,1,S-DTL,16,0,0,0,0,8,8
20180831-M-US_Open-R32-Rafael_Nadal-Karen_Khachanov,1,S-IO,3,0,0,0,0,2,1
20180831-M-US_Open-R32-Rafael_Nadal-Karen_Khachanov,2,F-XC,161,18,5,3,10,84,77
20180831-M-US_Open-R32-Rafael_Nadal-Karen_Khachanov,2,F-DTM,28,2,1,0,1,14,14
20180831-M-US_Open-R32-Rafael_Nadal-Karen_Khachanov,2,F-DTL,34,17,8,2,7,18,16
20180831-M-US_Open-R32-Rafael_Nadal-Karen_Khachanov,2,F-IO,44,14,5,3,6,22,22
20180831-M-US_Open-R32-Rafael_Nadal-Karen_Khachanov,2,F-II,9,3,2,1,0,7,2
20180831-M-US_Open-R32-Rafael_Nadal-Karen_Khachanov,2,B-XC,99,10,0,3,7,44,55
20180831-M-US_Open-R32-Rafael_Nadal-Karen_Khachanov,2,B-DTM,60,5,0,0,5,30,30
20180831-M-US_Open-R32-Rafael_Nadal-Karen_Khachanov,2,B-DTL,32,12,4,1,7,12,20
20180831-M-US_Open-R32-Rafael_Nadal-Karen_Khachanov,2,B-IO,11,1,0,0,1,6,5
20180831-M-US_Open-R32-Rafael_Nadal-Karen_Khachanov,2,S-XC,10,1,0,1,0,4,6
20180831-M-US_Open-R32-Rafael_Nadal-Karen_Khachanov,2,S-DTM,4,0,0,0,0,2,2
20180831-M-US_Open-R32-Rafael_Nadal-Karen_Khachanov,2,S-DTL,2,0,0,0,0,0,2
20180831-M-US_Open-R32-Rafael_Nadal-Karen_Khachanov,2,S-IO,1,0,0,0,0,0,1
20180909-M-US_Open-F-Novak_Djokovic-Juan_Martin_Del_Potro,1,F-XC,72,17,4,5,8,41,31
20180909-M-US_Open-F-Novak_Djokovic-Juan_Martin_Del_Potro,1,F-DTM,41,1,0,1,0,27,14
20180909-M-US_Open-F-Novak_Djokovic-Juan_Martin_Del_Potro,1,F-DTL,25,3,2,0,1,18,7
20180909-M-US_Open-F-Novak_Djokovic-Juan_Martin_Del_Potro,1,F-IO,55,4,2,2,0,40,15
20180909-M-US_Open-F-Novak_Djokovic-Juan_Martin_Del_Potro,1,F-II,16,5,3,0,2,11,5
20180909-M-US_Open-F-Novak_Djokovic-Juan_Martin_Del_Potro,1,B-XC,135,15,0,0,15,67,68
20180909-M-US_Open-F-Novak_Djokovic-Juan_Martin_Del_Potro,1,B-DTM,56,2,0,0,2,32,24
20180909-M-US_Open-F-Novak_Djokovic-Juan_Martin_Del_Potro,1,B-DTL,20,7,3,1,3,10,10
20180909-M-US_Open-F-Novak_Djokovic-Juan_Martin_Del_Potro,1,B-IO,6,1,0,0,1,1,5
20180909-M-US_Open-F-Novak_Djokovic-Juan_Martin_Del_Potro,1,B-II,1,0,0,0,0,0,1
20180909-M-US_Open-F-Novak_Djokovic-Juan_Martin_Del_Potro,1,S-XC,20,2,0,0,2,9,11
20180909-M-US_Open-F-Novak_Djokovic-Juan_Martin_Del_Potro,1,S-DTM,5,1,0,0,1,2,3
20180909-M-US_Open-F-Novak_Djokovic-Juan_Martin_Del_Potro,1,S-DTL,3,0,0,0,0,1,2
20180909-M-US_Open-F-Novak_Djokovic-Juan_Martin_Del_Potro,2,F-XC,79,21,6,2,13,36,43
20180909-M-US_Open-F-Novak_Djokovic-Juan_Martin_Del_Potro,2,F-DTM,42,3,0,0,3,19,23
20180909-M-US_Open-F-Novak_Djokovic-Juan_Martin_Del_Potro,2,F-DTL,18,8,3,1,4,11,7
20180909-M-US_Open-F-Novak_Djokovic-Juan_Martin_Del_Potro,2,F-IO,76,18,4,4,10,33,43
20180909-M-US_Open-F-Novak_Djokovic-Juan_Martin_Del_Potro,2,F-II,17,8,3,3,2,8,9
20180909-M-US_Open-F-Novak_Djokovic-Juan_Martin_Del_Potro,2,B-XC,70,4,0,0,4,30,40
20180909-M-US_Open-F-Novak_Djokovic-Juan_Martin_Del_Potro,2,B-DTM,40,1,0,0,1,15,25
20180909-M-US_Open-F-Novak_Djokovic-Juan_Martin_Del_Potro,2,B-DTL,14,8,3,0,5,7,7
20180909-M-US_Open-F-Novak_Djokovic-Juan_Martin_Del_Potro,2,B-IO,4,2,1,0,1,1,3
20180909-M-US_Open-F-Novak_Djokovic-Juan_Martin_Del_Potro,2,S-XC,69,2,0,0,2,27,42
20180909-M-US_Open-F-Novak_Djokovic-Juan_Martin_Del_Potro,2,S-DTM,19,3,0,0,3,9,10
20180909-M-US_Open-F-Novak_Djokovic-Juan_Martin_Del_Potro,2,S-DTL,6,2,0,0,2,0,6
20060219-M-San_Jose-F-Lleyton_Hewitt-Andy_Murray,1,F-XC,136,14,3,3,8,58,78
20060219-M-San_Jose-F-Lleyton_Hewitt-Andy_Murray,1,F-DTM,38,1,0,0,1,16,22
20060219-M-San_Jose-F-Lleyton_Hewitt-Andy_Murray,1,F-DTL,32,7,1,2,4,13,19
20060219-M-San_Jose-F-Lleyton_Hewitt-Andy_Murray,1,F-IO,51,7,2,2,3,28,23
20060219-M-San_Jose-F-Lleyton_Hewitt-Andy_Murray,1,F-II,5,1,0,1,0,3,2
20060219-M-San_Jose-F-Lleyton_Hewitt-Andy_Murray,1,B-XC,99,9,0,1,8,42,57
20060219-M-San_Jose-F-Lleyton_Hewitt-Andy_Murray,1,B-DTM,34,2,0,0,2,10,24
20060219-M-San_Jose-F-Lleyton_Hewitt-Andy_Murray,1,B-DTL,5,3,1,1,1,4,1
20060219-M-San_Jose-F-Lleyton_Hewitt-Andy_Murray,1,B-IO,8,2,0,1,1,5,3
20060219-M-San_Jose-F-Lleyton_Hewitt-Andy_Murray,1,S-XC,17,0,0,0,0,7,10
20060219-M-San_Jose-F-Lleyton_Hewitt-Andy_Murray,1,S-DTM,6,0,0,0,0,0,6
20060219-M-San_Jose-F-Lleyton_Hewitt-Andy_Murray,1,S-DTL,2,0,0,0,0,0,2
20060219-M-San_Jose-F-Lleyton_Hewitt-Andy_Murray,2,F-XC,102,12,1,5,6,62,40
20060219-M-San_Jose-F-Lleyton_Hewitt-Andy_Murray,2,F-DTM,41,3,0,0,3,16,25
20060219-M-San_Jose-F-Lleyton_Hewitt-Andy_Murray,2,F-DTL,26,8,2,2,4,18,8
20060219-M-San_Jose-F-Lleyton_Hewitt-Andy_Murray,2,F-IO,12,4,1,0,3,7,5
20060219-M-San_Jose-F-Lleyton_Hewitt-Andy_Murray,2,F-II,5,4,2,0,2,3,2
20060219-M-San_Jose-F-Lleyton_Hewitt-Andy_Murray,2,B-XC,37,10,8,0,2,19,18
20060219-M-San_Jose-F-Lleyton_Hewitt-Andy_Murray,2,B-DTM,32,1,0,0,1,17,15
20060219-M-San_Jose-F-Lleyton_Hewitt-Andy_Murray,2,B-DTL,15,7,3,1,3,8,7
20060219-M-San_Jose-F-Lleyton_Hewitt-Andy_Murray,2,B-IO,4,2,1,0,1,1,3
20060219-M-San_Jose-F-Lleyton_Hewitt-Andy_Murray,2,S-XC,58,3,0,1,2,30,28
20060219-M-San_Jose-F-Lleyton_Hewitt-Andy_Murray,2,S-DTM,64,2,0,1,1,34,30
20060219-M-San_Jose-F-Lleyton_Hewitt-Andy_Murray,2,S-DTL,20,1,0,1,0,13,7
20060219-M-San_Jose-F-Lleyton_Hewitt-Andy_Murray,2,S-IO,10,0,0,0,0,8,2
20090109-M-Doha-SF-Roger_Federer-Andy_Murray,1,F-XC,40,11,1,1,9,15,25
20090109-M-Doha-SF-Roger_Federer-Andy_Murray,1,F-DTM,26,2,0,0,2,7,19
20090109-M-Doha-SF-Roger_Federer-Andy_Murray,1,F-DTL,6,3,2,0,1,5,1
20090109-M-Doha-SF-Roger_Federer-Andy_Murray,1,F-IO,43,15,6,4,5,26,17
20090109-M-Doha-SF-Roger_Federer-Andy_Murray,1,F-II,15,5,1,4,0,9,6
20090109-M-Doha-SF-Roger_Federer-Andy_Murray,1,B-XC,57,13,2,0,11,23,34
20090109-M-Doha-SF-Roger_Federer-Andy_Murray,1,B-DTM,29,3,0,0,3,10,19
20090109-M-Doha-SF-Roger_Federer-Andy_Murray,1,B-DTL,11,4,1,2,1,7,4
20090109-M-Doha-SF-Roger_Federer-Andy_Murray,1,B-IO,3,0,0,0,0,1,2
20090109-M-Doha-SF-Roger_Federer-Andy_Murray,1,S-XC,23,0,0,0,0,6,17
20090109-M-Doha-SF-Roger_Federer-Andy_Murray,1,S-DTM,9,1,0,0,1,3,6
20090109-M-Doha-SF-Roger_Federer-Andy_Murray,1,S-DTL,3,1,0,1,0,1,2
20090109-M-Doha-SF-Roger_Federer-Andy_Murray,2,F-XC,41,12,4,2,6,23,18
20090109-M-Doha-SF-Roger_Federer-Andy_Murray,2,F-DTM,28,0,0,0,0,17,11
20090109-M-Doha-SF-Roger_Federer-Andy_Murray,2,F-DTL,18,2,0,2,0,10,8
20090109-M-Doha-SF-Roger_Federer-Andy_Murray,2,F-IO,36,1,1,0,0,22,14
20090109-M-Doha-SF-Roger_Federer-Andy_Murray,2,F-II,5,2,1,1,0,3,2
20090109-M-Doha-SF-Roger_Federer-Andy_Murray,2,B-XC,72,12,3,3,6,45,27
20090109-M-Doha-SF-Roger_Federer-Andy_Murray,2,B-DTM,11,0,0,0,0,5,6
20090109-M-Doha-SF-Roger_Federer-Andy_Murray,2,B-DTL,18,10,4,3,3,12,6
20090109-M-Doha-SF-Roger_Federer-Andy_Murray,2,S-XC,16,0,0,0,0,9,7
20090109-M-Doha-SF-Roger_Federer-Andy_Murray,2,S-DTM,8,0,0,0,0,5,3
20090109-M-Doha-SF-Roger_Federer-Andy_Murray,2,S-DTL,2,0,0,0,0,1,1
20090109-M-Doha-SF-Roger_Federer-Andy_Murray,2,S-IO,2,0,0,0,0,1,1
20070707-M-Wimbledon-SF-Novak_Djokovic-Rafael_Nadal,1,F-XC,14,5,2,0,3,5,9
20070707-M-Wimbledon-SF-Novak_Djokovic-Rafael_Nadal,1,F-DTM,8,1,0,0,1,4,4
20070707-M-Wimbledon-SF-Novak_Djokovic-Rafael_Nadal,1,F-DTL,2,1,0,1,0,2,0
20070707-M-Wimbledon-SF-Novak_Djokovic-Rafael_Nadal,1,F-IO,8,3,0,2,1,3,5
20070707-M-Wimbledon-SF-Novak_Djokovic-Rafael_Nadal,1,B-XC,13,3,1,2,0,6,7
20070707-M-Wimbledon-SF-Novak_Djokovic-Rafael_Nadal,1,B-DTM,13,2,0,1,1,5,8
20070707-M-Wimbledon-SF-Novak_Djokovic-Rafael_Nadal,1,B-DTL,6,2,0,0,2,2,4
20070707-M-Wimbledon-SF-Novak_Djokovic-Rafael_Nadal,1,B-IO,4,1,0,0,1,1,3
20070707-M-Wimbledon-SF-Novak_Djokovic-Rafael_Nadal,1,S-DTM,1,0,0,0,0,1,0
20070707-M-Wimbledon-SF-Novak_Djokovic-Rafael_Nadal,1,S-DTL,1,0,0,0,0,0,1
20070707-M-Wimbledon-SF-Novak_Djokovic-Rafael_Nadal,2,F-XC,20,1,0,1,0,12,8
20070707-M-Wimbledon-SF-Novak_Djokovic-Rafael_Nadal,2,F-DTM,4,0,0,0,0,2,2
20070707-M-Wimbledon-SF-Novak_Djokovic-Rafael_Nadal,2,F-DTL,3,3,2,1,0,3,0
20070707-M-Wimbledon-SF-Novak_Djokovic-Rafael_Nadal,2,F-IO,3,1,1,0,0,2,1
20070707-M-Wimbledon-SF-Novak_Djokovic-Rafael_Nadal,2,F-II,1,1,1,0,0,1,0
20070707-M-Wimbledon-SF-Novak_Djokovic-Rafael_Nadal,2,B-XC,7,2,0,1,1,3,4
20070707-M-Wimbledon-SF-Novak_Djokovic-Rafael_Nadal,2,B-DTM,8,0,0,0,0,4,4
20070707-M-Wimbledon-SF-Novak_Djokovic-Rafael_Nadal,2,B-DTL,2,1,1,0,0,1,1
20070707-M-Wimbledon-SF-Novak_Djokovic-Rafael_Nadal,2,B-IO,2,0,0,0,0,1,1
20070707-M-Wimbledon-SF-Novak_Djokovic-Rafael_Nadal,2,S-XC,2,0,0,0,0,2,0
20070707-M-Wimbledon-SF-Novak_Djokovic-Rafael_Nadal,2,S-DTM,4,0,0,0,0,3,1
20070707-M-Wimbledon-SF-Novak_Djokovic-Rafael_Nadal,2,S-DTL,1,1,0,1,0,1,0
20070707-M-Wimbledon-SF-Novak_Djokovic-Rafael_Nadal,2,S-IO,1,0,0,0,0,1,0
20061008-M-Metz-F-Novak_Djokovic-Jurgen_Melzer,1,F-XC,29,2,1,1,0,20,9
20061008-M-Metz-F-Novak_Djokovic-Jurgen_Melzer,1,F-DTM,20,1,0,0,1,11,9
20061008-M-Metz-F-Novak_Djokovic-Jurgen_Melzer,1,F-DTL,11,3,1,1,1,6,5
20061008-M-Metz-F-Novak_Djokovic-Jurgen_Melzer,1,F-IO,24,12,5,6,1,18,6
20061008-M-Metz-F-Novak_Djokovic-Jurgen_Melzer,1,F-II,1,0,0,0,0,1,0
20061008-M-Metz-F-Novak_Djokovic-Jurgen_Melzer,1,B-XC,24,6,3,2,1,14,10
20061008-M-Metz-F-Novak_Djokovic-Jurgen_Melzer,1,B-DTM,30,3,0,0,3,12,18
20061008-M-Metz-F-Novak_Djokovic-Jurgen_Melzer,1,B-DTL,15,3,0,1,2,9,6
20061008-M-Metz-F-Novak_Djokovic-Jurgen_Melzer,1,B-IO,5,4,1,2,1,4,1
20061008-M-Metz-F-Novak_Djokovic-Jurgen_Melzer,1,S-DTM,3,0,0,0,0,0,3
20061008-M-Metz-F-Novak_Djokovic-Jurgen_Melzer,1,S-DTL,2,0,0,0,0,2,0
20061008-M-Metz-F-Novak_Djokovic-Jurgen_Melzer,1,S-IO,1,0,0,0,0,1,0
20061008-M-Metz-F-Novak_Djokovic-Jurgen_Melzer,2,F-XC,37,9,3,2,4,14,23
20061008-M-Metz-F-Novak_Djokovic-Jurgen_Melzer,2,F-DTM,12,0,0,0,0,7,5
20061008-M-Metz-F-Novak_Djokovic-Jurgen_Melzer,2,F-DTL,11,6,3,1,2,6,5
20061008-M-Metz-F-Novak_Djokovic-Jurgen_Melzer,2,F-IO,13,7,1,4,2,7,6
20061008-M-Metz-F-Novak_Djokovic-Jurgen_Melzer,2,B-XC,26,7,0,1,6,9,17
20061008-M-Metz-F-Novak_Djokovic-Jurgen_Melzer,2,B-DTM,18,2,1,0,1,5,13
20061008-M-Metz-F-Novak_Djokovic-Jurgen_Melzer,2,B-DTL,9,7,0,2,5,3,6
20061008-M-Metz-F-Novak_Djokovic-Jurgen_Melzer,2,B-IO,8,0,0,0,0,1,7
20061008-M-Metz-F-Novak_Djokovic-Jurgen_Melzer,2,S-XC,5,1,0,0,1,0,5
20061008-M-Metz-F-Novak_Djokovic-Jurgen_Melzer,2,S-DTM,9,2,0,0,2,1,8
20061008-M-Metz-F-Novak_Djokovic-Jurgen_Melzer,2,S-DTL,9,0,0,0,0,4,5
20180919-M-St_Petersburg-R16-Stanislas_Wawrinka-Karen_Khachanov,1,F-XC,38,14,6,5,3,28,10
20180919-M-St_Petersburg-R16-Stanislas_Wawrinka-Karen_Khachanov,1,F-DTM,17,2,0,1,1,9,8
20180919-M-St_Petersburg-R16-Stanislas_Wawrinka-Karen_Khachanov,1,F-DTL,14,8,6,0,2,8,6
20180919-M-St_Petersburg-R16-Stanislas_Wawrinka-Karen_Khachanov,1,F-IO,17,5,4,0,1,9,8
20180919-M-St_Petersburg-R16-Stanislas_Wawrinka-Karen_Khachanov,1,B-XC,51,4,1,0,3,34,17
20180919-M-St_Petersburg-R16-Stanislas_Wawrinka-Karen_Khachanov,1,B-DTM,24,4,0,1,3,14,10
20180919-M-St_Petersburg-R16-Stanislas_Wawrinka-Karen_Khachanov,1,B-DTL,10,8,5,2,1,8,2
20180919-M-St_Petersburg-R16-Stanislas_Wawrinka-Karen_Khachanov,1,B-IO,1,0,0,0,0,1,0
20180919-M-St_Petersburg-R16-Stanislas_Wawrinka-Karen_Khachanov,1,S-XC,22,4,0,1,3,11,11
20180919-M-St_Petersburg-R16-Stanislas_Wawrinka-Karen_Khachanov,1,S-DTM,11,0,0,0,0,8,3
20180919-M-St_Petersburg-R16-Stanislas_Wawrinka-Karen_Khachanov,1,S-DTL,2,0,0,0,0,0,2
20180919-M-St_Petersburg-R16-Stanislas_Wawrinka-Karen_Khachanov,1,S-IO,1,0,0,0,0,0,1
20180919-M-St_Petersburg-R16-Stanislas_Wawrinka-Karen_Khachanov,2,F-XC,48,18,6,8,4,22,26
20180919-M-St_Petersburg-R16-Stanislas_Wawrinka-Karen_Khachanov,2,F-DTM,17,2,0,0,2,2,15
20180919-M-St_Petersburg-R16-Stanislas_Wawrinka-Karen_Khachanov,2,F-DTL,8,3,0,0,3,1,7
20180919-M-St_Petersburg-R16-Stanislas_Wawrinka-Karen_Khachanov,2,F-IO,39,15,5,4,6,21,18
20180919-M-St_Petersburg-R16-Stanislas_Wawrinka-Karen_Khachanov,2,F-II,2,0,0,0,0,2,0
20180919-M-St_Petersburg-R16-Stanislas_Wawrinka-Karen_Khachanov,2,B-XC,52,8,1,1,6,19,33
20180919-M-St_Petersburg-R16-Stanislas_Wawrinka-Karen_Khachanov,2,B-DTM,26,3,1,0,2,7,19
20180919-M-St_Petersburg-R16-Stanislas_Wawrinka-Karen_Khachanov,2,B-DTL,14,5,2,1,2,7,7
20180919-M-St_Petersburg-R16-Stanislas_Wawrinka-Karen_Khachanov,2,B-IO,2,1,1,0,0,1,1
20180919-M-St_Petersburg-R16-Stanislas_Wawrinka-Karen_Khachanov,2,S-XC,5,1,0,0,1,1,4
20180919-M-St_Petersburg-R16-Stanislas_Wawrinka-Karen_Khachanov,2,S-DTM,3,0,0,0,0,0,3
20180919-M-St_Petersburg-R16-Stanislas_Wawrinka-Karen_Khachanov,2,S-DTL,2,1,1,0,0,2,0
20060607-M-Roland_Garros-QF-Novak_Djokovic-Rafael_Nadal,1,F-XC,45,6,3,2,1,15,30
20060607-M-Roland_Garros-QF-Novak_Djokovic-Rafael_Nadal,1,F-DTM,17,0,0,0,0,11,6
20060607-M-Roland_Garros-QF-Novak_Djokovic-Rafael_Nadal,1,F-DTL,8,4,2,0,2,4,4
20060607-M-Roland_Garros-QF-Novak_Djokovic-Rafael_Nadal,1,F-IO,39,11,5,3,3,22,17
20060607-M-Roland_Garros-QF-Novak_Djokovic-Rafael_Nadal,1,F-II,2,0,0,0,0,1,1
20060607-M-Roland_Garros-QF-Novak_Djokovic-Rafael_Nadal,1,B-XC,25,8,0,1,7,6,19
20060607-M-Roland_Garros-QF-Novak_Djokovic-Rafael_Nadal,1,B-DTM,31,3,0,0,3,13,18
20060607-M-Roland_Garros-QF-Novak_Djokovic-Rafael_Nadal,1,B-DTL,18,1,0,0,1,11,7
20060607-M-Roland_Garros-QF-Novak_Djokovic-Rafael_Nadal,1,B-IO,8,2,2,0,0,6,2
20060607-M-Roland_Garros-QF-Novak_Djokovic-Rafael_Nadal,1,S-DTL,2,0,0,0,0,2,0
20060607-M-Roland_Garros-QF-Novak_Djokovic-Rafael_Nadal,2,F-XC,53,9,4,4,1,32,21
20060607-M-Roland_Garros-QF-Novak_Djokovic-Rafael_Nadal,2,F-DTM,23,2,0,0,2,11,12
20060607-M-Roland_Garros-QF-Novak_Djokovic-Rafael_Nadal,2,F-DTL,9,6,2,1,3,4,5
20060607-M-Roland_Garros-QF-Novak_Djokovic-Rafael_Nadal,2,F-IO,17,8,5,2,1,11,6
20060607-M-Roland_Garros-QF-Novak_Djokovic-Rafael_Nadal,2,F-II,7,1,0,0,1,3,4
20060607-M-Roland_Garros-QF-Novak_Djokovic-Rafael_Nadal,2,B-XC,37,5,0,2,3,24,13
20060607-M-Roland_Garros-QF-Novak_Djokovic-Rafael_Nadal,2,B-DTM,19,0,0,0,0,8,11
20060607-M-Roland_Garros-QF-Novak_Djokovic-Rafael_Nadal,2,B-DTL,12,1,0,0,1,7,5
20060607-M-Roland_Garros-QF-Novak_Djokovic-Rafael_Nadal,2,B-IO,9,1,1,0,0,5,4
20060607-M-Roland_Garros-QF-Novak_Djokovic-Rafael_Nadal,2,S-XC,1,1,0,1,0,1,0
20060607-M-Roland_Garros-QF-Novak_Djokovic-Rafael_Nadal,2,S-DTM,4,0,0,0,0,1,3
20060607-M-Roland_Garros-QF-Novak_Djokovic-Rafael_Nadal,2,S-DTL,3,0,0,0,0,3,0
20060607-M-Roland_Garros-QF-Novak_Djokovic-Rafael_Nadal,2,S-IO,2,0,0,0,0,2,0
20101124-M-Tour_Finals-RR-Novak_Djokovic-Rafael_Nadal,1,F-XC,52,6,1,3,2,29,23
20101124-M-Tour_Finals-RR-Novak_Djokovic-Rafael_Nadal,1,F-DTM,12,3,0,0,3,2,10
20101124-M-Tour_Finals-RR-Novak_Djokovic-Rafael_Nadal,1,F-DTL,7,2,0,0,2,2,5
20101124-M-Tour_Finals-RR-Novak_Djokovic-Rafael_Nadal,1,F-IO,24,7,1,4,2,14,10
20101124-M-Tour_Finals-RR-Novak_Djokovic-Rafael_Nadal,1,F-II,3,1,0,1,0,2,1
20101124-M-Tour_Finals-RR-Novak_Djokovic-Rafael_Nadal,1,B-XC,26,6,0,3,3,10,16
20101124-M-Tour_Finals-RR-Novak_Djokovic-Rafael_Nadal,1,B-DTM,29,4,0,0,4,6,23
20101124-M-Tour_Finals-RR-Novak_Djokovic-Rafael_Nadal,1,B-DTL,17,6,1,1,4,10,7
20101124-M-Tour_Finals-RR-Novak_Djokovic-Rafael_Nadal,1,B-IO,5,0,0,0,0,3,2
20101124-M-Tour_Finals-RR-Novak_Djokovic-Rafael_Nadal,1,S-II,1,0,0,0,0,1,0
20101124-M-Tour_Finals-RR-Novak_Djokovic-Rafael_Nadal,2,F-XC,45,9,1,4,4,25,20
20101124-M-Tour_Finals-RR-Novak_Djokovic-Rafael_Nadal,2,F-DTM,15,1,0,0,1,6,9
20101124-M-Tour_Finals-RR-Novak_Djokovic-Rafael_Nadal,2,F-DTL,13,4,4,0,0,12,1
20101124-M-Tour_Finals-RR-Novak_Djokovic-Rafael_Nadal,2,F-IO,19,6,2,3,1,14,5
20101124-M-Tour_Finals-RR-Novak_Djokovic-Rafael_Nadal,2,F-II,7,0,0,0,0,4,3
20101124-M-Tour_Finals-RR-Novak_Djokovic-Rafael_Nadal,2,B-XC,13,3,1,2,0,5,8
20101124-M-Tour_Finals-RR-Novak_Djokovic-Rafael_Nadal,2,B-DTM,25,4,0,0,4,13,12
20101124-M-Tour_Finals-RR-Novak_Djokovic-Rafael_Nadal,2,B-DTL,14,4,1,0,3,7,7
20101124-M-Tour_Finals-RR-Novak_Djokovic-Rafael_Nadal,2,B-IO,2,1,0,0,1,1,1
20101124-M-Tour_Finals-RR-Novak_Djokovic-Rafael_Nadal,2,S-XC,7,1,0,1,0,4,3
20101124-M-Tour_Finals-RR-Novak_Djokovic-Rafael_Nadal,2,S-DTM,14,0,0,0,0,5,9
20101124-M-Tour_Finals-RR-Novak_Djokovic-Rafael_Nadal,2,S-DTL,5,0,0,0,0,3,2
20101124-M-Tour_Finals-RR-Novak_Djokovic-Rafael_Nadal,2,S-IO,2,0,0,0,0,2,0
20070329-M-Miami_Masters-QF-Novak_Djokovic-Rafael_Nadal,1,F-XC,70,3,0,2,1,39,31
20070329-M-Miami_Masters-QF-Novak_Djokovic-Rafael_Nadal,1,F-DTM,10,0,0,0,0,5,5
20070329-M-Miami_Masters-QF-Novak_Djokovic-Rafael_Nadal,1,F-DTL,16,4,1,1,2,7,9
20070329-M-Miami_Masters-QF-Novak_Djokovic-Rafael_Nadal,1,F-IO,32,11,3,4,4,18,14
20070329-M-Miami_Masters-QF-Novak_Djokovic-Rafael_Nadal,1,F-II,4,2,0,2,0,2,2
20070329-M-Miami_Masters-QF-Novak_Djokovic-Rafael_Nadal,1,B-XC,16,6,1,2,3,10,6
20070329-M-Miami_Masters-QF-Novak_Djokovic-Rafael_Nadal,1,B-DTM,17,0,0,0,0,9,8
20070329-M-Miami_Masters-QF-Novak_Djokovic-Rafael_Nadal,1,B-DTL,8,0,0,0,0,8,0
20070329-M-Miami_Masters-QF-Novak_Djokovic-Rafael_Nadal,1,B-II,1,0,0,0,0,1,0
20070329-M-Miami_Masters-QF-Novak_Djokovic-Rafael_Nadal,1,S-DTM,1,0,0,0,0,0,1
20070329-M-Miami_Masters-QF-Novak_Djokovic-Rafael_Nadal,1,S-DTL,3,1,0,0,1,2,1
20070329-M-Miami_Masters-QF-Novak_Djokovic-Rafael_Nadal,2,F-XC,35,2,2,0,0,15,20
20070329-M-Miami_Masters-QF-Novak_Djokovic-Rafael_Nadal,2,F-DTM,20,4,1,0,3,9,11
20070329-M-Miami_Masters-QF-Novak_Djokovic-Rafael_Nadal,2,F-DTL,15,7,2,1,4,8,7
20070329-M-Miami_Masters-QF-Novak_Djokovic-Rafael_Nadal,2,F-IO,21,9,5,1,3,11,10
20070329-M-Miami_Masters-QF-Novak_Djokovic-Rafael_Nadal,2,F-II,10,3,0,2,1,5,5
20070329-M-Miami_Masters-QF-Novak_Djokovic-Rafael_Nadal,2,B-XC,37,4,0,0,4,16,21
20070329-M-Miami_Masters-QF-Novak_Djokovic-Rafael_Nadal,2,B-DTM,15,1,0,0,1,7,8
20070329-M-Miami_Masters-QF-Novak_Djokovic-Rafael_Nadal,2,B-DTL,8,3,0,0,3,1,7
20070329-M-Miami_Masters-QF-Novak_Djokovic-Rafael_Nadal,2,S-XC,7,1,0,0,1,3,4
20070329-M-Miami_Masters-QF-Novak_Djokovic-Rafael_Nadal,2,S-DTM,6,0,0,0,0,2,4
20070329-M-Miami_Masters-QF-Novak_Djokovic-Rafael_Nadal,2,S-DTL,4,0,0,0,0,0,4
20070812-M-Canada_Masters-SF-Novak_Djokovic-Rafael_Nadal,1,F-XC,53,8,3,2,3,31,22
20070812-M-Canada_Masters-SF-Novak_Djokovic-Rafael_Nadal,1,F-DTM,13,1,0,0,1,6,7
20070812-M-Canada_Masters-SF-Novak_Djokovic-Rafael_Nadal,1,F-DTL,9,2,0,2,0,4,5
20070812-M-Canada_Masters-SF-Novak_Djokovic-Rafael_Nadal,1,F-IO,32,15,1,6,8,16,16
20070812-M-Canada_Masters-SF-Novak_Djokovic-Rafael_Nadal,1,F-II,2,0,0,0,0,1,1
20070812-M-Canada_Masters-SF-Novak_Djokovic-Rafael_Nadal,1,B-XC,29,7,1,3,3,11,18
20070812-M-Canada_Masters-SF-Novak_Djokovic-Rafael_Nadal,1,B-DTM,26,2,0,0,2,13,13
20070812-M-Canada_Masters-SF-Novak_Djokovic-Rafael_Nadal,1,B-DTL,19,3,1,0,2,12,7
20070812-M-Canada_Masters-SF-Novak_Djokovic-Rafael_Nadal,1,B-IO,8,1,1,0,0,5,3
20070812-M-Canada_Masters-SF-Novak_Djokovic-Rafael_Nadal,1,S-DTL,3,1,0,1,0,3,0
20070812-M-Canada_Masters-SF-Novak_Djokovic-Rafael_Nadal,2,F-XC,49,0,0,0,0,27,22
20070812-M-Canada_Masters-SF-Novak_Djokovic-Rafael_Nadal,2,F-DTM,14,0,0,0,0,8,6
20070812-M-Canada_Masters-SF-Novak_Djokovic-Rafael_Nadal,2,F-DTL,11,2,2,0,0,7,4
20070812-M-Canada_Masters-SF-Novak_Djokovic-Rafael_Nadal,2,F-IO,17,4,3,0,1,9,8
20070812-M-Canada_Masters-SF-Novak_Djokovic-Rafael_Nadal,2,F-II,11,2,0,1,1,4,7
20070812-M-Canada_Masters-SF-Novak_Djokovic-Rafael_Nadal,2,B-XC,36,6,2,2,2,19,17
20070812-M-Canada_Masters-SF-Novak_Djokovic-Rafael_Nadal,2,B-DTM,15,4,0,1,3,6,9
20070812-M-Canada_Masters-SF-Novak_Djokovic-Rafael_Nadal,2,B-DTL,16,2,0,1,1,6,10
20070812-M-Canada_Masters-SF-Novak_Djokovic-Rafael_Nadal,2,B-IO,2,2,1,0,1,1,1
20070812-M-Canada_Masters-SF-Novak_Djokovic-Rafael_Nadal,2,S-XC,3,1,1,0,0,1,2
20070812-M-Canada_Masters-SF-Novak_Djokovic-Rafael_Nadal,2,S-DTM,10,0,0,0,0,3,7
20070812-M-Canada_Masters-SF-Novak_Djokovic-Rafael_Nadal,2,S-DTL,2,1,0,1,0,1,1
20070812-M-Canada_Masters-SF-Novak_Djokovic-Rafael_Nadal,2,S-IO,2,0,0,0,0,1,1
20130810-M-Canada_Masters-SF-Novak_Djokovic-Rafael_Nadal,1,F-XC,84,17,3,6,8,43,41
20130810-M-Canada_Masters-SF-Novak_Djokovic-Rafael_Nadal,1,F-DTM,20,3,0,0,3,9,11
20130810-M-Canada_Masters-SF-Novak_Djokovic-Rafael_Nadal,1,F-DTL,12,5,1,1,3,8,4
20130810-M-Canada_Masters-SF-Novak_Djokovic-Rafael_Nadal,1,F-IO,34,16,2,6,8,16,18
20130810-M-Canada_Masters-SF-Novak_Djokovic-Rafael_Nadal,1,F-II,3,2,1,0,1,2,1
20130810-M-Canada_Masters-SF-Novak_Djokovic-Rafael_Nadal,1,B-XC,51,10,3,4,3,34,17
20130810-M-Canada_Masters-SF-Novak_Djokovic-Rafael_Nadal,1,B-DTM,38,2,0,0,2,17,21
20130810-M-Canada_Masters-SF-Novak_Djokovic-Rafael_Nadal,1,B-DTL,23,4,2,0,2,10,13
20130810-M-Canada_Masters-SF-Novak_Djokovic-Rafael_Nadal,1,B-IO,11,1,0,1,0,7,4
20130810-M-Canada_Masters-SF-Novak_Djokovic-Rafael_Nadal,1,S-DTM,2,0,0,0,0,0,2
20130810-M-Canada_Masters-SF-Novak_Djokovic-Rafael_Nadal,1,S-DTL,1,0,0,0,0,0,1
20130810-M-Canada_Masters-SF-Novak_Djokovic-Rafael_Nadal,1,S-IO,1,0,0,0,0,1,0
20130810-M-Canada_Masters-SF-Novak_Djokovic-Rafael_Nadal,2,F-XC,74,12,3,3,6,33,41
20130810-M-Canada_Masters-SF-Novak_Djokovic-Rafael_Nadal,2,F-DTM,36,1,0,0,1,22,14
20130810-M-Canada_Masters-SF-Novak_Djokovic-Rafael_Nadal,2,F-DTL,17,10,2,4,4,8,9
20130810-M-Canada_Masters-SF-Novak_Djokovic-Rafael_Nadal,2,F-IO,42,12,4,4,4,27,15
20130810-M-Canada_Masters-SF-Novak_Djokovic-Rafael_Nadal,2,F-II,10,2,0,0,2,4,6
20130810-M-Canada_Masters-SF-Novak_Djokovic-Rafael_Nadal,2,B-XC,30,4,1,2,1,16,14
20130810-M-Canada_Masters-SF-Novak_Djokovic-Rafael_Nadal,2,B-DTM,32,8,0,1,7,11,21
20130810-M-Canada_Masters-SF-Novak_Djokovic-Rafael_Nadal,2,B-DTL,8,1,0,1,0,4,4
20130810-M-Canada_Masters-SF-Novak_Djokovic-Rafael_Nadal,2,B-IO,3,0,0,0,0,2,1
20130810-M-Canada_Masters-SF-Novak_Djokovic-Rafael_Nadal,2,S-XC,3,0,0,0,0,2,1
20130810-M-Canada_Masters-SF-Novak_Djokovic-Rafael_Nadal,2,S-DTM,12,0,0,0,0,4,8
20130810-M-Canada_Masters-SF-Novak_Djokovic-Rafael_Nadal,2,S-DTL,8,0,0,0,0,4,4
20130810-M-Canada_Masters-SF-Novak_Djokovic-Rafael_Nadal,2,S-IO,3,0,0,0,0,2,1
20160513-M-Rome_Masters-QF-Novak_Djokovic-Rafael_Nadal,1,F-XC,88,6,3,1,2,51,37
20160513-M-Rome_Masters-QF-Novak_Djokovic-Rafael_Nadal,1,F-DTM,29,4,0,0,4,11,18
20160513-M-Rome_Masters-QF-Novak_Djokovic-Rafael_Nadal,1,F-DTL,20,9,3,3,3,12,8
20160513-M-Rome_Masters-QF-Novak_Djokovic-Rafael_Nadal,1,F-IO,50,13,5,4,4,28,22
20160513-M-Rome_Masters-QF-Novak_Djokovic-Rafael_Nadal,1,F-II,3,2,1,1,0,3,0
20160513-M-Rome_Masters-QF-Novak_Djokovic-Rafael_Nadal,1,B-XC,63,14,4,5,5,40,23
20160513-M-Rome_Masters-QF-Novak_Djokovic-Rafael_Nadal,1,B-DTM,30,2,0,1,1,17,13
20160513-M-Rome_Masters-QF-Novak_Djokovic-Rafael_Nadal,1,B-DTL,29,5,0,4,1,14,15
20160513-M-Rome_Masters-QF-Novak_Djokovic-Rafael_Nadal,1,B-IO,17,1,0,0,1,12,5
20160513-M-Rome_Masters-QF-Novak_Djokovic-Rafael_Nadal,1,S-XC,3,0,0,0,0,1,2
20160513-M-Rome_Masters-QF-Novak_Djokovic-Rafael_Nadal,1,S-DTM,2,0,0,0,0,1,1
20160513-M-Rome_Masters-QF-Novak_Djokovic-Rafael_Nadal,1,S-DTL,1,0,0,0,0,1,0
20160513-M-Rome_Masters-QF-Novak_Djokovic-Rafael_Nadal,1,S-IO,2,0,0,0,0,2,0
20160513-M-Rome_Masters-QF-Novak_Djokovic-Rafael_Nadal,2,F-XC,80,12,3,2,7,39,41
20160513-M-Rome_Masters-QF-Novak_Djokovic-Rafael_Nadal,2,F-DTM,37,1,1,0,0,14,23
20160513-M-Rome_Masters-QF-Novak_Djokovic-Rafael_Nadal,2,F-DTL,19,6,1,2,3,11,8
20160513-M-Rome_Masters-QF-Novak_Djokovic-Rafael_Nadal,2,F-IO,35,14,3,7,4,22,13
20160513-M-Rome_Masters-QF-Novak_Djokovic-Rafael_Nadal,2,F-II,8,2,1,0,1,3,5
20160513-M-Rome_Masters-QF-Novak_Djokovic-Rafael_Nadal,2,B-XC,62,7,3,0,4,25,37
20160513-M-Rome_Masters-QF-Novak_Djokovic-Rafael_Nadal,2,B-DTM,47,0,0,0,0,23,24
20160513-M-Rome_Masters-QF-Novak_Djokovic-Rafael_Nadal,2,B-DTL,25,5,0,4,1,12,13
20160513-M-Rome_Masters-QF-Novak_Djokovic-Rafael_Nadal,2,B-IO,4,1,0,0,1,3,1
20160513-M-Rome_Masters-QF-Novak_Djokovic-Rafael_Nadal,2,S-XC,2,1,0,1,0,2,0
20160513-M-Rome_Masters-QF-Novak_Djokovic-Rafael_Nadal,2,S-DTM,9,1,0,0,1,1,8
20160513-M-Rome_Masters-QF-Novak_Djokovic-Rafael_Nadal,2,S-DTL,11,2,2,0,0,6,5
20070511-M-Rome_Masters-QF-Novak_Djokovic-Rafael_Nadal,1,F-XC,52,5,1,1,3,14,38
20070511-M-Rome_Masters-QF-Novak_Djokovic-Rafael_Nadal,1,F-DTM,14,0,0,0,0,3,11
20070511-M-Rome_Masters-QF-Novak_Djokovic-Rafael_Nadal,1,F-DTL,17,6,1,0,5,4,13
20070511-M-Rome_Masters-QF-Novak_Djokovic-Rafael_Nadal,1,F-IO,34,12,5,4,3,17,17
20070511-M-Rome_Masters-QF-Novak_Djokovic-Rafael_Nadal,1,F-II,3,1,1,0,0,1,2
20070511-M-Rome_Masters-QF-Novak_Djokovic-Rafael_Nadal,1,B-XC,30,8,1,2,5,10,20
20070511-M-Rome_Masters-QF-Novak_Djokovic-Rafael_Nadal,1,B-DTM,33,2,0,0,2,13,20
20070511-M-Rome_Masters-QF-Novak_Djokovic-Rafael_Nadal,1,B-DTL,29,5,1,2,2,10,19
20070511-M-Rome_Masters-QF-Novak_Djokovic-Rafael_Nadal,1,B-IO,12,2,0,0,2,4,8
20070511-M-Rome_Masters-QF-Novak_Djokovic-Rafael_Nadal,1,S-DTM,2,0,0,0,0,0,2
20070511-M-Rome_Masters-QF-Novak_Djokovic-Rafael_Nadal,1,S-DTL,1,0,0,0,0,1,0
20070511-M-Rome_Masters-QF-Novak_Djokovic-Rafael_Nadal,2,F-XC,55,7,4,1,2,33,22
20070511-M-Rome_Masters-QF-Novak_Djokovic-Rafael_Nadal,2,F-DTM,15,0,0,0,0,7,8
20070511-M-Rome_Masters-QF-Novak_Djokovic-Rafael_Nadal,2,F-DTL,14,6,5,0,1,12,2
20070511-M-Rome_Masters-QF-Novak_Djokovic-Rafael_Nadal,2,F-IO,26,8,3,2,3,22,4
20070511-M-Rome_Masters-QF-Novak_Djokovic-Rafael_Nadal,2,F-II,15,3,2,1,0,13,2
20070511-M-Rome_Masters-QF-Novak_Djokovic-Rafael_Nadal,2,B-XC,34,4,0,3,1,23,11
20070511-M-Rome_Masters-QF-Novak_Djokovic-Rafael_Nadal,2,B-DTM,14,0,0,0,0,10,4
20070511-M-Rome_Masters-QF-Novak_Djokovic-Rafael_Nadal,2,B-DTL,13,1,1,0,0,10,3
20070511-M-Rome_Masters-QF-Novak_Djokovic-Rafael_Nadal,2,B-IO,7,1,1,0,0,7,0
20070511-M-Rome_Masters-QF-Novak_Djokovic-Rafael_Nadal,2,S-XC,6,2,2,0,0,5,1
20070511-M-Rome_Masters-QF-Novak_Djokovic-Rafael_Nadal,2,S-DTM,7,0,0,0,0,7,0
20070511-M-Rome_Masters-QF-Novak_Djokovic-Rafael_Nadal,2,S-DTL,5,1,0,0,1,2,3
20180916-M-Davis_Cup_World_Group_SF-RR-Francis_Tiafoe-Borna_Coric,1,F-XC,75,14,5,2,7,33,42
20180916-M-Davis_Cup_World_Group_SF-RR-Francis_Tiafoe-Borna_Coric,1,F-DTM,48,5,0,0,5,19,29
20180916-M-Davis_Cup_World_Group_SF-RR-Francis_Tiafoe-Borna_Coric,1,F-DTL,14,7,4,0,3,7,7
20180916-M-Davis_Cup_World_Group_SF-RR-Francis_Tiafoe-Borna_Coric,1,F-IO,16,5,2,1,2,9,7
20180916-M-Davis_Cup_World_Group_SF-RR-Francis_Tiafoe-Borna_Coric,1,F-II,6,3,1,1,1,3,3
20180916-M-Davis_Cup_World_Group_SF-RR-Francis_Tiafoe-Borna_Coric,1,B-XC,112,10,0,0,10,49,63
20180916-M-Davis_Cup_World_Group_SF-RR-Francis_Tiafoe-Borna_Coric,1,B-DTM,93,7,1,0,6,33,60
20180916-M-Davis_Cup_World_Group_SF-RR-Francis_Tiafoe-Borna_Coric,1,B-DTL,14,4,2,1,1,7,7
20180916-M-Davis_Cup_World_Group_SF-RR-Francis_Tiafoe-Borna_Coric,1,B-IO,8,3,0,1,2,2,6
20180916-M-Davis_Cup_World_Group_SF-RR-Francis_Tiafoe-Borna_Coric,1,S-XC,23,5,0,0,5,6,17
20180916-M-Davis_Cup_World_Group_SF-RR-Francis_Tiafoe-Borna_Coric,1,S-DTM,14,1,0,0,1,4,10
20180916-M-Davis_Cup_World_Group_SF-RR-Francis_Tiafoe-Borna_Coric,1,S-DTL,7,0,0,0,0,2,5
20180916-M-Davis_Cup_World_Group_SF-RR-Francis_Tiafoe-Borna_Coric,1,S-IO,1,0,0,0,0,0,1
20180916-M-Davis_Cup_World_Group_SF-RR-Francis_Tiafoe-Borna_Coric,2,F-XC,110,36,6,16,14,69,41
20180916-M-Davis_Cup_World_Group_SF-RR-Francis_Tiafoe-Borna_Coric,2,F-DTM,42,6,1,0,5,22,20
20180916-M-Davis_Cup_World_Group_SF-RR-Francis_Tiafoe-Borna_Coric,2,F-DTL,32,9,4,1,4,19,13
20180916-M-Davis_Cup_World_Group_SF-RR-Francis_Tiafoe-Borna_Coric,2,F-IO,71,22,10,7,5,47,24
20180916-M-Davis_Cup_World_Group_SF-RR-Francis_Tiafoe-Borna_Coric,2,F-II,7,1,0,0,1,2,5
20180916-M-Davis_Cup_World_Group_SF-RR-Francis_Tiafoe-Borna_Coric,2,B-XC,107,15,3,3,9,63,44
20180916-M-Davis_Cup_World_Group_SF-RR-Francis_Tiafoe-Borna_Coric,2,B-DTM,50,3,0,1,2,29,21
20180916-M-Davis_Cup_World_Group_SF-RR-Francis_Tiafoe-Borna_Coric,2,B-DTL,16,9,3,1,5,8,8
20180916-M-Davis_Cup_World_Group_SF-RR-Francis_Tiafoe-Borna_Coric,2,B-IO,7,4,1,1,2,4,3
20180916-M-Davis_Cup_World_Group_SF-RR-Francis_Tiafoe-Borna_Coric,2,S-XC,11,1,0,0,1,5,6
20180916-M-Davis_Cup_World_Group_SF-RR-Francis_Tiafoe-Borna_Coric,2,S-DTM,3,1,0,0,1,1,2
20180916-M-Davis_Cup_World_Group_SF-RR-Francis_Tiafoe-Borna_Coric,2,S-IO,1,0,0,0,0,0,1
20090822-M-Cincinnati_Masters-SF-Novak_Djokovic-Rafael_Nadal,1,F-XC,54,7,2,2,3,25,29
20090822-M-Cincinnati_Masters-SF-Novak_Djokovic-Rafael_Nadal,1,F-DTM,17,4,0,0,4,8,9
20090822-M-Cincinnati_Masters-SF-Novak_Djokovic-Rafael_Nadal,1,F-DTL,9,6,2,0,4,4,5
20090822-M-Cincinnati_Masters-SF-Novak_Djokovic-Rafael_Nadal,1,F-IO,32,8,5,1,2,19,13
20090822-M-Cincinnati_Masters-SF-Novak_Djokovic-Rafael_Nadal,1,F-II,1,0,0,0,0,1,0
20090822-M-Cincinnati_Masters-SF-Novak_Djokovic-Rafael_Nadal,1,B-XC,36,6,1,1,4,20,16
20090822-M-Cincinnati_Masters-SF-Novak_Djokovic-Rafael_Nadal,1,B-DTM,26,2,0,0,2,13,13
20090822-M-Cincinnati_Masters-SF-Novak_Djokovic-Rafael_Nadal,1,B-DTL,21,6,2,2,2,9,12
20090822-M-Cincinnati_Masters-SF-Novak_Djokovic-Rafael_Nadal,1,B-IO,7,1,1,0,0,3,4
20090822-M-Cincinnati_Masters-SF-Novak_Djokovic-Rafael_Nadal,1,S-XC,1,1,0,0,1,0,1
20090822-M-Cincinnati_Masters-SF-Novak_Djokovic-Rafael_Nadal,1,S-DTM,2,0,0,0,0,1,1
20090822-M-Cincinnati_Masters-SF-Novak_Djokovic-Rafael_Nadal,1,S-DTL,2,0,0,0,0,0,2
20090822-M-Cincinnati_Masters-SF-Novak_Djokovic-Rafael_Nadal,1,S-IO,1,0,0,0,0,1,0
20090822-M-Cincinnati_Masters-SF-Novak_Djokovic-Rafael_Nadal,2,F-XC,63,6,0,1,5,25,38
20090822-M-Cincinnati_Masters-SF-Novak_Djokovic-Rafael_Nadal,2,F-DTM,28,1,0,0,1,12,16
20090822-M-Cincinnati_Masters-SF-Novak_Djokovic-Rafael_Nadal,2,F-DTL,13,3,1,1,1,8,5
20090822-M-Cincinnati_Masters-SF-Novak_Djokovic-Rafael_Nadal,2,F-IO,19,5,2,0,3,13,6
20090822-M-Cincinnati_Masters-SF-Novak_Djokovic-Rafael_Nadal,2,F-II,5,1,0,1,0,4,1
20090822-M-Cincinnati_Masters-SF-Novak_Djokovic-Rafael_Nadal,2,B-XC,30,3,1,0,2,17,13
20090822-M-Cincinnati_Masters-SF-Novak_Djokovic-Rafael_Nadal,2,B-DTM,13,0,0,0,0,6,7
20090822-M-Cincinnati_Masters-SF-Novak_Djokovic-Rafael_Nadal,2,B-DTL,10,4,1,1,2,6,4
20090822-M-Cincinnati_Masters-SF-Novak_Djokovic-Rafael_Nadal,2,B-IO,3,0,0,0,0,2,1
20090822-M-Cincinnati_Masters-SF-Novak_Djokovic-Rafael_Nadal,2,S-XC,6,1,0,0,1,3,3
20090822-M-Cincinnati_Masters-SF-Novak_Djokovic-Rafael_Nadal,2,S-DTM,8,0,0,0,0,4,4
20090822-M-Cincinnati_Masters-SF-Novak_Djokovic-Rafael_Nadal,2,S-DTL,7,2,1,1,0,4,3
20090822-M-Cincinnati_Masters-SF-Novak_Djokovic-Rafael_Nadal,2,S-IO,1,0,0,0,0,1,0
19950514-M-Hamburg_Masters-F-Andrei_Medvedev-Goran_Ivanisevic,1,F-XC,36,10,2,4,4,24,12
19950514-M-Hamburg_Masters-F-Andrei_Medvedev-Goran_Ivanisevic,1,F-DTM,43,1,1,0,0,32,11
19950514-M-Hamburg_Masters-F-Andrei_Medvedev-Goran_Ivanisevic,1,F-DTL,7,1,0,0,1,3,4
19950514-M-Hamburg_Masters-F-Andrei_Medvedev-Goran_Ivanisevic,1,F-IO,15,5,4,0,1,11,4
19950514-M-Hamburg_Masters-F-Andrei_Medvedev-Goran_Ivanisevic,1,B-XC,52,10,1,6,3,37,15
19950514-M-Hamburg_Masters-F-Andrei_Medvedev-Goran_Ivanisevic,1,B-DTM,52,2,0,1,1,41,11
19950514-M-Hamburg_Masters-F-Andrei_Medvedev-Goran_Ivanisevic,1,B-DTL,11,3,2,0,1,9,2
19950514-M-Hamburg_Masters-F-Andrei_Medvedev-Goran_Ivanisevic,1,B-IO,9,1,0,0,1,5,4
19950514-M-Hamburg_Masters-F-Andrei_Medvedev-Goran_Ivanisevic,1,S-XC,1,0,0,0,0,1,0
19950514-M-Hamburg_Masters-F-Andrei_Medvedev-Goran_Ivanisevic,1,S-DTM,7,0,0,0,0,4,3
19950514-M-Hamburg_Masters-F-Andrei_Medvedev-Goran_Ivanisevic,1,S-DTL,2,0,0,0,0,1,1
19950514-M-Hamburg_Masters-F-Andrei_Medvedev-Goran_Ivanisevic,1,S-IO,4,0,0,0,0,2,2
19950514-M-Hamburg_Masters-F-Andrei_Medvedev-Goran_Ivanisevic,2,F-XC,55,10,0,1,9,10,45
19950514-M-Hamburg_Masters-F-Andrei_Medvedev-Goran_Ivanisevic,2,F-DTM,61,3,0,0,3,17,44
19950514-M-Hamburg_Masters-F-Andrei_Medvedev-Goran_Ivanisevic,2,F-DTL,10,2,1,0,1,5,5
19950514-M-Hamburg_Masters-F-Andrei_Medvedev-Goran_Ivanisevic,2,F-IO,33,14,1,4,9,12,21
19950514-M-Hamburg_Masters-F-Andrei_Medvedev-Goran_Ivanisevic,2,F-II,3,1,0,0,1,0,3
19950514-M-Hamburg_Masters-F-Andrei_Medvedev-Goran_Ivanisevic,2,B-XC,5,1,0,0,1,1,4
19950514-M-Hamburg_Masters-F-Andrei_Medvedev-Goran_Ivanisevic,2,B-DTM,38,4,0,0,4,12,26
19950514-M-Hamburg_Masters-F-Andrei_Medvedev-Goran_Ivanisevic,2,B-DTL,16,3,0,0,3,3,13
19950514-M-Hamburg_Masters-F-Andrei_Medvedev-Goran_Ivanisevic,2,B-IO,11,0,0,0,0,1,10
19950514-M-Hamburg_Masters-F-Andrei_Medvedev-Goran_Ivanisevic,2,S-DTM,3,1,0,0,1,0,3
19950514-M-Hamburg_Masters-F-Andrei_Medvedev-Goran_Ivanisevic,2,S-DTL,1,0,0,0,0,0,1
19950514-M-Hamburg_Masters-F-Andrei_Medvedev-Goran_Ivanisevic,2,S-IO,1,0,0,0,0,0,1
20091127-M-Tour_Finals-RR-Rafael_Nadal-Novak_Djokovic,1,F-XC,61,5,0,0,5,24,37
20091127-M-Tour_Finals-RR-Rafael_Nadal-Novak_Djokovic,1,F-DTM,30,2,0,0,2,12,18
20091127-M-Tour_Finals-RR-Rafael_Nadal-Novak_Djokovic,1,F-DTL,15,4,0,2,2,3,12
20091127-M-Tour_Finals-RR-Rafael_Nadal-Novak_Djokovic,1,F-IO,31,11,2,4,5,12,19
20091127-M-Tour_Finals-RR-Rafael_Nadal-Novak_Djokovic,1,F-II,8,3,0,2,1,5,3
20091127-M-Tour_Finals-RR-Rafael_Nadal-Novak_Djokovic,1,B-XC,43,6,0,0,6,11,32
20091127-M-Tour_Finals-RR-Rafael_Nadal-Novak_Djokovic,1,B-DTM,27,3,0,0,3,5,22
20091127-M-Tour_Finals-RR-Rafael_Nadal-Novak_Djokovic,1,B-DTL,12,4,2,0,2,2,10
20091127-M-Tour_Finals-RR-Rafael_Nadal-Novak_Djokovic,1,B-IO,4,1,0,0,1,0,4
20091127-M-Tour_Finals-RR-Rafael_Nadal-Novak_Djokovic,1,S-XC,2,0,0,0,0,0,2
20091127-M-Tour_Finals-RR-Rafael_Nadal-Novak_Djokovic,1,S-DTM,13,0,0,0,0,1,12
20091127-M-Tour_Finals-RR-Rafael_Nadal-Novak_Djokovic,1,S-DTL,4,0,0,0,0,2,2
20091127-M-Tour_Finals-RR-Rafael_Nadal-Novak_Djokovic,1,S-IO,2,0,0,0,0,1,1
20091127-M-Tour_Finals-RR-Rafael_Nadal-Novak_Djokovic,2,F-XC,80,8,0,4,4,60,20
20091127-M-Tour_Finals-RR-Rafael_Nadal-Novak_Djokovic,2,F-DTM,29,2,0,0,2,21,8
20091127-M-Tour_Finals-RR-Rafael_Nadal-Novak_Djokovic,2,F-DTL,14,4,1,1,2,10,4
20091127-M-Tour_Finals-RR-Rafael_Nadal-Novak_Djokovic,2,F-IO,45,16,5,3,8,26,19
20091127-M-Tour_Finals-RR-Rafael_Nadal-Novak_Djokovic,2,F-II,4,1,1,0,0,1,3
20091127-M-Tour_Finals-RR-Rafael_Nadal-Novak_Djokovic,2,B-XC,32,10,2,3,5,20,12
20091127-M-Tour_Finals-RR-Rafael_Nadal-Novak_Djokovic,2,B-DTM,23,3,0,0,3,14,9
20091127-M-Tour_Finals-RR-Rafael_Nadal-Novak_Djokovic,2,B-DTL,17,7,2,2,3,10,7
20091127-M-Tour_Finals-RR-Rafael_Nadal-Novak_Djokovic,2,B-IO,1,1,0,0,1,0,1
20091127-M-Tour_Finals-RR-Rafael_Nadal-Novak_Djokovic,2,S-DTM,3,0,0,0,0,3,0
20091127-M-Tour_Finals-RR-Rafael_Nadal-Novak_Djokovic,2,S-DTL,2,0,0,0,0,1,1
20091127-M-Tour_Finals-RR-Rafael_Nadal-Novak_Djokovic,2,S-IO,2,0,0,0,0,2,0
20071115-M-Tour_Finals-RR-Novak_Djokovic-Rafael_Nadal,1,F-XC,49,4,0,2,2,23,26
20071115-M-Tour_Finals-RR-Novak_Djokovic-Rafael_Nadal,1,F-DTM,13,2,0,0,2,6,7
20071115-M-Tour_Finals-RR-Novak_Djokovic-Rafael_Nadal,1,F-DTL,12,7,2,0,5,4,8
20071115-M-Tour_Finals-RR-Novak_Djokovic-Rafael_Nadal,1,F-IO,32,9,3,3,3,14,18
20071115-M-Tour_Finals-RR-Novak_Djokovic-Rafael_Nadal,1,F-II,7,1,1,0,0,4,3
20071115-M-Tour_Finals-RR-Novak_Djokovic-Rafael_Nadal,1,B-XC,27,6,1,3,2,17,10
20071115-M-Tour_Finals-RR-Novak_Djokovic-Rafael_Nadal,1,B-DTM,32,5,0,0,5,12,20
20071115-M-Tour_Finals-RR-Novak_Djokovic-Rafael_Nadal,1,B-DTL,26,7,1,0,6,5,21
20071115-M-Tour_Finals-RR-Novak_Djokovic-Rafael_Nadal,1,B-IO,5,1,0,0,1,2,3
20071115-M-Tour_Finals-RR-Novak_Djokovic-Rafael_Nadal,1,S-DTM,2,0,0,0,0,1,1
20071115-M-Tour_Finals-RR-Novak_Djokovic-Rafael_Nadal,1,S-DTL,3,0,0,0,0,1,2
20071115-M-Tour_Finals-RR-Novak_Djokovic-Rafael_Nadal,2,F-XC,46,4,2,1,1,28,18
20071115-M-Tour_Finals-RR-Novak_Djokovic-Rafael_Nadal,2,F-DTM,19,0,0,0,0,10,9
20071115-M-Tour_Finals-RR-Novak_Djokovic-Rafael_Nadal,2,F-DTL,18,8,3,3,2,9,9
20071115-M-Tour_Finals-RR-Novak_Djokovic-Rafael_Nadal,2,F-IO,17,3,1,2,0,9,8
20071115-M-Tour_Finals-RR-Novak_Djokovic-Rafael_Nadal,2,F-II,2,0,0,0,0,1,1
20071115-M-Tour_Finals-RR-Novak_Djokovic-Rafael_Nadal,2,B-XC,36,7,1,3,3,23,13
20071115-M-Tour_Finals-RR-Novak_Djokovic-Rafael_Nadal,2,B-DTM,22,0,0,0,0,13,9
20071115-M-Tour_Finals-RR-Novak_Djokovic-Rafael_Nadal,2,B-DTL,19,4,2,2,0,10,9
20071115-M-Tour_Finals-RR-Novak_Djokovic-Rafael_Nadal,2,B-IO,6,1,1,0,0,4,2
20071115-M-Tour_Finals-RR-Novak_Djokovic-Rafael_Nadal,2,B-II,1,0,0,0,0,1,0
20071115-M-Tour_Finals-RR-Novak_Djokovic-Rafael_Nadal,2,S-XC,2,0,0,0,0,2,0
20071115-M-Tour_Finals-RR-Novak_Djokovic-Rafael_Nadal,2,S-DTM,5,0,0,0,0,5,0
20071115-M-Tour_Finals-RR-Novak_Djokovic-Rafael_Nadal,2,S-DTL,3,0,0,0,0,2,1
20180923-M-Metz-F-Matthias_Bachinger-Gilles_Simon,1,F-XC,23,6,1,2,3,9,14
20180923-M-Metz-F-Matthias_Bachinger-Gilles_Simon,1,F-DTM,11,0,0,0,0,2,9
20180923-M-Metz-F-Matthias_Bachinger-Gilles_Simon,1,F-DTL,10,6,1,0,5,3,7
20180923-M-Metz-F-Matthias_Bachinger-Gilles_Simon,1,F-IO,12,4,2,1,1,8,4
20180923-M-Metz-F-Matthias_Bachinger-Gilles_Simon,1,B-XC,16,7,0,2,5,6,10
20180923-M-Metz-F-Matthias_Bachinger-Gilles_Simon,1,B-DTM,9,0,0,0,0,2,7
20180923-M-Metz-F-Matthias_Bachinger-Gilles_Simon,1,B-DTL,6,1,0,0,1,4,2
20180923-M-Metz-F-Matthias_Bachinger-Gilles_Simon,1,B-IO,3,1,0,0,1,0,3
20180923-M-Metz-F-Matthias_Bachinger-Gilles_Simon,1,S-XC,4,0,0,0,0,0,4
20180923-M-Metz-F-Matthias_Bachinger-Gilles_Simon,1,S-DTM,4,1,0,0,1,1,3
20180923-M-Metz-F-Matthias_Bachinger-Gilles_Simon,2,F-XC,25,5,3,0,2,17,8
20180923-M-Metz-F-Matthias_Bachinger-Gilles_Simon,2,F-DTM,13,1,0,0,1,8,5
20180923-M-Metz-F-Matthias_Bachinger-Gilles_Simon,2,F-DTL,7,1,0,0,1,5,2
20180923-M-Metz-F-Matthias_Bachinger-Gilles_Simon,2,F-IO,13,4,4,0,0,10,3
20180923-M-Metz-F-Matthias_Bachinger-Gilles_Simon,2,F-II,1,1,1,0,0,1,0
20180923-M-Metz-F-Matthias_Bachinger-Gilles_Simon,2,B-XC,17,6,2,2,2,12,5
20180923-M-Metz-F-Matthias_Bachinger-Gilles_Simon,2,B-DTM,11,1,0,0,1,5,6
20180923-M-Metz-F-Matthias_Bachinger-Gilles_Simon,2,B-DTL,16,6,3,2,1,9,7
20180923-M-Metz-F-Matthias_Bachinger-Gilles_Simon,2,S-XC,1,1,1,0,0,1,0
20080517-M-Hamburg_Masters-SF-Novak_Djokovic-Rafael_Nadal,1,F-XC,102,4,1,2,1,55,47
20080517-M-Hamburg_Masters-SF-Novak_Djokovic-Rafael_Nadal,1,F-DTM,29,4,0,0,4,14,15
20080517-M-Hamburg_Masters-SF-Novak_Djokovic-Rafael_Nadal,1,F-DTL,23,13,4,2,7,10,13
20080517-M-Hamburg_Masters-SF-Novak_Djokovic-Rafael_Nadal,1,F-IO,60,24,2,13,9,33,27
20080517-M-Hamburg_Masters-SF-Novak_Djokovic-Rafael_Nadal,1,F-II,9,4,2,1,1,5,4
20080517-M-Hamburg_Masters-SF-Novak_Djokovic-Rafael_Nadal,1,B-XC,74,13,2,3,8,38,36
20080517-M-Hamburg_Masters-SF-Novak_Djokovic-Rafael_Nadal,1,B-DTM,64,3,0,2,1,32,32
20080517-M-Hamburg_Masters-SF-Novak_Djokovic-Rafael_Nadal,1,B-DTL,59,6,1,2,3,27,32
20080517-M-Hamburg_Masters-SF-Novak_Djokovic-Rafael_Nadal,1,B-IO,8,2,0,1,1,5,3
20080517-M-Hamburg_Masters-SF-Novak_Djokovic-Rafael_Nadal,1,S-DTM,2,0,0,0,0,1,1
20080517-M-Hamburg_Masters-SF-Novak_Djokovic-Rafael_Nadal,1,S-DTL,3,0,0,0,0,0,3
20080517-M-Hamburg_Masters-SF-Novak_Djokovic-Rafael_Nadal,1,S-IO,1,0,0,0,0,1,0
20080517-M-Hamburg_Masters-SF-Novak_Djokovic-Rafael_Nadal,2,F-XC,140,11,2,3,6,68,72
20080517-M-Hamburg_Masters-SF-Novak_Djokovic-Rafael_Nadal,2,F-DTM,36,2,0,1,1,19,17
20080517-M-Hamburg_Masters-SF-Novak_Djokovic-Rafael_Nadal,2,F-DTL,22,7,4,1,2,13,9
20080517-M-Hamburg_Masters-SF-Novak_Djokovic-Rafael_Nadal,2,F-IO,39,9,5,1,3,25,14
20080517-M-Hamburg_Masters-SF-Novak_Djokovic-Rafael_Nadal,2,F-II,15,1,1,0,0,9,6
20080517-M-Hamburg_Masters-SF-Novak_Djokovic-Rafael_Nadal,2,B-XC,65,10,3,2,5,29,36
20080517-M-Hamburg_Masters-SF-Novak_Djokovic-Rafael_Nadal,2,B-DTM,42,0,0,0,0,18,24
20080517-M-Hamburg_Masters-SF-Novak_Djokovic-Rafael_Nadal,2,B-DTL,27,2,0,2,0,16,11
20080517-M-Hamburg_Masters-SF-Novak_Djokovic-Rafael_Nadal,2,B-IO,8,0,0,0,0,3,5
20080517-M-Hamburg_Masters-SF-Novak_Djokovic-Rafael_Nadal,2,S-XC,8,4,1,3,0,5,3
20080517-M-Hamburg_Masters-SF-Novak_Djokovic-Rafael_Nadal,2,S-DTM,17,0,0,0,0,8,9
20080517-M-Hamburg_Masters-SF-Novak_Djokovic-Rafael_Nadal,2,S-DTL,10,1,0,1,0,3,7
20080517-M-Hamburg_Masters-SF-Novak_Djokovic-Rafael_Nadal,2,S-IO,2,0,0,0,0,0,2
20180803-M-Washington-R16-Hyeon_Chung-Alex_De_Minaur,1,F-XC,57,12,3,5,4,35,22
20180803-M-Washington-R16-Hyeon_Chung-Alex_De_Minaur,1,F-DTM,32,1,0,0,1,14,18
20180803-M-Washington-R16-Hyeon_Chung-Alex_De_Minaur,1,F-DTL,8,6,1,1,4,4,4
20180803-M-Washington-R16-Hyeon_Chung-Alex_De_Minaur,1,F-IO,30,13,5,2,6,14,16
20180803-M-Washington-R16-Hyeon_Chung-Alex_De_Minaur,1,F-II,2,1,1,0,0,1,1
20180803-M-Washington-R16-Hyeon_Chung-Alex_De_Minaur,1,B-XC,94,14,1,5,8,38,56
20180803-M-Washington-R16-Hyeon_Chung-Alex_De_Minaur,1,B-DTM,71,0,0,0,0,30,41
20180803-M-Washington-R16-Hyeon_Chung-Alex_De_Minaur,1,B-DTL,14,12,3,2,7,6,8
20180803-M-Washington-R16-Hyeon_Chung-Alex_De_Minaur,1,B-IO,9,5,1,0,4,4,5
20180803-M-Washington-R16-Hyeon_Chung-Alex_De_Minaur,1,S-XC,5,1,1,0,0,2,3
20180803-M-Washington-R16-Hyeon_Chung-Alex_De_Minaur,1,S-DTM,11,0,0,0,0,3,8
20180803-M-Washington-R16-Hyeon_Chung-Alex_De_Minaur,1,S-IO,1,1,1,0,0,1,0
20180803-M-Washington-R16-Hyeon_Chung-Alex_De_Minaur,2,F-XC,50,9,3,3,3,26,24
20180803-M-Washington-R16-Hyeon_Chung-Alex_De_Minaur,2,F-DTM,41,3,0,0,3,15,26
20180803-M-Washington-R16-Hyeon_Chung-Alex_De_Minaur,2,F-DTL,10,3,0,2,1,6,4
20180803-M-Washington-R16-Hyeon_Chung-Alex_De_Minaur,2,F-IO,55,6,1,2,3,33,22
20180803-M-Washington-R16-Hyeon_Chung-Alex_De_Minaur,2,F-II,1,0,0,0,0,0,1
20180803-M-Washington-R16-Hyeon_Chung-Alex_De_Minaur,2,B-XC,76,5,0,2,3,45,31
20180803-M-Washington-R16-Hyeon_Chung-Alex_De_Minaur,2,B-DTM,73,5,0,0,5,44,29
20180803-M-Washington-R16-Hyeon_Chung-Alex_De_Minaur,2,B-DTL,6,3,2,0,1,4,2
20180803-M-Washington-R16-Hyeon_Chung-Alex_De_Minaur,2,B-IO,3,0,0,0,0,1,2
20180803-M-Washington-R16-Hyeon_Chung-Alex_De_Minaur,2,S-XC,6,0,0,0,0,4,2
20180803-M-Washington-R16-Hyeon_Chung-Alex_De_Minaur,2,S-DTM,6,0,0,0,0,3,3
20050319-M-Indian_Wells_Masters-SF-Lleyton_Hewitt-Andy_Roddick,1,F-XC,84,16,7,5,4,50,34
20050319-M-Indian_Wells_Masters-SF-Lleyton_Hewitt-Andy_Roddick,1,F-DTM,25,2,0,0,2,16,9
20050319-M-Indian_Wells_Masters-SF-Lleyton_Hewitt-Andy_Roddick,1,F-DTL,28,5,4,0,1,16,12
20050319-M-Indian_Wells_Masters-SF-Lleyton_Hewitt-Andy_Roddick,1,F-IO,37,9,2,2,5,22,15
20050319-M-Indian_Wells_Masters-SF-Lleyton_Hewitt-Andy_Roddick,1,F-II,3,1,1,0,0,3,0
20050319-M-Indian_Wells_Masters-SF-Lleyton_Hewitt-Andy_Roddick,1,B-XC,98,18,6,5,7,60,38
20050319-M-Indian_Wells_Masters-SF-Lleyton_Hewitt-Andy_Roddick,1,B-DTM,34,3,0,1,2,19,15
20050319-M-Indian_Wells_Masters-SF-Lleyton_Hewitt-Andy_Roddick,1,B-DTL,10,4,2,1,1,7,3
20050319-M-Indian_Wells_Masters-SF-Lleyton_Hewitt-Andy_Roddick,1,B-IO,3,1,0,1,0,2,1
20050319-M-Indian_Wells_Masters-SF-Lleyton_Hewitt-Andy_Roddick,1,S-XC,9,1,0,1,0,3,6
20050319-M-Indian_Wells_Masters-SF-Lleyton_Hewitt-Andy_Roddick,1,S-DTM,8,0,0,0,0,4,4
20050319-M-Indian_Wells_Masters-SF-Lleyton_Hewitt-Andy_Roddick,1,S-DTL,1,1,0,1,0,1,0
20050319-M-Indian_Wells_Masters-SF-Lleyton_Hewitt-Andy_Roddick,1,S-IO,2,1,0,1,0,1,1
20050319-M-Indian_Wells_Masters-SF-Lleyton_Hewitt-Andy_Roddick,2,F-XC,72,14,2,6,6,34,38
20050319-M-Indian_Wells_Masters-SF-Lleyton_Hewitt-Andy_Roddick,2,F-DTM,20,3,0,1,2,10,10
20050319-M-Indian_Wells_Masters-SF-Lleyton_Hewitt-Andy_Roddick,2,F-DTL,26,10,4,3,3,11,15
20050319-M-Indian_Wells_Masters-SF-Lleyton_Hewitt-Andy_Roddick,2,F-IO,49,11,1,5,5,23,26
20050319-M-Indian_Wells_Masters-SF-Lleyton_Hewitt-Andy_Roddick,2,F-II,18,7,2,2,2,8,10
20050319-M-Indian_Wells_Masters-SF-Lleyton_Hewitt-Andy_Roddick,2,B-XC,58,10,1,1,8,21,37
20050319-M-Indian_Wells_Masters-SF-Lleyton_Hewitt-Andy_Roddick,2,B-DTM,24,2,0,0,2,7,17
20050319-M-Indian_Wells_Masters-SF-Lleyton_Hewitt-Andy_Roddick,2,B-DTL,17,5,2,1,2,11,6
20050319-M-Indian_Wells_Masters-SF-Lleyton_Hewitt-Andy_Roddick,2,B-IO,2,0,0,0,0,0,2
20050319-M-Indian_Wells_Masters-SF-Lleyton_Hewitt-Andy_Roddick,2,S-XC,24,2,0,0,2,10,14
20050319-M-Indian_Wells_Masters-SF-Lleyton_Hewitt-Andy_Roddick,2,S-DTM,4,2,0,0,2,0,4
20050319-M-Indian_Wells_Masters-SF-Lleyton_Hewitt-Andy_Roddick,2,S-DTL,6,2,0,1,1,2,4
20050319-M-Indian_Wells_Masters-SF-Lleyton_Hewitt-Andy_Roddick,2,S-IO,4,0,0,0,0,1,3
20050821-M-Cincinnati_Masters-SF-Lleyton_Hewitt-Andy_Roddick,1,F-XC,34,14,5,4,5,21,13
20050821-M-Cincinnati_Masters-SF-Lleyton_Hewitt-Andy_Roddick,1,F-DTM,10,1,0,0,1,5,5
20050821-M-Cincinnati_Masters-SF-Lleyton_Hewitt-Andy_Roddick,1,F-DTL,12,5,3,2,0,9,3
20050821-M-Cincinnati_Masters-SF-Lleyton_Hewitt-Andy_Roddick,1,F-IO,25,4,3,0,1,15,10
20050821-M-Cincinnati_Masters-SF-Lleyton_Hewitt-Andy_Roddick,1,F-II,4,2,2,0,0,3,1
20050821-M-Cincinnati_Masters-SF-Lleyton_Hewitt-Andy_Roddick,1,B-XC,38,9,5,1,3,26,12
20050821-M-Cincinnati_Masters-SF-Lleyton_Hewitt-Andy_Roddick,1,B-DTM,7,2,0,1,1,3,4
20050821-M-Cincinnati_Masters-SF-Lleyton_Hewitt-Andy_Roddick,1,B-DTL,10,3,2,1,0,7,3
20050821-M-Cincinnati_Masters-SF-Lleyton_Hewitt-Andy_Roddick,1,B-IO,5,1,0,0,1,1,4
20050821-M-Cincinnati_Masters-SF-Lleyton_Hewitt-Andy_Roddick,1,S-XC,6,1,1,0,0,3,3
20050821-M-Cincinnati_Masters-SF-Lleyton_Hewitt-Andy_Roddick,1,S-DTL,1,0,0,0,0,0,1
20050821-M-Cincinnati_Masters-SF-Lleyton_Hewitt-Andy_Roddick,1,S-IO,2,1,0,0,1,1,1
20050821-M-Cincinnati_Masters-SF-Lleyton_Hewitt-Andy_Roddick,2,F-XC,22,5,1,2,2,11,11
20050821-M-Cincinnati_Masters-SF-Lleyton_Hewitt-Andy_Roddick,2,F-DTM,10,0,0,0,0,5,5
20050821-M-Cincinnati_Masters-SF-Lleyton_Hewitt-Andy_Roddick,2,F-DTL,15,4,1,1,2,9,6
20050821-M-Cincinnati_Masters-SF-Lleyton_Hewitt-Andy_Roddick,2,F-IO,13,4,3,0,1,6,7
20050821-M-Cincinnati_Masters-SF-Lleyton_Hewitt-Andy_Roddick,2,F-II,6,2,1,0,1,4,2
20050821-M-Cincinnati_Masters-SF-Lleyton_Hewitt-Andy_Roddick,2,B-XC,11,2,0,0,2,4,7
20050821-M-Cincinnati_Masters-SF-Lleyton_Hewitt-Andy_Roddick,2,B-DTM,2,0,0,0,0,2,0
20050821-M-Cincinnati_Masters-SF-Lleyton_Hewitt-Andy_Roddick,2,B-DTL,2,0,0,0,0,0,2
20050821-M-Cincinnati_Masters-SF-Lleyton_Hewitt-Andy_Roddick,2,S-XC,21,2,0,1,1,7,14
20050821-M-Cincinnati_Masters-SF-Lleyton_Hewitt-Andy_Roddick,2,S-DTM,17,1,0,1,0,9,8
20050821-M-Cincinnati_Masters-SF-Lleyton_Hewitt-Andy_Roddick,2,S-DTL,3,0,0,0,0,1,2
20050821-M-Cincinnati_Masters-SF-Lleyton_Hewitt-Andy_Roddick,2,S-IO,1,0,0,0,0,1,0
20180916-M-Davis_Cup_World_Group_SF-RR-Marcel_Granollers-Nicolas_Mahut,1,F-XC,24,4,2,2,0,13,11
20180916-M-Davis_Cup_World_Group_SF-RR-Marcel_Granollers-Nicolas_Mahut,1,F-DTM,18,0,0,0,0,3,15
20180916-M-Davis_Cup_World_Group_SF-RR-Marcel_Granollers-Nicolas_Mahut,1,F-DTL,14,4,2,0,2,9,5
20180916-M-Davis_Cup_World_Group_SF-RR-Marcel_Granollers-Nicolas_Mahut,1,F-IO,15,3,1,1,1,8,7
20180916-M-Davis_Cup_World_Group_SF-RR-Marcel_Granollers-Nicolas_Mahut,1,F-II,1,0,0,0,0,1,0
20180916-M-Davis_Cup_World_Group_SF-RR-Marcel_Granollers-Nicolas_Mahut,1,B-XC,32,8,2,1,5,14,18
20180916-M-Davis_Cup_World_Group_SF-RR-Marcel_Granollers-Nicolas_Mahut,1,B-DTM,40,4,0,1,3,13,27
20180916-M-Davis_Cup_World_Group_SF-RR-Marcel_Granollers-Nicolas_Mahut,1,B-DTL,5,2,2,0,0,3,2
20180916-M-Davis_Cup_World_Group_SF-RR-Marcel_Granollers-Nicolas_Mahut,1,B-IO,5,3,1,1,1,3,2
20180916-M-Davis_Cup_World_Group_SF-RR-Marcel_Granollers-Nicolas_Mahut,1,B-II,1,0,0,0,0,0,1
20180916-M-Davis_Cup_World_Group_SF-RR-Marcel_Granollers-Nicolas_Mahut,1,S-XC,38,2,1,0,1,8,30
20180916-M-Davis_Cup_World_Group_SF-RR-Marcel_Granollers-Nicolas_Mahut,1,S-DTM,24,1,0,0,1,2,22
20180916-M-Davis_Cup_World_Group_SF-RR-Marcel_Granollers-Nicolas_Mahut,1,S-DTL,7,2,0,0,2,1,6
20180916-M-Davis_Cup_World_Group_SF-RR-Marcel_Granollers-Nicolas_Mahut,1,S-IO,3,2,0,0,2,0,3
20180916-M-Davis_Cup_World_Group_SF-RR-Marcel_Granollers-Nicolas_Mahut,2,F-XC,29,8,3,2,3,17,12
20180916-M-Davis_Cup_World_Group_SF-RR-Marcel_Granollers-Nicolas_Mahut,2,F-DTM,17,0,0,0,0,12,5
20180916-M-Davis_Cup_World_Group_SF-RR-Marcel_Granollers-Nicolas_Mahut,2,F-DTL,13,3,1,1,1,9,4
20180916-M-Davis_Cup_World_Group_SF-RR-Marcel_Granollers-Nicolas_Mahut,2,F-IO,36,5,1,1,3,25,11
20180916-M-Davis_Cup_World_Group_SF-RR-Marcel_Granollers-Nicolas_Mahut,2,F-II,2,0,0,0,0,1,1
20180916-M-Davis_Cup_World_Group_SF-RR-Marcel_Granollers-Nicolas_Mahut,2,B-XC,6,1,1,0,0,3,3
20180916-M-Davis_Cup_World_Group_SF-RR-Marcel_Granollers-Nicolas_Mahut,2,B-DTM,15,2,0,1,1,6,9
20180916-M-Davis_Cup_World_Group_SF-RR-Marcel_Granollers-Nicolas_Mahut,2,B-DTL,2,2,1,1,0,2,0
20180916-M-Davis_Cup_World_Group_SF-RR-Marcel_Granollers-Nicolas_Mahut,2,B-IO,2,1,1,0,0,1,1
20180916-M-Davis_Cup_World_Group_SF-RR-Marcel_Granollers-Nicolas_Mahut,2,S-XC,59,0,0,0,0,46,13
20180916-M-Davis_Cup_World_Group_SF-RR-Marcel_Granollers-Nicolas_Mahut,2,S-DTM,25,1,0,0,1,18,7
20180916-M-Davis_Cup_World_Group_SF-RR-Marcel_Granollers-Nicolas_Mahut,2,S-DTL,6,1,0,1,0,4,2
20180916-M-Davis_Cup_World_Group_SF-RR-Marcel_Granollers-Nicolas_Mahut,2,S-II,1,0,0,0,0,1,0
20180907-M-US_Open-SF-Rafael_Nadal-Juan_Martin_Del_Potro,1,F-XC,49,4,1,0,3,14,35
20180907-M-US_Open-SF-Rafael_Nadal-Juan_Martin_Del_Potro,1,F-DTM,15,0,0,0,0,8,7
20180907-M-US_Open-SF-Rafael_Nadal-Juan_Martin_Del_Potro,1,F-DTL,15,9,5,0,4,6,9
20180907-M-US_Open-SF-Rafael_Nadal-Juan_Martin_Del_Potro,1,F-IO,19,5,1,1,3,10,9
20180907-M-US_Open-SF-Rafael_Nadal-Juan_Martin_Del_Potro,1,F-II,5,0,0,0,0,3,2
20180907-M-US_Open-SF-Rafael_Nadal-Juan_Martin_Del_Potro,1,B-XC,40,12,2,2,8,17,23
20180907-M-US_Open-SF-Rafael_Nadal-Juan_Martin_Del_Potro,1,B-DTM,14,0,0,0,0,7,7
20180907-M-US_Open-SF-Rafael_Nadal-Juan_Martin_Del_Potro,1,B-DTL,16,3,1,0,2,7,9
20180907-M-US_Open-SF-Rafael_Nadal-Juan_Martin_Del_Potro,1,B-IO,2,0,0,0,0,1,1
20180907-M-US_Open-SF-Rafael_Nadal-Juan_Martin_Del_Potro,1,S-XC,8,1,0,1,0,4,4
20180907-M-US_Open-SF-Rafael_Nadal-Juan_Martin_Del_Potro,1,S-DTM,2,0,0,0,0,1,1
20180907-M-US_Open-SF-Rafael_Nadal-Juan_Martin_Del_Potro,1,S-DTL,12,0,0,0,0,8,4
20180907-M-US_Open-SF-Rafael_Nadal-Juan_Martin_Del_Potro,1,S-IO,1,0,0,0,0,0,1
20180907-M-US_Open-SF-Rafael_Nadal-Juan_Martin_Del_Potro,2,F-XC,65,9,2,3,4,32,33
20180907-M-US_Open-SF-Rafael_Nadal-Juan_Martin_Del_Potro,2,F-DTM,9,3,0,1,2,6,3
20180907-M-US_Open-SF-Rafael_Nadal-Juan_Martin_Del_Potro,2,F-DTL,14,5,3,1,1,8,6
20180907-M-US_Open-SF-Rafael_Nadal-Juan_Martin_Del_Potro,2,F-IO,25,10,3,3,4,14,11
20180907-M-US_Open-SF-Rafael_Nadal-Juan_Martin_Del_Potro,2,F-II,9,4,3,1,0,7,2
20180907-M-US_Open-SF-Rafael_Nadal-Juan_Martin_Del_Potro,2,B-XC,25,7,1,2,4,15,10
20180907-M-US_Open-SF-Rafael_Nadal-Juan_Martin_Del_Potro,2,B-DTM,19,0,0,0,0,12,7
20180907-M-US_Open-SF-Rafael_Nadal-Juan_Martin_Del_Potro,2,B-DTL,24,10,7,0,3,16,8
20180907-M-US_Open-SF-Rafael_Nadal-Juan_Martin_Del_Potro,2,B-IO,3,0,0,0,0,2,1
20180907-M-US_Open-SF-Rafael_Nadal-Juan_Martin_Del_Potro,2,S-XC,4,1,0,0,1,3,1
20180907-M-US_Open-SF-Rafael_Nadal-Juan_Martin_Del_Potro,2,S-DTM,1,0,0,0,0,1,0
20180907-M-US_Open-SF-Rafael_Nadal-Juan_Martin_Del_Potro,2,S-DTL,5,1,0,1,0,3,2
20180907-M-US_Open-SF-Rafael_Nadal-Juan_Martin_Del_Potro,2,S-IO,1,1,0,0,1,0,1
20180905-M-US_Open-QF-Rafael_Nadal-Dominic_Thiem,1,F-XC,126,13,6,5,2,74,52
20180905-M-US_Open-QF-Rafael_Nadal-Dominic_Thiem,1,F-DTM,17,2,0,1,1,7,10
20180905-M-US_Open-QF-Rafael_Nadal-Dominic_Thiem,1,F-DTL,31,17,7,4,6,17,14
20180905-M-US_Open-QF-Rafael_Nadal-Dominic_Thiem,1,F-IO,43,20,9,6,5,26,17
20180905-M-US_Open-QF-Rafael_Nadal-Dominic_Thiem,1,F-II,16,2,1,0,1,8,8
20180905-M-US_Open-QF-Rafael_Nadal-Dominic_Thiem,1,B-XC,59,13,1,4,8,32,27
20180905-M-US_Open-QF-Rafael_Nadal-Dominic_Thiem,1,B-DTM,35,1,1,0,0,16,19
20180905-M-US_Open-QF-Rafael_Nadal-Dominic_Thiem,1,B-DTL,28,9,5,1,3,17,11
20180905-M-US_Open-QF-Rafael_Nadal-Dominic_Thiem,1,B-IO,3,0,0,0,0,1,2
20180905-M-US_Open-QF-Rafael_Nadal-Dominic_Thiem,1,S-XC,5,1,0,0,1,2,3
20180905-M-US_Open-QF-Rafael_Nadal-Dominic_Thiem,1,S-DTM,5,0,0,0,0,3,2
20180905-M-US_Open-QF-Rafael_Nadal-Dominic_Thiem,1,S-DTL,9,1,0,0,1,4,5
20180905-M-US_Open-QF-Rafael_Nadal-Dominic_Thiem,1,S-IO,2,0,0,0,0,0,2
20180905-M-US_Open-QF-Rafael_Nadal-Dominic_Thiem,2,F-XC,122,26,11,9,6,63,59
20180905-M-US_Open-QF-Rafael_Nadal-Dominic_Thiem,2,F-DTM,22,2,0,1,1,11,11
20180905-M-US_Open-QF-Rafael_Nadal-Dominic_Thiem,2,F-DTL,18,9,2,2,5,8,10
20180905-M-US_Open-QF-Rafael_Nadal-Dominic_Thiem,2,F-IO,41,16,5,5,6,21,20
20180905-M-US_Open-QF-Rafael_Nadal-Dominic_Thiem,2,F-II,14,5,2,1,2,8,6
20180905-M-US_Open-QF-Rafael_Nadal-Dominic_Thiem,2,B-XC,81,23,10,3,10,42,39
20180905-M-US_Open-QF-Rafael_Nadal-Dominic_Thiem,2,B-DTM,33,4,0,1,3,13,20
20180905-M-US_Open-QF-Rafael_Nadal-Dominic_Thiem,2,B-DTL,25,12,8,0,4,18,7
20180905-M-US_Open-QF-Rafael_Nadal-Dominic_Thiem,2,B-IO,3,0,0,0,0,1,2
20180905-M-US_Open-QF-Rafael_Nadal-Dominic_Thiem,2,S-XC,14,1,1,0,0,3,11
20180905-M-US_Open-QF-Rafael_Nadal-Dominic_Thiem,2,S-DTM,11,1,0,0,1,6,5
20180905-M-US_Open-QF-Rafael_Nadal-Dominic_Thiem,2,S-DTL,5,1,0,0,1,2,3
20071018-M-Madrid_Masters-R16-Andy_Murray-Rafael_Nadal,1,F-XC,97,9,4,2,3,47,50
20071018-M-Madrid_Masters-R16-Andy_Murray-Rafael_Nadal,1,F-DTM,22,2,0,0,2,7,15
20071018-M-Madrid_Masters-R16-Andy_Murray-Rafael_Nadal,1,F-DTL,13,2,1,0,1,7,6
20071018-M-Madrid_Masters-R16-Andy_Murray-Rafael_Nadal,1,F-IO,21,8,4,2,2,11,10
20071018-M-Madrid_Masters-R16-Andy_Murray-Rafael_Nadal,1,F-II,2,1,0,0,1,0,2
20071018-M-Madrid_Masters-R16-Andy_Murray-Rafael_Nadal,1,B-XC,54,13,4,2,7,23,31
20071018-M-Madrid_Masters-R16-Andy_Murray-Rafael_Nadal,1,B-DTM,40,4,0,1,3,19,21
20071018-M-Madrid_Masters-R16-Andy_Murray-Rafael_Nadal,1,B-DTL,37,12,2,3,7,16,21
20071018-M-Madrid_Masters-R16-Andy_Murray-Rafael_Nadal,1,B-IO,11,2,2,0,0,6,5
20071018-M-Madrid_Masters-R16-Andy_Murray-Rafael_Nadal,1,S-XC,2,0,0,0,0,1,1
20071018-M-Madrid_Masters-R16-Andy_Murray-Rafael_Nadal,1,S-DTM,8,0,0,0,0,4,4
20071018-M-Madrid_Masters-R16-Andy_Murray-Rafael_Nadal,1,S-DTL,5,0,0,0,0,2,3
20071018-M-Madrid_Masters-R16-Andy_Murray-Rafael_Nadal,1,S-IO,2,0,0,0,0,1,1
20071018-M-Madrid_Masters-R16-Andy_Murray-Rafael_Nadal,2,F-XC,81,9,2,3,4,44,37
20071018-M-Madrid_Masters-R16-Andy_Murray-Rafael_Nadal,2,F-DTM,30,3,0,1,2,17,13
20071018-M-Madrid_Masters-R16-Andy_Murray-Rafael_Nadal,2,F-DTL,16,5,2,1,2,8,8
20071018-M-Madrid_Masters-R16-Andy_Murray-Rafael_Nadal,2,F-IO,28,4,1,0,3,15,13
20071018-M-Madrid_Masters-R16-Andy_Murray-Rafael_Nadal,2,F-II,16,3,0,2,1,10,6
20071018-M-Madrid_Masters-R16-Andy_Murray-Rafael_Nadal,2,B-XC,49,6,2,2,2,27,22
20071018-M-Madrid_Masters-R16-Andy_Murray-Rafael_Nadal,2,B-DTM,45,1,0,0,1,19,26
20071018-M-Madrid_Masters-R16-Andy_Murray-Rafael_Nadal,2,B-DTL,20,9,4,2,3,11,9
20071018-M-Madrid_Masters-R16-Andy_Murray-Rafael_Nadal,2,B-IO,6,0,0,0,0,5,1
20071018-M-Madrid_Masters-R16-Andy_Murray-Rafael_Nadal,2,S-XC,6,2,0,1,1,3,3
20071018-M-Madrid_Masters-R16-Andy_Murray-Rafael_Nadal,2,S-DTM,11,1,0,0,1,7,4
20071018-M-Madrid_Masters-R16-Andy_Murray-Rafael_Nadal,2,S-DTL,7,1,0,0,1,3,4
20071018-M-Madrid_Masters-R16-Andy_Murray-Rafael_Nadal,2,S-IO,2,0,0,0,0,1,1
20180928-M-Shenzhen-QF-Alex_De_Minaur-Damir_Dzumhur,1,F-XC,37,10,6,1,3,23,14
20180928-M-Shenzhen-QF-Alex_De_Minaur-Damir_Dzumhur,1,F-DTM,33,3,0,1,2,13,20
20180928-M-Shenzhen-QF-Alex_De_Minaur-Damir_Dzumhur,1,F-DTL,12,6,1,2,3,6,6
20180928-M-Shenzhen-QF-Alex_De_Minaur-Damir_Dzumhur,1,F-IO,41,6,0,2,4,17,24
20180928-M-Shenzhen-QF-Alex_De_Minaur-Damir_Dzumhur,1,F-II,5,2,0,2,0,2,3
20180928-M-Shenzhen-QF-Alex_De_Minaur-Damir_Dzumhur,1,B-XC,70,4,0,1,3,32,38
20180928-M-Shenzhen-QF-Alex_De_Minaur-Damir_Dzumhur,1,B-DTM,79,4,0,0,4,40,39
20180928-M-Shenzhen-QF-Alex_De_Minaur-Damir_Dzumhur,1,B-DTL,11,2,0,1,1,5,6
20180928-M-Shenzhen-QF-Alex_De_Minaur-Damir_Dzumhur,1,B-IO,3,0,0,0,0,1,2
20180928-M-Shenzhen-QF-Alex_De_Minaur-Damir_Dzumhur,1,S-XC,32,1,0,0,1,7,25
20180928-M-Shenzhen-QF-Alex_De_Minaur-Damir_Dzumhur,1,S-DTM,20,1,0,0,1,8,12
20180928-M-Shenzhen-QF-Alex_De_Minaur-Damir_Dzumhur,1,S-DTL,4,0,0,0,0,2,2
20180928-M-Shenzhen-QF-Alex_De_Minaur-Damir_Dzumhur,2,F-XC,29,5,1,1,3,17,12
20180928-M-Shenzhen-QF-Alex_De_Minaur-Damir_Dzumhur,2,F-DTM,22,1,0,0,1,10,12
20180928-M-Shenzhen-QF-Alex_De_Minaur-Damir_Dzumhur,2,F-DTL,18,5,1,1,3,7,11
20180928-M-Shenzhen-QF-Alex_De_Minaur-Damir_Dzumhur,2,F-IO,27,6,1,1,4,10,17
20180928-M-Shenzhen-QF-Alex_De_Minaur-Damir_Dzumhur,2,F-II,2,1,0,0,1,0,2
20180928-M-Shenzhen-QF-Alex_De_Minaur-Damir_Dzumhur,2,B-XC,99,8,1,0,7,55,44
20180928-M-Shenzhen-QF-Alex_De_Minaur-Damir_Dzumhur,2,B-DTM,46,5,0,0,5,24,22
20180928-M-Shenzhen-QF-Alex_De_Minaur-Damir_Dzumhur,2,B-DTL,11,6,4,1,1,8,3
20180928-M-Shenzhen-QF-Alex_De_Minaur-Damir_Dzumhur,2,B-IO,14,5,2,0,3,5,9
20180928-M-Shenzhen-QF-Alex_De_Minaur-Damir_Dzumhur,2,S-XC,43,2,0,1,1,29,14
20180928-M-Shenzhen-QF-Alex_De_Minaur-Damir_Dzumhur,2,S-DTM,16,0,0,0,0,10,6
20180928-M-Shenzhen-QF-Alex_De_Minaur-Damir_Dzumhur,2,S-DTL,7,1,1,0,0,5,2
20180928-M-Shenzhen-QF-Alex_De_Minaur-Damir_Dzumhur,2,S-IO,4,0,0,0,0,3,1
20180919-M-St_Petersburg-R16-Stanislas_Wawrinka-Karen_Khachanov,1,F-XC,38,14,6,5,3,28,10
20180919-M-St_Petersburg-R16-Stanislas_Wawrinka-Karen_Khachanov,1,F-DTM,17,2,0,1,1,9,8
20180919-M-St_Petersburg-R16-Stanislas_Wawrinka-Karen_Khachanov,1,F-DTL,14,8,6,0,2,8,6
20180919-M-St_Petersburg-R16-Stanislas_Wawrinka-Karen_Khachanov,1,F-IO,17,5,4,0,1,9,8
20180919-M-St_Petersburg-R16-Stanislas_Wawrinka-Karen_Khachanov,1,B-XC,51,4,1,0,3,34,17
20180919-M-St_Petersburg-R16-Stanislas_Wawrinka-Karen_Khachanov,1,B-DTM,24,4,0,1,3,14,10
20180919-M-St_Petersburg-R16-Stanislas_Wawrinka-Karen_Khachanov,1,B-DTL,10,8,5,2,1,8,2
20180919-M-St_Petersburg-R16-Stanislas_Wawrinka-Karen_Khachanov,1,B-IO,1,0,0,0,0,1,0
20180919-M-St_Petersburg-R16-Stanislas_Wawrinka-Karen_Khachanov,1,S-XC,22,4,0,1,3,11,11
20180919-M-St_Petersburg-R16-Stanislas_Wawrinka-Karen_Khachanov,1,S-DTM,11,0,0,0,0,8,3
20180919-M-St_Petersburg-R16-Stanislas_Wawrinka-Karen_Khachanov,1,S-DTL,2,0,0,0,0,0,2
20180919-M-St_Petersburg-R16-Stanislas_Wawrinka-Karen_Khachanov,1,S-IO,1,0,0,0,0,0,1
20180919-M-St_Petersburg-R16-Stanislas_Wawrinka-Karen_Khachanov,2,F-XC,48,18,6,8,4,22,26
20180919-M-St_Petersburg-R16-Stanislas_Wawrinka-Karen_Khachanov,2,F-DTM,17,2,0,0,2,2,15
20180919-M-St_Petersburg-R16-Stanislas_Wawrinka-Karen_Khachanov,2,F-DTL,8,3,0,0,3,1,7
20180919-M-St_Petersburg-R16-Stanislas_Wawrinka-Karen_Khachanov,2,F-IO,39,15,5,4,6,21,18
20180919-M-St_Petersburg-R16-Stanislas_Wawrinka-Karen_Khachanov,2,F-II,2,0,0,0,0,2,0
20180919-M-St_Petersburg-R16-Stanislas_Wawrinka-Karen_Khachanov,2,B-XC,52,8,1,1,6,19,33
20180919-M-St_Petersburg-R16-Stanislas_Wawrinka-Karen_Khachanov,2,B-DTM,26,3,1,0,2,7,19
20180919-M-St_Petersburg-R16-Stanislas_Wawrinka-Karen_Khachanov,2,B-DTL,14,5,2,1,2,7,7
20180919-M-St_Petersburg-R16-Stanislas_Wawrinka-Karen_Khachanov,2,B-IO,2,1,1,0,0,1,1
20180919-M-St_Petersburg-R16-Stanislas_Wawrinka-Karen_Khachanov,2,S-XC,5,1,0,0,1,1,4
20180919-M-St_Petersburg-R16-Stanislas_Wawrinka-Karen_Khachanov,2,S-DTM,3,0,0,0,0,0,3
20180919-M-St_Petersburg-R16-Stanislas_Wawrinka-Karen_Khachanov,2,S-DTL,2,1,1,0,0,2,0
20150605-M-Roland_Garros-SF-Novak_Djokovic-Andy_Murray,1,F-XC,108,17,5,6,6,55,53
20150605-M-Roland_Garros-SF-Novak_Djokovic-Andy_Murray,1,F-DTM,58,5,0,0,5,27,31
20150605-M-Roland_Garros-SF-Novak_Djokovic-Andy_Murray,1,F-DTL,32,12,4,2,6,21,11
20150605-M-Roland_Garros-SF-Novak_Djokovic-Andy_Murray,1,F-IO,45,9,5,2,2,24,21
20150605-M-Roland_Garros-SF-Novak_Djokovic-Andy_Murray,1,F-II,9,2,0,1,1,2,7
20150605-M-Roland_Garros-SF-Novak_Djokovic-Andy_Murray,1,B-XC,144,22,4,6,12,74,70
20150605-M-Roland_Garros-SF-Novak_Djokovic-Andy_Murray,1,B-DTM,78,3,0,0,3,24,54
20150605-M-Roland_Garros-SF-Novak_Djokovic-Andy_Murray,1,B-DTL,40,11,3,4,4,23,17
20150605-M-Roland_Garros-SF-Novak_Djokovic-Andy_Murray,1,B-IO,14,1,0,0,1,4,10
20150605-M-Roland_Garros-SF-Novak_Djokovic-Andy_Murray,1,S-XC,22,2,0,0,2,11,11
20150605-M-Roland_Garros-SF-Novak_Djokovic-Andy_Murray,1,S-DTM,20,1,0,0,1,5,15
20150605-M-Roland_Garros-SF-Novak_Djokovic-Andy_Murray,1,S-DTL,1,0,0,0,0,1,0
20150605-M-Roland_Garros-SF-Novak_Djokovic-Andy_Murray,2,F-XC,116,22,7,7,8,70,46
20150605-M-Roland_Garros-SF-Novak_Djokovic-Andy_Murray,2,F-DTM,68,6,0,1,5,37,31
20150605-M-Roland_Garros-SF-Novak_Djokovic-Andy_Murray,2,F-DTL,41,6,1,3,2,26,15
20150605-M-Roland_Garros-SF-Novak_Djokovic-Andy_Murray,2,F-IO,53,5,1,2,2,27,26
20150605-M-Roland_Garros-SF-Novak_Djokovic-Andy_Murray,2,F-II,7,4,1,1,2,4,3
20150605-M-Roland_Garros-SF-Novak_Djokovic-Andy_Murray,2,B-XC,142,16,1,3,12,78,64
20150605-M-Roland_Garros-SF-Novak_Djokovic-Andy_Murray,2,B-DTM,57,3,0,1,2,29,28
20150605-M-Roland_Garros-SF-Novak_Djokovic-Andy_Murray,2,B-DTL,20,6,1,1,4,9,11
20150605-M-Roland_Garros-SF-Novak_Djokovic-Andy_Murray,2,B-IO,14,4,2,1,1,7,7
20150605-M-Roland_Garros-SF-Novak_Djokovic-Andy_Murray,2,B-II,1,0,0,0,0,0,1
20150605-M-Roland_Garros-SF-Novak_Djokovic-Andy_Murray,2,S-XC,27,2,0,0,2,18,9
20150605-M-Roland_Garros-SF-Novak_Djokovic-Andy_Murray,2,S-DTM,15,1,0,0,1,1,14
20020810-M-Cincinnati_Masters-QF-Andre_Agassi-Lleyton_Hewitt,1,F-XC,50,9,1,2,6,19,31
20020810-M-Cincinnati_Masters-QF-Andre_Agassi-Lleyton_Hewitt,1,F-DTM,17,1,0,0,1,8,9
20020810-M-Cincinnati_Masters-QF-Andre_Agassi-Lleyton_Hewitt,1,F-DTL,26,3,0,1,2,11,15
20020810-M-Cincinnati_Masters-QF-Andre_Agassi-Lleyton_Hewitt,1,F-IO,21,5,0,2,3,8,13
20020810-M-Cincinnati_Masters-QF-Andre_Agassi-Lleyton_Hewitt,1,F-II,2,1,0,1,0,1,1
20020810-M-Cincinnati_Masters-QF-Andre_Agassi-Lleyton_Hewitt,1,B-XC,93,10,0,2,8,49,44
20020810-M-Cincinnati_Masters-QF-Andre_Agassi-Lleyton_Hewitt,1,B-DTM,14,0,0,0,0,5,9
20020810-M-Cincinnati_Masters-QF-Andre_Agassi-Lleyton_Hewitt,1,B-DTL,26,11,1,4,6,10,16
20020810-M-Cincinnati_Masters-QF-Andre_Agassi-Lleyton_Hewitt,1,B-IO,8,0,0,0,0,5,3
20020810-M-Cincinnati_Masters-QF-Andre_Agassi-Lleyton_Hewitt,1,S-XC,6,0,0,0,0,2,4
20020810-M-Cincinnati_Masters-QF-Andre_Agassi-Lleyton_Hewitt,1,S-DTM,2,0,0,0,0,1,1
20020810-M-Cincinnati_Masters-QF-Andre_Agassi-Lleyton_Hewitt,2,F-XC,64,13,4,3,6,39,25
20020810-M-Cincinnati_Masters-QF-Andre_Agassi-Lleyton_Hewitt,2,F-DTM,18,2,0,1,1,9,9
20020810-M-Cincinnati_Masters-QF-Andre_Agassi-Lleyton_Hewitt,2,F-DTL,7,1,1,0,0,5,2
20020810-M-Cincinnati_Masters-QF-Andre_Agassi-Lleyton_Hewitt,2,F-IO,21,7,4,0,3,10,11
20020810-M-Cincinnati_Masters-QF-Andre_Agassi-Lleyton_Hewitt,2,F-II,4,3,0,2,1,2,2
20020810-M-Cincinnati_Masters-QF-Andre_Agassi-Lleyton_Hewitt,2,B-XC,88,11,1,2,8,47,41
20020810-M-Cincinnati_Masters-QF-Andre_Agassi-Lleyton_Hewitt,2,B-DTM,26,1,0,0,1,11,15
20020810-M-Cincinnati_Masters-QF-Andre_Agassi-Lleyton_Hewitt,2,B-DTL,10,5,1,1,3,5,5
20020810-M-Cincinnati_Masters-QF-Andre_Agassi-Lleyton_Hewitt,2,B-IO,4,1,1,0,0,3,1
20020810-M-Cincinnati_Masters-QF-Andre_Agassi-Lleyton_Hewitt,2,S-XC,17,3,0,0,3,8,9
20020810-M-Cincinnati_Masters-QF-Andre_Agassi-Lleyton_Hewitt,2,S-DTM,2,0,0,0,0,1,1
20100702-M-Wimbledon-SF-Andy_Murray-Rafael_Nadal,1,F-XC,72,9,3,2,4,29,43
20100702-M-Wimbledon-SF-Andy_Murray-Rafael_Nadal,1,F-DTM,17,0,0,0,0,4,13
20100702-M-Wimbledon-SF-Andy_Murray-Rafael_Nadal,1,F-DTL,11,7,2,0,5,3,8
20100702-M-Wimbledon-SF-Andy_Murray-Rafael_Nadal,1,F-IO,16,6,2,2,2,6,10
20100702-M-Wimbledon-SF-Andy_Murray-Rafael_Nadal,1,F-II,2,0,0,0,0,0,2
20100702-M-Wimbledon-SF-Andy_Murray-Rafael_Nadal,1,B-XC,32,6,2,2,2,14,18
20100702-M-Wimbledon-SF-Andy_Murray-Rafael_Nadal,1,B-DTM,15,1,0,1,0,8,7
20100702-M-Wimbledon-SF-Andy_Murray-Rafael_Nadal,1,B-DTL,13,5,2,1,2,6,7
20100702-M-Wimbledon-SF-Andy_Murray-Rafael_Nadal,1,B-IO,3,3,0,1,2,1,2
20100702-M-Wimbledon-SF-Andy_Murray-Rafael_Nadal,1,S-XC,9,0,0,0,0,1,8
20100702-M-Wimbledon-SF-Andy_Murray-Rafael_Nadal,1,S-DTM,8,1,1,0,0,3,5
20100702-M-Wimbledon-SF-Andy_Murray-Rafael_Nadal,1,S-DTL,4,0,0,0,0,1,3
20100702-M-Wimbledon-SF-Andy_Murray-Rafael_Nadal,1,S-IO,1,0,0,0,0,0,1
20100702-M-Wimbledon-SF-Andy_Murray-Rafael_Nadal,2,F-XC,55,15,5,7,3,37,18
20100702-M-Wimbledon-SF-Andy_Murray-Rafael_Nadal,2,F-DTM,17,1,1,0,0,11,6
20100702-M-Wimbledon-SF-Andy_Murray-Rafael_Nadal,2,F-DTL,23,11,3,7,1,19,4
20100702-M-Wimbledon-SF-Andy_Murray-Rafael_Nadal,2,F-IO,31,8,3,3,2,24,7
20100702-M-Wimbledon-SF-Andy_Murray-Rafael_Nadal,2,F-II,12,2,0,1,1,7,5
20100702-M-Wimbledon-SF-Andy_Murray-Rafael_Nadal,2,B-XC,35,13,3,4,6,23,12
20100702-M-Wimbledon-SF-Andy_Murray-Rafael_Nadal,2,B-DTM,11,1,0,0,1,5,6
20100702-M-Wimbledon-SF-Andy_Murray-Rafael_Nadal,2,B-DTL,13,4,1,1,2,6,7
20100702-M-Wimbledon-SF-Andy_Murray-Rafael_Nadal,2,B-IO,1,0,0,0,0,1,0
20100702-M-Wimbledon-SF-Andy_Murray-Rafael_Nadal,2,S-XC,10,2,0,2,0,6,4
20100702-M-Wimbledon-SF-Andy_Murray-Rafael_Nadal,2,S-DTM,10,0,0,0,0,7,3
20100702-M-Wimbledon-SF-Andy_Murray-Rafael_Nadal,2,S-DTL,12,0,0,0,0,7,5
20100702-M-Wimbledon-SF-Andy_Murray-Rafael_Nadal,2,S-IO,2,0,0,0,0,1,1
20040911-M-US_Open-SF-Lleyton_Hewitt-Joachim_Johansson,1,F-XC,31,6,1,1,4,21,10
20040911-M-US_Open-SF-Lleyton_Hewitt-Joachim_Johansson,1,F-DTM,17,0,0,0,0,14,3
20040911-M-US_Open-SF-Lleyton_Hewitt-Joachim_Johansson,1,F-DTL,28,6,1,3,2,23,5
20040911-M-US_Open-SF-Lleyton_Hewitt-Joachim_Johansson,1,F-IO,23,5,1,3,1,16,7
20040911-M-US_Open-SF-Lleyton_Hewitt-Joachim_Johansson,1,F-II,2,1,1,0,0,1,1
20040911-M-US_Open-SF-Lleyton_Hewitt-Joachim_Johansson,1,B-XC,53,5,1,2,2,45,8
20040911-M-US_Open-SF-Lleyton_Hewitt-Joachim_Johansson,1,B-DTM,15,2,1,1,0,14,1
20040911-M-US_Open-SF-Lleyton_Hewitt-Joachim_Johansson,1,B-DTL,7,3,2,0,1,4,3
20040911-M-US_Open-SF-Lleyton_Hewitt-Joachim_Johansson,1,B-IO,2,1,1,0,0,2,0
20040911-M-US_Open-SF-Lleyton_Hewitt-Joachim_Johansson,1,S-XC,4,0,0,0,0,2,2
20040911-M-US_Open-SF-Lleyton_Hewitt-Joachim_Johansson,1,S-DTM,5,0,0,0,0,4,1
20040911-M-US_Open-SF-Lleyton_Hewitt-Joachim_Johansson,1,S-DTL,3,1,0,1,0,3,0
20040911-M-US_Open-SF-Lleyton_Hewitt-Joachim_Johansson,2,F-XC,39,14,4,2,8,9,30
20040911-M-US_Open-SF-Lleyton_Hewitt-Joachim_Johansson,2,F-DTM,10,3,1,0,2,3,7
20040911-M-US_Open-SF-Lleyton_Hewitt-Joachim_Johansson,2,F-DTL,14,7,3,2,2,5,9
20040911-M-US_Open-SF-Lleyton_Hewitt-Joachim_Johansson,2,F-IO,27,9,1,3,5,5,22
20040911-M-US_Open-SF-Lleyton_Hewitt-Joachim_Johansson,2,F-II,11,8,2,2,4,4,7
20040911-M-US_Open-SF-Lleyton_Hewitt-Joachim_Johansson,2,B-XC,33,5,0,2,3,6,27
20040911-M-US_Open-SF-Lleyton_Hewitt-Joachim_Johansson,2,B-DTM,17,1,0,0,1,3,14
20040911-M-US_Open-SF-Lleyton_Hewitt-Joachim_Johansson,2,B-DTL,9,5,1,1,3,3,6
20040911-M-US_Open-SF-Lleyton_Hewitt-Joachim_Johansson,2,B-IO,1,0,0,0,0,1,0
20040911-M-US_Open-SF-Lleyton_Hewitt-Joachim_Johansson,2,S-XC,20,4,1,0,3,6,14
20040911-M-US_Open-SF-Lleyton_Hewitt-Joachim_Johansson,2,S-DTM,4,0,0,0,0,0,4
20040911-M-US_Open-SF-Lleyton_Hewitt-Joachim_Johansson,2,S-DTL,12,2,0,0,2,3,9
20040911-M-US_Open-SF-Lleyton_Hewitt-Joachim_Johansson,2,S-IO,2,1,0,0,1,0,2
20080702-M-Wimbledon-QF-Rafael_Nadal-Andy_Murray,1,F-XC,48,12,2,7,3,38,10
20080702-M-Wimbledon-QF-Rafael_Nadal-Andy_Murray,1,F-DTM,13,0,0,0,0,7,6
20080702-M-Wimbledon-QF-Rafael_Nadal-Andy_Murray,1,F-DTL,17,6,5,1,0,11,6
20080702-M-Wimbledon-QF-Rafael_Nadal-Andy_Murray,1,F-IO,28,12,3,8,1,23,5
20080702-M-Wimbledon-QF-Rafael_Nadal-Andy_Murray,1,F-II,9,2,1,1,0,6,3
20080702-M-Wimbledon-QF-Rafael_Nadal-Andy_Murray,1,B-XC,43,10,1,4,5,30,13
20080702-M-Wimbledon-QF-Rafael_Nadal-Andy_Murray,1,B-DTM,18,1,0,1,0,8,10
20080702-M-Wimbledon-QF-Rafael_Nadal-Andy_Murray,1,B-DTL,5,3,1,0,2,2,3
20080702-M-Wimbledon-QF-Rafael_Nadal-Andy_Murray,1,B-IO,2,1,0,0,1,1,1
20080702-M-Wimbledon-QF-Rafael_Nadal-Andy_Murray,1,S-XC,15,0,0,0,0,10,5
20080702-M-Wimbledon-QF-Rafael_Nadal-Andy_Murray,1,S-DTM,9,0,0,0,0,5,4
20080702-M-Wimbledon-QF-Rafael_Nadal-Andy_Murray,1,S-DTL,1,0,0,0,0,0,1
20080702-M-Wimbledon-QF-Rafael_Nadal-Andy_Murray,1,S-IO,1,0,0,0,0,1,0
20080702-M-Wimbledon-QF-Rafael_Nadal-Andy_Murray,2,F-XC,74,6,2,3,1,33,41
20080702-M-Wimbledon-QF-Rafael_Nadal-Andy_Murray,2,F-DTM,23,2,0,0,2,6,17
20080702-M-Wimbledon-QF-Rafael_Nadal-Andy_Murray,2,F-DTL,15,7,1,1,5,4,11
20080702-M-Wimbledon-QF-Rafael_Nadal-Andy_Murray,2,F-IO,19,6,0,0,6,4,15
20080702-M-Wimbledon-QF-Rafael_Nadal-Andy_Murray,2,B-XC,18,5,0,1,4,6,12
20080702-M-Wimbledon-QF-Rafael_Nadal-Andy_Murray,2,B-DTM,21,1,0,0,1,10,11
20080702-M-Wimbledon-QF-Rafael_Nadal-Andy_Murray,2,B-DTL,7,2,0,0,2,2,5
20080702-M-Wimbledon-QF-Rafael_Nadal-Andy_Murray,2,B-IO,5,1,0,1,0,2,3
20080702-M-Wimbledon-QF-Rafael_Nadal-Andy_Murray,2,S-XC,1,0,0,0,0,0,1
20080702-M-Wimbledon-QF-Rafael_Nadal-Andy_Murray,2,S-DTM,9,0,0,0,0,1,8
20080702-M-Wimbledon-QF-Rafael_Nadal-Andy_Murray,2,S-DTL,10,1,0,0,1,5,5
20110701-M-Wimbledon-SF-Andy_Murray-Rafael_Nadal,1,F-XC,125,22,2,9,11,49,76
20110701-M-Wimbledon-SF-Andy_Murray-Rafael_Nadal,1,F-DTM,21,1,0,0,1,10,11
20110701-M-Wimbledon-SF-Andy_Murray-Rafael_Nadal,1,F-DTL,23,11,4,2,5,13,10
20110701-M-Wimbledon-SF-Andy_Murray-Rafael_Nadal,1,F-IO,31,17,4,3,10,15,16
20110701-M-Wimbledon-SF-Andy_Murray-Rafael_Nadal,1,F-II,7,2,0,0,2,0,7
20110701-M-Wimbledon-SF-Andy_Murray-Rafael_Nadal,1,B-XC,35,6,1,2,3,9,26
20110701-M-Wimbledon-SF-Andy_Murray-Rafael_Nadal,1,B-DTM,11,0,0,0,0,6,5
20110701-M-Wimbledon-SF-Andy_Murray-Rafael_Nadal,1,B-DTL,20,5,2,1,2,11,9
20110701-M-Wimbledon-SF-Andy_Murray-Rafael_Nadal,1,B-IO,9,2,0,1,1,3,6
20110701-M-Wimbledon-SF-Andy_Murray-Rafael_Nadal,1,B-II,1,1,1,0,0,1,0
20110701-M-Wimbledon-SF-Andy_Murray-Rafael_Nadal,1,S-XC,3,0,0,0,0,1,2
20110701-M-Wimbledon-SF-Andy_Murray-Rafael_Nadal,1,S-DTM,8,1,0,0,1,2,6
20110701-M-Wimbledon-SF-Andy_Murray-Rafael_Nadal,1,S-DTL,16,0,0,0,0,8,8
20110701-M-Wimbledon-SF-Andy_Murray-Rafael_Nadal,1,S-IO,2,0,0,0,0,1,1
20110701-M-Wimbledon-SF-Andy_Murray-Rafael_Nadal,2,F-XC,58,11,5,5,1,41,17
20110701-M-Wimbledon-SF-Andy_Murray-Rafael_Nadal,2,F-DTM,26,0,0,0,0,12,14
20110701-M-Wimbledon-SF-Andy_Murray-Rafael_Nadal,2,F-DTL,26,9,5,3,1,17,9
20110701-M-Wimbledon-SF-Andy_Murray-Rafael_Nadal,2,F-IO,31,10,4,3,3,20,11
20110701-M-Wimbledon-SF-Andy_Murray-Rafael_Nadal,2,F-II,16,1,0,1,0,11,5
20110701-M-Wimbledon-SF-Andy_Murray-Rafael_Nadal,2,B-XC,58,9,2,2,5,36,22
20110701-M-Wimbledon-SF-Andy_Murray-Rafael_Nadal,2,B-DTM,28,1,0,0,1,19,9
20110701-M-Wimbledon-SF-Andy_Murray-Rafael_Nadal,2,B-DTL,12,8,1,2,5,4,8
20110701-M-Wimbledon-SF-Andy_Murray-Rafael_Nadal,2,B-IO,1,0,0,0,0,0,1
20110701-M-Wimbledon-SF-Andy_Murray-Rafael_Nadal,2,S-XC,9,0,0,0,0,6,3
20110701-M-Wimbledon-SF-Andy_Murray-Rafael_Nadal,2,S-DTM,17,0,0,0,0,9,8
20110701-M-Wimbledon-SF-Andy_Murray-Rafael_Nadal,2,S-DTL,26,1,0,0,1,17,9
20110701-M-Wimbledon-SF-Andy_Murray-Rafael_Nadal,2,S-IO,5,0,0,0,0,3,2
20181001-M-Tokyo-R32-Denis_Kudla-Richard_Gasquet,1,F-XC,38,5,1,1,3,24,14
20181001-M-Tokyo-R32-Denis_Kudla-Richard_Gasquet,1,F-DTM,16,1,0,0,1,7,9
20181001-M-Tokyo-R32-Denis_Kudla-Richard_Gasquet,1,F-DTL,22,8,7,1,0,15,7
20181001-M-Tokyo-R32-Denis_Kudla-Richard_Gasquet,1,F-IO,12,4,1,0,3,5,7
20181001-M-Tokyo-R32-Denis_Kudla-Richard_Gasquet,1,B-XC,43,7,3,0,4,28,15
20181001-M-Tokyo-R32-Denis_Kudla-Richard_Gasquet,1,B-DTM,46,2,0,1,1,23,23
20181001-M-Tokyo-R32-Denis_Kudla-Richard_Gasquet,1,B-DTL,13,3,0,1,2,7,6
20181001-M-Tokyo-R32-Denis_Kudla-Richard_Gasquet,1,B-IO,9,3,0,1,2,7,2
20181001-M-Tokyo-R32-Denis_Kudla-Richard_Gasquet,1,S-XC,8,0,0,0,0,4,4
20181001-M-Tokyo-R32-Denis_Kudla-Richard_Gasquet,1,S-DTM,9,0,0,0,0,2,7
20181001-M-Tokyo-R32-Denis_Kudla-Richard_Gasquet,1,S-DTL,3,1,0,0,1,1,2
20181001-M-Tokyo-R32-Denis_Kudla-Richard_Gasquet,1,S-IO,6,1,0,0,1,3,3
20181001-M-Tokyo-R32-Denis_Kudla-Richard_Gasquet,2,F-XC,49,9,2,3,4,22,27
20181001-M-Tokyo-R32-Denis_Kudla-Richard_Gasquet,2,F-DTM,38,0,0,0,0,17,21
20181001-M-Tokyo-R32-Denis_Kudla-Richard_Gasquet,2,F-DTL,7,2,0,0,2,3,4
20181001-M-Tokyo-R32-Denis_Kudla-Richard_Gasquet,2,F-IO,11,2,0,0,2,4,7
20181001-M-Tokyo-R32-Denis_Kudla-Richard_Gasquet,2,B-XC,46,7,2,1,4,23,23
20181001-M-Tokyo-R32-Denis_Kudla-Richard_Gasquet,2,B-DTM,14,1,0,0,1,5,9
20181001-M-Tokyo-R32-Denis_Kudla-Richard_Gasquet,2,B-DTL,12,8,4,2,2,8,4
20181001-M-Tokyo-R32-Denis_Kudla-Richard_Gasquet,2,B-IO,5,2,1,0,1,4,1
20181001-M-Tokyo-R32-Denis_Kudla-Richard_Gasquet,2,S-XC,19,2,0,0,2,8,11
20181001-M-Tokyo-R32-Denis_Kudla-Richard_Gasquet,2,S-DTM,13,0,0,0,0,2,11
20181002-M-Tokyo-R32-Gilles_Simon-Alex_De_Minaur,1,F-XC,150,23,1,5,17,71,79
20181002-M-Tokyo-R32-Gilles_Simon-Alex_De_Minaur,1,F-DTM,109,2,0,0,2,56,53
20181002-M-Tokyo-R32-Gilles_Simon-Alex_De_Minaur,1,F-DTL,20,6,1,2,3,9,11
20181002-M-Tokyo-R32-Gilles_Simon-Alex_De_Minaur,1,F-IO,64,9,2,5,2,30,34
20181002-M-Tokyo-R32-Gilles_Simon-Alex_De_Minaur,1,F-II,9,1,1,0,0,5,4
20181002-M-Tokyo-R32-Gilles_Simon-Alex_De_Minaur,1,B-XC,137,12,2,4,6,68,69
20181002-M-Tokyo-R32-Gilles_Simon-Alex_De_Minaur,1,B-DTM,101,3,0,0,3,46,55
20181002-M-Tokyo-R32-Gilles_Simon-Alex_De_Minaur,1,B-DTL,38,15,4,4,7,18,20
20181002-M-Tokyo-R32-Gilles_Simon-Alex_De_Minaur,1,B-IO,6,0,0,0,0,3,3
20181002-M-Tokyo-R32-Gilles_Simon-Alex_De_Minaur,1,B-II,1,0,0,0,0,1,0
20181002-M-Tokyo-R32-Gilles_Simon-Alex_De_Minaur,1,S-XC,5,1,0,0,1,0,5
20181002-M-Tokyo-R32-Gilles_Simon-Alex_De_Minaur,1,S-DTL,1,0,0,0,0,1,0
20181002-M-Tokyo-R32-Gilles_Simon-Alex_De_Minaur,2,F-XC,147,13,2,5,6,71,76
20181002-M-Tokyo-R32-Gilles_Simon-Alex_De_Minaur,2,F-DTM,90,7,1,1,5,47,43
20181002-M-Tokyo-R32-Gilles_Simon-Alex_De_Minaur,2,F-DTL,27,13,5,5,3,19,8
20181002-M-Tokyo-R32-Gilles_Simon-Alex_De_Minaur,2,F-IO,54,12,3,2,7,26,28
20181002-M-Tokyo-R32-Gilles_Simon-Alex_De_Minaur,2,F-II,2,0,0,0,0,0,2
20181002-M-Tokyo-R32-Gilles_Simon-Alex_De_Minaur,2,B-XC,119,8,2,1,5,66,53
20181002-M-Tokyo-R32-Gilles_Simon-Alex_De_Minaur,2,B-DTM,97,2,0,0,2,53,44
20181002-M-Tokyo-R32-Gilles_Simon-Alex_De_Minaur,2,B-DTL,32,8,2,4,2,15,17
20181002-M-Tokyo-R32-Gilles_Simon-Alex_De_Minaur,2,B-IO,15,4,0,2,2,9,6
20181002-M-Tokyo-R32-Gilles_Simon-Alex_De_Minaur,2,S-XC,37,2,0,0,2,11,26
20181002-M-Tokyo-R32-Gilles_Simon-Alex_De_Minaur,2,S-DTM,20,0,0,0,0,13,7
20181002-M-Tokyo-R32-Gilles_Simon-Alex_De_Minaur,2,S-DTL,1,0,0,0,0,0,1
20181002-M-Tokyo-R32-Gilles_Simon-Alex_De_Minaur,2,S-IO,1,0,0,0,0,0,1
20050114-M-Australian_Open-R16-Lleyton_Hewitt-Rafael_Nadal,1,F-XC,182,22,7,6,9,100,82
20050114-M-Australian_Open-R16-Lleyton_Hewitt-Rafael_Nadal,1,F-DTM,26,1,0,1,0,12,14
20050114-M-Australian_Open-R16-Lleyton_Hewitt-Rafael_Nadal,1,F-DTL,17,9,4,2,3,11,6
20050114-M-Australian_Open-R16-Lleyton_Hewitt-Rafael_Nadal,1,F-IO,57,19,7,4,8,34,23
20050114-M-Australian_Open-R16-Lleyton_Hewitt-Rafael_Nadal,1,F-II,23,2,2,0,0,13,10
20050114-M-Australian_Open-R16-Lleyton_Hewitt-Rafael_Nadal,1,B-XC,124,17,3,1,13,51,73
20050114-M-Australian_Open-R16-Lleyton_Hewitt-Rafael_Nadal,1,B-DTM,27,1,0,0,1,14,13
20050114-M-Australian_Open-R16-Lleyton_Hewitt-Rafael_Nadal,1,B-DTL,37,7,2,2,3,25,12
20050114-M-Australian_Open-R16-Lleyton_Hewitt-Rafael_Nadal,1,B-IO,2,0,0,0,0,0,2
20050114-M-Australian_Open-R16-Lleyton_Hewitt-Rafael_Nadal,1,S-XC,10,2,0,0,2,5,5
20050114-M-Australian_Open-R16-Lleyton_Hewitt-Rafael_Nadal,1,S-DTM,5,0,0,0,0,0,5
20050114-M-Australian_Open-R16-Lleyton_Hewitt-Rafael_Nadal,1,S-DTL,11,1,0,1,0,5,6
20050114-M-Australian_Open-R16-Lleyton_Hewitt-Rafael_Nadal,2,F-XC,151,15,2,6,7,79,72
20050114-M-Australian_Open-R16-Lleyton_Hewitt-Rafael_Nadal,2,F-DTM,44,5,1,1,3,19,25
20050114-M-Australian_Open-R16-Lleyton_Hewitt-Rafael_Nadal,2,F-DTL,48,21,8,2,11,24,24
20050114-M-Australian_Open-R16-Lleyton_Hewitt-Rafael_Nadal,2,F-IO,54,18,9,5,4,35,19
20050114-M-Australian_Open-R16-Lleyton_Hewitt-Rafael_Nadal,2,F-II,40,4,3,0,1,22,18
20050114-M-Australian_Open-R16-Lleyton_Hewitt-Rafael_Nadal,2,B-XC,82,14,2,4,8,36,46
20050114-M-Australian_Open-R16-Lleyton_Hewitt-Rafael_Nadal,2,B-DTM,48,2,0,1,1,24,24
20050114-M-Australian_Open-R16-Lleyton_Hewitt-Rafael_Nadal,2,B-DTL,46,10,2,3,5,23,23
20050114-M-Australian_Open-R16-Lleyton_Hewitt-Rafael_Nadal,2,B-IO,3,0,0,0,0,1,2
20050114-M-Australian_Open-R16-Lleyton_Hewitt-Rafael_Nadal,2,S-XC,5,0,0,0,0,2,3
20050114-M-Australian_Open-R16-Lleyton_Hewitt-Rafael_Nadal,2,S-DTM,8,1,1,0,0,3,5
20050114-M-Australian_Open-R16-Lleyton_Hewitt-Rafael_Nadal,2,S-DTL,9,2,0,0,2,2,7
20110603-M-Roland_Garros-SF-Andy_Murray-Rafael_Nadal,1,F-XC,145,17,1,10,6,74,71
20110603-M-Roland_Garros-SF-Andy_Murray-Rafael_Nadal,1,F-DTM,47,3,1,1,1,14,33
20110603-M-Roland_Garros-SF-Andy_Murray-Rafael_Nadal,1,F-DTL,13,4,2,0,2,7,6
20110603-M-Roland_Garros-SF-Andy_Murray-Rafael_Nadal,1,F-IO,34,15,5,2,8,15,19
20110603-M-Roland_Garros-SF-Andy_Murray-Rafael_Nadal,1,F-II,2,1,0,0,1,0,2
20110603-M-Roland_Garros-SF-Andy_Murray-Rafael_Nadal,1,B-XC,56,14,2,5,7,26,30
20110603-M-Roland_Garros-SF-Andy_Murray-Rafael_Nadal,1,B-DTM,47,4,0,1,3,16,31
20110603-M-Roland_Garros-SF-Andy_Murray-Rafael_Nadal,1,B-DTL,36,6,2,0,4,14,22
20110603-M-Roland_Garros-SF-Andy_Murray-Rafael_Nadal,1,B-IO,19,3,1,1,1,8,11
20110603-M-Roland_Garros-SF-Andy_Murray-Rafael_Nadal,1,S-XC,3,0,0,0,0,3,0
20110603-M-Roland_Garros-SF-Andy_Murray-Rafael_Nadal,1,S-DTM,9,0,0,0,0,7,2
20110603-M-Roland_Garros-SF-Andy_Murray-Rafael_Nadal,1,S-DTL,6,0,0,0,0,2,4
20110603-M-Roland_Garros-SF-Andy_Murray-Rafael_Nadal,2,F-XC,93,14,1,8,5,57,36
20110603-M-Roland_Garros-SF-Andy_Murray-Rafael_Nadal,2,F-DTM,43,4,0,1,3,23,20
20110603-M-Roland_Garros-SF-Andy_Murray-Rafael_Nadal,2,F-DTL,20,10,4,3,3,11,9
20110603-M-Roland_Garros-SF-Andy_Murray-Rafael_Nadal,2,F-IO,78,13,10,2,1,56,22
20110603-M-Roland_Garros-SF-Andy_Murray-Rafael_Nadal,2,F-II,27,10,1,5,4,13,14
20110603-M-Roland_Garros-SF-Andy_Murray-Rafael_Nadal,2,B-XC,59,12,5,4,3,30,29
20110603-M-Roland_Garros-SF-Andy_Murray-Rafael_Nadal,2,B-DTM,65,2,0,0,2,36,29
20110603-M-Roland_Garros-SF-Andy_Murray-Rafael_Nadal,2,B-DTL,38,6,0,4,2,19,19
20110603-M-Roland_Garros-SF-Andy_Murray-Rafael_Nadal,2,B-IO,6,2,0,0,2,1,5
20110603-M-Roland_Garros-SF-Andy_Murray-Rafael_Nadal,2,S-XC,3,1,0,1,0,1,2
20110603-M-Roland_Garros-SF-Andy_Murray-Rafael_Nadal,2,S-DTM,4,0,0,0,0,2,2
20110603-M-Roland_Garros-SF-Andy_Murray-Rafael_Nadal,2,S-DTL,8,1,0,0,1,5,3
20001028-M-Basel-SF-Lleyton_Hewitt-Roger_Federer,1,F-XC,49,7,0,3,4,22,27
20001028-M-Basel-SF-Lleyton_Hewitt-Roger_Federer,1,F-DTM,9,0,0,0,0,7,2
20001028-M-Basel-SF-Lleyton_Hewitt-Roger_Federer,1,F-DTL,20,4,0,2,2,9,11
20001028-M-Basel-SF-Lleyton_Hewitt-Roger_Federer,1,F-IO,23,3,1,2,0,11,12
20001028-M-Basel-SF-Lleyton_Hewitt-Roger_Federer,1,F-II,2,0,0,0,0,0,2
20001028-M-Basel-SF-Lleyton_Hewitt-Roger_Federer,1,B-XC,74,8,0,3,5,38,36
20001028-M-Basel-SF-Lleyton_Hewitt-Roger_Federer,1,B-DTM,5,0,0,0,0,2,3
20001028-M-Basel-SF-Lleyton_Hewitt-Roger_Federer,1,B-DTL,9,5,2,0,3,5,4
20001028-M-Basel-SF-Lleyton_Hewitt-Roger_Federer,1,B-IO,1,0,0,0,0,1,0
20001028-M-Basel-SF-Lleyton_Hewitt-Roger_Federer,1,S-XC,11,0,0,0,0,2,9
20001028-M-Basel-SF-Lleyton_Hewitt-Roger_Federer,1,S-DTM,4,0,0,0,0,0,4
20001028-M-Basel-SF-Lleyton_Hewitt-Roger_Federer,1,S-DTL,1,1,0,0,1,0,1
20001028-M-Basel-SF-Lleyton_Hewitt-Roger_Federer,2,F-XC,38,9,3,2,4,18,20
20001028-M-Basel-SF-Lleyton_Hewitt-Roger_Federer,2,F-DTM,8,1,0,0,1,4,4
20001028-M-Basel-SF-Lleyton_Hewitt-Roger_Federer,2,F-DTL,28,3,2,1,0,17,11
20001028-M-Basel-SF-Lleyton_Hewitt-Roger_Federer,2,F-IO,20,4,1,1,2,11,9
20001028-M-Basel-SF-Lleyton_Hewitt-Roger_Federer,2,F-II,5,2,0,1,1,4,1
20001028-M-Basel-SF-Lleyton_Hewitt-Roger_Federer,2,B-XC,39,2,0,0,2,20,19
20001028-M-Basel-SF-Lleyton_Hewitt-Roger_Federer,2,B-DTM,16,2,0,1,1,6,10
20001028-M-Basel-SF-Lleyton_Hewitt-Roger_Federer,2,B-DTL,24,11,2,4,5,14,10
20001028-M-Basel-SF-Lleyton_Hewitt-Roger_Federer,2,S-XC,20,1,0,1,0,10,10
20001028-M-Basel-SF-Lleyton_Hewitt-Roger_Federer,2,S-DTM,5,0,0,0,0,3,2
20001028-M-Basel-SF-Lleyton_Hewitt-Roger_Federer,2,S-DTL,12,2,0,1,1,4,8
20001028-M-Basel-SF-Lleyton_Hewitt-Roger_Federer,2,S-IO,1,0,0,0,0,1,0
20000205-M-Davis_Cup_World_Group_R1-RR-Roger_Federer-Lleyton_Hewitt,1,F-XC,50,12,1,8,3,29,21
20000205-M-Davis_Cup_World_Group_R1-RR-Roger_Federer-Lleyton_Hewitt,1,F-DTM,14,2,0,1,1,5,9
20000205-M-Davis_Cup_World_Group_R1-RR-Roger_Federer-Lleyton_Hewitt,1,F-DTL,36,11,2,1,8,13,23
20000205-M-Davis_Cup_World_Group_R1-RR-Roger_Federer-Lleyton_Hewitt,1,F-IO,49,19,13,2,4,32,17
20000205-M-Davis_Cup_World_Group_R1-RR-Roger_Federer-Lleyton_Hewitt,1,F-II,24,8,1,2,5,13,11
20000205-M-Davis_Cup_World_Group_R1-RR-Roger_Federer-Lleyton_Hewitt,1,B-XC,85,17,1,2,14,39,46
20000205-M-Davis_Cup_World_Group_R1-RR-Roger_Federer-Lleyton_Hewitt,1,B-DTM,19,4,0,2,2,11,8
20000205-M-Davis_Cup_World_Group_R1-RR-Roger_Federer-Lleyton_Hewitt,1,B-DTL,28,12,2,1,9,11,17
20000205-M-Davis_Cup_World_Group_R1-RR-Roger_Federer-Lleyton_Hewitt,1,S-XC,36,5,0,0,5,11,25
20000205-M-Davis_Cup_World_Group_R1-RR-Roger_Federer-Lleyton_Hewitt,1,S-DTM,17,0,0,0,0,9,8
20000205-M-Davis_Cup_World_Group_R1-RR-Roger_Federer-Lleyton_Hewitt,1,S-DTL,14,0,0,0,0,6,8
20000205-M-Davis_Cup_World_Group_R1-RR-Roger_Federer-Lleyton_Hewitt,1,S-IO,2,0,0,0,0,0,2
20000205-M-Davis_Cup_World_Group_R1-RR-Roger_Federer-Lleyton_Hewitt,2,F-XC,79,19,5,3,11,43,36
20000205-M-Davis_Cup_World_Group_R1-RR-Roger_Federer-Lleyton_Hewitt,2,F-DTM,18,2,0,0,2,8,10
20000205-M-Davis_Cup_World_Group_R1-RR-Roger_Federer-Lleyton_Hewitt,2,F-DTL,34,4,4,0,0,21,13
20000205-M-Davis_Cup_World_Group_R1-RR-Roger_Federer-Lleyton_Hewitt,2,F-IO,27,4,2,2,0,17,10
20000205-M-Davis_Cup_World_Group_R1-RR-Roger_Federer-Lleyton_Hewitt,2,F-II,8,3,2,1,0,6,2
20000205-M-Davis_Cup_World_Group_R1-RR-Roger_Federer-Lleyton_Hewitt,2,B-XC,151,10,3,4,3,81,70
20000205-M-Davis_Cup_World_Group_R1-RR-Roger_Federer-Lleyton_Hewitt,2,B-DTM,13,0,0,0,0,6,7
20000205-M-Davis_Cup_World_Group_R1-RR-Roger_Federer-Lleyton_Hewitt,2,B-DTL,10,4,3,1,0,7,3
20000205-M-Davis_Cup_World_Group_R1-RR-Roger_Federer-Lleyton_Hewitt,2,B-IO,2,1,0,0,1,1,1
20000205-M-Davis_Cup_World_Group_R1-RR-Roger_Federer-Lleyton_Hewitt,2,S-XC,14,0,0,0,0,3,11
20000205-M-Davis_Cup_World_Group_R1-RR-Roger_Federer-Lleyton_Hewitt,2,S-DTM,2,0,0,0,0,0,2
20000205-M-Davis_Cup_World_Group_R1-RR-Roger_Federer-Lleyton_Hewitt,2,S-DTL,1,1,0,1,0,1,0
20010622-M-s_Hertogenbosch-SF-Roger_Federer-Lleyton_Hewitt,1,F-XC,7,3,1,0,2,4,3
20010622-M-s_Hertogenbosch-SF-Roger_Federer-Lleyton_Hewitt,1,F-DTM,2,0,0,0,0,1,1
20010622-M-s_Hertogenbosch-SF-Roger_Federer-Lleyton_Hewitt,1,F-DTL,8,2,1,0,1,4,4
20010622-M-s_Hertogenbosch-SF-Roger_Federer-Lleyton_Hewitt,1,F-IO,7,1,1,0,0,3,4
20010622-M-s_Hertogenbosch-SF-Roger_Federer-Lleyton_Hewitt,1,F-II,4,2,0,0,2,2,2
20010622-M-s_Hertogenbosch-SF-Roger_Federer-Lleyton_Hewitt,1,B-XC,2,2,2,0,0,2,0
20010622-M-s_Hertogenbosch-SF-Roger_Federer-Lleyton_Hewitt,1,B-DTM,1,0,0,0,0,0,1
20010622-M-s_Hertogenbosch-SF-Roger_Federer-Lleyton_Hewitt,1,B-DTL,4,3,1,0,2,2,2
20010622-M-s_Hertogenbosch-SF-Roger_Federer-Lleyton_Hewitt,1,B-IO,1,1,0,0,1,0,1
20010622-M-s_Hertogenbosch-SF-Roger_Federer-Lleyton_Hewitt,1,S-XC,5,0,0,0,0,3,2
20010622-M-s_Hertogenbosch-SF-Roger_Federer-Lleyton_Hewitt,1,S-DTM,2,0,0,0,0,2,0
20010622-M-s_Hertogenbosch-SF-Roger_Federer-Lleyton_Hewitt,1,S-DTL,2,0,0,0,0,1,1
20010622-M-s_Hertogenbosch-SF-Roger_Federer-Lleyton_Hewitt,2,F-XC,14,1,0,1,0,6,8
20010622-M-s_Hertogenbosch-SF-Roger_Federer-Lleyton_Hewitt,2,F-DTM,3,0,0,0,0,1,2
20010622-M-s_Hertogenbosch-SF-Roger_Federer-Lleyton_Hewitt,2,F-DTL,7,3,2,0,1,2,5
20010622-M-s_Hertogenbosch-SF-Roger_Federer-Lleyton_Hewitt,2,F-IO,11,3,2,0,1,7,4
20010622-M-s_Hertogenbosch-SF-Roger_Federer-Lleyton_Hewitt,2,F-II,1,0,0,0,0,1,0
20010622-M-s_Hertogenbosch-SF-Roger_Federer-Lleyton_Hewitt,2,B-XC,18,7,2,3,2,8,10
20010622-M-s_Hertogenbosch-SF-Roger_Federer-Lleyton_Hewitt,2,B-DTM,3,0,0,0,0,2,1
20010622-M-s_Hertogenbosch-SF-Roger_Federer-Lleyton_Hewitt,2,B-DTL,1,0,0,0,0,1,0
20010622-M-s_Hertogenbosch-SF-Roger_Federer-Lleyton_Hewitt,2,B-IO,1,1,0,1,0,1,0
20010622-M-s_Hertogenbosch-SF-Roger_Federer-Lleyton_Hewitt,2,S-XC,2,1,0,1,0,1,1
20010622-M-s_Hertogenbosch-SF-Roger_Federer-Lleyton_Hewitt,2,S-DTM,2,0,0,0,0,0,2
20010622-M-s_Hertogenbosch-SF-Roger_Federer-Lleyton_Hewitt,2,S-DTL,1,0,0,0,0,0,1
20020329-M-Miami_Masters-SF-Roger_Federer-Lleyton_Hewitt,1,F-XC,44,8,1,2,5,20,24
20020329-M-Miami_Masters-SF-Roger_Federer-Lleyton_Hewitt,1,F-DTM,8,1,0,0,1,4,4
20020329-M-Miami_Masters-SF-Roger_Federer-Lleyton_Hewitt,1,F-DTL,24,5,2,0,3,10,14
20020329-M-Miami_Masters-SF-Roger_Federer-Lleyton_Hewitt,1,F-IO,20,8,4,2,2,14,6
20020329-M-Miami_Masters-SF-Roger_Federer-Lleyton_Hewitt,1,F-II,9,2,0,2,0,5,4
20020329-M-Miami_Masters-SF-Roger_Federer-Lleyton_Hewitt,1,B-XC,30,8,2,2,4,11,19
20020329-M-Miami_Masters-SF-Roger_Federer-Lleyton_Hewitt,1,B-DTM,7,1,0,0,1,4,3
20020329-M-Miami_Masters-SF-Roger_Federer-Lleyton_Hewitt,1,B-DTL,19,8,5,1,2,11,8
20020329-M-Miami_Masters-SF-Roger_Federer-Lleyton_Hewitt,1,B-IO,1,0,0,0,0,1,0
20020329-M-Miami_Masters-SF-Roger_Federer-Lleyton_Hewitt,1,S-XC,21,2,1,0,1,8,13
20020329-M-Miami_Masters-SF-Roger_Federer-Lleyton_Hewitt,1,S-DTM,4,0,0,0,0,2,2
20020329-M-Miami_Masters-SF-Roger_Federer-Lleyton_Hewitt,1,S-DTL,10,3,0,1,2,4,6
20020329-M-Miami_Masters-SF-Roger_Federer-Lleyton_Hewitt,1,S-IO,1,1,0,1,0,1,0
20020329-M-Miami_Masters-SF-Roger_Federer-Lleyton_Hewitt,2,F-XC,52,7,2,1,4,31,21
20020329-M-Miami_Masters-SF-Roger_Federer-Lleyton_Hewitt,2,F-DTM,7,1,0,0,1,0,7
20020329-M-Miami_Masters-SF-Roger_Federer-Lleyton_Hewitt,2,F-DTL,28,4,0,4,0,16,12
20020329-M-Miami_Masters-SF-Roger_Federer-Lleyton_Hewitt,2,F-IO,21,2,0,1,1,11,10
20020329-M-Miami_Masters-SF-Roger_Federer-Lleyton_Hewitt,2,F-II,11,1,0,0,1,6,5
20020329-M-Miami_Masters-SF-Roger_Federer-Lleyton_Hewitt,2,B-XC,50,7,0,2,5,30,20
20020329-M-Miami_Masters-SF-Roger_Federer-Lleyton_Hewitt,2,B-DTM,9,0,0,0,0,5,4
20020329-M-Miami_Masters-SF-Roger_Federer-Lleyton_Hewitt,2,B-DTL,8,3,1,0,2,5,3
20020329-M-Miami_Masters-SF-Roger_Federer-Lleyton_Hewitt,2,B-IO,5,2,0,0,2,3,2
20020329-M-Miami_Masters-SF-Roger_Federer-Lleyton_Hewitt,2,S-XC,11,1,0,0,1,4,7
20020329-M-Miami_Masters-SF-Roger_Federer-Lleyton_Hewitt,2,S-DTM,1,0,0,0,0,0,1
20020329-M-Miami_Masters-SF-Roger_Federer-Lleyton_Hewitt,2,S-DTL,2,1,1,0,0,2,0
20021101-M-Paris_Masters-QF-Roger_Federer-Lleyton_Hewitt,1,F-XC,31,9,1,2,6,12,19
20021101-M-Paris_Masters-QF-Roger_Federer-Lleyton_Hewitt,1,F-DTM,13,3,0,0,3,5,8
20021101-M-Paris_Masters-QF-Roger_Federer-Lleyton_Hewitt,1,F-DTL,18,7,3,0,4,10,8
20021101-M-Paris_Masters-QF-Roger_Federer-Lleyton_Hewitt,1,F-IO,17,5,3,2,0,9,8
20021101-M-Paris_Masters-QF-Roger_Federer-Lleyton_Hewitt,1,F-II,8,2,1,1,0,5,3
20021101-M-Paris_Masters-QF-Roger_Federer-Lleyton_Hewitt,1,B-XC,24,8,0,3,5,9,15
20021101-M-Paris_Masters-QF-Roger_Federer-Lleyton_Hewitt,1,B-DTM,21,2,0,0,2,8,13
20021101-M-Paris_Masters-QF-Roger_Federer-Lleyton_Hewitt,1,B-DTL,15,5,0,0,5,4,11
20021101-M-Paris_Masters-QF-Roger_Federer-Lleyton_Hewitt,1,B-IO,2,1,0,0,1,1,1
20021101-M-Paris_Masters-QF-Roger_Federer-Lleyton_Hewitt,1,S-XC,26,4,0,1,3,12,14
20021101-M-Paris_Masters-QF-Roger_Federer-Lleyton_Hewitt,1,S-DTM,5,0,0,0,0,1,4
20021101-M-Paris_Masters-QF-Roger_Federer-Lleyton_Hewitt,1,S-DTL,10,0,0,0,0,3,7
20021101-M-Paris_Masters-QF-Roger_Federer-Lleyton_Hewitt,2,F-XC,46,10,1,3,6,24,22
20021101-M-Paris_Masters-QF-Roger_Federer-Lleyton_Hewitt,2,F-DTM,6,1,0,0,1,1,5
20021101-M-Paris_Masters-QF-Roger_Federer-Lleyton_Hewitt,2,F-DTL,22,3,1,1,1,18,4
20021101-M-Paris_Masters-QF-Roger_Federer-Lleyton_Hewitt,2,F-IO,35,4,1,1,2,19,16
20021101-M-Paris_Masters-QF-Roger_Federer-Lleyton_Hewitt,2,F-II,7,1,0,0,1,4,3
20021101-M-Paris_Masters-QF-Roger_Federer-Lleyton_Hewitt,2,B-XC,50,7,1,2,4,28,22
20021101-M-Paris_Masters-QF-Roger_Federer-Lleyton_Hewitt,2,B-DTM,9,1,0,0,1,6,3
20021101-M-Paris_Masters-QF-Roger_Federer-Lleyton_Hewitt,2,B-DTL,2,2,1,1,0,2,0
20021101-M-Paris_Masters-QF-Roger_Federer-Lleyton_Hewitt,2,B-IO,1,1,0,0,1,0,1
20021101-M-Paris_Masters-QF-Roger_Federer-Lleyton_Hewitt,2,S-XC,14,1,0,1,0,8,6
20021101-M-Paris_Masters-QF-Roger_Federer-Lleyton_Hewitt,2,S-DTM,2,0,0,0,0,0,2
20021101-M-Paris_Masters-QF-Roger_Federer-Lleyton_Hewitt,2,S-DTL,1,0,0,0,0,1,0
20030921-M-Davis_Cup_World_Group_SF-RR-Roger_Federer-Lleyton_Hewitt,1,F-XC,68,17,7,4,6,35,33
20030921-M-Davis_Cup_World_Group_SF-RR-Roger_Federer-Lleyton_Hewitt,1,F-DTM,10,2,0,0,2,4,6
20030921-M-Davis_Cup_World_Group_SF-RR-Roger_Federer-Lleyton_Hewitt,1,F-DTL,35,12,5,3,4,15,20
20030921-M-Davis_Cup_World_Group_SF-RR-Roger_Federer-Lleyton_Hewitt,1,F-IO,51,22,8,9,5,37,14
20030921-M-Davis_Cup_World_Group_SF-RR-Roger_Federer-Lleyton_Hewitt,1,F-II,28,10,2,2,6,14,14
20030921-M-Davis_Cup_World_Group_SF-RR-Roger_Federer-Lleyton_Hewitt,1,B-XC,82,21,4,3,14,40,42
20030921-M-Davis_Cup_World_Group_SF-RR-Roger_Federer-Lleyton_Hewitt,1,B-DTM,28,0,0,0,0,13,15
20030921-M-Davis_Cup_World_Group_SF-RR-Roger_Federer-Lleyton_Hewitt,1,B-DTL,39,15,4,2,9,18,21
20030921-M-Davis_Cup_World_Group_SF-RR-Roger_Federer-Lleyton_Hewitt,1,B-IO,4,0,0,0,0,1,3
20030921-M-Davis_Cup_World_Group_SF-RR-Roger_Federer-Lleyton_Hewitt,1,S-XC,56,2,0,0,2,23,33
20030921-M-Davis_Cup_World_Group_SF-RR-Roger_Federer-Lleyton_Hewitt,1,S-DTM,5,0,0,0,0,2,3
20030921-M-Davis_Cup_World_Group_SF-RR-Roger_Federer-Lleyton_Hewitt,1,S-DTL,12,3,0,0,3,3,9
20030921-M-Davis_Cup_World_Group_SF-RR-Roger_Federer-Lleyton_Hewitt,2,F-XC,84,20,4,8,8,48,36
20030921-M-Davis_Cup_World_Group_SF-RR-Roger_Federer-Lleyton_Hewitt,2,F-DTM,20,0,0,0,0,8,12
20030921-M-Davis_Cup_World_Group_SF-RR-Roger_Federer-Lleyton_Hewitt,2,F-DTL,50,10,4,2,4,24,26
20030921-M-Davis_Cup_World_Group_SF-RR-Roger_Federer-Lleyton_Hewitt,2,F-IO,84,12,4,3,5,49,35
20030921-M-Davis_Cup_World_Group_SF-RR-Roger_Federer-Lleyton_Hewitt,2,F-II,17,7,1,5,1,12,5
20030921-M-Davis_Cup_World_Group_SF-RR-Roger_Federer-Lleyton_Hewitt,2,B-XC,131,18,1,5,12,64,67
20030921-M-Davis_Cup_World_Group_SF-RR-Roger_Federer-Lleyton_Hewitt,2,B-DTM,9,1,0,1,0,3,6
20030921-M-Davis_Cup_World_Group_SF-RR-Roger_Federer-Lleyton_Hewitt,2,B-DTL,6,2,1,0,1,3,3
20030921-M-Davis_Cup_World_Group_SF-RR-Roger_Federer-Lleyton_Hewitt,2,B-IO,4,1,0,0,1,2,2
20030921-M-Davis_Cup_World_Group_SF-RR-Roger_Federer-Lleyton_Hewitt,2,S-XC,17,4,0,2,2,9,8
20030921-M-Davis_Cup_World_Group_SF-RR-Roger_Federer-Lleyton_Hewitt,2,S-DTM,3,0,0,0,0,3,0
20030921-M-Davis_Cup_World_Group_SF-RR-Roger_Federer-Lleyton_Hewitt,2,S-DTL,6,0,0,0,0,1,5
20061114-M-Masters_Cup-RR-Roger_Federer-Andy_Roddick,1,F-XC,62,15,8,5,2,44,18
20061114-M-Masters_Cup-RR-Roger_Federer-Andy_Roddick,1,F-DTM,20,1,0,0,1,11,9
20061114-M-Masters_Cup-RR-Roger_Federer-Andy_Roddick,1,F-DTL,19,5,2,1,2,10,9
20061114-M-Masters_Cup-RR-Roger_Federer-Andy_Roddick,1,F-IO,33,15,9,3,3,22,11
20061114-M-Masters_Cup-RR-Roger_Federer-Andy_Roddick,1,F-II,7,1,0,0,1,4,3
20061114-M-Masters_Cup-RR-Roger_Federer-Andy_Roddick,1,B-XC,34,9,4,2,3,24,10
20061114-M-Masters_Cup-RR-Roger_Federer-Andy_Roddick,1,B-DTM,24,0,0,0,0,15,9
20061114-M-Masters_Cup-RR-Roger_Federer-Andy_Roddick,1,B-DTL,21,15,9,3,3,16,5
20061114-M-Masters_Cup-RR-Roger_Federer-Andy_Roddick,1,B-IO,2,0,0,0,0,2,0
20061114-M-Masters_Cup-RR-Roger_Federer-Andy_Roddick,1,S-XC,19,3,0,1,2,12,7
20061114-M-Masters_Cup-RR-Roger_Federer-Andy_Roddick,1,S-DTM,2,0,0,0,0,1,1
20061114-M-Masters_Cup-RR-Roger_Federer-Andy_Roddick,1,S-DTL,6,1,1,0,0,3,3
20061114-M-Masters_Cup-RR-Roger_Federer-Andy_Roddick,2,F-XC,59,13,1,4,8,21,38
20061114-M-Masters_Cup-RR-Roger_Federer-Andy_Roddick,2,F-DTM,14,1,0,0,1,4,10
20061114-M-Masters_Cup-RR-Roger_Federer-Andy_Roddick,2,F-DTL,21,6,0,4,2,8,13
20061114-M-Masters_Cup-RR-Roger_Federer-Andy_Roddick,2,F-IO,22,4,1,1,2,12,10
20061114-M-Masters_Cup-RR-Roger_Federer-Andy_Roddick,2,F-II,8,2,1,0,1,3,5
20061114-M-Masters_Cup-RR-Roger_Federer-Andy_Roddick,2,B-XC,31,2,0,1,1,12,19
20061114-M-Masters_Cup-RR-Roger_Federer-Andy_Roddick,2,B-DTM,25,1,0,0,1,7,18
20061114-M-Masters_Cup-RR-Roger_Federer-Andy_Roddick,2,B-DTL,7,1,1,0,0,3,4
20061114-M-Masters_Cup-RR-Roger_Federer-Andy_Roddick,2,B-IO,3,0,0,0,0,1,2
20061114-M-Masters_Cup-RR-Roger_Federer-Andy_Roddick,2,S-XC,11,4,0,3,1,6,5
20061114-M-Masters_Cup-RR-Roger_Federer-Andy_Roddick,2,S-DTM,5,0,0,0,0,2,3
20061114-M-Masters_Cup-RR-Roger_Federer-Andy_Roddick,2,S-DTL,7,4,0,3,1,4,3
20061114-M-Masters_Cup-RR-Roger_Federer-Andy_Roddick,2,S-IO,1,1,0,0,1,0,1
20061113-M-Masters_Cup-SF-Roger_Federer-Rafael_Nadal,1,F-XC,63,14,5,6,3,36,27
20061113-M-Masters_Cup-SF-Roger_Federer-Rafael_Nadal,1,F-DTM,41,4,0,0,4,21,20
20061113-M-Masters_Cup-SF-Roger_Federer-Rafael_Nadal,1,F-DTL,3,2,1,1,0,2,1
20061113-M-Masters_Cup-SF-Roger_Federer-Rafael_Nadal,1,F-IO,22,14,3,4,7,11,11
20061113-M-Masters_Cup-SF-Roger_Federer-Rafael_Nadal,1,F-II,1,1,0,0,1,0,1
20061113-M-Masters_Cup-SF-Roger_Federer-Rafael_Nadal,1,B-XC,35,3,0,1,2,22,13
20061113-M-Masters_Cup-SF-Roger_Federer-Rafael_Nadal,1,B-DTM,50,3,0,0,3,27,23
20061113-M-Masters_Cup-SF-Roger_Federer-Rafael_Nadal,1,B-DTL,14,2,1,0,1,10,4
20061113-M-Masters_Cup-SF-Roger_Federer-Rafael_Nadal,1,B-IO,3,0,0,0,0,2,1
20061113-M-Masters_Cup-SF-Roger_Federer-Rafael_Nadal,1,S-XC,10,1,0,1,0,4,6
20061113-M-Masters_Cup-SF-Roger_Federer-Rafael_Nadal,1,S-DTM,17,3,0,0,3,11,6
20061113-M-Masters_Cup-SF-Roger_Federer-Rafael_Nadal,1,S-DTL,4,1,0,0,1,0,4
20061113-M-Masters_Cup-SF-Roger_Federer-Rafael_Nadal,1,S-IO,1,0,0,0,0,0,1
20061113-M-Masters_Cup-SF-Roger_Federer-Rafael_Nadal,2,F-XC,92,12,4,4,4,44,48
20061113-M-Masters_Cup-SF-Roger_Federer-Rafael_Nadal,2,F-DTM,42,4,0,0,4,15,27
20061113-M-Masters_Cup-SF-Roger_Federer-Rafael_Nadal,2,F-DTL,9,5,2,1,2,6,3
20061113-M-Masters_Cup-SF-Roger_Federer-Rafael_Nadal,2,F-IO,21,3,2,1,0,12,9
20061113-M-Masters_Cup-SF-Roger_Federer-Rafael_Nadal,2,F-II,6,1,0,1,0,3,3
20061113-M-Masters_Cup-SF-Roger_Federer-Rafael_Nadal,2,B-XC,31,5,1,1,3,17,14
20061113-M-Masters_Cup-SF-Roger_Federer-Rafael_Nadal,2,B-DTM,41,4,0,0,4,17,24
20061113-M-Masters_Cup-SF-Roger_Federer-Rafael_Nadal,2,B-DTL,21,8,3,0,5,9,12
20061113-M-Masters_Cup-SF-Roger_Federer-Rafael_Nadal,2,B-IO,6,0,0,0,0,1,5
20061113-M-Masters_Cup-SF-Roger_Federer-Rafael_Nadal,2,S-XC,1,0,0,0,0,0,1
20061113-M-Masters_Cup-SF-Roger_Federer-Rafael_Nadal,2,S-DTM,5,0,0,0,0,2,3
20061113-M-Masters_Cup-SF-Roger_Federer-Rafael_Nadal,2,S-DTL,3,0,0,0,0,2,1
20070122-M-Australian_Open-R16-Rafael_Nadal-Andy_Murray,1,F-XC,87,11,4,3,4,50,37
20070122-M-Australian_Open-R16-Rafael_Nadal-Andy_Murray,1,F-DTM,31,2,0,1,1,16,15
20070122-M-Australian_Open-R16-Rafael_Nadal-Andy_Murray,1,F-DTL,16,8,4,3,1,11,5
20070122-M-Australian_Open-R16-Rafael_Nadal-Andy_Murray,1,F-IO,55,18,8,7,3,39,16
20070122-M-Australian_Open-R16-Rafael_Nadal-Andy_Murray,1,F-II,18,5,0,3,2,12,6
20070122-M-Australian_Open-R16-Rafael_Nadal-Andy_Murray,1,B-XC,76,14,6,3,5,38,38
20070122-M-Australian_Open-R16-Rafael_Nadal-Andy_Murray,1,B-DTM,60,4,0,0,4,30,30
20070122-M-Australian_Open-R16-Rafael_Nadal-Andy_Murray,1,B-DTL,42,12,7,1,4,25,17
20070122-M-Australian_Open-R16-Rafael_Nadal-Andy_Murray,1,B-IO,5,0,0,0,0,1,4
20070122-M-Australian_Open-R16-Rafael_Nadal-Andy_Murray,1,S-XC,6,1,1,0,0,3,3
20070122-M-Australian_Open-R16-Rafael_Nadal-Andy_Murray,1,S-DTM,9,0,0,0,0,6,3
20070122-M-Australian_Open-R16-Rafael_Nadal-Andy_Murray,1,S-DTL,16,2,0,0,2,4,12
20070122-M-Australian_Open-R16-Rafael_Nadal-Andy_Murray,1,S-IO,4,0,0,0,0,2,2
20070122-M-Australian_Open-R16-Rafael_Nadal-Andy_Murray,2,F-XC,126,11,3,4,4,62,64
20070122-M-Australian_Open-R16-Rafael_Nadal-Andy_Murray,2,F-DTM,24,2,0,0,2,11,13
20070122-M-Australian_Open-R16-Rafael_Nadal-Andy_Murray,2,F-DTL,20,9,5,2,2,12,8
20070122-M-Australian_Open-R16-Rafael_Nadal-Andy_Murray,2,F-IO,30,13,2,4,7,12,18
20070122-M-Australian_Open-R16-Rafael_Nadal-Andy_Murray,2,F-II,11,6,1,1,4,5,6
20070122-M-Australian_Open-R16-Rafael_Nadal-Andy_Murray,2,B-XC,56,29,6,5,18,26,30
20070122-M-Australian_Open-R16-Rafael_Nadal-Andy_Murray,2,B-DTM,52,3,1,0,2,23,29
20070122-M-Australian_Open-R16-Rafael_Nadal-Andy_Murray,2,B-DTL,34,8,1,3,4,17,17
20070122-M-Australian_Open-R16-Rafael_Nadal-Andy_Murray,2,B-IO,11,4,1,1,2,8,3
20070122-M-Australian_Open-R16-Rafael_Nadal-Andy_Murray,2,S-XC,5,1,0,0,1,2,3
20070122-M-Australian_Open-R16-Rafael_Nadal-Andy_Murray,2,S-DTM,6,0,0,0,0,1,5
20070122-M-Australian_Open-R16-Rafael_Nadal-Andy_Murray,2,S-DTL,22,4,1,2,1,10,12
20070122-M-Australian_Open-R16-Rafael_Nadal-Andy_Murray,2,S-IO,8,3,0,0,3,1,7
19960825-M-Canada_Masters-F-Todd_Woodbridge-Wayne_Ferreira,1,F-XC,18,8,0,5,3,10,8
19960825-M-Canada_Masters-F-Todd_Woodbridge-Wayne_Ferreira,1,F-DTM,11,1,0,0,1,4,7
19960825-M-Canada_Masters-F-Todd_Woodbridge-Wayne_Ferreira,1,F-DTL,8,1,0,0,1,2,6
19960825-M-Canada_Masters-F-Todd_Woodbridge-Wayne_Ferreira,1,F-IO,26,6,2,2,2,12,14
19960825-M-Canada_Masters-F-Todd_Woodbridge-Wayne_Ferreira,1,F-II,3,2,0,0,2,1,2
19960825-M-Canada_Masters-F-Todd_Woodbridge-Wayne_Ferreira,1,B-XC,7,2,0,1,1,4,3
19960825-M-Canada_Masters-F-Todd_Woodbridge-Wayne_Ferreira,1,B-DTM,4,0,0,0,0,3,1
19960825-M-Canada_Masters-F-Todd_Woodbridge-Wayne_Ferreira,1,B-DTL,3,2,0,1,1,2,1
19960825-M-Canada_Masters-F-Todd_Woodbridge-Wayne_Ferreira,1,S-XC,30,5,0,2,3,17,13
19960825-M-Canada_Masters-F-Todd_Woodbridge-Wayne_Ferreira,1,S-DTM,9,1,0,0,1,5,4
19960825-M-Canada_Masters-F-Todd_Woodbridge-Wayne_Ferreira,1,S-DTL,7,4,0,2,2,3,4
19960825-M-Canada_Masters-F-Todd_Woodbridge-Wayne_Ferreira,1,S-IO,3,1,0,0,1,1,2
19960825-M-Canada_Masters-F-Todd_Woodbridge-Wayne_Ferreira,2,F-XC,13,5,2,2,1,10,3
19960825-M-Canada_Masters-F-Todd_Woodbridge-Wayne_Ferreira,2,F-DTM,14,1,0,0,1,5,9
19960825-M-Canada_Masters-F-Todd_Woodbridge-Wayne_Ferreira,2,F-DTL,6,1,1,0,0,3,3
19960825-M-Canada_Masters-F-Todd_Woodbridge-Wayne_Ferreira,2,F-IO,15,7,0,4,3,7,8
19960825-M-Canada_Masters-F-Todd_Woodbridge-Wayne_Ferreira,2,F-II,2,1,0,1,0,1,1
19960825-M-Canada_Masters-F-Todd_Woodbridge-Wayne_Ferreira,2,B-XC,26,2,0,0,2,11,15
19960825-M-Canada_Masters-F-Todd_Woodbridge-Wayne_Ferreira,2,B-DTM,14,1,0,0,1,7,7
19960825-M-Canada_Masters-F-Todd_Woodbridge-Wayne_Ferreira,2,B-DTL,4,2,1,0,1,1,3
19960825-M-Canada_Masters-F-Todd_Woodbridge-Wayne_Ferreira,2,S-XC,15,1,0,1,0,9,6
19960825-M-Canada_Masters-F-Todd_Woodbridge-Wayne_Ferreira,2,S-DTM,7,1,0,0,1,4,3
19960825-M-Canada_Masters-F-Todd_Woodbridge-Wayne_Ferreira,2,S-DTL,6,1,0,1,0,4,2
19961105-M-Paris_Masters-F-Yevgeny_Kafelnikov-Thomas_Enqvist,1,F-XC,32,6,2,3,1,12,20
19961105-M-Paris_Masters-F-Yevgeny_Kafelnikov-Thomas_Enqvist,1,F-DTM,17,4,0,2,2,6,11
19961105-M-Paris_Masters-F-Yevgeny_Kafelnikov-Thomas_Enqvist,1,F-DTL,8,2,1,1,0,5,3
19961105-M-Paris_Masters-F-Yevgeny_Kafelnikov-Thomas_Enqvist,1,F-IO,9,2,1,0,1,4,5
19961105-M-Paris_Masters-F-Yevgeny_Kafelnikov-Thomas_Enqvist,1,B-XC,51,5,0,3,2,17,34
19961105-M-Paris_Masters-F-Yevgeny_Kafelnikov-Thomas_Enqvist,1,B-DTM,14,4,0,0,4,2,12
19961105-M-Paris_Masters-F-Yevgeny_Kafelnikov-Thomas_Enqvist,1,B-DTL,4,2,0,1,1,2,2
19961105-M-Paris_Masters-F-Yevgeny_Kafelnikov-Thomas_Enqvist,1,B-IO,6,1,0,0,1,2,4
19961105-M-Paris_Masters-F-Yevgeny_Kafelnikov-Thomas_Enqvist,1,S-XC,17,2,0,1,1,6,11
19961105-M-Paris_Masters-F-Yevgeny_Kafelnikov-Thomas_Enqvist,1,S-DTM,3,1,0,1,0,1,2
19961105-M-Paris_Masters-F-Yevgeny_Kafelnikov-Thomas_Enqvist,1,S-DTL,3,0,0,0,0,1,2
19961105-M-Paris_Masters-F-Yevgeny_Kafelnikov-Thomas_Enqvist,2,F-XC,29,10,2,5,3,20,9
19961105-M-Paris_Masters-F-Yevgeny_Kafelnikov-Thomas_Enqvist,2,F-DTM,14,1,0,0,1,10,4
19961105-M-Paris_Masters-F-Yevgeny_Kafelnikov-Thomas_Enqvist,2,F-DTL,12,5,1,3,1,8,4
19961105-M-Paris_Masters-F-Yevgeny_Kafelnikov-Thomas_Enqvist,2,F-IO,9,4,2,0,2,7,2
19961105-M-Paris_Masters-F-Yevgeny_Kafelnikov-Thomas_Enqvist,2,F-II,5,3,2,1,0,4,1
19961105-M-Paris_Masters-F-Yevgeny_Kafelnikov-Thomas_Enqvist,2,B-XC,47,7,1,1,5,29,18
19961105-M-Paris_Masters-F-Yevgeny_Kafelnikov-Thomas_Enqvist,2,B-DTM,23,1,0,0,1,13,10
19961105-M-Paris_Masters-F-Yevgeny_Kafelnikov-Thomas_Enqvist,2,B-DTL,13,7,4,3,0,11,2
19961105-M-Paris_Masters-F-Yevgeny_Kafelnikov-Thomas_Enqvist,2,B-IO,6,2,0,1,1,4,2
19961105-M-Paris_Masters-F-Yevgeny_Kafelnikov-Thomas_Enqvist,2,S-XC,12,1,0,1,0,9,3
19961105-M-Paris_Masters-F-Yevgeny_Kafelnikov-Thomas_Enqvist,2,S-DTM,2,0,0,0,0,0,2
19961105-M-Paris_Masters-F-Yevgeny_Kafelnikov-Thomas_Enqvist,2,S-DTL,2,1,1,0,0,2,0
19961105-M-Paris_Masters-F-Yevgeny_Kafelnikov-Thomas_Enqvist,2,S-IO,1,0,0,0,0,1,0
20121107-M-Tour_Finals-RR-Novak_Djokovic-Andy_Murray,1,F-XC,50,11,1,7,3,23,27
20121107-M-Tour_Finals-RR-Novak_Djokovic-Andy_Murray,1,F-DTM,38,0,0,0,0,17,21
20121107-M-Tour_Finals-RR-Novak_Djokovic-Andy_Murray,1,F-DTL,22,6,0,2,4,10,12
20121107-M-Tour_Finals-RR-Novak_Djokovic-Andy_Murray,1,F-IO,29,7,3,1,3,15,14
20121107-M-Tour_Finals-RR-Novak_Djokovic-Andy_Murray,1,F-II,5,1,0,1,0,2,3
20121107-M-Tour_Finals-RR-Novak_Djokovic-Andy_Murray,1,B-XC,74,13,0,6,7,36,38
20121107-M-Tour_Finals-RR-Novak_Djokovic-Andy_Murray,1,B-DTM,64,4,0,0,4,23,41
20121107-M-Tour_Finals-RR-Novak_Djokovic-Andy_Murray,1,B-DTL,22,6,1,1,4,13,9
20121107-M-Tour_Finals-RR-Novak_Djokovic-Andy_Murray,1,B-IO,11,2,0,0,2,4,7
20121107-M-Tour_Finals-RR-Novak_Djokovic-Andy_Murray,1,S-XC,11,0,0,0,0,7,4
20121107-M-Tour_Finals-RR-Novak_Djokovic-Andy_Murray,1,S-DTM,7,0,0,0,0,4,3
20121107-M-Tour_Finals-RR-Novak_Djokovic-Andy_Murray,1,S-DTL,4,0,0,0,0,1,3
20121107-M-Tour_Finals-RR-Novak_Djokovic-Andy_Murray,2,F-XC,75,16,6,6,4,43,32
20121107-M-Tour_Finals-RR-Novak_Djokovic-Andy_Murray,2,F-DTM,37,2,0,0,2,22,15
20121107-M-Tour_Finals-RR-Novak_Djokovic-Andy_Murray,2,F-DTL,19,4,2,0,2,11,8
20121107-M-Tour_Finals-RR-Novak_Djokovic-Andy_Murray,2,F-IO,41,9,3,3,3,29,12
20121107-M-Tour_Finals-RR-Novak_Djokovic-Andy_Murray,2,F-II,4,3,1,0,2,1,3
20121107-M-Tour_Finals-RR-Novak_Djokovic-Andy_Murray,2,B-XC,69,11,1,3,7,36,33
20121107-M-Tour_Finals-RR-Novak_Djokovic-Andy_Murray,2,B-DTM,34,4,0,0,4,18,16
20121107-M-Tour_Finals-RR-Novak_Djokovic-Andy_Murray,2,B-DTL,12,6,1,1,4,6,6
20121107-M-Tour_Finals-RR-Novak_Djokovic-Andy_Murray,2,B-IO,7,2,0,0,2,5,2
20121107-M-Tour_Finals-RR-Novak_Djokovic-Andy_Murray,2,S-XC,25,1,0,0,1,12,13
20121107-M-Tour_Finals-RR-Novak_Djokovic-Andy_Murray,2,S-DTM,18,0,0,0,0,6,12
20121107-M-Tour_Finals-RR-Novak_Djokovic-Andy_Murray,2,S-IO,3,1,0,0,1,2,1
20021116-M-Masters_Cup-SF-Roger_Federer-Lleyton_Hewitt,1,F-XC,69,16,1,3,12,29,40
20021116-M-Masters_Cup-SF-Roger_Federer-Lleyton_Hewitt,1,F-DTM,23,3,0,1,2,11,12
20021116-M-Masters_Cup-SF-Roger_Federer-Lleyton_Hewitt,1,F-DTL,44,11,3,4,4,25,19
20021116-M-Masters_Cup-SF-Roger_Federer-Lleyton_Hewitt,1,F-IO,45,20,6,5,9,19,26
20021116-M-Masters_Cup-SF-Roger_Federer-Lleyton_Hewitt,1,F-II,22,6,5,0,1,13,9
20021116-M-Masters_Cup-SF-Roger_Federer-Lleyton_Hewitt,1,B-XC,48,1,0,1,0,29,19
20021116-M-Masters_Cup-SF-Roger_Federer-Lleyton_Hewitt,1,B-DTM,14,1,0,0,1,8,6
20021116-M-Masters_Cup-SF-Roger_Federer-Lleyton_Hewitt,1,B-DTL,29,7,0,1,6,12,17
20021116-M-Masters_Cup-SF-Roger_Federer-Lleyton_Hewitt,1,S-XC,53,4,0,2,2,20,33
20021116-M-Masters_Cup-SF-Roger_Federer-Lleyton_Hewitt,1,S-DTM,6,0,0,0,0,3,3
20021116-M-Masters_Cup-SF-Roger_Federer-Lleyton_Hewitt,1,S-DTL,24,1,0,1,0,11,13
20021116-M-Masters_Cup-SF-Roger_Federer-Lleyton_Hewitt,2,F-XC,100,19,4,8,7,56,44
20021116-M-Masters_Cup-SF-Roger_Federer-Lleyton_Hewitt,2,F-DTM,13,2,0,0,2,7,6
20021116-M-Masters_Cup-SF-Roger_Federer-Lleyton_Hewitt,2,F-DTL,49,10,2,4,4,25,24
20021116-M-Masters_Cup-SF-Roger_Federer-Lleyton_Hewitt,2,F-IO,50,5,0,1,4,22,28
20021116-M-Masters_Cup-SF-Roger_Federer-Lleyton_Hewitt,2,F-II,19,3,2,0,1,11,8
20021116-M-Masters_Cup-SF-Roger_Federer-Lleyton_Hewitt,2,B-XC,119,13,3,5,5,64,55
20021116-M-Masters_Cup-SF-Roger_Federer-Lleyton_Hewitt,2,B-DTM,14,0,0,0,0,8,6
20021116-M-Masters_Cup-SF-Roger_Federer-Lleyton_Hewitt,2,B-DTL,7,3,2,1,0,6,1
20021116-M-Masters_Cup-SF-Roger_Federer-Lleyton_Hewitt,2,B-IO,3,2,0,1,1,1,2
20021116-M-Masters_Cup-SF-Roger_Federer-Lleyton_Hewitt,2,S-XC,23,5,2,1,2,12,11
20021116-M-Masters_Cup-SF-Roger_Federer-Lleyton_Hewitt,2,S-DTM,3,0,0,0,0,1,2
20140326-M-Miami_Masters-QF-Novak_Djokovic-Andy_Murray,1,F-XC,22,7,1,3,3,12,10
20140326-M-Miami_Masters-QF-Novak_Djokovic-Andy_Murray,1,F-DTM,30,2,0,0,2,15,15
20140326-M-Miami_Masters-QF-Novak_Djokovic-Andy_Murray,1,F-DTL,13,5,3,0,2,6,7
20140326-M-Miami_Masters-QF-Novak_Djokovic-Andy_Murray,1,F-IO,25,4,2,1,1,17,8
20140326-M-Miami_Masters-QF-Novak_Djokovic-Andy_Murray,1,F-II,1,0,0,0,0,1,0
20140326-M-Miami_Masters-QF-Novak_Djokovic-Andy_Murray,1,B-XC,22,4,2,1,1,16,6
20140326-M-Miami_Masters-QF-Novak_Djokovic-Andy_Murray,1,B-DTM,36,2,1,0,1,20,16
20140326-M-Miami_Masters-QF-Novak_Djokovic-Andy_Murray,1,B-DTL,7,1,1,0,0,6,1
20140326-M-Miami_Masters-QF-Novak_Djokovic-Andy_Murray,1,B-IO,11,4,0,1,3,5,6
20140326-M-Miami_Masters-QF-Novak_Djokovic-Andy_Murray,1,S-XC,7,0,0,0,0,2,5
20140326-M-Miami_Masters-QF-Novak_Djokovic-Andy_Murray,1,S-DTM,7,0,0,0,0,4,3
20140326-M-Miami_Masters-QF-Novak_Djokovic-Andy_Murray,1,S-DTL,1,0,0,0,0,1,0
20140326-M-Miami_Masters-QF-Novak_Djokovic-Andy_Murray,1,S-IO,2,0,0,0,0,1,1
20140326-M-Miami_Masters-QF-Novak_Djokovic-Andy_Murray,2,F-XC,38,6,3,0,3,20,18
20140326-M-Miami_Masters-QF-Novak_Djokovic-Andy_Murray,2,F-DTM,25,1,0,0,1,8,17
20140326-M-Miami_Masters-QF-Novak_Djokovic-Andy_Murray,2,F-DTL,11,4,1,2,1,5,6
20140326-M-Miami_Masters-QF-Novak_Djokovic-Andy_Murray,2,F-IO,26,8,1,6,1,14,12
20140326-M-Miami_Masters-QF-Novak_Djokovic-Andy_Murray,2,F-II,1,1,1,0,0,1,0
20140326-M-Miami_Masters-QF-Novak_Djokovic-Andy_Murray,2,B-XC,31,8,0,1,7,11,20
20140326-M-Miami_Masters-QF-Novak_Djokovic-Andy_Murray,2,B-DTM,28,1,0,1,0,14,14
20140326-M-Miami_Masters-QF-Novak_Djokovic-Andy_Murray,2,B-DTL,7,3,2,1,0,6,1
20140326-M-Miami_Masters-QF-Novak_Djokovic-Andy_Murray,2,B-IO,6,4,0,0,4,2,4
20140326-M-Miami_Masters-QF-Novak_Djokovic-Andy_Murray,2,S-XC,11,1,0,1,0,3,8
20140326-M-Miami_Masters-QF-Novak_Djokovic-Andy_Murray,2,S-DTM,8,1,0,0,1,3,5
20140326-M-Miami_Masters-QF-Novak_Djokovic-Andy_Murray,2,S-DTL,2,0,0,0,0,1,1
20140326-M-Miami_Masters-QF-Novak_Djokovic-Andy_Murray,2,S-IO,2,2,0,0,2,0,2
20050126-M-Australian_Open-QF-Lleyton_Hewitt-David_Nalbandian,1,F-XC,152,27,7,6,14,72,80
20050126-M-Australian_Open-QF-Lleyton_Hewitt-David_Nalbandian,1,F-DTM,25,0,0,0,0,8,17
20050126-M-Australian_Open-QF-Lleyton_Hewitt-David_Nalbandian,1,F-DTL,49,11,2,5,4,26,23
20050126-M-Australian_Open-QF-Lleyton_Hewitt-David_Nalbandian,1,F-IO,34,5,2,0,3,18,16
20050126-M-Australian_Open-QF-Lleyton_Hewitt-David_Nalbandian,1,F-II,4,1,0,0,1,2,2
20050126-M-Australian_Open-QF-Lleyton_Hewitt-David_Nalbandian,1,B-XC,185,18,2,3,13,94,91
20050126-M-Australian_Open-QF-Lleyton_Hewitt-David_Nalbandian,1,B-DTM,29,1,0,0,1,14,15
20050126-M-Australian_Open-QF-Lleyton_Hewitt-David_Nalbandian,1,B-DTL,20,8,3,3,2,10,10
20050126-M-Australian_Open-QF-Lleyton_Hewitt-David_Nalbandian,1,B-IO,14,3,0,1,2,6,8
20050126-M-Australian_Open-QF-Lleyton_Hewitt-David_Nalbandian,1,S-XC,41,1,0,1,0,18,23
20050126-M-Australian_Open-QF-Lleyton_Hewitt-David_Nalbandian,1,S-DTM,4,0,0,0,0,0,4
20050126-M-Australian_Open-QF-Lleyton_Hewitt-David_Nalbandian,1,S-DTL,10,1,0,1,0,5,5
20050126-M-Australian_Open-QF-Lleyton_Hewitt-David_Nalbandian,2,F-XC,106,16,2,5,9,57,49
20050126-M-Australian_Open-QF-Lleyton_Hewitt-David_Nalbandian,2,F-DTM,29,0,0,0,0,15,14
20050126-M-Australian_Open-QF-Lleyton_Hewitt-David_Nalbandian,2,F-DTL,56,14,6,5,3,33,23
20050126-M-Australian_Open-QF-Lleyton_Hewitt-David_Nalbandian,2,F-IO,29,4,2,1,1,16,13
20050126-M-Australian_Open-QF-Lleyton_Hewitt-David_Nalbandian,2,F-II,8,1,0,0,1,3,5
20050126-M-Australian_Open-QF-Lleyton_Hewitt-David_Nalbandian,2,B-XC,146,19,1,7,11,73,73
20050126-M-Australian_Open-QF-Lleyton_Hewitt-David_Nalbandian,2,B-DTM,41,5,1,1,3,19,22
20050126-M-Australian_Open-QF-Lleyton_Hewitt-David_Nalbandian,2,B-DTL,74,26,5,6,15,34,40
20050126-M-Australian_Open-QF-Lleyton_Hewitt-David_Nalbandian,2,B-IO,8,3,1,2,0,6,2
20050126-M-Australian_Open-QF-Lleyton_Hewitt-David_Nalbandian,2,B-II,1,0,0,0,0,1,0
20050126-M-Australian_Open-QF-Lleyton_Hewitt-David_Nalbandian,2,S-XC,38,4,0,1,3,17,21
20050126-M-Australian_Open-QF-Lleyton_Hewitt-David_Nalbandian,2,S-DTM,20,0,0,0,0,11,9
20050126-M-Australian_Open-QF-Lleyton_Hewitt-David_Nalbandian,2,S-DTL,12,2,0,1,1,8,4
20050126-M-Australian_Open-QF-Lleyton_Hewitt-David_Nalbandian,2,S-IO,2,0,0,0,0,2,0
19960519-M-Rome_Masters-F-Richard_Krajicek-Thomas_Muster,1,F-XC,48,5,0,1,4,19,29
19960519-M-Rome_Masters-F-Richard_Krajicek-Thomas_Muster,1,F-DTM,16,1,0,0,1,6,10
19960519-M-Rome_Masters-F-Richard_Krajicek-Thomas_Muster,1,F-DTL,3,3,1,0,2,1,2
19960519-M-Rome_Masters-F-Richard_Krajicek-Thomas_Muster,1,F-IO,8,6,2,1,3,5,3
19960519-M-Rome_Masters-F-Richard_Krajicek-Thomas_Muster,1,F-II,5,3,0,2,1,3,2
19960519-M-Rome_Masters-F-Richard_Krajicek-Thomas_Muster,1,B-XC,4,4,3,0,1,3,1
19960519-M-Rome_Masters-F-Richard_Krajicek-Thomas_Muster,1,B-DTM,5,0,0,0,0,1,4
19960519-M-Rome_Masters-F-Richard_Krajicek-Thomas_Muster,1,B-DTL,4,1,0,0,1,1,3
19960519-M-Rome_Masters-F-Richard_Krajicek-Thomas_Muster,1,B-IO,1,1,0,1,0,1,0
19960519-M-Rome_Masters-F-Richard_Krajicek-Thomas_Muster,1,S-XC,24,6,0,1,5,10,14
19960519-M-Rome_Masters-F-Richard_Krajicek-Thomas_Muster,1,S-DTM,26,2,0,0,2,9,17
19960519-M-Rome_Masters-F-Richard_Krajicek-Thomas_Muster,1,S-DTL,27,6,0,0,6,8,19
19960519-M-Rome_Masters-F-Richard_Krajicek-Thomas_Muster,1,S-IO,4,2,0,2,0,4,0
19960519-M-Rome_Masters-F-Richard_Krajicek-Thomas_Muster,2,F-XC,62,7,4,2,1,38,24
19960519-M-Rome_Masters-F-Richard_Krajicek-Thomas_Muster,2,F-DTM,24,1,0,0,1,10,14
19960519-M-Rome_Masters-F-Richard_Krajicek-Thomas_Muster,2,F-DTL,7,2,2,0,0,6,1
19960519-M-Rome_Masters-F-Richard_Krajicek-Thomas_Muster,2,F-IO,19,6,0,4,2,12,7
19960519-M-Rome_Masters-F-Richard_Krajicek-Thomas_Muster,2,F-II,20,4,0,3,1,14,6
19960519-M-Rome_Masters-F-Richard_Krajicek-Thomas_Muster,2,B-XC,26,9,4,3,2,20,6
19960519-M-Rome_Masters-F-Richard_Krajicek-Thomas_Muster,2,B-DTM,31,3,0,2,1,16,15
19960519-M-Rome_Masters-F-Richard_Krajicek-Thomas_Muster,2,B-DTL,18,5,2,2,1,11,7
19960519-M-Rome_Masters-F-Richard_Krajicek-Thomas_Muster,2,B-IO,1,0,0,0,0,1,0
19960519-M-Rome_Masters-F-Richard_Krajicek-Thomas_Muster,2,S-XC,6,2,0,0,2,1,5
19960519-M-Rome_Masters-F-Richard_Krajicek-Thomas_Muster,2,S-DTM,3,0,0,0,0,0,3
19960519-M-Rome_Masters-F-Richard_Krajicek-Thomas_Muster,2,S-DTL,6,1,0,1,0,5,1
20181014-M-Shanghai_Masters-F-Novak_Djokovic-Borna_Coric,1,F-XC,24,6,0,3,3,13,11
20181014-M-Shanghai_Masters-F-Novak_Djokovic-Borna_Coric,1,F-DTM,23,0,0,0,0,12,11
20181014-M-Shanghai_Masters-F-Novak_Djokovic-Borna_Coric,1,F-DTL,15,2,1,0,1,6,9
20181014-M-Shanghai_Masters-F-Novak_Djokovic-Borna_Coric,1,F-IO,17,5,1,3,1,13,4
20181014-M-Shanghai_Masters-F-Novak_Djokovic-Borna_Coric,1,F-II,5,2,0,2,0,4,1
20181014-M-Shanghai_Masters-F-Novak_Djokovic-Borna_Coric,1,B-XC,42,3,0,2,1,26,16
20181014-M-Shanghai_Masters-F-Novak_Djokovic-Borna_Coric,1,B-DTM,28,1,0,1,0,15,13
20181014-M-Shanghai_Masters-F-Novak_Djokovic-Borna_Coric,1,B-DTL,15,7,2,1,4,7,8
20181014-M-Shanghai_Masters-F-Novak_Djokovic-Borna_Coric,1,B-IO,6,1,0,0,1,3,3
20181014-M-Shanghai_Masters-F-Novak_Djokovic-Borna_Coric,1,S-XC,11,2,0,0,2,5,6
20181014-M-Shanghai_Masters-F-Novak_Djokovic-Borna_Coric,1,S-DTM,14,0,0,0,0,6,8
20181014-M-Shanghai_Masters-F-Novak_Djokovic-Borna_Coric,1,S-DTL,3,0,0,0,0,2,1
20181014-M-Shanghai_Masters-F-Novak_Djokovic-Borna_Coric,1,S-IO,2,1,0,0,1,1,1
20181014-M-Shanghai_Masters-F-Novak_Djokovic-Borna_Coric,2,F-XC,40,6,2,1,3,25,15
20181014-M-Shanghai_Masters-F-Novak_Djokovic-Borna_Coric,2,F-DTM,14,2,0,0,2,4,10
20181014-M-Shanghai_Masters-F-Novak_Djokovic-Borna_Coric,2,F-DTL,10,1,0,0,1,4,6
20181014-M-Shanghai_Masters-F-Novak_Djokovic-Borna_Coric,2,F-IO,37,10,3,1,6,17,20
20181014-M-Shanghai_Masters-F-Novak_Djokovic-Borna_Coric,2,F-II,3,2,1,1,0,2,1
20181014-M-Shanghai_Masters-F-Novak_Djokovic-Borna_Coric,2,B-XC,52,7,0,1,6,24,28
20181014-M-Shanghai_Masters-F-Novak_Djokovic-Borna_Coric,2,B-DTM,29,4,0,0,4,15,14
20181014-M-Shanghai_Masters-F-Novak_Djokovic-Borna_Coric,2,B-DTL,9,7,3,0,4,4,5
20181014-M-Shanghai_Masters-F-Novak_Djokovic-Borna_Coric,2,B-IO,10,3,1,1,1,4,6
20181014-M-Shanghai_Masters-F-Novak_Djokovic-Borna_Coric,2,S-XC,8,1,0,0,1,2,6
20181014-M-Shanghai_Masters-F-Novak_Djokovic-Borna_Coric,2,S-DTM,4,0,0,0,0,1,3
20040126-M-Australian_Open-R16-Roger_Federer-Lleyton_Hewitt,1,F-XC,79,23,7,6,10,42,37
20040126-M-Australian_Open-R16-Roger_Federer-Lleyton_Hewitt,1,F-DTM,26,4,1,0,3,9,17
20040126-M-Australian_Open-R16-Roger_Federer-Lleyton_Hewitt,1,F-DTL,31,13,6,3,4,13,18
20040126-M-Australian_Open-R16-Roger_Federer-Lleyton_Hewitt,1,F-IO,34,13,3,4,6,15,19
20040126-M-Australian_Open-R16-Roger_Federer-Lleyton_Hewitt,1,F-II,20,7,2,4,1,12,8
20040126-M-Australian_Open-R16-Roger_Federer-Lleyton_Hewitt,1,B-XC,55,4,1,1,2,26,29
20040126-M-Australian_Open-R16-Roger_Federer-Lleyton_Hewitt,1,B-DTM,19,0,0,0,0,9,10
20040126-M-Australian_Open-R16-Roger_Federer-Lleyton_Hewitt,1,B-DTL,23,12,6,1,5,12,11
20040126-M-Australian_Open-R16-Roger_Federer-Lleyton_Hewitt,1,B-IO,3,1,0,0,1,0,3
20040126-M-Australian_Open-R16-Roger_Federer-Lleyton_Hewitt,1,S-XC,44,2,0,0,2,21,23
20040126-M-Australian_Open-R16-Roger_Federer-Lleyton_Hewitt,1,S-DTM,7,0,0,0,0,6,1
20040126-M-Australian_Open-R16-Roger_Federer-Lleyton_Hewitt,1,S-DTL,8,0,0,0,0,4,4
20040126-M-Australian_Open-R16-Roger_Federer-Lleyton_Hewitt,2,F-XC,86,14,1,6,7,50,36
20040126-M-Australian_Open-R16-Roger_Federer-Lleyton_Hewitt,2,F-DTM,20,4,0,1,3,9,11
20040126-M-Australian_Open-R16-Roger_Federer-Lleyton_Hewitt,2,F-DTL,26,7,2,3,2,13,13
20040126-M-Australian_Open-R16-Roger_Federer-Lleyton_Hewitt,2,F-IO,52,8,1,3,4,19,33
20040126-M-Australian_Open-R16-Roger_Federer-Lleyton_Hewitt,2,F-II,9,2,1,0,1,6,3
20040126-M-Australian_Open-R16-Roger_Federer-Lleyton_Hewitt,2,B-XC,92,5,0,2,3,54,38
20040126-M-Australian_Open-R16-Roger_Federer-Lleyton_Hewitt,2,B-DTM,17,1,0,0,1,13,4
20040126-M-Australian_Open-R16-Roger_Federer-Lleyton_Hewitt,2,B-DTL,10,4,1,2,1,5,5
20040126-M-Australian_Open-R16-Roger_Federer-Lleyton_Hewitt,2,B-IO,6,0,0,0,0,2,4
20040126-M-Australian_Open-R16-Roger_Federer-Lleyton_Hewitt,2,S-XC,19,0,0,0,0,9,10
20040126-M-Australian_Open-R16-Roger_Federer-Lleyton_Hewitt,2,S-DTM,4,0,0,0,0,3,1
20040126-M-Australian_Open-R16-Roger_Federer-Lleyton_Hewitt,2,S-DTL,6,3,1,2,0,4,2
19950311-M-Indian_Wells_Masters-SF-Pete_Sampras-Stefan_Edberg,1,F-XC,9,6,2,2,2,5,4
19950311-M-Indian_Wells_Masters-SF-Pete_Sampras-Stefan_Edberg,1,F-DTM,5,0,0,0,0,1,4
19950311-M-Indian_Wells_Masters-SF-Pete_Sampras-Stefan_Edberg,1,F-DTL,4,4,2,1,1,3,1
19950311-M-Indian_Wells_Masters-SF-Pete_Sampras-Stefan_Edberg,1,F-IO,12,8,2,4,2,7,5
19950311-M-Indian_Wells_Masters-SF-Pete_Sampras-Stefan_Edberg,1,B-XC,15,2,1,1,0,6,9
19950311-M-Indian_Wells_Masters-SF-Pete_Sampras-Stefan_Edberg,1,B-DTM,7,2,0,1,1,2,5
19950311-M-Indian_Wells_Masters-SF-Pete_Sampras-Stefan_Edberg,1,B-DTL,16,12,6,2,4,10,6
19950311-M-Indian_Wells_Masters-SF-Pete_Sampras-Stefan_Edberg,1,B-IO,2,2,1,1,0,2,0
19950311-M-Indian_Wells_Masters-SF-Pete_Sampras-Stefan_Edberg,1,S-XC,2,1,0,0,1,0,2
19950311-M-Indian_Wells_Masters-SF-Pete_Sampras-Stefan_Edberg,1,S-DTL,1,1,0,0,1,0,1
19950311-M-Indian_Wells_Masters-SF-Pete_Sampras-Stefan_Edberg,1,S-IO,1,1,0,0,1,0,1
19950311-M-Indian_Wells_Masters-SF-Pete_Sampras-Stefan_Edberg,2,F-XC,7,4,3,0,1,4,3
19950311-M-Indian_Wells_Masters-SF-Pete_Sampras-Stefan_Edberg,2,F-DTM,2,0,0,0,0,1,1
19950311-M-Indian_Wells_Masters-SF-Pete_Sampras-Stefan_Edberg,2,F-IO,5,1,0,1,0,3,2
19950311-M-Indian_Wells_Masters-SF-Pete_Sampras-Stefan_Edberg,2,B-XC,8,4,4,0,0,6,2
19950311-M-Indian_Wells_Masters-SF-Pete_Sampras-Stefan_Edberg,2,B-DTM,5,0,0,0,0,4,1
19950311-M-Indian_Wells_Masters-SF-Pete_Sampras-Stefan_Edberg,2,B-DTL,6,3,3,0,0,4,2
19950311-M-Indian_Wells_Masters-SF-Pete_Sampras-Stefan_Edberg,2,S-XC,9,0,0,0,0,6,3
20181016-M-Stockholm-R32-Philipp_Kohlschreiber-Alex_De_Minaur,1,F-XC,62,12,2,10,0,32,30
20181016-M-Stockholm-R32-Philipp_Kohlschreiber-Alex_De_Minaur,1,F-DTM,41,6,1,0,5,11,30
20181016-M-Stockholm-R32-Philipp_Kohlschreiber-Alex_De_Minaur,1,F-DTL,19,3,1,1,1,8,11
20181016-M-Stockholm-R32-Philipp_Kohlschreiber-Alex_De_Minaur,1,F-IO,56,14,5,3,6,29,27
20181016-M-Stockholm-R32-Philipp_Kohlschreiber-Alex_De_Minaur,1,F-II,3,1,0,1,0,3,0
20181016-M-Stockholm-R32-Philipp_Kohlschreiber-Alex_De_Minaur,1,B-XC,72,16,4,5,7,26,46
20181016-M-Stockholm-R32-Philipp_Kohlschreiber-Alex_De_Minaur,1,B-DTM,44,3,0,1,2,19,25
20181016-M-Stockholm-R32-Philipp_Kohlschreiber-Alex_De_Minaur,1,B-DTL,9,6,2,0,4,4,5
20181016-M-Stockholm-R32-Philipp_Kohlschreiber-Alex_De_Minaur,1,B-IO,3,2,0,0,2,1,2
20181016-M-Stockholm-R32-Philipp_Kohlschreiber-Alex_De_Minaur,1,S-XC,44,1,0,0,1,13,31
20181016-M-Stockholm-R32-Philipp_Kohlschreiber-Alex_De_Minaur,1,S-DTM,16,1,0,1,0,6,10
20181016-M-Stockholm-R32-Philipp_Kohlschreiber-Alex_De_Minaur,1,S-DTL,1,0,0,0,0,0,1
20181016-M-Stockholm-R32-Philipp_Kohlschreiber-Alex_De_Minaur,1,S-IO,3,0,0,0,0,1,2
20181016-M-Stockholm-R32-Philipp_Kohlschreiber-Alex_De_Minaur,2,F-XC,48,15,10,3,2,35,13
20181016-M-Stockholm-R32-Philipp_Kohlschreiber-Alex_De_Minaur,2,F-DTM,61,5,1,0,4,28,33
20181016-M-Stockholm-R32-Philipp_Kohlschreiber-Alex_De_Minaur,2,F-DTL,17,3,0,1,2,12,5
20181016-M-Stockholm-R32-Philipp_Kohlschreiber-Alex_De_Minaur,2,F-IO,61,10,5,0,5,46,15
20181016-M-Stockholm-R32-Philipp_Kohlschreiber-Alex_De_Minaur,2,F-II,5,2,2,0,0,5,0
20181016-M-Stockholm-R32-Philipp_Kohlschreiber-Alex_De_Minaur,2,B-XC,71,6,0,1,5,36,35
20181016-M-Stockholm-R32-Philipp_Kohlschreiber-Alex_De_Minaur,2,B-DTM,81,9,0,0,9,45,36
20181016-M-Stockholm-R32-Philipp_Kohlschreiber-Alex_De_Minaur,2,B-DTL,18,5,1,2,2,13,5
20181016-M-Stockholm-R32-Philipp_Kohlschreiber-Alex_De_Minaur,2,B-IO,4,0,0,0,0,4,0
20181016-M-Stockholm-R32-Philipp_Kohlschreiber-Alex_De_Minaur,2,S-XC,8,0,0,0,0,4,4
20181016-M-Stockholm-R32-Philipp_Kohlschreiber-Alex_De_Minaur,2,S-DTM,4,0,0,0,0,1,3
20181016-M-Stockholm-R32-Philipp_Kohlschreiber-Alex_De_Minaur,2,S-DTL,1,0,0,0,0,1,0
20181016-M-Stockholm-R32-Philipp_Kohlschreiber-Alex_De_Minaur,2,S-IO,1,1,0,0,1,0,1
19940305-M-Indian_Wells_Masters-SF-Pete_Sampras-Stefan_Edberg,1,F-XC,7,1,1,0,0,3,4
19940305-M-Indian_Wells_Masters-SF-Pete_Sampras-Stefan_Edberg,1,F-DTM,3,0,0,0,0,0,3
19940305-M-Indian_Wells_Masters-SF-Pete_Sampras-Stefan_Edberg,1,F-DTL,3,3,3,0,0,3,0
19940305-M-Indian_Wells_Masters-SF-Pete_Sampras-Stefan_Edberg,1,F-IO,7,3,1,2,0,5,2
19940305-M-Indian_Wells_Masters-SF-Pete_Sampras-Stefan_Edberg,1,B-XC,16,5,1,1,3,6,10
19940305-M-Indian_Wells_Masters-SF-Pete_Sampras-Stefan_Edberg,1,B-DTM,8,0,0,0,0,3,5
19940305-M-Indian_Wells_Masters-SF-Pete_Sampras-Stefan_Edberg,1,B-DTL,7,4,2,0,2,3,4
19940305-M-Indian_Wells_Masters-SF-Pete_Sampras-Stefan_Edberg,1,B-IO,1,1,0,0,1,0,1
19940305-M-Indian_Wells_Masters-SF-Pete_Sampras-Stefan_Edberg,1,S-XC,5,1,0,0,1,1,4
19940305-M-Indian_Wells_Masters-SF-Pete_Sampras-Stefan_Edberg,1,S-DTL,1,0,0,0,0,1,0
19940305-M-Indian_Wells_Masters-SF-Pete_Sampras-Stefan_Edberg,1,S-IO,1,0,0,0,0,0,1
19940305-M-Indian_Wells_Masters-SF-Pete_Sampras-Stefan_Edberg,2,F-XC,7,3,1,1,1,4,3
19940305-M-Indian_Wells_Masters-SF-Pete_Sampras-Stefan_Edberg,2,F-DTM,2,0,0,0,0,2,0
19940305-M-Indian_Wells_Masters-SF-Pete_Sampras-Stefan_Edberg,2,F-DTL,3,0,0,0,0,2,1
19940305-M-Indian_Wells_Masters-SF-Pete_Sampras-Stefan_Edberg,2,F-IO,3,0,0,0,0,1,2
19940305-M-Indian_Wells_Masters-SF-Pete_Sampras-Stefan_Edberg,2,B-XC,15,8,4,2,2,12,3
19940305-M-Indian_Wells_Masters-SF-Pete_Sampras-Stefan_Edberg,2,B-DTM,7,2,0,0,2,2,5
19940305-M-Indian_Wells_Masters-SF-Pete_Sampras-Stefan_Edberg,2,B-DTL,2,1,1,0,0,1,1
19940305-M-Indian_Wells_Masters-SF-Pete_Sampras-Stefan_Edberg,2,B-IO,3,2,0,0,2,0,3
19940305-M-Indian_Wells_Masters-SF-Pete_Sampras-Stefan_Edberg,2,S-XC,6,2,0,2,0,3,3
19940305-M-Indian_Wells_Masters-SF-Pete_Sampras-Stefan_Edberg,2,S-DTM,1,0,0,0,0,1,0
19940305-M-Indian_Wells_Masters-SF-Pete_Sampras-Stefan_Edberg,2,S-DTL,1,0,0,0,0,1,0
20040909-M-US_Open-QF-Lleyton_Hewitt-Tommy_Haas,1,F-XC,48,7,4,2,1,35,13
20040909-M-US_Open-QF-Lleyton_Hewitt-Tommy_Haas,1,F-DTM,21,3,1,0,2,11,10
20040909-M-US_Open-QF-Lleyton_Hewitt-Tommy_Haas,1,F-DTL,18,3,2,1,0,14,4
20040909-M-US_Open-QF-Lleyton_Hewitt-Tommy_Haas,1,F-IO,36,10,4,5,1,20,16
20040909-M-US_Open-QF-Lleyton_Hewitt-Tommy_Haas,1,F-II,1,0,0,0,0,0,1
20040909-M-US_Open-QF-Lleyton_Hewitt-Tommy_Haas,1,B-XC,33,5,2,2,1,20,13
20040909-M-US_Open-QF-Lleyton_Hewitt-Tommy_Haas,1,B-DTM,29,2,0,1,1,16,13
20040909-M-US_Open-QF-Lleyton_Hewitt-Tommy_Haas,1,B-DTL,10,6,3,2,1,7,3
20040909-M-US_Open-QF-Lleyton_Hewitt-Tommy_Haas,1,B-IO,20,11,5,2,4,14,6
20040909-M-US_Open-QF-Lleyton_Hewitt-Tommy_Haas,1,S-XC,15,1,0,1,0,11,4
20040909-M-US_Open-QF-Lleyton_Hewitt-Tommy_Haas,1,S-DTM,7,0,0,0,0,4,3
20040909-M-US_Open-QF-Lleyton_Hewitt-Tommy_Haas,1,S-DTL,3,2,0,2,0,3,0
20040909-M-US_Open-QF-Lleyton_Hewitt-Tommy_Haas,1,S-IO,1,0,0,0,0,0,1
20040909-M-US_Open-QF-Lleyton_Hewitt-Tommy_Haas,2,F-XC,58,16,2,4,10,17,41
20040909-M-US_Open-QF-Lleyton_Hewitt-Tommy_Haas,2,F-DTM,28,1,0,0,1,12,16
20040909-M-US_Open-QF-Lleyton_Hewitt-Tommy_Haas,2,F-DTL,10,4,1,1,2,3,7
20040909-M-US_Open-QF-Lleyton_Hewitt-Tommy_Haas,2,F-IO,23,5,1,0,4,9,14
20040909-M-US_Open-QF-Lleyton_Hewitt-Tommy_Haas,2,F-II,4,1,0,1,0,1,3
20040909-M-US_Open-QF-Lleyton_Hewitt-Tommy_Haas,2,B-XC,28,2,1,0,1,14,14
20040909-M-US_Open-QF-Lleyton_Hewitt-Tommy_Haas,2,B-DTM,17,1,0,1,0,7,10
20040909-M-US_Open-QF-Lleyton_Hewitt-Tommy_Haas,2,B-DTL,10,4,1,0,3,4,6
20040909-M-US_Open-QF-Lleyton_Hewitt-Tommy_Haas,2,B-IO,1,1,1,0,0,1,0
20040909-M-US_Open-QF-Lleyton_Hewitt-Tommy_Haas,2,S-XC,29,4,0,1,3,11,18
20040909-M-US_Open-QF-Lleyton_Hewitt-Tommy_Haas,2,S-DTM,12,0,0,0,0,6,6
20040909-M-US_Open-QF-Lleyton_Hewitt-Tommy_Haas,2,S-DTL,5,1,0,1,0,2,3
20040909-M-US_Open-QF-Lleyton_Hewitt-Tommy_Haas,2,S-IO,2,0,0,0,0,0,2
19940813-M-Cincinnati_Masters-SF-Stefan_Edberg-Michael_Stich,1,F-XC,13,6,1,1,4,6,7
19940813-M-Cincinnati_Masters-SF-Stefan_Edberg-Michael_Stich,1,F-DTM,4,0,0,0,0,2,2
19940813-M-Cincinnati_Masters-SF-Stefan_Edberg-Michael_Stich,1,F-DTL,4,3,0,1,2,2,2
19940813-M-Cincinnati_Masters-SF-Stefan_Edberg-Michael_Stich,1,F-IO,3,1,0,0,1,1,2
19940813-M-Cincinnati_Masters-SF-Stefan_Edberg-Michael_Stich,1,B-XC,11,4,2,1,1,4,7
19940813-M-Cincinnati_Masters-SF-Stefan_Edberg-Michael_Stich,1,B-DTM,3,1,0,1,0,2,1
19940813-M-Cincinnati_Masters-SF-Stefan_Edberg-Michael_Stich,1,B-DTL,4,1,0,0,1,0,4
19940813-M-Cincinnati_Masters-SF-Stefan_Edberg-Michael_Stich,1,B-IO,1,0,0,0,0,1,0
19940813-M-Cincinnati_Masters-SF-Stefan_Edberg-Michael_Stich,1,S-XC,4,0,0,0,0,4,0
19940813-M-Cincinnati_Masters-SF-Stefan_Edberg-Michael_Stich,1,S-DTM,3,0,0,0,0,3,0
19940813-M-Cincinnati_Masters-SF-Stefan_Edberg-Michael_Stich,2,F-XC,6,1,0,0,1,3,3
19940813-M-Cincinnati_Masters-SF-Stefan_Edberg-Michael_Stich,2,F-DTM,5,1,1,0,0,1,4
19940813-M-Cincinnati_Masters-SF-Stefan_Edberg-Michael_Stich,2,F-DTL,2,1,1,0,0,2,0
19940813-M-Cincinnati_Masters-SF-Stefan_Edberg-Michael_Stich,2,F-IO,2,1,0,1,0,2,0
19940813-M-Cincinnati_Masters-SF-Stefan_Edberg-Michael_Stich,2,B-XC,9,6,0,3,3,4,5
19940813-M-Cincinnati_Masters-SF-Stefan_Edberg-Michael_Stich,2,B-DTM,5,1,0,0,1,0,5
19940813-M-Cincinnati_Masters-SF-Stefan_Edberg-Michael_Stich,2,B-DTL,8,3,3,0,0,5,3
19940813-M-Cincinnati_Masters-SF-Stefan_Edberg-Michael_Stich,2,B-IO,2,1,0,0,1,0,2
19940813-M-Cincinnati_Masters-SF-Stefan_Edberg-Michael_Stich,2,S-XC,3,0,0,0,0,1,2
19940813-M-Cincinnati_Masters-SF-Stefan_Edberg-Michael_Stich,2,S-DTM,1,0,0,0,0,1,0
19940813-M-Cincinnati_Masters-SF-Stefan_Edberg-Michael_Stich,2,S-DTL,2,0,0,0,0,0,2
19940423-M-Monte_Carlo_Masters-SF-Sergi_Bruguera-Stefan_Edberg,1,F-XC,32,7,5,2,0,21,11
19940423-M-Monte_Carlo_Masters-SF-Sergi_Bruguera-Stefan_Edberg,1,F-DTM,20,0,0,0,0,10,10
19940423-M-Monte_Carlo_Masters-SF-Sergi_Bruguera-Stefan_Edberg,1,F-DTL,15,3,1,2,0,9,6
19940423-M-Monte_Carlo_Masters-SF-Sergi_Bruguera-Stefan_Edberg,1,F-IO,15,4,2,1,1,10,5
19940423-M-Monte_Carlo_Masters-SF-Sergi_Bruguera-Stefan_Edberg,1,F-II,4,1,0,1,0,3,1
19940423-M-Monte_Carlo_Masters-SF-Sergi_Bruguera-Stefan_Edberg,1,B-XC,33,1,0,0,1,17,16
19940423-M-Monte_Carlo_Masters-SF-Sergi_Bruguera-Stefan_Edberg,1,B-DTM,20,2,0,2,0,14,6
19940423-M-Monte_Carlo_Masters-SF-Sergi_Bruguera-Stefan_Edberg,1,B-DTL,14,7,3,2,2,7,7
19940423-M-Monte_Carlo_Masters-SF-Sergi_Bruguera-Stefan_Edberg,1,B-IO,2,0,0,0,0,0,2
19940423-M-Monte_Carlo_Masters-SF-Sergi_Bruguera-Stefan_Edberg,1,S-XC,3,1,1,0,0,2,1
19940423-M-Monte_Carlo_Masters-SF-Sergi_Bruguera-Stefan_Edberg,1,S-DTM,2,0,0,0,0,0,2
19940423-M-Monte_Carlo_Masters-SF-Sergi_Bruguera-Stefan_Edberg,2,F-XC,30,3,2,1,0,12,18
19940423-M-Monte_Carlo_Masters-SF-Sergi_Bruguera-Stefan_Edberg,2,F-DTM,7,1,0,0,1,3,4
19940423-M-Monte_Carlo_Masters-SF-Sergi_Bruguera-Stefan_Edberg,2,F-DTL,7,1,0,0,1,4,3
19940423-M-Monte_Carlo_Masters-SF-Sergi_Bruguera-Stefan_Edberg,2,F-IO,5,0,0,0,0,3,2
19940423-M-Monte_Carlo_Masters-SF-Sergi_Bruguera-Stefan_Edberg,2,F-II,2,1,0,0,1,0,2
19940423-M-Monte_Carlo_Masters-SF-Sergi_Bruguera-Stefan_Edberg,2,B-XC,18,3,0,2,1,11,7
19940423-M-Monte_Carlo_Masters-SF-Sergi_Bruguera-Stefan_Edberg,2,B-DTM,11,0,0,0,0,3,8
19940423-M-Monte_Carlo_Masters-SF-Sergi_Bruguera-Stefan_Edberg,2,B-DTL,5,3,0,1,2,1,4
19940423-M-Monte_Carlo_Masters-SF-Sergi_Bruguera-Stefan_Edberg,2,B-IO,1,1,0,1,0,1,0
19940423-M-Monte_Carlo_Masters-SF-Sergi_Bruguera-Stefan_Edberg,2,S-XC,22,2,0,0,2,9,13
19940423-M-Monte_Carlo_Masters-SF-Sergi_Bruguera-Stefan_Edberg,2,S-DTM,5,1,0,0,1,2,3
19940423-M-Monte_Carlo_Masters-SF-Sergi_Bruguera-Stefan_Edberg,2,S-DTL,7,4,0,3,1,3,4
19940423-M-Monte_Carlo_Masters-SF-Sergi_Bruguera-Stefan_Edberg,2,S-IO,1,0,0,0,0,0,1
20020303-M-San_Jose-F-Lleyton_Hewitt-Andre_Agassi,1,F-XC,107,23,10,3,10,49,58
20020303-M-San_Jose-F-Lleyton_Hewitt-Andre_Agassi,1,F-DTM,18,0,0,0,0,7,11
20020303-M-San_Jose-F-Lleyton_Hewitt-Andre_Agassi,1,F-DTL,37,9,5,1,3,14,23
20020303-M-San_Jose-F-Lleyton_Hewitt-Andre_Agassi,1,F-IO,33,8,6,0,2,21,12
20020303-M-San_Jose-F-Lleyton_Hewitt-Andre_Agassi,1,F-II,13,8,2,3,3,7,6
20020303-M-San_Jose-F-Lleyton_Hewitt-Andre_Agassi,1,B-XC,190,13,2,4,7,90,100
20020303-M-San_Jose-F-Lleyton_Hewitt-Andre_Agassi,1,B-DTM,28,2,0,0,2,11,17
20020303-M-San_Jose-F-Lleyton_Hewitt-Andre_Agassi,1,B-DTL,25,19,9,1,9,10,15
20020303-M-San_Jose-F-Lleyton_Hewitt-Andre_Agassi,1,B-IO,12,5,3,1,1,6,6
20020303-M-San_Jose-F-Lleyton_Hewitt-Andre_Agassi,1,S-XC,26,1,0,0,1,11,15
20020303-M-San_Jose-F-Lleyton_Hewitt-Andre_Agassi,1,S-DTM,2,2,0,0,2,0,2
20020303-M-San_Jose-F-Lleyton_Hewitt-Andre_Agassi,1,S-DTL,3,0,0,0,0,0,3
20020303-M-San_Jose-F-Lleyton_Hewitt-Andre_Agassi,2,F-XC,83,13,1,9,3,53,30
20020303-M-San_Jose-F-Lleyton_Hewitt-Andre_Agassi,2,F-DTM,17,1,0,0,1,9,8
20020303-M-San_Jose-F-Lleyton_Hewitt-Andre_Agassi,2,F-DTL,41,14,4,5,5,26,15
20020303-M-San_Jose-F-Lleyton_Hewitt-Andre_Agassi,2,F-IO,14,2,0,1,1,11,3
20020303-M-San_Jose-F-Lleyton_Hewitt-Andre_Agassi,2,F-II,14,6,3,2,1,9,5
20020303-M-San_Jose-F-Lleyton_Hewitt-Andre_Agassi,2,B-XC,192,12,1,4,7,111,81
20020303-M-San_Jose-F-Lleyton_Hewitt-Andre_Agassi,2,B-DTM,22,1,0,0,1,9,13
20020303-M-San_Jose-F-Lleyton_Hewitt-Andre_Agassi,2,B-DTL,31,10,5,1,4,17,14
20020303-M-San_Jose-F-Lleyton_Hewitt-Andre_Agassi,2,B-IO,13,2,0,2,0,9,4
20020303-M-San_Jose-F-Lleyton_Hewitt-Andre_Agassi,2,S-XC,33,0,0,0,0,15,18
20020303-M-San_Jose-F-Lleyton_Hewitt-Andre_Agassi,2,S-DTM,8,1,0,1,0,3,5
20020303-M-San_Jose-F-Lleyton_Hewitt-Andre_Agassi,2,S-DTL,4,1,0,1,0,2,2
20181021-M-Stockholm-F-Stefanos_Tsitsipas-Ernests_Gulbis,1,F-XC,22,6,0,3,3,12,10
20181021-M-Stockholm-F-Stefanos_Tsitsipas-Ernests_Gulbis,1,F-DTM,13,1,0,0,1,9,4
20181021-M-Stockholm-F-Stefanos_Tsitsipas-Ernests_Gulbis,1,F-DTL,4,0,0,0,0,3,1
20181021-M-Stockholm-F-Stefanos_Tsitsipas-Ernests_Gulbis,1,F-IO,10,5,1,3,1,7,3
20181021-M-Stockholm-F-Stefanos_Tsitsipas-Ernests_Gulbis,1,F-II,3,1,1,0,0,2,1
20181021-M-Stockholm-F-Stefanos_Tsitsipas-Ernests_Gulbis,1,B-XC,29,4,0,1,3,17,12
20181021-M-Stockholm-F-Stefanos_Tsitsipas-Ernests_Gulbis,1,B-DTM,24,0,0,0,0,12,12
20181021-M-Stockholm-F-Stefanos_Tsitsipas-Ernests_Gulbis,1,B-DTL,5,4,1,1,2,3,2
20181021-M-Stockholm-F-Stefanos_Tsitsipas-Ernests_Gulbis,1,B-IO,1,0,0,0,0,1,0
20181021-M-Stockholm-F-Stefanos_Tsitsipas-Ernests_Gulbis,1,S-XC,4,0,0,0,0,1,3
20181021-M-Stockholm-F-Stefanos_Tsitsipas-Ernests_Gulbis,1,S-DTM,5,0,0,0,0,2,3
20181021-M-Stockholm-F-Stefanos_Tsitsipas-Ernests_Gulbis,2,F-XC,14,6,2,0,4,6,8
20181021-M-Stockholm-F-Stefanos_Tsitsipas-Ernests_Gulbis,2,F-DTM,9,0,0,0,0,4,5
20181021-M-Stockholm-F-Stefanos_Tsitsipas-Ernests_Gulbis,2,F-DTL,9,0,0,0,0,5,4
20181021-M-Stockholm-F-Stefanos_Tsitsipas-Ernests_Gulbis,2,F-IO,11,4,1,0,3,6,5
20181021-M-Stockholm-F-Stefanos_Tsitsipas-Ernests_Gulbis,2,B-XC,45,11,3,3,5,19,26
20181021-M-Stockholm-F-Stefanos_Tsitsipas-Ernests_Gulbis,2,B-DTM,16,2,0,0,2,6,10
20181021-M-Stockholm-F-Stefanos_Tsitsipas-Ernests_Gulbis,2,B-DTL,9,3,2,0,1,5,4
20181021-M-Stockholm-F-Stefanos_Tsitsipas-Ernests_Gulbis,2,B-IO,4,2,0,0,2,2,2
20181021-M-Stockholm-F-Stefanos_Tsitsipas-Ernests_Gulbis,2,S-XC,1,0,0,0,0,0,1
20181021-M-Stockholm-F-Stefanos_Tsitsipas-Ernests_Gulbis,2,S-DTM,3,0,0,0,0,0,3
20170609-M-Roland_Garros-SF-Stanislas_Wawrinka-Andy_Murray,1,F-XC,116,29,12,2,15,64,52
20170609-M-Roland_Garros-SF-Stanislas_Wawrinka-Andy_Murray,1,F-DTM,53,4,0,0,4,21,32
20170609-M-Roland_Garros-SF-Stanislas_Wawrinka-Andy_Murray,1,F-DTL,28,13,9,1,3,17,11
20170609-M-Roland_Garros-SF-Stanislas_Wawrinka-Andy_Murray,1,F-IO,69,31,14,4,13,42,27
20170609-M-Roland_Garros-SF-Stanislas_Wawrinka-Andy_Murray,1,F-II,19,9,2,4,3,11,8
20170609-M-Roland_Garros-SF-Stanislas_Wawrinka-Andy_Murray,1,B-XC,129,24,6,6,12,75,54
20170609-M-Roland_Garros-SF-Stanislas_Wawrinka-Andy_Murray,1,B-DTM,35,5,0,0,5,15,20
20170609-M-Roland_Garros-SF-Stanislas_Wawrinka-Andy_Murray,1,B-DTL,36,17,10,3,4,21,15
20170609-M-Roland_Garros-SF-Stanislas_Wawrinka-Andy_Murray,1,B-IO,6,2,2,0,0,3,3
20170609-M-Roland_Garros-SF-Stanislas_Wawrinka-Andy_Murray,1,S-XC,26,2,0,1,1,13,13
20170609-M-Roland_Garros-SF-Stanislas_Wawrinka-Andy_Murray,1,S-DTM,15,1,0,1,0,5,10
20170609-M-Roland_Garros-SF-Stanislas_Wawrinka-Andy_Murray,1,S-DTL,4,0,0,0,0,2,2
20170609-M-Roland_Garros-SF-Stanislas_Wawrinka-Andy_Murray,1,S-IO,1,0,0,0,0,1,0
20170609-M-Roland_Garros-SF-Stanislas_Wawrinka-Andy_Murray,2,F-XC,108,21,9,6,6,53,55
20170609-M-Roland_Garros-SF-Stanislas_Wawrinka-Andy_Murray,2,F-DTM,62,2,0,0,2,34,28
20170609-M-Roland_Garros-SF-Stanislas_Wawrinka-Andy_Murray,2,F-DTL,37,6,3,2,1,18,19
20170609-M-Roland_Garros-SF-Stanislas_Wawrinka-Andy_Murray,2,F-IO,61,13,3,4,6,32,29
20170609-M-Roland_Garros-SF-Stanislas_Wawrinka-Andy_Murray,2,F-II,10,4,2,1,1,8,2
20170609-M-Roland_Garros-SF-Stanislas_Wawrinka-Andy_Murray,2,B-XC,103,16,2,6,8,50,53
20170609-M-Roland_Garros-SF-Stanislas_Wawrinka-Andy_Murray,2,B-DTM,57,2,0,0,2,23,34
20170609-M-Roland_Garros-SF-Stanislas_Wawrinka-Andy_Murray,2,B-DTL,15,4,1,1,2,6,9
20170609-M-Roland_Garros-SF-Stanislas_Wawrinka-Andy_Murray,2,B-IO,9,1,0,1,0,8,1
20170609-M-Roland_Garros-SF-Stanislas_Wawrinka-Andy_Murray,2,S-XC,21,0,0,0,0,8,13
20170609-M-Roland_Garros-SF-Stanislas_Wawrinka-Andy_Murray,2,S-DTM,21,1,0,1,0,8,13
20170609-M-Roland_Garros-SF-Stanislas_Wawrinka-Andy_Murray,2,S-DTL,4,2,1,1,0,2,2
20170609-M-Roland_Garros-SF-Stanislas_Wawrinka-Andy_Murray,2,S-IO,1,1,0,1,0,1,0
19870912-M-US_Open-SF-Stefan_Edberg-Mats_Wilander,1,F-XC,49,13,4,2,7,23,26
19870912-M-US_Open-SF-Stefan_Edberg-Mats_Wilander,1,F-DTM,17,1,0,0,1,4,13
19870912-M-US_Open-SF-Stefan_Edberg-Mats_Wilander,1,F-DTL,23,8,1,2,5,10,13
19870912-M-US_Open-SF-Stefan_Edberg-Mats_Wilander,1,F-IO,10,0,0,0,0,5,5
19870912-M-US_Open-SF-Stefan_Edberg-Mats_Wilander,1,F-II,2,1,0,1,0,2,0
19870912-M-US_Open-SF-Stefan_Edberg-Mats_Wilander,1,B-XC,36,4,0,1,3,14,22
19870912-M-US_Open-SF-Stefan_Edberg-Mats_Wilander,1,B-DTM,9,0,0,0,0,2,7
19870912-M-US_Open-SF-Stefan_Edberg-Mats_Wilander,1,B-DTL,8,8,6,0,2,6,2
19870912-M-US_Open-SF-Stefan_Edberg-Mats_Wilander,1,B-IO,3,2,0,0,2,1,2
19870912-M-US_Open-SF-Stefan_Edberg-Mats_Wilander,1,S-XC,20,4,0,0,4,6,14
19870912-M-US_Open-SF-Stefan_Edberg-Mats_Wilander,1,S-DTM,9,0,0,0,0,2,7
19870912-M-US_Open-SF-Stefan_Edberg-Mats_Wilander,1,S-DTL,7,2,0,2,0,4,3
19870912-M-US_Open-SF-Stefan_Edberg-Mats_Wilander,1,S-IO,4,1,0,0,1,2,2
19870912-M-US_Open-SF-Stefan_Edberg-Mats_Wilander,2,F-XC,45,12,5,3,4,25,20
19870912-M-US_Open-SF-Stefan_Edberg-Mats_Wilander,2,F-DTM,22,2,0,0,2,13,9
19870912-M-US_Open-SF-Stefan_Edberg-Mats_Wilander,2,F-DTL,21,6,3,2,1,9,12
19870912-M-US_Open-SF-Stefan_Edberg-Mats_Wilander,2,F-IO,10,1,0,1,0,10,0
19870912-M-US_Open-SF-Stefan_Edberg-Mats_Wilander,2,F-II,2,0,0,0,0,1,1
19870912-M-US_Open-SF-Stefan_Edberg-Mats_Wilander,2,B-XC,22,3,1,1,1,14,8
19870912-M-US_Open-SF-Stefan_Edberg-Mats_Wilander,2,B-DTM,22,0,0,0,0,13,9
19870912-M-US_Open-SF-Stefan_Edberg-Mats_Wilander,2,B-DTL,17,8,4,2,2,9,8
19870912-M-US_Open-SF-Stefan_Edberg-Mats_Wilander,2,B-IO,7,3,2,1,0,7,0
19870912-M-US_Open-SF-Stefan_Edberg-Mats_Wilander,2,S-XC,27,0,0,0,0,20,7
19870912-M-US_Open-SF-Stefan_Edberg-Mats_Wilander,2,S-DTM,17,1,0,1,0,9,8
19870912-M-US_Open-SF-Stefan_Edberg-Mats_Wilander,2,S-DTL,12,0,0,0,0,4,8
19870912-M-US_Open-SF-Stefan_Edberg-Mats_Wilander,2,S-IO,5,1,0,1,0,4,1
20030906-M-US_Open-SF-Andy_Roddick-David_Nalbandian,1,F-XC,80,19,4,11,4,36,44
20030906-M-US_Open-SF-Andy_Roddick-David_Nalbandian,1,F-DTM,46,1,0,0,1,15,31
20030906-M-US_Open-SF-Andy_Roddick-David_Nalbandian,1,F-DTL,16,5,1,3,1,8,8
20030906-M-US_Open-SF-Andy_Roddick-David_Nalbandian,1,F-IO,89,21,7,6,8,46,43
20030906-M-US_Open-SF-Andy_Roddick-David_Nalbandian,1,F-II,14,5,0,3,2,5,9
20030906-M-US_Open-SF-Andy_Roddick-David_Nalbandian,1,B-XC,93,8,2,1,5,40,53
20030906-M-US_Open-SF-Andy_Roddick-David_Nalbandian,1,B-DTM,50,4,0,1,3,17,33
20030906-M-US_Open-SF-Andy_Roddick-David_Nalbandian,1,B-DTL,13,7,1,3,3,6,7
20030906-M-US_Open-SF-Andy_Roddick-David_Nalbandian,1,B-IO,7,3,0,0,3,3,4
20030906-M-US_Open-SF-Andy_Roddick-David_Nalbandian,1,S-XC,33,4,0,2,2,12,21
20030906-M-US_Open-SF-Andy_Roddick-David_Nalbandian,1,S-DTM,13,1,0,0,1,2,11
20030906-M-US_Open-SF-Andy_Roddick-David_Nalbandian,1,S-DTL,10,1,0,0,1,5,5
20030906-M-US_Open-SF-Andy_Roddick-David_Nalbandian,1,S-IO,2,1,0,1,0,1,1
20030906-M-US_Open-SF-Andy_Roddick-David_Nalbandian,2,F-XC,90,30,10,17,3,65,25
20030906-M-US_Open-SF-Andy_Roddick-David_Nalbandian,2,F-DTM,55,5,0,3,2,31,24
20030906-M-US_Open-SF-Andy_Roddick-David_Nalbandian,2,F-DTL,29,8,3,2,3,20,9
20030906-M-US_Open-SF-Andy_Roddick-David_Nalbandian,2,F-IO,67,17,5,5,7,39,28
20030906-M-US_Open-SF-Andy_Roddick-David_Nalbandian,2,F-II,19,10,3,2,5,10,9
20030906-M-US_Open-SF-Andy_Roddick-David_Nalbandian,2,B-XC,113,7,1,4,2,76,37
20030906-M-US_Open-SF-Andy_Roddick-David_Nalbandian,2,B-DTM,33,2,0,0,2,21,12
20030906-M-US_Open-SF-Andy_Roddick-David_Nalbandian,2,B-DTL,27,14,7,3,4,19,8
20030906-M-US_Open-SF-Andy_Roddick-David_Nalbandian,2,B-IO,11,4,0,0,4,5,6
20030906-M-US_Open-SF-Andy_Roddick-David_Nalbandian,2,S-XC,41,5,0,3,2,21,20
20030906-M-US_Open-SF-Andy_Roddick-David_Nalbandian,2,S-DTM,22,1,0,0,1,6,16
20030906-M-US_Open-SF-Andy_Roddick-David_Nalbandian,2,S-DTL,8,1,0,0,1,3,5
20030906-M-US_Open-SF-Andy_Roddick-David_Nalbandian,2,S-IO,4,2,1,0,1,1,3
19960126-M-Australian_Open-SF-Mark_Woodforde-Boris_Becker,1,F-XC,21,5,2,2,1,12,9
19960126-M-Australian_Open-SF-Mark_Woodforde-Boris_Becker,1,F-DTM,9,2,0,0,2,2,7
19960126-M-Australian_Open-SF-Mark_Woodforde-Boris_Becker,1,F-DTL,1,0,0,0,0,0,1
19960126-M-Australian_Open-SF-Mark_Woodforde-Boris_Becker,1,F-IO,1,0,0,0,0,1,0
19960126-M-Australian_Open-SF-Mark_Woodforde-Boris_Becker,1,F-II,2,1,1,0,0,1,1
19960126-M-Australian_Open-SF-Mark_Woodforde-Boris_Becker,1,B-XC,2,1,1,0,0,1,1
19960126-M-Australian_Open-SF-Mark_Woodforde-Boris_Becker,1,B-DTM,6,0,0,0,0,4,2
19960126-M-Australian_Open-SF-Mark_Woodforde-Boris_Becker,1,B-DTL,3,1,0,0,1,1,2
19960126-M-Australian_Open-SF-Mark_Woodforde-Boris_Becker,1,S-XC,15,1,1,0,0,8,7
19960126-M-Australian_Open-SF-Mark_Woodforde-Boris_Becker,1,S-DTM,15,2,1,0,1,6,9
19960126-M-Australian_Open-SF-Mark_Woodforde-Boris_Becker,1,S-DTL,5,1,1,0,0,2,3
19960126-M-Australian_Open-SF-Mark_Woodforde-Boris_Becker,2,F-XC,26,7,5,1,1,14,12
19960126-M-Australian_Open-SF-Mark_Woodforde-Boris_Becker,2,F-DTM,5,0,0,0,0,1,4
19960126-M-Australian_Open-SF-Mark_Woodforde-Boris_Becker,2,F-DTL,6,1,1,0,0,3,3
19960126-M-Australian_Open-SF-Mark_Woodforde-Boris_Becker,2,F-IO,10,4,3,0,1,7,3
19960126-M-Australian_Open-SF-Mark_Woodforde-Boris_Becker,2,B-XC,9,5,3,1,1,5,4
19960126-M-Australian_Open-SF-Mark_Woodforde-Boris_Becker,2,B-DTM,8,0,0,0,0,6,2
19960126-M-Australian_Open-SF-Mark_Woodforde-Boris_Becker,2,B-DTL,7,3,0,1,2,4,3
19960126-M-Australian_Open-SF-Mark_Woodforde-Boris_Becker,2,B-IO,4,1,1,0,0,2,2
19960126-M-Australian_Open-SF-Mark_Woodforde-Boris_Becker,2,S-XC,2,0,0,0,0,1,1
19960126-M-Australian_Open-SF-Mark_Woodforde-Boris_Becker,2,S-DTM,1,0,0,0,0,0,1
19960126-M-Australian_Open-SF-Mark_Woodforde-Boris_Becker,2,S-DTL,1,0,0,0,0,0,1
19970905-M-US_Open-SF-Michael_Chang-Patrick_Rafter,1,F-XC,38,10,2,5,3,20,18
19970905-M-US_Open-SF-Michael_Chang-Patrick_Rafter,1,F-DTM,19,3,0,1,2,9,10
19970905-M-US_Open-SF-Michael_Chang-Patrick_Rafter,1,F-DTL,13,1,0,1,0,5,8
19970905-M-US_Open-SF-Michael_Chang-Patrick_Rafter,1,F-IO,21,3,1,1,1,15,6
19970905-M-US_Open-SF-Michael_Chang-Patrick_Rafter,1,F-II,10,0,0,0,0,6,4
19970905-M-US_Open-SF-Michael_Chang-Patrick_Rafter,1,B-XC,35,3,0,0,3,24,11
19970905-M-US_Open-SF-Michael_Chang-Patrick_Rafter,1,B-DTM,14,0,0,0,0,8,6
19970905-M-US_Open-SF-Michael_Chang-Patrick_Rafter,1,B-DTL,9,3,1,2,0,4,5
19970905-M-US_Open-SF-Michael_Chang-Patrick_Rafter,1,B-IO,2,1,0,0,1,1,1
19970905-M-US_Open-SF-Michael_Chang-Patrick_Rafter,1,S-XC,7,1,0,1,0,4,3
19970905-M-US_Open-SF-Michael_Chang-Patrick_Rafter,1,S-DTM,1,1,0,1,0,1,0
19970905-M-US_Open-SF-Michael_Chang-Patrick_Rafter,1,S-DTL,2,0,0,0,0,1,1
19970905-M-US_Open-SF-Michael_Chang-Patrick_Rafter,2,F-XC,26,7,2,2,3,12,14
19970905-M-US_Open-SF-Michael_Chang-Patrick_Rafter,2,F-DTM,14,0,0,0,0,5,9
19970905-M-US_Open-SF-Michael_Chang-Patrick_Rafter,2,F-DTL,9,3,2,0,1,4,5
19970905-M-US_Open-SF-Michael_Chang-Patrick_Rafter,2,F-IO,4,0,0,0,0,1,3
19970905-M-US_Open-SF-Michael_Chang-Patrick_Rafter,2,F-II,1,1,0,0,1,0,1
19970905-M-US_Open-SF-Michael_Chang-Patrick_Rafter,2,B-XC,11,1,0,0,1,2,9
19970905-M-US_Open-SF-Michael_Chang-Patrick_Rafter,2,B-DTM,8,0,0,0,0,2,6
19970905-M-US_Open-SF-Michael_Chang-Patrick_Rafter,2,B-DTL,4,2,0,0,2,1,3
19970905-M-US_Open-SF-Michael_Chang-Patrick_Rafter,2,B-IO,2,1,0,0,1,1,1
19970905-M-US_Open-SF-Michael_Chang-Patrick_Rafter,2,S-XC,26,0,0,0,0,13,13
19970905-M-US_Open-SF-Michael_Chang-Patrick_Rafter,2,S-DTM,9,3,0,0,3,3,6
19970905-M-US_Open-SF-Michael_Chang-Patrick_Rafter,2,S-DTL,5,2,0,0,2,0,5
19970905-M-US_Open-SF-Michael_Chang-Patrick_Rafter,2,S-IO,1,0,0,0,0,1,0
20170714-M-Wimbledon-SF-Tomas_Berdych-Roger_Federer,1,F-XC,42,12,6,4,2,26,16
20170714-M-Wimbledon-SF-Tomas_Berdych-Roger_Federer,1,F-DTM,16,3,0,1,2,6,10
20170714-M-Wimbledon-SF-Tomas_Berdych-Roger_Federer,1,F-DTL,8,3,1,0,2,4,4
20170714-M-Wimbledon-SF-Tomas_Berdych-Roger_Federer,1,F-IO,31,8,2,1,5,11,20
20170714-M-Wimbledon-SF-Tomas_Berdych-Roger_Federer,1,F-II,5,1,0,0,1,3,2
20170714-M-Wimbledon-SF-Tomas_Berdych-Roger_Federer,1,B-XC,30,6,1,3,2,15,15
20170714-M-Wimbledon-SF-Tomas_Berdych-Roger_Federer,1,B-DTM,23,4,0,0,4,8,15
20170714-M-Wimbledon-SF-Tomas_Berdych-Roger_Federer,1,B-DTL,7,3,1,0,2,3,4
20170714-M-Wimbledon-SF-Tomas_Berdych-Roger_Federer,1,B-IO,4,2,0,1,1,2,2
20170714-M-Wimbledon-SF-Tomas_Berdych-Roger_Federer,1,S-XC,7,1,0,0,1,4,3
20170714-M-Wimbledon-SF-Tomas_Berdych-Roger_Federer,1,S-DTM,7,0,0,0,0,2,5
20170714-M-Wimbledon-SF-Tomas_Berdych-Roger_Federer,1,S-DTL,2,1,0,0,1,0,2
20170714-M-Wimbledon-SF-Tomas_Berdych-Roger_Federer,2,F-XC,46,23,9,8,6,25,21
20170714-M-Wimbledon-SF-Tomas_Berdych-Roger_Federer,2,F-DTM,24,3,0,2,1,14,10
20170714-M-Wimbledon-SF-Tomas_Berdych-Roger_Federer,2,F-DTL,16,8,4,1,3,9,7
20170714-M-Wimbledon-SF-Tomas_Berdych-Roger_Federer,2,F-IO,30,10,3,5,2,20,10
20170714-M-Wimbledon-SF-Tomas_Berdych-Roger_Federer,2,F-II,9,5,3,2,0,8,1
20170714-M-Wimbledon-SF-Tomas_Berdych-Roger_Federer,2,B-XC,12,9,1,2,6,6,6
20170714-M-Wimbledon-SF-Tomas_Berdych-Roger_Federer,2,B-DTM,16,3,0,0,3,6,10
20170714-M-Wimbledon-SF-Tomas_Berdych-Roger_Federer,2,B-DTL,5,3,2,0,1,4,1
20170714-M-Wimbledon-SF-Tomas_Berdych-Roger_Federer,2,B-IO,2,2,1,0,1,1,1
20170714-M-Wimbledon-SF-Tomas_Berdych-Roger_Federer,2,S-XC,11,0,0,0,0,7,4
20170714-M-Wimbledon-SF-Tomas_Berdych-Roger_Federer,2,S-DTM,6,0,0,0,0,5,1
20170714-M-Wimbledon-SF-Tomas_Berdych-Roger_Federer,2,S-DTL,3,0,0,0,0,1,2
20030701-M-Wimbledon-SF-Andy_Roddick-Roger_Federer,1,F-XC,21,5,1,2,2,11,10
20030701-M-Wimbledon-SF-Andy_Roddick-Roger_Federer,1,F-DTM,17,2,0,0,2,5,12
20030701-M-Wimbledon-SF-Andy_Roddick-Roger_Federer,1,F-DTL,9,0,0,0,0,3,6
20030701-M-Wimbledon-SF-Andy_Roddick-Roger_Federer,1,F-IO,33,7,1,4,2,23,10
20030701-M-Wimbledon-SF-Andy_Roddick-Roger_Federer,1,F-II,5,2,0,1,1,3,2
20030701-M-Wimbledon-SF-Andy_Roddick-Roger_Federer,1,B-XC,33,7,2,1,4,12,21
20030701-M-Wimbledon-SF-Andy_Roddick-Roger_Federer,1,B-DTM,16,1,0,0,1,4,12
20030701-M-Wimbledon-SF-Andy_Roddick-Roger_Federer,1,B-DTL,12,3,2,0,1,4,8
20030701-M-Wimbledon-SF-Andy_Roddick-Roger_Federer,1,B-IO,1,0,0,0,0,0,1
20030701-M-Wimbledon-SF-Andy_Roddick-Roger_Federer,1,S-XC,3,1,0,0,1,0,3
20030701-M-Wimbledon-SF-Andy_Roddick-Roger_Federer,1,S-DTM,1,0,0,0,0,0,1
20030701-M-Wimbledon-SF-Andy_Roddick-Roger_Federer,1,S-DTL,2,1,0,1,0,1,1
20030701-M-Wimbledon-SF-Andy_Roddick-Roger_Federer,2,F-XC,31,20,11,6,3,25,6
20030701-M-Wimbledon-SF-Andy_Roddick-Roger_Federer,2,F-DTM,9,0,0,0,0,5,4
20030701-M-Wimbledon-SF-Andy_Roddick-Roger_Federer,2,F-DTL,14,8,3,3,2,10,4
20030701-M-Wimbledon-SF-Andy_Roddick-Roger_Federer,2,F-IO,20,4,1,0,3,13,7
20030701-M-Wimbledon-SF-Andy_Roddick-Roger_Federer,2,F-II,3,2,1,0,1,2,1
20030701-M-Wimbledon-SF-Andy_Roddick-Roger_Federer,2,B-XC,20,5,4,0,1,9,11
20030701-M-Wimbledon-SF-Andy_Roddick-Roger_Federer,2,B-DTM,14,3,0,0,3,5,9
20030701-M-Wimbledon-SF-Andy_Roddick-Roger_Federer,2,B-DTL,11,6,2,0,4,4,7
20030701-M-Wimbledon-SF-Andy_Roddick-Roger_Federer,2,S-XC,8,0,0,0,0,5,3
20030701-M-Wimbledon-SF-Andy_Roddick-Roger_Federer,2,S-DTM,4,1,0,0,1,0,4
20030701-M-Wimbledon-SF-Andy_Roddick-Roger_Federer,2,S-DTL,9,2,0,2,0,7,2
20040130-M-Australian_Open-SF-Roger_Federer-Juan_Carlos_Ferrero,1,F-XC,33,15,5,6,4,20,13
20040130-M-Australian_Open-SF-Roger_Federer-Juan_Carlos_Ferrero,1,F-DTM,22,6,0,2,4,11,11
20040130-M-Australian_Open-SF-Roger_Federer-Juan_Carlos_Ferrero,1,F-DTL,9,5,4,0,1,4,5
20040130-M-Australian_Open-SF-Roger_Federer-Juan_Carlos_Ferrero,1,F-IO,15,8,3,2,3,10,5
20040130-M-Australian_Open-SF-Roger_Federer-Juan_Carlos_Ferrero,1,F-II,3,2,1,1,0,3,0
20040130-M-Australian_Open-SF-Roger_Federer-Juan_Carlos_Ferrero,1,B-XC,23,1,0,0,1,12,11
20040130-M-Australian_Open-SF-Roger_Federer-Juan_Carlos_Ferrero,1,B-DTM,26,3,0,0,3,11,15
20040130-M-Australian_Open-SF-Roger_Federer-Juan_Carlos_Ferrero,1,B-DTL,9,6,0,1,5,3,6
20040130-M-Australian_Open-SF-Roger_Federer-Juan_Carlos_Ferrero,1,B-IO,1,1,0,0,1,0,1
20040130-M-Australian_Open-SF-Roger_Federer-Juan_Carlos_Ferrero,1,S-XC,20,3,1,2,0,11,9
20040130-M-Australian_Open-SF-Roger_Federer-Juan_Carlos_Ferrero,1,S-DTM,10,0,0,0,0,5,5
20040130-M-Australian_Open-SF-Roger_Federer-Juan_Carlos_Ferrero,1,S-DTL,1,0,0,0,0,1,0
20040130-M-Australian_Open-SF-Roger_Federer-Juan_Carlos_Ferrero,2,F-XC,32,13,3,4,6,16,16
20040130-M-Australian_Open-SF-Roger_Federer-Juan_Carlos_Ferrero,2,F-DTM,17,0,0,0,0,10,7
20040130-M-Australian_Open-SF-Roger_Federer-Juan_Carlos_Ferrero,2,F-DTL,13,3,0,1,2,4,9
20040130-M-Australian_Open-SF-Roger_Federer-Juan_Carlos_Ferrero,2,F-IO,22,4,1,1,2,10,12
20040130-M-Australian_Open-SF-Roger_Federer-Juan_Carlos_Ferrero,2,F-II,3,0,0,0,0,0,3
20040130-M-Australian_Open-SF-Roger_Federer-Juan_Carlos_Ferrero,2,B-XC,46,5,1,1,3,25,21
20040130-M-Australian_Open-SF-Roger_Federer-Juan_Carlos_Ferrero,2,B-DTM,18,2,0,0,2,10,8
20040130-M-Australian_Open-SF-Roger_Federer-Juan_Carlos_Ferrero,2,B-DTL,9,4,2,1,1,6,3
20040130-M-Australian_Open-SF-Roger_Federer-Juan_Carlos_Ferrero,2,B-IO,3,2,1,1,0,2,1
20040130-M-Australian_Open-SF-Roger_Federer-Juan_Carlos_Ferrero,2,S-XC,1,1,0,0,1,0,1
20040130-M-Australian_Open-SF-Roger_Federer-Juan_Carlos_Ferrero,2,S-DTM,1,0,0,0,0,0,1
20040130-M-Australian_Open-SF-Roger_Federer-Juan_Carlos_Ferrero,2,S-DTL,1,1,0,1,0,1,0
20010508-M-Rome_Masters-R64-Marcelo_Rios-Davide_Sanguinetti,1,F-XC,90,11,2,4,5,51,39
20010508-M-Rome_Masters-R64-Marcelo_Rios-Davide_Sanguinetti,1,F-DTM,15,1,0,0,1,7,8
20010508-M-Rome_Masters-R64-Marcelo_Rios-Davide_Sanguinetti,1,F-DTL,33,18,4,3,11,14,19
20010508-M-Rome_Masters-R64-Marcelo_Rios-Davide_Sanguinetti,1,F-IO,27,10,3,3,4,20,7
20010508-M-Rome_Masters-R64-Marcelo_Rios-Davide_Sanguinetti,1,F-II,1,0,0,0,0,1,0
20010508-M-Rome_Masters-R64-Marcelo_Rios-Davide_Sanguinetti,1,B-XC,39,15,1,3,11,17,22
20010508-M-Rome_Masters-R64-Marcelo_Rios-Davide_Sanguinetti,1,B-DTM,26,3,0,0,3,10,16
20010508-M-Rome_Masters-R64-Marcelo_Rios-Davide_Sanguinetti,1,B-DTL,22,7,0,1,6,12,10
20010508-M-Rome_Masters-R64-Marcelo_Rios-Davide_Sanguinetti,1,B-IO,15,3,0,0,3,6,9
20010508-M-Rome_Masters-R64-Marcelo_Rios-Davide_Sanguinetti,1,S-XC,4,2,2,0,0,3,1
20010508-M-Rome_Masters-R64-Marcelo_Rios-Davide_Sanguinetti,1,S-DTM,2,0,0,0,0,1,1
20010508-M-Rome_Masters-R64-Marcelo_Rios-Davide_Sanguinetti,1,S-IO,2,0,0,0,0,1,1
20010508-M-Rome_Masters-R64-Marcelo_Rios-Davide_Sanguinetti,2,F-XC,59,8,1,1,6,25,34
20010508-M-Rome_Masters-R64-Marcelo_Rios-Davide_Sanguinetti,2,F-DTM,17,2,0,1,1,7,10
20010508-M-Rome_Masters-R64-Marcelo_Rios-Davide_Sanguinetti,2,F-DTL,12,3,1,2,0,5,7
20010508-M-Rome_Masters-R64-Marcelo_Rios-Davide_Sanguinetti,2,F-IO,9,3,0,1,2,3,6
20010508-M-Rome_Masters-R64-Marcelo_Rios-Davide_Sanguinetti,2,B-XC,92,17,2,1,14,42,50
20010508-M-Rome_Masters-R64-Marcelo_Rios-Davide_Sanguinetti,2,B-DTM,46,6,1,0,5,20,26
20010508-M-Rome_Masters-R64-Marcelo_Rios-Davide_Sanguinetti,2,B-DTL,17,5,1,1,3,5,12
20010508-M-Rome_Masters-R64-Marcelo_Rios-Davide_Sanguinetti,2,B-IO,11,3,0,0,3,5,6
20010508-M-Rome_Masters-R64-Marcelo_Rios-Davide_Sanguinetti,2,S-DTL,1,0,0,0,0,1,0
20040703-M-Wimbledon-SF-Sebastien_Grosjean-Roger_Federer,1,F-XC,40,12,5,1,6,13,27
20040703-M-Wimbledon-SF-Sebastien_Grosjean-Roger_Federer,1,F-DTM,35,2,0,0,2,11,24
20040703-M-Wimbledon-SF-Sebastien_Grosjean-Roger_Federer,1,F-DTL,14,2,0,1,1,8,6
20040703-M-Wimbledon-SF-Sebastien_Grosjean-Roger_Federer,1,F-IO,44,8,2,1,5,19,25
20040703-M-Wimbledon-SF-Sebastien_Grosjean-Roger_Federer,1,F-II,9,3,1,1,1,4,5
20040703-M-Wimbledon-SF-Sebastien_Grosjean-Roger_Federer,1,B-XC,20,1,0,1,0,10,10
20040703-M-Wimbledon-SF-Sebastien_Grosjean-Roger_Federer,1,B-DTM,23,2,0,0,2,4,19
20040703-M-Wimbledon-SF-Sebastien_Grosjean-Roger_Federer,1,B-DTL,10,7,1,5,1,8,2
20040703-M-Wimbledon-SF-Sebastien_Grosjean-Roger_Federer,1,S-XC,7,0,0,0,0,3,4
20040703-M-Wimbledon-SF-Sebastien_Grosjean-Roger_Federer,1,S-DTM,7,1,0,1,0,2,5
20040703-M-Wimbledon-SF-Sebastien_Grosjean-Roger_Federer,1,S-DTL,3,1,0,1,0,1,2
20040703-M-Wimbledon-SF-Sebastien_Grosjean-Roger_Federer,1,S-IO,1,0,0,0,0,1,0
20040703-M-Wimbledon-SF-Sebastien_Grosjean-Roger_Federer,2,F-XC,51,23,13,7,3,36,15
20040703-M-Wimbledon-SF-Sebastien_Grosjean-Roger_Federer,2,F-DTM,24,5,1,1,3,15,9
20040703-M-Wimbledon-SF-Sebastien_Grosjean-Roger_Federer,2,F-DTL,8,3,1,1,1,4,4
20040703-M-Wimbledon-SF-Sebastien_Grosjean-Roger_Federer,2,F-IO,43,14,6,4,4,29,14
20040703-M-Wimbledon-SF-Sebastien_Grosjean-Roger_Federer,2,F-II,3,1,0,1,0,2,1
20040703-M-Wimbledon-SF-Sebastien_Grosjean-Roger_Federer,2,B-XC,31,4,3,0,1,18,13
20040703-M-Wimbledon-SF-Sebastien_Grosjean-Roger_Federer,2,B-DTM,20,3,0,0,3,11,9
20040703-M-Wimbledon-SF-Sebastien_Grosjean-Roger_Federer,2,B-DTL,20,9,3,0,6,11,9
20040703-M-Wimbledon-SF-Sebastien_Grosjean-Roger_Federer,2,S-XC,9,0,0,0,0,7,2
20040703-M-Wimbledon-SF-Sebastien_Grosjean-Roger_Federer,2,S-DTM,8,1,0,1,0,4,4
20040703-M-Wimbledon-SF-Sebastien_Grosjean-Roger_Federer,2,S-DTL,3,0,0,0,0,1,2
20181028-M-Basel-F-Roger_Federer-Marius_Copil,1,F-XC,33,9,3,2,4,23,10
20181028-M-Basel-F-Roger_Federer-Marius_Copil,1,F-DTM,20,1,0,0,1,12,8
20181028-M-Basel-F-Roger_Federer-Marius_Copil,1,F-DTL,10,2,1,1,0,5,5
20181028-M-Basel-F-Roger_Federer-Marius_Copil,1,F-IO,20,3,1,1,1,11,9
20181028-M-Basel-F-Roger_Federer-Marius_Copil,1,F-II,5,2,0,1,1,2,3
20181028-M-Basel-F-Roger_Federer-Marius_Copil,1,B-XC,11,1,0,0,1,6,5
20181028-M-Basel-F-Roger_Federer-Marius_Copil,1,B-DTM,6,1,0,1,0,3,3
20181028-M-Basel-F-Roger_Federer-Marius_Copil,1,B-DTL,5,2,0,1,1,3,2
20181028-M-Basel-F-Roger_Federer-Marius_Copil,1,S-XC,14,1,0,0,1,8,6
20181028-M-Basel-F-Roger_Federer-Marius_Copil,1,S-DTM,9,1,0,0,1,7,2
20181028-M-Basel-F-Roger_Federer-Marius_Copil,1,S-DTL,4,1,0,1,0,2,2
20181028-M-Basel-F-Roger_Federer-Marius_Copil,1,S-IO,1,0,0,0,0,1,0
20181028-M-Basel-F-Roger_Federer-Marius_Copil,2,F-XC,22,9,2,1,6,6,16
20181028-M-Basel-F-Roger_Federer-Marius_Copil,2,F-DTM,19,0,0,0,0,6,13
20181028-M-Basel-F-Roger_Federer-Marius_Copil,2,F-DTL,11,4,0,0,4,2,9
20181028-M-Basel-F-Roger_Federer-Marius_Copil,2,F-IO,13,4,2,0,2,6,7
20181028-M-Basel-F-Roger_Federer-Marius_Copil,2,F-II,1,0,0,0,0,0,1
20181028-M-Basel-F-Roger_Federer-Marius_Copil,2,B-XC,18,7,1,2,4,9,9
20181028-M-Basel-F-Roger_Federer-Marius_Copil,2,B-DTM,10,0,0,0,0,7,3
20181028-M-Basel-F-Roger_Federer-Marius_Copil,2,B-DTL,8,3,0,0,3,2,6
20181028-M-Basel-F-Roger_Federer-Marius_Copil,2,B-IO,4,2,1,0,1,2,2
20181028-M-Basel-F-Roger_Federer-Marius_Copil,2,S-XC,17,1,0,0,1,7,10
20181028-M-Basel-F-Roger_Federer-Marius_Copil,2,S-DTM,7,0,0,0,0,2,5
20181028-M-Basel-F-Roger_Federer-Marius_Copil,2,S-DTL,4,1,0,0,1,2,2
20181028-M-Basel-F-Roger_Federer-Marius_Copil,2,S-IO,1,0,0,0,0,0,1
20080704-M-Wimbledon-SF-Roger_Federer-Marat_Safin,1,F-XC,23,8,4,3,1,16,7
20080704-M-Wimbledon-SF-Roger_Federer-Marat_Safin,1,F-DTM,24,4,1,0,3,15,9
20080704-M-Wimbledon-SF-Roger_Federer-Marat_Safin,1,F-DTL,12,9,3,4,2,9,3
20080704-M-Wimbledon-SF-Roger_Federer-Marat_Safin,1,F-IO,11,5,3,1,1,8,3
20080704-M-Wimbledon-SF-Roger_Federer-Marat_Safin,1,F-II,8,4,2,1,1,6,2
20080704-M-Wimbledon-SF-Roger_Federer-Marat_Safin,1,B-XC,7,5,3,0,2,5,2
20080704-M-Wimbledon-SF-Roger_Federer-Marat_Safin,1,B-DTM,13,0,0,0,0,7,6
20080704-M-Wimbledon-SF-Roger_Federer-Marat_Safin,1,B-DTL,8,4,1,1,2,5,3
20080704-M-Wimbledon-SF-Roger_Federer-Marat_Safin,1,B-IO,1,0,0,0,0,1,0
20080704-M-Wimbledon-SF-Roger_Federer-Marat_Safin,1,S-XC,15,1,0,0,1,7,8
20080704-M-Wimbledon-SF-Roger_Federer-Marat_Safin,1,S-DTM,15,0,0,0,0,5,10
20080704-M-Wimbledon-SF-Roger_Federer-Marat_Safin,1,S-DTL,3,0,0,0,0,1,2
20080704-M-Wimbledon-SF-Roger_Federer-Marat_Safin,2,F-XC,26,9,1,4,4,13,13
20080704-M-Wimbledon-SF-Roger_Federer-Marat_Safin,2,F-DTM,19,2,0,0,2,5,14
20080704-M-Wimbledon-SF-Roger_Federer-Marat_Safin,2,F-DTL,10,6,0,0,6,3,7
20080704-M-Wimbledon-SF-Roger_Federer-Marat_Safin,2,F-IO,12,4,2,0,2,8,4
20080704-M-Wimbledon-SF-Roger_Federer-Marat_Safin,2,B-XC,46,11,1,5,5,21,25
20080704-M-Wimbledon-SF-Roger_Federer-Marat_Safin,2,B-DTM,15,3,0,0,3,5,10
20080704-M-Wimbledon-SF-Roger_Federer-Marat_Safin,2,B-DTL,6,4,2,0,2,2,4
20080704-M-Wimbledon-SF-Roger_Federer-Marat_Safin,2,B-IO,4,0,0,0,0,3,1
20080704-M-Wimbledon-SF-Roger_Federer-Marat_Safin,2,S-XC,1,0,0,0,0,0,1
20080704-M-Wimbledon-SF-Roger_Federer-Marat_Safin,2,S-DTM,1,0,0,0,0,0,1
20080704-M-Wimbledon-SF-Roger_Federer-Marat_Safin,2,S-IO,1,1,0,1,0,1,0
19900707-M-Wimbledon-SF-Stefan_Edberg-Ivan_Lendl,1,F-XC,3,3,2,1,0,3,0
19900707-M-Wimbledon-SF-Stefan_Edberg-Ivan_Lendl,1,F-DTM,1,0,0,0,0,0,1
19900707-M-Wimbledon-SF-Stefan_Edberg-Ivan_Lendl,1,F-DTL,2,1,0,1,0,2,0
19900707-M-Wimbledon-SF-Stefan_Edberg-Ivan_Lendl,1,B-XC,1,0,0,0,0,1,0
19900707-M-Wimbledon-SF-Stefan_Edberg-Ivan_Lendl,1,B-DTM,1,0,0,0,0,0,1
19900707-M-Wimbledon-SF-Stefan_Edberg-Ivan_Lendl,1,B-DTL,4,3,2,0,1,2,2
19900707-M-Wimbledon-SF-Stefan_Edberg-Ivan_Lendl,1,B-IO,2,1,0,0,1,0,2
19900707-M-Wimbledon-SF-Stefan_Edberg-Ivan_Lendl,2,F-XC,2,2,2,0,0,2,0
19900707-M-Wimbledon-SF-Stefan_Edberg-Ivan_Lendl,2,F-DTM,2,0,0,0,0,0,2
19900707-M-Wimbledon-SF-Stefan_Edberg-Ivan_Lendl,2,F-IO,1,1,1,0,0,1,0
19900707-M-Wimbledon-SF-Stefan_Edberg-Ivan_Lendl,2,F-II,1,1,0,0,1,0,1
19900707-M-Wimbledon-SF-Stefan_Edberg-Ivan_Lendl,2,B-XC,2,0,0,0,0,1,1
19900707-M-Wimbledon-SF-Stefan_Edberg-Ivan_Lendl,2,B-DTM,1,0,0,0,0,0,1
19900707-M-Wimbledon-SF-Stefan_Edberg-Ivan_Lendl,2,B-DTL,1,1,0,0,1,0,1
19900707-M-Wimbledon-SF-Stefan_Edberg-Ivan_Lendl,2,S-DTM,1,0,0,0,0,0,1
19900707-M-Wimbledon-SF-Stefan_Edberg-Ivan_Lendl,2,S-IO,1,0,0,0,0,0,1
20120909-M-US_Open-SF-Novak_Djokovic-David_Ferrer,1,F-XC,65,13,7,4,2,39,26
20120909-M-US_Open-SF-Novak_Djokovic-David_Ferrer,1,F-DTM,39,3,0,0,3,18,21
20120909-M-US_Open-SF-Novak_Djokovic-David_Ferrer,1,F-DTL,29,6,0,3,3,19,10
20120909-M-US_Open-SF-Novak_Djokovic-David_Ferrer,1,F-IO,36,8,4,3,1,21,15
20120909-M-US_Open-SF-Novak_Djokovic-David_Ferrer,1,F-II,8,1,0,1,0,4,4
20120909-M-US_Open-SF-Novak_Djokovic-David_Ferrer,1,B-XC,98,9,2,2,5,57,41
20120909-M-US_Open-SF-Novak_Djokovic-David_Ferrer,1,B-DTM,48,4,0,1,3,24,24
20120909-M-US_Open-SF-Novak_Djokovic-David_Ferrer,1,B-DTL,25,9,0,4,5,13,12
20120909-M-US_Open-SF-Novak_Djokovic-David_Ferrer,1,B-IO,11,5,0,0,5,5,6
20120909-M-US_Open-SF-Novak_Djokovic-David_Ferrer,1,S-XC,16,0,0,0,0,12,4
20120909-M-US_Open-SF-Novak_Djokovic-David_Ferrer,1,S-DTM,12,1,0,0,1,4,8
20120909-M-US_Open-SF-Novak_Djokovic-David_Ferrer,1,S-DTL,4,1,0,0,1,1,3
20120909-M-US_Open-SF-Novak_Djokovic-David_Ferrer,2,F-XC,86,16,7,4,5,49,37
20120909-M-US_Open-SF-Novak_Djokovic-David_Ferrer,2,F-DTM,46,5,0,1,4,15,31
20120909-M-US_Open-SF-Novak_Djokovic-David_Ferrer,2,F-DTL,31,3,0,1,2,17,14
20120909-M-US_Open-SF-Novak_Djokovic-David_Ferrer,2,F-IO,63,9,3,2,4,30,33
20120909-M-US_Open-SF-Novak_Djokovic-David_Ferrer,2,F-II,16,3,0,1,2,5,11
20120909-M-US_Open-SF-Novak_Djokovic-David_Ferrer,2,B-XC,72,9,1,1,7,27,45
20120909-M-US_Open-SF-Novak_Djokovic-David_Ferrer,2,B-DTM,46,6,0,2,4,23,23
20120909-M-US_Open-SF-Novak_Djokovic-David_Ferrer,2,B-DTL,19,5,2,1,2,7,12
20120909-M-US_Open-SF-Novak_Djokovic-David_Ferrer,2,B-IO,1,1,0,0,1,0,1
20120909-M-US_Open-SF-Novak_Djokovic-David_Ferrer,2,S-XC,12,0,0,0,0,8,4
20120909-M-US_Open-SF-Novak_Djokovic-David_Ferrer,2,S-DTM,9,1,0,0,1,3,6
20120909-M-US_Open-SF-Novak_Djokovic-David_Ferrer,2,S-DTL,1,0,0,0,0,1,0
20090703-M-Wimbledon-SF-Tommy_Haas-Roger_Federer,1,F-XC,39,13,3,2,8,11,28
20090703-M-Wimbledon-SF-Tommy_Haas-Roger_Federer,1,F-DTM,13,1,0,0,1,2,11
20090703-M-Wimbledon-SF-Tommy_Haas-Roger_Federer,1,F-DTL,12,5,2,1,2,8,4
20090703-M-Wimbledon-SF-Tommy_Haas-Roger_Federer,1,F-IO,17,5,1,3,1,10,7
20090703-M-Wimbledon-SF-Tommy_Haas-Roger_Federer,1,F-II,4,3,1,1,1,2,2
20090703-M-Wimbledon-SF-Tommy_Haas-Roger_Federer,1,B-XC,37,10,1,0,9,13,24
20090703-M-Wimbledon-SF-Tommy_Haas-Roger_Federer,1,B-DTM,22,3,0,1,2,5,17
20090703-M-Wimbledon-SF-Tommy_Haas-Roger_Federer,1,B-DTL,6,4,0,2,2,3,3
20090703-M-Wimbledon-SF-Tommy_Haas-Roger_Federer,1,B-IO,4,2,1,0,1,1,3
20090703-M-Wimbledon-SF-Tommy_Haas-Roger_Federer,1,S-XC,11,0,0,0,0,3,8
20090703-M-Wimbledon-SF-Tommy_Haas-Roger_Federer,1,S-DTM,6,1,0,0,1,1,5
20090703-M-Wimbledon-SF-Tommy_Haas-Roger_Federer,1,S-DTL,4,2,0,2,0,4,0
20090703-M-Wimbledon-SF-Tommy_Haas-Roger_Federer,2,F-XC,32,9,3,4,2,23,9
20090703-M-Wimbledon-SF-Tommy_Haas-Roger_Federer,2,F-DTM,21,2,0,1,1,19,2
20090703-M-Wimbledon-SF-Tommy_Haas-Roger_Federer,2,F-DTL,13,3,0,2,1,11,2
20090703-M-Wimbledon-SF-Tommy_Haas-Roger_Federer,2,F-IO,37,10,6,3,1,31,6
20090703-M-Wimbledon-SF-Tommy_Haas-Roger_Federer,2,F-II,6,2,1,0,1,3,3
20090703-M-Wimbledon-SF-Tommy_Haas-Roger_Federer,2,B-XC,19,7,4,0,3,11,8
20090703-M-Wimbledon-SF-Tommy_Haas-Roger_Federer,2,B-DTM,8,1,0,0,1,4,4
20090703-M-Wimbledon-SF-Tommy_Haas-Roger_Federer,2,B-DTL,3,1,0,1,0,2,1
20090703-M-Wimbledon-SF-Tommy_Haas-Roger_Federer,2,B-IO,1,1,0,0,1,0,1
20090703-M-Wimbledon-SF-Tommy_Haas-Roger_Federer,2,S-XC,18,2,0,1,1,10,8
20090703-M-Wimbledon-SF-Tommy_Haas-Roger_Federer,2,S-DTM,6,0,0,0,0,5,1
20090703-M-Wimbledon-SF-Tommy_Haas-Roger_Federer,2,S-DTL,2,0,0,0,0,2,0
20090703-M-Wimbledon-SF-Tommy_Haas-Roger_Federer,2,S-IO,1,0,0,0,0,1,0
20180907-M-US_Open-SF-Novak_Djokovic-Kei_Nishikori,1,F-XC,42,9,1,6,2,24,18
20180907-M-US_Open-SF-Novak_Djokovic-Kei_Nishikori,1,F-DTM,26,2,0,0,2,10,16
20180907-M-US_Open-SF-Novak_Djokovic-Kei_Nishikori,1,F-DTL,17,2,0,1,1,8,9
20180907-M-US_Open-SF-Novak_Djokovic-Kei_Nishikori,1,F-IO,29,9,5,3,1,19,10
20180907-M-US_Open-SF-Novak_Djokovic-Kei_Nishikori,1,F-II,7,3,2,1,0,5,2
20180907-M-US_Open-SF-Novak_Djokovic-Kei_Nishikori,1,B-XC,53,0,0,0,0,31,22
20180907-M-US_Open-SF-Novak_Djokovic-Kei_Nishikori,1,B-DTM,39,4,0,1,3,18,21
20180907-M-US_Open-SF-Novak_Djokovic-Kei_Nishikori,1,B-DTL,19,11,2,4,5,11,8
20180907-M-US_Open-SF-Novak_Djokovic-Kei_Nishikori,1,B-IO,3,0,0,0,0,3,0
20180907-M-US_Open-SF-Novak_Djokovic-Kei_Nishikori,1,S-XC,6,0,0,0,0,1,5
20180907-M-US_Open-SF-Novak_Djokovic-Kei_Nishikori,1,S-DTM,5,0,0,0,0,0,5
20180907-M-US_Open-SF-Novak_Djokovic-Kei_Nishikori,1,S-DTL,1,0,0,0,0,0,1
20180907-M-US_Open-SF-Novak_Djokovic-Kei_Nishikori,2,F-XC,50,13,1,3,9,25,25
20180907-M-US_Open-SF-Novak_Djokovic-Kei_Nishikori,2,F-DTM,37,3,1,0,2,17,20
20180907-M-US_Open-SF-Novak_Djokovic-Kei_Nishikori,2,F-DTL,11,4,1,0,3,6,5
20180907-M-US_Open-SF-Novak_Djokovic-Kei_Nishikori,2,F-IO,35,9,0,4,5,18,17
20180907-M-US_Open-SF-Novak_Djokovic-Kei_Nishikori,2,F-II,5,2,0,1,1,4,1
20180907-M-US_Open-SF-Novak_Djokovic-Kei_Nishikori,2,B-XC,65,15,1,5,9,29,36
20180907-M-US_Open-SF-Novak_Djokovic-Kei_Nishikori,2,B-DTM,34,5,0,0,5,16,18
20180907-M-US_Open-SF-Novak_Djokovic-Kei_Nishikori,2,B-DTL,14,7,4,0,3,7,7
20180907-M-US_Open-SF-Novak_Djokovic-Kei_Nishikori,2,B-IO,5,1,1,0,0,3,2
20180907-M-US_Open-SF-Novak_Djokovic-Kei_Nishikori,2,S-XC,8,1,0,1,0,5,3
20180907-M-US_Open-SF-Novak_Djokovic-Kei_Nishikori,2,S-DTM,4,0,0,0,0,1,3
20180907-M-US_Open-SF-Novak_Djokovic-Kei_Nishikori,2,S-IO,1,0,0,0,0,0,1
20181101-M-Paris_Masters-R16-Diego_Sebastian_Schwartzman-Alexander_Zverev,1,F-XC,27,3,1,1,1,14,13
20181101-M-Paris_Masters-R16-Diego_Sebastian_Schwartzman-Alexander_Zverev,1,F-DTM,21,3,0,2,1,12,9
20181101-M-Paris_Masters-R16-Diego_Sebastian_Schwartzman-Alexander_Zverev,1,F-DTL,7,5,1,2,2,4,3
20181101-M-Paris_Masters-R16-Diego_Sebastian_Schwartzman-Alexander_Zverev,1,F-IO,17,4,1,2,1,10,7
20181101-M-Paris_Masters-R16-Diego_Sebastian_Schwartzman-Alexander_Zverev,1,F-II,1,0,0,0,0,1,0
20181101-M-Paris_Masters-R16-Diego_Sebastian_Schwartzman-Alexander_Zverev,1,B-XC,44,5,0,3,2,21,23
20181101-M-Paris_Masters-R16-Diego_Sebastian_Schwartzman-Alexander_Zverev,1,B-DTM,26,2,0,0,2,15,11
20181101-M-Paris_Masters-R16-Diego_Sebastian_Schwartzman-Alexander_Zverev,1,B-DTL,7,4,2,0,2,5,2
20181101-M-Paris_Masters-R16-Diego_Sebastian_Schwartzman-Alexander_Zverev,1,B-IO,4,1,1,0,0,3,1
20181101-M-Paris_Masters-R16-Diego_Sebastian_Schwartzman-Alexander_Zverev,1,S-XC,14,0,0,0,0,11,3
20181101-M-Paris_Masters-R16-Diego_Sebastian_Schwartzman-Alexander_Zverev,1,S-DTM,6,0,0,0,0,2,4
20181101-M-Paris_Masters-R16-Diego_Sebastian_Schwartzman-Alexander_Zverev,2,F-XC,22,6,2,2,2,12,10
20181101-M-Paris_Masters-R16-Diego_Sebastian_Schwartzman-Alexander_Zverev,2,F-DTM,19,0,0,0,0,7,12
20181101-M-Paris_Masters-R16-Diego_Sebastian_Schwartzman-Alexander_Zverev,2,F-DTL,11,3,0,2,1,6,5
20181101-M-Paris_Masters-R16-Diego_Sebastian_Schwartzman-Alexander_Zverev,2,F-IO,22,8,4,2,2,11,11
20181101-M-Paris_Masters-R16-Diego_Sebastian_Schwartzman-Alexander_Zverev,2,F-II,2,1,0,0,1,1,1
20181101-M-Paris_Masters-R16-Diego_Sebastian_Schwartzman-Alexander_Zverev,2,B-XC,48,5,1,2,2,22,26
20181101-M-Paris_Masters-R16-Diego_Sebastian_Schwartzman-Alexander_Zverev,2,B-DTM,16,1,0,0,1,5,11
20181101-M-Paris_Masters-R16-Diego_Sebastian_Schwartzman-Alexander_Zverev,2,B-DTL,9,6,1,2,3,5,4
20181101-M-Paris_Masters-R16-Diego_Sebastian_Schwartzman-Alexander_Zverev,2,B-IO,6,2,1,0,1,2,4
20181101-M-Paris_Masters-R16-Diego_Sebastian_Schwartzman-Alexander_Zverev,2,S-XC,6,0,0,0,0,2,4
20181101-M-Paris_Masters-R16-Diego_Sebastian_Schwartzman-Alexander_Zverev,2,S-DTM,1,0,0,0,0,0,1
20181101-M-Paris_Masters-R16-Diego_Sebastian_Schwartzman-Alexander_Zverev,2,S-DTL,3,0,0,0,0,1,2
20181101-M-Paris_Masters-R16-Diego_Sebastian_Schwartzman-Alexander_Zverev,2,S-IO,2,0,0,0,0,0,2
20160909-M-US_Open-SF-Novak_Djokovic-Gael_Monfils,1,F-XC,49,13,4,8,1,30,19
20160909-M-US_Open-SF-Novak_Djokovic-Gael_Monfils,1,F-DTM,11,1,0,0,1,7,4
20160909-M-US_Open-SF-Novak_Djokovic-Gael_Monfils,1,F-DTL,19,8,2,3,3,12,7
20160909-M-US_Open-SF-Novak_Djokovic-Gael_Monfils,1,F-IO,44,11,3,6,2,22,22
20160909-M-US_Open-SF-Novak_Djokovic-Gael_Monfils,1,F-II,6,1,0,1,0,3,3
20160909-M-US_Open-SF-Novak_Djokovic-Gael_Monfils,1,B-XC,43,5,1,0,4,26,17
20160909-M-US_Open-SF-Novak_Djokovic-Gael_Monfils,1,B-DTM,18,6,2,0,4,9,9
20160909-M-US_Open-SF-Novak_Djokovic-Gael_Monfils,1,B-DTL,16,4,2,1,1,9,7
20160909-M-US_Open-SF-Novak_Djokovic-Gael_Monfils,1,B-IO,4,0,0,0,0,3,1
20160909-M-US_Open-SF-Novak_Djokovic-Gael_Monfils,1,S-XC,5,0,0,0,0,3,2
20160909-M-US_Open-SF-Novak_Djokovic-Gael_Monfils,1,S-DTM,3,0,0,0,0,0,3
20160909-M-US_Open-SF-Novak_Djokovic-Gael_Monfils,1,S-DTL,2,0,0,0,0,0,2
20160909-M-US_Open-SF-Novak_Djokovic-Gael_Monfils,1,S-IO,1,1,0,1,0,1,0
20160909-M-US_Open-SF-Novak_Djokovic-Gael_Monfils,2,F-XC,39,13,4,5,4,19,20
20160909-M-US_Open-SF-Novak_Djokovic-Gael_Monfils,2,F-DTM,17,1,0,0,1,9,8
20160909-M-US_Open-SF-Novak_Djokovic-Gael_Monfils,2,F-DTL,12,6,1,3,2,7,5
20160909-M-US_Open-SF-Novak_Djokovic-Gael_Monfils,2,F-IO,24,8,2,2,4,11,13
20160909-M-US_Open-SF-Novak_Djokovic-Gael_Monfils,2,F-II,1,1,0,1,0,1,0
20160909-M-US_Open-SF-Novak_Djokovic-Gael_Monfils,2,B-XC,41,6,0,0,6,16,25
20160909-M-US_Open-SF-Novak_Djokovic-Gael_Monfils,2,B-DTM,24,3,0,0,3,9,15
20160909-M-US_Open-SF-Novak_Djokovic-Gael_Monfils,2,B-DTL,19,9,3,1,5,12,7
20160909-M-US_Open-SF-Novak_Djokovic-Gael_Monfils,2,B-IO,3,1,0,0,1,1,2
20160909-M-US_Open-SF-Novak_Djokovic-Gael_Monfils,2,S-XC,10,1,0,0,1,5,5
20160909-M-US_Open-SF-Novak_Djokovic-Gael_Monfils,2,S-DTM,8,0,0,0,0,5,3
20160909-M-US_Open-SF-Novak_Djokovic-Gael_Monfils,2,S-DTL,4,0,0,0,0,2,2
19920125-M-Australian_Open-SF-Wayne_Ferreira-Stefan_Edberg,1,F-XC,20,6,2,3,1,12,8
19920125-M-Australian_Open-SF-Wayne_Ferreira-Stefan_Edberg,1,F-DTM,9,1,0,0,1,3,6
19920125-M-Australian_Open-SF-Wayne_Ferreira-Stefan_Edberg,1,F-DTL,11,8,6,1,1,7,4
19920125-M-Australian_Open-SF-Wayne_Ferreira-Stefan_Edberg,1,F-IO,26,14,7,1,6,16,10
19920125-M-Australian_Open-SF-Wayne_Ferreira-Stefan_Edberg,1,F-II,2,1,0,0,1,1,1
19920125-M-Australian_Open-SF-Wayne_Ferreira-Stefan_Edberg,1,B-XC,26,10,4,1,5,13,13
19920125-M-Australian_Open-SF-Wayne_Ferreira-Stefan_Edberg,1,B-DTM,14,3,0,0,3,4,10
19920125-M-Australian_Open-SF-Wayne_Ferreira-Stefan_Edberg,1,B-DTL,11,6,1,0,5,6,5
19920125-M-Australian_Open-SF-Wayne_Ferreira-Stefan_Edberg,1,B-IO,2,0,0,0,0,0,2
19920125-M-Australian_Open-SF-Wayne_Ferreira-Stefan_Edberg,1,S-XC,3,1,1,0,0,1,2
19920125-M-Australian_Open-SF-Wayne_Ferreira-Stefan_Edberg,1,S-DTM,1,0,0,0,0,0,1
19920125-M-Australian_Open-SF-Wayne_Ferreira-Stefan_Edberg,1,S-DTL,4,1,0,0,1,2,2
19920125-M-Australian_Open-SF-Wayne_Ferreira-Stefan_Edberg,2,F-XC,12,1,1,0,0,8,4
19920125-M-Australian_Open-SF-Wayne_Ferreira-Stefan_Edberg,2,F-DTM,7,0,0,0,0,2,5
19920125-M-Australian_Open-SF-Wayne_Ferreira-Stefan_Edberg,2,F-DTL,11,0,0,0,0,5,6
19920125-M-Australian_Open-SF-Wayne_Ferreira-Stefan_Edberg,2,F-IO,7,1,1,0,0,5,2
19920125-M-Australian_Open-SF-Wayne_Ferreira-Stefan_Edberg,2,B-XC,11,2,0,0,2,5,6
19920125-M-Australian_Open-SF-Wayne_Ferreira-Stefan_Edberg,2,B-DTM,5,1,0,0,1,2,3
19920125-M-Australian_Open-SF-Wayne_Ferreira-Stefan_Edberg,2,B-DTL,4,2,0,0,2,2,2
19920125-M-Australian_Open-SF-Wayne_Ferreira-Stefan_Edberg,2,B-IO,2,2,0,1,1,1,1
19920125-M-Australian_Open-SF-Wayne_Ferreira-Stefan_Edberg,2,S-XC,13,1,1,0,0,7,6
19920125-M-Australian_Open-SF-Wayne_Ferreira-Stefan_Edberg,2,S-DTM,2,0,0,0,0,0,2
19920125-M-Australian_Open-SF-Wayne_Ferreira-Stefan_Edberg,2,S-DTL,1,0,0,0,0,0,1
19920125-M-Australian_Open-SF-Wayne_Ferreira-Stefan_Edberg,2,S-IO,1,0,0,0,0,0,1
20040515-M-Hamburg_Masters-SF-Roger_Federer-Lleyton_Hewitt,1,F-XC,35,12,2,7,3,21,14
20040515-M-Hamburg_Masters-SF-Roger_Federer-Lleyton_Hewitt,1,F-DTM,9,0,0,0,0,5,4
20040515-M-Hamburg_Masters-SF-Roger_Federer-Lleyton_Hewitt,1,F-DTL,11,4,1,0,3,6,5
20040515-M-Hamburg_Masters-SF-Roger_Federer-Lleyton_Hewitt,1,F-IO,26,6,4,0,2,21,5
20040515-M-Hamburg_Masters-SF-Roger_Federer-Lleyton_Hewitt,1,F-II,10,6,3,3,0,7,3
20040515-M-Hamburg_Masters-SF-Roger_Federer-Lleyton_Hewitt,1,B-XC,46,4,0,1,3,26,20
20040515-M-Hamburg_Masters-SF-Roger_Federer-Lleyton_Hewitt,1,B-DTM,7,0,0,0,0,3,4
20040515-M-Hamburg_Masters-SF-Roger_Federer-Lleyton_Hewitt,1,B-DTL,14,4,2,1,1,8,6
20040515-M-Hamburg_Masters-SF-Roger_Federer-Lleyton_Hewitt,1,B-IO,1,0,0,0,0,1,0
20040515-M-Hamburg_Masters-SF-Roger_Federer-Lleyton_Hewitt,1,S-XC,18,0,0,0,0,9,9
20040515-M-Hamburg_Masters-SF-Roger_Federer-Lleyton_Hewitt,1,S-DTM,5,1,0,0,1,2,3
20040515-M-Hamburg_Masters-SF-Roger_Federer-Lleyton_Hewitt,1,S-DTL,4,1,0,0,1,3,1
20040515-M-Hamburg_Masters-SF-Roger_Federer-Lleyton_Hewitt,2,F-XC,33,8,1,4,3,15,18
20040515-M-Hamburg_Masters-SF-Roger_Federer-Lleyton_Hewitt,2,F-DTM,10,0,0,0,0,3,7
20040515-M-Hamburg_Masters-SF-Roger_Federer-Lleyton_Hewitt,2,F-DTL,17,1,0,0,1,11,6
20040515-M-Hamburg_Masters-SF-Roger_Federer-Lleyton_Hewitt,2,F-IO,25,1,0,0,1,12,13
20040515-M-Hamburg_Masters-SF-Roger_Federer-Lleyton_Hewitt,2,F-II,6,2,0,2,0,3,3
20040515-M-Hamburg_Masters-SF-Roger_Federer-Lleyton_Hewitt,2,B-XC,71,8,0,1,7,24,47
20040515-M-Hamburg_Masters-SF-Roger_Federer-Lleyton_Hewitt,2,B-DTM,6,1,0,0,1,3,3
20040515-M-Hamburg_Masters-SF-Roger_Federer-Lleyton_Hewitt,2,B-DTL,5,2,1,1,0,3,2
20040515-M-Hamburg_Masters-SF-Roger_Federer-Lleyton_Hewitt,2,B-IO,2,0,0,0,0,0,2
20040515-M-Hamburg_Masters-SF-Roger_Federer-Lleyton_Hewitt,2,S-XC,9,1,0,0,1,0,9
20040515-M-Hamburg_Masters-SF-Roger_Federer-Lleyton_Hewitt,2,S-DTM,1,0,0,0,0,0,1
20040912-M-US_Open-F-Lleyton_Hewitt-Roger_Federer,1,F-XC,64,9,0,2,7,20,44
20040912-M-US_Open-F-Lleyton_Hewitt-Roger_Federer,1,F-DTM,19,0,0,0,0,5,14
20040912-M-US_Open-F-Lleyton_Hewitt-Roger_Federer,1,F-DTL,30,10,0,5,5,12,18
20040912-M-US_Open-F-Lleyton_Hewitt-Roger_Federer,1,F-IO,49,8,3,2,3,27,22
20040912-M-US_Open-F-Lleyton_Hewitt-Roger_Federer,1,F-II,2,0,0,0,0,0,2
20040912-M-US_Open-F-Lleyton_Hewitt-Roger_Federer,1,B-XC,63,4,1,0,3,30,33
20040912-M-US_Open-F-Lleyton_Hewitt-Roger_Federer,1,B-DTM,25,0,0,0,0,8,17
20040912-M-US_Open-F-Lleyton_Hewitt-Roger_Federer,1,B-DTL,10,5,3,0,2,4,6
20040912-M-US_Open-F-Lleyton_Hewitt-Roger_Federer,1,B-IO,6,1,0,0,1,1,5
20040912-M-US_Open-F-Lleyton_Hewitt-Roger_Federer,1,S-XC,6,1,0,0,1,0,6
20040912-M-US_Open-F-Lleyton_Hewitt-Roger_Federer,1,S-DTM,1,0,0,0,0,1,0
20040912-M-US_Open-F-Lleyton_Hewitt-Roger_Federer,1,S-DTL,5,1,0,1,0,2,3
20040912-M-US_Open-F-Lleyton_Hewitt-Roger_Federer,2,F-XC,72,16,4,6,6,49,23
20040912-M-US_Open-F-Lleyton_Hewitt-Roger_Federer,2,F-DTM,21,0,0,0,0,12,9
20040912-M-US_Open-F-Lleyton_Hewitt-Roger_Federer,2,F-DTL,29,13,5,5,3,21,8
20040912-M-US_Open-F-Lleyton_Hewitt-Roger_Federer,2,F-IO,23,8,4,1,3,13,10
20040912-M-US_Open-F-Lleyton_Hewitt-Roger_Federer,2,F-II,11,5,1,2,2,8,3
20040912-M-US_Open-F-Lleyton_Hewitt-Roger_Federer,2,B-XC,48,11,0,5,6,26,22
20040912-M-US_Open-F-Lleyton_Hewitt-Roger_Federer,2,B-DTM,32,0,0,0,0,16,16
20040912-M-US_Open-F-Lleyton_Hewitt-Roger_Federer,2,B-DTL,12,6,1,0,5,5,7
20040912-M-US_Open-F-Lleyton_Hewitt-Roger_Federer,2,B-IO,2,0,0,0,0,2,0
20040912-M-US_Open-F-Lleyton_Hewitt-Roger_Federer,2,S-XC,28,0,0,0,0,17,11
20040912-M-US_Open-F-Lleyton_Hewitt-Roger_Federer,2,S-DTM,5,0,0,0,0,4,1
20040912-M-US_Open-F-Lleyton_Hewitt-Roger_Federer,2,S-DTL,7,1,0,0,1,2,5
20040630-M-Wimbledon-QF-Roger_Federer-Lleyton_Hewitt,1,F-XC,56,18,5,4,9,28,28
20040630-M-Wimbledon-QF-Roger_Federer-Lleyton_Hewitt,1,F-DTM,16,0,0,0,0,5,11
20040630-M-Wimbledon-QF-Roger_Federer-Lleyton_Hewitt,1,F-DTL,29,13,3,3,7,14,15
20040630-M-Wimbledon-QF-Roger_Federer-Lleyton_Hewitt,1,F-IO,26,8,2,3,3,17,9
20040630-M-Wimbledon-QF-Roger_Federer-Lleyton_Hewitt,1,F-II,11,6,1,2,3,5,6
20040630-M-Wimbledon-QF-Roger_Federer-Lleyton_Hewitt,1,B-XC,62,5,2,1,2,35,27
20040630-M-Wimbledon-QF-Roger_Federer-Lleyton_Hewitt,1,B-DTM,21,0,0,0,0,8,13
20040630-M-Wimbledon-QF-Roger_Federer-Lleyton_Hewitt,1,B-DTL,40,12,3,3,6,20,20
20040630-M-Wimbledon-QF-Roger_Federer-Lleyton_Hewitt,1,S-XC,21,2,0,0,2,8,13
20040630-M-Wimbledon-QF-Roger_Federer-Lleyton_Hewitt,1,S-DTM,3,0,0,0,0,2,1
20040630-M-Wimbledon-QF-Roger_Federer-Lleyton_Hewitt,1,S-DTL,6,0,0,0,0,4,2
20040630-M-Wimbledon-QF-Roger_Federer-Lleyton_Hewitt,2,F-XC,66,8,2,3,3,36,30
20040630-M-Wimbledon-QF-Roger_Federer-Lleyton_Hewitt,2,F-DTM,9,0,0,0,0,6,3
20040630-M-Wimbledon-QF-Roger_Federer-Lleyton_Hewitt,2,F-DTL,27,7,2,5,0,15,12
20040630-M-Wimbledon-QF-Roger_Federer-Lleyton_Hewitt,2,F-IO,43,9,3,2,4,19,24
20040630-M-Wimbledon-QF-Roger_Federer-Lleyton_Hewitt,2,F-II,4,2,0,1,1,2,2
20040630-M-Wimbledon-QF-Roger_Federer-Lleyton_Hewitt,2,B-XC,87,14,2,5,7,43,44
20040630-M-Wimbledon-QF-Roger_Federer-Lleyton_Hewitt,2,B-DTM,4,0,0,0,0,1,3
20040630-M-Wimbledon-QF-Roger_Federer-Lleyton_Hewitt,2,B-DTL,8,3,0,1,2,4,4
20040630-M-Wimbledon-QF-Roger_Federer-Lleyton_Hewitt,2,B-IO,4,2,1,0,1,3,1
20040630-M-Wimbledon-QF-Roger_Federer-Lleyton_Hewitt,2,S-XC,17,5,1,1,3,8,9
20040630-M-Wimbledon-QF-Roger_Federer-Lleyton_Hewitt,2,S-DTM,2,0,0,0,0,0,2
20040630-M-Wimbledon-QF-Roger_Federer-Lleyton_Hewitt,2,S-DTL,13,1,0,1,0,7,6
20050910-M-US_Open-SF-Roger_Federer-Lleyton_Hewitt,1,F-XC,80,24,9,8,7,43,37
20050910-M-US_Open-SF-Roger_Federer-Lleyton_Hewitt,1,F-DTM,34,4,1,0,3,16,18
20050910-M-US_Open-SF-Roger_Federer-Lleyton_Hewitt,1,F-DTL,37,15,6,3,6,18,19
20050910-M-US_Open-SF-Roger_Federer-Lleyton_Hewitt,1,F-IO,36,12,5,4,3,18,18
20050910-M-US_Open-SF-Roger_Federer-Lleyton_Hewitt,1,F-II,17,9,5,2,2,11,6
20050910-M-US_Open-SF-Roger_Federer-Lleyton_Hewitt,1,B-XC,58,11,3,2,6,22,36
20050910-M-US_Open-SF-Roger_Federer-Lleyton_Hewitt,1,B-DTM,39,4,0,0,4,11,28
20050910-M-US_Open-SF-Roger_Federer-Lleyton_Hewitt,1,B-DTL,24,7,1,2,4,10,14
20050910-M-US_Open-SF-Roger_Federer-Lleyton_Hewitt,1,B-IO,2,2,2,0,0,2,0
20050910-M-US_Open-SF-Roger_Federer-Lleyton_Hewitt,1,S-XC,48,2,0,1,1,28,20
20050910-M-US_Open-SF-Roger_Federer-Lleyton_Hewitt,1,S-DTM,7,0,0,0,0,2,5
20050910-M-US_Open-SF-Roger_Federer-Lleyton_Hewitt,1,S-DTL,15,3,1,1,1,6,9
20050910-M-US_Open-SF-Roger_Federer-Lleyton_Hewitt,1,S-IO,2,0,0,0,0,1,1
20050910-M-US_Open-SF-Roger_Federer-Lleyton_Hewitt,2,F-XC,76,14,1,8,5,45,31
20050910-M-US_Open-SF-Roger_Federer-Lleyton_Hewitt,2,F-DTM,23,2,0,0,2,12,11
20050910-M-US_Open-SF-Roger_Federer-Lleyton_Hewitt,2,F-DTL,50,10,1,6,3,27,23
20050910-M-US_Open-SF-Roger_Federer-Lleyton_Hewitt,2,F-IO,68,14,4,6,4,43,25
20050910-M-US_Open-SF-Roger_Federer-Lleyton_Hewitt,2,F-II,17,5,1,2,2,8,9
20050910-M-US_Open-SF-Roger_Federer-Lleyton_Hewitt,2,B-XC,104,9,1,2,6,59,45
20050910-M-US_Open-SF-Roger_Federer-Lleyton_Hewitt,2,B-DTM,21,1,1,0,0,11,10
20050910-M-US_Open-SF-Roger_Federer-Lleyton_Hewitt,2,B-DTL,14,7,4,1,2,9,5
20050910-M-US_Open-SF-Roger_Federer-Lleyton_Hewitt,2,B-IO,10,5,0,0,5,5,5
20050910-M-US_Open-SF-Roger_Federer-Lleyton_Hewitt,2,S-XC,13,1,0,0,1,3,10
20050910-M-US_Open-SF-Roger_Federer-Lleyton_Hewitt,2,S-DTM,1,0,0,0,0,1,0
20050910-M-US_Open-SF-Roger_Federer-Lleyton_Hewitt,2,S-DTL,4,1,0,1,0,3,1
20181104-M-Paris_Masters-F-Novak_Djokovic-Karen_Khachanov,1,F-XC,29,10,3,3,4,17,12
20181104-M-Paris_Masters-F-Novak_Djokovic-Karen_Khachanov,1,F-DTM,12,2,0,0,2,3,9
20181104-M-Paris_Masters-F-Novak_Djokovic-Karen_Khachanov,1,F-DTL,16,2,1,1,0,11,5
20181104-M-Paris_Masters-F-Novak_Djokovic-Karen_Khachanov,1,F-IO,25,4,1,2,1,8,17
20181104-M-Paris_Masters-F-Novak_Djokovic-Karen_Khachanov,1,F-II,5,1,0,1,0,2,3
20181104-M-Paris_Masters-F-Novak_Djokovic-Karen_Khachanov,1,B-XC,49,5,0,2,3,22,27
20181104-M-Paris_Masters-F-Novak_Djokovic-Karen_Khachanov,1,B-DTM,22,1,0,0,1,12,10
20181104-M-Paris_Masters-F-Novak_Djokovic-Karen_Khachanov,1,B-DTL,14,9,1,2,6,5,9
20181104-M-Paris_Masters-F-Novak_Djokovic-Karen_Khachanov,1,B-IO,6,3,2,0,1,4,2
20181104-M-Paris_Masters-F-Novak_Djokovic-Karen_Khachanov,1,B-II,1,1,0,1,0,1,0
20181104-M-Paris_Masters-F-Novak_Djokovic-Karen_Khachanov,1,S-XC,4,0,0,0,0,2,2
20181104-M-Paris_Masters-F-Novak_Djokovic-Karen_Khachanov,1,S-DTM,1,0,0,0,0,1,0
20181104-M-Paris_Masters-F-Novak_Djokovic-Karen_Khachanov,1,S-DTL,1,0,0,0,0,0,1
20181104-M-Paris_Masters-F-Novak_Djokovic-Karen_Khachanov,2,F-XC,35,11,4,2,5,18,17
20181104-M-Paris_Masters-F-Novak_Djokovic-Karen_Khachanov,2,F-DTM,13,0,0,0,0,7,6
20181104-M-Paris_Masters-F-Novak_Djokovic-Karen_Khachanov,2,F-DTL,10,7,5,1,1,8,2
20181104-M-Paris_Masters-F-Novak_Djokovic-Karen_Khachanov,2,F-IO,17,7,2,3,2,12,5
20181104-M-Paris_Masters-F-Novak_Djokovic-Karen_Khachanov,2,F-II,1,0,0,0,0,0,1
20181104-M-Paris_Masters-F-Novak_Djokovic-Karen_Khachanov,2,B-XC,56,6,2,1,3,30,26
20181104-M-Paris_Masters-F-Novak_Djokovic-Karen_Khachanov,2,B-DTM,20,1,0,0,1,11,9
20181104-M-Paris_Masters-F-Novak_Djokovic-Karen_Khachanov,2,B-DTL,17,7,2,2,3,9,8
20181104-M-Paris_Masters-F-Novak_Djokovic-Karen_Khachanov,2,B-IO,2,0,0,0,0,0,2
20181104-M-Paris_Masters-F-Novak_Djokovic-Karen_Khachanov,2,S-XC,8,0,0,0,0,6,2
20181104-M-Paris_Masters-F-Novak_Djokovic-Karen_Khachanov,2,S-DTM,5,1,0,1,0,3,2
20181104-M-Paris_Masters-F-Novak_Djokovic-Karen_Khachanov,2,S-DTL,1,0,0,0,0,0,1
20050701-M-Wimbledon-SF-Roger_Federer-Lleyton_Hewitt,1,F-XC,58,14,3,6,5,30,28
20050701-M-Wimbledon-SF-Roger_Federer-Lleyton_Hewitt,1,F-DTM,19,0,0,0,0,10,9
20050701-M-Wimbledon-SF-Roger_Federer-Lleyton_Hewitt,1,F-DTL,22,12,10,1,1,16,6
20050701-M-Wimbledon-SF-Roger_Federer-Lleyton_Hewitt,1,F-IO,22,7,3,1,3,10,12
20050701-M-Wimbledon-SF-Roger_Federer-Lleyton_Hewitt,1,F-II,9,4,3,1,0,5,4
20050701-M-Wimbledon-SF-Roger_Federer-Lleyton_Hewitt,1,B-XC,47,6,0,2,4,24,23
20050701-M-Wimbledon-SF-Roger_Federer-Lleyton_Hewitt,1,B-DTM,30,4,0,1,3,12,18
20050701-M-Wimbledon-SF-Roger_Federer-Lleyton_Hewitt,1,B-DTL,22,8,5,1,2,13,9
20050701-M-Wimbledon-SF-Roger_Federer-Lleyton_Hewitt,1,B-IO,2,1,0,0,1,0,2
20050701-M-Wimbledon-SF-Roger_Federer-Lleyton_Hewitt,1,S-XC,19,0,0,0,0,11,8
20050701-M-Wimbledon-SF-Roger_Federer-Lleyton_Hewitt,1,S-DTM,8,0,0,0,0,2,6
20050701-M-Wimbledon-SF-Roger_Federer-Lleyton_Hewitt,1,S-DTL,6,0,0,0,0,3,3
20050701-M-Wimbledon-SF-Roger_Federer-Lleyton_Hewitt,2,F-XC,67,13,4,7,2,36,31
20050701-M-Wimbledon-SF-Roger_Federer-Lleyton_Hewitt,2,F-DTM,16,3,0,1,2,9,7
20050701-M-Wimbledon-SF-Roger_Federer-Lleyton_Hewitt,2,F-DTL,20,4,1,2,1,12,8
20050701-M-Wimbledon-SF-Roger_Federer-Lleyton_Hewitt,2,F-IO,38,7,2,3,2,22,16
20050701-M-Wimbledon-SF-Roger_Federer-Lleyton_Hewitt,2,F-II,3,1,0,1,0,1,2
20050701-M-Wimbledon-SF-Roger_Federer-Lleyton_Hewitt,2,B-XC,80,9,1,3,5,41,39
20050701-M-Wimbledon-SF-Roger_Federer-Lleyton_Hewitt,2,B-DTM,11,0,0,0,0,6,5
20050701-M-Wimbledon-SF-Roger_Federer-Lleyton_Hewitt,2,B-DTL,16,9,0,5,4,10,6
20050701-M-Wimbledon-SF-Roger_Federer-Lleyton_Hewitt,2,B-IO,8,1,0,0,1,5,3
20050701-M-Wimbledon-SF-Roger_Federer-Lleyton_Hewitt,2,S-XC,7,1,0,1,0,6,1
20050701-M-Wimbledon-SF-Roger_Federer-Lleyton_Hewitt,2,S-DTM,1,0,0,0,0,0,1
20050701-M-Wimbledon-SF-Roger_Federer-Lleyton_Hewitt,2,S-DTL,7,1,0,0,1,2,5
20050701-M-Wimbledon-SF-Roger_Federer-Lleyton_Hewitt,2,S-IO,2,2,1,0,1,1,1
20060909-M-US_Open-SF-Roger_Federer-Nikolay_Davydenko,1,F-XC,35,9,2,3,4,23,12
20060909-M-US_Open-SF-Roger_Federer-Nikolay_Davydenko,1,F-DTM,17,0,0,0,0,10,7
20060909-M-US_Open-SF-Roger_Federer-Nikolay_Davydenko,1,F-DTL,8,2,2,0,0,5,3
20060909-M-US_Open-SF-Roger_Federer-Nikolay_Davydenko,1,F-IO,31,12,5,4,3,21,10
20060909-M-US_Open-SF-Roger_Federer-Nikolay_Davydenko,1,F-II,5,1,0,1,0,2,3
20060909-M-US_Open-SF-Roger_Federer-Nikolay_Davydenko,1,B-XC,36,7,2,3,2,19,17
20060909-M-US_Open-SF-Roger_Federer-Nikolay_Davydenko,1,B-DTM,22,1,0,0,1,9,13
20060909-M-US_Open-SF-Roger_Federer-Nikolay_Davydenko,1,B-DTL,7,5,1,1,3,2,5
20060909-M-US_Open-SF-Roger_Federer-Nikolay_Davydenko,1,B-IO,4,1,0,0,1,2,2
20060909-M-US_Open-SF-Roger_Federer-Nikolay_Davydenko,1,S-XC,18,1,0,1,0,9,9
20060909-M-US_Open-SF-Roger_Federer-Nikolay_Davydenko,1,S-DTM,9,3,0,0,3,2,7
20060909-M-US_Open-SF-Roger_Federer-Nikolay_Davydenko,1,S-DTL,4,0,0,0,0,3,1
20060909-M-US_Open-SF-Roger_Federer-Nikolay_Davydenko,1,S-IO,2,0,0,0,0,1,1
20060909-M-US_Open-SF-Roger_Federer-Nikolay_Davydenko,2,F-XC,35,16,2,7,7,20,15
20060909-M-US_Open-SF-Roger_Federer-Nikolay_Davydenko,2,F-DTM,19,2,0,1,1,8,11
20060909-M-US_Open-SF-Roger_Federer-Nikolay_Davydenko,2,F-DTL,14,6,3,1,2,6,8
20060909-M-US_Open-SF-Roger_Federer-Nikolay_Davydenko,2,F-IO,23,3,1,2,0,13,10
20060909-M-US_Open-SF-Roger_Federer-Nikolay_Davydenko,2,F-II,5,3,0,0,3,1,4
20060909-M-US_Open-SF-Roger_Federer-Nikolay_Davydenko,2,B-XC,58,7,1,2,4,34,24
20060909-M-US_Open-SF-Roger_Federer-Nikolay_Davydenko,2,B-DTM,33,4,0,2,2,14,19
20060909-M-US_Open-SF-Roger_Federer-Nikolay_Davydenko,2,B-DTL,9,5,1,1,3,2,7
20060909-M-US_Open-SF-Roger_Federer-Nikolay_Davydenko,2,B-IO,5,2,0,1,1,3,2
20060909-M-US_Open-SF-Roger_Federer-Nikolay_Davydenko,2,S-XC,4,1,0,0,1,1,3
20060909-M-US_Open-SF-Roger_Federer-Nikolay_Davydenko,2,S-DTM,3,0,0,0,0,0,3
20060909-M-US_Open-SF-Roger_Federer-Nikolay_Davydenko,2,S-DTL,1,1,0,0,1,0,1
20080606-M-Roland_Garros-SF-Gael_Monfils-Roger_Federer,1,F-XC,74,18,5,8,5,40,34
20080606-M-Roland_Garros-SF-Gael_Monfils-Roger_Federer,1,F-DTM,62,4,0,1,3,27,35
20080606-M-Roland_Garros-SF-Gael_Monfils-Roger_Federer,1,F-DTL,32,7,1,3,3,19,13
20080606-M-Roland_Garros-SF-Gael_Monfils-Roger_Federer,1,F-IO,99,20,3,7,10,42,57
20080606-M-Roland_Garros-SF-Gael_Monfils-Roger_Federer,1,F-II,20,11,4,4,3,15,5
20080606-M-Roland_Garros-SF-Gael_Monfils-Roger_Federer,1,B-XC,70,6,0,3,3,34,36
20080606-M-Roland_Garros-SF-Gael_Monfils-Roger_Federer,1,B-DTM,45,3,1,0,2,18,27
20080606-M-Roland_Garros-SF-Gael_Monfils-Roger_Federer,1,B-DTL,14,2,1,0,1,4,10
20080606-M-Roland_Garros-SF-Gael_Monfils-Roger_Federer,1,B-IO,5,3,1,0,2,3,2
20080606-M-Roland_Garros-SF-Gael_Monfils-Roger_Federer,1,S-XC,8,0,0,0,0,3,5
20080606-M-Roland_Garros-SF-Gael_Monfils-Roger_Federer,1,S-DTM,2,0,0,0,0,0,2
20080606-M-Roland_Garros-SF-Gael_Monfils-Roger_Federer,1,S-DTL,3,2,0,2,0,2,1
20080606-M-Roland_Garros-SF-Gael_Monfils-Roger_Federer,2,F-XC,94,20,11,3,6,51,43
20080606-M-Roland_Garros-SF-Gael_Monfils-Roger_Federer,2,F-DTM,52,5,0,1,4,22,30
20080606-M-Roland_Garros-SF-Gael_Monfils-Roger_Federer,2,F-DTL,24,3,1,1,1,11,13
20080606-M-Roland_Garros-SF-Gael_Monfils-Roger_Federer,2,F-IO,56,19,2,9,8,32,24
20080606-M-Roland_Garros-SF-Gael_Monfils-Roger_Federer,2,F-II,28,7,1,4,2,18,10
20080606-M-Roland_Garros-SF-Gael_Monfils-Roger_Federer,2,B-XC,61,4,2,0,2,43,18
20080606-M-Roland_Garros-SF-Gael_Monfils-Roger_Federer,2,B-DTM,33,2,1,0,1,17,16
20080606-M-Roland_Garros-SF-Gael_Monfils-Roger_Federer,2,B-DTL,23,12,3,2,7,11,12
20080606-M-Roland_Garros-SF-Gael_Monfils-Roger_Federer,2,B-IO,1,0,0,0,0,1,0
20080606-M-Roland_Garros-SF-Gael_Monfils-Roger_Federer,2,S-XC,34,4,1,2,1,13,21
20080606-M-Roland_Garros-SF-Gael_Monfils-Roger_Federer,2,S-DTM,4,0,0,0,0,3,1
20080606-M-Roland_Garros-SF-Gael_Monfils-Roger_Federer,2,S-DTL,6,1,0,0,1,2,4
20080606-M-Roland_Garros-SF-Gael_Monfils-Roger_Federer,2,S-IO,1,0,0,0,0,1,0
19890701-M-Wimbledon-SF-Stefan_Edberg-John_Mcenroe,1,F-XC,1,1,0,0,1,0,1
19890701-M-Wimbledon-SF-Stefan_Edberg-John_Mcenroe,1,F-DTL,3,1,1,0,0,1,2
19890701-M-Wimbledon-SF-Stefan_Edberg-John_Mcenroe,1,F-IO,2,2,2,0,0,2,0
19890701-M-Wimbledon-SF-Stefan_Edberg-John_Mcenroe,1,B-XC,2,2,1,0,1,1,1
19890701-M-Wimbledon-SF-Stefan_Edberg-John_Mcenroe,1,B-DTM,1,0,0,0,0,0,1
19890701-M-Wimbledon-SF-Stefan_Edberg-John_Mcenroe,1,B-DTL,4,2,0,0,2,0,4
19890701-M-Wimbledon-SF-Stefan_Edberg-John_Mcenroe,1,B-IO,4,2,2,0,0,3,1
19890701-M-Wimbledon-SF-Stefan_Edberg-John_Mcenroe,1,S-IO,1,1,1,0,0,1,0
19890701-M-Wimbledon-SF-Stefan_Edberg-John_Mcenroe,2,F-XC,4,2,1,1,0,2,2
19890701-M-Wimbledon-SF-Stefan_Edberg-John_Mcenroe,2,F-DTM,1,0,0,0,0,0,1
19890701-M-Wimbledon-SF-Stefan_Edberg-John_Mcenroe,2,F-DTL,3,2,1,1,0,3,0
19890701-M-Wimbledon-SF-Stefan_Edberg-John_Mcenroe,2,F-IO,1,0,0,0,0,0,1
19890701-M-Wimbledon-SF-Stefan_Edberg-John_Mcenroe,2,B-XC,4,4,2,1,1,3,1
19890701-M-Wimbledon-SF-Stefan_Edberg-John_Mcenroe,2,B-DTM,2,1,0,0,1,0,2
19890701-M-Wimbledon-SF-Stefan_Edberg-John_Mcenroe,2,B-DTL,3,1,1,0,0,1,2
19890701-M-Wimbledon-SF-Stefan_Edberg-John_Mcenroe,2,S-XC,1,0,0,0,0,1,0
20181031-M-Paris_Masters-R32-Daniil_Medvedev-Borna_Coric,1,F-XC,22,9,5,0,4,13,9
20181031-M-Paris_Masters-R32-Daniil_Medvedev-Borna_Coric,1,F-DTM,12,0,0,0,0,7,5
20181031-M-Paris_Masters-R32-Daniil_Medvedev-Borna_Coric,1,F-DTL,5,3,0,0,3,1,4
20181031-M-Paris_Masters-R32-Daniil_Medvedev-Borna_Coric,1,F-IO,11,3,2,1,0,9,2
20181031-M-Paris_Masters-R32-Daniil_Medvedev-Borna_Coric,1,F-II,1,0,0,0,0,1,0
20181031-M-Paris_Masters-R32-Daniil_Medvedev-Borna_Coric,1,B-XC,36,7,2,0,5,20,16
20181031-M-Paris_Masters-R32-Daniil_Medvedev-Borna_Coric,1,B-DTM,13,2,0,0,2,6,7
20181031-M-Paris_Masters-R32-Daniil_Medvedev-Borna_Coric,1,B-DTL,4,1,0,0,1,2,2
20181031-M-Paris_Masters-R32-Daniil_Medvedev-Borna_Coric,1,B-IO,2,1,0,0,1,0,2
20181031-M-Paris_Masters-R32-Daniil_Medvedev-Borna_Coric,1,S-XC,1,0,0,0,0,0,1
20181031-M-Paris_Masters-R32-Daniil_Medvedev-Borna_Coric,1,S-DTM,1,0,0,0,0,1,0
20181031-M-Paris_Masters-R32-Daniil_Medvedev-Borna_Coric,2,F-XC,24,7,1,2,4,11,13
20181031-M-Paris_Masters-R32-Daniil_Medvedev-Borna_Coric,2,F-DTM,14,2,0,0,2,5,9
20181031-M-Paris_Masters-R32-Daniil_Medvedev-Borna_Coric,2,F-DTL,2,1,0,1,0,1,1
20181031-M-Paris_Masters-R32-Daniil_Medvedev-Borna_Coric,2,F-IO,13,5,2,2,1,9,4
20181031-M-Paris_Masters-R32-Daniil_Medvedev-Borna_Coric,2,B-XC,15,4,1,1,2,7,8
20181031-M-Paris_Masters-R32-Daniil_Medvedev-Borna_Coric,2,B-DTM,14,2,0,0,2,5,9
20181031-M-Paris_Masters-R32-Daniil_Medvedev-Borna_Coric,2,B-DTL,6,1,1,0,0,5,1
20181031-M-Paris_Masters-R32-Daniil_Medvedev-Borna_Coric,2,B-IO,3,2,1,0,1,2,1
20181031-M-Paris_Masters-R32-Daniil_Medvedev-Borna_Coric,2,S-XC,11,0,0,0,0,4,7
20181031-M-Paris_Masters-R32-Daniil_Medvedev-Borna_Coric,2,S-DTM,7,0,0,0,0,2,5
20181031-M-Paris_Masters-R32-Daniil_Medvedev-Borna_Coric,2,S-DTL,1,0,0,0,0,0,1
20181031-M-Paris_Masters-R32-Daniil_Medvedev-Borna_Coric,2,S-IO,1,0,0,0,0,1,0
20181101-M-Paris_Masters-R16-Dominic_Thiem-Borna_Coric,1,F-XC,26,9,1,3,5,13,13
20181101-M-Paris_Masters-R16-Dominic_Thiem-Borna_Coric,1,F-DTM,23,2,1,0,1,13,10
20181101-M-Paris_Masters-R16-Dominic_Thiem-Borna_Coric,1,F-DTL,2,0,0,0,0,2,0
20181101-M-Paris_Masters-R16-Dominic_Thiem-Borna_Coric,1,F-IO,21,6,2,2,2,15,6
20181101-M-Paris_Masters-R16-Dominic_Thiem-Borna_Coric,1,F-II,4,2,1,0,1,2,2
20181101-M-Paris_Masters-R16-Dominic_Thiem-Borna_Coric,1,B-XC,32,4,2,1,1,21,11
20181101-M-Paris_Masters-R16-Dominic_Thiem-Borna_Coric,1,B-DTM,30,4,0,1,3,18,12
20181101-M-Paris_Masters-R16-Dominic_Thiem-Borna_Coric,1,B-DTL,8,6,1,1,4,4,4
20181101-M-Paris_Masters-R16-Dominic_Thiem-Borna_Coric,1,S-XC,38,0,0,0,0,18,20
20181101-M-Paris_Masters-R16-Dominic_Thiem-Borna_Coric,1,S-DTM,18,0,0,0,0,14,4
20181101-M-Paris_Masters-R16-Dominic_Thiem-Borna_Coric,1,S-DTL,5,0,0,0,0,3,2
20181101-M-Paris_Masters-R16-Dominic_Thiem-Borna_Coric,1,S-IO,3,1,0,0,1,0,3
20181101-M-Paris_Masters-R16-Dominic_Thiem-Borna_Coric,2,F-XC,35,13,2,3,8,15,20
20181101-M-Paris_Masters-R16-Dominic_Thiem-Borna_Coric,2,F-DTM,24,4,0,0,4,9,15
20181101-M-Paris_Masters-R16-Dominic_Thiem-Borna_Coric,2,F-DTL,15,3,0,1,2,7,8
20181101-M-Paris_Masters-R16-Dominic_Thiem-Borna_Coric,2,F-IO,42,11,3,4,4,19,23
20181101-M-Paris_Masters-R16-Dominic_Thiem-Borna_Coric,2,F-II,4,2,0,1,1,1,3
20181101-M-Paris_Masters-R16-Dominic_Thiem-Borna_Coric,2,B-XC,73,13,1,2,10,27,46
20181101-M-Paris_Masters-R16-Dominic_Thiem-Borna_Coric,2,B-DTM,20,4,1,1,2,6,14
20181101-M-Paris_Masters-R16-Dominic_Thiem-Borna_Coric,2,B-DTL,12,9,2,2,5,7,5
20181101-M-Paris_Masters-R16-Dominic_Thiem-Borna_Coric,2,B-IO,1,0,0,0,0,1,0
20181101-M-Paris_Masters-R16-Dominic_Thiem-Borna_Coric,2,S-XC,8,1,0,0,1,3,5
20181101-M-Paris_Masters-R16-Dominic_Thiem-Borna_Coric,2,S-DTM,1,0,0,0,0,1,0
20041117-M-Masters_Cup-RR-Roger_Federer-Lleyton_Hewitt,1,F-XC,39,6,3,1,2,28,11
20041117-M-Masters_Cup-RR-Roger_Federer-Lleyton_Hewitt,1,F-DTM,7,1,0,0,1,4,3
20041117-M-Masters_Cup-RR-Roger_Federer-Lleyton_Hewitt,1,F-DTL,13,4,1,1,2,10,3
20041117-M-Masters_Cup-RR-Roger_Federer-Lleyton_Hewitt,1,F-IO,14,6,2,3,1,11,3
20041117-M-Masters_Cup-RR-Roger_Federer-Lleyton_Hewitt,1,F-II,7,3,2,1,0,6,1
20041117-M-Masters_Cup-RR-Roger_Federer-Lleyton_Hewitt,1,B-XC,44,4,1,0,3,29,15
20041117-M-Masters_Cup-RR-Roger_Federer-Lleyton_Hewitt,1,B-DTM,15,0,0,0,0,11,4
20041117-M-Masters_Cup-RR-Roger_Federer-Lleyton_Hewitt,1,B-DTL,14,4,0,1,3,6,8
20041117-M-Masters_Cup-RR-Roger_Federer-Lleyton_Hewitt,1,B-IO,2,0,0,0,0,2,0
20041117-M-Masters_Cup-RR-Roger_Federer-Lleyton_Hewitt,1,S-XC,15,0,0,0,0,7,8
20041117-M-Masters_Cup-RR-Roger_Federer-Lleyton_Hewitt,1,S-DTL,3,0,0,0,0,2,1
20041117-M-Masters_Cup-RR-Roger_Federer-Lleyton_Hewitt,1,S-IO,1,0,0,0,0,1,0
20041117-M-Masters_Cup-RR-Roger_Federer-Lleyton_Hewitt,2,F-XC,35,9,0,2,7,8,27
20041117-M-Masters_Cup-RR-Roger_Federer-Lleyton_Hewitt,2,F-DTM,11,0,0,0,0,4,7
20041117-M-Masters_Cup-RR-Roger_Federer-Lleyton_Hewitt,2,F-DTL,27,6,0,4,2,11,16
20041117-M-Masters_Cup-RR-Roger_Federer-Lleyton_Hewitt,2,F-IO,33,4,1,1,2,13,20
20041117-M-Masters_Cup-RR-Roger_Federer-Lleyton_Hewitt,2,F-II,4,2,0,1,1,2,2
20041117-M-Masters_Cup-RR-Roger_Federer-Lleyton_Hewitt,2,B-XC,37,3,0,1,2,15,22
20041117-M-Masters_Cup-RR-Roger_Federer-Lleyton_Hewitt,2,B-DTM,7,1,0,0,1,1,6
20041117-M-Masters_Cup-RR-Roger_Federer-Lleyton_Hewitt,2,B-DTL,7,3,0,1,2,2,5
20041117-M-Masters_Cup-RR-Roger_Federer-Lleyton_Hewitt,2,B-IO,4,0,0,0,0,2,2
20041117-M-Masters_Cup-RR-Roger_Federer-Lleyton_Hewitt,2,S-XC,4,2,0,0,2,1,3
20041117-M-Masters_Cup-RR-Roger_Federer-Lleyton_Hewitt,2,S-DTM,1,0,0,0,0,0,1
20041117-M-Masters_Cup-RR-Roger_Federer-Lleyton_Hewitt,2,S-DTL,3,1,0,1,0,1,2
20070818-M-Cincinnati_Masters-SF-Roger_Federer-Lleyton_Hewitt,1,F-XC,68,25,4,8,13,27,41
20070818-M-Cincinnati_Masters-SF-Roger_Federer-Lleyton_Hewitt,1,F-DTM,14,1,0,0,1,5,9
20070818-M-Cincinnati_Masters-SF-Roger_Federer-Lleyton_Hewitt,1,F-DTL,26,10,3,2,5,11,15
20070818-M-Cincinnati_Masters-SF-Roger_Federer-Lleyton_Hewitt,1,F-IO,35,11,3,5,3,19,16
20070818-M-Cincinnati_Masters-SF-Roger_Federer-Lleyton_Hewitt,1,F-II,15,4,3,0,1,6,9
20070818-M-Cincinnati_Masters-SF-Roger_Federer-Lleyton_Hewitt,1,B-XC,52,10,2,1,7,16,36
20070818-M-Cincinnati_Masters-SF-Roger_Federer-Lleyton_Hewitt,1,B-DTM,31,4,0,0,4,11,20
20070818-M-Cincinnati_Masters-SF-Roger_Federer-Lleyton_Hewitt,1,B-DTL,21,11,3,2,6,10,11
20070818-M-Cincinnati_Masters-SF-Roger_Federer-Lleyton_Hewitt,1,B-IO,1,0,0,0,0,1,0
20070818-M-Cincinnati_Masters-SF-Roger_Federer-Lleyton_Hewitt,1,S-XC,46,0,0,0,0,11,35
20070818-M-Cincinnati_Masters-SF-Roger_Federer-Lleyton_Hewitt,1,S-DTM,10,0,0,0,0,4,6
20070818-M-Cincinnati_Masters-SF-Roger_Federer-Lleyton_Hewitt,1,S-DTL,5,1,1,0,0,1,4
20070818-M-Cincinnati_Masters-SF-Roger_Federer-Lleyton_Hewitt,2,F-XC,74,19,2,8,9,41,33
20070818-M-Cincinnati_Masters-SF-Roger_Federer-Lleyton_Hewitt,2,F-DTM,13,0,0,0,0,8,5
20070818-M-Cincinnati_Masters-SF-Roger_Federer-Lleyton_Hewitt,2,F-DTL,24,6,1,4,1,17,7
20070818-M-Cincinnati_Masters-SF-Roger_Federer-Lleyton_Hewitt,2,F-IO,52,4,0,2,2,32,20
20070818-M-Cincinnati_Masters-SF-Roger_Federer-Lleyton_Hewitt,2,F-II,8,0,0,0,0,6,2
20070818-M-Cincinnati_Masters-SF-Roger_Federer-Lleyton_Hewitt,2,B-XC,99,14,1,5,8,66,33
20070818-M-Cincinnati_Masters-SF-Roger_Federer-Lleyton_Hewitt,2,B-DTM,16,1,0,0,1,9,7
20070818-M-Cincinnati_Masters-SF-Roger_Federer-Lleyton_Hewitt,2,B-DTL,6,2,2,0,0,3,3
20070818-M-Cincinnati_Masters-SF-Roger_Federer-Lleyton_Hewitt,2,B-IO,8,3,1,1,1,7,1
20070818-M-Cincinnati_Masters-SF-Roger_Federer-Lleyton_Hewitt,2,B-II,2,0,0,0,0,2,0
20070818-M-Cincinnati_Masters-SF-Roger_Federer-Lleyton_Hewitt,2,S-XC,17,2,0,1,1,11,6
20070818-M-Cincinnati_Masters-SF-Roger_Federer-Lleyton_Hewitt,2,S-DTM,1,0,0,0,0,0,1
20070818-M-Cincinnati_Masters-SF-Roger_Federer-Lleyton_Hewitt,2,S-DTL,3,0,0,0,0,2,1
20181103-M-Paris_Masters-SF-Novak_Djokovic-Roger_Federer,1,F-XC,64,15,3,7,5,38,26
20181103-M-Paris_Masters-SF-Novak_Djokovic-Roger_Federer,1,F-DTM,18,1,1,0,0,11,7
20181103-M-Paris_Masters-SF-Novak_Djokovic-Roger_Federer,1,F-DTL,27,7,3,1,3,15,12
20181103-M-Paris_Masters-SF-Novak_Djokovic-Roger_Federer,1,F-IO,48,12,3,7,2,36,12
20181103-M-Paris_Masters-SF-Novak_Djokovic-Roger_Federer,1,F-II,12,6,0,5,1,9,3
20181103-M-Paris_Masters-SF-Novak_Djokovic-Roger_Federer,1,B-XC,118,15,4,5,6,73,45
20181103-M-Paris_Masters-SF-Novak_Djokovic-Roger_Federer,1,B-DTM,18,3,0,1,2,10,8
20181103-M-Paris_Masters-SF-Novak_Djokovic-Roger_Federer,1,B-DTL,23,9,1,4,4,13,10
20181103-M-Paris_Masters-SF-Novak_Djokovic-Roger_Federer,1,B-IO,4,0,0,0,0,3,1
20181103-M-Paris_Masters-SF-Novak_Djokovic-Roger_Federer,1,S-XC,6,2,0,0,2,3,3
20181103-M-Paris_Masters-SF-Novak_Djokovic-Roger_Federer,1,S-DTM,1,0,0,0,0,1,0
20181103-M-Paris_Masters-SF-Novak_Djokovic-Roger_Federer,1,S-DTL,1,0,0,0,0,0,1
20181103-M-Paris_Masters-SF-Novak_Djokovic-Roger_Federer,2,F-XC,60,12,1,3,8,27,33
20181103-M-Paris_Masters-SF-Novak_Djokovic-Roger_Federer,2,F-DTM,26,3,0,1,2,12,14
20181103-M-Paris_Masters-SF-Novak_Djokovic-Roger_Federer,2,F-DTL,25,10,3,2,5,15,10
20181103-M-Paris_Masters-SF-Novak_Djokovic-Roger_Federer,2,F-IO,25,6,4,0,2,10,15
20181103-M-Paris_Masters-SF-Novak_Djokovic-Roger_Federer,2,F-II,11,4,2,2,0,9,2
20181103-M-Paris_Masters-SF-Novak_Djokovic-Roger_Federer,2,B-XC,55,8,0,1,7,11,44
20181103-M-Paris_Masters-SF-Novak_Djokovic-Roger_Federer,2,B-DTM,24,4,0,0,4,7,17
20181103-M-Paris_Masters-SF-Novak_Djokovic-Roger_Federer,2,B-DTL,16,8,4,1,3,9,7
20181103-M-Paris_Masters-SF-Novak_Djokovic-Roger_Federer,2,B-IO,1,1,0,0,1,0,1
20181103-M-Paris_Masters-SF-Novak_Djokovic-Roger_Federer,2,S-XC,61,2,0,0,2,26,35
20181103-M-Paris_Masters-SF-Novak_Djokovic-Roger_Federer,2,S-DTM,7,0,0,0,0,0,7
20181103-M-Paris_Masters-SF-Novak_Djokovic-Roger_Federer,2,S-DTL,9,0,0,0,0,5,4
20181103-M-Paris_Masters-SF-Novak_Djokovic-Roger_Federer,2,S-IO,1,0,0,0,0,0,1
20140906-M-US_Open-SF-Novak_Djokovic-Kei_Nishikori,1,F-XC,41,8,4,3,1,22,19
20140906-M-US_Open-SF-Novak_Djokovic-Kei_Nishikori,1,F-DTM,28,3,0,1,2,13,15
20140906-M-US_Open-SF-Novak_Djokovic-Kei_Nishikori,1,F-DTL,21,5,2,1,2,12,9
20140906-M-US_Open-SF-Novak_Djokovic-Kei_Nishikori,1,F-IO,28,9,3,4,2,19,9
20140906-M-US_Open-SF-Novak_Djokovic-Kei_Nishikori,1,F-II,4,3,2,0,1,2,2
20140906-M-US_Open-SF-Novak_Djokovic-Kei_Nishikori,1,B-XC,52,6,1,1,4,29,23
20140906-M-US_Open-SF-Novak_Djokovic-Kei_Nishikori,1,B-DTM,52,3,0,0,3,22,30
20140906-M-US_Open-SF-Novak_Djokovic-Kei_Nishikori,1,B-DTL,20,11,1,6,4,12,8
20140906-M-US_Open-SF-Novak_Djokovic-Kei_Nishikori,1,B-IO,8,4,0,2,2,5,3
20140906-M-US_Open-SF-Novak_Djokovic-Kei_Nishikori,1,S-XC,20,2,0,1,1,15,5
20140906-M-US_Open-SF-Novak_Djokovic-Kei_Nishikori,1,S-DTM,11,1,0,0,1,7,4
20140906-M-US_Open-SF-Novak_Djokovic-Kei_Nishikori,1,S-DTL,2,0,0,0,0,0,2
20140906-M-US_Open-SF-Novak_Djokovic-Kei_Nishikori,2,F-XC,54,13,4,3,6,31,23
20140906-M-US_Open-SF-Novak_Djokovic-Kei_Nishikori,2,F-DTM,33,5,0,2,3,14,19
20140906-M-US_Open-SF-Novak_Djokovic-Kei_Nishikori,2,F-DTL,23,11,4,4,3,16,7
20140906-M-US_Open-SF-Novak_Djokovic-Kei_Nishikori,2,F-IO,28,8,2,4,2,17,11
20140906-M-US_Open-SF-Novak_Djokovic-Kei_Nishikori,2,F-II,2,1,0,1,0,2,0
20140906-M-US_Open-SF-Novak_Djokovic-Kei_Nishikori,2,B-XC,80,11,3,4,4,32,48
20140906-M-US_Open-SF-Novak_Djokovic-Kei_Nishikori,2,B-DTM,36,2,0,1,1,13,23
20140906-M-US_Open-SF-Novak_Djokovic-Kei_Nishikori,2,B-DTL,20,11,6,1,4,10,10
20140906-M-US_Open-SF-Novak_Djokovic-Kei_Nishikori,2,B-IO,9,4,2,0,2,5,4
20140906-M-US_Open-SF-Novak_Djokovic-Kei_Nishikori,2,S-XC,13,1,0,1,0,5,8
20140906-M-US_Open-SF-Novak_Djokovic-Kei_Nishikori,2,S-DTM,4,0,0,0,0,1,3
20140906-M-US_Open-SF-Novak_Djokovic-Kei_Nishikori,2,S-DTL,5,1,0,1,0,3,2
20001127-M-Tour_Finals-RR-Pete_Sampras-Lleyton_Hewitt,1,F-XC,18,3,0,0,3,5,13
20001127-M-Tour_Finals-RR-Pete_Sampras-Lleyton_Hewitt,1,F-DTM,4,0,0,0,0,2,2
20001127-M-Tour_Finals-RR-Pete_Sampras-Lleyton_Hewitt,1,F-DTL,3,2,0,0,2,1,2
20001127-M-Tour_Finals-RR-Pete_Sampras-Lleyton_Hewitt,1,F-IO,9,3,0,0,3,2,7
20001127-M-Tour_Finals-RR-Pete_Sampras-Lleyton_Hewitt,1,F-II,2,1,0,1,0,2,0
20001127-M-Tour_Finals-RR-Pete_Sampras-Lleyton_Hewitt,1,B-XC,39,7,0,0,7,14,25
20001127-M-Tour_Finals-RR-Pete_Sampras-Lleyton_Hewitt,1,B-DTM,7,1,0,0,1,2,5
20001127-M-Tour_Finals-RR-Pete_Sampras-Lleyton_Hewitt,1,B-DTL,3,1,0,0,1,1,2
20001127-M-Tour_Finals-RR-Pete_Sampras-Lleyton_Hewitt,1,S-XC,11,3,1,1,1,5,6
20001127-M-Tour_Finals-RR-Pete_Sampras-Lleyton_Hewitt,1,S-DTM,3,0,0,0,0,0,3
20001127-M-Tour_Finals-RR-Pete_Sampras-Lleyton_Hewitt,1,S-DTL,3,0,0,0,0,0,3
20001127-M-Tour_Finals-RR-Pete_Sampras-Lleyton_Hewitt,1,S-II,1,0,0,0,0,0,1
20001127-M-Tour_Finals-RR-Pete_Sampras-Lleyton_Hewitt,2,F-XC,23,3,2,0,1,16,7
20001127-M-Tour_Finals-RR-Pete_Sampras-Lleyton_Hewitt,2,F-DTM,10,0,0,0,0,5,5
20001127-M-Tour_Finals-RR-Pete_Sampras-Lleyton_Hewitt,2,F-DTL,12,2,2,0,0,8,4
20001127-M-Tour_Finals-RR-Pete_Sampras-Lleyton_Hewitt,2,F-IO,25,2,0,0,2,18,7
20001127-M-Tour_Finals-RR-Pete_Sampras-Lleyton_Hewitt,2,F-II,5,3,2,0,1,3,2
20001127-M-Tour_Finals-RR-Pete_Sampras-Lleyton_Hewitt,2,B-XC,32,2,0,1,1,22,10
20001127-M-Tour_Finals-RR-Pete_Sampras-Lleyton_Hewitt,2,B-DTM,6,0,0,0,0,4,2
20001127-M-Tour_Finals-RR-Pete_Sampras-Lleyton_Hewitt,2,B-DTL,4,2,1,0,1,2,2
20001127-M-Tour_Finals-RR-Pete_Sampras-Lleyton_Hewitt,2,S-XC,5,2,0,1,1,1,4
20001127-M-Tour_Finals-RR-Pete_Sampras-Lleyton_Hewitt,2,S-DTL,1,0,0,0,0,0,1
20140704-M-Wimbledon-SF-Grigor_Dimitrov-Novak_Djokovic,1,F-XC,62,11,5,3,3,36,26
20140704-M-Wimbledon-SF-Grigor_Dimitrov-Novak_Djokovic,1,F-DTM,36,2,0,0,2,21,15
20140704-M-Wimbledon-SF-Grigor_Dimitrov-Novak_Djokovic,1,F-DTL,26,12,5,4,3,17,9
20140704-M-Wimbledon-SF-Grigor_Dimitrov-Novak_Djokovic,1,F-IO,46,10,4,2,4,31,15
20140704-M-Wimbledon-SF-Grigor_Dimitrov-Novak_Djokovic,1,F-II,4,2,1,1,0,4,0
20140704-M-Wimbledon-SF-Grigor_Dimitrov-Novak_Djokovic,1,B-XC,33,5,0,1,4,17,16
20140704-M-Wimbledon-SF-Grigor_Dimitrov-Novak_Djokovic,1,B-DTM,28,4,0,0,4,15,13
20140704-M-Wimbledon-SF-Grigor_Dimitrov-Novak_Djokovic,1,B-DTL,10,5,1,0,4,3,7
20140704-M-Wimbledon-SF-Grigor_Dimitrov-Novak_Djokovic,1,B-IO,1,0,0,0,0,1,0
20140704-M-Wimbledon-SF-Grigor_Dimitrov-Novak_Djokovic,1,S-XC,21,2,0,1,1,10,11
20140704-M-Wimbledon-SF-Grigor_Dimitrov-Novak_Djokovic,1,S-DTM,29,2,1,1,0,14,15
20140704-M-Wimbledon-SF-Grigor_Dimitrov-Novak_Djokovic,1,S-DTL,13,1,0,0,1,5,8
20140704-M-Wimbledon-SF-Grigor_Dimitrov-Novak_Djokovic,2,F-XC,77,22,5,11,6,44,33
20140704-M-Wimbledon-SF-Grigor_Dimitrov-Novak_Djokovic,2,F-DTM,24,2,0,1,1,9,15
20140704-M-Wimbledon-SF-Grigor_Dimitrov-Novak_Djokovic,2,F-DTL,18,6,2,2,2,11,7
20140704-M-Wimbledon-SF-Grigor_Dimitrov-Novak_Djokovic,2,F-IO,44,6,0,3,3,26,18
20140704-M-Wimbledon-SF-Grigor_Dimitrov-Novak_Djokovic,2,F-II,2,0,0,0,0,1,1
20140704-M-Wimbledon-SF-Grigor_Dimitrov-Novak_Djokovic,2,B-XC,80,9,2,3,4,37,43
20140704-M-Wimbledon-SF-Grigor_Dimitrov-Novak_Djokovic,2,B-DTM,32,5,0,0,5,7,25
20140704-M-Wimbledon-SF-Grigor_Dimitrov-Novak_Djokovic,2,B-DTL,18,5,2,1,2,5,13
20140704-M-Wimbledon-SF-Grigor_Dimitrov-Novak_Djokovic,2,B-IO,12,2,0,0,2,5,7
20140704-M-Wimbledon-SF-Grigor_Dimitrov-Novak_Djokovic,2,S-XC,10,1,0,0,1,4,6
20140704-M-Wimbledon-SF-Grigor_Dimitrov-Novak_Djokovic,2,S-DTM,2,0,0,0,0,1,1
20140704-M-Wimbledon-SF-Grigor_Dimitrov-Novak_Djokovic,2,S-DTL,1,0,0,0,0,0,1
20140704-M-Wimbledon-SF-Grigor_Dimitrov-Novak_Djokovic,2,S-IO,2,1,0,0,1,1,1
20070512-M-Rome_Masters-SF-Fernando_Gonzalez-Filippo_Volandri,1,F-XC,20,3,0,2,1,14,6
20070512-M-Rome_Masters-SF-Fernando_Gonzalez-Filippo_Volandri,1,F-DTM,3,0,0,0,0,1,2
20070512-M-Rome_Masters-SF-Fernando_Gonzalez-Filippo_Volandri,1,F-DTL,15,7,1,1,5,5,10
20070512-M-Rome_Masters-SF-Fernando_Gonzalez-Filippo_Volandri,1,F-IO,18,5,1,4,0,17,1
20070512-M-Rome_Masters-SF-Fernando_Gonzalez-Filippo_Volandri,1,F-II,4,0,0,0,0,2,2
20070512-M-Rome_Masters-SF-Fernando_Gonzalez-Filippo_Volandri,1,B-XC,7,0,0,0,0,4,3
20070512-M-Rome_Masters-SF-Fernando_Gonzalez-Filippo_Volandri,1,B-DTM,5,0,0,0,0,3,2
20070512-M-Rome_Masters-SF-Fernando_Gonzalez-Filippo_Volandri,1,B-DTL,7,4,4,0,0,5,2
20070512-M-Rome_Masters-SF-Fernando_Gonzalez-Filippo_Volandri,1,S-XC,19,2,1,0,1,10,9
20070512-M-Rome_Masters-SF-Fernando_Gonzalez-Filippo_Volandri,1,S-DTM,1,0,0,0,0,1,0
20070512-M-Rome_Masters-SF-Fernando_Gonzalez-Filippo_Volandri,1,S-DTL,1,0,0,0,0,0,1
20070512-M-Rome_Masters-SF-Fernando_Gonzalez-Filippo_Volandri,2,F-XC,20,6,3,2,1,12,8
20070512-M-Rome_Masters-SF-Fernando_Gonzalez-Filippo_Volandri,2,F-DTM,10,1,0,0,1,2,8
20070512-M-Rome_Masters-SF-Fernando_Gonzalez-Filippo_Volandri,2,F-DTL,4,2,1,0,1,1,3
20070512-M-Rome_Masters-SF-Fernando_Gonzalez-Filippo_Volandri,2,F-IO,26,5,1,2,2,14,12
20070512-M-Rome_Masters-SF-Fernando_Gonzalez-Filippo_Volandri,2,F-II,6,4,0,2,2,2,4
20070512-M-Rome_Masters-SF-Fernando_Gonzalez-Filippo_Volandri,2,B-XC,30,7,1,3,3,12,18
20070512-M-Rome_Masters-SF-Fernando_Gonzalez-Filippo_Volandri,2,B-DTM,4,2,0,0,2,0,4
20070512-M-Rome_Masters-SF-Fernando_Gonzalez-Filippo_Volandri,2,B-DTL,6,2,1,1,0,5,1
20070512-M-Rome_Masters-SF-Fernando_Gonzalez-Filippo_Volandri,2,S-XC,3,0,0,0,0,1,2
20070512-M-Rome_Masters-SF-Fernando_Gonzalez-Filippo_Volandri,2,S-DTL,1,0,0,0,0,1,0
20140606-M-Roland_Garros-SF-Ernests_Gulbis-Novak_Djokovic,1,F-XC,47,9,1,3,5,29,18
20140606-M-Roland_Garros-SF-Ernests_Gulbis-Novak_Djokovic,1,F-DTM,17,4,0,0,4,6,11
20140606-M-Roland_Garros-SF-Ernests_Gulbis-Novak_Djokovic,1,F-DTL,19,8,1,0,7,10,9
20140606-M-Roland_Garros-SF-Ernests_Gulbis-Novak_Djokovic,1,F-IO,14,6,1,2,3,5,9
20140606-M-Roland_Garros-SF-Ernests_Gulbis-Novak_Djokovic,1,B-XC,73,12,4,3,5,44,29
20140606-M-Roland_Garros-SF-Ernests_Gulbis-Novak_Djokovic,1,B-DTM,34,4,0,1,3,15,19
20140606-M-Roland_Garros-SF-Ernests_Gulbis-Novak_Djokovic,1,B-DTL,26,19,8,2,9,16,10
20140606-M-Roland_Garros-SF-Ernests_Gulbis-Novak_Djokovic,1,B-IO,19,3,1,0,2,9,10
20140606-M-Roland_Garros-SF-Ernests_Gulbis-Novak_Djokovic,1,S-XC,4,0,0,0,0,2,2
20140606-M-Roland_Garros-SF-Ernests_Gulbis-Novak_Djokovic,1,S-DTM,2,1,0,1,0,1,1
20140606-M-Roland_Garros-SF-Ernests_Gulbis-Novak_Djokovic,1,S-DTL,1,1,1,0,0,1,0
20140606-M-Roland_Garros-SF-Ernests_Gulbis-Novak_Djokovic,2,F-XC,50,9,2,4,3,27,23
20140606-M-Roland_Garros-SF-Ernests_Gulbis-Novak_Djokovic,2,F-DTM,26,2,0,0,2,10,16
20140606-M-Roland_Garros-SF-Ernests_Gulbis-Novak_Djokovic,2,F-DTL,28,7,1,1,5,12,16
20140606-M-Roland_Garros-SF-Ernests_Gulbis-Novak_Djokovic,2,F-IO,27,13,5,6,2,21,6
20140606-M-Roland_Garros-SF-Ernests_Gulbis-Novak_Djokovic,2,F-II,2,1,1,0,0,2,0
20140606-M-Roland_Garros-SF-Ernests_Gulbis-Novak_Djokovic,2,B-XC,56,8,2,1,5,22,34
20140606-M-Roland_Garros-SF-Ernests_Gulbis-Novak_Djokovic,2,B-DTM,34,1,0,1,0,17,17
20140606-M-Roland_Garros-SF-Ernests_Gulbis-Novak_Djokovic,2,B-DTL,23,10,2,5,3,12,11
20140606-M-Roland_Garros-SF-Ernests_Gulbis-Novak_Djokovic,2,B-IO,16,4,0,1,3,6,10
20140606-M-Roland_Garros-SF-Ernests_Gulbis-Novak_Djokovic,2,S-XC,4,0,0,0,0,1,3
20140606-M-Roland_Garros-SF-Ernests_Gulbis-Novak_Djokovic,2,S-DTM,2,1,0,0,1,1,1
20140606-M-Roland_Garros-SF-Ernests_Gulbis-Novak_Djokovic,2,S-DTL,3,0,0,0,0,2,1
20070908-M-US_Open-SF-David_Ferrer-Novak_Djokovic,1,F-XC,69,14,3,6,5,29,40
20070908-M-US_Open-SF-David_Ferrer-Novak_Djokovic,1,F-DTM,37,5,0,0,5,17,20
20070908-M-US_Open-SF-David_Ferrer-Novak_Djokovic,1,F-DTL,17,2,1,0,1,7,10
20070908-M-US_Open-SF-David_Ferrer-Novak_Djokovic,1,F-IO,47,12,2,3,7,14,33
20070908-M-US_Open-SF-David_Ferrer-Novak_Djokovic,1,F-II,13,4,1,2,1,9,4
20070908-M-US_Open-SF-David_Ferrer-Novak_Djokovic,1,B-XC,56,8,0,3,5,22,34
20070908-M-US_Open-SF-David_Ferrer-Novak_Djokovic,1,B-DTM,46,3,0,0,3,15,31
20070908-M-US_Open-SF-David_Ferrer-Novak_Djokovic,1,B-DTL,7,2,1,0,1,2,5
20070908-M-US_Open-SF-David_Ferrer-Novak_Djokovic,1,B-IO,2,1,0,1,0,2,0
20070908-M-US_Open-SF-David_Ferrer-Novak_Djokovic,1,S-XC,3,0,0,0,0,2,1
20070908-M-US_Open-SF-David_Ferrer-Novak_Djokovic,1,S-DTM,6,0,0,0,0,0,6
20070908-M-US_Open-SF-David_Ferrer-Novak_Djokovic,1,S-DTL,1,0,0,0,0,0,1
20070908-M-US_Open-SF-David_Ferrer-Novak_Djokovic,2,F-XC,59,20,8,7,5,37,22
20070908-M-US_Open-SF-David_Ferrer-Novak_Djokovic,2,F-DTM,16,1,0,1,0,12,4
20070908-M-US_Open-SF-David_Ferrer-Novak_Djokovic,2,F-DTL,33,7,2,1,4,17,16
20070908-M-US_Open-SF-David_Ferrer-Novak_Djokovic,2,F-IO,40,8,2,2,4,26,14
20070908-M-US_Open-SF-David_Ferrer-Novak_Djokovic,2,F-II,11,5,1,0,4,5,6
20070908-M-US_Open-SF-David_Ferrer-Novak_Djokovic,2,B-XC,57,9,0,2,7,34,23
20070908-M-US_Open-SF-David_Ferrer-Novak_Djokovic,2,B-DTM,30,0,0,0,0,20,10
20070908-M-US_Open-SF-David_Ferrer-Novak_Djokovic,2,B-DTL,25,8,3,2,3,19,6
20070908-M-US_Open-SF-David_Ferrer-Novak_Djokovic,2,B-IO,10,3,0,1,2,5,5
20070908-M-US_Open-SF-David_Ferrer-Novak_Djokovic,2,S-XC,10,1,0,0,1,4,6
20070908-M-US_Open-SF-David_Ferrer-Novak_Djokovic,2,S-DTM,3,0,0,0,0,3,0
20070908-M-US_Open-SF-David_Ferrer-Novak_Djokovic,2,S-DTL,1,0,0,0,0,0,1
20070908-M-US_Open-SF-David_Ferrer-Novak_Djokovic,2,S-IO,1,0,0,0,0,1,0
20181015-M-Moscow-R32-Laslo_Djere-Aljaz_Bedene,1,F-XC,86,24,8,4,12,53,33
20181015-M-Moscow-R32-Laslo_Djere-Aljaz_Bedene,1,F-DTM,36,4,0,0,4,15,21
20181015-M-Moscow-R32-Laslo_Djere-Aljaz_Bedene,1,F-DTL,35,9,2,3,4,17,18
20181015-M-Moscow-R32-Laslo_Djere-Aljaz_Bedene,1,F-IO,49,13,4,1,7,23,26
20181015-M-Moscow-R32-Laslo_Djere-Aljaz_Bedene,1,F-II,2,2,1,0,1,1,1
20181015-M-Moscow-R32-Laslo_Djere-Aljaz_Bedene,1,B-XC,92,13,2,2,9,47,45
20181015-M-Moscow-R32-Laslo_Djere-Aljaz_Bedene,1,B-DTM,36,2,0,1,1,19,17
20181015-M-Moscow-R32-Laslo_Djere-Aljaz_Bedene,1,B-DTL,16,5,4,0,1,11,5
20181015-M-Moscow-R32-Laslo_Djere-Aljaz_Bedene,1,B-IO,16,7,3,1,3,11,5
20181015-M-Moscow-R32-Laslo_Djere-Aljaz_Bedene,1,S-XC,23,2,0,0,2,13,10
20181015-M-Moscow-R32-Laslo_Djere-Aljaz_Bedene,1,S-DTM,9,0,0,0,0,3,6
20181015-M-Moscow-R32-Laslo_Djere-Aljaz_Bedene,1,S-DTL,3,0,0,0,0,0,3
20181015-M-Moscow-R32-Laslo_Djere-Aljaz_Bedene,2,F-XC,89,19,5,3,10,40,49
20181015-M-Moscow-R32-Laslo_Djere-Aljaz_Bedene,2,F-DTM,36,3,0,1,2,11,25
20181015-M-Moscow-R32-Laslo_Djere-Aljaz_Bedene,2,F-DTL,29,10,3,1,6,12,17
20181015-M-Moscow-R32-Laslo_Djere-Aljaz_Bedene,2,F-IO,46,12,5,5,2,26,20
20181015-M-Moscow-R32-Laslo_Djere-Aljaz_Bedene,2,F-II,5,2,0,2,0,3,2
20181015-M-Moscow-R32-Laslo_Djere-Aljaz_Bedene,2,B-XC,59,4,1,2,1,34,25
20181015-M-Moscow-R32-Laslo_Djere-Aljaz_Bedene,2,B-DTM,57,5,0,0,5,28,29
20181015-M-Moscow-R32-Laslo_Djere-Aljaz_Bedene,2,B-DTL,17,5,1,1,3,7,10
20181015-M-Moscow-R32-Laslo_Djere-Aljaz_Bedene,2,B-IO,11,1,0,0,1,7,4
20181015-M-Moscow-R32-Laslo_Djere-Aljaz_Bedene,2,S-XC,21,3,0,1,2,10,11
20181015-M-Moscow-R32-Laslo_Djere-Aljaz_Bedene,2,S-DTM,14,0,0,0,0,4,10
20181015-M-Moscow-R32-Laslo_Djere-Aljaz_Bedene,2,S-DTL,8,0,0,0,0,5,3
20180926-M-Orleans_CH-R16-Constant_Lestienne-Aljaz_Bedene,1,F-XC,26,9,2,4,3,15,11
20180926-M-Orleans_CH-R16-Constant_Lestienne-Aljaz_Bedene,1,F-DTM,12,2,0,1,1,6,6
20180926-M-Orleans_CH-R16-Constant_Lestienne-Aljaz_Bedene,1,F-DTL,11,3,2,0,1,6,5
20180926-M-Orleans_CH-R16-Constant_Lestienne-Aljaz_Bedene,1,F-IO,24,7,4,2,1,15,9
20180926-M-Orleans_CH-R16-Constant_Lestienne-Aljaz_Bedene,1,B-XC,46,4,1,0,3,21,25
20180926-M-Orleans_CH-R16-Constant_Lestienne-Aljaz_Bedene,1,B-DTM,26,2,0,0,2,15,11
20180926-M-Orleans_CH-R16-Constant_Lestienne-Aljaz_Bedene,1,B-DTL,9,7,1,1,5,3,6
20180926-M-Orleans_CH-R16-Constant_Lestienne-Aljaz_Bedene,1,B-IO,4,3,0,1,2,1,3
20180926-M-Orleans_CH-R16-Constant_Lestienne-Aljaz_Bedene,1,S-XC,4,1,0,0,1,3,1
20180926-M-Orleans_CH-R16-Constant_Lestienne-Aljaz_Bedene,1,S-DTM,6,2,0,0,2,1,5
20180926-M-Orleans_CH-R16-Constant_Lestienne-Aljaz_Bedene,2,F-XC,29,13,1,3,9,11,18
20180926-M-Orleans_CH-R16-Constant_Lestienne-Aljaz_Bedene,2,F-DTM,13,2,0,2,0,8,5
20180926-M-Orleans_CH-R16-Constant_Lestienne-Aljaz_Bedene,2,F-DTL,9,6,4,1,1,5,4
20180926-M-Orleans_CH-R16-Constant_Lestienne-Aljaz_Bedene,2,F-IO,49,16,2,6,8,28,21
20180926-M-Orleans_CH-R16-Constant_Lestienne-Aljaz_Bedene,2,F-II,5,2,0,1,1,3,2
20180926-M-Orleans_CH-R16-Constant_Lestienne-Aljaz_Bedene,2,B-XC,27,2,1,0,1,13,14
20180926-M-Orleans_CH-R16-Constant_Lestienne-Aljaz_Bedene,2,B-DTM,17,1,0,0,1,5,12
20180926-M-Orleans_CH-R16-Constant_Lestienne-Aljaz_Bedene,2,B-DTL,13,5,1,2,2,7,6
20180926-M-Orleans_CH-R16-Constant_Lestienne-Aljaz_Bedene,2,B-IO,3,1,0,0,1,1,2
20180926-M-Orleans_CH-R16-Constant_Lestienne-Aljaz_Bedene,2,S-XC,8,0,0,0,0,5,3
20180926-M-Orleans_CH-R16-Constant_Lestienne-Aljaz_Bedene,2,S-DTM,10,0,0,0,0,3,7
20180926-M-Orleans_CH-R16-Constant_Lestienne-Aljaz_Bedene,2,S-DTL,6,2,0,1,1,4,2
20180828-M-US_Open-R128-Nikoloz_Basilashvili-Aljaz_Bedene,1,F-XC,57,25,7,9,9,38,19
20180828-M-US_Open-R128-Nikoloz_Basilashvili-Aljaz_Bedene,1,F-DTM,31,2,0,0,2,18,13
20180828-M-US_Open-R128-Nikoloz_Basilashvili-Aljaz_Bedene,1,F-DTL,27,9,2,2,5,11,16
20180828-M-US_Open-R128-Nikoloz_Basilashvili-Aljaz_Bedene,1,F-IO,49,9,4,1,4,22,27
20180828-M-US_Open-R128-Nikoloz_Basilashvili-Aljaz_Bedene,1,F-II,6,4,2,1,1,4,2
20180828-M-US_Open-R128-Nikoloz_Basilashvili-Aljaz_Bedene,1,B-XC,72,16,3,2,11,42,30
20180828-M-US_Open-R128-Nikoloz_Basilashvili-Aljaz_Bedene,1,B-DTM,18,1,0,0,1,8,10
20180828-M-US_Open-R128-Nikoloz_Basilashvili-Aljaz_Bedene,1,B-DTL,15,8,5,2,1,10,5
20180828-M-US_Open-R128-Nikoloz_Basilashvili-Aljaz_Bedene,1,B-IO,11,3,3,0,0,4,7
20180828-M-US_Open-R128-Nikoloz_Basilashvili-Aljaz_Bedene,1,S-XC,3,0,0,0,0,2,1
20180828-M-US_Open-R128-Nikoloz_Basilashvili-Aljaz_Bedene,1,S-DTM,3,1,0,1,0,2,1
20180828-M-US_Open-R128-Nikoloz_Basilashvili-Aljaz_Bedene,2,F-XC,44,11,1,5,5,21,23
20180828-M-US_Open-R128-Nikoloz_Basilashvili-Aljaz_Bedene,2,F-DTM,27,4,0,1,3,8,19
20180828-M-US_Open-R128-Nikoloz_Basilashvili-Aljaz_Bedene,2,F-DTL,17,6,4,0,2,7,10
20180828-M-US_Open-R128-Nikoloz_Basilashvili-Aljaz_Bedene,2,F-IO,28,13,5,3,5,15,13
20180828-M-US_Open-R128-Nikoloz_Basilashvili-Aljaz_Bedene,2,F-II,3,3,3,0,0,3,0
20180828-M-US_Open-R128-Nikoloz_Basilashvili-Aljaz_Bedene,2,B-XC,40,8,2,1,5,15,25
20180828-M-US_Open-R128-Nikoloz_Basilashvili-Aljaz_Bedene,2,B-DTM,43,3,0,0,3,18,25
20180828-M-US_Open-R128-Nikoloz_Basilashvili-Aljaz_Bedene,2,B-DTL,28,10,1,1,8,14,14
20180828-M-US_Open-R128-Nikoloz_Basilashvili-Aljaz_Bedene,2,B-IO,8,5,1,1,3,3,5
20180828-M-US_Open-R128-Nikoloz_Basilashvili-Aljaz_Bedene,2,B-II,1,1,0,1,0,1,0
20180828-M-US_Open-R128-Nikoloz_Basilashvili-Aljaz_Bedene,2,S-XC,20,4,0,1,3,12,8
20180828-M-US_Open-R128-Nikoloz_Basilashvili-Aljaz_Bedene,2,S-DTM,10,0,0,0,0,5,5
20180828-M-US_Open-R128-Nikoloz_Basilashvili-Aljaz_Bedene,2,S-DTL,5,0,0,0,0,3,2
20170714-M-Wimbledon-SF-Marin_Cilic-Sam_Querrey,1,F-XC,37,19,12,4,3,25,12
20170714-M-Wimbledon-SF-Marin_Cilic-Sam_Querrey,1,F-DTM,13,2,0,0,2,8,5
20170714-M-Wimbledon-SF-Marin_Cilic-Sam_Querrey,1,F-DTL,17,7,5,1,1,11,6
20170714-M-Wimbledon-SF-Marin_Cilic-Sam_Querrey,1,F-IO,32,12,3,3,6,17,15
20170714-M-Wimbledon-SF-Marin_Cilic-Sam_Querrey,1,F-II,6,5,3,1,1,5,1
20170714-M-Wimbledon-SF-Marin_Cilic-Sam_Querrey,1,B-XC,50,11,4,3,4,33,17
20170714-M-Wimbledon-SF-Marin_Cilic-Sam_Querrey,1,B-DTM,13,4,0,1,3,6,7
20170714-M-Wimbledon-SF-Marin_Cilic-Sam_Querrey,1,B-DTL,16,6,3,0,3,9,7
20170714-M-Wimbledon-SF-Marin_Cilic-Sam_Querrey,1,B-IO,1,0,0,0,0,1,0
20170714-M-Wimbledon-SF-Marin_Cilic-Sam_Querrey,1,S-XC,7,2,0,1,1,5,2
20170714-M-Wimbledon-SF-Marin_Cilic-Sam_Querrey,1,S-DTM,4,0,0,0,0,2,2
20170714-M-Wimbledon-SF-Marin_Cilic-Sam_Querrey,2,F-XC,32,9,3,1,5,14,18
20170714-M-Wimbledon-SF-Marin_Cilic-Sam_Querrey,2,F-DTM,13,4,0,2,2,4,9
20170714-M-Wimbledon-SF-Marin_Cilic-Sam_Querrey,2,F-DTL,14,5,2,1,2,8,6
20170714-M-Wimbledon-SF-Marin_Cilic-Sam_Querrey,2,F-IO,22,10,5,2,3,12,10
20170714-M-Wimbledon-SF-Marin_Cilic-Sam_Querrey,2,F-II,4,3,1,2,0,4,0
20170714-M-Wimbledon-SF-Marin_Cilic-Sam_Querrey,2,B-XC,47,9,2,0,7,16,31
20170714-M-Wimbledon-SF-Marin_Cilic-Sam_Querrey,2,B-DTM,25,3,0,0,3,9,16
20170714-M-Wimbledon-SF-Marin_Cilic-Sam_Querrey,2,B-DTL,16,6,1,3,2,9,7
20170714-M-Wimbledon-SF-Marin_Cilic-Sam_Querrey,2,B-IO,7,2,0,2,0,4,3
20170714-M-Wimbledon-SF-Marin_Cilic-Sam_Querrey,2,S-XC,8,0,0,0,0,1,7
20170714-M-Wimbledon-SF-Marin_Cilic-Sam_Querrey,2,S-DTM,5,0,0,0,0,2,3
20170714-M-Wimbledon-SF-Marin_Cilic-Sam_Querrey,2,S-DTL,3,0,0,0,0,1,2
20120706-M-Wimbledon-SF-Andy_Murray-Jo_Wilfried_Tsonga,1,F-XC,35,12,7,4,1,22,13
20120706-M-Wimbledon-SF-Andy_Murray-Jo_Wilfried_Tsonga,1,F-DTM,20,4,1,2,1,11,9
20120706-M-Wimbledon-SF-Andy_Murray-Jo_Wilfried_Tsonga,1,F-DTL,19,5,1,2,2,8,11
20120706-M-Wimbledon-SF-Andy_Murray-Jo_Wilfried_Tsonga,1,F-IO,31,4,1,1,2,19,12
20120706-M-Wimbledon-SF-Andy_Murray-Jo_Wilfried_Tsonga,1,F-II,7,2,1,0,1,5,2
20120706-M-Wimbledon-SF-Andy_Murray-Jo_Wilfried_Tsonga,1,B-XC,46,7,3,2,2,24,22
20120706-M-Wimbledon-SF-Andy_Murray-Jo_Wilfried_Tsonga,1,B-DTM,19,1,0,1,0,8,11
20120706-M-Wimbledon-SF-Andy_Murray-Jo_Wilfried_Tsonga,1,B-DTL,11,4,1,3,0,7,4
20120706-M-Wimbledon-SF-Andy_Murray-Jo_Wilfried_Tsonga,1,B-IO,5,1,1,0,0,4,1
20120706-M-Wimbledon-SF-Andy_Murray-Jo_Wilfried_Tsonga,1,S-XC,18,1,0,1,0,8,10
20120706-M-Wimbledon-SF-Andy_Murray-Jo_Wilfried_Tsonga,1,S-DTM,1,0,0,0,0,1,0
20120706-M-Wimbledon-SF-Andy_Murray-Jo_Wilfried_Tsonga,1,S-DTL,3,1,0,0,1,0,3
20120706-M-Wimbledon-SF-Andy_Murray-Jo_Wilfried_Tsonga,1,S-IO,1,1,0,1,0,1,0
20120706-M-Wimbledon-SF-Andy_Murray-Jo_Wilfried_Tsonga,2,F-XC,30,9,0,4,5,15,15
20120706-M-Wimbledon-SF-Andy_Murray-Jo_Wilfried_Tsonga,2,F-DTM,15,0,0,0,0,4,11
20120706-M-Wimbledon-SF-Andy_Murray-Jo_Wilfried_Tsonga,2,F-DTL,18,7,2,3,2,11,7
20120706-M-Wimbledon-SF-Andy_Murray-Jo_Wilfried_Tsonga,2,F-IO,34,10,1,3,6,17,17
20120706-M-Wimbledon-SF-Andy_Murray-Jo_Wilfried_Tsonga,2,F-II,17,4,0,2,2,9,8
20120706-M-Wimbledon-SF-Andy_Murray-Jo_Wilfried_Tsonga,2,B-XC,34,11,3,3,5,14,20
20120706-M-Wimbledon-SF-Andy_Murray-Jo_Wilfried_Tsonga,2,B-DTM,15,2,1,0,1,7,8
20120706-M-Wimbledon-SF-Andy_Murray-Jo_Wilfried_Tsonga,2,B-DTL,9,4,1,0,3,4,5
20120706-M-Wimbledon-SF-Andy_Murray-Jo_Wilfried_Tsonga,2,B-IO,2,1,0,0,1,0,2
20120706-M-Wimbledon-SF-Andy_Murray-Jo_Wilfried_Tsonga,2,S-XC,23,4,0,1,3,14,9
20120706-M-Wimbledon-SF-Andy_Murray-Jo_Wilfried_Tsonga,2,S-DTM,12,2,0,0,2,4,8
20120706-M-Wimbledon-SF-Andy_Murray-Jo_Wilfried_Tsonga,2,S-DTL,5,1,0,1,0,1,4
20000619-M-Queens_Club-F-Pete_Sampras-Lleyton_Hewitt,1,F-XC,11,5,3,0,2,4,7
20000619-M-Queens_Club-F-Pete_Sampras-Lleyton_Hewitt,1,F-DTM,1,0,0,0,0,0,1
20000619-M-Queens_Club-F-Pete_Sampras-Lleyton_Hewitt,1,F-DTL,3,2,1,0,1,2,1
20000619-M-Queens_Club-F-Pete_Sampras-Lleyton_Hewitt,1,F-IO,1,0,0,0,0,1,0
20000619-M-Queens_Club-F-Pete_Sampras-Lleyton_Hewitt,1,F-II,5,4,0,3,1,4,1
20000619-M-Queens_Club-F-Pete_Sampras-Lleyton_Hewitt,1,B-XC,16,6,1,0,5,7,9
20000619-M-Queens_Club-F-Pete_Sampras-Lleyton_Hewitt,1,B-DTM,1,1,0,0,1,0,1
20000619-M-Queens_Club-F-Pete_Sampras-Lleyton_Hewitt,1,B-DTL,2,2,0,0,2,0,2
20000619-M-Queens_Club-F-Pete_Sampras-Lleyton_Hewitt,1,S-XC,10,0,0,0,0,4,6
20000619-M-Queens_Club-F-Pete_Sampras-Lleyton_Hewitt,1,S-DTL,1,0,0,0,0,0,1
20000619-M-Queens_Club-F-Pete_Sampras-Lleyton_Hewitt,2,F-XC,12,5,5,0,0,9,3
20000619-M-Queens_Club-F-Pete_Sampras-Lleyton_Hewitt,2,F-DTM,4,1,0,0,1,2,2
20000619-M-Queens_Club-F-Pete_Sampras-Lleyton_Hewitt,2,F-DTL,7,1,1,0,0,3,4
20000619-M-Queens_Club-F-Pete_Sampras-Lleyton_Hewitt,2,F-IO,12,4,1,1,2,8,4
20000619-M-Queens_Club-F-Pete_Sampras-Lleyton_Hewitt,2,F-II,2,0,0,0,0,1,1
20000619-M-Queens_Club-F-Pete_Sampras-Lleyton_Hewitt,2,B-XC,27,4,0,2,2,13,14
20000619-M-Queens_Club-F-Pete_Sampras-Lleyton_Hewitt,2,B-DTM,4,0,0,0,0,1,3
20000619-M-Queens_Club-F-Pete_Sampras-Lleyton_Hewitt,2,B-DTL,2,2,2,0,0,2,0
20000619-M-Queens_Club-F-Pete_Sampras-Lleyton_Hewitt,2,B-IO,1,1,1,0,0,1,0
20000619-M-Queens_Club-F-Pete_Sampras-Lleyton_Hewitt,2,S-XC,1,0,0,0,0,1,0
20000619-M-Queens_Club-F-Pete_Sampras-Lleyton_Hewitt,2,S-DTM,1,0,0,0,0,1,0
20000619-M-Queens_Club-F-Pete_Sampras-Lleyton_Hewitt,2,S-DTL,1,0,0,0,0,1,0
20070608-M-Roland_Garros-SF-Roger_Federer-Nikolay_Davydenko,1,F-XC,76,21,5,9,7,38,38
20070608-M-Roland_Garros-SF-Roger_Federer-Nikolay_Davydenko,1,F-DTM,32,6,1,3,2,15,17
20070608-M-Roland_Garros-SF-Roger_Federer-Nikolay_Davydenko,1,F-DTL,33,10,5,2,3,21,12
20070608-M-Roland_Garros-SF-Roger_Federer-Nikolay_Davydenko,1,F-IO,27,12,3,6,3,13,14
20070608-M-Roland_Garros-SF-Roger_Federer-Nikolay_Davydenko,1,F-II,7,2,1,1,0,5,2
20070608-M-Roland_Garros-SF-Roger_Federer-Nikolay_Davydenko,1,B-XC,64,10,2,6,2,35,29
20070608-M-Roland_Garros-SF-Roger_Federer-Nikolay_Davydenko,1,B-DTM,31,3,0,0,3,10,21
20070608-M-Roland_Garros-SF-Roger_Federer-Nikolay_Davydenko,1,B-DTL,23,11,3,2,6,11,12
20070608-M-Roland_Garros-SF-Roger_Federer-Nikolay_Davydenko,1,B-IO,5,1,0,0,1,1,4
20070608-M-Roland_Garros-SF-Roger_Federer-Nikolay_Davydenko,1,S-XC,26,0,0,0,0,8,18
20070608-M-Roland_Garros-SF-Roger_Federer-Nikolay_Davydenko,1,S-DTM,3,0,0,0,0,1,2
20070608-M-Roland_Garros-SF-Roger_Federer-Nikolay_Davydenko,1,S-DTL,3,0,0,0,0,0,3
20070608-M-Roland_Garros-SF-Roger_Federer-Nikolay_Davydenko,2,F-XC,67,20,6,8,6,37,30
20070608-M-Roland_Garros-SF-Roger_Federer-Nikolay_Davydenko,2,F-DTM,19,1,0,0,1,8,11
20070608-M-Roland_Garros-SF-Roger_Federer-Nikolay_Davydenko,2,F-DTL,26,10,2,3,5,18,8
20070608-M-Roland_Garros-SF-Roger_Federer-Nikolay_Davydenko,2,F-IO,40,11,2,5,4,22,18
20070608-M-Roland_Garros-SF-Roger_Federer-Nikolay_Davydenko,2,F-II,14,4,2,1,1,8,6
20070608-M-Roland_Garros-SF-Roger_Federer-Nikolay_Davydenko,2,B-XC,85,18,0,9,9,42,43
20070608-M-Roland_Garros-SF-Roger_Federer-Nikolay_Davydenko,2,B-DTM,33,2,0,0,2,20,13
20070608-M-Roland_Garros-SF-Roger_Federer-Nikolay_Davydenko,2,B-DTL,38,20,7,5,8,22,16
20070608-M-Roland_Garros-SF-Roger_Federer-Nikolay_Davydenko,2,B-IO,9,3,0,3,0,6,3
20070608-M-Roland_Garros-SF-Roger_Federer-Nikolay_Davydenko,2,S-XC,4,1,0,1,0,2,2
20070608-M-Roland_Garros-SF-Roger_Federer-Nikolay_Davydenko,2,S-DTM,2,0,0,0,0,1,1
20070608-M-Roland_Garros-SF-Roger_Federer-Nikolay_Davydenko,2,S-DTL,2,0,0,0,0,1,1
20070707-M-Wimbledon-SF-Roger_Federer-Richard_Gasquet,1,F-XC,25,12,3,7,2,14,11
20070707-M-Wimbledon-SF-Roger_Federer-Richard_Gasquet,1,F-DTM,8,2,1,1,0,6,2
20070707-M-Wimbledon-SF-Roger_Federer-Richard_Gasquet,1,F-DTL,14,5,4,0,1,10,4
20070707-M-Wimbledon-SF-Roger_Federer-Richard_Gasquet,1,F-IO,22,11,6,1,4,9,13
20070707-M-Wimbledon-SF-Roger_Federer-Richard_Gasquet,1,F-II,15,9,2,4,3,11,4
20070707-M-Wimbledon-SF-Roger_Federer-Richard_Gasquet,1,B-XC,36,12,2,3,7,18,18
20070707-M-Wimbledon-SF-Roger_Federer-Richard_Gasquet,1,B-DTM,10,0,0,0,0,4,6
20070707-M-Wimbledon-SF-Roger_Federer-Richard_Gasquet,1,B-DTL,14,7,3,2,2,8,6
20070707-M-Wimbledon-SF-Roger_Federer-Richard_Gasquet,1,B-IO,1,1,0,1,0,1,0
20070707-M-Wimbledon-SF-Roger_Federer-Richard_Gasquet,1,S-XC,12,0,0,0,0,7,5
20070707-M-Wimbledon-SF-Roger_Federer-Richard_Gasquet,1,S-DTL,1,0,0,0,0,0,1
20070707-M-Wimbledon-SF-Roger_Federer-Richard_Gasquet,2,F-XC,25,13,6,5,2,15,10
20070707-M-Wimbledon-SF-Roger_Federer-Richard_Gasquet,2,F-DTM,15,1,0,0,1,9,6
20070707-M-Wimbledon-SF-Roger_Federer-Richard_Gasquet,2,F-DTL,9,1,0,1,0,7,2
20070707-M-Wimbledon-SF-Roger_Federer-Richard_Gasquet,2,F-IO,22,3,0,1,2,10,12
20070707-M-Wimbledon-SF-Roger_Federer-Richard_Gasquet,2,F-II,2,2,0,2,0,2,0
20070707-M-Wimbledon-SF-Roger_Federer-Richard_Gasquet,2,B-XC,49,4,1,1,2,25,24
20070707-M-Wimbledon-SF-Roger_Federer-Richard_Gasquet,2,B-DTM,1,0,0,0,0,0,1
20070707-M-Wimbledon-SF-Roger_Federer-Richard_Gasquet,2,B-DTL,13,5,4,0,1,6,7
20070707-M-Wimbledon-SF-Roger_Federer-Richard_Gasquet,2,B-IO,3,2,0,0,2,0,3
20070707-M-Wimbledon-SF-Roger_Federer-Richard_Gasquet,2,S-XC,4,1,0,0,1,2,2
20070707-M-Wimbledon-SF-Roger_Federer-Richard_Gasquet,2,S-DTM,3,1,0,0,1,0,3
20070707-M-Wimbledon-SF-Roger_Federer-Richard_Gasquet,2,S-DTL,1,0,0,0,0,0,1
20060909-M-US_Open-SF-Andy_Roddick-Mikhail_Youzhny,1,F-XC,55,7,1,3,3,28,27
20060909-M-US_Open-SF-Andy_Roddick-Mikhail_Youzhny,1,F-DTM,30,1,0,0,1,15,15
20060909-M-US_Open-SF-Andy_Roddick-Mikhail_Youzhny,1,F-DTL,17,0,0,0,0,8,9
20060909-M-US_Open-SF-Andy_Roddick-Mikhail_Youzhny,1,F-IO,53,16,6,8,2,37,16
20060909-M-US_Open-SF-Andy_Roddick-Mikhail_Youzhny,1,F-II,10,2,1,1,0,7,3
20060909-M-US_Open-SF-Andy_Roddick-Mikhail_Youzhny,1,B-XC,49,3,0,2,1,31,18
20060909-M-US_Open-SF-Andy_Roddick-Mikhail_Youzhny,1,B-DTM,40,3,0,1,2,21,19
20060909-M-US_Open-SF-Andy_Roddick-Mikhail_Youzhny,1,B-DTL,20,7,1,4,2,16,4
20060909-M-US_Open-SF-Andy_Roddick-Mikhail_Youzhny,1,B-IO,5,1,0,0,1,3,2
20060909-M-US_Open-SF-Andy_Roddick-Mikhail_Youzhny,1,S-XC,36,3,0,0,3,15,21
20060909-M-US_Open-SF-Andy_Roddick-Mikhail_Youzhny,1,S-DTM,13,1,0,0,1,4,9
20060909-M-US_Open-SF-Andy_Roddick-Mikhail_Youzhny,1,S-DTL,6,4,1,3,0,5,1
20060909-M-US_Open-SF-Andy_Roddick-Mikhail_Youzhny,2,F-XC,50,15,6,3,6,21,29
20060909-M-US_Open-SF-Andy_Roddick-Mikhail_Youzhny,2,F-DTM,31,3,0,0,3,12,19
20060909-M-US_Open-SF-Andy_Roddick-Mikhail_Youzhny,2,F-DTL,32,10,4,3,3,19,13
20060909-M-US_Open-SF-Andy_Roddick-Mikhail_Youzhny,2,F-IO,39,6,4,0,2,20,19
20060909-M-US_Open-SF-Andy_Roddick-Mikhail_Youzhny,2,F-II,3,0,0,0,0,3,0
20060909-M-US_Open-SF-Andy_Roddick-Mikhail_Youzhny,2,B-XC,81,19,3,6,10,37,44
20060909-M-US_Open-SF-Andy_Roddick-Mikhail_Youzhny,2,B-DTM,32,4,1,1,2,13,19
20060909-M-US_Open-SF-Andy_Roddick-Mikhail_Youzhny,2,B-DTL,24,18,3,6,9,11,13
20060909-M-US_Open-SF-Andy_Roddick-Mikhail_Youzhny,2,B-IO,6,2,0,0,2,4,2
20060909-M-US_Open-SF-Andy_Roddick-Mikhail_Youzhny,2,S-XC,38,1,0,0,1,15,23
20060909-M-US_Open-SF-Andy_Roddick-Mikhail_Youzhny,2,S-DTM,9,1,0,0,1,4,5
20060909-M-US_Open-SF-Andy_Roddick-Mikhail_Youzhny,2,S-DTL,12,2,0,1,1,8,4
20060909-M-US_Open-SF-Andy_Roddick-Mikhail_Youzhny,2,S-IO,3,0,0,0,0,1,2
20020907-M-US_Open-SF-Lleyton_Hewitt-Andre_Agassi,1,F-XC,88,11,4,1,6,38,50
20020907-M-US_Open-SF-Lleyton_Hewitt-Andre_Agassi,1,F-DTM,22,0,0,0,0,11,11
20020907-M-US_Open-SF-Lleyton_Hewitt-Andre_Agassi,1,F-DTL,31,7,4,1,2,15,16
20020907-M-US_Open-SF-Lleyton_Hewitt-Andre_Agassi,1,F-IO,22,8,2,2,4,10,12
20020907-M-US_Open-SF-Lleyton_Hewitt-Andre_Agassi,1,F-II,10,3,3,0,0,6,4
20020907-M-US_Open-SF-Lleyton_Hewitt-Andre_Agassi,1,B-XC,159,14,3,2,9,74,85
20020907-M-US_Open-SF-Lleyton_Hewitt-Andre_Agassi,1,B-DTM,30,2,0,0,2,7,23
20020907-M-US_Open-SF-Lleyton_Hewitt-Andre_Agassi,1,B-DTL,16,7,2,0,5,6,10
20020907-M-US_Open-SF-Lleyton_Hewitt-Andre_Agassi,1,B-IO,7,2,0,1,1,2,5
20020907-M-US_Open-SF-Lleyton_Hewitt-Andre_Agassi,1,S-XC,25,1,0,0,1,10,15
20020907-M-US_Open-SF-Lleyton_Hewitt-Andre_Agassi,1,S-DTM,13,0,0,0,0,7,6
20020907-M-US_Open-SF-Lleyton_Hewitt-Andre_Agassi,1,S-DTL,4,1,1,0,0,1,3
20020907-M-US_Open-SF-Lleyton_Hewitt-Andre_Agassi,1,S-II,2,0,0,0,0,1,1
20020907-M-US_Open-SF-Lleyton_Hewitt-Andre_Agassi,2,F-XC,91,19,5,5,9,54,37
20020907-M-US_Open-SF-Lleyton_Hewitt-Andre_Agassi,2,F-DTM,29,2,0,1,1,15,14
20020907-M-US_Open-SF-Lleyton_Hewitt-Andre_Agassi,2,F-DTL,50,11,5,4,2,34,16
20020907-M-US_Open-SF-Lleyton_Hewitt-Andre_Agassi,2,F-IO,46,11,3,3,5,30,16
20020907-M-US_Open-SF-Lleyton_Hewitt-Andre_Agassi,2,F-II,16,5,1,1,3,8,8
20020907-M-US_Open-SF-Lleyton_Hewitt-Andre_Agassi,2,B-XC,153,13,1,3,9,79,74
20020907-M-US_Open-SF-Lleyton_Hewitt-Andre_Agassi,2,B-DTM,10,0,0,0,0,7,3
20020907-M-US_Open-SF-Lleyton_Hewitt-Andre_Agassi,2,B-DTL,50,13,4,5,4,30,20
20020907-M-US_Open-SF-Lleyton_Hewitt-Andre_Agassi,2,B-IO,4,2,0,1,1,2,2
20020907-M-US_Open-SF-Lleyton_Hewitt-Andre_Agassi,2,B-II,1,1,0,1,0,1,0
20020907-M-US_Open-SF-Lleyton_Hewitt-Andre_Agassi,2,S-XC,10,3,0,0,3,4,6
20020907-M-US_Open-SF-Lleyton_Hewitt-Andre_Agassi,2,S-DTL,3,1,0,1,0,2,1
20070908-M-US_Open-SF-Roger_Federer-Nikolay_Davydenko,1,F-XC,70,15,3,6,6,33,37
20070908-M-US_Open-SF-Roger_Federer-Nikolay_Davydenko,1,F-DTM,49,3,0,0,3,20,29
20070908-M-US_Open-SF-Roger_Federer-Nikolay_Davydenko,1,F-DTL,18,6,5,1,0,9,9
20070908-M-US_Open-SF-Roger_Federer-Nikolay_Davydenko,1,F-IO,36,13,5,4,4,20,16
20070908-M-US_Open-SF-Roger_Federer-Nikolay_Davydenko,1,F-II,11,5,2,3,0,8,3
20070908-M-US_Open-SF-Roger_Federer-Nikolay_Davydenko,1,B-XC,38,6,0,2,4,17,21
20070908-M-US_Open-SF-Roger_Federer-Nikolay_Davydenko,1,B-DTM,23,1,0,0,1,7,16
20070908-M-US_Open-SF-Roger_Federer-Nikolay_Davydenko,1,B-DTL,9,4,1,3,0,6,3
20070908-M-US_Open-SF-Roger_Federer-Nikolay_Davydenko,1,B-IO,3,3,0,1,2,1,2
20070908-M-US_Open-SF-Roger_Federer-Nikolay_Davydenko,1,S-XC,28,1,0,0,1,8,20
20070908-M-US_Open-SF-Roger_Federer-Nikolay_Davydenko,1,S-DTM,14,0,0,0,0,3,11
20070908-M-US_Open-SF-Roger_Federer-Nikolay_Davydenko,1,S-DTL,5,1,0,0,1,2,3
20070908-M-US_Open-SF-Roger_Federer-Nikolay_Davydenko,1,S-IO,2,1,0,1,0,2,0
20070908-M-US_Open-SF-Roger_Federer-Nikolay_Davydenko,2,F-XC,70,15,5,3,7,43,27
20070908-M-US_Open-SF-Roger_Federer-Nikolay_Davydenko,2,F-DTM,40,3,2,0,1,17,23
20070908-M-US_Open-SF-Roger_Federer-Nikolay_Davydenko,2,F-DTL,25,11,3,3,5,13,12
20070908-M-US_Open-SF-Roger_Federer-Nikolay_Davydenko,2,F-IO,38,8,3,1,4,27,11
20070908-M-US_Open-SF-Roger_Federer-Nikolay_Davydenko,2,F-II,13,3,0,1,2,6,7
20070908-M-US_Open-SF-Roger_Federer-Nikolay_Davydenko,2,B-XC,70,13,6,4,3,39,31
20070908-M-US_Open-SF-Roger_Federer-Nikolay_Davydenko,2,B-DTM,33,3,0,0,3,17,16
20070908-M-US_Open-SF-Roger_Federer-Nikolay_Davydenko,2,B-DTL,17,9,3,2,4,7,10
20070908-M-US_Open-SF-Roger_Federer-Nikolay_Davydenko,2,B-IO,4,1,0,1,0,3,1
20070908-M-US_Open-SF-Roger_Federer-Nikolay_Davydenko,2,S-XC,5,0,0,0,0,3,2
20070908-M-US_Open-SF-Roger_Federer-Nikolay_Davydenko,2,S-DTM,1,0,0,0,0,0,1
20070908-M-US_Open-SF-Roger_Federer-Nikolay_Davydenko,2,S-DTL,1,0,0,0,0,1,0
20060126-M-Australian_Open-SF-Roger_Federer-Nicolas_Kiefer,1,F-XC,51,16,4,7,5,35,16
20060126-M-Australian_Open-SF-Roger_Federer-Nicolas_Kiefer,1,F-DTM,17,1,0,0,1,11,6
20060126-M-Australian_Open-SF-Roger_Federer-Nicolas_Kiefer,1,F-DTL,12,6,3,2,1,9,3
20060126-M-Australian_Open-SF-Roger_Federer-Nicolas_Kiefer,1,F-IO,27,9,5,4,0,24,3
20060126-M-Australian_Open-SF-Roger_Federer-Nicolas_Kiefer,1,F-II,11,8,5,0,3,5,6
20060126-M-Australian_Open-SF-Roger_Federer-Nicolas_Kiefer,1,B-XC,69,5,1,0,4,42,27
20060126-M-Australian_Open-SF-Roger_Federer-Nicolas_Kiefer,1,B-DTM,20,0,0,0,0,11,9
20060126-M-Australian_Open-SF-Roger_Federer-Nicolas_Kiefer,1,B-DTL,20,9,2,3,4,10,10
20060126-M-Australian_Open-SF-Roger_Federer-Nicolas_Kiefer,1,B-IO,4,2,2,0,0,4,0
20060126-M-Australian_Open-SF-Roger_Federer-Nicolas_Kiefer,1,S-XC,26,2,0,1,1,16,10
20060126-M-Australian_Open-SF-Roger_Federer-Nicolas_Kiefer,1,S-DTM,5,0,0,0,0,4,1
20060126-M-Australian_Open-SF-Roger_Federer-Nicolas_Kiefer,1,S-DTL,9,2,0,2,0,5,4
20060126-M-Australian_Open-SF-Roger_Federer-Nicolas_Kiefer,1,S-IO,2,1,0,0,1,1,1
20060126-M-Australian_Open-SF-Roger_Federer-Nicolas_Kiefer,2,F-XC,49,15,0,8,7,22,27
20060126-M-Australian_Open-SF-Roger_Federer-Nicolas_Kiefer,2,F-DTM,21,3,0,0,3,8,13
20060126-M-Australian_Open-SF-Roger_Federer-Nicolas_Kiefer,2,F-DTL,21,6,0,0,6,8,13
20060126-M-Australian_Open-SF-Roger_Federer-Nicolas_Kiefer,2,F-IO,26,5,1,2,2,11,15
20060126-M-Australian_Open-SF-Roger_Federer-Nicolas_Kiefer,2,F-II,8,2,0,0,2,2,6
20060126-M-Australian_Open-SF-Roger_Federer-Nicolas_Kiefer,2,B-XC,104,10,0,2,8,34,70
20060126-M-Australian_Open-SF-Roger_Federer-Nicolas_Kiefer,2,B-DTM,18,2,0,0,2,5,13
20060126-M-Australian_Open-SF-Roger_Federer-Nicolas_Kiefer,2,B-DTL,13,5,1,1,3,4,9
20060126-M-Australian_Open-SF-Roger_Federer-Nicolas_Kiefer,2,B-IO,1,0,0,0,0,0,1
20060126-M-Australian_Open-SF-Roger_Federer-Nicolas_Kiefer,2,S-XC,5,0,0,0,0,3,2
20060126-M-Australian_Open-SF-Roger_Federer-Nicolas_Kiefer,2,S-DTM,2,0,0,0,0,0,2
20060126-M-Australian_Open-SF-Roger_Federer-Nicolas_Kiefer,2,S-DTL,1,0,0,0,0,0,1
20060707-M-Wimbledon-SF-Jonas_Bjorkman-Roger_Federer,1,F-XC,19,5,2,0,3,5,14
20060707-M-Wimbledon-SF-Jonas_Bjorkman-Roger_Federer,1,F-DTM,14,3,0,1,2,6,8
20060707-M-Wimbledon-SF-Jonas_Bjorkman-Roger_Federer,1,F-DTL,15,1,0,0,1,3,12
20060707-M-Wimbledon-SF-Jonas_Bjorkman-Roger_Federer,1,F-IO,9,1,0,1,0,3,6
20060707-M-Wimbledon-SF-Jonas_Bjorkman-Roger_Federer,1,B-XC,25,4,0,2,2,9,16
20060707-M-Wimbledon-SF-Jonas_Bjorkman-Roger_Federer,1,B-DTM,8,0,0,0,0,1,7
20060707-M-Wimbledon-SF-Jonas_Bjorkman-Roger_Federer,1,B-DTL,8,3,0,1,2,3,5
20060707-M-Wimbledon-SF-Jonas_Bjorkman-Roger_Federer,1,B-IO,4,1,0,0,1,2,2
20060707-M-Wimbledon-SF-Jonas_Bjorkman-Roger_Federer,1,S-XC,5,0,0,0,0,1,4
20060707-M-Wimbledon-SF-Jonas_Bjorkman-Roger_Federer,1,S-DTM,2,0,0,0,0,0,2
20060707-M-Wimbledon-SF-Jonas_Bjorkman-Roger_Federer,1,S-DTL,2,0,0,0,0,0,2
20060707-M-Wimbledon-SF-Jonas_Bjorkman-Roger_Federer,2,F-XC,27,7,3,3,1,21,6
20060707-M-Wimbledon-SF-Jonas_Bjorkman-Roger_Federer,2,F-DTM,7,2,0,0,2,2,5
20060707-M-Wimbledon-SF-Jonas_Bjorkman-Roger_Federer,2,F-DTL,13,5,1,3,1,9,4
20060707-M-Wimbledon-SF-Jonas_Bjorkman-Roger_Federer,2,F-IO,13,7,3,2,2,10,3
20060707-M-Wimbledon-SF-Jonas_Bjorkman-Roger_Federer,2,F-II,5,4,2,1,1,4,1
20060707-M-Wimbledon-SF-Jonas_Bjorkman-Roger_Federer,2,B-XC,11,2,0,2,0,6,5
20060707-M-Wimbledon-SF-Jonas_Bjorkman-Roger_Federer,2,B-DTM,11,0,0,0,0,6,5
20060707-M-Wimbledon-SF-Jonas_Bjorkman-Roger_Federer,2,B-DTL,9,5,3,1,1,8,1
20060707-M-Wimbledon-SF-Jonas_Bjorkman-Roger_Federer,2,S-XC,14,1,0,1,0,8,6
20060707-M-Wimbledon-SF-Jonas_Bjorkman-Roger_Federer,2,S-DTM,3,0,0,0,0,3,0
20060707-M-Wimbledon-SF-Jonas_Bjorkman-Roger_Federer,2,S-DTL,7,1,0,1,0,6,1
20060707-M-Wimbledon-SF-Jonas_Bjorkman-Roger_Federer,2,S-IO,1,0,0,0,0,1,0
20100128-M-Australian_Open-SF-Roger_Federer-Jo_Wilfried_Tsonga,1,F-XC,24,10,3,4,3,15,9
20100128-M-Australian_Open-SF-Roger_Federer-Jo_Wilfried_Tsonga,1,F-DTM,10,0,0,0,0,6,4
20100128-M-Australian_Open-SF-Roger_Federer-Jo_Wilfried_Tsonga,1,F-DTL,16,4,3,0,1,11,5
20100128-M-Australian_Open-SF-Roger_Federer-Jo_Wilfried_Tsonga,1,F-IO,26,8,5,1,2,22,4
20100128-M-Australian_Open-SF-Roger_Federer-Jo_Wilfried_Tsonga,1,F-II,9,4,2,2,0,8,1
20100128-M-Australian_Open-SF-Roger_Federer-Jo_Wilfried_Tsonga,1,B-XC,34,2,1,1,0,26,8
20100128-M-Australian_Open-SF-Roger_Federer-Jo_Wilfried_Tsonga,1,B-DTM,8,2,0,1,1,5,3
20100128-M-Australian_Open-SF-Roger_Federer-Jo_Wilfried_Tsonga,1,B-DTL,4,2,1,0,1,1,3
20100128-M-Australian_Open-SF-Roger_Federer-Jo_Wilfried_Tsonga,1,S-XC,14,0,0,0,0,9,5
20100128-M-Australian_Open-SF-Roger_Federer-Jo_Wilfried_Tsonga,1,S-DTM,1,0,0,0,0,1,0
20100128-M-Australian_Open-SF-Roger_Federer-Jo_Wilfried_Tsonga,1,S-DTL,2,1,0,0,1,1,1
20100128-M-Australian_Open-SF-Roger_Federer-Jo_Wilfried_Tsonga,1,S-IO,1,0,0,0,0,1,0
20100128-M-Australian_Open-SF-Roger_Federer-Jo_Wilfried_Tsonga,2,F-XC,26,4,1,2,1,7,19
20100128-M-Australian_Open-SF-Roger_Federer-Jo_Wilfried_Tsonga,2,F-DTM,8,1,0,0,1,1,7
20100128-M-Australian_Open-SF-Roger_Federer-Jo_Wilfried_Tsonga,2,F-DTL,7,1,0,1,0,3,4
20100128-M-Australian_Open-SF-Roger_Federer-Jo_Wilfried_Tsonga,2,F-IO,20,4,2,0,2,6,14
20100128-M-Australian_Open-SF-Roger_Federer-Jo_Wilfried_Tsonga,2,F-II,6,1,0,0,1,4,2
20100128-M-Australian_Open-SF-Roger_Federer-Jo_Wilfried_Tsonga,2,B-XC,52,11,0,3,8,16,36
20100128-M-Australian_Open-SF-Roger_Federer-Jo_Wilfried_Tsonga,2,B-DTM,12,1,0,0,1,4,8
20100128-M-Australian_Open-SF-Roger_Federer-Jo_Wilfried_Tsonga,2,B-DTL,7,5,1,2,2,4,3
20100128-M-Australian_Open-SF-Roger_Federer-Jo_Wilfried_Tsonga,2,S-XC,6,0,0,0,0,0,6
20100128-M-Australian_Open-SF-Roger_Federer-Jo_Wilfried_Tsonga,2,S-DTM,2,0,0,0,0,0,2
20100128-M-Australian_Open-SF-Roger_Federer-Jo_Wilfried_Tsonga,2,S-DTL,2,1,1,0,0,1,1
20040911-M-US_Open-SF-Roger_Federer-Tim_Henman,1,F-XC,24,6,1,2,3,10,14
20040911-M-US_Open-SF-Roger_Federer-Tim_Henman,1,F-DTM,14,4,0,1,3,6,8
20040911-M-US_Open-SF-Roger_Federer-Tim_Henman,1,F-DTL,5,0,0,0,0,3,2
20040911-M-US_Open-SF-Roger_Federer-Tim_Henman,1,F-IO,28,7,3,1,3,17,11
20040911-M-US_Open-SF-Roger_Federer-Tim_Henman,1,F-II,11,5,2,0,3,4,7
20040911-M-US_Open-SF-Roger_Federer-Tim_Henman,1,B-XC,24,4,2,2,0,17,7
20040911-M-US_Open-SF-Roger_Federer-Tim_Henman,1,B-DTM,10,1,0,0,1,3,7
20040911-M-US_Open-SF-Roger_Federer-Tim_Henman,1,B-DTL,9,5,2,3,0,8,1
20040911-M-US_Open-SF-Roger_Federer-Tim_Henman,1,B-IO,1,1,1,0,0,1,0
20040911-M-US_Open-SF-Roger_Federer-Tim_Henman,1,S-XC,4,0,0,0,0,3,1
20040911-M-US_Open-SF-Roger_Federer-Tim_Henman,1,S-DTM,2,0,0,0,0,2,0
20040911-M-US_Open-SF-Roger_Federer-Tim_Henman,1,S-DTL,7,2,0,1,1,2,5
20040911-M-US_Open-SF-Roger_Federer-Tim_Henman,1,S-IO,1,0,0,0,0,0,1
20040911-M-US_Open-SF-Roger_Federer-Tim_Henman,2,F-XC,17,4,0,2,2,9,8
20040911-M-US_Open-SF-Roger_Federer-Tim_Henman,2,F-DTM,10,1,0,0,1,6,4
20040911-M-US_Open-SF-Roger_Federer-Tim_Henman,2,F-DTL,9,4,2,1,1,5,4
20040911-M-US_Open-SF-Roger_Federer-Tim_Henman,2,F-IO,16,6,2,1,3,6,10
20040911-M-US_Open-SF-Roger_Federer-Tim_Henman,2,F-II,4,2,0,1,1,2,2
20040911-M-US_Open-SF-Roger_Federer-Tim_Henman,2,B-XC,9,2,1,0,1,3,6
20040911-M-US_Open-SF-Roger_Federer-Tim_Henman,2,B-DTM,6,1,0,0,1,3,3
20040911-M-US_Open-SF-Roger_Federer-Tim_Henman,2,B-DTL,3,1,0,0,1,1,2
20040911-M-US_Open-SF-Roger_Federer-Tim_Henman,2,S-XC,25,1,0,0,1,10,15
20040911-M-US_Open-SF-Roger_Federer-Tim_Henman,2,S-DTM,8,1,0,0,1,2,6
20060609-M-Roland_Garros-SF-Roger_Federer-David_Nalbandian,1,F-XC,37,14,3,8,3,28,9
20060609-M-Roland_Garros-SF-Roger_Federer-David_Nalbandian,1,F-DTM,12,3,1,0,2,7,5
20060609-M-Roland_Garros-SF-Roger_Federer-David_Nalbandian,1,F-DTL,13,5,0,2,3,5,8
20060609-M-Roland_Garros-SF-Roger_Federer-David_Nalbandian,1,F-IO,23,7,6,0,1,18,5
20060609-M-Roland_Garros-SF-Roger_Federer-David_Nalbandian,1,F-II,9,3,3,0,0,8,1
20060609-M-Roland_Garros-SF-Roger_Federer-David_Nalbandian,1,B-XC,55,8,1,1,5,33,22
20060609-M-Roland_Garros-SF-Roger_Federer-David_Nalbandian,1,B-DTM,16,0,0,0,0,4,12
20060609-M-Roland_Garros-SF-Roger_Federer-David_Nalbandian,1,B-DTL,17,5,1,2,2,9,8
20060609-M-Roland_Garros-SF-Roger_Federer-David_Nalbandian,1,B-IO,4,1,0,0,1,2,2
20060609-M-Roland_Garros-SF-Roger_Federer-David_Nalbandian,1,S-XC,15,1,0,0,1,8,7
20060609-M-Roland_Garros-SF-Roger_Federer-David_Nalbandian,1,S-DTM,1,0,0,0,0,0,1
20060609-M-Roland_Garros-SF-Roger_Federer-David_Nalbandian,1,S-DTL,4,1,0,0,1,0,4
20060609-M-Roland_Garros-SF-Roger_Federer-David_Nalbandian,1,S-IO,2,0,0,0,0,2,0
20060609-M-Roland_Garros-SF-Roger_Federer-David_Nalbandian,2,F-XC,38,6,0,4,2,18,20
20060609-M-Roland_Garros-SF-Roger_Federer-David_Nalbandian,2,F-DTM,11,0,0,0,0,4,7
20060609-M-Roland_Garros-SF-Roger_Federer-David_Nalbandian,2,F-DTL,21,5,2,2,1,10,11
20060609-M-Roland_Garros-SF-Roger_Federer-David_Nalbandian,2,F-IO,20,7,0,3,4,12,8
20060609-M-Roland_Garros-SF-Roger_Federer-David_Nalbandian,2,F-II,6,4,0,2,2,2,4
20060609-M-Roland_Garros-SF-Roger_Federer-David_Nalbandian,2,B-XC,61,7,1,2,4,29,32
20060609-M-Roland_Garros-SF-Roger_Federer-David_Nalbandian,2,B-DTM,11,1,0,1,0,5,6
20060609-M-Roland_Garros-SF-Roger_Federer-David_Nalbandian,2,B-DTL,17,9,1,5,3,6,11
20060609-M-Roland_Garros-SF-Roger_Federer-David_Nalbandian,2,B-IO,1,0,0,0,0,1,0
20060609-M-Roland_Garros-SF-Roger_Federer-David_Nalbandian,2,S-XC,10,2,0,1,1,2,8
20060609-M-Roland_Garros-SF-Roger_Federer-David_Nalbandian,2,S-DTM,2,0,0,0,0,1,1
20080704-M-Wimbledon-SF-Rainer_Schuettler-Rafael_Nadal,1,F-XC,46,9,2,3,4,22,24
20080704-M-Wimbledon-SF-Rainer_Schuettler-Rafael_Nadal,1,F-DTM,13,1,0,0,1,3,10
20080704-M-Wimbledon-SF-Rainer_Schuettler-Rafael_Nadal,1,F-DTL,17,8,1,3,4,11,6
20080704-M-Wimbledon-SF-Rainer_Schuettler-Rafael_Nadal,1,F-IO,26,8,2,2,4,13,13
20080704-M-Wimbledon-SF-Rainer_Schuettler-Rafael_Nadal,1,F-II,2,0,0,0,0,2,0
20080704-M-Wimbledon-SF-Rainer_Schuettler-Rafael_Nadal,1,B-XC,17,3,1,2,0,8,9
20080704-M-Wimbledon-SF-Rainer_Schuettler-Rafael_Nadal,1,B-DTM,11,1,0,0,1,6,5
20080704-M-Wimbledon-SF-Rainer_Schuettler-Rafael_Nadal,1,B-DTL,12,3,1,0,2,6,6
20080704-M-Wimbledon-SF-Rainer_Schuettler-Rafael_Nadal,1,B-IO,5,2,1,1,0,3,2
20080704-M-Wimbledon-SF-Rainer_Schuettler-Rafael_Nadal,1,S-XC,9,1,0,0,1,3,6
20080704-M-Wimbledon-SF-Rainer_Schuettler-Rafael_Nadal,1,S-DTM,6,0,0,0,0,0,6
20080704-M-Wimbledon-SF-Rainer_Schuettler-Rafael_Nadal,1,S-DTL,12,1,0,0,1,6,6
20080704-M-Wimbledon-SF-Rainer_Schuettler-Rafael_Nadal,1,S-IO,1,0,0,0,0,0,1
20080704-M-Wimbledon-SF-Rainer_Schuettler-Rafael_Nadal,2,F-XC,57,13,8,3,2,33,24
20080704-M-Wimbledon-SF-Rainer_Schuettler-Rafael_Nadal,2,F-DTM,9,2,0,1,1,5,4
20080704-M-Wimbledon-SF-Rainer_Schuettler-Rafael_Nadal,2,F-DTL,19,6,4,1,1,12,7
20080704-M-Wimbledon-SF-Rainer_Schuettler-Rafael_Nadal,2,F-IO,23,13,7,2,4,15,8
20080704-M-Wimbledon-SF-Rainer_Schuettler-Rafael_Nadal,2,F-II,13,4,2,1,1,10,3
20080704-M-Wimbledon-SF-Rainer_Schuettler-Rafael_Nadal,2,B-XC,26,9,2,3,4,13,13
20080704-M-Wimbledon-SF-Rainer_Schuettler-Rafael_Nadal,2,B-DTM,8,1,0,0,1,3,5
20080704-M-Wimbledon-SF-Rainer_Schuettler-Rafael_Nadal,2,B-DTL,4,1,0,0,1,2,2
20080704-M-Wimbledon-SF-Rainer_Schuettler-Rafael_Nadal,2,B-II,2,1,0,0,1,1,1
20080704-M-Wimbledon-SF-Rainer_Schuettler-Rafael_Nadal,2,S-XC,7,3,0,3,0,6,1
20080704-M-Wimbledon-SF-Rainer_Schuettler-Rafael_Nadal,2,S-DTM,5,0,0,0,0,3,2
20080704-M-Wimbledon-SF-Rainer_Schuettler-Rafael_Nadal,2,S-DTL,9,1,0,1,0,2,7
20080704-M-Wimbledon-SF-Rainer_Schuettler-Rafael_Nadal,2,S-IO,1,0,0,0,0,1,0
20090129-M-Australian_Open-SF-Andy_Roddick-Roger_Federer,1,F-XC,38,6,2,2,2,17,21
20090129-M-Australian_Open-SF-Andy_Roddick-Roger_Federer,1,F-DTM,9,1,0,0,1,4,5
20090129-M-Australian_Open-SF-Andy_Roddick-Roger_Federer,1,F-DTL,15,3,1,1,1,7,8
20090129-M-Australian_Open-SF-Andy_Roddick-Roger_Federer,1,F-IO,20,3,2,1,0,12,8
20090129-M-Australian_Open-SF-Andy_Roddick-Roger_Federer,1,F-II,7,1,0,1,0,4,3
20090129-M-Australian_Open-SF-Andy_Roddick-Roger_Federer,1,B-XC,54,5,1,1,3,23,31
20090129-M-Australian_Open-SF-Andy_Roddick-Roger_Federer,1,B-DTM,15,3,0,0,3,5,10
20090129-M-Australian_Open-SF-Andy_Roddick-Roger_Federer,1,B-DTL,14,4,3,0,1,9,5
20090129-M-Australian_Open-SF-Andy_Roddick-Roger_Federer,1,B-IO,2,1,0,0,1,0,2
20090129-M-Australian_Open-SF-Andy_Roddick-Roger_Federer,1,S-XC,11,3,0,0,3,4,7
20090129-M-Australian_Open-SF-Andy_Roddick-Roger_Federer,1,S-DTM,1,0,0,0,0,0,1
20090129-M-Australian_Open-SF-Andy_Roddick-Roger_Federer,1,S-DTL,6,1,0,1,0,2,4
20090129-M-Australian_Open-SF-Andy_Roddick-Roger_Federer,1,S-IO,2,0,0,0,0,0,2
20090129-M-Australian_Open-SF-Andy_Roddick-Roger_Federer,2,F-XC,48,18,8,6,4,30,18
20090129-M-Australian_Open-SF-Andy_Roddick-Roger_Federer,2,F-DTM,24,0,0,0,0,12,12
20090129-M-Australian_Open-SF-Andy_Roddick-Roger_Federer,2,F-DTL,17,8,7,1,0,13,4
20090129-M-Australian_Open-SF-Andy_Roddick-Roger_Federer,2,F-IO,20,8,3,3,2,13,7
20090129-M-Australian_Open-SF-Andy_Roddick-Roger_Federer,2,F-II,12,6,5,0,1,8,4
20090129-M-Australian_Open-SF-Andy_Roddick-Roger_Federer,2,B-XC,44,6,2,1,3,22,22
20090129-M-Australian_Open-SF-Andy_Roddick-Roger_Federer,2,B-DTM,11,1,0,1,0,5,6
20090129-M-Australian_Open-SF-Andy_Roddick-Roger_Federer,2,B-DTL,10,7,3,0,4,5,5
20090129-M-Australian_Open-SF-Andy_Roddick-Roger_Federer,2,B-IO,1,1,0,0,1,0,1
20090129-M-Australian_Open-SF-Andy_Roddick-Roger_Federer,2,S-XC,17,1,0,0,1,9,8
20090129-M-Australian_Open-SF-Andy_Roddick-Roger_Federer,2,S-DTM,1,0,0,0,0,0,1
20090129-M-Australian_Open-SF-Andy_Roddick-Roger_Federer,2,S-DTL,8,1,1,0,0,5,3
20090129-M-Australian_Open-SF-Andy_Roddick-Roger_Federer,2,S-IO,1,0,0,0,0,1,0
19920808-M-Olympics-F-Marc_Rosset-Jordi_Arrese,1,F-XC,85,21,3,5,13,34,51
19920808-M-Olympics-F-Marc_Rosset-Jordi_Arrese,1,F-DTM,37,9,0,1,8,17,20
19920808-M-Olympics-F-Marc_Rosset-Jordi_Arrese,1,F-DTL,54,8,0,3,5,25,29
19920808-M-Olympics-F-Marc_Rosset-Jordi_Arrese,1,F-IO,71,11,2,1,8,32,39
19920808-M-Olympics-F-Marc_Rosset-Jordi_Arrese,1,F-II,38,17,6,3,8,18,20
19920808-M-Olympics-F-Marc_Rosset-Jordi_Arrese,1,B-XC,88,2,0,0,2,37,51
19920808-M-Olympics-F-Marc_Rosset-Jordi_Arrese,1,B-DTM,29,1,0,0,1,14,15
19920808-M-Olympics-F-Marc_Rosset-Jordi_Arrese,1,B-DTL,27,7,3,1,3,12,15
19920808-M-Olympics-F-Marc_Rosset-Jordi_Arrese,1,B-IO,2,1,0,0,1,0,2
19920808-M-Olympics-F-Marc_Rosset-Jordi_Arrese,1,S-XC,58,10,0,1,9,18,40
19920808-M-Olympics-F-Marc_Rosset-Jordi_Arrese,1,S-DTM,19,6,0,0,6,2,17
19920808-M-Olympics-F-Marc_Rosset-Jordi_Arrese,1,S-DTL,9,3,2,0,1,4,5
19920808-M-Olympics-F-Marc_Rosset-Jordi_Arrese,2,F-XC,100,16,8,5,3,66,34
19920808-M-Olympics-F-Marc_Rosset-Jordi_Arrese,2,F-DTM,25,3,0,1,2,11,14
19920808-M-Olympics-F-Marc_Rosset-Jordi_Arrese,2,F-DTL,58,7,2,2,3,30,28
19920808-M-Olympics-F-Marc_Rosset-Jordi_Arrese,2,F-IO,184,14,2,5,7,113,71
19920808-M-Olympics-F-Marc_Rosset-Jordi_Arrese,2,F-II,50,15,5,4,6,31,19
19920808-M-Olympics-F-Marc_Rosset-Jordi_Arrese,2,B-XC,71,5,4,1,0,47,24
19920808-M-Olympics-F-Marc_Rosset-Jordi_Arrese,2,B-DTM,29,5,0,1,4,11,18
19920808-M-Olympics-F-Marc_Rosset-Jordi_Arrese,2,B-DTL,29,11,1,2,8,14,15
19920808-M-Olympics-F-Marc_Rosset-Jordi_Arrese,2,B-IO,2,0,0,0,0,2,0
19920808-M-Olympics-F-Marc_Rosset-Jordi_Arrese,2,S-XC,27,3,0,0,3,14,13
19920808-M-Olympics-F-Marc_Rosset-Jordi_Arrese,2,S-DTM,5,1,0,0,1,2,3
19920808-M-Olympics-F-Marc_Rosset-Jordi_Arrese,2,S-DTL,4,0,0,0,0,2,2
20080106-M-Chennai-F-Mikhail_Youzhny-Rafael_Nadal,1,F-XC,32,4,1,3,0,26,6
20080106-M-Chennai-F-Mikhail_Youzhny-Rafael_Nadal,1,F-DTM,8,0,0,0,0,6,2
20080106-M-Chennai-F-Mikhail_Youzhny-Rafael_Nadal,1,F-DTL,12,5,3,2,0,9,3
20080106-M-Chennai-F-Mikhail_Youzhny-Rafael_Nadal,1,F-IO,7,3,3,0,0,5,2
20080106-M-Chennai-F-Mikhail_Youzhny-Rafael_Nadal,1,F-II,2,0,0,0,0,2,0
20080106-M-Chennai-F-Mikhail_Youzhny-Rafael_Nadal,1,B-XC,9,3,0,1,2,5,4
20080106-M-Chennai-F-Mikhail_Youzhny-Rafael_Nadal,1,B-DTM,6,0,0,0,0,5,1
20080106-M-Chennai-F-Mikhail_Youzhny-Rafael_Nadal,1,B-DTL,9,4,0,1,3,3,6
20080106-M-Chennai-F-Mikhail_Youzhny-Rafael_Nadal,1,B-IO,3,0,0,0,0,2,1
20080106-M-Chennai-F-Mikhail_Youzhny-Rafael_Nadal,1,S-XC,1,0,0,0,0,1,0
20080106-M-Chennai-F-Mikhail_Youzhny-Rafael_Nadal,1,S-DTM,6,0,0,0,0,4,2
20080106-M-Chennai-F-Mikhail_Youzhny-Rafael_Nadal,1,S-DTL,1,1,0,1,0,1,0
20080106-M-Chennai-F-Mikhail_Youzhny-Rafael_Nadal,2,F-XC,26,4,1,0,3,10,16
20080106-M-Chennai-F-Mikhail_Youzhny-Rafael_Nadal,2,F-DTM,10,0,0,0,0,4,6
20080106-M-Chennai-F-Mikhail_Youzhny-Rafael_Nadal,2,F-DTL,3,1,1,0,0,1,2
20080106-M-Chennai-F-Mikhail_Youzhny-Rafael_Nadal,2,F-IO,10,2,1,0,1,1,9
20080106-M-Chennai-F-Mikhail_Youzhny-Rafael_Nadal,2,F-II,3,3,0,1,2,1,2
20080106-M-Chennai-F-Mikhail_Youzhny-Rafael_Nadal,2,B-XC,23,4,1,0,3,5,18
20080106-M-Chennai-F-Mikhail_Youzhny-Rafael_Nadal,2,B-DTM,10,1,0,0,1,3,7
20080106-M-Chennai-F-Mikhail_Youzhny-Rafael_Nadal,2,B-DTL,8,6,0,1,5,1,7
20080106-M-Chennai-F-Mikhail_Youzhny-Rafael_Nadal,2,B-IO,2,0,0,0,0,1,1
20080106-M-Chennai-F-Mikhail_Youzhny-Rafael_Nadal,2,S-XC,2,0,0,0,0,0,2
20080106-M-Chennai-F-Mikhail_Youzhny-Rafael_Nadal,2,S-DTM,1,1,0,1,0,1,0
20080106-M-Chennai-F-Mikhail_Youzhny-Rafael_Nadal,2,S-DTL,2,0,0,0,0,1,1
20170327-M-Miami_Masters-R16-Roger_Federer-Juan_Martin_Del_Potro,1,F-XC,17,8,2,4,2,10,7
20170327-M-Miami_Masters-R16-Roger_Federer-Juan_Martin_Del_Potro,1,F-DTM,7,1,1,0,0,1,6
20170327-M-Miami_Masters-R16-Roger_Federer-Juan_Martin_Del_Potro,1,F-DTL,9,3,0,1,2,5,4
20170327-M-Miami_Masters-R16-Roger_Federer-Juan_Martin_Del_Potro,1,F-IO,24,13,6,2,5,14,10
20170327-M-Miami_Masters-R16-Roger_Federer-Juan_Martin_Del_Potro,1,F-II,12,2,2,0,0,6,6
20170327-M-Miami_Masters-R16-Roger_Federer-Juan_Martin_Del_Potro,1,B-XC,16,4,0,0,4,8,8
20170327-M-Miami_Masters-R16-Roger_Federer-Juan_Martin_Del_Potro,1,B-DTM,9,0,0,0,0,5,4
20170327-M-Miami_Masters-R16-Roger_Federer-Juan_Martin_Del_Potro,1,B-DTL,10,5,4,0,1,7,3
20170327-M-Miami_Masters-R16-Roger_Federer-Juan_Martin_Del_Potro,1,S-XC,2,0,0,0,0,0,2
20170327-M-Miami_Masters-R16-Roger_Federer-Juan_Martin_Del_Potro,1,S-DTL,1,0,0,0,0,0,1
20170327-M-Miami_Masters-R16-Roger_Federer-Juan_Martin_Del_Potro,2,F-XC,20,8,4,1,3,12,8
20170327-M-Miami_Masters-R16-Roger_Federer-Juan_Martin_Del_Potro,2,F-DTM,11,0,0,0,0,6,5
20170327-M-Miami_Masters-R16-Roger_Federer-Juan_Martin_Del_Potro,2,F-DTL,5,2,0,1,1,2,3
20170327-M-Miami_Masters-R16-Roger_Federer-Juan_Martin_Del_Potro,2,F-IO,21,6,2,1,3,9,12
20170327-M-Miami_Masters-R16-Roger_Federer-Juan_Martin_Del_Potro,2,F-II,4,1,1,0,0,3,1
20170327-M-Miami_Masters-R16-Roger_Federer-Juan_Martin_Del_Potro,2,B-XC,13,3,1,0,2,5,8
20170327-M-Miami_Masters-R16-Roger_Federer-Juan_Martin_Del_Potro,2,B-DTM,3,0,0,0,0,1,2
20170327-M-Miami_Masters-R16-Roger_Federer-Juan_Martin_Del_Potro,2,B-DTL,1,0,0,0,0,1,0
20170327-M-Miami_Masters-R16-Roger_Federer-Juan_Martin_Del_Potro,2,B-IO,1,0,0,0,0,0,1
20170327-M-Miami_Masters-R16-Roger_Federer-Juan_Martin_Del_Potro,2,S-XC,13,1,0,0,1,9,4
20170327-M-Miami_Masters-R16-Roger_Federer-Juan_Martin_Del_Potro,2,S-DTM,4,0,0,0,0,1,3
20170327-M-Miami_Masters-R16-Roger_Federer-Juan_Martin_Del_Potro,2,S-DTL,1,0,0,0,0,0,1
19990129-M-Australian_Open-SF-Nicolas_Lapentti-Thomas_Enqvist,1,F-XC,27,8,3,4,1,12,15
19990129-M-Australian_Open-SF-Nicolas_Lapentti-Thomas_Enqvist,1,F-DTM,21,1,0,0,1,4,17
19990129-M-Australian_Open-SF-Nicolas_Lapentti-Thomas_Enqvist,1,F-DTL,15,5,1,1,3,4,11
19990129-M-Australian_Open-SF-Nicolas_Lapentti-Thomas_Enqvist,1,F-IO,18,3,2,1,0,9,9
19990129-M-Australian_Open-SF-Nicolas_Lapentti-Thomas_Enqvist,1,F-II,7,2,0,1,1,3,4
19990129-M-Australian_Open-SF-Nicolas_Lapentti-Thomas_Enqvist,1,B-XC,15,2,0,2,0,5,10
19990129-M-Australian_Open-SF-Nicolas_Lapentti-Thomas_Enqvist,1,B-DTM,13,0,0,0,0,2,11
19990129-M-Australian_Open-SF-Nicolas_Lapentti-Thomas_Enqvist,1,B-DTL,4,2,1,0,1,2,2
19990129-M-Australian_Open-SF-Nicolas_Lapentti-Thomas_Enqvist,1,B-IO,2,0,0,0,0,0,2
19990129-M-Australian_Open-SF-Nicolas_Lapentti-Thomas_Enqvist,1,S-XC,19,1,0,0,1,1,18
19990129-M-Australian_Open-SF-Nicolas_Lapentti-Thomas_Enqvist,1,S-DTM,9,0,0,0,0,0,9
19990129-M-Australian_Open-SF-Nicolas_Lapentti-Thomas_Enqvist,1,S-DTL,2,0,0,0,0,0,2
19990129-M-Australian_Open-SF-Nicolas_Lapentti-Thomas_Enqvist,2,F-XC,37,15,7,6,2,30,7
19990129-M-Australian_Open-SF-Nicolas_Lapentti-Thomas_Enqvist,2,F-DTM,10,0,0,0,0,7,3
19990129-M-Australian_Open-SF-Nicolas_Lapentti-Thomas_Enqvist,2,F-DTL,12,5,1,3,1,8,4
19990129-M-Australian_Open-SF-Nicolas_Lapentti-Thomas_Enqvist,2,F-IO,20,7,2,4,1,18,2
19990129-M-Australian_Open-SF-Nicolas_Lapentti-Thomas_Enqvist,2,F-II,5,4,2,2,0,5,0
19990129-M-Australian_Open-SF-Nicolas_Lapentti-Thomas_Enqvist,2,B-XC,50,14,2,4,8,36,14
19990129-M-Australian_Open-SF-Nicolas_Lapentti-Thomas_Enqvist,2,B-DTM,13,1,0,0,1,8,5
19990129-M-Australian_Open-SF-Nicolas_Lapentti-Thomas_Enqvist,2,B-DTL,13,7,4,1,2,10,3
19990129-M-Australian_Open-SF-Nicolas_Lapentti-Thomas_Enqvist,2,B-IO,4,2,1,1,0,2,2
19990129-M-Australian_Open-SF-Nicolas_Lapentti-Thomas_Enqvist,2,S-XC,7,1,0,0,1,5,2
19990129-M-Australian_Open-SF-Nicolas_Lapentti-Thomas_Enqvist,2,S-DTM,4,0,0,0,0,2,2
19990129-M-Australian_Open-SF-Nicolas_Lapentti-Thomas_Enqvist,2,S-DTL,5,2,0,2,0,4,1
20050320-M-Indian_Wells_Masters-F-Lleyton_Hewitt-Roger_Federer,1,F-XC,44,15,2,6,7,28,16
20050320-M-Indian_Wells_Masters-F-Lleyton_Hewitt-Roger_Federer,1,F-DTM,28,1,0,0,1,11,17
20050320-M-Indian_Wells_Masters-F-Lleyton_Hewitt-Roger_Federer,1,F-DTL,13,2,1,0,1,5,8
20050320-M-Indian_Wells_Masters-F-Lleyton_Hewitt-Roger_Federer,1,F-IO,22,5,1,2,2,10,12
20050320-M-Indian_Wells_Masters-F-Lleyton_Hewitt-Roger_Federer,1,F-II,3,0,0,0,0,0,3
20050320-M-Indian_Wells_Masters-F-Lleyton_Hewitt-Roger_Federer,1,B-XC,68,7,1,1,5,35,33
20050320-M-Indian_Wells_Masters-F-Lleyton_Hewitt-Roger_Federer,1,B-DTM,39,4,0,0,4,10,29
20050320-M-Indian_Wells_Masters-F-Lleyton_Hewitt-Roger_Federer,1,B-DTL,4,3,0,2,1,2,2
20050320-M-Indian_Wells_Masters-F-Lleyton_Hewitt-Roger_Federer,1,B-IO,4,3,1,0,2,2,2
20050320-M-Indian_Wells_Masters-F-Lleyton_Hewitt-Roger_Federer,1,S-XC,6,1,0,1,0,5,1
20050320-M-Indian_Wells_Masters-F-Lleyton_Hewitt-Roger_Federer,1,S-DTM,5,1,0,0,1,0,5
20050320-M-Indian_Wells_Masters-F-Lleyton_Hewitt-Roger_Federer,2,F-XC,32,11,4,4,3,17,15
20050320-M-Indian_Wells_Masters-F-Lleyton_Hewitt-Roger_Federer,2,F-DTM,32,4,1,0,3,11,21
20050320-M-Indian_Wells_Masters-F-Lleyton_Hewitt-Roger_Federer,2,F-DTL,11,6,3,0,3,5,6
20050320-M-Indian_Wells_Masters-F-Lleyton_Hewitt-Roger_Federer,2,F-IO,15,6,5,1,0,13,2
20050320-M-Indian_Wells_Masters-F-Lleyton_Hewitt-Roger_Federer,2,F-II,1,0,0,0,0,1,0
20050320-M-Indian_Wells_Masters-F-Lleyton_Hewitt-Roger_Federer,2,B-XC,42,14,4,2,8,24,18
20050320-M-Indian_Wells_Masters-F-Lleyton_Hewitt-Roger_Federer,2,B-DTM,43,3,0,0,3,25,18
20050320-M-Indian_Wells_Masters-F-Lleyton_Hewitt-Roger_Federer,2,B-DTL,13,5,2,0,3,5,8
20050320-M-Indian_Wells_Masters-F-Lleyton_Hewitt-Roger_Federer,2,B-IO,2,0,0,0,0,2,0
20050320-M-Indian_Wells_Masters-F-Lleyton_Hewitt-Roger_Federer,2,S-XC,12,0,0,0,0,6,6
20050320-M-Indian_Wells_Masters-F-Lleyton_Hewitt-Roger_Federer,2,S-DTM,15,0,0,0,0,6,9
20050320-M-Indian_Wells_Masters-F-Lleyton_Hewitt-Roger_Federer,2,S-DTL,6,0,0,0,0,3,3
20050320-M-Indian_Wells_Masters-F-Lleyton_Hewitt-Roger_Federer,2,S-IO,3,1,0,0,1,1,2
19890609-M-Roland_Garros-SF-Stefan_Edberg-Boris_Becker,1,F-XC,28,7,1,2,4,15,13
19890609-M-Roland_Garros-SF-Stefan_Edberg-Boris_Becker,1,F-DTM,15,0,0,0,0,5,10
19890609-M-Roland_Garros-SF-Stefan_Edberg-Boris_Becker,1,F-DTL,31,4,0,2,2,18,13
19890609-M-Roland_Garros-SF-Stefan_Edberg-Boris_Becker,1,F-IO,18,4,1,2,1,10,8
19890609-M-Roland_Garros-SF-Stefan_Edberg-Boris_Becker,1,F-II,1,1,0,1,0,1,0
19890609-M-Roland_Garros-SF-Stefan_Edberg-Boris_Becker,1,B-XC,56,9,1,2,6,26,30
19890609-M-Roland_Garros-SF-Stefan_Edberg-Boris_Becker,1,B-DTM,19,1,0,0,1,12,7
19890609-M-Roland_Garros-SF-Stefan_Edberg-Boris_Becker,1,B-DTL,13,6,3,0,3,5,8
19890609-M-Roland_Garros-SF-Stefan_Edberg-Boris_Becker,1,B-IO,8,6,1,3,2,5,3
19890609-M-Roland_Garros-SF-Stefan_Edberg-Boris_Becker,1,S-XC,49,6,0,1,5,19,30
19890609-M-Roland_Garros-SF-Stefan_Edberg-Boris_Becker,1,S-DTM,9,1,1,0,0,4,5
19890609-M-Roland_Garros-SF-Stefan_Edberg-Boris_Becker,1,S-DTL,7,1,0,1,0,1,6
19890609-M-Roland_Garros-SF-Stefan_Edberg-Boris_Becker,1,S-IO,1,1,1,0,0,1,0
19890609-M-Roland_Garros-SF-Stefan_Edberg-Boris_Becker,2,F-XC,64,21,4,7,9,37,27
19890609-M-Roland_Garros-SF-Stefan_Edberg-Boris_Becker,2,F-DTM,17,2,0,1,1,11,6
19890609-M-Roland_Garros-SF-Stefan_Edberg-Boris_Becker,2,F-DTL,11,5,3,1,1,5,6
19890609-M-Roland_Garros-SF-Stefan_Edberg-Boris_Becker,2,F-IO,59,8,2,2,4,31,28
19890609-M-Roland_Garros-SF-Stefan_Edberg-Boris_Becker,2,F-II,10,1,0,1,0,5,5
19890609-M-Roland_Garros-SF-Stefan_Edberg-Boris_Becker,2,B-XC,68,13,3,3,7,35,33
19890609-M-Roland_Garros-SF-Stefan_Edberg-Boris_Becker,2,B-DTM,37,2,1,0,1,16,21
19890609-M-Roland_Garros-SF-Stefan_Edberg-Boris_Becker,2,B-DTL,28,12,4,4,4,15,13
19890609-M-Roland_Garros-SF-Stefan_Edberg-Boris_Becker,2,B-IO,3,1,1,0,0,1,2
19890609-M-Roland_Garros-SF-Stefan_Edberg-Boris_Becker,2,S-XC,9,1,0,0,1,5,4
19890609-M-Roland_Garros-SF-Stefan_Edberg-Boris_Becker,2,S-DTM,10,1,0,0,1,6,4
19890609-M-Roland_Garros-SF-Stefan_Edberg-Boris_Becker,2,S-DTL,3,0,0,0,0,1,2
20060125-M-Australian_Open-QF-Roger_Federer-Nikolay_Davydenko,1,F-XC,101,26,5,9,12,56,45
20060125-M-Australian_Open-QF-Roger_Federer-Nikolay_Davydenko,1,F-DTM,17,3,0,1,2,7,10
20060125-M-Australian_Open-QF-Roger_Federer-Nikolay_Davydenko,1,F-DTL,19,6,3,1,2,9,10
20060125-M-Australian_Open-QF-Roger_Federer-Nikolay_Davydenko,1,F-IO,43,14,5,3,6,21,22
20060125-M-Australian_Open-QF-Roger_Federer-Nikolay_Davydenko,1,F-II,11,6,2,2,2,7,4
20060125-M-Australian_Open-QF-Roger_Federer-Nikolay_Davydenko,1,B-XC,92,14,1,1,12,53,39
20060125-M-Australian_Open-QF-Roger_Federer-Nikolay_Davydenko,1,B-DTM,30,2,0,0,2,12,18
20060125-M-Australian_Open-QF-Roger_Federer-Nikolay_Davydenko,1,B-DTL,20,6,5,0,1,15,5
20060125-M-Australian_Open-QF-Roger_Federer-Nikolay_Davydenko,1,B-IO,5,3,1,0,2,2,3
20060125-M-Australian_Open-QF-Roger_Federer-Nikolay_Davydenko,1,S-XC,61,5,0,0,5,27,34
20060125-M-Australian_Open-QF-Roger_Federer-Nikolay_Davydenko,1,S-DTM,9,0,0,0,0,6,3
20060125-M-Australian_Open-QF-Roger_Federer-Nikolay_Davydenko,1,S-DTL,8,1,0,1,0,3,5
20060125-M-Australian_Open-QF-Roger_Federer-Nikolay_Davydenko,2,F-XC,87,27,2,14,11,47,40
20060125-M-Australian_Open-QF-Roger_Federer-Nikolay_Davydenko,2,F-DTM,34,3,0,1,2,13,21
20060125-M-Australian_Open-QF-Roger_Federer-Nikolay_Davydenko,2,F-DTL,43,8,4,1,3,24,19
20060125-M-Australian_Open-QF-Roger_Federer-Nikolay_Davydenko,2,F-IO,43,9,1,3,5,24,19
20060125-M-Australian_Open-QF-Roger_Federer-Nikolay_Davydenko,2,F-II,14,4,2,0,2,8,6
20060125-M-Australian_Open-QF-Roger_Federer-Nikolay_Davydenko,2,B-XC,154,17,3,3,11,71,83
20060125-M-Australian_Open-QF-Roger_Federer-Nikolay_Davydenko,2,B-DTM,29,2,0,0,2,16,13
20060125-M-Australian_Open-QF-Roger_Federer-Nikolay_Davydenko,2,B-DTL,36,15,6,2,7,12,24
20060125-M-Australian_Open-QF-Roger_Federer-Nikolay_Davydenko,2,B-IO,1,1,0,0,1,0,1
20060125-M-Australian_Open-QF-Roger_Federer-Nikolay_Davydenko,2,S-XC,8,0,0,0,0,3,5
20060125-M-Australian_Open-QF-Roger_Federer-Nikolay_Davydenko,2,S-DTM,1,0,0,0,0,1,0
20080630-M-Wimbledon-R16-Roger_Federer-Lleyton_Hewitt,1,F-XC,27,9,0,3,6,13,14
20080630-M-Wimbledon-R16-Roger_Federer-Lleyton_Hewitt,1,F-DTM,10,1,0,0,1,5,5
20080630-M-Wimbledon-R16-Roger_Federer-Lleyton_Hewitt,1,F-DTL,15,5,1,1,3,8,7
20080630-M-Wimbledon-R16-Roger_Federer-Lleyton_Hewitt,1,F-IO,18,8,2,2,4,9,9
20080630-M-Wimbledon-R16-Roger_Federer-Lleyton_Hewitt,1,F-II,9,7,3,2,2,7,2
20080630-M-Wimbledon-R16-Roger_Federer-Lleyton_Hewitt,1,B-XC,17,3,2,0,1,8,9
20080630-M-Wimbledon-R16-Roger_Federer-Lleyton_Hewitt,1,B-DTM,15,0,0,0,0,7,8
20080630-M-Wimbledon-R16-Roger_Federer-Lleyton_Hewitt,1,B-DTL,18,8,3,2,3,10,8
20080630-M-Wimbledon-R16-Roger_Federer-Lleyton_Hewitt,1,S-XC,23,1,0,1,0,7,16
20080630-M-Wimbledon-R16-Roger_Federer-Lleyton_Hewitt,1,S-DTM,4,0,0,0,0,1,3
20080630-M-Wimbledon-R16-Roger_Federer-Lleyton_Hewitt,1,S-DTL,4,0,0,0,0,1,3
20080630-M-Wimbledon-R16-Roger_Federer-Lleyton_Hewitt,2,F-XC,31,9,2,2,5,17,14
20080630-M-Wimbledon-R16-Roger_Federer-Lleyton_Hewitt,2,F-DTM,3,0,0,0,0,1,2
20080630-M-Wimbledon-R16-Roger_Federer-Lleyton_Hewitt,2,F-DTL,14,2,0,0,2,8,6
20080630-M-Wimbledon-R16-Roger_Federer-Lleyton_Hewitt,2,F-IO,40,13,5,5,3,25,15
20080630-M-Wimbledon-R16-Roger_Federer-Lleyton_Hewitt,2,F-II,1,1,0,0,1,0,1
20080630-M-Wimbledon-R16-Roger_Federer-Lleyton_Hewitt,2,B-XC,44,7,0,2,5,21,23
20080630-M-Wimbledon-R16-Roger_Federer-Lleyton_Hewitt,2,B-DTM,7,0,0,0,0,4,3
20080630-M-Wimbledon-R16-Roger_Federer-Lleyton_Hewitt,2,B-DTL,6,3,0,2,1,4,2
20080630-M-Wimbledon-R16-Roger_Federer-Lleyton_Hewitt,2,B-IO,8,4,3,1,0,6,2
20080630-M-Wimbledon-R16-Roger_Federer-Lleyton_Hewitt,2,S-XC,6,1,1,0,0,3,3
20080630-M-Wimbledon-R16-Roger_Federer-Lleyton_Hewitt,2,S-DTM,1,0,0,0,0,0,1
20080630-M-Wimbledon-R16-Roger_Federer-Lleyton_Hewitt,2,S-DTL,3,1,0,1,0,2,1
20080630-M-Wimbledon-R16-Roger_Federer-Lleyton_Hewitt,2,S-II,1,0,0,0,0,0,1
20090821-M-Cincinnati_Masters-QF-Roger_Federer-Lleyton_Hewitt,1,F-XC,17,7,2,1,4,10,7
20090821-M-Cincinnati_Masters-QF-Roger_Federer-Lleyton_Hewitt,1,F-DTM,8,0,0,0,0,4,4
20090821-M-Cincinnati_Masters-QF-Roger_Federer-Lleyton_Hewitt,1,F-DTL,8,1,1,0,0,5,3
20090821-M-Cincinnati_Masters-QF-Roger_Federer-Lleyton_Hewitt,1,F-IO,17,6,3,1,2,9,8
20090821-M-Cincinnati_Masters-QF-Roger_Federer-Lleyton_Hewitt,1,F-II,3,1,0,0,1,1,2
20090821-M-Cincinnati_Masters-QF-Roger_Federer-Lleyton_Hewitt,1,B-XC,19,4,1,0,3,7,12
20090821-M-Cincinnati_Masters-QF-Roger_Federer-Lleyton_Hewitt,1,B-DTM,9,0,0,0,0,4,5
20090821-M-Cincinnati_Masters-QF-Roger_Federer-Lleyton_Hewitt,1,B-DTL,8,6,3,0,3,3,5
20090821-M-Cincinnati_Masters-QF-Roger_Federer-Lleyton_Hewitt,1,S-XC,14,1,0,1,0,9,5
20090821-M-Cincinnati_Masters-QF-Roger_Federer-Lleyton_Hewitt,1,S-DTM,2,0,0,0,0,2,0
20090821-M-Cincinnati_Masters-QF-Roger_Federer-Lleyton_Hewitt,2,F-XC,16,3,0,1,2,6,10
20090821-M-Cincinnati_Masters-QF-Roger_Federer-Lleyton_Hewitt,2,F-DTM,7,2,0,0,2,3,4
20090821-M-Cincinnati_Masters-QF-Roger_Federer-Lleyton_Hewitt,2,F-DTL,9,4,1,0,3,4,5
20090821-M-Cincinnati_Masters-QF-Roger_Federer-Lleyton_Hewitt,2,F-IO,15,2,0,1,1,7,8
20090821-M-Cincinnati_Masters-QF-Roger_Federer-Lleyton_Hewitt,2,F-II,5,1,1,0,0,3,2
20090821-M-Cincinnati_Masters-QF-Roger_Federer-Lleyton_Hewitt,2,B-XC,38,4,0,0,4,18,20
20090821-M-Cincinnati_Masters-QF-Roger_Federer-Lleyton_Hewitt,2,B-DTM,8,1,0,0,1,3,5
20090821-M-Cincinnati_Masters-QF-Roger_Federer-Lleyton_Hewitt,2,B-DTL,9,7,2,3,2,6,3
20090821-M-Cincinnati_Masters-QF-Roger_Federer-Lleyton_Hewitt,2,B-IO,4,2,1,0,1,3,1
20090821-M-Cincinnati_Masters-QF-Roger_Federer-Lleyton_Hewitt,2,S-XC,5,1,0,0,1,3,2
20090821-M-Cincinnati_Masters-QF-Roger_Federer-Lleyton_Hewitt,2,S-DTM,1,0,0,0,0,1,0
20090821-M-Cincinnati_Masters-QF-Roger_Federer-Lleyton_Hewitt,2,S-DTL,3,0,0,0,0,3,0
20090905-M-US_Open-R32-Roger_Federer-Lleyton_Hewitt,1,F-XC,50,19,4,2,13,29,21
20090905-M-US_Open-R32-Roger_Federer-Lleyton_Hewitt,1,F-DTM,19,1,0,1,0,14,5
20090905-M-US_Open-R32-Roger_Federer-Lleyton_Hewitt,1,F-DTL,20,11,4,2,5,9,11
20090905-M-US_Open-R32-Roger_Federer-Lleyton_Hewitt,1,F-IO,45,18,4,5,9,28,17
20090905-M-US_Open-R32-Roger_Federer-Lleyton_Hewitt,1,F-II,18,9,1,1,7,6,12
20090905-M-US_Open-R32-Roger_Federer-Lleyton_Hewitt,1,B-XC,40,7,2,0,5,22,18
20090905-M-US_Open-R32-Roger_Federer-Lleyton_Hewitt,1,B-DTM,13,1,0,0,1,4,9
20090905-M-US_Open-R32-Roger_Federer-Lleyton_Hewitt,1,B-DTL,21,10,3,2,5,13,8
20090905-M-US_Open-R32-Roger_Federer-Lleyton_Hewitt,1,B-IO,1,0,0,0,0,1,0
20090905-M-US_Open-R32-Roger_Federer-Lleyton_Hewitt,1,S-XC,25,1,0,1,0,15,10
20090905-M-US_Open-R32-Roger_Federer-Lleyton_Hewitt,1,S-DTM,9,2,0,0,2,3,6
20090905-M-US_Open-R32-Roger_Federer-Lleyton_Hewitt,1,S-DTL,3,2,0,1,1,1,2
20090905-M-US_Open-R32-Roger_Federer-Lleyton_Hewitt,2,F-XC,36,8,2,1,5,14,22
20090905-M-US_Open-R32-Roger_Federer-Lleyton_Hewitt,2,F-DTM,9,1,0,0,1,3,6
20090905-M-US_Open-R32-Roger_Federer-Lleyton_Hewitt,2,F-DTL,26,4,0,1,3,10,16
20090905-M-US_Open-R32-Roger_Federer-Lleyton_Hewitt,2,F-IO,35,7,0,2,5,13,22
20090905-M-US_Open-R32-Roger_Federer-Lleyton_Hewitt,2,F-II,5,2,0,1,1,2,3
20090905-M-US_Open-R32-Roger_Federer-Lleyton_Hewitt,2,B-XC,74,13,2,3,8,40,34
20090905-M-US_Open-R32-Roger_Federer-Lleyton_Hewitt,2,B-DTM,14,2,0,0,2,7,7
20090905-M-US_Open-R32-Roger_Federer-Lleyton_Hewitt,2,B-DTL,13,5,2,3,0,7,6
20090905-M-US_Open-R32-Roger_Federer-Lleyton_Hewitt,2,B-IO,7,4,0,1,3,2,5
20090905-M-US_Open-R32-Roger_Federer-Lleyton_Hewitt,2,S-XC,13,1,0,0,1,6,7
20090905-M-US_Open-R32-Roger_Federer-Lleyton_Hewitt,2,S-DTM,2,0,0,0,0,0,2
20090905-M-US_Open-R32-Roger_Federer-Lleyton_Hewitt,2,S-DTL,3,0,0,0,0,2,1
20090905-M-US_Open-R32-Roger_Federer-Lleyton_Hewitt,2,S-IO,2,0,0,0,0,0,2
20180316-M-Indian_Wells_Masters-SF-Milos_Raonic-Juan_Martin_Del_Potro,1,F-XC,11,1,0,1,0,3,8
20180316-M-Indian_Wells_Masters-SF-Milos_Raonic-Juan_Martin_Del_Potro,1,F-DTM,8,1,0,0,1,4,4
20180316-M-Indian_Wells_Masters-SF-Milos_Raonic-Juan_Martin_Del_Potro,1,F-DTL,11,3,1,0,2,6,5
20180316-M-Indian_Wells_Masters-SF-Milos_Raonic-Juan_Martin_Del_Potro,1,F-IO,28,5,2,0,3,10,18
20180316-M-Indian_Wells_Masters-SF-Milos_Raonic-Juan_Martin_Del_Potro,1,F-II,2,1,1,0,0,1,1
20180316-M-Indian_Wells_Masters-SF-Milos_Raonic-Juan_Martin_Del_Potro,1,B-XC,6,1,0,1,0,1,5
20180316-M-Indian_Wells_Masters-SF-Milos_Raonic-Juan_Martin_Del_Potro,1,B-DTM,5,0,0,0,0,1,4
20180316-M-Indian_Wells_Masters-SF-Milos_Raonic-Juan_Martin_Del_Potro,1,B-DTL,8,2,0,0,2,3,5
20180316-M-Indian_Wells_Masters-SF-Milos_Raonic-Juan_Martin_Del_Potro,1,S-XC,11,1,0,0,1,2,9
20180316-M-Indian_Wells_Masters-SF-Milos_Raonic-Juan_Martin_Del_Potro,1,S-DTM,2,1,0,0,1,0,2
20180316-M-Indian_Wells_Masters-SF-Milos_Raonic-Juan_Martin_Del_Potro,1,S-DTL,2,2,0,0,2,0,2
20180316-M-Indian_Wells_Masters-SF-Milos_Raonic-Juan_Martin_Del_Potro,2,F-XC,20,7,2,4,1,14,6
20180316-M-Indian_Wells_Masters-SF-Milos_Raonic-Juan_Martin_Del_Potro,2,F-DTM,6,1,0,0,1,3,3
20180316-M-Indian_Wells_Masters-SF-Milos_Raonic-Juan_Martin_Del_Potro,2,F-DTL,5,2,1,0,1,4,1
20180316-M-Indian_Wells_Masters-SF-Milos_Raonic-Juan_Martin_Del_Potro,2,F-IO,19,3,1,2,0,16,3
20180316-M-Indian_Wells_Masters-SF-Milos_Raonic-Juan_Martin_Del_Potro,2,F-II,2,0,0,0,0,2,0
20180316-M-Indian_Wells_Masters-SF-Milos_Raonic-Juan_Martin_Del_Potro,2,B-XC,11,2,1,0,1,6,5
20180316-M-Indian_Wells_Masters-SF-Milos_Raonic-Juan_Martin_Del_Potro,2,B-DTM,2,0,0,0,0,1,1
20180316-M-Indian_Wells_Masters-SF-Milos_Raonic-Juan_Martin_Del_Potro,2,B-DTL,6,4,3,1,0,5,1
20180316-M-Indian_Wells_Masters-SF-Milos_Raonic-Juan_Martin_Del_Potro,2,B-IO,1,0,0,0,0,0,1
20180316-M-Indian_Wells_Masters-SF-Milos_Raonic-Juan_Martin_Del_Potro,2,S-XC,18,2,0,1,1,12,6
20180316-M-Indian_Wells_Masters-SF-Milos_Raonic-Juan_Martin_Del_Potro,2,S-DTM,4,0,0,0,0,3,1
20180316-M-Indian_Wells_Masters-SF-Milos_Raonic-Juan_Martin_Del_Potro,2,S-DTL,2,0,0,0,0,0,2
20181103-M-Paris_Masters-SF-Dominic_Thiem-Karen_Khachanov,1,F-XC,32,8,1,2,5,14,18
20181103-M-Paris_Masters-SF-Dominic_Thiem-Karen_Khachanov,1,F-DTM,6,0,0,0,0,3,3
20181103-M-Paris_Masters-SF-Dominic_Thiem-Karen_Khachanov,1,F-DTL,6,3,0,1,2,2,4
20181103-M-Paris_Masters-SF-Dominic_Thiem-Karen_Khachanov,1,F-IO,16,6,2,0,4,5,11
20181103-M-Paris_Masters-SF-Dominic_Thiem-Karen_Khachanov,1,B-XC,24,6,2,2,2,13,11
20181103-M-Paris_Masters-SF-Dominic_Thiem-Karen_Khachanov,1,B-DTM,12,0,0,0,0,4,8
20181103-M-Paris_Masters-SF-Dominic_Thiem-Karen_Khachanov,1,B-DTL,8,5,2,1,2,5,3
20181103-M-Paris_Masters-SF-Dominic_Thiem-Karen_Khachanov,1,B-IO,1,1,0,0,1,0,1
20181103-M-Paris_Masters-SF-Dominic_Thiem-Karen_Khachanov,1,S-XC,11,0,0,0,0,5,6
20181103-M-Paris_Masters-SF-Dominic_Thiem-Karen_Khachanov,1,S-DTM,4,0,0,0,0,1,3
20181103-M-Paris_Masters-SF-Dominic_Thiem-Karen_Khachanov,1,S-DTL,2,1,1,0,0,1,1
20181103-M-Paris_Masters-SF-Dominic_Thiem-Karen_Khachanov,2,F-XC,29,8,3,2,3,16,13
20181103-M-Paris_Masters-SF-Dominic_Thiem-Karen_Khachanov,2,F-DTM,7,0,0,0,0,3,4
20181103-M-Paris_Masters-SF-Dominic_Thiem-Karen_Khachanov,2,F-DTL,9,2,0,1,1,2,7
20181103-M-Paris_Masters-SF-Dominic_Thiem-Karen_Khachanov,2,F-IO,19,3,1,0,2,14,5
20181103-M-Paris_Masters-SF-Dominic_Thiem-Karen_Khachanov,2,F-II,3,2,0,1,1,2,1
20181103-M-Paris_Masters-SF-Dominic_Thiem-Karen_Khachanov,2,B-XC,26,0,0,0,0,12,14
20181103-M-Paris_Masters-SF-Dominic_Thiem-Karen_Khachanov,2,B-DTM,8,1,0,1,0,7,1
20181103-M-Paris_Masters-SF-Dominic_Thiem-Karen_Khachanov,2,B-DTL,9,4,0,1,3,4,5
20181103-M-Paris_Masters-SF-Dominic_Thiem-Karen_Khachanov,2,B-IO,3,2,0,2,0,3,0
20181103-M-Paris_Masters-SF-Dominic_Thiem-Karen_Khachanov,2,S-XC,1,0,0,0,0,0,1
20000909-M-US_Open-SF-Pete_Sampras-Lleyton_Hewitt,1,F-XC,25,13,4,5,4,15,10
20000909-M-US_Open-SF-Pete_Sampras-Lleyton_Hewitt,1,F-DTM,3,0,0,0,0,3,0
20000909-M-US_Open-SF-Pete_Sampras-Lleyton_Hewitt,1,F-DTL,9,4,2,0,2,4,5
20000909-M-US_Open-SF-Pete_Sampras-Lleyton_Hewitt,1,F-IO,18,9,2,3,4,7,11
20000909-M-US_Open-SF-Pete_Sampras-Lleyton_Hewitt,1,F-II,8,5,1,1,3,2,6
20000909-M-US_Open-SF-Pete_Sampras-Lleyton_Hewitt,1,B-XC,40,6,1,2,3,17,23
20000909-M-US_Open-SF-Pete_Sampras-Lleyton_Hewitt,1,B-DTM,9,3,0,0,3,2,7
20000909-M-US_Open-SF-Pete_Sampras-Lleyton_Hewitt,1,B-DTL,5,2,0,0,2,2,3
20000909-M-US_Open-SF-Pete_Sampras-Lleyton_Hewitt,1,B-IO,2,2,0,0,2,0,2
20000909-M-US_Open-SF-Pete_Sampras-Lleyton_Hewitt,1,S-XC,11,2,0,0,2,1,10
20000909-M-US_Open-SF-Pete_Sampras-Lleyton_Hewitt,1,S-DTM,1,0,0,0,0,0,1
20000909-M-US_Open-SF-Pete_Sampras-Lleyton_Hewitt,1,S-DTL,1,1,1,0,0,1,0
20000909-M-US_Open-SF-Pete_Sampras-Lleyton_Hewitt,2,F-XC,28,6,1,2,3,15,13
20000909-M-US_Open-SF-Pete_Sampras-Lleyton_Hewitt,2,F-DTM,15,1,1,0,0,6,9
20000909-M-US_Open-SF-Pete_Sampras-Lleyton_Hewitt,2,F-DTL,15,3,2,1,0,8,7
20000909-M-US_Open-SF-Pete_Sampras-Lleyton_Hewitt,2,F-IO,31,4,3,1,0,19,12
20000909-M-US_Open-SF-Pete_Sampras-Lleyton_Hewitt,2,F-II,6,3,1,1,1,3,3
20000909-M-US_Open-SF-Pete_Sampras-Lleyton_Hewitt,2,B-XC,49,12,5,2,5,32,17
20000909-M-US_Open-SF-Pete_Sampras-Lleyton_Hewitt,2,B-DTM,12,0,0,0,0,7,5
20000909-M-US_Open-SF-Pete_Sampras-Lleyton_Hewitt,2,B-DTL,3,2,2,0,0,3,0
20000909-M-US_Open-SF-Pete_Sampras-Lleyton_Hewitt,2,S-XC,9,0,0,0,0,5,4
20000909-M-US_Open-SF-Pete_Sampras-Lleyton_Hewitt,2,S-DTM,1,0,0,0,0,0,1
20000909-M-US_Open-SF-Pete_Sampras-Lleyton_Hewitt,2,S-DTL,3,1,0,0,1,1,2
20110917-M-Davis_Cup_World_Group_PO-RR-Roger_Federer-Lleyton_Hewitt,1,F-XC,57,19,2,8,9,33,24
20110917-M-Davis_Cup_World_Group_PO-RR-Roger_Federer-Lleyton_Hewitt,1,F-DTM,20,2,0,1,1,13,7
20110917-M-Davis_Cup_World_Group_PO-RR-Roger_Federer-Lleyton_Hewitt,1,F-DTL,31,10,5,3,2,18,13
20110917-M-Davis_Cup_World_Group_PO-RR-Roger_Federer-Lleyton_Hewitt,1,F-IO,47,16,7,4,5,24,23
20110917-M-Davis_Cup_World_Group_PO-RR-Roger_Federer-Lleyton_Hewitt,1,F-II,13,5,2,2,1,7,6
20110917-M-Davis_Cup_World_Group_PO-RR-Roger_Federer-Lleyton_Hewitt,1,B-XC,38,9,4,1,4,19,19
20110917-M-Davis_Cup_World_Group_PO-RR-Roger_Federer-Lleyton_Hewitt,1,B-DTM,13,1,0,0,1,8,5
20110917-M-Davis_Cup_World_Group_PO-RR-Roger_Federer-Lleyton_Hewitt,1,B-DTL,11,5,3,0,2,6,5
20110917-M-Davis_Cup_World_Group_PO-RR-Roger_Federer-Lleyton_Hewitt,1,B-IO,1,0,0,0,0,0,1
20110917-M-Davis_Cup_World_Group_PO-RR-Roger_Federer-Lleyton_Hewitt,1,S-XC,38,5,0,1,4,16,22
20110917-M-Davis_Cup_World_Group_PO-RR-Roger_Federer-Lleyton_Hewitt,1,S-DTM,11,0,0,0,0,5,6
20110917-M-Davis_Cup_World_Group_PO-RR-Roger_Federer-Lleyton_Hewitt,1,S-DTL,9,2,1,0,1,7,2
20110917-M-Davis_Cup_World_Group_PO-RR-Roger_Federer-Lleyton_Hewitt,2,F-XC,53,9,1,5,3,23,30
20110917-M-Davis_Cup_World_Group_PO-RR-Roger_Federer-Lleyton_Hewitt,2,F-DTM,15,0,0,0,0,6,9
20110917-M-Davis_Cup_World_Group_PO-RR-Roger_Federer-Lleyton_Hewitt,2,F-DTL,25,6,3,1,2,12,13
20110917-M-Davis_Cup_World_Group_PO-RR-Roger_Federer-Lleyton_Hewitt,2,F-IO,45,12,2,4,6,23,22
20110917-M-Davis_Cup_World_Group_PO-RR-Roger_Federer-Lleyton_Hewitt,2,F-II,5,1,0,1,0,3,2
20110917-M-Davis_Cup_World_Group_PO-RR-Roger_Federer-Lleyton_Hewitt,2,B-XC,70,10,2,3,5,33,37
20110917-M-Davis_Cup_World_Group_PO-RR-Roger_Federer-Lleyton_Hewitt,2,B-DTM,21,4,0,1,3,8,13
20110917-M-Davis_Cup_World_Group_PO-RR-Roger_Federer-Lleyton_Hewitt,2,B-DTL,9,5,1,4,0,8,1
20110917-M-Davis_Cup_World_Group_PO-RR-Roger_Federer-Lleyton_Hewitt,2,B-IO,7,4,0,1,3,2,5
20110917-M-Davis_Cup_World_Group_PO-RR-Roger_Federer-Lleyton_Hewitt,2,S-XC,32,4,2,0,2,17,15
20110917-M-Davis_Cup_World_Group_PO-RR-Roger_Federer-Lleyton_Hewitt,2,S-DTM,5,0,0,0,0,1,4
20110917-M-Davis_Cup_World_Group_PO-RR-Roger_Federer-Lleyton_Hewitt,2,S-DTL,9,4,0,3,1,6,3
20110917-M-Davis_Cup_World_Group_PO-RR-Roger_Federer-Lleyton_Hewitt,2,S-IO,1,1,0,1,0,1,0
20181013-M-Shanghai_Masters-SF-Roger_Federer-Borna_Coric,1,F-XC,16,5,2,1,2,8,8
20181013-M-Shanghai_Masters-SF-Roger_Federer-Borna_Coric,1,F-DTM,12,0,0,0,0,4,8
20181013-M-Shanghai_Masters-SF-Roger_Federer-Borna_Coric,1,F-DTL,3,0,0,0,0,1,2
20181013-M-Shanghai_Masters-SF-Roger_Federer-Borna_Coric,1,F-IO,16,2,1,1,0,9,7
20181013-M-Shanghai_Masters-SF-Roger_Federer-Borna_Coric,1,F-II,5,2,1,1,0,2,3
20181013-M-Shanghai_Masters-SF-Roger_Federer-Borna_Coric,1,B-XC,24,6,1,0,5,6,18
20181013-M-Shanghai_Masters-SF-Roger_Federer-Borna_Coric,1,B-DTM,22,2,0,0,2,3,19
20181013-M-Shanghai_Masters-SF-Roger_Federer-Borna_Coric,1,B-DTL,7,4,0,0,4,1,6
20181013-M-Shanghai_Masters-SF-Roger_Federer-Borna_Coric,1,B-IO,1,0,0,0,0,0,1
20181013-M-Shanghai_Masters-SF-Roger_Federer-Borna_Coric,1,S-XC,8,0,0,0,0,2,6
20181013-M-Shanghai_Masters-SF-Roger_Federer-Borna_Coric,1,S-DTM,6,0,0,0,0,2,4
20181013-M-Shanghai_Masters-SF-Roger_Federer-Borna_Coric,1,S-DTL,8,1,0,1,0,6,2
20181013-M-Shanghai_Masters-SF-Roger_Federer-Borna_Coric,1,S-IO,1,0,0,0,0,0,1
20181013-M-Shanghai_Masters-SF-Roger_Federer-Borna_Coric,2,F-XC,27,11,5,3,3,18,9
20181013-M-Shanghai_Masters-SF-Roger_Federer-Borna_Coric,2,F-DTM,10,1,0,0,1,7,3
20181013-M-Shanghai_Masters-SF-Roger_Federer-Borna_Coric,2,F-DTL,13,1,0,1,0,6,7
20181013-M-Shanghai_Masters-SF-Roger_Federer-Borna_Coric,2,F-IO,19,2,1,0,1,16,3
20181013-M-Shanghai_Masters-SF-Roger_Federer-Borna_Coric,2,B-XC,42,6,1,3,2,29,13
20181013-M-Shanghai_Masters-SF-Roger_Federer-Borna_Coric,2,B-DTM,12,0,0,0,0,10,2
20181013-M-Shanghai_Masters-SF-Roger_Federer-Borna_Coric,2,B-DTL,6,2,1,1,0,3,3
20181013-M-Shanghai_Masters-SF-Roger_Federer-Borna_Coric,2,B-IO,2,1,0,0,1,1,1
20181013-M-Shanghai_Masters-SF-Roger_Federer-Borna_Coric,2,S-XC,2,0,0,0,0,1,1
20181013-M-Shanghai_Masters-SF-Roger_Federer-Borna_Coric,2,S-DTM,1,0,0,0,0,0,1
19880702-M-Wimbledon-SF-Stefan_Edberg-Miroslav_Mecir,1,F-XC,11,4,2,1,1,4,7
19880702-M-Wimbledon-SF-Stefan_Edberg-Miroslav_Mecir,1,F-DTM,6,2,0,1,1,1,5
19880702-M-Wimbledon-SF-Stefan_Edberg-Miroslav_Mecir,1,F-DTL,5,2,1,1,0,3,2
19880702-M-Wimbledon-SF-Stefan_Edberg-Miroslav_Mecir,1,F-IO,3,1,0,0,1,2,1
19880702-M-Wimbledon-SF-Stefan_Edberg-Miroslav_Mecir,1,B-XC,6,1,0,1,0,2,4
19880702-M-Wimbledon-SF-Stefan_Edberg-Miroslav_Mecir,1,B-DTM,3,0,0,0,0,1,2
19880702-M-Wimbledon-SF-Stefan_Edberg-Miroslav_Mecir,1,B-DTL,4,2,1,0,1,2,2
19880702-M-Wimbledon-SF-Stefan_Edberg-Miroslav_Mecir,1,B-IO,1,0,0,0,0,0,1
19880702-M-Wimbledon-SF-Stefan_Edberg-Miroslav_Mecir,1,S-XC,7,2,0,1,1,2,5
19880702-M-Wimbledon-SF-Stefan_Edberg-Miroslav_Mecir,1,S-DTM,4,1,0,0,1,1,3
19880702-M-Wimbledon-SF-Stefan_Edberg-Miroslav_Mecir,1,S-DTL,2,0,0,0,0,2,0
19880702-M-Wimbledon-SF-Stefan_Edberg-Miroslav_Mecir,1,S-IO,1,0,0,0,0,1,0
19880702-M-Wimbledon-SF-Stefan_Edberg-Miroslav_Mecir,2,F-XC,16,5,3,2,0,9,7
19880702-M-Wimbledon-SF-Stefan_Edberg-Miroslav_Mecir,2,F-DTM,3,0,0,0,0,1,2
19880702-M-Wimbledon-SF-Stefan_Edberg-Miroslav_Mecir,2,F-DTL,12,5,1,3,1,7,5
19880702-M-Wimbledon-SF-Stefan_Edberg-Miroslav_Mecir,2,F-IO,6,3,1,0,2,3,3
19880702-M-Wimbledon-SF-Stefan_Edberg-Miroslav_Mecir,2,B-XC,15,5,4,0,1,10,5
19880702-M-Wimbledon-SF-Stefan_Edberg-Miroslav_Mecir,2,B-DTM,12,1,1,0,0,6,6
19880702-M-Wimbledon-SF-Stefan_Edberg-Miroslav_Mecir,2,B-DTL,17,9,3,3,3,8,9
19880702-M-Wimbledon-SF-Stefan_Edberg-Miroslav_Mecir,2,B-IO,5,3,2,0,1,4,1
19880702-M-Wimbledon-SF-Stefan_Edberg-Miroslav_Mecir,2,S-XC,1,0,0,0,0,0,1
19880702-M-Wimbledon-SF-Stefan_Edberg-Miroslav_Mecir,2,S-DTL,1,0,0,0,0,0,1
19880123-M-Australian_Open-SF-Stefan_Edberg-Mats_Wilander,1,F-XC,50,7,3,1,3,24,26
19880123-M-Australian_Open-SF-Stefan_Edberg-Mats_Wilander,1,F-DTM,8,0,0,0,0,2,6
19880123-M-Australian_Open-SF-Stefan_Edberg-Mats_Wilander,1,F-DTL,25,6,1,2,3,9,16
19880123-M-Australian_Open-SF-Stefan_Edberg-Mats_Wilander,1,F-IO,6,1,0,0,1,3,3
19880123-M-Australian_Open-SF-Stefan_Edberg-Mats_Wilander,1,B-XC,27,2,1,0,1,14,13
19880123-M-Australian_Open-SF-Stefan_Edberg-Mats_Wilander,1,B-DTM,4,0,0,0,0,2,2
19880123-M-Australian_Open-SF-Stefan_Edberg-Mats_Wilander,1,B-DTL,8,5,3,0,2,5,3
19880123-M-Australian_Open-SF-Stefan_Edberg-Mats_Wilander,1,B-IO,3,0,0,0,0,2,1
19880123-M-Australian_Open-SF-Stefan_Edberg-Mats_Wilander,1,S-XC,35,4,0,0,4,17,18
19880123-M-Australian_Open-SF-Stefan_Edberg-Mats_Wilander,1,S-DTM,14,3,0,1,2,8,6
19880123-M-Australian_Open-SF-Stefan_Edberg-Mats_Wilander,1,S-DTL,2,0,0,0,0,0,2
19880123-M-Australian_Open-SF-Stefan_Edberg-Mats_Wilander,1,S-IO,1,0,0,0,0,0,1
19880123-M-Australian_Open-SF-Stefan_Edberg-Mats_Wilander,2,F-XC,44,8,4,4,0,28,16
19880123-M-Australian_Open-SF-Stefan_Edberg-Mats_Wilander,2,F-DTM,21,2,0,0,2,6,15
19880123-M-Australian_Open-SF-Stefan_Edberg-Mats_Wilander,2,F-DTL,29,11,1,9,1,20,9
19880123-M-Australian_Open-SF-Stefan_Edberg-Mats_Wilander,2,F-IO,18,2,0,1,1,9,9
19880123-M-Australian_Open-SF-Stefan_Edberg-Mats_Wilander,2,F-II,1,0,0,0,0,1,0
19880123-M-Australian_Open-SF-Stefan_Edberg-Mats_Wilander,2,B-XC,41,12,3,7,2,21,20
19880123-M-Australian_Open-SF-Stefan_Edberg-Mats_Wilander,2,B-DTM,19,1,0,0,1,10,9
19880123-M-Australian_Open-SF-Stefan_Edberg-Mats_Wilander,2,B-DTL,26,10,2,3,5,13,13
19880123-M-Australian_Open-SF-Stefan_Edberg-Mats_Wilander,2,B-IO,9,5,2,3,0,6,3
19880123-M-Australian_Open-SF-Stefan_Edberg-Mats_Wilander,2,S-XC,19,1,0,1,0,11,8
19880123-M-Australian_Open-SF-Stefan_Edberg-Mats_Wilander,2,S-DTM,7,1,0,0,1,5,2
19880123-M-Australian_Open-SF-Stefan_Edberg-Mats_Wilander,2,S-DTL,9,3,1,0,2,6,3
19880123-M-Australian_Open-SF-Stefan_Edberg-Mats_Wilander,2,S-IO,1,1,0,1,0,1,0
20020907-M-US_Open-SF-Pete_Sampras-Sjeng_Schalken,1,F-XC,15,5,1,4,0,10,5
20020907-M-US_Open-SF-Pete_Sampras-Sjeng_Schalken,1,F-DTM,8,0,0,0,0,4,4
20020907-M-US_Open-SF-Pete_Sampras-Sjeng_Schalken,1,F-DTL,5,3,1,0,2,2,3
20020907-M-US_Open-SF-Pete_Sampras-Sjeng_Schalken,1,F-IO,15,7,3,2,2,9,6
20020907-M-US_Open-SF-Pete_Sampras-Sjeng_Schalken,1,F-II,8,6,4,0,2,5,3
20020907-M-US_Open-SF-Pete_Sampras-Sjeng_Schalken,1,B-XC,46,6,1,1,4,17,29
20020907-M-US_Open-SF-Pete_Sampras-Sjeng_Schalken,1,B-DTM,4,2,0,1,1,2,2
20020907-M-US_Open-SF-Pete_Sampras-Sjeng_Schalken,1,B-DTL,2,2,0,0,2,0,2
20020907-M-US_Open-SF-Pete_Sampras-Sjeng_Schalken,1,S-XC,17,3,0,1,2,6,11
20020907-M-US_Open-SF-Pete_Sampras-Sjeng_Schalken,1,S-DTM,4,1,0,0,1,1,3
20020907-M-US_Open-SF-Pete_Sampras-Sjeng_Schalken,1,S-DTL,5,1,0,0,1,2,3
20020907-M-US_Open-SF-Pete_Sampras-Sjeng_Schalken,2,F-XC,23,7,1,4,2,11,12
20020907-M-US_Open-SF-Pete_Sampras-Sjeng_Schalken,2,F-DTM,13,3,1,2,0,9,4
20020907-M-US_Open-SF-Pete_Sampras-Sjeng_Schalken,2,F-DTL,7,1,1,0,0,4,3
20020907-M-US_Open-SF-Pete_Sampras-Sjeng_Schalken,2,F-IO,14,2,1,1,0,8,6
20020907-M-US_Open-SF-Pete_Sampras-Sjeng_Schalken,2,F-II,2,0,0,0,0,2,0
20020907-M-US_Open-SF-Pete_Sampras-Sjeng_Schalken,2,B-XC,75,6,1,1,4,45,30
20020907-M-US_Open-SF-Pete_Sampras-Sjeng_Schalken,2,B-DTM,18,1,0,1,0,7,11
20020907-M-US_Open-SF-Pete_Sampras-Sjeng_Schalken,2,B-DTL,14,11,8,1,2,10,4
20020907-M-US_Open-SF-Pete_Sampras-Sjeng_Schalken,2,B-IO,4,3,1,2,0,4,0
20020907-M-US_Open-SF-Pete_Sampras-Sjeng_Schalken,2,S-XC,3,0,0,0,0,0,3
20020907-M-US_Open-SF-Pete_Sampras-Sjeng_Schalken,2,S-DTM,1,0,0,0,0,1,0
20020907-M-US_Open-SF-Pete_Sampras-Sjeng_Schalken,2,S-DTL,1,1,1,0,0,1,0
20180316-M-Indian_Wells_Masters-SF-Roger_Federer-Borna_Coric,1,F-XC,36,7,2,1,4,17,19
20180316-M-Indian_Wells_Masters-SF-Roger_Federer-Borna_Coric,1,F-DTM,21,0,0,0,0,9,12
20180316-M-Indian_Wells_Masters-SF-Roger_Federer-Borna_Coric,1,F-DTL,10,4,0,2,2,4,6
20180316-M-Indian_Wells_Masters-SF-Roger_Federer-Borna_Coric,1,F-IO,33,4,1,1,2,21,12
20180316-M-Indian_Wells_Masters-SF-Roger_Federer-Borna_Coric,1,F-II,15,5,1,1,3,8,7
20180316-M-Indian_Wells_Masters-SF-Roger_Federer-Borna_Coric,1,B-XC,68,12,4,0,8,33,35
20180316-M-Indian_Wells_Masters-SF-Roger_Federer-Borna_Coric,1,B-DTM,48,3,0,0,3,26,22
20180316-M-Indian_Wells_Masters-SF-Roger_Federer-Borna_Coric,1,B-DTL,17,9,2,1,6,3,14
20180316-M-Indian_Wells_Masters-SF-Roger_Federer-Borna_Coric,1,B-IO,1,0,0,0,0,1,0
20180316-M-Indian_Wells_Masters-SF-Roger_Federer-Borna_Coric,1,S-XC,43,2,0,0,2,24,19
20180316-M-Indian_Wells_Masters-SF-Roger_Federer-Borna_Coric,1,S-DTM,11,0,0,0,0,6,5
20180316-M-Indian_Wells_Masters-SF-Roger_Federer-Borna_Coric,1,S-DTL,6,1,0,0,1,2,4
20180316-M-Indian_Wells_Masters-SF-Roger_Federer-Borna_Coric,2,F-XC,49,14,4,5,5,30,19
20180316-M-Indian_Wells_Masters-SF-Roger_Federer-Borna_Coric,2,F-DTM,18,1,0,0,1,10,8
20180316-M-Indian_Wells_Masters-SF-Roger_Federer-Borna_Coric,2,F-DTL,25,1,0,0,1,11,14
20180316-M-Indian_Wells_Masters-SF-Roger_Federer-Borna_Coric,2,F-IO,65,15,4,3,8,32,33
20180316-M-Indian_Wells_Masters-SF-Roger_Federer-Borna_Coric,2,F-II,5,3,0,0,3,2,3
20180316-M-Indian_Wells_Masters-SF-Roger_Federer-Borna_Coric,2,B-XC,138,22,3,3,16,60,78
20180316-M-Indian_Wells_Masters-SF-Roger_Federer-Borna_Coric,2,B-DTM,11,0,0,0,0,4,7
20180316-M-Indian_Wells_Masters-SF-Roger_Federer-Borna_Coric,2,B-DTL,18,12,2,3,7,8,10
20180316-M-Indian_Wells_Masters-SF-Roger_Federer-Borna_Coric,2,S-XC,7,2,1,1,0,5,2
20180316-M-Indian_Wells_Masters-SF-Roger_Federer-Borna_Coric,2,S-DTL,1,0,0,0,0,0,1
19840908-M-US_Open-SF-Pat_Cash-Ivan_Lendl,1,F-XC,33,8,2,3,3,18,15
19840908-M-US_Open-SF-Pat_Cash-Ivan_Lendl,1,F-DTM,23,2,0,0,2,9,14
19840908-M-US_Open-SF-Pat_Cash-Ivan_Lendl,1,F-DTL,34,8,1,2,5,12,22
19840908-M-US_Open-SF-Pat_Cash-Ivan_Lendl,1,F-IO,28,4,1,2,1,12,16
19840908-M-US_Open-SF-Pat_Cash-Ivan_Lendl,1,F-II,4,3,1,1,1,3,1
19840908-M-US_Open-SF-Pat_Cash-Ivan_Lendl,1,B-XC,26,5,1,2,2,11,15
19840908-M-US_Open-SF-Pat_Cash-Ivan_Lendl,1,B-DTM,11,2,0,2,0,6,5
19840908-M-US_Open-SF-Pat_Cash-Ivan_Lendl,1,B-DTL,28,13,1,2,10,11,17
19840908-M-US_Open-SF-Pat_Cash-Ivan_Lendl,1,B-IO,2,0,0,0,0,2,0
19840908-M-US_Open-SF-Pat_Cash-Ivan_Lendl,1,S-XC,32,8,0,4,4,12,20
19840908-M-US_Open-SF-Pat_Cash-Ivan_Lendl,1,S-DTM,5,0,0,0,0,1,4
19840908-M-US_Open-SF-Pat_Cash-Ivan_Lendl,1,S-DTL,10,4,0,2,2,4,6
19840908-M-US_Open-SF-Pat_Cash-Ivan_Lendl,1,S-IO,3,2,0,0,2,0,3
19840908-M-US_Open-SF-Pat_Cash-Ivan_Lendl,2,F-XC,71,8,3,3,2,36,35
19840908-M-US_Open-SF-Pat_Cash-Ivan_Lendl,2,F-DTM,21,4,0,1,3,9,12
19840908-M-US_Open-SF-Pat_Cash-Ivan_Lendl,2,F-DTL,31,11,6,3,2,16,15
19840908-M-US_Open-SF-Pat_Cash-Ivan_Lendl,2,F-IO,32,6,3,1,2,20,12
19840908-M-US_Open-SF-Pat_Cash-Ivan_Lendl,2,F-II,6,3,0,3,0,5,1
19840908-M-US_Open-SF-Pat_Cash-Ivan_Lendl,2,B-XC,69,7,3,1,3,43,26
19840908-M-US_Open-SF-Pat_Cash-Ivan_Lendl,2,B-DTM,27,3,0,1,2,13,14
19840908-M-US_Open-SF-Pat_Cash-Ivan_Lendl,2,B-DTL,17,8,3,2,3,12,5
19840908-M-US_Open-SF-Pat_Cash-Ivan_Lendl,2,B-IO,5,4,2,2,0,5,0
19840908-M-US_Open-SF-Pat_Cash-Ivan_Lendl,2,S-XC,24,3,0,3,0,14,10
19840908-M-US_Open-SF-Pat_Cash-Ivan_Lendl,2,S-DTM,3,0,0,0,0,0,3
19840908-M-US_Open-SF-Pat_Cash-Ivan_Lendl,2,S-DTL,7,2,0,2,0,7,0
20180928-M-Shenzhen-QF-Andy_Murray-Fernando_Verdasco,1,F-XC,44,8,0,4,4,17,27
20180928-M-Shenzhen-QF-Andy_Murray-Fernando_Verdasco,1,F-DTM,18,0,0,0,0,8,10
20180928-M-Shenzhen-QF-Andy_Murray-Fernando_Verdasco,1,F-DTL,1,0,0,0,0,1,0
20180928-M-Shenzhen-QF-Andy_Murray-Fernando_Verdasco,1,F-IO,12,5,2,2,1,8,4
20180928-M-Shenzhen-QF-Andy_Murray-Fernando_Verdasco,1,F-II,1,0,0,0,0,0,1
20180928-M-Shenzhen-QF-Andy_Murray-Fernando_Verdasco,1,B-XC,20,6,1,3,2,10,10
20180928-M-Shenzhen-QF-Andy_Murray-Fernando_Verdasco,1,B-DTM,24,5,0,1,4,9,15
20180928-M-Shenzhen-QF-Andy_Murray-Fernando_Verdasco,1,B-DTL,5,2,0,2,0,4,1
20180928-M-Shenzhen-QF-Andy_Murray-Fernando_Verdasco,1,B-IO,3,2,0,0,2,1,2
20180928-M-Shenzhen-QF-Andy_Murray-Fernando_Verdasco,1,S-DTM,5,0,0,0,0,0,5
20180928-M-Shenzhen-QF-Andy_Murray-Fernando_Verdasco,1,S-IO,1,0,0,0,0,0,1
20180928-M-Shenzhen-QF-Andy_Murray-Fernando_Verdasco,2,F-XC,29,6,3,2,1,20,9
20180928-M-Shenzhen-QF-Andy_Murray-Fernando_Verdasco,2,F-DTM,21,2,0,1,1,13,8
20180928-M-Shenzhen-QF-Andy_Murray-Fernando_Verdasco,2,F-DTL,4,2,1,1,0,2,2
20180928-M-Shenzhen-QF-Andy_Murray-Fernando_Verdasco,2,F-IO,24,12,7,2,3,17,7
20180928-M-Shenzhen-QF-Andy_Murray-Fernando_Verdasco,2,F-II,3,2,1,0,1,2,1
20180928-M-Shenzhen-QF-Andy_Murray-Fernando_Verdasco,2,B-XC,19,7,3,1,3,12,7
20180928-M-Shenzhen-QF-Andy_Murray-Fernando_Verdasco,2,B-DTM,17,3,0,0,3,10,7
20180928-M-Shenzhen-QF-Andy_Murray-Fernando_Verdasco,2,B-DTL,6,5,3,0,2,4,2
20180928-M-Shenzhen-QF-Andy_Murray-Fernando_Verdasco,2,B-IO,1,0,0,0,0,0,1
20180928-M-Shenzhen-QF-Andy_Murray-Fernando_Verdasco,2,S-XC,3,1,0,1,0,1,2
20180928-M-Shenzhen-QF-Andy_Murray-Fernando_Verdasco,2,S-DTM,7,0,0,0,0,4,3
20180829-M-US_Open-R64-Andy_Murray-Fernando_Verdasco,1,F-XC,95,20,5,5,10,55,40
20180829-M-US_Open-R64-Andy_Murray-Fernando_Verdasco,1,F-DTM,38,3,0,0,3,26,12
20180829-M-US_Open-R64-Andy_Murray-Fernando_Verdasco,1,F-DTL,18,6,3,1,2,8,10
20180829-M-US_Open-R64-Andy_Murray-Fernando_Verdasco,1,F-IO,24,7,1,2,4,14,10
20180829-M-US_Open-R64-Andy_Murray-Fernando_Verdasco,1,F-II,2,1,0,1,0,2,0
20180829-M-US_Open-R64-Andy_Murray-Fernando_Verdasco,1,B-XC,48,12,3,5,4,28,20
20180829-M-US_Open-R64-Andy_Murray-Fernando_Verdasco,1,B-DTM,22,3,0,0,3,10,12
20180829-M-US_Open-R64-Andy_Murray-Fernando_Verdasco,1,B-DTL,16,3,1,1,1,9,7
20180829-M-US_Open-R64-Andy_Murray-Fernando_Verdasco,1,B-IO,12,1,0,1,0,7,5
20180829-M-US_Open-R64-Andy_Murray-Fernando_Verdasco,1,S-XC,7,0,0,0,0,1,6
20180829-M-US_Open-R64-Andy_Murray-Fernando_Verdasco,1,S-DTM,9,0,0,0,0,4,5
20180829-M-US_Open-R64-Andy_Murray-Fernando_Verdasco,1,S-DTL,10,0,0,0,0,7,3
20180829-M-US_Open-R64-Andy_Murray-Fernando_Verdasco,1,S-IO,2,0,0,0,0,0,2
20180829-M-US_Open-R64-Andy_Murray-Fernando_Verdasco,2,F-XC,71,19,7,9,3,39,32
20180829-M-US_Open-R64-Andy_Murray-Fernando_Verdasco,2,F-DTM,34,1,0,0,1,11,23
20180829-M-US_Open-R64-Andy_Murray-Fernando_Verdasco,2,F-DTL,25,9,2,2,5,13,12
20180829-M-US_Open-R64-Andy_Murray-Fernando_Verdasco,2,F-IO,46,23,11,3,9,25,21
20180829-M-US_Open-R64-Andy_Murray-Fernando_Verdasco,2,F-II,8,2,1,1,0,3,5
20180829-M-US_Open-R64-Andy_Murray-Fernando_Verdasco,2,B-XC,70,12,6,1,5,34,36
20180829-M-US_Open-R64-Andy_Murray-Fernando_Verdasco,2,B-DTM,28,3,0,0,3,9,19
20180829-M-US_Open-R64-Andy_Murray-Fernando_Verdasco,2,B-DTL,17,6,3,0,3,10,7
20180829-M-US_Open-R64-Andy_Murray-Fernando_Verdasco,2,B-IO,7,3,0,1,2,2,5
20180829-M-US_Open-R64-Andy_Murray-Fernando_Verdasco,2,S-XC,4,0,0,0,0,1,3
20180829-M-US_Open-R64-Andy_Murray-Fernando_Verdasco,2,S-DTM,7,0,0,0,0,4,3
20180829-M-US_Open-R64-Andy_Murray-Fernando_Verdasco,2,S-DTL,2,0,0,0,0,1,1
20000128-M-Australian_Open-SF-Pete_Sampras-Andre_Agassi,1,F-XC,16,10,5,3,2,10,6
20000128-M-Australian_Open-SF-Pete_Sampras-Andre_Agassi,1,F-DTM,5,2,0,0,2,1,4
20000128-M-Australian_Open-SF-Pete_Sampras-Andre_Agassi,1,F-DTL,1,0,0,0,0,1,0
20000128-M-Australian_Open-SF-Pete_Sampras-Andre_Agassi,1,F-IO,10,7,1,3,3,4,6
20000128-M-Australian_Open-SF-Pete_Sampras-Andre_Agassi,1,F-II,2,2,1,1,0,2,0
20000128-M-Australian_Open-SF-Pete_Sampras-Andre_Agassi,1,B-XC,15,3,0,0,3,6,9
20000128-M-Australian_Open-SF-Pete_Sampras-Andre_Agassi,1,B-DTM,15,4,0,0,4,6,9
20000128-M-Australian_Open-SF-Pete_Sampras-Andre_Agassi,1,B-DTL,8,4,0,1,3,3,5
20000128-M-Australian_Open-SF-Pete_Sampras-Andre_Agassi,1,S-XC,15,3,0,2,1,6,9
20000128-M-Australian_Open-SF-Pete_Sampras-Andre_Agassi,1,S-DTM,8,0,0,0,0,2,6
20000128-M-Australian_Open-SF-Pete_Sampras-Andre_Agassi,1,S-DTL,5,1,0,0,1,1,4
20000128-M-Australian_Open-SF-Pete_Sampras-Andre_Agassi,2,F-XC,24,10,5,4,1,13,11
20000128-M-Australian_Open-SF-Pete_Sampras-Andre_Agassi,2,F-DTM,19,6,1,1,4,6,13
20000128-M-Australian_Open-SF-Pete_Sampras-Andre_Agassi,2,F-DTL,15,7,3,3,1,8,7
20000128-M-Australian_Open-SF-Pete_Sampras-Andre_Agassi,2,F-IO,33,9,5,3,1,26,7
20000128-M-Australian_Open-SF-Pete_Sampras-Andre_Agassi,2,B-XC,47,13,4,7,2,34,13
20000128-M-Australian_Open-SF-Pete_Sampras-Andre_Agassi,2,B-DTM,8,2,0,0,2,0,8
20000128-M-Australian_Open-SF-Pete_Sampras-Andre_Agassi,2,B-DTL,13,11,4,5,2,10,3
20000128-M-Australian_Open-SF-Pete_Sampras-Andre_Agassi,2,B-IO,2,0,0,0,0,1,1
20000128-M-Australian_Open-SF-Pete_Sampras-Andre_Agassi,2,S-XC,3,2,1,0,1,2,1
20000128-M-Australian_Open-SF-Pete_Sampras-Andre_Agassi,2,S-DTM,1,0,0,0,0,1,0
20000128-M-Australian_Open-SF-Pete_Sampras-Andre_Agassi,2,S-DTL,2,0,0,0,0,1,1
20180117-M-Australian_Open-R64-Grigor_Dimitrov-Mackenzie_Mcdonald,1,F-XC,74,26,7,11,8,39,35
20180117-M-Australian_Open-R64-Grigor_Dimitrov-Mackenzie_Mcdonald,1,F-DTM,55,3,0,1,2,22,33
20180117-M-Australian_Open-R64-Grigor_Dimitrov-Mackenzie_Mcdonald,1,F-DTL,9,3,3,0,0,6,3
20180117-M-Australian_Open-R64-Grigor_Dimitrov-Mackenzie_Mcdonald,1,F-IO,47,21,7,7,7,28,19
20180117-M-Australian_Open-R64-Grigor_Dimitrov-Mackenzie_Mcdonald,1,F-II,2,1,1,0,0,2,0
20180117-M-Australian_Open-R64-Grigor_Dimitrov-Mackenzie_Mcdonald,1,B-XC,16,7,1,1,5,8,8
20180117-M-Australian_Open-R64-Grigor_Dimitrov-Mackenzie_Mcdonald,1,B-DTM,37,3,0,0,3,13,24
20180117-M-Australian_Open-R64-Grigor_Dimitrov-Mackenzie_Mcdonald,1,B-DTL,6,4,2,1,1,3,3
20180117-M-Australian_Open-R64-Grigor_Dimitrov-Mackenzie_Mcdonald,1,B-IO,4,3,1,1,1,2,2
20180117-M-Australian_Open-R64-Grigor_Dimitrov-Mackenzie_Mcdonald,1,S-XC,29,2,1,0,1,17,12
20180117-M-Australian_Open-R64-Grigor_Dimitrov-Mackenzie_Mcdonald,1,S-DTM,33,2,0,0,2,17,16
20180117-M-Australian_Open-R64-Grigor_Dimitrov-Mackenzie_Mcdonald,1,S-DTL,6,0,0,0,0,2,4
20180117-M-Australian_Open-R64-Grigor_Dimitrov-Mackenzie_Mcdonald,1,S-IO,1,1,0,1,0,1,0
20180117-M-Australian_Open-R64-Grigor_Dimitrov-Mackenzie_Mcdonald,1,S-II,1,0,0,0,0,0,1
20180117-M-Australian_Open-R64-Grigor_Dimitrov-Mackenzie_Mcdonald,2,F-XC,50,22,7,9,6,34,16
20180117-M-Australian_Open-R64-Grigor_Dimitrov-Mackenzie_Mcdonald,2,F-DTM,78,10,0,3,7,42,36
20180117-M-Australian_Open-R64-Grigor_Dimitrov-Mackenzie_Mcdonald,2,F-DTL,21,9,3,3,3,13,8
20180117-M-Australian_Open-R64-Grigor_Dimitrov-Mackenzie_Mcdonald,2,F-IO,64,23,3,16,4,41,23
20180117-M-Australian_Open-R64-Grigor_Dimitrov-Mackenzie_Mcdonald,2,F-II,3,0,0,0,0,1,2
20180117-M-Australian_Open-R64-Grigor_Dimitrov-Mackenzie_Mcdonald,2,B-XC,31,6,1,1,4,16,15
20180117-M-Australian_Open-R64-Grigor_Dimitrov-Mackenzie_Mcdonald,2,B-DTM,49,6,0,0,6,17,32
20180117-M-Australian_Open-R64-Grigor_Dimitrov-Mackenzie_Mcdonald,2,B-DTL,9,4,0,2,2,4,5
20180117-M-Australian_Open-R64-Grigor_Dimitrov-Mackenzie_Mcdonald,2,B-IO,4,1,1,0,0,2,2
20180117-M-Australian_Open-R64-Grigor_Dimitrov-Mackenzie_Mcdonald,2,S-XC,4,1,0,0,1,1,3
20180117-M-Australian_Open-R64-Grigor_Dimitrov-Mackenzie_Mcdonald,2,S-DTM,12,1,0,1,0,6,6
20180117-M-Australian_Open-R64-Grigor_Dimitrov-Mackenzie_Mcdonald,2,S-DTL,3,0,0,0,0,1,2
19840908-M-US_Open-SF-John_Mcenroe-Jimmy_Connors,1,F-XC,44,7,3,1,3,24,20
19840908-M-US_Open-SF-John_Mcenroe-Jimmy_Connors,1,F-DTM,18,0,0,0,0,8,10
19840908-M-US_Open-SF-John_Mcenroe-Jimmy_Connors,1,F-DTL,25,10,2,1,7,11,14
19840908-M-US_Open-SF-John_Mcenroe-Jimmy_Connors,1,F-IO,7,4,1,1,2,4,3
19840908-M-US_Open-SF-John_Mcenroe-Jimmy_Connors,1,F-II,2,1,1,0,0,2,0
19840908-M-US_Open-SF-John_Mcenroe-Jimmy_Connors,1,B-XC,25,8,2,2,4,12,13
19840908-M-US_Open-SF-John_Mcenroe-Jimmy_Connors,1,B-DTM,11,2,0,1,1,8,3
19840908-M-US_Open-SF-John_Mcenroe-Jimmy_Connors,1,B-DTL,8,3,2,0,1,4,4
19840908-M-US_Open-SF-John_Mcenroe-Jimmy_Connors,1,B-IO,4,1,0,0,1,2,2
19840908-M-US_Open-SF-John_Mcenroe-Jimmy_Connors,1,S-XC,29,4,0,2,2,17,12
19840908-M-US_Open-SF-John_Mcenroe-Jimmy_Connors,1,S-DTM,18,0,0,0,0,9,9
19840908-M-US_Open-SF-John_Mcenroe-Jimmy_Connors,1,S-DTL,14,0,0,0,0,7,7
19840908-M-US_Open-SF-John_Mcenroe-Jimmy_Connors,1,S-IO,6,2,0,1,1,2,4
19840908-M-US_Open-SF-John_Mcenroe-Jimmy_Connors,1,S-II,1,0,0,0,0,0,1
19840908-M-US_Open-SF-John_Mcenroe-Jimmy_Connors,2,F-XC,88,21,4,7,10,45,43
19840908-M-US_Open-SF-John_Mcenroe-Jimmy_Connors,2,F-DTM,19,2,0,1,1,9,10
19840908-M-US_Open-SF-John_Mcenroe-Jimmy_Connors,2,F-DTL,31,7,3,0,4,19,12
19840908-M-US_Open-SF-John_Mcenroe-Jimmy_Connors,2,F-IO,16,4,0,1,3,6,10
19840908-M-US_Open-SF-John_Mcenroe-Jimmy_Connors,2,F-II,1,1,1,0,0,1,0
19840908-M-US_Open-SF-John_Mcenroe-Jimmy_Connors,2,B-XC,84,22,8,5,9,39,45
19840908-M-US_Open-SF-John_Mcenroe-Jimmy_Connors,2,B-DTM,19,2,0,1,1,6,13
19840908-M-US_Open-SF-John_Mcenroe-Jimmy_Connors,2,B-DTL,23,10,6,3,1,13,10
19840908-M-US_Open-SF-John_Mcenroe-Jimmy_Connors,2,B-IO,16,3,1,0,2,6,10
19840908-M-US_Open-SF-John_Mcenroe-Jimmy_Connors,2,B-II,1,0,0,0,0,1,0
19840908-M-US_Open-SF-John_Mcenroe-Jimmy_Connors,2,S-XC,1,0,0,0,0,0,1
20160909-M-US_Open-SF-Stanislas_Wawrinka-Kei_Nishikori,1,F-XC,54,9,2,5,2,36,18
20160909-M-US_Open-SF-Stanislas_Wawrinka-Kei_Nishikori,1,F-DTM,19,0,0,0,0,11,8
20160909-M-US_Open-SF-Stanislas_Wawrinka-Kei_Nishikori,1,F-DTL,9,3,1,1,1,5,4
20160909-M-US_Open-SF-Stanislas_Wawrinka-Kei_Nishikori,1,F-IO,16,7,4,1,2,13,3
20160909-M-US_Open-SF-Stanislas_Wawrinka-Kei_Nishikori,1,F-II,11,3,1,0,2,8,3
20160909-M-US_Open-SF-Stanislas_Wawrinka-Kei_Nishikori,1,B-XC,84,13,2,6,5,46,38
20160909-M-US_Open-SF-Stanislas_Wawrinka-Kei_Nishikori,1,B-DTM,30,5,0,0,5,11,19
20160909-M-US_Open-SF-Stanislas_Wawrinka-Kei_Nishikori,1,B-DTL,24,17,5,5,7,15,9
20160909-M-US_Open-SF-Stanislas_Wawrinka-Kei_Nishikori,1,B-IO,8,2,0,1,1,4,4
20160909-M-US_Open-SF-Stanislas_Wawrinka-Kei_Nishikori,1,S-XC,19,0,0,0,0,8,11
20160909-M-US_Open-SF-Stanislas_Wawrinka-Kei_Nishikori,1,S-DTM,4,0,0,0,0,1,3
20160909-M-US_Open-SF-Stanislas_Wawrinka-Kei_Nishikori,1,S-DTL,4,2,1,1,0,3,1
20160909-M-US_Open-SF-Stanislas_Wawrinka-Kei_Nishikori,2,F-XC,45,17,4,4,9,19,26
20160909-M-US_Open-SF-Stanislas_Wawrinka-Kei_Nishikori,2,F-DTM,23,1,0,0,1,7,16
20160909-M-US_Open-SF-Stanislas_Wawrinka-Kei_Nishikori,2,F-DTL,27,5,1,3,1,13,14
20160909-M-US_Open-SF-Stanislas_Wawrinka-Kei_Nishikori,2,F-IO,34,7,1,4,2,21,13
20160909-M-US_Open-SF-Stanislas_Wawrinka-Kei_Nishikori,2,F-II,6,2,1,1,0,3,3
20160909-M-US_Open-SF-Stanislas_Wawrinka-Kei_Nishikori,2,B-XC,76,12,0,5,7,40,36
20160909-M-US_Open-SF-Stanislas_Wawrinka-Kei_Nishikori,2,B-DTM,13,3,0,0,3,4,9
20160909-M-US_Open-SF-Stanislas_Wawrinka-Kei_Nishikori,2,B-DTL,19,6,1,2,3,7,12
20160909-M-US_Open-SF-Stanislas_Wawrinka-Kei_Nishikori,2,B-IO,3,1,1,0,0,3,0
20160909-M-US_Open-SF-Stanislas_Wawrinka-Kei_Nishikori,2,S-XC,18,0,0,0,0,6,12
20160909-M-US_Open-SF-Stanislas_Wawrinka-Kei_Nishikori,2,S-DTM,3,0,0,0,0,0,3
20160909-M-US_Open-SF-Stanislas_Wawrinka-Kei_Nishikori,2,S-DTL,5,0,0,0,0,1,4
19990602-M-Wimbledon-SF-Patrick_Rafter-Andre_Agassi,1,F-XC,17,3,1,0,2,5,12
19990602-M-Wimbledon-SF-Patrick_Rafter-Andre_Agassi,1,F-DTM,5,0,0,0,0,0,5
19990602-M-Wimbledon-SF-Patrick_Rafter-Andre_Agassi,1,F-DTL,7,2,0,1,1,2,5
19990602-M-Wimbledon-SF-Patrick_Rafter-Andre_Agassi,1,F-IO,2,0,0,0,0,1,1
19990602-M-Wimbledon-SF-Patrick_Rafter-Andre_Agassi,1,B-XC,4,0,0,0,0,0,4
19990602-M-Wimbledon-SF-Patrick_Rafter-Andre_Agassi,1,B-DTM,7,1,0,0,1,0,7
19990602-M-Wimbledon-SF-Patrick_Rafter-Andre_Agassi,1,B-DTL,2,2,1,0,1,1,1
19990602-M-Wimbledon-SF-Patrick_Rafter-Andre_Agassi,1,B-IO,2,2,1,1,0,2,0
19990602-M-Wimbledon-SF-Patrick_Rafter-Andre_Agassi,1,S-XC,32,2,0,0,2,2,30
19990602-M-Wimbledon-SF-Patrick_Rafter-Andre_Agassi,1,S-DTM,11,1,0,0,1,1,10
19990602-M-Wimbledon-SF-Patrick_Rafter-Andre_Agassi,1,S-DTL,4,0,0,0,0,2,2
19990602-M-Wimbledon-SF-Patrick_Rafter-Andre_Agassi,1,S-IO,2,1,0,1,0,2,0
19990602-M-Wimbledon-SF-Patrick_Rafter-Andre_Agassi,2,F-XC,28,7,4,1,2,20,8
19990602-M-Wimbledon-SF-Patrick_Rafter-Andre_Agassi,2,F-DTM,4,0,0,0,0,0,4
19990602-M-Wimbledon-SF-Patrick_Rafter-Andre_Agassi,2,F-DTL,10,4,3,1,0,10,0
19990602-M-Wimbledon-SF-Patrick_Rafter-Andre_Agassi,2,F-IO,14,7,3,3,1,12,2
19990602-M-Wimbledon-SF-Patrick_Rafter-Andre_Agassi,2,B-XC,57,4,1,2,1,49,8
19990602-M-Wimbledon-SF-Patrick_Rafter-Andre_Agassi,2,B-DTM,2,0,0,0,0,2,0
19990602-M-Wimbledon-SF-Patrick_Rafter-Andre_Agassi,2,B-DTL,21,10,6,4,0,17,4
19990602-M-Wimbledon-SF-Patrick_Rafter-Andre_Agassi,2,B-IO,4,2,2,0,0,3,1
19990602-M-Wimbledon-SF-Patrick_Rafter-Andre_Agassi,2,S-XC,2,1,1,0,0,2,0
19990602-M-Wimbledon-SF-Patrick_Rafter-Andre_Agassi,2,S-DTL,2,0,0,0,0,0,2
20010328-M-Miami_Masters-R16-Alex_Corretja-Patrick_Rafter,1,F-XC,17,7,4,1,2,9,8
20010328-M-Miami_Masters-R16-Alex_Corretja-Patrick_Rafter,1,F-DTM,8,1,0,1,0,2,6
20010328-M-Miami_Masters-R16-Alex_Corretja-Patrick_Rafter,1,F-DTL,4,0,0,0,0,1,3
20010328-M-Miami_Masters-R16-Alex_Corretja-Patrick_Rafter,1,F-IO,8,4,2,1,1,5,3
20010328-M-Miami_Masters-R16-Alex_Corretja-Patrick_Rafter,1,B-XC,21,8,2,1,5,9,12
20010328-M-Miami_Masters-R16-Alex_Corretja-Patrick_Rafter,1,B-DTM,18,4,1,0,3,6,12
20010328-M-Miami_Masters-R16-Alex_Corretja-Patrick_Rafter,1,B-DTL,7,2,1,0,1,2,5
20010328-M-Miami_Masters-R16-Alex_Corretja-Patrick_Rafter,1,B-IO,2,1,1,0,0,1,1
20010328-M-Miami_Masters-R16-Alex_Corretja-Patrick_Rafter,1,B-II,1,0,0,0,0,0,1
20010328-M-Miami_Masters-R16-Alex_Corretja-Patrick_Rafter,1,S-XC,4,0,0,0,0,2,2
20010328-M-Miami_Masters-R16-Alex_Corretja-Patrick_Rafter,1,S-DTM,3,0,0,0,0,0,3
20010328-M-Miami_Masters-R16-Alex_Corretja-Patrick_Rafter,1,S-DTL,1,1,0,1,0,1,0
20010328-M-Miami_Masters-R16-Alex_Corretja-Patrick_Rafter,1,S-II,1,0,0,0,0,1,0
20010328-M-Miami_Masters-R16-Alex_Corretja-Patrick_Rafter,2,F-XC,16,5,2,2,1,13,3
20010328-M-Miami_Masters-R16-Alex_Corretja-Patrick_Rafter,2,F-DTM,6,0,0,0,0,5,1
20010328-M-Miami_Masters-R16-Alex_Corretja-Patrick_Rafter,2,F-DTL,4,1,1,0,0,3,1
20010328-M-Miami_Masters-R16-Alex_Corretja-Patrick_Rafter,2,F-IO,6,2,1,1,0,5,1
20010328-M-Miami_Masters-R16-Alex_Corretja-Patrick_Rafter,2,B-XC,5,1,0,0,1,3,2
20010328-M-Miami_Masters-R16-Alex_Corretja-Patrick_Rafter,2,B-DTM,3,0,0,0,0,3,0
20010328-M-Miami_Masters-R16-Alex_Corretja-Patrick_Rafter,2,B-DTL,3,1,1,0,0,1,2
20010328-M-Miami_Masters-R16-Alex_Corretja-Patrick_Rafter,2,B-IO,2,2,1,0,1,1,1
20010328-M-Miami_Masters-R16-Alex_Corretja-Patrick_Rafter,2,S-XC,13,0,0,0,0,6,7
20010328-M-Miami_Masters-R16-Alex_Corretja-Patrick_Rafter,2,S-DTM,5,0,0,0,0,4,1
20010328-M-Miami_Masters-R16-Alex_Corretja-Patrick_Rafter,2,S-DTL,1,0,0,0,0,0,1
20150609-M-Stuttgart-R32-Dustin_Brown-Jerzy_Janowicz,1,F-XC,18,9,4,3,2,12,6
20150609-M-Stuttgart-R32-Dustin_Brown-Jerzy_Janowicz,1,F-DTM,2,0,0,0,0,1,1
20150609-M-Stuttgart-R32-Dustin_Brown-Jerzy_Janowicz,1,F-DTL,1,1,0,0,1,0,1
20150609-M-Stuttgart-R32-Dustin_Brown-Jerzy_Janowicz,1,F-IO,4,2,2,0,0,3,1
20150609-M-Stuttgart-R32-Dustin_Brown-Jerzy_Janowicz,1,F-II,1,1,0,0,1,0,1
20150609-M-Stuttgart-R32-Dustin_Brown-Jerzy_Janowicz,1,B-XC,5,1,0,0,1,1,4
20150609-M-Stuttgart-R32-Dustin_Brown-Jerzy_Janowicz,1,B-DTM,6,1,1,0,0,3,3
20150609-M-Stuttgart-R32-Dustin_Brown-Jerzy_Janowicz,1,B-DTL,8,4,1,1,2,4,4
20150609-M-Stuttgart-R32-Dustin_Brown-Jerzy_Janowicz,1,B-IO,2,1,0,0,1,1,1
20150609-M-Stuttgart-R32-Dustin_Brown-Jerzy_Janowicz,1,S-XC,7,1,1,0,0,7,0
20150609-M-Stuttgart-R32-Dustin_Brown-Jerzy_Janowicz,1,S-DTM,4,0,0,0,0,3,1
20150609-M-Stuttgart-R32-Dustin_Brown-Jerzy_Janowicz,1,S-DTL,1,0,0,0,0,0,1
20150609-M-Stuttgart-R32-Dustin_Brown-Jerzy_Janowicz,1,S-II,1,1,0,0,1,0,1
20150609-M-Stuttgart-R32-Dustin_Brown-Jerzy_Janowicz,2,F-XC,34,15,6,4,5,19,15
20150609-M-Stuttgart-R32-Dustin_Brown-Jerzy_Janowicz,2,F-DTM,10,1,1,0,0,7,3
20150609-M-Stuttgart-R32-Dustin_Brown-Jerzy_Janowicz,2,F-DTL,6,4,2,1,1,4,2
20150609-M-Stuttgart-R32-Dustin_Brown-Jerzy_Janowicz,2,F-IO,10,4,1,2,1,7,3
20150609-M-Stuttgart-R32-Dustin_Brown-Jerzy_Janowicz,2,F-II,1,1,0,1,0,1,0
20150609-M-Stuttgart-R32-Dustin_Brown-Jerzy_Janowicz,2,B-XC,14,7,3,2,2,9,5
20150609-M-Stuttgart-R32-Dustin_Brown-Jerzy_Janowicz,2,B-DTM,11,3,1,1,1,5,6
20150609-M-Stuttgart-R32-Dustin_Brown-Jerzy_Janowicz,2,B-DTL,8,5,0,2,3,4,4
20150609-M-Stuttgart-R32-Dustin_Brown-Jerzy_Janowicz,2,S-XC,6,2,0,0,2,0,6
20150609-M-Stuttgart-R32-Dustin_Brown-Jerzy_Janowicz,2,S-DTM,1,0,0,0,0,0,1
20150609-M-Stuttgart-R32-Dustin_Brown-Jerzy_Janowicz,2,S-DTL,4,1,1,0,0,2,2
20150609-M-Stuttgart-R32-Dustin_Brown-Jerzy_Janowicz,2,S-IO,1,0,0,0,0,1,0
20181003-M-Tokyo-R32-Yoshihito_Nishioka-Nick_Kyrgios,1,F-XC,20,2,0,0,2,12,8
20181003-M-Tokyo-R32-Yoshihito_Nishioka-Nick_Kyrgios,1,F-DTM,15,1,0,0,1,8,7
20181003-M-Tokyo-R32-Yoshihito_Nishioka-Nick_Kyrgios,1,F-DTL,9,5,4,1,0,8,1
20181003-M-Tokyo-R32-Yoshihito_Nishioka-Nick_Kyrgios,1,F-IO,7,5,0,3,2,4,3
20181003-M-Tokyo-R32-Yoshihito_Nishioka-Nick_Kyrgios,1,F-II,1,1,0,1,0,1,0
20181003-M-Tokyo-R32-Yoshihito_Nishioka-Nick_Kyrgios,1,B-XC,23,7,3,2,2,13,10
20181003-M-Tokyo-R32-Yoshihito_Nishioka-Nick_Kyrgios,1,B-DTM,20,1,1,0,0,13,7
20181003-M-Tokyo-R32-Yoshihito_Nishioka-Nick_Kyrgios,1,B-DTL,9,2,1,0,1,6,3
20181003-M-Tokyo-R32-Yoshihito_Nishioka-Nick_Kyrgios,1,B-IO,3,1,0,0,1,0,3
20181003-M-Tokyo-R32-Yoshihito_Nishioka-Nick_Kyrgios,1,B-II,1,0,0,0,0,0,1
20181003-M-Tokyo-R32-Yoshihito_Nishioka-Nick_Kyrgios,1,S-DTM,5,0,0,0,0,5,0
20181003-M-Tokyo-R32-Yoshihito_Nishioka-Nick_Kyrgios,1,S-DTL,2,0,0,0,0,2,0
20181003-M-Tokyo-R32-Yoshihito_Nishioka-Nick_Kyrgios,1,S-IO,1,0,0,0,0,0,1
20181003-M-Tokyo-R32-Yoshihito_Nishioka-Nick_Kyrgios,2,F-XC,30,12,4,4,4,16,14
20181003-M-Tokyo-R32-Yoshihito_Nishioka-Nick_Kyrgios,2,F-DTM,12,0,0,0,0,6,6
20181003-M-Tokyo-R32-Yoshihito_Nishioka-Nick_Kyrgios,2,F-DTL,7,4,1,2,1,4,3
20181003-M-Tokyo-R32-Yoshihito_Nishioka-Nick_Kyrgios,2,F-IO,13,6,2,1,3,5,8
20181003-M-Tokyo-R32-Yoshihito_Nishioka-Nick_Kyrgios,2,F-II,2,2,1,0,1,1,1
20181003-M-Tokyo-R32-Yoshihito_Nishioka-Nick_Kyrgios,2,B-XC,17,10,2,2,6,7,10
20181003-M-Tokyo-R32-Yoshihito_Nishioka-Nick_Kyrgios,2,B-DTM,12,2,0,0,2,5,7
20181003-M-Tokyo-R32-Yoshihito_Nishioka-Nick_Kyrgios,2,B-DTL,4,3,0,0,3,0,4
20181003-M-Tokyo-R32-Yoshihito_Nishioka-Nick_Kyrgios,2,B-IO,4,1,1,0,0,1,3
20181003-M-Tokyo-R32-Yoshihito_Nishioka-Nick_Kyrgios,2,S-XC,2,1,0,0,1,1,1
20181003-M-Tokyo-R32-Yoshihito_Nishioka-Nick_Kyrgios,2,S-DTM,6,0,0,0,0,3,3
20181003-M-Tokyo-R32-Yoshihito_Nishioka-Nick_Kyrgios,2,S-DTL,4,1,0,1,0,2,2
20181003-M-Tokyo-R32-Yoshihito_Nishioka-Nick_Kyrgios,2,S-IO,1,0,0,0,0,0,1
20180831-M-US_Open-R32-Kevin_Anderson-Denis_Shapovalov,1,F-XC,36,7,3,3,1,18,18
20180831-M-US_Open-R32-Kevin_Anderson-Denis_Shapovalov,1,F-DTM,29,0,0,0,0,15,14
20180831-M-US_Open-R32-Kevin_Anderson-Denis_Shapovalov,1,F-DTL,6,4,1,1,2,3,3
20180831-M-US_Open-R32-Kevin_Anderson-Denis_Shapovalov,1,F-IO,28,13,2,4,7,11,17
20180831-M-US_Open-R32-Kevin_Anderson-Denis_Shapovalov,1,F-II,5,1,1,0,0,2,3
20180831-M-US_Open-R32-Kevin_Anderson-Denis_Shapovalov,1,B-XC,27,6,1,1,4,14,13
20180831-M-US_Open-R32-Kevin_Anderson-Denis_Shapovalov,1,B-DTM,51,6,1,0,5,23,28
20180831-M-US_Open-R32-Kevin_Anderson-Denis_Shapovalov,1,B-DTL,11,3,0,0,3,4,7
20180831-M-US_Open-R32-Kevin_Anderson-Denis_Shapovalov,1,B-IO,9,5,1,1,3,3,6
20180831-M-US_Open-R32-Kevin_Anderson-Denis_Shapovalov,1,S-XC,3,0,0,0,0,2,1
20180831-M-US_Open-R32-Kevin_Anderson-Denis_Shapovalov,1,S-DTM,13,1,0,0,1,4,9
20180831-M-US_Open-R32-Kevin_Anderson-Denis_Shapovalov,1,S-DTL,6,0,0,0,0,4,2
20180831-M-US_Open-R32-Kevin_Anderson-Denis_Shapovalov,1,S-IO,1,0,0,0,0,0,1
20180831-M-US_Open-R32-Kevin_Anderson-Denis_Shapovalov,2,F-XC,73,19,1,7,11,42,31
20180831-M-US_Open-R32-Kevin_Anderson-Denis_Shapovalov,2,F-DTM,50,8,0,3,5,24,26
20180831-M-US_Open-R32-Kevin_Anderson-Denis_Shapovalov,2,F-DTL,6,5,4,0,1,4,2
20180831-M-US_Open-R32-Kevin_Anderson-Denis_Shapovalov,2,F-IO,27,19,11,2,6,17,10
20180831-M-US_Open-R32-Kevin_Anderson-Denis_Shapovalov,2,F-II,2,0,0,0,0,0,2
20180831-M-US_Open-R32-Kevin_Anderson-Denis_Shapovalov,2,B-XC,30,14,8,1,5,17,13
20180831-M-US_Open-R32-Kevin_Anderson-Denis_Shapovalov,2,B-DTM,25,2,0,1,1,15,10
20180831-M-US_Open-R32-Kevin_Anderson-Denis_Shapovalov,2,B-DTL,14,6,2,3,1,9,5
20180831-M-US_Open-R32-Kevin_Anderson-Denis_Shapovalov,2,B-IO,4,2,0,1,1,1,3
20180831-M-US_Open-R32-Kevin_Anderson-Denis_Shapovalov,2,S-XC,1,0,0,0,0,0,1
20180831-M-US_Open-R32-Kevin_Anderson-Denis_Shapovalov,2,S-DTM,6,0,0,0,0,4,2
20180831-M-US_Open-R32-Kevin_Anderson-Denis_Shapovalov,2,S-DTL,4,0,0,0,0,1,3
20180831-M-US_Open-R32-Kevin_Anderson-Denis_Shapovalov,2,S-IO,1,0,0,0,0,1,0
20170908-M-US_Open-SF-Rafael_Nadal-Juan_Martin_Del_Potro,1,F-XC,107,7,4,1,2,69,38
20170908-M-US_Open-SF-Rafael_Nadal-Juan_Martin_Del_Potro,1,F-DTM,11,1,0,0,1,6,5
20170908-M-US_Open-SF-Rafael_Nadal-Juan_Martin_Del_Potro,1,F-DTL,27,11,8,0,3,19,8
20170908-M-US_Open-SF-Rafael_Nadal-Juan_Martin_Del_Potro,1,F-IO,32,14,8,4,2,21,11
20170908-M-US_Open-SF-Rafael_Nadal-Juan_Martin_Del_Potro,1,F-II,13,3,1,1,1,12,1
20170908-M-US_Open-SF-Rafael_Nadal-Juan_Martin_Del_Potro,1,B-XC,40,6,1,3,2,26,14
20170908-M-US_Open-SF-Rafael_Nadal-Juan_Martin_Del_Potro,1,B-DTM,21,6,0,2,4,14,7
20170908-M-US_Open-SF-Rafael_Nadal-Juan_Martin_Del_Potro,1,B-DTL,23,5,3,1,1,16,7
20170908-M-US_Open-SF-Rafael_Nadal-Juan_Martin_Del_Potro,1,B-IO,1,1,0,0,1,0,1
20170908-M-US_Open-SF-Rafael_Nadal-Juan_Martin_Del_Potro,1,S-XC,3,0,0,0,0,2,1
20170908-M-US_Open-SF-Rafael_Nadal-Juan_Martin_Del_Potro,1,S-DTM,5,0,0,0,0,3,2
20170908-M-US_Open-SF-Rafael_Nadal-Juan_Martin_Del_Potro,1,S-DTL,7,0,0,0,0,5,2
20170908-M-US_Open-SF-Rafael_Nadal-Juan_Martin_Del_Potro,1,S-IO,5,0,0,0,0,4,1
20170908-M-US_Open-SF-Rafael_Nadal-Juan_Martin_Del_Potro,2,F-XC,69,13,0,6,7,24,45
20170908-M-US_Open-SF-Rafael_Nadal-Juan_Martin_Del_Potro,2,F-DTM,23,0,0,0,0,7,16
20170908-M-US_Open-SF-Rafael_Nadal-Juan_Martin_Del_Potro,2,F-DTL,17,8,5,2,1,11,6
20170908-M-US_Open-SF-Rafael_Nadal-Juan_Martin_Del_Potro,2,F-IO,31,11,3,3,5,13,18
20170908-M-US_Open-SF-Rafael_Nadal-Juan_Martin_Del_Potro,2,F-II,17,7,3,1,3,10,7
20170908-M-US_Open-SF-Rafael_Nadal-Juan_Martin_Del_Potro,2,B-XC,58,8,1,0,7,19,39
20170908-M-US_Open-SF-Rafael_Nadal-Juan_Martin_Del_Potro,2,B-DTM,23,1,0,0,1,8,15
20170908-M-US_Open-SF-Rafael_Nadal-Juan_Martin_Del_Potro,2,B-DTL,28,7,1,2,4,10,18
20170908-M-US_Open-SF-Rafael_Nadal-Juan_Martin_Del_Potro,2,B-IO,3,0,0,0,0,1,2
20170908-M-US_Open-SF-Rafael_Nadal-Juan_Martin_Del_Potro,2,S-XC,7,0,0,0,0,3,4
20170908-M-US_Open-SF-Rafael_Nadal-Juan_Martin_Del_Potro,2,S-DTM,7,0,0,0,0,1,6
20170908-M-US_Open-SF-Rafael_Nadal-Juan_Martin_Del_Potro,2,S-DTL,7,1,0,0,1,0,7
20170908-M-US_Open-SF-Rafael_Nadal-Juan_Martin_Del_Potro,2,S-IO,1,0,0,0,0,0,1
20181123-M-Davis_Cup_World_Group_F-RR-Marin_Cilic-Jo_Wilfried_Tsonga,1,F-XC,28,13,6,3,4,18,10
20181123-M-Davis_Cup_World_Group_F-RR-Marin_Cilic-Jo_Wilfried_Tsonga,1,F-DTM,7,0,0,0,0,5,2
20181123-M-Davis_Cup_World_Group_F-RR-Marin_Cilic-Jo_Wilfried_Tsonga,1,F-DTL,20,9,1,4,4,9,11
20181123-M-Davis_Cup_World_Group_F-RR-Marin_Cilic-Jo_Wilfried_Tsonga,1,F-IO,35,11,3,6,2,22,13
20181123-M-Davis_Cup_World_Group_F-RR-Marin_Cilic-Jo_Wilfried_Tsonga,1,F-II,3,3,2,1,0,3,0
20181123-M-Davis_Cup_World_Group_F-RR-Marin_Cilic-Jo_Wilfried_Tsonga,1,B-XC,31,6,2,3,1,21,10
20181123-M-Davis_Cup_World_Group_F-RR-Marin_Cilic-Jo_Wilfried_Tsonga,1,B-DTM,8,0,0,0,0,5,3
20181123-M-Davis_Cup_World_Group_F-RR-Marin_Cilic-Jo_Wilfried_Tsonga,1,B-DTL,8,7,3,1,3,4,4
20181123-M-Davis_Cup_World_Group_F-RR-Marin_Cilic-Jo_Wilfried_Tsonga,1,B-IO,2,2,2,0,0,2,0
20181123-M-Davis_Cup_World_Group_F-RR-Marin_Cilic-Jo_Wilfried_Tsonga,1,S-DTM,1,0,0,0,0,0,1
20181123-M-Davis_Cup_World_Group_F-RR-Marin_Cilic-Jo_Wilfried_Tsonga,1,S-DTL,1,0,0,0,0,0,1
20181123-M-Davis_Cup_World_Group_F-RR-Marin_Cilic-Jo_Wilfried_Tsonga,2,F-XC,26,11,4,4,3,15,11
20181123-M-Davis_Cup_World_Group_F-RR-Marin_Cilic-Jo_Wilfried_Tsonga,2,F-DTM,7,0,0,0,0,4,3
20181123-M-Davis_Cup_World_Group_F-RR-Marin_Cilic-Jo_Wilfried_Tsonga,2,F-DTL,5,4,2,1,1,3,2
20181123-M-Davis_Cup_World_Group_F-RR-Marin_Cilic-Jo_Wilfried_Tsonga,2,F-IO,14,4,2,0,2,7,7
20181123-M-Davis_Cup_World_Group_F-RR-Marin_Cilic-Jo_Wilfried_Tsonga,2,F-II,1,0,0,0,0,0,1
20181123-M-Davis_Cup_World_Group_F-RR-Marin_Cilic-Jo_Wilfried_Tsonga,2,B-XC,30,4,2,0,2,14,16
20181123-M-Davis_Cup_World_Group_F-RR-Marin_Cilic-Jo_Wilfried_Tsonga,2,B-DTM,18,1,0,0,1,4,14
20181123-M-Davis_Cup_World_Group_F-RR-Marin_Cilic-Jo_Wilfried_Tsonga,2,B-DTL,17,7,0,1,6,7,10
20181123-M-Davis_Cup_World_Group_F-RR-Marin_Cilic-Jo_Wilfried_Tsonga,2,B-IO,1,0,0,0,0,0,1
20181123-M-Davis_Cup_World_Group_F-RR-Marin_Cilic-Jo_Wilfried_Tsonga,2,S-XC,5,0,0,0,0,3,2
20181123-M-Davis_Cup_World_Group_F-RR-Marin_Cilic-Jo_Wilfried_Tsonga,2,S-DTM,4,0,0,0,0,3,1
20181123-M-Davis_Cup_World_Group_F-RR-Marin_Cilic-Jo_Wilfried_Tsonga,2,S-DTL,4,1,0,0,1,2,2
20181123-M-Davis_Cup_World_Group_F-RR-Marin_Cilic-Jo_Wilfried_Tsonga,2,S-II,1,0,0,0,0,0,1
20181123-M-Davis_Cup_World_Group_F-RR-Jeremy_Chardy-Borna_Coric,1,F-XC,19,5,1,0,4,7,12
20181123-M-Davis_Cup_World_Group_F-RR-Jeremy_Chardy-Borna_Coric,1,F-DTM,20,0,0,0,0,8,12
20181123-M-Davis_Cup_World_Group_F-RR-Jeremy_Chardy-Borna_Coric,1,F-DTL,11,4,1,0,3,3,8
20181123-M-Davis_Cup_World_Group_F-RR-Jeremy_Chardy-Borna_Coric,1,F-IO,24,6,2,1,3,8,16
20181123-M-Davis_Cup_World_Group_F-RR-Jeremy_Chardy-Borna_Coric,1,F-II,9,3,1,0,2,5,4
20181123-M-Davis_Cup_World_Group_F-RR-Jeremy_Chardy-Borna_Coric,1,B-XC,38,8,0,1,7,10,28
20181123-M-Davis_Cup_World_Group_F-RR-Jeremy_Chardy-Borna_Coric,1,B-DTM,24,0,0,0,0,10,14
20181123-M-Davis_Cup_World_Group_F-RR-Jeremy_Chardy-Borna_Coric,1,B-DTL,20,6,0,1,5,5,15
20181123-M-Davis_Cup_World_Group_F-RR-Jeremy_Chardy-Borna_Coric,1,B-II,1,0,0,0,0,0,1
20181123-M-Davis_Cup_World_Group_F-RR-Jeremy_Chardy-Borna_Coric,1,S-XC,12,1,0,0,1,3,9
20181123-M-Davis_Cup_World_Group_F-RR-Jeremy_Chardy-Borna_Coric,1,S-DTM,8,1,0,0,1,0,8
20181123-M-Davis_Cup_World_Group_F-RR-Jeremy_Chardy-Borna_Coric,1,S-DTL,5,2,0,2,0,3,2
20181123-M-Davis_Cup_World_Group_F-RR-Jeremy_Chardy-Borna_Coric,1,S-IO,1,0,0,0,0,0,1
20181123-M-Davis_Cup_World_Group_F-RR-Jeremy_Chardy-Borna_Coric,2,F-XC,35,14,4,6,4,25,10
20181123-M-Davis_Cup_World_Group_F-RR-Jeremy_Chardy-Borna_Coric,2,F-DTM,15,0,0,0,0,8,7
20181123-M-Davis_Cup_World_Group_F-RR-Jeremy_Chardy-Borna_Coric,2,F-DTL,20,3,2,0,1,11,9
20181123-M-Davis_Cup_World_Group_F-RR-Jeremy_Chardy-Borna_Coric,2,F-IO,31,12,6,5,1,24,7
20181123-M-Davis_Cup_World_Group_F-RR-Jeremy_Chardy-Borna_Coric,2,B-XC,66,12,1,2,9,46,20
20181123-M-Davis_Cup_World_Group_F-RR-Jeremy_Chardy-Borna_Coric,2,B-DTM,10,1,1,0,0,7,3
20181123-M-Davis_Cup_World_Group_F-RR-Jeremy_Chardy-Borna_Coric,2,B-DTL,11,7,4,1,2,8,3
20181123-M-Davis_Cup_World_Group_F-RR-Jeremy_Chardy-Borna_Coric,2,B-IO,3,1,0,0,1,2,1
20181123-M-Davis_Cup_World_Group_F-RR-Jeremy_Chardy-Borna_Coric,2,S-XC,5,1,0,0,1,3,2
20181123-M-Davis_Cup_World_Group_F-RR-Jeremy_Chardy-Borna_Coric,2,S-DTL,1,0,0,0,0,1,0
20181125-M-Davis_Cup_World_Group_F-RR-Lucas_Pouille-Marin_Cilic,1,F-XC,23,6,3,3,0,13,10
20181125-M-Davis_Cup_World_Group_F-RR-Lucas_Pouille-Marin_Cilic,1,F-DTM,18,0,0,0,0,7,11
20181125-M-Davis_Cup_World_Group_F-RR-Lucas_Pouille-Marin_Cilic,1,F-DTL,5,3,2,0,1,2,3
20181125-M-Davis_Cup_World_Group_F-RR-Lucas_Pouille-Marin_Cilic,1,F-IO,20,9,2,1,6,9,11
20181125-M-Davis_Cup_World_Group_F-RR-Lucas_Pouille-Marin_Cilic,1,F-II,1,0,0,0,0,0,1
20181125-M-Davis_Cup_World_Group_F-RR-Lucas_Pouille-Marin_Cilic,1,B-XC,20,8,0,2,6,8,12
20181125-M-Davis_Cup_World_Group_F-RR-Lucas_Pouille-Marin_Cilic,1,B-DTM,26,7,0,0,7,6,20
20181125-M-Davis_Cup_World_Group_F-RR-Lucas_Pouille-Marin_Cilic,1,B-DTL,14,8,1,2,5,8,6
20181125-M-Davis_Cup_World_Group_F-RR-Lucas_Pouille-Marin_Cilic,1,B-IO,1,0,0,0,0,0,1
20181125-M-Davis_Cup_World_Group_F-RR-Lucas_Pouille-Marin_Cilic,1,S-XC,8,1,0,0,1,3,5
20181125-M-Davis_Cup_World_Group_F-RR-Lucas_Pouille-Marin_Cilic,1,S-DTM,11,0,0,0,0,3,8
20181125-M-Davis_Cup_World_Group_F-RR-Lucas_Pouille-Marin_Cilic,1,S-DTL,4,3,1,2,0,3,1
20181125-M-Davis_Cup_World_Group_F-RR-Lucas_Pouille-Marin_Cilic,1,S-IO,2,0,0,0,0,1,1
20181125-M-Davis_Cup_World_Group_F-RR-Lucas_Pouille-Marin_Cilic,1,S-II,1,0,0,0,0,1,0
20181125-M-Davis_Cup_World_Group_F-RR-Lucas_Pouille-Marin_Cilic,2,F-XC,36,22,6,11,5,27,9
20181125-M-Davis_Cup_World_Group_F-RR-Lucas_Pouille-Marin_Cilic,2,F-DTM,13,1,0,0,1,7,6
20181125-M-Davis_Cup_World_Group_F-RR-Lucas_Pouille-Marin_Cilic,2,F-DTL,16,6,0,4,2,10,6
20181125-M-Davis_Cup_World_Group_F-RR-Lucas_Pouille-Marin_Cilic,2,F-IO,31,8,2,4,2,24,7
20181125-M-Davis_Cup_World_Group_F-RR-Lucas_Pouille-Marin_Cilic,2,F-II,2,2,1,0,1,1,1
20181125-M-Davis_Cup_World_Group_F-RR-Lucas_Pouille-Marin_Cilic,2,B-XC,29,6,2,3,1,19,10
20181125-M-Davis_Cup_World_Group_F-RR-Lucas_Pouille-Marin_Cilic,2,B-DTM,13,1,0,0,1,6,7
20181125-M-Davis_Cup_World_Group_F-RR-Lucas_Pouille-Marin_Cilic,2,B-DTL,2,1,0,1,0,1,1
20181125-M-Davis_Cup_World_Group_F-RR-Lucas_Pouille-Marin_Cilic,2,B-IO,2,1,1,0,0,2,0
20181125-M-Davis_Cup_World_Group_F-RR-Lucas_Pouille-Marin_Cilic,2,S-XC,1,0,0,0,0,0,1
20181125-M-Davis_Cup_World_Group_F-RR-Lucas_Pouille-Marin_Cilic,2,S-DTL,1,1,0,1,0,1,0
20150129-M-Australian_Open-SF-Tomas_Berdych-Andy_Murray,1,F-XC,85,12,1,6,5,37,48
20150129-M-Australian_Open-SF-Tomas_Berdych-Andy_Murray,1,F-DTM,30,4,0,0,4,10,20
20150129-M-Australian_Open-SF-Tomas_Berdych-Andy_Murray,1,F-DTL,24,8,1,1,5,12,12
20150129-M-Australian_Open-SF-Tomas_Berdych-Andy_Murray,1,F-IO,51,15,8,4,3,28,23
20150129-M-Australian_Open-SF-Tomas_Berdych-Andy_Murray,1,F-II,16,5,1,3,1,9,7
20150129-M-Australian_Open-SF-Tomas_Berdych-Andy_Murray,1,B-XC,101,9,1,2,6,42,59
20150129-M-Australian_Open-SF-Tomas_Berdych-Andy_Murray,1,B-DTM,19,2,0,0,2,7,12
20150129-M-Australian_Open-SF-Tomas_Berdych-Andy_Murray,1,B-DTL,18,7,1,0,6,7,11
20150129-M-Australian_Open-SF-Tomas_Berdych-Andy_Murray,1,B-IO,7,3,0,1,2,4,3
20150129-M-Australian_Open-SF-Tomas_Berdych-Andy_Murray,1,S-XC,22,1,0,0,1,10,12
20150129-M-Australian_Open-SF-Tomas_Berdych-Andy_Murray,1,S-DTM,6,0,0,0,0,2,4
20150129-M-Australian_Open-SF-Tomas_Berdych-Andy_Murray,1,S-DTL,8,0,0,0,0,3,5
20150129-M-Australian_Open-SF-Tomas_Berdych-Andy_Murray,2,F-XC,96,25,3,11,11,53,43
20150129-M-Australian_Open-SF-Tomas_Berdych-Andy_Murray,2,F-DTM,30,1,0,1,0,16,14
20150129-M-Australian_Open-SF-Tomas_Berdych-Andy_Murray,2,F-DTL,34,10,3,6,1,25,9
20150129-M-Australian_Open-SF-Tomas_Berdych-Andy_Murray,2,F-IO,36,11,4,5,2,23,13
20150129-M-Australian_Open-SF-Tomas_Berdych-Andy_Murray,2,F-II,7,2,2,0,0,4,3
20150129-M-Australian_Open-SF-Tomas_Berdych-Andy_Murray,2,B-XC,96,11,0,5,6,57,39
20150129-M-Australian_Open-SF-Tomas_Berdych-Andy_Murray,2,B-DTM,21,0,0,0,0,14,7
20150129-M-Australian_Open-SF-Tomas_Berdych-Andy_Murray,2,B-DTL,28,13,0,4,9,16,12
20150129-M-Australian_Open-SF-Tomas_Berdych-Andy_Murray,2,B-IO,1,1,0,0,1,0,1
20150129-M-Australian_Open-SF-Tomas_Berdych-Andy_Murray,2,S-XC,30,3,2,0,1,17,13
20150129-M-Australian_Open-SF-Tomas_Berdych-Andy_Murray,2,S-DTM,11,0,0,0,0,1,10
20150129-M-Australian_Open-SF-Tomas_Berdych-Andy_Murray,2,S-DTL,3,2,0,1,1,2,1
20150129-M-Australian_Open-SF-Tomas_Berdych-Andy_Murray,2,S-II,1,0,0,0,0,0,1
20140123-M-Australian_Open-SF-Stanislas_Wawrinka-Tomas_Berdych,1,F-XC,70,23,13,4,6,43,27
20140123-M-Australian_Open-SF-Stanislas_Wawrinka-Tomas_Berdych,1,F-DTM,35,5,0,1,4,14,21
20140123-M-Australian_Open-SF-Stanislas_Wawrinka-Tomas_Berdych,1,F-DTL,18,11,4,4,3,10,8
20140123-M-Australian_Open-SF-Stanislas_Wawrinka-Tomas_Berdych,1,F-IO,29,9,4,3,2,22,7
20140123-M-Australian_Open-SF-Stanislas_Wawrinka-Tomas_Berdych,1,F-II,5,4,3,0,1,4,1
20140123-M-Australian_Open-SF-Stanislas_Wawrinka-Tomas_Berdych,1,B-XC,47,11,1,4,6,27,20
20140123-M-Australian_Open-SF-Stanislas_Wawrinka-Tomas_Berdych,1,B-DTM,20,1,0,0,1,9,11
20140123-M-Australian_Open-SF-Stanislas_Wawrinka-Tomas_Berdych,1,B-DTL,9,6,3,0,3,4,5
20140123-M-Australian_Open-SF-Stanislas_Wawrinka-Tomas_Berdych,1,B-IO,6,3,1,0,2,2,4
20140123-M-Australian_Open-SF-Stanislas_Wawrinka-Tomas_Berdych,1,S-XC,33,2,0,0,2,14,19
20140123-M-Australian_Open-SF-Stanislas_Wawrinka-Tomas_Berdych,1,S-DTM,9,0,0,0,0,2,7
20140123-M-Australian_Open-SF-Stanislas_Wawrinka-Tomas_Berdych,1,S-DTL,2,0,0,0,0,0,2
20140123-M-Australian_Open-SF-Stanislas_Wawrinka-Tomas_Berdych,2,F-XC,66,15,8,5,2,40,26
20140123-M-Australian_Open-SF-Stanislas_Wawrinka-Tomas_Berdych,2,F-DTM,24,1,0,0,1,12,12
20140123-M-Australian_Open-SF-Stanislas_Wawrinka-Tomas_Berdych,2,F-DTL,18,4,1,1,1,8,10
20140123-M-Australian_Open-SF-Stanislas_Wawrinka-Tomas_Berdych,2,F-IO,46,12,4,3,5,26,20
20140123-M-Australian_Open-SF-Stanislas_Wawrinka-Tomas_Berdych,2,F-II,17,8,2,2,4,10,7
20140123-M-Australian_Open-SF-Stanislas_Wawrinka-Tomas_Berdych,2,B-XC,45,9,4,3,2,25,20
20140123-M-Australian_Open-SF-Stanislas_Wawrinka-Tomas_Berdych,2,B-DTM,26,1,0,0,1,10,16
20140123-M-Australian_Open-SF-Stanislas_Wawrinka-Tomas_Berdych,2,B-DTL,13,8,0,3,5,5,8
20140123-M-Australian_Open-SF-Stanislas_Wawrinka-Tomas_Berdych,2,B-IO,2,0,0,0,0,2,0
20140123-M-Australian_Open-SF-Stanislas_Wawrinka-Tomas_Berdych,2,S-XC,16,2,0,1,1,10,6
20140123-M-Australian_Open-SF-Stanislas_Wawrinka-Tomas_Berdych,2,S-DTM,5,0,0,0,0,1,4
20140123-M-Australian_Open-SF-Stanislas_Wawrinka-Tomas_Berdych,2,S-DTL,3,0,0,0,0,1,2
20040129-M-Australian_Open-SF-Andre_Agassi-Marat_Safin,1,F-XC,110,18,2,5,11,47,63
20040129-M-Australian_Open-SF-Andre_Agassi-Marat_Safin,1,F-DTM,20,1,0,0,1,12,8
20040129-M-Australian_Open-SF-Andre_Agassi-Marat_Safin,1,F-DTL,32,8,1,1,6,18,14
20040129-M-Australian_Open-SF-Andre_Agassi-Marat_Safin,1,F-IO,25,7,2,3,2,15,10
20040129-M-Australian_Open-SF-Andre_Agassi-Marat_Safin,1,F-II,3,0,0,0,0,1,2
20040129-M-Australian_Open-SF-Andre_Agassi-Marat_Safin,1,B-XC,148,14,1,5,8,80,68
20040129-M-Australian_Open-SF-Andre_Agassi-Marat_Safin,1,B-DTM,29,4,0,1,3,13,16
20040129-M-Australian_Open-SF-Andre_Agassi-Marat_Safin,1,B-DTL,28,12,8,1,3,17,11
20040129-M-Australian_Open-SF-Andre_Agassi-Marat_Safin,1,B-IO,6,3,1,0,2,1,5
20040129-M-Australian_Open-SF-Andre_Agassi-Marat_Safin,1,S-XC,19,1,0,1,0,6,13
20040129-M-Australian_Open-SF-Andre_Agassi-Marat_Safin,1,S-DTL,7,1,0,1,0,3,4
20040129-M-Australian_Open-SF-Andre_Agassi-Marat_Safin,2,F-XC,88,14,2,2,10,45,43
20040129-M-Australian_Open-SF-Andre_Agassi-Marat_Safin,2,F-DTM,25,2,0,0,2,14,11
20040129-M-Australian_Open-SF-Andre_Agassi-Marat_Safin,2,F-DTL,37,11,7,1,3,24,13
20040129-M-Australian_Open-SF-Andre_Agassi-Marat_Safin,2,F-IO,18,6,0,0,6,6,12
20040129-M-Australian_Open-SF-Andre_Agassi-Marat_Safin,2,F-II,2,0,0,0,0,1,1
20040129-M-Australian_Open-SF-Andre_Agassi-Marat_Safin,2,B-XC,139,20,2,6,12,67,72
20040129-M-Australian_Open-SF-Andre_Agassi-Marat_Safin,2,B-DTM,38,2,0,1,1,14,24
20040129-M-Australian_Open-SF-Andre_Agassi-Marat_Safin,2,B-DTL,40,19,9,1,9,24,16
20040129-M-Australian_Open-SF-Andre_Agassi-Marat_Safin,2,B-IO,3,3,0,0,3,0,3
20040129-M-Australian_Open-SF-Andre_Agassi-Marat_Safin,2,S-XC,17,1,0,0,1,10,7
20040129-M-Australian_Open-SF-Andre_Agassi-Marat_Safin,2,S-DTM,8,1,0,0,1,2,6
20040129-M-Australian_Open-SF-Andre_Agassi-Marat_Safin,2,S-DTL,8,1,0,0,1,2,6
20120908-M-US_Open-SF-Tomas_Berdych-Andy_Murray,1,F-XC,75,18,6,5,7,35,40
20120908-M-US_Open-SF-Tomas_Berdych-Andy_Murray,1,F-DTM,44,4,0,1,3,14,30
20120908-M-US_Open-SF-Tomas_Berdych-Andy_Murray,1,F-DTL,18,3,1,0,2,5,13
20120908-M-US_Open-SF-Tomas_Berdych-Andy_Murray,1,F-IO,87,25,8,4,13,52,35
20120908-M-US_Open-SF-Tomas_Berdych-Andy_Murray,1,F-II,16,7,2,2,3,9,7
20120908-M-US_Open-SF-Tomas_Berdych-Andy_Murray,1,B-XC,55,10,2,4,4,27,28
20120908-M-US_Open-SF-Tomas_Berdych-Andy_Murray,1,B-DTM,36,3,0,0,3,11,25
20120908-M-US_Open-SF-Tomas_Berdych-Andy_Murray,1,B-DTL,23,6,0,4,2,11,12
20120908-M-US_Open-SF-Tomas_Berdych-Andy_Murray,1,B-IO,9,2,0,0,2,4,5
20120908-M-US_Open-SF-Tomas_Berdych-Andy_Murray,1,S-XC,15,2,0,0,2,7,8
20120908-M-US_Open-SF-Tomas_Berdych-Andy_Murray,1,S-DTM,10,2,0,0,2,4,6
20120908-M-US_Open-SF-Tomas_Berdych-Andy_Murray,1,S-DTL,3,1,0,1,0,1,2
20120908-M-US_Open-SF-Tomas_Berdych-Andy_Murray,1,S-IO,2,2,0,2,0,2,0
20120908-M-US_Open-SF-Tomas_Berdych-Andy_Murray,2,F-XC,67,23,10,9,4,47,20
20120908-M-US_Open-SF-Tomas_Berdych-Andy_Murray,2,F-DTM,36,2,0,1,1,22,14
20120908-M-US_Open-SF-Tomas_Berdych-Andy_Murray,2,F-DTL,21,4,0,2,2,10,11
20120908-M-US_Open-SF-Tomas_Berdych-Andy_Murray,2,F-IO,33,6,2,2,2,21,12
20120908-M-US_Open-SF-Tomas_Berdych-Andy_Murray,2,F-II,1,1,1,0,0,1,0
20120908-M-US_Open-SF-Tomas_Berdych-Andy_Murray,2,B-XC,64,14,2,6,6,37,27
20120908-M-US_Open-SF-Tomas_Berdych-Andy_Murray,2,B-DTM,26,1,0,0,1,8,18
20120908-M-US_Open-SF-Tomas_Berdych-Andy_Murray,2,B-DTL,17,9,4,5,0,14,3
20120908-M-US_Open-SF-Tomas_Berdych-Andy_Murray,2,B-IO,7,1,1,0,0,7,0
20120908-M-US_Open-SF-Tomas_Berdych-Andy_Murray,2,S-XC,43,3,0,2,1,20,23
20120908-M-US_Open-SF-Tomas_Berdych-Andy_Murray,2,S-DTM,20,2,0,1,1,6,14
20120908-M-US_Open-SF-Tomas_Berdych-Andy_Murray,2,S-DTL,11,4,1,2,1,7,4
20120908-M-US_Open-SF-Tomas_Berdych-Andy_Murray,2,S-IO,5,0,0,0,0,4,1
20100501-M-Rome_Masters-SF-Ernests_Gulbis-Rafael_Nadal,1,F-XC,50,10,4,4,2,31,19
20100501-M-Rome_Masters-SF-Ernests_Gulbis-Rafael_Nadal,1,F-DTM,17,2,0,0,2,6,11
20100501-M-Rome_Masters-SF-Ernests_Gulbis-Rafael_Nadal,1,F-DTL,11,3,1,0,2,5,6
20100501-M-Rome_Masters-SF-Ernests_Gulbis-Rafael_Nadal,1,F-IO,31,19,6,2,11,11,20
20100501-M-Rome_Masters-SF-Ernests_Gulbis-Rafael_Nadal,1,F-II,6,4,1,0,3,2,4
20100501-M-Rome_Masters-SF-Ernests_Gulbis-Rafael_Nadal,1,B-XC,73,16,4,2,10,25,48
20100501-M-Rome_Masters-SF-Ernests_Gulbis-Rafael_Nadal,1,B-DTM,59,2,0,0,2,17,42
20100501-M-Rome_Masters-SF-Ernests_Gulbis-Rafael_Nadal,1,B-DTL,44,11,1,1,9,13,31
20100501-M-Rome_Masters-SF-Ernests_Gulbis-Rafael_Nadal,1,B-IO,12,2,2,0,0,6,6
20100501-M-Rome_Masters-SF-Ernests_Gulbis-Rafael_Nadal,1,S-XC,1,1,1,0,0,1,0
20100501-M-Rome_Masters-SF-Ernests_Gulbis-Rafael_Nadal,1,S-DTM,2,0,0,0,0,0,2
20100501-M-Rome_Masters-SF-Ernests_Gulbis-Rafael_Nadal,2,F-XC,130,13,0,9,4,96,34
20100501-M-Rome_Masters-SF-Ernests_Gulbis-Rafael_Nadal,2,F-DTM,28,2,0,0,2,15,13
20100501-M-Rome_Masters-SF-Ernests_Gulbis-Rafael_Nadal,2,F-DTL,22,3,1,1,1,13,9
20100501-M-Rome_Masters-SF-Ernests_Gulbis-Rafael_Nadal,2,F-IO,24,11,5,1,5,14,10
20100501-M-Rome_Masters-SF-Ernests_Gulbis-Rafael_Nadal,2,F-II,7,0,0,0,0,3,4
20100501-M-Rome_Masters-SF-Ernests_Gulbis-Rafael_Nadal,2,B-XC,33,7,1,5,1,18,15
20100501-M-Rome_Masters-SF-Ernests_Gulbis-Rafael_Nadal,2,B-DTM,20,2,0,0,2,10,10
20100501-M-Rome_Masters-SF-Ernests_Gulbis-Rafael_Nadal,2,B-DTL,43,8,3,2,3,28,15
20100501-M-Rome_Masters-SF-Ernests_Gulbis-Rafael_Nadal,2,B-IO,1,1,1,0,0,1,0
20100501-M-Rome_Masters-SF-Ernests_Gulbis-Rafael_Nadal,2,S-DTM,3,0,0,0,0,1,2
20100501-M-Rome_Masters-SF-Ernests_Gulbis-Rafael_Nadal,2,S-DTL,2,0,0,0,0,1,1
20100501-M-Rome_Masters-SF-Ernests_Gulbis-Rafael_Nadal,2,S-IO,2,1,0,0,1,0,2
20180715-M-Perugia_CH-F-Gianluigi_Quinzi-Ulises_Blanch,1,F-XC,22,2,0,1,1,10,12
20180715-M-Perugia_CH-F-Gianluigi_Quinzi-Ulises_Blanch,1,F-DTM,16,0,0,0,0,8,8
20180715-M-Perugia_CH-F-Gianluigi_Quinzi-Ulises_Blanch,1,F-DTL,8,4,4,0,0,5,3
20180715-M-Perugia_CH-F-Gianluigi_Quinzi-Ulises_Blanch,1,F-IO,12,6,3,1,2,7,5
20180715-M-Perugia_CH-F-Gianluigi_Quinzi-Ulises_Blanch,1,F-II,2,0,0,0,0,1,1
20180715-M-Perugia_CH-F-Gianluigi_Quinzi-Ulises_Blanch,1,B-XC,17,5,4,1,0,10,7
20180715-M-Perugia_CH-F-Gianluigi_Quinzi-Ulises_Blanch,1,B-DTM,18,1,0,0,1,6,12
20180715-M-Perugia_CH-F-Gianluigi_Quinzi-Ulises_Blanch,1,B-DTL,7,0,0,0,0,0,7
20180715-M-Perugia_CH-F-Gianluigi_Quinzi-Ulises_Blanch,1,B-IO,5,0,0,0,0,1,4
20180715-M-Perugia_CH-F-Gianluigi_Quinzi-Ulises_Blanch,1,S-DTM,1,0,0,0,0,0,1
20180715-M-Perugia_CH-F-Gianluigi_Quinzi-Ulises_Blanch,1,S-DTL,1,0,0,0,0,0,1
20180715-M-Perugia_CH-F-Gianluigi_Quinzi-Ulises_Blanch,2,F-XC,35,11,1,4,6,20,15
20180715-M-Perugia_CH-F-Gianluigi_Quinzi-Ulises_Blanch,2,F-DTM,13,2,1,0,1,8,5
20180715-M-Perugia_CH-F-Gianluigi_Quinzi-Ulises_Blanch,2,F-DTL,6,3,2,0,1,4,2
20180715-M-Perugia_CH-F-Gianluigi_Quinzi-Ulises_Blanch,2,F-IO,12,8,6,1,1,9,3
20180715-M-Perugia_CH-F-Gianluigi_Quinzi-Ulises_Blanch,2,F-II,3,1,0,0,1,2,1
20180715-M-Perugia_CH-F-Gianluigi_Quinzi-Ulises_Blanch,2,B-XC,19,6,3,2,1,13,6
20180715-M-Perugia_CH-F-Gianluigi_Quinzi-Ulises_Blanch,2,B-DTM,8,1,1,0,0,6,2
20180715-M-Perugia_CH-F-Gianluigi_Quinzi-Ulises_Blanch,2,B-DTL,5,4,3,0,1,3,2
20180715-M-Perugia_CH-F-Gianluigi_Quinzi-Ulises_Blanch,2,B-IO,1,0,0,0,0,1,0
20180715-M-Perugia_CH-F-Gianluigi_Quinzi-Ulises_Blanch,2,S-XC,1,0,0,0,0,1,0
20180715-M-Perugia_CH-F-Gianluigi_Quinzi-Ulises_Blanch,2,S-DTM,1,1,0,0,1,0,1
20180715-M-Perugia_CH-F-Gianluigi_Quinzi-Ulises_Blanch,2,S-DTL,1,0,0,0,0,1,0
20040127-M-Australian_Open-QF-Andy_Roddick-Marat_Safin,1,F-XC,116,16,2,4,10,54,62
20040127-M-Australian_Open-QF-Andy_Roddick-Marat_Safin,1,F-DTM,34,2,1,0,1,13,21
20040127-M-Australian_Open-QF-Andy_Roddick-Marat_Safin,1,F-DTL,25,3,2,1,0,16,9
20040127-M-Australian_Open-QF-Andy_Roddick-Marat_Safin,1,F-IO,48,12,3,5,4,27,21
20040127-M-Australian_Open-QF-Andy_Roddick-Marat_Safin,1,F-II,23,9,3,2,4,12,11
20040127-M-Australian_Open-QF-Andy_Roddick-Marat_Safin,1,B-XC,110,12,0,3,9,46,64
20040127-M-Australian_Open-QF-Andy_Roddick-Marat_Safin,1,B-DTM,46,4,0,0,4,18,28
20040127-M-Australian_Open-QF-Andy_Roddick-Marat_Safin,1,B-DTL,31,6,2,0,4,9,22
20040127-M-Australian_Open-QF-Andy_Roddick-Marat_Safin,1,B-IO,7,2,0,1,1,3,4
20040127-M-Australian_Open-QF-Andy_Roddick-Marat_Safin,1,B-II,1,0,0,0,0,0,1
20040127-M-Australian_Open-QF-Andy_Roddick-Marat_Safin,1,S-XC,29,3,0,0,3,7,22
20040127-M-Australian_Open-QF-Andy_Roddick-Marat_Safin,1,S-DTM,14,0,0,0,0,6,8
20040127-M-Australian_Open-QF-Andy_Roddick-Marat_Safin,1,S-DTL,3,0,0,0,0,1,2
20040127-M-Australian_Open-QF-Andy_Roddick-Marat_Safin,1,S-IO,1,0,0,0,0,0,1
20040127-M-Australian_Open-QF-Andy_Roddick-Marat_Safin,2,F-XC,94,15,8,2,5,55,39
20040127-M-Australian_Open-QF-Andy_Roddick-Marat_Safin,2,F-DTM,40,3,1,1,1,15,25
20040127-M-Australian_Open-QF-Andy_Roddick-Marat_Safin,2,F-DTL,50,14,2,4,8,28,22
20040127-M-Australian_Open-QF-Andy_Roddick-Marat_Safin,2,F-IO,40,8,2,2,4,18,22
20040127-M-Australian_Open-QF-Andy_Roddick-Marat_Safin,2,F-II,1,1,1,0,0,1,0
20040127-M-Australian_Open-QF-Andy_Roddick-Marat_Safin,2,B-XC,164,18,3,7,8,106,58
20040127-M-Australian_Open-QF-Andy_Roddick-Marat_Safin,2,B-DTM,36,2,0,0,2,20,16
20040127-M-Australian_Open-QF-Andy_Roddick-Marat_Safin,2,B-DTL,26,5,1,1,3,15,11
20040127-M-Australian_Open-QF-Andy_Roddick-Marat_Safin,2,B-IO,7,1,0,0,1,4,3
20040127-M-Australian_Open-QF-Andy_Roddick-Marat_Safin,2,S-XC,6,0,0,0,0,2,4
20040127-M-Australian_Open-QF-Andy_Roddick-Marat_Safin,2,S-DTM,7,1,0,0,1,1,6
20040127-M-Australian_Open-QF-Andy_Roddick-Marat_Safin,2,S-DTL,2,0,0,0,0,2,0
20040127-M-Australian_Open-QF-Andy_Roddick-Marat_Safin,2,S-IO,1,1,1,0,0,1,0
20130705-M-Wimbledon-SF-Andy_Murray-Jerzy_Janowicz,1,F-XC,57,15,7,5,3,33,24
20130705-M-Wimbledon-SF-Andy_Murray-Jerzy_Janowicz,1,F-DTM,14,1,1,0,0,3,11
20130705-M-Wimbledon-SF-Andy_Murray-Jerzy_Janowicz,1,F-DTL,16,6,5,0,1,9,7
20130705-M-Wimbledon-SF-Andy_Murray-Jerzy_Janowicz,1,F-IO,21,6,1,3,2,12,9
20130705-M-Wimbledon-SF-Andy_Murray-Jerzy_Janowicz,1,F-II,3,2,2,0,0,3,0
20130705-M-Wimbledon-SF-Andy_Murray-Jerzy_Janowicz,1,B-XC,35,7,3,2,2,20,15
20130705-M-Wimbledon-SF-Andy_Murray-Jerzy_Janowicz,1,B-DTM,9,0,0,0,0,4,5
20130705-M-Wimbledon-SF-Andy_Murray-Jerzy_Janowicz,1,B-DTL,10,5,2,2,1,5,5
20130705-M-Wimbledon-SF-Andy_Murray-Jerzy_Janowicz,1,B-IO,2,1,0,0,1,0,2
20130705-M-Wimbledon-SF-Andy_Murray-Jerzy_Janowicz,1,S-XC,16,0,0,0,0,7,9
20130705-M-Wimbledon-SF-Andy_Murray-Jerzy_Janowicz,1,S-DTM,14,1,0,0,1,6,8
20130705-M-Wimbledon-SF-Andy_Murray-Jerzy_Janowicz,1,S-DTL,4,0,0,0,0,0,4
20130705-M-Wimbledon-SF-Andy_Murray-Jerzy_Janowicz,1,S-IO,2,1,1,0,0,1,1
20130705-M-Wimbledon-SF-Andy_Murray-Jerzy_Janowicz,2,F-XC,47,17,2,8,7,29,18
20130705-M-Wimbledon-SF-Andy_Murray-Jerzy_Janowicz,2,F-DTM,7,1,0,0,1,1,6
20130705-M-Wimbledon-SF-Andy_Murray-Jerzy_Janowicz,2,F-DTL,22,8,2,2,4,10,12
20130705-M-Wimbledon-SF-Andy_Murray-Jerzy_Janowicz,2,F-IO,34,13,6,4,3,22,12
20130705-M-Wimbledon-SF-Andy_Murray-Jerzy_Janowicz,2,F-II,8,3,0,1,2,3,5
20130705-M-Wimbledon-SF-Andy_Murray-Jerzy_Janowicz,2,B-XC,28,7,1,1,5,13,15
20130705-M-Wimbledon-SF-Andy_Murray-Jerzy_Janowicz,2,B-DTM,20,2,0,1,1,11,9
20130705-M-Wimbledon-SF-Andy_Murray-Jerzy_Janowicz,2,B-DTL,10,3,1,0,1,3,7
20130705-M-Wimbledon-SF-Andy_Murray-Jerzy_Janowicz,2,B-IO,1,0,0,0,0,1,0
20130705-M-Wimbledon-SF-Andy_Murray-Jerzy_Janowicz,2,S-XC,13,3,0,2,1,8,5
20130705-M-Wimbledon-SF-Andy_Murray-Jerzy_Janowicz,2,S-DTM,5,0,0,0,0,3,2
20130705-M-Wimbledon-SF-Andy_Murray-Jerzy_Janowicz,2,S-DTL,7,2,2,0,0,5,2
20000708-M-Wimbledon-SF-Patrick_Rafter-Andre_Agassi,1,F-XC,26,12,4,4,4,13,13
20000708-M-Wimbledon-SF-Patrick_Rafter-Andre_Agassi,1,F-DTM,7,1,0,0,1,5,2
20000708-M-Wimbledon-SF-Patrick_Rafter-Andre_Agassi,1,F-DTL,20,8,2,1,5,10,10
20000708-M-Wimbledon-SF-Patrick_Rafter-Andre_Agassi,1,F-IO,2,0,0,0,0,0,2
20000708-M-Wimbledon-SF-Patrick_Rafter-Andre_Agassi,1,F-II,1,0,0,0,0,0,1
20000708-M-Wimbledon-SF-Patrick_Rafter-Andre_Agassi,1,B-XC,20,3,1,0,2,13,7
20000708-M-Wimbledon-SF-Patrick_Rafter-Andre_Agassi,1,B-DTM,2,0,0,0,0,1,1
20000708-M-Wimbledon-SF-Patrick_Rafter-Andre_Agassi,1,B-DTL,15,8,1,3,4,7,8
20000708-M-Wimbledon-SF-Patrick_Rafter-Andre_Agassi,1,B-IO,1,0,0,0,0,1,0
20000708-M-Wimbledon-SF-Patrick_Rafter-Andre_Agassi,1,S-XC,69,1,0,0,1,33,36
20000708-M-Wimbledon-SF-Patrick_Rafter-Andre_Agassi,1,S-DTM,8,0,0,0,0,6,2
20000708-M-Wimbledon-SF-Patrick_Rafter-Andre_Agassi,1,S-DTL,2,0,0,0,0,1,1
20000708-M-Wimbledon-SF-Patrick_Rafter-Andre_Agassi,2,F-XC,39,14,4,8,2,29,10
20000708-M-Wimbledon-SF-Patrick_Rafter-Andre_Agassi,2,F-DTM,10,0,0,0,0,5,5
20000708-M-Wimbledon-SF-Patrick_Rafter-Andre_Agassi,2,F-DTL,17,8,3,3,2,10,7
20000708-M-Wimbledon-SF-Patrick_Rafter-Andre_Agassi,2,F-IO,31,13,6,2,5,16,15
20000708-M-Wimbledon-SF-Patrick_Rafter-Andre_Agassi,2,F-II,3,1,0,0,1,2,1
20000708-M-Wimbledon-SF-Patrick_Rafter-Andre_Agassi,2,B-XC,101,13,3,3,7,51,50
20000708-M-Wimbledon-SF-Patrick_Rafter-Andre_Agassi,2,B-DTM,6,0,0,0,0,1,5
20000708-M-Wimbledon-SF-Patrick_Rafter-Andre_Agassi,2,B-DTL,32,16,8,4,4,16,16
20000708-M-Wimbledon-SF-Patrick_Rafter-Andre_Agassi,2,B-IO,6,3,3,0,0,3,3
20000708-M-Wimbledon-SF-Patrick_Rafter-Andre_Agassi,2,S-XC,6,1,1,0,0,4,2
20000708-M-Wimbledon-SF-Patrick_Rafter-Andre_Agassi,2,S-DTM,2,0,0,0,0,1,1
20000708-M-Wimbledon-SF-Patrick_Rafter-Andre_Agassi,2,S-DTL,5,2,1,1,0,3,2
20010707-M-Wimbledon-SF-Patrick_Rafter-Andre_Agassi,1,F-XC,29,4,1,2,1,24,5
20010707-M-Wimbledon-SF-Patrick_Rafter-Andre_Agassi,1,F-DTM,7,1,1,0,0,5,2
20010707-M-Wimbledon-SF-Patrick_Rafter-Andre_Agassi,1,F-DTL,12,2,0,0,2,7,5
20010707-M-Wimbledon-SF-Patrick_Rafter-Andre_Agassi,1,F-IO,8,1,0,0,1,4,4
20010707-M-Wimbledon-SF-Patrick_Rafter-Andre_Agassi,1,F-II,1,1,1,0,0,1,0
20010707-M-Wimbledon-SF-Patrick_Rafter-Andre_Agassi,1,B-XC,25,6,2,0,4,15,10
20010707-M-Wimbledon-SF-Patrick_Rafter-Andre_Agassi,1,B-DTM,2,0,0,0,0,2,0
20010707-M-Wimbledon-SF-Patrick_Rafter-Andre_Agassi,1,B-DTL,11,2,0,1,1,6,5
20010707-M-Wimbledon-SF-Patrick_Rafter-Andre_Agassi,1,B-IO,1,0,0,0,0,0,1
20010707-M-Wimbledon-SF-Patrick_Rafter-Andre_Agassi,1,S-XC,67,5,0,0,5,43,24
20010707-M-Wimbledon-SF-Patrick_Rafter-Andre_Agassi,1,S-DTM,8,2,1,1,0,6,2
20010707-M-Wimbledon-SF-Patrick_Rafter-Andre_Agassi,1,S-DTL,7,1,0,1,0,3,4
20010707-M-Wimbledon-SF-Patrick_Rafter-Andre_Agassi,2,F-XC,42,14,7,3,4,16,26
20010707-M-Wimbledon-SF-Patrick_Rafter-Andre_Agassi,2,F-DTM,5,0,0,0,0,2,3
20010707-M-Wimbledon-SF-Patrick_Rafter-Andre_Agassi,2,F-DTL,27,13,9,1,3,13,14
20010707-M-Wimbledon-SF-Patrick_Rafter-Andre_Agassi,2,F-IO,15,3,0,3,0,7,8
20010707-M-Wimbledon-SF-Patrick_Rafter-Andre_Agassi,2,F-II,1,1,0,1,0,1,0
20010707-M-Wimbledon-SF-Patrick_Rafter-Andre_Agassi,2,B-XC,100,17,7,2,8,43,57
20010707-M-Wimbledon-SF-Patrick_Rafter-Andre_Agassi,2,B-DTM,15,2,0,1,1,3,12
20010707-M-Wimbledon-SF-Patrick_Rafter-Andre_Agassi,2,B-DTL,33,13,5,2,6,14,19
20010707-M-Wimbledon-SF-Patrick_Rafter-Andre_Agassi,2,B-IO,5,3,3,0,0,3,2
20010707-M-Wimbledon-SF-Patrick_Rafter-Andre_Agassi,2,S-XC,16,1,1,0,0,7,9
20010707-M-Wimbledon-SF-Patrick_Rafter-Andre_Agassi,2,S-DTM,2,0,0,0,0,1,1
20010707-M-Wimbledon-SF-Patrick_Rafter-Andre_Agassi,2,S-DTL,2,0,0,0,0,0,2
20180613-M-Stuttgart-R16-Mischa_Zverev-Roger_Federer,1,F-XC,5,3,1,0,2,3,2
20180613-M-Stuttgart-R16-Mischa_Zverev-Roger_Federer,1,F-DTM,5,0,0,0,0,1,4
20180613-M-Stuttgart-R16-Mischa_Zverev-Roger_Federer,1,F-IO,3,1,1,0,0,3,0
20180613-M-Stuttgart-R16-Mischa_Zverev-Roger_Federer,1,B-XC,6,4,2,1,1,3,3
20180613-M-Stuttgart-R16-Mischa_Zverev-Roger_Federer,1,B-DTM,6,1,0,0,1,1,5
20180613-M-Stuttgart-R16-Mischa_Zverev-Roger_Federer,1,B-DTL,1,0,0,0,0,0,1
20180613-M-Stuttgart-R16-Mischa_Zverev-Roger_Federer,1,B-IO,1,0,0,0,0,0,1
20180613-M-Stuttgart-R16-Mischa_Zverev-Roger_Federer,1,S-XC,2,1,1,0,0,1,1
20180613-M-Stuttgart-R16-Mischa_Zverev-Roger_Federer,1,S-DTM,3,1,0,0,1,0,3
20180613-M-Stuttgart-R16-Mischa_Zverev-Roger_Federer,1,S-DTL,5,2,0,0,2,2,3
20180613-M-Stuttgart-R16-Mischa_Zverev-Roger_Federer,1,S-IO,1,0,0,0,0,1,0
20180613-M-Stuttgart-R16-Mischa_Zverev-Roger_Federer,2,F-XC,14,5,3,1,1,9,5
20180613-M-Stuttgart-R16-Mischa_Zverev-Roger_Federer,2,F-DTM,11,3,0,1,2,3,8
20180613-M-Stuttgart-R16-Mischa_Zverev-Roger_Federer,2,F-DTL,4,1,0,0,1,1,3
20180613-M-Stuttgart-R16-Mischa_Zverev-Roger_Federer,2,F-IO,8,5,5,0,0,6,2
20180613-M-Stuttgart-R16-Mischa_Zverev-Roger_Federer,2,F-II,1,1,1,0,0,1,0
20180613-M-Stuttgart-R16-Mischa_Zverev-Roger_Federer,2,B-XC,5,5,3,1,1,4,1
20180613-M-Stuttgart-R16-Mischa_Zverev-Roger_Federer,2,B-DTM,7,2,0,1,1,5,2
20180613-M-Stuttgart-R16-Mischa_Zverev-Roger_Federer,2,B-DTL,9,5,4,0,1,6,3
20180613-M-Stuttgart-R16-Mischa_Zverev-Roger_Federer,2,B-IO,4,3,1,0,2,2,2
20180613-M-Stuttgart-R16-Mischa_Zverev-Roger_Federer,2,S-XC,2,1,0,0,1,1,1
20180613-M-Stuttgart-R16-Mischa_Zverev-Roger_Federer,2,S-DTM,1,0,0,0,0,1,0
20180613-M-Stuttgart-R16-Mischa_Zverev-Roger_Federer,2,S-DTL,4,1,0,0,1,0,4
20180613-M-Stuttgart-R16-Mischa_Zverev-Roger_Federer,2,S-IO,1,0,0,0,0,1,0
20180615-M-Stuttgart-QF-Feliciano_Lopez-Nick_Kyrgios,1,F-XC,16,6,3,0,3,8,8
20180615-M-Stuttgart-QF-Feliciano_Lopez-Nick_Kyrgios,1,F-DTM,6,0,0,0,0,2,4
20180615-M-Stuttgart-QF-Feliciano_Lopez-Nick_Kyrgios,1,F-DTL,4,2,0,1,1,2,2
20180615-M-Stuttgart-QF-Feliciano_Lopez-Nick_Kyrgios,1,F-IO,8,4,1,1,2,3,5
20180615-M-Stuttgart-QF-Feliciano_Lopez-Nick_Kyrgios,1,B-XC,7,1,0,0,1,1,6
20180615-M-Stuttgart-QF-Feliciano_Lopez-Nick_Kyrgios,1,B-DTM,5,1,0,0,1,1,4
20180615-M-Stuttgart-QF-Feliciano_Lopez-Nick_Kyrgios,1,S-XC,15,3,0,0,3,6,9
20180615-M-Stuttgart-QF-Feliciano_Lopez-Nick_Kyrgios,1,S-DTM,3,0,0,0,0,1,2
20180615-M-Stuttgart-QF-Feliciano_Lopez-Nick_Kyrgios,1,S-DTL,11,1,0,1,0,5,6
20180615-M-Stuttgart-QF-Feliciano_Lopez-Nick_Kyrgios,1,S-IO,2,1,0,0,1,0,2
20180615-M-Stuttgart-QF-Feliciano_Lopez-Nick_Kyrgios,2,F-XC,23,6,1,3,2,15,8
20180615-M-Stuttgart-QF-Feliciano_Lopez-Nick_Kyrgios,2,F-DTM,5,0,0,0,0,4,1
20180615-M-Stuttgart-QF-Feliciano_Lopez-Nick_Kyrgios,2,F-DTL,6,3,1,1,1,4,2
20180615-M-Stuttgart-QF-Feliciano_Lopez-Nick_Kyrgios,2,F-IO,7,7,0,3,4,3,4
20180615-M-Stuttgart-QF-Feliciano_Lopez-Nick_Kyrgios,2,B-XC,12,4,1,1,2,8,4
20180615-M-Stuttgart-QF-Feliciano_Lopez-Nick_Kyrgios,2,B-DTM,5,2,0,0,2,3,2
20180615-M-Stuttgart-QF-Feliciano_Lopez-Nick_Kyrgios,2,B-DTL,8,1,0,1,0,5,3
20180615-M-Stuttgart-QF-Feliciano_Lopez-Nick_Kyrgios,2,B-IO,5,0,0,0,0,3,2
20180615-M-Stuttgart-QF-Feliciano_Lopez-Nick_Kyrgios,2,B-II,1,1,1,0,0,1,0
20180615-M-Stuttgart-QF-Feliciano_Lopez-Nick_Kyrgios,2,S-XC,1,1,0,0,1,0,1
20180615-M-Stuttgart-QF-Feliciano_Lopez-Nick_Kyrgios,2,S-DTM,2,0,0,0,0,1,1
20180615-M-Stuttgart-QF-Feliciano_Lopez-Nick_Kyrgios,2,S-DTL,2,0,0,0,0,1,1
20180615-M-Stuttgart-QF-Feliciano_Lopez-Nick_Kyrgios,2,S-IO,1,0,0,0,0,1,0
20090914-M-US_Open-F-Roger_Federer-Juan_Martin_Del_Potro,1,F-XC,91,20,6,4,10,56,35
20090914-M-US_Open-F-Roger_Federer-Juan_Martin_Del_Potro,1,F-DTM,50,1,0,0,1,31,19
20090914-M-US_Open-F-Roger_Federer-Juan_Martin_Del_Potro,1,F-DTL,23,6,1,2,3,14,9
20090914-M-US_Open-F-Roger_Federer-Juan_Martin_Del_Potro,1,F-IO,57,18,5,6,7,30,27
20090914-M-US_Open-F-Roger_Federer-Juan_Martin_Del_Potro,1,F-II,17,9,3,0,6,8,9
20090914-M-US_Open-F-Roger_Federer-Juan_Martin_Del_Potro,1,B-XC,77,16,4,2,10,39,38
20090914-M-US_Open-F-Roger_Federer-Juan_Martin_Del_Potro,1,B-DTM,48,2,0,0,2,25,23
20090914-M-US_Open-F-Roger_Federer-Juan_Martin_Del_Potro,1,B-DTL,28,10,4,1,5,11,17
20090914-M-US_Open-F-Roger_Federer-Juan_Martin_Del_Potro,1,B-IO,3,2,0,0,2,0,3
20090914-M-US_Open-F-Roger_Federer-Juan_Martin_Del_Potro,1,S-XC,36,6,0,1,5,18,18
20090914-M-US_Open-F-Roger_Federer-Juan_Martin_Del_Potro,1,S-DTM,13,0,0,0,0,6,7
20090914-M-US_Open-F-Roger_Federer-Juan_Martin_Del_Potro,1,S-DTL,5,1,0,0,1,4,1
20090914-M-US_Open-F-Roger_Federer-Juan_Martin_Del_Potro,1,S-IO,1,0,0,0,0,1,0
20090914-M-US_Open-F-Roger_Federer-Juan_Martin_Del_Potro,2,F-XC,118,48,12,11,25,56,62
20090914-M-US_Open-F-Roger_Federer-Juan_Martin_Del_Potro,2,F-DTM,38,2,0,0,2,17,21
20090914-M-US_Open-F-Roger_Federer-Juan_Martin_Del_Potro,2,F-DTL,47,18,9,3,6,26,21
20090914-M-US_Open-F-Roger_Federer-Juan_Martin_Del_Potro,2,F-IO,98,20,6,7,7,51,47
20090914-M-US_Open-F-Roger_Federer-Juan_Martin_Del_Potro,2,F-II,10,6,1,2,3,4,6
20090914-M-US_Open-F-Roger_Federer-Juan_Martin_Del_Potro,2,B-XC,87,9,1,3,5,47,40
20090914-M-US_Open-F-Roger_Federer-Juan_Martin_Del_Potro,2,B-DTM,43,2,0,0,2,16,27
20090914-M-US_Open-F-Roger_Federer-Juan_Martin_Del_Potro,2,B-DTL,24,7,2,2,3,11,13
20090914-M-US_Open-F-Roger_Federer-Juan_Martin_Del_Potro,2,B-IO,2,1,0,0,1,0,2
20090914-M-US_Open-F-Roger_Federer-Juan_Martin_Del_Potro,2,S-XC,10,1,0,1,0,6,4
20090914-M-US_Open-F-Roger_Federer-Juan_Martin_Del_Potro,2,S-DTM,1,0,0,0,0,0,1
20090914-M-US_Open-F-Roger_Federer-Juan_Martin_Del_Potro,2,S-DTL,3,0,0,0,0,1,2
20090913-M-US_Open-SF-Juan_Martin_Del_Potro-Rafael_Nadal,1,F-XC,83,8,0,7,1,46,37
20090913-M-US_Open-SF-Juan_Martin_Del_Potro-Rafael_Nadal,1,F-DTM,12,3,0,0,3,5,7
20090913-M-US_Open-SF-Juan_Martin_Del_Potro-Rafael_Nadal,1,F-DTL,23,11,3,3,5,14,9
20090913-M-US_Open-SF-Juan_Martin_Del_Potro-Rafael_Nadal,1,F-IO,33,18,7,8,3,25,8
20090913-M-US_Open-SF-Juan_Martin_Del_Potro-Rafael_Nadal,1,F-II,7,2,1,1,0,7,0
20090913-M-US_Open-SF-Juan_Martin_Del_Potro-Rafael_Nadal,1,B-XC,84,17,1,6,10,44,40
20090913-M-US_Open-SF-Juan_Martin_Del_Potro-Rafael_Nadal,1,B-DTM,39,4,0,0,4,16,23
20090913-M-US_Open-SF-Juan_Martin_Del_Potro-Rafael_Nadal,1,B-DTL,10,4,3,0,1,8,2
20090913-M-US_Open-SF-Juan_Martin_Del_Potro-Rafael_Nadal,1,B-IO,6,1,0,1,0,3,3
20090913-M-US_Open-SF-Juan_Martin_Del_Potro-Rafael_Nadal,1,S-XC,1,0,0,0,0,1,0
20090913-M-US_Open-SF-Juan_Martin_Del_Potro-Rafael_Nadal,1,S-DTM,2,0,0,0,0,1,1
20090913-M-US_Open-SF-Juan_Martin_Del_Potro-Rafael_Nadal,1,S-DTL,4,0,0,0,0,0,4
20090913-M-US_Open-SF-Juan_Martin_Del_Potro-Rafael_Nadal,1,S-IO,1,0,0,0,0,0,1
20090913-M-US_Open-SF-Juan_Martin_Del_Potro-Rafael_Nadal,2,F-XC,102,11,1,5,5,47,55
20090913-M-US_Open-SF-Juan_Martin_Del_Potro-Rafael_Nadal,2,F-DTM,28,1,0,0,1,12,16
20090913-M-US_Open-SF-Juan_Martin_Del_Potro-Rafael_Nadal,2,F-DTL,16,6,2,2,2,8,8
20090913-M-US_Open-SF-Juan_Martin_Del_Potro-Rafael_Nadal,2,F-IO,37,9,1,5,3,20,17
20090913-M-US_Open-SF-Juan_Martin_Del_Potro-Rafael_Nadal,2,F-II,11,2,0,0,2,2,9
20090913-M-US_Open-SF-Juan_Martin_Del_Potro-Rafael_Nadal,2,B-XC,34,4,2,0,2,14,20
20090913-M-US_Open-SF-Juan_Martin_Del_Potro-Rafael_Nadal,2,B-DTM,17,2,0,0,2,6,11
20090913-M-US_Open-SF-Juan_Martin_Del_Potro-Rafael_Nadal,2,B-DTL,13,3,1,1,1,9,4
20090913-M-US_Open-SF-Juan_Martin_Del_Potro-Rafael_Nadal,2,B-IO,3,1,0,0,1,2,1
20090913-M-US_Open-SF-Juan_Martin_Del_Potro-Rafael_Nadal,2,S-XC,7,0,0,0,0,4,3
20090913-M-US_Open-SF-Juan_Martin_Del_Potro-Rafael_Nadal,2,S-DTM,13,2,0,1,1,5,8
20090913-M-US_Open-SF-Juan_Martin_Del_Potro-Rafael_Nadal,2,S-DTL,15,0,0,0,0,8,7
20090913-M-US_Open-SF-Juan_Martin_Del_Potro-Rafael_Nadal,2,S-IO,1,0,0,0,0,1,0
20180208-M-Sofia-R16-Stanislas_Wawrinka-Martin_Klizan,1,F-XC,29,6,2,1,3,14,15
20180208-M-Sofia-R16-Stanislas_Wawrinka-Martin_Klizan,1,F-DTM,17,3,1,1,1,9,8
20180208-M-Sofia-R16-Stanislas_Wawrinka-Martin_Klizan,1,F-DTL,8,7,3,0,4,3,5
20180208-M-Sofia-R16-Stanislas_Wawrinka-Martin_Klizan,1,F-IO,13,8,5,0,3,8,5
20180208-M-Sofia-R16-Stanislas_Wawrinka-Martin_Klizan,1,F-II,2,1,1,0,0,2,0
20180208-M-Sofia-R16-Stanislas_Wawrinka-Martin_Klizan,1,B-XC,25,9,1,4,4,15,10
20180208-M-Sofia-R16-Stanislas_Wawrinka-Martin_Klizan,1,B-DTM,9,1,0,0,1,3,6
20180208-M-Sofia-R16-Stanislas_Wawrinka-Martin_Klizan,1,B-DTL,8,2,0,0,2,3,5
20180208-M-Sofia-R16-Stanislas_Wawrinka-Martin_Klizan,1,B-IO,1,0,0,0,0,1,0
20180208-M-Sofia-R16-Stanislas_Wawrinka-Martin_Klizan,1,S-XC,2,0,0,0,0,1,1
20180208-M-Sofia-R16-Stanislas_Wawrinka-Martin_Klizan,1,S-DTM,2,0,0,0,0,0,2
20180208-M-Sofia-R16-Stanislas_Wawrinka-Martin_Klizan,1,S-DTL,3,1,0,0,1,0,3
20180208-M-Sofia-R16-Stanislas_Wawrinka-Martin_Klizan,2,F-XC,41,12,1,4,7,19,22
20180208-M-Sofia-R16-Stanislas_Wawrinka-Martin_Klizan,2,F-DTM,15,1,0,1,0,8,7
20180208-M-Sofia-R16-Stanislas_Wawrinka-Martin_Klizan,2,F-DTL,10,2,0,1,1,5,5
20180208-M-Sofia-R16-Stanislas_Wawrinka-Martin_Klizan,2,F-IO,9,4,1,0,3,3,6
20180208-M-Sofia-R16-Stanislas_Wawrinka-Martin_Klizan,2,F-II,2,0,0,0,0,2,0
20180208-M-Sofia-R16-Stanislas_Wawrinka-Martin_Klizan,2,B-XC,24,10,0,4,6,13,11
20180208-M-Sofia-R16-Stanislas_Wawrinka-Martin_Klizan,2,B-DTM,12,4,0,0,4,5,7
20180208-M-Sofia-R16-Stanislas_Wawrinka-Martin_Klizan,2,B-DTL,7,5,2,2,1,5,2
20180208-M-Sofia-R16-Stanislas_Wawrinka-Martin_Klizan,2,B-IO,3,1,1,0,0,1,2
20180208-M-Sofia-R16-Stanislas_Wawrinka-Martin_Klizan,2,S-DTM,2,0,0,0,0,1,1
20180208-M-Sofia-R16-Stanislas_Wawrinka-Martin_Klizan,2,S-DTL,4,1,0,0,1,0,4
20180208-M-Sofia-R16-Stanislas_Wawrinka-Martin_Klizan,2,S-IO,1,0,0,0,0,1,0
20180616-M-Stuttgart-SF-Roger_Federer-Nick_Kyrgios,1,F-XC,20,12,7,2,3,12,8
20180616-M-Stuttgart-SF-Roger_Federer-Nick_Kyrgios,1,F-DTM,14,2,0,0,2,6,8
20180616-M-Stuttgart-SF-Roger_Federer-Nick_Kyrgios,1,F-DTL,4,3,2,0,1,3,1
20180616-M-Stuttgart-SF-Roger_Federer-Nick_Kyrgios,1,F-IO,21,12,5,5,2,16,5
20180616-M-Stuttgart-SF-Roger_Federer-Nick_Kyrgios,1,F-II,2,1,0,1,0,1,1
20180616-M-Stuttgart-SF-Roger_Federer-Nick_Kyrgios,1,B-XC,12,1,0,0,1,6,6
20180616-M-Stuttgart-SF-Roger_Federer-Nick_Kyrgios,1,B-DTM,9,3,0,1,2,5,4
20180616-M-Stuttgart-SF-Roger_Federer-Nick_Kyrgios,1,B-DTL,4,3,1,1,1,3,1
20180616-M-Stuttgart-SF-Roger_Federer-Nick_Kyrgios,1,B-IO,3,1,1,0,0,2,1
20180616-M-Stuttgart-SF-Roger_Federer-Nick_Kyrgios,1,S-XC,7,0,0,0,0,3,4
20180616-M-Stuttgart-SF-Roger_Federer-Nick_Kyrgios,1,S-DTM,3,1,0,0,1,1,2
20180616-M-Stuttgart-SF-Roger_Federer-Nick_Kyrgios,1,S-DTL,2,0,0,0,0,1,1
20180616-M-Stuttgart-SF-Roger_Federer-Nick_Kyrgios,2,F-XC,27,12,2,3,7,12,15
20180616-M-Stuttgart-SF-Roger_Federer-Nick_Kyrgios,2,F-DTM,10,2,0,0,2,4,6
20180616-M-Stuttgart-SF-Roger_Federer-Nick_Kyrgios,2,F-DTL,7,3,0,1,2,3,4
20180616-M-Stuttgart-SF-Roger_Federer-Nick_Kyrgios,2,F-IO,11,2,0,0,2,7,4
20180616-M-Stuttgart-SF-Roger_Federer-Nick_Kyrgios,2,B-XC,26,9,3,4,2,16,10
20180616-M-Stuttgart-SF-Roger_Federer-Nick_Kyrgios,2,B-DTM,9,1,0,0,1,3,6
20180616-M-Stuttgart-SF-Roger_Federer-Nick_Kyrgios,2,B-DTL,6,4,1,1,2,4,2
20180616-M-Stuttgart-SF-Roger_Federer-Nick_Kyrgios,2,B-IO,3,0,0,0,0,2,1
20180616-M-Stuttgart-SF-Roger_Federer-Nick_Kyrgios,2,S-XC,2,0,0,0,0,1,1
20180616-M-Stuttgart-SF-Roger_Federer-Nick_Kyrgios,2,S-DTM,4,0,0,0,0,3,1
20180616-M-Stuttgart-SF-Roger_Federer-Nick_Kyrgios,2,S-DTL,2,0,0,0,0,1,1
20180616-M-Stuttgart-SF-Roger_Federer-Nick_Kyrgios,2,S-IO,1,0,0,0,0,0,1
20180517-M-Rome_Masters-R16-Denis_Shapovalov-Rafael_Nadal,1,F-XC,30,8,1,1,6,10,20
20180517-M-Rome_Masters-R16-Denis_Shapovalov-Rafael_Nadal,1,F-DTM,14,1,0,0,1,3,11
20180517-M-Rome_Masters-R16-Denis_Shapovalov-Rafael_Nadal,1,F-DTL,10,4,2,0,2,5,5
20180517-M-Rome_Masters-R16-Denis_Shapovalov-Rafael_Nadal,1,F-IO,15,4,2,0,2,6,9
20180517-M-Rome_Masters-R16-Denis_Shapovalov-Rafael_Nadal,1,F-II,1,0,0,0,0,1,0
20180517-M-Rome_Masters-R16-Denis_Shapovalov-Rafael_Nadal,1,B-XC,24,3,2,1,0,11,13
20180517-M-Rome_Masters-R16-Denis_Shapovalov-Rafael_Nadal,1,B-DTM,21,2,0,0,2,7,14
20180517-M-Rome_Masters-R16-Denis_Shapovalov-Rafael_Nadal,1,B-DTL,8,5,0,0,5,0,8
20180517-M-Rome_Masters-R16-Denis_Shapovalov-Rafael_Nadal,1,S-XC,3,0,0,0,0,1,2
20180517-M-Rome_Masters-R16-Denis_Shapovalov-Rafael_Nadal,1,S-DTM,7,1,0,0,1,1,6
20180517-M-Rome_Masters-R16-Denis_Shapovalov-Rafael_Nadal,1,S-DTL,5,0,0,0,0,2,3
20180517-M-Rome_Masters-R16-Denis_Shapovalov-Rafael_Nadal,2,F-XC,37,13,5,7,1,30,7
20180517-M-Rome_Masters-R16-Denis_Shapovalov-Rafael_Nadal,2,F-DTM,12,1,0,0,1,9,3
20180517-M-Rome_Masters-R16-Denis_Shapovalov-Rafael_Nadal,2,F-DTL,15,4,3,0,1,9,6
20180517-M-Rome_Masters-R16-Denis_Shapovalov-Rafael_Nadal,2,F-IO,21,3,1,1,1,16,5
20180517-M-Rome_Masters-R16-Denis_Shapovalov-Rafael_Nadal,2,F-II,4,4,1,2,1,3,1
20180517-M-Rome_Masters-R16-Denis_Shapovalov-Rafael_Nadal,2,B-XC,28,2,0,1,1,18,10
20180517-M-Rome_Masters-R16-Denis_Shapovalov-Rafael_Nadal,2,B-DTM,3,0,0,0,0,2,1
20180517-M-Rome_Masters-R16-Denis_Shapovalov-Rafael_Nadal,2,B-DTL,4,3,0,0,3,1,3
20180517-M-Rome_Masters-R16-Denis_Shapovalov-Rafael_Nadal,2,S-XC,2,0,0,0,0,1,1
20180517-M-Rome_Masters-R16-Denis_Shapovalov-Rafael_Nadal,2,S-DTL,1,0,0,0,0,0,1
20181012-M-Shanghai_Masters-QF-Matthew_Ebden-Borna_Coric,1,F-XC,25,6,1,3,2,16,9
20181012-M-Shanghai_Masters-QF-Matthew_Ebden-Borna_Coric,1,F-DTM,10,1,0,0,1,4,6
20181012-M-Shanghai_Masters-QF-Matthew_Ebden-Borna_Coric,1,F-DTL,8,5,0,1,4,2,6
20181012-M-Shanghai_Masters-QF-Matthew_Ebden-Borna_Coric,1,F-IO,13,5,1,0,4,6,7
20181012-M-Shanghai_Masters-QF-Matthew_Ebden-Borna_Coric,1,F-II,1,0,0,0,0,1,0
20181012-M-Shanghai_Masters-QF-Matthew_Ebden-Borna_Coric,1,B-XC,25,1,0,0,1,9,16
20181012-M-Shanghai_Masters-QF-Matthew_Ebden-Borna_Coric,1,B-DTM,11,1,0,0,1,3,8
20181012-M-Shanghai_Masters-QF-Matthew_Ebden-Borna_Coric,1,B-DTL,7,5,0,2,3,2,5
20181012-M-Shanghai_Masters-QF-Matthew_Ebden-Borna_Coric,1,B-IO,2,1,0,0,1,0,2
20181012-M-Shanghai_Masters-QF-Matthew_Ebden-Borna_Coric,1,B-II,1,0,0,0,0,0,1
20181012-M-Shanghai_Masters-QF-Matthew_Ebden-Borna_Coric,1,S-XC,9,1,1,0,0,5,4
20181012-M-Shanghai_Masters-QF-Matthew_Ebden-Borna_Coric,1,S-DTM,7,0,0,0,0,1,6
20181012-M-Shanghai_Masters-QF-Matthew_Ebden-Borna_Coric,1,S-DTL,2,0,0,0,0,1,1
20181012-M-Shanghai_Masters-QF-Matthew_Ebden-Borna_Coric,1,S-IO,2,0,0,0,0,0,2
20181012-M-Shanghai_Masters-QF-Matthew_Ebden-Borna_Coric,2,F-XC,27,7,1,4,2,12,15
20181012-M-Shanghai_Masters-QF-Matthew_Ebden-Borna_Coric,2,F-DTM,8,0,0,0,0,5,3
20181012-M-Shanghai_Masters-QF-Matthew_Ebden-Borna_Coric,2,F-DTL,13,1,1,0,0,6,7
20181012-M-Shanghai_Masters-QF-Matthew_Ebden-Borna_Coric,2,F-IO,20,4,2,2,0,14,6
20181012-M-Shanghai_Masters-QF-Matthew_Ebden-Borna_Coric,2,B-XC,32,8,0,2,6,20,12
20181012-M-Shanghai_Masters-QF-Matthew_Ebden-Borna_Coric,2,B-DTM,17,1,0,1,0,11,6
20181012-M-Shanghai_Masters-QF-Matthew_Ebden-Borna_Coric,2,B-DTL,6,5,4,0,1,4,2
20181012-M-Shanghai_Masters-QF-Matthew_Ebden-Borna_Coric,2,B-IO,2,0,0,0,0,2,0
20181012-M-Shanghai_Masters-QF-Matthew_Ebden-Borna_Coric,2,S-XC,4,0,0,0,0,3,1
20181012-M-Shanghai_Masters-QF-Matthew_Ebden-Borna_Coric,2,S-DTM,1,0,0,0,0,1,0
20181012-M-Shanghai_Masters-QF-Matthew_Ebden-Borna_Coric,2,S-IO,1,1,1,0,0,1,0
20181112-M-Tour_Finals-RR-John_Isner-Novak_Djokovic,1,F-XC,20,4,2,0,2,7,13
20181112-M-Tour_Finals-RR-John_Isner-Novak_Djokovic,1,F-DTM,14,2,0,0,2,2,12
20181112-M-Tour_Finals-RR-John_Isner-Novak_Djokovic,1,F-DTL,10,3,0,1,2,3,7
20181112-M-Tour_Finals-RR-John_Isner-Novak_Djokovic,1,F-IO,18,4,1,1,2,5,13
20181112-M-Tour_Finals-RR-John_Isner-Novak_Djokovic,1,F-II,2,1,0,0,1,1,1
20181112-M-Tour_Finals-RR-John_Isner-Novak_Djokovic,1,B-XC,11,5,1,1,3,2,9
20181112-M-Tour_Finals-RR-John_Isner-Novak_Djokovic,1,B-DTM,13,2,0,0,2,4,9
20181112-M-Tour_Finals-RR-John_Isner-Novak_Djokovic,1,B-DTL,1,0,0,0,0,0,1
20181112-M-Tour_Finals-RR-John_Isner-Novak_Djokovic,1,B-IO,3,1,0,0,1,1,2
20181112-M-Tour_Finals-RR-John_Isner-Novak_Djokovic,1,S-XC,3,2,0,1,1,1,2
20181112-M-Tour_Finals-RR-John_Isner-Novak_Djokovic,1,S-DTM,8,0,0,0,0,1,7
20181112-M-Tour_Finals-RR-John_Isner-Novak_Djokovic,2,F-XC,20,4,1,2,1,14,6
20181112-M-Tour_Finals-RR-John_Isner-Novak_Djokovic,2,F-DTM,8,0,0,0,0,6,2
20181112-M-Tour_Finals-RR-John_Isner-Novak_Djokovic,2,F-DTL,9,2,2,0,0,6,3
20181112-M-Tour_Finals-RR-John_Isner-Novak_Djokovic,2,F-IO,11,6,3,2,1,9,2
20181112-M-Tour_Finals-RR-John_Isner-Novak_Djokovic,2,F-II,2,2,1,1,0,2,0
20181112-M-Tour_Finals-RR-John_Isner-Novak_Djokovic,2,B-XC,25,4,3,0,1,17,8
20181112-M-Tour_Finals-RR-John_Isner-Novak_Djokovic,2,B-DTM,4,0,0,0,0,3,1
20181112-M-Tour_Finals-RR-John_Isner-Novak_Djokovic,2,B-DTL,8,3,2,0,1,7,1
20181112-M-Tour_Finals-RR-John_Isner-Novak_Djokovic,2,B-IO,4,1,0,1,0,4,0
20181112-M-Tour_Finals-RR-John_Isner-Novak_Djokovic,2,S-XC,7,0,0,0,0,7,0
20181112-M-Tour_Finals-RR-John_Isner-Novak_Djokovic,2,S-DTM,5,0,0,0,0,4,1
20181112-M-Tour_Finals-RR-John_Isner-Novak_Djokovic,2,S-DTL,1,0,0,0,0,1,0
20181114-M-Tour_Finals-RR-Dominic_Thiem-Roger_Federer,1,F-XC,17,7,2,1,4,7,10
20181114-M-Tour_Finals-RR-Dominic_Thiem-Roger_Federer,1,F-DTM,8,1,0,0,1,4,4
20181114-M-Tour_Finals-RR-Dominic_Thiem-Roger_Federer,1,F-DTL,1,1,0,1,0,1,0
20181114-M-Tour_Finals-RR-Dominic_Thiem-Roger_Federer,1,F-IO,20,8,2,1,5,6,14
20181114-M-Tour_Finals-RR-Dominic_Thiem-Roger_Federer,1,F-II,3,2,1,0,1,2,1
20181114-M-Tour_Finals-RR-Dominic_Thiem-Roger_Federer,1,B-XC,20,7,0,1,6,3,17
20181114-M-Tour_Finals-RR-Dominic_Thiem-Roger_Federer,1,B-DTM,1,0,0,0,0,0,1
20181114-M-Tour_Finals-RR-Dominic_Thiem-Roger_Federer,1,B-DTL,7,6,1,3,2,4,3
20181114-M-Tour_Finals-RR-Dominic_Thiem-Roger_Federer,1,B-IO,1,0,0,0,0,0,1
20181114-M-Tour_Finals-RR-Dominic_Thiem-Roger_Federer,1,S-XC,3,1,0,0,1,1,2
20181114-M-Tour_Finals-RR-Dominic_Thiem-Roger_Federer,1,S-DTM,1,0,0,0,0,1,0
20181114-M-Tour_Finals-RR-Dominic_Thiem-Roger_Federer,1,S-DTL,1,0,0,0,0,0,1
20181114-M-Tour_Finals-RR-Dominic_Thiem-Roger_Federer,2,F-XC,11,2,2,0,0,8,3
20181114-M-Tour_Finals-RR-Dominic_Thiem-Roger_Federer,2,F-DTM,7,0,0,0,0,4,3
20181114-M-Tour_Finals-RR-Dominic_Thiem-Roger_Federer,2,F-DTL,4,1,1,0,0,2,2
20181114-M-Tour_Finals-RR-Dominic_Thiem-Roger_Federer,2,F-IO,5,4,0,2,2,3,2
20181114-M-Tour_Finals-RR-Dominic_Thiem-Roger_Federer,2,F-II,1,0,0,0,0,0,1
20181114-M-Tour_Finals-RR-Dominic_Thiem-Roger_Federer,2,B-XC,5,0,0,0,0,5,0
20181114-M-Tour_Finals-RR-Dominic_Thiem-Roger_Federer,2,B-DTM,9,1,0,0,1,8,1
20181114-M-Tour_Finals-RR-Dominic_Thiem-Roger_Federer,2,B-DTL,4,3,0,2,1,3,1
20181114-M-Tour_Finals-RR-Dominic_Thiem-Roger_Federer,2,B-IO,1,0,0,0,0,0,1
20181114-M-Tour_Finals-RR-Dominic_Thiem-Roger_Federer,2,S-XC,8,0,0,0,0,6,2
20181114-M-Tour_Finals-RR-Dominic_Thiem-Roger_Federer,2,S-DTM,1,0,0,0,0,1,0
20181114-M-Tour_Finals-RR-Dominic_Thiem-Roger_Federer,2,S-DTL,3,0,0,0,0,0,3
19970606-M-Roland_Garros-SF-Patrick_Rafter-Sergi_Bruguera,1,F-XC,21,3,2,0,1,8,13
19970606-M-Roland_Garros-SF-Patrick_Rafter-Sergi_Bruguera,1,F-DTM,19,1,0,0,1,6,13
19970606-M-Roland_Garros-SF-Patrick_Rafter-Sergi_Bruguera,1,F-DTL,13,3,2,0,1,6,7
19970606-M-Roland_Garros-SF-Patrick_Rafter-Sergi_Bruguera,1,F-IO,16,3,1,1,1,15,1
19970606-M-Roland_Garros-SF-Patrick_Rafter-Sergi_Bruguera,1,F-II,2,0,0,0,0,2,0
19970606-M-Roland_Garros-SF-Patrick_Rafter-Sergi_Bruguera,1,B-XC,29,2,0,0,2,11,18
19970606-M-Roland_Garros-SF-Patrick_Rafter-Sergi_Bruguera,1,B-DTM,14,3,0,0,3,4,10
19970606-M-Roland_Garros-SF-Patrick_Rafter-Sergi_Bruguera,1,B-DTL,4,2,1,0,1,3,1
19970606-M-Roland_Garros-SF-Patrick_Rafter-Sergi_Bruguera,1,S-XC,36,5,0,1,4,14,22
19970606-M-Roland_Garros-SF-Patrick_Rafter-Sergi_Bruguera,1,S-DTM,15,2,0,0,2,4,11
19970606-M-Roland_Garros-SF-Patrick_Rafter-Sergi_Bruguera,1,S-DTL,4,0,0,0,0,0,4
19970606-M-Roland_Garros-SF-Patrick_Rafter-Sergi_Bruguera,1,S-IO,2,1,1,0,0,1,1
19970606-M-Roland_Garros-SF-Patrick_Rafter-Sergi_Bruguera,2,F-XC,36,13,8,4,1,26,10
19970606-M-Roland_Garros-SF-Patrick_Rafter-Sergi_Bruguera,2,F-DTM,23,2,1,1,0,16,7
19970606-M-Roland_Garros-SF-Patrick_Rafter-Sergi_Bruguera,2,F-DTL,24,3,2,0,1,11,13
19970606-M-Roland_Garros-SF-Patrick_Rafter-Sergi_Bruguera,2,F-IO,53,6,2,2,2,31,22
19970606-M-Roland_Garros-SF-Patrick_Rafter-Sergi_Bruguera,2,F-II,10,2,0,0,2,3,7
19970606-M-Roland_Garros-SF-Patrick_Rafter-Sergi_Bruguera,2,B-XC,56,8,3,1,4,29,27
19970606-M-Roland_Garros-SF-Patrick_Rafter-Sergi_Bruguera,2,B-DTM,31,3,1,0,2,13,18
19970606-M-Roland_Garros-SF-Patrick_Rafter-Sergi_Bruguera,2,B-DTL,18,10,6,2,2,12,6
19970606-M-Roland_Garros-SF-Patrick_Rafter-Sergi_Bruguera,2,B-IO,8,5,3,1,1,6,2
19970606-M-Roland_Garros-SF-Patrick_Rafter-Sergi_Bruguera,2,S-XC,7,1,1,0,0,3,4
19970606-M-Roland_Garros-SF-Patrick_Rafter-Sergi_Bruguera,2,S-DTM,1,0,0,0,0,1,0
19970606-M-Roland_Garros-SF-Patrick_Rafter-Sergi_Bruguera,2,S-DTL,4,0,0,0,0,2,2
20090703-M-Wimbledon-SF-Andy_Roddick-Andy_Murray,1,F-XC,65,7,3,4,0,31,34
20090703-M-Wimbledon-SF-Andy_Roddick-Andy_Murray,1,F-DTM,16,1,0,0,1,6,10
20090703-M-Wimbledon-SF-Andy_Roddick-Andy_Murray,1,F-DTL,20,6,2,2,2,7,13
20090703-M-Wimbledon-SF-Andy_Roddick-Andy_Murray,1,F-IO,51,14,3,8,3,31,20
20090703-M-Wimbledon-SF-Andy_Roddick-Andy_Murray,1,F-II,15,3,1,1,1,7,8
20090703-M-Wimbledon-SF-Andy_Roddick-Andy_Murray,1,B-XC,62,12,1,4,7,24,38
20090703-M-Wimbledon-SF-Andy_Roddick-Andy_Murray,1,B-DTM,14,1,0,0,1,2,12
20090703-M-Wimbledon-SF-Andy_Roddick-Andy_Murray,1,B-DTL,17,5,1,0,4,8,9
20090703-M-Wimbledon-SF-Andy_Roddick-Andy_Murray,1,B-IO,3,2,0,1,1,2,1
20090703-M-Wimbledon-SF-Andy_Roddick-Andy_Murray,1,S-XC,20,0,0,0,0,9,11
20090703-M-Wimbledon-SF-Andy_Roddick-Andy_Murray,1,S-DTM,5,0,0,0,0,2,3
20090703-M-Wimbledon-SF-Andy_Roddick-Andy_Murray,1,S-DTL,13,1,0,1,0,5,8
20090703-M-Wimbledon-SF-Andy_Roddick-Andy_Murray,1,S-IO,2,1,0,0,1,0,2
20090703-M-Wimbledon-SF-Andy_Roddick-Andy_Murray,2,F-XC,64,19,13,2,4,39,25
20090703-M-Wimbledon-SF-Andy_Roddick-Andy_Murray,2,F-DTM,26,2,1,0,1,10,16
20090703-M-Wimbledon-SF-Andy_Roddick-Andy_Murray,2,F-DTL,40,12,7,3,2,28,12
20090703-M-Wimbledon-SF-Andy_Roddick-Andy_Murray,2,F-IO,21,4,1,0,3,12,9
20090703-M-Wimbledon-SF-Andy_Roddick-Andy_Murray,2,F-II,3,1,1,0,0,3,0
20090703-M-Wimbledon-SF-Andy_Roddick-Andy_Murray,2,B-XC,60,13,5,4,4,35,25
20090703-M-Wimbledon-SF-Andy_Roddick-Andy_Murray,2,B-DTM,21,3,1,0,2,10,11
20090703-M-Wimbledon-SF-Andy_Roddick-Andy_Murray,2,B-DTL,21,14,10,3,1,16,5
20090703-M-Wimbledon-SF-Andy_Roddick-Andy_Murray,2,B-IO,1,1,1,0,0,1,0
20090703-M-Wimbledon-SF-Andy_Roddick-Andy_Murray,2,S-XC,47,0,0,0,0,27,20
20090703-M-Wimbledon-SF-Andy_Roddick-Andy_Murray,2,S-DTM,13,0,0,0,0,8,5
20090703-M-Wimbledon-SF-Andy_Roddick-Andy_Murray,2,S-DTL,10,3,0,1,2,4,6
20090703-M-Wimbledon-SF-Andy_Roddick-Andy_Murray,2,S-IO,4,0,0,0,0,4,0
20010126-M-Australian_Open-SF-Patrick_Rafter-Andre_Agassi,1,F-XC,32,12,4,1,7,18,14
20010126-M-Australian_Open-SF-Patrick_Rafter-Andre_Agassi,1,F-DTM,5,0,0,0,0,3,2
20010126-M-Australian_Open-SF-Patrick_Rafter-Andre_Agassi,1,F-DTL,14,7,4,1,2,11,3
20010126-M-Australian_Open-SF-Patrick_Rafter-Andre_Agassi,1,F-IO,5,2,0,2,0,2,3
20010126-M-Australian_Open-SF-Patrick_Rafter-Andre_Agassi,1,F-II,2,1,1,0,0,1,1
20010126-M-Australian_Open-SF-Patrick_Rafter-Andre_Agassi,1,B-XC,21,5,0,0,5,5,16
20010126-M-Australian_Open-SF-Patrick_Rafter-Andre_Agassi,1,B-DTM,6,1,0,0,1,1,5
20010126-M-Australian_Open-SF-Patrick_Rafter-Andre_Agassi,1,B-DTL,10,6,0,0,6,1,9
20010126-M-Australian_Open-SF-Patrick_Rafter-Andre_Agassi,1,B-IO,3,0,0,0,0,0,3
20010126-M-Australian_Open-SF-Patrick_Rafter-Andre_Agassi,1,S-XC,52,8,0,0,8,13,39
20010126-M-Australian_Open-SF-Patrick_Rafter-Andre_Agassi,1,S-DTM,5,0,0,0,0,1,4
20010126-M-Australian_Open-SF-Patrick_Rafter-Andre_Agassi,1,S-DTL,3,0,0,0,0,2,1
20010126-M-Australian_Open-SF-Patrick_Rafter-Andre_Agassi,2,F-XC,38,10,6,3,1,22,16
20010126-M-Australian_Open-SF-Patrick_Rafter-Andre_Agassi,2,F-DTM,11,0,0,0,0,7,4
20010126-M-Australian_Open-SF-Patrick_Rafter-Andre_Agassi,2,F-DTL,14,5,3,1,1,10,4
20010126-M-Australian_Open-SF-Patrick_Rafter-Andre_Agassi,2,F-IO,17,6,2,3,1,13,4
20010126-M-Australian_Open-SF-Patrick_Rafter-Andre_Agassi,2,F-II,6,1,1,0,0,2,4
20010126-M-Australian_Open-SF-Patrick_Rafter-Andre_Agassi,2,B-XC,93,13,5,4,4,68,25
20010126-M-Australian_Open-SF-Patrick_Rafter-Andre_Agassi,2,B-DTM,9,2,0,0,2,4,5
20010126-M-Australian_Open-SF-Patrick_Rafter-Andre_Agassi,2,B-DTL,25,12,11,0,1,15,10
20010126-M-Australian_Open-SF-Patrick_Rafter-Andre_Agassi,2,B-IO,2,2,1,1,0,2,0
20010126-M-Australian_Open-SF-Patrick_Rafter-Andre_Agassi,2,S-XC,5,0,0,0,0,2,3
20181117-M-Tour_Finals-SF-Kevin_Anderson-Novak_Djokovic,1,F-XC,29,7,2,1,4,9,20
20181117-M-Tour_Finals-SF-Kevin_Anderson-Novak_Djokovic,1,F-DTM,15,2,0,0,2,1,14
20181117-M-Tour_Finals-SF-Kevin_Anderson-Novak_Djokovic,1,F-DTL,6,1,0,0,1,1,5
20181117-M-Tour_Finals-SF-Kevin_Anderson-Novak_Djokovic,1,F-IO,16,5,1,1,3,5,11
20181117-M-Tour_Finals-SF-Kevin_Anderson-Novak_Djokovic,1,B-XC,24,5,0,1,4,6,18
20181117-M-Tour_Finals-SF-Kevin_Anderson-Novak_Djokovic,1,B-DTM,12,2,0,0,2,1,11
20181117-M-Tour_Finals-SF-Kevin_Anderson-Novak_Djokovic,1,B-DTL,3,0,0,0,0,0,3
20181117-M-Tour_Finals-SF-Kevin_Anderson-Novak_Djokovic,1,B-IO,3,2,1,0,1,2,1
20181117-M-Tour_Finals-SF-Kevin_Anderson-Novak_Djokovic,1,S-XC,4,1,0,0,1,2,2
20181117-M-Tour_Finals-SF-Kevin_Anderson-Novak_Djokovic,1,S-DTM,5,2,0,0,2,1,4
20181117-M-Tour_Finals-SF-Kevin_Anderson-Novak_Djokovic,1,S-DTL,2,1,0,0,1,0,2
20181117-M-Tour_Finals-SF-Kevin_Anderson-Novak_Djokovic,2,F-XC,21,5,3,1,1,18,3
20181117-M-Tour_Finals-SF-Kevin_Anderson-Novak_Djokovic,2,F-DTM,15,0,0,0,0,12,3
20181117-M-Tour_Finals-SF-Kevin_Anderson-Novak_Djokovic,2,F-DTL,11,3,1,1,1,7,4
20181117-M-Tour_Finals-SF-Kevin_Anderson-Novak_Djokovic,2,F-IO,8,5,3,1,1,7,1
20181117-M-Tour_Finals-SF-Kevin_Anderson-Novak_Djokovic,2,B-XC,25,3,0,0,3,19,6
20181117-M-Tour_Finals-SF-Kevin_Anderson-Novak_Djokovic,2,B-DTM,5,0,0,0,0,3,2
20181117-M-Tour_Finals-SF-Kevin_Anderson-Novak_Djokovic,2,B-DTL,12,9,2,4,3,8,4
20181117-M-Tour_Finals-SF-Kevin_Anderson-Novak_Djokovic,2,S-XC,4,0,0,0,0,4,0
20181117-M-Tour_Finals-SF-Kevin_Anderson-Novak_Djokovic,2,S-DTM,3,0,0,0,0,2,1
20181117-M-Tour_Finals-SF-Kevin_Anderson-Novak_Djokovic,2,S-DTL,2,0,0,0,0,2,0
20181117-M-Tour_Finals-SF-Kevin_Anderson-Novak_Djokovic,2,S-IO,1,0,0,0,0,1,0
20181114-M-Tour_Finals-RR-John_Isner-Marin_Cilic,1,F-XC,18,8,2,2,4,8,10
20181114-M-Tour_Finals-RR-John_Isner-Marin_Cilic,1,F-DTM,9,2,0,0,2,4,5
20181114-M-Tour_Finals-RR-John_Isner-Marin_Cilic,1,F-DTL,7,3,1,0,2,2,5
20181114-M-Tour_Finals-RR-John_Isner-Marin_Cilic,1,F-IO,24,7,3,1,3,15,9
20181114-M-Tour_Finals-RR-John_Isner-Marin_Cilic,1,F-II,8,6,2,3,1,5,3
20181114-M-Tour_Finals-RR-John_Isner-Marin_Cilic,1,B-XC,7,2,0,1,1,1,6
20181114-M-Tour_Finals-RR-John_Isner-Marin_Cilic,1,B-DTM,9,1,0,0,1,1,8
20181114-M-Tour_Finals-RR-John_Isner-Marin_Cilic,1,B-DTL,9,5,0,0,5,0,9
20181114-M-Tour_Finals-RR-John_Isner-Marin_Cilic,1,B-IO,2,1,0,1,0,1,1
20181114-M-Tour_Finals-RR-John_Isner-Marin_Cilic,1,S-XC,9,2,0,1,1,3,6
20181114-M-Tour_Finals-RR-John_Isner-Marin_Cilic,1,S-DTM,8,2,0,0,2,2,6
20181114-M-Tour_Finals-RR-John_Isner-Marin_Cilic,1,S-DTL,7,2,0,1,1,1,6
20181114-M-Tour_Finals-RR-John_Isner-Marin_Cilic,2,F-XC,24,12,5,3,4,19,5
20181114-M-Tour_Finals-RR-John_Isner-Marin_Cilic,2,F-DTM,9,0,0,0,0,7,2
20181114-M-Tour_Finals-RR-John_Isner-Marin_Cilic,2,F-DTL,8,3,2,0,1,6,2
20181114-M-Tour_Finals-RR-John_Isner-Marin_Cilic,2,F-IO,34,12,4,5,3,30,4
20181114-M-Tour_Finals-RR-John_Isner-Marin_Cilic,2,F-II,3,1,1,0,0,3,0
20181114-M-Tour_Finals-RR-John_Isner-Marin_Cilic,2,B-XC,18,5,0,2,3,9,9
20181114-M-Tour_Finals-RR-John_Isner-Marin_Cilic,2,B-DTM,12,5,0,0,5,3,9
20181114-M-Tour_Finals-RR-John_Isner-Marin_Cilic,2,B-DTL,2,2,1,0,1,1,1
20181114-M-Tour_Finals-RR-John_Isner-Marin_Cilic,2,B-IO,1,0,0,0,0,1,0
20181114-M-Tour_Finals-RR-John_Isner-Marin_Cilic,2,S-XC,3,0,0,0,0,2,1
20181114-M-Tour_Finals-RR-John_Isner-Marin_Cilic,2,S-DTM,4,0,0,0,0,3,1
20181114-M-Tour_Finals-RR-John_Isner-Marin_Cilic,2,S-DTL,1,0,0,0,0,0,1
20190102-M-Doha-R16-Nicolas_Jarry-Stanislas_Wawrinka,1,F-XC,36,11,1,3,7,9,27
20190102-M-Doha-R16-Nicolas_Jarry-Stanislas_Wawrinka,1,F-DTM,7,0,0,0,0,3,4
20190102-M-Doha-R16-Nicolas_Jarry-Stanislas_Wawrinka,1,F-DTL,7,4,2,0,2,3,4
20190102-M-Doha-R16-Nicolas_Jarry-Stanislas_Wawrinka,1,F-IO,17,8,4,0,4,10,7
20190102-M-Doha-R16-Nicolas_Jarry-Stanislas_Wawrinka,1,F-II,2,2,0,1,1,1,1
20190102-M-Doha-R16-Nicolas_Jarry-Stanislas_Wawrinka,1,B-XC,20,5,2,0,3,6,14
20190102-M-Doha-R16-Nicolas_Jarry-Stanislas_Wawrinka,1,B-DTM,6,1,0,0,1,3,3
20190102-M-Doha-R16-Nicolas_Jarry-Stanislas_Wawrinka,1,B-DTL,13,3,1,0,2,5,8
20190102-M-Doha-R16-Nicolas_Jarry-Stanislas_Wawrinka,1,B-IO,1,0,0,0,0,0,1
20190102-M-Doha-R16-Nicolas_Jarry-Stanislas_Wawrinka,1,S-XC,6,2,0,0,2,2,4
20190102-M-Doha-R16-Nicolas_Jarry-Stanislas_Wawrinka,1,S-DTM,6,0,0,0,0,2,4
20190102-M-Doha-R16-Nicolas_Jarry-Stanislas_Wawrinka,1,S-DTL,3,2,0,1,1,1,2
20190102-M-Doha-R16-Nicolas_Jarry-Stanislas_Wawrinka,1,S-IO,1,1,0,0,1,0,1
20190102-M-Doha-R16-Nicolas_Jarry-Stanislas_Wawrinka,2,F-XC,27,8,1,5,2,23,4
20190102-M-Doha-R16-Nicolas_Jarry-Stanislas_Wawrinka,2,F-DTM,9,0,0,0,0,5,4
20190102-M-Doha-R16-Nicolas_Jarry-Stanislas_Wawrinka,2,F-DTL,14,6,2,2,2,10,4
20190102-M-Doha-R16-Nicolas_Jarry-Stanislas_Wawrinka,2,F-IO,7,2,1,0,1,4,3
20190102-M-Doha-R16-Nicolas_Jarry-Stanislas_Wawrinka,2,B-XC,12,1,0,1,0,10,2
20190102-M-Doha-R16-Nicolas_Jarry-Stanislas_Wawrinka,2,B-DTM,9,0,0,0,0,7,2
20190102-M-Doha-R16-Nicolas_Jarry-Stanislas_Wawrinka,2,B-DTL,4,1,0,0,1,1,3
20190102-M-Doha-R16-Nicolas_Jarry-Stanislas_Wawrinka,2,B-IO,1,1,0,0,1,0,1
20190102-M-Doha-R16-Nicolas_Jarry-Stanislas_Wawrinka,2,S-XC,19,0,0,0,0,11,8
20190102-M-Doha-R16-Nicolas_Jarry-Stanislas_Wawrinka,2,S-DTM,9,0,0,0,0,5,4
20190102-M-Doha-R16-Nicolas_Jarry-Stanislas_Wawrinka,2,S-DTL,1,1,1,0,0,1,0
20190102-M-Doha-R16-Nicolas_Jarry-Stanislas_Wawrinka,2,S-II,1,0,0,0,0,0,1
20190102-M-Brisbane-R16-Grigor_Dimitrov-John_Millman,1,F-XC,50,11,5,3,3,26,24
20190102-M-Brisbane-R16-Grigor_Dimitrov-John_Millman,1,F-DTM,42,2,0,1,1,19,23
20190102-M-Brisbane-R16-Grigor_Dimitrov-John_Millman,1,F-DTL,9,2,1,0,1,7,2
20190102-M-Brisbane-R16-Grigor_Dimitrov-John_Millman,1,F-IO,42,8,6,1,1,32,10
20190102-M-Brisbane-R16-Grigor_Dimitrov-John_Millman,1,F-II,4,2,0,2,0,3,1
20190102-M-Brisbane-R16-Grigor_Dimitrov-John_Millman,1,B-XC,17,4,1,2,1,8,9
20190102-M-Brisbane-R16-Grigor_Dimitrov-John_Millman,1,B-DTM,21,2,0,0,2,11,10
20190102-M-Brisbane-R16-Grigor_Dimitrov-John_Millman,1,B-DTL,6,5,2,2,1,5,1
20190102-M-Brisbane-R16-Grigor_Dimitrov-John_Millman,1,B-IO,3,2,0,1,1,1,2
20190102-M-Brisbane-R16-Grigor_Dimitrov-John_Millman,1,S-XC,24,1,0,0,1,10,14
20190102-M-Brisbane-R16-Grigor_Dimitrov-John_Millman,1,S-DTM,32,0,0,0,0,19,13
20190102-M-Brisbane-R16-Grigor_Dimitrov-John_Millman,1,S-DTL,10,1,0,0,1,5,5
20190102-M-Brisbane-R16-Grigor_Dimitrov-John_Millman,1,S-IO,4,0,0,0,0,1,3
20190102-M-Brisbane-R16-Grigor_Dimitrov-John_Millman,2,F-XC,48,9,3,3,3,29,19
20190102-M-Brisbane-R16-Grigor_Dimitrov-John_Millman,2,F-DTM,43,1,0,0,1,14,29
20190102-M-Brisbane-R16-Grigor_Dimitrov-John_Millman,2,F-DTL,9,3,2,1,0,6,3
20190102-M-Brisbane-R16-Grigor_Dimitrov-John_Millman,2,F-IO,17,4,1,1,2,8,9
20190102-M-Brisbane-R16-Grigor_Dimitrov-John_Millman,2,F-II,1,1,0,1,0,1,0
20190102-M-Brisbane-R16-Grigor_Dimitrov-John_Millman,2,B-XC,74,7,0,3,4,31,43
20190102-M-Brisbane-R16-Grigor_Dimitrov-John_Millman,2,B-DTM,55,2,0,0,2,25,30
20190102-M-Brisbane-R16-Grigor_Dimitrov-John_Millman,2,B-DTL,5,2,0,1,1,2,3
20190102-M-Brisbane-R16-Grigor_Dimitrov-John_Millman,2,B-IO,8,4,3,1,0,6,2
20190102-M-Brisbane-R16-Grigor_Dimitrov-John_Millman,2,S-DTM,3,0,0,0,0,1,2
20190102-M-Doha-R16-Nikoloz_Basilashvili-Andrey_Rublev,1,F-XC,19,11,4,5,2,15,4
20190102-M-Doha-R16-Nikoloz_Basilashvili-Andrey_Rublev,1,F-DTM,23,4,0,0,4,11,12
20190102-M-Doha-R16-Nikoloz_Basilashvili-Andrey_Rublev,1,F-DTL,5,0,0,0,0,4,1
20190102-M-Doha-R16-Nikoloz_Basilashvili-Andrey_Rublev,1,F-IO,14,9,4,3,2,12,2
20190102-M-Doha-R16-Nikoloz_Basilashvili-Andrey_Rublev,1,B-XC,9,1,0,0,1,7,2
20190102-M-Doha-R16-Nikoloz_Basilashvili-Andrey_Rublev,1,B-DTM,13,0,0,0,0,3,10
20190102-M-Doha-R16-Nikoloz_Basilashvili-Andrey_Rublev,1,B-DTL,1,1,0,0,1,0,1
20190102-M-Doha-R16-Nikoloz_Basilashvili-Andrey_Rublev,2,F-XC,12,4,1,2,1,6,6
20190102-M-Doha-R16-Nikoloz_Basilashvili-Andrey_Rublev,2,F-DTM,19,3,0,1,2,7,12
20190102-M-Doha-R16-Nikoloz_Basilashvili-Andrey_Rublev,2,F-DTL,3,3,1,0,2,1,2
20190102-M-Doha-R16-Nikoloz_Basilashvili-Andrey_Rublev,2,F-IO,14,7,2,1,4,7,7
20190102-M-Doha-R16-Nikoloz_Basilashvili-Andrey_Rublev,2,B-XC,4,2,0,0,2,0,4
20190102-M-Doha-R16-Nikoloz_Basilashvili-Andrey_Rublev,2,B-DTM,23,2,1,0,1,8,15
20190102-M-Doha-R16-Nikoloz_Basilashvili-Andrey_Rublev,2,B-DTL,2,2,1,0,1,1,1
20190102-M-Doha-R16-Nikoloz_Basilashvili-Andrey_Rublev,2,B-IO,2,1,0,0,1,1,1
20190102-M-Doha-R16-Nikoloz_Basilashvili-Andrey_Rublev,2,S-DTM,4,0,0,0,0,0,4
20190102-M-Doha-R16-Nikoloz_Basilashvili-Andrey_Rublev,2,S-DTL,1,0,0,0,0,0,1
20130705-M-Wimbledon-SF-Novak_Djokovic-Juan_Martin_Del_Potro,1,F-XC,94,20,1,10,9,51,43
20130705-M-Wimbledon-SF-Novak_Djokovic-Juan_Martin_Del_Potro,1,F-DTM,35,4,0,1,3,17,18
20130705-M-Wimbledon-SF-Novak_Djokovic-Juan_Martin_Del_Potro,1,F-DTL,47,10,2,1,7,18,29
20130705-M-Wimbledon-SF-Novak_Djokovic-Juan_Martin_Del_Potro,1,F-IO,48,15,12,1,2,29,19
20130705-M-Wimbledon-SF-Novak_Djokovic-Juan_Martin_Del_Potro,1,F-II,9,5,1,3,1,6,3
20130705-M-Wimbledon-SF-Novak_Djokovic-Juan_Martin_Del_Potro,1,B-XC,174,16,5,4,7,79,95
20130705-M-Wimbledon-SF-Novak_Djokovic-Juan_Martin_Del_Potro,1,B-DTM,41,4,0,2,2,11,30
20130705-M-Wimbledon-SF-Novak_Djokovic-Juan_Martin_Del_Potro,1,B-DTL,55,28,8,6,14,27,28
20130705-M-Wimbledon-SF-Novak_Djokovic-Juan_Martin_Del_Potro,1,B-IO,10,2,0,0,2,4,6
20130705-M-Wimbledon-SF-Novak_Djokovic-Juan_Martin_Del_Potro,1,S-XC,20,1,0,1,0,8,12
20130705-M-Wimbledon-SF-Novak_Djokovic-Juan_Martin_Del_Potro,1,S-DTM,7,1,0,1,0,4,3
20130705-M-Wimbledon-SF-Novak_Djokovic-Juan_Martin_Del_Potro,1,S-DTL,3,0,0,0,0,0,3
20130705-M-Wimbledon-SF-Novak_Djokovic-Juan_Martin_Del_Potro,2,F-XC,130,28,9,9,10,77,53
20130705-M-Wimbledon-SF-Novak_Djokovic-Juan_Martin_Del_Potro,2,F-DTM,32,3,0,1,2,15,17
20130705-M-Wimbledon-SF-Novak_Djokovic-Juan_Martin_Del_Potro,2,F-DTL,31,9,6,2,1,17,14
20130705-M-Wimbledon-SF-Novak_Djokovic-Juan_Martin_Del_Potro,2,F-IO,71,10,3,3,4,45,26
20130705-M-Wimbledon-SF-Novak_Djokovic-Juan_Martin_Del_Potro,2,F-II,17,8,3,1,4,5,12
20130705-M-Wimbledon-SF-Novak_Djokovic-Juan_Martin_Del_Potro,2,B-XC,159,16,1,8,7,92,67
20130705-M-Wimbledon-SF-Novak_Djokovic-Juan_Martin_Del_Potro,2,B-DTM,29,3,0,2,1,17,12
20130705-M-Wimbledon-SF-Novak_Djokovic-Juan_Martin_Del_Potro,2,B-DTL,50,18,6,8,4,32,18
20130705-M-Wimbledon-SF-Novak_Djokovic-Juan_Martin_Del_Potro,2,B-IO,4,0,0,0,0,0,4
20130705-M-Wimbledon-SF-Novak_Djokovic-Juan_Martin_Del_Potro,2,S-XC,33,0,0,0,0,17,16
20130705-M-Wimbledon-SF-Novak_Djokovic-Juan_Martin_Del_Potro,2,S-DTM,7,0,0,0,0,2,5
20130705-M-Wimbledon-SF-Novak_Djokovic-Juan_Martin_Del_Potro,2,S-DTL,2,1,1,0,0,1,1
20130705-M-Wimbledon-SF-Novak_Djokovic-Juan_Martin_Del_Potro,2,S-IO,1,0,0,0,0,0,1
20181115-M-Tour_Finals-RR-Kevin_Anderson-Roger_Federer,1,F-XC,24,3,0,0,3,7,17
20181115-M-Tour_Finals-RR-Kevin_Anderson-Roger_Federer,1,F-DTM,12,1,0,0,1,4,8
20181115-M-Tour_Finals-RR-Kevin_Anderson-Roger_Federer,1,F-DTL,6,3,0,1,2,3,3
20181115-M-Tour_Finals-RR-Kevin_Anderson-Roger_Federer,1,F-IO,20,7,1,1,5,4,16
20181115-M-Tour_Finals-RR-Kevin_Anderson-Roger_Federer,1,F-II,4,2,1,0,1,1,3
20181115-M-Tour_Finals-RR-Kevin_Anderson-Roger_Federer,1,B-XC,20,3,0,1,2,8,12
20181115-M-Tour_Finals-RR-Kevin_Anderson-Roger_Federer,1,B-DTM,12,2,0,0,2,7,5
20181115-M-Tour_Finals-RR-Kevin_Anderson-Roger_Federer,1,B-DTL,5,3,0,1,2,2,3
20181115-M-Tour_Finals-RR-Kevin_Anderson-Roger_Federer,1,B-IO,2,2,0,1,1,1,1
20181115-M-Tour_Finals-RR-Kevin_Anderson-Roger_Federer,1,S-XC,10,1,0,0,1,1,9
20181115-M-Tour_Finals-RR-Kevin_Anderson-Roger_Federer,1,S-DTM,3,0,0,0,0,0,3
20181115-M-Tour_Finals-RR-Kevin_Anderson-Roger_Federer,1,S-IO,1,0,0,0,0,0,1
20181115-M-Tour_Finals-RR-Kevin_Anderson-Roger_Federer,2,F-XC,25,4,2,2,0,16,9
20181115-M-Tour_Finals-RR-Kevin_Anderson-Roger_Federer,2,F-DTM,14,2,0,0,2,8,6
20181115-M-Tour_Finals-RR-Kevin_Anderson-Roger_Federer,2,F-DTL,9,4,1,0,3,6,3
20181115-M-Tour_Finals-RR-Kevin_Anderson-Roger_Federer,2,F-IO,13,4,2,1,1,7,6
20181115-M-Tour_Finals-RR-Kevin_Anderson-Roger_Federer,2,F-II,2,1,0,0,1,1,1
20181115-M-Tour_Finals-RR-Kevin_Anderson-Roger_Federer,2,B-XC,11,3,0,0,3,6,5
20181115-M-Tour_Finals-RR-Kevin_Anderson-Roger_Federer,2,B-DTM,14,3,0,1,2,9,5
20181115-M-Tour_Finals-RR-Kevin_Anderson-Roger_Federer,2,B-DTL,3,2,2,0,0,2,1
20181115-M-Tour_Finals-RR-Kevin_Anderson-Roger_Federer,2,B-IO,2,2,1,0,1,1,1
20181115-M-Tour_Finals-RR-Kevin_Anderson-Roger_Federer,2,S-XC,10,1,0,1,0,8,2
20181115-M-Tour_Finals-RR-Kevin_Anderson-Roger_Federer,2,S-DTM,4,0,0,0,0,3,1
20181115-M-Tour_Finals-RR-Kevin_Anderson-Roger_Federer,2,S-DTL,3,0,0,0,0,3,0
20190104-M-Brisbane-QF-Alex_De_Minaur-Jo_Wilfried_Tsonga,1,F-XC,31,4,3,0,1,18,13
20190104-M-Brisbane-QF-Alex_De_Minaur-Jo_Wilfried_Tsonga,1,F-DTM,11,0,0,0,0,3,8
20190104-M-Brisbane-QF-Alex_De_Minaur-Jo_Wilfried_Tsonga,1,F-DTL,12,0,0,0,0,7,5
20190104-M-Brisbane-QF-Alex_De_Minaur-Jo_Wilfried_Tsonga,1,F-IO,56,13,3,5,5,30,26
20190104-M-Brisbane-QF-Alex_De_Minaur-Jo_Wilfried_Tsonga,1,F-II,7,3,2,0,1,5,2
20190104-M-Brisbane-QF-Alex_De_Minaur-Jo_Wilfried_Tsonga,1,B-XC,51,4,1,2,1,30,21
20190104-M-Brisbane-QF-Alex_De_Minaur-Jo_Wilfried_Tsonga,1,B-DTM,12,1,0,0,1,3,9
20190104-M-Brisbane-QF-Alex_De_Minaur-Jo_Wilfried_Tsonga,1,B-DTL,5,1,0,0,1,1,4
20190104-M-Brisbane-QF-Alex_De_Minaur-Jo_Wilfried_Tsonga,1,B-IO,1,0,0,0,0,1,0
20190104-M-Brisbane-QF-Alex_De_Minaur-Jo_Wilfried_Tsonga,1,S-XC,4,0,0,0,0,1,3
20190104-M-Brisbane-QF-Alex_De_Minaur-Jo_Wilfried_Tsonga,1,S-DTL,2,0,0,0,0,1,1
20190104-M-Brisbane-QF-Alex_De_Minaur-Jo_Wilfried_Tsonga,2,F-XC,32,14,5,6,3,18,14
20190104-M-Brisbane-QF-Alex_De_Minaur-Jo_Wilfried_Tsonga,2,F-DTM,6,0,0,0,0,2,4
20190104-M-Brisbane-QF-Alex_De_Minaur-Jo_Wilfried_Tsonga,2,F-DTL,12,4,0,1,3,6,6
20190104-M-Brisbane-QF-Alex_De_Minaur-Jo_Wilfried_Tsonga,2,F-IO,37,13,4,5,4,26,11
20190104-M-Brisbane-QF-Alex_De_Minaur-Jo_Wilfried_Tsonga,2,F-II,18,10,6,1,3,11,7
20190104-M-Brisbane-QF-Alex_De_Minaur-Jo_Wilfried_Tsonga,2,B-XC,24,2,2,0,0,17,7
20190104-M-Brisbane-QF-Alex_De_Minaur-Jo_Wilfried_Tsonga,2,B-DTM,16,3,0,0,3,3,13
20190104-M-Brisbane-QF-Alex_De_Minaur-Jo_Wilfried_Tsonga,2,B-DTL,12,6,1,2,3,5,7
20190104-M-Brisbane-QF-Alex_De_Minaur-Jo_Wilfried_Tsonga,2,B-IO,1,0,0,0,0,1,0
20190104-M-Brisbane-QF-Alex_De_Minaur-Jo_Wilfried_Tsonga,2,S-XC,29,3,0,0,3,10,19
20190104-M-Brisbane-QF-Alex_De_Minaur-Jo_Wilfried_Tsonga,2,S-DTM,5,0,0,0,0,2,3
20190104-M-Brisbane-QF-Alex_De_Minaur-Jo_Wilfried_Tsonga,2,S-DTL,3,0,0,0,0,2,1
20190104-M-Brisbane-QF-Alex_De_Minaur-Jo_Wilfried_Tsonga,2,S-IO,2,0,0,0,0,2,0
20190103-M-Doha-QF-Novak_Djokovic-Nikoloz_Basilashvili,1,F-XC,36,6,0,2,4,17,19
20190103-M-Doha-QF-Novak_Djokovic-Nikoloz_Basilashvili,1,F-DTM,21,2,0,0,2,12,9
20190103-M-Doha-QF-Novak_Djokovic-Nikoloz_Basilashvili,1,F-DTL,12,1,0,0,1,9,3
20190103-M-Doha-QF-Novak_Djokovic-Nikoloz_Basilashvili,1,F-IO,20,5,2,2,1,12,8
20190103-M-Doha-QF-Novak_Djokovic-Nikoloz_Basilashvili,1,B-XC,70,3,0,3,0,42,28
20190103-M-Doha-QF-Novak_Djokovic-Nikoloz_Basilashvili,1,B-DTM,34,1,0,0,1,23,11
20190103-M-Doha-QF-Novak_Djokovic-Nikoloz_Basilashvili,1,B-DTL,16,9,1,3,5,6,10
20190103-M-Doha-QF-Novak_Djokovic-Nikoloz_Basilashvili,1,B-IO,4,1,0,1,0,1,3
20190103-M-Doha-QF-Novak_Djokovic-Nikoloz_Basilashvili,1,S-XC,7,1,0,0,1,4,3
20190103-M-Doha-QF-Novak_Djokovic-Nikoloz_Basilashvili,1,S-DTM,9,0,0,0,0,5,4
20190103-M-Doha-QF-Novak_Djokovic-Nikoloz_Basilashvili,1,S-DTL,1,0,0,0,0,1,0
20190103-M-Doha-QF-Novak_Djokovic-Nikoloz_Basilashvili,2,F-XC,58,17,4,4,9,26,32
20190103-M-Doha-QF-Novak_Djokovic-Nikoloz_Basilashvili,2,F-DTM,20,0,0,0,0,10,10
20190103-M-Doha-QF-Novak_Djokovic-Nikoloz_Basilashvili,2,F-DTL,11,2,1,1,0,8,3
20190103-M-Doha-QF-Novak_Djokovic-Nikoloz_Basilashvili,2,F-IO,50,16,6,2,8,19,31
20190103-M-Doha-QF-Novak_Djokovic-Nikoloz_Basilashvili,2,F-II,5,4,1,1,2,3,2
20190103-M-Doha-QF-Novak_Djokovic-Nikoloz_Basilashvili,2,B-XC,65,10,3,2,5,27,38
20190103-M-Doha-QF-Novak_Djokovic-Nikoloz_Basilashvili,2,B-DTM,26,3,0,0,3,8,18
20190103-M-Doha-QF-Novak_Djokovic-Nikoloz_Basilashvili,2,B-DTL,11,4,0,3,1,8,3
20190103-M-Doha-QF-Novak_Djokovic-Nikoloz_Basilashvili,2,B-IO,5,3,0,1,2,1,4
20190103-M-Doha-QF-Novak_Djokovic-Nikoloz_Basilashvili,2,B-II,1,0,0,0,0,0,1
20190103-M-Doha-QF-Novak_Djokovic-Nikoloz_Basilashvili,2,S-XC,2,0,0,0,0,1,1
20190103-M-Doha-QF-Novak_Djokovic-Nikoloz_Basilashvili,2,S-DTM,1,0,0,0,0,1,0
20190103-M-Doha-QF-Novak_Djokovic-Nikoloz_Basilashvili,2,S-DTL,2,0,0,0,0,0,2
20190103-M-Doha-QF-Novak_Djokovic-Nikoloz_Basilashvili,2,S-IO,1,1,0,0,1,0,1
20190102-M-Pune-R16-Ernests_Gulbis-Hyeon_Chung,1,F-XC,19,8,2,2,4,7,12
20190102-M-Pune-R16-Ernests_Gulbis-Hyeon_Chung,1,F-DTM,11,3,0,0,3,4,7
20190102-M-Pune-R16-Ernests_Gulbis-Hyeon_Chung,1,F-DTL,12,3,0,1,2,6,6
20190102-M-Pune-R16-Ernests_Gulbis-Hyeon_Chung,1,F-IO,6,3,0,0,3,2,4
20190102-M-Pune-R16-Ernests_Gulbis-Hyeon_Chung,1,B-XC,56,12,2,3,7,20,36
20190102-M-Pune-R16-Ernests_Gulbis-Hyeon_Chung,1,B-DTM,22,1,0,0,1,9,13
20190102-M-Pune-R16-Ernests_Gulbis-Hyeon_Chung,1,B-DTL,8,3,2,0,1,5,3
20190102-M-Pune-R16-Ernests_Gulbis-Hyeon_Chung,1,B-IO,16,4,0,2,2,6,10
20190102-M-Pune-R16-Ernests_Gulbis-Hyeon_Chung,1,S-XC,2,0,0,0,0,0,2
20190102-M-Pune-R16-Ernests_Gulbis-Hyeon_Chung,1,S-DTM,1,0,0,0,0,1,0
20190102-M-Pune-R16-Ernests_Gulbis-Hyeon_Chung,2,F-XC,25,7,0,4,3,14,11
20190102-M-Pune-R16-Ernests_Gulbis-Hyeon_Chung,2,F-DTM,20,1,0,0,1,13,7
20190102-M-Pune-R16-Ernests_Gulbis-Hyeon_Chung,2,F-DTL,3,1,1,0,0,1,2
20190102-M-Pune-R16-Ernests_Gulbis-Hyeon_Chung,2,F-IO,7,3,2,0,1,5,2
20190102-M-Pune-R16-Ernests_Gulbis-Hyeon_Chung,2,F-II,2,0,0,0,0,1,1
20190102-M-Pune-R16-Ernests_Gulbis-Hyeon_Chung,2,B-XC,42,7,1,2,4,25,17
20190102-M-Pune-R16-Ernests_Gulbis-Hyeon_Chung,2,B-DTM,41,3,0,0,3,25,16
20190102-M-Pune-R16-Ernests_Gulbis-Hyeon_Chung,2,B-DTL,14,6,0,2,4,7,7
20190102-M-Pune-R16-Ernests_Gulbis-Hyeon_Chung,2,B-IO,3,0,0,0,0,0,3
20190102-M-Pune-R16-Ernests_Gulbis-Hyeon_Chung,2,S-DTL,1,0,0,0,0,0,1
20190104-M-Doha-SF-Marco_Cecchinato-Tomas_Berdych,1,F-XC,24,11,2,3,6,11,13
20190104-M-Doha-SF-Marco_Cecchinato-Tomas_Berdych,1,F-DTM,9,0,0,0,0,2,7
20190104-M-Doha-SF-Marco_Cecchinato-Tomas_Berdych,1,F-DTL,8,3,1,1,1,3,5
20190104-M-Doha-SF-Marco_Cecchinato-Tomas_Berdych,1,F-IO,27,10,4,0,6,15,12
20190104-M-Doha-SF-Marco_Cecchinato-Tomas_Berdych,1,F-II,4,4,1,1,2,2,2
20190104-M-Doha-SF-Marco_Cecchinato-Tomas_Berdych,1,B-XC,17,4,1,1,2,6,11
20190104-M-Doha-SF-Marco_Cecchinato-Tomas_Berdych,1,B-DTM,11,1,0,0,1,3,8
20190104-M-Doha-SF-Marco_Cecchinato-Tomas_Berdych,1,B-DTL,7,2,2,0,0,3,4
20190104-M-Doha-SF-Marco_Cecchinato-Tomas_Berdych,1,B-IO,1,0,0,0,0,0,1
20190104-M-Doha-SF-Marco_Cecchinato-Tomas_Berdych,1,S-XC,11,1,0,0,1,4,7
20190104-M-Doha-SF-Marco_Cecchinato-Tomas_Berdych,1,S-DTM,6,1,0,0,1,0,6
20190104-M-Doha-SF-Marco_Cecchinato-Tomas_Berdych,1,S-II,1,0,0,0,0,1,0
20190104-M-Doha-SF-Marco_Cecchinato-Tomas_Berdych,2,F-XC,21,8,3,2,3,15,6
20190104-M-Doha-SF-Marco_Cecchinato-Tomas_Berdych,2,F-DTM,8,1,0,0,1,7,1
20190104-M-Doha-SF-Marco_Cecchinato-Tomas_Berdych,2,F-DTL,6,4,1,0,3,3,3
20190104-M-Doha-SF-Marco_Cecchinato-Tomas_Berdych,2,F-IO,21,2,2,0,0,17,4
20190104-M-Doha-SF-Marco_Cecchinato-Tomas_Berdych,2,F-II,6,4,2,1,1,4,2
20190104-M-Doha-SF-Marco_Cecchinato-Tomas_Berdych,2,B-XC,19,3,0,0,3,11,8
20190104-M-Doha-SF-Marco_Cecchinato-Tomas_Berdych,2,B-DTM,7,1,0,0,1,4,3
20190104-M-Doha-SF-Marco_Cecchinato-Tomas_Berdych,2,B-DTL,6,4,2,1,1,4,2
20190104-M-Doha-SF-Marco_Cecchinato-Tomas_Berdych,2,B-IO,1,0,0,0,0,0,1
20190104-M-Doha-SF-Marco_Cecchinato-Tomas_Berdych,2,S-XC,12,0,0,0,0,4,8
20190104-M-Doha-SF-Marco_Cecchinato-Tomas_Berdych,2,S-DTM,4,0,0,0,0,0,4
20190104-M-Doha-SF-Marco_Cecchinato-Tomas_Berdych,2,S-DTL,4,0,0,0,0,2,2
19990129-M-Australian_Open-SF-Yevgeny_Kafelnikov-Tommy_Haas,1,F-XC,57,11,4,5,2,41,16
19990129-M-Australian_Open-SF-Yevgeny_Kafelnikov-Tommy_Haas,1,F-DTM,13,0,0,0,0,9,4
19990129-M-Australian_Open-SF-Yevgeny_Kafelnikov-Tommy_Haas,1,F-DTL,28,5,2,1,2,12,16
19990129-M-Australian_Open-SF-Yevgeny_Kafelnikov-Tommy_Haas,1,F-IO,32,7,2,3,2,20,12
19990129-M-Australian_Open-SF-Yevgeny_Kafelnikov-Tommy_Haas,1,F-II,8,1,0,0,1,3,5
19990129-M-Australian_Open-SF-Yevgeny_Kafelnikov-Tommy_Haas,1,B-XC,64,8,1,3,4,37,27
19990129-M-Australian_Open-SF-Yevgeny_Kafelnikov-Tommy_Haas,1,B-DTM,11,0,0,0,0,6,5
19990129-M-Australian_Open-SF-Yevgeny_Kafelnikov-Tommy_Haas,1,B-DTL,16,3,0,1,2,4,12
19990129-M-Australian_Open-SF-Yevgeny_Kafelnikov-Tommy_Haas,1,B-IO,1,0,0,0,0,0,1
19990129-M-Australian_Open-SF-Yevgeny_Kafelnikov-Tommy_Haas,1,S-XC,27,1,0,0,1,22,5
19990129-M-Australian_Open-SF-Yevgeny_Kafelnikov-Tommy_Haas,1,S-DTM,3,0,0,0,0,2,1
19990129-M-Australian_Open-SF-Yevgeny_Kafelnikov-Tommy_Haas,1,S-DTL,3,1,1,0,0,1,2
19990129-M-Australian_Open-SF-Yevgeny_Kafelnikov-Tommy_Haas,1,S-IO,1,0,0,0,0,0,1
19990129-M-Australian_Open-SF-Yevgeny_Kafelnikov-Tommy_Haas,2,F-XC,51,10,3,3,4,28,23
19990129-M-Australian_Open-SF-Yevgeny_Kafelnikov-Tommy_Haas,2,F-DTM,16,2,0,0,2,2,14
19990129-M-Australian_Open-SF-Yevgeny_Kafelnikov-Tommy_Haas,2,F-DTL,21,7,3,0,4,10,11
19990129-M-Australian_Open-SF-Yevgeny_Kafelnikov-Tommy_Haas,2,F-IO,20,5,0,3,2,5,15
19990129-M-Australian_Open-SF-Yevgeny_Kafelnikov-Tommy_Haas,2,F-II,6,3,0,1,2,2,4
19990129-M-Australian_Open-SF-Yevgeny_Kafelnikov-Tommy_Haas,2,B-XC,58,5,1,1,3,28,30
19990129-M-Australian_Open-SF-Yevgeny_Kafelnikov-Tommy_Haas,2,B-DTM,31,7,0,0,7,9,22
19990129-M-Australian_Open-SF-Yevgeny_Kafelnikov-Tommy_Haas,2,B-DTL,25,7,5,0,2,12,13
19990129-M-Australian_Open-SF-Yevgeny_Kafelnikov-Tommy_Haas,2,B-IO,1,0,0,0,0,0,1
19990129-M-Australian_Open-SF-Yevgeny_Kafelnikov-Tommy_Haas,2,S-XC,32,3,0,1,2,12,20
19990129-M-Australian_Open-SF-Yevgeny_Kafelnikov-Tommy_Haas,2,S-DTM,4,0,0,0,0,2,2
19990129-M-Australian_Open-SF-Yevgeny_Kafelnikov-Tommy_Haas,2,S-DTL,4,0,0,0,0,1,3
20110916-M-Davis_Cup_World_Group_SF-RR-Richard_Gasquet-Rafael_Nadal,1,F-XC,41,10,2,3,5,18,23
20110916-M-Davis_Cup_World_Group_SF-RR-Richard_Gasquet-Rafael_Nadal,1,F-DTM,14,3,0,0,3,1,13
20110916-M-Davis_Cup_World_Group_SF-RR-Richard_Gasquet-Rafael_Nadal,1,F-DTL,9,4,2,0,2,5,4
20110916-M-Davis_Cup_World_Group_SF-RR-Richard_Gasquet-Rafael_Nadal,1,F-IO,11,5,3,0,2,9,2
20110916-M-Davis_Cup_World_Group_SF-RR-Richard_Gasquet-Rafael_Nadal,1,F-II,4,1,1,0,0,2,2
20110916-M-Davis_Cup_World_Group_SF-RR-Richard_Gasquet-Rafael_Nadal,1,B-XC,46,10,2,2,6,20,26
20110916-M-Davis_Cup_World_Group_SF-RR-Richard_Gasquet-Rafael_Nadal,1,B-DTM,17,1,0,0,1,7,10
20110916-M-Davis_Cup_World_Group_SF-RR-Richard_Gasquet-Rafael_Nadal,1,B-DTL,18,2,0,1,1,7,11
20110916-M-Davis_Cup_World_Group_SF-RR-Richard_Gasquet-Rafael_Nadal,1,B-IO,2,1,0,1,0,2,0
20110916-M-Davis_Cup_World_Group_SF-RR-Richard_Gasquet-Rafael_Nadal,1,S-XC,4,0,0,0,0,1,3
20110916-M-Davis_Cup_World_Group_SF-RR-Richard_Gasquet-Rafael_Nadal,1,S-DTM,3,0,0,0,0,1,2
20110916-M-Davis_Cup_World_Group_SF-RR-Richard_Gasquet-Rafael_Nadal,1,S-DTL,2,0,0,0,0,1,1
20110916-M-Davis_Cup_World_Group_SF-RR-Richard_Gasquet-Rafael_Nadal,1,S-IO,1,0,0,0,0,0,1
20110916-M-Davis_Cup_World_Group_SF-RR-Richard_Gasquet-Rafael_Nadal,2,F-XC,57,9,2,5,2,37,20
20110916-M-Davis_Cup_World_Group_SF-RR-Richard_Gasquet-Rafael_Nadal,2,F-DTM,10,0,0,0,0,6,4
20110916-M-Davis_Cup_World_Group_SF-RR-Richard_Gasquet-Rafael_Nadal,2,F-DTL,19,9,4,2,3,10,9
20110916-M-Davis_Cup_World_Group_SF-RR-Richard_Gasquet-Rafael_Nadal,2,F-IO,27,12,4,5,3,18,9
20110916-M-Davis_Cup_World_Group_SF-RR-Richard_Gasquet-Rafael_Nadal,2,F-II,12,6,3,0,3,6,6
20110916-M-Davis_Cup_World_Group_SF-RR-Richard_Gasquet-Rafael_Nadal,2,B-XC,27,8,5,3,0,23,4
20110916-M-Davis_Cup_World_Group_SF-RR-Richard_Gasquet-Rafael_Nadal,2,B-DTM,4,0,0,0,0,2,2
20110916-M-Davis_Cup_World_Group_SF-RR-Richard_Gasquet-Rafael_Nadal,2,B-DTL,15,4,0,2,2,7,8
20110916-M-Davis_Cup_World_Group_SF-RR-Richard_Gasquet-Rafael_Nadal,2,B-IO,1,1,0,1,0,1,0
20110916-M-Davis_Cup_World_Group_SF-RR-Richard_Gasquet-Rafael_Nadal,2,S-XC,1,1,0,1,0,1,0
20110916-M-Davis_Cup_World_Group_SF-RR-Richard_Gasquet-Rafael_Nadal,2,S-DTL,2,0,0,0,0,0,2
20110918-M-Davis_Cup_World_Group_SF-RR-Jo_Wilfried_Tsonga-Rafael_Nadal,1,F-XC,38,8,1,3,4,9,29
20110918-M-Davis_Cup_World_Group_SF-RR-Jo_Wilfried_Tsonga-Rafael_Nadal,1,F-DTM,10,2,0,0,2,0,10
20110918-M-Davis_Cup_World_Group_SF-RR-Jo_Wilfried_Tsonga-Rafael_Nadal,1,F-DTL,8,5,2,0,3,2,6
20110918-M-Davis_Cup_World_Group_SF-RR-Jo_Wilfried_Tsonga-Rafael_Nadal,1,F-IO,28,14,3,2,9,12,16
20110918-M-Davis_Cup_World_Group_SF-RR-Jo_Wilfried_Tsonga-Rafael_Nadal,1,F-II,9,4,0,2,2,4,5
20110918-M-Davis_Cup_World_Group_SF-RR-Jo_Wilfried_Tsonga-Rafael_Nadal,1,B-XC,20,8,0,1,7,4,16
20110918-M-Davis_Cup_World_Group_SF-RR-Jo_Wilfried_Tsonga-Rafael_Nadal,1,B-DTM,12,4,0,0,4,1,11
20110918-M-Davis_Cup_World_Group_SF-RR-Jo_Wilfried_Tsonga-Rafael_Nadal,1,B-DTL,13,6,2,0,4,3,10
20110918-M-Davis_Cup_World_Group_SF-RR-Jo_Wilfried_Tsonga-Rafael_Nadal,1,S-DTM,1,0,0,0,0,0,1
20110918-M-Davis_Cup_World_Group_SF-RR-Jo_Wilfried_Tsonga-Rafael_Nadal,2,F-XC,46,8,3,5,0,34,12
20110918-M-Davis_Cup_World_Group_SF-RR-Jo_Wilfried_Tsonga-Rafael_Nadal,2,F-DTM,4,0,0,0,0,2,2
20110918-M-Davis_Cup_World_Group_SF-RR-Jo_Wilfried_Tsonga-Rafael_Nadal,2,F-DTL,9,2,1,0,1,8,1
20110918-M-Davis_Cup_World_Group_SF-RR-Jo_Wilfried_Tsonga-Rafael_Nadal,2,F-IO,13,1,0,1,0,11,2
20110918-M-Davis_Cup_World_Group_SF-RR-Jo_Wilfried_Tsonga-Rafael_Nadal,2,F-II,7,3,1,2,0,6,1
20110918-M-Davis_Cup_World_Group_SF-RR-Jo_Wilfried_Tsonga-Rafael_Nadal,2,B-XC,14,3,1,2,0,13,1
20110918-M-Davis_Cup_World_Group_SF-RR-Jo_Wilfried_Tsonga-Rafael_Nadal,2,B-DTM,8,1,0,0,1,6,2
20110918-M-Davis_Cup_World_Group_SF-RR-Jo_Wilfried_Tsonga-Rafael_Nadal,2,B-DTL,12,4,2,1,1,11,1
20110918-M-Davis_Cup_World_Group_SF-RR-Jo_Wilfried_Tsonga-Rafael_Nadal,2,B-IO,1,0,0,0,0,0,1
20110918-M-Davis_Cup_World_Group_SF-RR-Jo_Wilfried_Tsonga-Rafael_Nadal,2,S-DTM,1,0,0,0,0,0,1
20110918-M-Davis_Cup_World_Group_SF-RR-Jo_Wilfried_Tsonga-Rafael_Nadal,2,S-DTL,3,0,0,0,0,1,2
20001202-M-Tour_Finals-SF-Pete_Sampras-Gustavo_Kuerten,1,F-XC,20,6,3,0,3,9,11
20001202-M-Tour_Finals-SF-Pete_Sampras-Gustavo_Kuerten,1,F-DTM,2,0,0,0,0,0,2
20001202-M-Tour_Finals-SF-Pete_Sampras-Gustavo_Kuerten,1,F-DTL,8,6,4,2,0,7,1
20001202-M-Tour_Finals-SF-Pete_Sampras-Gustavo_Kuerten,1,F-IO,8,0,0,0,0,5,3
20001202-M-Tour_Finals-SF-Pete_Sampras-Gustavo_Kuerten,1,F-II,3,0,0,0,0,2,1
20001202-M-Tour_Finals-SF-Pete_Sampras-Gustavo_Kuerten,1,B-XC,34,6,2,0,4,13,21
20001202-M-Tour_Finals-SF-Pete_Sampras-Gustavo_Kuerten,1,B-DTM,3,0,0,0,0,0,3
20001202-M-Tour_Finals-SF-Pete_Sampras-Gustavo_Kuerten,1,B-DTL,8,6,3,2,1,5,3
20001202-M-Tour_Finals-SF-Pete_Sampras-Gustavo_Kuerten,1,B-IO,1,0,0,0,0,1,0
20001202-M-Tour_Finals-SF-Pete_Sampras-Gustavo_Kuerten,1,S-XC,19,3,0,0,3,9,10
20001202-M-Tour_Finals-SF-Pete_Sampras-Gustavo_Kuerten,1,S-DTM,4,0,0,0,0,1,3
20001202-M-Tour_Finals-SF-Pete_Sampras-Gustavo_Kuerten,1,S-DTL,2,0,0,0,0,0,2
20001202-M-Tour_Finals-SF-Pete_Sampras-Gustavo_Kuerten,1,S-IO,1,0,0,0,0,0,1
20001202-M-Tour_Finals-SF-Pete_Sampras-Gustavo_Kuerten,2,F-XC,22,6,2,2,2,12,10
20001202-M-Tour_Finals-SF-Pete_Sampras-Gustavo_Kuerten,2,F-DTM,5,1,0,0,1,1,4
20001202-M-Tour_Finals-SF-Pete_Sampras-Gustavo_Kuerten,2,F-DTL,11,1,0,0,1,6,5
20001202-M-Tour_Finals-SF-Pete_Sampras-Gustavo_Kuerten,2,F-IO,22,10,5,1,4,12,10
20001202-M-Tour_Finals-SF-Pete_Sampras-Gustavo_Kuerten,2,F-II,3,2,0,2,0,2,1
20001202-M-Tour_Finals-SF-Pete_Sampras-Gustavo_Kuerten,2,B-XC,60,13,3,5,5,37,23
20001202-M-Tour_Finals-SF-Pete_Sampras-Gustavo_Kuerten,2,B-DTM,10,2,0,0,2,3,7
20001202-M-Tour_Finals-SF-Pete_Sampras-Gustavo_Kuerten,2,B-DTL,15,10,3,1,6,6,9
20001202-M-Tour_Finals-SF-Pete_Sampras-Gustavo_Kuerten,2,B-IO,6,4,3,0,1,4,2
20001202-M-Tour_Finals-SF-Pete_Sampras-Gustavo_Kuerten,2,S-XC,2,0,0,0,0,2,0
20001202-M-Tour_Finals-SF-Pete_Sampras-Gustavo_Kuerten,2,S-DTM,2,0,0,0,0,2,0
20001202-M-Tour_Finals-SF-Pete_Sampras-Gustavo_Kuerten,2,S-DTL,1,0,0,0,0,0,1
20110701-M-Wimbledon-SF-Novak_Djokovic-Jo_Wilfried_Tsonga,1,F-XC,64,21,6,8,7,43,21
20110701-M-Wimbledon-SF-Novak_Djokovic-Jo_Wilfried_Tsonga,1,F-DTM,15,0,0,0,0,9,6
20110701-M-Wimbledon-SF-Novak_Djokovic-Jo_Wilfried_Tsonga,1,F-DTL,22,6,2,2,2,15,7
20110701-M-Wimbledon-SF-Novak_Djokovic-Jo_Wilfried_Tsonga,1,F-IO,38,6,0,6,0,26,12
20110701-M-Wimbledon-SF-Novak_Djokovic-Jo_Wilfried_Tsonga,1,F-II,18,7,3,3,1,12,6
20110701-M-Wimbledon-SF-Novak_Djokovic-Jo_Wilfried_Tsonga,1,B-XC,80,9,4,3,2,50,30
20110701-M-Wimbledon-SF-Novak_Djokovic-Jo_Wilfried_Tsonga,1,B-DTM,14,1,0,0,1,10,4
20110701-M-Wimbledon-SF-Novak_Djokovic-Jo_Wilfried_Tsonga,1,B-DTL,20,6,2,4,0,16,4
20110701-M-Wimbledon-SF-Novak_Djokovic-Jo_Wilfried_Tsonga,1,B-IO,4,2,0,1,1,3,1
20110701-M-Wimbledon-SF-Novak_Djokovic-Jo_Wilfried_Tsonga,1,S-XC,10,0,0,0,0,7,3
20110701-M-Wimbledon-SF-Novak_Djokovic-Jo_Wilfried_Tsonga,1,S-DTM,5,1,0,1,0,1,4
20110701-M-Wimbledon-SF-Novak_Djokovic-Jo_Wilfried_Tsonga,1,S-DTL,1,1,1,0,0,1,0
20110701-M-Wimbledon-SF-Novak_Djokovic-Jo_Wilfried_Tsonga,1,S-IO,1,1,0,1,0,1,0
20110701-M-Wimbledon-SF-Novak_Djokovic-Jo_Wilfried_Tsonga,2,F-XC,52,10,4,2,4,24,28
20110701-M-Wimbledon-SF-Novak_Djokovic-Jo_Wilfried_Tsonga,2,F-DTM,16,3,0,1,2,6,10
20110701-M-Wimbledon-SF-Novak_Djokovic-Jo_Wilfried_Tsonga,2,F-DTL,21,6,2,1,3,8,13
20110701-M-Wimbledon-SF-Novak_Djokovic-Jo_Wilfried_Tsonga,2,F-IO,41,11,2,6,3,16,25
20110701-M-Wimbledon-SF-Novak_Djokovic-Jo_Wilfried_Tsonga,2,F-II,12,2,0,1,1,5,7
20110701-M-Wimbledon-SF-Novak_Djokovic-Jo_Wilfried_Tsonga,2,B-XC,48,11,1,2,8,17,31
20110701-M-Wimbledon-SF-Novak_Djokovic-Jo_Wilfried_Tsonga,2,B-DTM,18,3,0,0,3,6,12
20110701-M-Wimbledon-SF-Novak_Djokovic-Jo_Wilfried_Tsonga,2,B-DTL,16,9,2,2,5,6,10
20110701-M-Wimbledon-SF-Novak_Djokovic-Jo_Wilfried_Tsonga,2,B-IO,3,1,0,0,1,0,3
20110701-M-Wimbledon-SF-Novak_Djokovic-Jo_Wilfried_Tsonga,2,S-XC,37,2,0,0,2,17,20
20110701-M-Wimbledon-SF-Novak_Djokovic-Jo_Wilfried_Tsonga,2,S-DTM,6,1,0,0,1,0,6
20110701-M-Wimbledon-SF-Novak_Djokovic-Jo_Wilfried_Tsonga,2,S-DTL,3,0,0,0,0,1,2
20110701-M-Wimbledon-SF-Novak_Djokovic-Jo_Wilfried_Tsonga,2,S-IO,1,1,0,1,0,1,0
20190104-M-Pune-SF-Kevin_Anderson-Gilles_Simon,1,F-XC,46,12,3,2,7,22,24
20190104-M-Pune-SF-Kevin_Anderson-Gilles_Simon,1,F-DTM,16,1,0,0,1,4,12
20190104-M-Pune-SF-Kevin_Anderson-Gilles_Simon,1,F-DTL,10,2,1,0,1,5,5
20190104-M-Pune-SF-Kevin_Anderson-Gilles_Simon,1,F-IO,36,15,3,4,8,17,19
20190104-M-Pune-SF-Kevin_Anderson-Gilles_Simon,1,F-II,4,1,0,0,1,3,1
20190104-M-Pune-SF-Kevin_Anderson-Gilles_Simon,1,B-XC,39,7,2,1,4,12,27
20190104-M-Pune-SF-Kevin_Anderson-Gilles_Simon,1,B-DTM,11,2,0,0,2,3,8
20190104-M-Pune-SF-Kevin_Anderson-Gilles_Simon,1,B-DTL,5,1,0,1,0,4,1
20190104-M-Pune-SF-Kevin_Anderson-Gilles_Simon,1,B-IO,2,0,0,0,0,2,0
20190104-M-Pune-SF-Kevin_Anderson-Gilles_Simon,1,S-XC,4,1,0,0,1,1,3
20190104-M-Pune-SF-Kevin_Anderson-Gilles_Simon,1,S-DTM,2,0,0,0,0,1,1
20190104-M-Pune-SF-Kevin_Anderson-Gilles_Simon,1,S-DTL,1,0,0,0,0,0,1
20190104-M-Pune-SF-Kevin_Anderson-Gilles_Simon,2,F-XC,39,12,2,5,5,23,16
20190104-M-Pune-SF-Kevin_Anderson-Gilles_Simon,2,F-DTM,14,2,0,0,2,3,11
20190104-M-Pune-SF-Kevin_Anderson-Gilles_Simon,2,F-DTL,9,2,2,0,0,5,4
20190104-M-Pune-SF-Kevin_Anderson-Gilles_Simon,2,F-IO,23,7,3,4,0,21,2
20190104-M-Pune-SF-Kevin_Anderson-Gilles_Simon,2,F-II,3,2,0,2,0,3,0
20190104-M-Pune-SF-Kevin_Anderson-Gilles_Simon,2,B-XC,36,4,0,0,4,20,16
20190104-M-Pune-SF-Kevin_Anderson-Gilles_Simon,2,B-DTM,20,0,0,0,0,12,8
20190104-M-Pune-SF-Kevin_Anderson-Gilles_Simon,2,B-DTL,11,2,1,1,0,8,3
20190104-M-Pune-SF-Kevin_Anderson-Gilles_Simon,2,B-IO,2,1,0,0,1,1,1
20190104-M-Pune-SF-Kevin_Anderson-Gilles_Simon,2,S-XC,1,0,0,0,0,1,0
20190104-M-Pune-SF-Kevin_Anderson-Gilles_Simon,2,S-DTM,3,0,0,0,0,2,1
20190103-M-Doha-QF-Marco_Cecchinato-Dusan_Lajovic,1,F-XC,15,3,3,0,0,11,4
20190103-M-Doha-QF-Marco_Cecchinato-Dusan_Lajovic,1,F-DTM,25,1,0,0,1,14,11
20190103-M-Doha-QF-Marco_Cecchinato-Dusan_Lajovic,1,F-DTL,8,2,1,0,1,4,4
20190103-M-Doha-QF-Marco_Cecchinato-Dusan_Lajovic,1,F-IO,14,6,3,1,2,10,4
20190103-M-Doha-QF-Marco_Cecchinato-Dusan_Lajovic,1,F-II,2,1,0,0,1,1,1
20190103-M-Doha-QF-Marco_Cecchinato-Dusan_Lajovic,1,B-XC,8,1,0,0,1,4,4
20190103-M-Doha-QF-Marco_Cecchinato-Dusan_Lajovic,1,B-DTM,15,2,1,1,0,12,3
20190103-M-Doha-QF-Marco_Cecchinato-Dusan_Lajovic,1,B-DTL,6,4,2,1,1,3,3
20190103-M-Doha-QF-Marco_Cecchinato-Dusan_Lajovic,1,B-IO,1,1,0,0,1,0,1
20190103-M-Doha-QF-Marco_Cecchinato-Dusan_Lajovic,1,S-XC,5,0,0,0,0,2,3
20190103-M-Doha-QF-Marco_Cecchinato-Dusan_Lajovic,1,S-DTL,2,0,0,0,0,0,2
20190103-M-Doha-QF-Marco_Cecchinato-Dusan_Lajovic,2,F-XC,30,14,3,5,6,13,17
20190103-M-Doha-QF-Marco_Cecchinato-Dusan_Lajovic,2,F-DTM,17,3,0,0,3,3,14
20190103-M-Doha-QF-Marco_Cecchinato-Dusan_Lajovic,2,F-DTL,5,5,4,0,1,4,1
20190103-M-Doha-QF-Marco_Cecchinato-Dusan_Lajovic,2,F-IO,20,8,2,2,4,12,8
20190103-M-Doha-QF-Marco_Cecchinato-Dusan_Lajovic,2,B-XC,14,3,0,0,3,6,8
20190103-M-Doha-QF-Marco_Cecchinato-Dusan_Lajovic,2,B-DTM,15,2,0,0,2,5,10
20190103-M-Doha-QF-Marco_Cecchinato-Dusan_Lajovic,2,B-DTL,4,3,1,0,2,2,2
20190103-M-Doha-QF-Marco_Cecchinato-Dusan_Lajovic,2,B-IO,4,3,0,0,3,1,3
20190103-M-Doha-QF-Marco_Cecchinato-Dusan_Lajovic,2,S-XC,2,1,0,0,1,1,1
20190103-M-Doha-QF-Marco_Cecchinato-Dusan_Lajovic,2,S-DTM,3,1,0,0,1,0,3
20190103-M-Doha-QF-Marco_Cecchinato-Dusan_Lajovic,2,S-DTL,1,0,0,0,0,0,1
20190103-M-Doha-QF-Marco_Cecchinato-Dusan_Lajovic,2,S-IO,1,0,0,0,0,0,1
20190103-M-Brisbane-QF-Jeremy_Chardy-Yasutaka_Uchiyama,1,F-XC,42,17,3,4,10,22,20
20190103-M-Brisbane-QF-Jeremy_Chardy-Yasutaka_Uchiyama,1,F-DTM,6,0,0,0,0,3,3
20190103-M-Brisbane-QF-Jeremy_Chardy-Yasutaka_Uchiyama,1,F-DTL,17,8,1,2,5,7,10
20190103-M-Brisbane-QF-Jeremy_Chardy-Yasutaka_Uchiyama,1,F-IO,21,5,1,2,2,9,12
20190103-M-Brisbane-QF-Jeremy_Chardy-Yasutaka_Uchiyama,1,F-II,7,4,1,1,2,4,3
20190103-M-Brisbane-QF-Jeremy_Chardy-Yasutaka_Uchiyama,1,B-XC,8,1,0,0,1,4,4
20190103-M-Brisbane-QF-Jeremy_Chardy-Yasutaka_Uchiyama,1,B-DTM,2,0,0,0,0,0,2
20190103-M-Brisbane-QF-Jeremy_Chardy-Yasutaka_Uchiyama,1,B-DTL,3,2,0,0,2,0,3
20190103-M-Brisbane-QF-Jeremy_Chardy-Yasutaka_Uchiyama,1,S-XC,17,1,0,0,1,10,7
20190103-M-Brisbane-QF-Jeremy_Chardy-Yasutaka_Uchiyama,1,S-DTM,4,0,0,0,0,2,2
20190103-M-Brisbane-QF-Jeremy_Chardy-Yasutaka_Uchiyama,1,S-DTL,6,2,0,1,1,3,3
20190103-M-Brisbane-QF-Jeremy_Chardy-Yasutaka_Uchiyama,1,S-IO,3,0,0,0,0,2,1
20190103-M-Brisbane-QF-Jeremy_Chardy-Yasutaka_Uchiyama,2,F-XC,30,10,3,3,4,14,16
20190103-M-Brisbane-QF-Jeremy_Chardy-Yasutaka_Uchiyama,2,F-DTM,14,1,0,0,1,7,7
20190103-M-Brisbane-QF-Jeremy_Chardy-Yasutaka_Uchiyama,2,F-DTL,13,5,2,0,3,6,7
20190103-M-Brisbane-QF-Jeremy_Chardy-Yasutaka_Uchiyama,2,F-IO,17,8,3,2,3,8,9
20190103-M-Brisbane-QF-Jeremy_Chardy-Yasutaka_Uchiyama,2,F-II,5,3,0,1,2,1,4
20190103-M-Brisbane-QF-Jeremy_Chardy-Yasutaka_Uchiyama,2,B-XC,17,0,0,0,0,10,7
20190103-M-Brisbane-QF-Jeremy_Chardy-Yasutaka_Uchiyama,2,B-DTM,19,1,0,0,1,14,5
20190103-M-Brisbane-QF-Jeremy_Chardy-Yasutaka_Uchiyama,2,B-DTL,8,6,2,0,4,3,5
20190103-M-Brisbane-QF-Jeremy_Chardy-Yasutaka_Uchiyama,2,B-IO,1,0,0,0,0,1,0
20190103-M-Brisbane-QF-Jeremy_Chardy-Yasutaka_Uchiyama,2,S-XC,2,0,0,0,0,1,1
20190103-M-Brisbane-QF-Jeremy_Chardy-Yasutaka_Uchiyama,2,S-DTM,2,0,0,0,0,1,1
20190103-M-Brisbane-QF-Jeremy_Chardy-Yasutaka_Uchiyama,2,S-DTL,3,0,0,0,0,0,3
20110128-M-Australian_Open-SF-David_Ferrer-Andy_Murray,1,F-XC,111,14,4,5,5,53,58
20110128-M-Australian_Open-SF-David_Ferrer-Andy_Murray,1,F-DTM,40,2,0,0,2,20,20
20110128-M-Australian_Open-SF-David_Ferrer-Andy_Murray,1,F-DTL,54,6,2,1,3,25,29
20110128-M-Australian_Open-SF-David_Ferrer-Andy_Murray,1,F-IO,83,10,1,5,4,46,37
20110128-M-Australian_Open-SF-David_Ferrer-Andy_Murray,1,F-II,43,11,3,5,3,29,14
20110128-M-Australian_Open-SF-David_Ferrer-Andy_Murray,1,B-XC,213,16,3,7,6,111,102
20110128-M-Australian_Open-SF-David_Ferrer-Andy_Murray,1,B-DTM,37,3,0,0,3,17,20
20110128-M-Australian_Open-SF-David_Ferrer-Andy_Murray,1,B-DTL,14,3,0,1,2,8,6
20110128-M-Australian_Open-SF-David_Ferrer-Andy_Murray,1,B-IO,2,2,1,0,1,1,1
20110128-M-Australian_Open-SF-David_Ferrer-Andy_Murray,1,S-XC,12,2,0,1,1,5,7
20110128-M-Australian_Open-SF-David_Ferrer-Andy_Murray,1,S-DTM,12,1,0,0,1,2,10
20110128-M-Australian_Open-SF-David_Ferrer-Andy_Murray,1,S-DTL,1,0,0,0,0,0,1
20110128-M-Australian_Open-SF-David_Ferrer-Andy_Murray,2,F-XC,123,24,8,4,12,65,58
20110128-M-Australian_Open-SF-David_Ferrer-Andy_Murray,2,F-DTM,24,3,1,0,2,12,12
20110128-M-Australian_Open-SF-David_Ferrer-Andy_Murray,2,F-DTL,46,10,4,0,6,19,27
20110128-M-Australian_Open-SF-David_Ferrer-Andy_Murray,2,F-IO,46,6,2,1,3,23,23
20110128-M-Australian_Open-SF-David_Ferrer-Andy_Murray,2,F-II,9,2,0,1,1,5,4
20110128-M-Australian_Open-SF-David_Ferrer-Andy_Murray,2,B-XC,187,20,6,4,10,92,95
20110128-M-Australian_Open-SF-David_Ferrer-Andy_Murray,2,B-DTM,34,4,0,0,4,15,19
20110128-M-Australian_Open-SF-David_Ferrer-Andy_Murray,2,B-DTL,59,18,5,4,9,28,31
20110128-M-Australian_Open-SF-David_Ferrer-Andy_Murray,2,B-IO,5,2,0,1,1,2,3
20110128-M-Australian_Open-SF-David_Ferrer-Andy_Murray,2,S-XC,58,0,0,0,0,27,31
20110128-M-Australian_Open-SF-David_Ferrer-Andy_Murray,2,S-DTM,9,0,0,0,0,5,4
20110128-M-Australian_Open-SF-David_Ferrer-Andy_Murray,2,S-DTL,17,4,1,2,1,9,8
20110128-M-Australian_Open-SF-David_Ferrer-Andy_Murray,2,S-IO,2,0,0,0,0,2,0
20070617-M-Queens_Club-F-Nicolas_Mahut-Andy_Roddick,1,F-XC,18,5,1,1,3,9,9
20070617-M-Queens_Club-F-Nicolas_Mahut-Andy_Roddick,1,F-DTM,9,0,0,0,0,6,3
20070617-M-Queens_Club-F-Nicolas_Mahut-Andy_Roddick,1,F-DTL,9,3,1,1,1,4,5
20070617-M-Queens_Club-F-Nicolas_Mahut-Andy_Roddick,1,F-IO,13,1,1,0,0,8,5
20070617-M-Queens_Club-F-Nicolas_Mahut-Andy_Roddick,1,F-II,2,1,0,0,1,1,1
20070617-M-Queens_Club-F-Nicolas_Mahut-Andy_Roddick,1,B-XC,6,2,1,0,1,2,4
20070617-M-Queens_Club-F-Nicolas_Mahut-Andy_Roddick,1,B-DTM,8,2,0,1,1,2,6
20070617-M-Queens_Club-F-Nicolas_Mahut-Andy_Roddick,1,B-DTL,5,2,1,0,1,1,4
20070617-M-Queens_Club-F-Nicolas_Mahut-Andy_Roddick,1,B-IO,1,1,1,0,0,1,0
20070617-M-Queens_Club-F-Nicolas_Mahut-Andy_Roddick,1,S-XC,18,3,0,1,2,8,10
20070617-M-Queens_Club-F-Nicolas_Mahut-Andy_Roddick,1,S-DTM,4,0,0,0,0,1,3
20070617-M-Queens_Club-F-Nicolas_Mahut-Andy_Roddick,1,S-DTL,1,0,0,0,0,0,1
20070617-M-Queens_Club-F-Nicolas_Mahut-Andy_Roddick,2,F-XC,33,8,6,2,0,20,13
20070617-M-Queens_Club-F-Nicolas_Mahut-Andy_Roddick,2,F-DTM,6,0,0,0,0,3,3
20070617-M-Queens_Club-F-Nicolas_Mahut-Andy_Roddick,2,F-DTL,8,1,1,0,0,3,5
20070617-M-Queens_Club-F-Nicolas_Mahut-Andy_Roddick,2,F-IO,29,7,4,2,1,21,8
20070617-M-Queens_Club-F-Nicolas_Mahut-Andy_Roddick,2,F-II,4,3,1,1,1,3,1
20070617-M-Queens_Club-F-Nicolas_Mahut-Andy_Roddick,2,B-XC,11,2,1,0,1,8,3
20070617-M-Queens_Club-F-Nicolas_Mahut-Andy_Roddick,2,B-DTM,4,1,0,0,1,2,2
20070617-M-Queens_Club-F-Nicolas_Mahut-Andy_Roddick,2,B-DTL,10,5,3,0,2,5,5
20070617-M-Queens_Club-F-Nicolas_Mahut-Andy_Roddick,2,B-IO,1,1,0,0,1,0,1
20070617-M-Queens_Club-F-Nicolas_Mahut-Andy_Roddick,2,S-XC,16,1,0,0,1,4,12
20070617-M-Queens_Club-F-Nicolas_Mahut-Andy_Roddick,2,S-DTM,3,0,0,0,0,0,3
20070617-M-Queens_Club-F-Nicolas_Mahut-Andy_Roddick,2,S-DTL,3,1,0,0,1,0,3
20190111-M-Auckland-SF-Tennys_Sandgren-Philipp_Kohlschreiber,1,F-XC,26,7,2,3,2,18,8
20190111-M-Auckland-SF-Tennys_Sandgren-Philipp_Kohlschreiber,1,F-DTM,20,4,0,0,4,11,9
20190111-M-Auckland-SF-Tennys_Sandgren-Philipp_Kohlschreiber,1,F-DTL,10,5,2,2,1,7,3
20190111-M-Auckland-SF-Tennys_Sandgren-Philipp_Kohlschreiber,1,F-IO,10,4,3,1,0,9,1
20190111-M-Auckland-SF-Tennys_Sandgren-Philipp_Kohlschreiber,1,F-II,1,1,0,0,1,0,1
20190111-M-Auckland-SF-Tennys_Sandgren-Philipp_Kohlschreiber,1,B-XC,18,4,2,0,2,14,4
20190111-M-Auckland-SF-Tennys_Sandgren-Philipp_Kohlschreiber,1,B-DTM,19,0,0,0,0,12,7
20190111-M-Auckland-SF-Tennys_Sandgren-Philipp_Kohlschreiber,1,B-DTL,3,2,0,1,1,1,2
20190111-M-Auckland-SF-Tennys_Sandgren-Philipp_Kohlschreiber,1,S-XC,3,1,1,0,0,3,0
20190111-M-Auckland-SF-Tennys_Sandgren-Philipp_Kohlschreiber,1,S-DTM,1,0,0,0,0,0,1
20190111-M-Auckland-SF-Tennys_Sandgren-Philipp_Kohlschreiber,1,S-DTL,1,0,0,0,0,1,0
20190111-M-Auckland-SF-Tennys_Sandgren-Philipp_Kohlschreiber,2,F-XC,35,2,0,0,2,17,18
20190111-M-Auckland-SF-Tennys_Sandgren-Philipp_Kohlschreiber,2,F-DTM,17,0,0,0,0,4,13
20190111-M-Auckland-SF-Tennys_Sandgren-Philipp_Kohlschreiber,2,F-DTL,7,3,2,0,1,4,3
20190111-M-Auckland-SF-Tennys_Sandgren-Philipp_Kohlschreiber,2,F-IO,18,5,0,2,3,6,12
20190111-M-Auckland-SF-Tennys_Sandgren-Philipp_Kohlschreiber,2,B-XC,16,4,0,2,2,5,11
20190111-M-Auckland-SF-Tennys_Sandgren-Philipp_Kohlschreiber,2,B-DTM,7,0,0,0,0,1,6
20190111-M-Auckland-SF-Tennys_Sandgren-Philipp_Kohlschreiber,2,B-DTL,4,2,2,0,0,2,2
20190111-M-Auckland-SF-Tennys_Sandgren-Philipp_Kohlschreiber,2,B-IO,1,0,0,0,0,0,1
20190111-M-Auckland-SF-Tennys_Sandgren-Philipp_Kohlschreiber,2,S-XC,8,1,0,0,1,1,7
20190111-M-Auckland-SF-Tennys_Sandgren-Philipp_Kohlschreiber,2,S-DTM,3,0,0,0,0,0,3
20190107-M-Auckland-R32-Denis_Shapovalov-Joao_Sousa,1,F-XC,43,13,2,3,8,22,21
20190107-M-Auckland-R32-Denis_Shapovalov-Joao_Sousa,1,F-DTM,46,8,1,1,6,25,21
20190107-M-Auckland-R32-Denis_Shapovalov-Joao_Sousa,1,F-DTL,12,8,4,0,4,6,6
20190107-M-Auckland-R32-Denis_Shapovalov-Joao_Sousa,1,F-IO,30,18,7,2,9,15,15
20190107-M-Auckland-R32-Denis_Shapovalov-Joao_Sousa,1,F-II,5,5,1,3,1,4,1
20190107-M-Auckland-R32-Denis_Shapovalov-Joao_Sousa,1,B-XC,26,12,2,2,8,17,9
20190107-M-Auckland-R32-Denis_Shapovalov-Joao_Sousa,1,B-DTM,17,5,0,1,4,8,9
20190107-M-Auckland-R32-Denis_Shapovalov-Joao_Sousa,1,B-DTL,9,4,2,0,2,3,6
20190107-M-Auckland-R32-Denis_Shapovalov-Joao_Sousa,1,B-IO,1,1,1,0,0,1,0
20190107-M-Auckland-R32-Denis_Shapovalov-Joao_Sousa,1,S-DTM,5,0,0,0,0,3,2
20190107-M-Auckland-R32-Denis_Shapovalov-Joao_Sousa,1,S-DTL,4,0,0,0,0,3,1
20190107-M-Auckland-R32-Denis_Shapovalov-Joao_Sousa,1,S-IO,2,1,0,1,0,1,1
20190107-M-Auckland-R32-Denis_Shapovalov-Joao_Sousa,2,F-XC,49,12,1,5,6,24,25
20190107-M-Auckland-R32-Denis_Shapovalov-Joao_Sousa,2,F-DTM,34,2,1,0,1,13,21
20190107-M-Auckland-R32-Denis_Shapovalov-Joao_Sousa,2,F-DTL,8,2,0,1,1,2,6
20190107-M-Auckland-R32-Denis_Shapovalov-Joao_Sousa,2,F-IO,31,9,4,3,2,15,16
20190107-M-Auckland-R32-Denis_Shapovalov-Joao_Sousa,2,F-II,4,0,0,0,0,0,4
20190107-M-Auckland-R32-Denis_Shapovalov-Joao_Sousa,2,B-XC,7,0,0,0,0,4,3
20190107-M-Auckland-R32-Denis_Shapovalov-Joao_Sousa,2,B-DTM,27,2,0,0,2,12,15
20190107-M-Auckland-R32-Denis_Shapovalov-Joao_Sousa,2,B-DTL,2,0,0,0,0,0,2
20190107-M-Auckland-R32-Denis_Shapovalov-Joao_Sousa,2,B-IO,4,4,0,1,3,1,3
20190107-M-Auckland-R32-Denis_Shapovalov-Joao_Sousa,2,S-XC,1,0,0,0,0,1,0
20190107-M-Auckland-R32-Denis_Shapovalov-Joao_Sousa,2,S-DTM,9,0,0,0,0,5,4
20190107-M-Auckland-R32-Denis_Shapovalov-Joao_Sousa,2,S-DTL,3,1,0,0,1,0,3
20190107-M-Auckland-R32-Denis_Shapovalov-Joao_Sousa,2,S-IO,1,0,0,0,0,0,1
20190104-M-Brisbane-QF-Milos_Raonic-Daniil_Medvedev,1,F-XC,19,4,1,1,2,10,9
20190104-M-Brisbane-QF-Milos_Raonic-Daniil_Medvedev,1,F-DTM,15,3,0,1,2,5,10
20190104-M-Brisbane-QF-Milos_Raonic-Daniil_Medvedev,1,F-DTL,2,1,0,1,0,1,1
20190104-M-Brisbane-QF-Milos_Raonic-Daniil_Medvedev,1,F-IO,21,10,3,0,7,7,14
20190104-M-Brisbane-QF-Milos_Raonic-Daniil_Medvedev,1,F-II,3,1,1,0,0,3,0
20190104-M-Brisbane-QF-Milos_Raonic-Daniil_Medvedev,1,B-XC,5,2,0,0,2,1,4
20190104-M-Brisbane-QF-Milos_Raonic-Daniil_Medvedev,1,B-DTM,6,1,0,0,1,2,4
20190104-M-Brisbane-QF-Milos_Raonic-Daniil_Medvedev,1,B-DTL,5,3,0,0,3,2,3
20190104-M-Brisbane-QF-Milos_Raonic-Daniil_Medvedev,1,B-IO,5,3,1,1,1,3,2
20190104-M-Brisbane-QF-Milos_Raonic-Daniil_Medvedev,1,S-XC,16,4,0,1,3,5,11
20190104-M-Brisbane-QF-Milos_Raonic-Daniil_Medvedev,1,S-DTM,7,1,0,0,1,1,6
20190104-M-Brisbane-QF-Milos_Raonic-Daniil_Medvedev,1,S-DTL,2,0,0,0,0,2,0
20190104-M-Brisbane-QF-Milos_Raonic-Daniil_Medvedev,1,S-IO,2,1,0,1,0,2,0
20190104-M-Brisbane-QF-Milos_Raonic-Daniil_Medvedev,2,F-XC,16,9,3,1,5,7,9
20190104-M-Brisbane-QF-Milos_Raonic-Daniil_Medvedev,2,F-DTM,18,2,1,0,1,12,6
20190104-M-Brisbane-QF-Milos_Raonic-Daniil_Medvedev,2,F-DTL,8,3,1,1,1,6,2
20190104-M-Brisbane-QF-Milos_Raonic-Daniil_Medvedev,2,F-IO,8,4,2,0,2,6,2
20190104-M-Brisbane-QF-Milos_Raonic-Daniil_Medvedev,2,B-XC,40,6,1,3,2,20,20
20190104-M-Brisbane-QF-Milos_Raonic-Daniil_Medvedev,2,B-DTM,20,0,0,0,0,13,7
20190104-M-Brisbane-QF-Milos_Raonic-Daniil_Medvedev,2,B-DTL,3,3,3,0,0,3,0
20190104-M-Brisbane-QF-Milos_Raonic-Daniil_Medvedev,2,B-IO,5,1,0,1,0,4,1
20190104-M-Brisbane-QF-Milos_Raonic-Daniil_Medvedev,2,S-XC,1,0,0,0,0,1,0
20190104-M-Brisbane-QF-Milos_Raonic-Daniil_Medvedev,2,S-DTM,2,0,0,0,0,0,2
20190110-M-Sydney-QF-John_Millman-Gilles_Simon,1,F-XC,175,19,8,1,10,83,92
20190110-M-Sydney-QF-John_Millman-Gilles_Simon,1,F-DTM,37,1,0,0,1,17,20
20190110-M-Sydney-QF-John_Millman-Gilles_Simon,1,F-DTL,36,12,6,0,6,18,18
20190110-M-Sydney-QF-John_Millman-Gilles_Simon,1,F-IO,43,12,5,3,4,21,22
20190110-M-Sydney-QF-John_Millman-Gilles_Simon,1,F-II,5,1,0,0,1,3,2
20190110-M-Sydney-QF-John_Millman-Gilles_Simon,1,B-XC,211,20,1,1,18,99,112
20190110-M-Sydney-QF-John_Millman-Gilles_Simon,1,B-DTM,82,4,0,0,4,28,54
20190110-M-Sydney-QF-John_Millman-Gilles_Simon,1,B-DTL,40,23,10,3,10,18,22
20190110-M-Sydney-QF-John_Millman-Gilles_Simon,1,B-IO,14,6,3,0,3,7,7
20190110-M-Sydney-QF-John_Millman-Gilles_Simon,1,S-XC,6,0,0,0,0,2,4
20190110-M-Sydney-QF-John_Millman-Gilles_Simon,1,S-DTM,3,0,0,0,0,0,3
20190110-M-Sydney-QF-John_Millman-Gilles_Simon,1,S-DTL,2,0,0,0,0,0,2
20190110-M-Sydney-QF-John_Millman-Gilles_Simon,2,F-XC,147,10,2,4,4,77,70
20190110-M-Sydney-QF-John_Millman-Gilles_Simon,2,F-DTM,38,2,0,0,2,20,18
20190110-M-Sydney-QF-John_Millman-Gilles_Simon,2,F-DTL,46,10,1,4,5,29,17
20190110-M-Sydney-QF-John_Millman-Gilles_Simon,2,F-IO,57,7,2,2,3,34,23
20190110-M-Sydney-QF-John_Millman-Gilles_Simon,2,F-II,6,2,1,1,0,4,2
20190110-M-Sydney-QF-John_Millman-Gilles_Simon,2,B-XC,174,7,2,1,4,90,84
20190110-M-Sydney-QF-John_Millman-Gilles_Simon,2,B-DTM,84,3,0,0,3,47,37
20190110-M-Sydney-QF-John_Millman-Gilles_Simon,2,B-DTL,44,14,5,2,7,26,18
20190110-M-Sydney-QF-John_Millman-Gilles_Simon,2,B-IO,7,0,0,0,0,6,1
20190110-M-Sydney-QF-John_Millman-Gilles_Simon,2,S-XC,1,0,0,0,0,0,1
20190110-M-Sydney-QF-John_Millman-Gilles_Simon,2,S-DTM,1,0,0,0,0,0,1
20100911-M-US_Open-SF-Rafael_Nadal-Mikhail_Youzhny,1,F-XC,48,10,1,6,3,29,19
20100911-M-US_Open-SF-Rafael_Nadal-Mikhail_Youzhny,1,F-DTM,22,2,0,1,1,13,9
20100911-M-US_Open-SF-Rafael_Nadal-Mikhail_Youzhny,1,F-DTL,42,8,3,5,0,26,16
20100911-M-US_Open-SF-Rafael_Nadal-Mikhail_Youzhny,1,F-IO,31,10,2,4,4,20,11
20100911-M-US_Open-SF-Rafael_Nadal-Mikhail_Youzhny,1,F-II,10,2,0,1,1,6,4
20100911-M-US_Open-SF-Rafael_Nadal-Mikhail_Youzhny,1,B-XC,22,5,0,2,3,12,10
20100911-M-US_Open-SF-Rafael_Nadal-Mikhail_Youzhny,1,B-DTM,7,0,0,0,0,5,2
20100911-M-US_Open-SF-Rafael_Nadal-Mikhail_Youzhny,1,B-DTL,7,3,0,1,2,5,2
20100911-M-US_Open-SF-Rafael_Nadal-Mikhail_Youzhny,1,B-IO,2,0,0,0,0,1,1
20100911-M-US_Open-SF-Rafael_Nadal-Mikhail_Youzhny,1,B-II,2,0,0,0,0,1,1
20100911-M-US_Open-SF-Rafael_Nadal-Mikhail_Youzhny,1,S-XC,15,1,0,1,0,10,5
20100911-M-US_Open-SF-Rafael_Nadal-Mikhail_Youzhny,1,S-DTM,13,1,0,0,1,4,9
20100911-M-US_Open-SF-Rafael_Nadal-Mikhail_Youzhny,1,S-DTL,8,0,0,0,0,5,3
20100911-M-US_Open-SF-Rafael_Nadal-Mikhail_Youzhny,1,S-IO,1,0,0,0,0,1,0
20100911-M-US_Open-SF-Rafael_Nadal-Mikhail_Youzhny,2,F-XC,59,8,1,2,5,27,32
20100911-M-US_Open-SF-Rafael_Nadal-Mikhail_Youzhny,2,F-DTM,17,3,0,0,3,5,12
20100911-M-US_Open-SF-Rafael_Nadal-Mikhail_Youzhny,2,F-DTL,32,11,2,3,6,13,19
20100911-M-US_Open-SF-Rafael_Nadal-Mikhail_Youzhny,2,F-IO,20,7,1,4,2,11,9
20100911-M-US_Open-SF-Rafael_Nadal-Mikhail_Youzhny,2,F-II,3,0,0,0,0,2,1
20100911-M-US_Open-SF-Rafael_Nadal-Mikhail_Youzhny,2,B-XC,34,10,1,4,5,20,14
20100911-M-US_Open-SF-Rafael_Nadal-Mikhail_Youzhny,2,B-DTM,12,1,0,0,1,2,10
20100911-M-US_Open-SF-Rafael_Nadal-Mikhail_Youzhny,2,B-DTL,9,3,1,2,0,4,5
20100911-M-US_Open-SF-Rafael_Nadal-Mikhail_Youzhny,2,B-IO,7,0,0,0,0,3,4
20100911-M-US_Open-SF-Rafael_Nadal-Mikhail_Youzhny,2,S-XC,22,3,2,0,1,7,15
20100911-M-US_Open-SF-Rafael_Nadal-Mikhail_Youzhny,2,S-DTM,4,0,0,0,0,1,3
20100911-M-US_Open-SF-Rafael_Nadal-Mikhail_Youzhny,2,S-DTL,10,0,0,0,0,3,7
20100911-M-US_Open-SF-Rafael_Nadal-Mikhail_Youzhny,2,S-IO,3,0,0,0,0,3,0
20190112-M-Sydney-F-Alex_De_Minaur-Andreas_Seppi,1,F-XC,47,13,3,2,8,16,31
20190112-M-Sydney-F-Alex_De_Minaur-Andreas_Seppi,1,F-DTM,19,0,0,0,0,9,10
20190112-M-Sydney-F-Alex_De_Minaur-Andreas_Seppi,1,F-DTL,30,7,1,3,3,19,11
20190112-M-Sydney-F-Alex_De_Minaur-Andreas_Seppi,1,F-IO,52,9,3,2,4,29,23
20190112-M-Sydney-F-Alex_De_Minaur-Andreas_Seppi,1,F-II,5,2,1,1,0,5,0
20190112-M-Sydney-F-Alex_De_Minaur-Andreas_Seppi,1,B-XC,96,8,4,1,3,51,45
20190112-M-Sydney-F-Alex_De_Minaur-Andreas_Seppi,1,B-DTM,34,0,0,0,0,16,18
20190112-M-Sydney-F-Alex_De_Minaur-Andreas_Seppi,1,B-DTL,14,5,0,1,4,7,7
20190112-M-Sydney-F-Alex_De_Minaur-Andreas_Seppi,1,B-IO,3,2,0,2,0,2,1
20190112-M-Sydney-F-Alex_De_Minaur-Andreas_Seppi,1,S-XC,19,1,0,0,1,11,8
20190112-M-Sydney-F-Alex_De_Minaur-Andreas_Seppi,1,S-DTM,10,0,0,0,0,5,5
20190112-M-Sydney-F-Alex_De_Minaur-Andreas_Seppi,1,S-DTL,1,0,0,0,0,0,1
20190112-M-Sydney-F-Alex_De_Minaur-Andreas_Seppi,2,F-XC,51,14,2,6,6,28,23
20190112-M-Sydney-F-Alex_De_Minaur-Andreas_Seppi,2,F-DTM,14,2,0,0,2,4,10
20190112-M-Sydney-F-Alex_De_Minaur-Andreas_Seppi,2,F-DTL,17,6,2,2,2,12,5
20190112-M-Sydney-F-Alex_De_Minaur-Andreas_Seppi,2,F-IO,48,11,4,2,5,25,23
20190112-M-Sydney-F-Alex_De_Minaur-Andreas_Seppi,2,F-II,5,3,1,0,2,2,3
20190112-M-Sydney-F-Alex_De_Minaur-Andreas_Seppi,2,B-XC,86,5,1,2,2,45,41
20190112-M-Sydney-F-Alex_De_Minaur-Andreas_Seppi,2,B-DTM,42,1,0,0,1,14,28
20190112-M-Sydney-F-Alex_De_Minaur-Andreas_Seppi,2,B-DTL,18,5,1,1,3,8,10
20190112-M-Sydney-F-Alex_De_Minaur-Andreas_Seppi,2,B-IO,5,1,1,0,0,4,1
20190112-M-Sydney-F-Alex_De_Minaur-Andreas_Seppi,2,S-XC,26,6,0,0,6,9,17
20190112-M-Sydney-F-Alex_De_Minaur-Andreas_Seppi,2,S-DTM,17,3,0,0,3,7,10
20190112-M-Sydney-F-Alex_De_Minaur-Andreas_Seppi,2,S-DTL,15,1,0,0,1,10,5
20190112-M-Sydney-F-Alex_De_Minaur-Andreas_Seppi,2,S-IO,2,1,0,0,1,1,1
19980622-M-Wimbledon-SF-Tim_Henman-Pete_Sampras,1,F-XC,11,4,1,3,0,7,4
19980622-M-Wimbledon-SF-Tim_Henman-Pete_Sampras,1,F-DTM,2,0,0,0,0,0,2
19980622-M-Wimbledon-SF-Tim_Henman-Pete_Sampras,1,F-DTL,3,2,1,1,0,2,1
19980622-M-Wimbledon-SF-Tim_Henman-Pete_Sampras,1,F-IO,8,3,2,1,0,6,2
19980622-M-Wimbledon-SF-Tim_Henman-Pete_Sampras,1,F-II,2,1,0,1,0,1,1
19980622-M-Wimbledon-SF-Tim_Henman-Pete_Sampras,1,B-XC,14,7,4,1,2,8,6
19980622-M-Wimbledon-SF-Tim_Henman-Pete_Sampras,1,B-DTM,1,0,0,0,0,1,0
19980622-M-Wimbledon-SF-Tim_Henman-Pete_Sampras,1,B-DTL,7,6,2,1,3,3,4
19980622-M-Wimbledon-SF-Tim_Henman-Pete_Sampras,1,B-IO,1,1,1,0,0,1,0
19980622-M-Wimbledon-SF-Tim_Henman-Pete_Sampras,1,S-XC,7,0,0,0,0,4,3
19980622-M-Wimbledon-SF-Tim_Henman-Pete_Sampras,1,S-DTM,1,1,0,0,1,0,1
19980622-M-Wimbledon-SF-Tim_Henman-Pete_Sampras,1,S-DTL,3,0,0,0,0,1,2
19980622-M-Wimbledon-SF-Tim_Henman-Pete_Sampras,2,F-XC,4,1,0,0,1,2,2
19980622-M-Wimbledon-SF-Tim_Henman-Pete_Sampras,2,F-DTM,1,0,0,0,0,1,0
19980622-M-Wimbledon-SF-Tim_Henman-Pete_Sampras,2,F-DTL,7,5,1,0,4,2,5
19980622-M-Wimbledon-SF-Tim_Henman-Pete_Sampras,2,F-IO,5,2,0,1,1,2,3
19980622-M-Wimbledon-SF-Tim_Henman-Pete_Sampras,2,F-II,2,1,0,0,1,0,2
19980622-M-Wimbledon-SF-Tim_Henman-Pete_Sampras,2,B-XC,22,11,3,3,5,10,12
19980622-M-Wimbledon-SF-Tim_Henman-Pete_Sampras,2,B-DTM,1,0,0,0,0,1,0
19980622-M-Wimbledon-SF-Tim_Henman-Pete_Sampras,2,B-IO,1,1,0,0,1,0,1
19980622-M-Wimbledon-SF-Tim_Henman-Pete_Sampras,2,S-DTM,1,0,0,0,0,1,0
19980622-M-Wimbledon-SF-Tim_Henman-Pete_Sampras,2,S-DTL,3,1,1,0,0,2,1
20190108-M-Sydney-R16-John_Millman-Marton_Fucsovics,1,F-XC,39,12,1,5,6,19,20
20190108-M-Sydney-R16-John_Millman-Marton_Fucsovics,1,F-DTM,26,1,0,1,0,15,11
20190108-M-Sydney-R16-John_Millman-Marton_Fucsovics,1,F-DTL,1,0,0,0,0,0,1
20190108-M-Sydney-R16-John_Millman-Marton_Fucsovics,1,F-IO,19,0,0,0,0,15,4
20190108-M-Sydney-R16-John_Millman-Marton_Fucsovics,1,B-XC,64,7,0,3,4,41,23
20190108-M-Sydney-R16-John_Millman-Marton_Fucsovics,1,B-DTM,31,3,0,1,2,18,13
20190108-M-Sydney-R16-John_Millman-Marton_Fucsovics,1,B-DTL,9,4,0,1,3,5,4
20190108-M-Sydney-R16-John_Millman-Marton_Fucsovics,1,B-IO,8,4,3,1,0,5,3
20190108-M-Sydney-R16-John_Millman-Marton_Fucsovics,1,S-DTM,1,0,0,0,0,0,1
20190108-M-Sydney-R16-John_Millman-Marton_Fucsovics,2,F-XC,27,13,2,4,7,16,11
20190108-M-Sydney-R16-John_Millman-Marton_Fucsovics,2,F-DTM,35,3,0,1,2,10,25
20190108-M-Sydney-R16-John_Millman-Marton_Fucsovics,2,F-DTL,7,2,1,0,1,3,4
20190108-M-Sydney-R16-John_Millman-Marton_Fucsovics,2,F-IO,24,10,3,0,7,10,14
20190108-M-Sydney-R16-John_Millman-Marton_Fucsovics,2,F-II,7,4,2,1,1,5,2
20190108-M-Sydney-R16-John_Millman-Marton_Fucsovics,2,B-XC,30,2,0,0,2,12,18
20190108-M-Sydney-R16-John_Millman-Marton_Fucsovics,2,B-DTM,22,2,0,0,2,9,13
20190108-M-Sydney-R16-John_Millman-Marton_Fucsovics,2,B-DTL,6,3,1,0,2,4,2
20190108-M-Sydney-R16-John_Millman-Marton_Fucsovics,2,B-IO,1,1,0,1,0,1,0
20190108-M-Sydney-R16-John_Millman-Marton_Fucsovics,2,S-XC,20,3,0,0,3,3,17
20190108-M-Sydney-R16-John_Millman-Marton_Fucsovics,2,S-DTM,9,1,0,0,1,3,6
20190108-M-Sydney-R16-John_Millman-Marton_Fucsovics,2,S-DTL,2,0,0,0,0,1,1
20190108-M-Sydney-R16-John_Millman-Marton_Fucsovics,2,S-IO,1,0,0,0,0,1,0
20190110-M-Sydney-QF-Stefanos_Tsitsipas-Andreas_Seppi,1,F-XC,34,11,7,1,3,16,18
20190110-M-Sydney-QF-Stefanos_Tsitsipas-Andreas_Seppi,1,F-DTM,55,8,0,2,6,20,35
20190110-M-Sydney-QF-Stefanos_Tsitsipas-Andreas_Seppi,1,F-DTL,8,4,0,1,3,3,5
20190110-M-Sydney-QF-Stefanos_Tsitsipas-Andreas_Seppi,1,F-IO,24,7,1,0,6,8,16
20190110-M-Sydney-QF-Stefanos_Tsitsipas-Andreas_Seppi,1,F-II,7,4,0,0,4,2,5
20190110-M-Sydney-QF-Stefanos_Tsitsipas-Andreas_Seppi,1,B-XC,33,6,1,1,4,14,19
20190110-M-Sydney-QF-Stefanos_Tsitsipas-Andreas_Seppi,1,B-DTM,38,5,0,0,5,13,25
20190110-M-Sydney-QF-Stefanos_Tsitsipas-Andreas_Seppi,1,B-DTL,4,3,0,1,2,1,3
20190110-M-Sydney-QF-Stefanos_Tsitsipas-Andreas_Seppi,1,B-IO,4,2,0,0,2,1,3
20190110-M-Sydney-QF-Stefanos_Tsitsipas-Andreas_Seppi,1,S-XC,23,1,0,0,1,5,18
20190110-M-Sydney-QF-Stefanos_Tsitsipas-Andreas_Seppi,1,S-DTM,8,0,0,0,0,2,6
20190110-M-Sydney-QF-Stefanos_Tsitsipas-Andreas_Seppi,1,S-DTL,1,0,0,0,0,0,1
20190110-M-Sydney-QF-Stefanos_Tsitsipas-Andreas_Seppi,2,F-XC,41,8,6,1,1,33,8
20190110-M-Sydney-QF-Stefanos_Tsitsipas-Andreas_Seppi,2,F-DTM,38,3,0,0,3,21,17
20190110-M-Sydney-QF-Stefanos_Tsitsipas-Andreas_Seppi,2,F-DTL,7,2,0,1,1,5,2
20190110-M-Sydney-QF-Stefanos_Tsitsipas-Andreas_Seppi,2,F-IO,45,7,0,2,5,28,17
20190110-M-Sydney-QF-Stefanos_Tsitsipas-Andreas_Seppi,2,F-II,4,2,0,0,2,1,3
20190110-M-Sydney-QF-Stefanos_Tsitsipas-Andreas_Seppi,2,B-XC,41,7,1,3,3,27,14
20190110-M-Sydney-QF-Stefanos_Tsitsipas-Andreas_Seppi,2,B-DTM,37,3,0,0,3,20,17
20190110-M-Sydney-QF-Stefanos_Tsitsipas-Andreas_Seppi,2,B-DTL,11,7,3,1,3,7,4
20190110-M-Sydney-QF-Stefanos_Tsitsipas-Andreas_Seppi,2,B-IO,2,2,2,0,0,2,0
20190110-M-Sydney-QF-Stefanos_Tsitsipas-Andreas_Seppi,2,S-XC,10,2,0,0,2,7,3
20190110-M-Sydney-QF-Stefanos_Tsitsipas-Andreas_Seppi,2,S-DTM,3,0,0,0,0,2,1
20190110-M-Sydney-QF-Stefanos_Tsitsipas-Andreas_Seppi,2,S-DTL,6,1,0,0,1,3,3
20100702-M-Wimbledon-SF-Tomas_Berdych-Novak_Djokovic,1,F-XC,36,11,4,4,3,15,21
20100702-M-Wimbledon-SF-Tomas_Berdych-Novak_Djokovic,1,F-DTM,13,2,0,0,2,3,10
20100702-M-Wimbledon-SF-Tomas_Berdych-Novak_Djokovic,1,F-DTL,11,4,1,0,3,5,6
20100702-M-Wimbledon-SF-Tomas_Berdych-Novak_Djokovic,1,F-IO,27,7,3,2,2,14,13
20100702-M-Wimbledon-SF-Tomas_Berdych-Novak_Djokovic,1,F-II,9,5,2,1,2,5,4
20100702-M-Wimbledon-SF-Tomas_Berdych-Novak_Djokovic,1,B-XC,52,8,1,1,6,26,26
20100702-M-Wimbledon-SF-Tomas_Berdych-Novak_Djokovic,1,B-DTM,14,1,0,0,1,5,9
20100702-M-Wimbledon-SF-Tomas_Berdych-Novak_Djokovic,1,B-DTL,12,6,0,2,4,4,8
20100702-M-Wimbledon-SF-Tomas_Berdych-Novak_Djokovic,1,B-IO,3,2,0,1,1,1,2
20100702-M-Wimbledon-SF-Tomas_Berdych-Novak_Djokovic,1,S-XC,9,0,0,0,0,6,3
20100702-M-Wimbledon-SF-Tomas_Berdych-Novak_Djokovic,1,S-DTM,3,0,0,0,0,1,2
20100702-M-Wimbledon-SF-Tomas_Berdych-Novak_Djokovic,1,S-DTL,4,2,0,1,1,1,3
20100702-M-Wimbledon-SF-Tomas_Berdych-Novak_Djokovic,2,F-XC,24,10,4,4,2,19,5
20100702-M-Wimbledon-SF-Tomas_Berdych-Novak_Djokovic,2,F-DTM,15,4,0,2,2,9,6
20100702-M-Wimbledon-SF-Tomas_Berdych-Novak_Djokovic,2,F-DTL,18,1,0,0,1,13,5
20100702-M-Wimbledon-SF-Tomas_Berdych-Novak_Djokovic,2,F-IO,29,7,2,2,3,21,8
20100702-M-Wimbledon-SF-Tomas_Berdych-Novak_Djokovic,2,F-II,2,0,0,0,0,2,0
20100702-M-Wimbledon-SF-Tomas_Berdych-Novak_Djokovic,2,B-XC,35,1,0,0,1,18,17
20100702-M-Wimbledon-SF-Tomas_Berdych-Novak_Djokovic,2,B-DTM,20,2,0,1,1,10,10
20100702-M-Wimbledon-SF-Tomas_Berdych-Novak_Djokovic,2,B-DTL,20,9,2,3,4,10,10
20100702-M-Wimbledon-SF-Tomas_Berdych-Novak_Djokovic,2,B-IO,1,0,0,0,0,1,0
20100702-M-Wimbledon-SF-Tomas_Berdych-Novak_Djokovic,2,S-XC,13,1,1,0,0,6,7
20100702-M-Wimbledon-SF-Tomas_Berdych-Novak_Djokovic,2,S-DTM,5,0,0,0,0,1,4
20100702-M-Wimbledon-SF-Tomas_Berdych-Novak_Djokovic,2,S-DTL,1,1,0,0,1,0,1
20190104-M-Doha-SF-Novak_Djokovic-Roberto_Bautista_Agut,1,F-XC,91,18,7,3,8,35,56
20190104-M-Doha-SF-Novak_Djokovic-Roberto_Bautista_Agut,1,F-DTM,30,3,1,1,1,10,20
20190104-M-Doha-SF-Novak_Djokovic-Roberto_Bautista_Agut,1,F-DTL,48,6,0,1,5,17,31
20190104-M-Doha-SF-Novak_Djokovic-Roberto_Bautista_Agut,1,F-IO,40,14,7,3,4,25,15
20190104-M-Doha-SF-Novak_Djokovic-Roberto_Bautista_Agut,1,F-II,8,5,2,2,1,7,1
20190104-M-Doha-SF-Novak_Djokovic-Roberto_Bautista_Agut,1,B-XC,115,14,3,1,10,54,61
20190104-M-Doha-SF-Novak_Djokovic-Roberto_Bautista_Agut,1,B-DTM,50,1,0,0,1,22,28
20190104-M-Doha-SF-Novak_Djokovic-Roberto_Bautista_Agut,1,B-DTL,34,7,2,1,4,13,21
20190104-M-Doha-SF-Novak_Djokovic-Roberto_Bautista_Agut,1,B-IO,6,2,1,1,0,3,3
20190104-M-Doha-SF-Novak_Djokovic-Roberto_Bautista_Agut,1,S-XC,21,1,0,0,1,6,15
20190104-M-Doha-SF-Novak_Djokovic-Roberto_Bautista_Agut,1,S-DTM,7,0,0,0,0,2,5
20190104-M-Doha-SF-Novak_Djokovic-Roberto_Bautista_Agut,1,S-DTL,4,1,0,0,1,2,2
20190104-M-Doha-SF-Novak_Djokovic-Roberto_Bautista_Agut,1,S-IO,1,0,0,0,0,0,1
20190104-M-Doha-SF-Novak_Djokovic-Roberto_Bautista_Agut,2,F-XC,114,16,10,3,3,77,37
20190104-M-Doha-SF-Novak_Djokovic-Roberto_Bautista_Agut,2,F-DTM,30,1,0,0,1,16,14
20190104-M-Doha-SF-Novak_Djokovic-Roberto_Bautista_Agut,2,F-DTL,27,8,2,4,2,18,9
20190104-M-Doha-SF-Novak_Djokovic-Roberto_Bautista_Agut,2,F-IO,56,12,3,5,4,38,18
20190104-M-Doha-SF-Novak_Djokovic-Roberto_Bautista_Agut,2,F-II,6,1,1,0,0,5,1
20190104-M-Doha-SF-Novak_Djokovic-Roberto_Bautista_Agut,2,B-XC,100,5,1,2,2,53,47
20190104-M-Doha-SF-Novak_Djokovic-Roberto_Bautista_Agut,2,B-DTM,56,1,0,0,1,36,20
20190104-M-Doha-SF-Novak_Djokovic-Roberto_Bautista_Agut,2,B-DTL,15,5,0,3,2,8,7
20190104-M-Doha-SF-Novak_Djokovic-Roberto_Bautista_Agut,2,B-IO,2,0,0,0,0,2,0
20190104-M-Doha-SF-Novak_Djokovic-Roberto_Bautista_Agut,2,S-XC,19,0,0,0,0,6,13
20190104-M-Doha-SF-Novak_Djokovic-Roberto_Bautista_Agut,2,S-DTM,9,0,0,0,0,3,6
20190104-M-Doha-SF-Novak_Djokovic-Roberto_Bautista_Agut,2,S-DTL,6,1,0,0,1,2,4
20190114-M-Australian_Open-R128-Stefanos_Tsitsipas-Matteo_Berrettini,1,F-XC,64,23,6,7,10,31,33
20190114-M-Australian_Open-R128-Stefanos_Tsitsipas-Matteo_Berrettini,1,F-DTM,18,2,0,0,2,9,9
20190114-M-Australian_Open-R128-Stefanos_Tsitsipas-Matteo_Berrettini,1,F-DTL,8,4,1,3,0,6,2
20190114-M-Australian_Open-R128-Stefanos_Tsitsipas-Matteo_Berrettini,1,F-IO,27,8,2,1,5,15,12
20190114-M-Australian_Open-R128-Stefanos_Tsitsipas-Matteo_Berrettini,1,F-II,10,7,3,1,3,7,3
20190114-M-Australian_Open-R128-Stefanos_Tsitsipas-Matteo_Berrettini,1,B-XC,41,5,0,0,5,18,23
20190114-M-Australian_Open-R128-Stefanos_Tsitsipas-Matteo_Berrettini,1,B-DTM,14,0,0,0,0,5,9
20190114-M-Australian_Open-R128-Stefanos_Tsitsipas-Matteo_Berrettini,1,B-DTL,4,2,2,0,0,3,1
20190114-M-Australian_Open-R128-Stefanos_Tsitsipas-Matteo_Berrettini,1,B-IO,1,0,0,0,0,1,0
20190114-M-Australian_Open-R128-Stefanos_Tsitsipas-Matteo_Berrettini,1,S-XC,5,2,0,1,1,1,4
20190114-M-Australian_Open-R128-Stefanos_Tsitsipas-Matteo_Berrettini,1,S-DTM,5,0,0,0,0,2,3
20190114-M-Australian_Open-R128-Stefanos_Tsitsipas-Matteo_Berrettini,1,S-DTL,3,1,0,0,1,0,3
20190114-M-Australian_Open-R128-Stefanos_Tsitsipas-Matteo_Berrettini,2,F-XC,37,19,7,3,9,20,17
20190114-M-Australian_Open-R128-Stefanos_Tsitsipas-Matteo_Berrettini,2,F-DTM,20,3,0,0,3,12,8
20190114-M-Australian_Open-R128-Stefanos_Tsitsipas-Matteo_Berrettini,2,F-DTL,21,7,1,3,3,14,7
20190114-M-Australian_Open-R128-Stefanos_Tsitsipas-Matteo_Berrettini,2,F-IO,40,14,5,3,6,22,18
20190114-M-Australian_Open-R128-Stefanos_Tsitsipas-Matteo_Berrettini,2,F-II,7,4,1,2,1,5,2
20190114-M-Australian_Open-R128-Stefanos_Tsitsipas-Matteo_Berrettini,2,B-XC,33,5,0,1,4,18,15
20190114-M-Australian_Open-R128-Stefanos_Tsitsipas-Matteo_Berrettini,2,B-DTM,12,0,0,0,0,7,5
20190114-M-Australian_Open-R128-Stefanos_Tsitsipas-Matteo_Berrettini,2,B-DTL,4,2,0,1,1,2,2
20190114-M-Australian_Open-R128-Stefanos_Tsitsipas-Matteo_Berrettini,2,S-XC,14,2,0,0,2,7,7
20190114-M-Australian_Open-R128-Stefanos_Tsitsipas-Matteo_Berrettini,2,S-DTM,6,0,0,0,0,4,2
20190114-M-Australian_Open-R128-Stefanos_Tsitsipas-Matteo_Berrettini,2,S-DTL,6,1,1,0,0,3,3
20190114-M-Australian_Open-R128-Stefanos_Tsitsipas-Matteo_Berrettini,2,S-IO,1,0,0,0,0,0,1
20190114-M-Australian_Open-R128-Taylor_Harry_Fritz-Cameron_Norrie,1,F-XC,76,16,6,4,6,38,38
20190114-M-Australian_Open-R128-Taylor_Harry_Fritz-Cameron_Norrie,1,F-DTM,21,1,0,1,0,12,9
20190114-M-Australian_Open-R128-Taylor_Harry_Fritz-Cameron_Norrie,1,F-DTL,24,7,1,3,3,13,11
20190114-M-Australian_Open-R128-Taylor_Harry_Fritz-Cameron_Norrie,1,F-IO,18,9,5,1,3,11,7
20190114-M-Australian_Open-R128-Taylor_Harry_Fritz-Cameron_Norrie,1,F-II,8,5,2,2,1,6,2
20190114-M-Australian_Open-R128-Taylor_Harry_Fritz-Cameron_Norrie,1,B-XC,57,11,4,3,4,28,29
20190114-M-Australian_Open-R128-Taylor_Harry_Fritz-Cameron_Norrie,1,B-DTM,30,2,0,0,2,9,21
20190114-M-Australian_Open-R128-Taylor_Harry_Fritz-Cameron_Norrie,1,B-DTL,17,3,2,0,1,7,10
20190114-M-Australian_Open-R128-Taylor_Harry_Fritz-Cameron_Norrie,1,B-IO,7,2,1,0,1,5,2
20190114-M-Australian_Open-R128-Taylor_Harry_Fritz-Cameron_Norrie,1,S-DTM,1,0,0,0,0,0,1
20190114-M-Australian_Open-R128-Taylor_Harry_Fritz-Cameron_Norrie,2,F-XC,60,7,2,1,4,40,20
20190114-M-Australian_Open-R128-Taylor_Harry_Fritz-Cameron_Norrie,2,F-DTM,25,2,0,0,2,14,11
20190114-M-Australian_Open-R128-Taylor_Harry_Fritz-Cameron_Norrie,2,F-DTL,33,17,5,4,8,17,16
20190114-M-Australian_Open-R128-Taylor_Harry_Fritz-Cameron_Norrie,2,F-IO,25,10,5,0,5,13,12
20190114-M-Australian_Open-R128-Taylor_Harry_Fritz-Cameron_Norrie,2,F-II,1,0,0,0,0,1,0
20190114-M-Australian_Open-R128-Taylor_Harry_Fritz-Cameron_Norrie,2,B-XC,46,6,2,1,3,23,23
20190114-M-Australian_Open-R128-Taylor_Harry_Fritz-Cameron_Norrie,2,B-DTM,28,2,0,0,2,15,13
20190114-M-Australian_Open-R128-Taylor_Harry_Fritz-Cameron_Norrie,2,B-DTL,16,3,0,2,1,8,8
20190114-M-Australian_Open-R128-Taylor_Harry_Fritz-Cameron_Norrie,2,B-IO,5,1,0,0,1,1,4
20190114-M-Australian_Open-R128-Taylor_Harry_Fritz-Cameron_Norrie,2,S-XC,4,0,0,0,0,1,3
20190114-M-Australian_Open-R128-Taylor_Harry_Fritz-Cameron_Norrie,2,S-DTM,9,0,0,0,0,2,7
20190114-M-Australian_Open-R128-Taylor_Harry_Fritz-Cameron_Norrie,2,S-DTL,5,1,0,0,1,3,2
20190114-M-Australian_Open-R128-Taylor_Harry_Fritz-Cameron_Norrie,2,S-IO,3,2,0,1,1,1,2
20190115-M-Australian_Open-R128-Dominic_Thiem-Benoit_Paire,1,F-XC,90,16,4,7,5,52,38
20190115-M-Australian_Open-R128-Dominic_Thiem-Benoit_Paire,1,F-DTM,28,0,0,0,0,12,16
20190115-M-Australian_Open-R128-Dominic_Thiem-Benoit_Paire,1,F-DTL,8,4,3,1,0,7,1
20190115-M-Australian_Open-R128-Dominic_Thiem-Benoit_Paire,1,F-IO,59,15,5,6,4,37,22
20190115-M-Australian_Open-R128-Dominic_Thiem-Benoit_Paire,1,F-II,20,6,1,3,2,14,6
20190115-M-Australian_Open-R128-Dominic_Thiem-Benoit_Paire,1,B-XC,53,13,2,6,5,31,22
20190115-M-Australian_Open-R128-Dominic_Thiem-Benoit_Paire,1,B-DTM,30,3,1,0,2,19,11
20190115-M-Australian_Open-R128-Dominic_Thiem-Benoit_Paire,1,B-DTL,29,11,2,3,6,16,13
20190115-M-Australian_Open-R128-Dominic_Thiem-Benoit_Paire,1,B-IO,4,1,1,0,0,4,0
20190115-M-Australian_Open-R128-Dominic_Thiem-Benoit_Paire,1,S-XC,25,3,1,0,2,16,9
20190115-M-Australian_Open-R128-Dominic_Thiem-Benoit_Paire,1,S-DTM,8,0,0,0,0,2,6
20190115-M-Australian_Open-R128-Dominic_Thiem-Benoit_Paire,1,S-DTL,6,2,0,0,2,2,4
20190115-M-Australian_Open-R128-Dominic_Thiem-Benoit_Paire,1,S-IO,1,0,0,0,0,1,0
20190115-M-Australian_Open-R128-Dominic_Thiem-Benoit_Paire,2,F-XC,77,32,10,4,18,35,42
20190115-M-Australian_Open-R128-Dominic_Thiem-Benoit_Paire,2,F-DTM,43,1,1,0,0,15,28
20190115-M-Australian_Open-R128-Dominic_Thiem-Benoit_Paire,2,F-DTL,46,10,2,1,7,18,28
20190115-M-Australian_Open-R128-Dominic_Thiem-Benoit_Paire,2,F-IO,27,9,4,3,2,18,9
20190115-M-Australian_Open-R128-Dominic_Thiem-Benoit_Paire,2,F-II,1,1,0,1,0,1,0
20190115-M-Australian_Open-R128-Dominic_Thiem-Benoit_Paire,2,B-XC,82,13,2,2,9,32,50
20190115-M-Australian_Open-R128-Dominic_Thiem-Benoit_Paire,2,B-DTM,12,1,0,0,1,3,9
20190115-M-Australian_Open-R128-Dominic_Thiem-Benoit_Paire,2,B-DTL,32,16,4,4,8,16,16
20190115-M-Australian_Open-R128-Dominic_Thiem-Benoit_Paire,2,B-IO,9,3,2,0,1,7,2
20190115-M-Australian_Open-R128-Dominic_Thiem-Benoit_Paire,2,S-XC,1,0,0,0,0,0,1
20190115-M-Australian_Open-R128-Dominic_Thiem-Benoit_Paire,2,S-DTM,3,0,0,0,0,1,2
20100128-M-Australian_Open-SF-Andy_Murray-Marin_Cilic,1,F-XC,93,14,5,2,7,54,39
20100128-M-Australian_Open-SF-Andy_Murray-Marin_Cilic,1,F-DTM,19,0,0,0,0,9,10
20100128-M-Australian_Open-SF-Andy_Murray-Marin_Cilic,1,F-DTL,34,10,5,1,4,27,7
20100128-M-Australian_Open-SF-Andy_Murray-Marin_Cilic,1,F-IO,21,6,2,2,2,17,4
20100128-M-Australian_Open-SF-Andy_Murray-Marin_Cilic,1,F-II,6,2,1,1,0,4,2
20100128-M-Australian_Open-SF-Andy_Murray-Marin_Cilic,1,B-XC,98,10,3,4,3,58,40
20100128-M-Australian_Open-SF-Andy_Murray-Marin_Cilic,1,B-DTM,18,0,0,0,0,13,5
20100128-M-Australian_Open-SF-Andy_Murray-Marin_Cilic,1,B-DTL,29,10,3,5,2,18,11
20100128-M-Australian_Open-SF-Andy_Murray-Marin_Cilic,1,B-IO,2,0,0,0,0,1,1
20100128-M-Australian_Open-SF-Andy_Murray-Marin_Cilic,1,S-XC,40,2,0,1,1,26,14
20100128-M-Australian_Open-SF-Andy_Murray-Marin_Cilic,1,S-DTM,13,1,1,0,0,5,8
20100128-M-Australian_Open-SF-Andy_Murray-Marin_Cilic,1,S-DTL,5,0,0,0,0,3,2
20100128-M-Australian_Open-SF-Andy_Murray-Marin_Cilic,1,S-IO,1,0,0,0,0,1,0
20100128-M-Australian_Open-SF-Andy_Murray-Marin_Cilic,2,F-XC,84,18,5,5,8,42,42
20100128-M-Australian_Open-SF-Andy_Murray-Marin_Cilic,2,F-DTM,26,4,0,0,4,7,19
20100128-M-Australian_Open-SF-Andy_Murray-Marin_Cilic,2,F-DTL,38,9,4,3,2,18,20
20100128-M-Australian_Open-SF-Andy_Murray-Marin_Cilic,2,F-IO,39,12,5,0,7,17,22
20100128-M-Australian_Open-SF-Andy_Murray-Marin_Cilic,2,F-II,13,3,1,2,0,5,8
20100128-M-Australian_Open-SF-Andy_Murray-Marin_Cilic,2,B-XC,105,16,1,5,10,41,64
20100128-M-Australian_Open-SF-Andy_Murray-Marin_Cilic,2,B-DTM,31,1,0,0,1,13,18
20100128-M-Australian_Open-SF-Andy_Murray-Marin_Cilic,2,B-DTL,26,5,1,2,2,10,16
20100128-M-Australian_Open-SF-Andy_Murray-Marin_Cilic,2,B-IO,5,0,0,0,0,1,4
20100128-M-Australian_Open-SF-Andy_Murray-Marin_Cilic,2,S-XC,19,0,0,0,0,8,11
20100128-M-Australian_Open-SF-Andy_Murray-Marin_Cilic,2,S-DTM,5,0,0,0,0,1,4
20100128-M-Australian_Open-SF-Andy_Murray-Marin_Cilic,2,S-DTL,2,0,0,0,0,0,2
20100128-M-Australian_Open-SF-Andy_Murray-Marin_Cilic,2,S-IO,1,0,0,0,0,0,1
20100128-M-Australian_Open-SF-Andy_Murray-Marin_Cilic,2,S-II,1,0,0,0,0,0,1
20190115-M-Australian_Open-R128-Pierre_Hugues_Herbert-Sam_Querrey,1,F-XC,45,14,9,1,4,30,15
20190115-M-Australian_Open-R128-Pierre_Hugues_Herbert-Sam_Querrey,1,F-DTM,14,2,1,0,1,10,4
20190115-M-Australian_Open-R128-Pierre_Hugues_Herbert-Sam_Querrey,1,F-DTL,11,8,1,3,4,5,6
20190115-M-Australian_Open-R128-Pierre_Hugues_Herbert-Sam_Querrey,1,F-IO,10,5,2,1,2,6,4
20190115-M-Australian_Open-R128-Pierre_Hugues_Herbert-Sam_Querrey,1,F-II,2,1,0,0,1,0,2
20190115-M-Australian_Open-R128-Pierre_Hugues_Herbert-Sam_Querrey,1,B-XC,26,6,4,1,1,19,7
20190115-M-Australian_Open-R128-Pierre_Hugues_Herbert-Sam_Querrey,1,B-DTM,9,0,0,0,0,8,1
20190115-M-Australian_Open-R128-Pierre_Hugues_Herbert-Sam_Querrey,1,B-DTL,10,5,4,1,0,9,1
20190115-M-Australian_Open-R128-Pierre_Hugues_Herbert-Sam_Querrey,1,S-XC,4,0,0,0,0,2,2
20190115-M-Australian_Open-R128-Pierre_Hugues_Herbert-Sam_Querrey,1,S-DTM,3,0,0,0,0,3,0
20190115-M-Australian_Open-R128-Pierre_Hugues_Herbert-Sam_Querrey,1,S-DTL,2,1,1,0,0,1,1
20190115-M-Australian_Open-R128-Pierre_Hugues_Herbert-Sam_Querrey,1,S-IO,1,1,0,0,1,0,1
20190115-M-Australian_Open-R128-Pierre_Hugues_Herbert-Sam_Querrey,2,F-XC,56,15,5,3,7,21,35
20190115-M-Australian_Open-R128-Pierre_Hugues_Herbert-Sam_Querrey,2,F-DTM,9,0,0,0,0,3,6
20190115-M-Australian_Open-R128-Pierre_Hugues_Herbert-Sam_Querrey,2,F-DTL,13,6,4,0,2,5,8
20190115-M-Australian_Open-R128-Pierre_Hugues_Herbert-Sam_Querrey,2,F-IO,9,3,2,1,0,3,6
20190115-M-Australian_Open-R128-Pierre_Hugues_Herbert-Sam_Querrey,2,F-II,3,1,0,0,1,1,2
20190115-M-Australian_Open-R128-Pierre_Hugues_Herbert-Sam_Querrey,2,B-XC,23,10,2,1,7,8,15
20190115-M-Australian_Open-R128-Pierre_Hugues_Herbert-Sam_Querrey,2,B-DTM,6,0,0,0,0,1,5
20190115-M-Australian_Open-R128-Pierre_Hugues_Herbert-Sam_Querrey,2,B-DTL,7,3,3,0,0,3,4
20190115-M-Australian_Open-R128-Pierre_Hugues_Herbert-Sam_Querrey,2,B-IO,6,1,1,0,0,2,4
20190115-M-Australian_Open-R128-Pierre_Hugues_Herbert-Sam_Querrey,2,S-XC,6,1,0,0,1,1,5
20190115-M-Australian_Open-R128-Pierre_Hugues_Herbert-Sam_Querrey,2,S-DTM,1,0,0,0,0,1,0
20190115-M-Australian_Open-R128-Pierre_Hugues_Herbert-Sam_Querrey,2,S-DTL,3,0,0,0,0,1,2
20190116-M-Australian_Open-R64-Kevin_Anderson-Francis_Tiafoe,1,F-XC,44,14,4,6,4,14,30
20190116-M-Australian_Open-R64-Kevin_Anderson-Francis_Tiafoe,1,F-DTM,17,0,0,0,0,4,13
20190116-M-Australian_Open-R64-Kevin_Anderson-Francis_Tiafoe,1,F-DTL,6,3,1,1,1,3,3
20190116-M-Australian_Open-R64-Kevin_Anderson-Francis_Tiafoe,1,F-IO,42,13,3,3,7,19,23
20190116-M-Australian_Open-R64-Kevin_Anderson-Francis_Tiafoe,1,F-II,4,2,0,1,1,1,3
20190116-M-Australian_Open-R64-Kevin_Anderson-Francis_Tiafoe,1,B-XC,55,11,2,3,6,21,34
20190116-M-Australian_Open-R64-Kevin_Anderson-Francis_Tiafoe,1,B-DTM,24,3,0,0,3,11,13
20190116-M-Australian_Open-R64-Kevin_Anderson-Francis_Tiafoe,1,B-DTL,12,4,3,0,1,6,6
20190116-M-Australian_Open-R64-Kevin_Anderson-Francis_Tiafoe,1,B-IO,3,1,0,0,1,2,1
20190116-M-Australian_Open-R64-Kevin_Anderson-Francis_Tiafoe,1,S-XC,23,1,1,0,0,8,15
20190116-M-Australian_Open-R64-Kevin_Anderson-Francis_Tiafoe,1,S-DTM,3,0,0,0,0,2,1
20190116-M-Australian_Open-R64-Kevin_Anderson-Francis_Tiafoe,1,S-DTL,2,0,0,0,0,1,1
20190116-M-Australian_Open-R64-Kevin_Anderson-Francis_Tiafoe,1,S-II,1,1,1,0,0,1,0
20190116-M-Australian_Open-R64-Kevin_Anderson-Francis_Tiafoe,2,F-XC,44,15,5,3,7,30,14
20190116-M-Australian_Open-R64-Kevin_Anderson-Francis_Tiafoe,2,F-DTM,22,6,1,0,5,11,11
20190116-M-Australian_Open-R64-Kevin_Anderson-Francis_Tiafoe,2,F-DTL,14,5,2,1,2,8,6
20190116-M-Australian_Open-R64-Kevin_Anderson-Francis_Tiafoe,2,F-IO,17,6,3,1,2,9,8
20190116-M-Australian_Open-R64-Kevin_Anderson-Francis_Tiafoe,2,F-II,5,3,2,1,0,5,0
20190116-M-Australian_Open-R64-Kevin_Anderson-Francis_Tiafoe,2,B-XC,61,8,3,2,3,37,24
20190116-M-Australian_Open-R64-Kevin_Anderson-Francis_Tiafoe,2,B-DTM,24,2,0,0,2,13,11
20190116-M-Australian_Open-R64-Kevin_Anderson-Francis_Tiafoe,2,B-DTL,9,3,2,0,1,5,4
20190116-M-Australian_Open-R64-Kevin_Anderson-Francis_Tiafoe,2,B-IO,1,1,1,0,0,1,0
20190116-M-Australian_Open-R64-Kevin_Anderson-Francis_Tiafoe,2,S-XC,23,1,0,1,0,19,4
20190116-M-Australian_Open-R64-Kevin_Anderson-Francis_Tiafoe,2,S-DTM,7,1,0,0,1,3,4
20190116-M-Australian_Open-R64-Kevin_Anderson-Francis_Tiafoe,2,S-DTL,5,0,0,0,0,3,2
20190116-M-Australian_Open-R64-Kevin_Anderson-Francis_Tiafoe,2,S-IO,2,1,0,0,1,1,1
19870704-M-Wimbledon-SF-Stefan_Edberg-Ivan_Lendl,1,F-XC,4,3,1,1,1,3,1
19870704-M-Wimbledon-SF-Stefan_Edberg-Ivan_Lendl,1,F-DTL,2,2,1,0,1,1,1
19870704-M-Wimbledon-SF-Stefan_Edberg-Ivan_Lendl,1,F-IO,1,1,0,1,0,1,0
19870704-M-Wimbledon-SF-Stefan_Edberg-Ivan_Lendl,1,B-XC,1,1,0,0,1,0,1
19870704-M-Wimbledon-SF-Stefan_Edberg-Ivan_Lendl,1,B-DTM,2,0,0,0,0,0,2
19870704-M-Wimbledon-SF-Stefan_Edberg-Ivan_Lendl,1,B-DTL,8,5,3,0,2,4,4
19870704-M-Wimbledon-SF-Stefan_Edberg-Ivan_Lendl,1,S-DTM,1,0,0,0,0,0,1
19870704-M-Wimbledon-SF-Stefan_Edberg-Ivan_Lendl,1,S-DTL,1,0,0,0,0,0,1
19870704-M-Wimbledon-SF-Stefan_Edberg-Ivan_Lendl,2,F-XC,1,0,0,0,0,1,0
19870704-M-Wimbledon-SF-Stefan_Edberg-Ivan_Lendl,2,F-DTM,1,0,0,0,0,0,1
19870704-M-Wimbledon-SF-Stefan_Edberg-Ivan_Lendl,2,F-DTL,4,2,1,1,0,2,2
19870704-M-Wimbledon-SF-Stefan_Edberg-Ivan_Lendl,2,F-IO,6,4,4,0,0,5,1
19870704-M-Wimbledon-SF-Stefan_Edberg-Ivan_Lendl,2,B-XC,3,2,1,0,1,1,2
19870704-M-Wimbledon-SF-Stefan_Edberg-Ivan_Lendl,2,B-DTM,3,2,0,1,1,1,2
19870704-M-Wimbledon-SF-Stefan_Edberg-Ivan_Lendl,2,B-DTL,4,1,0,1,0,1,3
19870704-M-Wimbledon-SF-Stefan_Edberg-Ivan_Lendl,2,B-IO,1,1,1,0,0,1,0
19870704-M-Wimbledon-SF-Stefan_Edberg-Ivan_Lendl,2,S-DTL,1,0,0,0,0,1,0
20190117-M-Australian_Open-R64-Marius_Copil-David_Goffin,1,F-XC,41,19,5,5,9,16,25
20190117-M-Australian_Open-R64-Marius_Copil-David_Goffin,1,F-DTM,21,1,0,0,1,7,14
20190117-M-Australian_Open-R64-Marius_Copil-David_Goffin,1,F-DTL,11,8,1,2,5,4,7
20190117-M-Australian_Open-R64-Marius_Copil-David_Goffin,1,F-IO,18,8,1,4,3,9,9
20190117-M-Australian_Open-R64-Marius_Copil-David_Goffin,1,F-II,1,0,0,0,0,0,1
20190117-M-Australian_Open-R64-Marius_Copil-David_Goffin,1,B-XC,29,7,2,1,4,14,15
20190117-M-Australian_Open-R64-Marius_Copil-David_Goffin,1,B-DTM,16,1,0,0,1,7,9
20190117-M-Australian_Open-R64-Marius_Copil-David_Goffin,1,B-DTL,12,7,1,1,5,4,8
20190117-M-Australian_Open-R64-Marius_Copil-David_Goffin,1,S-XC,17,4,0,1,3,6,11
20190117-M-Australian_Open-R64-Marius_Copil-David_Goffin,1,S-DTM,9,1,0,0,1,3,6
20190117-M-Australian_Open-R64-Marius_Copil-David_Goffin,1,S-DTL,1,0,0,0,0,0,1
20190117-M-Australian_Open-R64-Marius_Copil-David_Goffin,1,S-IO,1,0,0,0,0,0,1
20190117-M-Australian_Open-R64-Marius_Copil-David_Goffin,2,F-XC,44,10,3,3,4,30,14
20190117-M-Australian_Open-R64-Marius_Copil-David_Goffin,2,F-DTM,19,3,1,0,2,8,11
20190117-M-Australian_Open-R64-Marius_Copil-David_Goffin,2,F-DTL,20,7,6,0,1,14,6
20190117-M-Australian_Open-R64-Marius_Copil-David_Goffin,2,F-IO,25,7,3,3,1,17,8
20190117-M-Australian_Open-R64-Marius_Copil-David_Goffin,2,F-II,6,2,0,1,1,4,2
20190117-M-Australian_Open-R64-Marius_Copil-David_Goffin,2,B-XC,28,4,3,0,1,17,11
20190117-M-Australian_Open-R64-Marius_Copil-David_Goffin,2,B-DTM,19,2,0,0,2,9,10
20190117-M-Australian_Open-R64-Marius_Copil-David_Goffin,2,B-DTL,9,8,3,2,3,5,4
20190117-M-Australian_Open-R64-Marius_Copil-David_Goffin,2,B-IO,1,0,0,0,0,1,0
20190117-M-Australian_Open-R64-Marius_Copil-David_Goffin,2,S-XC,5,0,0,0,0,3,2
20190117-M-Australian_Open-R64-Marius_Copil-David_Goffin,2,S-DTM,5,0,0,0,0,2,3
20190117-M-Australian_Open-R64-Marius_Copil-David_Goffin,2,S-DTL,1,0,0,0,0,1,0
19900908-M-US_Open-SF-Andre_Agassi-Boris_Becker,1,F-XC,67,19,6,6,7,40,27
19900908-M-US_Open-SF-Andre_Agassi-Boris_Becker,1,F-DTM,26,2,0,1,1,15,11
19900908-M-US_Open-SF-Andre_Agassi-Boris_Becker,1,F-DTL,26,6,3,0,3,13,13
19900908-M-US_Open-SF-Andre_Agassi-Boris_Becker,1,F-IO,52,12,4,3,5,29,23
19900908-M-US_Open-SF-Andre_Agassi-Boris_Becker,1,F-II,19,8,5,2,1,13,6
19900908-M-US_Open-SF-Andre_Agassi-Boris_Becker,1,B-XC,118,19,5,6,8,66,52
19900908-M-US_Open-SF-Andre_Agassi-Boris_Becker,1,B-DTM,17,2,0,0,2,7,10
19900908-M-US_Open-SF-Andre_Agassi-Boris_Becker,1,B-DTL,42,18,5,8,5,28,14
19900908-M-US_Open-SF-Andre_Agassi-Boris_Becker,1,B-IO,4,2,0,0,2,1,3
19900908-M-US_Open-SF-Andre_Agassi-Boris_Becker,1,S-XC,13,1,0,0,1,7,6
19900908-M-US_Open-SF-Andre_Agassi-Boris_Becker,1,S-DTM,4,0,0,0,0,3,1
19900908-M-US_Open-SF-Andre_Agassi-Boris_Becker,1,S-DTL,4,1,0,1,0,2,2
19900908-M-US_Open-SF-Andre_Agassi-Boris_Becker,2,F-XC,65,16,7,4,5,36,29
19900908-M-US_Open-SF-Andre_Agassi-Boris_Becker,2,F-DTM,19,1,0,0,1,7,12
19900908-M-US_Open-SF-Andre_Agassi-Boris_Becker,2,F-DTL,47,10,2,2,6,19,28
19900908-M-US_Open-SF-Andre_Agassi-Boris_Becker,2,F-IO,34,3,1,1,1,12,22
19900908-M-US_Open-SF-Andre_Agassi-Boris_Becker,2,F-II,6,4,1,1,2,3,3
19900908-M-US_Open-SF-Andre_Agassi-Boris_Becker,2,B-XC,66,12,1,2,9,26,40
19900908-M-US_Open-SF-Andre_Agassi-Boris_Becker,2,B-DTM,24,1,0,0,1,12,12
19900908-M-US_Open-SF-Andre_Agassi-Boris_Becker,2,B-DTL,27,13,3,3,7,11,16
19900908-M-US_Open-SF-Andre_Agassi-Boris_Becker,2,B-IO,5,2,1,0,1,2,3
19900908-M-US_Open-SF-Andre_Agassi-Boris_Becker,2,S-XC,56,6,0,2,4,27,29
19900908-M-US_Open-SF-Andre_Agassi-Boris_Becker,2,S-DTM,18,1,0,0,1,4,14
19900908-M-US_Open-SF-Andre_Agassi-Boris_Becker,2,S-DTL,9,1,0,0,1,4,5
19930703-M-Wimbledon-SF-Pete_Sampras-Boris_Becker,1,F-XC,3,1,1,0,0,2,1
19930703-M-Wimbledon-SF-Pete_Sampras-Boris_Becker,1,F-DTM,1,1,0,0,1,0,1
19930703-M-Wimbledon-SF-Pete_Sampras-Boris_Becker,1,F-IO,1,0,0,0,0,0,1
19930703-M-Wimbledon-SF-Pete_Sampras-Boris_Becker,1,B-XC,7,4,3,1,0,4,3
19930703-M-Wimbledon-SF-Pete_Sampras-Boris_Becker,1,B-DTM,3,1,0,0,1,0,3
19930703-M-Wimbledon-SF-Pete_Sampras-Boris_Becker,1,B-DTL,1,0,0,0,0,1,0
19930703-M-Wimbledon-SF-Pete_Sampras-Boris_Becker,1,B-IO,1,1,0,0,1,0,1
19930703-M-Wimbledon-SF-Pete_Sampras-Boris_Becker,1,S-XC,2,0,0,0,0,0,2
19930703-M-Wimbledon-SF-Pete_Sampras-Boris_Becker,1,S-DTL,1,1,1,0,0,1,0
19930703-M-Wimbledon-SF-Pete_Sampras-Boris_Becker,2,F-XC,2,0,0,0,0,0,2
19930703-M-Wimbledon-SF-Pete_Sampras-Boris_Becker,2,F-DTM,1,0,0,0,0,0,1
19930703-M-Wimbledon-SF-Pete_Sampras-Boris_Becker,2,F-DTL,2,0,0,0,0,0,2
19930703-M-Wimbledon-SF-Pete_Sampras-Boris_Becker,2,B-XC,4,2,1,1,0,3,1
19930703-M-Wimbledon-SF-Pete_Sampras-Boris_Becker,2,B-DTL,3,3,1,0,2,1,2
19930703-M-Wimbledon-SF-Pete_Sampras-Boris_Becker,2,B-IO,2,1,1,0,0,1,1
19930703-M-Wimbledon-SF-Pete_Sampras-Boris_Becker,2,S-XC,1,1,0,1,0,1,0
19930703-M-Wimbledon-SF-Pete_Sampras-Boris_Becker,2,S-DTL,3,2,0,2,0,3,0
20190118-M-Australian_Open-R32-Stefanos_Tsitsipas-Nikoloz_Basilashvili,1,F-XC,70,8,2,2,4,35,35
20190118-M-Australian_Open-R32-Stefanos_Tsitsipas-Nikoloz_Basilashvili,1,F-DTM,25,0,0,0,0,10,15
20190118-M-Australian_Open-R32-Stefanos_Tsitsipas-Nikoloz_Basilashvili,1,F-DTL,21,9,1,4,4,9,12
20190118-M-Australian_Open-R32-Stefanos_Tsitsipas-Nikoloz_Basilashvili,1,F-IO,9,4,1,3,0,6,3
20190118-M-Australian_Open-R32-Stefanos_Tsitsipas-Nikoloz_Basilashvili,1,F-II,8,3,0,1,2,5,3
20190118-M-Australian_Open-R32-Stefanos_Tsitsipas-Nikoloz_Basilashvili,1,B-XC,38,4,0,1,3,13,25
20190118-M-Australian_Open-R32-Stefanos_Tsitsipas-Nikoloz_Basilashvili,1,B-DTM,22,1,0,0,1,10,12
20190118-M-Australian_Open-R32-Stefanos_Tsitsipas-Nikoloz_Basilashvili,1,B-DTL,8,3,1,1,1,2,6
20190118-M-Australian_Open-R32-Stefanos_Tsitsipas-Nikoloz_Basilashvili,1,S-XC,26,0,0,0,0,10,16
20190118-M-Australian_Open-R32-Stefanos_Tsitsipas-Nikoloz_Basilashvili,1,S-DTM,16,1,0,0,1,3,13
20190118-M-Australian_Open-R32-Stefanos_Tsitsipas-Nikoloz_Basilashvili,1,S-DTL,1,0,0,0,0,0,1
20190118-M-Australian_Open-R32-Stefanos_Tsitsipas-Nikoloz_Basilashvili,2,F-XC,86,35,17,7,11,53,33
20190118-M-Australian_Open-R32-Stefanos_Tsitsipas-Nikoloz_Basilashvili,2,F-DTM,25,2,0,0,2,8,17
20190118-M-Australian_Open-R32-Stefanos_Tsitsipas-Nikoloz_Basilashvili,2,F-DTL,32,13,2,5,6,19,13
20190118-M-Australian_Open-R32-Stefanos_Tsitsipas-Nikoloz_Basilashvili,2,F-IO,40,10,2,2,6,25,15
20190118-M-Australian_Open-R32-Stefanos_Tsitsipas-Nikoloz_Basilashvili,2,F-II,11,5,1,3,1,9,2
20190118-M-Australian_Open-R32-Stefanos_Tsitsipas-Nikoloz_Basilashvili,2,B-XC,62,13,3,2,8,38,24
20190118-M-Australian_Open-R32-Stefanos_Tsitsipas-Nikoloz_Basilashvili,2,B-DTM,7,1,0,0,1,4,3
20190118-M-Australian_Open-R32-Stefanos_Tsitsipas-Nikoloz_Basilashvili,2,B-DTL,11,4,2,0,2,7,4
20190118-M-Australian_Open-R32-Stefanos_Tsitsipas-Nikoloz_Basilashvili,2,B-IO,5,3,1,1,1,3,2
20190118-M-Australian_Open-R32-Stefanos_Tsitsipas-Nikoloz_Basilashvili,2,S-XC,7,0,0,0,0,2,5
20190118-M-Australian_Open-R32-Stefanos_Tsitsipas-Nikoloz_Basilashvili,2,S-DTM,2,0,0,0,0,1,1
20190118-M-Australian_Open-R32-Stefanos_Tsitsipas-Nikoloz_Basilashvili,2,S-DTL,2,1,0,0,1,0,2
20100124-M-Australian_Open-R16-Roger_Federer-Lleyton_Hewitt,1,F-XC,52,10,6,2,2,28,24
20100124-M-Australian_Open-R16-Roger_Federer-Lleyton_Hewitt,1,F-DTM,21,1,0,0,1,9,12
20100124-M-Australian_Open-R16-Roger_Federer-Lleyton_Hewitt,1,F-DTL,23,7,4,2,1,11,12
20100124-M-Australian_Open-R16-Roger_Federer-Lleyton_Hewitt,1,F-IO,37,8,5,1,2,22,15
20100124-M-Australian_Open-R16-Roger_Federer-Lleyton_Hewitt,1,F-II,12,5,3,1,1,7,5
20100124-M-Australian_Open-R16-Roger_Federer-Lleyton_Hewitt,1,B-XC,59,9,4,2,3,37,22
20100124-M-Australian_Open-R16-Roger_Federer-Lleyton_Hewitt,1,B-DTM,13,2,0,0,2,3,10
20100124-M-Australian_Open-R16-Roger_Federer-Lleyton_Hewitt,1,B-DTL,13,9,6,2,1,11,2
20100124-M-Australian_Open-R16-Roger_Federer-Lleyton_Hewitt,1,S-XC,30,2,0,0,2,14,16
20100124-M-Australian_Open-R16-Roger_Federer-Lleyton_Hewitt,1,S-DTM,7,0,0,0,0,5,2
20100124-M-Australian_Open-R16-Roger_Federer-Lleyton_Hewitt,1,S-DTL,6,0,0,0,0,4,2
20100124-M-Australian_Open-R16-Roger_Federer-Lleyton_Hewitt,2,F-XC,47,3,1,1,1,24,23
20100124-M-Australian_Open-R16-Roger_Federer-Lleyton_Hewitt,2,F-DTM,21,2,1,0,1,13,8
20100124-M-Australian_Open-R16-Roger_Federer-Lleyton_Hewitt,2,F-DTL,26,1,0,0,1,8,18
20100124-M-Australian_Open-R16-Roger_Federer-Lleyton_Hewitt,2,F-IO,42,10,2,4,4,22,20
20100124-M-Australian_Open-R16-Roger_Federer-Lleyton_Hewitt,2,F-II,4,2,0,1,1,2,2
20100124-M-Australian_Open-R16-Roger_Federer-Lleyton_Hewitt,2,B-XC,75,10,0,6,4,31,44
20100124-M-Australian_Open-R16-Roger_Federer-Lleyton_Hewitt,2,B-DTM,25,1,0,1,0,12,13
20100124-M-Australian_Open-R16-Roger_Federer-Lleyton_Hewitt,2,B-DTL,19,6,1,3,2,12,7
20100124-M-Australian_Open-R16-Roger_Federer-Lleyton_Hewitt,2,S-XC,19,3,1,1,1,10,9
20100124-M-Australian_Open-R16-Roger_Federer-Lleyton_Hewitt,2,S-DTM,1,0,0,0,0,1,0
20100124-M-Australian_Open-R16-Roger_Federer-Lleyton_Hewitt,2,S-DTL,2,0,0,0,0,1,1
20050415-M-Monte_Carlo_Masters-QF-Roger_Federer-Richard_Gasquet,1,F-XC,66,16,6,5,5,39,27
20050415-M-Monte_Carlo_Masters-QF-Roger_Federer-Richard_Gasquet,1,F-DTM,10,1,0,1,0,7,3
20050415-M-Monte_Carlo_Masters-QF-Roger_Federer-Richard_Gasquet,1,F-DTL,17,5,1,2,2,12,5
20050415-M-Monte_Carlo_Masters-QF-Roger_Federer-Richard_Gasquet,1,F-IO,32,12,1,6,5,16,16
20050415-M-Monte_Carlo_Masters-QF-Roger_Federer-Richard_Gasquet,1,F-II,15,4,1,2,1,10,5
20050415-M-Monte_Carlo_Masters-QF-Roger_Federer-Richard_Gasquet,1,B-XC,53,9,0,4,5,26,27
20050415-M-Monte_Carlo_Masters-QF-Roger_Federer-Richard_Gasquet,1,B-DTM,21,0,0,0,0,10,11
20050415-M-Monte_Carlo_Masters-QF-Roger_Federer-Richard_Gasquet,1,B-DTL,22,4,1,1,2,11,11
20050415-M-Monte_Carlo_Masters-QF-Roger_Federer-Richard_Gasquet,1,S-XC,20,0,0,0,0,7,13
20050415-M-Monte_Carlo_Masters-QF-Roger_Federer-Richard_Gasquet,1,S-DTM,8,0,0,0,0,3,5
20050415-M-Monte_Carlo_Masters-QF-Roger_Federer-Richard_Gasquet,1,S-DTL,3,1,0,0,1,0,3
20050415-M-Monte_Carlo_Masters-QF-Roger_Federer-Richard_Gasquet,2,F-XC,55,13,4,5,4,27,28
20050415-M-Monte_Carlo_Masters-QF-Roger_Federer-Richard_Gasquet,2,F-DTM,16,1,0,0,1,4,12
20050415-M-Monte_Carlo_Masters-QF-Roger_Federer-Richard_Gasquet,2,F-DTL,26,8,1,5,2,12,14
20050415-M-Monte_Carlo_Masters-QF-Roger_Federer-Richard_Gasquet,2,F-IO,39,7,2,2,3,26,13
20050415-M-Monte_Carlo_Masters-QF-Roger_Federer-Richard_Gasquet,2,B-XC,83,8,2,4,2,42,41
20050415-M-Monte_Carlo_Masters-QF-Roger_Federer-Richard_Gasquet,2,B-DTM,12,1,0,0,1,4,8
20050415-M-Monte_Carlo_Masters-QF-Roger_Federer-Richard_Gasquet,2,B-DTL,28,16,2,5,9,9,19
20050415-M-Monte_Carlo_Masters-QF-Roger_Federer-Richard_Gasquet,2,B-IO,6,3,0,1,2,4,2
20050415-M-Monte_Carlo_Masters-QF-Roger_Federer-Richard_Gasquet,2,S-XC,8,0,0,0,0,2,6
20050415-M-Monte_Carlo_Masters-QF-Roger_Federer-Richard_Gasquet,2,S-DTM,1,0,0,0,0,0,1
20050415-M-Monte_Carlo_Masters-QF-Roger_Federer-Richard_Gasquet,2,S-DTL,2,0,0,0,0,0,2
19900908-M-US_Open-SF-John_Mcenroe-Pete_Sampras,1,F-XC,8,3,3,0,0,4,4
19900908-M-US_Open-SF-John_Mcenroe-Pete_Sampras,1,F-DTM,2,1,0,1,0,1,1
19900908-M-US_Open-SF-John_Mcenroe-Pete_Sampras,1,F-DTL,3,0,0,0,0,0,3
19900908-M-US_Open-SF-John_Mcenroe-Pete_Sampras,1,F-IO,1,0,0,0,0,1,0
19900908-M-US_Open-SF-John_Mcenroe-Pete_Sampras,1,B-XC,5,3,2,0,1,3,2
19900908-M-US_Open-SF-John_Mcenroe-Pete_Sampras,1,B-DTM,3,0,0,0,0,0,3
19900908-M-US_Open-SF-John_Mcenroe-Pete_Sampras,1,B-DTL,5,2,1,0,1,3,2
19900908-M-US_Open-SF-John_Mcenroe-Pete_Sampras,1,B-IO,1,0,0,0,0,0,1
19900908-M-US_Open-SF-John_Mcenroe-Pete_Sampras,1,S-DTM,1,0,0,0,0,0,1
19900908-M-US_Open-SF-John_Mcenroe-Pete_Sampras,2,F-XC,12,6,3,1,2,7,5
19900908-M-US_Open-SF-John_Mcenroe-Pete_Sampras,2,F-DTM,5,2,0,2,0,4,1
19900908-M-US_Open-SF-John_Mcenroe-Pete_Sampras,2,F-DTL,3,2,0,0,2,1,2
19900908-M-US_Open-SF-John_Mcenroe-Pete_Sampras,2,F-IO,10,5,1,4,0,9,1
19900908-M-US_Open-SF-John_Mcenroe-Pete_Sampras,2,F-II,1,1,0,1,0,1,0
19900908-M-US_Open-SF-John_Mcenroe-Pete_Sampras,2,B-XC,7,4,0,1,3,3,4
19900908-M-US_Open-SF-John_Mcenroe-Pete_Sampras,2,B-DTM,4,1,0,1,0,2,2
19900908-M-US_Open-SF-John_Mcenroe-Pete_Sampras,2,B-DTL,18,10,5,0,5,8,10
19900908-M-US_Open-SF-John_Mcenroe-Pete_Sampras,2,B-IO,1,1,0,0,1,0,1
19900908-M-US_Open-SF-John_Mcenroe-Pete_Sampras,2,S-XC,1,1,1,0,0,1,0
19900908-M-US_Open-SF-John_Mcenroe-Pete_Sampras,2,S-DTM,1,0,0,0,0,1,0
19900908-M-US_Open-SF-John_Mcenroe-Pete_Sampras,2,S-DTL,1,0,0,0,0,1,0
19900908-M-US_Open-SF-John_Mcenroe-Pete_Sampras,2,S-IO,2,1,0,0,1,1,1
20190118-M-Australian_Open-R32-Fernando_Verdasco-Marin_Cilic,1,F-XC,59,12,8,2,2,30,29
20190118-M-Australian_Open-R32-Fernando_Verdasco-Marin_Cilic,1,F-DTM,29,2,0,0,2,10,19
20190118-M-Australian_Open-R32-Fernando_Verdasco-Marin_Cilic,1,F-DTL,23,14,6,1,7,10,13
20190118-M-Australian_Open-R32-Fernando_Verdasco-Marin_Cilic,1,F-IO,23,13,7,2,4,13,10
20190118-M-Australian_Open-R32-Fernando_Verdasco-Marin_Cilic,1,F-II,1,1,0,0,1,0,1
20190118-M-Australian_Open-R32-Fernando_Verdasco-Marin_Cilic,1,B-XC,69,15,2,1,12,28,41
20190118-M-Australian_Open-R32-Fernando_Verdasco-Marin_Cilic,1,B-DTM,55,2,0,0,2,21,34
20190118-M-Australian_Open-R32-Fernando_Verdasco-Marin_Cilic,1,B-DTL,28,10,1,3,6,13,15
20190118-M-Australian_Open-R32-Fernando_Verdasco-Marin_Cilic,1,B-IO,7,2,1,1,0,4,3
20190118-M-Australian_Open-R32-Fernando_Verdasco-Marin_Cilic,1,S-XC,10,0,0,0,0,5,5
20190118-M-Australian_Open-R32-Fernando_Verdasco-Marin_Cilic,1,S-DTM,12,0,0,0,0,1,11
20190118-M-Australian_Open-R32-Fernando_Verdasco-Marin_Cilic,1,S-DTL,7,0,0,0,0,0,7
20190118-M-Australian_Open-R32-Fernando_Verdasco-Marin_Cilic,1,S-IO,1,0,0,0,0,0,1
20190118-M-Australian_Open-R32-Fernando_Verdasco-Marin_Cilic,2,F-XC,144,26,6,8,12,89,55
20190118-M-Australian_Open-R32-Fernando_Verdasco-Marin_Cilic,2,F-DTM,15,2,0,1,1,11,4
20190118-M-Australian_Open-R32-Fernando_Verdasco-Marin_Cilic,2,F-DTL,25,14,8,3,3,15,10
20190118-M-Australian_Open-R32-Fernando_Verdasco-Marin_Cilic,2,F-IO,31,15,6,3,6,20,11
20190118-M-Australian_Open-R32-Fernando_Verdasco-Marin_Cilic,2,F-II,13,7,4,1,2,8,5
20190118-M-Australian_Open-R32-Fernando_Verdasco-Marin_Cilic,2,B-XC,48,15,5,4,6,31,17
20190118-M-Australian_Open-R32-Fernando_Verdasco-Marin_Cilic,2,B-DTM,33,5,1,0,4,19,14
20190118-M-Australian_Open-R32-Fernando_Verdasco-Marin_Cilic,2,B-DTL,24,8,2,1,5,16,8
20190118-M-Australian_Open-R32-Fernando_Verdasco-Marin_Cilic,2,B-IO,18,4,0,2,2,9,9
20190118-M-Australian_Open-R32-Fernando_Verdasco-Marin_Cilic,2,B-II,1,0,0,0,0,1,0
20190118-M-Australian_Open-R32-Fernando_Verdasco-Marin_Cilic,2,S-XC,2,0,0,0,0,1,1
20190118-M-Australian_Open-R32-Fernando_Verdasco-Marin_Cilic,2,S-DTM,3,0,0,0,0,1,2
20190118-M-Australian_Open-R32-Fernando_Verdasco-Marin_Cilic,2,S-DTL,2,0,0,0,0,1,1
20190114-M-Australian_Open-R128-Jason_Kubler-Thomas_Fabbiano,1,F-XC,47,15,5,5,5,29,18
20190114-M-Australian_Open-R128-Jason_Kubler-Thomas_Fabbiano,1,F-DTM,20,0,0,0,0,6,14
20190114-M-Australian_Open-R128-Jason_Kubler-Thomas_Fabbiano,1,F-DTL,26,12,5,0,7,10,16
20190114-M-Australian_Open-R128-Jason_Kubler-Thomas_Fabbiano,1,F-IO,46,16,5,7,4,20,26
20190114-M-Australian_Open-R128-Jason_Kubler-Thomas_Fabbiano,1,F-II,7,6,3,2,1,5,2
20190114-M-Australian_Open-R128-Jason_Kubler-Thomas_Fabbiano,1,B-XC,58,6,1,1,4,27,31
20190114-M-Australian_Open-R128-Jason_Kubler-Thomas_Fabbiano,1,B-DTM,40,1,0,0,1,15,25
20190114-M-Australian_Open-R128-Jason_Kubler-Thomas_Fabbiano,1,B-DTL,33,21,10,1,10,17,16
20190114-M-Australian_Open-R128-Jason_Kubler-Thomas_Fabbiano,1,B-IO,6,3,1,0,2,2,4
20190114-M-Australian_Open-R128-Jason_Kubler-Thomas_Fabbiano,1,S-XC,24,2,0,0,2,2,22
20190114-M-Australian_Open-R128-Jason_Kubler-Thomas_Fabbiano,1,S-DTM,8,0,0,0,0,2,6
20190114-M-Australian_Open-R128-Jason_Kubler-Thomas_Fabbiano,1,S-DTL,2,0,0,0,0,1,1
20190114-M-Australian_Open-R128-Jason_Kubler-Thomas_Fabbiano,2,F-XC,68,19,6,4,9,37,31
20190114-M-Australian_Open-R128-Jason_Kubler-Thomas_Fabbiano,2,F-DTM,27,4,0,1,3,15,12
20190114-M-Australian_Open-R128-Jason_Kubler-Thomas_Fabbiano,2,F-DTL,8,2,1,0,1,5,3
20190114-M-Australian_Open-R128-Jason_Kubler-Thomas_Fabbiano,2,F-IO,67,22,11,6,5,44,23
20190114-M-Australian_Open-R128-Jason_Kubler-Thomas_Fabbiano,2,F-II,7,3,1,1,1,5,2
20190114-M-Australian_Open-R128-Jason_Kubler-Thomas_Fabbiano,2,B-XC,70,13,2,4,7,47,23
20190114-M-Australian_Open-R128-Jason_Kubler-Thomas_Fabbiano,2,B-DTM,45,4,0,0,4,25,20
20190114-M-Australian_Open-R128-Jason_Kubler-Thomas_Fabbiano,2,B-DTL,5,4,2,0,2,3,2
20190114-M-Australian_Open-R128-Jason_Kubler-Thomas_Fabbiano,2,B-IO,2,1,0,1,0,2,0
20190114-M-Australian_Open-R128-Jason_Kubler-Thomas_Fabbiano,2,S-XC,23,3,0,1,2,11,12
20190114-M-Australian_Open-R128-Jason_Kubler-Thomas_Fabbiano,2,S-DTM,5,0,0,0,0,3,2
20190114-M-Australian_Open-R128-Jason_Kubler-Thomas_Fabbiano,2,S-DTL,2,0,0,0,0,2,0
20190115-M-Australian_Open-R128-Alexander_Zverev-Aljaz_Bedene,1,F-XC,39,17,4,4,9,24,15
20190115-M-Australian_Open-R128-Alexander_Zverev-Aljaz_Bedene,1,F-DTM,11,0,0,0,0,6,5
20190115-M-Australian_Open-R128-Alexander_Zverev-Aljaz_Bedene,1,F-DTL,19,3,2,0,1,12,7
20190115-M-Australian_Open-R128-Alexander_Zverev-Aljaz_Bedene,1,F-IO,19,5,0,2,3,8,11
20190115-M-Australian_Open-R128-Alexander_Zverev-Aljaz_Bedene,1,F-II,1,0,0,0,0,1,0
20190115-M-Australian_Open-R128-Alexander_Zverev-Aljaz_Bedene,1,B-XC,55,9,2,3,4,28,27
20190115-M-Australian_Open-R128-Alexander_Zverev-Aljaz_Bedene,1,B-DTM,14,2,0,0,2,7,7
20190115-M-Australian_Open-R128-Alexander_Zverev-Aljaz_Bedene,1,B-DTL,14,6,3,2,1,11,3
20190115-M-Australian_Open-R128-Alexander_Zverev-Aljaz_Bedene,1,B-IO,5,3,1,1,1,3,2
20190115-M-Australian_Open-R128-Alexander_Zverev-Aljaz_Bedene,1,S-XC,3,2,0,1,1,2,1
20190115-M-Australian_Open-R128-Alexander_Zverev-Aljaz_Bedene,1,S-DTM,2,0,0,0,0,0,2
20190115-M-Australian_Open-R128-Alexander_Zverev-Aljaz_Bedene,1,S-DTL,3,1,0,1,0,1,2
20190115-M-Australian_Open-R128-Alexander_Zverev-Aljaz_Bedene,2,F-XC,36,10,7,1,2,15,21
20190115-M-Australian_Open-R128-Alexander_Zverev-Aljaz_Bedene,2,F-DTM,20,0,0,0,0,12,8
20190115-M-Australian_Open-R128-Alexander_Zverev-Aljaz_Bedene,2,F-DTL,14,7,1,2,4,4,10
20190115-M-Australian_Open-R128-Alexander_Zverev-Aljaz_Bedene,2,F-IO,24,7,1,2,4,12,12
20190115-M-Australian_Open-R128-Alexander_Zverev-Aljaz_Bedene,2,F-II,5,3,0,1,2,3,2
20190115-M-Australian_Open-R128-Alexander_Zverev-Aljaz_Bedene,2,B-XC,33,6,0,2,4,13,20
20190115-M-Australian_Open-R128-Alexander_Zverev-Aljaz_Bedene,2,B-DTM,27,2,0,0,2,9,18
20190115-M-Australian_Open-R128-Alexander_Zverev-Aljaz_Bedene,2,B-DTL,16,3,0,0,3,8,8
20190115-M-Australian_Open-R128-Alexander_Zverev-Aljaz_Bedene,2,B-IO,3,0,0,0,0,1,2
20190115-M-Australian_Open-R128-Alexander_Zverev-Aljaz_Bedene,2,S-XC,8,0,0,0,0,3,5
20190115-M-Australian_Open-R128-Alexander_Zverev-Aljaz_Bedene,2,S-DTM,5,0,0,0,0,3,2
20190115-M-Australian_Open-R128-Alexander_Zverev-Aljaz_Bedene,2,S-DTL,3,1,0,0,1,1,2
20190115-M-Australian_Open-R128-Alexander_Zverev-Aljaz_Bedene,2,S-IO,1,1,0,0,1,0,1
20190119-M-Australian_Open-R32-Alexei_Popyrin-Lucas_Pouille,1,F-XC,79,19,10,2,7,42,37
20190119-M-Australian_Open-R32-Alexei_Popyrin-Lucas_Pouille,1,F-DTM,28,4,1,0,3,14,14
20190119-M-Australian_Open-R32-Alexei_Popyrin-Lucas_Pouille,1,F-DTL,24,8,2,2,4,10,14
20190119-M-Australian_Open-R32-Alexei_Popyrin-Lucas_Pouille,1,F-IO,39,15,3,5,7,20,19
20190119-M-Australian_Open-R32-Alexei_Popyrin-Lucas_Pouille,1,F-II,9,5,2,1,2,5,4
20190119-M-Australian_Open-R32-Alexei_Popyrin-Lucas_Pouille,1,B-XC,23,6,1,1,4,11,12
20190119-M-Australian_Open-R32-Alexei_Popyrin-Lucas_Pouille,1,B-DTM,25,7,0,0,7,12,13
20190119-M-Australian_Open-R32-Alexei_Popyrin-Lucas_Pouille,1,B-DTL,18,8,4,2,2,11,7
20190119-M-Australian_Open-R32-Alexei_Popyrin-Lucas_Pouille,1,B-IO,3,2,1,1,0,2,1
20190119-M-Australian_Open-R32-Alexei_Popyrin-Lucas_Pouille,1,S-XC,12,2,0,0,2,4,8
20190119-M-Australian_Open-R32-Alexei_Popyrin-Lucas_Pouille,1,S-DTM,13,0,0,0,0,3,10
20190119-M-Australian_Open-R32-Alexei_Popyrin-Lucas_Pouille,1,S-DTL,2,0,0,0,0,1,1
20190119-M-Australian_Open-R32-Alexei_Popyrin-Lucas_Pouille,2,F-XC,80,31,15,6,10,56,24
20190119-M-Australian_Open-R32-Alexei_Popyrin-Lucas_Pouille,2,F-DTM,30,5,0,2,3,11,19
20190119-M-Australian_Open-R32-Alexei_Popyrin-Lucas_Pouille,2,F-DTL,22,8,5,1,2,12,10
20190119-M-Australian_Open-R32-Alexei_Popyrin-Lucas_Pouille,2,F-IO,42,11,1,6,3,28,14
20190119-M-Australian_Open-R32-Alexei_Popyrin-Lucas_Pouille,2,F-II,6,5,3,2,0,6,0
20190119-M-Australian_Open-R32-Alexei_Popyrin-Lucas_Pouille,2,B-XC,34,10,1,4,5,18,16
20190119-M-Australian_Open-R32-Alexei_Popyrin-Lucas_Pouille,2,B-DTM,17,1,0,0,1,6,11
20190119-M-Australian_Open-R32-Alexei_Popyrin-Lucas_Pouille,2,B-DTL,6,2,1,1,0,4,2
20190119-M-Australian_Open-R32-Alexei_Popyrin-Lucas_Pouille,2,B-IO,5,4,0,1,3,2,3
20190119-M-Australian_Open-R32-Alexei_Popyrin-Lucas_Pouille,2,S-XC,9,1,0,0,1,3,6
20190119-M-Australian_Open-R32-Alexei_Popyrin-Lucas_Pouille,2,S-DTM,13,1,0,0,1,3,10
20190119-M-Australian_Open-R32-Alexei_Popyrin-Lucas_Pouille,2,S-DTL,4,0,0,0,0,4,0
20190119-M-Australian_Open-R32-Alexei_Popyrin-Lucas_Pouille,2,S-IO,2,1,0,0,1,0,2
20190120-M-Australian_Open-R16-Stefanos_Tsitsipas-Roger_Federer,1,F-XC,90,22,6,10,6,49,41
20190120-M-Australian_Open-R16-Stefanos_Tsitsipas-Roger_Federer,1,F-DTM,26,5,0,1,4,9,17
20190120-M-Australian_Open-R16-Stefanos_Tsitsipas-Roger_Federer,1,F-DTL,26,6,2,4,0,14,12
20190120-M-Australian_Open-R16-Stefanos_Tsitsipas-Roger_Federer,1,F-IO,39,17,5,6,6,24,15
20190120-M-Australian_Open-R16-Stefanos_Tsitsipas-Roger_Federer,1,F-II,12,3,0,1,2,6,6
20190120-M-Australian_Open-R16-Stefanos_Tsitsipas-Roger_Federer,1,B-XC,74,11,2,7,2,48,26
20190120-M-Australian_Open-R16-Stefanos_Tsitsipas-Roger_Federer,1,B-DTM,22,2,0,0,2,14,8
20190120-M-Australian_Open-R16-Stefanos_Tsitsipas-Roger_Federer,1,B-DTL,17,11,4,5,2,12,5
20190120-M-Australian_Open-R16-Stefanos_Tsitsipas-Roger_Federer,1,B-IO,3,1,0,0,1,1,2
20190120-M-Australian_Open-R16-Stefanos_Tsitsipas-Roger_Federer,1,S-XC,22,1,0,0,1,9,13
20190120-M-Australian_Open-R16-Stefanos_Tsitsipas-Roger_Federer,1,S-DTM,3,0,0,0,0,1,2
20190120-M-Australian_Open-R16-Stefanos_Tsitsipas-Roger_Federer,1,S-DTL,1,0,0,0,0,1,0
20190120-M-Australian_Open-R16-Stefanos_Tsitsipas-Roger_Federer,2,F-XC,77,27,5,8,14,41,36
20190120-M-Australian_Open-R16-Stefanos_Tsitsipas-Roger_Federer,2,F-DTM,43,3,0,0,3,23,20
20190120-M-Australian_Open-R16-Stefanos_Tsitsipas-Roger_Federer,2,F-DTL,22,4,1,1,2,10,12
20190120-M-Australian_Open-R16-Stefanos_Tsitsipas-Roger_Federer,2,F-IO,46,16,5,3,8,17,29
20190120-M-Australian_Open-R16-Stefanos_Tsitsipas-Roger_Federer,2,F-II,16,3,1,1,1,8,8
20190120-M-Australian_Open-R16-Stefanos_Tsitsipas-Roger_Federer,2,B-XC,51,7,2,2,3,22,29
20190120-M-Australian_Open-R16-Stefanos_Tsitsipas-Roger_Federer,2,B-DTM,17,0,0,0,0,7,10
20190120-M-Australian_Open-R16-Stefanos_Tsitsipas-Roger_Federer,2,B-DTL,24,10,6,1,3,14,10
20190120-M-Australian_Open-R16-Stefanos_Tsitsipas-Roger_Federer,2,B-IO,1,1,1,0,0,1,0
20190120-M-Australian_Open-R16-Stefanos_Tsitsipas-Roger_Federer,2,S-XC,18,0,0,0,0,8,10
20190120-M-Australian_Open-R16-Stefanos_Tsitsipas-Roger_Federer,2,S-DTM,2,1,0,0,1,0,2
20190120-M-Australian_Open-R16-Stefanos_Tsitsipas-Roger_Federer,2,S-DTL,2,0,0,0,0,2,0
20190121-M-Australian_Open-R16-Novak_Djokovic-Daniil_Medvedev,1,F-XC,97,19,9,7,3,49,48
20190121-M-Australian_Open-R16-Novak_Djokovic-Daniil_Medvedev,1,F-DTM,31,2,0,0,2,13,18
20190121-M-Australian_Open-R16-Novak_Djokovic-Daniil_Medvedev,1,F-DTL,55,16,3,2,11,28,27
20190121-M-Australian_Open-R16-Novak_Djokovic-Daniil_Medvedev,1,F-IO,62,15,8,3,4,38,24
20190121-M-Australian_Open-R16-Novak_Djokovic-Daniil_Medvedev,1,F-II,10,6,4,2,0,8,2
20190121-M-Australian_Open-R16-Novak_Djokovic-Daniil_Medvedev,1,B-XC,134,15,3,5,7,62,72
20190121-M-Australian_Open-R16-Novak_Djokovic-Daniil_Medvedev,1,B-DTM,64,0,0,0,0,38,26
20190121-M-Australian_Open-R16-Novak_Djokovic-Daniil_Medvedev,1,B-DTL,66,13,2,2,9,31,35
20190121-M-Australian_Open-R16-Novak_Djokovic-Daniil_Medvedev,1,B-IO,12,0,0,0,0,8,4
20190121-M-Australian_Open-R16-Novak_Djokovic-Daniil_Medvedev,1,S-XC,38,1,0,0,1,24,14
20190121-M-Australian_Open-R16-Novak_Djokovic-Daniil_Medvedev,1,S-DTM,29,0,0,0,0,16,13
20190121-M-Australian_Open-R16-Novak_Djokovic-Daniil_Medvedev,1,S-DTL,7,0,0,0,0,0,7
20190121-M-Australian_Open-R16-Novak_Djokovic-Daniil_Medvedev,1,S-IO,7,1,0,0,1,3,4
20190121-M-Australian_Open-R16-Novak_Djokovic-Daniil_Medvedev,2,F-XC,102,14,5,4,5,57,45
20190121-M-Australian_Open-R16-Novak_Djokovic-Daniil_Medvedev,2,F-DTM,65,2,0,0,2,35,30
20190121-M-Australian_Open-R16-Novak_Djokovic-Daniil_Medvedev,2,F-DTL,38,4,1,1,2,21,17
20190121-M-Australian_Open-R16-Novak_Djokovic-Daniil_Medvedev,2,F-IO,39,11,3,3,5,19,20
20190121-M-Australian_Open-R16-Novak_Djokovic-Daniil_Medvedev,2,B-XC,230,22,3,6,13,109,121
20190121-M-Australian_Open-R16-Novak_Djokovic-Daniil_Medvedev,2,B-DTM,75,6,0,0,6,33,42
20190121-M-Australian_Open-R16-Novak_Djokovic-Daniil_Medvedev,2,B-DTL,32,5,3,1,1,17,15
20190121-M-Australian_Open-R16-Novak_Djokovic-Daniil_Medvedev,2,B-IO,20,4,0,1,3,9,11
20190121-M-Australian_Open-R16-Novak_Djokovic-Daniil_Medvedev,2,S-XC,5,0,0,0,0,0,5
20190121-M-Australian_Open-R16-Novak_Djokovic-Daniil_Medvedev,2,S-DTM,4,0,0,0,0,2,2
20190121-M-Australian_Open-R16-Milos_Raonic-Alexander_Zverev,1,F-XC,20,7,5,1,1,17,3
20190121-M-Australian_Open-R16-Milos_Raonic-Alexander_Zverev,1,F-DTM,4,1,0,0,1,1,3
20190121-M-Australian_Open-R16-Milos_Raonic-Alexander_Zverev,1,F-DTL,11,5,1,4,0,9,2
20190121-M-Australian_Open-R16-Milos_Raonic-Alexander_Zverev,1,F-IO,18,5,2,1,2,9,9
20190121-M-Australian_Open-R16-Milos_Raonic-Alexander_Zverev,1,F-II,6,6,0,3,3,3,3
20190121-M-Australian_Open-R16-Milos_Raonic-Alexander_Zverev,1,B-XC,7,1,0,1,0,5,2
20190121-M-Australian_Open-R16-Milos_Raonic-Alexander_Zverev,1,B-DTM,3,0,0,0,0,2,1
20190121-M-Australian_Open-R16-Milos_Raonic-Alexander_Zverev,1,B-DTL,4,2,1,0,1,2,2
20190121-M-Australian_Open-R16-Milos_Raonic-Alexander_Zverev,1,B-IO,3,1,0,1,0,3,0
20190121-M-Australian_Open-R16-Milos_Raonic-Alexander_Zverev,1,S-XC,36,3,0,0,3,19,17
20190121-M-Australian_Open-R16-Milos_Raonic-Alexander_Zverev,1,S-DTM,11,0,0,0,0,4,7
20190121-M-Australian_Open-R16-Milos_Raonic-Alexander_Zverev,1,S-DTL,12,4,1,0,3,6,6
20190121-M-Australian_Open-R16-Milos_Raonic-Alexander_Zverev,2,F-XC,21,7,3,0,4,6,15
20190121-M-Australian_Open-R16-Milos_Raonic-Alexander_Zverev,2,F-DTM,13,0,0,0,0,2,11
20190121-M-Australian_Open-R16-Milos_Raonic-Alexander_Zverev,2,F-DTL,14,7,2,1,4,7,7
20190121-M-Australian_Open-R16-Milos_Raonic-Alexander_Zverev,2,F-IO,13,3,2,0,1,7,6
20190121-M-Australian_Open-R16-Milos_Raonic-Alexander_Zverev,2,F-II,2,0,0,0,0,2,0
20190121-M-Australian_Open-R16-Milos_Raonic-Alexander_Zverev,2,B-XC,62,7,1,2,4,33,29
20190121-M-Australian_Open-R16-Milos_Raonic-Alexander_Zverev,2,B-DTM,10,1,0,0,1,3,7
20190121-M-Australian_Open-R16-Milos_Raonic-Alexander_Zverev,2,B-DTL,11,3,3,0,0,3,8
20190121-M-Australian_Open-R16-Milos_Raonic-Alexander_Zverev,2,S-XC,2,1,0,1,0,1,1
20190121-M-Australian_Open-R16-Milos_Raonic-Alexander_Zverev,2,S-DTM,2,0,0,0,0,0,2
20190121-M-Australian_Open-R16-Milos_Raonic-Alexander_Zverev,2,S-DTL,3,0,0,0,0,1,2
19890909-M-US_Open-SF-Boris_Becker-Aaron_Krickstein,1,F-XC,49,11,2,5,4,26,23
19890909-M-US_Open-SF-Boris_Becker-Aaron_Krickstein,1,F-DTM,20,1,0,0,1,12,8
19890909-M-US_Open-SF-Boris_Becker-Aaron_Krickstein,1,F-DTL,25,11,5,2,4,13,12
19890909-M-US_Open-SF-Boris_Becker-Aaron_Krickstein,1,F-IO,31,7,0,4,3,18,13
19890909-M-US_Open-SF-Boris_Becker-Aaron_Krickstein,1,F-II,4,0,0,0,0,2,2
19890909-M-US_Open-SF-Boris_Becker-Aaron_Krickstein,1,B-XC,47,3,1,0,2,27,20
19890909-M-US_Open-SF-Boris_Becker-Aaron_Krickstein,1,B-DTM,16,2,0,0,2,5,11
19890909-M-US_Open-SF-Boris_Becker-Aaron_Krickstein,1,B-DTL,30,9,3,1,5,16,14
19890909-M-US_Open-SF-Boris_Becker-Aaron_Krickstein,1,B-IO,3,2,2,0,0,2,1
19890909-M-US_Open-SF-Boris_Becker-Aaron_Krickstein,1,S-XC,72,5,0,2,3,37,35
19890909-M-US_Open-SF-Boris_Becker-Aaron_Krickstein,1,S-DTM,8,1,0,0,1,2,6
19890909-M-US_Open-SF-Boris_Becker-Aaron_Krickstein,1,S-DTL,6,0,0,0,0,3,3
19890909-M-US_Open-SF-Boris_Becker-Aaron_Krickstein,1,S-IO,1,1,0,0,1,0,1
19890909-M-US_Open-SF-Boris_Becker-Aaron_Krickstein,2,F-XC,57,13,3,5,5,26,31
19890909-M-US_Open-SF-Boris_Becker-Aaron_Krickstein,2,F-DTM,28,2,0,0,2,14,14
19890909-M-US_Open-SF-Boris_Becker-Aaron_Krickstein,2,F-DTL,18,2,1,1,0,11,7
19890909-M-US_Open-SF-Boris_Becker-Aaron_Krickstein,2,F-IO,64,4,2,1,1,39,25
19890909-M-US_Open-SF-Boris_Becker-Aaron_Krickstein,2,F-II,14,4,2,1,1,9,5
19890909-M-US_Open-SF-Boris_Becker-Aaron_Krickstein,2,B-XC,77,11,4,3,4,26,51
19890909-M-US_Open-SF-Boris_Becker-Aaron_Krickstein,2,B-DTM,11,2,1,0,1,3,8
19890909-M-US_Open-SF-Boris_Becker-Aaron_Krickstein,2,B-DTL,14,4,1,2,1,10,4
19890909-M-US_Open-SF-Boris_Becker-Aaron_Krickstein,2,B-IO,1,1,0,1,0,1,0
19890909-M-US_Open-SF-Boris_Becker-Aaron_Krickstein,2,B-II,1,0,0,0,0,0,1
19890909-M-US_Open-SF-Boris_Becker-Aaron_Krickstein,2,S-XC,30,1,0,0,1,15,15
19890909-M-US_Open-SF-Boris_Becker-Aaron_Krickstein,2,S-DTM,3,1,0,0,1,0,3
19890909-M-US_Open-SF-Boris_Becker-Aaron_Krickstein,2,S-DTL,3,0,0,0,0,1,2
19890909-M-US_Open-SF-Boris_Becker-Aaron_Krickstein,2,S-IO,1,1,0,1,0,1,0
20190106-M-Sydney-Q1-Guillermo_Garcia_Lopez-Aljaz_Bedene,1,F-XC,48,7,2,3,2,29,19
20190106-M-Sydney-Q1-Guillermo_Garcia_Lopez-Aljaz_Bedene,1,F-DTM,11,2,0,1,1,6,5
20190106-M-Sydney-Q1-Guillermo_Garcia_Lopez-Aljaz_Bedene,1,F-DTL,22,4,1,2,1,14,8
20190106-M-Sydney-Q1-Guillermo_Garcia_Lopez-Aljaz_Bedene,1,F-IO,40,10,4,3,3,25,15
20190106-M-Sydney-Q1-Guillermo_Garcia_Lopez-Aljaz_Bedene,1,F-II,5,1,0,0,1,3,2
20190106-M-Sydney-Q1-Guillermo_Garcia_Lopez-Aljaz_Bedene,1,B-XC,45,3,0,0,3,21,24
20190106-M-Sydney-Q1-Guillermo_Garcia_Lopez-Aljaz_Bedene,1,B-DTM,24,2,0,0,2,12,12
20190106-M-Sydney-Q1-Guillermo_Garcia_Lopez-Aljaz_Bedene,1,B-DTL,9,7,4,2,1,7,2
20190106-M-Sydney-Q1-Guillermo_Garcia_Lopez-Aljaz_Bedene,1,B-IO,2,1,0,1,0,2,0
20190106-M-Sydney-Q1-Guillermo_Garcia_Lopez-Aljaz_Bedene,1,S-XC,29,1,0,0,1,19,10
20190106-M-Sydney-Q1-Guillermo_Garcia_Lopez-Aljaz_Bedene,1,S-DTM,4,0,0,0,0,0,4
20190106-M-Sydney-Q1-Guillermo_Garcia_Lopez-Aljaz_Bedene,1,S-DTL,4,0,0,0,0,4,0
20190106-M-Sydney-Q1-Guillermo_Garcia_Lopez-Aljaz_Bedene,2,F-XC,52,16,4,3,9,23,29
20190106-M-Sydney-Q1-Guillermo_Garcia_Lopez-Aljaz_Bedene,2,F-DTM,15,0,0,0,0,6,9
20190106-M-Sydney-Q1-Guillermo_Garcia_Lopez-Aljaz_Bedene,2,F-DTL,19,3,0,0,3,3,16
20190106-M-Sydney-Q1-Guillermo_Garcia_Lopez-Aljaz_Bedene,2,F-IO,34,5,1,1,3,16,18
20190106-M-Sydney-Q1-Guillermo_Garcia_Lopez-Aljaz_Bedene,2,F-II,6,3,1,2,0,4,2
20190106-M-Sydney-Q1-Guillermo_Garcia_Lopez-Aljaz_Bedene,2,B-XC,55,3,0,1,2,25,30
20190106-M-Sydney-Q1-Guillermo_Garcia_Lopez-Aljaz_Bedene,2,B-DTM,21,2,0,0,2,9,12
20190106-M-Sydney-Q1-Guillermo_Garcia_Lopez-Aljaz_Bedene,2,B-DTL,9,5,3,1,1,6,3
20190106-M-Sydney-Q1-Guillermo_Garcia_Lopez-Aljaz_Bedene,2,B-IO,4,1,0,1,0,3,1
20190106-M-Sydney-Q1-Guillermo_Garcia_Lopez-Aljaz_Bedene,2,S-XC,14,3,1,1,1,6,8
20190106-M-Sydney-Q1-Guillermo_Garcia_Lopez-Aljaz_Bedene,2,S-DTM,3,0,0,0,0,0,3
20190106-M-Sydney-Q1-Guillermo_Garcia_Lopez-Aljaz_Bedene,2,S-DTL,6,1,0,0,1,0,6
20190122-M-Australian_Open-QF-Rafael_Nadal-Francis_Tiafoe,1,F-XC,56,11,3,5,3,39,17
20190122-M-Australian_Open-QF-Rafael_Nadal-Francis_Tiafoe,1,F-DTM,10,1,0,0,1,5,5
20190122-M-Australian_Open-QF-Rafael_Nadal-Francis_Tiafoe,1,F-DTL,11,7,3,1,3,7,4
20190122-M-Australian_Open-QF-Rafael_Nadal-Francis_Tiafoe,1,F-IO,18,10,4,3,3,15,3
20190122-M-Australian_Open-QF-Rafael_Nadal-Francis_Tiafoe,1,F-II,3,1,1,0,0,3,0
20190122-M-Australian_Open-QF-Rafael_Nadal-Francis_Tiafoe,1,B-XC,28,4,0,1,3,18,10
20190122-M-Australian_Open-QF-Rafael_Nadal-Francis_Tiafoe,1,B-DTM,13,1,0,0,1,11,2
20190122-M-Australian_Open-QF-Rafael_Nadal-Francis_Tiafoe,1,B-DTL,13,6,1,3,2,6,7
20190122-M-Australian_Open-QF-Rafael_Nadal-Francis_Tiafoe,1,B-IO,1,0,0,0,0,1,0
20190122-M-Australian_Open-QF-Rafael_Nadal-Francis_Tiafoe,1,S-XC,1,1,0,0,1,0,1
20190122-M-Australian_Open-QF-Rafael_Nadal-Francis_Tiafoe,1,S-DTM,1,0,0,0,0,1,0
20190122-M-Australian_Open-QF-Rafael_Nadal-Francis_Tiafoe,1,S-DTL,7,1,0,0,1,4,3
20190122-M-Australian_Open-QF-Rafael_Nadal-Francis_Tiafoe,1,S-IO,1,0,0,0,0,0,1
20190122-M-Australian_Open-QF-Rafael_Nadal-Francis_Tiafoe,2,F-XC,39,10,1,1,8,11,28
20190122-M-Australian_Open-QF-Rafael_Nadal-Francis_Tiafoe,2,F-DTM,6,1,0,0,1,2,4
20190122-M-Australian_Open-QF-Rafael_Nadal-Francis_Tiafoe,2,F-DTL,8,4,0,0,4,1,7
20190122-M-Australian_Open-QF-Rafael_Nadal-Francis_Tiafoe,2,F-IO,8,3,2,0,1,5,3
20190122-M-Australian_Open-QF-Rafael_Nadal-Francis_Tiafoe,2,F-II,3,2,1,0,1,1,2
20190122-M-Australian_Open-QF-Rafael_Nadal-Francis_Tiafoe,2,B-XC,37,10,4,1,5,14,23
20190122-M-Australian_Open-QF-Rafael_Nadal-Francis_Tiafoe,2,B-DTM,24,2,0,0,2,5,19
20190122-M-Australian_Open-QF-Rafael_Nadal-Francis_Tiafoe,2,B-DTL,22,5,0,1,4,10,12
20190122-M-Australian_Open-QF-Rafael_Nadal-Francis_Tiafoe,2,B-IO,4,1,0,0,1,1,3
20190122-M-Australian_Open-QF-Rafael_Nadal-Francis_Tiafoe,2,S-XC,1,0,0,0,0,1,0
20190122-M-Australian_Open-QF-Rafael_Nadal-Francis_Tiafoe,2,S-DTM,2,0,0,0,0,0,2
20190122-M-Australian_Open-QF-Rafael_Nadal-Francis_Tiafoe,2,S-DTL,4,1,1,0,0,4,0
20190117-M-Australian_Open-R64-Denis_Shapovalov-Taro_Daniel,1,F-XC,37,9,3,3,3,24,13
20190117-M-Australian_Open-R64-Denis_Shapovalov-Taro_Daniel,1,F-DTM,18,4,1,1,2,9,9
20190117-M-Australian_Open-R64-Denis_Shapovalov-Taro_Daniel,1,F-DTL,7,5,1,1,3,4,3
20190117-M-Australian_Open-R64-Denis_Shapovalov-Taro_Daniel,1,F-IO,27,20,8,5,7,17,10
20190117-M-Australian_Open-R64-Denis_Shapovalov-Taro_Daniel,1,F-II,4,2,1,0,1,1,3
20190117-M-Australian_Open-R64-Denis_Shapovalov-Taro_Daniel,1,B-XC,16,4,0,2,2,11,5
20190117-M-Australian_Open-R64-Denis_Shapovalov-Taro_Daniel,1,B-DTM,11,0,0,0,0,8,3
20190117-M-Australian_Open-R64-Denis_Shapovalov-Taro_Daniel,1,B-DTL,7,2,0,0,2,3,4
20190117-M-Australian_Open-R64-Denis_Shapovalov-Taro_Daniel,1,B-IO,1,0,0,0,0,0,1
20190117-M-Australian_Open-R64-Denis_Shapovalov-Taro_Daniel,1,S-XC,1,0,0,0,0,1,0
20190117-M-Australian_Open-R64-Denis_Shapovalov-Taro_Daniel,1,S-DTM,1,0,0,0,0,1,0
20190117-M-Australian_Open-R64-Denis_Shapovalov-Taro_Daniel,2,F-XC,31,6,2,2,2,12,19
20190117-M-Australian_Open-R64-Denis_Shapovalov-Taro_Daniel,2,F-DTM,17,1,0,0,1,6,11
20190117-M-Australian_Open-R64-Denis_Shapovalov-Taro_Daniel,2,F-DTL,3,1,1,0,0,2,1
20190117-M-Australian_Open-R64-Denis_Shapovalov-Taro_Daniel,2,F-IO,7,4,0,1,3,2,5
20190117-M-Australian_Open-R64-Denis_Shapovalov-Taro_Daniel,2,B-XC,26,9,3,2,4,15,11
20190117-M-Australian_Open-R64-Denis_Shapovalov-Taro_Daniel,2,B-DTM,21,2,1,0,1,6,15
20190117-M-Australian_Open-R64-Denis_Shapovalov-Taro_Daniel,2,B-DTL,5,2,0,1,1,2,3
20190117-M-Australian_Open-R64-Denis_Shapovalov-Taro_Daniel,2,B-IO,2,1,0,1,0,2,0
20190117-M-Australian_Open-R64-Denis_Shapovalov-Taro_Daniel,2,S-DTM,3,0,0,0,0,2,1
20190117-M-Australian_Open-R64-Denis_Shapovalov-Taro_Daniel,2,S-DTL,1,0,0,0,0,0,1
20190117-M-Australian_Open-R64-Denis_Shapovalov-Taro_Daniel,2,S-IO,1,0,0,0,0,0,1
20190123-M-Australian_Open-QF-Novak_Djokovic-Kei_Nishikori,1,F-XC,14,2,2,0,0,12,2
20190123-M-Australian_Open-QF-Novak_Djokovic-Kei_Nishikori,1,F-DTM,8,0,0,0,0,6,2
20190123-M-Australian_Open-QF-Novak_Djokovic-Kei_Nishikori,1,F-DTL,7,1,1,0,0,6,1
20190123-M-Australian_Open-QF-Novak_Djokovic-Kei_Nishikori,1,F-IO,9,3,1,1,1,8,1
20190123-M-Australian_Open-QF-Novak_Djokovic-Kei_Nishikori,1,F-II,1,1,1,0,0,1,0
20190123-M-Australian_Open-QF-Novak_Djokovic-Kei_Nishikori,1,B-XC,15,3,1,1,1,13,2
20190123-M-Australian_Open-QF-Novak_Djokovic-Kei_Nishikori,1,B-DTM,9,1,0,0,1,5,4
20190123-M-Australian_Open-QF-Novak_Djokovic-Kei_Nishikori,1,B-DTL,13,7,1,4,2,9,4
20190123-M-Australian_Open-QF-Novak_Djokovic-Kei_Nishikori,1,B-IO,5,1,0,1,0,5,0
20190123-M-Australian_Open-QF-Novak_Djokovic-Kei_Nishikori,1,S-XC,4,0,0,0,0,2,2
20190123-M-Australian_Open-QF-Novak_Djokovic-Kei_Nishikori,1,S-DTM,1,0,0,0,0,1,0
20190123-M-Australian_Open-QF-Novak_Djokovic-Kei_Nishikori,1,S-DTL,2,0,0,0,0,1,1
20190123-M-Australian_Open-QF-Novak_Djokovic-Kei_Nishikori,2,F-XC,21,6,2,1,3,8,13
20190123-M-Australian_Open-QF-Novak_Djokovic-Kei_Nishikori,2,F-DTM,8,1,0,0,1,0,8
20190123-M-Australian_Open-QF-Novak_Djokovic-Kei_Nishikori,2,F-DTL,9,5,1,0,4,2,7
20190123-M-Australian_Open-QF-Novak_Djokovic-Kei_Nishikori,2,F-IO,9,4,0,2,2,4,5
20190123-M-Australian_Open-QF-Novak_Djokovic-Kei_Nishikori,2,B-XC,19,4,1,0,3,7,12
20190123-M-Australian_Open-QF-Novak_Djokovic-Kei_Nishikori,2,B-DTM,5,0,0,0,0,0,5
20190123-M-Australian_Open-QF-Novak_Djokovic-Kei_Nishikori,2,B-DTL,5,2,0,1,1,1,4
20190123-M-Australian_Open-QF-Novak_Djokovic-Kei_Nishikori,2,B-IO,4,3,0,0,3,0,4
20190123-M-Australian_Open-QF-Novak_Djokovic-Kei_Nishikori,2,S-XC,13,0,0,0,0,1,12
20190123-M-Australian_Open-QF-Novak_Djokovic-Kei_Nishikori,2,S-DTM,2,0,0,0,0,1,1
19910706-M-Wimbledon-SF-Michael_Stich-Stefan_Edberg,1,F-XC,8,4,3,1,0,5,3
19910706-M-Wimbledon-SF-Michael_Stich-Stefan_Edberg,1,F-DTM,1,0,0,0,0,0,1
19910706-M-Wimbledon-SF-Michael_Stich-Stefan_Edberg,1,F-DTL,2,1,1,0,0,2,0
19910706-M-Wimbledon-SF-Michael_Stich-Stefan_Edberg,1,F-IO,2,2,0,1,1,1,1
19910706-M-Wimbledon-SF-Michael_Stich-Stefan_Edberg,1,B-XC,6,3,1,0,2,2,4
19910706-M-Wimbledon-SF-Michael_Stich-Stefan_Edberg,1,B-DTM,3,1,0,1,0,1,2
19910706-M-Wimbledon-SF-Michael_Stich-Stefan_Edberg,1,B-DTL,5,2,0,0,2,0,5
19910706-M-Wimbledon-SF-Michael_Stich-Stefan_Edberg,1,B-IO,2,2,1,0,1,1,1
19910706-M-Wimbledon-SF-Michael_Stich-Stefan_Edberg,1,S-XC,1,0,0,0,0,0,1
19910706-M-Wimbledon-SF-Michael_Stich-Stefan_Edberg,1,S-DTL,1,0,0,0,0,0,1
19910706-M-Wimbledon-SF-Michael_Stich-Stefan_Edberg,2,F-XC,5,4,2,1,1,3,2
19910706-M-Wimbledon-SF-Michael_Stich-Stefan_Edberg,2,F-DTM,1,0,0,0,0,1,0
19910706-M-Wimbledon-SF-Michael_Stich-Stefan_Edberg,2,F-DTL,3,0,0,0,0,1,2
19910706-M-Wimbledon-SF-Michael_Stich-Stefan_Edberg,2,F-IO,1,1,0,1,0,1,0
19910706-M-Wimbledon-SF-Michael_Stich-Stefan_Edberg,2,B-XC,7,7,3,1,3,4,3
19910706-M-Wimbledon-SF-Michael_Stich-Stefan_Edberg,2,B-DTM,2,0,0,0,0,0,2
19910706-M-Wimbledon-SF-Michael_Stich-Stefan_Edberg,2,B-DTL,6,4,3,0,1,3,3
19910706-M-Wimbledon-SF-Michael_Stich-Stefan_Edberg,2,S-XC,2,0,0,0,0,1,1
19910706-M-Wimbledon-SF-Michael_Stich-Stefan_Edberg,2,S-DTL,1,0,0,0,0,0,1
20190124-M-Australian_Open-SF-Stefanos_Tsitsipas-Rafael_Nadal,1,F-XC,45,6,3,0,3,17,28
20190124-M-Australian_Open-SF-Stefanos_Tsitsipas-Rafael_Nadal,1,F-DTM,11,1,0,0,1,4,7
20190124-M-Australian_Open-SF-Stefanos_Tsitsipas-Rafael_Nadal,1,F-DTL,3,0,0,0,0,1,2
20190124-M-Australian_Open-SF-Stefanos_Tsitsipas-Rafael_Nadal,1,F-IO,15,4,2,1,1,4,11
20190124-M-Australian_Open-SF-Stefanos_Tsitsipas-Rafael_Nadal,1,F-II,4,1,0,0,1,1,3
20190124-M-Australian_Open-SF-Stefanos_Tsitsipas-Rafael_Nadal,1,B-XC,23,5,0,1,4,7,16
20190124-M-Australian_Open-SF-Stefanos_Tsitsipas-Rafael_Nadal,1,B-DTM,7,1,0,0,1,2,5
20190124-M-Australian_Open-SF-Stefanos_Tsitsipas-Rafael_Nadal,1,B-DTL,12,5,2,0,3,4,8
20190124-M-Australian_Open-SF-Stefanos_Tsitsipas-Rafael_Nadal,1,S-XC,2,0,0,0,0,0,2
20190124-M-Australian_Open-SF-Stefanos_Tsitsipas-Rafael_Nadal,1,S-DTM,7,2,0,0,2,2,5
20190124-M-Australian_Open-SF-Stefanos_Tsitsipas-Rafael_Nadal,1,S-DTL,1,0,0,0,0,0,1
20190124-M-Australian_Open-SF-Stefanos_Tsitsipas-Rafael_Nadal,2,F-XC,34,5,0,1,4,24,10
20190124-M-Australian_Open-SF-Stefanos_Tsitsipas-Rafael_Nadal,2,F-DTM,11,0,0,0,0,9,2
20190124-M-Australian_Open-SF-Stefanos_Tsitsipas-Rafael_Nadal,2,F-DTL,11,2,2,0,0,9,2
20190124-M-Australian_Open-SF-Stefanos_Tsitsipas-Rafael_Nadal,2,F-IO,16,7,4,2,1,12,4
20190124-M-Australian_Open-SF-Stefanos_Tsitsipas-Rafael_Nadal,2,F-II,5,3,1,1,1,4,1
20190124-M-Australian_Open-SF-Stefanos_Tsitsipas-Rafael_Nadal,2,B-XC,26,8,3,2,3,18,8
20190124-M-Australian_Open-SF-Stefanos_Tsitsipas-Rafael_Nadal,2,B-DTM,10,1,0,1,0,3,7
20190124-M-Australian_Open-SF-Stefanos_Tsitsipas-Rafael_Nadal,2,B-DTL,10,2,0,2,0,9,1
20190124-M-Australian_Open-SF-Stefanos_Tsitsipas-Rafael_Nadal,2,B-IO,4,3,0,2,1,2,2
20190124-M-Australian_Open-SF-Stefanos_Tsitsipas-Rafael_Nadal,2,S-DTM,4,0,0,0,0,1,3
20190124-M-Australian_Open-SF-Stefanos_Tsitsipas-Rafael_Nadal,2,S-DTL,5,2,1,0,1,4,1
20190124-M-Australian_Open-SF-Stefanos_Tsitsipas-Rafael_Nadal,2,S-IO,1,0,0,0,0,1,0
20190112-M-Canberra_CH-F-Ilya_Ivashka-Hubert_Hurkacz,1,F-XC,64,12,2,2,8,29,35
20190112-M-Canberra_CH-F-Ilya_Ivashka-Hubert_Hurkacz,1,F-DTM,23,1,0,0,1,9,14
20190112-M-Canberra_CH-F-Ilya_Ivashka-Hubert_Hurkacz,1,F-DTL,8,6,2,2,2,5,3
20190112-M-Canberra_CH-F-Ilya_Ivashka-Hubert_Hurkacz,1,F-IO,31,14,4,4,6,17,14
20190112-M-Canberra_CH-F-Ilya_Ivashka-Hubert_Hurkacz,1,F-II,2,2,2,0,0,2,0
20190112-M-Canberra_CH-F-Ilya_Ivashka-Hubert_Hurkacz,1,B-XC,34,6,0,3,3,19,15
20190112-M-Canberra_CH-F-Ilya_Ivashka-Hubert_Hurkacz,1,B-DTM,31,3,0,0,3,16,15
20190112-M-Canberra_CH-F-Ilya_Ivashka-Hubert_Hurkacz,1,B-DTL,9,2,0,2,0,5,4
20190112-M-Canberra_CH-F-Ilya_Ivashka-Hubert_Hurkacz,1,B-IO,4,0,0,0,0,1,3
20190112-M-Canberra_CH-F-Ilya_Ivashka-Hubert_Hurkacz,1,S-XC,4,1,0,0,1,1,3
20190112-M-Canberra_CH-F-Ilya_Ivashka-Hubert_Hurkacz,1,S-DTM,5,0,0,0,0,3,2
20190112-M-Canberra_CH-F-Ilya_Ivashka-Hubert_Hurkacz,1,S-DTL,3,1,0,0,1,1,2
20190112-M-Canberra_CH-F-Ilya_Ivashka-Hubert_Hurkacz,2,F-XC,52,8,1,4,3,32,20
20190112-M-Canberra_CH-F-Ilya_Ivashka-Hubert_Hurkacz,2,F-DTM,23,0,0,0,0,10,13
20190112-M-Canberra_CH-F-Ilya_Ivashka-Hubert_Hurkacz,2,F-DTL,27,11,6,0,5,16,11
20190112-M-Canberra_CH-F-Ilya_Ivashka-Hubert_Hurkacz,2,F-IO,29,6,1,2,3,13,16
20190112-M-Canberra_CH-F-Ilya_Ivashka-Hubert_Hurkacz,2,F-II,3,1,0,0,1,2,1
20190112-M-Canberra_CH-F-Ilya_Ivashka-Hubert_Hurkacz,2,B-XC,17,6,0,3,3,8,9
20190112-M-Canberra_CH-F-Ilya_Ivashka-Hubert_Hurkacz,2,B-DTM,14,1,0,0,1,8,6
20190112-M-Canberra_CH-F-Ilya_Ivashka-Hubert_Hurkacz,2,B-DTL,9,2,1,1,0,3,6
20190112-M-Canberra_CH-F-Ilya_Ivashka-Hubert_Hurkacz,2,B-IO,8,4,1,1,2,4,4
20190112-M-Canberra_CH-F-Ilya_Ivashka-Hubert_Hurkacz,2,S-XC,6,0,0,0,0,4,2
20190112-M-Canberra_CH-F-Ilya_Ivashka-Hubert_Hurkacz,2,S-DTM,9,1,0,0,1,5,4
20190112-M-Canberra_CH-F-Ilya_Ivashka-Hubert_Hurkacz,2,S-DTL,4,1,0,0,1,2,2
20190125-M-Australian_Open-SF-Novak_Djokovic-Lucas_Pouille,1,F-XC,22,8,4,3,1,16,6
20190125-M-Australian_Open-SF-Novak_Djokovic-Lucas_Pouille,1,F-DTM,21,1,0,1,0,18,3
20190125-M-Australian_Open-SF-Novak_Djokovic-Lucas_Pouille,1,F-DTL,18,5,1,4,0,13,5
20190125-M-Australian_Open-SF-Novak_Djokovic-Lucas_Pouille,1,F-IO,17,5,3,2,0,14,3
20190125-M-Australian_Open-SF-Novak_Djokovic-Lucas_Pouille,1,F-II,4,1,1,0,0,4,0
20190125-M-Australian_Open-SF-Novak_Djokovic-Lucas_Pouille,1,B-XC,24,2,0,2,0,19,5
20190125-M-Australian_Open-SF-Novak_Djokovic-Lucas_Pouille,1,B-DTM,24,0,0,0,0,15,9
20190125-M-Australian_Open-SF-Novak_Djokovic-Lucas_Pouille,1,B-DTL,13,4,2,0,2,10,3
20190125-M-Australian_Open-SF-Novak_Djokovic-Lucas_Pouille,1,B-IO,4,0,0,0,0,1,3
20190125-M-Australian_Open-SF-Novak_Djokovic-Lucas_Pouille,1,S-XC,2,0,0,0,0,1,1
20190125-M-Australian_Open-SF-Novak_Djokovic-Lucas_Pouille,1,S-DTM,2,0,0,0,0,2,0
20190125-M-Australian_Open-SF-Novak_Djokovic-Lucas_Pouille,1,S-DTL,2,0,0,0,0,1,1
20190125-M-Australian_Open-SF-Novak_Djokovic-Lucas_Pouille,1,S-IO,1,0,0,0,0,0,1
20190125-M-Australian_Open-SF-Novak_Djokovic-Lucas_Pouille,2,F-XC,43,18,3,4,11,17,26
20190125-M-Australian_Open-SF-Novak_Djokovic-Lucas_Pouille,2,F-DTM,15,1,0,0,1,2,13
20190125-M-Australian_Open-SF-Novak_Djokovic-Lucas_Pouille,2,F-DTL,10,0,0,0,0,4,6
20190125-M-Australian_Open-SF-Novak_Djokovic-Lucas_Pouille,2,F-IO,20,4,2,0,2,9,11
20190125-M-Australian_Open-SF-Novak_Djokovic-Lucas_Pouille,2,F-II,2,1,0,1,0,1,1
20190125-M-Australian_Open-SF-Novak_Djokovic-Lucas_Pouille,2,B-XC,14,2,1,0,1,3,11
20190125-M-Australian_Open-SF-Novak_Djokovic-Lucas_Pouille,2,B-DTM,25,6,0,0,6,6,19
20190125-M-Australian_Open-SF-Novak_Djokovic-Lucas_Pouille,2,B-DTL,11,5,3,0,2,3,8
20190125-M-Australian_Open-SF-Novak_Djokovic-Lucas_Pouille,2,B-IO,7,1,0,1,0,2,5
20190125-M-Australian_Open-SF-Novak_Djokovic-Lucas_Pouille,2,S-XC,11,1,0,0,1,3,8
20190125-M-Australian_Open-SF-Novak_Djokovic-Lucas_Pouille,2,S-DTM,5,0,0,0,0,0,5
20190125-M-Australian_Open-SF-Novak_Djokovic-Lucas_Pouille,2,S-DTL,2,0,0,0,0,0,2
20190125-M-Australian_Open-SF-Novak_Djokovic-Lucas_Pouille,2,S-IO,1,0,0,0,0,0,1
19890909-M-US_Open-SF-Andre_Agassi-Ivan_Lendl,1,F-XC,44,10,1,2,7,15,29
19890909-M-US_Open-SF-Andre_Agassi-Ivan_Lendl,1,F-DTM,15,1,0,0,1,6,9
19890909-M-US_Open-SF-Andre_Agassi-Ivan_Lendl,1,F-DTL,22,5,2,0,3,11,11
19890909-M-US_Open-SF-Andre_Agassi-Ivan_Lendl,1,F-IO,28,5,1,2,2,12,16
19890909-M-US_Open-SF-Andre_Agassi-Ivan_Lendl,1,F-II,12,3,0,1,2,4,8
19890909-M-US_Open-SF-Andre_Agassi-Ivan_Lendl,1,B-XC,101,12,0,2,10,48,53
19890909-M-US_Open-SF-Andre_Agassi-Ivan_Lendl,1,B-DTM,13,2,0,0,2,3,10
19890909-M-US_Open-SF-Andre_Agassi-Ivan_Lendl,1,B-DTL,32,10,2,3,5,16,16
19890909-M-US_Open-SF-Andre_Agassi-Ivan_Lendl,1,B-IO,1,0,0,0,0,1,0
19890909-M-US_Open-SF-Andre_Agassi-Ivan_Lendl,1,S-XC,17,1,0,0,1,6,11
19890909-M-US_Open-SF-Andre_Agassi-Ivan_Lendl,1,S-DTM,5,0,0,0,0,3,2
19890909-M-US_Open-SF-Andre_Agassi-Ivan_Lendl,1,S-DTL,1,0,0,0,0,0,1
19890909-M-US_Open-SF-Andre_Agassi-Ivan_Lendl,2,F-XC,54,12,3,4,5,29,25
19890909-M-US_Open-SF-Andre_Agassi-Ivan_Lendl,2,F-DTM,13,2,0,0,2,7,6
19890909-M-US_Open-SF-Andre_Agassi-Ivan_Lendl,2,F-DTL,24,7,3,2,2,15,9
19890909-M-US_Open-SF-Andre_Agassi-Ivan_Lendl,2,F-IO,21,6,2,2,2,14,7
19890909-M-US_Open-SF-Andre_Agassi-Ivan_Lendl,2,F-II,12,6,4,2,0,12,0
19890909-M-US_Open-SF-Andre_Agassi-Ivan_Lendl,2,B-XC,27,5,0,2,3,13,14
19890909-M-US_Open-SF-Andre_Agassi-Ivan_Lendl,2,B-DTM,7,1,0,1,0,2,5
19890909-M-US_Open-SF-Andre_Agassi-Ivan_Lendl,2,B-DTL,6,3,2,1,0,4,2
19890909-M-US_Open-SF-Andre_Agassi-Ivan_Lendl,2,B-IO,3,1,0,0,1,1,2
19890909-M-US_Open-SF-Andre_Agassi-Ivan_Lendl,2,S-XC,99,5,0,1,4,53,46
19890909-M-US_Open-SF-Andre_Agassi-Ivan_Lendl,2,S-DTM,17,2,0,0,2,8,9
19890909-M-US_Open-SF-Andre_Agassi-Ivan_Lendl,2,S-DTL,11,6,1,1,4,6,5
19890909-M-US_Open-SF-Andre_Agassi-Ivan_Lendl,2,S-IO,2,1,0,1,0,2,0
20180711-M-Wimbledon-QF-Milos_Raonic-John_Isner,1,F-XC,5,2,0,2,0,3,2
20180711-M-Wimbledon-QF-Milos_Raonic-John_Isner,1,F-DTM,4,0,0,0,0,1,3
20180711-M-Wimbledon-QF-Milos_Raonic-John_Isner,1,F-DTL,2,1,1,0,0,1,1
20180711-M-Wimbledon-QF-Milos_Raonic-John_Isner,1,F-IO,17,5,0,1,4,5,12
20180711-M-Wimbledon-QF-Milos_Raonic-John_Isner,1,B-XC,11,2,0,0,2,1,10
20180711-M-Wimbledon-QF-Milos_Raonic-John_Isner,1,B-DTM,7,0,0,0,0,3,4
20180711-M-Wimbledon-QF-Milos_Raonic-John_Isner,1,B-DTL,5,3,2,0,1,3,2
20180711-M-Wimbledon-QF-Milos_Raonic-John_Isner,1,B-IO,1,0,0,0,0,0,1
20180711-M-Wimbledon-QF-Milos_Raonic-John_Isner,1,S-XC,8,2,0,2,0,5,3
20180711-M-Wimbledon-QF-Milos_Raonic-John_Isner,1,S-DTM,3,0,0,0,0,0,3
20180711-M-Wimbledon-QF-Milos_Raonic-John_Isner,1,S-DTL,2,1,0,1,0,1,1
20180711-M-Wimbledon-QF-Milos_Raonic-John_Isner,2,F-XC,12,6,4,0,2,6,6
20180711-M-Wimbledon-QF-Milos_Raonic-John_Isner,2,F-DTM,2,1,0,0,1,1,1
20180711-M-Wimbledon-QF-Milos_Raonic-John_Isner,2,F-DTL,8,1,0,1,0,6,2
20180711-M-Wimbledon-QF-Milos_Raonic-John_Isner,2,F-IO,23,8,1,3,4,15,8
20180711-M-Wimbledon-QF-Milos_Raonic-John_Isner,2,F-II,2,1,1,0,0,2,0
20180711-M-Wimbledon-QF-Milos_Raonic-John_Isner,2,B-XC,9,2,1,0,1,4,5
20180711-M-Wimbledon-QF-Milos_Raonic-John_Isner,2,B-DTM,5,2,0,1,1,3,2
20180711-M-Wimbledon-QF-Milos_Raonic-John_Isner,2,B-DTL,7,4,1,1,2,4,3
20180711-M-Wimbledon-QF-Milos_Raonic-John_Isner,2,B-IO,2,2,0,0,2,0,2
20180711-M-Wimbledon-QF-Milos_Raonic-John_Isner,2,S-DTM,4,0,0,0,0,2,2
20190127-M-Newport_Beach_CH-F-Taylor_Harry_Fritz-Brayden_Schnur,1,F-XC,20,6,1,3,2,11,9
20190127-M-Newport_Beach_CH-F-Taylor_Harry_Fritz-Brayden_Schnur,1,F-DTM,13,0,0,0,0,8,5
20190127-M-Newport_Beach_CH-F-Taylor_Harry_Fritz-Brayden_Schnur,1,F-DTL,4,2,0,1,1,3,1
20190127-M-Newport_Beach_CH-F-Taylor_Harry_Fritz-Brayden_Schnur,1,F-IO,14,5,3,2,0,9,5
20190127-M-Newport_Beach_CH-F-Taylor_Harry_Fritz-Brayden_Schnur,1,B-XC,29,4,2,1,1,21,8
20190127-M-Newport_Beach_CH-F-Taylor_Harry_Fritz-Brayden_Schnur,1,B-DTM,14,1,0,0,1,7,7
20190127-M-Newport_Beach_CH-F-Taylor_Harry_Fritz-Brayden_Schnur,1,B-DTL,11,3,1,2,0,7,4
20190127-M-Newport_Beach_CH-F-Taylor_Harry_Fritz-Brayden_Schnur,1,B-IO,1,0,0,0,0,0,1
20190127-M-Newport_Beach_CH-F-Taylor_Harry_Fritz-Brayden_Schnur,1,S-XC,1,0,0,0,0,1,0
20190127-M-Newport_Beach_CH-F-Taylor_Harry_Fritz-Brayden_Schnur,1,S-DTM,1,0,0,0,0,0,1
20190127-M-Newport_Beach_CH-F-Taylor_Harry_Fritz-Brayden_Schnur,2,F-XC,19,9,3,2,4,12,7
20190127-M-Newport_Beach_CH-F-Taylor_Harry_Fritz-Brayden_Schnur,2,F-DTM,3,0,0,0,0,1,2
20190127-M-Newport_Beach_CH-F-Taylor_Harry_Fritz-Brayden_Schnur,2,F-DTL,4,1,1,0,0,2,2
20190127-M-Newport_Beach_CH-F-Taylor_Harry_Fritz-Brayden_Schnur,2,F-IO,21,8,4,2,2,13,8
20190127-M-Newport_Beach_CH-F-Taylor_Harry_Fritz-Brayden_Schnur,2,F-II,1,1,0,1,0,1,0
20190127-M-Newport_Beach_CH-F-Taylor_Harry_Fritz-Brayden_Schnur,2,B-XC,19,2,1,1,0,10,9
20190127-M-Newport_Beach_CH-F-Taylor_Harry_Fritz-Brayden_Schnur,2,B-DTM,17,1,0,0,1,5,12
20190127-M-Newport_Beach_CH-F-Taylor_Harry_Fritz-Brayden_Schnur,2,B-DTL,5,1,1,0,0,3,2
20190127-M-Newport_Beach_CH-F-Taylor_Harry_Fritz-Brayden_Schnur,2,B-IO,4,2,1,0,1,3,1
20190127-M-Newport_Beach_CH-F-Taylor_Harry_Fritz-Brayden_Schnur,2,S-XC,3,0,0,0,0,1,2
20190127-M-Newport_Beach_CH-F-Taylor_Harry_Fritz-Brayden_Schnur,2,S-DTM,5,1,0,0,1,3,2
20190127-M-Newport_Beach_CH-F-Taylor_Harry_Fritz-Brayden_Schnur,2,S-DTL,1,0,0,0,0,0,1
20190127-M-Newport_Beach_CH-F-Taylor_Harry_Fritz-Brayden_Schnur,2,S-IO,2,1,0,0,1,1,1
20030906-M-US_Open-SF-Andre_Agassi-Juan_Carlos_Ferrero,1,F-XC,78,26,6,10,10,48,30
20030906-M-US_Open-SF-Andre_Agassi-Juan_Carlos_Ferrero,1,F-DTM,25,1,0,0,1,12,13
20030906-M-US_Open-SF-Andre_Agassi-Juan_Carlos_Ferrero,1,F-DTL,12,4,3,0,1,11,1
20030906-M-US_Open-SF-Andre_Agassi-Juan_Carlos_Ferrero,1,F-IO,30,5,3,0,2,21,9
20030906-M-US_Open-SF-Andre_Agassi-Juan_Carlos_Ferrero,1,F-II,6,2,1,1,0,4,2
20030906-M-US_Open-SF-Andre_Agassi-Juan_Carlos_Ferrero,1,B-XC,84,21,4,8,9,54,30
20030906-M-US_Open-SF-Andre_Agassi-Juan_Carlos_Ferrero,1,B-DTM,16,4,0,1,3,7,9
20030906-M-US_Open-SF-Andre_Agassi-Juan_Carlos_Ferrero,1,B-DTL,19,10,5,2,3,14,5
20030906-M-US_Open-SF-Andre_Agassi-Juan_Carlos_Ferrero,1,B-IO,3,3,3,0,0,3,0
20030906-M-US_Open-SF-Andre_Agassi-Juan_Carlos_Ferrero,1,S-XC,6,0,0,0,0,3,3
20030906-M-US_Open-SF-Andre_Agassi-Juan_Carlos_Ferrero,1,S-DTM,3,0,0,0,0,1,2
20030906-M-US_Open-SF-Andre_Agassi-Juan_Carlos_Ferrero,1,S-DTL,1,0,0,0,0,0,1
20030906-M-US_Open-SF-Andre_Agassi-Juan_Carlos_Ferrero,2,F-XC,43,12,9,1,2,24,19
20030906-M-US_Open-SF-Andre_Agassi-Juan_Carlos_Ferrero,2,F-DTM,35,4,0,1,3,13,22
20030906-M-US_Open-SF-Andre_Agassi-Juan_Carlos_Ferrero,2,F-DTL,26,13,8,2,3,14,12
20030906-M-US_Open-SF-Andre_Agassi-Juan_Carlos_Ferrero,2,F-IO,21,8,3,3,2,9,12
20030906-M-US_Open-SF-Andre_Agassi-Juan_Carlos_Ferrero,2,F-II,11,5,2,2,1,6,5
20030906-M-US_Open-SF-Andre_Agassi-Juan_Carlos_Ferrero,2,B-XC,71,9,3,4,2,29,42
20030906-M-US_Open-SF-Andre_Agassi-Juan_Carlos_Ferrero,2,B-DTM,34,5,0,0,5,11,23
20030906-M-US_Open-SF-Andre_Agassi-Juan_Carlos_Ferrero,2,B-DTL,26,13,5,2,6,11,15
20030906-M-US_Open-SF-Andre_Agassi-Juan_Carlos_Ferrero,2,B-IO,2,1,0,1,0,1,1
20030906-M-US_Open-SF-Andre_Agassi-Juan_Carlos_Ferrero,2,S-XC,5,0,0,0,0,2,3
20030906-M-US_Open-SF-Andre_Agassi-Juan_Carlos_Ferrero,2,S-DTM,2,0,0,0,0,0,2
20030906-M-US_Open-SF-Andre_Agassi-Juan_Carlos_Ferrero,2,S-DTL,1,1,1,0,0,1,0
20190119-M-Australian_Open-R32-Fabio_Fognini-Pablo_Carreno_Busta,1,F-XC,57,21,6,6,9,31,26
20190119-M-Australian_Open-R32-Fabio_Fognini-Pablo_Carreno_Busta,1,F-DTM,39,6,0,0,6,18,21
20190119-M-Australian_Open-R32-Fabio_Fognini-Pablo_Carreno_Busta,1,F-DTL,18,8,2,2,4,10,8
20190119-M-Australian_Open-R32-Fabio_Fognini-Pablo_Carreno_Busta,1,F-IO,52,15,0,4,11,25,27
20190119-M-Australian_Open-R32-Fabio_Fognini-Pablo_Carreno_Busta,1,F-II,5,3,3,0,0,4,1
20190119-M-Australian_Open-R32-Fabio_Fognini-Pablo_Carreno_Busta,1,B-XC,53,7,2,0,5,31,22
20190119-M-Australian_Open-R32-Fabio_Fognini-Pablo_Carreno_Busta,1,B-DTM,42,3,0,0,3,23,19
20190119-M-Australian_Open-R32-Fabio_Fognini-Pablo_Carreno_Busta,1,B-DTL,17,7,3,1,3,10,7
20190119-M-Australian_Open-R32-Fabio_Fognini-Pablo_Carreno_Busta,1,B-IO,6,4,2,1,1,4,2
20190119-M-Australian_Open-R32-Fabio_Fognini-Pablo_Carreno_Busta,1,S-XC,21,2,0,0,2,14,7
20190119-M-Australian_Open-R32-Fabio_Fognini-Pablo_Carreno_Busta,1,S-DTM,12,1,1,0,0,8,4
20190119-M-Australian_Open-R32-Fabio_Fognini-Pablo_Carreno_Busta,1,S-DTL,2,1,0,1,0,1,1
20190119-M-Australian_Open-R32-Fabio_Fognini-Pablo_Carreno_Busta,1,S-IO,1,0,0,0,0,1,0
20190119-M-Australian_Open-R32-Fabio_Fognini-Pablo_Carreno_Busta,2,F-XC,50,15,3,2,10,20,30
20190119-M-Australian_Open-R32-Fabio_Fognini-Pablo_Carreno_Busta,2,F-DTM,42,3,0,1,2,22,20
20190119-M-Australian_Open-R32-Fabio_Fognini-Pablo_Carreno_Busta,2,F-DTL,9,5,2,2,1,6,3
20190119-M-Australian_Open-R32-Fabio_Fognini-Pablo_Carreno_Busta,2,F-IO,31,9,5,3,1,17,14
20190119-M-Australian_Open-R32-Fabio_Fognini-Pablo_Carreno_Busta,2,F-II,4,2,1,0,1,2,2
20190119-M-Australian_Open-R32-Fabio_Fognini-Pablo_Carreno_Busta,2,B-XC,81,6,1,2,3,32,49
20190119-M-Australian_Open-R32-Fabio_Fognini-Pablo_Carreno_Busta,2,B-DTM,53,3,0,0,3,22,31
20190119-M-Australian_Open-R32-Fabio_Fognini-Pablo_Carreno_Busta,2,B-DTL,12,3,1,1,1,5,7
20190119-M-Australian_Open-R32-Fabio_Fognini-Pablo_Carreno_Busta,2,B-IO,5,1,0,0,1,3,2
20190119-M-Australian_Open-R32-Fabio_Fognini-Pablo_Carreno_Busta,2,S-XC,10,0,0,0,0,1,9
20190119-M-Australian_Open-R32-Fabio_Fognini-Pablo_Carreno_Busta,2,S-DTM,7,0,0,0,0,2,5
20190119-M-Australian_Open-R32-Fabio_Fognini-Pablo_Carreno_Busta,2,S-DTL,4,0,0,0,0,2,2
20190119-M-Australian_Open-R32-Fabio_Fognini-Pablo_Carreno_Busta,2,S-IO,1,1,0,1,0,1,0
20190115-M-Australian_Open-R128-Ugo_Humbert-Jeremy_Chardy,1,F-XC,85,23,9,8,6,63,22
20190115-M-Australian_Open-R128-Ugo_Humbert-Jeremy_Chardy,1,F-DTM,62,6,0,1,5,31,31
20190115-M-Australian_Open-R128-Ugo_Humbert-Jeremy_Chardy,1,F-DTL,16,13,10,1,2,12,4
20190115-M-Australian_Open-R128-Ugo_Humbert-Jeremy_Chardy,1,F-IO,33,18,9,5,4,22,11
20190115-M-Australian_Open-R128-Ugo_Humbert-Jeremy_Chardy,1,B-XC,68,12,4,2,6,38,30
20190115-M-Australian_Open-R128-Ugo_Humbert-Jeremy_Chardy,1,B-DTM,40,3,0,0,3,24,16
20190115-M-Australian_Open-R128-Ugo_Humbert-Jeremy_Chardy,1,B-DTL,27,14,8,1,5,17,10
20190115-M-Australian_Open-R128-Ugo_Humbert-Jeremy_Chardy,1,B-IO,17,7,0,1,6,7,10
20190115-M-Australian_Open-R128-Ugo_Humbert-Jeremy_Chardy,1,S-XC,1,0,0,0,0,1,0
20190115-M-Australian_Open-R128-Ugo_Humbert-Jeremy_Chardy,1,S-DTM,12,2,0,0,2,5,7
20190115-M-Australian_Open-R128-Ugo_Humbert-Jeremy_Chardy,1,S-DTL,6,0,0,0,0,3,3
20190115-M-Australian_Open-R128-Ugo_Humbert-Jeremy_Chardy,1,S-IO,2,1,0,0,1,1,1
20190115-M-Australian_Open-R128-Ugo_Humbert-Jeremy_Chardy,2,F-XC,79,14,7,2,5,37,42
20190115-M-Australian_Open-R128-Ugo_Humbert-Jeremy_Chardy,2,F-DTM,50,5,0,1,4,20,30
20190115-M-Australian_Open-R128-Ugo_Humbert-Jeremy_Chardy,2,F-DTL,29,14,4,3,7,16,13
20190115-M-Australian_Open-R128-Ugo_Humbert-Jeremy_Chardy,2,F-IO,50,18,6,4,8,23,27
20190115-M-Australian_Open-R128-Ugo_Humbert-Jeremy_Chardy,2,F-II,11,9,2,3,4,7,4
20190115-M-Australian_Open-R128-Ugo_Humbert-Jeremy_Chardy,2,B-XC,14,1,0,0,1,7,7
20190115-M-Australian_Open-R128-Ugo_Humbert-Jeremy_Chardy,2,B-DTM,15,4,0,0,4,6,9
20190115-M-Australian_Open-R128-Ugo_Humbert-Jeremy_Chardy,2,B-DTL,8,5,2,1,2,4,4
20190115-M-Australian_Open-R128-Ugo_Humbert-Jeremy_Chardy,2,B-IO,3,1,0,0,1,1,2
20190115-M-Australian_Open-R128-Ugo_Humbert-Jeremy_Chardy,2,S-XC,17,2,0,1,1,6,11
20190115-M-Australian_Open-R128-Ugo_Humbert-Jeremy_Chardy,2,S-DTM,34,5,0,0,5,8,26
20190115-M-Australian_Open-R128-Ugo_Humbert-Jeremy_Chardy,2,S-DTL,27,6,0,0,6,4,23
20190115-M-Australian_Open-R128-Ugo_Humbert-Jeremy_Chardy,2,S-IO,11,1,0,0,1,7,4
20010908-M-US_Open-SF-Pete_Sampras-Marat_Safin,1,F-XC,9,5,1,2,2,4,5
20010908-M-US_Open-SF-Pete_Sampras-Marat_Safin,1,F-DTM,2,0,0,0,0,0,2
20010908-M-US_Open-SF-Pete_Sampras-Marat_Safin,1,F-DTL,1,1,1,0,0,1,0
20010908-M-US_Open-SF-Pete_Sampras-Marat_Safin,1,F-IO,4,3,2,0,1,2,2
20010908-M-US_Open-SF-Pete_Sampras-Marat_Safin,1,F-II,2,1,0,0,1,0,2
20010908-M-US_Open-SF-Pete_Sampras-Marat_Safin,1,B-XC,5,0,0,0,0,1,4
20010908-M-US_Open-SF-Pete_Sampras-Marat_Safin,1,B-DTM,3,0,0,0,0,1,2
20010908-M-US_Open-SF-Pete_Sampras-Marat_Safin,1,B-DTL,5,4,0,2,2,3,2
20010908-M-US_Open-SF-Pete_Sampras-Marat_Safin,1,S-XC,14,2,0,0,2,4,10
20010908-M-US_Open-SF-Pete_Sampras-Marat_Safin,1,S-DTM,3,1,0,0,1,1,2
20010908-M-US_Open-SF-Pete_Sampras-Marat_Safin,1,S-DTL,1,1,0,1,0,1,0
20010908-M-US_Open-SF-Pete_Sampras-Marat_Safin,2,F-XC,11,8,4,2,2,7,4
20010908-M-US_Open-SF-Pete_Sampras-Marat_Safin,2,F-DTM,6,0,0,0,0,4,2
20010908-M-US_Open-SF-Pete_Sampras-Marat_Safin,2,F-DTL,4,1,0,0,1,2,2
20010908-M-US_Open-SF-Pete_Sampras-Marat_Safin,2,F-IO,7,1,1,0,0,6,1
20010908-M-US_Open-SF-Pete_Sampras-Marat_Safin,2,F-II,3,1,0,0,1,1,2
20010908-M-US_Open-SF-Pete_Sampras-Marat_Safin,2,B-XC,34,10,3,5,2,22,12
20010908-M-US_Open-SF-Pete_Sampras-Marat_Safin,2,B-DTM,7,0,0,0,0,4,3
20010908-M-US_Open-SF-Pete_Sampras-Marat_Safin,2,B-DTL,5,1,1,0,0,2,3
20010908-M-US_Open-SF-Pete_Sampras-Marat_Safin,2,B-IO,2,2,1,0,1,1,1
20010908-M-US_Open-SF-Pete_Sampras-Marat_Safin,2,S-XC,4,1,0,0,1,2,2
20010908-M-US_Open-SF-Pete_Sampras-Marat_Safin,2,S-DTL,1,0,0,0,0,0,1
20010908-M-US_Open-SF-Pete_Sampras-Marat_Safin,2,S-IO,1,0,0,0,0,0,1
20040703-M-Wimbledon-SF-Mario_Ancic-Andy_Roddick,1,F-XC,31,12,7,1,4,19,12
20040703-M-Wimbledon-SF-Mario_Ancic-Andy_Roddick,1,F-DTM,18,1,0,0,1,9,9
20040703-M-Wimbledon-SF-Mario_Ancic-Andy_Roddick,1,F-DTL,8,1,1,0,0,4,4
20040703-M-Wimbledon-SF-Mario_Ancic-Andy_Roddick,1,F-IO,17,7,2,2,3,11,6
20040703-M-Wimbledon-SF-Mario_Ancic-Andy_Roddick,1,F-II,1,1,0,0,1,0,1
20040703-M-Wimbledon-SF-Mario_Ancic-Andy_Roddick,1,B-XC,22,4,0,1,3,13,9
20040703-M-Wimbledon-SF-Mario_Ancic-Andy_Roddick,1,B-DTM,14,2,0,1,1,9,5
20040703-M-Wimbledon-SF-Mario_Ancic-Andy_Roddick,1,B-DTL,3,2,1,0,1,2,1
20040703-M-Wimbledon-SF-Mario_Ancic-Andy_Roddick,1,S-XC,10,1,0,0,1,5,5
20040703-M-Wimbledon-SF-Mario_Ancic-Andy_Roddick,1,S-DTM,3,0,0,0,0,2,1
20040703-M-Wimbledon-SF-Mario_Ancic-Andy_Roddick,1,S-DTL,3,2,0,2,0,3,0
20040703-M-Wimbledon-SF-Mario_Ancic-Andy_Roddick,2,F-XC,39,10,4,2,4,16,23
20040703-M-Wimbledon-SF-Mario_Ancic-Andy_Roddick,2,F-DTM,11,3,1,1,1,7,4
20040703-M-Wimbledon-SF-Mario_Ancic-Andy_Roddick,2,F-DTL,11,3,2,0,1,6,5
20040703-M-Wimbledon-SF-Mario_Ancic-Andy_Roddick,2,F-IO,20,4,1,2,1,11,9
20040703-M-Wimbledon-SF-Mario_Ancic-Andy_Roddick,2,F-II,4,2,0,1,1,3,1
20040703-M-Wimbledon-SF-Mario_Ancic-Andy_Roddick,2,B-XC,32,4,1,3,0,14,18
20040703-M-Wimbledon-SF-Mario_Ancic-Andy_Roddick,2,B-DTM,24,4,0,2,2,10,14
20040703-M-Wimbledon-SF-Mario_Ancic-Andy_Roddick,2,B-DTL,8,3,0,3,0,6,2
20040703-M-Wimbledon-SF-Mario_Ancic-Andy_Roddick,2,B-IO,5,4,1,0,3,2,3
20040703-M-Wimbledon-SF-Mario_Ancic-Andy_Roddick,2,S-XC,19,2,0,0,2,5,14
20040703-M-Wimbledon-SF-Mario_Ancic-Andy_Roddick,2,S-DTM,2,0,0,0,0,1,1
20040703-M-Wimbledon-SF-Mario_Ancic-Andy_Roddick,2,S-DTL,3,0,0,0,0,2,1
20040703-M-Wimbledon-SF-Mario_Ancic-Andy_Roddick,2,S-IO,3,2,0,1,1,2,1
20190105-M-Brisbane-SF-Jeremy_Chardy-Kei_Nishikori,1,F-XC,10,4,1,1,2,3,7
20190105-M-Brisbane-SF-Jeremy_Chardy-Kei_Nishikori,1,F-DTM,3,0,0,0,0,1,2
20190105-M-Brisbane-SF-Jeremy_Chardy-Kei_Nishikori,1,F-DTL,3,1,0,0,1,0,3
20190105-M-Brisbane-SF-Jeremy_Chardy-Kei_Nishikori,1,F-IO,16,4,1,1,2,4,12
20190105-M-Brisbane-SF-Jeremy_Chardy-Kei_Nishikori,1,F-II,3,2,0,1,1,1,2
20190105-M-Brisbane-SF-Jeremy_Chardy-Kei_Nishikori,1,B-XC,7,2,0,0,2,0,7
20190105-M-Brisbane-SF-Jeremy_Chardy-Kei_Nishikori,1,B-DTM,6,1,0,0,0,2,4
20190105-M-Brisbane-SF-Jeremy_Chardy-Kei_Nishikori,1,B-DTL,4,2,0,0,2,0,4
20190105-M-Brisbane-SF-Jeremy_Chardy-Kei_Nishikori,1,S-XC,6,0,0,0,0,1,5
20190105-M-Brisbane-SF-Jeremy_Chardy-Kei_Nishikori,1,S-DTM,3,0,0,0,0,0,3
20190105-M-Brisbane-SF-Jeremy_Chardy-Kei_Nishikori,1,S-DTL,3,1,0,0,1,0,3
20190105-M-Brisbane-SF-Jeremy_Chardy-Kei_Nishikori,1,S-IO,2,2,0,0,2,0,2
20190105-M-Brisbane-SF-Jeremy_Chardy-Kei_Nishikori,1,S-II,1,0,0,0,0,0,1
20190105-M-Brisbane-SF-Jeremy_Chardy-Kei_Nishikori,2,F-XC,10,7,3,1,3,7,3
20190105-M-Brisbane-SF-Jeremy_Chardy-Kei_Nishikori,2,F-DTM,6,0,0,0,0,5,1
20190105-M-Brisbane-SF-Jeremy_Chardy-Kei_Nishikori,2,F-DTL,6,2,1,1,0,6,0
20190105-M-Brisbane-SF-Jeremy_Chardy-Kei_Nishikori,2,F-IO,12,2,2,0,0,10,2
20190105-M-Brisbane-SF-Jeremy_Chardy-Kei_Nishikori,2,F-II,2,1,1,0,0,2,0
20190105-M-Brisbane-SF-Jeremy_Chardy-Kei_Nishikori,2,B-XC,18,2,0,2,0,17,1
20190105-M-Brisbane-SF-Jeremy_Chardy-Kei_Nishikori,2,B-DTM,6,0,0,0,0,5,1
20190105-M-Brisbane-SF-Jeremy_Chardy-Kei_Nishikori,2,B-DTL,2,0,0,0,0,1,1
20190105-M-Brisbane-SF-Jeremy_Chardy-Kei_Nishikori,2,B-IO,2,1,1,0,0,2,0
20190105-M-Brisbane-SF-Jeremy_Chardy-Kei_Nishikori,2,B-II,1,0,0,0,0,1,0
20190105-M-Brisbane-SF-Jeremy_Chardy-Kei_Nishikori,2,S-XC,2,0,0,0,0,2,0
20190105-M-Brisbane-SF-Jeremy_Chardy-Kei_Nishikori,2,S-DTM,2,0,0,0,0,2,0
20190105-M-Brisbane-SF-Jeremy_Chardy-Kei_Nishikori,2,S-DTL,2,1,0,1,0,2,0
20190105-M-Brisbane-SF-Jeremy_Chardy-Kei_Nishikori,2,S-IO,1,0,0,0,0,1,0
20190105-M-Brisbane-SF-Jeremy_Chardy-Kei_Nishikori,2,S-II,1,0,0,0,0,1,0
19800906-M-US_Open-SF-John_Mcenroe-Jimmy_Connors,1,F-XC,53,4,0,1,3,23,30
19800906-M-US_Open-SF-John_Mcenroe-Jimmy_Connors,1,F-DTM,30,4,0,2,2,12,18
19800906-M-US_Open-SF-John_Mcenroe-Jimmy_Connors,1,F-DTL,21,8,1,1,6,7,14
19800906-M-US_Open-SF-John_Mcenroe-Jimmy_Connors,1,F-IO,7,3,1,0,2,3,4
19800906-M-US_Open-SF-John_Mcenroe-Jimmy_Connors,1,F-II,2,1,0,1,0,1,1
19800906-M-US_Open-SF-John_Mcenroe-Jimmy_Connors,1,B-XC,22,4,2,2,0,13,9
19800906-M-US_Open-SF-John_Mcenroe-Jimmy_Connors,1,B-DTM,12,1,0,0,1,5,7
19800906-M-US_Open-SF-John_Mcenroe-Jimmy_Connors,1,B-DTL,11,6,1,2,3,3,8
19800906-M-US_Open-SF-John_Mcenroe-Jimmy_Connors,1,B-IO,2,1,0,1,0,1,1
19800906-M-US_Open-SF-John_Mcenroe-Jimmy_Connors,1,S-XC,29,4,0,1,3,20,9
19800906-M-US_Open-SF-John_Mcenroe-Jimmy_Connors,1,S-DTM,30,4,0,0,4,7,23
19800906-M-US_Open-SF-John_Mcenroe-Jimmy_Connors,1,S-DTL,26,3,0,1,2,14,12
19800906-M-US_Open-SF-John_Mcenroe-Jimmy_Connors,1,S-IO,10,2,0,0,2,2,8
19800906-M-US_Open-SF-John_Mcenroe-Jimmy_Connors,1,S-II,1,0,0,0,0,1,0
19800906-M-US_Open-SF-John_Mcenroe-Jimmy_Connors,2,F-XC,74,16,5,6,5,46,28
19800906-M-US_Open-SF-John_Mcenroe-Jimmy_Connors,2,F-DTM,20,1,0,0,1,8,12
19800906-M-US_Open-SF-John_Mcenroe-Jimmy_Connors,2,F-DTL,31,6,0,5,1,15,16
19800906-M-US_Open-SF-John_Mcenroe-Jimmy_Connors,2,F-IO,25,8,2,3,3,15,10
19800906-M-US_Open-SF-John_Mcenroe-Jimmy_Connors,2,F-II,4,1,0,0,1,1,3
19800906-M-US_Open-SF-John_Mcenroe-Jimmy_Connors,2,B-XC,75,16,5,3,8,38,37
19800906-M-US_Open-SF-John_Mcenroe-Jimmy_Connors,2,B-DTM,28,4,0,1,3,20,8
19800906-M-US_Open-SF-John_Mcenroe-Jimmy_Connors,2,B-DTL,16,6,3,2,1,9,7
19800906-M-US_Open-SF-John_Mcenroe-Jimmy_Connors,2,B-IO,30,8,3,2,3,18,12
19800906-M-US_Open-SF-John_Mcenroe-Jimmy_Connors,2,S-XC,14,2,0,1,1,7,7
19800906-M-US_Open-SF-John_Mcenroe-Jimmy_Connors,2,S-DTM,5,0,0,0,0,3,2
19800906-M-US_Open-SF-John_Mcenroe-Jimmy_Connors,2,S-DTL,5,1,0,1,0,2,3
19800906-M-US_Open-SF-John_Mcenroe-Jimmy_Connors,2,S-IO,2,0,0,0,0,1,1
20190201-M-Davis_Cup_Qualifiers-RR-Prajnesh_Gunneswaran-Matteo_Berrettini,1,F-XC,19,7,2,4,1,10,9
20190201-M-Davis_Cup_Qualifiers-RR-Prajnesh_Gunneswaran-Matteo_Berrettini,1,F-DTM,20,3,0,1,2,13,7
20190201-M-Davis_Cup_Qualifiers-RR-Prajnesh_Gunneswaran-Matteo_Berrettini,1,F-DTL,4,2,0,1,1,2,2
20190201-M-Davis_Cup_Qualifiers-RR-Prajnesh_Gunneswaran-Matteo_Berrettini,1,F-IO,16,6,1,1,4,5,11
20190201-M-Davis_Cup_Qualifiers-RR-Prajnesh_Gunneswaran-Matteo_Berrettini,1,F-II,2,0,0,0,0,1,1
20190201-M-Davis_Cup_Qualifiers-RR-Prajnesh_Gunneswaran-Matteo_Berrettini,1,B-XC,5,2,0,0,2,2,3
20190201-M-Davis_Cup_Qualifiers-RR-Prajnesh_Gunneswaran-Matteo_Berrettini,1,B-DTM,11,1,0,0,1,5,6
20190201-M-Davis_Cup_Qualifiers-RR-Prajnesh_Gunneswaran-Matteo_Berrettini,1,B-DTL,2,1,0,0,1,1,1
20190201-M-Davis_Cup_Qualifiers-RR-Prajnesh_Gunneswaran-Matteo_Berrettini,1,B-IO,1,1,1,0,0,1,0
20190201-M-Davis_Cup_Qualifiers-RR-Prajnesh_Gunneswaran-Matteo_Berrettini,1,S-XC,2,0,0,0,0,1,1
20190201-M-Davis_Cup_Qualifiers-RR-Prajnesh_Gunneswaran-Matteo_Berrettini,1,S-DTM,1,0,0,0,0,1,0
20190201-M-Davis_Cup_Qualifiers-RR-Prajnesh_Gunneswaran-Matteo_Berrettini,1,S-DTL,1,0,0,0,0,1,0
20190201-M-Davis_Cup_Qualifiers-RR-Prajnesh_Gunneswaran-Matteo_Berrettini,2,F-XC,22,6,3,1,2,11,11
20190201-M-Davis_Cup_Qualifiers-RR-Prajnesh_Gunneswaran-Matteo_Berrettini,2,F-DTM,7,2,0,0,2,4,3
20190201-M-Davis_Cup_Qualifiers-RR-Prajnesh_Gunneswaran-Matteo_Berrettini,2,F-DTL,10,7,4,1,2,7,3
20190201-M-Davis_Cup_Qualifiers-RR-Prajnesh_Gunneswaran-Matteo_Berrettini,2,F-IO,11,7,2,1,3,7,4
20190201-M-Davis_Cup_Qualifiers-RR-Prajnesh_Gunneswaran-Matteo_Berrettini,2,F-II,1,0,0,0,0,1,0
20190201-M-Davis_Cup_Qualifiers-RR-Prajnesh_Gunneswaran-Matteo_Berrettini,2,B-XC,5,1,1,0,0,2,3
20190201-M-Davis_Cup_Qualifiers-RR-Prajnesh_Gunneswaran-Matteo_Berrettini,2,B-DTM,7,3,0,2,1,4,3
20190201-M-Davis_Cup_Qualifiers-RR-Prajnesh_Gunneswaran-Matteo_Berrettini,2,B-DTL,3,2,1,0,1,2,1
20190201-M-Davis_Cup_Qualifiers-RR-Prajnesh_Gunneswaran-Matteo_Berrettini,2,S-XC,3,0,0,0,0,2,1
20190201-M-Davis_Cup_Qualifiers-RR-Prajnesh_Gunneswaran-Matteo_Berrettini,2,S-DTM,1,0,0,0,0,0,1
20190201-M-Davis_Cup_Qualifiers-RR-Prajnesh_Gunneswaran-Matteo_Berrettini,2,S-DTL,1,1,0,0,1,0,1
20181017-M-Moscow-R16-Marco_Cecchinato-Adrian_Mannarino,1,F-XC,15,7,1,1,5,5,10
20181017-M-Moscow-R16-Marco_Cecchinato-Adrian_Mannarino,1,F-DTM,12,1,0,0,1,3,9
20181017-M-Moscow-R16-Marco_Cecchinato-Adrian_Mannarino,1,F-DTL,3,3,0,1,2,1,2
20181017-M-Moscow-R16-Marco_Cecchinato-Adrian_Mannarino,1,F-IO,12,8,6,0,2,6,6
20181017-M-Moscow-R16-Marco_Cecchinato-Adrian_Mannarino,1,B-XC,4,2,0,0,2,1,3
20181017-M-Moscow-R16-Marco_Cecchinato-Adrian_Mannarino,1,B-DTM,7,4,0,0,4,1,6
20181017-M-Moscow-R16-Marco_Cecchinato-Adrian_Mannarino,1,B-DTL,1,0,0,0,0,0,1
20181017-M-Moscow-R16-Marco_Cecchinato-Adrian_Mannarino,1,B-IO,3,2,1,0,1,1,2
20181017-M-Moscow-R16-Marco_Cecchinato-Adrian_Mannarino,1,S-XC,2,0,0,0,0,0,2
20181017-M-Moscow-R16-Marco_Cecchinato-Adrian_Mannarino,1,S-DTM,4,1,0,0,1,0,4
20181017-M-Moscow-R16-Marco_Cecchinato-Adrian_Mannarino,1,S-DTL,1,0,0,0,0,1,0
20181017-M-Moscow-R16-Marco_Cecchinato-Adrian_Mannarino,2,F-XC,10,2,0,2,0,9,1
20181017-M-Moscow-R16-Marco_Cecchinato-Adrian_Mannarino,2,F-DTM,9,1,0,0,1,7,2
20181017-M-Moscow-R16-Marco_Cecchinato-Adrian_Mannarino,2,F-DTL,1,1,1,0,0,1,0
20181017-M-Moscow-R16-Marco_Cecchinato-Adrian_Mannarino,2,F-IO,1,1,0,0,1,0,1
20181017-M-Moscow-R16-Marco_Cecchinato-Adrian_Mannarino,2,B-XC,9,4,3,1,0,9,0
20181017-M-Moscow-R16-Marco_Cecchinato-Adrian_Mannarino,2,B-DTM,11,0,0,0,0,8,3
20181017-M-Moscow-R16-Marco_Cecchinato-Adrian_Mannarino,2,B-IO,2,0,0,0,0,1,1
20181017-M-Moscow-R16-Marco_Cecchinato-Adrian_Mannarino,2,S-DTM,2,0,0,0,0,0,2
20190201-M-Davis_Cup_Qualifiers-RR-Felix_Auger_Aliassime-Martin_Klizan,1,F-XC,51,15,5,2,8,23,28
20190201-M-Davis_Cup_Qualifiers-RR-Felix_Auger_Aliassime-Martin_Klizan,1,F-DTM,18,0,0,0,0,7,11
20190201-M-Davis_Cup_Qualifiers-RR-Felix_Auger_Aliassime-Martin_Klizan,1,F-DTL,8,3,3,0,0,6,2
20190201-M-Davis_Cup_Qualifiers-RR-Felix_Auger_Aliassime-Martin_Klizan,1,F-IO,17,7,2,2,3,7,10
20190201-M-Davis_Cup_Qualifiers-RR-Felix_Auger_Aliassime-Martin_Klizan,1,F-II,4,2,0,0,2,2,2
20190201-M-Davis_Cup_Qualifiers-RR-Felix_Auger_Aliassime-Martin_Klizan,1,B-XC,30,9,0,0,9,11,19
20190201-M-Davis_Cup_Qualifiers-RR-Felix_Auger_Aliassime-Martin_Klizan,1,B-DTM,20,3,0,0,3,7,13
20190201-M-Davis_Cup_Qualifiers-RR-Felix_Auger_Aliassime-Martin_Klizan,1,B-DTL,11,1,0,0,1,4,7
20190201-M-Davis_Cup_Qualifiers-RR-Felix_Auger_Aliassime-Martin_Klizan,1,B-IO,3,0,0,0,0,0,3
20190201-M-Davis_Cup_Qualifiers-RR-Felix_Auger_Aliassime-Martin_Klizan,1,S-DTL,2,0,0,0,0,1,1
20190201-M-Davis_Cup_Qualifiers-RR-Felix_Auger_Aliassime-Martin_Klizan,2,F-XC,44,7,2,4,1,28,16
20190201-M-Davis_Cup_Qualifiers-RR-Felix_Auger_Aliassime-Martin_Klizan,2,F-DTM,12,1,0,0,1,9,3
20190201-M-Davis_Cup_Qualifiers-RR-Felix_Auger_Aliassime-Martin_Klizan,2,F-DTL,13,6,1,0,5,6,7
20190201-M-Davis_Cup_Qualifiers-RR-Felix_Auger_Aliassime-Martin_Klizan,2,F-IO,11,4,3,0,1,6,5
20190201-M-Davis_Cup_Qualifiers-RR-Felix_Auger_Aliassime-Martin_Klizan,2,F-II,3,3,0,0,3,0,3
20190201-M-Davis_Cup_Qualifiers-RR-Felix_Auger_Aliassime-Martin_Klizan,2,B-XC,25,7,0,5,2,15,10
20190201-M-Davis_Cup_Qualifiers-RR-Felix_Auger_Aliassime-Martin_Klizan,2,B-DTM,17,0,0,0,0,10,7
20190201-M-Davis_Cup_Qualifiers-RR-Felix_Auger_Aliassime-Martin_Klizan,2,B-DTL,13,3,0,1,2,7,6
20190201-M-Davis_Cup_Qualifiers-RR-Felix_Auger_Aliassime-Martin_Klizan,2,B-IO,4,1,0,0,1,2,2
20190201-M-Davis_Cup_Qualifiers-RR-Felix_Auger_Aliassime-Martin_Klizan,2,S-XC,1,0,0,0,0,0,1
20190201-M-Davis_Cup_Qualifiers-RR-Felix_Auger_Aliassime-Martin_Klizan,2,S-DTM,2,0,0,0,0,0,2
20060707-M-Wimbledon-SF-Marcos_Baghdatis-Rafael_Nadal,1,F-XC,87,13,3,6,4,52,35
20060707-M-Wimbledon-SF-Marcos_Baghdatis-Rafael_Nadal,1,F-DTM,11,1,0,0,1,3,8
20060707-M-Wimbledon-SF-Marcos_Baghdatis-Rafael_Nadal,1,F-DTL,17,11,4,2,5,8,9
20060707-M-Wimbledon-SF-Marcos_Baghdatis-Rafael_Nadal,1,F-IO,16,7,6,1,0,13,3
20060707-M-Wimbledon-SF-Marcos_Baghdatis-Rafael_Nadal,1,F-II,12,3,2,1,0,7,5
20060707-M-Wimbledon-SF-Marcos_Baghdatis-Rafael_Nadal,1,B-XC,42,10,4,1,5,22,20
20060707-M-Wimbledon-SF-Marcos_Baghdatis-Rafael_Nadal,1,B-DTM,41,3,0,0,3,16,25
20060707-M-Wimbledon-SF-Marcos_Baghdatis-Rafael_Nadal,1,B-DTL,27,3,0,1,2,15,12
20060707-M-Wimbledon-SF-Marcos_Baghdatis-Rafael_Nadal,1,B-IO,8,1,0,0,1,6,2
20060707-M-Wimbledon-SF-Marcos_Baghdatis-Rafael_Nadal,1,S-DTM,9,0,0,0,0,4,5
20060707-M-Wimbledon-SF-Marcos_Baghdatis-Rafael_Nadal,1,S-DTL,7,0,0,0,0,4,3
20060707-M-Wimbledon-SF-Marcos_Baghdatis-Rafael_Nadal,2,F-XC,76,10,5,4,1,46,30
20060707-M-Wimbledon-SF-Marcos_Baghdatis-Rafael_Nadal,2,F-DTM,15,0,0,0,0,3,12
20060707-M-Wimbledon-SF-Marcos_Baghdatis-Rafael_Nadal,2,F-DTL,15,6,2,1,3,7,8
20060707-M-Wimbledon-SF-Marcos_Baghdatis-Rafael_Nadal,2,F-IO,40,14,7,3,4,26,14
20060707-M-Wimbledon-SF-Marcos_Baghdatis-Rafael_Nadal,2,F-II,16,3,2,0,1,7,9
20060707-M-Wimbledon-SF-Marcos_Baghdatis-Rafael_Nadal,2,B-XC,53,21,5,9,7,30,23
20060707-M-Wimbledon-SF-Marcos_Baghdatis-Rafael_Nadal,2,B-DTM,24,0,0,0,0,6,18
20060707-M-Wimbledon-SF-Marcos_Baghdatis-Rafael_Nadal,2,B-DTL,32,9,3,4,2,20,12
20060707-M-Wimbledon-SF-Marcos_Baghdatis-Rafael_Nadal,2,B-IO,5,0,0,0,0,3,2
20060707-M-Wimbledon-SF-Marcos_Baghdatis-Rafael_Nadal,2,S-XC,2,0,0,0,0,1,1
20060707-M-Wimbledon-SF-Marcos_Baghdatis-Rafael_Nadal,2,S-DTM,10,1,0,0,1,0,10
20060707-M-Wimbledon-SF-Marcos_Baghdatis-Rafael_Nadal,2,S-DTL,10,0,0,0,0,2,8
20060707-M-Wimbledon-SF-Marcos_Baghdatis-Rafael_Nadal,2,S-IO,1,0,0,0,0,0,1
20050910-M-US_Open-SF-Robby_Ginepri-Andre_Agassi,1,F-XC,46,10,0,8,2,24,22
20050910-M-US_Open-SF-Robby_Ginepri-Andre_Agassi,1,F-DTM,27,4,0,0,4,7,20
20050910-M-US_Open-SF-Robby_Ginepri-Andre_Agassi,1,F-DTL,30,9,5,3,1,18,12
20050910-M-US_Open-SF-Robby_Ginepri-Andre_Agassi,1,F-IO,20,9,1,3,5,6,14
20050910-M-US_Open-SF-Robby_Ginepri-Andre_Agassi,1,F-II,5,4,2,0,2,2,3
20050910-M-US_Open-SF-Robby_Ginepri-Andre_Agassi,1,B-XC,101,16,4,5,7,44,57
20050910-M-US_Open-SF-Robby_Ginepri-Andre_Agassi,1,B-DTM,34,4,0,0,4,10,24
20050910-M-US_Open-SF-Robby_Ginepri-Andre_Agassi,1,B-DTL,48,20,7,2,11,18,30
20050910-M-US_Open-SF-Robby_Ginepri-Andre_Agassi,1,B-IO,5,2,1,0,1,4,1
20050910-M-US_Open-SF-Robby_Ginepri-Andre_Agassi,1,B-II,1,1,0,1,0,1,0
20050910-M-US_Open-SF-Robby_Ginepri-Andre_Agassi,1,S-XC,9,2,1,0,1,4,5
20050910-M-US_Open-SF-Robby_Ginepri-Andre_Agassi,1,S-DTM,6,1,0,0,1,0,6
20050910-M-US_Open-SF-Robby_Ginepri-Andre_Agassi,1,S-DTL,8,2,0,1,1,2,6
20050910-M-US_Open-SF-Robby_Ginepri-Andre_Agassi,2,F-XC,76,17,7,10,0,49,27
20050910-M-US_Open-SF-Robby_Ginepri-Andre_Agassi,2,F-DTM,17,0,0,0,0,11,6
20050910-M-US_Open-SF-Robby_Ginepri-Andre_Agassi,2,F-DTL,28,9,5,2,2,17,11
20050910-M-US_Open-SF-Robby_Ginepri-Andre_Agassi,2,F-IO,31,8,4,1,3,23,8
20050910-M-US_Open-SF-Robby_Ginepri-Andre_Agassi,2,F-II,7,4,3,0,1,6,1
20050910-M-US_Open-SF-Robby_Ginepri-Andre_Agassi,2,B-XC,105,22,2,7,13,62,43
20050910-M-US_Open-SF-Robby_Ginepri-Andre_Agassi,2,B-DTM,17,2,0,0,2,12,5
20050910-M-US_Open-SF-Robby_Ginepri-Andre_Agassi,2,B-DTL,20,11,4,1,6,11,9
20050910-M-US_Open-SF-Robby_Ginepri-Andre_Agassi,2,B-IO,5,2,1,0,1,3,2
20050910-M-US_Open-SF-Robby_Ginepri-Andre_Agassi,2,S-XC,31,2,0,1,1,19,12
20050910-M-US_Open-SF-Robby_Ginepri-Andre_Agassi,2,S-DTM,1,0,0,0,0,0,1
20050910-M-US_Open-SF-Robby_Ginepri-Andre_Agassi,2,S-DTL,2,0,0,0,0,1,1
20050910-M-US_Open-SF-Robby_Ginepri-Andre_Agassi,2,S-IO,1,1,0,1,0,1,0
20181020-M-Moscow-SF-Adrian_Mannarino-Andreas_Seppi,1,F-XC,64,8,1,0,7,31,33
20181020-M-Moscow-SF-Adrian_Mannarino-Andreas_Seppi,1,F-DTM,60,3,0,0,3,27,33
20181020-M-Moscow-SF-Adrian_Mannarino-Andreas_Seppi,1,F-DTL,8,3,1,2,0,5,3
20181020-M-Moscow-SF-Adrian_Mannarino-Andreas_Seppi,1,F-IO,7,0,0,0,0,5,2
20181020-M-Moscow-SF-Adrian_Mannarino-Andreas_Seppi,1,B-XC,47,6,1,1,4,31,16
20181020-M-Moscow-SF-Adrian_Mannarino-Andreas_Seppi,1,B-DTM,63,6,0,0,6,33,30
20181020-M-Moscow-SF-Adrian_Mannarino-Andreas_Seppi,1,B-DTL,4,2,0,1,1,3,1
20181020-M-Moscow-SF-Adrian_Mannarino-Andreas_Seppi,1,B-IO,10,3,0,1,2,3,7
20181020-M-Moscow-SF-Adrian_Mannarino-Andreas_Seppi,1,S-XC,3,0,0,0,0,3,0
20181020-M-Moscow-SF-Adrian_Mannarino-Andreas_Seppi,1,S-DTM,6,2,0,0,2,2,4
20181020-M-Moscow-SF-Adrian_Mannarino-Andreas_Seppi,1,S-DTL,3,0,0,0,0,0,3
20181020-M-Moscow-SF-Adrian_Mannarino-Andreas_Seppi,1,S-IO,1,0,0,0,0,1,0
20181020-M-Moscow-SF-Adrian_Mannarino-Andreas_Seppi,2,F-XC,60,10,2,0,8,25,35
20181020-M-Moscow-SF-Adrian_Mannarino-Andreas_Seppi,2,F-DTM,55,6,0,0,6,23,32
20181020-M-Moscow-SF-Adrian_Mannarino-Andreas_Seppi,2,F-DTL,12,5,1,1,3,5,7
20181020-M-Moscow-SF-Adrian_Mannarino-Andreas_Seppi,2,F-IO,40,8,3,0,5,20,20
20181020-M-Moscow-SF-Adrian_Mannarino-Andreas_Seppi,2,F-II,1,1,1,0,0,1,0
20181020-M-Moscow-SF-Adrian_Mannarino-Andreas_Seppi,2,B-XC,33,4,1,0,3,16,17
20181020-M-Moscow-SF-Adrian_Mannarino-Andreas_Seppi,2,B-DTM,47,6,1,0,5,23,24
20181020-M-Moscow-SF-Adrian_Mannarino-Andreas_Seppi,2,B-DTL,3,0,0,0,0,2,1
20181020-M-Moscow-SF-Adrian_Mannarino-Andreas_Seppi,2,B-IO,5,3,0,0,3,2,3
20181020-M-Moscow-SF-Adrian_Mannarino-Andreas_Seppi,2,S-XC,7,0,0,0,0,1,6
20181020-M-Moscow-SF-Adrian_Mannarino-Andreas_Seppi,2,S-DTM,14,3,0,0,3,5,9
20181020-M-Moscow-SF-Adrian_Mannarino-Andreas_Seppi,2,S-DTL,3,1,0,0,1,1,2
20181020-M-Moscow-SF-Adrian_Mannarino-Andreas_Seppi,2,S-IO,5,0,0,0,0,5,0
20181019-M-Moscow-QF-Ricardas_Berankis-Daniil_Medvedev,1,F-XC,37,13,5,4,4,22,15
20181019-M-Moscow-QF-Ricardas_Berankis-Daniil_Medvedev,1,F-DTM,23,6,0,0,6,7,16
20181019-M-Moscow-QF-Ricardas_Berankis-Daniil_Medvedev,1,F-DTL,12,8,4,0,4,6,6
20181019-M-Moscow-QF-Ricardas_Berankis-Daniil_Medvedev,1,F-IO,33,13,3,5,5,22,11
20181019-M-Moscow-QF-Ricardas_Berankis-Daniil_Medvedev,1,B-XC,30,7,1,2,4,18,12
20181019-M-Moscow-QF-Ricardas_Berankis-Daniil_Medvedev,1,B-DTM,18,2,0,0,2,5,13
20181019-M-Moscow-QF-Ricardas_Berankis-Daniil_Medvedev,1,B-DTL,7,3,1,0,2,3,4
20181019-M-Moscow-QF-Ricardas_Berankis-Daniil_Medvedev,1,B-IO,8,5,1,1,3,4,4
20181019-M-Moscow-QF-Ricardas_Berankis-Daniil_Medvedev,1,B-II,1,1,0,0,1,0,1
20181019-M-Moscow-QF-Ricardas_Berankis-Daniil_Medvedev,1,S-XC,3,1,0,0,1,1,2
20181019-M-Moscow-QF-Ricardas_Berankis-Daniil_Medvedev,1,S-DTM,5,1,1,0,0,3,2
20181019-M-Moscow-QF-Ricardas_Berankis-Daniil_Medvedev,1,S-DTL,2,0,0,0,0,0,2
20181019-M-Moscow-QF-Ricardas_Berankis-Daniil_Medvedev,1,S-IO,1,0,0,0,0,1,0
20181019-M-Moscow-QF-Ricardas_Berankis-Daniil_Medvedev,2,F-XC,21,6,3,1,2,13,8
20181019-M-Moscow-QF-Ricardas_Berankis-Daniil_Medvedev,2,F-DTM,31,3,0,0,3,10,21
20181019-M-Moscow-QF-Ricardas_Berankis-Daniil_Medvedev,2,F-DTL,3,1,1,0,0,3,0
20181019-M-Moscow-QF-Ricardas_Berankis-Daniil_Medvedev,2,F-IO,6,4,2,0,2,3,3
20181019-M-Moscow-QF-Ricardas_Berankis-Daniil_Medvedev,2,B-XC,30,4,3,0,1,16,14
20181019-M-Moscow-QF-Ricardas_Berankis-Daniil_Medvedev,2,B-DTM,44,3,1,0,2,23,21
20181019-M-Moscow-QF-Ricardas_Berankis-Daniil_Medvedev,2,B-DTL,5,2,0,0,2,3,2
20181019-M-Moscow-QF-Ricardas_Berankis-Daniil_Medvedev,2,B-IO,1,0,0,0,0,0,1
20181019-M-Moscow-QF-Ricardas_Berankis-Daniil_Medvedev,2,B-II,1,1,1,0,0,1,0
20181019-M-Moscow-QF-Ricardas_Berankis-Daniil_Medvedev,2,S-XC,2,0,0,0,0,1,1
20181019-M-Moscow-QF-Ricardas_Berankis-Daniil_Medvedev,2,S-DTM,2,1,0,0,1,0,2
20181019-M-Moscow-QF-Ricardas_Berankis-Daniil_Medvedev,2,S-IO,1,0,0,0,0,0,1
20181019-M-Moscow-QF-Ricardas_Berankis-Daniil_Medvedev,2,S-II,1,1,0,0,1,0,1
20190204-M-Dallas_CH-Q1-Gijs_Brouwer-Martin_Redlicki,1,F-XC,25,7,0,2,5,15,10
20190204-M-Dallas_CH-Q1-Gijs_Brouwer-Martin_Redlicki,1,F-DTM,32,1,0,0,1,21,11
20190204-M-Dallas_CH-Q1-Gijs_Brouwer-Martin_Redlicki,1,F-DTL,7,2,1,0,1,5,2
20190204-M-Dallas_CH-Q1-Gijs_Brouwer-Martin_Redlicki,1,F-IO,17,8,3,0,5,9,8
20190204-M-Dallas_CH-Q1-Gijs_Brouwer-Martin_Redlicki,1,B-XC,17,6,2,1,3,7,10
20190204-M-Dallas_CH-Q1-Gijs_Brouwer-Martin_Redlicki,1,B-DTM,14,2,0,0,2,5,9
20190204-M-Dallas_CH-Q1-Gijs_Brouwer-Martin_Redlicki,1,B-DTL,4,1,0,0,1,1,3
20190204-M-Dallas_CH-Q1-Gijs_Brouwer-Martin_Redlicki,1,B-IO,3,0,0,0,0,1,2
20190204-M-Dallas_CH-Q1-Gijs_Brouwer-Martin_Redlicki,1,S-XC,2,0,0,0,0,1,1
20190204-M-Dallas_CH-Q1-Gijs_Brouwer-Martin_Redlicki,1,S-DTM,8,0,0,0,0,3,5
20190204-M-Dallas_CH-Q1-Gijs_Brouwer-Martin_Redlicki,1,S-DTL,2,0,0,0,0,0,2
20190204-M-Dallas_CH-Q1-Gijs_Brouwer-Martin_Redlicki,1,S-IO,2,0,0,0,0,1,1
20190204-M-Dallas_CH-Q1-Gijs_Brouwer-Martin_Redlicki,2,F-XC,23,4,0,0,4,9,14
20190204-M-Dallas_CH-Q1-Gijs_Brouwer-Martin_Redlicki,2,F-DTM,22,4,0,0,4,5,17
20190204-M-Dallas_CH-Q1-Gijs_Brouwer-Martin_Redlicki,2,F-DTL,3,1,0,0,1,0,3
20190204-M-Dallas_CH-Q1-Gijs_Brouwer-Martin_Redlicki,2,F-IO,22,8,3,1,4,14,8
20190204-M-Dallas_CH-Q1-Gijs_Brouwer-Martin_Redlicki,2,F-II,2,2,0,1,1,1,1
20190204-M-Dallas_CH-Q1-Gijs_Brouwer-Martin_Redlicki,2,B-XC,10,3,0,0,3,5,5
20190204-M-Dallas_CH-Q1-Gijs_Brouwer-Martin_Redlicki,2,B-DTM,13,2,0,0,2,2,11
20190204-M-Dallas_CH-Q1-Gijs_Brouwer-Martin_Redlicki,2,B-DTL,4,2,0,0,2,2,2
20190204-M-Dallas_CH-Q1-Gijs_Brouwer-Martin_Redlicki,2,B-IO,1,1,0,1,0,1,0
20190204-M-Dallas_CH-Q1-Gijs_Brouwer-Martin_Redlicki,2,B-II,1,0,0,0,0,0,1
20190204-M-Dallas_CH-Q1-Gijs_Brouwer-Martin_Redlicki,2,S-XC,4,1,0,0,1,2,2
20190204-M-Dallas_CH-Q1-Gijs_Brouwer-Martin_Redlicki,2,S-DTM,14,1,0,0,1,5,9
20190204-M-Dallas_CH-R64-Michael_Redlicki-Goncalo_Oliveira,1,F-XC,36,4,1,0,3,18,18
20190204-M-Dallas_CH-R64-Michael_Redlicki-Goncalo_Oliveira,1,F-DTM,79,5,0,0,5,38,41
20190204-M-Dallas_CH-R64-Michael_Redlicki-Goncalo_Oliveira,1,F-DTL,8,1,0,0,1,5,3
20190204-M-Dallas_CH-R64-Michael_Redlicki-Goncalo_Oliveira,1,F-IO,15,5,3,0,2,9,6
20190204-M-Dallas_CH-R64-Michael_Redlicki-Goncalo_Oliveira,1,F-II,2,1,0,0,1,1,1
20190204-M-Dallas_CH-R64-Michael_Redlicki-Goncalo_Oliveira,1,B-XC,24,3,0,1,2,16,8
20190204-M-Dallas_CH-R64-Michael_Redlicki-Goncalo_Oliveira,1,B-DTM,34,1,0,0,1,16,18
20190204-M-Dallas_CH-R64-Michael_Redlicki-Goncalo_Oliveira,1,B-DTL,2,1,1,0,0,1,1
20190204-M-Dallas_CH-R64-Michael_Redlicki-Goncalo_Oliveira,1,B-IO,1,1,1,0,0,1,0
20190204-M-Dallas_CH-R64-Michael_Redlicki-Goncalo_Oliveira,1,B-II,1,1,0,0,1,0,1
20190204-M-Dallas_CH-R64-Michael_Redlicki-Goncalo_Oliveira,1,S-XC,3,1,0,0,1,0,3
20190204-M-Dallas_CH-R64-Michael_Redlicki-Goncalo_Oliveira,1,S-DTM,9,0,0,0,0,3,6
20190204-M-Dallas_CH-R64-Michael_Redlicki-Goncalo_Oliveira,1,S-IO,1,0,0,0,0,0,1
20190204-M-Dallas_CH-R64-Michael_Redlicki-Goncalo_Oliveira,2,F-XC,39,10,3,3,4,24,15
20190204-M-Dallas_CH-R64-Michael_Redlicki-Goncalo_Oliveira,2,F-DTM,68,12,0,3,9,31,37
20190204-M-Dallas_CH-R64-Michael_Redlicki-Goncalo_Oliveira,2,F-DTL,3,3,2,0,1,2,1
20190204-M-Dallas_CH-R64-Michael_Redlicki-Goncalo_Oliveira,2,F-IO,21,8,7,0,1,15,6
20190204-M-Dallas_CH-R64-Michael_Redlicki-Goncalo_Oliveira,2,F-II,1,0,0,0,0,1,0
20190204-M-Dallas_CH-R64-Michael_Redlicki-Goncalo_Oliveira,2,B-XC,19,6,1,0,5,5,14
20190204-M-Dallas_CH-R64-Michael_Redlicki-Goncalo_Oliveira,2,B-DTM,57,7,0,0,7,24,33
20190204-M-Dallas_CH-R64-Michael_Redlicki-Goncalo_Oliveira,2,B-DTL,3,3,0,0,3,0,3
20190204-M-Dallas_CH-R64-Michael_Redlicki-Goncalo_Oliveira,2,B-IO,8,3,1,0,2,2,6
20190204-M-Dallas_CH-R64-Michael_Redlicki-Goncalo_Oliveira,2,S-XC,2,1,0,0,1,0,2
20190204-M-Dallas_CH-R64-Michael_Redlicki-Goncalo_Oliveira,2,S-DTM,12,1,0,0,1,6,6
20190202-M-Davis_Cup_Qualifiers-RR-Jiri_Lehecka-Robin_Haase,1,F-XC,33,10,3,4,2,21,12
20190202-M-Davis_Cup_Qualifiers-RR-Jiri_Lehecka-Robin_Haase,1,F-DTM,40,7,0,2,5,18,22
20190202-M-Davis_Cup_Qualifiers-RR-Jiri_Lehecka-Robin_Haase,1,F-DTL,5,3,0,0,3,1,4
20190202-M-Davis_Cup_Qualifiers-RR-Jiri_Lehecka-Robin_Haase,1,F-IO,24,13,7,1,5,15,9
20190202-M-Davis_Cup_Qualifiers-RR-Jiri_Lehecka-Robin_Haase,1,F-II,1,0,0,0,0,0,1
20190202-M-Davis_Cup_Qualifiers-RR-Jiri_Lehecka-Robin_Haase,1,B-XC,41,6,0,4,2,19,22
20190202-M-Davis_Cup_Qualifiers-RR-Jiri_Lehecka-Robin_Haase,1,B-DTM,52,6,1,1,4,28,24
20190202-M-Davis_Cup_Qualifiers-RR-Jiri_Lehecka-Robin_Haase,1,B-DTL,5,3,0,0,3,1,4
20190202-M-Davis_Cup_Qualifiers-RR-Jiri_Lehecka-Robin_Haase,1,B-IO,9,4,2,0,2,5,4
20190202-M-Davis_Cup_Qualifiers-RR-Jiri_Lehecka-Robin_Haase,1,B-II,1,1,0,1,0,1,0
20190202-M-Davis_Cup_Qualifiers-RR-Jiri_Lehecka-Robin_Haase,1,S-XC,5,0,0,0,0,1,4
20190202-M-Davis_Cup_Qualifiers-RR-Jiri_Lehecka-Robin_Haase,1,S-DTM,6,0,0,0,0,1,5
20190202-M-Davis_Cup_Qualifiers-RR-Jiri_Lehecka-Robin_Haase,1,S-DTL,4,1,0,0,1,0,4
20190202-M-Davis_Cup_Qualifiers-RR-Jiri_Lehecka-Robin_Haase,2,F-XC,26,6,1,2,3,14,12
20190202-M-Davis_Cup_Qualifiers-RR-Jiri_Lehecka-Robin_Haase,2,F-DTM,38,1,0,0,1,19,19
20190202-M-Davis_Cup_Qualifiers-RR-Jiri_Lehecka-Robin_Haase,2,F-DTL,9,4,1,1,2,5,4
20190202-M-Davis_Cup_Qualifiers-RR-Jiri_Lehecka-Robin_Haase,2,F-IO,28,6,3,2,1,17,11
20190202-M-Davis_Cup_Qualifiers-RR-Jiri_Lehecka-Robin_Haase,2,F-II,1,1,0,1,0,1,0
20190202-M-Davis_Cup_Qualifiers-RR-Jiri_Lehecka-Robin_Haase,2,B-XC,7,3,0,0,3,3,4
20190202-M-Davis_Cup_Qualifiers-RR-Jiri_Lehecka-Robin_Haase,2,B-DTM,21,2,0,0,2,8,13
20190202-M-Davis_Cup_Qualifiers-RR-Jiri_Lehecka-Robin_Haase,2,B-DTL,7,4,1,1,2,3,4
20190202-M-Davis_Cup_Qualifiers-RR-Jiri_Lehecka-Robin_Haase,2,B-IO,1,1,0,0,1,0,1
20190202-M-Davis_Cup_Qualifiers-RR-Jiri_Lehecka-Robin_Haase,2,S-XC,22,1,0,0,1,15,7
20190202-M-Davis_Cup_Qualifiers-RR-Jiri_Lehecka-Robin_Haase,2,S-DTM,32,1,0,0,1,15,17
20190202-M-Davis_Cup_Qualifiers-RR-Jiri_Lehecka-Robin_Haase,2,S-DTL,1,1,0,0,1,0,1
20190202-M-Davis_Cup_Qualifiers-RR-Jiri_Lehecka-Robin_Haase,2,S-IO,2,1,0,0,1,0,2
20190201-M-Davis_Cup_Qualifiers-RR-Lukas_Rosol-Robin_Haase,1,F-XC,21,5,2,0,3,11,10
20190201-M-Davis_Cup_Qualifiers-RR-Lukas_Rosol-Robin_Haase,1,F-DTM,38,1,0,0,1,20,18
20190201-M-Davis_Cup_Qualifiers-RR-Lukas_Rosol-Robin_Haase,1,F-DTL,5,2,2,0,0,3,2
20190201-M-Davis_Cup_Qualifiers-RR-Lukas_Rosol-Robin_Haase,1,F-IO,23,6,1,0,5,12,11
20190201-M-Davis_Cup_Qualifiers-RR-Lukas_Rosol-Robin_Haase,1,F-II,5,3,1,0,2,3,2
20190201-M-Davis_Cup_Qualifiers-RR-Lukas_Rosol-Robin_Haase,1,B-XC,24,3,1,1,1,11,13
20190201-M-Davis_Cup_Qualifiers-RR-Lukas_Rosol-Robin_Haase,1,B-DTM,12,3,0,0,3,4,8
20190201-M-Davis_Cup_Qualifiers-RR-Lukas_Rosol-Robin_Haase,1,B-DTL,3,3,0,1,2,1,2
20190201-M-Davis_Cup_Qualifiers-RR-Lukas_Rosol-Robin_Haase,1,B-IO,1,0,0,0,0,0,1
20190201-M-Davis_Cup_Qualifiers-RR-Lukas_Rosol-Robin_Haase,1,S-XC,4,2,1,0,1,2,2
20190201-M-Davis_Cup_Qualifiers-RR-Lukas_Rosol-Robin_Haase,1,S-DTM,8,1,0,0,1,3,5
20190201-M-Davis_Cup_Qualifiers-RR-Lukas_Rosol-Robin_Haase,1,S-IO,1,0,0,0,0,1,0
20190201-M-Davis_Cup_Qualifiers-RR-Lukas_Rosol-Robin_Haase,2,F-XC,12,4,2,0,2,6,6
20190201-M-Davis_Cup_Qualifiers-RR-Lukas_Rosol-Robin_Haase,2,F-DTM,26,2,0,1,1,17,9
20190201-M-Davis_Cup_Qualifiers-RR-Lukas_Rosol-Robin_Haase,2,F-DTL,1,1,0,0,1,0,1
20190201-M-Davis_Cup_Qualifiers-RR-Lukas_Rosol-Robin_Haase,2,F-IO,14,3,2,0,1,9,5
20190201-M-Davis_Cup_Qualifiers-RR-Lukas_Rosol-Robin_Haase,2,B-XC,4,1,0,0,1,2,2
20190201-M-Davis_Cup_Qualifiers-RR-Lukas_Rosol-Robin_Haase,2,B-DTM,18,2,0,0,2,9,9
20190201-M-Davis_Cup_Qualifiers-RR-Lukas_Rosol-Robin_Haase,2,B-DTL,5,1,0,0,1,2,3
20190201-M-Davis_Cup_Qualifiers-RR-Lukas_Rosol-Robin_Haase,2,B-IO,2,0,0,0,0,1,1
20190201-M-Davis_Cup_Qualifiers-RR-Lukas_Rosol-Robin_Haase,2,S-XC,19,0,0,0,0,10,9
20190201-M-Davis_Cup_Qualifiers-RR-Lukas_Rosol-Robin_Haase,2,S-DTM,21,2,0,1,1,9,12
20190201-M-Davis_Cup_Qualifiers-RR-Lukas_Rosol-Robin_Haase,2,S-DTL,3,1,0,0,1,1,2
20190201-M-Davis_Cup_Qualifiers-RR-Lukas_Rosol-Robin_Haase,2,S-IO,1,0,0,0,0,0,1
20050701-M-Wimbledon-SF-Andy_Roddick-Thomas_Johansson,1,F-XC,60,14,3,6,5,32,28
20050701-M-Wimbledon-SF-Andy_Roddick-Thomas_Johansson,1,F-DTM,20,1,1,0,0,10,10
20050701-M-Wimbledon-SF-Andy_Roddick-Thomas_Johansson,1,F-DTL,24,9,1,6,2,16,8
20050701-M-Wimbledon-SF-Andy_Roddick-Thomas_Johansson,1,F-IO,42,9,2,3,4,25,17
20050701-M-Wimbledon-SF-Andy_Roddick-Thomas_Johansson,1,F-II,21,10,4,4,2,14,7
20050701-M-Wimbledon-SF-Andy_Roddick-Thomas_Johansson,1,B-XC,31,3,0,2,1,20,11
20050701-M-Wimbledon-SF-Andy_Roddick-Thomas_Johansson,1,B-DTM,13,0,0,0,0,4,9
20050701-M-Wimbledon-SF-Andy_Roddick-Thomas_Johansson,1,B-DTL,12,4,1,1,2,7,5
20050701-M-Wimbledon-SF-Andy_Roddick-Thomas_Johansson,1,B-IO,2,0,0,0,0,0,2
20050701-M-Wimbledon-SF-Andy_Roddick-Thomas_Johansson,1,S-XC,20,2,0,1,1,9,11
20050701-M-Wimbledon-SF-Andy_Roddick-Thomas_Johansson,1,S-DTM,8,1,1,0,0,3,5
20050701-M-Wimbledon-SF-Andy_Roddick-Thomas_Johansson,1,S-DTL,14,2,0,1,1,10,4
20050701-M-Wimbledon-SF-Andy_Roddick-Thomas_Johansson,1,S-IO,2,0,0,0,0,0,2
20050701-M-Wimbledon-SF-Andy_Roddick-Thomas_Johansson,2,F-XC,64,21,7,4,10,32,32
20050701-M-Wimbledon-SF-Andy_Roddick-Thomas_Johansson,2,F-DTM,19,0,0,0,0,10,9
20050701-M-Wimbledon-SF-Andy_Roddick-Thomas_Johansson,2,F-DTL,35,10,3,3,4,18,17
20050701-M-Wimbledon-SF-Andy_Roddick-Thomas_Johansson,2,F-IO,25,7,1,3,3,16,9
20050701-M-Wimbledon-SF-Andy_Roddick-Thomas_Johansson,2,F-II,10,3,1,2,0,4,6
20050701-M-Wimbledon-SF-Andy_Roddick-Thomas_Johansson,2,B-XC,50,12,6,5,1,29,21
20050701-M-Wimbledon-SF-Andy_Roddick-Thomas_Johansson,2,B-DTM,14,2,0,1,1,6,8
20050701-M-Wimbledon-SF-Andy_Roddick-Thomas_Johansson,2,B-DTL,26,13,4,4,5,13,13
20050701-M-Wimbledon-SF-Andy_Roddick-Thomas_Johansson,2,B-IO,8,3,0,1,2,5,3
20050701-M-Wimbledon-SF-Andy_Roddick-Thomas_Johansson,2,B-II,1,1,0,1,0,1,0
20050701-M-Wimbledon-SF-Andy_Roddick-Thomas_Johansson,2,S-XC,26,5,0,2,3,11,15
20050701-M-Wimbledon-SF-Andy_Roddick-Thomas_Johansson,2,S-DTM,2,0,0,0,0,0,2
20050701-M-Wimbledon-SF-Andy_Roddick-Thomas_Johansson,2,S-DTL,2,0,0,0,0,0,2
20190127-M-Rennes_CH-F-Antonie_Hoang-Ricardas_Berankis,1,F-XC,16,5,2,0,3,7,9
20190127-M-Rennes_CH-F-Antonie_Hoang-Ricardas_Berankis,1,F-DTM,16,2,0,0,2,6,10
20190127-M-Rennes_CH-F-Antonie_Hoang-Ricardas_Berankis,1,F-DTL,7,3,1,0,2,2,5
20190127-M-Rennes_CH-F-Antonie_Hoang-Ricardas_Berankis,1,F-IO,13,4,0,2,2,6,7
20190127-M-Rennes_CH-F-Antonie_Hoang-Ricardas_Berankis,1,B-XC,28,8,4,2,2,12,16
20190127-M-Rennes_CH-F-Antonie_Hoang-Ricardas_Berankis,1,B-DTM,11,1,0,0,1,6,5
20190127-M-Rennes_CH-F-Antonie_Hoang-Ricardas_Berankis,1,B-DTL,5,3,0,1,2,2,3
20190127-M-Rennes_CH-F-Antonie_Hoang-Ricardas_Berankis,1,B-IO,9,6,3,1,2,4,5
20190127-M-Rennes_CH-F-Antonie_Hoang-Ricardas_Berankis,1,S-XC,2,0,0,0,0,1,1
20190127-M-Rennes_CH-F-Antonie_Hoang-Ricardas_Berankis,1,S-DTM,2,0,0,0,0,0,2
20190127-M-Rennes_CH-F-Antonie_Hoang-Ricardas_Berankis,2,F-XC,22,5,4,1,0,15,7
20190127-M-Rennes_CH-F-Antonie_Hoang-Ricardas_Berankis,2,F-DTM,10,2,0,1,1,4,6
20190127-M-Rennes_CH-F-Antonie_Hoang-Ricardas_Berankis,2,F-DTL,9,4,1,2,1,5,4
20190127-M-Rennes_CH-F-Antonie_Hoang-Ricardas_Berankis,2,F-IO,12,2,1,1,0,5,7
20190127-M-Rennes_CH-F-Antonie_Hoang-Ricardas_Berankis,2,B-XC,21,2,0,1,1,14,7
20190127-M-Rennes_CH-F-Antonie_Hoang-Ricardas_Berankis,2,B-DTM,12,2,0,0,2,6,6
20190127-M-Rennes_CH-F-Antonie_Hoang-Ricardas_Berankis,2,B-DTL,11,5,4,1,0,10,1
20190127-M-Rennes_CH-F-Antonie_Hoang-Ricardas_Berankis,2,B-IO,3,1,0,1,0,3,0
20190127-M-Rennes_CH-F-Antonie_Hoang-Ricardas_Berankis,2,S-XC,7,0,0,0,0,3,4
20190127-M-Rennes_CH-F-Antonie_Hoang-Ricardas_Berankis,2,S-DTM,5,0,0,0,0,3,2
20190204-M-Cordoba-R32-Cameron_Norrie-Pedro_Cachin,1,F-XC,40,11,2,2,7,14,26
20190204-M-Cordoba-R32-Cameron_Norrie-Pedro_Cachin,1,F-DTM,14,4,0,0,4,2,12
20190204-M-Cordoba-R32-Cameron_Norrie-Pedro_Cachin,1,F-DTL,13,7,3,3,1,9,4
20190204-M-Cordoba-R32-Cameron_Norrie-Pedro_Cachin,1,F-IO,15,7,4,0,3,7,8
20190204-M-Cordoba-R32-Cameron_Norrie-Pedro_Cachin,1,F-II,2,1,0,0,1,0,2
20190204-M-Cordoba-R32-Cameron_Norrie-Pedro_Cachin,1,B-XC,25,3,0,0,3,7,18
20190204-M-Cordoba-R32-Cameron_Norrie-Pedro_Cachin,1,B-DTM,4,0,0,0,0,0,4
20190204-M-Cordoba-R32-Cameron_Norrie-Pedro_Cachin,1,B-DTL,9,2,0,0,2,4,5
20190204-M-Cordoba-R32-Cameron_Norrie-Pedro_Cachin,1,B-IO,2,0,0,0,0,1,1
20190204-M-Cordoba-R32-Cameron_Norrie-Pedro_Cachin,1,S-DTM,3,1,0,0,1,0,3
20190204-M-Cordoba-R32-Cameron_Norrie-Pedro_Cachin,2,F-XC,36,5,1,3,1,26,10
20190204-M-Cordoba-R32-Cameron_Norrie-Pedro_Cachin,2,F-DTM,11,1,0,0,1,8,3
20190204-M-Cordoba-R32-Cameron_Norrie-Pedro_Cachin,2,F-DTL,6,2,1,1,0,5,1
20190204-M-Cordoba-R32-Cameron_Norrie-Pedro_Cachin,2,F-IO,11,4,2,2,0,10,1
20190204-M-Cordoba-R32-Cameron_Norrie-Pedro_Cachin,2,F-II,2,0,0,0,0,2,0
20190204-M-Cordoba-R32-Cameron_Norrie-Pedro_Cachin,2,B-XC,23,6,0,3,3,14,9
20190204-M-Cordoba-R32-Cameron_Norrie-Pedro_Cachin,2,B-DTM,16,2,0,0,2,11,5
20190204-M-Cordoba-R32-Cameron_Norrie-Pedro_Cachin,2,B-DTL,4,2,1,0,1,3,1
20190204-M-Cordoba-R32-Cameron_Norrie-Pedro_Cachin,2,S-XC,3,0,0,0,0,2,1
20190204-M-Cordoba-R32-Cameron_Norrie-Pedro_Cachin,2,S-DTM,1,0,0,0,0,1,0
20190204-M-Cordoba-R32-Cameron_Norrie-Pedro_Cachin,2,S-DTL,3,0,0,0,0,1,2
20060126-M-Australian_Open-SF-David_Nalbandian-Marcos_Baghdatis,1,F-XC,72,27,4,13,10,39,33
20060126-M-Australian_Open-SF-David_Nalbandian-Marcos_Baghdatis,1,F-DTM,25,2,0,0,2,10,15
20060126-M-Australian_Open-SF-David_Nalbandian-Marcos_Baghdatis,1,F-DTL,30,11,3,4,4,16,14
20060126-M-Australian_Open-SF-David_Nalbandian-Marcos_Baghdatis,1,F-IO,41,14,4,5,5,28,13
20060126-M-Australian_Open-SF-David_Nalbandian-Marcos_Baghdatis,1,F-II,4,2,0,1,1,1,3
20060126-M-Australian_Open-SF-David_Nalbandian-Marcos_Baghdatis,1,B-XC,123,15,3,7,5,69,54
20060126-M-Australian_Open-SF-David_Nalbandian-Marcos_Baghdatis,1,B-DTM,25,2,0,0,2,11,14
20060126-M-Australian_Open-SF-David_Nalbandian-Marcos_Baghdatis,1,B-DTL,44,23,8,7,8,24,20
20060126-M-Australian_Open-SF-David_Nalbandian-Marcos_Baghdatis,1,B-IO,8,1,0,1,0,6,2
20060126-M-Australian_Open-SF-David_Nalbandian-Marcos_Baghdatis,1,S-XC,21,0,0,0,0,7,14
20060126-M-Australian_Open-SF-David_Nalbandian-Marcos_Baghdatis,1,S-DTM,3,1,0,0,1,2,1
20060126-M-Australian_Open-SF-David_Nalbandian-Marcos_Baghdatis,1,S-DTL,4,1,0,0,1,1,3
20060126-M-Australian_Open-SF-David_Nalbandian-Marcos_Baghdatis,2,F-XC,56,9,3,3,3,31,25
20060126-M-Australian_Open-SF-David_Nalbandian-Marcos_Baghdatis,2,F-DTM,24,2,0,0,2,8,16
20060126-M-Australian_Open-SF-David_Nalbandian-Marcos_Baghdatis,2,F-DTL,24,5,3,1,1,11,13
20060126-M-Australian_Open-SF-David_Nalbandian-Marcos_Baghdatis,2,F-IO,27,7,4,3,0,14,13
20060126-M-Australian_Open-SF-David_Nalbandian-Marcos_Baghdatis,2,F-II,7,3,0,2,1,5,2
20060126-M-Australian_Open-SF-David_Nalbandian-Marcos_Baghdatis,2,B-XC,120,15,4,5,6,60,60
20060126-M-Australian_Open-SF-David_Nalbandian-Marcos_Baghdatis,2,B-DTM,39,2,0,0,2,14,25
20060126-M-Australian_Open-SF-David_Nalbandian-Marcos_Baghdatis,2,B-DTL,38,19,4,6,9,20,18
20060126-M-Australian_Open-SF-David_Nalbandian-Marcos_Baghdatis,2,B-IO,9,2,1,0,1,7,2
20060126-M-Australian_Open-SF-David_Nalbandian-Marcos_Baghdatis,2,S-XC,10,0,0,0,0,4,6
20060126-M-Australian_Open-SF-David_Nalbandian-Marcos_Baghdatis,2,S-DTM,10,1,0,0,1,4,6
20060126-M-Australian_Open-SF-David_Nalbandian-Marcos_Baghdatis,2,S-DTL,12,1,0,1,0,6,6
20060126-M-Australian_Open-SF-David_Nalbandian-Marcos_Baghdatis,2,S-IO,1,0,0,0,0,0,1
20190114-M-Australian_Open-R128-Mirza_Basic-Henri_Laaksonen,1,F-XC,56,19,6,6,7,29,27
20190114-M-Australian_Open-R128-Mirza_Basic-Henri_Laaksonen,1,F-DTM,22,3,2,1,0,15,7
20190114-M-Australian_Open-R128-Mirza_Basic-Henri_Laaksonen,1,F-DTL,19,7,2,2,3,11,8
20190114-M-Australian_Open-R128-Mirza_Basic-Henri_Laaksonen,1,F-IO,38,11,3,5,3,21,17
20190114-M-Australian_Open-R128-Mirza_Basic-Henri_Laaksonen,1,F-II,8,5,2,2,1,5,3
20190114-M-Australian_Open-R128-Mirza_Basic-Henri_Laaksonen,1,B-XC,44,3,1,0,2,27,17
20190114-M-Australian_Open-R128-Mirza_Basic-Henri_Laaksonen,1,B-DTM,22,2,0,0,2,6,16
20190114-M-Australian_Open-R128-Mirza_Basic-Henri_Laaksonen,1,B-DTL,19,6,1,2,3,11,8
20190114-M-Australian_Open-R128-Mirza_Basic-Henri_Laaksonen,1,B-IO,7,5,0,3,2,5,2
20190114-M-Australian_Open-R128-Mirza_Basic-Henri_Laaksonen,1,S-XC,14,1,0,0,1,6,8
20190114-M-Australian_Open-R128-Mirza_Basic-Henri_Laaksonen,1,S-DTM,10,0,0,0,0,3,7
20190114-M-Australian_Open-R128-Mirza_Basic-Henri_Laaksonen,1,S-DTL,2,2,1,0,1,1,1
20190114-M-Australian_Open-R128-Mirza_Basic-Henri_Laaksonen,2,F-XC,56,22,6,5,11,29,27
20190114-M-Australian_Open-R128-Mirza_Basic-Henri_Laaksonen,2,F-DTM,48,4,1,0,3,21,27
20190114-M-Australian_Open-R128-Mirza_Basic-Henri_Laaksonen,2,F-DTL,20,9,4,1,4,15,5
20190114-M-Australian_Open-R128-Mirza_Basic-Henri_Laaksonen,2,F-IO,37,15,5,5,5,20,17
20190114-M-Australian_Open-R128-Mirza_Basic-Henri_Laaksonen,2,F-II,5,1,1,0,0,4,1
20190114-M-Australian_Open-R128-Mirza_Basic-Henri_Laaksonen,2,B-XC,15,1,1,0,0,11,4
20190114-M-Australian_Open-R128-Mirza_Basic-Henri_Laaksonen,2,B-DTM,24,0,0,0,0,12,12
20190114-M-Australian_Open-R128-Mirza_Basic-Henri_Laaksonen,2,B-DTL,8,7,2,1,4,3,5
20190114-M-Australian_Open-R128-Mirza_Basic-Henri_Laaksonen,2,S-XC,33,3,1,0,2,10,23
20190114-M-Australian_Open-R128-Mirza_Basic-Henri_Laaksonen,2,S-DTM,17,1,0,0,1,9,8
20190114-M-Australian_Open-R128-Mirza_Basic-Henri_Laaksonen,2,S-DTL,8,2,0,0,2,3,5
20190205-M-Montpellier-R32-Hubert_Hurkacz-Ernests_Gulbis,1,F-XC,32,6,3,2,1,19,13
20190205-M-Montpellier-R32-Hubert_Hurkacz-Ernests_Gulbis,1,F-DTM,12,1,0,0,1,4,8
20190205-M-Montpellier-R32-Hubert_Hurkacz-Ernests_Gulbis,1,F-DTL,11,3,0,1,2,6,5
20190205-M-Montpellier-R32-Hubert_Hurkacz-Ernests_Gulbis,1,F-IO,22,9,3,3,3,15,7
20190205-M-Montpellier-R32-Hubert_Hurkacz-Ernests_Gulbis,1,F-II,2,1,0,0,1,0,2
20190205-M-Montpellier-R32-Hubert_Hurkacz-Ernests_Gulbis,1,B-XC,10,5,0,2,3,3,7
20190205-M-Montpellier-R32-Hubert_Hurkacz-Ernests_Gulbis,1,B-DTM,13,1,0,1,0,9,4
20190205-M-Montpellier-R32-Hubert_Hurkacz-Ernests_Gulbis,1,B-DTL,13,7,0,5,2,9,4
20190205-M-Montpellier-R32-Hubert_Hurkacz-Ernests_Gulbis,1,B-IO,4,1,0,0,1,2,2
20190205-M-Montpellier-R32-Hubert_Hurkacz-Ernests_Gulbis,1,S-XC,3,0,0,0,0,2,1
20190205-M-Montpellier-R32-Hubert_Hurkacz-Ernests_Gulbis,1,S-DTM,11,1,0,1,0,5,6
20190205-M-Montpellier-R32-Hubert_Hurkacz-Ernests_Gulbis,1,S-DTL,5,1,0,0,1,3,2
20190205-M-Montpellier-R32-Hubert_Hurkacz-Ernests_Gulbis,2,F-XC,33,10,2,4,4,20,13
20190205-M-Montpellier-R32-Hubert_Hurkacz-Ernests_Gulbis,2,F-DTM,15,1,0,0,1,4,11
20190205-M-Montpellier-R32-Hubert_Hurkacz-Ernests_Gulbis,2,F-DTL,10,4,0,0,4,2,8
20190205-M-Montpellier-R32-Hubert_Hurkacz-Ernests_Gulbis,2,F-IO,12,6,1,2,3,6,6
20190205-M-Montpellier-R32-Hubert_Hurkacz-Ernests_Gulbis,2,B-XC,28,7,2,3,2,13,15
20190205-M-Montpellier-R32-Hubert_Hurkacz-Ernests_Gulbis,2,B-DTM,15,0,0,0,0,6,9
20190205-M-Montpellier-R32-Hubert_Hurkacz-Ernests_Gulbis,2,B-DTL,6,2,1,0,1,3,3
20190205-M-Montpellier-R32-Hubert_Hurkacz-Ernests_Gulbis,2,B-IO,3,2,1,1,0,3,0
20190205-M-Montpellier-R32-Hubert_Hurkacz-Ernests_Gulbis,2,S-XC,5,1,0,1,0,4,1
20190205-M-Montpellier-R32-Hubert_Hurkacz-Ernests_Gulbis,2,S-DTL,1,1,1,0,0,1,0
20190207-M-Sofia-R16-Yannick_Maden-Marton_Fucsovics,1,F-XC,71,17,2,9,6,40,31
20190207-M-Sofia-R16-Yannick_Maden-Marton_Fucsovics,1,F-DTM,67,7,0,1,6,28,39
20190207-M-Sofia-R16-Yannick_Maden-Marton_Fucsovics,1,F-DTL,24,4,0,2,2,12,12
20190207-M-Sofia-R16-Yannick_Maden-Marton_Fucsovics,1,F-IO,36,14,3,4,7,16,20
20190207-M-Sofia-R16-Yannick_Maden-Marton_Fucsovics,1,F-II,2,0,0,0,0,1,1
20190207-M-Sofia-R16-Yannick_Maden-Marton_Fucsovics,1,B-XC,78,6,1,1,4,36,42
20190207-M-Sofia-R16-Yannick_Maden-Marton_Fucsovics,1,B-DTM,70,6,0,1,5,34,36
20190207-M-Sofia-R16-Yannick_Maden-Marton_Fucsovics,1,B-DTL,17,12,6,3,3,13,4
20190207-M-Sofia-R16-Yannick_Maden-Marton_Fucsovics,1,B-IO,10,3,1,0,2,5,5
20190207-M-Sofia-R16-Yannick_Maden-Marton_Fucsovics,1,S-XC,2,1,0,0,1,0,2
20190207-M-Sofia-R16-Yannick_Maden-Marton_Fucsovics,1,S-DTM,2,0,0,0,0,1,1
20190207-M-Sofia-R16-Yannick_Maden-Marton_Fucsovics,1,S-DTL,2,0,0,0,0,1,1
20190207-M-Sofia-R16-Yannick_Maden-Marton_Fucsovics,2,F-XC,82,27,5,8,14,43,39
20190207-M-Sofia-R16-Yannick_Maden-Marton_Fucsovics,2,F-DTM,55,3,0,0,3,23,32
20190207-M-Sofia-R16-Yannick_Maden-Marton_Fucsovics,2,F-DTL,15,5,1,3,1,10,5
20190207-M-Sofia-R16-Yannick_Maden-Marton_Fucsovics,2,F-IO,41,14,6,5,3,28,13
20190207-M-Sofia-R16-Yannick_Maden-Marton_Fucsovics,2,F-II,10,4,0,2,2,5,5
20190207-M-Sofia-R16-Yannick_Maden-Marton_Fucsovics,2,B-XC,45,11,1,4,6,24,21
20190207-M-Sofia-R16-Yannick_Maden-Marton_Fucsovics,2,B-DTM,62,4,0,3,1,34,28
20190207-M-Sofia-R16-Yannick_Maden-Marton_Fucsovics,2,B-DTL,16,7,3,1,3,11,5
20190207-M-Sofia-R16-Yannick_Maden-Marton_Fucsovics,2,B-IO,10,3,0,1,2,3,7
20190207-M-Sofia-R16-Yannick_Maden-Marton_Fucsovics,2,S-XC,23,1,0,0,1,9,14
20190207-M-Sofia-R16-Yannick_Maden-Marton_Fucsovics,2,S-DTM,11,0,0,0,0,2,9
20190207-M-Sofia-R16-Yannick_Maden-Marton_Fucsovics,2,S-DTL,5,0,0,0,0,2,3
20190207-M-Sofia-R16-Yannick_Maden-Marton_Fucsovics,2,S-IO,3,0,0,0,0,3,0
20190206-M-Sofia-R32-Mikhail_Kukushkin-Laslo_Djere,1,F-XC,33,7,0,1,6,14,19
20190206-M-Sofia-R32-Mikhail_Kukushkin-Laslo_Djere,1,F-DTM,26,3,0,0,3,14,12
20190206-M-Sofia-R32-Mikhail_Kukushkin-Laslo_Djere,1,F-DTL,29,6,2,3,1,19,10
20190206-M-Sofia-R32-Mikhail_Kukushkin-Laslo_Djere,1,F-IO,38,9,3,4,2,23,15
20190206-M-Sofia-R32-Mikhail_Kukushkin-Laslo_Djere,1,B-XC,54,6,0,3,3,33,21
20190206-M-Sofia-R32-Mikhail_Kukushkin-Laslo_Djere,1,B-DTM,26,0,0,0,0,16,10
20190206-M-Sofia-R32-Mikhail_Kukushkin-Laslo_Djere,1,B-DTL,23,6,1,2,3,15,8
20190206-M-Sofia-R32-Mikhail_Kukushkin-Laslo_Djere,1,B-IO,4,0,0,0,0,1,3
20190206-M-Sofia-R32-Mikhail_Kukushkin-Laslo_Djere,1,S-XC,7,1,0,0,1,4,3
20190206-M-Sofia-R32-Mikhail_Kukushkin-Laslo_Djere,1,S-DTM,4,0,0,0,0,2,2
20190206-M-Sofia-R32-Mikhail_Kukushkin-Laslo_Djere,1,S-DTL,5,0,0,0,0,3,2
20190206-M-Sofia-R32-Mikhail_Kukushkin-Laslo_Djere,2,F-XC,48,11,3,1,7,23,25
20190206-M-Sofia-R32-Mikhail_Kukushkin-Laslo_Djere,2,F-DTM,22,1,0,0,1,11,11
20190206-M-Sofia-R32-Mikhail_Kukushkin-Laslo_Djere,2,F-DTL,15,4,2,1,1,8,7
20190206-M-Sofia-R32-Mikhail_Kukushkin-Laslo_Djere,2,F-IO,20,5,3,1,1,10,10
20190206-M-Sofia-R32-Mikhail_Kukushkin-Laslo_Djere,2,F-II,4,2,1,1,0,3,1
20190206-M-Sofia-R32-Mikhail_Kukushkin-Laslo_Djere,2,B-XC,58,12,0,1,11,22,36
20190206-M-Sofia-R32-Mikhail_Kukushkin-Laslo_Djere,2,B-DTM,22,2,0,1,1,7,15
20190206-M-Sofia-R32-Mikhail_Kukushkin-Laslo_Djere,2,B-DTL,15,4,2,0,2,10,5
20190206-M-Sofia-R32-Mikhail_Kukushkin-Laslo_Djere,2,B-IO,6,1,0,0,1,2,4
20190206-M-Sofia-R32-Mikhail_Kukushkin-Laslo_Djere,2,S-XC,23,1,0,0,1,10,13
20190206-M-Sofia-R32-Mikhail_Kukushkin-Laslo_Djere,2,S-DTM,17,1,0,0,1,2,15
20190206-M-Sofia-R32-Mikhail_Kukushkin-Laslo_Djere,2,S-DTL,6,0,0,0,0,4,2
20190206-M-Sofia-R32-Mikhail_Kukushkin-Laslo_Djere,2,S-IO,1,0,0,0,0,0,1
20190205-M-Sofia-R32-Gael_Monfils-Viktor_Troicki,1,F-XC,13,8,3,2,3,10,3
20190205-M-Sofia-R32-Gael_Monfils-Viktor_Troicki,1,F-DTM,12,3,0,0,3,4,8
20190205-M-Sofia-R32-Gael_Monfils-Viktor_Troicki,1,F-DTL,4,2,0,1,1,3,1
20190205-M-Sofia-R32-Gael_Monfils-Viktor_Troicki,1,F-IO,7,2,1,1,0,6,1
20190205-M-Sofia-R32-Gael_Monfils-Viktor_Troicki,1,F-II,1,1,0,0,1,0,1
20190205-M-Sofia-R32-Gael_Monfils-Viktor_Troicki,1,B-XC,24,3,1,1,1,17,7
20190205-M-Sofia-R32-Gael_Monfils-Viktor_Troicki,1,B-DTM,14,0,0,0,0,13,1
20190205-M-Sofia-R32-Gael_Monfils-Viktor_Troicki,1,B-DTL,8,5,4,0,1,5,3
20190205-M-Sofia-R32-Gael_Monfils-Viktor_Troicki,1,S-DTM,2,0,0,0,0,0,2
20190205-M-Sofia-R32-Gael_Monfils-Viktor_Troicki,2,F-XC,5,0,0,0,0,3,2
20190205-M-Sofia-R32-Gael_Monfils-Viktor_Troicki,2,F-DTM,6,0,0,0,0,1,5
20190205-M-Sofia-R32-Gael_Monfils-Viktor_Troicki,2,F-DTL,5,3,1,0,2,2,3
20190205-M-Sofia-R32-Gael_Monfils-Viktor_Troicki,2,F-IO,13,7,1,2,4,6,7
20190205-M-Sofia-R32-Gael_Monfils-Viktor_Troicki,2,B-XC,26,5,2,0,3,6,20
20190205-M-Sofia-R32-Gael_Monfils-Viktor_Troicki,2,B-DTM,10,1,0,0,1,2,8
20190205-M-Sofia-R32-Gael_Monfils-Viktor_Troicki,2,B-DTL,3,2,0,0,2,0,3
20190205-M-Sofia-R32-Gael_Monfils-Viktor_Troicki,2,B-IO,5,2,0,0,2,2,3
20180816-M-Gwangju_CH-R16-Akira_Santillan-Karim_Mohamed_Maamoun,1,F-XC,27,9,1,3,5,15,12
20180816-M-Gwangju_CH-R16-Akira_Santillan-Karim_Mohamed_Maamoun,1,F-DTM,14,1,0,0,1,6,8
20180816-M-Gwangju_CH-R16-Akira_Santillan-Karim_Mohamed_Maamoun,1,F-DTL,4,3,2,0,1,2,2
20180816-M-Gwangju_CH-R16-Akira_Santillan-Karim_Mohamed_Maamoun,1,F-IO,13,2,1,0,1,10,3
20180816-M-Gwangju_CH-R16-Akira_Santillan-Karim_Mohamed_Maamoun,1,F-II,1,1,1,0,0,1,0
20180816-M-Gwangju_CH-R16-Akira_Santillan-Karim_Mohamed_Maamoun,1,B-XC,5,3,1,0,2,2,3
20180816-M-Gwangju_CH-R16-Akira_Santillan-Karim_Mohamed_Maamoun,1,B-DTM,7,1,0,0,1,2,5
20180816-M-Gwangju_CH-R16-Akira_Santillan-Karim_Mohamed_Maamoun,1,B-DTL,8,2,2,0,0,7,1
20180816-M-Gwangju_CH-R16-Akira_Santillan-Karim_Mohamed_Maamoun,1,B-IO,2,1,0,0,1,0,2
20180816-M-Gwangju_CH-R16-Akira_Santillan-Karim_Mohamed_Maamoun,1,S-XC,17,3,0,0,3,4,13
20180816-M-Gwangju_CH-R16-Akira_Santillan-Karim_Mohamed_Maamoun,1,S-DTM,11,0,0,0,0,7,4
20180816-M-Gwangju_CH-R16-Akira_Santillan-Karim_Mohamed_Maamoun,1,S-DTL,3,0,0,0,0,2,1
20180816-M-Gwangju_CH-R16-Akira_Santillan-Karim_Mohamed_Maamoun,2,F-XC,22,13,5,0,8,9,13
20180816-M-Gwangju_CH-R16-Akira_Santillan-Karim_Mohamed_Maamoun,2,F-DTM,21,3,0,0,3,9,12
20180816-M-Gwangju_CH-R16-Akira_Santillan-Karim_Mohamed_Maamoun,2,F-DTL,7,5,1,0,4,2,5
20180816-M-Gwangju_CH-R16-Akira_Santillan-Karim_Mohamed_Maamoun,2,F-IO,14,2,2,0,0,10,4
20180816-M-Gwangju_CH-R16-Akira_Santillan-Karim_Mohamed_Maamoun,2,F-II,1,1,0,0,1,0,1
20180816-M-Gwangju_CH-R16-Akira_Santillan-Karim_Mohamed_Maamoun,2,B-XC,21,4,0,1,3,9,12
20180816-M-Gwangju_CH-R16-Akira_Santillan-Karim_Mohamed_Maamoun,2,B-DTM,14,1,0,1,0,8,6
20180816-M-Gwangju_CH-R16-Akira_Santillan-Karim_Mohamed_Maamoun,2,B-DTL,3,1,0,0,1,1,2
20180816-M-Gwangju_CH-R16-Akira_Santillan-Karim_Mohamed_Maamoun,2,B-IO,2,0,0,0,0,2,0
20180816-M-Gwangju_CH-R16-Akira_Santillan-Karim_Mohamed_Maamoun,2,S-XC,5,0,0,0,0,1,4
20180816-M-Gwangju_CH-R16-Akira_Santillan-Karim_Mohamed_Maamoun,2,S-DTM,3,0,0,0,0,1,2
20180816-M-Gwangju_CH-R16-Akira_Santillan-Karim_Mohamed_Maamoun,2,S-DTL,2,2,0,1,1,1,1
20190208-M-Cordoba-QF-Jaume_Munar-Federico_Delbonis,1,F-XC,26,6,0,2,4,12,14
20190208-M-Cordoba-QF-Jaume_Munar-Federico_Delbonis,1,F-DTM,21,3,0,0,3,5,16
20190208-M-Cordoba-QF-Jaume_Munar-Federico_Delbonis,1,F-DTL,8,2,1,1,0,6,2
20190208-M-Cordoba-QF-Jaume_Munar-Federico_Delbonis,1,F-IO,30,12,5,3,4,17,13
20190208-M-Cordoba-QF-Jaume_Munar-Federico_Delbonis,1,F-II,4,0,0,0,0,1,3
20190208-M-Cordoba-QF-Jaume_Munar-Federico_Delbonis,1,B-XC,27,0,0,0,0,18,9
20190208-M-Cordoba-QF-Jaume_Munar-Federico_Delbonis,1,B-DTM,30,2,0,0,2,11,19
20190208-M-Cordoba-QF-Jaume_Munar-Federico_Delbonis,1,B-DTL,13,3,1,1,1,6,7
20190208-M-Cordoba-QF-Jaume_Munar-Federico_Delbonis,1,B-IO,5,0,0,0,0,1,4
20190208-M-Cordoba-QF-Jaume_Munar-Federico_Delbonis,1,S-XC,2,0,0,0,0,0,2
20190208-M-Cordoba-QF-Jaume_Munar-Federico_Delbonis,1,S-DTM,4,0,0,0,0,2,2
20190208-M-Cordoba-QF-Jaume_Munar-Federico_Delbonis,1,S-DTL,1,0,0,0,0,1,0
20190208-M-Cordoba-QF-Jaume_Munar-Federico_Delbonis,2,F-XC,70,11,4,6,1,43,27
20190208-M-Cordoba-QF-Jaume_Munar-Federico_Delbonis,2,F-DTM,19,2,0,0,2,11,8
20190208-M-Cordoba-QF-Jaume_Munar-Federico_Delbonis,2,F-DTL,9,3,0,0,3,3,6
20190208-M-Cordoba-QF-Jaume_Munar-Federico_Delbonis,2,F-IO,30,15,8,4,3,20,10
20190208-M-Cordoba-QF-Jaume_Munar-Federico_Delbonis,2,F-II,9,3,0,2,1,4,5
20190208-M-Cordoba-QF-Jaume_Munar-Federico_Delbonis,2,B-XC,26,11,3,3,5,14,12
20190208-M-Cordoba-QF-Jaume_Munar-Federico_Delbonis,2,B-DTM,21,2,1,0,1,11,10
20190208-M-Cordoba-QF-Jaume_Munar-Federico_Delbonis,2,B-DTL,4,1,0,0,1,3,1
20190208-M-Cordoba-QF-Jaume_Munar-Federico_Delbonis,2,B-IO,2,1,0,0,1,1,1
20190208-M-Cordoba-QF-Jaume_Munar-Federico_Delbonis,2,S-DTL,4,0,0,0,0,3,1
20190208-M-Cordoba-QF-Jaume_Munar-Federico_Delbonis,2,S-IO,2,0,0,0,0,0,2
20190202-M-Davis_Cup_Qualifiers-RR-Felix_Auger_Aliassime-Norbert_Gombos,1,F-XC,26,11,2,5,4,14,12
20190202-M-Davis_Cup_Qualifiers-RR-Felix_Auger_Aliassime-Norbert_Gombos,1,F-DTM,20,2,0,0,2,5,15
20190202-M-Davis_Cup_Qualifiers-RR-Felix_Auger_Aliassime-Norbert_Gombos,1,F-DTL,3,1,1,0,0,2,1
20190202-M-Davis_Cup_Qualifiers-RR-Felix_Auger_Aliassime-Norbert_Gombos,1,F-IO,20,11,4,4,3,13,7
20190202-M-Davis_Cup_Qualifiers-RR-Felix_Auger_Aliassime-Norbert_Gombos,1,F-II,3,1,0,1,0,3,0
20190202-M-Davis_Cup_Qualifiers-RR-Felix_Auger_Aliassime-Norbert_Gombos,1,B-XC,40,4,1,1,2,17,23
20190202-M-Davis_Cup_Qualifiers-RR-Felix_Auger_Aliassime-Norbert_Gombos,1,B-DTM,14,1,0,0,1,9,5
20190202-M-Davis_Cup_Qualifiers-RR-Felix_Auger_Aliassime-Norbert_Gombos,1,B-DTL,15,4,1,1,2,6,9
20190202-M-Davis_Cup_Qualifiers-RR-Felix_Auger_Aliassime-Norbert_Gombos,1,B-IO,2,1,0,0,1,1,1
20190202-M-Davis_Cup_Qualifiers-RR-Felix_Auger_Aliassime-Norbert_Gombos,1,S-XC,1,0,0,0,0,1,0
20190202-M-Davis_Cup_Qualifiers-RR-Felix_Auger_Aliassime-Norbert_Gombos,1,S-DTM,3,0,0,0,0,0,3
20190202-M-Davis_Cup_Qualifiers-RR-Felix_Auger_Aliassime-Norbert_Gombos,1,S-DTL,3,0,0,0,0,3,0
20190202-M-Davis_Cup_Qualifiers-RR-Felix_Auger_Aliassime-Norbert_Gombos,2,F-XC,25,11,4,3,4,14,11
20190202-M-Davis_Cup_Qualifiers-RR-Felix_Auger_Aliassime-Norbert_Gombos,2,F-DTM,18,1,0,0,1,10,8
20190202-M-Davis_Cup_Qualifiers-RR-Felix_Auger_Aliassime-Norbert_Gombos,2,F-DTL,12,3,1,1,1,7,5
20190202-M-Davis_Cup_Qualifiers-RR-Felix_Auger_Aliassime-Norbert_Gombos,2,F-IO,11,5,1,1,3,8,3
20190202-M-Davis_Cup_Qualifiers-RR-Felix_Auger_Aliassime-Norbert_Gombos,2,F-II,1,0,0,0,0,0,1
20190202-M-Davis_Cup_Qualifiers-RR-Felix_Auger_Aliassime-Norbert_Gombos,2,B-XC,45,2,0,1,1,24,21
20190202-M-Davis_Cup_Qualifiers-RR-Felix_Auger_Aliassime-Norbert_Gombos,2,B-DTM,19,4,0,0,4,10,9
20190202-M-Davis_Cup_Qualifiers-RR-Felix_Auger_Aliassime-Norbert_Gombos,2,B-DTL,3,1,1,0,0,3,0
20190202-M-Davis_Cup_Qualifiers-RR-Felix_Auger_Aliassime-Norbert_Gombos,2,B-IO,2,1,1,0,0,2,0
20190202-M-Davis_Cup_Qualifiers-RR-Felix_Auger_Aliassime-Norbert_Gombos,2,S-XC,3,0,0,0,0,1,2
20190202-M-Davis_Cup_Qualifiers-RR-Felix_Auger_Aliassime-Norbert_Gombos,2,S-DTM,3,0,0,0,0,1,2
20190208-M-Sofia-QF-Fernando_Verdasco-Matteo_Berrettini,1,F-XC,68,13,0,6,7,33,35
20190208-M-Sofia-QF-Fernando_Verdasco-Matteo_Berrettini,1,F-DTM,30,7,0,0,7,9,21
20190208-M-Sofia-QF-Fernando_Verdasco-Matteo_Berrettini,1,F-DTL,10,8,4,1,3,6,4
20190208-M-Sofia-QF-Fernando_Verdasco-Matteo_Berrettini,1,F-IO,31,15,5,4,6,22,9
20190208-M-Sofia-QF-Fernando_Verdasco-Matteo_Berrettini,1,F-II,2,1,0,0,1,0,2
20190208-M-Sofia-QF-Fernando_Verdasco-Matteo_Berrettini,1,B-XC,32,10,1,3,6,14,18
20190208-M-Sofia-QF-Fernando_Verdasco-Matteo_Berrettini,1,B-DTM,20,4,0,1,3,10,10
20190208-M-Sofia-QF-Fernando_Verdasco-Matteo_Berrettini,1,B-DTL,14,3,1,0,2,4,10
20190208-M-Sofia-QF-Fernando_Verdasco-Matteo_Berrettini,1,B-IO,1,0,0,0,0,0,1
20190208-M-Sofia-QF-Fernando_Verdasco-Matteo_Berrettini,1,B-II,1,1,0,0,1,0,1
20190208-M-Sofia-QF-Fernando_Verdasco-Matteo_Berrettini,1,S-XC,2,0,0,0,0,1,1
20190208-M-Sofia-QF-Fernando_Verdasco-Matteo_Berrettini,1,S-DTM,2,1,0,0,1,0,2
20190208-M-Sofia-QF-Fernando_Verdasco-Matteo_Berrettini,1,S-DTL,4,0,0,0,0,0,4
20190208-M-Sofia-QF-Fernando_Verdasco-Matteo_Berrettini,2,F-XC,56,4,0,0,4,28,28
20190208-M-Sofia-QF-Fernando_Verdasco-Matteo_Berrettini,2,F-DTM,24,4,0,2,2,12,12
20190208-M-Sofia-QF-Fernando_Verdasco-Matteo_Berrettini,2,F-DTL,8,4,2,2,0,6,2
20190208-M-Sofia-QF-Fernando_Verdasco-Matteo_Berrettini,2,F-IO,24,14,7,2,5,15,9
20190208-M-Sofia-QF-Fernando_Verdasco-Matteo_Berrettini,2,F-II,3,1,0,0,1,0,3
20190208-M-Sofia-QF-Fernando_Verdasco-Matteo_Berrettini,2,B-XC,22,5,0,3,1,15,7
20190208-M-Sofia-QF-Fernando_Verdasco-Matteo_Berrettini,2,B-DTM,34,4,0,0,4,18,16
20190208-M-Sofia-QF-Fernando_Verdasco-Matteo_Berrettini,2,B-DTL,4,4,1,1,2,2,2
20190208-M-Sofia-QF-Fernando_Verdasco-Matteo_Berrettini,2,B-IO,1,0,0,0,0,0,1
20190208-M-Sofia-QF-Fernando_Verdasco-Matteo_Berrettini,2,S-XC,8,1,0,0,1,3,5
20190208-M-Sofia-QF-Fernando_Verdasco-Matteo_Berrettini,2,S-DTM,12,0,0,0,0,8,4
20190208-M-Sofia-QF-Fernando_Verdasco-Matteo_Berrettini,2,S-DTL,6,0,0,0,0,4,2
20030701-M-Wimbledon-SF-Mark_Philippoussis-Sebastien_Grosjean,1,F-XC,11,4,0,1,3,3,8
20030701-M-Wimbledon-SF-Mark_Philippoussis-Sebastien_Grosjean,1,F-DTM,4,0,0,0,0,0,4
20030701-M-Wimbledon-SF-Mark_Philippoussis-Sebastien_Grosjean,1,F-DTL,7,1,0,1,0,3,4
20030701-M-Wimbledon-SF-Mark_Philippoussis-Sebastien_Grosjean,1,F-IO,4,2,0,1,1,1,3
20030701-M-Wimbledon-SF-Mark_Philippoussis-Sebastien_Grosjean,1,F-II,4,2,1,0,1,2,2
20030701-M-Wimbledon-SF-Mark_Philippoussis-Sebastien_Grosjean,1,B-XC,23,3,0,2,1,8,15
20030701-M-Wimbledon-SF-Mark_Philippoussis-Sebastien_Grosjean,1,B-DTM,3,1,0,0,1,1,2
20030701-M-Wimbledon-SF-Mark_Philippoussis-Sebastien_Grosjean,1,B-DTL,7,3,1,0,2,2,5
20030701-M-Wimbledon-SF-Mark_Philippoussis-Sebastien_Grosjean,1,S-XC,8,0,0,0,0,3,5
20030701-M-Wimbledon-SF-Mark_Philippoussis-Sebastien_Grosjean,1,S-DTM,4,0,0,0,0,1,3
20030701-M-Wimbledon-SF-Mark_Philippoussis-Sebastien_Grosjean,1,S-DTL,4,0,0,0,0,2,2
20030701-M-Wimbledon-SF-Mark_Philippoussis-Sebastien_Grosjean,2,F-XC,20,7,3,3,1,14,6
20030701-M-Wimbledon-SF-Mark_Philippoussis-Sebastien_Grosjean,2,F-DTM,4,1,0,0,1,3,1
20030701-M-Wimbledon-SF-Mark_Philippoussis-Sebastien_Grosjean,2,F-DTL,11,4,3,0,1,6,5
20030701-M-Wimbledon-SF-Mark_Philippoussis-Sebastien_Grosjean,2,F-IO,27,5,2,2,1,17,10
20030701-M-Wimbledon-SF-Mark_Philippoussis-Sebastien_Grosjean,2,F-II,10,5,1,2,2,6,4
20030701-M-Wimbledon-SF-Mark_Philippoussis-Sebastien_Grosjean,2,B-XC,22,3,0,2,1,14,8
20030701-M-Wimbledon-SF-Mark_Philippoussis-Sebastien_Grosjean,2,B-DTM,9,0,0,0,0,8,1
20030701-M-Wimbledon-SF-Mark_Philippoussis-Sebastien_Grosjean,2,B-DTL,2,1,0,0,1,1,1
20030701-M-Wimbledon-SF-Mark_Philippoussis-Sebastien_Grosjean,2,B-IO,2,1,1,0,0,1,1
20030701-M-Wimbledon-SF-Mark_Philippoussis-Sebastien_Grosjean,2,S-XC,7,2,0,1,1,3,4
20030701-M-Wimbledon-SF-Mark_Philippoussis-Sebastien_Grosjean,2,S-DTL,1,0,0,0,0,1,0
20181017-M-Moscow-R16-Lukas_Rosol-Karen_Khachanov,1,F-XC,20,6,4,0,2,15,5
20181017-M-Moscow-R16-Lukas_Rosol-Karen_Khachanov,1,F-DTM,27,2,0,0,2,13,14
20181017-M-Moscow-R16-Lukas_Rosol-Karen_Khachanov,1,F-DTL,2,2,1,0,1,1,1
20181017-M-Moscow-R16-Lukas_Rosol-Karen_Khachanov,1,F-IO,16,3,1,1,1,13,3
20181017-M-Moscow-R16-Lukas_Rosol-Karen_Khachanov,1,B-XC,29,8,1,0,7,13,16
20181017-M-Moscow-R16-Lukas_Rosol-Karen_Khachanov,1,B-DTM,24,5,0,0,5,13,11
20181017-M-Moscow-R16-Lukas_Rosol-Karen_Khachanov,1,B-DTL,5,2,0,0,2,1,4
20181017-M-Moscow-R16-Lukas_Rosol-Karen_Khachanov,1,B-IO,2,1,0,0,1,1,1
20181017-M-Moscow-R16-Lukas_Rosol-Karen_Khachanov,1,S-XC,9,0,0,0,0,8,1
20181017-M-Moscow-R16-Lukas_Rosol-Karen_Khachanov,1,S-DTM,11,2,0,0,2,2,9
20181017-M-Moscow-R16-Lukas_Rosol-Karen_Khachanov,1,S-DTL,2,0,0,0,0,1,1
20181017-M-Moscow-R16-Lukas_Rosol-Karen_Khachanov,2,F-XC,16,5,5,0,0,10,6
20181017-M-Moscow-R16-Lukas_Rosol-Karen_Khachanov,2,F-DTM,32,8,2,0,6,10,22
20181017-M-Moscow-R16-Lukas_Rosol-Karen_Khachanov,2,F-DTL,4,3,3,0,0,4,0
20181017-M-Moscow-R16-Lukas_Rosol-Karen_Khachanov,2,F-IO,24,10,4,2,4,14,10
20181017-M-Moscow-R16-Lukas_Rosol-Karen_Khachanov,2,F-II,1,1,0,0,1,0,1
20181017-M-Moscow-R16-Lukas_Rosol-Karen_Khachanov,2,B-XC,29,8,1,1,6,14,15
20181017-M-Moscow-R16-Lukas_Rosol-Karen_Khachanov,2,B-DTM,33,7,0,0,7,8,25
20181017-M-Moscow-R16-Lukas_Rosol-Karen_Khachanov,2,B-DTL,5,3,0,0,3,0,5
20181017-M-Moscow-R16-Lukas_Rosol-Karen_Khachanov,2,B-IO,3,3,3,0,0,3,0
20181017-M-Moscow-R16-Lukas_Rosol-Karen_Khachanov,2,S-XC,2,1,0,0,1,1,1
20181017-M-Moscow-R16-Lukas_Rosol-Karen_Khachanov,2,S-DTM,6,0,0,0,0,1,5
20181017-M-Moscow-R16-Lukas_Rosol-Karen_Khachanov,2,S-DTL,1,0,0,0,0,1,0
20190208-M-Cordoba-QF-Pedro_Cachin-Juan_Ignacio_Londero,1,F-XC,33,6,6,0,0,20,13
20190208-M-Cordoba-QF-Pedro_Cachin-Juan_Ignacio_Londero,1,F-DTM,20,2,0,0,2,7,13
20190208-M-Cordoba-QF-Pedro_Cachin-Juan_Ignacio_Londero,1,F-DTL,6,3,0,0,3,2,4
20190208-M-Cordoba-QF-Pedro_Cachin-Juan_Ignacio_Londero,1,F-IO,18,7,4,0,3,9,9
20190208-M-Cordoba-QF-Pedro_Cachin-Juan_Ignacio_Londero,1,F-II,1,0,0,0,0,1,0
20190208-M-Cordoba-QF-Pedro_Cachin-Juan_Ignacio_Londero,1,B-XC,49,16,2,1,13,21,28
20190208-M-Cordoba-QF-Pedro_Cachin-Juan_Ignacio_Londero,1,B-DTM,18,3,0,0,3,5,13
20190208-M-Cordoba-QF-Pedro_Cachin-Juan_Ignacio_Londero,1,B-DTL,5,3,1,2,0,4,1
20190208-M-Cordoba-QF-Pedro_Cachin-Juan_Ignacio_Londero,1,B-IO,2,2,2,0,0,2,0
20190208-M-Cordoba-QF-Pedro_Cachin-Juan_Ignacio_Londero,1,S-XC,8,3,0,2,1,3,5
20190208-M-Cordoba-QF-Pedro_Cachin-Juan_Ignacio_Londero,1,S-DTM,3,0,0,0,0,1,2
20190208-M-Cordoba-QF-Pedro_Cachin-Juan_Ignacio_Londero,2,F-XC,34,7,2,3,2,22,12
20190208-M-Cordoba-QF-Pedro_Cachin-Juan_Ignacio_Londero,2,F-DTM,19,2,0,1,1,10,9
20190208-M-Cordoba-QF-Pedro_Cachin-Juan_Ignacio_Londero,2,F-DTL,11,1,1,0,0,5,6
20190208-M-Cordoba-QF-Pedro_Cachin-Juan_Ignacio_Londero,2,F-IO,51,16,5,3,8,31,20
20190208-M-Cordoba-QF-Pedro_Cachin-Juan_Ignacio_Londero,2,F-II,7,5,2,3,0,6,1
20190208-M-Cordoba-QF-Pedro_Cachin-Juan_Ignacio_Londero,2,B-XC,21,2,1,0,1,8,13
20190208-M-Cordoba-QF-Pedro_Cachin-Juan_Ignacio_Londero,2,B-DTM,8,2,0,0,2,2,6
20190208-M-Cordoba-QF-Pedro_Cachin-Juan_Ignacio_Londero,2,B-DTL,6,3,0,2,1,3,3
20190208-M-Cordoba-QF-Pedro_Cachin-Juan_Ignacio_Londero,2,S-XC,1,0,0,0,0,1,0
20190208-M-Cordoba-QF-Pedro_Cachin-Juan_Ignacio_Londero,2,S-DTM,1,0,0,0,0,0,1
20190208-M-Cordoba-QF-Pedro_Cachin-Juan_Ignacio_Londero,2,S-DTL,1,0,0,0,0,1,0
20190206-M-Cordoba-R16-Juan_Ignacio_Londero-Lorenzo_Sonego,1,F-XC,32,10,1,7,2,18,14
20190206-M-Cordoba-R16-Juan_Ignacio_Londero-Lorenzo_Sonego,1,F-DTM,10,1,0,0,1,4,6
20190206-M-Cordoba-R16-Juan_Ignacio_Londero-Lorenzo_Sonego,1,F-DTL,19,3,0,3,0,13,6
20190206-M-Cordoba-R16-Juan_Ignacio_Londero-Lorenzo_Sonego,1,F-IO,51,21,8,7,6,33,18
20190206-M-Cordoba-R16-Juan_Ignacio_Londero-Lorenzo_Sonego,1,F-II,8,6,0,4,2,6,2
20190206-M-Cordoba-R16-Juan_Ignacio_Londero-Lorenzo_Sonego,1,B-XC,30,5,0,1,4,16,14
20190206-M-Cordoba-R16-Juan_Ignacio_Londero-Lorenzo_Sonego,1,B-DTM,7,1,0,0,1,3,4
20190206-M-Cordoba-R16-Juan_Ignacio_Londero-Lorenzo_Sonego,1,B-DTL,7,5,1,1,3,3,4
20190206-M-Cordoba-R16-Juan_Ignacio_Londero-Lorenzo_Sonego,1,B-IO,1,0,0,0,0,0,1
20190206-M-Cordoba-R16-Juan_Ignacio_Londero-Lorenzo_Sonego,1,S-XC,3,0,0,0,0,2,1
20190206-M-Cordoba-R16-Juan_Ignacio_Londero-Lorenzo_Sonego,1,S-DTM,3,0,0,0,0,2,1
20190206-M-Cordoba-R16-Juan_Ignacio_Londero-Lorenzo_Sonego,1,S-DTL,2,0,0,0,0,0,2
20190206-M-Cordoba-R16-Juan_Ignacio_Londero-Lorenzo_Sonego,2,F-XC,32,11,7,3,1,20,12
20190206-M-Cordoba-R16-Juan_Ignacio_Londero-Lorenzo_Sonego,2,F-DTM,15,0,0,0,0,7,8
20190206-M-Cordoba-R16-Juan_Ignacio_Londero-Lorenzo_Sonego,2,F-DTL,3,1,1,0,0,3,0
20190206-M-Cordoba-R16-Juan_Ignacio_Londero-Lorenzo_Sonego,2,F-IO,19,5,1,1,3,8,11
20190206-M-Cordoba-R16-Juan_Ignacio_Londero-Lorenzo_Sonego,2,F-II,5,1,0,1,0,4,1
20190206-M-Cordoba-R16-Juan_Ignacio_Londero-Lorenzo_Sonego,2,B-XC,27,5,0,1,4,12,15
20190206-M-Cordoba-R16-Juan_Ignacio_Londero-Lorenzo_Sonego,2,B-DTM,18,3,0,0,3,5,13
20190206-M-Cordoba-R16-Juan_Ignacio_Londero-Lorenzo_Sonego,2,B-DTL,3,2,0,0,2,1,2
20190206-M-Cordoba-R16-Juan_Ignacio_Londero-Lorenzo_Sonego,2,B-IO,1,0,0,0,0,0,1
20190206-M-Cordoba-R16-Juan_Ignacio_Londero-Lorenzo_Sonego,2,S-XC,6,0,0,0,0,0,6
20190206-M-Cordoba-R16-Juan_Ignacio_Londero-Lorenzo_Sonego,2,S-DTM,5,0,0,0,0,3,2
20190206-M-Cordoba-R16-Juan_Ignacio_Londero-Lorenzo_Sonego,2,S-DTL,2,0,0,0,0,0,2
20190209-M-Montpellier-SF-Jo_Wilfried_Tsonga-Radu_Albot,1,F-XC,22,7,3,3,1,13,9
20190209-M-Montpellier-SF-Jo_Wilfried_Tsonga-Radu_Albot,1,F-DTM,11,1,0,0,1,4,7
20190209-M-Montpellier-SF-Jo_Wilfried_Tsonga-Radu_Albot,1,F-DTL,7,3,2,1,0,7,0
20190209-M-Montpellier-SF-Jo_Wilfried_Tsonga-Radu_Albot,1,F-IO,20,7,1,4,2,15,5
20190209-M-Montpellier-SF-Jo_Wilfried_Tsonga-Radu_Albot,1,F-II,11,6,1,1,4,6,5
20190209-M-Montpellier-SF-Jo_Wilfried_Tsonga-Radu_Albot,1,B-XC,15,1,0,0,1,12,3
20190209-M-Montpellier-SF-Jo_Wilfried_Tsonga-Radu_Albot,1,B-DTM,8,0,0,0,0,5,3
20190209-M-Montpellier-SF-Jo_Wilfried_Tsonga-Radu_Albot,1,B-DTL,8,3,0,1,2,6,2
20190209-M-Montpellier-SF-Jo_Wilfried_Tsonga-Radu_Albot,1,S-XC,9,1,0,0,1,5,4
20190209-M-Montpellier-SF-Jo_Wilfried_Tsonga-Radu_Albot,1,S-DTM,1,0,0,0,0,1,0
20190209-M-Montpellier-SF-Jo_Wilfried_Tsonga-Radu_Albot,1,S-DTL,1,0,0,0,0,1,0
20190209-M-Montpellier-SF-Jo_Wilfried_Tsonga-Radu_Albot,2,F-XC,21,3,0,2,1,10,11
20190209-M-Montpellier-SF-Jo_Wilfried_Tsonga-Radu_Albot,2,F-DTM,14,0,0,0,0,4,10
20190209-M-Montpellier-SF-Jo_Wilfried_Tsonga-Radu_Albot,2,F-DTL,8,1,0,1,0,3,5
20190209-M-Montpellier-SF-Jo_Wilfried_Tsonga-Radu_Albot,2,F-IO,22,2,0,1,1,12,10
20190209-M-Montpellier-SF-Jo_Wilfried_Tsonga-Radu_Albot,2,F-II,5,3,1,1,1,3,2
20190209-M-Montpellier-SF-Jo_Wilfried_Tsonga-Radu_Albot,2,B-XC,27,5,1,0,4,5,22
20190209-M-Montpellier-SF-Jo_Wilfried_Tsonga-Radu_Albot,2,B-DTM,7,0,0,0,0,2,5
20190209-M-Montpellier-SF-Jo_Wilfried_Tsonga-Radu_Albot,2,B-DTL,2,1,0,0,1,0,2
20190209-M-Montpellier-SF-Jo_Wilfried_Tsonga-Radu_Albot,2,S-XC,2,0,0,0,0,0,2
20190209-M-Montpellier-SF-Jo_Wilfried_Tsonga-Radu_Albot,2,S-DTL,1,1,0,0,1,0,1
20190205-M-Cordoba-R32-Jaume_Munar-Guido_Andreozzi,1,F-XC,29,9,1,6,2,18,11
20190205-M-Cordoba-R32-Jaume_Munar-Guido_Andreozzi,1,F-DTM,32,0,0,0,0,24,8
20190205-M-Cordoba-R32-Jaume_Munar-Guido_Andreozzi,1,F-DTL,8,2,0,1,1,5,3
20190205-M-Cordoba-R32-Jaume_Munar-Guido_Andreozzi,1,F-IO,18,3,1,0,2,12,6
20190205-M-Cordoba-R32-Jaume_Munar-Guido_Andreozzi,1,B-XC,44,5,2,1,2,28,16
20190205-M-Cordoba-R32-Jaume_Munar-Guido_Andreozzi,1,B-DTM,41,1,0,0,1,21,20
20190205-M-Cordoba-R32-Jaume_Munar-Guido_Andreozzi,1,B-DTL,13,6,3,0,3,7,6
20190205-M-Cordoba-R32-Jaume_Munar-Guido_Andreozzi,1,B-IO,1,0,0,0,0,1,0
20190205-M-Cordoba-R32-Jaume_Munar-Guido_Andreozzi,1,S-XC,10,2,1,0,1,9,1
20190205-M-Cordoba-R32-Jaume_Munar-Guido_Andreozzi,1,S-DTM,7,0,0,0,0,2,5
20190205-M-Cordoba-R32-Jaume_Munar-Guido_Andreozzi,2,F-XC,36,10,6,0,4,19,17
20190205-M-Cordoba-R32-Jaume_Munar-Guido_Andreozzi,2,F-DTM,32,2,0,0,2,10,22
20190205-M-Cordoba-R32-Jaume_Munar-Guido_Andreozzi,2,F-DTL,12,6,1,3,2,7,5
20190205-M-Cordoba-R32-Jaume_Munar-Guido_Andreozzi,2,F-IO,62,11,1,2,8,22,40
20190205-M-Cordoba-R32-Jaume_Munar-Guido_Andreozzi,2,F-II,5,2,1,0,1,2,3
20190205-M-Cordoba-R32-Jaume_Munar-Guido_Andreozzi,2,B-XC,30,4,0,0,4,9,21
20190205-M-Cordoba-R32-Jaume_Munar-Guido_Andreozzi,2,B-DTM,29,4,0,0,4,10,19
20190205-M-Cordoba-R32-Jaume_Munar-Guido_Andreozzi,2,B-DTL,1,1,0,0,1,0,1
20190205-M-Cordoba-R32-Jaume_Munar-Guido_Andreozzi,2,B-IO,1,1,1,0,0,1,0
20190205-M-Cordoba-R32-Jaume_Munar-Guido_Andreozzi,2,S-XC,5,0,0,0,0,0,5
20190205-M-Cordoba-R32-Jaume_Munar-Guido_Andreozzi,2,S-DTM,5,0,0,0,0,2,3
20190205-M-Cordoba-R32-Jaume_Munar-Guido_Andreozzi,2,S-DTL,2,0,0,0,0,1,1
20190205-M-Cordoba-R32-Jaume_Munar-Guido_Andreozzi,2,S-IO,1,0,0,0,0,1,0
20190208-M-Dallas_CH-QF-Reilly_Opelka-Dominik_Koepfer,1,F-XC,74,13,3,3,7,30,44
20190208-M-Dallas_CH-QF-Reilly_Opelka-Dominik_Koepfer,1,F-DTM,48,8,0,1,7,14,34
20190208-M-Dallas_CH-QF-Reilly_Opelka-Dominik_Koepfer,1,F-DTL,13,4,1,0,3,6,7
20190208-M-Dallas_CH-QF-Reilly_Opelka-Dominik_Koepfer,1,F-IO,49,28,7,7,14,25,24
20190208-M-Dallas_CH-QF-Reilly_Opelka-Dominik_Koepfer,1,B-XC,23,11,3,3,5,11,12
20190208-M-Dallas_CH-QF-Reilly_Opelka-Dominik_Koepfer,1,B-DTM,22,6,0,1,5,8,14
20190208-M-Dallas_CH-QF-Reilly_Opelka-Dominik_Koepfer,1,B-DTL,1,1,0,0,1,0,1
20190208-M-Dallas_CH-QF-Reilly_Opelka-Dominik_Koepfer,1,B-IO,2,1,1,0,0,1,1
20190208-M-Dallas_CH-QF-Reilly_Opelka-Dominik_Koepfer,1,S-XC,1,0,0,0,0,0,1
20190208-M-Dallas_CH-QF-Reilly_Opelka-Dominik_Koepfer,1,S-DTM,10,0,0,0,0,3,7
20190208-M-Dallas_CH-QF-Reilly_Opelka-Dominik_Koepfer,1,S-IO,3,0,0,0,0,0,3
20190208-M-Dallas_CH-QF-Reilly_Opelka-Dominik_Koepfer,2,F-XC,33,10,2,5,3,21,12
20190208-M-Dallas_CH-QF-Reilly_Opelka-Dominik_Koepfer,2,F-DTM,58,5,0,2,3,32,26
20190208-M-Dallas_CH-QF-Reilly_Opelka-Dominik_Koepfer,2,F-DTL,6,2,1,0,1,5,1
20190208-M-Dallas_CH-QF-Reilly_Opelka-Dominik_Koepfer,2,F-IO,25,9,4,0,5,12,13
20190208-M-Dallas_CH-QF-Reilly_Opelka-Dominik_Koepfer,2,F-II,1,0,0,0,0,1,0
20190208-M-Dallas_CH-QF-Reilly_Opelka-Dominik_Koepfer,2,B-XC,38,9,0,5,4,25,13
20190208-M-Dallas_CH-QF-Reilly_Opelka-Dominik_Koepfer,2,B-DTM,66,9,0,3,6,38,28
20190208-M-Dallas_CH-QF-Reilly_Opelka-Dominik_Koepfer,2,B-DTL,4,3,1,0,2,2,2
20190208-M-Dallas_CH-QF-Reilly_Opelka-Dominik_Koepfer,2,B-IO,4,1,0,0,1,3,1
20190208-M-Dallas_CH-QF-Reilly_Opelka-Dominik_Koepfer,2,S-XC,5,1,0,0,1,3,2
20190208-M-Dallas_CH-QF-Reilly_Opelka-Dominik_Koepfer,2,S-DTM,8,0,0,0,0,5,3
20190208-M-Montpellier-QF-Denis_Shapovalov-Pierre_Hugues_Herbert,1,F-XC,37,9,1,4,4,18,19
20190208-M-Montpellier-QF-Denis_Shapovalov-Pierre_Hugues_Herbert,1,F-DTM,29,7,1,1,4,10,19
20190208-M-Montpellier-QF-Denis_Shapovalov-Pierre_Hugues_Herbert,1,F-DTL,5,4,2,0,2,3,2
20190208-M-Montpellier-QF-Denis_Shapovalov-Pierre_Hugues_Herbert,1,F-IO,14,8,3,1,4,6,8
20190208-M-Montpellier-QF-Denis_Shapovalov-Pierre_Hugues_Herbert,1,B-XC,25,11,1,3,7,9,16
20190208-M-Montpellier-QF-Denis_Shapovalov-Pierre_Hugues_Herbert,1,B-DTM,14,1,0,0,1,4,10
20190208-M-Montpellier-QF-Denis_Shapovalov-Pierre_Hugues_Herbert,1,B-DTL,7,3,1,0,2,2,5
20190208-M-Montpellier-QF-Denis_Shapovalov-Pierre_Hugues_Herbert,1,B-IO,3,0,0,0,0,2,1
20190208-M-Montpellier-QF-Denis_Shapovalov-Pierre_Hugues_Herbert,1,S-DTM,1,0,0,0,0,0,1
20190208-M-Montpellier-QF-Denis_Shapovalov-Pierre_Hugues_Herbert,1,S-DTL,2,0,0,0,0,1,1
20190208-M-Montpellier-QF-Denis_Shapovalov-Pierre_Hugues_Herbert,2,F-XC,29,10,5,2,3,24,5
20190208-M-Montpellier-QF-Denis_Shapovalov-Pierre_Hugues_Herbert,2,F-DTM,19,5,0,0,5,7,12
20190208-M-Montpellier-QF-Denis_Shapovalov-Pierre_Hugues_Herbert,2,F-DTL,2,1,1,0,0,2,0
20190208-M-Montpellier-QF-Denis_Shapovalov-Pierre_Hugues_Herbert,2,F-IO,15,8,4,2,2,11,4
20190208-M-Montpellier-QF-Denis_Shapovalov-Pierre_Hugues_Herbert,2,B-XC,19,6,1,1,4,9,10
20190208-M-Montpellier-QF-Denis_Shapovalov-Pierre_Hugues_Herbert,2,B-DTM,21,3,1,0,2,15,6
20190208-M-Montpellier-QF-Denis_Shapovalov-Pierre_Hugues_Herbert,2,B-DTL,1,0,0,0,0,1,0
20190208-M-Montpellier-QF-Denis_Shapovalov-Pierre_Hugues_Herbert,2,B-IO,3,1,0,0,1,1,2
20190208-M-Montpellier-QF-Denis_Shapovalov-Pierre_Hugues_Herbert,2,S-XC,3,1,0,0,1,0,3
20190208-M-Montpellier-QF-Denis_Shapovalov-Pierre_Hugues_Herbert,2,S-DTM,6,0,0,0,0,4,2
20190208-M-Montpellier-QF-Denis_Shapovalov-Pierre_Hugues_Herbert,2,S-DTL,1,1,1,0,0,1,0
20030125-M-Australian_Open-SF-Wayne_Ferreira-Andre_Agassi,1,F-XC,22,2,0,2,0,11,11
20030125-M-Australian_Open-SF-Wayne_Ferreira-Andre_Agassi,1,F-DTM,13,1,0,0,1,5,8
20030125-M-Australian_Open-SF-Wayne_Ferreira-Andre_Agassi,1,F-DTL,16,5,2,2,1,10,6
20030125-M-Australian_Open-SF-Wayne_Ferreira-Andre_Agassi,1,F-IO,16,7,1,2,4,6,10
20030125-M-Australian_Open-SF-Wayne_Ferreira-Andre_Agassi,1,F-II,9,3,1,1,1,4,5
20030125-M-Australian_Open-SF-Wayne_Ferreira-Andre_Agassi,1,B-XC,49,11,1,3,7,19,30
20030125-M-Australian_Open-SF-Wayne_Ferreira-Andre_Agassi,1,B-DTM,27,2,0,0,2,8,19
20030125-M-Australian_Open-SF-Wayne_Ferreira-Andre_Agassi,1,B-DTL,22,6,0,1,5,8,14
20030125-M-Australian_Open-SF-Wayne_Ferreira-Andre_Agassi,1,B-IO,5,1,0,1,0,3,2
20030125-M-Australian_Open-SF-Wayne_Ferreira-Andre_Agassi,1,S-XC,12,0,0,0,0,4,8
20030125-M-Australian_Open-SF-Wayne_Ferreira-Andre_Agassi,1,S-DTM,9,1,0,0,1,1,8
20030125-M-Australian_Open-SF-Wayne_Ferreira-Andre_Agassi,1,S-DTL,6,1,0,0,1,1,5
20030125-M-Australian_Open-SF-Wayne_Ferreira-Andre_Agassi,2,F-XC,47,15,6,7,2,30,17
20030125-M-Australian_Open-SF-Wayne_Ferreira-Andre_Agassi,2,F-DTM,14,0,0,0,0,9,5
20030125-M-Australian_Open-SF-Wayne_Ferreira-Andre_Agassi,2,F-DTL,25,7,3,3,1,16,9
20030125-M-Australian_Open-SF-Wayne_Ferreira-Andre_Agassi,2,F-IO,16,1,0,1,0,12,4
20030125-M-Australian_Open-SF-Wayne_Ferreira-Andre_Agassi,2,F-II,5,1,0,1,0,2,3
20030125-M-Australian_Open-SF-Wayne_Ferreira-Andre_Agassi,2,B-XC,75,7,2,3,2,51,24
20030125-M-Australian_Open-SF-Wayne_Ferreira-Andre_Agassi,2,B-DTM,11,0,0,0,0,6,5
20030125-M-Australian_Open-SF-Wayne_Ferreira-Andre_Agassi,2,B-DTL,10,5,3,1,1,6,4
20030125-M-Australian_Open-SF-Wayne_Ferreira-Andre_Agassi,2,B-II,1,0,0,0,0,0,1
20030125-M-Australian_Open-SF-Wayne_Ferreira-Andre_Agassi,2,S-XC,3,0,0,0,0,2,1
20030125-M-Australian_Open-SF-Wayne_Ferreira-Andre_Agassi,2,S-DTM,2,0,0,0,0,0,2
20190202-M-Davis_Cup_Qualifiers-RR-Denis_Shapovalov-Martin_Klizan,1,F-XC,35,12,4,3,5,20,15
20190202-M-Davis_Cup_Qualifiers-RR-Denis_Shapovalov-Martin_Klizan,1,F-DTM,44,6,1,0,5,23,21
20190202-M-Davis_Cup_Qualifiers-RR-Denis_Shapovalov-Martin_Klizan,1,F-DTL,9,4,2,1,1,7,2
20190202-M-Davis_Cup_Qualifiers-RR-Denis_Shapovalov-Martin_Klizan,1,F-IO,21,10,3,2,5,12,9
20190202-M-Davis_Cup_Qualifiers-RR-Denis_Shapovalov-Martin_Klizan,1,B-XC,26,4,1,0,3,12,14
20190202-M-Davis_Cup_Qualifiers-RR-Denis_Shapovalov-Martin_Klizan,1,B-DTM,21,8,1,0,7,9,12
20190202-M-Davis_Cup_Qualifiers-RR-Denis_Shapovalov-Martin_Klizan,1,B-DTL,12,7,2,1,4,5,7
20190202-M-Davis_Cup_Qualifiers-RR-Denis_Shapovalov-Martin_Klizan,1,B-IO,4,2,0,1,1,2,2
20190202-M-Davis_Cup_Qualifiers-RR-Denis_Shapovalov-Martin_Klizan,1,S-XC,1,0,0,0,0,1,0
20190202-M-Davis_Cup_Qualifiers-RR-Denis_Shapovalov-Martin_Klizan,1,S-DTM,4,1,0,0,1,3,1
20190202-M-Davis_Cup_Qualifiers-RR-Denis_Shapovalov-Martin_Klizan,1,S-DTL,2,0,0,0,0,0,2
20190202-M-Davis_Cup_Qualifiers-RR-Denis_Shapovalov-Martin_Klizan,2,F-XC,39,17,4,5,8,22,17
20190202-M-Davis_Cup_Qualifiers-RR-Denis_Shapovalov-Martin_Klizan,2,F-DTM,35,5,0,0,5,15,20
20190202-M-Davis_Cup_Qualifiers-RR-Denis_Shapovalov-Martin_Klizan,2,F-DTL,11,2,0,2,0,7,4
20190202-M-Davis_Cup_Qualifiers-RR-Denis_Shapovalov-Martin_Klizan,2,F-IO,18,5,1,1,3,8,10
20190202-M-Davis_Cup_Qualifiers-RR-Denis_Shapovalov-Martin_Klizan,2,F-II,2,0,0,0,0,1,1
20190202-M-Davis_Cup_Qualifiers-RR-Denis_Shapovalov-Martin_Klizan,2,B-XC,28,6,1,0,5,13,15
20190202-M-Davis_Cup_Qualifiers-RR-Denis_Shapovalov-Martin_Klizan,2,B-DTM,20,1,0,0,1,9,11
20190202-M-Davis_Cup_Qualifiers-RR-Denis_Shapovalov-Martin_Klizan,2,B-DTL,11,6,2,0,4,6,5
20190202-M-Davis_Cup_Qualifiers-RR-Denis_Shapovalov-Martin_Klizan,2,B-IO,5,3,1,0,2,1,4
20190202-M-Davis_Cup_Qualifiers-RR-Denis_Shapovalov-Martin_Klizan,2,S-XC,1,0,0,0,0,0,1
20190202-M-Davis_Cup_Qualifiers-RR-Denis_Shapovalov-Martin_Klizan,2,S-DTM,2,0,0,0,0,0,2
20190211-M-Rotterdam-R32-Robin_Haase-Mikhail_Kukushkin,1,F-XC,22,5,1,2,2,12,10
20190211-M-Rotterdam-R32-Robin_Haase-Mikhail_Kukushkin,1,F-DTM,38,1,0,1,0,10,28
20190211-M-Rotterdam-R32-Robin_Haase-Mikhail_Kukushkin,1,F-DTL,4,1,0,0,1,2,2
20190211-M-Rotterdam-R32-Robin_Haase-Mikhail_Kukushkin,1,F-IO,21,2,2,0,0,8,13
20190211-M-Rotterdam-R32-Robin_Haase-Mikhail_Kukushkin,1,F-II,2,1,0,0,1,1,1
20190211-M-Rotterdam-R32-Robin_Haase-Mikhail_Kukushkin,1,B-XC,19,1,0,0,1,6,13
20190211-M-Rotterdam-R32-Robin_Haase-Mikhail_Kukushkin,1,B-DTM,29,5,0,0,5,7,22
20190211-M-Rotterdam-R32-Robin_Haase-Mikhail_Kukushkin,1,B-DTL,4,3,2,0,1,3,1
20190211-M-Rotterdam-R32-Robin_Haase-Mikhail_Kukushkin,1,B-IO,4,2,1,0,1,2,2
20190211-M-Rotterdam-R32-Robin_Haase-Mikhail_Kukushkin,1,S-XC,48,2,0,0,2,17,31
20190211-M-Rotterdam-R32-Robin_Haase-Mikhail_Kukushkin,1,S-DTM,35,1,0,0,1,13,22
20190211-M-Rotterdam-R32-Robin_Haase-Mikhail_Kukushkin,1,S-DTL,6,2,0,1,1,2,4
20190211-M-Rotterdam-R32-Robin_Haase-Mikhail_Kukushkin,2,F-XC,29,6,2,1,3,15,14
20190211-M-Rotterdam-R32-Robin_Haase-Mikhail_Kukushkin,2,F-DTM,35,2,1,1,0,23,12
20190211-M-Rotterdam-R32-Robin_Haase-Mikhail_Kukushkin,2,F-DTL,7,2,0,1,1,6,1
20190211-M-Rotterdam-R32-Robin_Haase-Mikhail_Kukushkin,2,F-IO,54,14,8,4,2,37,17
20190211-M-Rotterdam-R32-Robin_Haase-Mikhail_Kukushkin,2,F-II,3,0,0,0,0,2,1
20190211-M-Rotterdam-R32-Robin_Haase-Mikhail_Kukushkin,2,B-XC,60,5,0,3,2,42,18
20190211-M-Rotterdam-R32-Robin_Haase-Mikhail_Kukushkin,2,B-DTM,35,2,0,1,1,25,10
20190211-M-Rotterdam-R32-Robin_Haase-Mikhail_Kukushkin,2,B-DTL,15,4,2,0,2,6,9
20190211-M-Rotterdam-R32-Robin_Haase-Mikhail_Kukushkin,2,B-IO,6,0,0,0,0,4,2
20190211-M-Rotterdam-R32-Robin_Haase-Mikhail_Kukushkin,2,S-XC,3,0,0,0,0,1,2
20190211-M-Rotterdam-R32-Robin_Haase-Mikhail_Kukushkin,2,S-DTM,4,0,0,0,0,3,1
20190211-M-Rotterdam-R32-Robin_Haase-Mikhail_Kukushkin,2,S-DTL,1,0,0,0,0,1,0
20030125-M-Australian_Open-SF-Rainer_Schuettler-Andy_Roddick,1,F-XC,46,10,6,2,2,30,16
20030125-M-Australian_Open-SF-Rainer_Schuettler-Andy_Roddick,1,F-DTM,19,0,0,0,0,11,8
20030125-M-Australian_Open-SF-Rainer_Schuettler-Andy_Roddick,1,F-DTL,26,9,1,7,1,22,4
20030125-M-Australian_Open-SF-Rainer_Schuettler-Andy_Roddick,1,F-IO,53,8,2,3,3,36,17
20030125-M-Australian_Open-SF-Rainer_Schuettler-Andy_Roddick,1,F-II,16,5,0,3,2,12,4
20030125-M-Australian_Open-SF-Rainer_Schuettler-Andy_Roddick,1,B-XC,69,8,1,3,4,46,23
20030125-M-Australian_Open-SF-Rainer_Schuettler-Andy_Roddick,1,B-DTM,16,2,1,1,0,9,7
20030125-M-Australian_Open-SF-Rainer_Schuettler-Andy_Roddick,1,B-DTL,21,13,5,3,5,14,7
20030125-M-Australian_Open-SF-Rainer_Schuettler-Andy_Roddick,1,B-IO,1,0,0,0,0,1,0
20030125-M-Australian_Open-SF-Rainer_Schuettler-Andy_Roddick,1,S-XC,16,3,0,1,2,9,7
20030125-M-Australian_Open-SF-Rainer_Schuettler-Andy_Roddick,1,S-DTM,5,0,0,0,0,4,1
20030125-M-Australian_Open-SF-Rainer_Schuettler-Andy_Roddick,1,S-DTL,7,0,0,0,0,5,2
20030125-M-Australian_Open-SF-Rainer_Schuettler-Andy_Roddick,2,F-XC,51,14,0,7,7,16,35
20030125-M-Australian_Open-SF-Rainer_Schuettler-Andy_Roddick,2,F-DTM,16,2,1,0,1,5,11
20030125-M-Australian_Open-SF-Rainer_Schuettler-Andy_Roddick,2,F-DTL,26,9,3,3,3,12,14
20030125-M-Australian_Open-SF-Rainer_Schuettler-Andy_Roddick,2,F-IO,45,15,4,6,5,22,23
20030125-M-Australian_Open-SF-Rainer_Schuettler-Andy_Roddick,2,F-II,13,6,1,3,2,5,8
20030125-M-Australian_Open-SF-Rainer_Schuettler-Andy_Roddick,2,B-XC,79,7,0,1,6,18,61
20030125-M-Australian_Open-SF-Rainer_Schuettler-Andy_Roddick,2,B-DTM,20,4,0,1,3,8,12
20030125-M-Australian_Open-SF-Rainer_Schuettler-Andy_Roddick,2,B-DTL,18,9,2,0,7,5,13
20030125-M-Australian_Open-SF-Rainer_Schuettler-Andy_Roddick,2,B-IO,3,2,0,0,2,1,2
20030125-M-Australian_Open-SF-Rainer_Schuettler-Andy_Roddick,2,S-XC,26,1,0,0,1,14,12
20030125-M-Australian_Open-SF-Rainer_Schuettler-Andy_Roddick,2,S-DTM,5,1,0,0,1,2,3
20030125-M-Australian_Open-SF-Rainer_Schuettler-Andy_Roddick,2,S-DTL,4,0,0,0,0,3,1
20190207-M-Sofia-R16-Stefanos_Tsitsipas-Jan_Lennard_Struff,1,F-XC,19,4,1,1,2,13,6
20190207-M-Sofia-R16-Stefanos_Tsitsipas-Jan_Lennard_Struff,1,F-DTM,28,2,0,0,2,15,13
20190207-M-Sofia-R16-Stefanos_Tsitsipas-Jan_Lennard_Struff,1,F-DTL,4,2,2,0,0,2,2
20190207-M-Sofia-R16-Stefanos_Tsitsipas-Jan_Lennard_Struff,1,F-IO,16,6,3,1,2,12,4
20190207-M-Sofia-R16-Stefanos_Tsitsipas-Jan_Lennard_Struff,1,F-II,2,1,0,0,1,1,1
20190207-M-Sofia-R16-Stefanos_Tsitsipas-Jan_Lennard_Struff,1,B-XC,17,2,1,0,1,11,6
20190207-M-Sofia-R16-Stefanos_Tsitsipas-Jan_Lennard_Struff,1,B-DTM,21,1,0,0,1,7,14
20190207-M-Sofia-R16-Stefanos_Tsitsipas-Jan_Lennard_Struff,1,B-DTL,2,2,2,0,0,2,0
20190207-M-Sofia-R16-Stefanos_Tsitsipas-Jan_Lennard_Struff,1,B-IO,3,2,0,0,2,1,2
20190207-M-Sofia-R16-Stefanos_Tsitsipas-Jan_Lennard_Struff,1,S-XC,5,1,0,1,0,3,2
20190207-M-Sofia-R16-Stefanos_Tsitsipas-Jan_Lennard_Struff,1,S-DTM,3,0,0,0,0,1,2
20190207-M-Sofia-R16-Stefanos_Tsitsipas-Jan_Lennard_Struff,2,F-XC,19,9,3,1,5,8,11
20190207-M-Sofia-R16-Stefanos_Tsitsipas-Jan_Lennard_Struff,2,F-DTM,33,6,1,0,5,13,20
20190207-M-Sofia-R16-Stefanos_Tsitsipas-Jan_Lennard_Struff,2,F-DTL,5,3,0,2,1,4,1
20190207-M-Sofia-R16-Stefanos_Tsitsipas-Jan_Lennard_Struff,2,F-IO,11,5,3,1,1,8,3
20190207-M-Sofia-R16-Stefanos_Tsitsipas-Jan_Lennard_Struff,2,B-XC,21,3,1,0,2,10,11
20190207-M-Sofia-R16-Stefanos_Tsitsipas-Jan_Lennard_Struff,2,B-DTM,24,6,0,0,6,9,15
20190207-M-Sofia-R16-Stefanos_Tsitsipas-Jan_Lennard_Struff,2,B-DTL,3,2,1,0,1,1,2
20190207-M-Sofia-R16-Stefanos_Tsitsipas-Jan_Lennard_Struff,2,S-XC,4,1,0,0,1,2,2
20190207-M-Sofia-R16-Stefanos_Tsitsipas-Jan_Lennard_Struff,2,S-DTM,5,1,0,0,1,1,4
20190207-M-Sofia-R16-Stefanos_Tsitsipas-Jan_Lennard_Struff,2,S-DTL,2,0,0,0,0,0,2
20190207-M-Sofia-R16-Stefanos_Tsitsipas-Jan_Lennard_Struff,2,S-IO,1,0,0,0,0,0,1
20050621-M-Wimbledon-R128-George_Bastl-Andy_Murray,1,F-XC,40,6,0,1,5,10,30
20050621-M-Wimbledon-R128-George_Bastl-Andy_Murray,1,F-DTM,9,1,0,0,1,2,7
20050621-M-Wimbledon-R128-George_Bastl-Andy_Murray,1,F-DTL,13,1,1,0,0,9,4
20050621-M-Wimbledon-R128-George_Bastl-Andy_Murray,1,F-IO,12,5,0,1,4,5,7
20050621-M-Wimbledon-R128-George_Bastl-Andy_Murray,1,F-II,1,1,0,0,1,0,1
20050621-M-Wimbledon-R128-George_Bastl-Andy_Murray,1,B-XC,24,5,0,1,4,4,20
20050621-M-Wimbledon-R128-George_Bastl-Andy_Murray,1,B-DTM,12,4,0,1,3,3,9
20050621-M-Wimbledon-R128-George_Bastl-Andy_Murray,1,B-DTL,11,5,0,1,4,2,9
20050621-M-Wimbledon-R128-George_Bastl-Andy_Murray,1,B-IO,6,0,0,0,0,4,2
20050621-M-Wimbledon-R128-George_Bastl-Andy_Murray,1,S-XC,7,1,0,1,0,5,2
20050621-M-Wimbledon-R128-George_Bastl-Andy_Murray,1,S-DTM,7,0,0,0,0,6,1
20050621-M-Wimbledon-R128-George_Bastl-Andy_Murray,1,S-DTL,1,1,0,0,1,0,1
20050621-M-Wimbledon-R128-George_Bastl-Andy_Murray,2,F-XC,36,9,5,0,4,24,12
20050621-M-Wimbledon-R128-George_Bastl-Andy_Murray,2,F-DTM,10,1,1,0,0,8,2
20050621-M-Wimbledon-R128-George_Bastl-Andy_Murray,2,F-DTL,17,6,1,1,4,12,5
20050621-M-Wimbledon-R128-George_Bastl-Andy_Murray,2,F-IO,11,3,2,1,0,9,2
20050621-M-Wimbledon-R128-George_Bastl-Andy_Murray,2,B-XC,11,1,0,1,0,5,6
20050621-M-Wimbledon-R128-George_Bastl-Andy_Murray,2,B-DTM,4,0,0,0,0,3,1
20050621-M-Wimbledon-R128-George_Bastl-Andy_Murray,2,B-DTL,13,5,2,2,1,8,5
20050621-M-Wimbledon-R128-George_Bastl-Andy_Murray,2,B-IO,2,1,0,0,1,0,2
20050621-M-Wimbledon-R128-George_Bastl-Andy_Murray,2,S-XC,21,0,0,0,0,12,9
20050621-M-Wimbledon-R128-George_Bastl-Andy_Murray,2,S-DTM,7,0,0,0,0,3,4
20050621-M-Wimbledon-R128-George_Bastl-Andy_Murray,2,S-DTL,4,0,0,0,0,2,2
20050621-M-Wimbledon-R128-George_Bastl-Andy_Murray,2,S-IO,5,1,0,0,1,2,3
20190210-M-Cordoba-F-Guido_Pella-Juan_Ignacio_Londero,1,F-XC,80,9,3,2,4,43,37
20190210-M-Cordoba-F-Guido_Pella-Juan_Ignacio_Londero,1,F-DTM,24,1,0,0,1,14,10
20190210-M-Cordoba-F-Guido_Pella-Juan_Ignacio_Londero,1,F-DTL,8,3,0,1,2,4,4
20190210-M-Cordoba-F-Guido_Pella-Juan_Ignacio_Londero,1,F-IO,10,5,3,1,1,7,3
20190210-M-Cordoba-F-Guido_Pella-Juan_Ignacio_Londero,1,F-II,4,3,0,2,1,3,1
20190210-M-Cordoba-F-Guido_Pella-Juan_Ignacio_Londero,1,B-XC,53,10,1,1,8,31,22
20190210-M-Cordoba-F-Guido_Pella-Juan_Ignacio_Londero,1,B-DTM,34,4,0,1,3,21,13
20190210-M-Cordoba-F-Guido_Pella-Juan_Ignacio_Londero,1,B-DTL,5,0,0,0,0,2,3
20190210-M-Cordoba-F-Guido_Pella-Juan_Ignacio_Londero,1,B-IO,6,1,1,0,0,5,1
20190210-M-Cordoba-F-Guido_Pella-Juan_Ignacio_Londero,1,S-XC,4,0,0,0,0,1,3
20190210-M-Cordoba-F-Guido_Pella-Juan_Ignacio_Londero,1,S-DTM,6,0,0,0,0,5,1
20190210-M-Cordoba-F-Guido_Pella-Juan_Ignacio_Londero,1,S-DTL,5,0,0,0,0,4,1
20190210-M-Cordoba-F-Guido_Pella-Juan_Ignacio_Londero,1,S-IO,2,1,0,1,0,2,0
20190210-M-Cordoba-F-Guido_Pella-Juan_Ignacio_Londero,2,F-XC,60,12,3,2,7,26,34
20190210-M-Cordoba-F-Guido_Pella-Juan_Ignacio_Londero,2,F-DTM,40,3,0,1,2,18,22
20190210-M-Cordoba-F-Guido_Pella-Juan_Ignacio_Londero,2,F-DTL,12,6,3,1,2,4,8
20190210-M-Cordoba-F-Guido_Pella-Juan_Ignacio_Londero,2,F-IO,32,15,9,2,4,14,18
20190210-M-Cordoba-F-Guido_Pella-Juan_Ignacio_Londero,2,F-II,9,3,0,2,1,6,3
20190210-M-Cordoba-F-Guido_Pella-Juan_Ignacio_Londero,2,B-XC,31,10,2,3,5,17,14
20190210-M-Cordoba-F-Guido_Pella-Juan_Ignacio_Londero,2,B-DTM,26,5,0,0,5,9,17
20190210-M-Cordoba-F-Guido_Pella-Juan_Ignacio_Londero,2,B-DTL,19,6,1,2,3,7,12
20190210-M-Cordoba-F-Guido_Pella-Juan_Ignacio_Londero,2,B-IO,4,1,0,0,1,0,4
20190210-M-Cordoba-F-Guido_Pella-Juan_Ignacio_Londero,2,S-XC,2,1,0,0,1,0,2
20190210-M-Cordoba-F-Guido_Pella-Juan_Ignacio_Londero,2,S-DTM,3,0,0,0,0,0,3
20190210-M-Cordoba-F-Guido_Pella-Juan_Ignacio_Londero,2,S-DTL,7,1,1,0,0,5,2
20190203-M-Launceston_CH-F-Lorenzo_Giustino-Lloyd_George_Muirhead_Harris,1,F-XC,18,8,2,4,2,9,9
20190203-M-Launceston_CH-F-Lorenzo_Giustino-Lloyd_George_Muirhead_Harris,1,F-DTM,16,3,0,1,2,3,13
20190203-M-Launceston_CH-F-Lorenzo_Giustino-Lloyd_George_Muirhead_Harris,1,F-DTL,1,1,0,0,1,0,1
20190203-M-Launceston_CH-F-Lorenzo_Giustino-Lloyd_George_Muirhead_Harris,1,F-IO,16,4,2,1,1,8,8
20190203-M-Launceston_CH-F-Lorenzo_Giustino-Lloyd_George_Muirhead_Harris,1,F-II,1,1,0,0,1,0,1
20190203-M-Launceston_CH-F-Lorenzo_Giustino-Lloyd_George_Muirhead_Harris,1,B-XC,28,5,0,1,4,13,15
20190203-M-Launceston_CH-F-Lorenzo_Giustino-Lloyd_George_Muirhead_Harris,1,B-DTM,19,3,0,0,3,5,14
20190203-M-Launceston_CH-F-Lorenzo_Giustino-Lloyd_George_Muirhead_Harris,1,B-DTL,4,2,1,0,1,2,2
20190203-M-Launceston_CH-F-Lorenzo_Giustino-Lloyd_George_Muirhead_Harris,1,S-XC,2,1,1,0,0,1,1
20190203-M-Launceston_CH-F-Lorenzo_Giustino-Lloyd_George_Muirhead_Harris,1,S-DTM,1,0,0,0,0,0,1
20190203-M-Launceston_CH-F-Lorenzo_Giustino-Lloyd_George_Muirhead_Harris,2,F-XC,18,7,2,3,2,12,6
20190203-M-Launceston_CH-F-Lorenzo_Giustino-Lloyd_George_Muirhead_Harris,2,F-DTM,10,1,0,1,0,8,2
20190203-M-Launceston_CH-F-Lorenzo_Giustino-Lloyd_George_Muirhead_Harris,2,F-DTL,7,2,1,1,0,6,1
20190203-M-Launceston_CH-F-Lorenzo_Giustino-Lloyd_George_Muirhead_Harris,2,F-IO,29,9,1,5,3,18,11
20190203-M-Launceston_CH-F-Lorenzo_Giustino-Lloyd_George_Muirhead_Harris,2,F-II,1,0,0,0,0,1,0
20190203-M-Launceston_CH-F-Lorenzo_Giustino-Lloyd_George_Muirhead_Harris,2,B-XC,23,1,0,0,1,9,14
20190203-M-Launceston_CH-F-Lorenzo_Giustino-Lloyd_George_Muirhead_Harris,2,B-DTM,10,0,0,0,0,6,4
20190203-M-Launceston_CH-F-Lorenzo_Giustino-Lloyd_George_Muirhead_Harris,2,B-DTL,4,4,0,2,2,2,2
20190203-M-Launceston_CH-F-Lorenzo_Giustino-Lloyd_George_Muirhead_Harris,2,B-IO,2,0,0,0,0,2,0
20190203-M-Launceston_CH-F-Lorenzo_Giustino-Lloyd_George_Muirhead_Harris,2,S-XC,1,0,0,0,0,0,1
20190209-M-Sofia-SF-Gael_Monfils-Daniil_Medvedev,1,F-XC,32,5,1,2,2,17,15
20190209-M-Sofia-SF-Gael_Monfils-Daniil_Medvedev,1,F-DTM,20,1,0,0,1,8,12
20190209-M-Sofia-SF-Gael_Monfils-Daniil_Medvedev,1,F-DTL,7,2,0,1,1,6,1
20190209-M-Sofia-SF-Gael_Monfils-Daniil_Medvedev,1,F-IO,19,6,2,3,1,11,8
20190209-M-Sofia-SF-Gael_Monfils-Daniil_Medvedev,1,F-II,1,1,0,0,1,0,1
20190209-M-Sofia-SF-Gael_Monfils-Daniil_Medvedev,1,B-XC,73,13,0,1,12,23,50
20190209-M-Sofia-SF-Gael_Monfils-Daniil_Medvedev,1,B-DTM,26,1,0,0,1,8,18
20190209-M-Sofia-SF-Gael_Monfils-Daniil_Medvedev,1,B-DTL,6,2,1,1,0,3,3
20190209-M-Sofia-SF-Gael_Monfils-Daniil_Medvedev,1,B-IO,2,2,0,1,1,1,1
20190209-M-Sofia-SF-Gael_Monfils-Daniil_Medvedev,1,S-XC,18,1,0,0,1,9,9
20190209-M-Sofia-SF-Gael_Monfils-Daniil_Medvedev,1,S-DTM,13,0,0,0,0,4,9
20190209-M-Sofia-SF-Gael_Monfils-Daniil_Medvedev,1,S-DTL,3,0,0,0,0,3,0
20190209-M-Sofia-SF-Gael_Monfils-Daniil_Medvedev,1,S-IO,1,0,0,0,0,0,1
20190209-M-Sofia-SF-Gael_Monfils-Daniil_Medvedev,2,F-XC,26,8,5,1,2,13,13
20190209-M-Sofia-SF-Gael_Monfils-Daniil_Medvedev,2,F-DTM,26,1,0,0,1,13,13
20190209-M-Sofia-SF-Gael_Monfils-Daniil_Medvedev,2,F-DTL,13,5,2,1,2,7,6
20190209-M-Sofia-SF-Gael_Monfils-Daniil_Medvedev,2,F-IO,22,7,3,3,1,17,5
20190209-M-Sofia-SF-Gael_Monfils-Daniil_Medvedev,2,B-XC,98,10,1,1,8,57,41
20190209-M-Sofia-SF-Gael_Monfils-Daniil_Medvedev,2,B-DTM,28,0,0,0,0,18,10
20190209-M-Sofia-SF-Gael_Monfils-Daniil_Medvedev,2,B-DTL,10,3,2,0,1,5,5
20190209-M-Sofia-SF-Gael_Monfils-Daniil_Medvedev,2,B-IO,5,2,0,2,0,4,1
20190209-M-Sofia-SF-Gael_Monfils-Daniil_Medvedev,2,S-XC,1,0,0,0,0,1,0
20190209-M-Sofia-SF-Gael_Monfils-Daniil_Medvedev,2,S-DTL,2,0,0,0,0,0,2
20190212-M-Bangkok_CH-R32-Zhe_Li-Thiemo_De_Bakker,1,F-XC,43,16,7,2,7,21,22
20190212-M-Bangkok_CH-R32-Zhe_Li-Thiemo_De_Bakker,1,F-DTM,27,5,0,2,3,14,13
20190212-M-Bangkok_CH-R32-Zhe_Li-Thiemo_De_Bakker,1,F-DTL,1,0,0,0,0,0,1
20190212-M-Bangkok_CH-R32-Zhe_Li-Thiemo_De_Bakker,1,F-IO,20,8,5,3,0,15,5
20190212-M-Bangkok_CH-R32-Zhe_Li-Thiemo_De_Bakker,1,B-XC,31,6,0,1,5,14,17
20190212-M-Bangkok_CH-R32-Zhe_Li-Thiemo_De_Bakker,1,B-DTM,17,0,0,0,0,9,8
20190212-M-Bangkok_CH-R32-Zhe_Li-Thiemo_De_Bakker,1,B-DTL,3,2,2,0,0,2,1
20190212-M-Bangkok_CH-R32-Zhe_Li-Thiemo_De_Bakker,1,B-IO,1,0,0,0,0,1,0
20190212-M-Bangkok_CH-R32-Zhe_Li-Thiemo_De_Bakker,1,S-XC,1,1,0,0,1,0,1
20190212-M-Bangkok_CH-R32-Zhe_Li-Thiemo_De_Bakker,1,S-DTM,4,1,1,0,0,2,2
20190212-M-Bangkok_CH-R32-Zhe_Li-Thiemo_De_Bakker,1,S-DTL,1,1,1,0,0,1,0
20190212-M-Bangkok_CH-R32-Zhe_Li-Thiemo_De_Bakker,2,F-XC,20,10,7,0,3,14,6
20190212-M-Bangkok_CH-R32-Zhe_Li-Thiemo_De_Bakker,2,F-DTM,24,3,0,0,3,13,11
20190212-M-Bangkok_CH-R32-Zhe_Li-Thiemo_De_Bakker,2,F-DTL,8,4,1,1,2,6,2
20190212-M-Bangkok_CH-R32-Zhe_Li-Thiemo_De_Bakker,2,F-IO,16,10,4,0,6,8,8
20190212-M-Bangkok_CH-R32-Zhe_Li-Thiemo_De_Bakker,2,B-XC,10,7,2,2,3,4,6
20190212-M-Bangkok_CH-R32-Zhe_Li-Thiemo_De_Bakker,2,B-DTM,29,7,2,1,4,15,14
20190212-M-Bangkok_CH-R32-Zhe_Li-Thiemo_De_Bakker,2,B-DTL,10,7,4,0,3,6,4
20190212-M-Bangkok_CH-R32-Zhe_Li-Thiemo_De_Bakker,2,B-IO,6,4,1,1,2,2,4
20190212-M-Bangkok_CH-R32-Zhe_Li-Thiemo_De_Bakker,2,S-XC,3,0,0,0,0,1,2
20190212-M-Bangkok_CH-R32-Zhe_Li-Thiemo_De_Bakker,2,S-DTM,8,0,0,0,0,3,5
20190212-M-Bangkok_CH-R32-Zhe_Li-Thiemo_De_Bakker,2,S-DTL,1,1,0,0,1,0,1
20020705-M-Wimbledon-SF-David_Nalbandian-Xavier_Malisse,1,F-XC,83,16,1,10,5,53,30
20020705-M-Wimbledon-SF-David_Nalbandian-Xavier_Malisse,1,F-DTM,24,0,0,0,0,13,11
20020705-M-Wimbledon-SF-David_Nalbandian-Xavier_Malisse,1,F-DTL,19,8,3,2,3,10,9
20020705-M-Wimbledon-SF-David_Nalbandian-Xavier_Malisse,1,F-IO,34,8,0,4,4,21,13
20020705-M-Wimbledon-SF-David_Nalbandian-Xavier_Malisse,1,F-II,8,4,0,1,3,4,4
20020705-M-Wimbledon-SF-David_Nalbandian-Xavier_Malisse,1,B-XC,107,14,2,8,4,64,43
20020705-M-Wimbledon-SF-David_Nalbandian-Xavier_Malisse,1,B-DTM,28,3,0,1,2,19,9
20020705-M-Wimbledon-SF-David_Nalbandian-Xavier_Malisse,1,B-DTL,25,8,3,2,3,17,8
20020705-M-Wimbledon-SF-David_Nalbandian-Xavier_Malisse,1,B-IO,5,4,2,1,1,4,1
20020705-M-Wimbledon-SF-David_Nalbandian-Xavier_Malisse,1,B-II,1,0,0,0,0,1,0
20020705-M-Wimbledon-SF-David_Nalbandian-Xavier_Malisse,1,S-XC,9,0,0,0,0,6,3
20020705-M-Wimbledon-SF-David_Nalbandian-Xavier_Malisse,1,S-DTM,6,1,0,0,1,3,3
20020705-M-Wimbledon-SF-David_Nalbandian-Xavier_Malisse,1,S-DTL,2,0,0,0,0,1,1
20020705-M-Wimbledon-SF-David_Nalbandian-Xavier_Malisse,1,S-IO,1,0,0,0,0,0,1
20020705-M-Wimbledon-SF-David_Nalbandian-Xavier_Malisse,2,F-XC,64,13,4,4,5,25,39
20020705-M-Wimbledon-SF-David_Nalbandian-Xavier_Malisse,2,F-DTM,35,1,1,0,0,13,22
20020705-M-Wimbledon-SF-David_Nalbandian-Xavier_Malisse,2,F-DTL,28,14,2,5,7,14,14
20020705-M-Wimbledon-SF-David_Nalbandian-Xavier_Malisse,2,F-IO,32,12,2,3,7,10,22
20020705-M-Wimbledon-SF-David_Nalbandian-Xavier_Malisse,2,F-II,9,3,1,1,1,6,3
20020705-M-Wimbledon-SF-David_Nalbandian-Xavier_Malisse,2,B-XC,76,8,0,3,5,31,45
20020705-M-Wimbledon-SF-David_Nalbandian-Xavier_Malisse,2,B-DTM,36,5,0,2,3,16,20
20020705-M-Wimbledon-SF-David_Nalbandian-Xavier_Malisse,2,B-DTL,12,5,2,1,2,8,4
20020705-M-Wimbledon-SF-David_Nalbandian-Xavier_Malisse,2,B-IO,4,2,1,0,1,2,2
20020705-M-Wimbledon-SF-David_Nalbandian-Xavier_Malisse,2,S-XC,25,4,0,1,3,8,17
20020705-M-Wimbledon-SF-David_Nalbandian-Xavier_Malisse,2,S-DTM,28,2,0,0,2,9,19
20020705-M-Wimbledon-SF-David_Nalbandian-Xavier_Malisse,2,S-DTL,9,3,1,2,0,4,5
20190213-M-New_York-R16-Jordan_Thompson-Christopher_Eubanks,1,F-XC,11,2,1,1,0,10,1
20190213-M-New_York-R16-Jordan_Thompson-Christopher_Eubanks,1,F-DTM,20,0,0,0,0,11,9
20190213-M-New_York-R16-Jordan_Thompson-Christopher_Eubanks,1,F-DTL,14,3,0,1,2,10,4
20190213-M-New_York-R16-Jordan_Thompson-Christopher_Eubanks,1,F-IO,16,2,0,1,1,9,7
20190213-M-New_York-R16-Jordan_Thompson-Christopher_Eubanks,1,F-II,1,0,0,0,0,1,0
20190213-M-New_York-R16-Jordan_Thompson-Christopher_Eubanks,1,B-XC,15,3,1,1,1,12,3
20190213-M-New_York-R16-Jordan_Thompson-Christopher_Eubanks,1,B-DTM,10,1,0,0,1,4,6
20190213-M-New_York-R16-Jordan_Thompson-Christopher_Eubanks,1,B-DTL,8,3,1,0,2,4,4
20190213-M-New_York-R16-Jordan_Thompson-Christopher_Eubanks,1,B-IO,3,0,0,0,0,2,1
20190213-M-New_York-R16-Jordan_Thompson-Christopher_Eubanks,1,S-XC,1,0,0,0,0,1,0
20190213-M-New_York-R16-Jordan_Thompson-Christopher_Eubanks,1,S-DTM,4,0,0,0,0,1,3
20190213-M-New_York-R16-Jordan_Thompson-Christopher_Eubanks,1,S-DTL,2,0,0,0,0,0,2
20190213-M-New_York-R16-Jordan_Thompson-Christopher_Eubanks,2,F-XC,41,12,4,3,5,20,21
20190213-M-New_York-R16-Jordan_Thompson-Christopher_Eubanks,2,F-DTM,14,1,0,0,1,7,7
20190213-M-New_York-R16-Jordan_Thompson-Christopher_Eubanks,2,F-DTL,8,6,1,0,5,2,6
20190213-M-New_York-R16-Jordan_Thompson-Christopher_Eubanks,2,F-IO,26,16,8,3,5,16,10
20190213-M-New_York-R16-Jordan_Thompson-Christopher_Eubanks,2,F-II,3,2,0,0,2,0,3
20190213-M-New_York-R16-Jordan_Thompson-Christopher_Eubanks,2,B-XC,21,9,1,1,7,4,17
20190213-M-New_York-R16-Jordan_Thompson-Christopher_Eubanks,2,B-DTM,7,1,0,0,1,2,5
20190213-M-New_York-R16-Jordan_Thompson-Christopher_Eubanks,2,B-DTL,5,2,1,0,1,1,4
20190213-M-New_York-R16-Jordan_Thompson-Christopher_Eubanks,2,B-IO,1,1,0,1,0,1,0
20190213-M-New_York-R16-Jordan_Thompson-Christopher_Eubanks,2,S-XC,5,2,0,0,2,1,4
20190213-M-New_York-R16-Jordan_Thompson-Christopher_Eubanks,2,S-DTM,1,0,0,0,0,0,1
20190213-M-New_York-R16-Jordan_Thompson-Christopher_Eubanks,2,S-DTL,1,0,0,0,0,0,1
20190214-M-Rotterdam-R16-Mikhail_Kukushkin-Damir_Dzumhur,1,F-XC,42,3,0,1,2,15,27
20190214-M-Rotterdam-R16-Mikhail_Kukushkin-Damir_Dzumhur,1,F-DTM,11,1,0,0,1,3,8
20190214-M-Rotterdam-R16-Mikhail_Kukushkin-Damir_Dzumhur,1,F-DTL,32,8,0,4,4,11,21
20190214-M-Rotterdam-R16-Mikhail_Kukushkin-Damir_Dzumhur,1,F-IO,53,11,0,3,8,28,25
20190214-M-Rotterdam-R16-Mikhail_Kukushkin-Damir_Dzumhur,1,F-II,4,2,0,1,1,3,1
20190214-M-Rotterdam-R16-Mikhail_Kukushkin-Damir_Dzumhur,1,B-XC,86,7,1,1,5,52,34
20190214-M-Rotterdam-R16-Mikhail_Kukushkin-Damir_Dzumhur,1,B-DTM,15,1,0,0,1,5,10
20190214-M-Rotterdam-R16-Mikhail_Kukushkin-Damir_Dzumhur,1,B-DTL,34,5,1,0,4,14,20
20190214-M-Rotterdam-R16-Mikhail_Kukushkin-Damir_Dzumhur,1,B-IO,6,0,0,0,0,2,4
20190214-M-Rotterdam-R16-Mikhail_Kukushkin-Damir_Dzumhur,1,B-II,1,0,0,0,0,1,0
20190214-M-Rotterdam-R16-Mikhail_Kukushkin-Damir_Dzumhur,1,S-XC,8,0,0,0,0,0,8
20190214-M-Rotterdam-R16-Mikhail_Kukushkin-Damir_Dzumhur,1,S-DTM,1,0,0,0,0,0,1
20190214-M-Rotterdam-R16-Mikhail_Kukushkin-Damir_Dzumhur,1,S-DTL,3,0,0,0,0,1,2
20190214-M-Rotterdam-R16-Mikhail_Kukushkin-Damir_Dzumhur,2,F-XC,43,6,0,1,5,25,18
20190214-M-Rotterdam-R16-Mikhail_Kukushkin-Damir_Dzumhur,2,F-DTM,18,1,1,0,0,12,6
20190214-M-Rotterdam-R16-Mikhail_Kukushkin-Damir_Dzumhur,2,F-DTL,27,8,3,3,2,16,11
20190214-M-Rotterdam-R16-Mikhail_Kukushkin-Damir_Dzumhur,2,F-IO,7,2,1,1,0,6,1
20190214-M-Rotterdam-R16-Mikhail_Kukushkin-Damir_Dzumhur,2,F-II,1,0,0,0,0,0,1
20190214-M-Rotterdam-R16-Mikhail_Kukushkin-Damir_Dzumhur,2,B-XC,45,5,1,4,0,30,15
20190214-M-Rotterdam-R16-Mikhail_Kukushkin-Damir_Dzumhur,2,B-DTM,15,2,0,0,2,6,9
20190214-M-Rotterdam-R16-Mikhail_Kukushkin-Damir_Dzumhur,2,B-DTL,7,5,1,0,4,2,5
20190214-M-Rotterdam-R16-Mikhail_Kukushkin-Damir_Dzumhur,2,B-IO,1,1,1,0,0,1,0
20190214-M-Rotterdam-R16-Mikhail_Kukushkin-Damir_Dzumhur,2,S-XC,68,4,1,0,3,27,41
20190214-M-Rotterdam-R16-Mikhail_Kukushkin-Damir_Dzumhur,2,S-DTM,23,2,0,1,1,11,12
20190214-M-Rotterdam-R16-Mikhail_Kukushkin-Damir_Dzumhur,2,S-DTL,20,4,0,2,2,12,8
20190214-M-Rotterdam-R16-Mikhail_Kukushkin-Damir_Dzumhur,2,S-IO,2,0,0,0,0,1,1
20190212-M-Rotterdam-R32-Ernests_Gulbis-Marius_Copil,1,F-XC,12,6,2,1,3,7,5
20190212-M-Rotterdam-R32-Ernests_Gulbis-Marius_Copil,1,F-DTM,5,1,0,0,1,2,3
20190212-M-Rotterdam-R32-Ernests_Gulbis-Marius_Copil,1,F-DTL,8,4,3,1,0,8,0
20190212-M-Rotterdam-R32-Ernests_Gulbis-Marius_Copil,1,F-IO,1,0,0,0,0,0,1
20190212-M-Rotterdam-R32-Ernests_Gulbis-Marius_Copil,1,B-XC,30,7,0,1,6,20,10
20190212-M-Rotterdam-R32-Ernests_Gulbis-Marius_Copil,1,B-DTM,5,0,0,0,0,4,1
20190212-M-Rotterdam-R32-Ernests_Gulbis-Marius_Copil,1,B-DTL,6,2,2,0,0,5,1
20190212-M-Rotterdam-R32-Ernests_Gulbis-Marius_Copil,1,B-IO,4,1,1,0,0,3,1
20190212-M-Rotterdam-R32-Ernests_Gulbis-Marius_Copil,1,S-XC,4,0,0,0,0,3,1
20190212-M-Rotterdam-R32-Ernests_Gulbis-Marius_Copil,1,S-DTL,2,0,0,0,0,2,0
20190212-M-Rotterdam-R32-Ernests_Gulbis-Marius_Copil,2,F-XC,21,8,0,3,5,8,13
20190212-M-Rotterdam-R32-Ernests_Gulbis-Marius_Copil,2,F-DTM,7,0,0,0,0,3,4
20190212-M-Rotterdam-R32-Ernests_Gulbis-Marius_Copil,2,F-DTL,3,0,0,0,0,1,2
20190212-M-Rotterdam-R32-Ernests_Gulbis-Marius_Copil,2,F-IO,9,2,0,0,2,5,4
20190212-M-Rotterdam-R32-Ernests_Gulbis-Marius_Copil,2,F-II,1,0,0,0,0,0,1
20190212-M-Rotterdam-R32-Ernests_Gulbis-Marius_Copil,2,B-XC,19,9,1,3,5,5,14
20190212-M-Rotterdam-R32-Ernests_Gulbis-Marius_Copil,2,B-DTM,10,0,0,0,0,4,6
20190212-M-Rotterdam-R32-Ernests_Gulbis-Marius_Copil,2,B-DTL,5,0,0,0,0,0,5
20190212-M-Rotterdam-R32-Ernests_Gulbis-Marius_Copil,2,S-XC,7,1,0,0,1,1,6
20190212-M-Rotterdam-R32-Ernests_Gulbis-Marius_Copil,2,S-DTM,4,1,0,1,0,2,2
20190212-M-Rotterdam-R32-Ernests_Gulbis-Marius_Copil,2,S-DTL,1,0,0,0,0,0,1
20190212-M-Rotterdam-R32-Ernests_Gulbis-Marius_Copil,2,S-IO,2,0,0,0,0,0,2
20190211-M-Rotterdam-R32-Peter_Gojowczyk-Andreas_Seppi,1,F-XC,68,18,5,3,10,28,40
20190211-M-Rotterdam-R32-Peter_Gojowczyk-Andreas_Seppi,1,F-DTM,24,1,0,0,1,8,16
20190211-M-Rotterdam-R32-Peter_Gojowczyk-Andreas_Seppi,1,F-DTL,16,7,1,1,5,4,12
20190211-M-Rotterdam-R32-Peter_Gojowczyk-Andreas_Seppi,1,F-IO,23,15,7,4,4,15,8
20190211-M-Rotterdam-R32-Peter_Gojowczyk-Andreas_Seppi,1,B-XC,43,8,1,2,5,21,22
20190211-M-Rotterdam-R32-Peter_Gojowczyk-Andreas_Seppi,1,B-DTM,18,1,0,0,1,10,8
20190211-M-Rotterdam-R32-Peter_Gojowczyk-Andreas_Seppi,1,B-DTL,17,10,3,3,4,7,10
20190211-M-Rotterdam-R32-Peter_Gojowczyk-Andreas_Seppi,1,B-IO,7,4,0,1,3,2,5
20190211-M-Rotterdam-R32-Peter_Gojowczyk-Andreas_Seppi,1,S-XC,4,0,0,0,0,3,1
20190211-M-Rotterdam-R32-Peter_Gojowczyk-Andreas_Seppi,2,F-XC,54,14,6,3,5,38,16
20190211-M-Rotterdam-R32-Peter_Gojowczyk-Andreas_Seppi,2,F-DTM,26,3,0,0,3,14,12
20190211-M-Rotterdam-R32-Peter_Gojowczyk-Andreas_Seppi,2,F-DTL,15,5,4,0,1,10,5
20190211-M-Rotterdam-R32-Peter_Gojowczyk-Andreas_Seppi,2,F-IO,13,1,1,0,0,7,6
20190211-M-Rotterdam-R32-Peter_Gojowczyk-Andreas_Seppi,2,F-II,1,1,1,0,0,1,0
20190211-M-Rotterdam-R32-Peter_Gojowczyk-Andreas_Seppi,2,B-XC,26,7,2,2,3,13,13
20190211-M-Rotterdam-R32-Peter_Gojowczyk-Andreas_Seppi,2,B-DTM,24,1,0,0,1,12,12
20190211-M-Rotterdam-R32-Peter_Gojowczyk-Andreas_Seppi,2,B-DTL,13,9,3,2,4,7,6
20190211-M-Rotterdam-R32-Peter_Gojowczyk-Andreas_Seppi,2,B-IO,2,1,0,0,1,1,1
20190211-M-Rotterdam-R32-Peter_Gojowczyk-Andreas_Seppi,2,S-XC,13,2,0,0,2,2,11
20190211-M-Rotterdam-R32-Peter_Gojowczyk-Andreas_Seppi,2,S-DTM,11,0,0,0,0,7,4
20190211-M-Rotterdam-R32-Peter_Gojowczyk-Andreas_Seppi,2,S-DTL,6,1,0,0,1,5,1
20190211-M-Rotterdam-R32-Peter_Gojowczyk-Andreas_Seppi,2,S-IO,1,0,0,0,0,1,0
20190211-M-Rotterdam-R32-Nikoloz_Basilashvili-Hyeon_Chung,1,F-XC,67,17,3,3,11,32,35
20190211-M-Rotterdam-R32-Nikoloz_Basilashvili-Hyeon_Chung,1,F-DTM,44,5,1,0,4,20,24
20190211-M-Rotterdam-R32-Nikoloz_Basilashvili-Hyeon_Chung,1,F-DTL,10,5,3,0,2,6,4
20190211-M-Rotterdam-R32-Nikoloz_Basilashvili-Hyeon_Chung,1,F-IO,50,20,9,1,10,27,23
20190211-M-Rotterdam-R32-Nikoloz_Basilashvili-Hyeon_Chung,1,F-II,5,4,3,0,1,3,2
20190211-M-Rotterdam-R32-Nikoloz_Basilashvili-Hyeon_Chung,1,B-XC,51,22,7,2,13,24,27
20190211-M-Rotterdam-R32-Nikoloz_Basilashvili-Hyeon_Chung,1,B-DTM,43,4,0,0,4,13,30
20190211-M-Rotterdam-R32-Nikoloz_Basilashvili-Hyeon_Chung,1,B-DTL,7,4,1,0,3,3,4
20190211-M-Rotterdam-R32-Nikoloz_Basilashvili-Hyeon_Chung,1,B-IO,2,1,0,0,1,0,2
20190211-M-Rotterdam-R32-Nikoloz_Basilashvili-Hyeon_Chung,1,S-XC,2,0,0,0,0,1,1
20190211-M-Rotterdam-R32-Nikoloz_Basilashvili-Hyeon_Chung,1,S-DTM,4,0,0,0,0,2,2
20190211-M-Rotterdam-R32-Nikoloz_Basilashvili-Hyeon_Chung,1,S-DTL,1,0,0,0,0,0,1
20190211-M-Rotterdam-R32-Nikoloz_Basilashvili-Hyeon_Chung,1,S-IO,3,1,0,0,1,1,2
20190211-M-Rotterdam-R32-Nikoloz_Basilashvili-Hyeon_Chung,2,F-XC,36,7,1,2,4,16,20
20190211-M-Rotterdam-R32-Nikoloz_Basilashvili-Hyeon_Chung,2,F-DTM,50,4,0,0,4,25,25
20190211-M-Rotterdam-R32-Nikoloz_Basilashvili-Hyeon_Chung,2,F-DTL,13,6,3,1,2,8,5
20190211-M-Rotterdam-R32-Nikoloz_Basilashvili-Hyeon_Chung,2,F-IO,12,2,2,0,0,9,3
20190211-M-Rotterdam-R32-Nikoloz_Basilashvili-Hyeon_Chung,2,F-II,1,1,0,1,0,1,0
20190211-M-Rotterdam-R32-Nikoloz_Basilashvili-Hyeon_Chung,2,B-XC,44,3,0,0,3,22,22
20190211-M-Rotterdam-R32-Nikoloz_Basilashvili-Hyeon_Chung,2,B-DTM,61,4,0,0,4,36,25
20190211-M-Rotterdam-R32-Nikoloz_Basilashvili-Hyeon_Chung,2,B-DTL,13,9,2,2,5,5,8
20190211-M-Rotterdam-R32-Nikoloz_Basilashvili-Hyeon_Chung,2,B-IO,9,3,1,0,2,6,3
20190211-M-Rotterdam-R32-Nikoloz_Basilashvili-Hyeon_Chung,2,S-XC,7,1,0,0,1,1,6
20190211-M-Rotterdam-R32-Nikoloz_Basilashvili-Hyeon_Chung,2,S-DTM,12,0,0,0,0,5,7
20190211-M-Rotterdam-R32-Nikoloz_Basilashvili-Hyeon_Chung,2,S-DTL,3,2,0,1,1,2,1
20190211-M-Rotterdam-R32-Nikoloz_Basilashvili-Hyeon_Chung,2,S-IO,1,1,0,1,0,1,0
20190210-M-Sofia-F-Marton_Fucsovics-Daniil_Medvedev,1,F-XC,41,11,2,2,7,19,22
20190210-M-Sofia-F-Marton_Fucsovics-Daniil_Medvedev,1,F-DTM,38,0,0,0,0,12,26
20190210-M-Sofia-F-Marton_Fucsovics-Daniil_Medvedev,1,F-DTL,12,4,3,0,1,7,5
20190210-M-Sofia-F-Marton_Fucsovics-Daniil_Medvedev,1,F-IO,19,6,1,0,5,7,12
20190210-M-Sofia-F-Marton_Fucsovics-Daniil_Medvedev,1,F-II,2,2,0,1,1,1,1
20190210-M-Sofia-F-Marton_Fucsovics-Daniil_Medvedev,1,B-XC,15,4,1,0,3,6,9
20190210-M-Sofia-F-Marton_Fucsovics-Daniil_Medvedev,1,B-DTM,36,1,0,0,1,10,26
20190210-M-Sofia-F-Marton_Fucsovics-Daniil_Medvedev,1,B-DTL,7,3,1,1,1,4,3
20190210-M-Sofia-F-Marton_Fucsovics-Daniil_Medvedev,1,B-IO,4,3,0,0,3,0,4
20190210-M-Sofia-F-Marton_Fucsovics-Daniil_Medvedev,1,S-XC,18,2,0,0,2,6,12
20190210-M-Sofia-F-Marton_Fucsovics-Daniil_Medvedev,1,S-DTM,7,0,0,0,0,2,5
20190210-M-Sofia-F-Marton_Fucsovics-Daniil_Medvedev,1,S-DTL,3,0,0,0,0,2,1
20190210-M-Sofia-F-Marton_Fucsovics-Daniil_Medvedev,1,S-IO,3,1,0,0,1,0,3
20190210-M-Sofia-F-Marton_Fucsovics-Daniil_Medvedev,2,F-XC,27,3,1,1,1,15,12
20190210-M-Sofia-F-Marton_Fucsovics-Daniil_Medvedev,2,F-DTM,37,4,2,0,2,25,12
20190210-M-Sofia-F-Marton_Fucsovics-Daniil_Medvedev,2,F-DTL,14,7,1,1,5,5,9
20190210-M-Sofia-F-Marton_Fucsovics-Daniil_Medvedev,2,F-IO,18,5,0,2,3,10,8
20190210-M-Sofia-F-Marton_Fucsovics-Daniil_Medvedev,2,B-XC,49,6,0,2,4,30,19
20190210-M-Sofia-F-Marton_Fucsovics-Daniil_Medvedev,2,B-DTM,40,2,0,0,2,25,15
20190210-M-Sofia-F-Marton_Fucsovics-Daniil_Medvedev,2,B-DTL,9,2,0,2,0,6,3
20190210-M-Sofia-F-Marton_Fucsovics-Daniil_Medvedev,2,B-IO,14,5,2,3,0,12,2
20190210-M-Sofia-F-Marton_Fucsovics-Daniil_Medvedev,2,S-XC,1,0,0,0,0,0,1
20190210-M-Sofia-F-Marton_Fucsovics-Daniil_Medvedev,2,S-DTM,2,0,0,0,0,1,1
20190210-M-Chennai_CH-F-Andrew_Harris-Corentin_Moutet,1,F-XC,29,6,2,3,1,14,15
20190210-M-Chennai_CH-F-Andrew_Harris-Corentin_Moutet,1,F-DTM,16,2,0,0,2,5,11
20190210-M-Chennai_CH-F-Andrew_Harris-Corentin_Moutet,1,F-DTL,4,2,0,1,1,2,2
20190210-M-Chennai_CH-F-Andrew_Harris-Corentin_Moutet,1,F-IO,16,6,0,1,5,3,13
20190210-M-Chennai_CH-F-Andrew_Harris-Corentin_Moutet,1,F-II,3,1,0,1,0,2,1
20190210-M-Chennai_CH-F-Andrew_Harris-Corentin_Moutet,1,B-XC,18,4,0,0,4,7,11
20190210-M-Chennai_CH-F-Andrew_Harris-Corentin_Moutet,1,B-DTM,26,4,0,0,4,7,19
20190210-M-Chennai_CH-F-Andrew_Harris-Corentin_Moutet,1,B-DTL,9,1,0,0,1,3,6
20190210-M-Chennai_CH-F-Andrew_Harris-Corentin_Moutet,1,S-XC,1,0,0,0,0,1,0
20190210-M-Chennai_CH-F-Andrew_Harris-Corentin_Moutet,1,S-DTM,5,0,0,0,0,1,4
20190210-M-Chennai_CH-F-Andrew_Harris-Corentin_Moutet,1,S-DTL,7,1,0,0,1,1,6
20190210-M-Chennai_CH-F-Andrew_Harris-Corentin_Moutet,1,S-II,1,0,0,0,0,0,1
20190210-M-Chennai_CH-F-Andrew_Harris-Corentin_Moutet,2,F-XC,40,6,2,1,3,29,11
20190210-M-Chennai_CH-F-Andrew_Harris-Corentin_Moutet,2,F-DTM,9,1,0,0,1,6,3
20190210-M-Chennai_CH-F-Andrew_Harris-Corentin_Moutet,2,F-DTL,3,0,0,0,0,3,0
20190210-M-Chennai_CH-F-Andrew_Harris-Corentin_Moutet,2,F-IO,18,11,5,2,4,10,8
20190210-M-Chennai_CH-F-Andrew_Harris-Corentin_Moutet,2,F-II,10,2,1,0,1,6,4
20190210-M-Chennai_CH-F-Andrew_Harris-Corentin_Moutet,2,B-XC,11,2,0,0,2,5,6
20190210-M-Chennai_CH-F-Andrew_Harris-Corentin_Moutet,2,B-DTM,7,0,0,0,0,5,2
20190210-M-Chennai_CH-F-Andrew_Harris-Corentin_Moutet,2,B-DTL,13,1,0,1,0,7,6
20190210-M-Chennai_CH-F-Andrew_Harris-Corentin_Moutet,2,B-IO,2,0,0,0,0,1,1
20190210-M-Chennai_CH-F-Andrew_Harris-Corentin_Moutet,2,S-XC,1,1,1,0,0,1,0
20190210-M-Chennai_CH-F-Andrew_Harris-Corentin_Moutet,2,S-DTM,2,0,0,0,0,1,1
20190210-M-Chennai_CH-F-Andrew_Harris-Corentin_Moutet,2,S-DTL,4,2,0,1,1,3,1
20190213-M-Rotterdam-R32-Marton_Fucsovics-Martin_Klizan,1,F-XC,45,5,1,2,2,30,15
20190213-M-Rotterdam-R32-Marton_Fucsovics-Martin_Klizan,1,F-DTM,9,1,0,0,1,4,5
20190213-M-Rotterdam-R32-Marton_Fucsovics-Martin_Klizan,1,F-DTL,15,2,1,1,0,12,3
20190213-M-Rotterdam-R32-Marton_Fucsovics-Martin_Klizan,1,F-IO,15,5,3,2,0,13,2
20190213-M-Rotterdam-R32-Marton_Fucsovics-Martin_Klizan,1,F-II,10,4,2,1,1,7,3
20190213-M-Rotterdam-R32-Marton_Fucsovics-Martin_Klizan,1,B-XC,23,1,1,0,0,14,9
20190213-M-Rotterdam-R32-Marton_Fucsovics-Martin_Klizan,1,B-DTM,15,0,0,0,0,11,4
20190213-M-Rotterdam-R32-Marton_Fucsovics-Martin_Klizan,1,B-DTL,10,2,0,1,1,5,5
20190213-M-Rotterdam-R32-Marton_Fucsovics-Martin_Klizan,1,B-IO,4,0,0,0,0,3,1
20190213-M-Rotterdam-R32-Marton_Fucsovics-Martin_Klizan,1,S-XC,12,4,1,0,3,4,8
20190213-M-Rotterdam-R32-Marton_Fucsovics-Martin_Klizan,1,S-DTM,5,0,0,0,0,3,2
20190213-M-Rotterdam-R32-Marton_Fucsovics-Martin_Klizan,1,S-DTL,12,2,0,0,2,8,4
20190213-M-Rotterdam-R32-Marton_Fucsovics-Martin_Klizan,1,S-IO,2,0,0,0,0,1,1
20190213-M-Rotterdam-R32-Marton_Fucsovics-Martin_Klizan,2,F-XC,51,10,2,2,6,18,33
20190213-M-Rotterdam-R32-Marton_Fucsovics-Martin_Klizan,2,F-DTM,5,1,0,0,1,0,5
20190213-M-Rotterdam-R32-Marton_Fucsovics-Martin_Klizan,2,F-DTL,16,10,3,1,6,8,8
20190213-M-Rotterdam-R32-Marton_Fucsovics-Martin_Klizan,2,F-IO,21,11,3,2,6,11,10
20190213-M-Rotterdam-R32-Marton_Fucsovics-Martin_Klizan,2,F-II,5,3,2,1,0,4,1
20190213-M-Rotterdam-R32-Marton_Fucsovics-Martin_Klizan,2,B-XC,35,13,0,4,9,10,25
20190213-M-Rotterdam-R32-Marton_Fucsovics-Martin_Klizan,2,B-DTM,15,3,0,1,2,4,11
20190213-M-Rotterdam-R32-Marton_Fucsovics-Martin_Klizan,2,B-DTL,13,2,0,2,0,5,8
20190213-M-Rotterdam-R32-Marton_Fucsovics-Martin_Klizan,2,B-IO,13,4,1,1,2,9,4
20190213-M-Rotterdam-R32-Marton_Fucsovics-Martin_Klizan,2,S-XC,2,0,0,0,0,1,1
20190213-M-Rotterdam-R32-Marton_Fucsovics-Martin_Klizan,2,S-DTM,4,0,0,0,0,0,4
20190213-M-Rotterdam-R32-Marton_Fucsovics-Martin_Klizan,2,S-DTL,8,0,0,0,0,2,6
20190213-M-Rotterdam-R32-Marton_Fucsovics-Martin_Klizan,2,S-IO,2,1,0,0,1,0,2
20190215-M-Rotterdam-QF-Gael_Monfils-Damir_Dzumhur,1,F-XC,45,8,2,3,3,28,17
20190215-M-Rotterdam-QF-Gael_Monfils-Damir_Dzumhur,1,F-DTM,11,0,0,0,0,6,5
20190215-M-Rotterdam-QF-Gael_Monfils-Damir_Dzumhur,1,F-DTL,8,4,3,1,0,5,3
20190215-M-Rotterdam-QF-Gael_Monfils-Damir_Dzumhur,1,F-IO,34,4,0,0,4,22,12
20190215-M-Rotterdam-QF-Gael_Monfils-Damir_Dzumhur,1,F-II,2,2,0,1,1,1,1
20190215-M-Rotterdam-QF-Gael_Monfils-Damir_Dzumhur,1,B-XC,52,6,0,1,5,30,22
20190215-M-Rotterdam-QF-Gael_Monfils-Damir_Dzumhur,1,B-DTM,12,0,0,0,0,7,5
20190215-M-Rotterdam-QF-Gael_Monfils-Damir_Dzumhur,1,B-DTL,16,8,4,2,2,11,5
20190215-M-Rotterdam-QF-Gael_Monfils-Damir_Dzumhur,1,S-XC,12,0,0,0,0,5,7
20190215-M-Rotterdam-QF-Gael_Monfils-Damir_Dzumhur,1,S-DTM,1,0,0,0,0,0,1
20190215-M-Rotterdam-QF-Gael_Monfils-Damir_Dzumhur,1,S-DTL,3,0,0,0,0,1,2
20190215-M-Rotterdam-QF-Gael_Monfils-Damir_Dzumhur,2,F-XC,15,0,0,0,0,8,7
20190215-M-Rotterdam-QF-Gael_Monfils-Damir_Dzumhur,2,F-DTM,11,0,0,0,0,4,7
20190215-M-Rotterdam-QF-Gael_Monfils-Damir_Dzumhur,2,F-DTL,31,6,1,0,5,12,19
20190215-M-Rotterdam-QF-Gael_Monfils-Damir_Dzumhur,2,F-IO,23,5,2,1,2,10,13
20190215-M-Rotterdam-QF-Gael_Monfils-Damir_Dzumhur,2,F-II,7,3,0,0,3,1,6
20190215-M-Rotterdam-QF-Gael_Monfils-Damir_Dzumhur,2,B-XC,37,3,1,0,2,17,20
20190215-M-Rotterdam-QF-Gael_Monfils-Damir_Dzumhur,2,B-DTM,15,3,0,0,3,4,11
20190215-M-Rotterdam-QF-Gael_Monfils-Damir_Dzumhur,2,B-DTL,13,6,4,0,2,9,4
20190215-M-Rotterdam-QF-Gael_Monfils-Damir_Dzumhur,2,B-IO,2,0,0,0,0,2,0
20190215-M-Rotterdam-QF-Gael_Monfils-Damir_Dzumhur,2,S-XC,20,2,0,1,1,8,12
20190215-M-Rotterdam-QF-Gael_Monfils-Damir_Dzumhur,2,S-DTM,6,0,0,0,0,2,4
20190215-M-Rotterdam-QF-Gael_Monfils-Damir_Dzumhur,2,S-DTL,7,0,0,0,0,2,5
20190215-M-Rotterdam-QF-Gael_Monfils-Damir_Dzumhur,2,S-IO,1,0,0,0,0,0,1
20190212-M-Rotterdam-R32-Denis_Shapovalov-Franco_Skugor,1,F-XC,40,11,3,2,6,25,15
20190212-M-Rotterdam-R32-Denis_Shapovalov-Franco_Skugor,1,F-DTM,12,1,0,1,0,9,3
20190212-M-Rotterdam-R32-Denis_Shapovalov-Franco_Skugor,1,F-DTL,16,11,5,1,5,10,6
20190212-M-Rotterdam-R32-Denis_Shapovalov-Franco_Skugor,1,F-IO,10,4,2,0,2,6,4
20190212-M-Rotterdam-R32-Denis_Shapovalov-Franco_Skugor,1,F-II,2,1,0,1,0,2,0
20190212-M-Rotterdam-R32-Denis_Shapovalov-Franco_Skugor,1,B-XC,17,6,0,3,3,11,6
20190212-M-Rotterdam-R32-Denis_Shapovalov-Franco_Skugor,1,B-DTM,11,3,0,0,3,6,5
20190212-M-Rotterdam-R32-Denis_Shapovalov-Franco_Skugor,1,B-DTL,13,8,4,2,2,10,3
20190212-M-Rotterdam-R32-Denis_Shapovalov-Franco_Skugor,1,B-IO,2,0,0,0,0,2,0
20190212-M-Rotterdam-R32-Denis_Shapovalov-Franco_Skugor,1,S-DTM,1,0,0,0,0,1,0
20190212-M-Rotterdam-R32-Denis_Shapovalov-Franco_Skugor,1,S-DTL,4,1,0,0,1,2,2
20190212-M-Rotterdam-R32-Denis_Shapovalov-Franco_Skugor,2,F-XC,30,5,1,0,4,9,21
20190212-M-Rotterdam-R32-Denis_Shapovalov-Franco_Skugor,2,F-DTM,7,0,0,0,0,2,5
20190212-M-Rotterdam-R32-Denis_Shapovalov-Franco_Skugor,2,F-DTL,5,0,0,0,0,0,5
20190212-M-Rotterdam-R32-Denis_Shapovalov-Franco_Skugor,2,F-IO,5,2,1,0,1,1,4
20190212-M-Rotterdam-R32-Denis_Shapovalov-Franco_Skugor,2,B-XC,31,8,2,0,6,10,21
20190212-M-Rotterdam-R32-Denis_Shapovalov-Franco_Skugor,2,B-DTM,12,0,0,0,0,5,7
20190212-M-Rotterdam-R32-Denis_Shapovalov-Franco_Skugor,2,B-DTL,5,2,1,0,1,2,3
20190212-M-Rotterdam-R32-Denis_Shapovalov-Franco_Skugor,2,B-IO,4,0,0,0,0,0,4
20190212-M-Rotterdam-R32-Denis_Shapovalov-Franco_Skugor,2,S-XC,5,0,0,0,0,1,4
20190212-M-Rotterdam-R32-Denis_Shapovalov-Franco_Skugor,2,S-DTM,3,0,0,0,0,2,1
20020126-M-Australian_Open-SF-Thomas_Johansson-Jiri_Novak,1,F-XC,78,17,4,6,7,46,32
20020126-M-Australian_Open-SF-Thomas_Johansson-Jiri_Novak,1,F-DTM,34,6,0,2,4,15,19
20020126-M-Australian_Open-SF-Thomas_Johansson-Jiri_Novak,1,F-DTL,41,6,4,1,1,20,21
20020126-M-Australian_Open-SF-Thomas_Johansson-Jiri_Novak,1,F-IO,49,13,1,4,8,17,32
20020126-M-Australian_Open-SF-Thomas_Johansson-Jiri_Novak,1,F-II,3,1,0,1,0,3,0
20020126-M-Australian_Open-SF-Thomas_Johansson-Jiri_Novak,1,B-XC,111,16,4,5,7,59,52
20020126-M-Australian_Open-SF-Thomas_Johansson-Jiri_Novak,1,B-DTM,34,3,0,2,1,14,20
20020126-M-Australian_Open-SF-Thomas_Johansson-Jiri_Novak,1,B-DTL,36,21,3,7,11,21,15
20020126-M-Australian_Open-SF-Thomas_Johansson-Jiri_Novak,1,B-IO,7,4,1,2,1,5,2
20020126-M-Australian_Open-SF-Thomas_Johansson-Jiri_Novak,1,S-XC,9,0,0,0,0,5,4
20020126-M-Australian_Open-SF-Thomas_Johansson-Jiri_Novak,1,S-DTM,6,0,0,0,0,1,5
20020126-M-Australian_Open-SF-Thomas_Johansson-Jiri_Novak,1,S-DTL,1,1,0,1,0,1,0
20020126-M-Australian_Open-SF-Thomas_Johansson-Jiri_Novak,2,F-XC,66,14,2,5,7,35,31
20020126-M-Australian_Open-SF-Thomas_Johansson-Jiri_Novak,2,F-DTM,36,5,0,1,4,14,22
20020126-M-Australian_Open-SF-Thomas_Johansson-Jiri_Novak,2,F-DTL,37,9,3,4,2,15,22
20020126-M-Australian_Open-SF-Thomas_Johansson-Jiri_Novak,2,F-IO,35,10,1,6,3,23,12
20020126-M-Australian_Open-SF-Thomas_Johansson-Jiri_Novak,2,F-II,4,2,1,1,0,3,1
20020126-M-Australian_Open-SF-Thomas_Johansson-Jiri_Novak,2,B-XC,111,8,1,4,3,59,52
20020126-M-Australian_Open-SF-Thomas_Johansson-Jiri_Novak,2,B-DTM,59,6,0,0,6,34,25
20020126-M-Australian_Open-SF-Thomas_Johansson-Jiri_Novak,2,B-DTL,43,16,2,7,7,22,21
20020126-M-Australian_Open-SF-Thomas_Johansson-Jiri_Novak,2,B-IO,14,2,0,0,2,9,5
20020126-M-Australian_Open-SF-Thomas_Johansson-Jiri_Novak,2,S-XC,7,0,0,0,0,3,4
20020126-M-Australian_Open-SF-Thomas_Johansson-Jiri_Novak,2,S-DTM,6,0,0,0,0,2,4
20020126-M-Australian_Open-SF-Thomas_Johansson-Jiri_Novak,2,S-DTL,5,0,0,0,0,1,4
20190216-M-New_York-SF-Sam_Querrey-Brayden_Schnur,1,F-XC,37,17,4,4,9,18,19
20190216-M-New_York-SF-Sam_Querrey-Brayden_Schnur,1,F-DTM,14,4,1,0,3,4,10
20190216-M-New_York-SF-Sam_Querrey-Brayden_Schnur,1,F-DTL,3,2,2,0,0,3,0
20190216-M-New_York-SF-Sam_Querrey-Brayden_Schnur,1,F-IO,16,7,4,1,2,10,6
20190216-M-New_York-SF-Sam_Querrey-Brayden_Schnur,1,F-II,3,2,1,1,0,3,0
20190216-M-New_York-SF-Sam_Querrey-Brayden_Schnur,1,B-XC,35,9,2,1,6,15,20
20190216-M-New_York-SF-Sam_Querrey-Brayden_Schnur,1,B-DTM,24,0,0,0,0,10,14
20190216-M-New_York-SF-Sam_Querrey-Brayden_Schnur,1,B-DTL,10,4,2,0,2,3,7
20190216-M-New_York-SF-Sam_Querrey-Brayden_Schnur,1,B-IO,6,2,1,0,1,3,3
20190216-M-New_York-SF-Sam_Querrey-Brayden_Schnur,1,S-XC,13,0,0,0,0,4,9
20190216-M-New_York-SF-Sam_Querrey-Brayden_Schnur,1,S-DTM,4,1,0,0,1,0,4
20190216-M-New_York-SF-Sam_Querrey-Brayden_Schnur,1,S-DTL,2,2,0,0,2,0,2
20190216-M-New_York-SF-Sam_Querrey-Brayden_Schnur,2,F-XC,21,9,3,3,3,12,9
20190216-M-New_York-SF-Sam_Querrey-Brayden_Schnur,2,F-DTM,27,2,0,0,2,14,13
20190216-M-New_York-SF-Sam_Querrey-Brayden_Schnur,2,F-DTL,10,2,2,0,0,6,4
20190216-M-New_York-SF-Sam_Querrey-Brayden_Schnur,2,F-IO,40,12,5,3,4,24,16
20190216-M-New_York-SF-Sam_Querrey-Brayden_Schnur,2,F-II,5,1,1,0,0,4,1
20190216-M-New_York-SF-Sam_Querrey-Brayden_Schnur,2,B-XC,17,2,0,0,2,12,5
20190216-M-New_York-SF-Sam_Querrey-Brayden_Schnur,2,B-DTM,13,3,0,0,3,4,9
20190216-M-New_York-SF-Sam_Querrey-Brayden_Schnur,2,B-DTL,8,5,1,1,3,4,4
20190216-M-New_York-SF-Sam_Querrey-Brayden_Schnur,2,B-IO,2,0,0,0,0,1,1
20190216-M-New_York-SF-Sam_Querrey-Brayden_Schnur,2,S-XC,12,1,0,1,0,7,5
20190216-M-New_York-SF-Sam_Querrey-Brayden_Schnur,2,S-DTM,9,0,0,0,0,4,5
20190216-M-New_York-SF-Sam_Querrey-Brayden_Schnur,2,S-DTL,1,0,0,0,0,1,0
20190214-M-Rotterdam-R16-Fernando_Verdasco-Daniil_Medvedev,1,F-XC,79,16,1,5,10,36,43
20190214-M-Rotterdam-R16-Fernando_Verdasco-Daniil_Medvedev,1,F-DTM,33,5,0,0,5,15,18
20190214-M-Rotterdam-R16-Fernando_Verdasco-Daniil_Medvedev,1,F-DTL,16,7,2,2,3,8,8
20190214-M-Rotterdam-R16-Fernando_Verdasco-Daniil_Medvedev,1,F-IO,28,9,1,4,4,16,12
20190214-M-Rotterdam-R16-Fernando_Verdasco-Daniil_Medvedev,1,F-II,2,0,0,0,0,1,1
20190214-M-Rotterdam-R16-Fernando_Verdasco-Daniil_Medvedev,1,B-XC,28,5,0,0,5,10,18
20190214-M-Rotterdam-R16-Fernando_Verdasco-Daniil_Medvedev,1,B-DTM,18,2,0,0,2,3,15
20190214-M-Rotterdam-R16-Fernando_Verdasco-Daniil_Medvedev,1,B-DTL,13,4,0,2,2,5,8
20190214-M-Rotterdam-R16-Fernando_Verdasco-Daniil_Medvedev,1,B-IO,4,0,0,0,0,1,3
20190214-M-Rotterdam-R16-Fernando_Verdasco-Daniil_Medvedev,1,S-XC,16,2,0,1,1,7,9
20190214-M-Rotterdam-R16-Fernando_Verdasco-Daniil_Medvedev,1,S-DTM,15,2,0,0,2,5,10
20190214-M-Rotterdam-R16-Fernando_Verdasco-Daniil_Medvedev,1,S-DTL,2,0,0,0,0,2,0
20190214-M-Rotterdam-R16-Fernando_Verdasco-Daniil_Medvedev,1,S-IO,2,1,0,0,1,1,1
20190214-M-Rotterdam-R16-Fernando_Verdasco-Daniil_Medvedev,2,F-XC,51,5,1,2,2,33,18
20190214-M-Rotterdam-R16-Fernando_Verdasco-Daniil_Medvedev,2,F-DTM,36,4,0,0,4,15,21
20190214-M-Rotterdam-R16-Fernando_Verdasco-Daniil_Medvedev,2,F-DTL,11,4,1,1,2,7,4
20190214-M-Rotterdam-R16-Fernando_Verdasco-Daniil_Medvedev,2,F-IO,8,2,0,0,2,3,5
20190214-M-Rotterdam-R16-Fernando_Verdasco-Daniil_Medvedev,2,B-XC,58,6,1,2,3,34,24
20190214-M-Rotterdam-R16-Fernando_Verdasco-Daniil_Medvedev,2,B-DTM,47,2,0,1,1,24,23
20190214-M-Rotterdam-R16-Fernando_Verdasco-Daniil_Medvedev,2,B-DTL,12,2,0,1,1,7,5
20190214-M-Rotterdam-R16-Fernando_Verdasco-Daniil_Medvedev,2,B-IO,7,1,0,0,1,5,2
20190214-M-Rotterdam-R16-Fernando_Verdasco-Daniil_Medvedev,2,S-XC,3,0,0,0,0,1,2
20190214-M-Rotterdam-R16-Fernando_Verdasco-Daniil_Medvedev,2,S-DTM,2,0,0,0,0,0,2
20190214-M-Rotterdam-R16-Fernando_Verdasco-Daniil_Medvedev,2,S-DTL,2,0,0,0,0,0,2
20190214-M-Rotterdam-R16-Fernando_Verdasco-Daniil_Medvedev,2,S-IO,2,0,0,0,0,2,0
20190215-M-Rotterdam-QF-Denis_Shapovalov-Stanislas_Wawrinka,1,F-XC,38,11,3,4,4,20,18
20190215-M-Rotterdam-QF-Denis_Shapovalov-Stanislas_Wawrinka,1,F-DTM,13,1,0,0,1,4,9
20190215-M-Rotterdam-QF-Denis_Shapovalov-Stanislas_Wawrinka,1,F-DTL,7,2,1,0,1,4,3
20190215-M-Rotterdam-QF-Denis_Shapovalov-Stanislas_Wawrinka,1,F-IO,21,6,3,2,1,14,7
20190215-M-Rotterdam-QF-Denis_Shapovalov-Stanislas_Wawrinka,1,F-II,3,3,1,0,2,1,2
20190215-M-Rotterdam-QF-Denis_Shapovalov-Stanislas_Wawrinka,1,B-XC,21,2,0,0,2,8,13
20190215-M-Rotterdam-QF-Denis_Shapovalov-Stanislas_Wawrinka,1,B-DTM,13,0,0,0,0,8,5
20190215-M-Rotterdam-QF-Denis_Shapovalov-Stanislas_Wawrinka,1,B-DTL,7,4,2,0,2,3,4
20190215-M-Rotterdam-QF-Denis_Shapovalov-Stanislas_Wawrinka,1,B-IO,4,4,1,0,3,1,3
20190215-M-Rotterdam-QF-Denis_Shapovalov-Stanislas_Wawrinka,1,S-XC,1,0,0,0,0,0,1
20190215-M-Rotterdam-QF-Denis_Shapovalov-Stanislas_Wawrinka,1,S-DTM,3,0,0,0,0,0,3
20190215-M-Rotterdam-QF-Denis_Shapovalov-Stanislas_Wawrinka,1,S-DTL,4,2,0,0,2,2,2
20190215-M-Rotterdam-QF-Denis_Shapovalov-Stanislas_Wawrinka,2,F-XC,40,8,1,2,5,22,18
20190215-M-Rotterdam-QF-Denis_Shapovalov-Stanislas_Wawrinka,2,F-DTM,23,1,0,1,0,8,15
20190215-M-Rotterdam-QF-Denis_Shapovalov-Stanislas_Wawrinka,2,F-DTL,5,4,1,0,3,1,4
20190215-M-Rotterdam-QF-Denis_Shapovalov-Stanislas_Wawrinka,2,F-IO,13,6,3,2,1,7,6
20190215-M-Rotterdam-QF-Denis_Shapovalov-Stanislas_Wawrinka,2,B-XC,21,7,1,1,5,13,8
20190215-M-Rotterdam-QF-Denis_Shapovalov-Stanislas_Wawrinka,2,B-DTM,17,0,0,0,0,9,8
20190215-M-Rotterdam-QF-Denis_Shapovalov-Stanislas_Wawrinka,2,B-DTL,3,1,1,0,0,1,2
20190215-M-Rotterdam-QF-Denis_Shapovalov-Stanislas_Wawrinka,2,B-IO,3,1,0,0,1,1,2
20190215-M-Rotterdam-QF-Denis_Shapovalov-Stanislas_Wawrinka,2,S-XC,1,1,0,0,1,0,1
20190215-M-Rotterdam-QF-Denis_Shapovalov-Stanislas_Wawrinka,2,S-DTM,4,0,0,0,0,2,2
20190215-M-Rotterdam-QF-Denis_Shapovalov-Stanislas_Wawrinka,2,S-DTL,2,0,0,0,0,1,1
20190215-M-Rotterdam-QF-Denis_Shapovalov-Stanislas_Wawrinka,2,S-IO,2,0,0,0,0,1,1
20190215-M-New_York-QF-Reilly_Opelka-Guillermo_Garcia_Lopez,1,F-XC,15,4,1,0,3,6,9
20190215-M-New_York-QF-Reilly_Opelka-Guillermo_Garcia_Lopez,1,F-DTM,8,2,1,0,1,3,5
20190215-M-New_York-QF-Reilly_Opelka-Guillermo_Garcia_Lopez,1,F-DTL,12,2,2,0,0,6,6
20190215-M-New_York-QF-Reilly_Opelka-Guillermo_Garcia_Lopez,1,F-IO,26,7,3,1,3,12,14
20190215-M-New_York-QF-Reilly_Opelka-Guillermo_Garcia_Lopez,1,F-II,3,1,1,0,0,1,2
20190215-M-New_York-QF-Reilly_Opelka-Guillermo_Garcia_Lopez,1,B-XC,22,4,1,1,2,8,14
20190215-M-New_York-QF-Reilly_Opelka-Guillermo_Garcia_Lopez,1,B-DTM,10,0,0,0,0,2,8
20190215-M-New_York-QF-Reilly_Opelka-Guillermo_Garcia_Lopez,1,B-DTL,11,7,4,0,3,6,5
20190215-M-New_York-QF-Reilly_Opelka-Guillermo_Garcia_Lopez,1,B-IO,1,1,0,1,0,1,0
20190215-M-New_York-QF-Reilly_Opelka-Guillermo_Garcia_Lopez,1,S-XC,4,1,0,0,1,1,3
20190215-M-New_York-QF-Reilly_Opelka-Guillermo_Garcia_Lopez,1,S-DTL,5,1,0,0,1,0,5
20190215-M-New_York-QF-Reilly_Opelka-Guillermo_Garcia_Lopez,1,S-IO,1,1,0,1,0,1,0
20190215-M-New_York-QF-Reilly_Opelka-Guillermo_Garcia_Lopez,2,F-XC,17,3,1,2,0,12,5
20190215-M-New_York-QF-Reilly_Opelka-Guillermo_Garcia_Lopez,2,F-DTM,5,2,0,0,2,3,2
20190215-M-New_York-QF-Reilly_Opelka-Guillermo_Garcia_Lopez,2,F-DTL,8,3,1,0,2,5,3
20190215-M-New_York-QF-Reilly_Opelka-Guillermo_Garcia_Lopez,2,F-IO,18,3,0,2,1,11,7
20190215-M-New_York-QF-Reilly_Opelka-Guillermo_Garcia_Lopez,2,F-II,1,0,0,0,0,1,0
20190215-M-New_York-QF-Reilly_Opelka-Guillermo_Garcia_Lopez,2,B-XC,11,0,0,0,0,8,3
20190215-M-New_York-QF-Reilly_Opelka-Guillermo_Garcia_Lopez,2,B-DTM,18,2,0,0,2,10,8
20190215-M-New_York-QF-Reilly_Opelka-Guillermo_Garcia_Lopez,2,B-DTL,1,1,1,0,0,1,0
20190215-M-New_York-QF-Reilly_Opelka-Guillermo_Garcia_Lopez,2,S-XC,22,1,1,0,0,14,8
20190215-M-New_York-QF-Reilly_Opelka-Guillermo_Garcia_Lopez,2,S-DTM,9,0,0,0,0,4,5
20190215-M-New_York-QF-Reilly_Opelka-Guillermo_Garcia_Lopez,2,S-DTL,2,0,0,0,0,1,1
20190217-M-New_York-F-Reilly_Opelka-Brayden_Schnur,1,F-XC,17,2,0,1,1,9,8
20190217-M-New_York-F-Reilly_Opelka-Brayden_Schnur,1,F-DTM,7,0,0,0,0,3,4
20190217-M-New_York-F-Reilly_Opelka-Brayden_Schnur,1,F-DTL,4,3,0,0,3,0,4
20190217-M-New_York-F-Reilly_Opelka-Brayden_Schnur,1,F-IO,29,14,9,0,5,17,12
20190217-M-New_York-F-Reilly_Opelka-Brayden_Schnur,1,F-II,5,4,1,1,2,3,2
20190217-M-New_York-F-Reilly_Opelka-Brayden_Schnur,1,B-XC,23,7,1,0,6,9,14
20190217-M-New_York-F-Reilly_Opelka-Brayden_Schnur,1,B-DTM,6,1,0,1,0,3,3
20190217-M-New_York-F-Reilly_Opelka-Brayden_Schnur,1,B-DTL,6,4,1,0,3,2,4
20190217-M-New_York-F-Reilly_Opelka-Brayden_Schnur,1,B-IO,2,1,0,0,1,1,1
20190217-M-New_York-F-Reilly_Opelka-Brayden_Schnur,1,S-XC,6,0,0,0,0,2,4
20190217-M-New_York-F-Reilly_Opelka-Brayden_Schnur,1,S-DTM,3,1,0,0,1,0,3
20190217-M-New_York-F-Reilly_Opelka-Brayden_Schnur,1,S-DTL,1,0,0,0,0,1,0
20190217-M-New_York-F-Reilly_Opelka-Brayden_Schnur,2,F-XC,13,5,2,0,3,8,5
20190217-M-New_York-F-Reilly_Opelka-Brayden_Schnur,2,F-DTM,15,3,0,3,0,10,5
20190217-M-New_York-F-Reilly_Opelka-Brayden_Schnur,2,F-DTL,13,2,0,0,2,5,8
20190217-M-New_York-F-Reilly_Opelka-Brayden_Schnur,2,F-IO,31,10,1,4,5,21,10
20190217-M-New_York-F-Reilly_Opelka-Brayden_Schnur,2,F-II,2,1,1,0,0,2,0
20190217-M-New_York-F-Reilly_Opelka-Brayden_Schnur,2,B-XC,17,3,0,0,3,7,10
20190217-M-New_York-F-Reilly_Opelka-Brayden_Schnur,2,B-DTM,8,1,0,0,1,3,5
20190217-M-New_York-F-Reilly_Opelka-Brayden_Schnur,2,B-DTL,5,2,1,0,1,3,2
20190217-M-New_York-F-Reilly_Opelka-Brayden_Schnur,2,S-XC,7,1,0,0,1,2,5
20190217-M-New_York-F-Reilly_Opelka-Brayden_Schnur,2,S-DTM,8,0,0,0,0,5,3
20190217-M-New_York-F-Reilly_Opelka-Brayden_Schnur,2,S-DTL,3,1,0,0,1,0,3
20190215-M-New_York-QF-Paolo_Lorenzi-Brayden_Schnur,1,F-XC,41,10,2,5,3,22,19
20190215-M-New_York-QF-Paolo_Lorenzi-Brayden_Schnur,1,F-DTM,32,1,1,0,0,20,12
20190215-M-New_York-QF-Paolo_Lorenzi-Brayden_Schnur,1,F-DTL,17,4,1,1,2,11,6
20190215-M-New_York-QF-Paolo_Lorenzi-Brayden_Schnur,1,F-IO,37,9,2,3,4,19,18
20190215-M-New_York-QF-Paolo_Lorenzi-Brayden_Schnur,1,F-II,2,0,0,0,0,1,1
20190215-M-New_York-QF-Paolo_Lorenzi-Brayden_Schnur,1,B-XC,88,10,1,5,4,62,26
20190215-M-New_York-QF-Paolo_Lorenzi-Brayden_Schnur,1,B-DTM,21,0,0,0,0,12,9
20190215-M-New_York-QF-Paolo_Lorenzi-Brayden_Schnur,1,B-DTL,12,3,2,1,0,7,5
20190215-M-New_York-QF-Paolo_Lorenzi-Brayden_Schnur,1,B-IO,11,6,4,1,1,8,3
20190215-M-New_York-QF-Paolo_Lorenzi-Brayden_Schnur,1,S-XC,17,2,1,0,1,8,9
20190215-M-New_York-QF-Paolo_Lorenzi-Brayden_Schnur,1,S-DTM,4,0,0,0,0,3,1
20190215-M-New_York-QF-Paolo_Lorenzi-Brayden_Schnur,1,S-DTL,2,0,0,0,0,1,1
20190215-M-New_York-QF-Paolo_Lorenzi-Brayden_Schnur,2,F-XC,38,13,3,5,5,21,17
20190215-M-New_York-QF-Paolo_Lorenzi-Brayden_Schnur,2,F-DTM,25,1,0,0,1,11,14
20190215-M-New_York-QF-Paolo_Lorenzi-Brayden_Schnur,2,F-DTL,17,8,4,2,2,8,9
20190215-M-New_York-QF-Paolo_Lorenzi-Brayden_Schnur,2,F-IO,57,21,9,6,6,25,32
20190215-M-New_York-QF-Paolo_Lorenzi-Brayden_Schnur,2,F-II,7,2,0,1,1,2,5
20190215-M-New_York-QF-Paolo_Lorenzi-Brayden_Schnur,2,B-XC,48,2,0,0,2,18,30
20190215-M-New_York-QF-Paolo_Lorenzi-Brayden_Schnur,2,B-DTM,26,2,0,0,2,11,15
20190215-M-New_York-QF-Paolo_Lorenzi-Brayden_Schnur,2,B-DTL,23,12,4,1,7,9,14
20190215-M-New_York-QF-Paolo_Lorenzi-Brayden_Schnur,2,B-IO,5,0,0,0,0,3,2
20190215-M-New_York-QF-Paolo_Lorenzi-Brayden_Schnur,2,S-XC,16,2,0,0,2,7,9
20190215-M-New_York-QF-Paolo_Lorenzi-Brayden_Schnur,2,S-DTM,13,0,0,0,0,5,8
20190215-M-New_York-QF-Paolo_Lorenzi-Brayden_Schnur,2,S-DTL,9,2,0,0,2,2,7
20190215-M-New_York-QF-Paolo_Lorenzi-Brayden_Schnur,2,S-IO,1,0,0,0,0,0,1
20190214-M-Rotterdam-R16-Marton_Fucsovics-Nikoloz_Basilashvili,1,F-XC,29,5,2,2,1,18,11
20190214-M-Rotterdam-R16-Marton_Fucsovics-Nikoloz_Basilashvili,1,F-DTM,26,0,0,0,0,13,13
20190214-M-Rotterdam-R16-Marton_Fucsovics-Nikoloz_Basilashvili,1,F-DTL,6,4,1,0,3,1,5
20190214-M-Rotterdam-R16-Marton_Fucsovics-Nikoloz_Basilashvili,1,F-IO,15,3,1,0,2,10,5
20190214-M-Rotterdam-R16-Marton_Fucsovics-Nikoloz_Basilashvili,1,F-II,2,1,1,0,0,1,1
20190214-M-Rotterdam-R16-Marton_Fucsovics-Nikoloz_Basilashvili,1,B-XC,19,0,0,0,0,15,4
20190214-M-Rotterdam-R16-Marton_Fucsovics-Nikoloz_Basilashvili,1,B-DTM,40,1,0,0,1,21,19
20190214-M-Rotterdam-R16-Marton_Fucsovics-Nikoloz_Basilashvili,1,B-DTL,5,3,2,0,1,3,2
20190214-M-Rotterdam-R16-Marton_Fucsovics-Nikoloz_Basilashvili,1,B-IO,4,3,0,0,3,0,4
20190214-M-Rotterdam-R16-Marton_Fucsovics-Nikoloz_Basilashvili,1,S-XC,14,0,0,0,0,8,6
20190214-M-Rotterdam-R16-Marton_Fucsovics-Nikoloz_Basilashvili,1,S-DTM,6,0,0,0,0,2,4
20190214-M-Rotterdam-R16-Marton_Fucsovics-Nikoloz_Basilashvili,1,S-DTL,2,0,0,0,0,2,0
20190214-M-Rotterdam-R16-Marton_Fucsovics-Nikoloz_Basilashvili,2,F-XC,45,16,5,3,8,25,20
20190214-M-Rotterdam-R16-Marton_Fucsovics-Nikoloz_Basilashvili,2,F-DTM,38,4,0,1,3,19,19
20190214-M-Rotterdam-R16-Marton_Fucsovics-Nikoloz_Basilashvili,2,F-DTL,11,4,2,1,1,4,7
20190214-M-Rotterdam-R16-Marton_Fucsovics-Nikoloz_Basilashvili,2,F-IO,40,11,2,0,9,16,24
20190214-M-Rotterdam-R16-Marton_Fucsovics-Nikoloz_Basilashvili,2,F-II,3,3,1,0,2,1,2
20190214-M-Rotterdam-R16-Marton_Fucsovics-Nikoloz_Basilashvili,2,B-XC,30,7,0,2,5,7,23
20190214-M-Rotterdam-R16-Marton_Fucsovics-Nikoloz_Basilashvili,2,B-DTM,13,2,0,0,2,5,8
20190214-M-Rotterdam-R16-Marton_Fucsovics-Nikoloz_Basilashvili,2,B-DTL,6,3,1,0,2,2,4
20190214-M-Rotterdam-R16-Marton_Fucsovics-Nikoloz_Basilashvili,2,B-IO,2,0,0,0,0,1,1
20190214-M-Rotterdam-R16-Marton_Fucsovics-Nikoloz_Basilashvili,2,S-XC,5,0,0,0,0,3,2
20190214-M-Rotterdam-R16-Marton_Fucsovics-Nikoloz_Basilashvili,2,S-DTM,2,0,0,0,0,1,1
20190217-M-Rotterdam-F-Stanislas_Wawrinka-Gael_Monfils,1,F-XC,44,10,4,1,5,21,23
20190217-M-Rotterdam-F-Stanislas_Wawrinka-Gael_Monfils,1,F-DTM,35,4,0,0,4,12,23
20190217-M-Rotterdam-F-Stanislas_Wawrinka-Gael_Monfils,1,F-DTL,17,5,2,0,3,9,8
20190217-M-Rotterdam-F-Stanislas_Wawrinka-Gael_Monfils,1,F-IO,34,6,4,0,2,17,17
20190217-M-Rotterdam-F-Stanislas_Wawrinka-Gael_Monfils,1,F-II,5,3,3,0,0,3,2
20190217-M-Rotterdam-F-Stanislas_Wawrinka-Gael_Monfils,1,B-XC,101,15,3,4,8,43,58
20190217-M-Rotterdam-F-Stanislas_Wawrinka-Gael_Monfils,1,B-DTM,32,2,0,0,2,16,16
20190217-M-Rotterdam-F-Stanislas_Wawrinka-Gael_Monfils,1,B-DTL,13,8,2,1,5,5,8
20190217-M-Rotterdam-F-Stanislas_Wawrinka-Gael_Monfils,1,B-IO,1,0,0,0,0,1,0
20190217-M-Rotterdam-F-Stanislas_Wawrinka-Gael_Monfils,1,S-XC,18,1,0,1,0,12,6
20190217-M-Rotterdam-F-Stanislas_Wawrinka-Gael_Monfils,1,S-DTM,4,0,0,0,0,0,4
20190217-M-Rotterdam-F-Stanislas_Wawrinka-Gael_Monfils,1,S-DTL,2,1,0,1,0,2,0
20190217-M-Rotterdam-F-Stanislas_Wawrinka-Gael_Monfils,2,F-XC,49,7,0,2,5,26,23
20190217-M-Rotterdam-F-Stanislas_Wawrinka-Gael_Monfils,2,F-DTM,39,1,0,0,1,13,26
20190217-M-Rotterdam-F-Stanislas_Wawrinka-Gael_Monfils,2,F-DTL,5,2,1,0,1,3,2
20190217-M-Rotterdam-F-Stanislas_Wawrinka-Gael_Monfils,2,F-IO,23,4,2,1,1,10,13
20190217-M-Rotterdam-F-Stanislas_Wawrinka-Gael_Monfils,2,F-II,2,2,0,2,0,2,0
20190217-M-Rotterdam-F-Stanislas_Wawrinka-Gael_Monfils,2,B-XC,90,6,0,2,4,54,36
20190217-M-Rotterdam-F-Stanislas_Wawrinka-Gael_Monfils,2,B-DTM,48,1,0,0,1,29,19
20190217-M-Rotterdam-F-Stanislas_Wawrinka-Gael_Monfils,2,B-DTL,15,8,2,0,6,7,8
20190217-M-Rotterdam-F-Stanislas_Wawrinka-Gael_Monfils,2,B-IO,3,1,0,0,1,2,1
20190217-M-Rotterdam-F-Stanislas_Wawrinka-Gael_Monfils,2,S-XC,2,0,0,0,0,0,2
20190217-M-Rotterdam-F-Stanislas_Wawrinka-Gael_Monfils,2,S-DTM,11,2,1,1,0,7,4
20190217-M-Rotterdam-F-Stanislas_Wawrinka-Gael_Monfils,2,S-DTL,1,0,0,0,0,0,1
20190217-M-Rotterdam-F-Stanislas_Wawrinka-Gael_Monfils,2,S-IO,1,1,1,0,0,1,0
20190214-M-Rotterdam-R16-Jo_Wilfried_Tsonga-Tallon_Griekspoor,1,F-XC,25,8,3,3,2,12,13
20190214-M-Rotterdam-R16-Jo_Wilfried_Tsonga-Tallon_Griekspoor,1,F-DTM,8,2,0,0,2,2,6
20190214-M-Rotterdam-R16-Jo_Wilfried_Tsonga-Tallon_Griekspoor,1,F-DTL,6,5,2,1,2,4,2
20190214-M-Rotterdam-R16-Jo_Wilfried_Tsonga-Tallon_Griekspoor,1,F-IO,21,8,2,4,2,11,10
20190214-M-Rotterdam-R16-Jo_Wilfried_Tsonga-Tallon_Griekspoor,1,F-II,2,2,0,2,0,2,0
20190214-M-Rotterdam-R16-Jo_Wilfried_Tsonga-Tallon_Griekspoor,1,B-XC,8,3,2,1,0,3,5
20190214-M-Rotterdam-R16-Jo_Wilfried_Tsonga-Tallon_Griekspoor,1,B-DTM,11,1,0,0,1,1,10
20190214-M-Rotterdam-R16-Jo_Wilfried_Tsonga-Tallon_Griekspoor,1,B-DTL,2,1,0,0,1,1,1
20190214-M-Rotterdam-R16-Jo_Wilfried_Tsonga-Tallon_Griekspoor,1,B-IO,1,1,1,0,0,1,0
20190214-M-Rotterdam-R16-Jo_Wilfried_Tsonga-Tallon_Griekspoor,1,S-XC,7,1,0,0,1,3,4
20190214-M-Rotterdam-R16-Jo_Wilfried_Tsonga-Tallon_Griekspoor,1,S-DTM,5,0,0,0,0,3,2
20190214-M-Rotterdam-R16-Jo_Wilfried_Tsonga-Tallon_Griekspoor,1,S-DTL,1,0,0,0,0,1,0
20190214-M-Rotterdam-R16-Jo_Wilfried_Tsonga-Tallon_Griekspoor,2,F-XC,26,9,5,2,2,17,9
20190214-M-Rotterdam-R16-Jo_Wilfried_Tsonga-Tallon_Griekspoor,2,F-DTM,12,1,0,0,1,6,6
20190214-M-Rotterdam-R16-Jo_Wilfried_Tsonga-Tallon_Griekspoor,2,F-DTL,5,1,0,1,0,3,2
20190214-M-Rotterdam-R16-Jo_Wilfried_Tsonga-Tallon_Griekspoor,2,F-IO,16,7,2,1,4,8,8
20190214-M-Rotterdam-R16-Jo_Wilfried_Tsonga-Tallon_Griekspoor,2,F-II,6,4,1,0,3,3,3
20190214-M-Rotterdam-R16-Jo_Wilfried_Tsonga-Tallon_Griekspoor,2,B-XC,8,2,1,1,0,6,2
20190214-M-Rotterdam-R16-Jo_Wilfried_Tsonga-Tallon_Griekspoor,2,B-DTM,4,0,0,0,0,4,0
20190214-M-Rotterdam-R16-Jo_Wilfried_Tsonga-Tallon_Griekspoor,2,B-DTL,3,2,1,1,0,2,1
20190214-M-Rotterdam-R16-Jo_Wilfried_Tsonga-Tallon_Griekspoor,2,S-XC,8,0,0,0,0,5,3
20190214-M-Rotterdam-R16-Jo_Wilfried_Tsonga-Tallon_Griekspoor,2,S-DTM,3,0,0,0,0,3,0
20190214-M-Rotterdam-R16-Jo_Wilfried_Tsonga-Tallon_Griekspoor,2,S-DTL,2,1,1,0,0,1,1
20020126-M-Australian_Open-SF-Tommy_Haas-Marat_Safin,1,F-XC,67,16,4,7,5,35,32
20020126-M-Australian_Open-SF-Tommy_Haas-Marat_Safin,1,F-DTM,10,1,0,0,1,3,7
20020126-M-Australian_Open-SF-Tommy_Haas-Marat_Safin,1,F-DTL,20,5,1,0,4,9,11
20020126-M-Australian_Open-SF-Tommy_Haas-Marat_Safin,1,F-IO,28,8,3,4,1,17,11
20020126-M-Australian_Open-SF-Tommy_Haas-Marat_Safin,1,F-II,6,4,1,2,1,4,2
20020126-M-Australian_Open-SF-Tommy_Haas-Marat_Safin,1,B-XC,74,11,4,2,5,42,32
20020126-M-Australian_Open-SF-Tommy_Haas-Marat_Safin,1,B-DTM,29,7,0,4,3,14,15
20020126-M-Australian_Open-SF-Tommy_Haas-Marat_Safin,1,B-DTL,27,16,6,2,8,12,15
20020126-M-Australian_Open-SF-Tommy_Haas-Marat_Safin,1,B-IO,9,5,0,2,3,3,6
20020126-M-Australian_Open-SF-Tommy_Haas-Marat_Safin,1,S-XC,53,4,0,0,4,21,32
20020126-M-Australian_Open-SF-Tommy_Haas-Marat_Safin,1,S-DTM,14,0,0,0,0,6,8
20020126-M-Australian_Open-SF-Tommy_Haas-Marat_Safin,1,S-DTL,9,1,1,0,0,5,4
20020126-M-Australian_Open-SF-Tommy_Haas-Marat_Safin,2,F-XC,52,11,3,6,2,33,19
20020126-M-Australian_Open-SF-Tommy_Haas-Marat_Safin,2,F-DTM,21,1,0,0,1,9,12
20020126-M-Australian_Open-SF-Tommy_Haas-Marat_Safin,2,F-DTL,31,9,2,3,4,17,14
20020126-M-Australian_Open-SF-Tommy_Haas-Marat_Safin,2,F-IO,26,4,1,2,1,19,7
20020126-M-Australian_Open-SF-Tommy_Haas-Marat_Safin,2,F-II,4,1,0,1,0,2,2
20020126-M-Australian_Open-SF-Tommy_Haas-Marat_Safin,2,B-XC,121,14,5,2,7,60,61
20020126-M-Australian_Open-SF-Tommy_Haas-Marat_Safin,2,B-DTM,20,5,0,0,5,4,16
20020126-M-Australian_Open-SF-Tommy_Haas-Marat_Safin,2,B-DTL,14,12,4,4,4,9,5
20020126-M-Australian_Open-SF-Tommy_Haas-Marat_Safin,2,B-IO,3,2,0,1,1,2,1
20020126-M-Australian_Open-SF-Tommy_Haas-Marat_Safin,2,S-XC,12,3,0,1,2,4,8
20020126-M-Australian_Open-SF-Tommy_Haas-Marat_Safin,2,S-DTM,6,0,0,0,0,3,3
20020126-M-Australian_Open-SF-Tommy_Haas-Marat_Safin,2,S-DTL,6,0,0,0,0,3,3
20020126-M-Australian_Open-SF-Tommy_Haas-Marat_Safin,2,S-IO,1,1,0,0,1,0,1
20190208-M-Sofia-QF-Stefanos_Tsitsipas-Gael_Monfils,1,F-XC,31,10,1,5,4,17,14
20190208-M-Sofia-QF-Stefanos_Tsitsipas-Gael_Monfils,1,F-DTM,16,1,0,1,0,6,10
20190208-M-Sofia-QF-Stefanos_Tsitsipas-Gael_Monfils,1,F-DTL,11,4,0,3,1,5,6
20190208-M-Sofia-QF-Stefanos_Tsitsipas-Gael_Monfils,1,F-IO,24,8,1,4,3,16,8
20190208-M-Sofia-QF-Stefanos_Tsitsipas-Gael_Monfils,1,F-II,4,2,1,0,1,2,2
20190208-M-Sofia-QF-Stefanos_Tsitsipas-Gael_Monfils,1,B-XC,16,3,0,1,2,3,13
20190208-M-Sofia-QF-Stefanos_Tsitsipas-Gael_Monfils,1,B-DTM,12,2,0,0,2,4,8
20190208-M-Sofia-QF-Stefanos_Tsitsipas-Gael_Monfils,1,B-DTL,3,2,0,0,2,0,3
20190208-M-Sofia-QF-Stefanos_Tsitsipas-Gael_Monfils,1,S-XC,10,2,0,1,1,2,8
20190208-M-Sofia-QF-Stefanos_Tsitsipas-Gael_Monfils,1,S-DTM,5,0,0,0,0,2,3
20190208-M-Sofia-QF-Stefanos_Tsitsipas-Gael_Monfils,2,F-XC,23,10,3,2,5,13,10
20190208-M-Sofia-QF-Stefanos_Tsitsipas-Gael_Monfils,2,F-DTM,16,1,0,0,1,7,9
20190208-M-Sofia-QF-Stefanos_Tsitsipas-Gael_Monfils,2,F-DTL,7,3,1,1,1,4,3
20190208-M-Sofia-QF-Stefanos_Tsitsipas-Gael_Monfils,2,F-IO,17,7,3,2,2,13,4
20190208-M-Sofia-QF-Stefanos_Tsitsipas-Gael_Monfils,2,F-II,2,2,1,0,1,1,1
20190208-M-Sofia-QF-Stefanos_Tsitsipas-Gael_Monfils,2,B-XC,29,3,1,2,0,22,7
20190208-M-Sofia-QF-Stefanos_Tsitsipas-Gael_Monfils,2,B-DTM,15,1,0,1,0,7,8
20190208-M-Sofia-QF-Stefanos_Tsitsipas-Gael_Monfils,2,B-DTL,9,4,2,1,1,5,4
20190208-M-Sofia-QF-Stefanos_Tsitsipas-Gael_Monfils,2,B-IO,1,0,0,0,0,0,1
20190208-M-Sofia-QF-Stefanos_Tsitsipas-Gael_Monfils,2,S-XC,2,0,0,0,0,2,0
20190208-M-Sofia-QF-Stefanos_Tsitsipas-Gael_Monfils,2,S-DTM,1,0,0,0,0,0,1
20190208-M-Sofia-QF-Stefanos_Tsitsipas-Gael_Monfils,2,S-IO,1,1,1,0,0,1,0
20040709-M-Gstaad-QF-Roger_Federer-Radek_Stepanek,1,F-XC,29,11,3,3,5,15,14
20040709-M-Gstaad-QF-Roger_Federer-Radek_Stepanek,1,F-DTM,6,2,0,0,2,1,5
20040709-M-Gstaad-QF-Roger_Federer-Radek_Stepanek,1,F-DTL,9,6,3,2,1,7,2
20040709-M-Gstaad-QF-Roger_Federer-Radek_Stepanek,1,F-IO,16,6,1,3,2,9,7
20040709-M-Gstaad-QF-Roger_Federer-Radek_Stepanek,1,F-II,7,4,2,0,2,4,3
20040709-M-Gstaad-QF-Roger_Federer-Radek_Stepanek,1,B-XC,29,6,3,1,2,19,10
20040709-M-Gstaad-QF-Roger_Federer-Radek_Stepanek,1,B-DTM,8,3,0,3,0,7,1
20040709-M-Gstaad-QF-Roger_Federer-Radek_Stepanek,1,B-DTL,10,6,4,0,2,5,5
20040709-M-Gstaad-QF-Roger_Federer-Radek_Stepanek,1,B-IO,1,0,0,0,0,1,0
20040709-M-Gstaad-QF-Roger_Federer-Radek_Stepanek,1,S-XC,5,0,0,0,0,2,3
20040709-M-Gstaad-QF-Roger_Federer-Radek_Stepanek,1,S-DTM,2,0,0,0,0,1,1
20040709-M-Gstaad-QF-Roger_Federer-Radek_Stepanek,1,S-DTL,3,0,0,0,0,0,3
20040709-M-Gstaad-QF-Roger_Federer-Radek_Stepanek,1,S-IO,1,0,0,0,0,0,1
20040709-M-Gstaad-QF-Roger_Federer-Radek_Stepanek,2,F-XC,14,3,1,0,2,6,8
20040709-M-Gstaad-QF-Roger_Federer-Radek_Stepanek,2,F-DTM,6,1,0,0,1,4,2
20040709-M-Gstaad-QF-Roger_Federer-Radek_Stepanek,2,F-DTL,14,4,1,0,3,5,9
20040709-M-Gstaad-QF-Roger_Federer-Radek_Stepanek,2,F-IO,9,3,1,0,2,2,7
20040709-M-Gstaad-QF-Roger_Federer-Radek_Stepanek,2,B-XC,27,5,2,1,2,11,16
20040709-M-Gstaad-QF-Roger_Federer-Radek_Stepanek,2,B-DTM,7,0,0,0,0,4,3
20040709-M-Gstaad-QF-Roger_Federer-Radek_Stepanek,2,B-DTL,10,2,1,1,0,3,7
20040709-M-Gstaad-QF-Roger_Federer-Radek_Stepanek,2,B-IO,3,0,0,0,0,2,1
20040709-M-Gstaad-QF-Roger_Federer-Radek_Stepanek,2,S-XC,5,1,0,1,0,4,1
20040709-M-Gstaad-QF-Roger_Federer-Radek_Stepanek,2,S-DTM,2,0,0,0,0,0,2
20040709-M-Gstaad-QF-Roger_Federer-Radek_Stepanek,2,S-DTL,1,0,0,0,0,1,0
20190216-M-Buenos_Aires-SF-Marco_Cecchinato-Guido_Pella,1,F-XC,48,7,1,3,3,30,18
20190216-M-Buenos_Aires-SF-Marco_Cecchinato-Guido_Pella,1,F-DTM,13,2,0,1,1,8,5
20190216-M-Buenos_Aires-SF-Marco_Cecchinato-Guido_Pella,1,F-DTL,9,4,2,1,1,6,3
20190216-M-Buenos_Aires-SF-Marco_Cecchinato-Guido_Pella,1,F-IO,18,8,3,3,2,10,8
20190216-M-Buenos_Aires-SF-Marco_Cecchinato-Guido_Pella,1,F-II,2,0,0,0,0,2,0
20190216-M-Buenos_Aires-SF-Marco_Cecchinato-Guido_Pella,1,B-XC,13,2,0,0,2,2,11
20190216-M-Buenos_Aires-SF-Marco_Cecchinato-Guido_Pella,1,B-DTM,7,0,0,0,0,2,5
20190216-M-Buenos_Aires-SF-Marco_Cecchinato-Guido_Pella,1,B-DTL,9,2,0,2,0,7,2
20190216-M-Buenos_Aires-SF-Marco_Cecchinato-Guido_Pella,1,B-IO,3,0,0,0,0,1,2
20190216-M-Buenos_Aires-SF-Marco_Cecchinato-Guido_Pella,1,S-XC,9,1,0,0,1,6,3
20190216-M-Buenos_Aires-SF-Marco_Cecchinato-Guido_Pella,1,S-DTM,3,0,0,0,0,1,2
20190216-M-Buenos_Aires-SF-Marco_Cecchinato-Guido_Pella,2,F-XC,37,5,2,1,2,22,15
20190216-M-Buenos_Aires-SF-Marco_Cecchinato-Guido_Pella,2,F-DTM,14,0,0,0,0,5,9
20190216-M-Buenos_Aires-SF-Marco_Cecchinato-Guido_Pella,2,F-DTL,8,5,3,1,1,5,3
20190216-M-Buenos_Aires-SF-Marco_Cecchinato-Guido_Pella,2,F-IO,12,2,0,1,1,5,7
20190216-M-Buenos_Aires-SF-Marco_Cecchinato-Guido_Pella,2,F-II,6,2,0,1,1,3,3
20190216-M-Buenos_Aires-SF-Marco_Cecchinato-Guido_Pella,2,B-XC,29,7,0,2,5,7,22
20190216-M-Buenos_Aires-SF-Marco_Cecchinato-Guido_Pella,2,B-DTM,14,1,0,0,1,7,7
20190216-M-Buenos_Aires-SF-Marco_Cecchinato-Guido_Pella,2,B-DTL,4,3,1,0,2,2,2
20190216-M-Buenos_Aires-SF-Marco_Cecchinato-Guido_Pella,2,S-XC,5,0,0,0,0,2,3
20190216-M-Buenos_Aires-SF-Marco_Cecchinato-Guido_Pella,2,S-DTM,4,1,0,0,1,3,1
20190216-M-Buenos_Aires-SF-Marco_Cecchinato-Guido_Pella,2,S-DTL,3,0,0,0,0,2,1
20190214-M-New_York-R16-Jason_Jung-Francis_Tiafoe,1,F-XC,30,6,2,3,1,23,7
20190214-M-New_York-R16-Jason_Jung-Francis_Tiafoe,1,F-DTM,29,0,0,0,0,18,11
20190214-M-New_York-R16-Jason_Jung-Francis_Tiafoe,1,F-DTL,9,2,2,0,0,5,4
20190214-M-New_York-R16-Jason_Jung-Francis_Tiafoe,1,F-IO,30,4,0,1,3,14,16
20190214-M-New_York-R16-Jason_Jung-Francis_Tiafoe,1,F-II,4,3,0,1,2,1,3
20190214-M-New_York-R16-Jason_Jung-Francis_Tiafoe,1,B-XC,66,8,1,3,4,32,34
20190214-M-New_York-R16-Jason_Jung-Francis_Tiafoe,1,B-DTM,28,4,0,1,3,12,16
20190214-M-New_York-R16-Jason_Jung-Francis_Tiafoe,1,B-DTL,3,1,0,1,0,3,0
20190214-M-New_York-R16-Jason_Jung-Francis_Tiafoe,1,S-XC,19,3,0,0,3,10,9
20190214-M-New_York-R16-Jason_Jung-Francis_Tiafoe,1,S-DTM,2,0,0,0,0,0,2
20190214-M-New_York-R16-Jason_Jung-Francis_Tiafoe,1,S-DTL,3,1,0,0,1,2,1
20190214-M-New_York-R16-Jason_Jung-Francis_Tiafoe,2,F-XC,44,11,2,5,4,21,23
20190214-M-New_York-R16-Jason_Jung-Francis_Tiafoe,2,F-DTM,12,1,0,0,1,6,6
20190214-M-New_York-R16-Jason_Jung-Francis_Tiafoe,2,F-DTL,7,1,0,0,1,1,6
20190214-M-New_York-R16-Jason_Jung-Francis_Tiafoe,2,F-IO,21,6,2,1,3,12,9
20190214-M-New_York-R16-Jason_Jung-Francis_Tiafoe,2,F-II,4,2,0,1,1,1,3
20190214-M-New_York-R16-Jason_Jung-Francis_Tiafoe,2,B-XC,84,6,1,2,3,50,34
20190214-M-New_York-R16-Jason_Jung-Francis_Tiafoe,2,B-DTM,22,3,0,0,3,4,18
20190214-M-New_York-R16-Jason_Jung-Francis_Tiafoe,2,B-DTL,9,4,1,2,1,5,4
20190214-M-New_York-R16-Jason_Jung-Francis_Tiafoe,2,B-IO,3,0,0,0,0,1,2
20190214-M-New_York-R16-Jason_Jung-Francis_Tiafoe,2,S-XC,26,4,0,0,4,12,14
20190214-M-New_York-R16-Jason_Jung-Francis_Tiafoe,2,S-DTM,5,0,0,0,0,2,3
20190214-M-New_York-R16-Jason_Jung-Francis_Tiafoe,2,S-DTL,2,0,0,0,0,1,1
20000708-M-Wimbledon-SF-Pete_Sampras-Vladimir_Voltchkov,1,F-XC,14,6,3,2,1,7,7
20000708-M-Wimbledon-SF-Pete_Sampras-Vladimir_Voltchkov,1,F-DTM,4,1,0,0,1,3,1
20000708-M-Wimbledon-SF-Pete_Sampras-Vladimir_Voltchkov,1,F-DTL,7,5,3,1,1,6,1
20000708-M-Wimbledon-SF-Pete_Sampras-Vladimir_Voltchkov,1,F-IO,9,4,1,2,1,7,2
20000708-M-Wimbledon-SF-Pete_Sampras-Vladimir_Voltchkov,1,F-II,2,2,0,1,1,1,1
20000708-M-Wimbledon-SF-Pete_Sampras-Vladimir_Voltchkov,1,B-XC,8,2,1,0,1,3,5
20000708-M-Wimbledon-SF-Pete_Sampras-Vladimir_Voltchkov,1,B-DTM,4,1,0,0,1,2,2
20000708-M-Wimbledon-SF-Pete_Sampras-Vladimir_Voltchkov,1,S-XC,10,0,0,0,0,4,6
20000708-M-Wimbledon-SF-Pete_Sampras-Vladimir_Voltchkov,1,S-DTM,2,0,0,0,0,0,2
20000708-M-Wimbledon-SF-Pete_Sampras-Vladimir_Voltchkov,1,S-DTL,5,2,0,2,0,4,1
20000708-M-Wimbledon-SF-Pete_Sampras-Vladimir_Voltchkov,1,S-II,1,0,0,0,0,0,1
20000708-M-Wimbledon-SF-Pete_Sampras-Vladimir_Voltchkov,2,F-XC,13,3,1,1,1,6,7
20000708-M-Wimbledon-SF-Pete_Sampras-Vladimir_Voltchkov,2,F-DTM,5,0,0,0,0,2,3
20000708-M-Wimbledon-SF-Pete_Sampras-Vladimir_Voltchkov,2,F-DTL,5,2,1,1,0,5,0
20000708-M-Wimbledon-SF-Pete_Sampras-Vladimir_Voltchkov,2,F-IO,19,9,3,1,5,9,10
20000708-M-Wimbledon-SF-Pete_Sampras-Vladimir_Voltchkov,2,F-II,5,3,2,0,1,4,1
20000708-M-Wimbledon-SF-Pete_Sampras-Vladimir_Voltchkov,2,B-XC,12,3,1,0,2,6,6
20000708-M-Wimbledon-SF-Pete_Sampras-Vladimir_Voltchkov,2,B-DTM,5,0,0,0,0,1,4
20000708-M-Wimbledon-SF-Pete_Sampras-Vladimir_Voltchkov,2,B-DTL,4,2,1,0,1,2,2
20000708-M-Wimbledon-SF-Pete_Sampras-Vladimir_Voltchkov,2,S-XC,4,0,0,0,0,2,2
20000708-M-Wimbledon-SF-Pete_Sampras-Vladimir_Voltchkov,2,S-DTM,2,0,0,0,0,0,2
20000708-M-Wimbledon-SF-Pete_Sampras-Vladimir_Voltchkov,2,S-DTL,5,1,0,1,0,3,2
20000708-M-Wimbledon-SF-Pete_Sampras-Vladimir_Voltchkov,2,S-IO,2,1,0,0,1,0,2
20190219-M-Bergamo_CH-R32-Elliot_Benchetrit-Tallon_Griekspoor,1,F-XC,14,5,0,2,3,5,9
20190219-M-Bergamo_CH-R32-Elliot_Benchetrit-Tallon_Griekspoor,1,F-DTM,11,1,0,0,1,7,4
20190219-M-Bergamo_CH-R32-Elliot_Benchetrit-Tallon_Griekspoor,1,F-DTL,1,0,0,0,0,0,1
20190219-M-Bergamo_CH-R32-Elliot_Benchetrit-Tallon_Griekspoor,1,F-IO,8,4,2,1,1,6,2
20190219-M-Bergamo_CH-R32-Elliot_Benchetrit-Tallon_Griekspoor,1,B-XC,12,5,1,1,3,5,7
20190219-M-Bergamo_CH-R32-Elliot_Benchetrit-Tallon_Griekspoor,1,B-DTM,6,2,0,1,1,2,4
20190219-M-Bergamo_CH-R32-Elliot_Benchetrit-Tallon_Griekspoor,1,B-DTL,3,3,2,0,1,2,1
20190219-M-Bergamo_CH-R32-Elliot_Benchetrit-Tallon_Griekspoor,1,B-IO,2,2,0,1,1,1,1
20190219-M-Bergamo_CH-R32-Elliot_Benchetrit-Tallon_Griekspoor,1,S-XC,10,1,0,0,1,6,4
20190219-M-Bergamo_CH-R32-Elliot_Benchetrit-Tallon_Griekspoor,1,S-DTM,8,1,0,0,1,4,4
20190219-M-Bergamo_CH-R32-Elliot_Benchetrit-Tallon_Griekspoor,1,S-DTL,3,2,1,0,1,2,1
20190219-M-Bergamo_CH-R32-Elliot_Benchetrit-Tallon_Griekspoor,2,F-XC,17,8,1,2,5,10,7
20190219-M-Bergamo_CH-R32-Elliot_Benchetrit-Tallon_Griekspoor,2,F-DTM,10,2,0,0,2,4,6
20190219-M-Bergamo_CH-R32-Elliot_Benchetrit-Tallon_Griekspoor,2,F-DTL,6,1,0,0,1,4,2
20190219-M-Bergamo_CH-R32-Elliot_Benchetrit-Tallon_Griekspoor,2,F-IO,16,3,1,1,1,7,9
20190219-M-Bergamo_CH-R32-Elliot_Benchetrit-Tallon_Griekspoor,2,F-II,4,2,2,0,0,3,1
20190219-M-Bergamo_CH-R32-Elliot_Benchetrit-Tallon_Griekspoor,2,B-XC,14,4,0,1,3,7,7
20190219-M-Bergamo_CH-R32-Elliot_Benchetrit-Tallon_Griekspoor,2,B-DTM,7,3,0,0,3,2,5
20190219-M-Bergamo_CH-R32-Elliot_Benchetrit-Tallon_Griekspoor,2,B-DTL,1,1,1,0,0,1,0
20190219-M-Bergamo_CH-R32-Elliot_Benchetrit-Tallon_Griekspoor,2,S-XC,7,1,0,0,1,1,6
20190219-M-Bergamo_CH-R32-Elliot_Benchetrit-Tallon_Griekspoor,2,S-DTM,1,0,0,0,0,0,1
20190219-M-Rio_de_Janeiro-R32-Thiago_Monteiro-Pedro_Sousa,1,F-XC,42,7,0,4,3,27,15
20190219-M-Rio_de_Janeiro-R32-Thiago_Monteiro-Pedro_Sousa,1,F-DTM,11,1,0,1,0,5,6
20190219-M-Rio_de_Janeiro-R32-Thiago_Monteiro-Pedro_Sousa,1,F-DTL,3,1,0,0,1,1,2
20190219-M-Rio_de_Janeiro-R32-Thiago_Monteiro-Pedro_Sousa,1,F-IO,19,7,2,3,2,13,6
20190219-M-Rio_de_Janeiro-R32-Thiago_Monteiro-Pedro_Sousa,1,F-II,5,2,0,2,0,4,1
20190219-M-Rio_de_Janeiro-R32-Thiago_Monteiro-Pedro_Sousa,1,B-XC,31,3,0,1,2,14,17
20190219-M-Rio_de_Janeiro-R32-Thiago_Monteiro-Pedro_Sousa,1,B-DTM,15,1,0,0,1,6,9
20190219-M-Rio_de_Janeiro-R32-Thiago_Monteiro-Pedro_Sousa,1,B-DTL,5,1,0,1,0,4,1
20190219-M-Rio_de_Janeiro-R32-Thiago_Monteiro-Pedro_Sousa,1,S-XC,4,0,0,0,0,3,1
20190219-M-Rio_de_Janeiro-R32-Thiago_Monteiro-Pedro_Sousa,1,S-DTM,1,0,0,0,0,0,1
20190219-M-Rio_de_Janeiro-R32-Thiago_Monteiro-Pedro_Sousa,1,S-DTL,1,1,1,0,0,1,0
20190219-M-Rio_de_Janeiro-R32-Thiago_Monteiro-Pedro_Sousa,2,F-XC,45,6,1,3,2,19,26
20190219-M-Rio_de_Janeiro-R32-Thiago_Monteiro-Pedro_Sousa,2,F-DTM,11,2,0,0,2,2,9
20190219-M-Rio_de_Janeiro-R32-Thiago_Monteiro-Pedro_Sousa,2,F-DTL,13,4,2,0,2,6,7
20190219-M-Rio_de_Janeiro-R32-Thiago_Monteiro-Pedro_Sousa,2,F-IO,6,3,3,0,0,5,1
20190219-M-Rio_de_Janeiro-R32-Thiago_Monteiro-Pedro_Sousa,2,B-XC,25,10,4,1,5,16,9
20190219-M-Rio_de_Janeiro-R32-Thiago_Monteiro-Pedro_Sousa,2,B-DTM,19,2,1,0,1,5,14
20190219-M-Rio_de_Janeiro-R32-Thiago_Monteiro-Pedro_Sousa,2,B-DTL,11,5,0,1,4,4,7
20190219-M-Rio_de_Janeiro-R32-Thiago_Monteiro-Pedro_Sousa,2,B-IO,6,1,0,1,0,3,3
20190219-M-Rio_de_Janeiro-R32-Thiago_Monteiro-Pedro_Sousa,2,S-XC,2,0,0,0,0,0,2
20190219-M-Rio_de_Janeiro-R32-Thiago_Monteiro-Pedro_Sousa,2,S-DTM,2,0,0,0,0,0,2
20190219-M-Rio_de_Janeiro-R32-Thiago_Monteiro-Pedro_Sousa,2,S-DTL,1,1,0,0,1,0,1
20190216-M-Rotterdam-SF-Stanislas_Wawrinka-Kei_Nishikori,1,F-XC,42,12,7,2,3,23,19
20190216-M-Rotterdam-SF-Stanislas_Wawrinka-Kei_Nishikori,1,F-DTM,14,2,0,0,2,7,7
20190216-M-Rotterdam-SF-Stanislas_Wawrinka-Kei_Nishikori,1,F-DTL,14,8,5,0,3,7,7
20190216-M-Rotterdam-SF-Stanislas_Wawrinka-Kei_Nishikori,1,F-IO,22,10,3,5,2,14,8
20190216-M-Rotterdam-SF-Stanislas_Wawrinka-Kei_Nishikori,1,F-II,4,0,0,0,0,2,2
20190216-M-Rotterdam-SF-Stanislas_Wawrinka-Kei_Nishikori,1,B-XC,72,18,3,4,11,29,43
20190216-M-Rotterdam-SF-Stanislas_Wawrinka-Kei_Nishikori,1,B-DTM,20,1,0,0,1,7,13
20190216-M-Rotterdam-SF-Stanislas_Wawrinka-Kei_Nishikori,1,B-DTL,18,12,4,1,7,8,10
20190216-M-Rotterdam-SF-Stanislas_Wawrinka-Kei_Nishikori,1,B-IO,4,3,0,1,2,1,3
20190216-M-Rotterdam-SF-Stanislas_Wawrinka-Kei_Nishikori,1,S-XC,28,0,0,0,0,8,20
20190216-M-Rotterdam-SF-Stanislas_Wawrinka-Kei_Nishikori,1,S-DTM,3,0,0,0,0,1,2
20190216-M-Rotterdam-SF-Stanislas_Wawrinka-Kei_Nishikori,1,S-DTL,3,1,0,0,1,1,2
20190216-M-Rotterdam-SF-Stanislas_Wawrinka-Kei_Nishikori,2,F-XC,50,17,3,4,10,25,25
20190216-M-Rotterdam-SF-Stanislas_Wawrinka-Kei_Nishikori,2,F-DTM,16,1,0,0,1,9,7
20190216-M-Rotterdam-SF-Stanislas_Wawrinka-Kei_Nishikori,2,F-DTL,14,4,1,1,2,9,5
20190216-M-Rotterdam-SF-Stanislas_Wawrinka-Kei_Nishikori,2,F-IO,26,7,2,2,3,16,10
20190216-M-Rotterdam-SF-Stanislas_Wawrinka-Kei_Nishikori,2,F-II,6,1,0,1,0,4,2
20190216-M-Rotterdam-SF-Stanislas_Wawrinka-Kei_Nishikori,2,B-XC,81,7,3,0,4,57,24
20190216-M-Rotterdam-SF-Stanislas_Wawrinka-Kei_Nishikori,2,B-DTM,12,0,0,0,0,5,7
20190216-M-Rotterdam-SF-Stanislas_Wawrinka-Kei_Nishikori,2,B-DTL,19,8,1,3,4,12,7
20190216-M-Rotterdam-SF-Stanislas_Wawrinka-Kei_Nishikori,2,B-IO,4,2,0,1,1,1,3
20190216-M-Rotterdam-SF-Stanislas_Wawrinka-Kei_Nishikori,2,S-XC,7,1,0,1,0,4,3
20190216-M-Rotterdam-SF-Stanislas_Wawrinka-Kei_Nishikori,2,S-DTM,2,0,0,0,0,0,2
20190216-M-Rotterdam-SF-Stanislas_Wawrinka-Kei_Nishikori,2,S-DTL,5,1,1,0,0,2,3
20190216-M-Rotterdam-SF-Stanislas_Wawrinka-Kei_Nishikori,2,S-IO,1,0,0,0,0,0,1
20190221-M-Marseille-R16-Ugo_Humbert-Borna_Coric,1,F-XC,26,3,0,2,1,19,7
20190221-M-Marseille-R16-Ugo_Humbert-Borna_Coric,1,F-DTM,18,2,1,0,1,13,5
20190221-M-Marseille-R16-Ugo_Humbert-Borna_Coric,1,F-DTL,5,2,0,1,1,4,1
20190221-M-Marseille-R16-Ugo_Humbert-Borna_Coric,1,F-IO,14,5,1,3,1,9,5
20190221-M-Marseille-R16-Ugo_Humbert-Borna_Coric,1,F-II,2,1,1,0,0,2,0
20190221-M-Marseille-R16-Ugo_Humbert-Borna_Coric,1,B-XC,32,4,1,0,3,18,14
20190221-M-Marseille-R16-Ugo_Humbert-Borna_Coric,1,B-DTM,17,0,0,0,0,14,3
20190221-M-Marseille-R16-Ugo_Humbert-Borna_Coric,1,B-DTL,4,1,1,0,0,4,0
20190221-M-Marseille-R16-Ugo_Humbert-Borna_Coric,1,B-IO,4,1,0,0,1,2,2
20190221-M-Marseille-R16-Ugo_Humbert-Borna_Coric,1,S-XC,2,0,0,0,0,0,2
20190221-M-Marseille-R16-Ugo_Humbert-Borna_Coric,1,S-DTM,1,0,0,0,0,0,1
20190221-M-Marseille-R16-Ugo_Humbert-Borna_Coric,2,F-XC,41,8,1,0,7,15,26
20190221-M-Marseille-R16-Ugo_Humbert-Borna_Coric,2,F-DTM,16,3,0,0,3,2,14
20190221-M-Marseille-R16-Ugo_Humbert-Borna_Coric,2,F-DTL,9,5,0,2,3,4,5
20190221-M-Marseille-R16-Ugo_Humbert-Borna_Coric,2,F-IO,13,7,1,1,5,3,10
20190221-M-Marseille-R16-Ugo_Humbert-Borna_Coric,2,B-XC,24,5,2,0,3,5,19
20190221-M-Marseille-R16-Ugo_Humbert-Borna_Coric,2,B-DTM,7,0,0,0,0,2,5
20190221-M-Marseille-R16-Ugo_Humbert-Borna_Coric,2,B-DTL,6,3,0,2,1,4,2
20190221-M-Marseille-R16-Ugo_Humbert-Borna_Coric,2,B-IO,2,0,0,0,0,0,2
20190221-M-Marseille-R16-Ugo_Humbert-Borna_Coric,2,S-XC,3,0,0,0,0,0,3
20190221-M-Marseille-R16-Ugo_Humbert-Borna_Coric,2,S-DTM,5,0,0,0,0,1,4
20190221-M-Marseille-R16-Ugo_Humbert-Borna_Coric,2,S-DTL,2,0,0,0,0,1,1
20190221-M-Marseille-R16-Ugo_Humbert-Borna_Coric,2,S-IO,2,0,0,0,0,1,1
19810912-M-US_Open-SF-Jimmy_Connors-Bjorn_Borg,1,F-XC,144,18,2,6,10,67,77
19810912-M-US_Open-SF-Jimmy_Connors-Bjorn_Borg,1,F-DTM,40,1,0,0,1,19,21
19810912-M-US_Open-SF-Jimmy_Connors-Bjorn_Borg,1,F-DTL,28,12,3,7,2,21,7
19810912-M-US_Open-SF-Jimmy_Connors-Bjorn_Borg,1,F-IO,23,4,1,1,2,13,10
19810912-M-US_Open-SF-Jimmy_Connors-Bjorn_Borg,1,F-II,1,0,0,0,0,1,0
19810912-M-US_Open-SF-Jimmy_Connors-Bjorn_Borg,1,B-XC,53,12,2,6,4,25,28
19810912-M-US_Open-SF-Jimmy_Connors-Bjorn_Borg,1,B-DTM,38,0,0,0,0,23,15
19810912-M-US_Open-SF-Jimmy_Connors-Bjorn_Borg,1,B-DTL,24,4,0,2,2,12,12
19810912-M-US_Open-SF-Jimmy_Connors-Bjorn_Borg,1,B-IO,27,6,0,1,5,11,16
19810912-M-US_Open-SF-Jimmy_Connors-Bjorn_Borg,1,S-XC,9,1,0,1,0,4,5
19810912-M-US_Open-SF-Jimmy_Connors-Bjorn_Borg,1,S-DTM,5,0,0,0,0,3,2
19810912-M-US_Open-SF-Jimmy_Connors-Bjorn_Borg,1,S-DTL,1,0,0,0,0,0,1
19810912-M-US_Open-SF-Jimmy_Connors-Bjorn_Borg,1,S-IO,3,1,0,1,0,1,2
19810912-M-US_Open-SF-Jimmy_Connors-Bjorn_Borg,2,F-XC,81,6,0,4,2,43,38
19810912-M-US_Open-SF-Jimmy_Connors-Bjorn_Borg,2,F-DTM,43,1,0,0,1,15,28
19810912-M-US_Open-SF-Jimmy_Connors-Bjorn_Borg,2,F-DTL,21,7,3,4,0,16,5
19810912-M-US_Open-SF-Jimmy_Connors-Bjorn_Borg,2,F-IO,24,6,3,0,3,15,9
19810912-M-US_Open-SF-Jimmy_Connors-Bjorn_Borg,2,F-II,3,2,1,0,1,1,2
19810912-M-US_Open-SF-Jimmy_Connors-Bjorn_Borg,2,B-XC,101,11,1,6,4,55,46
19810912-M-US_Open-SF-Jimmy_Connors-Bjorn_Borg,2,B-DTM,56,2,0,0,2,24,32
19810912-M-US_Open-SF-Jimmy_Connors-Bjorn_Borg,2,B-DTL,19,7,2,4,1,11,8
19810912-M-US_Open-SF-Jimmy_Connors-Bjorn_Borg,2,B-IO,5,2,0,0,2,1,4
19810912-M-US_Open-SF-Jimmy_Connors-Bjorn_Borg,2,S-XC,15,0,0,0,0,6,9
19810912-M-US_Open-SF-Jimmy_Connors-Bjorn_Borg,2,S-DTM,13,0,0,0,0,6,7
19810912-M-US_Open-SF-Jimmy_Connors-Bjorn_Borg,2,S-DTL,8,1,0,1,0,4,4
19810912-M-US_Open-SF-Jimmy_Connors-Bjorn_Borg,2,S-IO,4,3,1,0,2,2,2
19940702-M-Wimbledon-SF-Todd_Martin-Pete_Sampras,1,F-XC,3,1,1,0,0,1,2
19940702-M-Wimbledon-SF-Todd_Martin-Pete_Sampras,1,F-DTM,3,1,0,1,0,1,2
19940702-M-Wimbledon-SF-Todd_Martin-Pete_Sampras,1,F-DTL,1,0,0,0,0,0,1
19940702-M-Wimbledon-SF-Todd_Martin-Pete_Sampras,1,F-IO,3,2,2,0,0,2,1
19940702-M-Wimbledon-SF-Todd_Martin-Pete_Sampras,1,B-XC,2,1,0,1,0,1,1
19940702-M-Wimbledon-SF-Todd_Martin-Pete_Sampras,1,B-DTL,5,4,3,0,1,3,2
19940702-M-Wimbledon-SF-Todd_Martin-Pete_Sampras,1,B-IO,1,0,0,0,0,1,0
19940702-M-Wimbledon-SF-Todd_Martin-Pete_Sampras,1,S-XC,1,0,0,0,0,0,1
19940702-M-Wimbledon-SF-Todd_Martin-Pete_Sampras,2,F-XC,4,4,3,1,0,4,0
19940702-M-Wimbledon-SF-Todd_Martin-Pete_Sampras,2,F-DTL,3,2,2,0,0,2,1
19940702-M-Wimbledon-SF-Todd_Martin-Pete_Sampras,2,F-II,2,1,0,1,0,2,0
19940702-M-Wimbledon-SF-Todd_Martin-Pete_Sampras,2,B-XC,6,4,1,1,2,2,4
19940702-M-Wimbledon-SF-Todd_Martin-Pete_Sampras,2,B-DTL,7,7,3,0,4,3,4
19940702-M-Wimbledon-SF-Todd_Martin-Pete_Sampras,2,S-DTM,1,0,0,0,0,1,0
20180922-M-Kaohsiung_CH-SF-Gael_Monfils-Duck_Hee_Lee,1,F-XC,27,7,2,2,3,14,13
20180922-M-Kaohsiung_CH-SF-Gael_Monfils-Duck_Hee_Lee,1,F-DTM,13,2,0,0,2,5,8
20180922-M-Kaohsiung_CH-SF-Gael_Monfils-Duck_Hee_Lee,1,F-DTL,4,2,2,0,0,4,0
20180922-M-Kaohsiung_CH-SF-Gael_Monfils-Duck_Hee_Lee,1,F-IO,5,1,0,0,1,4,1
20180922-M-Kaohsiung_CH-SF-Gael_Monfils-Duck_Hee_Lee,1,F-II,1,0,0,0,0,1,0
20180922-M-Kaohsiung_CH-SF-Gael_Monfils-Duck_Hee_Lee,1,B-XC,47,4,1,0,3,23,24
20180922-M-Kaohsiung_CH-SF-Gael_Monfils-Duck_Hee_Lee,1,B-DTM,22,1,0,0,1,12,10
20180922-M-Kaohsiung_CH-SF-Gael_Monfils-Duck_Hee_Lee,1,B-DTL,6,2,0,1,1,3,3
20180922-M-Kaohsiung_CH-SF-Gael_Monfils-Duck_Hee_Lee,1,B-IO,3,3,1,0,2,1,2
20180922-M-Kaohsiung_CH-SF-Gael_Monfils-Duck_Hee_Lee,1,S-XC,8,0,0,0,0,4,4
20180922-M-Kaohsiung_CH-SF-Gael_Monfils-Duck_Hee_Lee,1,S-DTM,3,0,0,0,0,2,1
20180922-M-Kaohsiung_CH-SF-Gael_Monfils-Duck_Hee_Lee,2,F-XC,29,5,0,3,2,12,17
20180922-M-Kaohsiung_CH-SF-Gael_Monfils-Duck_Hee_Lee,2,F-DTM,21,2,0,1,1,11,10
20180922-M-Kaohsiung_CH-SF-Gael_Monfils-Duck_Hee_Lee,2,F-DTL,9,2,0,1,1,3,6
20180922-M-Kaohsiung_CH-SF-Gael_Monfils-Duck_Hee_Lee,2,F-IO,27,6,1,2,3,14,13
20180922-M-Kaohsiung_CH-SF-Gael_Monfils-Duck_Hee_Lee,2,F-II,4,2,1,1,0,4,0
20180922-M-Kaohsiung_CH-SF-Gael_Monfils-Duck_Hee_Lee,2,B-XC,48,6,1,0,5,18,30
20180922-M-Kaohsiung_CH-SF-Gael_Monfils-Duck_Hee_Lee,2,B-DTM,14,3,0,0,3,6,8
20180922-M-Kaohsiung_CH-SF-Gael_Monfils-Duck_Hee_Lee,2,B-DTL,7,4,0,0,4,1,6
20180922-M-Kaohsiung_CH-SF-Gael_Monfils-Duck_Hee_Lee,2,B-IO,1,0,0,0,0,0,1
20180922-M-Kaohsiung_CH-SF-Gael_Monfils-Duck_Hee_Lee,2,S-XC,2,0,0,0,0,0,2
20180922-M-Kaohsiung_CH-SF-Gael_Monfils-Duck_Hee_Lee,2,S-DTM,1,0,0,0,0,1,0
20180921-M-Kaohsiung_CH-QF-Gael_Monfils-Ernests_Gulbis,1,F-XC,18,1,0,1,0,13,5
20180921-M-Kaohsiung_CH-QF-Gael_Monfils-Ernests_Gulbis,1,F-DTM,15,1,0,0,1,9,6
20180921-M-Kaohsiung_CH-QF-Gael_Monfils-Ernests_Gulbis,1,F-DTL,7,5,2,2,1,6,1
20180921-M-Kaohsiung_CH-QF-Gael_Monfils-Ernests_Gulbis,1,F-IO,14,4,2,0,2,9,5
20180921-M-Kaohsiung_CH-QF-Gael_Monfils-Ernests_Gulbis,1,F-II,3,1,0,1,0,2,1
20180921-M-Kaohsiung_CH-QF-Gael_Monfils-Ernests_Gulbis,1,B-XC,17,4,0,0,4,8,9
20180921-M-Kaohsiung_CH-QF-Gael_Monfils-Ernests_Gulbis,1,B-DTM,15,1,0,0,1,12,3
20180921-M-Kaohsiung_CH-QF-Gael_Monfils-Ernests_Gulbis,1,B-DTL,5,4,2,1,1,4,1
20180921-M-Kaohsiung_CH-QF-Gael_Monfils-Ernests_Gulbis,1,B-IO,2,1,1,0,0,2,0
20180921-M-Kaohsiung_CH-QF-Gael_Monfils-Ernests_Gulbis,1,S-XC,13,1,0,0,0,6,7
20180921-M-Kaohsiung_CH-QF-Gael_Monfils-Ernests_Gulbis,1,S-DTM,7,0,0,0,0,4,3
20180921-M-Kaohsiung_CH-QF-Gael_Monfils-Ernests_Gulbis,1,S-DTL,3,0,0,0,0,2,1
20180921-M-Kaohsiung_CH-QF-Gael_Monfils-Ernests_Gulbis,1,S-IO,3,0,0,0,0,3,0
20180921-M-Kaohsiung_CH-QF-Gael_Monfils-Ernests_Gulbis,2,F-XC,23,11,0,1,10,3,20
20180921-M-Kaohsiung_CH-QF-Gael_Monfils-Ernests_Gulbis,2,F-DTM,13,3,0,0,3,5,8
20180921-M-Kaohsiung_CH-QF-Gael_Monfils-Ernests_Gulbis,2,F-DTL,9,4,1,0,3,5,4
20180921-M-Kaohsiung_CH-QF-Gael_Monfils-Ernests_Gulbis,2,F-IO,9,3,0,0,3,3,6
20180921-M-Kaohsiung_CH-QF-Gael_Monfils-Ernests_Gulbis,2,B-XC,34,6,1,1,4,16,18
20180921-M-Kaohsiung_CH-QF-Gael_Monfils-Ernests_Gulbis,2,B-DTM,17,1,1,0,0,7,10
20180921-M-Kaohsiung_CH-QF-Gael_Monfils-Ernests_Gulbis,2,B-DTL,9,4,2,0,2,4,5
20180921-M-Kaohsiung_CH-QF-Gael_Monfils-Ernests_Gulbis,2,B-IO,4,1,1,0,0,2,2
20180921-M-Kaohsiung_CH-QF-Gael_Monfils-Ernests_Gulbis,2,S-XC,4,0,0,0,0,2,2
20180921-M-Kaohsiung_CH-QF-Gael_Monfils-Ernests_Gulbis,2,S-DTM,3,1,1,0,0,2,1
20180923-M-Kaohsiung_CH-F-Gael_Monfils-Soon_Woo_Kwon,1,F-XC,42,9,0,2,7,19,23
20180923-M-Kaohsiung_CH-F-Gael_Monfils-Soon_Woo_Kwon,1,F-DTM,24,6,0,0,6,13,11
20180923-M-Kaohsiung_CH-F-Gael_Monfils-Soon_Woo_Kwon,1,F-DTL,11,6,4,0,2,7,4
20180923-M-Kaohsiung_CH-F-Gael_Monfils-Soon_Woo_Kwon,1,F-IO,19,7,2,4,1,16,3
20180923-M-Kaohsiung_CH-F-Gael_Monfils-Soon_Woo_Kwon,1,B-XC,57,7,0,2,5,35,22
20180923-M-Kaohsiung_CH-F-Gael_Monfils-Soon_Woo_Kwon,1,B-DTM,40,4,0,1,3,23,17
20180923-M-Kaohsiung_CH-F-Gael_Monfils-Soon_Woo_Kwon,1,B-DTL,5,3,0,1,2,2,3
20180923-M-Kaohsiung_CH-F-Gael_Monfils-Soon_Woo_Kwon,1,B-IO,5,2,0,1,1,4,1
20180923-M-Kaohsiung_CH-F-Gael_Monfils-Soon_Woo_Kwon,1,S-XC,11,0,0,0,0,4,7
20180923-M-Kaohsiung_CH-F-Gael_Monfils-Soon_Woo_Kwon,1,S-DTM,5,0,0,0,0,3,2
20180923-M-Kaohsiung_CH-F-Gael_Monfils-Soon_Woo_Kwon,1,S-DTL,2,1,1,0,0,2,0
20180923-M-Kaohsiung_CH-F-Gael_Monfils-Soon_Woo_Kwon,2,F-XC,52,13,6,1,6,27,25
20180923-M-Kaohsiung_CH-F-Gael_Monfils-Soon_Woo_Kwon,2,F-DTM,32,4,0,0,4,9,23
20180923-M-Kaohsiung_CH-F-Gael_Monfils-Soon_Woo_Kwon,2,F-DTL,8,3,2,0,1,3,5
20180923-M-Kaohsiung_CH-F-Gael_Monfils-Soon_Woo_Kwon,2,F-IO,43,13,3,2,8,22,21
20180923-M-Kaohsiung_CH-F-Gael_Monfils-Soon_Woo_Kwon,2,F-II,1,1,0,0,1,0,1
20180923-M-Kaohsiung_CH-F-Gael_Monfils-Soon_Woo_Kwon,2,B-XC,59,6,1,2,3,23,36
20180923-M-Kaohsiung_CH-F-Gael_Monfils-Soon_Woo_Kwon,2,B-DTM,40,4,0,0,4,12,28
20180923-M-Kaohsiung_CH-F-Gael_Monfils-Soon_Woo_Kwon,2,B-DTL,10,4,1,0,3,5,5
20180923-M-Kaohsiung_CH-F-Gael_Monfils-Soon_Woo_Kwon,2,S-XC,1,0,0,0,0,1,0
20180923-M-Kaohsiung_CH-F-Gael_Monfils-Soon_Woo_Kwon,2,S-DTM,1,0,0,0,0,0,1
20180923-M-Kaohsiung_CH-F-Gael_Monfils-Soon_Woo_Kwon,2,S-DTL,2,1,0,0,1,0,2
20190225-M-Dubai-R32-Nikoloz_Basilashvili-Karen_Khachanov,1,F-XC,17,5,1,1,3,9,8
20190225-M-Dubai-R32-Nikoloz_Basilashvili-Karen_Khachanov,1,F-DTM,24,0,0,0,0,13,11
20190225-M-Dubai-R32-Nikoloz_Basilashvili-Karen_Khachanov,1,F-DTL,3,2,1,0,1,2,1
20190225-M-Dubai-R32-Nikoloz_Basilashvili-Karen_Khachanov,1,F-IO,29,7,3,2,2,20,9
20190225-M-Dubai-R32-Nikoloz_Basilashvili-Karen_Khachanov,1,F-II,4,2,0,1,1,3,1
20190225-M-Dubai-R32-Nikoloz_Basilashvili-Karen_Khachanov,1,B-XC,24,3,0,1,2,13,11
20190225-M-Dubai-R32-Nikoloz_Basilashvili-Karen_Khachanov,1,B-DTM,23,4,2,0,2,16,7
20190225-M-Dubai-R32-Nikoloz_Basilashvili-Karen_Khachanov,1,B-DTL,4,1,1,0,0,1,3
20190225-M-Dubai-R32-Nikoloz_Basilashvili-Karen_Khachanov,1,B-IO,2,2,0,1,1,1,1
20190225-M-Dubai-R32-Nikoloz_Basilashvili-Karen_Khachanov,1,S-XC,3,0,0,0,0,1,2
20190225-M-Dubai-R32-Nikoloz_Basilashvili-Karen_Khachanov,2,F-XC,15,4,1,0,3,9,6
20190225-M-Dubai-R32-Nikoloz_Basilashvili-Karen_Khachanov,2,F-DTM,18,2,0,1,1,4,14
20190225-M-Dubai-R32-Nikoloz_Basilashvili-Karen_Khachanov,2,F-DTL,4,2,1,0,1,3,1
20190225-M-Dubai-R32-Nikoloz_Basilashvili-Karen_Khachanov,2,F-IO,6,2,1,0,1,3,3
20190225-M-Dubai-R32-Nikoloz_Basilashvili-Karen_Khachanov,2,F-II,1,1,0,1,0,1,0
20190225-M-Dubai-R32-Nikoloz_Basilashvili-Karen_Khachanov,2,B-XC,36,4,1,0,3,14,22
20190225-M-Dubai-R32-Nikoloz_Basilashvili-Karen_Khachanov,2,B-DTM,37,8,1,0,7,15,22
20190225-M-Dubai-R32-Nikoloz_Basilashvili-Karen_Khachanov,2,B-DTL,5,4,1,0,3,2,3
20190225-M-Dubai-R32-Nikoloz_Basilashvili-Karen_Khachanov,2,B-IO,2,1,1,0,0,2,0
20190225-M-Dubai-R32-Nikoloz_Basilashvili-Karen_Khachanov,2,S-XC,1,0,0,0,0,0,1
20190225-M-Dubai-R32-Nikoloz_Basilashvili-Karen_Khachanov,2,S-DTM,3,0,0,0,0,1,2
19920704-M-Wimbledon-SF-Pete_Sampras-Goran_Ivanisevic,1,F-DTM,2,1,0,1,0,2,0
19920704-M-Wimbledon-SF-Pete_Sampras-Goran_Ivanisevic,1,F-DTL,4,3,1,2,0,4,0
19920704-M-Wimbledon-SF-Pete_Sampras-Goran_Ivanisevic,1,B-XC,9,6,5,0,1,5,4
19920704-M-Wimbledon-SF-Pete_Sampras-Goran_Ivanisevic,1,B-DTM,1,1,0,0,1,0,1
19920704-M-Wimbledon-SF-Pete_Sampras-Goran_Ivanisevic,1,B-DTL,2,0,0,0,0,0,2
19920704-M-Wimbledon-SF-Pete_Sampras-Goran_Ivanisevic,1,B-IO,5,4,1,0,3,2,3
19920704-M-Wimbledon-SF-Pete_Sampras-Goran_Ivanisevic,1,S-DTL,1,1,0,1,0,1,0
19920704-M-Wimbledon-SF-Pete_Sampras-Goran_Ivanisevic,1,S-IO,1,1,0,0,1,0,1
19920704-M-Wimbledon-SF-Pete_Sampras-Goran_Ivanisevic,2,F-XC,6,2,2,0,0,4,2
19920704-M-Wimbledon-SF-Pete_Sampras-Goran_Ivanisevic,2,F-DTM,3,0,0,0,0,2,1
19920704-M-Wimbledon-SF-Pete_Sampras-Goran_Ivanisevic,2,F-DTL,6,3,3,0,0,3,3
19920704-M-Wimbledon-SF-Pete_Sampras-Goran_Ivanisevic,2,F-IO,1,1,0,0,1,0,1
19920704-M-Wimbledon-SF-Pete_Sampras-Goran_Ivanisevic,2,B-XC,3,2,1,0,1,1,2
19920704-M-Wimbledon-SF-Pete_Sampras-Goran_Ivanisevic,2,B-DTM,3,2,0,0,2,0,3
19920704-M-Wimbledon-SF-Pete_Sampras-Goran_Ivanisevic,2,B-DTL,2,2,0,1,1,1,1
19920704-M-Wimbledon-SF-Pete_Sampras-Goran_Ivanisevic,2,S-XC,1,0,0,0,0,1,0
19920704-M-Wimbledon-SF-Pete_Sampras-Goran_Ivanisevic,2,S-DTM,2,0,0,0,0,0,2
20190215-M-Buenos_Aires-QF-Jaume_Munar-Guido_Pella,1,F-XC,124,15,5,4,6,58,66
20190215-M-Buenos_Aires-QF-Jaume_Munar-Guido_Pella,1,F-DTM,49,2,0,0,2,23,26
20190215-M-Buenos_Aires-QF-Jaume_Munar-Guido_Pella,1,F-DTL,40,12,7,2,3,23,17
20190215-M-Buenos_Aires-QF-Jaume_Munar-Guido_Pella,1,F-IO,36,7,1,1,5,14,22
20190215-M-Buenos_Aires-QF-Jaume_Munar-Guido_Pella,1,F-II,2,1,0,0,1,0,2
20190215-M-Buenos_Aires-QF-Jaume_Munar-Guido_Pella,1,B-XC,66,10,3,5,2,37,29
20190215-M-Buenos_Aires-QF-Jaume_Munar-Guido_Pella,1,B-DTM,50,2,0,0,2,28,22
20190215-M-Buenos_Aires-QF-Jaume_Munar-Guido_Pella,1,B-DTL,26,8,1,1,6,9,17
20190215-M-Buenos_Aires-QF-Jaume_Munar-Guido_Pella,1,B-IO,4,0,0,0,0,2,2
20190215-M-Buenos_Aires-QF-Jaume_Munar-Guido_Pella,1,S-XC,7,1,0,1,0,3,4
20190215-M-Buenos_Aires-QF-Jaume_Munar-Guido_Pella,1,S-DTM,8,0,0,0,0,4,4
20190215-M-Buenos_Aires-QF-Jaume_Munar-Guido_Pella,1,S-DTL,5,0,0,0,0,1,4
20190215-M-Buenos_Aires-QF-Jaume_Munar-Guido_Pella,2,F-XC,112,22,2,6,14,54,58
20190215-M-Buenos_Aires-QF-Jaume_Munar-Guido_Pella,2,F-DTM,41,2,0,0,2,25,16
20190215-M-Buenos_Aires-QF-Jaume_Munar-Guido_Pella,2,F-DTL,47,14,3,6,5,26,21
20190215-M-Buenos_Aires-QF-Jaume_Munar-Guido_Pella,2,F-IO,62,20,7,3,10,32,30
20190215-M-Buenos_Aires-QF-Jaume_Munar-Guido_Pella,2,F-II,17,2,0,1,1,6,11
20190215-M-Buenos_Aires-QF-Jaume_Munar-Guido_Pella,2,B-XC,78,14,6,4,4,45,33
20190215-M-Buenos_Aires-QF-Jaume_Munar-Guido_Pella,2,B-DTM,30,1,0,0,1,16,14
20190215-M-Buenos_Aires-QF-Jaume_Munar-Guido_Pella,2,B-DTL,8,2,0,0,2,6,2
20190215-M-Buenos_Aires-QF-Jaume_Munar-Guido_Pella,2,B-IO,4,1,0,1,0,3,1
20190215-M-Buenos_Aires-QF-Jaume_Munar-Guido_Pella,2,S-XC,8,0,0,0,0,3,5
20190215-M-Buenos_Aires-QF-Jaume_Munar-Guido_Pella,2,S-DTM,7,0,0,0,0,2,5
20190215-M-Buenos_Aires-QF-Jaume_Munar-Guido_Pella,2,S-DTL,2,0,0,0,0,1,1
20190220-M-Delray_Beach-R16-Daniel_Evans-Lloyd_George_Muirhead_Harris,1,F-XC,24,8,1,5,2,18,6
20190220-M-Delray_Beach-R16-Daniel_Evans-Lloyd_George_Muirhead_Harris,1,F-DTM,9,0,0,0,0,6,3
20190220-M-Delray_Beach-R16-Daniel_Evans-Lloyd_George_Muirhead_Harris,1,F-DTL,6,1,0,1,0,6,0
20190220-M-Delray_Beach-R16-Daniel_Evans-Lloyd_George_Muirhead_Harris,1,F-IO,21,6,1,2,3,14,7
20190220-M-Delray_Beach-R16-Daniel_Evans-Lloyd_George_Muirhead_Harris,1,F-II,2,1,1,0,0,1,1
20190220-M-Delray_Beach-R16-Daniel_Evans-Lloyd_George_Muirhead_Harris,1,B-XC,1,1,0,1,0,1,0
20190220-M-Delray_Beach-R16-Daniel_Evans-Lloyd_George_Muirhead_Harris,1,B-DTM,1,0,0,0,0,0,1
20190220-M-Delray_Beach-R16-Daniel_Evans-Lloyd_George_Muirhead_Harris,1,B-DTL,6,4,3,1,0,5,1
20190220-M-Delray_Beach-R16-Daniel_Evans-Lloyd_George_Muirhead_Harris,1,S-XC,39,3,0,1,2,26,13
20190220-M-Delray_Beach-R16-Daniel_Evans-Lloyd_George_Muirhead_Harris,1,S-DTM,12,1,0,0,1,7,5
20190220-M-Delray_Beach-R16-Daniel_Evans-Lloyd_George_Muirhead_Harris,1,S-DTL,3,0,0,0,0,3,0
20190220-M-Delray_Beach-R16-Daniel_Evans-Lloyd_George_Muirhead_Harris,1,S-IO,2,0,0,0,0,1,1
20190220-M-Delray_Beach-R16-Daniel_Evans-Lloyd_George_Muirhead_Harris,2,F-XC,24,4,0,0,4,5,19
20190220-M-Delray_Beach-R16-Daniel_Evans-Lloyd_George_Muirhead_Harris,2,F-DTM,12,0,0,0,0,5,7
20190220-M-Delray_Beach-R16-Daniel_Evans-Lloyd_George_Muirhead_Harris,2,F-DTL,3,0,0,0,0,2,1
20190220-M-Delray_Beach-R16-Daniel_Evans-Lloyd_George_Muirhead_Harris,2,F-IO,41,12,4,3,5,17,24
20190220-M-Delray_Beach-R16-Daniel_Evans-Lloyd_George_Muirhead_Harris,2,F-II,4,3,0,2,1,2,2
20190220-M-Delray_Beach-R16-Daniel_Evans-Lloyd_George_Muirhead_Harris,2,B-XC,24,4,0,0,4,3,21
20190220-M-Delray_Beach-R16-Daniel_Evans-Lloyd_George_Muirhead_Harris,2,B-DTM,9,0,0,0,0,3,6
20190220-M-Delray_Beach-R16-Daniel_Evans-Lloyd_George_Muirhead_Harris,2,B-DTL,7,5,0,1,4,1,6
20190220-M-Delray_Beach-R16-Daniel_Evans-Lloyd_George_Muirhead_Harris,2,B-IO,2,0,0,0,0,0,2
20190220-M-Delray_Beach-R16-Daniel_Evans-Lloyd_George_Muirhead_Harris,2,S-XC,5,1,0,0,1,1,4
20190220-M-Delray_Beach-R16-Daniel_Evans-Lloyd_George_Muirhead_Harris,2,S-DTM,2,0,0,0,0,0,2
20190221-M-Rio_de_Janeiro-R16-Pablo_Cuevas-Juan_Ignacio_Londero,1,F-XC,27,6,2,3,1,17,10
20190221-M-Rio_de_Janeiro-R16-Pablo_Cuevas-Juan_Ignacio_Londero,1,F-DTM,8,1,0,0,1,3,5
20190221-M-Rio_de_Janeiro-R16-Pablo_Cuevas-Juan_Ignacio_Londero,1,F-DTL,6,1,0,0,1,3,3
20190221-M-Rio_de_Janeiro-R16-Pablo_Cuevas-Juan_Ignacio_Londero,1,F-IO,11,5,2,1,2,7,4
20190221-M-Rio_de_Janeiro-R16-Pablo_Cuevas-Juan_Ignacio_Londero,1,F-II,5,4,0,4,0,4,1
20190221-M-Rio_de_Janeiro-R16-Pablo_Cuevas-Juan_Ignacio_Londero,1,B-XC,34,7,1,2,4,19,15
20190221-M-Rio_de_Janeiro-R16-Pablo_Cuevas-Juan_Ignacio_Londero,1,B-DTM,4,0,0,0,0,1,3
20190221-M-Rio_de_Janeiro-R16-Pablo_Cuevas-Juan_Ignacio_Londero,1,B-DTL,1,1,0,0,1,0,1
20190221-M-Rio_de_Janeiro-R16-Pablo_Cuevas-Juan_Ignacio_Londero,1,B-IO,1,1,1,0,0,1,0
20190221-M-Rio_de_Janeiro-R16-Pablo_Cuevas-Juan_Ignacio_Londero,1,S-DTM,1,0,0,0,0,0,1
20190221-M-Rio_de_Janeiro-R16-Pablo_Cuevas-Juan_Ignacio_Londero,1,S-DTL,2,1,0,0,1,0,2
20190221-M-Rio_de_Janeiro-R16-Pablo_Cuevas-Juan_Ignacio_Londero,2,F-XC,13,0,0,0,0,8,5
20190221-M-Rio_de_Janeiro-R16-Pablo_Cuevas-Juan_Ignacio_Londero,2,F-DTM,17,1,0,0,1,9,8
20190221-M-Rio_de_Janeiro-R16-Pablo_Cuevas-Juan_Ignacio_Londero,2,F-DTL,9,7,2,0,5,4,5
20190221-M-Rio_de_Janeiro-R16-Pablo_Cuevas-Juan_Ignacio_Londero,2,F-IO,13,5,2,1,2,8,5
20190221-M-Rio_de_Janeiro-R16-Pablo_Cuevas-Juan_Ignacio_Londero,2,F-II,5,3,1,1,1,3,2
20190221-M-Rio_de_Janeiro-R16-Pablo_Cuevas-Juan_Ignacio_Londero,2,B-XC,20,4,0,1,3,9,11
20190221-M-Rio_de_Janeiro-R16-Pablo_Cuevas-Juan_Ignacio_Londero,2,B-DTM,13,2,0,0,2,4,9
20190221-M-Rio_de_Janeiro-R16-Pablo_Cuevas-Juan_Ignacio_Londero,2,B-DTL,6,4,1,1,2,2,4
20190221-M-Rio_de_Janeiro-R16-Pablo_Cuevas-Juan_Ignacio_Londero,2,S-XC,1,0,0,0,0,0,1
20190221-M-Rio_de_Janeiro-R16-Pablo_Cuevas-Juan_Ignacio_Londero,2,S-DTM,4,0,0,0,0,1,3
20190221-M-Rio_de_Janeiro-R16-Pablo_Cuevas-Juan_Ignacio_Londero,2,S-DTL,1,0,0,0,0,0,1
19950708-M-Wimbledon-SF-Pete_Sampras-Goran_Ivanisevic,1,F-XC,6,3,2,0,1,4,2
19950708-M-Wimbledon-SF-Pete_Sampras-Goran_Ivanisevic,1,F-DTL,2,1,0,1,0,2,0
19950708-M-Wimbledon-SF-Pete_Sampras-Goran_Ivanisevic,1,F-IO,1,1,1,0,0,1,0
19950708-M-Wimbledon-SF-Pete_Sampras-Goran_Ivanisevic,1,B-XC,4,4,2,0,2,2,2
19950708-M-Wimbledon-SF-Pete_Sampras-Goran_Ivanisevic,1,B-DTM,1,0,0,0,0,0,1
19950708-M-Wimbledon-SF-Pete_Sampras-Goran_Ivanisevic,1,B-DTL,7,3,2,0,1,4,3
19950708-M-Wimbledon-SF-Pete_Sampras-Goran_Ivanisevic,1,S-XC,1,0,0,0,0,0,1
19950708-M-Wimbledon-SF-Pete_Sampras-Goran_Ivanisevic,1,S-DTL,1,0,0,0,0,0,1
19950708-M-Wimbledon-SF-Pete_Sampras-Goran_Ivanisevic,2,F-XC,9,6,2,3,1,6,3
19950708-M-Wimbledon-SF-Pete_Sampras-Goran_Ivanisevic,2,F-DTM,1,0,0,0,0,1,0
19950708-M-Wimbledon-SF-Pete_Sampras-Goran_Ivanisevic,2,F-DTL,6,4,1,2,1,3,3
19950708-M-Wimbledon-SF-Pete_Sampras-Goran_Ivanisevic,2,F-IO,1,1,0,1,0,1,0
19950708-M-Wimbledon-SF-Pete_Sampras-Goran_Ivanisevic,2,F-II,1,1,1,0,0,1,0
19950708-M-Wimbledon-SF-Pete_Sampras-Goran_Ivanisevic,2,B-XC,3,2,0,1,1,2,1
19950708-M-Wimbledon-SF-Pete_Sampras-Goran_Ivanisevic,2,B-DTL,4,2,1,1,0,3,1
19950708-M-Wimbledon-SF-Pete_Sampras-Goran_Ivanisevic,2,B-IO,3,0,0,0,0,1,2
19950708-M-Wimbledon-SF-Pete_Sampras-Goran_Ivanisevic,2,S-XC,1,0,0,0,0,0,1
19950708-M-Wimbledon-SF-Pete_Sampras-Goran_Ivanisevic,2,S-DTL,1,1,0,0,1,0,1
19950708-M-Wimbledon-SF-Pete_Sampras-Goran_Ivanisevic,2,S-IO,1,1,0,0,1,0,1
19970704-M-Wimbledon-SF-Pete_Sampras-Todd_Woodbridge,1,F-XC,11,3,1,1,1,6,5
19970704-M-Wimbledon-SF-Pete_Sampras-Todd_Woodbridge,1,F-DTM,3,0,0,0,0,1,2
19970704-M-Wimbledon-SF-Pete_Sampras-Todd_Woodbridge,1,F-DTL,7,3,1,1,1,3,4
19970704-M-Wimbledon-SF-Pete_Sampras-Todd_Woodbridge,1,F-IO,5,3,1,1,1,2,3
19970704-M-Wimbledon-SF-Pete_Sampras-Todd_Woodbridge,1,F-II,1,0,0,0,0,1,0
19970704-M-Wimbledon-SF-Pete_Sampras-Todd_Woodbridge,1,B-XC,21,3,1,1,1,11,10
19970704-M-Wimbledon-SF-Pete_Sampras-Todd_Woodbridge,1,B-DTM,1,1,0,0,1,0,1
19970704-M-Wimbledon-SF-Pete_Sampras-Todd_Woodbridge,1,B-DTL,5,5,2,1,2,3,2
19970704-M-Wimbledon-SF-Pete_Sampras-Todd_Woodbridge,1,B-IO,1,1,0,1,0,1,0
19970704-M-Wimbledon-SF-Pete_Sampras-Todd_Woodbridge,1,S-XC,17,2,0,1,1,10,7
19970704-M-Wimbledon-SF-Pete_Sampras-Todd_Woodbridge,1,S-DTM,1,0,0,0,0,0,1
19970704-M-Wimbledon-SF-Pete_Sampras-Todd_Woodbridge,1,S-DTL,1,1,0,1,0,1,0
19970704-M-Wimbledon-SF-Pete_Sampras-Todd_Woodbridge,2,F-XC,8,3,2,0,1,4,4
19970704-M-Wimbledon-SF-Pete_Sampras-Todd_Woodbridge,2,F-DTM,5,0,0,0,0,2,3
19970704-M-Wimbledon-SF-Pete_Sampras-Todd_Woodbridge,2,F-DTL,8,3,2,0,1,5,3
19970704-M-Wimbledon-SF-Pete_Sampras-Todd_Woodbridge,2,F-IO,19,5,3,1,1,14,5
19970704-M-Wimbledon-SF-Pete_Sampras-Todd_Woodbridge,2,F-II,2,1,0,0,1,0,2
19970704-M-Wimbledon-SF-Pete_Sampras-Todd_Woodbridge,2,B-XC,12,5,2,1,2,5,7
19970704-M-Wimbledon-SF-Pete_Sampras-Todd_Woodbridge,2,B-DTM,1,1,0,0,1,0,1
19970704-M-Wimbledon-SF-Pete_Sampras-Todd_Woodbridge,2,B-DTL,6,1,0,0,1,3,3
19970704-M-Wimbledon-SF-Pete_Sampras-Todd_Woodbridge,2,B-IO,1,0,0,0,0,1,0
19970704-M-Wimbledon-SF-Pete_Sampras-Todd_Woodbridge,2,S-XC,20,2,0,1,1,8,12
19970704-M-Wimbledon-SF-Pete_Sampras-Todd_Woodbridge,2,S-DTM,3,0,0,0,0,0,3
19970704-M-Wimbledon-SF-Pete_Sampras-Todd_Woodbridge,2,S-DTL,10,1,0,0,1,4,6
19970704-M-Wimbledon-SF-Pete_Sampras-Todd_Woodbridge,2,S-IO,2,0,0,0,0,2,0
19970704-M-Wimbledon-SF-Pete_Sampras-Todd_Woodbridge,2,S-II,1,0,0,0,0,1,0
20190226-M-Acapulco-R32-Rafael_Nadal-Mischa_Zverev,1,F-XC,22,8,5,2,1,14,8
20190226-M-Acapulco-R32-Rafael_Nadal-Mischa_Zverev,1,F-DTM,6,1,0,0,1,5,1
20190226-M-Acapulco-R32-Rafael_Nadal-Mischa_Zverev,1,F-DTL,4,2,1,0,1,2,2
20190226-M-Acapulco-R32-Rafael_Nadal-Mischa_Zverev,1,F-IO,20,8,5,1,2,14,6
20190226-M-Acapulco-R32-Rafael_Nadal-Mischa_Zverev,1,F-II,6,2,1,0,1,3,3
20190226-M-Acapulco-R32-Rafael_Nadal-Mischa_Zverev,1,B-XC,13,4,0,2,2,7,6
20190226-M-Acapulco-R32-Rafael_Nadal-Mischa_Zverev,1,B-DTM,8,0,0,0,0,3,5
20190226-M-Acapulco-R32-Rafael_Nadal-Mischa_Zverev,1,B-DTL,3,2,2,0,0,3,0
20190226-M-Acapulco-R32-Rafael_Nadal-Mischa_Zverev,1,B-IO,4,3,2,0,1,2,2
20190226-M-Acapulco-R32-Rafael_Nadal-Mischa_Zverev,1,S-XC,1,0,0,0,0,0,1
20190226-M-Acapulco-R32-Rafael_Nadal-Mischa_Zverev,2,F-XC,4,2,0,0,2,2,2
20190226-M-Acapulco-R32-Rafael_Nadal-Mischa_Zverev,2,F-DTM,10,1,1,0,0,5,5
20190226-M-Acapulco-R32-Rafael_Nadal-Mischa_Zverev,2,F-DTL,5,1,0,0,1,2,3
20190226-M-Acapulco-R32-Rafael_Nadal-Mischa_Zverev,2,F-IO,2,2,0,0,2,0,2
20190226-M-Acapulco-R32-Rafael_Nadal-Mischa_Zverev,2,B-XC,12,2,0,0,2,6,6
20190226-M-Acapulco-R32-Rafael_Nadal-Mischa_Zverev,2,B-DTM,7,1,0,0,1,3,4
20190226-M-Acapulco-R32-Rafael_Nadal-Mischa_Zverev,2,B-DTL,1,1,0,0,1,0,1
20190226-M-Acapulco-R32-Rafael_Nadal-Mischa_Zverev,2,S-XC,6,0,0,0,0,2,4
20190226-M-Acapulco-R32-Rafael_Nadal-Mischa_Zverev,2,S-DTM,4,0,0,0,0,0,4
20190226-M-Acapulco-R32-Rafael_Nadal-Mischa_Zverev,2,S-DTL,2,0,0,0,0,0,2
20190226-M-Acapulco-R32-Rafael_Nadal-Mischa_Zverev,2,S-IO,1,0,0,0,0,1,0
20190226-M-Dubai-R32-Marin_Cilic-Gael_Monfils,1,F-XC,51,15,4,7,4,23,28
20190226-M-Dubai-R32-Marin_Cilic-Gael_Monfils,1,F-DTM,26,4,0,0,4,6,20
20190226-M-Dubai-R32-Marin_Cilic-Gael_Monfils,1,F-DTL,14,5,0,0,5,6,8
20190226-M-Dubai-R32-Marin_Cilic-Gael_Monfils,1,F-IO,56,15,4,3,8,26,30
20190226-M-Dubai-R32-Marin_Cilic-Gael_Monfils,1,F-II,13,8,2,3,3,7,6
20190226-M-Dubai-R32-Marin_Cilic-Gael_Monfils,1,B-XC,50,7,1,0,6,18,32
20190226-M-Dubai-R32-Marin_Cilic-Gael_Monfils,1,B-DTM,17,1,0,0,1,7,10
20190226-M-Dubai-R32-Marin_Cilic-Gael_Monfils,1,B-DTL,4,3,1,0,2,1,3
20190226-M-Dubai-R32-Marin_Cilic-Gael_Monfils,1,B-IO,1,0,0,0,0,0,1
20190226-M-Dubai-R32-Marin_Cilic-Gael_Monfils,1,S-XC,5,0,0,0,0,0,5
20190226-M-Dubai-R32-Marin_Cilic-Gael_Monfils,1,S-DTM,3,0,0,0,0,0,3
20190226-M-Dubai-R32-Marin_Cilic-Gael_Monfils,2,F-XC,26,11,8,2,1,21,5
20190226-M-Dubai-R32-Marin_Cilic-Gael_Monfils,2,F-DTM,23,0,0,0,0,15,8
20190226-M-Dubai-R32-Marin_Cilic-Gael_Monfils,2,F-DTL,5,3,2,0,1,4,1
20190226-M-Dubai-R32-Marin_Cilic-Gael_Monfils,2,F-IO,18,7,3,2,2,14,4
20190226-M-Dubai-R32-Marin_Cilic-Gael_Monfils,2,F-II,3,1,0,0,1,2,1
20190226-M-Dubai-R32-Marin_Cilic-Gael_Monfils,2,B-XC,51,4,0,0,4,28,23
20190226-M-Dubai-R32-Marin_Cilic-Gael_Monfils,2,B-DTM,44,4,0,0,4,25,19
20190226-M-Dubai-R32-Marin_Cilic-Gael_Monfils,2,B-DTL,9,4,1,1,2,5,4
20190226-M-Dubai-R32-Marin_Cilic-Gael_Monfils,2,B-IO,3,1,0,0,1,2,1
20190226-M-Dubai-R32-Marin_Cilic-Gael_Monfils,2,S-XC,7,1,0,1,0,6,1
20190226-M-Dubai-R32-Marin_Cilic-Gael_Monfils,2,S-DTM,10,1,0,0,1,3,7
20190226-M-Dubai-R32-Marin_Cilic-Gael_Monfils,2,S-DTL,1,0,0,0,0,0,1
20190227-M-Dubai-R16-Roger_Federer-Fernando_Verdasco,1,F-XC,35,11,5,2,4,25,10
20190227-M-Dubai-R16-Roger_Federer-Fernando_Verdasco,1,F-DTM,16,5,0,0,5,5,11
20190227-M-Dubai-R16-Roger_Federer-Fernando_Verdasco,1,F-DTL,5,3,3,0,0,5,0
20190227-M-Dubai-R16-Roger_Federer-Fernando_Verdasco,1,F-IO,10,5,3,0,2,5,5
20190227-M-Dubai-R16-Roger_Federer-Fernando_Verdasco,1,F-II,2,1,0,1,0,2,0
20190227-M-Dubai-R16-Roger_Federer-Fernando_Verdasco,1,B-XC,14,6,1,1,4,7,7
20190227-M-Dubai-R16-Roger_Federer-Fernando_Verdasco,1,B-DTM,23,3,2,0,1,16,7
20190227-M-Dubai-R16-Roger_Federer-Fernando_Verdasco,1,B-DTL,7,2,0,0,2,4,3
20190227-M-Dubai-R16-Roger_Federer-Fernando_Verdasco,1,S-XC,6,0,0,0,0,1,5
20190227-M-Dubai-R16-Roger_Federer-Fernando_Verdasco,1,S-DTM,6,0,0,0,0,2,4
20190227-M-Dubai-R16-Roger_Federer-Fernando_Verdasco,1,S-IO,1,0,0,0,0,0,1
20190227-M-Dubai-R16-Roger_Federer-Fernando_Verdasco,2,F-XC,42,9,3,3,3,23,19
20190227-M-Dubai-R16-Roger_Federer-Fernando_Verdasco,2,F-DTM,11,3,0,0,2,6,5
20190227-M-Dubai-R16-Roger_Federer-Fernando_Verdasco,2,F-DTL,6,2,2,0,0,3,3
20190227-M-Dubai-R16-Roger_Federer-Fernando_Verdasco,2,F-IO,18,3,2,1,0,9,9
20190227-M-Dubai-R16-Roger_Federer-Fernando_Verdasco,2,B-XC,17,6,1,2,3,8,9
20190227-M-Dubai-R16-Roger_Federer-Fernando_Verdasco,2,B-DTM,23,5,0,0,5,8,15
20190227-M-Dubai-R16-Roger_Federer-Fernando_Verdasco,2,B-DTL,6,1,0,0,1,2,4
20190227-M-Dubai-R16-Roger_Federer-Fernando_Verdasco,2,B-IO,3,1,0,1,0,1,2
20190227-M-Dubai-R16-Roger_Federer-Fernando_Verdasco,2,S-XC,1,0,0,0,0,0,1
20190227-M-Dubai-R16-Roger_Federer-Fernando_Verdasco,2,S-DTM,3,1,0,0,1,1,2
20190227-M-Dubai-R16-Roger_Federer-Fernando_Verdasco,2,S-IO,1,0,0,0,0,0,1
20190226-M-Dubai-R32-Egor_Gerasimov-Robin_Haase,1,F-XC,42,11,6,1,4,27,15
20190226-M-Dubai-R32-Egor_Gerasimov-Robin_Haase,1,F-DTM,31,6,1,2,3,18,13
20190226-M-Dubai-R32-Egor_Gerasimov-Robin_Haase,1,F-DTL,7,1,1,0,0,4,3
20190226-M-Dubai-R32-Egor_Gerasimov-Robin_Haase,1,F-IO,39,8,3,1,4,27,12
20190226-M-Dubai-R32-Egor_Gerasimov-Robin_Haase,1,F-II,1,1,0,0,1,0,1
20190226-M-Dubai-R32-Egor_Gerasimov-Robin_Haase,1,B-XC,59,11,2,5,4,34,25
20190226-M-Dubai-R32-Egor_Gerasimov-Robin_Haase,1,B-DTM,47,9,0,0,9,18,29
20190226-M-Dubai-R32-Egor_Gerasimov-Robin_Haase,1,B-DTL,12,7,2,2,3,7,5
20190226-M-Dubai-R32-Egor_Gerasimov-Robin_Haase,1,B-IO,3,2,1,0,1,1,2
20190226-M-Dubai-R32-Egor_Gerasimov-Robin_Haase,1,S-XC,16,1,0,1,0,13,3
20190226-M-Dubai-R32-Egor_Gerasimov-Robin_Haase,1,S-DTM,9,1,0,0,1,1,8
20190226-M-Dubai-R32-Egor_Gerasimov-Robin_Haase,1,S-DTL,2,0,0,0,0,2,0
20190226-M-Dubai-R32-Egor_Gerasimov-Robin_Haase,2,F-XC,28,4,1,1,2,13,15
20190226-M-Dubai-R32-Egor_Gerasimov-Robin_Haase,2,F-DTM,51,6,2,1,3,24,27
20190226-M-Dubai-R32-Egor_Gerasimov-Robin_Haase,2,F-DTL,12,3,1,0,2,4,8
20190226-M-Dubai-R32-Egor_Gerasimov-Robin_Haase,2,F-IO,40,5,2,1,2,24,16
20190226-M-Dubai-R32-Egor_Gerasimov-Robin_Haase,2,F-II,4,2,1,0,1,3,1
20190226-M-Dubai-R32-Egor_Gerasimov-Robin_Haase,2,B-XC,28,4,0,1,3,13,15
20190226-M-Dubai-R32-Egor_Gerasimov-Robin_Haase,2,B-DTM,26,3,0,0,3,10,16
20190226-M-Dubai-R32-Egor_Gerasimov-Robin_Haase,2,B-DTL,4,2,1,0,1,2,2
20190226-M-Dubai-R32-Egor_Gerasimov-Robin_Haase,2,B-IO,6,4,2,0,2,4,2
20190226-M-Dubai-R32-Egor_Gerasimov-Robin_Haase,2,S-XC,43,3,0,0,3,11,32
20190226-M-Dubai-R32-Egor_Gerasimov-Robin_Haase,2,S-DTM,15,0,0,0,0,3,12
20190226-M-Dubai-R32-Egor_Gerasimov-Robin_Haase,2,S-DTL,2,2,0,0,2,0,2
20190226-M-Dubai-R32-Egor_Gerasimov-Robin_Haase,2,S-IO,1,0,0,0,0,1,0
20190227-M-Dubai-R16-Gael_Monfils-Marcos_Baghdatis,1,F-XC,24,9,1,4,4,13,11
20190227-M-Dubai-R16-Gael_Monfils-Marcos_Baghdatis,1,F-DTM,32,4,0,0,4,14,18
20190227-M-Dubai-R16-Gael_Monfils-Marcos_Baghdatis,1,F-DTL,5,3,0,1,2,3,2
20190227-M-Dubai-R16-Gael_Monfils-Marcos_Baghdatis,1,F-IO,20,4,1,1,2,12,8
20190227-M-Dubai-R16-Gael_Monfils-Marcos_Baghdatis,1,F-II,2,0,0,0,0,0,2
20190227-M-Dubai-R16-Gael_Monfils-Marcos_Baghdatis,1,B-XC,23,4,1,0,3,6,17
20190227-M-Dubai-R16-Gael_Monfils-Marcos_Baghdatis,1,B-DTM,19,1,0,0,1,7,12
20190227-M-Dubai-R16-Gael_Monfils-Marcos_Baghdatis,1,B-DTL,6,4,1,0,3,2,4
20190227-M-Dubai-R16-Gael_Monfils-Marcos_Baghdatis,1,B-IO,2,0,0,0,0,2,0
20190227-M-Dubai-R16-Gael_Monfils-Marcos_Baghdatis,1,S-XC,2,0,0,0,0,2,0
20190227-M-Dubai-R16-Gael_Monfils-Marcos_Baghdatis,1,S-DTM,1,0,0,0,0,0,1
20190227-M-Dubai-R16-Gael_Monfils-Marcos_Baghdatis,1,S-DTL,1,0,0,0,0,0,1
20190227-M-Dubai-R16-Gael_Monfils-Marcos_Baghdatis,2,F-XC,37,8,1,2,5,19,18
20190227-M-Dubai-R16-Gael_Monfils-Marcos_Baghdatis,2,F-DTM,19,3,0,0,3,7,12
20190227-M-Dubai-R16-Gael_Monfils-Marcos_Baghdatis,2,F-DTL,1,1,1,0,0,1,0
20190227-M-Dubai-R16-Gael_Monfils-Marcos_Baghdatis,2,F-IO,21,4,2,0,2,10,11
20190227-M-Dubai-R16-Gael_Monfils-Marcos_Baghdatis,2,F-II,2,1,0,0,1,0,2
20190227-M-Dubai-R16-Gael_Monfils-Marcos_Baghdatis,2,B-XC,34,3,0,0,3,22,12
20190227-M-Dubai-R16-Gael_Monfils-Marcos_Baghdatis,2,B-DTM,12,2,0,0,2,5,7
20190227-M-Dubai-R16-Gael_Monfils-Marcos_Baghdatis,2,B-DTL,3,2,0,0,2,1,2
20190227-M-Dubai-R16-Gael_Monfils-Marcos_Baghdatis,2,B-IO,1,0,0,0,0,0,1
20190227-M-Dubai-R16-Gael_Monfils-Marcos_Baghdatis,2,S-XC,3,0,0,0,0,1,2
20190227-M-Dubai-R16-Gael_Monfils-Marcos_Baghdatis,2,S-DTM,2,0,0,0,0,0,2
20190227-M-Dubai-R16-Gael_Monfils-Marcos_Baghdatis,2,S-DTL,1,0,0,0,0,1,0
20190213-M-Buenos_Aires-R16-Roberto_Carballes_Baena-Lorenzo_Sonego,1,F-XC,33,9,3,3,3,21,12
20190213-M-Buenos_Aires-R16-Roberto_Carballes_Baena-Lorenzo_Sonego,1,F-DTM,20,1,0,0,1,9,11
20190213-M-Buenos_Aires-R16-Roberto_Carballes_Baena-Lorenzo_Sonego,1,F-DTL,21,0,0,0,0,18,3
20190213-M-Buenos_Aires-R16-Roberto_Carballes_Baena-Lorenzo_Sonego,1,F-IO,57,7,0,2,5,30,27
20190213-M-Buenos_Aires-R16-Roberto_Carballes_Baena-Lorenzo_Sonego,1,F-II,5,1,0,0,1,3,2
20190213-M-Buenos_Aires-R16-Roberto_Carballes_Baena-Lorenzo_Sonego,1,B-XC,50,4,0,3,1,26,24
20190213-M-Buenos_Aires-R16-Roberto_Carballes_Baena-Lorenzo_Sonego,1,B-DTM,16,1,0,0,1,7,9
20190213-M-Buenos_Aires-R16-Roberto_Carballes_Baena-Lorenzo_Sonego,1,B-DTL,10,6,3,1,2,6,4
20190213-M-Buenos_Aires-R16-Roberto_Carballes_Baena-Lorenzo_Sonego,1,S-XC,2,0,0,0,0,0,2
20190213-M-Buenos_Aires-R16-Roberto_Carballes_Baena-Lorenzo_Sonego,1,S-DTM,1,0,0,0,0,0,1
20190213-M-Buenos_Aires-R16-Roberto_Carballes_Baena-Lorenzo_Sonego,1,S-DTL,1,1,0,1,0,1,0
20190213-M-Buenos_Aires-R16-Roberto_Carballes_Baena-Lorenzo_Sonego,2,F-XC,42,14,2,4,8,16,26
20190213-M-Buenos_Aires-R16-Roberto_Carballes_Baena-Lorenzo_Sonego,2,F-DTM,20,0,0,0,0,10,10
20190213-M-Buenos_Aires-R16-Roberto_Carballes_Baena-Lorenzo_Sonego,2,F-DTL,4,2,1,0,1,3,1
20190213-M-Buenos_Aires-R16-Roberto_Carballes_Baena-Lorenzo_Sonego,2,F-IO,29,9,2,6,1,17,12
20190213-M-Buenos_Aires-R16-Roberto_Carballes_Baena-Lorenzo_Sonego,2,F-II,10,4,0,1,3,4,6
20190213-M-Buenos_Aires-R16-Roberto_Carballes_Baena-Lorenzo_Sonego,2,B-XC,53,6,1,0,5,21,32
20190213-M-Buenos_Aires-R16-Roberto_Carballes_Baena-Lorenzo_Sonego,2,B-DTM,29,2,0,0,2,10,19
20190213-M-Buenos_Aires-R16-Roberto_Carballes_Baena-Lorenzo_Sonego,2,B-DTL,7,2,0,0,2,2,5
20190213-M-Buenos_Aires-R16-Roberto_Carballes_Baena-Lorenzo_Sonego,2,B-IO,4,3,1,0,2,1,3
20190213-M-Buenos_Aires-R16-Roberto_Carballes_Baena-Lorenzo_Sonego,2,S-XC,8,0,0,0,0,6,2
20190213-M-Buenos_Aires-R16-Roberto_Carballes_Baena-Lorenzo_Sonego,2,S-DTM,3,0,0,0,0,2,1
20190213-M-Buenos_Aires-R16-Roberto_Carballes_Baena-Lorenzo_Sonego,2,S-DTL,4,0,0,0,0,1,3
20190228-M-Dubai-QF-Borna_Coric-Nikoloz_Basilashvili,1,F-XC,73,16,3,2,11,35,38
20190228-M-Dubai-QF-Borna_Coric-Nikoloz_Basilashvili,1,F-DTM,35,3,0,0,3,14,21
20190228-M-Dubai-QF-Borna_Coric-Nikoloz_Basilashvili,1,F-DTL,9,3,2,0,1,4,5
20190228-M-Dubai-QF-Borna_Coric-Nikoloz_Basilashvili,1,F-IO,29,5,1,0,4,18,11
20190228-M-Dubai-QF-Borna_Coric-Nikoloz_Basilashvili,1,B-XC,65,8,3,1,4,28,37
20190228-M-Dubai-QF-Borna_Coric-Nikoloz_Basilashvili,1,B-DTM,45,3,0,0,3,25,20
20190228-M-Dubai-QF-Borna_Coric-Nikoloz_Basilashvili,1,B-DTL,8,6,2,0,4,4,4
20190228-M-Dubai-QF-Borna_Coric-Nikoloz_Basilashvili,1,B-IO,6,1,0,1,0,5,1
20190228-M-Dubai-QF-Borna_Coric-Nikoloz_Basilashvili,1,S-XC,17,1,0,0,1,8,9
20190228-M-Dubai-QF-Borna_Coric-Nikoloz_Basilashvili,1,S-DTM,10,0,0,0,0,3,7
20190228-M-Dubai-QF-Borna_Coric-Nikoloz_Basilashvili,1,S-DTL,2,1,0,1,0,1,1
20190228-M-Dubai-QF-Borna_Coric-Nikoloz_Basilashvili,2,F-XC,72,16,5,2,9,38,34
20190228-M-Dubai-QF-Borna_Coric-Nikoloz_Basilashvili,2,F-DTM,49,3,0,1,2,25,24
20190228-M-Dubai-QF-Borna_Coric-Nikoloz_Basilashvili,2,F-DTL,16,5,0,2,3,8,8
20190228-M-Dubai-QF-Borna_Coric-Nikoloz_Basilashvili,2,F-IO,47,16,4,2,10,19,28
20190228-M-Dubai-QF-Borna_Coric-Nikoloz_Basilashvili,2,F-II,7,1,0,0,1,3,4
20190228-M-Dubai-QF-Borna_Coric-Nikoloz_Basilashvili,2,B-XC,65,11,3,2,6,35,30
20190228-M-Dubai-QF-Borna_Coric-Nikoloz_Basilashvili,2,B-DTM,36,0,0,0,0,20,16
20190228-M-Dubai-QF-Borna_Coric-Nikoloz_Basilashvili,2,B-DTL,19,7,0,1,6,8,11
20190228-M-Dubai-QF-Borna_Coric-Nikoloz_Basilashvili,2,B-IO,4,0,0,0,0,1,3
20190228-M-Dubai-QF-Borna_Coric-Nikoloz_Basilashvili,2,S-XC,1,0,0,0,0,1,0
20190228-M-Dubai-QF-Borna_Coric-Nikoloz_Basilashvili,2,S-DTM,2,0,0,0,0,0,2
20190223-M-Marseille-SF-Ugo_Humbert-Mikhail_Kukushkin,1,F-XC,81,10,1,3,6,34,47
20190223-M-Marseille-SF-Ugo_Humbert-Mikhail_Kukushkin,1,F-DTM,27,8,0,1,7,7,20
20190223-M-Marseille-SF-Ugo_Humbert-Mikhail_Kukushkin,1,F-DTL,12,7,3,0,4,6,6
20190223-M-Marseille-SF-Ugo_Humbert-Mikhail_Kukushkin,1,F-IO,11,3,1,0,2,5,6
20190223-M-Marseille-SF-Ugo_Humbert-Mikhail_Kukushkin,1,F-II,1,0,0,0,0,0,1
20190223-M-Marseille-SF-Ugo_Humbert-Mikhail_Kukushkin,1,B-XC,36,5,2,2,1,20,16
20190223-M-Marseille-SF-Ugo_Humbert-Mikhail_Kukushkin,1,B-DTM,34,0,0,0,0,11,23
20190223-M-Marseille-SF-Ugo_Humbert-Mikhail_Kukushkin,1,B-DTL,11,3,1,0,2,5,6
20190223-M-Marseille-SF-Ugo_Humbert-Mikhail_Kukushkin,1,B-IO,10,5,0,1,4,4,6
20190223-M-Marseille-SF-Ugo_Humbert-Mikhail_Kukushkin,1,S-XC,5,1,0,0,1,1,4
20190223-M-Marseille-SF-Ugo_Humbert-Mikhail_Kukushkin,1,S-DTM,4,1,0,0,1,1,3
20190223-M-Marseille-SF-Ugo_Humbert-Mikhail_Kukushkin,1,S-DTL,2,0,0,0,0,1,1
20190223-M-Marseille-SF-Ugo_Humbert-Mikhail_Kukushkin,2,F-XC,55,7,0,2,5,30,25
20190223-M-Marseille-SF-Ugo_Humbert-Mikhail_Kukushkin,2,F-DTM,13,0,0,0,0,8,5
20190223-M-Marseille-SF-Ugo_Humbert-Mikhail_Kukushkin,2,F-DTL,13,7,4,2,1,8,5
20190223-M-Marseille-SF-Ugo_Humbert-Mikhail_Kukushkin,2,F-IO,31,7,0,4,3,23,8
20190223-M-Marseille-SF-Ugo_Humbert-Mikhail_Kukushkin,2,B-XC,53,2,1,1,0,34,19
20190223-M-Marseille-SF-Ugo_Humbert-Mikhail_Kukushkin,2,B-DTM,24,0,0,0,0,13,11
20190223-M-Marseille-SF-Ugo_Humbert-Mikhail_Kukushkin,2,B-DTL,16,4,1,1,2,10,6
20190223-M-Marseille-SF-Ugo_Humbert-Mikhail_Kukushkin,2,B-IO,2,0,0,0,0,2,0
20190223-M-Marseille-SF-Ugo_Humbert-Mikhail_Kukushkin,2,S-XC,6,1,0,0,1,2,4
20190223-M-Marseille-SF-Ugo_Humbert-Mikhail_Kukushkin,2,S-DTM,2,0,0,0,0,1,1
20190223-M-Marseille-SF-Ugo_Humbert-Mikhail_Kukushkin,2,S-DTL,3,1,0,0,1,1,2
20190223-M-Marseille-SF-Ugo_Humbert-Mikhail_Kukushkin,2,S-IO,1,0,0,0,0,1,0
19990703-M-Wimbledon-SF-Tim_Henman-Pete_Sampras,1,F-XC,4,1,0,0,1,0,4
19990703-M-Wimbledon-SF-Tim_Henman-Pete_Sampras,1,F-DTM,3,1,1,0,0,3,0
19990703-M-Wimbledon-SF-Tim_Henman-Pete_Sampras,1,F-DTL,5,2,1,0,1,4,1
19990703-M-Wimbledon-SF-Tim_Henman-Pete_Sampras,1,F-IO,9,4,0,1,3,3,6
19990703-M-Wimbledon-SF-Tim_Henman-Pete_Sampras,1,B-XC,3,2,1,0,1,1,2
19990703-M-Wimbledon-SF-Tim_Henman-Pete_Sampras,1,B-DTM,4,1,0,0,1,1,3
19990703-M-Wimbledon-SF-Tim_Henman-Pete_Sampras,1,B-DTL,6,5,2,2,1,4,2
19990703-M-Wimbledon-SF-Tim_Henman-Pete_Sampras,1,S-XC,10,0,0,0,0,4,6
19990703-M-Wimbledon-SF-Tim_Henman-Pete_Sampras,1,S-DTM,5,0,0,0,0,1,4
19990703-M-Wimbledon-SF-Tim_Henman-Pete_Sampras,1,S-DTL,2,0,0,0,0,0,2
19990703-M-Wimbledon-SF-Tim_Henman-Pete_Sampras,2,F-XC,9,7,3,2,2,7,2
19990703-M-Wimbledon-SF-Tim_Henman-Pete_Sampras,2,F-DTL,4,2,1,0,1,3,1
19990703-M-Wimbledon-SF-Tim_Henman-Pete_Sampras,2,F-IO,6,2,0,0,2,2,4
19990703-M-Wimbledon-SF-Tim_Henman-Pete_Sampras,2,F-II,2,1,0,0,1,0,2
19990703-M-Wimbledon-SF-Tim_Henman-Pete_Sampras,2,B-XC,11,7,4,0,3,7,4
19990703-M-Wimbledon-SF-Tim_Henman-Pete_Sampras,2,B-DTM,4,3,0,1,2,1,3
19990703-M-Wimbledon-SF-Tim_Henman-Pete_Sampras,2,B-DTL,5,3,1,0,2,2,3
19990703-M-Wimbledon-SF-Tim_Henman-Pete_Sampras,2,S-XC,3,0,0,0,0,2,1
19990703-M-Wimbledon-SF-Tim_Henman-Pete_Sampras,2,S-DTL,2,2,1,0,1,1,1
20190227-M-Acapulco-R16-Rafael_Nadal-Nick_Kyrgios,1,F-XC,52,8,6,2,0,32,20
20190227-M-Acapulco-R16-Rafael_Nadal-Nick_Kyrgios,1,F-DTM,19,2,1,1,0,10,9
20190227-M-Acapulco-R16-Rafael_Nadal-Nick_Kyrgios,1,F-DTL,14,10,5,1,4,8,6
20190227-M-Acapulco-R16-Rafael_Nadal-Nick_Kyrgios,1,F-IO,21,9,7,1,1,15,6
20190227-M-Acapulco-R16-Rafael_Nadal-Nick_Kyrgios,1,F-II,9,4,3,1,0,6,3
20190227-M-Acapulco-R16-Rafael_Nadal-Nick_Kyrgios,1,B-XC,22,5,1,2,2,9,13
20190227-M-Acapulco-R16-Rafael_Nadal-Nick_Kyrgios,1,B-DTM,18,2,0,0,2,11,7
20190227-M-Acapulco-R16-Rafael_Nadal-Nick_Kyrgios,1,B-DTL,9,3,2,0,1,6,3
20190227-M-Acapulco-R16-Rafael_Nadal-Nick_Kyrgios,1,S-XC,1,0,0,0,0,0,1
20190227-M-Acapulco-R16-Rafael_Nadal-Nick_Kyrgios,1,S-DTM,4,0,0,0,0,2,2
20190227-M-Acapulco-R16-Rafael_Nadal-Nick_Kyrgios,1,S-DTL,2,0,0,0,0,1,1
20190227-M-Acapulco-R16-Rafael_Nadal-Nick_Kyrgios,1,S-IO,4,0,0,0,0,1,3
20190227-M-Acapulco-R16-Rafael_Nadal-Nick_Kyrgios,2,F-XC,45,14,6,2,6,23,22
20190227-M-Acapulco-R16-Rafael_Nadal-Nick_Kyrgios,2,F-DTM,19,2,1,0,1,8,11
20190227-M-Acapulco-R16-Rafael_Nadal-Nick_Kyrgios,2,F-DTL,8,4,2,0,2,5,3
20190227-M-Acapulco-R16-Rafael_Nadal-Nick_Kyrgios,2,F-IO,23,12,4,2,6,11,12
20190227-M-Acapulco-R16-Rafael_Nadal-Nick_Kyrgios,2,F-II,6,2,2,0,0,4,2
20190227-M-Acapulco-R16-Rafael_Nadal-Nick_Kyrgios,2,B-XC,41,16,0,6,10,20,21
20190227-M-Acapulco-R16-Rafael_Nadal-Nick_Kyrgios,2,B-DTM,11,2,0,0,2,4,7
20190227-M-Acapulco-R16-Rafael_Nadal-Nick_Kyrgios,2,B-DTL,13,6,2,1,3,5,8
20190227-M-Acapulco-R16-Rafael_Nadal-Nick_Kyrgios,2,B-IO,1,0,0,0,0,1,0
20190227-M-Acapulco-R16-Rafael_Nadal-Nick_Kyrgios,2,S-XC,2,1,1,0,0,1,1
20190227-M-Acapulco-R16-Rafael_Nadal-Nick_Kyrgios,2,S-DTM,4,0,0,0,0,2,2
20190227-M-Acapulco-R16-Rafael_Nadal-Nick_Kyrgios,2,S-DTL,2,0,0,0,0,1,1
20190228-M-Dubai-QF-Roger_Federer-Marton_Fucsovics,1,F-XC,41,14,3,5,6,23,18
20190228-M-Dubai-QF-Roger_Federer-Marton_Fucsovics,1,F-DTM,38,5,0,0,5,13,25
20190228-M-Dubai-QF-Roger_Federer-Marton_Fucsovics,1,F-DTL,12,5,1,1,3,5,7
20190228-M-Dubai-QF-Roger_Federer-Marton_Fucsovics,1,F-IO,20,10,4,5,1,13,7
20190228-M-Dubai-QF-Roger_Federer-Marton_Fucsovics,1,F-II,5,3,0,0,3,1,4
20190228-M-Dubai-QF-Roger_Federer-Marton_Fucsovics,1,B-XC,29,3,0,2,1,10,19
20190228-M-Dubai-QF-Roger_Federer-Marton_Fucsovics,1,B-DTM,29,3,0,1,2,12,17
20190228-M-Dubai-QF-Roger_Federer-Marton_Fucsovics,1,B-DTL,13,8,1,3,4,6,7
20190228-M-Dubai-QF-Roger_Federer-Marton_Fucsovics,1,B-IO,2,2,0,0,2,0,2
20190228-M-Dubai-QF-Roger_Federer-Marton_Fucsovics,1,S-XC,17,1,0,1,0,5,12
20190228-M-Dubai-QF-Roger_Federer-Marton_Fucsovics,1,S-DTM,7,1,0,0,1,1,6
20190228-M-Dubai-QF-Roger_Federer-Marton_Fucsovics,1,S-DTL,9,2,0,1,1,3,6
20190228-M-Dubai-QF-Roger_Federer-Marton_Fucsovics,2,F-XC,37,8,3,0,5,17,20
20190228-M-Dubai-QF-Roger_Federer-Marton_Fucsovics,2,F-DTM,34,3,0,0,3,19,15
20190228-M-Dubai-QF-Roger_Federer-Marton_Fucsovics,2,F-DTL,13,5,1,1,3,9,4
20190228-M-Dubai-QF-Roger_Federer-Marton_Fucsovics,2,F-IO,46,6,1,5,0,35,11
20190228-M-Dubai-QF-Roger_Federer-Marton_Fucsovics,2,F-II,7,3,0,1,2,4,3
20190228-M-Dubai-QF-Roger_Federer-Marton_Fucsovics,2,B-XC,34,3,1,1,1,19,15
20190228-M-Dubai-QF-Roger_Federer-Marton_Fucsovics,2,B-DTM,15,3,0,1,2,8,7
20190228-M-Dubai-QF-Roger_Federer-Marton_Fucsovics,2,B-DTL,6,3,1,0,2,3,3
20190228-M-Dubai-QF-Roger_Federer-Marton_Fucsovics,2,B-IO,3,0,0,0,0,1,2
20190228-M-Dubai-QF-Roger_Federer-Marton_Fucsovics,2,S-XC,20,5,1,0,4,12,8
20190228-M-Dubai-QF-Roger_Federer-Marton_Fucsovics,2,S-DTM,5,0,0,0,0,2,3
20190228-M-Dubai-QF-Roger_Federer-Marton_Fucsovics,2,S-DTL,5,0,0,0,0,2,3
20190228-M-Dubai-QF-Roger_Federer-Marton_Fucsovics,2,S-IO,2,0,0,0,0,1,1
20190228-M-Dubai-QF-Gael_Monfils-Ricardas_Berankis,1,F-XC,41,13,6,2,5,28,13
20190228-M-Dubai-QF-Gael_Monfils-Ricardas_Berankis,1,F-DTM,40,4,0,1,3,22,18
20190228-M-Dubai-QF-Gael_Monfils-Ricardas_Berankis,1,F-DTL,9,2,1,1,0,6,3
20190228-M-Dubai-QF-Gael_Monfils-Ricardas_Berankis,1,F-IO,16,5,2,1,2,8,8
20190228-M-Dubai-QF-Gael_Monfils-Ricardas_Berankis,1,B-XC,40,4,1,1,2,26,14
20190228-M-Dubai-QF-Gael_Monfils-Ricardas_Berankis,1,B-DTM,26,2,0,1,1,12,14
20190228-M-Dubai-QF-Gael_Monfils-Ricardas_Berankis,1,B-DTL,10,4,1,2,1,5,5
20190228-M-Dubai-QF-Gael_Monfils-Ricardas_Berankis,1,S-XC,6,2,1,0,1,4,2
20190228-M-Dubai-QF-Gael_Monfils-Ricardas_Berankis,1,S-DTM,9,0,0,0,0,1,8
20190228-M-Dubai-QF-Gael_Monfils-Ricardas_Berankis,1,S-DTL,2,1,1,0,0,1,1
20190228-M-Dubai-QF-Gael_Monfils-Ricardas_Berankis,2,F-XC,50,15,5,3,7,22,28
20190228-M-Dubai-QF-Gael_Monfils-Ricardas_Berankis,2,F-DTM,21,2,0,0,2,9,12
20190228-M-Dubai-QF-Gael_Monfils-Ricardas_Berankis,2,F-DTL,18,11,3,3,5,10,8
20190228-M-Dubai-QF-Gael_Monfils-Ricardas_Berankis,2,F-IO,26,5,4,0,1,15,11
20190228-M-Dubai-QF-Gael_Monfils-Ricardas_Berankis,2,F-II,3,3,0,2,1,2,1
20190228-M-Dubai-QF-Gael_Monfils-Ricardas_Berankis,2,B-XC,42,8,2,1,5,21,21
20190228-M-Dubai-QF-Gael_Monfils-Ricardas_Berankis,2,B-DTM,22,5,0,1,4,7,15
20190228-M-Dubai-QF-Gael_Monfils-Ricardas_Berankis,2,B-DTL,15,7,1,2,4,6,9
20190228-M-Dubai-QF-Gael_Monfils-Ricardas_Berankis,2,B-IO,13,5,0,2,3,7,6
20190228-M-Dubai-QF-Gael_Monfils-Ricardas_Berankis,2,S-XC,5,0,0,0,0,0,5
20190228-M-Dubai-QF-Gael_Monfils-Ricardas_Berankis,2,S-DTM,6,1,0,0,1,1,5
20190228-M-Dubai-QF-Gael_Monfils-Ricardas_Berankis,2,S-DTL,4,1,0,0,1,2,2
20190223-M-Delray_Beach-SF-Mackenzie_Mcdonald-Radu_Albot,1,F-XC,38,11,1,3,7,17,21
20190223-M-Delray_Beach-SF-Mackenzie_Mcdonald-Radu_Albot,1,F-DTM,15,1,0,0,1,3,12
20190223-M-Delray_Beach-SF-Mackenzie_Mcdonald-Radu_Albot,1,F-DTL,9,2,1,1,0,4,5
20190223-M-Delray_Beach-SF-Mackenzie_Mcdonald-Radu_Albot,1,F-IO,21,6,1,0,5,12,9
20190223-M-Delray_Beach-SF-Mackenzie_Mcdonald-Radu_Albot,1,F-II,3,0,0,0,0,1,2
20190223-M-Delray_Beach-SF-Mackenzie_Mcdonald-Radu_Albot,1,B-XC,21,6,1,0,5,3,18
20190223-M-Delray_Beach-SF-Mackenzie_Mcdonald-Radu_Albot,1,B-DTM,19,3,0,0,3,4,15
20190223-M-Delray_Beach-SF-Mackenzie_Mcdonald-Radu_Albot,1,B-DTL,7,4,2,0,2,3,4
20190223-M-Delray_Beach-SF-Mackenzie_Mcdonald-Radu_Albot,1,S-XC,5,1,0,0,1,2,3
20190223-M-Delray_Beach-SF-Mackenzie_Mcdonald-Radu_Albot,1,S-DTM,1,0,0,0,0,0,1
20190223-M-Delray_Beach-SF-Mackenzie_Mcdonald-Radu_Albot,1,S-DTL,2,1,0,0,1,1,1
20190223-M-Delray_Beach-SF-Mackenzie_Mcdonald-Radu_Albot,1,S-IO,1,0,0,0,0,0,1
20190223-M-Delray_Beach-SF-Mackenzie_Mcdonald-Radu_Albot,2,F-XC,23,4,3,0,1,17,6
20190223-M-Delray_Beach-SF-Mackenzie_Mcdonald-Radu_Albot,2,F-DTM,15,1,0,0,1,8,7
20190223-M-Delray_Beach-SF-Mackenzie_Mcdonald-Radu_Albot,2,F-DTL,12,3,0,1,2,8,4
20190223-M-Delray_Beach-SF-Mackenzie_Mcdonald-Radu_Albot,2,F-IO,19,5,0,4,1,14,5
20190223-M-Delray_Beach-SF-Mackenzie_Mcdonald-Radu_Albot,2,F-II,4,2,1,0,1,3,1
20190223-M-Delray_Beach-SF-Mackenzie_Mcdonald-Radu_Albot,2,B-XC,26,4,0,3,1,19,7
20190223-M-Delray_Beach-SF-Mackenzie_Mcdonald-Radu_Albot,2,B-DTM,17,3,0,0,3,6,11
20190223-M-Delray_Beach-SF-Mackenzie_Mcdonald-Radu_Albot,2,B-DTL,2,0,0,0,0,1,1
20190223-M-Delray_Beach-SF-Mackenzie_Mcdonald-Radu_Albot,2,B-IO,4,2,1,1,0,2,2
20190223-M-Delray_Beach-SF-Mackenzie_Mcdonald-Radu_Albot,2,S-XC,5,1,0,0,1,2,3
20190223-M-Delray_Beach-SF-Mackenzie_Mcdonald-Radu_Albot,2,S-DTM,1,0,0,0,0,1,0
20190223-M-Delray_Beach-SF-Mackenzie_Mcdonald-Radu_Albot,2,S-DTL,2,0,0,0,0,2,0
20190301-M-Dubai-SF-Stefanos_Tsitsipas-Gael_Monfils,1,F-XC,67,17,9,4,4,37,30
20190301-M-Dubai-SF-Stefanos_Tsitsipas-Gael_Monfils,1,F-DTM,42,2,0,0,2,14,28
20190301-M-Dubai-SF-Stefanos_Tsitsipas-Gael_Monfils,1,F-DTL,35,14,1,7,6,15,20
20190301-M-Dubai-SF-Stefanos_Tsitsipas-Gael_Monfils,1,F-IO,56,15,5,4,6,32,24
20190301-M-Dubai-SF-Stefanos_Tsitsipas-Gael_Monfils,1,F-II,11,3,1,0,2,4,7
20190301-M-Dubai-SF-Stefanos_Tsitsipas-Gael_Monfils,1,B-XC,75,5,1,3,1,32,43
20190301-M-Dubai-SF-Stefanos_Tsitsipas-Gael_Monfils,1,B-DTM,17,1,0,0,1,5,12
20190301-M-Dubai-SF-Stefanos_Tsitsipas-Gael_Monfils,1,B-DTL,13,7,2,2,3,5,8
20190301-M-Dubai-SF-Stefanos_Tsitsipas-Gael_Monfils,1,B-IO,1,0,0,0,0,0,1
20190301-M-Dubai-SF-Stefanos_Tsitsipas-Gael_Monfils,1,S-XC,26,4,0,0,4,5,21
20190301-M-Dubai-SF-Stefanos_Tsitsipas-Gael_Monfils,1,S-DTM,7,0,0,0,0,0,7
20190301-M-Dubai-SF-Stefanos_Tsitsipas-Gael_Monfils,1,S-DTL,2,0,0,0,0,0,2
20190301-M-Dubai-SF-Stefanos_Tsitsipas-Gael_Monfils,1,S-IO,1,0,0,0,0,0,1
20190301-M-Dubai-SF-Stefanos_Tsitsipas-Gael_Monfils,2,F-XC,64,16,9,0,7,43,21
20190301-M-Dubai-SF-Stefanos_Tsitsipas-Gael_Monfils,2,F-DTM,40,2,0,0,2,20,20
20190301-M-Dubai-SF-Stefanos_Tsitsipas-Gael_Monfils,2,F-DTL,21,8,2,3,3,9,12
20190301-M-Dubai-SF-Stefanos_Tsitsipas-Gael_Monfils,2,F-IO,55,14,4,5,5,38,17
20190301-M-Dubai-SF-Stefanos_Tsitsipas-Gael_Monfils,2,F-II,10,7,2,4,1,8,2
20190301-M-Dubai-SF-Stefanos_Tsitsipas-Gael_Monfils,2,B-XC,80,7,3,2,2,53,27
20190301-M-Dubai-SF-Stefanos_Tsitsipas-Gael_Monfils,2,B-DTM,51,5,0,0,5,24,27
20190301-M-Dubai-SF-Stefanos_Tsitsipas-Gael_Monfils,2,B-DTL,29,12,5,4,3,19,10
20190301-M-Dubai-SF-Stefanos_Tsitsipas-Gael_Monfils,2,B-IO,4,2,1,0,1,2,2
20190301-M-Dubai-SF-Stefanos_Tsitsipas-Gael_Monfils,2,S-XC,7,0,0,0,0,4,3
20190301-M-Dubai-SF-Stefanos_Tsitsipas-Gael_Monfils,2,S-DTM,4,0,0,0,0,2,2
20190301-M-Dubai-SF-Stefanos_Tsitsipas-Gael_Monfils,2,S-DTL,3,0,0,0,0,1,2
20190223-M-Marseille-SF-Stefanos_Tsitsipas-David_Goffin,1,F-XC,19,3,3,0,0,17,2
20190223-M-Marseille-SF-Stefanos_Tsitsipas-David_Goffin,1,F-DTM,14,1,0,0,1,11,3
20190223-M-Marseille-SF-Stefanos_Tsitsipas-David_Goffin,1,F-DTL,11,6,1,4,1,9,2
20190223-M-Marseille-SF-Stefanos_Tsitsipas-David_Goffin,1,F-IO,13,5,2,2,1,11,2
20190223-M-Marseille-SF-Stefanos_Tsitsipas-David_Goffin,1,F-II,9,3,1,1,1,8,1
20190223-M-Marseille-SF-Stefanos_Tsitsipas-David_Goffin,1,B-XC,32,6,3,2,1,19,13
20190223-M-Marseille-SF-Stefanos_Tsitsipas-David_Goffin,1,B-DTM,4,2,0,0,2,2,2
20190223-M-Marseille-SF-Stefanos_Tsitsipas-David_Goffin,1,B-DTL,7,5,2,2,1,5,2
20190223-M-Marseille-SF-Stefanos_Tsitsipas-David_Goffin,1,B-IO,1,1,1,0,0,1,0
20190223-M-Marseille-SF-Stefanos_Tsitsipas-David_Goffin,1,S-XC,9,1,0,1,0,6,3
20190223-M-Marseille-SF-Stefanos_Tsitsipas-David_Goffin,2,F-XC,23,5,1,1,3,3,20
20190223-M-Marseille-SF-Stefanos_Tsitsipas-David_Goffin,2,F-DTM,7,1,0,0,1,0,7
20190223-M-Marseille-SF-Stefanos_Tsitsipas-David_Goffin,2,F-DTL,12,2,0,0,2,3,9
20190223-M-Marseille-SF-Stefanos_Tsitsipas-David_Goffin,2,F-IO,10,2,0,0,2,4,6
20190223-M-Marseille-SF-Stefanos_Tsitsipas-David_Goffin,2,F-II,4,2,0,2,0,3,1
20190223-M-Marseille-SF-Stefanos_Tsitsipas-David_Goffin,2,B-XC,37,4,0,0,4,12,25
20190223-M-Marseille-SF-Stefanos_Tsitsipas-David_Goffin,2,B-DTM,11,1,0,0,1,3,8
20190223-M-Marseille-SF-Stefanos_Tsitsipas-David_Goffin,2,B-DTL,7,4,3,1,0,6,1
20190223-M-Marseille-SF-Stefanos_Tsitsipas-David_Goffin,2,B-IO,2,2,0,0,2,0,2
20190223-M-Marseille-SF-Stefanos_Tsitsipas-David_Goffin,2,S-XC,5,0,0,0,0,0,5
20190223-M-Marseille-SF-Stefanos_Tsitsipas-David_Goffin,2,S-DTL,1,0,0,0,0,0,1
19970125-M-Australian_Open-SF-Pete_Sampras-Thomas_Muster,1,F-XC,40,7,3,2,2,29,11
19970125-M-Australian_Open-SF-Pete_Sampras-Thomas_Muster,1,F-DTM,8,1,0,0,1,3,5
19970125-M-Australian_Open-SF-Pete_Sampras-Thomas_Muster,1,F-DTL,19,10,2,4,4,14,5
19970125-M-Australian_Open-SF-Pete_Sampras-Thomas_Muster,1,F-IO,24,9,2,3,4,16,8
19970125-M-Australian_Open-SF-Pete_Sampras-Thomas_Muster,1,F-II,8,2,1,0,1,4,4
19970125-M-Australian_Open-SF-Pete_Sampras-Thomas_Muster,1,B-XC,42,5,2,2,1,22,20
19970125-M-Australian_Open-SF-Pete_Sampras-Thomas_Muster,1,B-DTM,18,3,0,0,3,9,9
19970125-M-Australian_Open-SF-Pete_Sampras-Thomas_Muster,1,B-DTL,27,3,2,0,1,20,7
19970125-M-Australian_Open-SF-Pete_Sampras-Thomas_Muster,1,B-IO,9,1,1,0,0,8,1
19970125-M-Australian_Open-SF-Pete_Sampras-Thomas_Muster,1,S-XC,9,1,0,0,1,3,6
19970125-M-Australian_Open-SF-Pete_Sampras-Thomas_Muster,1,S-DTM,5,0,0,0,0,1,4
19970125-M-Australian_Open-SF-Pete_Sampras-Thomas_Muster,1,S-DTL,8,1,1,0,0,4,4
19970125-M-Australian_Open-SF-Pete_Sampras-Thomas_Muster,1,S-IO,2,1,0,0,1,0,2
19970125-M-Australian_Open-SF-Pete_Sampras-Thomas_Muster,2,F-XC,95,14,6,4,4,49,46
19970125-M-Australian_Open-SF-Pete_Sampras-Thomas_Muster,2,F-DTM,11,0,0,0,0,4,7
19970125-M-Australian_Open-SF-Pete_Sampras-Thomas_Muster,2,F-DTL,16,8,3,4,1,10,6
19970125-M-Australian_Open-SF-Pete_Sampras-Thomas_Muster,2,F-IO,15,6,3,1,2,7,8
19970125-M-Australian_Open-SF-Pete_Sampras-Thomas_Muster,2,F-II,12,1,1,0,0,5,7
19970125-M-Australian_Open-SF-Pete_Sampras-Thomas_Muster,2,B-XC,33,6,1,1,4,12,21
19970125-M-Australian_Open-SF-Pete_Sampras-Thomas_Muster,2,B-DTM,33,1,0,0,1,12,21
19970125-M-Australian_Open-SF-Pete_Sampras-Thomas_Muster,2,B-DTL,28,7,2,1,4,11,17
19970125-M-Australian_Open-SF-Pete_Sampras-Thomas_Muster,2,B-IO,4,0,0,0,0,1,3
19970125-M-Australian_Open-SF-Pete_Sampras-Thomas_Muster,2,S-XC,2,0,0,0,0,0,2
19970125-M-Australian_Open-SF-Pete_Sampras-Thomas_Muster,2,S-DTM,4,0,0,0,0,0,4
19970125-M-Australian_Open-SF-Pete_Sampras-Thomas_Muster,2,S-DTL,1,0,0,0,0,0,1
20130123-M-Australian_Open-QF-Jo_Wilfried_Tsonga-Roger_Federer,1,F-XC,58,23,11,2,10,30,28
20130123-M-Australian_Open-QF-Jo_Wilfried_Tsonga-Roger_Federer,1,F-DTM,64,4,0,1,3,30,34
20130123-M-Australian_Open-QF-Jo_Wilfried_Tsonga-Roger_Federer,1,F-DTL,21,7,4,1,2,13,8
20130123-M-Australian_Open-QF-Jo_Wilfried_Tsonga-Roger_Federer,1,F-IO,53,21,5,8,8,30,23
20130123-M-Australian_Open-QF-Jo_Wilfried_Tsonga-Roger_Federer,1,F-II,5,4,2,2,0,4,1
20130123-M-Australian_Open-QF-Jo_Wilfried_Tsonga-Roger_Federer,1,B-XC,64,14,4,5,5,40,24
20130123-M-Australian_Open-QF-Jo_Wilfried_Tsonga-Roger_Federer,1,B-DTM,66,10,0,2,8,32,34
20130123-M-Australian_Open-QF-Jo_Wilfried_Tsonga-Roger_Federer,1,B-DTL,13,7,0,1,6,4,9
20130123-M-Australian_Open-QF-Jo_Wilfried_Tsonga-Roger_Federer,1,B-IO,12,3,0,1,2,7,5
20130123-M-Australian_Open-QF-Jo_Wilfried_Tsonga-Roger_Federer,1,S-XC,10,1,0,0,1,7,3
20130123-M-Australian_Open-QF-Jo_Wilfried_Tsonga-Roger_Federer,1,S-DTM,16,3,0,0,3,4,12
20130123-M-Australian_Open-QF-Jo_Wilfried_Tsonga-Roger_Federer,1,S-DTL,3,1,0,0,1,1,2
20130123-M-Australian_Open-QF-Jo_Wilfried_Tsonga-Roger_Federer,1,S-IO,3,1,0,0,1,1,2
20130123-M-Australian_Open-QF-Jo_Wilfried_Tsonga-Roger_Federer,2,F-XC,70,21,4,12,5,42,28
20130123-M-Australian_Open-QF-Jo_Wilfried_Tsonga-Roger_Federer,2,F-DTM,66,9,1,0,8,29,37
20130123-M-Australian_Open-QF-Jo_Wilfried_Tsonga-Roger_Federer,2,F-DTL,20,9,4,1,4,11,9
20130123-M-Australian_Open-QF-Jo_Wilfried_Tsonga-Roger_Federer,2,F-IO,55,20,5,8,7,31,24
20130123-M-Australian_Open-QF-Jo_Wilfried_Tsonga-Roger_Federer,2,F-II,4,2,0,0,2,0,4
20130123-M-Australian_Open-QF-Jo_Wilfried_Tsonga-Roger_Federer,2,B-XC,49,11,1,4,6,19,30
20130123-M-Australian_Open-QF-Jo_Wilfried_Tsonga-Roger_Federer,2,B-DTM,63,5,2,0,3,32,31
20130123-M-Australian_Open-QF-Jo_Wilfried_Tsonga-Roger_Federer,2,B-DTL,17,7,1,3,3,9,8
20130123-M-Australian_Open-QF-Jo_Wilfried_Tsonga-Roger_Federer,2,B-IO,9,7,3,3,1,7,2
20130123-M-Australian_Open-QF-Jo_Wilfried_Tsonga-Roger_Federer,2,S-XC,10,0,0,0,0,5,5
20130123-M-Australian_Open-QF-Jo_Wilfried_Tsonga-Roger_Federer,2,S-DTM,9,0,0,0,0,4,5
20130123-M-Australian_Open-QF-Jo_Wilfried_Tsonga-Roger_Federer,2,S-DTL,3,0,0,0,0,0,3
20130123-M-Australian_Open-QF-Jo_Wilfried_Tsonga-Roger_Federer,2,S-IO,1,0,0,0,0,0,1
20190227-M-Acapulco-R16-David_Ferrer-Alexander_Zverev,1,F-XC,29,9,0,3,6,9,20
20190227-M-Acapulco-R16-David_Ferrer-Alexander_Zverev,1,F-DTM,40,4,0,0,4,14,26
20190227-M-Acapulco-R16-David_Ferrer-Alexander_Zverev,1,F-DTL,6,4,2,1,1,5,1
20190227-M-Acapulco-R16-David_Ferrer-Alexander_Zverev,1,F-IO,15,2,0,1,1,6,9
20190227-M-Acapulco-R16-David_Ferrer-Alexander_Zverev,1,F-II,2,1,0,0,1,1,1
20190227-M-Acapulco-R16-David_Ferrer-Alexander_Zverev,1,B-XC,21,2,0,0,2,10,11
20190227-M-Acapulco-R16-David_Ferrer-Alexander_Zverev,1,B-DTM,47,2,0,0,2,18,29
20190227-M-Acapulco-R16-David_Ferrer-Alexander_Zverev,1,B-DTL,9,2,0,1,1,3,6
20190227-M-Acapulco-R16-David_Ferrer-Alexander_Zverev,1,B-IO,5,3,0,1,2,3,2
20190227-M-Acapulco-R16-David_Ferrer-Alexander_Zverev,1,S-XC,5,0,0,0,0,2,3
20190227-M-Acapulco-R16-David_Ferrer-Alexander_Zverev,1,S-DTM,4,0,0,0,0,1,3
20190227-M-Acapulco-R16-David_Ferrer-Alexander_Zverev,1,S-DTL,4,1,0,0,1,2,2
20190227-M-Acapulco-R16-David_Ferrer-Alexander_Zverev,2,F-XC,29,8,4,1,3,21,8
20190227-M-Acapulco-R16-David_Ferrer-Alexander_Zverev,2,F-DTM,27,2,0,0,2,15,12
20190227-M-Acapulco-R16-David_Ferrer-Alexander_Zverev,2,F-DTL,6,0,0,0,0,2,4
20190227-M-Acapulco-R16-David_Ferrer-Alexander_Zverev,2,F-IO,38,9,2,1,6,21,17
20190227-M-Acapulco-R16-David_Ferrer-Alexander_Zverev,2,F-II,1,1,1,0,0,1,0
20190227-M-Acapulco-R16-David_Ferrer-Alexander_Zverev,2,B-XC,33,7,1,2,4,19,14
20190227-M-Acapulco-R16-David_Ferrer-Alexander_Zverev,2,B-DTM,26,5,0,0,5,12,14
20190227-M-Acapulco-R16-David_Ferrer-Alexander_Zverev,2,B-DTL,7,4,3,1,0,6,1
20190227-M-Acapulco-R16-David_Ferrer-Alexander_Zverev,2,B-IO,5,4,3,0,1,4,1
20190227-M-Acapulco-R16-David_Ferrer-Alexander_Zverev,2,S-XC,6,0,0,0,0,3,3
20190227-M-Acapulco-R16-David_Ferrer-Alexander_Zverev,2,S-DTM,4,1,0,0,1,3,1
20190227-M-Acapulco-R16-David_Ferrer-Alexander_Zverev,2,S-DTL,1,1,0,0,1,0,1
20190227-M-Acapulco-R16-David_Ferrer-Alexander_Zverev,2,S-IO,1,0,0,0,0,1,0
20190301-M-Dubai-SF-Borna_Coric-Roger_Federer,1,F-XC,20,5,1,3,1,7,13
20190301-M-Dubai-SF-Borna_Coric-Roger_Federer,1,F-DTM,10,2,0,0,2,2,8
20190301-M-Dubai-SF-Borna_Coric-Roger_Federer,1,F-DTL,6,2,1,0,1,2,4
20190301-M-Dubai-SF-Borna_Coric-Roger_Federer,1,F-IO,18,6,0,1,5,3,15
20190301-M-Dubai-SF-Borna_Coric-Roger_Federer,1,F-II,3,1,1,0,0,2,1
20190301-M-Dubai-SF-Borna_Coric-Roger_Federer,1,B-XC,28,5,0,0,4,13,15
20190301-M-Dubai-SF-Borna_Coric-Roger_Federer,1,B-DTM,11,1,0,0,1,3,8
20190301-M-Dubai-SF-Borna_Coric-Roger_Federer,1,B-DTL,5,3,2,0,1,3,2
20190301-M-Dubai-SF-Borna_Coric-Roger_Federer,1,B-IO,1,1,1,0,0,1,0
20190301-M-Dubai-SF-Borna_Coric-Roger_Federer,1,S-XC,4,0,0,0,0,1,3
20190301-M-Dubai-SF-Borna_Coric-Roger_Federer,1,S-DTM,1,0,0,0,0,0,1
20190301-M-Dubai-SF-Borna_Coric-Roger_Federer,2,F-XC,16,5,2,2,1,14,2
20190301-M-Dubai-SF-Borna_Coric-Roger_Federer,2,F-DTM,14,1,0,0,1,8,6
20190301-M-Dubai-SF-Borna_Coric-Roger_Federer,2,F-DTL,4,2,0,1,1,3,1
20190301-M-Dubai-SF-Borna_Coric-Roger_Federer,2,F-IO,6,2,1,0,1,5,1
20190301-M-Dubai-SF-Borna_Coric-Roger_Federer,2,F-II,1,1,0,1,0,1,0
20190301-M-Dubai-SF-Borna_Coric-Roger_Federer,2,B-XC,20,6,2,1,3,9,11
20190301-M-Dubai-SF-Borna_Coric-Roger_Federer,2,B-DTM,13,1,0,1,0,10,3
20190301-M-Dubai-SF-Borna_Coric-Roger_Federer,2,B-DTL,4,2,1,0,1,3,1
20190301-M-Dubai-SF-Borna_Coric-Roger_Federer,2,B-IO,2,1,0,0,1,0,2
20190301-M-Dubai-SF-Borna_Coric-Roger_Federer,2,S-XC,5,0,0,0,0,3,2
20190301-M-Dubai-SF-Borna_Coric-Roger_Federer,2,S-DTM,3,1,0,0,1,1,2
20190301-M-Dubai-SF-Borna_Coric-Roger_Federer,2,S-DTL,2,0,0,0,0,1,1
20190302-M-Dubai-F-Stefanos_Tsitsipas-Roger_Federer,1,F-XC,28,8,2,1,5,13,15
20190302-M-Dubai-F-Stefanos_Tsitsipas-Roger_Federer,1,F-DTM,14,1,0,1,0,4,10
20190302-M-Dubai-F-Stefanos_Tsitsipas-Roger_Federer,1,F-DTL,6,1,1,0,0,3,3
20190302-M-Dubai-F-Stefanos_Tsitsipas-Roger_Federer,1,F-IO,22,8,1,3,4,13,9
20190302-M-Dubai-F-Stefanos_Tsitsipas-Roger_Federer,1,F-II,2,1,1,0,0,2,0
20190302-M-Dubai-F-Stefanos_Tsitsipas-Roger_Federer,1,B-XC,29,3,2,0,1,15,14
20190302-M-Dubai-F-Stefanos_Tsitsipas-Roger_Federer,1,B-DTM,11,0,0,0,0,2,9
20190302-M-Dubai-F-Stefanos_Tsitsipas-Roger_Federer,1,B-DTL,7,7,0,1,6,1,6
20190302-M-Dubai-F-Stefanos_Tsitsipas-Roger_Federer,1,B-IO,1,1,0,0,1,0,1
20190302-M-Dubai-F-Stefanos_Tsitsipas-Roger_Federer,1,S-XC,5,0,0,0,0,1,4
20190302-M-Dubai-F-Stefanos_Tsitsipas-Roger_Federer,1,S-DTM,1,0,0,0,0,0,1
20190302-M-Dubai-F-Stefanos_Tsitsipas-Roger_Federer,2,F-XC,14,7,5,1,1,11,3
20190302-M-Dubai-F-Stefanos_Tsitsipas-Roger_Federer,2,F-DTM,20,2,0,0,2,13,7
20190302-M-Dubai-F-Stefanos_Tsitsipas-Roger_Federer,2,F-DTL,4,0,0,0,0,1,3
20190302-M-Dubai-F-Stefanos_Tsitsipas-Roger_Federer,2,F-IO,12,2,2,0,0,8,4
20190302-M-Dubai-F-Stefanos_Tsitsipas-Roger_Federer,2,F-II,3,1,0,0,1,1,2
20190302-M-Dubai-F-Stefanos_Tsitsipas-Roger_Federer,2,B-XC,19,4,1,0,3,11,8
20190302-M-Dubai-F-Stefanos_Tsitsipas-Roger_Federer,2,B-DTM,19,2,0,0,2,9,10
20190302-M-Dubai-F-Stefanos_Tsitsipas-Roger_Federer,2,B-DTL,6,3,0,1,2,3,3
20190302-M-Dubai-F-Stefanos_Tsitsipas-Roger_Federer,2,S-XC,6,1,0,0,1,1,5
20190302-M-Dubai-F-Stefanos_Tsitsipas-Roger_Federer,2,S-DTM,4,0,0,0,0,4,0
20190216-M-New_York-SF-John_Isner-Reilly_Opelka,1,F-XC,17,14,5,2,7,9,8
20190216-M-New_York-SF-John_Isner-Reilly_Opelka,1,F-DTM,14,2,0,0,2,6,8
20190216-M-New_York-SF-John_Isner-Reilly_Opelka,1,F-DTL,4,2,0,1,1,2,2
20190216-M-New_York-SF-John_Isner-Reilly_Opelka,1,F-IO,21,10,6,1,3,12,9
20190216-M-New_York-SF-John_Isner-Reilly_Opelka,1,F-II,1,1,0,1,0,1,0
20190216-M-New_York-SF-John_Isner-Reilly_Opelka,1,B-XC,13,2,0,1,1,7,6
20190216-M-New_York-SF-John_Isner-Reilly_Opelka,1,B-DTM,17,1,0,1,0,7,10
20190216-M-New_York-SF-John_Isner-Reilly_Opelka,1,B-DTL,5,3,0,1,2,2,3
20190216-M-New_York-SF-John_Isner-Reilly_Opelka,1,S-XC,3,1,0,0,1,2,1
20190216-M-New_York-SF-John_Isner-Reilly_Opelka,1,S-DTM,7,1,0,0,1,1,6
20190216-M-New_York-SF-John_Isner-Reilly_Opelka,1,S-DTL,3,0,0,0,0,1,2
20190216-M-New_York-SF-John_Isner-Reilly_Opelka,2,F-XC,20,8,5,1,2,11,9
20190216-M-New_York-SF-John_Isner-Reilly_Opelka,2,F-DTM,11,2,1,0,1,5,6
20190216-M-New_York-SF-John_Isner-Reilly_Opelka,2,F-DTL,7,3,2,0,1,5,2
20190216-M-New_York-SF-John_Isner-Reilly_Opelka,2,F-IO,23,8,5,1,2,16,7
20190216-M-New_York-SF-John_Isner-Reilly_Opelka,2,B-XC,20,6,3,1,2,12,8
20190216-M-New_York-SF-John_Isner-Reilly_Opelka,2,B-DTM,11,1,0,0,1,6,5
20190216-M-New_York-SF-John_Isner-Reilly_Opelka,2,B-DTL,8,5,4,0,1,5,3
20190216-M-New_York-SF-John_Isner-Reilly_Opelka,2,B-IO,2,1,1,0,0,1,1
20190216-M-New_York-SF-John_Isner-Reilly_Opelka,2,S-XC,3,1,0,0,1,0,3
20190216-M-New_York-SF-John_Isner-Reilly_Opelka,2,S-DTM,3,0,0,0,0,1,2
20190220-M-Rio_de_Janeiro-R16-Roberto_Carballes_Baena-Hugo_Dellien,1,F-XC,51,7,2,2,3,27,24
20190220-M-Rio_de_Janeiro-R16-Roberto_Carballes_Baena-Hugo_Dellien,1,F-DTM,22,0,0,0,0,9,13
20190220-M-Rio_de_Janeiro-R16-Roberto_Carballes_Baena-Hugo_Dellien,1,F-DTL,23,0,0,0,0,13,10
20190220-M-Rio_de_Janeiro-R16-Roberto_Carballes_Baena-Hugo_Dellien,1,F-IO,36,5,1,1,3,17,19
20190220-M-Rio_de_Janeiro-R16-Roberto_Carballes_Baena-Hugo_Dellien,1,F-II,7,1,1,0,0,3,4
20190220-M-Rio_de_Janeiro-R16-Roberto_Carballes_Baena-Hugo_Dellien,1,B-XC,76,10,3,1,6,36,40
20190220-M-Rio_de_Janeiro-R16-Roberto_Carballes_Baena-Hugo_Dellien,1,B-DTM,23,1,0,0,1,9,14
20190220-M-Rio_de_Janeiro-R16-Roberto_Carballes_Baena-Hugo_Dellien,1,B-DTL,13,6,1,0,5,3,10
20190220-M-Rio_de_Janeiro-R16-Roberto_Carballes_Baena-Hugo_Dellien,1,B-IO,1,1,0,0,1,0,1
20190220-M-Rio_de_Janeiro-R16-Roberto_Carballes_Baena-Hugo_Dellien,1,S-XC,4,0,0,0,0,1,3
20190220-M-Rio_de_Janeiro-R16-Roberto_Carballes_Baena-Hugo_Dellien,1,S-DTM,3,0,0,0,0,0,3
20190220-M-Rio_de_Janeiro-R16-Roberto_Carballes_Baena-Hugo_Dellien,1,S-DTL,2,1,0,0,1,1,1
20190220-M-Rio_de_Janeiro-R16-Roberto_Carballes_Baena-Hugo_Dellien,2,F-XC,42,8,3,1,4,20,22
20190220-M-Rio_de_Janeiro-R16-Roberto_Carballes_Baena-Hugo_Dellien,2,F-DTM,18,1,0,0,1,10,8
20190220-M-Rio_de_Janeiro-R16-Roberto_Carballes_Baena-Hugo_Dellien,2,F-DTL,17,6,0,2,4,10,7
20190220-M-Rio_de_Janeiro-R16-Roberto_Carballes_Baena-Hugo_Dellien,2,F-IO,63,19,10,6,3,40,23
20190220-M-Rio_de_Janeiro-R16-Roberto_Carballes_Baena-Hugo_Dellien,2,F-II,23,9,3,3,3,13,10
20190220-M-Rio_de_Janeiro-R16-Roberto_Carballes_Baena-Hugo_Dellien,2,B-XC,35,5,0,0,5,18,17
20190220-M-Rio_de_Janeiro-R16-Roberto_Carballes_Baena-Hugo_Dellien,2,B-DTM,28,2,0,0,2,15,13
20190220-M-Rio_de_Janeiro-R16-Roberto_Carballes_Baena-Hugo_Dellien,2,B-DTL,23,13,2,3,8,9,14
20190220-M-Rio_de_Janeiro-R16-Roberto_Carballes_Baena-Hugo_Dellien,2,S-XC,12,0,0,0,0,7,5
20190220-M-Rio_de_Janeiro-R16-Roberto_Carballes_Baena-Hugo_Dellien,2,S-DTM,5,0,0,0,0,4,1
20190220-M-Rio_de_Janeiro-R16-Roberto_Carballes_Baena-Hugo_Dellien,2,S-DTL,1,1,1,0,0,1,0
20190222-M-Rio_de_Janeiro-QF-Jaume_Munar-Felix_Auger_Aliassime,1,F-XC,17,5,2,1,2,11,6
20190222-M-Rio_de_Janeiro-QF-Jaume_Munar-Felix_Auger_Aliassime,1,F-DTM,10,1,0,0,1,6,4
20190222-M-Rio_de_Janeiro-QF-Jaume_Munar-Felix_Auger_Aliassime,1,F-DTL,5,1,0,0,1,1,4
20190222-M-Rio_de_Janeiro-QF-Jaume_Munar-Felix_Auger_Aliassime,1,F-IO,12,3,0,0,3,4,8
20190222-M-Rio_de_Janeiro-QF-Jaume_Munar-Felix_Auger_Aliassime,1,F-II,2,0,0,0,0,1,1
20190222-M-Rio_de_Janeiro-QF-Jaume_Munar-Felix_Auger_Aliassime,1,B-XC,37,1,0,1,0,20,17
20190222-M-Rio_de_Janeiro-QF-Jaume_Munar-Felix_Auger_Aliassime,1,B-DTM,20,3,0,0,3,8,12
20190222-M-Rio_de_Janeiro-QF-Jaume_Munar-Felix_Auger_Aliassime,1,B-DTL,4,2,0,1,1,2,2
20190222-M-Rio_de_Janeiro-QF-Jaume_Munar-Felix_Auger_Aliassime,1,B-IO,1,1,0,1,0,1,0
20190222-M-Rio_de_Janeiro-QF-Jaume_Munar-Felix_Auger_Aliassime,1,S-XC,9,1,0,0,1,4,5
20190222-M-Rio_de_Janeiro-QF-Jaume_Munar-Felix_Auger_Aliassime,1,S-DTM,5,0,0,0,0,4,1
20190222-M-Rio_de_Janeiro-QF-Jaume_Munar-Felix_Auger_Aliassime,1,S-DTL,1,0,0,0,0,1,0
20190222-M-Rio_de_Janeiro-QF-Jaume_Munar-Felix_Auger_Aliassime,2,F-XC,31,13,5,6,2,18,13
20190222-M-Rio_de_Janeiro-QF-Jaume_Munar-Felix_Auger_Aliassime,2,F-DTM,14,3,0,0,3,3,11
20190222-M-Rio_de_Janeiro-QF-Jaume_Munar-Felix_Auger_Aliassime,2,F-DTL,8,1,0,0,1,3,5
20190222-M-Rio_de_Janeiro-QF-Jaume_Munar-Felix_Auger_Aliassime,2,F-IO,35,11,2,2,7,17,18
20190222-M-Rio_de_Janeiro-QF-Jaume_Munar-Felix_Auger_Aliassime,2,F-II,8,6,3,2,1,7,1
20190222-M-Rio_de_Janeiro-QF-Jaume_Munar-Felix_Auger_Aliassime,2,B-XC,30,6,2,2,2,16,14
20190222-M-Rio_de_Janeiro-QF-Jaume_Munar-Felix_Auger_Aliassime,2,B-DTM,7,2,0,0,2,2,5
20190222-M-Rio_de_Janeiro-QF-Jaume_Munar-Felix_Auger_Aliassime,2,B-DTL,6,4,2,0,2,4,2
20190222-M-Rio_de_Janeiro-QF-Jaume_Munar-Felix_Auger_Aliassime,2,B-IO,2,0,0,0,0,0,2
20190222-M-Rio_de_Janeiro-QF-Jaume_Munar-Felix_Auger_Aliassime,2,S-XC,6,0,0,0,0,3,3
20190301-M-Sao_Paulo-QF-Casper_Ruud-Hugo_Dellien,1,F-XC,18,5,3,2,0,16,2
20190301-M-Sao_Paulo-QF-Casper_Ruud-Hugo_Dellien,1,F-DTM,8,2,0,0,2,2,6
20190301-M-Sao_Paulo-QF-Casper_Ruud-Hugo_Dellien,1,F-DTL,4,1,1,0,0,4,0
20190301-M-Sao_Paulo-QF-Casper_Ruud-Hugo_Dellien,1,F-IO,22,4,2,1,1,12,10
20190301-M-Sao_Paulo-QF-Casper_Ruud-Hugo_Dellien,1,F-II,5,3,2,0,1,3,2
20190301-M-Sao_Paulo-QF-Casper_Ruud-Hugo_Dellien,1,B-XC,28,1,0,1,0,17,11
20190301-M-Sao_Paulo-QF-Casper_Ruud-Hugo_Dellien,1,B-DTM,8,1,0,0,1,3,5
20190301-M-Sao_Paulo-QF-Casper_Ruud-Hugo_Dellien,1,B-DTL,5,2,1,0,1,2,3
20190301-M-Sao_Paulo-QF-Casper_Ruud-Hugo_Dellien,1,S-XC,2,0,0,0,0,2,0
20190301-M-Sao_Paulo-QF-Casper_Ruud-Hugo_Dellien,2,F-XC,12,6,3,0,3,6,6
20190301-M-Sao_Paulo-QF-Casper_Ruud-Hugo_Dellien,2,F-DTM,8,1,0,0,1,4,4
20190301-M-Sao_Paulo-QF-Casper_Ruud-Hugo_Dellien,2,F-DTL,10,4,0,0,4,1,9
20190301-M-Sao_Paulo-QF-Casper_Ruud-Hugo_Dellien,2,F-IO,36,8,0,5,3,18,18
20190301-M-Sao_Paulo-QF-Casper_Ruud-Hugo_Dellien,2,F-II,7,4,1,1,2,2,5
20190301-M-Sao_Paulo-QF-Casper_Ruud-Hugo_Dellien,2,B-XC,17,3,0,1,2,8,9
20190301-M-Sao_Paulo-QF-Casper_Ruud-Hugo_Dellien,2,B-DTM,4,0,0,0,0,3,1
20190301-M-Sao_Paulo-QF-Casper_Ruud-Hugo_Dellien,2,B-DTL,6,2,0,0,2,0,6
20190301-M-Sao_Paulo-QF-Casper_Ruud-Hugo_Dellien,2,S-XC,2,0,0,0,0,0,2
20190301-M-Sao_Paulo-QF-Casper_Ruud-Hugo_Dellien,2,S-DTM,1,0,0,0,0,0,1
20190301-M-Sao_Paulo-QF-Casper_Ruud-Hugo_Dellien,2,S-DTL,1,0,0,0,0,0,1
19930911-M-US_Open-SF-Pete_Sampras-Alexander_Volkov,1,F-XC,36,7,3,2,2,19,17
19930911-M-US_Open-SF-Pete_Sampras-Alexander_Volkov,1,F-DTM,7,1,0,0,1,5,2
19930911-M-US_Open-SF-Pete_Sampras-Alexander_Volkov,1,F-DTL,8,5,3,0,2,5,3
19930911-M-US_Open-SF-Pete_Sampras-Alexander_Volkov,1,F-IO,16,7,2,3,2,10,6
19930911-M-US_Open-SF-Pete_Sampras-Alexander_Volkov,1,F-II,3,0,0,0,0,1,2
19930911-M-US_Open-SF-Pete_Sampras-Alexander_Volkov,1,B-XC,33,4,3,0,1,18,15
19930911-M-US_Open-SF-Pete_Sampras-Alexander_Volkov,1,B-DTM,28,3,0,0,3,14,14
19930911-M-US_Open-SF-Pete_Sampras-Alexander_Volkov,1,B-DTL,7,1,0,0,1,3,4
19930911-M-US_Open-SF-Pete_Sampras-Alexander_Volkov,1,B-IO,7,3,0,1,2,3,4
19930911-M-US_Open-SF-Pete_Sampras-Alexander_Volkov,1,B-II,1,1,0,1,0,1,0
19930911-M-US_Open-SF-Pete_Sampras-Alexander_Volkov,1,S-XC,10,1,1,0,0,8,2
19930911-M-US_Open-SF-Pete_Sampras-Alexander_Volkov,1,S-DTM,5,0,0,0,0,1,4
19930911-M-US_Open-SF-Pete_Sampras-Alexander_Volkov,1,S-DTL,3,1,0,1,0,2,1
19930911-M-US_Open-SF-Pete_Sampras-Alexander_Volkov,1,S-IO,1,0,0,0,0,0,1
19930911-M-US_Open-SF-Pete_Sampras-Alexander_Volkov,1,S-II,1,0,0,0,0,0,1
19930911-M-US_Open-SF-Pete_Sampras-Alexander_Volkov,2,F-XC,51,7,0,3,4,20,31
19930911-M-US_Open-SF-Pete_Sampras-Alexander_Volkov,2,F-DTM,11,2,0,0,2,5,6
19930911-M-US_Open-SF-Pete_Sampras-Alexander_Volkov,2,F-DTL,21,10,1,1,8,10,11
19930911-M-US_Open-SF-Pete_Sampras-Alexander_Volkov,2,F-IO,5,1,0,0,1,2,3
19930911-M-US_Open-SF-Pete_Sampras-Alexander_Volkov,2,B-XC,25,8,1,2,5,8,17
19930911-M-US_Open-SF-Pete_Sampras-Alexander_Volkov,2,B-DTM,25,2,0,0,2,12,13
19930911-M-US_Open-SF-Pete_Sampras-Alexander_Volkov,2,B-DTL,22,3,0,0,3,10,12
19930911-M-US_Open-SF-Pete_Sampras-Alexander_Volkov,2,B-IO,12,2,0,0,2,4,8
19930911-M-US_Open-SF-Pete_Sampras-Alexander_Volkov,2,B-II,2,2,1,1,0,2,0
19930911-M-US_Open-SF-Pete_Sampras-Alexander_Volkov,2,S-DTL,2,0,0,0,0,2,0
19930911-M-US_Open-SF-Pete_Sampras-Alexander_Volkov,2,S-IO,1,0,0,0,0,1,0
19950127-M-Australian_Open-SF-Michael_Chang-Pete_Sampras,1,F-XC,44,13,8,2,3,26,18
19950127-M-Australian_Open-SF-Michael_Chang-Pete_Sampras,1,F-DTM,24,1,0,1,0,13,11
19950127-M-Australian_Open-SF-Michael_Chang-Pete_Sampras,1,F-DTL,26,6,2,3,1,14,12
19950127-M-Australian_Open-SF-Michael_Chang-Pete_Sampras,1,F-IO,55,10,3,0,7,28,27
19950127-M-Australian_Open-SF-Michael_Chang-Pete_Sampras,1,F-II,15,13,8,3,2,11,4
19950127-M-Australian_Open-SF-Michael_Chang-Pete_Sampras,1,B-XC,143,6,0,2,4,65,78
19950127-M-Australian_Open-SF-Michael_Chang-Pete_Sampras,1,B-DTM,18,1,0,0,1,6,12
19950127-M-Australian_Open-SF-Michael_Chang-Pete_Sampras,1,B-DTL,22,7,4,1,2,13,9
19950127-M-Australian_Open-SF-Michael_Chang-Pete_Sampras,1,B-IO,3,3,2,0,1,2,1
19950127-M-Australian_Open-SF-Michael_Chang-Pete_Sampras,1,S-XC,12,2,0,1,1,4,8
19950127-M-Australian_Open-SF-Michael_Chang-Pete_Sampras,1,S-DTM,8,0,0,0,0,4,4
19950127-M-Australian_Open-SF-Michael_Chang-Pete_Sampras,1,S-DTL,3,0,0,0,0,0,3
19950127-M-Australian_Open-SF-Michael_Chang-Pete_Sampras,2,F-XC,35,9,5,4,0,22,13
19950127-M-Australian_Open-SF-Michael_Chang-Pete_Sampras,2,F-DTM,15,0,0,0,0,5,10
19950127-M-Australian_Open-SF-Michael_Chang-Pete_Sampras,2,F-DTL,21,8,3,3,2,11,10
19950127-M-Australian_Open-SF-Michael_Chang-Pete_Sampras,2,F-IO,54,12,1,7,4,38,16
19950127-M-Australian_Open-SF-Michael_Chang-Pete_Sampras,2,F-II,15,5,1,1,3,9,6
19950127-M-Australian_Open-SF-Michael_Chang-Pete_Sampras,2,B-XC,127,10,2,2,6,58,69
19950127-M-Australian_Open-SF-Michael_Chang-Pete_Sampras,2,B-DTM,17,1,0,0,1,8,9
19950127-M-Australian_Open-SF-Michael_Chang-Pete_Sampras,2,B-DTL,18,12,3,0,9,7,11
19950127-M-Australian_Open-SF-Michael_Chang-Pete_Sampras,2,B-IO,1,0,0,0,0,1,0
19950127-M-Australian_Open-SF-Michael_Chang-Pete_Sampras,2,S-XC,20,3,0,0,3,9,11
19950127-M-Australian_Open-SF-Michael_Chang-Pete_Sampras,2,S-DTM,5,0,0,0,0,4,1
19950127-M-Australian_Open-SF-Michael_Chang-Pete_Sampras,2,S-DTL,6,1,0,0,1,2,4
20190222-M-Marseille-QF-Ugo_Humbert-Matthias_Bachinger,1,F-XC,48,15,5,6,4,34,14
20190222-M-Marseille-QF-Ugo_Humbert-Matthias_Bachinger,1,F-DTM,17,1,0,0,1,12,5
20190222-M-Marseille-QF-Ugo_Humbert-Matthias_Bachinger,1,F-DTL,7,5,4,1,0,6,1
20190222-M-Marseille-QF-Ugo_Humbert-Matthias_Bachinger,1,F-IO,15,6,2,2,2,11,4
20190222-M-Marseille-QF-Ugo_Humbert-Matthias_Bachinger,1,F-II,1,1,1,0,0,1,0
20190222-M-Marseille-QF-Ugo_Humbert-Matthias_Bachinger,1,B-XC,11,3,1,1,1,8,3
20190222-M-Marseille-QF-Ugo_Humbert-Matthias_Bachinger,1,B-DTM,14,2,0,0,2,4,10
20190222-M-Marseille-QF-Ugo_Humbert-Matthias_Bachinger,1,B-DTL,6,1,0,1,0,4,2
20190222-M-Marseille-QF-Ugo_Humbert-Matthias_Bachinger,1,B-IO,6,3,0,2,1,5,1
20190222-M-Marseille-QF-Ugo_Humbert-Matthias_Bachinger,1,S-DTL,1,0,0,0,0,1,0
20190222-M-Marseille-QF-Ugo_Humbert-Matthias_Bachinger,1,S-IO,1,0,0,0,0,1,0
20190222-M-Marseille-QF-Ugo_Humbert-Matthias_Bachinger,2,F-XC,20,4,1,0,3,10,10
20190222-M-Marseille-QF-Ugo_Humbert-Matthias_Bachinger,2,F-DTM,13,0,0,0,0,4,9
20190222-M-Marseille-QF-Ugo_Humbert-Matthias_Bachinger,2,F-DTL,4,0,0,0,0,1,3
20190222-M-Marseille-QF-Ugo_Humbert-Matthias_Bachinger,2,F-IO,16,4,2,0,2,6,10
20190222-M-Marseille-QF-Ugo_Humbert-Matthias_Bachinger,2,F-II,1,1,0,0,1,0,1
20190222-M-Marseille-QF-Ugo_Humbert-Matthias_Bachinger,2,B-XC,21,3,0,1,2,4,17
20190222-M-Marseille-QF-Ugo_Humbert-Matthias_Bachinger,2,B-DTM,24,1,0,0,1,9,15
20190222-M-Marseille-QF-Ugo_Humbert-Matthias_Bachinger,2,B-DTL,5,3,0,2,1,3,2
20190222-M-Marseille-QF-Ugo_Humbert-Matthias_Bachinger,2,B-IO,3,2,0,0,2,1,2
20190222-M-Marseille-QF-Ugo_Humbert-Matthias_Bachinger,2,S-XC,3,0,0,0,0,1,2
20190222-M-Marseille-QF-Ugo_Humbert-Matthias_Bachinger,2,S-DTM,6,0,0,0,0,2,4
19980912-M-US_Open-SF-Patrick_Rafter-Pete_Sampras,1,F-XC,7,3,2,0,1,3,4
19980912-M-US_Open-SF-Patrick_Rafter-Pete_Sampras,1,F-DTM,2,0,0,0,0,0,2
19980912-M-US_Open-SF-Patrick_Rafter-Pete_Sampras,1,F-DTL,6,3,1,1,1,4,2
19980912-M-US_Open-SF-Patrick_Rafter-Pete_Sampras,1,B-XC,10,4,3,0,1,5,5
19980912-M-US_Open-SF-Patrick_Rafter-Pete_Sampras,1,B-DTL,10,7,3,1,3,4,6
19980912-M-US_Open-SF-Patrick_Rafter-Pete_Sampras,1,B-IO,1,1,1,0,0,1,0
19980912-M-US_Open-SF-Patrick_Rafter-Pete_Sampras,1,S-XC,10,2,1,0,1,5,5
19980912-M-US_Open-SF-Patrick_Rafter-Pete_Sampras,1,S-DTM,2,0,0,0,0,1,1
19980912-M-US_Open-SF-Patrick_Rafter-Pete_Sampras,1,S-DTL,4,1,0,0,1,2,2
19980912-M-US_Open-SF-Patrick_Rafter-Pete_Sampras,1,S-IO,1,0,0,0,0,0,1
19980912-M-US_Open-SF-Patrick_Rafter-Pete_Sampras,2,F-XC,11,5,2,1,2,5,6
19980912-M-US_Open-SF-Patrick_Rafter-Pete_Sampras,2,F-DTM,1,0,0,0,0,1,0
19980912-M-US_Open-SF-Patrick_Rafter-Pete_Sampras,2,F-DTL,8,5,3,1,1,6,2
19980912-M-US_Open-SF-Patrick_Rafter-Pete_Sampras,2,F-IO,16,9,5,4,0,15,1
19980912-M-US_Open-SF-Patrick_Rafter-Pete_Sampras,2,F-II,1,1,0,0,1,0,1
19980912-M-US_Open-SF-Patrick_Rafter-Pete_Sampras,2,B-XC,13,3,0,0,3,5,8
19980912-M-US_Open-SF-Patrick_Rafter-Pete_Sampras,2,B-DTM,3,0,0,0,0,1,2
19980912-M-US_Open-SF-Patrick_Rafter-Pete_Sampras,2,B-DTL,4,2,1,0,1,2,2
19980912-M-US_Open-SF-Patrick_Rafter-Pete_Sampras,2,B-IO,1,1,0,1,0,1,0
19980912-M-US_Open-SF-Patrick_Rafter-Pete_Sampras,2,S-XC,5,0,0,0,0,3,2
19980912-M-US_Open-SF-Patrick_Rafter-Pete_Sampras,2,S-DTM,2,1,0,0,1,1,1
19980912-M-US_Open-SF-Patrick_Rafter-Pete_Sampras,2,S-DTL,2,1,0,0,1,1,1
19980912-M-US_Open-SF-Patrick_Rafter-Pete_Sampras,2,S-IO,3,2,0,1,1,1,2
20190304-M-Zhuhai_CH-R64-Jose_Hernandez-Karim_Mohamed_Maamoun,1,F-XC,26,8,1,3,4,14,12
20190304-M-Zhuhai_CH-R64-Jose_Hernandez-Karim_Mohamed_Maamoun,1,F-DTM,21,0,0,0,0,10,11
20190304-M-Zhuhai_CH-R64-Jose_Hernandez-Karim_Mohamed_Maamoun,1,F-DTL,3,1,0,0,1,1,2
20190304-M-Zhuhai_CH-R64-Jose_Hernandez-Karim_Mohamed_Maamoun,1,F-IO,22,5,2,1,2,16,6
20190304-M-Zhuhai_CH-R64-Jose_Hernandez-Karim_Mohamed_Maamoun,1,F-II,2,2,0,1,1,1,1
20190304-M-Zhuhai_CH-R64-Jose_Hernandez-Karim_Mohamed_Maamoun,1,B-XC,39,4,1,0,3,23,16
20190304-M-Zhuhai_CH-R64-Jose_Hernandez-Karim_Mohamed_Maamoun,1,B-DTM,21,2,1,0,1,11,10
20190304-M-Zhuhai_CH-R64-Jose_Hernandez-Karim_Mohamed_Maamoun,1,B-DTL,7,4,1,2,1,6,1
20190304-M-Zhuhai_CH-R64-Jose_Hernandez-Karim_Mohamed_Maamoun,1,B-IO,4,1,1,0,0,4,0
20190304-M-Zhuhai_CH-R64-Jose_Hernandez-Karim_Mohamed_Maamoun,1,S-XC,3,1,0,0,1,1,2
20190304-M-Zhuhai_CH-R64-Jose_Hernandez-Karim_Mohamed_Maamoun,2,F-XC,27,12,2,3,7,15,12
20190304-M-Zhuhai_CH-R64-Jose_Hernandez-Karim_Mohamed_Maamoun,2,F-DTM,26,3,0,0,3,9,17
20190304-M-Zhuhai_CH-R64-Jose_Hernandez-Karim_Mohamed_Maamoun,2,F-DTL,7,2,1,0,1,1,6
20190304-M-Zhuhai_CH-R64-Jose_Hernandez-Karim_Mohamed_Maamoun,2,F-IO,11,4,0,3,1,8,3
20190304-M-Zhuhai_CH-R64-Jose_Hernandez-Karim_Mohamed_Maamoun,2,F-II,2,1,1,0,0,2,0
20190304-M-Zhuhai_CH-R64-Jose_Hernandez-Karim_Mohamed_Maamoun,2,B-XC,46,8,0,2,6,17,29
20190304-M-Zhuhai_CH-R64-Jose_Hernandez-Karim_Mohamed_Maamoun,2,B-DTM,16,1,0,0,1,9,7
20190304-M-Zhuhai_CH-R64-Jose_Hernandez-Karim_Mohamed_Maamoun,2,B-DTL,3,2,1,0,1,1,2
20190304-M-Zhuhai_CH-R64-Jose_Hernandez-Karim_Mohamed_Maamoun,2,B-IO,1,1,1,0,0,1,0
20190304-M-Zhuhai_CH-R64-Jose_Hernandez-Karim_Mohamed_Maamoun,2,B-II,1,1,0,0,1,0,1
20190304-M-Zhuhai_CH-R64-Jose_Hernandez-Karim_Mohamed_Maamoun,2,S-XC,5,3,0,1,2,2,3
20190304-M-Zhuhai_CH-R64-Jose_Hernandez-Karim_Mohamed_Maamoun,2,S-DTM,5,1,0,0,1,1,4
20190304-M-Zhuhai_CH-R64-Jose_Hernandez-Karim_Mohamed_Maamoun,2,S-DTL,1,0,0,0,0,0,1
20180127-M-Newport_Beach_CH-SF-Bradley_Klahn-Christian_Garin,1,F-XC,43,14,5,3,6,29,14
20180127-M-Newport_Beach_CH-SF-Bradley_Klahn-Christian_Garin,1,F-DTM,8,1,0,0,1,6,2
20180127-M-Newport_Beach_CH-SF-Bradley_Klahn-Christian_Garin,1,F-DTL,6,4,3,0,1,4,2
20180127-M-Newport_Beach_CH-SF-Bradley_Klahn-Christian_Garin,1,F-IO,13,9,2,4,3,8,5
20180127-M-Newport_Beach_CH-SF-Bradley_Klahn-Christian_Garin,1,B-XC,5,2,0,0,2,0,5
20180127-M-Newport_Beach_CH-SF-Bradley_Klahn-Christian_Garin,1,B-DTM,7,0,0,0,0,3,4
20180127-M-Newport_Beach_CH-SF-Bradley_Klahn-Christian_Garin,1,B-DTL,5,3,0,0,3,1,4
20180127-M-Newport_Beach_CH-SF-Bradley_Klahn-Christian_Garin,1,S-XC,7,1,0,0,1,5,2
20180127-M-Newport_Beach_CH-SF-Bradley_Klahn-Christian_Garin,1,S-DTM,9,0,0,0,0,5,4
20180127-M-Newport_Beach_CH-SF-Bradley_Klahn-Christian_Garin,1,S-DTL,26,6,0,3,3,13,13
20180127-M-Newport_Beach_CH-SF-Bradley_Klahn-Christian_Garin,1,S-IO,3,0,0,0,0,2,1
20180127-M-Newport_Beach_CH-SF-Bradley_Klahn-Christian_Garin,2,F-XC,37,7,2,4,1,24,13
20180127-M-Newport_Beach_CH-SF-Bradley_Klahn-Christian_Garin,2,F-DTM,10,0,0,0,0,3,7
20180127-M-Newport_Beach_CH-SF-Bradley_Klahn-Christian_Garin,2,F-DTL,2,0,0,0,0,1,1
20180127-M-Newport_Beach_CH-SF-Bradley_Klahn-Christian_Garin,2,F-IO,12,7,1,3,3,4,8
20180127-M-Newport_Beach_CH-SF-Bradley_Klahn-Christian_Garin,2,F-II,5,0,0,0,0,4,1
20180127-M-Newport_Beach_CH-SF-Bradley_Klahn-Christian_Garin,2,B-XC,28,9,2,3,4,12,16
20180127-M-Newport_Beach_CH-SF-Bradley_Klahn-Christian_Garin,2,B-DTM,14,4,0,0,4,3,11
20180127-M-Newport_Beach_CH-SF-Bradley_Klahn-Christian_Garin,2,B-DTL,15,4,2,1,1,8,7
20180127-M-Newport_Beach_CH-SF-Bradley_Klahn-Christian_Garin,2,B-IO,3,1,1,0,0,2,1
20180127-M-Newport_Beach_CH-SF-Bradley_Klahn-Christian_Garin,2,S-XC,1,1,0,0,1,0,1
20180127-M-Newport_Beach_CH-SF-Bradley_Klahn-Christian_Garin,2,S-DTM,3,0,0,0,0,0,3
20180127-M-Newport_Beach_CH-SF-Bradley_Klahn-Christian_Garin,2,S-DTL,7,2,0,0,2,2,5
20180127-M-Newport_Beach_CH-SF-Bradley_Klahn-Christian_Garin,2,S-IO,1,0,0,0,0,0,1
20190301-M-Acapulco-SF-John_Isner-Nick_Kyrgios,1,F-XC,20,11,5,5,1,16,4
20190301-M-Acapulco-SF-John_Isner-Nick_Kyrgios,1,F-DTM,10,1,0,0,1,6,4
20190301-M-Acapulco-SF-John_Isner-Nick_Kyrgios,1,F-DTL,8,1,0,1,0,6,2
20190301-M-Acapulco-SF-John_Isner-Nick_Kyrgios,1,F-IO,38,19,9,4,6,27,11
20190301-M-Acapulco-SF-John_Isner-Nick_Kyrgios,1,F-II,3,2,0,2,0,2,1
20190301-M-Acapulco-SF-John_Isner-Nick_Kyrgios,1,B-XC,20,2,0,1,1,9,11
20190301-M-Acapulco-SF-John_Isner-Nick_Kyrgios,1,B-DTM,17,2,0,0,2,8,9
20190301-M-Acapulco-SF-John_Isner-Nick_Kyrgios,1,B-DTL,5,4,2,0,2,3,2
20190301-M-Acapulco-SF-John_Isner-Nick_Kyrgios,1,S-XC,11,1,0,0,1,5,6
20190301-M-Acapulco-SF-John_Isner-Nick_Kyrgios,1,S-DTM,2,0,0,0,0,1,1
20190301-M-Acapulco-SF-John_Isner-Nick_Kyrgios,1,S-DTL,1,1,0,1,0,1,0
20190301-M-Acapulco-SF-John_Isner-Nick_Kyrgios,2,F-XC,14,2,0,0,2,5,9
20190301-M-Acapulco-SF-John_Isner-Nick_Kyrgios,2,F-DTM,14,1,0,0,1,3,11
20190301-M-Acapulco-SF-John_Isner-Nick_Kyrgios,2,F-DTL,6,4,3,0,1,4,2
20190301-M-Acapulco-SF-John_Isner-Nick_Kyrgios,2,F-IO,14,6,3,1,2,10,4
20190301-M-Acapulco-SF-John_Isner-Nick_Kyrgios,2,F-II,2,1,1,0,0,2,0
20190301-M-Acapulco-SF-John_Isner-Nick_Kyrgios,2,B-XC,46,12,3,2,7,22,24
20190301-M-Acapulco-SF-John_Isner-Nick_Kyrgios,2,B-DTM,10,0,0,0,0,2,8
20190301-M-Acapulco-SF-John_Isner-Nick_Kyrgios,2,B-DTL,14,10,3,1,6,6,8
20190301-M-Acapulco-SF-John_Isner-Nick_Kyrgios,2,B-IO,2,2,2,0,0,2,0
20190301-M-Acapulco-SF-John_Isner-Nick_Kyrgios,2,S-XC,3,0,0,0,0,1,2
20190301-M-Acapulco-SF-John_Isner-Nick_Kyrgios,2,S-DTM,2,0,0,0,0,0,2
20190301-M-Acapulco-SF-John_Isner-Nick_Kyrgios,2,S-DTL,3,1,0,1,0,2,1
20190228-M-Dubai-QF-Stefanos_Tsitsipas-Hubert_Hurkacz,1,F-XC,62,17,6,7,4,35,27
20190228-M-Dubai-QF-Stefanos_Tsitsipas-Hubert_Hurkacz,1,F-DTM,21,1,0,0,1,12,9
20190228-M-Dubai-QF-Stefanos_Tsitsipas-Hubert_Hurkacz,1,F-DTL,19,5,2,2,1,12,7
20190228-M-Dubai-QF-Stefanos_Tsitsipas-Hubert_Hurkacz,1,F-IO,36,9,4,2,3,27,9
20190228-M-Dubai-QF-Stefanos_Tsitsipas-Hubert_Hurkacz,1,F-II,5,2,1,0,1,4,1
20190228-M-Dubai-QF-Stefanos_Tsitsipas-Hubert_Hurkacz,1,B-XC,47,7,1,2,4,28,19
20190228-M-Dubai-QF-Stefanos_Tsitsipas-Hubert_Hurkacz,1,B-DTM,16,1,0,0,1,6,10
20190228-M-Dubai-QF-Stefanos_Tsitsipas-Hubert_Hurkacz,1,B-DTL,5,3,2,0,1,4,1
20190228-M-Dubai-QF-Stefanos_Tsitsipas-Hubert_Hurkacz,1,B-IO,5,2,2,0,0,3,2
20190228-M-Dubai-QF-Stefanos_Tsitsipas-Hubert_Hurkacz,1,S-XC,12,1,0,0,1,8,4
20190228-M-Dubai-QF-Stefanos_Tsitsipas-Hubert_Hurkacz,1,S-DTM,3,0,0,0,0,3,0
20190228-M-Dubai-QF-Stefanos_Tsitsipas-Hubert_Hurkacz,1,S-IO,1,0,0,0,0,1,0
20190228-M-Dubai-QF-Stefanos_Tsitsipas-Hubert_Hurkacz,2,F-XC,48,9,1,3,5,24,24
20190228-M-Dubai-QF-Stefanos_Tsitsipas-Hubert_Hurkacz,2,F-DTM,23,1,0,0,1,9,14
20190228-M-Dubai-QF-Stefanos_Tsitsipas-Hubert_Hurkacz,2,F-DTL,24,4,1,3,0,15,9
20190228-M-Dubai-QF-Stefanos_Tsitsipas-Hubert_Hurkacz,2,F-IO,18,7,1,3,3,9,9
20190228-M-Dubai-QF-Stefanos_Tsitsipas-Hubert_Hurkacz,2,F-II,8,3,0,1,2,4,4
20190228-M-Dubai-QF-Stefanos_Tsitsipas-Hubert_Hurkacz,2,B-XC,43,6,0,3,3,15,28
20190228-M-Dubai-QF-Stefanos_Tsitsipas-Hubert_Hurkacz,2,B-DTM,27,4,1,0,3,6,21
20190228-M-Dubai-QF-Stefanos_Tsitsipas-Hubert_Hurkacz,2,B-DTL,23,9,3,2,4,13,10
20190228-M-Dubai-QF-Stefanos_Tsitsipas-Hubert_Hurkacz,2,B-IO,6,3,1,1,1,4,2
20190228-M-Dubai-QF-Stefanos_Tsitsipas-Hubert_Hurkacz,2,S-XC,4,1,0,1,0,1,3
20190228-M-Dubai-QF-Stefanos_Tsitsipas-Hubert_Hurkacz,2,S-DTM,5,0,0,0,0,0,5
20190228-M-Dubai-QF-Stefanos_Tsitsipas-Hubert_Hurkacz,2,S-DTL,2,0,0,0,0,2,0
20190228-M-Dubai-QF-Stefanos_Tsitsipas-Hubert_Hurkacz,2,S-IO,1,0,0,0,0,1,0
20190302-M-Sao_Paulo-SF-Casper_Ruud-Christian_Garin,1,F-XC,28,9,2,1,6,7,21
20190302-M-Sao_Paulo-SF-Casper_Ruud-Christian_Garin,1,F-DTM,8,3,0,0,3,0,8
20190302-M-Sao_Paulo-SF-Casper_Ruud-Christian_Garin,1,F-DTL,8,2,2,0,0,3,5
20190302-M-Sao_Paulo-SF-Casper_Ruud-Christian_Garin,1,F-IO,18,2,1,0,1,9,9
20190302-M-Sao_Paulo-SF-Casper_Ruud-Christian_Garin,1,F-II,4,1,0,0,1,2,2
20190302-M-Sao_Paulo-SF-Casper_Ruud-Christian_Garin,1,B-XC,37,5,1,0,4,9,28
20190302-M-Sao_Paulo-SF-Casper_Ruud-Christian_Garin,1,B-DTM,8,0,0,0,0,2,6
20190302-M-Sao_Paulo-SF-Casper_Ruud-Christian_Garin,1,B-DTL,3,1,0,0,1,1,2
20190302-M-Sao_Paulo-SF-Casper_Ruud-Christian_Garin,1,S-XC,9,1,0,0,1,1,8
20190302-M-Sao_Paulo-SF-Casper_Ruud-Christian_Garin,1,S-DTM,2,1,0,0,1,0,2
20190302-M-Sao_Paulo-SF-Casper_Ruud-Christian_Garin,2,F-XC,23,10,5,3,2,18,5
20190302-M-Sao_Paulo-SF-Casper_Ruud-Christian_Garin,2,F-DTM,12,0,0,0,0,11,1
20190302-M-Sao_Paulo-SF-Casper_Ruud-Christian_Garin,2,F-DTL,11,4,0,2,2,9,2
20190302-M-Sao_Paulo-SF-Casper_Ruud-Christian_Garin,2,F-IO,16,3,0,1,2,12,4
20190302-M-Sao_Paulo-SF-Casper_Ruud-Christian_Garin,2,F-II,4,3,2,1,0,4,0
20190302-M-Sao_Paulo-SF-Casper_Ruud-Christian_Garin,2,B-XC,45,9,2,3,4,29,16
20190302-M-Sao_Paulo-SF-Casper_Ruud-Christian_Garin,2,B-DTM,11,1,0,0,1,7,4
20190302-M-Sao_Paulo-SF-Casper_Ruud-Christian_Garin,2,B-DTL,10,6,3,0,3,7,3
20190302-M-Sao_Paulo-SF-Casper_Ruud-Christian_Garin,2,B-IO,3,2,1,0,1,2,1
20190302-M-Sao_Paulo-SF-Casper_Ruud-Christian_Garin,2,S-DTM,2,0,0,0,0,2,0
20180530-M-Roland_Garros-R64-Novak_Djokovic-Jaume_Munar,1,F-XC,90,27,13,9,5,55,35
20180530-M-Roland_Garros-R64-Novak_Djokovic-Jaume_Munar,1,F-DTM,22,1,0,0,1,12,10
20180530-M-Roland_Garros-R64-Novak_Djokovic-Jaume_Munar,1,F-DTL,23,2,0,0,2,14,9
20180530-M-Roland_Garros-R64-Novak_Djokovic-Jaume_Munar,1,F-IO,49,10,3,5,2,26,23
20180530-M-Roland_Garros-R64-Novak_Djokovic-Jaume_Munar,1,F-II,8,6,3,3,0,8,0
20180530-M-Roland_Garros-R64-Novak_Djokovic-Jaume_Munar,1,B-XC,76,10,2,3,5,53,23
20180530-M-Roland_Garros-R64-Novak_Djokovic-Jaume_Munar,1,B-DTM,15,1,0,1,0,10,5
20180530-M-Roland_Garros-R64-Novak_Djokovic-Jaume_Munar,1,B-DTL,15,9,4,2,3,11,4
20180530-M-Roland_Garros-R64-Novak_Djokovic-Jaume_Munar,1,B-IO,8,4,3,0,1,5,3
20180530-M-Roland_Garros-R64-Novak_Djokovic-Jaume_Munar,1,S-DTM,2,0,0,0,0,1,1
20180530-M-Roland_Garros-R64-Novak_Djokovic-Jaume_Munar,2,F-XC,50,9,4,1,4,26,24
20180530-M-Roland_Garros-R64-Novak_Djokovic-Jaume_Munar,2,F-DTM,29,1,0,0,1,9,20
20180530-M-Roland_Garros-R64-Novak_Djokovic-Jaume_Munar,2,F-DTL,21,4,2,1,1,10,11
20180530-M-Roland_Garros-R64-Novak_Djokovic-Jaume_Munar,2,F-IO,29,8,5,1,2,14,15
20180530-M-Roland_Garros-R64-Novak_Djokovic-Jaume_Munar,2,F-II,6,1,0,1,0,2,4
20180530-M-Roland_Garros-R64-Novak_Djokovic-Jaume_Munar,2,B-XC,62,2,1,0,1,19,43
20180530-M-Roland_Garros-R64-Novak_Djokovic-Jaume_Munar,2,B-DTM,36,2,0,0,2,17,19
20180530-M-Roland_Garros-R64-Novak_Djokovic-Jaume_Munar,2,B-DTL,30,10,3,3,4,14,16
20180530-M-Roland_Garros-R64-Novak_Djokovic-Jaume_Munar,2,B-IO,3,1,0,0,1,2,1
20180530-M-Roland_Garros-R64-Novak_Djokovic-Jaume_Munar,2,S-XC,11,0,0,0,0,2,9
20180530-M-Roland_Garros-R64-Novak_Djokovic-Jaume_Munar,2,S-DTM,5,0,0,0,0,2,3
20180530-M-Roland_Garros-R64-Novak_Djokovic-Jaume_Munar,2,S-DTL,3,1,1,0,0,2,1
20190228-M-Acapulco-QF-Nick_Kyrgios-Stanislas_Wawrinka,1,F-XC,31,13,5,3,5,17,14
20190228-M-Acapulco-QF-Nick_Kyrgios-Stanislas_Wawrinka,1,F-DTM,36,4,0,0,4,17,19
20190228-M-Acapulco-QF-Nick_Kyrgios-Stanislas_Wawrinka,1,F-DTL,9,3,1,1,1,5,4
20190228-M-Acapulco-QF-Nick_Kyrgios-Stanislas_Wawrinka,1,F-IO,35,12,6,2,4,22,13
20190228-M-Acapulco-QF-Nick_Kyrgios-Stanislas_Wawrinka,1,F-II,7,3,1,1,1,3,4
20190228-M-Acapulco-QF-Nick_Kyrgios-Stanislas_Wawrinka,1,B-XC,53,10,1,2,7,24,29
20190228-M-Acapulco-QF-Nick_Kyrgios-Stanislas_Wawrinka,1,B-DTM,12,2,0,0,2,5,7
20190228-M-Acapulco-QF-Nick_Kyrgios-Stanislas_Wawrinka,1,B-DTL,6,1,0,0,1,3,3
20190228-M-Acapulco-QF-Nick_Kyrgios-Stanislas_Wawrinka,1,B-IO,4,1,0,0,1,1,3
20190228-M-Acapulco-QF-Nick_Kyrgios-Stanislas_Wawrinka,1,S-XC,3,0,0,0,0,1,2
20190228-M-Acapulco-QF-Nick_Kyrgios-Stanislas_Wawrinka,1,S-DTM,3,1,0,0,1,1,2
20190228-M-Acapulco-QF-Nick_Kyrgios-Stanislas_Wawrinka,1,S-DTL,1,0,0,0,0,0,1
20190228-M-Acapulco-QF-Nick_Kyrgios-Stanislas_Wawrinka,2,F-XC,37,8,4,1,3,22,15
20190228-M-Acapulco-QF-Nick_Kyrgios-Stanislas_Wawrinka,2,F-DTM,25,3,1,0,2,14,11
20190228-M-Acapulco-QF-Nick_Kyrgios-Stanislas_Wawrinka,2,F-DTL,5,3,2,0,1,2,3
20190228-M-Acapulco-QF-Nick_Kyrgios-Stanislas_Wawrinka,2,F-IO,17,7,2,2,3,12,5
20190228-M-Acapulco-QF-Nick_Kyrgios-Stanislas_Wawrinka,2,F-II,1,0,0,0,0,1,0
20190228-M-Acapulco-QF-Nick_Kyrgios-Stanislas_Wawrinka,2,B-XC,45,11,1,1,9,24,21
20190228-M-Acapulco-QF-Nick_Kyrgios-Stanislas_Wawrinka,2,B-DTM,27,7,1,1,5,9,18
20190228-M-Acapulco-QF-Nick_Kyrgios-Stanislas_Wawrinka,2,B-DTL,12,10,5,3,2,10,2
20190228-M-Acapulco-QF-Nick_Kyrgios-Stanislas_Wawrinka,2,B-IO,1,0,0,0,0,0,1
20190228-M-Acapulco-QF-Nick_Kyrgios-Stanislas_Wawrinka,2,S-XC,22,2,0,0,2,9,13
20190228-M-Acapulco-QF-Nick_Kyrgios-Stanislas_Wawrinka,2,S-DTM,9,0,0,0,0,4,5
20190228-M-Acapulco-QF-Nick_Kyrgios-Stanislas_Wawrinka,2,S-DTL,3,0,0,0,0,1,2
20190228-M-Acapulco-QF-Nick_Kyrgios-Stanislas_Wawrinka,2,S-IO,2,1,1,0,0,2,0
20000604-M-Roland_Garros-R16-Alex_Corretja-Roger_Federer,1,F-XC,51,16,4,4,8,35,16
20000604-M-Roland_Garros-R16-Alex_Corretja-Roger_Federer,1,F-DTM,36,3,0,0,3,10,26
20000604-M-Roland_Garros-R16-Alex_Corretja-Roger_Federer,1,F-DTL,18,4,1,0,3,9,9
20000604-M-Roland_Garros-R16-Alex_Corretja-Roger_Federer,1,F-IO,58,8,4,3,1,37,21
20000604-M-Roland_Garros-R16-Alex_Corretja-Roger_Federer,1,F-II,2,0,0,0,0,1,1
20000604-M-Roland_Garros-R16-Alex_Corretja-Roger_Federer,1,B-XC,57,11,2,4,5,32,25
20000604-M-Roland_Garros-R16-Alex_Corretja-Roger_Federer,1,B-DTM,72,5,0,2,3,39,33
20000604-M-Roland_Garros-R16-Alex_Corretja-Roger_Federer,1,B-DTL,15,9,2,0,7,7,8
20000604-M-Roland_Garros-R16-Alex_Corretja-Roger_Federer,1,B-IO,9,2,1,0,1,5,4
20000604-M-Roland_Garros-R16-Alex_Corretja-Roger_Federer,1,S-XC,6,0,0,0,0,3,3
20000604-M-Roland_Garros-R16-Alex_Corretja-Roger_Federer,1,S-DTM,6,0,0,0,0,2,4
20000604-M-Roland_Garros-R16-Alex_Corretja-Roger_Federer,1,S-DTL,5,0,0,0,0,3,2
20000604-M-Roland_Garros-R16-Alex_Corretja-Roger_Federer,2,F-XC,62,17,7,5,5,32,30
20000604-M-Roland_Garros-R16-Alex_Corretja-Roger_Federer,2,F-DTM,57,5,0,0,5,22,35
20000604-M-Roland_Garros-R16-Alex_Corretja-Roger_Federer,2,F-DTL,12,6,1,0,5,4,8
20000604-M-Roland_Garros-R16-Alex_Corretja-Roger_Federer,2,F-IO,54,17,7,6,4,35,19
20000604-M-Roland_Garros-R16-Alex_Corretja-Roger_Federer,2,F-II,4,1,0,1,0,4,0
20000604-M-Roland_Garros-R16-Alex_Corretja-Roger_Federer,2,B-XC,56,12,2,0,10,26,30
20000604-M-Roland_Garros-R16-Alex_Corretja-Roger_Federer,2,B-DTM,62,6,0,0,6,21,41
20000604-M-Roland_Garros-R16-Alex_Corretja-Roger_Federer,2,B-DTL,7,2,0,0,2,2,5
20000604-M-Roland_Garros-R16-Alex_Corretja-Roger_Federer,2,B-IO,2,1,0,0,1,0,2
20000604-M-Roland_Garros-R16-Alex_Corretja-Roger_Federer,2,S-XC,13,1,0,0,1,5,8
20000604-M-Roland_Garros-R16-Alex_Corretja-Roger_Federer,2,S-DTM,21,2,0,0,2,6,15
20000604-M-Roland_Garros-R16-Alex_Corretja-Roger_Federer,2,S-DTL,2,0,0,0,0,1,1
20000604-M-Roland_Garros-R16-Alex_Corretja-Roger_Federer,2,S-IO,1,0,0,0,0,0,1
20180210-M-Sofia-SF-Jozef_Kovalik-Marius_Copil,1,F-XC,15,3,1,1,1,8,7
20180210-M-Sofia-SF-Jozef_Kovalik-Marius_Copil,1,F-DTM,10,3,0,2,1,4,6
20180210-M-Sofia-SF-Jozef_Kovalik-Marius_Copil,1,F-DTL,3,1,1,0,0,2,1
20180210-M-Sofia-SF-Jozef_Kovalik-Marius_Copil,1,F-IO,30,6,1,0,5,14,16
20180210-M-Sofia-SF-Jozef_Kovalik-Marius_Copil,1,F-II,3,3,1,0,2,1,2
20180210-M-Sofia-SF-Jozef_Kovalik-Marius_Copil,1,B-XC,18,4,0,1,3,5,13
20180210-M-Sofia-SF-Jozef_Kovalik-Marius_Copil,1,B-DTM,6,0,0,0,0,1,5
20180210-M-Sofia-SF-Jozef_Kovalik-Marius_Copil,1,B-DTL,4,2,1,0,1,2,2
20180210-M-Sofia-SF-Jozef_Kovalik-Marius_Copil,1,B-IO,3,2,0,0,2,0,3
20180210-M-Sofia-SF-Jozef_Kovalik-Marius_Copil,1,S-XC,10,1,0,0,1,4,6
20180210-M-Sofia-SF-Jozef_Kovalik-Marius_Copil,1,S-DTL,2,0,0,0,0,2,0
20180210-M-Sofia-SF-Jozef_Kovalik-Marius_Copil,2,F-XC,6,4,1,3,0,4,2
20180210-M-Sofia-SF-Jozef_Kovalik-Marius_Copil,2,F-DTM,10,1,0,0,1,4,6
20180210-M-Sofia-SF-Jozef_Kovalik-Marius_Copil,2,F-DTL,5,1,0,0,1,3,2
20180210-M-Sofia-SF-Jozef_Kovalik-Marius_Copil,2,F-IO,7,0,0,0,0,4,3
20180210-M-Sofia-SF-Jozef_Kovalik-Marius_Copil,2,F-II,2,1,1,0,0,1,1
20180210-M-Sofia-SF-Jozef_Kovalik-Marius_Copil,2,B-XC,22,7,2,4,1,18,4
20180210-M-Sofia-SF-Jozef_Kovalik-Marius_Copil,2,B-DTM,13,0,0,0,0,8,5
20180210-M-Sofia-SF-Jozef_Kovalik-Marius_Copil,2,B-DTL,6,3,1,0,2,2,4
20180210-M-Sofia-SF-Jozef_Kovalik-Marius_Copil,2,S-XC,11,1,0,0,1,1,10
20180210-M-Sofia-SF-Jozef_Kovalik-Marius_Copil,2,S-DTM,4,0,0,0,0,4,0
20180210-M-Sofia-SF-Jozef_Kovalik-Marius_Copil,2,S-DTL,2,0,0,0,0,2,0
19920905-M-US_Open-SF-Jim_Courier-Pete_Sampras,1,F-XC,32,10,2,4,4,13,19
19920905-M-US_Open-SF-Jim_Courier-Pete_Sampras,1,F-DTM,12,2,0,0,2,5,7
19920905-M-US_Open-SF-Jim_Courier-Pete_Sampras,1,F-DTL,15,3,2,0,1,9,6
19920905-M-US_Open-SF-Jim_Courier-Pete_Sampras,1,F-IO,65,15,1,4,10,22,43
19920905-M-US_Open-SF-Jim_Courier-Pete_Sampras,1,F-II,18,7,3,2,2,10,8
19920905-M-US_Open-SF-Jim_Courier-Pete_Sampras,1,B-XC,44,6,4,1,1,23,21
19920905-M-US_Open-SF-Jim_Courier-Pete_Sampras,1,B-DTM,9,1,0,0,1,2,7
19920905-M-US_Open-SF-Jim_Courier-Pete_Sampras,1,B-DTL,13,9,5,0,4,8,5
19920905-M-US_Open-SF-Jim_Courier-Pete_Sampras,1,B-IO,1,0,0,0,0,0,1
19920905-M-US_Open-SF-Jim_Courier-Pete_Sampras,1,S-XC,13,2,1,1,0,4,9
19920905-M-US_Open-SF-Jim_Courier-Pete_Sampras,1,S-DTM,2,0,0,0,0,2,0
19920905-M-US_Open-SF-Jim_Courier-Pete_Sampras,1,S-DTL,2,1,1,0,0,1,1
19920905-M-US_Open-SF-Jim_Courier-Pete_Sampras,2,F-XC,23,9,3,6,0,17,6
19920905-M-US_Open-SF-Jim_Courier-Pete_Sampras,2,F-DTM,7,0,0,0,0,3,4
19920905-M-US_Open-SF-Jim_Courier-Pete_Sampras,2,F-DTL,14,4,1,1,2,10,4
19920905-M-US_Open-SF-Jim_Courier-Pete_Sampras,2,F-IO,31,3,2,1,0,23,8
19920905-M-US_Open-SF-Jim_Courier-Pete_Sampras,2,F-II,6,4,0,1,3,1,5
19920905-M-US_Open-SF-Jim_Courier-Pete_Sampras,2,B-XC,47,4,2,0,2,29,18
19920905-M-US_Open-SF-Jim_Courier-Pete_Sampras,2,B-DTM,10,1,0,1,0,6,4
19920905-M-US_Open-SF-Jim_Courier-Pete_Sampras,2,B-DTL,10,0,0,0,0,7,3
19920905-M-US_Open-SF-Jim_Courier-Pete_Sampras,2,B-IO,1,0,0,0,0,1,0
19920905-M-US_Open-SF-Jim_Courier-Pete_Sampras,2,S-XC,13,0,0,0,0,8,5
19920905-M-US_Open-SF-Jim_Courier-Pete_Sampras,2,S-DTM,7,0,0,0,0,4,3
19920905-M-US_Open-SF-Jim_Courier-Pete_Sampras,2,S-DTL,8,3,1,1,1,5,3
19920905-M-US_Open-SF-Jim_Courier-Pete_Sampras,2,S-IO,3,2,0,0,2,0,3
19920905-M-US_Open-SF-Jim_Courier-Pete_Sampras,2,S-II,1,0,0,0,0,1,0
19991107-M-Paris_Masters-F-Andre_Agassi-Marat_Safin,1,F-XC,71,12,2,6,4,44,27
19991107-M-Paris_Masters-F-Andre_Agassi-Marat_Safin,1,F-DTM,38,2,0,0,2,17,21
19991107-M-Paris_Masters-F-Andre_Agassi-Marat_Safin,1,F-DTL,31,11,3,5,3,20,11
19991107-M-Paris_Masters-F-Andre_Agassi-Marat_Safin,1,F-IO,22,6,1,4,1,18,4
19991107-M-Paris_Masters-F-Andre_Agassi-Marat_Safin,1,F-II,2,2,0,1,1,1,1
19991107-M-Paris_Masters-F-Andre_Agassi-Marat_Safin,1,B-XC,50,9,1,5,3,28,22
19991107-M-Paris_Masters-F-Andre_Agassi-Marat_Safin,1,B-DTM,24,4,0,0,4,9,15
19991107-M-Paris_Masters-F-Andre_Agassi-Marat_Safin,1,B-DTL,11,4,2,1,1,6,5
19991107-M-Paris_Masters-F-Andre_Agassi-Marat_Safin,1,B-IO,1,0,0,0,0,1,0
19991107-M-Paris_Masters-F-Andre_Agassi-Marat_Safin,1,S-XC,27,1,0,0,1,12,15
19991107-M-Paris_Masters-F-Andre_Agassi-Marat_Safin,1,S-DTM,6,2,0,1,1,5,1
19991107-M-Paris_Masters-F-Andre_Agassi-Marat_Safin,1,S-DTL,4,0,0,0,0,2,2
19991107-M-Paris_Masters-F-Andre_Agassi-Marat_Safin,2,F-XC,74,18,6,5,7,31,43
19991107-M-Paris_Masters-F-Andre_Agassi-Marat_Safin,2,F-DTM,17,1,1,0,0,4,13
19991107-M-Paris_Masters-F-Andre_Agassi-Marat_Safin,2,F-DTL,17,4,0,1,3,6,11
19991107-M-Paris_Masters-F-Andre_Agassi-Marat_Safin,2,F-IO,11,5,2,1,2,6,5
19991107-M-Paris_Masters-F-Andre_Agassi-Marat_Safin,2,F-II,5,1,1,0,0,4,1
19991107-M-Paris_Masters-F-Andre_Agassi-Marat_Safin,2,B-XC,58,11,3,3,5,35,23
19991107-M-Paris_Masters-F-Andre_Agassi-Marat_Safin,2,B-DTM,32,5,0,1,4,11,21
19991107-M-Paris_Masters-F-Andre_Agassi-Marat_Safin,2,B-DTL,38,15,8,3,4,22,16
19991107-M-Paris_Masters-F-Andre_Agassi-Marat_Safin,2,B-IO,13,4,1,2,1,6,7
19991107-M-Paris_Masters-F-Andre_Agassi-Marat_Safin,2,S-XC,16,2,0,1,1,6,10
19991107-M-Paris_Masters-F-Andre_Agassi-Marat_Safin,2,S-DTM,8,0,0,0,0,1,7
19991107-M-Paris_Masters-F-Andre_Agassi-Marat_Safin,2,S-DTL,1,0,0,0,0,0,1
20190307-M-Indian_Wells_Masters-R128-Felix_Auger_Aliassime-Cameron_Norrie,1,F-XC,28,6,1,2,3,16,12
20190307-M-Indian_Wells_Masters-R128-Felix_Auger_Aliassime-Cameron_Norrie,1,F-DTM,21,4,1,1,2,9,12
20190307-M-Indian_Wells_Masters-R128-Felix_Auger_Aliassime-Cameron_Norrie,1,F-DTL,3,3,1,2,0,3,0
20190307-M-Indian_Wells_Masters-R128-Felix_Auger_Aliassime-Cameron_Norrie,1,F-IO,10,5,3,0,2,7,3
20190307-M-Indian_Wells_Masters-R128-Felix_Auger_Aliassime-Cameron_Norrie,1,F-II,2,0,0,0,0,0,2
20190307-M-Indian_Wells_Masters-R128-Felix_Auger_Aliassime-Cameron_Norrie,1,B-XC,18,4,0,0,4,5,13
20190307-M-Indian_Wells_Masters-R128-Felix_Auger_Aliassime-Cameron_Norrie,1,B-DTM,7,0,0,0,0,5,2
20190307-M-Indian_Wells_Masters-R128-Felix_Auger_Aliassime-Cameron_Norrie,1,B-DTL,7,0,0,0,0,3,4
20190307-M-Indian_Wells_Masters-R128-Felix_Auger_Aliassime-Cameron_Norrie,1,S-XC,2,0,0,0,0,0,2
20190307-M-Indian_Wells_Masters-R128-Felix_Auger_Aliassime-Cameron_Norrie,1,S-DTM,1,1,0,0,1,0,1
20190307-M-Indian_Wells_Masters-R128-Felix_Auger_Aliassime-Cameron_Norrie,2,F-XC,28,4,1,1,2,14,14
20190307-M-Indian_Wells_Masters-R128-Felix_Auger_Aliassime-Cameron_Norrie,2,F-DTM,23,4,0,1,3,11,12
20190307-M-Indian_Wells_Masters-R128-Felix_Auger_Aliassime-Cameron_Norrie,2,F-DTL,5,4,1,2,1,4,1
20190307-M-Indian_Wells_Masters-R128-Felix_Auger_Aliassime-Cameron_Norrie,2,F-IO,9,3,2,0,1,6,3
20190307-M-Indian_Wells_Masters-R128-Felix_Auger_Aliassime-Cameron_Norrie,2,B-XC,13,2,0,1,1,6,7
20190307-M-Indian_Wells_Masters-R128-Felix_Auger_Aliassime-Cameron_Norrie,2,B-DTM,14,2,0,0,2,6,8
20190307-M-Indian_Wells_Masters-R128-Felix_Auger_Aliassime-Cameron_Norrie,2,B-DTL,3,1,0,0,1,1,2
20190307-M-Indian_Wells_Masters-R128-Felix_Auger_Aliassime-Cameron_Norrie,2,B-IO,3,0,0,0,0,3,0
20190307-M-Indian_Wells_Masters-R128-Felix_Auger_Aliassime-Cameron_Norrie,2,S-DTM,2,0,0,0,0,2,0
20190307-M-Indian_Wells_Masters-R128-Felix_Auger_Aliassime-Cameron_Norrie,2,S-DTL,2,0,0,0,0,1,1
20190307-M-Indian_Wells_Masters-R128-Ilya_Ivashka-Guido_Andreozzi,1,F-XC,59,14,4,3,7,30,29
20190307-M-Indian_Wells_Masters-R128-Ilya_Ivashka-Guido_Andreozzi,1,F-DTM,35,5,0,1,4,12,23
20190307-M-Indian_Wells_Masters-R128-Ilya_Ivashka-Guido_Andreozzi,1,F-DTL,15,5,2,0,3,5,10
20190307-M-Indian_Wells_Masters-R128-Ilya_Ivashka-Guido_Andreozzi,1,F-IO,28,6,1,2,3,15,13
20190307-M-Indian_Wells_Masters-R128-Ilya_Ivashka-Guido_Andreozzi,1,F-II,4,2,2,0,0,3,1
20190307-M-Indian_Wells_Masters-R128-Ilya_Ivashka-Guido_Andreozzi,1,B-XC,56,8,0,2,6,24,32
20190307-M-Indian_Wells_Masters-R128-Ilya_Ivashka-Guido_Andreozzi,1,B-DTM,40,3,0,1,2,18,22
20190307-M-Indian_Wells_Masters-R128-Ilya_Ivashka-Guido_Andreozzi,1,B-DTL,6,4,1,2,1,4,2
20190307-M-Indian_Wells_Masters-R128-Ilya_Ivashka-Guido_Andreozzi,1,B-IO,4,1,0,0,1,2,2
20190307-M-Indian_Wells_Masters-R128-Ilya_Ivashka-Guido_Andreozzi,1,S-XC,10,0,0,0,0,5,5
20190307-M-Indian_Wells_Masters-R128-Ilya_Ivashka-Guido_Andreozzi,1,S-DTM,3,0,0,0,0,1,2
20190307-M-Indian_Wells_Masters-R128-Ilya_Ivashka-Guido_Andreozzi,1,S-DTL,1,0,0,0,0,1,0
20190307-M-Indian_Wells_Masters-R128-Ilya_Ivashka-Guido_Andreozzi,2,F-XC,62,14,3,4,7,35,27
20190307-M-Indian_Wells_Masters-R128-Ilya_Ivashka-Guido_Andreozzi,2,F-DTM,21,0,0,0,0,9,12
20190307-M-Indian_Wells_Masters-R128-Ilya_Ivashka-Guido_Andreozzi,2,F-DTL,35,10,2,4,4,19,16
20190307-M-Indian_Wells_Masters-R128-Ilya_Ivashka-Guido_Andreozzi,2,F-IO,58,12,5,5,2,36,22
20190307-M-Indian_Wells_Masters-R128-Ilya_Ivashka-Guido_Andreozzi,2,F-II,20,9,2,5,2,15,5
20190307-M-Indian_Wells_Masters-R128-Ilya_Ivashka-Guido_Andreozzi,2,B-XC,27,4,0,0,4,14,13
20190307-M-Indian_Wells_Masters-R128-Ilya_Ivashka-Guido_Andreozzi,2,B-DTM,25,3,0,0,3,8,17
20190307-M-Indian_Wells_Masters-R128-Ilya_Ivashka-Guido_Andreozzi,2,B-DTL,8,1,1,0,0,6,2
20190307-M-Indian_Wells_Masters-R128-Ilya_Ivashka-Guido_Andreozzi,2,S-XC,11,1,0,0,1,4,7
20190307-M-Indian_Wells_Masters-R128-Ilya_Ivashka-Guido_Andreozzi,2,S-DTM,6,0,0,0,0,2,4
20190307-M-Indian_Wells_Masters-R128-Ilya_Ivashka-Guido_Andreozzi,2,S-DTL,1,0,0,0,0,0,1
20190308-M-Indian_Wells_Masters-R128-Tomas_Berdych-Feliciano_Lopez,1,F-XC,43,14,1,6,7,24,19
20190308-M-Indian_Wells_Masters-R128-Tomas_Berdych-Feliciano_Lopez,1,F-DTM,14,0,0,0,0,7,7
20190308-M-Indian_Wells_Masters-R128-Tomas_Berdych-Feliciano_Lopez,1,F-DTL,10,5,2,2,1,8,2
20190308-M-Indian_Wells_Masters-R128-Tomas_Berdych-Feliciano_Lopez,1,F-IO,34,16,8,5,3,21,13
20190308-M-Indian_Wells_Masters-R128-Tomas_Berdych-Feliciano_Lopez,1,F-II,3,0,0,0,0,1,2
20190308-M-Indian_Wells_Masters-R128-Tomas_Berdych-Feliciano_Lopez,1,B-XC,23,4,1,1,2,15,8
20190308-M-Indian_Wells_Masters-R128-Tomas_Berdych-Feliciano_Lopez,1,B-DTM,12,1,0,0,1,5,7
20190308-M-Indian_Wells_Masters-R128-Tomas_Berdych-Feliciano_Lopez,1,B-DTL,18,7,5,0,2,11,7
20190308-M-Indian_Wells_Masters-R128-Tomas_Berdych-Feliciano_Lopez,1,B-IO,4,1,0,1,0,3,1
20190308-M-Indian_Wells_Masters-R128-Tomas_Berdych-Feliciano_Lopez,1,S-XC,10,1,0,0,1,2,8
20190308-M-Indian_Wells_Masters-R128-Tomas_Berdych-Feliciano_Lopez,1,S-DTM,4,1,0,0,1,1,3
20190308-M-Indian_Wells_Masters-R128-Tomas_Berdych-Feliciano_Lopez,1,S-DTL,6,0,0,0,0,4,2
20190308-M-Indian_Wells_Masters-R128-Tomas_Berdych-Feliciano_Lopez,2,F-XC,48,9,1,3,5,23,25
20190308-M-Indian_Wells_Masters-R128-Tomas_Berdych-Feliciano_Lopez,2,F-DTM,21,4,0,0,4,10,11
20190308-M-Indian_Wells_Masters-R128-Tomas_Berdych-Feliciano_Lopez,2,F-DTL,13,8,4,2,2,7,6
20190308-M-Indian_Wells_Masters-R128-Tomas_Berdych-Feliciano_Lopez,2,F-IO,17,7,3,0,4,10,7
20190308-M-Indian_Wells_Masters-R128-Tomas_Berdych-Feliciano_Lopez,2,F-II,3,1,0,0,1,1,2
20190308-M-Indian_Wells_Masters-R128-Tomas_Berdych-Feliciano_Lopez,2,B-XC,4,1,0,0,1,0,4
20190308-M-Indian_Wells_Masters-R128-Tomas_Berdych-Feliciano_Lopez,2,B-DTM,8,0,0,0,0,2,6
20190308-M-Indian_Wells_Masters-R128-Tomas_Berdych-Feliciano_Lopez,2,B-DTL,2,0,0,0,0,0,2
20190308-M-Indian_Wells_Masters-R128-Tomas_Berdych-Feliciano_Lopez,2,S-XC,17,2,0,0,2,8,9
20190308-M-Indian_Wells_Masters-R128-Tomas_Berdych-Feliciano_Lopez,2,S-DTM,16,1,0,0,1,8,8
20190308-M-Indian_Wells_Masters-R128-Tomas_Berdych-Feliciano_Lopez,2,S-DTL,19,5,0,3,2,11,8
20190308-M-Indian_Wells_Masters-R128-Tomas_Berdych-Feliciano_Lopez,2,S-IO,7,0,0,0,0,2,5
20190308-M-Indian_Wells_Masters-R128-Taylor_Harry_Fritz-Steve_Johnson,1,F-XC,20,7,1,1,5,10,10
20190308-M-Indian_Wells_Masters-R128-Taylor_Harry_Fritz-Steve_Johnson,1,F-DTM,7,0,0,0,0,3,4
20190308-M-Indian_Wells_Masters-R128-Taylor_Harry_Fritz-Steve_Johnson,1,F-DTL,4,2,0,2,0,3,1
20190308-M-Indian_Wells_Masters-R128-Taylor_Harry_Fritz-Steve_Johnson,1,F-IO,20,7,5,0,2,10,10
20190308-M-Indian_Wells_Masters-R128-Taylor_Harry_Fritz-Steve_Johnson,1,B-XC,53,4,0,1,3,15,38
20190308-M-Indian_Wells_Masters-R128-Taylor_Harry_Fritz-Steve_Johnson,1,B-DTM,12,0,0,0,0,2,10
20190308-M-Indian_Wells_Masters-R128-Taylor_Harry_Fritz-Steve_Johnson,1,B-DTL,4,1,0,0,1,1,3
20190308-M-Indian_Wells_Masters-R128-Taylor_Harry_Fritz-Steve_Johnson,1,S-XC,1,0,0,0,0,0,1
20190308-M-Indian_Wells_Masters-R128-Taylor_Harry_Fritz-Steve_Johnson,1,S-DTM,2,1,0,0,1,0,2
20190308-M-Indian_Wells_Masters-R128-Taylor_Harry_Fritz-Steve_Johnson,1,S-DTL,1,0,0,0,0,0,1
20190308-M-Indian_Wells_Masters-R128-Taylor_Harry_Fritz-Steve_Johnson,2,F-XC,11,5,1,3,1,5,6
20190308-M-Indian_Wells_Masters-R128-Taylor_Harry_Fritz-Steve_Johnson,2,F-DTM,8,1,0,0,1,6,2
20190308-M-Indian_Wells_Masters-R128-Taylor_Harry_Fritz-Steve_Johnson,2,F-DTL,2,2,2,0,0,2,0
20190308-M-Indian_Wells_Masters-R128-Taylor_Harry_Fritz-Steve_Johnson,2,F-IO,16,6,3,3,0,15,1
20190308-M-Indian_Wells_Masters-R128-Taylor_Harry_Fritz-Steve_Johnson,2,F-II,6,1,0,1,0,5,1
20190308-M-Indian_Wells_Masters-R128-Taylor_Harry_Fritz-Steve_Johnson,2,B-XC,2,1,0,1,0,2,0
20190308-M-Indian_Wells_Masters-R128-Taylor_Harry_Fritz-Steve_Johnson,2,B-DTM,2,0,0,0,0,1,1
20190308-M-Indian_Wells_Masters-R128-Taylor_Harry_Fritz-Steve_Johnson,2,B-DTL,2,1,0,0,1,0,2
20190308-M-Indian_Wells_Masters-R128-Taylor_Harry_Fritz-Steve_Johnson,2,S-XC,49,4,0,0,4,34,15
20190308-M-Indian_Wells_Masters-R128-Taylor_Harry_Fritz-Steve_Johnson,2,S-DTM,14,1,0,0,1,9,5
20190308-M-Indian_Wells_Masters-R128-Taylor_Harry_Fritz-Steve_Johnson,2,S-DTL,2,1,1,0,0,2,0
20190308-M-Indian_Wells_Masters-R128-Taylor_Harry_Fritz-Steve_Johnson,2,S-IO,1,0,0,0,0,1,0
20190307-M-Indian_Wells_Masters-R128-Martin_Klizan-Mischa_Zverev,1,F-XC,2,2,1,0,1,1,1
20190307-M-Indian_Wells_Masters-R128-Martin_Klizan-Mischa_Zverev,1,F-DTM,2,0,0,0,0,2,0
20190307-M-Indian_Wells_Masters-R128-Martin_Klizan-Mischa_Zverev,1,F-DTL,1,0,0,0,0,1,0
20190307-M-Indian_Wells_Masters-R128-Martin_Klizan-Mischa_Zverev,1,B-XC,9,1,0,0,1,5,4
20190307-M-Indian_Wells_Masters-R128-Martin_Klizan-Mischa_Zverev,1,B-DTM,7,2,0,2,0,7,0
20190307-M-Indian_Wells_Masters-R128-Martin_Klizan-Mischa_Zverev,1,B-DTL,1,1,1,0,0,1,0
20190307-M-Indian_Wells_Masters-R128-Martin_Klizan-Mischa_Zverev,1,B-IO,1,1,0,0,1,0,1
20190307-M-Indian_Wells_Masters-R128-Martin_Klizan-Mischa_Zverev,1,S-XC,2,0,0,0,0,2,0
20190307-M-Indian_Wells_Masters-R128-Martin_Klizan-Mischa_Zverev,2,F-XC,2,2,2,0,0,2,0
20190307-M-Indian_Wells_Masters-R128-Martin_Klizan-Mischa_Zverev,2,F-DTL,1,1,0,1,0,1,0
20190307-M-Indian_Wells_Masters-R128-Martin_Klizan-Mischa_Zverev,2,F-IO,1,1,0,0,1,0,1
20190307-M-Indian_Wells_Masters-R128-Martin_Klizan-Mischa_Zverev,2,B-XC,8,0,0,0,0,3,5
20190307-M-Indian_Wells_Masters-R128-Martin_Klizan-Mischa_Zverev,2,B-DTM,5,0,0,0,0,0,5
20190307-M-Indian_Wells_Masters-R128-Martin_Klizan-Mischa_Zverev,2,B-DTL,5,3,1,0,2,1,4
20190307-M-Indian_Wells_Masters-R128-Martin_Klizan-Mischa_Zverev,2,S-XC,2,2,0,0,2,0,2
20190307-M-Indian_Wells_Masters-R128-Martin_Klizan-Mischa_Zverev,2,S-DTM,1,0,0,0,0,0,1
20001105-M-Stuttgart_Masters-F-Lleyton_Hewitt-Wayne_Ferreira,1,F-XC,67,12,2,6,4,40,27
20001105-M-Stuttgart_Masters-F-Lleyton_Hewitt-Wayne_Ferreira,1,F-DTM,16,4,0,2,2,8,8
20001105-M-Stuttgart_Masters-F-Lleyton_Hewitt-Wayne_Ferreira,1,F-DTL,21,8,2,1,5,12,9
20001105-M-Stuttgart_Masters-F-Lleyton_Hewitt-Wayne_Ferreira,1,F-IO,37,7,1,4,2,22,15
20001105-M-Stuttgart_Masters-F-Lleyton_Hewitt-Wayne_Ferreira,1,F-II,11,2,0,0,2,8,3
20001105-M-Stuttgart_Masters-F-Lleyton_Hewitt-Wayne_Ferreira,1,B-XC,89,9,1,3,5,48,41
20001105-M-Stuttgart_Masters-F-Lleyton_Hewitt-Wayne_Ferreira,1,B-DTM,14,2,0,1,1,7,7
20001105-M-Stuttgart_Masters-F-Lleyton_Hewitt-Wayne_Ferreira,1,B-DTL,9,6,2,2,2,5,4
20001105-M-Stuttgart_Masters-F-Lleyton_Hewitt-Wayne_Ferreira,1,B-IO,3,1,0,1,0,2,1
20001105-M-Stuttgart_Masters-F-Lleyton_Hewitt-Wayne_Ferreira,1,S-XC,11,3,1,1,1,5,6
20001105-M-Stuttgart_Masters-F-Lleyton_Hewitt-Wayne_Ferreira,1,S-DTM,2,0,0,0,0,1,1
20001105-M-Stuttgart_Masters-F-Lleyton_Hewitt-Wayne_Ferreira,1,S-DTL,1,0,0,0,0,0,1
20001105-M-Stuttgart_Masters-F-Lleyton_Hewitt-Wayne_Ferreira,2,F-XC,54,13,1,3,9,20,34
20001105-M-Stuttgart_Masters-F-Lleyton_Hewitt-Wayne_Ferreira,2,F-DTM,18,1,0,0,1,5,13
20001105-M-Stuttgart_Masters-F-Lleyton_Hewitt-Wayne_Ferreira,2,F-DTL,31,11,1,4,6,17,14
20001105-M-Stuttgart_Masters-F-Lleyton_Hewitt-Wayne_Ferreira,2,F-IO,35,15,5,3,7,20,15
20001105-M-Stuttgart_Masters-F-Lleyton_Hewitt-Wayne_Ferreira,2,F-II,20,7,1,4,2,11,9
20001105-M-Stuttgart_Masters-F-Lleyton_Hewitt-Wayne_Ferreira,2,B-XC,62,8,1,2,5,27,35
20001105-M-Stuttgart_Masters-F-Lleyton_Hewitt-Wayne_Ferreira,2,B-DTM,21,2,0,0,2,5,16
20001105-M-Stuttgart_Masters-F-Lleyton_Hewitt-Wayne_Ferreira,2,B-DTL,24,9,0,1,8,10,14
20001105-M-Stuttgart_Masters-F-Lleyton_Hewitt-Wayne_Ferreira,2,B-IO,1,0,0,0,0,0,1
20001105-M-Stuttgart_Masters-F-Lleyton_Hewitt-Wayne_Ferreira,2,S-XC,19,0,0,0,0,9,10
20001105-M-Stuttgart_Masters-F-Lleyton_Hewitt-Wayne_Ferreira,2,S-DTM,5,0,0,0,0,0,5
20001105-M-Stuttgart_Masters-F-Lleyton_Hewitt-Wayne_Ferreira,2,S-DTL,1,0,0,0,0,1,0
20170318-M-Indian_Wells_Masters-SF-Roger_Federer-Jack_Sock,1,F-XC,30,13,5,4,4,20,10
20170318-M-Indian_Wells_Masters-SF-Roger_Federer-Jack_Sock,1,F-DTM,5,1,0,0,1,2,3
20170318-M-Indian_Wells_Masters-SF-Roger_Federer-Jack_Sock,1,F-DTL,6,3,1,1,1,5,1
20170318-M-Indian_Wells_Masters-SF-Roger_Federer-Jack_Sock,1,F-IO,18,7,4,1,2,12,6
20170318-M-Indian_Wells_Masters-SF-Roger_Federer-Jack_Sock,1,F-II,1,1,0,0,1,0,1
20170318-M-Indian_Wells_Masters-SF-Roger_Federer-Jack_Sock,1,B-XC,10,1,0,0,1,8,2
20170318-M-Indian_Wells_Masters-SF-Roger_Federer-Jack_Sock,1,B-DTM,7,2,0,1,1,4,3
20170318-M-Indian_Wells_Masters-SF-Roger_Federer-Jack_Sock,1,B-DTL,3,2,2,0,0,3,0
20170318-M-Indian_Wells_Masters-SF-Roger_Federer-Jack_Sock,1,B-IO,3,2,0,0,2,0,3
20170318-M-Indian_Wells_Masters-SF-Roger_Federer-Jack_Sock,1,S-XC,2,1,1,0,0,1,1
20170318-M-Indian_Wells_Masters-SF-Roger_Federer-Jack_Sock,1,S-DTM,1,0,0,0,0,0,1
20170318-M-Indian_Wells_Masters-SF-Roger_Federer-Jack_Sock,2,F-XC,12,5,0,2,3,4,8
20170318-M-Indian_Wells_Masters-SF-Roger_Federer-Jack_Sock,2,F-DTM,15,2,0,1,1,5,10
20170318-M-Indian_Wells_Masters-SF-Roger_Federer-Jack_Sock,2,F-DTL,4,2,0,0,2,1,3
20170318-M-Indian_Wells_Masters-SF-Roger_Federer-Jack_Sock,2,F-IO,9,4,3,0,1,5,4
20170318-M-Indian_Wells_Masters-SF-Roger_Federer-Jack_Sock,2,F-II,3,2,1,0,1,2,1
20170318-M-Indian_Wells_Masters-SF-Roger_Federer-Jack_Sock,2,B-XC,12,3,1,0,2,3,9
20170318-M-Indian_Wells_Masters-SF-Roger_Federer-Jack_Sock,2,B-DTM,8,1,0,0,1,2,6
20170318-M-Indian_Wells_Masters-SF-Roger_Federer-Jack_Sock,2,B-DTL,7,3,2,1,0,4,3
20170318-M-Indian_Wells_Masters-SF-Roger_Federer-Jack_Sock,2,B-IO,1,0,0,0,0,0,1
20170318-M-Indian_Wells_Masters-SF-Roger_Federer-Jack_Sock,2,S-XC,2,1,0,0,1,0,2
20170318-M-Indian_Wells_Masters-SF-Roger_Federer-Jack_Sock,2,S-DTM,3,1,0,0,1,0,3
20170318-M-Indian_Wells_Masters-SF-Roger_Federer-Jack_Sock,2,S-IO,1,0,0,0,0,0,1
20190228-M-Acapulco-QF-Mackenzie_Mcdonald-Cameron_Norrie,1,F-XC,46,10,0,2,8,22,24
20190228-M-Acapulco-QF-Mackenzie_Mcdonald-Cameron_Norrie,1,F-DTM,19,3,0,0,3,3,16
20190228-M-Acapulco-QF-Mackenzie_Mcdonald-Cameron_Norrie,1,F-DTL,10,4,1,2,1,6,4
20190228-M-Acapulco-QF-Mackenzie_Mcdonald-Cameron_Norrie,1,F-IO,19,8,1,2,5,7,12
20190228-M-Acapulco-QF-Mackenzie_Mcdonald-Cameron_Norrie,1,F-II,3,0,0,0,0,2,1
20190228-M-Acapulco-QF-Mackenzie_Mcdonald-Cameron_Norrie,1,B-XC,20,5,1,1,3,11,9
20190228-M-Acapulco-QF-Mackenzie_Mcdonald-Cameron_Norrie,1,B-DTM,15,1,0,0,1,5,10
20190228-M-Acapulco-QF-Mackenzie_Mcdonald-Cameron_Norrie,1,B-DTL,13,3,0,1,2,7,6
20190228-M-Acapulco-QF-Mackenzie_Mcdonald-Cameron_Norrie,1,B-IO,1,0,0,0,0,0,1
20190228-M-Acapulco-QF-Mackenzie_Mcdonald-Cameron_Norrie,1,S-XC,4,1,0,0,1,2,2
20190228-M-Acapulco-QF-Mackenzie_Mcdonald-Cameron_Norrie,1,S-DTM,2,1,0,0,1,1,1
20190228-M-Acapulco-QF-Mackenzie_Mcdonald-Cameron_Norrie,1,S-DTL,3,2,1,0,1,2,1
20190228-M-Acapulco-QF-Mackenzie_Mcdonald-Cameron_Norrie,1,S-IO,1,0,0,0,0,0,1
20190228-M-Acapulco-QF-Mackenzie_Mcdonald-Cameron_Norrie,2,F-XC,34,6,4,1,1,23,11
20190228-M-Acapulco-QF-Mackenzie_Mcdonald-Cameron_Norrie,2,F-DTM,24,4,0,1,3,14,10
20190228-M-Acapulco-QF-Mackenzie_Mcdonald-Cameron_Norrie,2,F-DTL,11,6,3,1,2,4,7
20190228-M-Acapulco-QF-Mackenzie_Mcdonald-Cameron_Norrie,2,F-IO,11,6,2,3,1,9,2
20190228-M-Acapulco-QF-Mackenzie_Mcdonald-Cameron_Norrie,2,F-II,2,0,0,0,0,1,1
20190228-M-Acapulco-QF-Mackenzie_Mcdonald-Cameron_Norrie,2,B-XC,27,7,2,2,3,13,14
20190228-M-Acapulco-QF-Mackenzie_Mcdonald-Cameron_Norrie,2,B-DTM,24,3,0,0,3,13,11
20190228-M-Acapulco-QF-Mackenzie_Mcdonald-Cameron_Norrie,2,B-DTL,9,1,0,0,1,5,4
20190228-M-Acapulco-QF-Mackenzie_Mcdonald-Cameron_Norrie,2,B-IO,3,1,0,0,1,1,2
20190228-M-Acapulco-QF-Mackenzie_Mcdonald-Cameron_Norrie,2,S-XC,3,0,0,0,0,1,2
20190228-M-Acapulco-QF-Mackenzie_Mcdonald-Cameron_Norrie,2,S-DTM,4,0,0,0,0,2,2
20190228-M-Acapulco-QF-Mackenzie_Mcdonald-Cameron_Norrie,2,S-DTL,4,0,0,0,0,2,2
20190228-M-Acapulco-QF-Mackenzie_Mcdonald-Cameron_Norrie,2,S-IO,1,0,0,0,0,0,1
20190309-M-Indian_Wells_Masters-R64-Stefanos_Tsitsipas-Felix_Auger_Aliassime,1,F-XC,33,11,3,1,7,11,22
20190309-M-Indian_Wells_Masters-R64-Stefanos_Tsitsipas-Felix_Auger_Aliassime,1,F-DTM,15,0,0,0,0,4,11
20190309-M-Indian_Wells_Masters-R64-Stefanos_Tsitsipas-Felix_Auger_Aliassime,1,F-DTL,10,3,0,1,2,4,6
20190309-M-Indian_Wells_Masters-R64-Stefanos_Tsitsipas-Felix_Auger_Aliassime,1,F-IO,13,3,0,1,2,6,7
20190309-M-Indian_Wells_Masters-R64-Stefanos_Tsitsipas-Felix_Auger_Aliassime,1,F-II,4,3,0,2,1,2,2
20190309-M-Indian_Wells_Masters-R64-Stefanos_Tsitsipas-Felix_Auger_Aliassime,1,B-XC,30,6,1,3,2,13,17
20190309-M-Indian_Wells_Masters-R64-Stefanos_Tsitsipas-Felix_Auger_Aliassime,1,B-DTM,13,1,0,0,1,4,9
20190309-M-Indian_Wells_Masters-R64-Stefanos_Tsitsipas-Felix_Auger_Aliassime,1,B-DTL,1,1,1,0,0,1,0
20190309-M-Indian_Wells_Masters-R64-Stefanos_Tsitsipas-Felix_Auger_Aliassime,1,S-XC,7,1,0,0,1,0,7
20190309-M-Indian_Wells_Masters-R64-Stefanos_Tsitsipas-Felix_Auger_Aliassime,1,S-DTM,1,0,0,0,0,1,0
20190309-M-Indian_Wells_Masters-R64-Stefanos_Tsitsipas-Felix_Auger_Aliassime,2,F-XC,26,7,2,3,2,20,6
20190309-M-Indian_Wells_Masters-R64-Stefanos_Tsitsipas-Felix_Auger_Aliassime,2,F-DTM,16,2,0,0,2,9,7
20190309-M-Indian_Wells_Masters-R64-Stefanos_Tsitsipas-Felix_Auger_Aliassime,2,F-DTL,7,0,0,0,0,6,1
20190309-M-Indian_Wells_Masters-R64-Stefanos_Tsitsipas-Felix_Auger_Aliassime,2,F-IO,19,9,3,4,2,13,6
20190309-M-Indian_Wells_Masters-R64-Stefanos_Tsitsipas-Felix_Auger_Aliassime,2,F-II,4,3,1,1,1,3,1
20190309-M-Indian_Wells_Masters-R64-Stefanos_Tsitsipas-Felix_Auger_Aliassime,2,B-XC,32,6,0,4,2,19,13
20190309-M-Indian_Wells_Masters-R64-Stefanos_Tsitsipas-Felix_Auger_Aliassime,2,B-DTM,19,2,1,0,1,12,7
20190309-M-Indian_Wells_Masters-R64-Stefanos_Tsitsipas-Felix_Auger_Aliassime,2,B-DTL,4,3,1,1,0,4,0
20190309-M-Indian_Wells_Masters-R64-Stefanos_Tsitsipas-Felix_Auger_Aliassime,2,B-IO,1,0,0,0,0,1,0
20190309-M-Indian_Wells_Masters-R64-Stefanos_Tsitsipas-Felix_Auger_Aliassime,2,S-XC,1,0,0,0,0,1,0
20190309-M-Indian_Wells_Masters-R64-Stefanos_Tsitsipas-Felix_Auger_Aliassime,2,S-DTL,2,0,0,0,0,1,1
20190227-M-Dubai-R16-Ricardas_Berankis-Denis_Kudla,1,F-XC,27,7,3,3,1,15,12
20190227-M-Dubai-R16-Ricardas_Berankis-Denis_Kudla,1,F-DTM,9,1,0,0,1,5,4
20190227-M-Dubai-R16-Ricardas_Berankis-Denis_Kudla,1,F-DTL,8,6,2,3,1,6,2
20190227-M-Dubai-R16-Ricardas_Berankis-Denis_Kudla,1,F-IO,14,7,3,2,2,10,4
20190227-M-Dubai-R16-Ricardas_Berankis-Denis_Kudla,1,F-II,2,0,0,0,0,1,1
20190227-M-Dubai-R16-Ricardas_Berankis-Denis_Kudla,1,B-XC,29,9,3,1,5,17,12
20190227-M-Dubai-R16-Ricardas_Berankis-Denis_Kudla,1,B-DTM,17,4,0,0,4,10,7
20190227-M-Dubai-R16-Ricardas_Berankis-Denis_Kudla,1,B-DTL,16,8,2,2,4,12,4
20190227-M-Dubai-R16-Ricardas_Berankis-Denis_Kudla,1,B-IO,4,2,0,1,1,3,1
20190227-M-Dubai-R16-Ricardas_Berankis-Denis_Kudla,1,S-XC,7,0,0,0,0,4,3
20190227-M-Dubai-R16-Ricardas_Berankis-Denis_Kudla,1,S-DTM,2,0,0,0,0,1,1
20190227-M-Dubai-R16-Ricardas_Berankis-Denis_Kudla,1,S-DTL,3,0,0,0,0,1,2
20190227-M-Dubai-R16-Ricardas_Berankis-Denis_Kudla,1,S-IO,1,0,0,0,0,1,0
20190227-M-Dubai-R16-Ricardas_Berankis-Denis_Kudla,2,F-XC,24,8,2,0,6,9,15
20190227-M-Dubai-R16-Ricardas_Berankis-Denis_Kudla,2,F-DTM,18,1,0,0,1,7,11
20190227-M-Dubai-R16-Ricardas_Berankis-Denis_Kudla,2,F-DTL,10,2,0,1,1,2,8
20190227-M-Dubai-R16-Ricardas_Berankis-Denis_Kudla,2,F-IO,16,5,0,1,4,7,9
20190227-M-Dubai-R16-Ricardas_Berankis-Denis_Kudla,2,B-XC,19,3,1,1,1,7,12
20190227-M-Dubai-R16-Ricardas_Berankis-Denis_Kudla,2,B-DTM,17,2,0,0,2,7,10
20190227-M-Dubai-R16-Ricardas_Berankis-Denis_Kudla,2,B-DTL,4,2,0,0,2,1,3
20190227-M-Dubai-R16-Ricardas_Berankis-Denis_Kudla,2,B-IO,1,0,0,0,0,0,1
20190227-M-Dubai-R16-Ricardas_Berankis-Denis_Kudla,2,S-XC,9,1,0,1,0,5,4
20190227-M-Dubai-R16-Ricardas_Berankis-Denis_Kudla,2,S-DTM,2,0,0,0,0,0,2
20190227-M-Dubai-R16-Ricardas_Berankis-Denis_Kudla,2,S-DTL,3,1,0,1,0,1,2
20190310-M-Indian_Wells_Masters-R64-Fabio_Fognini-Radu_Albot,1,F-XC,32,12,1,3,7,15,17
20190310-M-Indian_Wells_Masters-R64-Fabio_Fognini-Radu_Albot,1,F-DTM,22,0,0,0,0,9,13
20190310-M-Indian_Wells_Masters-R64-Fabio_Fognini-Radu_Albot,1,F-DTL,13,2,0,0,2,6,7
20190310-M-Indian_Wells_Masters-R64-Fabio_Fognini-Radu_Albot,1,F-IO,25,6,2,1,3,11,14
20190310-M-Indian_Wells_Masters-R64-Fabio_Fognini-Radu_Albot,1,F-II,8,4,0,1,3,3,5
20190310-M-Indian_Wells_Masters-R64-Fabio_Fognini-Radu_Albot,1,B-XC,50,7,1,0,6,21,29
20190310-M-Indian_Wells_Masters-R64-Fabio_Fognini-Radu_Albot,1,B-DTM,29,3,0,0,3,15,14
20190310-M-Indian_Wells_Masters-R64-Fabio_Fognini-Radu_Albot,1,B-DTL,14,8,1,2,5,5,9
20190310-M-Indian_Wells_Masters-R64-Fabio_Fognini-Radu_Albot,1,B-IO,3,0,0,0,0,3,0
20190310-M-Indian_Wells_Masters-R64-Fabio_Fognini-Radu_Albot,1,S-XC,6,0,0,0,0,3,3
20190310-M-Indian_Wells_Masters-R64-Fabio_Fognini-Radu_Albot,1,S-DTL,3,0,0,0,0,1,2
20190310-M-Indian_Wells_Masters-R64-Fabio_Fognini-Radu_Albot,2,F-XC,38,10,1,4,5,21,17
20190310-M-Indian_Wells_Masters-R64-Fabio_Fognini-Radu_Albot,2,F-DTM,24,2,0,0,2,17,7
20190310-M-Indian_Wells_Masters-R64-Fabio_Fognini-Radu_Albot,2,F-DTL,17,3,1,2,0,8,9
20190310-M-Indian_Wells_Masters-R64-Fabio_Fognini-Radu_Albot,2,F-IO,30,4,0,0,4,13,17
20190310-M-Indian_Wells_Masters-R64-Fabio_Fognini-Radu_Albot,2,F-II,7,3,1,1,1,5,2
20190310-M-Indian_Wells_Masters-R64-Fabio_Fognini-Radu_Albot,2,B-XC,42,5,0,1,4,26,16
20190310-M-Indian_Wells_Masters-R64-Fabio_Fognini-Radu_Albot,2,B-DTM,23,3,0,0,3,9,14
20190310-M-Indian_Wells_Masters-R64-Fabio_Fognini-Radu_Albot,2,B-DTL,7,4,1,0,3,3,4
20190310-M-Indian_Wells_Masters-R64-Fabio_Fognini-Radu_Albot,2,B-IO,1,0,0,0,0,0,1
20190310-M-Indian_Wells_Masters-R64-Fabio_Fognini-Radu_Albot,2,S-XC,6,0,0,0,0,3,3
20190310-M-Indian_Wells_Masters-R64-Fabio_Fognini-Radu_Albot,2,S-DTM,6,0,0,0,0,3,3
20190310-M-Indian_Wells_Masters-R64-Fabio_Fognini-Radu_Albot,2,S-DTL,1,0,0,0,0,0,1
20190310-M-Indian_Wells_Masters-R64-Lucas_Pouille-Hubert_Hurkacz,1,F-XC,65,18,8,2,8,37,28
20190310-M-Indian_Wells_Masters-R64-Lucas_Pouille-Hubert_Hurkacz,1,F-DTM,23,1,0,0,1,7,16
20190310-M-Indian_Wells_Masters-R64-Lucas_Pouille-Hubert_Hurkacz,1,F-DTL,17,5,3,0,2,12,5
20190310-M-Indian_Wells_Masters-R64-Lucas_Pouille-Hubert_Hurkacz,1,F-IO,33,10,4,2,4,15,18
20190310-M-Indian_Wells_Masters-R64-Lucas_Pouille-Hubert_Hurkacz,1,B-XC,29,9,4,1,4,18,11
20190310-M-Indian_Wells_Masters-R64-Lucas_Pouille-Hubert_Hurkacz,1,B-DTM,14,6,0,1,5,6,8
20190310-M-Indian_Wells_Masters-R64-Lucas_Pouille-Hubert_Hurkacz,1,B-DTL,8,2,1,0,1,3,5
20190310-M-Indian_Wells_Masters-R64-Lucas_Pouille-Hubert_Hurkacz,1,B-IO,5,2,1,0,1,2,3
20190310-M-Indian_Wells_Masters-R64-Lucas_Pouille-Hubert_Hurkacz,1,S-XC,17,3,0,0,3,9,8
20190310-M-Indian_Wells_Masters-R64-Lucas_Pouille-Hubert_Hurkacz,1,S-DTM,20,1,0,0,1,12,8
20190310-M-Indian_Wells_Masters-R64-Lucas_Pouille-Hubert_Hurkacz,1,S-DTL,5,1,0,0,1,3,2
20190310-M-Indian_Wells_Masters-R64-Lucas_Pouille-Hubert_Hurkacz,1,S-IO,1,0,0,0,0,0,1
20190310-M-Indian_Wells_Masters-R64-Lucas_Pouille-Hubert_Hurkacz,2,F-XC,48,10,2,2,6,25,23
20190310-M-Indian_Wells_Masters-R64-Lucas_Pouille-Hubert_Hurkacz,2,F-DTM,30,3,1,0,2,15,15
20190310-M-Indian_Wells_Masters-R64-Lucas_Pouille-Hubert_Hurkacz,2,F-DTL,28,8,2,2,4,13,15
20190310-M-Indian_Wells_Masters-R64-Lucas_Pouille-Hubert_Hurkacz,2,F-IO,25,6,1,4,1,11,14
20190310-M-Indian_Wells_Masters-R64-Lucas_Pouille-Hubert_Hurkacz,2,F-II,1,0,0,0,0,0,1
20190310-M-Indian_Wells_Masters-R64-Lucas_Pouille-Hubert_Hurkacz,2,B-XC,22,3,1,0,2,10,12
20190310-M-Indian_Wells_Masters-R64-Lucas_Pouille-Hubert_Hurkacz,2,B-DTM,21,1,0,1,0,11,10
20190310-M-Indian_Wells_Masters-R64-Lucas_Pouille-Hubert_Hurkacz,2,B-DTL,18,4,1,2,1,7,11
20190310-M-Indian_Wells_Masters-R64-Lucas_Pouille-Hubert_Hurkacz,2,B-IO,3,2,0,0,2,0,3
20190310-M-Indian_Wells_Masters-R64-Lucas_Pouille-Hubert_Hurkacz,2,S-XC,12,2,0,0,2,4,8
20190310-M-Indian_Wells_Masters-R64-Lucas_Pouille-Hubert_Hurkacz,2,S-DTM,2,0,0,0,0,0,2
20190310-M-Indian_Wells_Masters-R64-Lucas_Pouille-Hubert_Hurkacz,2,S-DTL,8,0,0,0,0,2,6
20190310-M-Indian_Wells_Masters-R64-Lucas_Pouille-Hubert_Hurkacz,2,S-IO,1,0,0,0,0,1,0
19910706-M-Wimbledon-SF-David_Wheaton-Boris_Becker,1,F-XC,5,3,2,0,1,3,2
19910706-M-Wimbledon-SF-David_Wheaton-Boris_Becker,1,F-DTM,1,0,0,0,0,0,1
19910706-M-Wimbledon-SF-David_Wheaton-Boris_Becker,1,F-DTL,2,0,0,0,0,0,2
19910706-M-Wimbledon-SF-David_Wheaton-Boris_Becker,1,F-IO,1,1,1,0,0,1,0
19910706-M-Wimbledon-SF-David_Wheaton-Boris_Becker,1,B-XC,7,3,1,0,2,2,5
19910706-M-Wimbledon-SF-David_Wheaton-Boris_Becker,1,B-DTM,3,0,0,0,0,0,3
19910706-M-Wimbledon-SF-David_Wheaton-Boris_Becker,1,B-DTL,4,3,1,0,2,1,3
19910706-M-Wimbledon-SF-David_Wheaton-Boris_Becker,1,B-IO,1,1,0,0,1,0,1
19910706-M-Wimbledon-SF-David_Wheaton-Boris_Becker,1,S-XC,1,0,0,0,0,0,1
19910706-M-Wimbledon-SF-David_Wheaton-Boris_Becker,1,S-DTM,1,0,0,0,0,0,1
19910706-M-Wimbledon-SF-David_Wheaton-Boris_Becker,1,S-DTL,1,0,0,0,0,0,1
19910706-M-Wimbledon-SF-David_Wheaton-Boris_Becker,2,F-XC,4,2,1,1,0,3,1
19910706-M-Wimbledon-SF-David_Wheaton-Boris_Becker,2,F-DTL,5,4,1,1,2,2,3
19910706-M-Wimbledon-SF-David_Wheaton-Boris_Becker,2,F-IO,5,3,1,1,1,3,2
19910706-M-Wimbledon-SF-David_Wheaton-Boris_Becker,2,B-XC,4,3,1,1,1,2,2
19910706-M-Wimbledon-SF-David_Wheaton-Boris_Becker,2,B-DTM,3,1,0,1,0,2,1
19910706-M-Wimbledon-SF-David_Wheaton-Boris_Becker,2,B-DTL,2,2,2,0,0,2,0
19910706-M-Wimbledon-SF-David_Wheaton-Boris_Becker,2,B-IO,2,2,0,1,1,1,1
19910706-M-Wimbledon-SF-David_Wheaton-Boris_Becker,2,S-XC,2,1,1,0,0,1,1
19910706-M-Wimbledon-SF-David_Wheaton-Boris_Becker,2,S-DTL,1,0,0,0,0,1,0
20190308-M-Indian_Wells_Masters-R128-Denis_Istomin-Robin_Haase,1,F-XC,42,6,0,2,4,16,26
20190308-M-Indian_Wells_Masters-R128-Denis_Istomin-Robin_Haase,1,F-DTM,30,4,0,0,4,9,21
20190308-M-Indian_Wells_Masters-R128-Denis_Istomin-Robin_Haase,1,F-DTL,8,4,3,0,1,4,4
20190308-M-Indian_Wells_Masters-R128-Denis_Istomin-Robin_Haase,1,F-IO,16,4,2,0,2,9,7
20190308-M-Indian_Wells_Masters-R128-Denis_Istomin-Robin_Haase,1,F-II,4,3,1,1,1,2,2
20190308-M-Indian_Wells_Masters-R128-Denis_Istomin-Robin_Haase,1,B-XC,41,7,1,1,5,17,24
20190308-M-Indian_Wells_Masters-R128-Denis_Istomin-Robin_Haase,1,B-DTM,28,2,0,0,2,9,19
20190308-M-Indian_Wells_Masters-R128-Denis_Istomin-Robin_Haase,1,B-DTL,10,2,2,0,0,6,4
20190308-M-Indian_Wells_Masters-R128-Denis_Istomin-Robin_Haase,1,B-IO,2,0,0,0,0,2,0
20190308-M-Indian_Wells_Masters-R128-Denis_Istomin-Robin_Haase,1,S-XC,5,2,1,1,0,3,2
20190308-M-Indian_Wells_Masters-R128-Denis_Istomin-Robin_Haase,1,S-DTM,8,0,0,0,0,3,5
20190308-M-Indian_Wells_Masters-R128-Denis_Istomin-Robin_Haase,1,S-DTL,1,0,0,0,0,0,1
20190308-M-Indian_Wells_Masters-R128-Denis_Istomin-Robin_Haase,2,F-XC,32,4,2,0,2,22,10
20190308-M-Indian_Wells_Masters-R128-Denis_Istomin-Robin_Haase,2,F-DTM,40,2,1,0,1,26,14
20190308-M-Indian_Wells_Masters-R128-Denis_Istomin-Robin_Haase,2,F-DTL,9,4,0,2,2,6,3
20190308-M-Indian_Wells_Masters-R128-Denis_Istomin-Robin_Haase,2,F-IO,32,7,2,0,5,16,16
20190308-M-Indian_Wells_Masters-R128-Denis_Istomin-Robin_Haase,2,F-II,4,1,0,0,1,3,1
20190308-M-Indian_Wells_Masters-R128-Denis_Istomin-Robin_Haase,2,B-XC,9,1,0,1,0,6,3
20190308-M-Indian_Wells_Masters-R128-Denis_Istomin-Robin_Haase,2,B-DTM,14,0,0,0,0,7,7
20190308-M-Indian_Wells_Masters-R128-Denis_Istomin-Robin_Haase,2,B-DTL,4,4,1,1,2,2,2
20190308-M-Indian_Wells_Masters-R128-Denis_Istomin-Robin_Haase,2,B-IO,3,2,2,0,0,3,0
20190308-M-Indian_Wells_Masters-R128-Denis_Istomin-Robin_Haase,2,S-XC,29,1,1,0,0,16,13
20190308-M-Indian_Wells_Masters-R128-Denis_Istomin-Robin_Haase,2,S-DTM,12,2,0,0,2,6,6
20190308-M-Indian_Wells_Masters-R128-Denis_Istomin-Robin_Haase,2,S-IO,2,0,0,0,0,1,1
20190311-M-Indian_Wells_Masters-R32-Ivo_Karlovic-Prajnesh_Gunneswaran,1,F-XC,10,3,1,0,2,3,7
20190311-M-Indian_Wells_Masters-R32-Ivo_Karlovic-Prajnesh_Gunneswaran,1,F-DTM,6,2,0,1,1,3,3
20190311-M-Indian_Wells_Masters-R32-Ivo_Karlovic-Prajnesh_Gunneswaran,1,F-DTL,2,2,1,0,1,1,1
20190311-M-Indian_Wells_Masters-R32-Ivo_Karlovic-Prajnesh_Gunneswaran,1,F-IO,4,1,1,0,0,2,2
20190311-M-Indian_Wells_Masters-R32-Ivo_Karlovic-Prajnesh_Gunneswaran,1,B-DTM,2,1,0,0,1,0,2
20190311-M-Indian_Wells_Masters-R32-Ivo_Karlovic-Prajnesh_Gunneswaran,1,B-DTL,1,1,0,0,1,0,1
20190311-M-Indian_Wells_Masters-R32-Ivo_Karlovic-Prajnesh_Gunneswaran,1,S-XC,4,1,0,0,1,1,3
20190311-M-Indian_Wells_Masters-R32-Ivo_Karlovic-Prajnesh_Gunneswaran,1,S-DTM,13,1,0,0,1,7,6
20190311-M-Indian_Wells_Masters-R32-Ivo_Karlovic-Prajnesh_Gunneswaran,1,S-DTL,1,0,0,0,0,1,0
20190311-M-Indian_Wells_Masters-R32-Ivo_Karlovic-Prajnesh_Gunneswaran,2,F-XC,20,10,6,1,3,12,8
20190311-M-Indian_Wells_Masters-R32-Ivo_Karlovic-Prajnesh_Gunneswaran,2,F-DTM,17,1,0,0,1,10,7
20190311-M-Indian_Wells_Masters-R32-Ivo_Karlovic-Prajnesh_Gunneswaran,2,F-DTL,4,4,4,0,0,4,0
20190311-M-Indian_Wells_Masters-R32-Ivo_Karlovic-Prajnesh_Gunneswaran,2,F-IO,21,11,4,2,5,12,9
20190311-M-Indian_Wells_Masters-R32-Ivo_Karlovic-Prajnesh_Gunneswaran,2,F-II,1,0,0,0,0,1,0
20190311-M-Indian_Wells_Masters-R32-Ivo_Karlovic-Prajnesh_Gunneswaran,2,B-XC,4,1,0,0,1,1,3
20190311-M-Indian_Wells_Masters-R32-Ivo_Karlovic-Prajnesh_Gunneswaran,2,B-DTM,10,3,0,0,3,3,7
20190311-M-Indian_Wells_Masters-R32-Ivo_Karlovic-Prajnesh_Gunneswaran,2,B-DTL,5,2,0,1,1,2,3
20190311-M-Indian_Wells_Masters-R32-Ivo_Karlovic-Prajnesh_Gunneswaran,2,S-DTL,3,0,0,0,0,2,1
20190309-M-Indian_Wells_Masters-R64-Leonardo_Mayer-Gael_Monfils,1,F-XC,50,11,4,4,3,19,31
20190309-M-Indian_Wells_Masters-R64-Leonardo_Mayer-Gael_Monfils,1,F-DTM,43,8,0,2,6,13,30
20190309-M-Indian_Wells_Masters-R64-Leonardo_Mayer-Gael_Monfils,1,F-DTL,5,3,0,1,2,1,4
20190309-M-Indian_Wells_Masters-R64-Leonardo_Mayer-Gael_Monfils,1,F-IO,39,9,2,2,5,10,29
20190309-M-Indian_Wells_Masters-R64-Leonardo_Mayer-Gael_Monfils,1,F-II,1,1,0,1,0,1,0
20190309-M-Indian_Wells_Masters-R64-Leonardo_Mayer-Gael_Monfils,1,B-XC,28,6,2,1,3,13,15
20190309-M-Indian_Wells_Masters-R64-Leonardo_Mayer-Gael_Monfils,1,B-DTM,23,2,0,0,2,10,13
20190309-M-Indian_Wells_Masters-R64-Leonardo_Mayer-Gael_Monfils,1,B-DTL,7,6,1,0,5,1,6
20190309-M-Indian_Wells_Masters-R64-Leonardo_Mayer-Gael_Monfils,1,B-IO,1,0,0,0,0,1,0
20190309-M-Indian_Wells_Masters-R64-Leonardo_Mayer-Gael_Monfils,1,S-XC,6,0,0,0,0,1,5
20190309-M-Indian_Wells_Masters-R64-Leonardo_Mayer-Gael_Monfils,1,S-DTM,6,1,0,0,1,1,5
20190309-M-Indian_Wells_Masters-R64-Leonardo_Mayer-Gael_Monfils,2,F-XC,43,12,4,4,4,31,12
20190309-M-Indian_Wells_Masters-R64-Leonardo_Mayer-Gael_Monfils,2,F-DTM,41,9,1,0,8,24,17
20190309-M-Indian_Wells_Masters-R64-Leonardo_Mayer-Gael_Monfils,2,F-DTL,6,2,1,0,1,5,1
20190309-M-Indian_Wells_Masters-R64-Leonardo_Mayer-Gael_Monfils,2,F-IO,35,5,2,2,1,28,7
20190309-M-Indian_Wells_Masters-R64-Leonardo_Mayer-Gael_Monfils,2,F-II,2,2,2,0,0,2,0
20190309-M-Indian_Wells_Masters-R64-Leonardo_Mayer-Gael_Monfils,2,B-XC,33,2,0,1,1,21,12
20190309-M-Indian_Wells_Masters-R64-Leonardo_Mayer-Gael_Monfils,2,B-DTM,38,7,0,2,5,26,12
20190309-M-Indian_Wells_Masters-R64-Leonardo_Mayer-Gael_Monfils,2,B-DTL,6,3,2,1,0,5,1
20190309-M-Indian_Wells_Masters-R64-Leonardo_Mayer-Gael_Monfils,2,B-IO,4,1,0,1,0,2,2
20190309-M-Indian_Wells_Masters-R64-Leonardo_Mayer-Gael_Monfils,2,S-XC,4,0,0,0,0,3,1
20190309-M-Indian_Wells_Masters-R64-Leonardo_Mayer-Gael_Monfils,2,S-DTM,7,0,0,0,0,2,5
20190309-M-Indian_Wells_Masters-R64-Leonardo_Mayer-Gael_Monfils,2,S-DTL,1,1,1,0,0,1,0
20190310-M-Indian_Wells_Masters-R64-Andrey_Rublev-Robin_Haase,1,F-XC,43,9,3,2,4,26,17
20190310-M-Indian_Wells_Masters-R64-Andrey_Rublev-Robin_Haase,1,F-DTM,44,5,3,0,2,21,23
20190310-M-Indian_Wells_Masters-R64-Andrey_Rublev-Robin_Haase,1,F-DTL,15,8,3,4,1,11,4
20190310-M-Indian_Wells_Masters-R64-Andrey_Rublev-Robin_Haase,1,F-IO,69,4,1,0,3,37,32
20190310-M-Indian_Wells_Masters-R64-Andrey_Rublev-Robin_Haase,1,F-II,17,5,2,0,3,10,7
20190310-M-Indian_Wells_Masters-R64-Andrey_Rublev-Robin_Haase,1,B-XC,81,9,3,1,5,48,33
20190310-M-Indian_Wells_Masters-R64-Andrey_Rublev-Robin_Haase,1,B-DTM,50,4,0,0,4,26,24
20190310-M-Indian_Wells_Masters-R64-Andrey_Rublev-Robin_Haase,1,B-DTL,15,11,4,2,5,8,7
20190310-M-Indian_Wells_Masters-R64-Andrey_Rublev-Robin_Haase,1,B-IO,8,3,1,0,2,1,7
20190310-M-Indian_Wells_Masters-R64-Andrey_Rublev-Robin_Haase,1,S-XC,2,0,0,0,0,1,1
20190310-M-Indian_Wells_Masters-R64-Andrey_Rublev-Robin_Haase,1,S-DTM,4,0,0,0,0,0,4
20190310-M-Indian_Wells_Masters-R64-Andrey_Rublev-Robin_Haase,1,S-DTL,1,1,0,0,1,0,1
20190310-M-Indian_Wells_Masters-R64-Andrey_Rublev-Robin_Haase,1,S-IO,1,0,0,0,0,1,0
20190310-M-Indian_Wells_Masters-R64-Andrey_Rublev-Robin_Haase,2,F-XC,31,8,3,3,2,13,18
20190310-M-Indian_Wells_Masters-R64-Andrey_Rublev-Robin_Haase,2,F-DTM,48,1,0,0,1,24,24
20190310-M-Indian_Wells_Masters-R64-Andrey_Rublev-Robin_Haase,2,F-DTL,10,2,2,0,0,5,5
20190310-M-Indian_Wells_Masters-R64-Andrey_Rublev-Robin_Haase,2,F-IO,44,1,1,0,0,23,21
20190310-M-Indian_Wells_Masters-R64-Andrey_Rublev-Robin_Haase,2,F-II,3,2,0,0,2,1,2
20190310-M-Indian_Wells_Masters-R64-Andrey_Rublev-Robin_Haase,2,B-XC,32,3,0,1,2,12,20
20190310-M-Indian_Wells_Masters-R64-Andrey_Rublev-Robin_Haase,2,B-DTM,60,8,0,0,8,19,41
20190310-M-Indian_Wells_Masters-R64-Andrey_Rublev-Robin_Haase,2,B-DTL,8,6,3,1,2,5,3
20190310-M-Indian_Wells_Masters-R64-Andrey_Rublev-Robin_Haase,2,B-IO,4,1,0,0,1,0,4
20190310-M-Indian_Wells_Masters-R64-Andrey_Rublev-Robin_Haase,2,S-XC,57,3,0,0,3,26,31
20190310-M-Indian_Wells_Masters-R64-Andrey_Rublev-Robin_Haase,2,S-DTM,16,2,0,0,2,7,9
20190310-M-Indian_Wells_Masters-R64-Andrey_Rublev-Robin_Haase,2,S-DTL,2,0,0,0,0,0,2
20190311-M-Indian_Wells_Masters-R32-Jan_Lennard_Struff-Alexander_Zverev,1,F-XC,31,6,2,1,3,23,8
20190311-M-Indian_Wells_Masters-R32-Jan_Lennard_Struff-Alexander_Zverev,1,F-DTM,14,3,0,0,3,9,5
20190311-M-Indian_Wells_Masters-R32-Jan_Lennard_Struff-Alexander_Zverev,1,F-DTL,3,2,2,0,0,3,0
20190311-M-Indian_Wells_Masters-R32-Jan_Lennard_Struff-Alexander_Zverev,1,F-IO,15,7,1,2,4,9,6
20190311-M-Indian_Wells_Masters-R32-Jan_Lennard_Struff-Alexander_Zverev,1,F-II,1,1,0,0,1,0,1
20190311-M-Indian_Wells_Masters-R32-Jan_Lennard_Struff-Alexander_Zverev,1,B-XC,32,3,1,0,2,20,12
20190311-M-Indian_Wells_Masters-R32-Jan_Lennard_Struff-Alexander_Zverev,1,B-DTM,9,1,0,0,1,8,1
20190311-M-Indian_Wells_Masters-R32-Jan_Lennard_Struff-Alexander_Zverev,1,B-DTL,4,4,2,2,0,4,0
20190311-M-Indian_Wells_Masters-R32-Jan_Lennard_Struff-Alexander_Zverev,1,B-IO,1,1,1,0,0,1,0
20190311-M-Indian_Wells_Masters-R32-Jan_Lennard_Struff-Alexander_Zverev,1,S-XC,19,1,0,0,1,14,5
20190311-M-Indian_Wells_Masters-R32-Jan_Lennard_Struff-Alexander_Zverev,1,S-DTM,4,0,0,0,0,3,1
20190311-M-Indian_Wells_Masters-R32-Jan_Lennard_Struff-Alexander_Zverev,1,S-DTL,2,1,0,1,0,1,1
20190311-M-Indian_Wells_Masters-R32-Jan_Lennard_Struff-Alexander_Zverev,2,F-XC,19,6,2,0,4,5,14
20190311-M-Indian_Wells_Masters-R32-Jan_Lennard_Struff-Alexander_Zverev,2,F-DTM,17,0,0,0,0,5,12
20190311-M-Indian_Wells_Masters-R32-Jan_Lennard_Struff-Alexander_Zverev,2,F-DTL,4,0,0,0,0,1,3
20190311-M-Indian_Wells_Masters-R32-Jan_Lennard_Struff-Alexander_Zverev,2,F-IO,12,1,0,0,1,4,8
20190311-M-Indian_Wells_Masters-R32-Jan_Lennard_Struff-Alexander_Zverev,2,F-II,1,0,0,0,0,0,1
20190311-M-Indian_Wells_Masters-R32-Jan_Lennard_Struff-Alexander_Zverev,2,B-XC,41,6,2,0,4,12,29
20190311-M-Indian_Wells_Masters-R32-Jan_Lennard_Struff-Alexander_Zverev,2,B-DTM,22,1,0,0,1,4,18
20190311-M-Indian_Wells_Masters-R32-Jan_Lennard_Struff-Alexander_Zverev,2,B-DTL,9,3,0,0,3,2,7
20190311-M-Indian_Wells_Masters-R32-Jan_Lennard_Struff-Alexander_Zverev,2,B-IO,1,0,0,0,0,1,0
20190311-M-Indian_Wells_Masters-R32-Jan_Lennard_Struff-Alexander_Zverev,2,S-XC,3,1,0,0,1,1,2
20190311-M-Indian_Wells_Masters-R32-Jan_Lennard_Struff-Alexander_Zverev,2,S-DTM,1,0,0,0,0,0,1
20190311-M-Indian_Wells_Masters-R32-Jan_Lennard_Struff-Alexander_Zverev,2,S-DTL,1,0,0,0,0,0,1
20170318-M-Indian_Wells_Masters-SF-Stanislas_Wawrinka-Pablo_Carreno_Busta,1,F-XC,26,10,6,2,2,15,11
20170318-M-Indian_Wells_Masters-SF-Stanislas_Wawrinka-Pablo_Carreno_Busta,1,F-DTM,6,1,0,0,1,4,2
20170318-M-Indian_Wells_Masters-SF-Stanislas_Wawrinka-Pablo_Carreno_Busta,1,F-DTL,11,4,2,0,2,6,5
20170318-M-Indian_Wells_Masters-SF-Stanislas_Wawrinka-Pablo_Carreno_Busta,1,F-IO,6,2,1,1,0,5,1
20170318-M-Indian_Wells_Masters-SF-Stanislas_Wawrinka-Pablo_Carreno_Busta,1,F-II,1,1,0,0,1,0,1
20170318-M-Indian_Wells_Masters-SF-Stanislas_Wawrinka-Pablo_Carreno_Busta,1,B-XC,26,4,1,1,2,17,9
20170318-M-Indian_Wells_Masters-SF-Stanislas_Wawrinka-Pablo_Carreno_Busta,1,B-DTM,10,1,0,0,1,6,4
20170318-M-Indian_Wells_Masters-SF-Stanislas_Wawrinka-Pablo_Carreno_Busta,1,B-DTL,2,1,0,1,0,1,1
20170318-M-Indian_Wells_Masters-SF-Stanislas_Wawrinka-Pablo_Carreno_Busta,1,S-XC,8,1,0,0,1,4,4
20170318-M-Indian_Wells_Masters-SF-Stanislas_Wawrinka-Pablo_Carreno_Busta,1,S-DTM,3,2,0,0,2,1,2
20170318-M-Indian_Wells_Masters-SF-Stanislas_Wawrinka-Pablo_Carreno_Busta,2,F-XC,32,4,1,2,1,16,16
20170318-M-Indian_Wells_Masters-SF-Stanislas_Wawrinka-Pablo_Carreno_Busta,2,F-DTM,10,3,0,1,2,3,7
20170318-M-Indian_Wells_Masters-SF-Stanislas_Wawrinka-Pablo_Carreno_Busta,2,F-DTL,5,2,1,0,1,2,3
20170318-M-Indian_Wells_Masters-SF-Stanislas_Wawrinka-Pablo_Carreno_Busta,2,F-IO,11,6,1,2,3,6,5
20170318-M-Indian_Wells_Masters-SF-Stanislas_Wawrinka-Pablo_Carreno_Busta,2,F-II,6,3,1,1,1,3,3
20170318-M-Indian_Wells_Masters-SF-Stanislas_Wawrinka-Pablo_Carreno_Busta,2,B-XC,30,9,1,1,7,12,18
20170318-M-Indian_Wells_Masters-SF-Stanislas_Wawrinka-Pablo_Carreno_Busta,2,B-DTM,9,1,0,0,1,2,7
20170318-M-Indian_Wells_Masters-SF-Stanislas_Wawrinka-Pablo_Carreno_Busta,2,B-DTL,3,2,0,0,2,0,3
20170318-M-Indian_Wells_Masters-SF-Stanislas_Wawrinka-Pablo_Carreno_Busta,2,B-IO,2,1,0,0,1,0,2
20170318-M-Indian_Wells_Masters-SF-Stanislas_Wawrinka-Pablo_Carreno_Busta,2,S-DTM,2,0,0,0,0,1,1
20170318-M-Indian_Wells_Masters-SF-Stanislas_Wawrinka-Pablo_Carreno_Busta,2,S-DTL,1,0,0,0,0,0,1
20190312-M-Indian_Wells_Masters-R32-Filip_Krajinovic-Daniil_Medvedev,1,F-XC,38,0,0,0,0,30,8
20190312-M-Indian_Wells_Masters-R32-Filip_Krajinovic-Daniil_Medvedev,1,F-DTM,28,0,0,0,0,17,11
20190312-M-Indian_Wells_Masters-R32-Filip_Krajinovic-Daniil_Medvedev,1,F-DTL,15,5,2,0,3,5,10
20190312-M-Indian_Wells_Masters-R32-Filip_Krajinovic-Daniil_Medvedev,1,F-IO,23,4,1,2,1,15,8
20190312-M-Indian_Wells_Masters-R32-Filip_Krajinovic-Daniil_Medvedev,1,F-II,4,2,0,1,1,3,1
20190312-M-Indian_Wells_Masters-R32-Filip_Krajinovic-Daniil_Medvedev,1,B-XC,36,4,1,0,3,20,16
20190312-M-Indian_Wells_Masters-R32-Filip_Krajinovic-Daniil_Medvedev,1,B-DTM,35,4,0,1,3,21,14
20190312-M-Indian_Wells_Masters-R32-Filip_Krajinovic-Daniil_Medvedev,1,B-DTL,17,5,3,0,2,12,5
20190312-M-Indian_Wells_Masters-R32-Filip_Krajinovic-Daniil_Medvedev,1,B-IO,7,3,1,2,0,5,2
20190312-M-Indian_Wells_Masters-R32-Filip_Krajinovic-Daniil_Medvedev,1,S-XC,13,0,0,0,0,6,7
20190312-M-Indian_Wells_Masters-R32-Filip_Krajinovic-Daniil_Medvedev,1,S-DTM,5,1,0,0,1,1,4
20190312-M-Indian_Wells_Masters-R32-Filip_Krajinovic-Daniil_Medvedev,2,F-XC,40,4,1,0,3,12,28
20190312-M-Indian_Wells_Masters-R32-Filip_Krajinovic-Daniil_Medvedev,2,F-DTM,31,5,1,0,4,10,21
20190312-M-Indian_Wells_Masters-R32-Filip_Krajinovic-Daniil_Medvedev,2,F-DTL,16,2,1,0,1,3,13
20190312-M-Indian_Wells_Masters-R32-Filip_Krajinovic-Daniil_Medvedev,2,F-IO,18,9,2,1,6,5,13
20190312-M-Indian_Wells_Masters-R32-Filip_Krajinovic-Daniil_Medvedev,2,B-XC,65,6,2,1,3,32,33
20190312-M-Indian_Wells_Masters-R32-Filip_Krajinovic-Daniil_Medvedev,2,B-DTM,31,4,1,0,3,12,19
20190312-M-Indian_Wells_Masters-R32-Filip_Krajinovic-Daniil_Medvedev,2,B-DTL,13,5,2,0,3,6,7
20190312-M-Indian_Wells_Masters-R32-Filip_Krajinovic-Daniil_Medvedev,2,B-IO,4,0,0,0,0,3,1
20190312-M-Indian_Wells_Masters-R32-Filip_Krajinovic-Daniil_Medvedev,2,S-XC,4,0,0,0,0,1,3
20190312-M-Indian_Wells_Masters-R32-Filip_Krajinovic-Daniil_Medvedev,2,S-DTM,2,0,0,0,0,1,1
19900706-M-Wimbledon-SF-Boris_Becker-Goran_Ivanisevic,1,F-XC,5,4,3,1,0,4,1
19900706-M-Wimbledon-SF-Boris_Becker-Goran_Ivanisevic,1,F-DTM,1,0,0,0,0,0,1
19900706-M-Wimbledon-SF-Boris_Becker-Goran_Ivanisevic,1,F-DTL,1,1,1,0,0,1,0
19900706-M-Wimbledon-SF-Boris_Becker-Goran_Ivanisevic,1,F-IO,2,1,1,0,0,2,0
19900706-M-Wimbledon-SF-Boris_Becker-Goran_Ivanisevic,1,F-II,1,0,0,0,0,0,1
19900706-M-Wimbledon-SF-Boris_Becker-Goran_Ivanisevic,1,B-XC,4,4,2,1,1,3,1
19900706-M-Wimbledon-SF-Boris_Becker-Goran_Ivanisevic,1,B-DTM,8,5,0,2,3,4,4
19900706-M-Wimbledon-SF-Boris_Becker-Goran_Ivanisevic,1,B-DTL,4,1,0,1,0,2,2
19900706-M-Wimbledon-SF-Boris_Becker-Goran_Ivanisevic,1,B-IO,3,2,0,1,1,2,1
19900706-M-Wimbledon-SF-Boris_Becker-Goran_Ivanisevic,1,S-DTL,2,0,0,0,0,0,2
19900706-M-Wimbledon-SF-Boris_Becker-Goran_Ivanisevic,2,F-XC,10,5,1,2,2,4,6
19900706-M-Wimbledon-SF-Boris_Becker-Goran_Ivanisevic,2,F-DTM,2,0,0,0,0,0,2
19900706-M-Wimbledon-SF-Boris_Becker-Goran_Ivanisevic,2,F-DTL,3,2,1,0,1,1,2
19900706-M-Wimbledon-SF-Boris_Becker-Goran_Ivanisevic,2,F-IO,1,1,0,0,1,0,1
19900706-M-Wimbledon-SF-Boris_Becker-Goran_Ivanisevic,2,B-XC,4,3,2,0,1,2,2
19900706-M-Wimbledon-SF-Boris_Becker-Goran_Ivanisevic,2,B-DTM,1,0,0,0,0,0,1
19900706-M-Wimbledon-SF-Boris_Becker-Goran_Ivanisevic,2,B-DTL,5,2,1,1,0,3,2
19900706-M-Wimbledon-SF-Boris_Becker-Goran_Ivanisevic,2,B-IO,2,1,0,0,1,0,2
19900706-M-Wimbledon-SF-Boris_Becker-Goran_Ivanisevic,2,S-XC,2,0,0,0,0,1,1
19900706-M-Wimbledon-SF-Boris_Becker-Goran_Ivanisevic,2,S-DTM,1,0,0,0,0,0,1
19900706-M-Wimbledon-SF-Boris_Becker-Goran_Ivanisevic,2,S-DTL,2,0,0,0,0,1,1
20190313-M-Indian_Wells_Masters-R16-Roger_Federer-Kyle_Edmund,1,F-XC,17,6,3,1,2,11,6
20190313-M-Indian_Wells_Masters-R16-Roger_Federer-Kyle_Edmund,1,F-DTM,15,1,0,0,1,9,6
20190313-M-Indian_Wells_Masters-R16-Roger_Federer-Kyle_Edmund,1,F-DTL,4,2,2,0,0,3,1
20190313-M-Indian_Wells_Masters-R16-Roger_Federer-Kyle_Edmund,1,F-IO,15,4,0,3,1,11,4
20190313-M-Indian_Wells_Masters-R16-Roger_Federer-Kyle_Edmund,1,F-II,1,1,1,0,0,1,0
20190313-M-Indian_Wells_Masters-R16-Roger_Federer-Kyle_Edmund,1,B-XC,14,4,0,2,2,8,6
20190313-M-Indian_Wells_Masters-R16-Roger_Federer-Kyle_Edmund,1,B-DTM,13,3,0,1,2,6,7
20190313-M-Indian_Wells_Masters-R16-Roger_Federer-Kyle_Edmund,1,B-DTL,2,2,1,0,1,1,1
20190313-M-Indian_Wells_Masters-R16-Roger_Federer-Kyle_Edmund,1,S-XC,6,0,0,0,0,4,2
20190313-M-Indian_Wells_Masters-R16-Roger_Federer-Kyle_Edmund,1,S-DTM,5,0,0,0,0,2,3
20190313-M-Indian_Wells_Masters-R16-Roger_Federer-Kyle_Edmund,1,S-DTL,2,0,0,0,0,2,0
20190313-M-Indian_Wells_Masters-R16-Roger_Federer-Kyle_Edmund,2,F-XC,15,5,2,0,3,7,8
20190313-M-Indian_Wells_Masters-R16-Roger_Federer-Kyle_Edmund,2,F-DTM,16,1,0,0,1,6,10
20190313-M-Indian_Wells_Masters-R16-Roger_Federer-Kyle_Edmund,2,F-DTL,3,2,1,0,1,2,1
20190313-M-Indian_Wells_Masters-R16-Roger_Federer-Kyle_Edmund,2,F-IO,19,10,2,3,5,7,12
20190313-M-Indian_Wells_Masters-R16-Roger_Federer-Kyle_Edmund,2,F-II,2,2,0,2,0,2,0
20190313-M-Indian_Wells_Masters-R16-Roger_Federer-Kyle_Edmund,2,B-XC,25,6,1,2,3,14,11
20190313-M-Indian_Wells_Masters-R16-Roger_Federer-Kyle_Edmund,2,B-DTM,9,1,0,0,1,1,8
20190313-M-Indian_Wells_Masters-R16-Roger_Federer-Kyle_Edmund,2,B-DTL,2,2,2,0,0,2,0
20190313-M-Indian_Wells_Masters-R16-Roger_Federer-Kyle_Edmund,2,B-IO,1,0,0,0,0,0,1
20190313-M-Indian_Wells_Masters-R16-Roger_Federer-Kyle_Edmund,2,S-XC,2,0,0,0,0,1,1
20190313-M-Indian_Wells_Masters-R16-Roger_Federer-Kyle_Edmund,2,S-DTM,1,0,0,0,0,0,1
20190313-M-Indian_Wells_Masters-R16-Roger_Federer-Kyle_Edmund,2,S-DTL,3,1,0,0,1,0,3
20190311-M-Indian_Wells_Masters-R32-Novak_Djokovic-Philipp_Kohlschreiber,1,F-XC,38,10,3,2,5,15,23
20190311-M-Indian_Wells_Masters-R32-Novak_Djokovic-Philipp_Kohlschreiber,1,F-DTM,44,6,0,0,6,18,26
20190311-M-Indian_Wells_Masters-R32-Novak_Djokovic-Philipp_Kohlschreiber,1,F-DTL,6,2,1,0,1,3,3
20190311-M-Indian_Wells_Masters-R32-Novak_Djokovic-Philipp_Kohlschreiber,1,F-IO,32,6,1,1,4,12,20
20190311-M-Indian_Wells_Masters-R32-Novak_Djokovic-Philipp_Kohlschreiber,1,F-II,7,3,1,1,1,4,3
20190311-M-Indian_Wells_Masters-R32-Novak_Djokovic-Philipp_Kohlschreiber,1,B-XC,67,4,0,1,3,27,40
20190311-M-Indian_Wells_Masters-R32-Novak_Djokovic-Philipp_Kohlschreiber,1,B-DTM,35,2,0,1,1,14,21
20190311-M-Indian_Wells_Masters-R32-Novak_Djokovic-Philipp_Kohlschreiber,1,B-DTL,6,3,1,0,2,3,3
20190311-M-Indian_Wells_Masters-R32-Novak_Djokovic-Philipp_Kohlschreiber,1,B-IO,6,2,2,0,0,4,2
20190311-M-Indian_Wells_Masters-R32-Novak_Djokovic-Philipp_Kohlschreiber,1,S-XC,4,1,0,0,1,0,4
20190311-M-Indian_Wells_Masters-R32-Novak_Djokovic-Philipp_Kohlschreiber,1,S-DTM,6,0,0,0,0,5,1
20190311-M-Indian_Wells_Masters-R32-Novak_Djokovic-Philipp_Kohlschreiber,2,F-XC,42,12,2,2,8,25,17
20190311-M-Indian_Wells_Masters-R32-Novak_Djokovic-Philipp_Kohlschreiber,2,F-DTM,44,2,0,0,2,23,21
20190311-M-Indian_Wells_Masters-R32-Novak_Djokovic-Philipp_Kohlschreiber,2,F-DTL,11,1,1,0,0,10,1
20190311-M-Indian_Wells_Masters-R32-Novak_Djokovic-Philipp_Kohlschreiber,2,F-IO,38,8,4,2,2,24,14
20190311-M-Indian_Wells_Masters-R32-Novak_Djokovic-Philipp_Kohlschreiber,2,F-II,6,4,2,2,0,4,2
20190311-M-Indian_Wells_Masters-R32-Novak_Djokovic-Philipp_Kohlschreiber,2,B-XC,38,5,1,1,3,18,20
20190311-M-Indian_Wells_Masters-R32-Novak_Djokovic-Philipp_Kohlschreiber,2,B-DTM,37,2,0,1,1,23,14
20190311-M-Indian_Wells_Masters-R32-Novak_Djokovic-Philipp_Kohlschreiber,2,B-DTL,3,2,1,0,1,2,1
20190311-M-Indian_Wells_Masters-R32-Novak_Djokovic-Philipp_Kohlschreiber,2,B-IO,3,2,0,0,2,1,2
20190311-M-Indian_Wells_Masters-R32-Novak_Djokovic-Philipp_Kohlschreiber,2,S-XC,24,2,0,0,2,14,10
20190311-M-Indian_Wells_Masters-R32-Novak_Djokovic-Philipp_Kohlschreiber,2,S-DTM,12,1,0,1,0,7,5
20190311-M-Indian_Wells_Masters-R32-Novak_Djokovic-Philipp_Kohlschreiber,2,S-DTL,1,0,0,0,0,0,1
20190313-M-Indian_Wells_Masters-R16-Gael_Monfils-Philipp_Kohlschreiber,1,F-XC,19,2,2,0,0,16,3
20190313-M-Indian_Wells_Masters-R16-Gael_Monfils-Philipp_Kohlschreiber,1,F-DTM,23,3,1,1,1,16,7
20190313-M-Indian_Wells_Masters-R16-Gael_Monfils-Philipp_Kohlschreiber,1,F-DTL,7,5,1,3,1,5,2
20190313-M-Indian_Wells_Masters-R16-Gael_Monfils-Philipp_Kohlschreiber,1,F-IO,13,3,2,0,1,11,2
20190313-M-Indian_Wells_Masters-R16-Gael_Monfils-Philipp_Kohlschreiber,1,F-II,2,1,1,0,0,2,0
20190313-M-Indian_Wells_Masters-R16-Gael_Monfils-Philipp_Kohlschreiber,1,B-XC,49,2,2,0,0,43,6
20190313-M-Indian_Wells_Masters-R16-Gael_Monfils-Philipp_Kohlschreiber,1,B-DTM,35,1,0,0,1,23,12
20190313-M-Indian_Wells_Masters-R16-Gael_Monfils-Philipp_Kohlschreiber,1,B-DTL,6,4,3,0,1,5,1
20190313-M-Indian_Wells_Masters-R16-Gael_Monfils-Philipp_Kohlschreiber,1,B-IO,3,2,1,0,1,2,1
20190313-M-Indian_Wells_Masters-R16-Gael_Monfils-Philipp_Kohlschreiber,1,S-DTL,1,1,1,0,0,1,0
20190313-M-Indian_Wells_Masters-R16-Gael_Monfils-Philipp_Kohlschreiber,2,F-XC,23,6,1,1,4,7,16
20190313-M-Indian_Wells_Masters-R16-Gael_Monfils-Philipp_Kohlschreiber,2,F-DTM,24,1,0,0,1,3,21
20190313-M-Indian_Wells_Masters-R16-Gael_Monfils-Philipp_Kohlschreiber,2,F-DTL,5,1,0,0,1,1,4
20190313-M-Indian_Wells_Masters-R16-Gael_Monfils-Philipp_Kohlschreiber,2,F-IO,43,9,1,1,7,13,30
20190313-M-Indian_Wells_Masters-R16-Gael_Monfils-Philipp_Kohlschreiber,2,F-II,5,2,0,1,1,2,3
20190313-M-Indian_Wells_Masters-R16-Gael_Monfils-Philipp_Kohlschreiber,2,B-XC,26,2,0,0,2,3,23
20190313-M-Indian_Wells_Masters-R16-Gael_Monfils-Philipp_Kohlschreiber,2,B-DTM,18,1,0,1,0,4,14
20190313-M-Indian_Wells_Masters-R16-Gael_Monfils-Philipp_Kohlschreiber,2,B-DTL,2,2,0,1,1,1,1
20190313-M-Indian_Wells_Masters-R16-Gael_Monfils-Philipp_Kohlschreiber,2,B-IO,2,1,1,0,0,1,1
20190313-M-Indian_Wells_Masters-R16-Gael_Monfils-Philipp_Kohlschreiber,2,S-XC,12,2,0,0,2,2,10
20190313-M-Indian_Wells_Masters-R16-Gael_Monfils-Philipp_Kohlschreiber,2,S-DTM,1,0,0,0,0,0,1
20190313-M-Indian_Wells_Masters-R16-Gael_Monfils-Philipp_Kohlschreiber,2,S-DTL,1,0,0,0,0,0,1
20190313-M-Indian_Wells_Masters-R16-Gael_Monfils-Philipp_Kohlschreiber,2,S-IO,1,0,0,0,0,1,0
20190313-M-Indian_Wells_Masters-R16-Hubert_Hurkacz-Denis_Shapovalov,1,F-XC,53,10,1,2,7,20,33
20190313-M-Indian_Wells_Masters-R16-Hubert_Hurkacz-Denis_Shapovalov,1,F-DTM,16,1,0,0,1,6,10
20190313-M-Indian_Wells_Masters-R16-Hubert_Hurkacz-Denis_Shapovalov,1,F-DTL,26,6,2,3,1,17,9
20190313-M-Indian_Wells_Masters-R16-Hubert_Hurkacz-Denis_Shapovalov,1,F-IO,20,9,2,3,4,10,10
20190313-M-Indian_Wells_Masters-R16-Hubert_Hurkacz-Denis_Shapovalov,1,F-II,1,0,0,0,0,1,0
20190313-M-Indian_Wells_Masters-R16-Hubert_Hurkacz-Denis_Shapovalov,1,B-XC,28,7,1,2,4,12,16
20190313-M-Indian_Wells_Masters-R16-Hubert_Hurkacz-Denis_Shapovalov,1,B-DTM,25,1,0,0,1,16,9
20190313-M-Indian_Wells_Masters-R16-Hubert_Hurkacz-Denis_Shapovalov,1,B-DTL,30,7,0,2,5,15,15
20190313-M-Indian_Wells_Masters-R16-Hubert_Hurkacz-Denis_Shapovalov,1,B-IO,10,3,0,1,2,5,5
20190313-M-Indian_Wells_Masters-R16-Hubert_Hurkacz-Denis_Shapovalov,1,S-XC,2,0,0,0,0,1,1
20190313-M-Indian_Wells_Masters-R16-Hubert_Hurkacz-Denis_Shapovalov,1,S-DTM,5,0,0,0,0,3,2
20190313-M-Indian_Wells_Masters-R16-Hubert_Hurkacz-Denis_Shapovalov,1,S-DTL,4,1,0,0,1,0,4
20190313-M-Indian_Wells_Masters-R16-Hubert_Hurkacz-Denis_Shapovalov,1,S-IO,3,1,0,0,1,1,2
20190313-M-Indian_Wells_Masters-R16-Hubert_Hurkacz-Denis_Shapovalov,2,F-XC,62,11,3,2,6,28,34
20190313-M-Indian_Wells_Masters-R16-Hubert_Hurkacz-Denis_Shapovalov,2,F-DTM,26,1,0,0,1,15,11
20190313-M-Indian_Wells_Masters-R16-Hubert_Hurkacz-Denis_Shapovalov,2,F-DTL,14,10,4,0,6,7,7
20190313-M-Indian_Wells_Masters-R16-Hubert_Hurkacz-Denis_Shapovalov,2,F-IO,24,13,6,2,5,13,11
20190313-M-Indian_Wells_Masters-R16-Hubert_Hurkacz-Denis_Shapovalov,2,F-II,10,2,0,0,2,5,5
20190313-M-Indian_Wells_Masters-R16-Hubert_Hurkacz-Denis_Shapovalov,2,B-XC,36,6,0,2,4,19,17
20190313-M-Indian_Wells_Masters-R16-Hubert_Hurkacz-Denis_Shapovalov,2,B-DTM,21,2,0,1,1,14,7
20190313-M-Indian_Wells_Masters-R16-Hubert_Hurkacz-Denis_Shapovalov,2,B-DTL,11,3,1,0,2,5,6
20190313-M-Indian_Wells_Masters-R16-Hubert_Hurkacz-Denis_Shapovalov,2,B-IO,4,2,0,1,1,2,2
20190313-M-Indian_Wells_Masters-R16-Hubert_Hurkacz-Denis_Shapovalov,2,S-XC,1,0,0,0,0,0,1
20190313-M-Indian_Wells_Masters-R16-Hubert_Hurkacz-Denis_Shapovalov,2,S-DTM,5,0,0,0,0,2,3
20190313-M-Indian_Wells_Masters-R16-Hubert_Hurkacz-Denis_Shapovalov,2,S-DTL,2,0,0,0,0,1,1
20190309-M-Indian_Wells_Masters-R64-Miomir_Kecmanovic-Maximilian_Marterer,1,F-XC,63,4,2,2,0,35,28
20190309-M-Indian_Wells_Masters-R64-Miomir_Kecmanovic-Maximilian_Marterer,1,F-DTM,12,0,0,0,0,4,8
20190309-M-Indian_Wells_Masters-R64-Miomir_Kecmanovic-Maximilian_Marterer,1,F-DTL,15,3,3,0,0,10,5
20190309-M-Indian_Wells_Masters-R64-Miomir_Kecmanovic-Maximilian_Marterer,1,F-IO,20,4,1,2,1,13,7
20190309-M-Indian_Wells_Masters-R64-Miomir_Kecmanovic-Maximilian_Marterer,1,F-II,8,4,2,1,1,6,2
20190309-M-Indian_Wells_Masters-R64-Miomir_Kecmanovic-Maximilian_Marterer,1,B-XC,42,9,1,5,3,25,17
20190309-M-Indian_Wells_Masters-R64-Miomir_Kecmanovic-Maximilian_Marterer,1,B-DTM,17,1,0,0,1,9,8
20190309-M-Indian_Wells_Masters-R64-Miomir_Kecmanovic-Maximilian_Marterer,1,B-DTL,8,1,0,1,0,4,4
20190309-M-Indian_Wells_Masters-R64-Miomir_Kecmanovic-Maximilian_Marterer,1,B-IO,4,0,0,0,0,4,0
20190309-M-Indian_Wells_Masters-R64-Miomir_Kecmanovic-Maximilian_Marterer,1,S-XC,2,0,0,0,0,1,1
20190309-M-Indian_Wells_Masters-R64-Miomir_Kecmanovic-Maximilian_Marterer,1,S-DTM,3,0,0,0,0,1,2
20190309-M-Indian_Wells_Masters-R64-Miomir_Kecmanovic-Maximilian_Marterer,1,S-DTL,1,0,0,0,0,1,0
20190309-M-Indian_Wells_Masters-R64-Miomir_Kecmanovic-Maximilian_Marterer,2,F-XC,60,7,1,1,5,25,35
20190309-M-Indian_Wells_Masters-R64-Miomir_Kecmanovic-Maximilian_Marterer,2,F-DTM,20,4,1,1,2,7,13
20190309-M-Indian_Wells_Masters-R64-Miomir_Kecmanovic-Maximilian_Marterer,2,F-DTL,15,3,2,1,0,10,5
20190309-M-Indian_Wells_Masters-R64-Miomir_Kecmanovic-Maximilian_Marterer,2,F-IO,10,5,4,0,1,6,4
20190309-M-Indian_Wells_Masters-R64-Miomir_Kecmanovic-Maximilian_Marterer,2,F-II,9,0,0,0,0,4,5
20190309-M-Indian_Wells_Masters-R64-Miomir_Kecmanovic-Maximilian_Marterer,2,B-XC,42,4,0,2,2,19,23
20190309-M-Indian_Wells_Masters-R64-Miomir_Kecmanovic-Maximilian_Marterer,2,B-DTM,22,2,0,0,2,8,14
20190309-M-Indian_Wells_Masters-R64-Miomir_Kecmanovic-Maximilian_Marterer,2,B-DTL,7,3,1,1,1,4,3
20190309-M-Indian_Wells_Masters-R64-Miomir_Kecmanovic-Maximilian_Marterer,2,B-IO,4,1,0,1,0,4,0
20190309-M-Indian_Wells_Masters-R64-Miomir_Kecmanovic-Maximilian_Marterer,2,S-XC,7,0,0,0,0,4,3
20190309-M-Indian_Wells_Masters-R64-Miomir_Kecmanovic-Maximilian_Marterer,2,S-DTM,3,0,0,0,0,1,2
20190309-M-Indian_Wells_Masters-R64-Miomir_Kecmanovic-Maximilian_Marterer,2,S-DTL,4,0,0,0,0,1,3
20000119-M-Australian_Open-R64-Jan_Kroslak-Roger_Federer,1,F-XC,24,10,2,1,7,8,16
20000119-M-Australian_Open-R64-Jan_Kroslak-Roger_Federer,1,F-DTM,19,2,0,1,1,9,10
20000119-M-Australian_Open-R64-Jan_Kroslak-Roger_Federer,1,F-DTL,7,4,0,1,3,3,4
20000119-M-Australian_Open-R64-Jan_Kroslak-Roger_Federer,1,F-IO,5,3,0,1,2,1,4
20000119-M-Australian_Open-R64-Jan_Kroslak-Roger_Federer,1,B-XC,30,11,1,2,8,10,20
20000119-M-Australian_Open-R64-Jan_Kroslak-Roger_Federer,1,B-DTM,26,6,0,0,6,9,17
20000119-M-Australian_Open-R64-Jan_Kroslak-Roger_Federer,1,B-DTL,5,5,3,0,2,3,2
20000119-M-Australian_Open-R64-Jan_Kroslak-Roger_Federer,1,B-IO,9,3,1,1,1,5,4
20000119-M-Australian_Open-R64-Jan_Kroslak-Roger_Federer,1,S-XC,2,0,0,0,0,1,1
20000119-M-Australian_Open-R64-Jan_Kroslak-Roger_Federer,1,S-DTM,1,0,0,0,0,1,0
20000119-M-Australian_Open-R64-Jan_Kroslak-Roger_Federer,1,S-DTL,1,0,0,0,0,0,1
20000119-M-Australian_Open-R64-Jan_Kroslak-Roger_Federer,1,S-IO,1,0,0,0,0,1,0
20000119-M-Australian_Open-R64-Jan_Kroslak-Roger_Federer,2,F-XC,34,17,7,2,8,18,16
20000119-M-Australian_Open-R64-Jan_Kroslak-Roger_Federer,2,F-DTM,32,6,3,1,2,18,14
20000119-M-Australian_Open-R64-Jan_Kroslak-Roger_Federer,2,F-DTL,9,5,1,0,4,4,5
20000119-M-Australian_Open-R64-Jan_Kroslak-Roger_Federer,2,F-IO,17,9,5,1,3,12,5
20000119-M-Australian_Open-R64-Jan_Kroslak-Roger_Federer,2,F-II,2,1,1,0,0,2,0
20000119-M-Australian_Open-R64-Jan_Kroslak-Roger_Federer,2,B-XC,9,4,1,0,3,3,6
20000119-M-Australian_Open-R64-Jan_Kroslak-Roger_Federer,2,B-DTM,18,3,1,0,2,11,7
20000119-M-Australian_Open-R64-Jan_Kroslak-Roger_Federer,2,B-DTL,4,3,2,1,0,4,0
20000119-M-Australian_Open-R64-Jan_Kroslak-Roger_Federer,2,B-IO,1,1,0,0,1,0,1
20000119-M-Australian_Open-R64-Jan_Kroslak-Roger_Federer,2,B-II,1,1,0,0,1,0,1
20000119-M-Australian_Open-R64-Jan_Kroslak-Roger_Federer,2,S-XC,3,0,0,0,0,3,0
20000119-M-Australian_Open-R64-Jan_Kroslak-Roger_Federer,2,S-DTM,5,0,0,0,0,1,4
20000119-M-Australian_Open-R64-Jan_Kroslak-Roger_Federer,2,S-IO,1,0,0,0,0,1,0
20190222-M-Bergamo_CH-QF-Jannik_Sinner-Gianluigi_Quinzi,1,F-XC,52,9,2,4,3,35,17
20190222-M-Bergamo_CH-QF-Jannik_Sinner-Gianluigi_Quinzi,1,F-DTM,12,1,0,1,0,8,4
20190222-M-Bergamo_CH-QF-Jannik_Sinner-Gianluigi_Quinzi,1,F-DTL,4,2,2,0,0,4,0
20190222-M-Bergamo_CH-QF-Jannik_Sinner-Gianluigi_Quinzi,1,F-IO,22,7,4,0,3,15,7
20190222-M-Bergamo_CH-QF-Jannik_Sinner-Gianluigi_Quinzi,1,F-II,1,0,0,0,0,0,1
20190222-M-Bergamo_CH-QF-Jannik_Sinner-Gianluigi_Quinzi,1,B-XC,37,7,4,1,2,25,12
20190222-M-Bergamo_CH-QF-Jannik_Sinner-Gianluigi_Quinzi,1,B-DTM,29,5,0,2,3,16,13
20190222-M-Bergamo_CH-QF-Jannik_Sinner-Gianluigi_Quinzi,1,B-DTL,4,3,2,0,1,3,1
20190222-M-Bergamo_CH-QF-Jannik_Sinner-Gianluigi_Quinzi,1,S-XC,2,0,0,0,0,0,2
20190222-M-Bergamo_CH-QF-Jannik_Sinner-Gianluigi_Quinzi,1,S-DTM,1,0,0,0,0,0,1
20190222-M-Bergamo_CH-QF-Jannik_Sinner-Gianluigi_Quinzi,2,F-XC,46,6,1,1,4,16,30
20190222-M-Bergamo_CH-QF-Jannik_Sinner-Gianluigi_Quinzi,2,F-DTM,24,3,0,1,2,9,15
20190222-M-Bergamo_CH-QF-Jannik_Sinner-Gianluigi_Quinzi,2,F-DTL,12,4,2,0,2,4,8
20190222-M-Bergamo_CH-QF-Jannik_Sinner-Gianluigi_Quinzi,2,F-IO,13,7,2,1,4,6,7
20190222-M-Bergamo_CH-QF-Jannik_Sinner-Gianluigi_Quinzi,2,B-XC,26,5,3,0,2,8,18
20190222-M-Bergamo_CH-QF-Jannik_Sinner-Gianluigi_Quinzi,2,B-DTM,18,4,0,1,3,7,11
20190222-M-Bergamo_CH-QF-Jannik_Sinner-Gianluigi_Quinzi,2,B-DTL,12,1,0,0,1,3,9
20190222-M-Bergamo_CH-QF-Jannik_Sinner-Gianluigi_Quinzi,2,B-IO,9,2,1,0,1,4,5
20190222-M-Bergamo_CH-QF-Jannik_Sinner-Gianluigi_Quinzi,2,S-DTM,3,0,0,0,0,0,3
20190222-M-Bergamo_CH-QF-Jannik_Sinner-Gianluigi_Quinzi,2,S-DTL,4,0,0,0,0,3,1
19860704-M-Wimbledon-SF-Henri_Leconte-Boris_Becker,1,F-XC,4,2,0,0,2,1,3
19860704-M-Wimbledon-SF-Henri_Leconte-Boris_Becker,1,F-DTM,1,0,0,0,0,0,1
19860704-M-Wimbledon-SF-Henri_Leconte-Boris_Becker,1,F-DTL,6,3,3,0,0,4,2
19860704-M-Wimbledon-SF-Henri_Leconte-Boris_Becker,1,F-IO,1,1,1,0,0,1,0
19860704-M-Wimbledon-SF-Henri_Leconte-Boris_Becker,1,B-XC,3,2,1,1,0,2,1
19860704-M-Wimbledon-SF-Henri_Leconte-Boris_Becker,1,B-DTM,4,0,0,0,0,1,3
19860704-M-Wimbledon-SF-Henri_Leconte-Boris_Becker,1,B-DTL,3,2,2,0,0,2,1
19860704-M-Wimbledon-SF-Henri_Leconte-Boris_Becker,1,S-DTL,1,0,0,0,0,1,0
19860704-M-Wimbledon-SF-Henri_Leconte-Boris_Becker,2,F-XC,3,2,2,0,0,2,1
19860704-M-Wimbledon-SF-Henri_Leconte-Boris_Becker,2,F-DTM,2,1,1,0,0,1,1
19860704-M-Wimbledon-SF-Henri_Leconte-Boris_Becker,2,F-DTL,1,0,0,0,0,0,1
19860704-M-Wimbledon-SF-Henri_Leconte-Boris_Becker,2,F-IO,3,2,1,0,1,1,2
19860704-M-Wimbledon-SF-Henri_Leconte-Boris_Becker,2,B-XC,6,5,1,2,2,3,3
19860704-M-Wimbledon-SF-Henri_Leconte-Boris_Becker,2,B-DTM,1,0,0,0,0,0,1
19860704-M-Wimbledon-SF-Henri_Leconte-Boris_Becker,2,B-DTL,4,3,3,0,0,3,1
19860704-M-Wimbledon-SF-Henri_Leconte-Boris_Becker,2,B-IO,2,1,0,0,1,0,2
19860704-M-Wimbledon-SF-Henri_Leconte-Boris_Becker,2,S-XC,1,0,0,0,0,0,1
19860704-M-Wimbledon-SF-Henri_Leconte-Boris_Becker,2,S-IO,2,1,0,1,0,1,1
20190315-M-Indian_Wells_Masters-QF-Rafael_Nadal-Karen_Khachanov,1,F-XC,71,11,3,5,3,48,23
20190315-M-Indian_Wells_Masters-QF-Rafael_Nadal-Karen_Khachanov,1,F-DTM,25,1,0,0,1,15,10
20190315-M-Indian_Wells_Masters-QF-Rafael_Nadal-Karen_Khachanov,1,F-DTL,17,10,4,2,4,12,5
20190315-M-Indian_Wells_Masters-QF-Rafael_Nadal-Karen_Khachanov,1,F-IO,22,8,5,1,2,13,9
20190315-M-Indian_Wells_Masters-QF-Rafael_Nadal-Karen_Khachanov,1,F-II,3,0,0,0,0,2,1
20190315-M-Indian_Wells_Masters-QF-Rafael_Nadal-Karen_Khachanov,1,B-XC,26,5,1,2,2,18,8
20190315-M-Indian_Wells_Masters-QF-Rafael_Nadal-Karen_Khachanov,1,B-DTM,18,0,0,0,0,15,3
20190315-M-Indian_Wells_Masters-QF-Rafael_Nadal-Karen_Khachanov,1,B-DTL,14,4,0,3,1,9,5
20190315-M-Indian_Wells_Masters-QF-Rafael_Nadal-Karen_Khachanov,1,S-XC,5,0,0,0,0,2,3
20190315-M-Indian_Wells_Masters-QF-Rafael_Nadal-Karen_Khachanov,1,S-DTM,6,0,0,0,0,2,4
20190315-M-Indian_Wells_Masters-QF-Rafael_Nadal-Karen_Khachanov,1,S-DTL,10,0,0,0,0,4,6
20190315-M-Indian_Wells_Masters-QF-Rafael_Nadal-Karen_Khachanov,1,S-IO,1,1,0,0,1,0,1
20190315-M-Indian_Wells_Masters-QF-Rafael_Nadal-Karen_Khachanov,2,F-XC,55,11,4,2,5,22,33
20190315-M-Indian_Wells_Masters-QF-Rafael_Nadal-Karen_Khachanov,2,F-DTM,24,0,0,0,0,10,14
20190315-M-Indian_Wells_Masters-QF-Rafael_Nadal-Karen_Khachanov,2,F-DTL,11,3,0,3,0,6,5
20190315-M-Indian_Wells_Masters-QF-Rafael_Nadal-Karen_Khachanov,2,F-IO,25,9,2,2,5,7,18
20190315-M-Indian_Wells_Masters-QF-Rafael_Nadal-Karen_Khachanov,2,F-II,3,0,0,0,0,2,1
20190315-M-Indian_Wells_Masters-QF-Rafael_Nadal-Karen_Khachanov,2,B-XC,48,12,1,1,10,15,33
20190315-M-Indian_Wells_Masters-QF-Rafael_Nadal-Karen_Khachanov,2,B-DTM,14,1,0,0,1,6,8
20190315-M-Indian_Wells_Masters-QF-Rafael_Nadal-Karen_Khachanov,2,B-DTL,16,8,3,2,3,9,7
20190315-M-Indian_Wells_Masters-QF-Rafael_Nadal-Karen_Khachanov,2,B-IO,4,1,0,0,1,0,4
20190315-M-Indian_Wells_Masters-QF-Rafael_Nadal-Karen_Khachanov,2,S-XC,5,0,0,0,0,1,4
20190315-M-Indian_Wells_Masters-QF-Rafael_Nadal-Karen_Khachanov,2,S-DTM,3,0,0,0,0,1,2
20190315-M-Indian_Wells_Masters-QF-Rafael_Nadal-Karen_Khachanov,2,S-DTL,1,0,0,0,0,0,1
20190315-M-Indian_Wells_Masters-QF-Rafael_Nadal-Karen_Khachanov,2,S-IO,1,0,0,0,0,0,1
20190314-M-Indian_Wells_Masters-QF-Milos_Raonic-Miomir_Kecmanovic,1,F-XC,12,4,4,0,0,8,4
20190314-M-Indian_Wells_Masters-QF-Milos_Raonic-Miomir_Kecmanovic,1,F-DTM,4,1,0,0,1,0,4
20190314-M-Indian_Wells_Masters-QF-Milos_Raonic-Miomir_Kecmanovic,1,F-DTL,7,2,0,0,2,5,2
20190314-M-Indian_Wells_Masters-QF-Milos_Raonic-Miomir_Kecmanovic,1,F-IO,33,13,7,2,4,22,11
20190314-M-Indian_Wells_Masters-QF-Milos_Raonic-Miomir_Kecmanovic,1,F-II,6,4,2,0,2,4,2
20190314-M-Indian_Wells_Masters-QF-Milos_Raonic-Miomir_Kecmanovic,1,B-XC,5,2,0,2,0,3,2
20190314-M-Indian_Wells_Masters-QF-Milos_Raonic-Miomir_Kecmanovic,1,B-DTL,1,1,1,0,0,1,0
20190314-M-Indian_Wells_Masters-QF-Milos_Raonic-Miomir_Kecmanovic,1,B-IO,1,1,0,0,1,0,1
20190314-M-Indian_Wells_Masters-QF-Milos_Raonic-Miomir_Kecmanovic,1,S-XC,17,1,0,1,0,10,7
20190314-M-Indian_Wells_Masters-QF-Milos_Raonic-Miomir_Kecmanovic,1,S-DTM,4,0,0,0,0,1,3
20190314-M-Indian_Wells_Masters-QF-Milos_Raonic-Miomir_Kecmanovic,1,S-DTL,1,1,0,1,0,1,0
20190314-M-Indian_Wells_Masters-QF-Milos_Raonic-Miomir_Kecmanovic,2,F-XC,11,1,1,0,0,5,6
20190314-M-Indian_Wells_Masters-QF-Milos_Raonic-Miomir_Kecmanovic,2,F-DTM,7,0,0,0,0,4,3
20190314-M-Indian_Wells_Masters-QF-Milos_Raonic-Miomir_Kecmanovic,2,F-DTL,1,0,0,0,0,0,1
20190314-M-Indian_Wells_Masters-QF-Milos_Raonic-Miomir_Kecmanovic,2,F-IO,7,4,3,1,0,5,2
20190314-M-Indian_Wells_Masters-QF-Milos_Raonic-Miomir_Kecmanovic,2,F-II,3,1,1,0,0,2,1
20190314-M-Indian_Wells_Masters-QF-Milos_Raonic-Miomir_Kecmanovic,2,B-XC,34,5,0,3,2,15,19
20190314-M-Indian_Wells_Masters-QF-Milos_Raonic-Miomir_Kecmanovic,2,B-DTM,6,0,0,0,0,1,5
20190314-M-Indian_Wells_Masters-QF-Milos_Raonic-Miomir_Kecmanovic,2,B-DTL,4,2,0,1,1,2,2
20190314-M-Indian_Wells_Masters-QF-Milos_Raonic-Miomir_Kecmanovic,2,B-IO,1,0,0,0,0,1,0
20190314-M-Indian_Wells_Masters-QF-Milos_Raonic-Miomir_Kecmanovic,2,S-XC,3,0,0,0,0,3,0
20190314-M-Indian_Wells_Masters-QF-Milos_Raonic-Miomir_Kecmanovic,2,S-DTM,4,0,0,0,0,2,2
20190227-M-Sao_Paulo-R16-Thiago_Seyboth_Wild-Marco_Trungelliti,1,F-XC,24,12,1,3,8,13,11
20190227-M-Sao_Paulo-R16-Thiago_Seyboth_Wild-Marco_Trungelliti,1,F-DTM,17,3,0,0,3,7,10
20190227-M-Sao_Paulo-R16-Thiago_Seyboth_Wild-Marco_Trungelliti,1,F-DTL,12,4,1,1,2,7,5
20190227-M-Sao_Paulo-R16-Thiago_Seyboth_Wild-Marco_Trungelliti,1,F-IO,21,9,4,2,3,12,9
20190227-M-Sao_Paulo-R16-Thiago_Seyboth_Wild-Marco_Trungelliti,1,F-II,6,3,1,1,1,4,2
20190227-M-Sao_Paulo-R16-Thiago_Seyboth_Wild-Marco_Trungelliti,1,B-XC,28,5,1,1,3,16,12
20190227-M-Sao_Paulo-R16-Thiago_Seyboth_Wild-Marco_Trungelliti,1,B-DTM,24,5,1,0,4,10,14
20190227-M-Sao_Paulo-R16-Thiago_Seyboth_Wild-Marco_Trungelliti,1,B-DTL,14,9,2,2,5,7,7
20190227-M-Sao_Paulo-R16-Thiago_Seyboth_Wild-Marco_Trungelliti,1,B-IO,5,2,0,0,2,1,4
20190227-M-Sao_Paulo-R16-Thiago_Seyboth_Wild-Marco_Trungelliti,1,S-XC,2,1,0,1,0,2,0
20190227-M-Sao_Paulo-R16-Thiago_Seyboth_Wild-Marco_Trungelliti,1,S-DTL,1,0,0,0,0,0,1
20190227-M-Sao_Paulo-R16-Thiago_Seyboth_Wild-Marco_Trungelliti,2,F-XC,24,5,0,4,1,13,11
20190227-M-Sao_Paulo-R16-Thiago_Seyboth_Wild-Marco_Trungelliti,2,F-DTM,11,2,0,0,2,2,9
20190227-M-Sao_Paulo-R16-Thiago_Seyboth_Wild-Marco_Trungelliti,2,F-DTL,6,0,0,0,0,3,3
20190227-M-Sao_Paulo-R16-Thiago_Seyboth_Wild-Marco_Trungelliti,2,F-IO,13,2,1,0,1,7,6
20190227-M-Sao_Paulo-R16-Thiago_Seyboth_Wild-Marco_Trungelliti,2,B-XC,22,2,0,1,1,9,13
20190227-M-Sao_Paulo-R16-Thiago_Seyboth_Wild-Marco_Trungelliti,2,B-DTM,10,1,0,0,1,4,6
20190227-M-Sao_Paulo-R16-Thiago_Seyboth_Wild-Marco_Trungelliti,2,B-DTL,10,6,2,0,4,5,5
20190227-M-Sao_Paulo-R16-Thiago_Seyboth_Wild-Marco_Trungelliti,2,B-IO,1,0,0,0,0,1,0
20190227-M-Sao_Paulo-R16-Thiago_Seyboth_Wild-Marco_Trungelliti,2,S-XC,12,1,0,0,1,5,7
20190227-M-Sao_Paulo-R16-Thiago_Seyboth_Wild-Marco_Trungelliti,2,S-DTM,7,1,0,0,1,4,3
20190227-M-Sao_Paulo-R16-Thiago_Seyboth_Wild-Marco_Trungelliti,2,S-DTL,3,0,0,0,0,3,0
19890708-M-Wimbledon-SF-Ivan_Lendl-Boris_Becker,1,F-XC,2,1,1,0,0,1,1
19890708-M-Wimbledon-SF-Ivan_Lendl-Boris_Becker,1,F-DTL,3,2,2,0,0,2,1
19890708-M-Wimbledon-SF-Ivan_Lendl-Boris_Becker,1,F-IO,1,1,0,1,0,1,0
19890708-M-Wimbledon-SF-Ivan_Lendl-Boris_Becker,1,F-II,3,2,2,0,0,3,0
19890708-M-Wimbledon-SF-Ivan_Lendl-Boris_Becker,1,B-XC,4,3,3,0,0,4,0
19890708-M-Wimbledon-SF-Ivan_Lendl-Boris_Becker,1,B-DTL,3,3,3,0,0,3,0
19890708-M-Wimbledon-SF-Ivan_Lendl-Boris_Becker,1,B-IO,1,1,0,0,1,0,1
19890708-M-Wimbledon-SF-Ivan_Lendl-Boris_Becker,1,S-XC,2,0,0,0,0,2,0
19890708-M-Wimbledon-SF-Ivan_Lendl-Boris_Becker,1,S-DTM,2,0,0,0,0,0,2
19890708-M-Wimbledon-SF-Ivan_Lendl-Boris_Becker,1,S-DTL,1,1,1,0,0,1,0
19890708-M-Wimbledon-SF-Ivan_Lendl-Boris_Becker,2,F-XC,6,3,2,0,1,4,2
19890708-M-Wimbledon-SF-Ivan_Lendl-Boris_Becker,2,F-DTM,3,0,0,0,0,1,2
19890708-M-Wimbledon-SF-Ivan_Lendl-Boris_Becker,2,F-DTL,3,1,0,0,1,0,3
19890708-M-Wimbledon-SF-Ivan_Lendl-Boris_Becker,2,F-IO,4,4,3,0,1,3,1
19890708-M-Wimbledon-SF-Ivan_Lendl-Boris_Becker,2,B-XC,11,6,3,2,1,5,6
19890708-M-Wimbledon-SF-Ivan_Lendl-Boris_Becker,2,B-DTM,6,3,1,0,2,2,4
19890708-M-Wimbledon-SF-Ivan_Lendl-Boris_Becker,2,B-DTL,18,13,9,1,3,10,8
19890708-M-Wimbledon-SF-Ivan_Lendl-Boris_Becker,2,S-XC,2,0,0,0,0,1,1
19890708-M-Wimbledon-SF-Ivan_Lendl-Boris_Becker,2,S-DTM,1,0,0,0,0,0,1
19890708-M-Wimbledon-SF-Ivan_Lendl-Boris_Becker,2,S-DTL,2,1,1,0,0,1,1
19950707-M-Wimbledon-SF-Boris_Becker-Andre_Agassi,1,F-XC,29,5,3,1,1,17,12
19950707-M-Wimbledon-SF-Boris_Becker-Andre_Agassi,1,F-DTM,12,1,0,0,1,5,7
19950707-M-Wimbledon-SF-Boris_Becker-Andre_Agassi,1,F-DTL,13,4,2,0,2,6,7
19950707-M-Wimbledon-SF-Boris_Becker-Andre_Agassi,1,F-IO,6,2,1,0,1,2,4
19950707-M-Wimbledon-SF-Boris_Becker-Andre_Agassi,1,F-II,1,1,0,0,1,0,1
19950707-M-Wimbledon-SF-Boris_Becker-Andre_Agassi,1,B-XC,13,2,0,2,0,9,4
19950707-M-Wimbledon-SF-Boris_Becker-Andre_Agassi,1,B-DTM,6,0,0,0,0,3,3
19950707-M-Wimbledon-SF-Boris_Becker-Andre_Agassi,1,B-DTL,6,4,0,2,2,3,3
19950707-M-Wimbledon-SF-Boris_Becker-Andre_Agassi,1,B-IO,3,0,0,0,0,1,2
19950707-M-Wimbledon-SF-Boris_Becker-Andre_Agassi,1,S-XC,25,4,0,2,2,13,12
19950707-M-Wimbledon-SF-Boris_Becker-Andre_Agassi,1,S-DTM,15,2,1,0,1,6,9
19950707-M-Wimbledon-SF-Boris_Becker-Andre_Agassi,1,S-DTL,17,6,1,2,3,11,6
19950707-M-Wimbledon-SF-Boris_Becker-Andre_Agassi,1,S-IO,1,0,0,0,0,0,1
19950707-M-Wimbledon-SF-Boris_Becker-Andre_Agassi,2,F-XC,47,14,7,6,1,32,15
19950707-M-Wimbledon-SF-Boris_Becker-Andre_Agassi,2,F-DTM,22,2,0,0,2,6,16
19950707-M-Wimbledon-SF-Boris_Becker-Andre_Agassi,2,F-DTL,16,8,3,3,2,11,5
19950707-M-Wimbledon-SF-Boris_Becker-Andre_Agassi,2,F-IO,19,7,2,4,1,11,8
19950707-M-Wimbledon-SF-Boris_Becker-Andre_Agassi,2,F-II,12,4,3,1,0,7,5
19950707-M-Wimbledon-SF-Boris_Becker-Andre_Agassi,2,B-XC,76,18,5,6,7,39,37
19950707-M-Wimbledon-SF-Boris_Becker-Andre_Agassi,2,B-DTM,18,5,0,1,4,5,13
19950707-M-Wimbledon-SF-Boris_Becker-Andre_Agassi,2,B-DTL,18,9,2,3,4,6,12
19950707-M-Wimbledon-SF-Boris_Becker-Andre_Agassi,2,B-IO,3,0,0,0,0,3,0
19950707-M-Wimbledon-SF-Boris_Becker-Andre_Agassi,2,S-XC,8,1,1,0,0,6,2
19950707-M-Wimbledon-SF-Boris_Becker-Andre_Agassi,2,S-DTL,4,2,1,1,0,4,0
19950707-M-Wimbledon-SF-Boris_Becker-Andre_Agassi,2,S-II,1,0,0,0,0,0,1
20060907-M-US_Open-QF-James_Blake-Roger_Federer,1,F-XC,49,17,7,5,5,31,18
20060907-M-US_Open-QF-James_Blake-Roger_Federer,1,F-DTM,16,2,1,0,1,8,8
20060907-M-US_Open-QF-James_Blake-Roger_Federer,1,F-DTL,21,7,1,1,5,7,14
20060907-M-US_Open-QF-James_Blake-Roger_Federer,1,F-IO,64,13,2,4,7,27,37
20060907-M-US_Open-QF-James_Blake-Roger_Federer,1,F-II,9,4,0,1,3,1,8
20060907-M-US_Open-QF-James_Blake-Roger_Federer,1,B-XC,70,7,1,1,5,35,35
20060907-M-US_Open-QF-James_Blake-Roger_Federer,1,B-DTM,19,4,0,1,3,9,10
20060907-M-US_Open-QF-James_Blake-Roger_Federer,1,B-DTL,12,6,3,0,3,4,8
20060907-M-US_Open-QF-James_Blake-Roger_Federer,1,B-IO,3,0,0,0,0,1,2
20060907-M-US_Open-QF-James_Blake-Roger_Federer,1,S-XC,20,0,0,0,0,7,13
20060907-M-US_Open-QF-James_Blake-Roger_Federer,1,S-DTM,1,0,0,0,0,1,0
20060907-M-US_Open-QF-James_Blake-Roger_Federer,1,S-DTL,2,1,0,0,1,1,1
20060907-M-US_Open-QF-James_Blake-Roger_Federer,2,F-XC,53,21,8,5,8,30,23
20060907-M-US_Open-QF-James_Blake-Roger_Federer,2,F-DTM,12,0,0,0,0,4,8
20060907-M-US_Open-QF-James_Blake-Roger_Federer,2,F-DTL,29,7,1,4,2,13,16
20060907-M-US_Open-QF-James_Blake-Roger_Federer,2,F-IO,41,16,10,1,5,24,17
20060907-M-US_Open-QF-James_Blake-Roger_Federer,2,F-II,13,5,0,5,0,9,4
20060907-M-US_Open-QF-James_Blake-Roger_Federer,2,B-XC,62,12,5,1,6,33,29
20060907-M-US_Open-QF-James_Blake-Roger_Federer,2,B-DTM,24,5,0,0,5,11,13
20060907-M-US_Open-QF-James_Blake-Roger_Federer,2,B-DTL,27,14,5,4,5,13,14
20060907-M-US_Open-QF-James_Blake-Roger_Federer,2,B-IO,1,0,0,0,0,1,0
20060907-M-US_Open-QF-James_Blake-Roger_Federer,2,S-XC,23,1,0,0,1,16,7
20060907-M-US_Open-QF-James_Blake-Roger_Federer,2,S-DTL,8,1,0,1,0,5,3
20180314-M-Indian_Wells_Masters-R16-Jeremy_Chardy-Roger_Federer,1,F-XC,19,5,1,2,2,8,11
20180314-M-Indian_Wells_Masters-R16-Jeremy_Chardy-Roger_Federer,1,F-DTM,13,0,0,0,0,4,9
20180314-M-Indian_Wells_Masters-R16-Jeremy_Chardy-Roger_Federer,1,F-DTL,7,1,0,0,1,1,6
20180314-M-Indian_Wells_Masters-R16-Jeremy_Chardy-Roger_Federer,1,F-IO,31,9,5,1,3,14,17
20180314-M-Indian_Wells_Masters-R16-Jeremy_Chardy-Roger_Federer,1,F-II,9,6,1,3,2,5,4
20180314-M-Indian_Wells_Masters-R16-Jeremy_Chardy-Roger_Federer,1,B-XC,8,2,0,0,2,2,6
20180314-M-Indian_Wells_Masters-R16-Jeremy_Chardy-Roger_Federer,1,B-DTM,5,1,0,0,1,0,5
20180314-M-Indian_Wells_Masters-R16-Jeremy_Chardy-Roger_Federer,1,B-DTL,5,1,0,1,0,3,2
20180314-M-Indian_Wells_Masters-R16-Jeremy_Chardy-Roger_Federer,1,B-IO,1,1,0,0,1,0,1
20180314-M-Indian_Wells_Masters-R16-Jeremy_Chardy-Roger_Federer,1,S-XC,13,4,0,1,3,3,10
20180314-M-Indian_Wells_Masters-R16-Jeremy_Chardy-Roger_Federer,1,S-DTM,6,2,1,0,1,1,5
20180314-M-Indian_Wells_Masters-R16-Jeremy_Chardy-Roger_Federer,1,S-DTL,7,1,0,0,1,1,6
20180314-M-Indian_Wells_Masters-R16-Jeremy_Chardy-Roger_Federer,2,F-XC,31,15,3,9,3,24,7
20180314-M-Indian_Wells_Masters-R16-Jeremy_Chardy-Roger_Federer,2,F-DTM,10,1,0,1,0,9,1
20180314-M-Indian_Wells_Masters-R16-Jeremy_Chardy-Roger_Federer,2,F-DTL,4,1,1,0,0,2,2
20180314-M-Indian_Wells_Masters-R16-Jeremy_Chardy-Roger_Federer,2,F-IO,26,6,2,4,0,21,5
20180314-M-Indian_Wells_Masters-R16-Jeremy_Chardy-Roger_Federer,2,F-II,3,0,0,0,0,3,0
20180314-M-Indian_Wells_Masters-R16-Jeremy_Chardy-Roger_Federer,2,B-XC,18,4,1,2,1,14,4
20180314-M-Indian_Wells_Masters-R16-Jeremy_Chardy-Roger_Federer,2,B-DTM,7,2,0,0,2,2,5
20180314-M-Indian_Wells_Masters-R16-Jeremy_Chardy-Roger_Federer,2,B-DTL,6,3,2,0,1,4,2
20180314-M-Indian_Wells_Masters-R16-Jeremy_Chardy-Roger_Federer,2,S-XC,7,1,0,1,0,5,2
20180314-M-Indian_Wells_Masters-R16-Jeremy_Chardy-Roger_Federer,2,S-DTM,1,0,0,0,0,0,1
20180314-M-Indian_Wells_Masters-R16-Jeremy_Chardy-Roger_Federer,2,S-DTL,1,0,0,0,0,1,0
20180315-M-Indian_Wells_Masters-QF-Roger_Federer-Hyeon_Chung,1,F-XC,42,18,4,5,9,22,20
20180315-M-Indian_Wells_Masters-QF-Roger_Federer-Hyeon_Chung,1,F-DTM,20,3,0,2,1,14,6
20180315-M-Indian_Wells_Masters-QF-Roger_Federer-Hyeon_Chung,1,F-DTL,11,2,1,1,0,8,3
20180315-M-Indian_Wells_Masters-QF-Roger_Federer-Hyeon_Chung,1,F-IO,22,8,4,1,3,10,12
20180315-M-Indian_Wells_Masters-QF-Roger_Federer-Hyeon_Chung,1,F-II,8,2,0,0,2,6,2
20180315-M-Indian_Wells_Masters-QF-Roger_Federer-Hyeon_Chung,1,B-XC,18,5,1,2,2,11,7
20180315-M-Indian_Wells_Masters-QF-Roger_Federer-Hyeon_Chung,1,B-DTM,14,0,0,0,0,5,9
20180315-M-Indian_Wells_Masters-QF-Roger_Federer-Hyeon_Chung,1,B-DTL,8,3,1,1,1,4,4
20180315-M-Indian_Wells_Masters-QF-Roger_Federer-Hyeon_Chung,1,S-XC,17,2,0,1,1,9,8
20180315-M-Indian_Wells_Masters-QF-Roger_Federer-Hyeon_Chung,1,S-DTM,4,0,0,0,0,2,2
20180315-M-Indian_Wells_Masters-QF-Roger_Federer-Hyeon_Chung,1,S-DTL,1,0,0,0,0,0,1
20180315-M-Indian_Wells_Masters-QF-Roger_Federer-Hyeon_Chung,2,F-XC,37,11,4,4,3,19,18
20180315-M-Indian_Wells_Masters-QF-Roger_Federer-Hyeon_Chung,2,F-DTM,10,2,0,1,1,4,6
20180315-M-Indian_Wells_Masters-QF-Roger_Federer-Hyeon_Chung,2,F-DTL,11,5,0,2,3,6,5
20180315-M-Indian_Wells_Masters-QF-Roger_Federer-Hyeon_Chung,2,F-IO,24,2,1,0,1,9,15
20180315-M-Indian_Wells_Masters-QF-Roger_Federer-Hyeon_Chung,2,F-II,2,1,0,0,1,0,2
20180315-M-Indian_Wells_Masters-QF-Roger_Federer-Hyeon_Chung,2,B-XC,42,10,0,5,5,21,21
20180315-M-Indian_Wells_Masters-QF-Roger_Federer-Hyeon_Chung,2,B-DTM,13,0,0,0,0,9,4
20180315-M-Indian_Wells_Masters-QF-Roger_Federer-Hyeon_Chung,2,B-DTL,5,2,0,1,1,3,2
20180315-M-Indian_Wells_Masters-QF-Roger_Federer-Hyeon_Chung,2,B-IO,1,0,0,0,0,0,1
20180315-M-Indian_Wells_Masters-QF-Roger_Federer-Hyeon_Chung,2,S-XC,5,1,0,0,1,1,4
20180315-M-Indian_Wells_Masters-QF-Roger_Federer-Hyeon_Chung,2,S-DTM,5,0,0,0,0,0,5
20180315-M-Indian_Wells_Masters-QF-Roger_Federer-Hyeon_Chung,2,S-DTL,3,0,0,0,0,2,1
20180315-M-Indian_Wells_Masters-QF-Roger_Federer-Hyeon_Chung,2,S-IO,1,0,0,0,0,0,1
20180312-M-Indian_Wells_Masters-R32-Roger_Federer-Filip_Krajinovic,1,F-XC,23,12,4,4,4,15,8
20180312-M-Indian_Wells_Masters-R32-Roger_Federer-Filip_Krajinovic,1,F-DTM,7,0,0,0,0,4,3
20180312-M-Indian_Wells_Masters-R32-Roger_Federer-Filip_Krajinovic,1,F-DTL,5,3,3,0,0,4,1
20180312-M-Indian_Wells_Masters-R32-Roger_Federer-Filip_Krajinovic,1,F-IO,9,2,0,1,1,5,4
20180312-M-Indian_Wells_Masters-R32-Roger_Federer-Filip_Krajinovic,1,F-II,3,0,0,0,0,1,2
20180312-M-Indian_Wells_Masters-R32-Roger_Federer-Filip_Krajinovic,1,B-XC,13,4,1,2,1,6,7
20180312-M-Indian_Wells_Masters-R32-Roger_Federer-Filip_Krajinovic,1,B-DTM,9,1,0,0,1,5,4
20180312-M-Indian_Wells_Masters-R32-Roger_Federer-Filip_Krajinovic,1,B-DTL,6,3,1,1,1,4,2
20180312-M-Indian_Wells_Masters-R32-Roger_Federer-Filip_Krajinovic,1,B-II,1,0,0,0,0,0,1
20180312-M-Indian_Wells_Masters-R32-Roger_Federer-Filip_Krajinovic,1,S-XC,11,1,1,0,0,6,5
20180312-M-Indian_Wells_Masters-R32-Roger_Federer-Filip_Krajinovic,1,S-DTM,1,0,0,0,0,0,1
20180312-M-Indian_Wells_Masters-R32-Roger_Federer-Filip_Krajinovic,1,S-DTL,1,0,0,0,0,0,1
20180312-M-Indian_Wells_Masters-R32-Roger_Federer-Filip_Krajinovic,2,F-XC,19,5,0,1,4,7,12
20180312-M-Indian_Wells_Masters-R32-Roger_Federer-Filip_Krajinovic,2,F-DTM,7,0,0,0,0,2,5
20180312-M-Indian_Wells_Masters-R32-Roger_Federer-Filip_Krajinovic,2,F-DTL,8,1,0,1,0,6,2
20180312-M-Indian_Wells_Masters-R32-Roger_Federer-Filip_Krajinovic,2,F-IO,13,4,2,2,0,6,7
20180312-M-Indian_Wells_Masters-R32-Roger_Federer-Filip_Krajinovic,2,F-II,3,0,0,0,0,1,2
20180312-M-Indian_Wells_Masters-R32-Roger_Federer-Filip_Krajinovic,2,B-XC,26,7,1,2,4,15,11
20180312-M-Indian_Wells_Masters-R32-Roger_Federer-Filip_Krajinovic,2,B-DTM,5,1,0,0,1,1,4
20180312-M-Indian_Wells_Masters-R32-Roger_Federer-Filip_Krajinovic,2,B-DTL,12,6,0,3,3,5,7
20180312-M-Indian_Wells_Masters-R32-Roger_Federer-Filip_Krajinovic,2,S-XC,2,0,0,0,0,0,2
20180312-M-Indian_Wells_Masters-R32-Roger_Federer-Filip_Krajinovic,2,S-DTM,2,0,0,0,0,1,1
20180312-M-Indian_Wells_Masters-R32-Roger_Federer-Filip_Krajinovic,2,S-DTL,1,1,0,1,0,1,0
20190315-M-Indian_Wells_Masters-QF-Hubert_Hurkacz-Roger_Federer,1,F-XC,22,5,1,2,2,9,13
20190315-M-Indian_Wells_Masters-QF-Hubert_Hurkacz-Roger_Federer,1,F-DTM,24,4,0,1,3,8,16
20190315-M-Indian_Wells_Masters-QF-Hubert_Hurkacz-Roger_Federer,1,F-DTL,8,4,0,0,4,1,7
20190315-M-Indian_Wells_Masters-QF-Hubert_Hurkacz-Roger_Federer,1,F-IO,20,5,1,0,4,8,12
20190315-M-Indian_Wells_Masters-QF-Hubert_Hurkacz-Roger_Federer,1,F-II,2,2,0,1,1,1,1
20190315-M-Indian_Wells_Masters-QF-Hubert_Hurkacz-Roger_Federer,1,B-XC,15,2,0,0,2,7,8
20190315-M-Indian_Wells_Masters-QF-Hubert_Hurkacz-Roger_Federer,1,B-DTM,11,2,0,1,1,2,9
20190315-M-Indian_Wells_Masters-QF-Hubert_Hurkacz-Roger_Federer,1,B-DTL,2,0,0,0,0,2,0
20190315-M-Indian_Wells_Masters-QF-Hubert_Hurkacz-Roger_Federer,1,B-IO,2,0,0,0,0,1,1
20190315-M-Indian_Wells_Masters-QF-Hubert_Hurkacz-Roger_Federer,1,S-XC,5,0,0,0,0,0,5
20190315-M-Indian_Wells_Masters-QF-Hubert_Hurkacz-Roger_Federer,1,S-DTM,4,0,0,0,0,0,4
20190315-M-Indian_Wells_Masters-QF-Hubert_Hurkacz-Roger_Federer,1,S-DTL,2,1,0,1,0,1,1
20190315-M-Indian_Wells_Masters-QF-Hubert_Hurkacz-Roger_Federer,2,F-XC,35,12,3,3,6,24,11
20190315-M-Indian_Wells_Masters-QF-Hubert_Hurkacz-Roger_Federer,2,F-DTM,29,5,1,0,4,20,9
20190315-M-Indian_Wells_Masters-QF-Hubert_Hurkacz-Roger_Federer,2,F-DTL,6,1,0,0,1,3,3
20190315-M-Indian_Wells_Masters-QF-Hubert_Hurkacz-Roger_Federer,2,F-IO,7,5,4,0,1,4,3
20190315-M-Indian_Wells_Masters-QF-Hubert_Hurkacz-Roger_Federer,2,F-II,4,3,1,2,0,4,0
20190315-M-Indian_Wells_Masters-QF-Hubert_Hurkacz-Roger_Federer,2,B-XC,16,3,0,1,2,11,5
20190315-M-Indian_Wells_Masters-QF-Hubert_Hurkacz-Roger_Federer,2,B-DTM,12,3,0,0,3,7,5
20190315-M-Indian_Wells_Masters-QF-Hubert_Hurkacz-Roger_Federer,2,B-DTL,2,1,1,0,0,1,1
20190315-M-Indian_Wells_Masters-QF-Hubert_Hurkacz-Roger_Federer,2,B-IO,1,1,0,1,0,1,0
20190315-M-Indian_Wells_Masters-QF-Hubert_Hurkacz-Roger_Federer,2,S-XC,12,0,0,0,0,7,5
20190315-M-Indian_Wells_Masters-QF-Hubert_Hurkacz-Roger_Federer,2,S-DTM,3,0,0,0,0,1,2
20190315-M-Indian_Wells_Masters-QF-Hubert_Hurkacz-Roger_Federer,2,S-DTL,1,0,0,0,0,0,1
20000128-M-Australian_Open-SF-Yevgeny_Kafelnikov-Magnus_Norman,1,F-XC,40,11,3,4,4,27,13
20000128-M-Australian_Open-SF-Yevgeny_Kafelnikov-Magnus_Norman,1,F-DTM,26,2,0,2,0,15,11
20000128-M-Australian_Open-SF-Yevgeny_Kafelnikov-Magnus_Norman,1,F-DTL,8,3,3,0,0,6,2
20000128-M-Australian_Open-SF-Yevgeny_Kafelnikov-Magnus_Norman,1,F-IO,30,6,3,2,1,22,8
20000128-M-Australian_Open-SF-Yevgeny_Kafelnikov-Magnus_Norman,1,F-II,3,0,0,0,0,3,0
20000128-M-Australian_Open-SF-Yevgeny_Kafelnikov-Magnus_Norman,1,B-XC,56,0,0,0,0,35,21
20000128-M-Australian_Open-SF-Yevgeny_Kafelnikov-Magnus_Norman,1,B-DTM,19,3,0,0,3,11,8
20000128-M-Australian_Open-SF-Yevgeny_Kafelnikov-Magnus_Norman,1,B-DTL,10,3,2,0,1,6,4
20000128-M-Australian_Open-SF-Yevgeny_Kafelnikov-Magnus_Norman,1,B-IO,2,2,0,1,1,1,1
20000128-M-Australian_Open-SF-Yevgeny_Kafelnikov-Magnus_Norman,1,S-XC,13,1,0,0,1,9,4
20000128-M-Australian_Open-SF-Yevgeny_Kafelnikov-Magnus_Norman,1,S-DTM,3,0,0,0,0,2,1
20000128-M-Australian_Open-SF-Yevgeny_Kafelnikov-Magnus_Norman,2,F-XC,42,11,2,2,7,16,26
20000128-M-Australian_Open-SF-Yevgeny_Kafelnikov-Magnus_Norman,2,F-DTM,26,3,0,0,3,9,17
20000128-M-Australian_Open-SF-Yevgeny_Kafelnikov-Magnus_Norman,2,F-DTL,13,7,1,2,4,4,9
20000128-M-Australian_Open-SF-Yevgeny_Kafelnikov-Magnus_Norman,2,F-IO,37,5,2,0,3,13,24
20000128-M-Australian_Open-SF-Yevgeny_Kafelnikov-Magnus_Norman,2,F-II,9,3,2,1,0,6,3
20000128-M-Australian_Open-SF-Yevgeny_Kafelnikov-Magnus_Norman,2,B-XC,51,8,2,1,5,16,35
20000128-M-Australian_Open-SF-Yevgeny_Kafelnikov-Magnus_Norman,2,B-DTM,19,1,0,0,1,8,11
20000128-M-Australian_Open-SF-Yevgeny_Kafelnikov-Magnus_Norman,2,B-DTL,14,12,1,2,9,3,11
20000128-M-Australian_Open-SF-Yevgeny_Kafelnikov-Magnus_Norman,2,B-IO,3,3,1,1,1,2,1
20000128-M-Australian_Open-SF-Yevgeny_Kafelnikov-Magnus_Norman,2,S-XC,5,0,0,0,0,1,4
20000128-M-Australian_Open-SF-Yevgeny_Kafelnikov-Magnus_Norman,2,S-DTM,2,0,0,0,0,1,1
20000128-M-Australian_Open-SF-Yevgeny_Kafelnikov-Magnus_Norman,2,S-DTL,4,3,2,0,1,2,2
20190310-M-Indian_Wells_Masters-R64-Alex_Bolt-Guido_Pella,1,F-XC,76,15,6,4,5,43,33
20190310-M-Indian_Wells_Masters-R64-Alex_Bolt-Guido_Pella,1,F-DTM,25,2,1,0,1,9,16
20190310-M-Indian_Wells_Masters-R64-Alex_Bolt-Guido_Pella,1,F-DTL,14,6,1,0,5,7,7
20190310-M-Indian_Wells_Masters-R64-Alex_Bolt-Guido_Pella,1,F-IO,39,17,6,3,8,22,17
20190310-M-Indian_Wells_Masters-R64-Alex_Bolt-Guido_Pella,1,F-II,13,5,3,0,2,9,4
20190310-M-Indian_Wells_Masters-R64-Alex_Bolt-Guido_Pella,1,B-XC,17,4,0,1,3,5,12
20190310-M-Indian_Wells_Masters-R64-Alex_Bolt-Guido_Pella,1,B-DTM,14,2,0,0,2,3,11
20190310-M-Indian_Wells_Masters-R64-Alex_Bolt-Guido_Pella,1,B-DTL,5,3,0,0,3,0,5
20190310-M-Indian_Wells_Masters-R64-Alex_Bolt-Guido_Pella,1,B-IO,2,0,0,0,0,1,1
20190310-M-Indian_Wells_Masters-R64-Alex_Bolt-Guido_Pella,1,S-XC,25,6,1,0,5,11,14
20190310-M-Indian_Wells_Masters-R64-Alex_Bolt-Guido_Pella,1,S-DTM,9,0,0,0,0,4,5
20190310-M-Indian_Wells_Masters-R64-Alex_Bolt-Guido_Pella,1,S-DTL,13,0,0,0,0,3,10
20190310-M-Indian_Wells_Masters-R64-Alex_Bolt-Guido_Pella,1,S-IO,1,0,0,0,0,1,0
20190310-M-Indian_Wells_Masters-R64-Alex_Bolt-Guido_Pella,2,F-XC,74,21,7,8,6,43,31
20190310-M-Indian_Wells_Masters-R64-Alex_Bolt-Guido_Pella,2,F-DTM,25,2,0,0,2,7,18
20190310-M-Indian_Wells_Masters-R64-Alex_Bolt-Guido_Pella,2,F-DTL,24,3,0,2,1,19,5
20190310-M-Indian_Wells_Masters-R64-Alex_Bolt-Guido_Pella,2,F-IO,28,4,0,0,4,18,10
20190310-M-Indian_Wells_Masters-R64-Alex_Bolt-Guido_Pella,2,F-II,4,0,0,0,0,0,4
20190310-M-Indian_Wells_Masters-R64-Alex_Bolt-Guido_Pella,2,B-XC,34,5,1,0,4,21,13
20190310-M-Indian_Wells_Masters-R64-Alex_Bolt-Guido_Pella,2,B-DTM,15,1,0,0,1,5,10
20190310-M-Indian_Wells_Masters-R64-Alex_Bolt-Guido_Pella,2,B-DTL,3,1,0,1,0,3,0
20190310-M-Indian_Wells_Masters-R64-Alex_Bolt-Guido_Pella,2,B-IO,2,0,0,0,0,1,1
20190310-M-Indian_Wells_Masters-R64-Alex_Bolt-Guido_Pella,2,B-II,1,0,0,0,0,1,0
20190310-M-Indian_Wells_Masters-R64-Alex_Bolt-Guido_Pella,2,S-XC,9,0,0,0,0,2,7
20190310-M-Indian_Wells_Masters-R64-Alex_Bolt-Guido_Pella,2,S-DTM,5,1,0,0,1,3,2
20190310-M-Indian_Wells_Masters-R64-Alex_Bolt-Guido_Pella,2,S-DTL,5,2,0,1,1,1,4
20190310-M-Indian_Wells_Masters-R64-Alex_Bolt-Guido_Pella,2,S-IO,1,0,0,0,0,0,1
20190317-M-Indian_Wells_Masters-F-Roger_Federer-Dominic_Thiem,1,F-XC,32,9,2,3,4,18,14
20190317-M-Indian_Wells_Masters-F-Roger_Federer-Dominic_Thiem,1,F-DTM,39,4,0,0,4,11,28
20190317-M-Indian_Wells_Masters-F-Roger_Federer-Dominic_Thiem,1,F-DTL,7,3,1,0,2,4,3
20190317-M-Indian_Wells_Masters-F-Roger_Federer-Dominic_Thiem,1,F-IO,24,4,1,0,3,11,13
20190317-M-Indian_Wells_Masters-F-Roger_Federer-Dominic_Thiem,1,F-II,5,0,0,0,0,3,2
20190317-M-Indian_Wells_Masters-F-Roger_Federer-Dominic_Thiem,1,B-XC,40,7,1,2,4,21,19
20190317-M-Indian_Wells_Masters-F-Roger_Federer-Dominic_Thiem,1,B-DTM,41,7,0,2,5,14,27
20190317-M-Indian_Wells_Masters-F-Roger_Federer-Dominic_Thiem,1,B-DTL,8,5,0,1,4,3,5
20190317-M-Indian_Wells_Masters-F-Roger_Federer-Dominic_Thiem,1,B-IO,1,0,0,0,0,1,0
20190317-M-Indian_Wells_Masters-F-Roger_Federer-Dominic_Thiem,1,S-XC,15,1,0,0,1,5,10
20190317-M-Indian_Wells_Masters-F-Roger_Federer-Dominic_Thiem,1,S-DTM,4,1,0,0,1,0,4
20190317-M-Indian_Wells_Masters-F-Roger_Federer-Dominic_Thiem,1,S-DTL,1,1,0,0,1,0,1
20190317-M-Indian_Wells_Masters-F-Roger_Federer-Dominic_Thiem,2,F-XC,37,11,4,3,4,22,15
20190317-M-Indian_Wells_Masters-F-Roger_Federer-Dominic_Thiem,2,F-DTM,36,2,0,1,1,20,16
20190317-M-Indian_Wells_Masters-F-Roger_Federer-Dominic_Thiem,2,F-DTL,7,4,1,0,3,3,4
20190317-M-Indian_Wells_Masters-F-Roger_Federer-Dominic_Thiem,2,F-IO,60,16,8,4,3,43,17
20190317-M-Indian_Wells_Masters-F-Roger_Federer-Dominic_Thiem,2,F-II,6,1,0,0,1,4,2
20190317-M-Indian_Wells_Masters-F-Roger_Federer-Dominic_Thiem,2,B-XC,26,5,0,2,3,14,12
20190317-M-Indian_Wells_Masters-F-Roger_Federer-Dominic_Thiem,2,B-DTM,31,6,0,1,5,10,21
20190317-M-Indian_Wells_Masters-F-Roger_Federer-Dominic_Thiem,2,B-DTL,8,5,2,1,2,6,2
20190317-M-Indian_Wells_Masters-F-Roger_Federer-Dominic_Thiem,2,B-IO,1,1,1,0,0,1,0
20190317-M-Indian_Wells_Masters-F-Roger_Federer-Dominic_Thiem,2,S-XC,14,2,0,0,2,7,7
20190317-M-Indian_Wells_Masters-F-Roger_Federer-Dominic_Thiem,2,S-DTM,6,0,0,0,0,4,2
19850907-M-US_Open-SF-Mats_Wilander-John_Mcenroe,1,F-XC,57,4,0,2,2,36,21
19850907-M-US_Open-SF-Mats_Wilander-John_Mcenroe,1,F-DTM,18,1,0,0,1,8,10
19850907-M-US_Open-SF-Mats_Wilander-John_Mcenroe,1,F-DTL,18,10,5,0,5,6,12
19850907-M-US_Open-SF-Mats_Wilander-John_Mcenroe,1,F-IO,10,2,2,0,0,4,6
19850907-M-US_Open-SF-Mats_Wilander-John_Mcenroe,1,F-II,1,0,0,0,0,1,0
19850907-M-US_Open-SF-Mats_Wilander-John_Mcenroe,1,B-XC,29,14,7,4,3,17,12
19850907-M-US_Open-SF-Mats_Wilander-John_Mcenroe,1,B-DTM,17,3,0,3,0,9,8
19850907-M-US_Open-SF-Mats_Wilander-John_Mcenroe,1,B-DTL,27,9,4,3,1,16,11
19850907-M-US_Open-SF-Mats_Wilander-John_Mcenroe,1,B-IO,20,7,0,4,3,11,9
19850907-M-US_Open-SF-Mats_Wilander-John_Mcenroe,1,S-XC,7,0,0,0,0,2,5
19850907-M-US_Open-SF-Mats_Wilander-John_Mcenroe,1,S-DTM,5,0,0,0,0,5,0
19850907-M-US_Open-SF-Mats_Wilander-John_Mcenroe,1,S-DTL,10,0,0,0,0,3,7
19850907-M-US_Open-SF-Mats_Wilander-John_Mcenroe,1,S-IO,3,0,0,0,0,2,1
19850907-M-US_Open-SF-Mats_Wilander-John_Mcenroe,2,F-XC,24,6,2,2,2,14,10
19850907-M-US_Open-SF-Mats_Wilander-John_Mcenroe,2,F-DTM,7,0,0,0,0,4,3
19850907-M-US_Open-SF-Mats_Wilander-John_Mcenroe,2,F-DTL,7,3,2,1,0,4,3
19850907-M-US_Open-SF-Mats_Wilander-John_Mcenroe,2,F-IO,7,3,1,2,0,3,4
19850907-M-US_Open-SF-Mats_Wilander-John_Mcenroe,2,F-II,3,0,0,0,0,2,1
19850907-M-US_Open-SF-Mats_Wilander-John_Mcenroe,2,B-XC,37,15,3,4,8,17,20
19850907-M-US_Open-SF-Mats_Wilander-John_Mcenroe,2,B-DTM,17,2,0,0,2,4,13
19850907-M-US_Open-SF-Mats_Wilander-John_Mcenroe,2,B-DTL,20,7,1,3,3,7,13
19850907-M-US_Open-SF-Mats_Wilander-John_Mcenroe,2,B-IO,4,2,0,0,2,1,3
19850907-M-US_Open-SF-Mats_Wilander-John_Mcenroe,2,S-XC,19,3,0,1,2,9,10
19850907-M-US_Open-SF-Mats_Wilander-John_Mcenroe,2,S-DTM,8,0,0,0,0,4,4
19850907-M-US_Open-SF-Mats_Wilander-John_Mcenroe,2,S-DTL,10,0,0,0,0,1,9
19850907-M-US_Open-SF-Mats_Wilander-John_Mcenroe,2,S-IO,3,0,0,0,0,1,2
19990904-M-US_Open-SF-Yevgeny_Kafelnikov-Andre_Agassi,1,F-XC,44,9,6,2,1,23,21
19990904-M-US_Open-SF-Yevgeny_Kafelnikov-Andre_Agassi,1,F-DTM,22,1,0,0,1,7,15
19990904-M-US_Open-SF-Yevgeny_Kafelnikov-Andre_Agassi,1,F-DTL,15,5,1,2,2,6,9
19990904-M-US_Open-SF-Yevgeny_Kafelnikov-Andre_Agassi,1,F-IO,22,6,1,4,1,11,11
19990904-M-US_Open-SF-Yevgeny_Kafelnikov-Andre_Agassi,1,F-II,2,1,0,0,1,0,2
19990904-M-US_Open-SF-Yevgeny_Kafelnikov-Andre_Agassi,1,B-XC,107,9,1,2,6,43,64
19990904-M-US_Open-SF-Yevgeny_Kafelnikov-Andre_Agassi,1,B-DTM,29,2,0,0,2,12,17
19990904-M-US_Open-SF-Yevgeny_Kafelnikov-Andre_Agassi,1,B-DTL,19,11,4,2,5,10,9
19990904-M-US_Open-SF-Yevgeny_Kafelnikov-Andre_Agassi,1,B-IO,4,2,0,0,2,1,3
19990904-M-US_Open-SF-Yevgeny_Kafelnikov-Andre_Agassi,1,S-XC,13,2,0,1,1,4,9
19990904-M-US_Open-SF-Yevgeny_Kafelnikov-Andre_Agassi,1,S-DTM,2,0,0,0,0,1,1
19990904-M-US_Open-SF-Yevgeny_Kafelnikov-Andre_Agassi,1,S-DTL,2,1,0,0,1,0,2
19990904-M-US_Open-SF-Yevgeny_Kafelnikov-Andre_Agassi,2,F-XC,50,11,2,4,5,26,24
19990904-M-US_Open-SF-Yevgeny_Kafelnikov-Andre_Agassi,2,F-DTM,21,3,0,0,3,9,12
19990904-M-US_Open-SF-Yevgeny_Kafelnikov-Andre_Agassi,2,F-DTL,16,7,3,2,2,11,5
19990904-M-US_Open-SF-Yevgeny_Kafelnikov-Andre_Agassi,2,F-IO,28,10,3,6,1,22,6
19990904-M-US_Open-SF-Yevgeny_Kafelnikov-Andre_Agassi,2,F-II,11,2,1,1,0,8,3
19990904-M-US_Open-SF-Yevgeny_Kafelnikov-Andre_Agassi,2,B-XC,107,15,2,5,8,63,44
19990904-M-US_Open-SF-Yevgeny_Kafelnikov-Andre_Agassi,2,B-DTM,22,2,0,1,1,13,9
19990904-M-US_Open-SF-Yevgeny_Kafelnikov-Andre_Agassi,2,B-DTL,15,8,4,1,3,11,4
19990904-M-US_Open-SF-Yevgeny_Kafelnikov-Andre_Agassi,2,B-IO,3,2,0,1,1,1,2
19990904-M-US_Open-SF-Yevgeny_Kafelnikov-Andre_Agassi,2,S-XC,14,1,0,0,1,6,8
19990904-M-US_Open-SF-Yevgeny_Kafelnikov-Andre_Agassi,2,S-DTL,1,0,0,0,0,0,1
19990904-M-US_Open-SF-Todd_Martin-Cedric_Pioline,1,F-XC,12,6,2,2,2,8,4
19990904-M-US_Open-SF-Todd_Martin-Cedric_Pioline,1,F-DTM,19,4,0,3,1,10,9
19990904-M-US_Open-SF-Todd_Martin-Cedric_Pioline,1,F-DTL,5,2,0,0,2,2,3
19990904-M-US_Open-SF-Todd_Martin-Cedric_Pioline,1,F-IO,11,4,1,2,1,7,4
19990904-M-US_Open-SF-Todd_Martin-Cedric_Pioline,1,F-II,2,0,0,0,0,1,1
19990904-M-US_Open-SF-Todd_Martin-Cedric_Pioline,1,B-XC,10,5,1,1,3,4,6
19990904-M-US_Open-SF-Todd_Martin-Cedric_Pioline,1,B-DTM,4,0,0,0,0,2,2
19990904-M-US_Open-SF-Todd_Martin-Cedric_Pioline,1,B-DTL,3,2,1,0,1,1,2
19990904-M-US_Open-SF-Todd_Martin-Cedric_Pioline,1,S-XC,14,3,0,2,1,9,5
19990904-M-US_Open-SF-Todd_Martin-Cedric_Pioline,1,S-DTM,2,0,0,0,0,0,2
19990904-M-US_Open-SF-Todd_Martin-Cedric_Pioline,2,F-XC,13,4,1,0,3,6,7
19990904-M-US_Open-SF-Todd_Martin-Cedric_Pioline,2,F-DTM,11,2,2,0,0,7,4
19990904-M-US_Open-SF-Todd_Martin-Cedric_Pioline,2,F-DTL,5,3,1,0,2,2,3
19990904-M-US_Open-SF-Todd_Martin-Cedric_Pioline,2,F-IO,16,10,3,1,6,7,9
19990904-M-US_Open-SF-Todd_Martin-Cedric_Pioline,2,F-II,1,0,0,0,0,0,1
19990904-M-US_Open-SF-Todd_Martin-Cedric_Pioline,2,B-XC,16,6,0,0,6,5,11
19990904-M-US_Open-SF-Todd_Martin-Cedric_Pioline,2,B-DTM,12,3,0,0,3,3,9
19990904-M-US_Open-SF-Todd_Martin-Cedric_Pioline,2,B-DTL,3,3,1,0,2,1,2
19990904-M-US_Open-SF-Todd_Martin-Cedric_Pioline,2,S-XC,14,4,0,1,3,5,9
19990904-M-US_Open-SF-Todd_Martin-Cedric_Pioline,2,S-DTM,5,0,0,0,0,2,3
19990904-M-US_Open-SF-Todd_Martin-Cedric_Pioline,2,S-DTL,6,3,3,0,0,4,2
19990904-M-US_Open-SF-Todd_Martin-Cedric_Pioline,2,S-IO,1,0,0,0,0,0,1
20190309-M-Indian_Wells_Masters-R64-Marco_Cecchinato-Albert_Ramos,1,F-XC,31,8,2,1,5,9,22
20190309-M-Indian_Wells_Masters-R64-Marco_Cecchinato-Albert_Ramos,1,F-DTM,12,1,0,0,1,6,6
20190309-M-Indian_Wells_Masters-R64-Marco_Cecchinato-Albert_Ramos,1,F-DTL,8,6,1,1,4,2,6
20190309-M-Indian_Wells_Masters-R64-Marco_Cecchinato-Albert_Ramos,1,F-IO,11,6,4,1,1,8,3
20190309-M-Indian_Wells_Masters-R64-Marco_Cecchinato-Albert_Ramos,1,F-II,4,1,1,0,0,2,2
20190309-M-Indian_Wells_Masters-R64-Marco_Cecchinato-Albert_Ramos,1,B-XC,22,4,1,0,3,10,12
20190309-M-Indian_Wells_Masters-R64-Marco_Cecchinato-Albert_Ramos,1,B-DTM,16,1,0,0,1,1,15
20190309-M-Indian_Wells_Masters-R64-Marco_Cecchinato-Albert_Ramos,1,B-DTL,11,4,2,0,2,4,7
20190309-M-Indian_Wells_Masters-R64-Marco_Cecchinato-Albert_Ramos,1,B-IO,1,0,0,0,0,1,0
20190309-M-Indian_Wells_Masters-R64-Marco_Cecchinato-Albert_Ramos,1,S-XC,1,0,0,0,0,0,1
20190309-M-Indian_Wells_Masters-R64-Marco_Cecchinato-Albert_Ramos,1,S-DTM,3,0,0,0,0,0,3
20190309-M-Indian_Wells_Masters-R64-Marco_Cecchinato-Albert_Ramos,1,S-DTL,4,1,0,0,1,1,3
20190309-M-Indian_Wells_Masters-R64-Marco_Cecchinato-Albert_Ramos,1,S-IO,2,2,0,0,2,0,2
20190309-M-Indian_Wells_Masters-R64-Marco_Cecchinato-Albert_Ramos,2,F-XC,51,7,3,1,3,33,18
20190309-M-Indian_Wells_Masters-R64-Marco_Cecchinato-Albert_Ramos,2,F-DTM,12,0,0,0,0,9,3
20190309-M-Indian_Wells_Masters-R64-Marco_Cecchinato-Albert_Ramos,2,F-DTL,4,0,0,0,0,4,0
20190309-M-Indian_Wells_Masters-R64-Marco_Cecchinato-Albert_Ramos,2,F-IO,9,3,2,0,1,6,3
20190309-M-Indian_Wells_Masters-R64-Marco_Cecchinato-Albert_Ramos,2,F-II,4,1,0,1,0,3,1
20190309-M-Indian_Wells_Masters-R64-Marco_Cecchinato-Albert_Ramos,2,B-XC,21,5,1,4,0,17,4
20190309-M-Indian_Wells_Masters-R64-Marco_Cecchinato-Albert_Ramos,2,B-DTM,16,1,0,0,1,9,7
20190309-M-Indian_Wells_Masters-R64-Marco_Cecchinato-Albert_Ramos,2,B-DTL,3,0,0,0,0,1,2
20190309-M-Indian_Wells_Masters-R64-Marco_Cecchinato-Albert_Ramos,2,B-IO,3,0,0,0,0,2,1
20190309-M-Indian_Wells_Masters-R64-Marco_Cecchinato-Albert_Ramos,2,S-XC,5,1,0,1,0,3,2
20190309-M-Indian_Wells_Masters-R64-Marco_Cecchinato-Albert_Ramos,2,S-DTM,3,0,0,0,0,0,3
20190309-M-Indian_Wells_Masters-R64-Marco_Cecchinato-Albert_Ramos,2,S-DTL,4,0,0,0,0,2,2
20190316-M-Indian_Wells_Masters-SF-Milos_Raonic-Dominic_Thiem,1,F-XC,21,10,5,2,3,10,11
20190316-M-Indian_Wells_Masters-SF-Milos_Raonic-Dominic_Thiem,1,F-DTM,11,1,0,0,1,1,10
20190316-M-Indian_Wells_Masters-SF-Milos_Raonic-Dominic_Thiem,1,F-DTL,10,6,0,1,5,2,8
20190316-M-Indian_Wells_Masters-SF-Milos_Raonic-Dominic_Thiem,1,F-IO,24,12,2,2,8,10,14
20190316-M-Indian_Wells_Masters-SF-Milos_Raonic-Dominic_Thiem,1,F-II,7,3,0,1,2,2,5
20190316-M-Indian_Wells_Masters-SF-Milos_Raonic-Dominic_Thiem,1,B-XC,11,1,0,0,1,1,10
20190316-M-Indian_Wells_Masters-SF-Milos_Raonic-Dominic_Thiem,1,B-DTM,13,2,1,0,1,3,10
20190316-M-Indian_Wells_Masters-SF-Milos_Raonic-Dominic_Thiem,1,B-DTL,4,1,1,0,0,2,2
20190316-M-Indian_Wells_Masters-SF-Milos_Raonic-Dominic_Thiem,1,S-XC,11,1,0,1,0,4,7
20190316-M-Indian_Wells_Masters-SF-Milos_Raonic-Dominic_Thiem,1,S-DTM,3,0,0,0,0,0,3
20190316-M-Indian_Wells_Masters-SF-Milos_Raonic-Dominic_Thiem,1,S-DTL,2,1,0,0,1,0,2
20190316-M-Indian_Wells_Masters-SF-Milos_Raonic-Dominic_Thiem,1,S-IO,2,1,0,1,0,2,0
20190316-M-Indian_Wells_Masters-SF-Milos_Raonic-Dominic_Thiem,2,F-XC,31,13,5,6,2,26,5
20190316-M-Indian_Wells_Masters-SF-Milos_Raonic-Dominic_Thiem,2,F-DTM,16,0,0,0,0,10,6
20190316-M-Indian_Wells_Masters-SF-Milos_Raonic-Dominic_Thiem,2,F-DTL,9,4,1,2,1,8,1
20190316-M-Indian_Wells_Masters-SF-Milos_Raonic-Dominic_Thiem,2,F-IO,28,4,0,3,1,24,4
20190316-M-Indian_Wells_Masters-SF-Milos_Raonic-Dominic_Thiem,2,F-II,2,1,1,0,0,1,1
20190316-M-Indian_Wells_Masters-SF-Milos_Raonic-Dominic_Thiem,2,B-XC,15,3,0,1,2,9,6
20190316-M-Indian_Wells_Masters-SF-Milos_Raonic-Dominic_Thiem,2,B-DTM,14,1,0,1,0,8,6
20190316-M-Indian_Wells_Masters-SF-Milos_Raonic-Dominic_Thiem,2,B-DTL,6,4,3,0,1,4,2
20190316-M-Indian_Wells_Masters-SF-Milos_Raonic-Dominic_Thiem,2,B-IO,1,1,1,0,0,1,0
20190316-M-Indian_Wells_Masters-SF-Milos_Raonic-Dominic_Thiem,2,S-XC,13,0,0,0,0,8,5
20190316-M-Indian_Wells_Masters-SF-Milos_Raonic-Dominic_Thiem,2,S-DTM,3,0,0,0,0,1,2
20190316-M-Indian_Wells_Masters-SF-Milos_Raonic-Dominic_Thiem,2,S-DTL,3,0,0,0,0,0,3
19990604-M-Roland_Garros-SF-Dominik_Hrbaty-Andre_Agassi,1,F-XC,71,17,4,4,9,38,33
19990604-M-Roland_Garros-SF-Dominik_Hrbaty-Andre_Agassi,1,F-DTM,29,4,0,0,4,12,17
19990604-M-Roland_Garros-SF-Dominik_Hrbaty-Andre_Agassi,1,F-DTL,17,7,5,1,1,12,5
19990604-M-Roland_Garros-SF-Dominik_Hrbaty-Andre_Agassi,1,F-IO,19,4,1,1,2,14,5
19990604-M-Roland_Garros-SF-Dominik_Hrbaty-Andre_Agassi,1,F-II,3,2,2,0,0,3,0
19990604-M-Roland_Garros-SF-Dominik_Hrbaty-Andre_Agassi,1,B-XC,98,17,3,5,9,57,41
19990604-M-Roland_Garros-SF-Dominik_Hrbaty-Andre_Agassi,1,B-DTM,25,3,0,0,3,9,16
19990604-M-Roland_Garros-SF-Dominik_Hrbaty-Andre_Agassi,1,B-DTL,28,15,5,5,5,18,10
19990604-M-Roland_Garros-SF-Dominik_Hrbaty-Andre_Agassi,1,B-IO,5,3,1,2,0,4,1
19990604-M-Roland_Garros-SF-Dominik_Hrbaty-Andre_Agassi,1,S-XC,3,0,0,0,0,2,1
19990604-M-Roland_Garros-SF-Dominik_Hrbaty-Andre_Agassi,1,S-DTM,1,0,0,0,0,1,0
19990604-M-Roland_Garros-SF-Dominik_Hrbaty-Andre_Agassi,1,S-DTL,2,0,0,0,0,0,2
19990604-M-Roland_Garros-SF-Dominik_Hrbaty-Andre_Agassi,2,F-XC,67,15,1,5,9,30,37
19990604-M-Roland_Garros-SF-Dominik_Hrbaty-Andre_Agassi,2,F-DTM,30,1,0,0,1,12,18
19990604-M-Roland_Garros-SF-Dominik_Hrbaty-Andre_Agassi,2,F-DTL,14,4,0,3,1,7,7
19990604-M-Roland_Garros-SF-Dominik_Hrbaty-Andre_Agassi,2,F-IO,21,11,6,4,1,16,5
19990604-M-Roland_Garros-SF-Dominik_Hrbaty-Andre_Agassi,2,F-II,3,0,0,0,0,0,3
19990604-M-Roland_Garros-SF-Dominik_Hrbaty-Andre_Agassi,2,B-XC,99,20,2,9,9,48,51
19990604-M-Roland_Garros-SF-Dominik_Hrbaty-Andre_Agassi,2,B-DTM,25,5,0,0,5,11,14
19990604-M-Roland_Garros-SF-Dominik_Hrbaty-Andre_Agassi,2,B-DTL,16,9,2,3,4,7,9
19990604-M-Roland_Garros-SF-Dominik_Hrbaty-Andre_Agassi,2,B-IO,9,4,3,0,1,7,2
19990604-M-Roland_Garros-SF-Dominik_Hrbaty-Andre_Agassi,2,S-XC,12,1,1,0,0,2,10
19990604-M-Roland_Garros-SF-Dominik_Hrbaty-Andre_Agassi,2,S-DTM,4,0,0,0,0,1,3
19990604-M-Roland_Garros-SF-Dominik_Hrbaty-Andre_Agassi,2,S-DTL,1,0,0,0,0,0,1
20010604-M-Roland_Garros-R16-Wayne_Arthurs-Roger_Federer,1,F-XC,6,0,0,0,0,4,2
20010604-M-Roland_Garros-R16-Wayne_Arthurs-Roger_Federer,1,F-DTM,19,2,0,0,2,4,15
20010604-M-Roland_Garros-R16-Wayne_Arthurs-Roger_Federer,1,F-DTL,2,1,0,1,0,1,1
20010604-M-Roland_Garros-R16-Wayne_Arthurs-Roger_Federer,1,F-IO,1,1,1,0,0,1,0
20010604-M-Roland_Garros-R16-Wayne_Arthurs-Roger_Federer,1,B-XC,6,2,0,0,2,1,5
20010604-M-Roland_Garros-R16-Wayne_Arthurs-Roger_Federer,1,B-DTM,12,1,0,0,1,3,9
20010604-M-Roland_Garros-R16-Wayne_Arthurs-Roger_Federer,1,B-DTL,3,2,1,0,1,2,1
20010604-M-Roland_Garros-R16-Wayne_Arthurs-Roger_Federer,1,B-IO,3,1,0,0,1,0,3
20010604-M-Roland_Garros-R16-Wayne_Arthurs-Roger_Federer,1,B-II,1,1,0,0,1,0,1
20010604-M-Roland_Garros-R16-Wayne_Arthurs-Roger_Federer,1,S-XC,7,1,0,0,1,1,6
20010604-M-Roland_Garros-R16-Wayne_Arthurs-Roger_Federer,1,S-DTM,5,0,0,0,0,2,3
20010604-M-Roland_Garros-R16-Wayne_Arthurs-Roger_Federer,1,S-DTL,1,1,1,0,0,1,0
20010604-M-Roland_Garros-R16-Wayne_Arthurs-Roger_Federer,1,S-IO,4,1,0,0,1,1,3
20010604-M-Roland_Garros-R16-Wayne_Arthurs-Roger_Federer,1,S-II,1,0,0,0,0,0,1
20010604-M-Roland_Garros-R16-Wayne_Arthurs-Roger_Federer,2,F-XC,29,8,1,3,4,20,9
20010604-M-Roland_Garros-R16-Wayne_Arthurs-Roger_Federer,2,F-DTM,12,3,0,2,1,10,2
20010604-M-Roland_Garros-R16-Wayne_Arthurs-Roger_Federer,2,F-DTL,10,3,2,0,1,7,3
20010604-M-Roland_Garros-R16-Wayne_Arthurs-Roger_Federer,2,F-IO,26,12,8,3,1,23,3
20010604-M-Roland_Garros-R16-Wayne_Arthurs-Roger_Federer,2,F-II,4,1,1,0,0,2,2
20010604-M-Roland_Garros-R16-Wayne_Arthurs-Roger_Federer,2,B-XC,19,7,4,1,2,12,7
20010604-M-Roland_Garros-R16-Wayne_Arthurs-Roger_Federer,2,B-DTM,4,2,1,0,1,2,2
20010604-M-Roland_Garros-R16-Wayne_Arthurs-Roger_Federer,2,B-DTL,6,3,1,0,2,3,3
20010604-M-Roland_Garros-R16-Wayne_Arthurs-Roger_Federer,2,B-IO,2,1,0,1,0,2,0
20010604-M-Roland_Garros-R16-Wayne_Arthurs-Roger_Federer,2,S-XC,4,1,0,0,1,1,3
20010604-M-Roland_Garros-R16-Wayne_Arthurs-Roger_Federer,2,S-DTM,3,0,0,0,0,0,3
20010604-M-Roland_Garros-R16-Wayne_Arthurs-Roger_Federer,2,S-DTL,1,0,0,0,0,1,0
20180311-M-Indian_Wells_Masters-R64-Roger_Federer-Federico_Delbonis,1,F-XC,53,12,0,2,10,20,33
20180311-M-Indian_Wells_Masters-R64-Roger_Federer-Federico_Delbonis,1,F-DTM,13,3,0,0,3,5,8
20180311-M-Indian_Wells_Masters-R64-Roger_Federer-Federico_Delbonis,1,F-DTL,10,4,0,1,3,2,8
20180311-M-Indian_Wells_Masters-R64-Roger_Federer-Federico_Delbonis,1,F-IO,27,14,4,5,5,12,15
20180311-M-Indian_Wells_Masters-R64-Roger_Federer-Federico_Delbonis,1,F-II,14,2,0,0,2,3,11
20180311-M-Indian_Wells_Masters-R64-Roger_Federer-Federico_Delbonis,1,B-XC,15,6,1,1,4,5,10
20180311-M-Indian_Wells_Masters-R64-Roger_Federer-Federico_Delbonis,1,B-DTM,20,2,0,0,2,3,17
20180311-M-Indian_Wells_Masters-R64-Roger_Federer-Federico_Delbonis,1,B-DTL,8,1,0,0,1,5,3
20180311-M-Indian_Wells_Masters-R64-Roger_Federer-Federico_Delbonis,1,B-IO,1,0,0,0,0,0,1
20180311-M-Indian_Wells_Masters-R64-Roger_Federer-Federico_Delbonis,1,S-DTM,1,0,0,0,0,0,1
20180311-M-Indian_Wells_Masters-R64-Roger_Federer-Federico_Delbonis,1,S-DTL,4,1,0,0,1,2,2
20180311-M-Indian_Wells_Masters-R64-Roger_Federer-Federico_Delbonis,2,F-XC,41,6,3,2,1,31,10
20180311-M-Indian_Wells_Masters-R64-Roger_Federer-Federico_Delbonis,2,F-DTM,5,0,0,0,0,4,1
20180311-M-Indian_Wells_Masters-R64-Roger_Federer-Federico_Delbonis,2,F-DTL,5,4,1,0,3,2,3
20180311-M-Indian_Wells_Masters-R64-Roger_Federer-Federico_Delbonis,2,F-IO,11,5,3,0,2,7,4
20180311-M-Indian_Wells_Masters-R64-Roger_Federer-Federico_Delbonis,2,F-II,2,1,1,0,0,1,1
20180311-M-Indian_Wells_Masters-R64-Roger_Federer-Federico_Delbonis,2,B-XC,32,8,0,6,2,25,7
20180311-M-Indian_Wells_Masters-R64-Roger_Federer-Federico_Delbonis,2,B-DTM,34,3,0,0,3,17,17
20180311-M-Indian_Wells_Masters-R64-Roger_Federer-Federico_Delbonis,2,B-DTL,21,3,0,0,3,9,12
20180311-M-Indian_Wells_Masters-R64-Roger_Federer-Federico_Delbonis,2,B-IO,3,1,0,0,1,2,1
20180311-M-Indian_Wells_Masters-R64-Roger_Federer-Federico_Delbonis,2,S-XC,3,0,0,0,0,3,0
20180311-M-Indian_Wells_Masters-R64-Roger_Federer-Federico_Delbonis,2,S-DTM,2,0,0,0,0,1,1
20180311-M-Indian_Wells_Masters-R64-Roger_Federer-Federico_Delbonis,2,S-DTL,4,1,0,0,1,1,3
20180311-M-Indian_Wells_Masters-R64-Roger_Federer-Federico_Delbonis,2,S-IO,1,0,0,0,0,1,0
20180325-M-Miami_Masters-R64-Roger_Federer-Thanasi_Kokkinakis,1,F-XC,34,12,4,1,7,20,14
20180325-M-Miami_Masters-R64-Roger_Federer-Thanasi_Kokkinakis,1,F-DTM,14,1,0,0,1,8,6
20180325-M-Miami_Masters-R64-Roger_Federer-Thanasi_Kokkinakis,1,F-DTL,16,5,1,2,2,10,6
20180325-M-Miami_Masters-R64-Roger_Federer-Thanasi_Kokkinakis,1,F-IO,33,7,2,3,2,23,10
20180325-M-Miami_Masters-R64-Roger_Federer-Thanasi_Kokkinakis,1,F-II,16,8,3,1,4,10,6
20180325-M-Miami_Masters-R64-Roger_Federer-Thanasi_Kokkinakis,1,B-XC,29,9,1,4,4,16,13
20180325-M-Miami_Masters-R64-Roger_Federer-Thanasi_Kokkinakis,1,B-DTM,12,2,0,0,2,5,7
20180325-M-Miami_Masters-R64-Roger_Federer-Thanasi_Kokkinakis,1,B-DTL,4,2,2,0,0,4,0
20180325-M-Miami_Masters-R64-Roger_Federer-Thanasi_Kokkinakis,1,S-XC,11,0,0,0,0,6,5
20180325-M-Miami_Masters-R64-Roger_Federer-Thanasi_Kokkinakis,1,S-DTM,2,0,0,0,0,2,0
20180325-M-Miami_Masters-R64-Roger_Federer-Thanasi_Kokkinakis,1,S-DTL,3,0,0,0,0,2,1
20180325-M-Miami_Masters-R64-Roger_Federer-Thanasi_Kokkinakis,2,F-XC,34,13,5,3,5,18,16
20180325-M-Miami_Masters-R64-Roger_Federer-Thanasi_Kokkinakis,2,F-DTM,9,0,0,0,0,7,2
20180325-M-Miami_Masters-R64-Roger_Federer-Thanasi_Kokkinakis,2,F-DTL,17,6,4,0,2,9,8
20180325-M-Miami_Masters-R64-Roger_Federer-Thanasi_Kokkinakis,2,F-IO,35,6,1,2,3,16,19
20180325-M-Miami_Masters-R64-Roger_Federer-Thanasi_Kokkinakis,2,F-II,19,10,0,9,1,15,4
20180325-M-Miami_Masters-R64-Roger_Federer-Thanasi_Kokkinakis,2,B-XC,34,2,0,0,2,9,25
20180325-M-Miami_Masters-R64-Roger_Federer-Thanasi_Kokkinakis,2,B-DTM,12,1,0,0,1,3,9
20180325-M-Miami_Masters-R64-Roger_Federer-Thanasi_Kokkinakis,2,B-DTL,16,8,2,1,5,9,7
20180325-M-Miami_Masters-R64-Roger_Federer-Thanasi_Kokkinakis,2,S-XC,7,2,0,2,0,4,3
20180325-M-Miami_Masters-R64-Roger_Federer-Thanasi_Kokkinakis,2,S-DTM,4,0,0,0,0,2,2
20180325-M-Miami_Masters-R64-Roger_Federer-Thanasi_Kokkinakis,2,S-DTL,6,1,0,0,1,1,5
20190308-M-Indian_Wells_Masters-R128-Taro_Daniel-Dusan_Lajovic,1,F-XC,46,6,1,1,4,22,24
20190308-M-Indian_Wells_Masters-R128-Taro_Daniel-Dusan_Lajovic,1,F-DTM,42,2,0,0,2,22,20
20190308-M-Indian_Wells_Masters-R128-Taro_Daniel-Dusan_Lajovic,1,F-DTL,30,6,0,2,4,10,20
20190308-M-Indian_Wells_Masters-R128-Taro_Daniel-Dusan_Lajovic,1,F-IO,39,8,2,4,2,21,18
20190308-M-Indian_Wells_Masters-R128-Taro_Daniel-Dusan_Lajovic,1,F-II,5,2,1,1,0,4,1
20190308-M-Indian_Wells_Masters-R128-Taro_Daniel-Dusan_Lajovic,1,B-XC,115,10,1,3,6,50,65
20190308-M-Indian_Wells_Masters-R128-Taro_Daniel-Dusan_Lajovic,1,B-DTM,43,3,0,1,2,18,25
20190308-M-Indian_Wells_Masters-R128-Taro_Daniel-Dusan_Lajovic,1,B-DTL,20,11,1,6,4,9,11
20190308-M-Indian_Wells_Masters-R128-Taro_Daniel-Dusan_Lajovic,1,B-IO,3,1,1,0,0,2,1
20190308-M-Indian_Wells_Masters-R128-Taro_Daniel-Dusan_Lajovic,1,S-XC,8,1,0,0,1,3,5
20190308-M-Indian_Wells_Masters-R128-Taro_Daniel-Dusan_Lajovic,1,S-DTL,4,1,0,0,1,0,4
20190308-M-Indian_Wells_Masters-R128-Taro_Daniel-Dusan_Lajovic,2,F-XC,68,15,5,3,7,39,29
20190308-M-Indian_Wells_Masters-R128-Taro_Daniel-Dusan_Lajovic,2,F-DTM,37,2,0,0,2,14,23
20190308-M-Indian_Wells_Masters-R128-Taro_Daniel-Dusan_Lajovic,2,F-DTL,8,6,5,1,0,8,0
20190308-M-Indian_Wells_Masters-R128-Taro_Daniel-Dusan_Lajovic,2,F-IO,37,8,4,3,1,23,14
20190308-M-Indian_Wells_Masters-R128-Taro_Daniel-Dusan_Lajovic,2,F-II,7,2,1,0,1,3,4
20190308-M-Indian_Wells_Masters-R128-Taro_Daniel-Dusan_Lajovic,2,B-XC,85,6,1,0,5,53,32
20190308-M-Indian_Wells_Masters-R128-Taro_Daniel-Dusan_Lajovic,2,B-DTM,29,2,1,0,1,16,13
20190308-M-Indian_Wells_Masters-R128-Taro_Daniel-Dusan_Lajovic,2,B-DTL,17,9,5,2,2,12,5
20190308-M-Indian_Wells_Masters-R128-Taro_Daniel-Dusan_Lajovic,2,B-IO,7,3,1,0,2,4,3
20190308-M-Indian_Wells_Masters-R128-Taro_Daniel-Dusan_Lajovic,2,S-XC,46,2,0,0,2,21,25
20190308-M-Indian_Wells_Masters-R128-Taro_Daniel-Dusan_Lajovic,2,S-DTM,9,1,0,0,1,3,6
20190308-M-Indian_Wells_Masters-R128-Taro_Daniel-Dusan_Lajovic,2,S-DTL,3,1,0,1,0,3,0
20190308-M-Indian_Wells_Masters-R128-Taro_Daniel-Dusan_Lajovic,2,S-II,1,0,0,0,0,0,1
20190312-M-Indian_Wells_Masters-R32-Kyle_Edmund-Radu_Albot,1,F-XC,28,11,5,3,3,22,6
20190312-M-Indian_Wells_Masters-R32-Kyle_Edmund-Radu_Albot,1,F-DTM,13,1,1,0,0,8,5
20190312-M-Indian_Wells_Masters-R32-Kyle_Edmund-Radu_Albot,1,F-DTL,9,1,1,0,0,4,5
20190312-M-Indian_Wells_Masters-R32-Kyle_Edmund-Radu_Albot,1,F-IO,29,10,8,1,1,20,9
20190312-M-Indian_Wells_Masters-R32-Kyle_Edmund-Radu_Albot,1,F-II,7,4,1,2,1,5,2
20190312-M-Indian_Wells_Masters-R32-Kyle_Edmund-Radu_Albot,1,B-XC,23,2,0,1,1,14,9
20190312-M-Indian_Wells_Masters-R32-Kyle_Edmund-Radu_Albot,1,B-DTM,8,0,0,0,0,5,3
20190312-M-Indian_Wells_Masters-R32-Kyle_Edmund-Radu_Albot,1,B-DTL,5,3,1,0,2,1,4
20190312-M-Indian_Wells_Masters-R32-Kyle_Edmund-Radu_Albot,1,B-IO,1,1,0,0,1,0,1
20190312-M-Indian_Wells_Masters-R32-Kyle_Edmund-Radu_Albot,1,S-XC,2,0,0,0,0,2,0
20190312-M-Indian_Wells_Masters-R32-Kyle_Edmund-Radu_Albot,1,S-DTM,1,0,0,0,0,0,1
20190312-M-Indian_Wells_Masters-R32-Kyle_Edmund-Radu_Albot,1,S-DTL,2,1,0,0,1,0,2
20190312-M-Indian_Wells_Masters-R32-Kyle_Edmund-Radu_Albot,2,F-XC,21,5,2,1,2,11,10
20190312-M-Indian_Wells_Masters-R32-Kyle_Edmund-Radu_Albot,2,F-DTM,15,2,0,0,2,4,11
20190312-M-Indian_Wells_Masters-R32-Kyle_Edmund-Radu_Albot,2,F-DTL,8,2,0,0,2,3,5
20190312-M-Indian_Wells_Masters-R32-Kyle_Edmund-Radu_Albot,2,F-IO,25,6,4,1,1,12,13
20190312-M-Indian_Wells_Masters-R32-Kyle_Edmund-Radu_Albot,2,F-II,1,0,0,0,0,0,1
20190312-M-Indian_Wells_Masters-R32-Kyle_Edmund-Radu_Albot,2,B-XC,23,8,0,3,5,8,15
20190312-M-Indian_Wells_Masters-R32-Kyle_Edmund-Radu_Albot,2,B-DTM,15,1,0,0,1,5,10
20190312-M-Indian_Wells_Masters-R32-Kyle_Edmund-Radu_Albot,2,B-DTL,5,2,0,1,1,2,3
20190312-M-Indian_Wells_Masters-R32-Kyle_Edmund-Radu_Albot,2,S-XC,10,1,0,1,0,5,5
20190312-M-Indian_Wells_Masters-R32-Kyle_Edmund-Radu_Albot,2,S-DTM,2,0,0,0,0,0,2
20190312-M-Indian_Wells_Masters-R32-Kyle_Edmund-Radu_Albot,2,S-DTL,2,0,0,0,0,2,0
20190311-M-Indian_Wells_Masters-R32-Laslo_Djere-Miomir_Kecmanovic,1,F-XC,58,8,2,2,4,30,28
20190311-M-Indian_Wells_Masters-R32-Laslo_Djere-Miomir_Kecmanovic,1,F-DTM,29,1,0,0,1,13,16
20190311-M-Indian_Wells_Masters-R32-Laslo_Djere-Miomir_Kecmanovic,1,F-DTL,13,3,3,0,0,8,5
20190311-M-Indian_Wells_Masters-R32-Laslo_Djere-Miomir_Kecmanovic,1,F-IO,34,12,6,1,5,17,17
20190311-M-Indian_Wells_Masters-R32-Laslo_Djere-Miomir_Kecmanovic,1,F-II,5,2,1,0,1,3,2
20190311-M-Indian_Wells_Masters-R32-Laslo_Djere-Miomir_Kecmanovic,1,B-XC,64,11,3,1,7,28,36
20190311-M-Indian_Wells_Masters-R32-Laslo_Djere-Miomir_Kecmanovic,1,B-DTM,21,1,0,0,1,9,12
20190311-M-Indian_Wells_Masters-R32-Laslo_Djere-Miomir_Kecmanovic,1,B-DTL,21,5,1,1,3,10,11
20190311-M-Indian_Wells_Masters-R32-Laslo_Djere-Miomir_Kecmanovic,1,B-IO,7,1,0,0,1,4,3
20190311-M-Indian_Wells_Masters-R32-Laslo_Djere-Miomir_Kecmanovic,1,S-XC,15,0,0,0,0,11,4
20190311-M-Indian_Wells_Masters-R32-Laslo_Djere-Miomir_Kecmanovic,1,S-DTM,7,0,0,0,0,0,7
20190311-M-Indian_Wells_Masters-R32-Laslo_Djere-Miomir_Kecmanovic,1,S-DTL,1,0,0,0,0,0,1
20190311-M-Indian_Wells_Masters-R32-Laslo_Djere-Miomir_Kecmanovic,2,F-XC,59,9,0,4,5,30,29
20190311-M-Indian_Wells_Masters-R32-Laslo_Djere-Miomir_Kecmanovic,2,F-DTM,34,1,0,0,1,17,17
20190311-M-Indian_Wells_Masters-R32-Laslo_Djere-Miomir_Kecmanovic,2,F-DTL,21,4,2,0,2,11,10
20190311-M-Indian_Wells_Masters-R32-Laslo_Djere-Miomir_Kecmanovic,2,F-IO,27,2,0,1,1,16,11
20190311-M-Indian_Wells_Masters-R32-Laslo_Djere-Miomir_Kecmanovic,2,F-II,6,1,1,0,0,4,2
20190311-M-Indian_Wells_Masters-R32-Laslo_Djere-Miomir_Kecmanovic,2,B-XC,57,7,0,3,4,29,28
20190311-M-Indian_Wells_Masters-R32-Laslo_Djere-Miomir_Kecmanovic,2,B-DTM,34,1,0,0,1,19,15
20190311-M-Indian_Wells_Masters-R32-Laslo_Djere-Miomir_Kecmanovic,2,B-DTL,13,2,1,1,0,7,6
20190311-M-Indian_Wells_Masters-R32-Laslo_Djere-Miomir_Kecmanovic,2,B-IO,5,2,1,1,0,4,1
20190311-M-Indian_Wells_Masters-R32-Laslo_Djere-Miomir_Kecmanovic,2,S-XC,13,0,0,0,0,5,8
20190311-M-Indian_Wells_Masters-R32-Laslo_Djere-Miomir_Kecmanovic,2,S-DTM,9,1,0,0,1,5,4
20190311-M-Indian_Wells_Masters-R32-Laslo_Djere-Miomir_Kecmanovic,2,S-DTL,2,1,0,0,1,0,2
20190321-M-Miami_Masters-R128-Chun_Hsin_Tseng-Joao_Sousa,1,F-XC,46,10,3,3,4,18,28
20190321-M-Miami_Masters-R128-Chun_Hsin_Tseng-Joao_Sousa,1,F-DTM,24,2,0,0,2,8,16
20190321-M-Miami_Masters-R128-Chun_Hsin_Tseng-Joao_Sousa,1,F-DTL,18,5,1,1,3,7,11
20190321-M-Miami_Masters-R128-Chun_Hsin_Tseng-Joao_Sousa,1,F-IO,29,5,1,1,3,13,16
20190321-M-Miami_Masters-R128-Chun_Hsin_Tseng-Joao_Sousa,1,B-XC,59,4,1,0,3,25,34
20190321-M-Miami_Masters-R128-Chun_Hsin_Tseng-Joao_Sousa,1,B-DTM,45,6,0,0,6,13,32
20190321-M-Miami_Masters-R128-Chun_Hsin_Tseng-Joao_Sousa,1,B-DTL,6,3,1,1,1,3,3
20190321-M-Miami_Masters-R128-Chun_Hsin_Tseng-Joao_Sousa,1,B-IO,2,0,0,0,0,1,1
20190321-M-Miami_Masters-R128-Chun_Hsin_Tseng-Joao_Sousa,1,S-XC,5,0,0,0,0,1,4
20190321-M-Miami_Masters-R128-Chun_Hsin_Tseng-Joao_Sousa,1,S-DTM,2,0,0,0,0,1,1
20190321-M-Miami_Masters-R128-Chun_Hsin_Tseng-Joao_Sousa,1,S-DTL,1,0,0,0,0,0,1
20190321-M-Miami_Masters-R128-Chun_Hsin_Tseng-Joao_Sousa,2,F-XC,58,14,3,4,7,39,19
20190321-M-Miami_Masters-R128-Chun_Hsin_Tseng-Joao_Sousa,2,F-DTM,21,1,0,0,1,10,11
20190321-M-Miami_Masters-R128-Chun_Hsin_Tseng-Joao_Sousa,2,F-DTL,21,8,3,4,1,18,3
20190321-M-Miami_Masters-R128-Chun_Hsin_Tseng-Joao_Sousa,2,F-IO,64,19,5,7,7,40,24
20190321-M-Miami_Masters-R128-Chun_Hsin_Tseng-Joao_Sousa,2,F-II,13,8,3,3,2,7,6
20190321-M-Miami_Masters-R128-Chun_Hsin_Tseng-Joao_Sousa,2,B-XC,26,5,1,1,3,14,12
20190321-M-Miami_Masters-R128-Chun_Hsin_Tseng-Joao_Sousa,2,B-DTM,23,0,0,0,0,14,9
20190321-M-Miami_Masters-R128-Chun_Hsin_Tseng-Joao_Sousa,2,B-DTL,3,1,1,0,0,3,0
20190321-M-Miami_Masters-R128-Chun_Hsin_Tseng-Joao_Sousa,2,B-IO,2,1,0,0,1,1,1
20190321-M-Miami_Masters-R128-Chun_Hsin_Tseng-Joao_Sousa,2,S-XC,6,0,0,0,0,4,2
20190321-M-Miami_Masters-R128-Chun_Hsin_Tseng-Joao_Sousa,2,S-DTM,4,0,0,0,0,3,1
20190321-M-Miami_Masters-R128-Chun_Hsin_Tseng-Joao_Sousa,2,S-DTL,6,0,0,0,0,1,5
20190322-M-Miami_Masters-R64-Robin_Haase-Lloyd_George_Muirhead_Harris,1,F-XC,25,7,1,1,5,11,14
20190322-M-Miami_Masters-R64-Robin_Haase-Lloyd_George_Muirhead_Harris,1,F-DTM,48,1,0,0,1,23,25
20190322-M-Miami_Masters-R64-Robin_Haase-Lloyd_George_Muirhead_Harris,1,F-DTL,5,0,0,0,0,3,2
20190322-M-Miami_Masters-R64-Robin_Haase-Lloyd_George_Muirhead_Harris,1,F-IO,51,8,2,2,4,31,20
20190322-M-Miami_Masters-R64-Robin_Haase-Lloyd_George_Muirhead_Harris,1,F-II,6,4,0,2,2,3,3
20190322-M-Miami_Masters-R64-Robin_Haase-Lloyd_George_Muirhead_Harris,1,B-XC,27,4,1,1,2,16,11
20190322-M-Miami_Masters-R64-Robin_Haase-Lloyd_George_Muirhead_Harris,1,B-DTM,28,3,0,0,3,13,15
20190322-M-Miami_Masters-R64-Robin_Haase-Lloyd_George_Muirhead_Harris,1,B-DTL,7,6,3,1,2,4,3
20190322-M-Miami_Masters-R64-Robin_Haase-Lloyd_George_Muirhead_Harris,1,B-IO,6,1,1,0,0,3,3
20190322-M-Miami_Masters-R64-Robin_Haase-Lloyd_George_Muirhead_Harris,1,S-XC,24,2,0,0,2,17,7
20190322-M-Miami_Masters-R64-Robin_Haase-Lloyd_George_Muirhead_Harris,1,S-DTM,9,0,0,0,0,2,7
20190322-M-Miami_Masters-R64-Robin_Haase-Lloyd_George_Muirhead_Harris,1,S-DTL,6,0,0,0,0,2,4
20190322-M-Miami_Masters-R64-Robin_Haase-Lloyd_George_Muirhead_Harris,2,F-XC,58,18,6,4,8,32,26
20190322-M-Miami_Masters-R64-Robin_Haase-Lloyd_George_Muirhead_Harris,2,F-DTM,40,4,0,0,4,14,26
20190322-M-Miami_Masters-R64-Robin_Haase-Lloyd_George_Muirhead_Harris,2,F-DTL,13,3,1,0,2,5,8
20190322-M-Miami_Masters-R64-Robin_Haase-Lloyd_George_Muirhead_Harris,2,F-IO,61,18,2,4,12,28,33
20190322-M-Miami_Masters-R64-Robin_Haase-Lloyd_George_Muirhead_Harris,2,F-II,7,3,2,0,1,5,2
20190322-M-Miami_Masters-R64-Robin_Haase-Lloyd_George_Muirhead_Harris,2,B-XC,32,8,1,1,6,13,19
20190322-M-Miami_Masters-R64-Robin_Haase-Lloyd_George_Muirhead_Harris,2,B-DTM,40,4,0,0,4,17,23
20190322-M-Miami_Masters-R64-Robin_Haase-Lloyd_George_Muirhead_Harris,2,B-DTL,1,0,0,0,0,1,0
20190322-M-Miami_Masters-R64-Robin_Haase-Lloyd_George_Muirhead_Harris,2,B-IO,3,3,0,0,3,0,3
20190322-M-Miami_Masters-R64-Robin_Haase-Lloyd_George_Muirhead_Harris,2,S-XC,4,0,0,0,0,1,3
20190322-M-Miami_Masters-R64-Robin_Haase-Lloyd_George_Muirhead_Harris,2,S-DTM,6,0,0,0,0,1,5
20190322-M-Miami_Masters-R64-Robin_Haase-Lloyd_George_Muirhead_Harris,2,S-DTL,1,0,0,0,0,0,1
20190321-M-Miami_Masters-R128-Lukas_Lacko-Robin_Haase,1,F-XC,39,15,3,5,7,17,22
20190321-M-Miami_Masters-R128-Lukas_Lacko-Robin_Haase,1,F-DTM,19,6,2,0,4,10,9
20190321-M-Miami_Masters-R128-Lukas_Lacko-Robin_Haase,1,F-DTL,4,1,0,0,1,2,2
20190321-M-Miami_Masters-R128-Lukas_Lacko-Robin_Haase,1,F-IO,24,10,3,1,6,10,14
20190321-M-Miami_Masters-R128-Lukas_Lacko-Robin_Haase,1,F-II,2,1,1,0,0,1,1
20190321-M-Miami_Masters-R128-Lukas_Lacko-Robin_Haase,1,B-XC,28,3,0,0,3,11,17
20190321-M-Miami_Masters-R128-Lukas_Lacko-Robin_Haase,1,B-DTM,18,1,0,0,1,7,11
20190321-M-Miami_Masters-R128-Lukas_Lacko-Robin_Haase,1,B-DTL,4,4,3,0,1,3,1
20190321-M-Miami_Masters-R128-Lukas_Lacko-Robin_Haase,1,S-XC,7,0,0,0,0,4,3
20190321-M-Miami_Masters-R128-Lukas_Lacko-Robin_Haase,1,S-DTM,2,0,0,0,0,1,1
20190321-M-Miami_Masters-R128-Lukas_Lacko-Robin_Haase,1,S-DTL,5,3,0,1,2,1,4
20190321-M-Miami_Masters-R128-Lukas_Lacko-Robin_Haase,2,F-XC,8,3,0,0,3,3,5
20190321-M-Miami_Masters-R128-Lukas_Lacko-Robin_Haase,2,F-DTM,28,2,0,0,2,14,14
20190321-M-Miami_Masters-R128-Lukas_Lacko-Robin_Haase,2,F-DTL,4,4,2,1,1,3,1
20190321-M-Miami_Masters-R128-Lukas_Lacko-Robin_Haase,2,F-IO,19,4,1,2,1,12,7
20190321-M-Miami_Masters-R128-Lukas_Lacko-Robin_Haase,2,F-II,5,4,2,1,1,4,1
20190321-M-Miami_Masters-R128-Lukas_Lacko-Robin_Haase,2,B-XC,13,2,1,0,1,8,5
20190321-M-Miami_Masters-R128-Lukas_Lacko-Robin_Haase,2,B-DTM,22,1,0,0,1,11,11
20190321-M-Miami_Masters-R128-Lukas_Lacko-Robin_Haase,2,B-DTL,2,0,0,0,0,2,0
20190321-M-Miami_Masters-R128-Lukas_Lacko-Robin_Haase,2,B-IO,1,0,0,0,0,0,1
20190321-M-Miami_Masters-R128-Lukas_Lacko-Robin_Haase,2,S-XC,22,2,0,0,2,10,12
20190321-M-Miami_Masters-R128-Lukas_Lacko-Robin_Haase,2,S-DTM,5,0,0,0,0,3,2
20190321-M-Miami_Masters-R128-Lukas_Lacko-Robin_Haase,2,S-DTL,3,0,0,0,0,2,1
20190321-M-Miami_Masters-R128-Lukas_Lacko-Robin_Haase,2,S-IO,1,0,0,0,0,1,0
20020705-M-Wimbledon-SF-Lleyton_Hewitt-Tim_Henman,1,F-XC,37,9,3,4,2,27,10
20020705-M-Wimbledon-SF-Lleyton_Hewitt-Tim_Henman,1,F-DTM,7,1,1,0,0,5,2
20020705-M-Wimbledon-SF-Lleyton_Hewitt-Tim_Henman,1,F-DTL,27,6,4,1,1,20,7
20020705-M-Wimbledon-SF-Lleyton_Hewitt-Tim_Henman,1,F-IO,25,3,2,0,1,17,8
20020705-M-Wimbledon-SF-Lleyton_Hewitt-Tim_Henman,1,F-II,8,2,0,2,0,7,1
20020705-M-Wimbledon-SF-Lleyton_Hewitt-Tim_Henman,1,B-XC,54,8,4,2,2,41,13
20020705-M-Wimbledon-SF-Lleyton_Hewitt-Tim_Henman,1,B-DTM,5,0,0,0,0,4,1
20020705-M-Wimbledon-SF-Lleyton_Hewitt-Tim_Henman,1,B-DTL,7,5,5,0,0,6,1
20020705-M-Wimbledon-SF-Lleyton_Hewitt-Tim_Henman,1,B-IO,3,1,0,0,1,1,2
20020705-M-Wimbledon-SF-Lleyton_Hewitt-Tim_Henman,1,S-XC,9,1,0,1,0,4,5
20020705-M-Wimbledon-SF-Lleyton_Hewitt-Tim_Henman,1,S-DTM,2,0,0,0,0,1,1
20020705-M-Wimbledon-SF-Lleyton_Hewitt-Tim_Henman,1,S-DTL,2,1,0,1,0,2,0
20020705-M-Wimbledon-SF-Lleyton_Hewitt-Tim_Henman,2,F-XC,30,4,1,1,2,7,23
20020705-M-Wimbledon-SF-Lleyton_Hewitt-Tim_Henman,2,F-DTM,4,1,0,0,1,3,1
20020705-M-Wimbledon-SF-Lleyton_Hewitt-Tim_Henman,2,F-DTL,10,2,1,0,1,4,6
20020705-M-Wimbledon-SF-Lleyton_Hewitt-Tim_Henman,2,F-IO,11,4,0,1,3,3,8
20020705-M-Wimbledon-SF-Lleyton_Hewitt-Tim_Henman,2,F-II,9,3,1,2,0,6,3
20020705-M-Wimbledon-SF-Lleyton_Hewitt-Tim_Henman,2,B-XC,11,4,1,1,2,5,6
20020705-M-Wimbledon-SF-Lleyton_Hewitt-Tim_Henman,2,B-DTM,2,1,0,0,1,1,1
20020705-M-Wimbledon-SF-Lleyton_Hewitt-Tim_Henman,2,B-DTL,9,5,1,1,3,4,5
20020705-M-Wimbledon-SF-Lleyton_Hewitt-Tim_Henman,2,B-IO,1,1,0,0,1,0,1
20020705-M-Wimbledon-SF-Lleyton_Hewitt-Tim_Henman,2,S-XC,51,7,0,1,6,10,41
20020705-M-Wimbledon-SF-Lleyton_Hewitt-Tim_Henman,2,S-DTM,4,0,0,0,0,0,4
20020705-M-Wimbledon-SF-Lleyton_Hewitt-Tim_Henman,2,S-DTL,11,2,0,0,2,0,11
20020705-M-Wimbledon-SF-Lleyton_Hewitt-Tim_Henman,2,S-IO,1,0,0,0,0,0,1
20020705-M-Wimbledon-SF-Lleyton_Hewitt-Tim_Henman,2,S-II,1,0,0,0,0,0,1
20010317-M-Indian_Wells_Masters-SF-Lleyton_Hewitt-Andre_Agassi,1,F-XC,68,8,1,1,6,35,33
20010317-M-Indian_Wells_Masters-SF-Lleyton_Hewitt-Andre_Agassi,1,F-DTM,23,3,0,0,3,12,11
20010317-M-Indian_Wells_Masters-SF-Lleyton_Hewitt-Andre_Agassi,1,F-DTL,20,5,4,1,0,12,8
20010317-M-Indian_Wells_Masters-SF-Lleyton_Hewitt-Andre_Agassi,1,F-IO,24,5,1,1,3,11,13
20010317-M-Indian_Wells_Masters-SF-Lleyton_Hewitt-Andre_Agassi,1,F-II,9,4,3,0,1,5,4
20010317-M-Indian_Wells_Masters-SF-Lleyton_Hewitt-Andre_Agassi,1,B-XC,85,7,1,1,5,44,41
20010317-M-Indian_Wells_Masters-SF-Lleyton_Hewitt-Andre_Agassi,1,B-DTM,28,3,0,0,3,13,15
20010317-M-Indian_Wells_Masters-SF-Lleyton_Hewitt-Andre_Agassi,1,B-DTL,5,2,1,1,0,3,2
20010317-M-Indian_Wells_Masters-SF-Lleyton_Hewitt-Andre_Agassi,1,S-XC,9,0,0,0,0,6,3
20010317-M-Indian_Wells_Masters-SF-Lleyton_Hewitt-Andre_Agassi,1,S-DTM,8,1,0,1,0,2,6
20010317-M-Indian_Wells_Masters-SF-Lleyton_Hewitt-Andre_Agassi,1,S-DTL,1,1,1,0,0,1,0
20010317-M-Indian_Wells_Masters-SF-Lleyton_Hewitt-Andre_Agassi,2,F-XC,78,17,1,5,11,33,45
20010317-M-Indian_Wells_Masters-SF-Lleyton_Hewitt-Andre_Agassi,2,F-DTM,7,0,0,0,0,5,2
20010317-M-Indian_Wells_Masters-SF-Lleyton_Hewitt-Andre_Agassi,2,F-DTL,26,10,3,1,6,12,14
20010317-M-Indian_Wells_Masters-SF-Lleyton_Hewitt-Andre_Agassi,2,F-IO,27,9,2,3,4,12,15
20010317-M-Indian_Wells_Masters-SF-Lleyton_Hewitt-Andre_Agassi,2,F-II,6,2,0,1,1,3,3
20010317-M-Indian_Wells_Masters-SF-Lleyton_Hewitt-Andre_Agassi,2,B-XC,94,13,2,4,7,50,44
20010317-M-Indian_Wells_Masters-SF-Lleyton_Hewitt-Andre_Agassi,2,B-DTM,22,3,0,0,3,8,14
20010317-M-Indian_Wells_Masters-SF-Lleyton_Hewitt-Andre_Agassi,2,B-DTL,15,4,1,1,2,8,7
20010317-M-Indian_Wells_Masters-SF-Lleyton_Hewitt-Andre_Agassi,2,B-IO,5,1,0,0,1,3,2
20010317-M-Indian_Wells_Masters-SF-Lleyton_Hewitt-Andre_Agassi,2,S-XC,6,0,0,0,0,3,3
20010317-M-Indian_Wells_Masters-SF-Lleyton_Hewitt-Andre_Agassi,2,S-DTM,1,0,0,0,0,0,1
20010317-M-Indian_Wells_Masters-SF-Lleyton_Hewitt-Andre_Agassi,2,S-DTL,1,0,0,0,0,0,1
20170710-M-Wimbledon-R16-Gilles_Muller-Rafael_Nadal,1,F-XC,53,25,7,8,10,29,24
20170710-M-Wimbledon-R16-Gilles_Muller-Rafael_Nadal,1,F-DTM,8,0,0,0,0,2,6
20170710-M-Wimbledon-R16-Gilles_Muller-Rafael_Nadal,1,F-DTL,27,16,6,3,7,15,12
20170710-M-Wimbledon-R16-Gilles_Muller-Rafael_Nadal,1,F-IO,35,9,3,1,5,19,16
20170710-M-Wimbledon-R16-Gilles_Muller-Rafael_Nadal,1,F-II,2,0,0,0,0,1,1
20170710-M-Wimbledon-R16-Gilles_Muller-Rafael_Nadal,1,B-XC,27,5,0,1,4,9,18
20170710-M-Wimbledon-R16-Gilles_Muller-Rafael_Nadal,1,B-DTM,12,2,0,0,2,6,6
20170710-M-Wimbledon-R16-Gilles_Muller-Rafael_Nadal,1,B-DTL,15,8,3,4,1,9,6
20170710-M-Wimbledon-R16-Gilles_Muller-Rafael_Nadal,1,B-IO,2,2,1,1,0,2,0
20170710-M-Wimbledon-R16-Gilles_Muller-Rafael_Nadal,1,S-XC,17,3,0,2,1,11,6
20170710-M-Wimbledon-R16-Gilles_Muller-Rafael_Nadal,1,S-DTM,9,0,0,0,0,2,7
20170710-M-Wimbledon-R16-Gilles_Muller-Rafael_Nadal,1,S-DTL,9,3,1,0,2,3,6
20170710-M-Wimbledon-R16-Gilles_Muller-Rafael_Nadal,2,F-XC,55,16,8,5,3,38,17
20170710-M-Wimbledon-R16-Gilles_Muller-Rafael_Nadal,2,F-DTM,21,0,0,0,0,9,12
20170710-M-Wimbledon-R16-Gilles_Muller-Rafael_Nadal,2,F-DTL,14,5,2,3,0,10,4
20170710-M-Wimbledon-R16-Gilles_Muller-Rafael_Nadal,2,F-IO,41,18,6,7,5,31,10
20170710-M-Wimbledon-R16-Gilles_Muller-Rafael_Nadal,2,F-II,10,3,1,1,1,6,4
20170710-M-Wimbledon-R16-Gilles_Muller-Rafael_Nadal,2,B-XC,36,3,3,0,0,20,16
20170710-M-Wimbledon-R16-Gilles_Muller-Rafael_Nadal,2,B-DTM,16,0,0,0,0,4,12
20170710-M-Wimbledon-R16-Gilles_Muller-Rafael_Nadal,2,B-DTL,19,10,5,4,1,14,5
20170710-M-Wimbledon-R16-Gilles_Muller-Rafael_Nadal,2,B-IO,4,2,0,2,0,4,0
20170710-M-Wimbledon-R16-Gilles_Muller-Rafael_Nadal,2,S-XC,15,2,1,1,0,6,9
20170710-M-Wimbledon-R16-Gilles_Muller-Rafael_Nadal,2,S-DTM,8,1,0,1,0,3,5
20170710-M-Wimbledon-R16-Gilles_Muller-Rafael_Nadal,2,S-DTL,5,1,0,1,0,1,4
20170710-M-Wimbledon-R16-Gilles_Muller-Rafael_Nadal,2,S-IO,1,0,0,0,0,1,0
20190324-M-Miami_Masters-R32-Robin_Haase-Nikoloz_Basilashvili,1,F-XC,9,1,0,1,0,7,2
20190324-M-Miami_Masters-R32-Robin_Haase-Nikoloz_Basilashvili,1,F-DTM,22,5,0,1,4,9,13
20190324-M-Miami_Masters-R32-Robin_Haase-Nikoloz_Basilashvili,1,F-DTL,6,2,2,0,0,3,3
20190324-M-Miami_Masters-R32-Robin_Haase-Nikoloz_Basilashvili,1,F-IO,11,1,1,0,0,3,8
20190324-M-Miami_Masters-R32-Robin_Haase-Nikoloz_Basilashvili,1,B-XC,1,0,0,0,0,1,0
20190324-M-Miami_Masters-R32-Robin_Haase-Nikoloz_Basilashvili,1,B-DTM,11,1,0,0,1,4,7
20190324-M-Miami_Masters-R32-Robin_Haase-Nikoloz_Basilashvili,1,B-IO,3,3,1,1,1,2,1
20190324-M-Miami_Masters-R32-Robin_Haase-Nikoloz_Basilashvili,1,S-XC,23,3,0,0,3,7,16
20190324-M-Miami_Masters-R32-Robin_Haase-Nikoloz_Basilashvili,1,S-DTM,8,0,0,0,0,0,8
20190324-M-Miami_Masters-R32-Robin_Haase-Nikoloz_Basilashvili,1,S-DTL,3,0,0,0,0,1,2
20190324-M-Miami_Masters-R32-Robin_Haase-Nikoloz_Basilashvili,2,F-XC,37,14,3,6,5,26,11
20190324-M-Miami_Masters-R32-Robin_Haase-Nikoloz_Basilashvili,2,F-DTM,11,1,0,0,1,5,6
20190324-M-Miami_Masters-R32-Robin_Haase-Nikoloz_Basilashvili,2,F-DTL,5,3,0,0,3,2,3
20190324-M-Miami_Masters-R32-Robin_Haase-Nikoloz_Basilashvili,2,F-IO,29,13,5,1,7,16,13
20190324-M-Miami_Masters-R32-Robin_Haase-Nikoloz_Basilashvili,2,F-II,5,4,0,2,2,3,2
20190324-M-Miami_Masters-R32-Robin_Haase-Nikoloz_Basilashvili,2,B-XC,23,6,1,2,3,16,7
20190324-M-Miami_Masters-R32-Robin_Haase-Nikoloz_Basilashvili,2,B-DTM,13,2,0,1,1,10,3
20190324-M-Miami_Masters-R32-Robin_Haase-Nikoloz_Basilashvili,2,B-DTL,1,1,1,0,0,1,0
20190324-M-Miami_Masters-R32-Robin_Haase-Nikoloz_Basilashvili,2,B-IO,2,0,0,0,0,1,1
20190324-M-Miami_Masters-R32-Robin_Haase-Nikoloz_Basilashvili,2,S-XC,1,0,0,0,0,1,0
20190323-M-Miami_Masters-R64-Roger_Federer-Radu_Albot,1,F-XC,35,14,4,5,5,20,15
20190323-M-Miami_Masters-R64-Roger_Federer-Radu_Albot,1,F-DTM,25,1,0,0,1,19,6
20190323-M-Miami_Masters-R64-Roger_Federer-Radu_Albot,1,F-DTL,12,3,0,2,1,7,5
20190323-M-Miami_Masters-R64-Roger_Federer-Radu_Albot,1,F-IO,23,10,3,0,7,11,12
20190323-M-Miami_Masters-R64-Roger_Federer-Radu_Albot,1,F-II,3,0,0,0,0,2,1
20190323-M-Miami_Masters-R64-Roger_Federer-Radu_Albot,1,B-XC,43,10,2,4,4,22,21
20190323-M-Miami_Masters-R64-Roger_Federer-Radu_Albot,1,B-DTM,30,4,0,0,4,12,18
20190323-M-Miami_Masters-R64-Roger_Federer-Radu_Albot,1,B-DTL,6,4,1,0,3,2,4
20190323-M-Miami_Masters-R64-Roger_Federer-Radu_Albot,1,B-IO,2,2,1,1,0,2,0
20190323-M-Miami_Masters-R64-Roger_Federer-Radu_Albot,1,S-XC,19,4,0,2,2,11,8
20190323-M-Miami_Masters-R64-Roger_Federer-Radu_Albot,1,S-DTM,5,0,0,0,0,4,1
20190323-M-Miami_Masters-R64-Roger_Federer-Radu_Albot,1,S-DTL,1,0,0,0,0,0,1
20190323-M-Miami_Masters-R64-Roger_Federer-Radu_Albot,2,F-XC,34,8,2,1,5,14,20
20190323-M-Miami_Masters-R64-Roger_Federer-Radu_Albot,2,F-DTM,37,7,1,0,6,14,23
20190323-M-Miami_Masters-R64-Roger_Federer-Radu_Albot,2,F-DTL,4,1,1,0,0,4,0
20190323-M-Miami_Masters-R64-Roger_Federer-Radu_Albot,2,F-IO,40,8,3,2,3,17,23
20190323-M-Miami_Masters-R64-Roger_Federer-Radu_Albot,2,F-II,5,2,0,1,1,2,3
20190323-M-Miami_Masters-R64-Roger_Federer-Radu_Albot,2,B-XC,50,12,1,2,9,20,30
20190323-M-Miami_Masters-R64-Roger_Federer-Radu_Albot,2,B-DTM,21,2,0,0,2,8,13
20190323-M-Miami_Masters-R64-Roger_Federer-Radu_Albot,2,B-DTL,5,3,2,0,1,2,3
20190323-M-Miami_Masters-R64-Roger_Federer-Radu_Albot,2,S-XC,6,1,0,1,0,4,2
20190323-M-Miami_Masters-R64-Roger_Federer-Radu_Albot,2,S-DTM,7,0,0,0,0,4,3
20190323-M-Miami_Masters-R64-Roger_Federer-Radu_Albot,2,S-DTL,2,1,0,1,0,1,1
20190323-M-Miami_Masters-R64-Alexander_Zverev-David_Ferrer,1,F-XC,46,10,2,1,7,18,28
20190323-M-Miami_Masters-R64-Alexander_Zverev-David_Ferrer,1,F-DTM,74,3,0,0,3,23,51
20190323-M-Miami_Masters-R64-Alexander_Zverev-David_Ferrer,1,F-DTL,18,3,1,1,1,8,10
20190323-M-Miami_Masters-R64-Alexander_Zverev-David_Ferrer,1,F-IO,30,5,1,2,2,16,14
20190323-M-Miami_Masters-R64-Alexander_Zverev-David_Ferrer,1,B-XC,64,12,1,3,8,23,41
20190323-M-Miami_Masters-R64-Alexander_Zverev-David_Ferrer,1,B-DTM,54,8,0,1,7,16,38
20190323-M-Miami_Masters-R64-Alexander_Zverev-David_Ferrer,1,B-DTL,6,5,3,0,2,4,2
20190323-M-Miami_Masters-R64-Alexander_Zverev-David_Ferrer,1,B-IO,17,6,1,3,2,9,8
20190323-M-Miami_Masters-R64-Alexander_Zverev-David_Ferrer,1,S-XC,7,0,0,0,0,2,5
20190323-M-Miami_Masters-R64-Alexander_Zverev-David_Ferrer,1,S-DTM,9,0,0,0,0,3,6
20190323-M-Miami_Masters-R64-Alexander_Zverev-David_Ferrer,1,S-DTL,2,0,0,0,0,1,1
20190323-M-Miami_Masters-R64-Alexander_Zverev-David_Ferrer,2,F-XC,65,8,1,4,3,39,26
20190323-M-Miami_Masters-R64-Alexander_Zverev-David_Ferrer,2,F-DTM,69,3,0,1,2,42,27
20190323-M-Miami_Masters-R64-Alexander_Zverev-David_Ferrer,2,F-DTL,7,4,2,0,2,3,4
20190323-M-Miami_Masters-R64-Alexander_Zverev-David_Ferrer,2,F-IO,45,10,1,3,6,28,17
20190323-M-Miami_Masters-R64-Alexander_Zverev-David_Ferrer,2,F-II,5,2,1,1,0,4,1
20190323-M-Miami_Masters-R64-Alexander_Zverev-David_Ferrer,2,B-XC,35,3,1,1,1,23,12
20190323-M-Miami_Masters-R64-Alexander_Zverev-David_Ferrer,2,B-DTM,62,2,0,0,2,43,19
20190323-M-Miami_Masters-R64-Alexander_Zverev-David_Ferrer,2,B-DTL,14,4,0,1,3,6,8
20190323-M-Miami_Masters-R64-Alexander_Zverev-David_Ferrer,2,B-IO,9,4,1,1,2,4,5
20190323-M-Miami_Masters-R64-Alexander_Zverev-David_Ferrer,2,S-XC,5,0,0,0,0,2,3
20190323-M-Miami_Masters-R64-Alexander_Zverev-David_Ferrer,2,S-DTM,10,2,0,0,2,4,6
20190323-M-Miami_Masters-R64-Alexander_Zverev-David_Ferrer,2,S-DTL,2,1,0,1,0,2,0
20190323-M-Miami_Masters-R64-Alexander_Zverev-David_Ferrer,2,S-IO,1,1,0,0,1,0,1
20190323-M-Miami_Masters-R64-David_Goffin-Pablo_Andujar,1,F-XC,60,9,5,3,1,39,21
20190323-M-Miami_Masters-R64-David_Goffin-Pablo_Andujar,1,F-DTM,23,4,0,1,3,10,13
20190323-M-Miami_Masters-R64-David_Goffin-Pablo_Andujar,1,F-DTL,24,7,3,0,4,13,11
20190323-M-Miami_Masters-R64-David_Goffin-Pablo_Andujar,1,F-IO,31,9,5,3,1,25,6
20190323-M-Miami_Masters-R64-David_Goffin-Pablo_Andujar,1,F-II,6,4,1,3,0,6,0
20190323-M-Miami_Masters-R64-David_Goffin-Pablo_Andujar,1,B-XC,45,2,1,0,1,31,14
20190323-M-Miami_Masters-R64-David_Goffin-Pablo_Andujar,1,B-DTM,22,3,0,0,3,11,11
20190323-M-Miami_Masters-R64-David_Goffin-Pablo_Andujar,1,B-DTL,9,4,1,0,3,3,6
20190323-M-Miami_Masters-R64-David_Goffin-Pablo_Andujar,1,B-IO,2,0,0,0,0,2,0
20190323-M-Miami_Masters-R64-David_Goffin-Pablo_Andujar,1,S-XC,6,0,0,0,0,2,4
20190323-M-Miami_Masters-R64-David_Goffin-Pablo_Andujar,1,S-DTM,2,0,0,0,0,1,1
20190323-M-Miami_Masters-R64-David_Goffin-Pablo_Andujar,1,S-DTL,4,2,0,1,1,2,2
20190323-M-Miami_Masters-R64-David_Goffin-Pablo_Andujar,1,S-IO,1,0,0,0,0,1,0
20190323-M-Miami_Masters-R64-David_Goffin-Pablo_Andujar,2,F-XC,56,8,1,1,6,24,32
20190323-M-Miami_Masters-R64-David_Goffin-Pablo_Andujar,2,F-DTM,22,1,0,0,1,7,15
20190323-M-Miami_Masters-R64-David_Goffin-Pablo_Andujar,2,F-DTL,14,6,2,1,3,6,8
20190323-M-Miami_Masters-R64-David_Goffin-Pablo_Andujar,2,F-IO,25,5,3,0,2,16,9
20190323-M-Miami_Masters-R64-David_Goffin-Pablo_Andujar,2,F-II,3,1,0,1,0,1,2
20190323-M-Miami_Masters-R64-David_Goffin-Pablo_Andujar,2,B-XC,47,3,1,1,1,15,32
20190323-M-Miami_Masters-R64-David_Goffin-Pablo_Andujar,2,B-DTM,23,0,0,0,0,3,20
20190323-M-Miami_Masters-R64-David_Goffin-Pablo_Andujar,2,B-DTL,15,7,3,1,3,7,8
20190323-M-Miami_Masters-R64-David_Goffin-Pablo_Andujar,2,B-IO,3,1,1,0,0,2,1
20190323-M-Miami_Masters-R64-David_Goffin-Pablo_Andujar,2,S-XC,9,1,0,0,1,3,6
20190323-M-Miami_Masters-R64-David_Goffin-Pablo_Andujar,2,S-DTM,7,0,0,0,0,2,5
20190323-M-Miami_Masters-R64-David_Goffin-Pablo_Andujar,2,S-DTL,2,0,0,0,0,0,2
20190321-M-Miami_Masters-R128-Leonardo_Mayer-Mikael_Ymer,1,F-XC,74,22,4,6,12,40,34
20190321-M-Miami_Masters-R128-Leonardo_Mayer-Mikael_Ymer,1,F-DTM,9,0,0,0,0,4,5
20190321-M-Miami_Masters-R128-Leonardo_Mayer-Mikael_Ymer,1,F-DTL,10,4,2,1,1,8,2
20190321-M-Miami_Masters-R128-Leonardo_Mayer-Mikael_Ymer,1,F-IO,45,15,3,4,8,29,16
20190321-M-Miami_Masters-R128-Leonardo_Mayer-Mikael_Ymer,1,F-II,18,6,0,1,5,8,10
20190321-M-Miami_Masters-R128-Leonardo_Mayer-Mikael_Ymer,1,B-XC,56,7,1,3,3,34,22
20190321-M-Miami_Masters-R128-Leonardo_Mayer-Mikael_Ymer,1,B-DTM,12,0,0,0,0,5,7
20190321-M-Miami_Masters-R128-Leonardo_Mayer-Mikael_Ymer,1,B-DTL,11,5,2,1,2,6,5
20190321-M-Miami_Masters-R128-Leonardo_Mayer-Mikael_Ymer,1,B-IO,2,1,1,0,0,1,1
20190321-M-Miami_Masters-R128-Leonardo_Mayer-Mikael_Ymer,1,S-XC,10,1,0,0,0,6,4
20190321-M-Miami_Masters-R128-Leonardo_Mayer-Mikael_Ymer,1,S-DTM,3,0,0,0,0,2,1
20190321-M-Miami_Masters-R128-Leonardo_Mayer-Mikael_Ymer,2,F-XC,33,8,2,0,6,12,21
20190321-M-Miami_Masters-R128-Leonardo_Mayer-Mikael_Ymer,2,F-DTM,30,1,0,0,0,14,16
20190321-M-Miami_Masters-R128-Leonardo_Mayer-Mikael_Ymer,2,F-DTL,21,5,2,3,0,13,8
20190321-M-Miami_Masters-R128-Leonardo_Mayer-Mikael_Ymer,2,F-IO,12,1,0,0,1,7,5
20190321-M-Miami_Masters-R128-Leonardo_Mayer-Mikael_Ymer,2,B-XC,81,5,2,1,2,34,47
20190321-M-Miami_Masters-R128-Leonardo_Mayer-Mikael_Ymer,2,B-DTM,33,3,0,0,3,12,21
20190321-M-Miami_Masters-R128-Leonardo_Mayer-Mikael_Ymer,2,B-DTL,18,7,3,3,1,11,7
20190321-M-Miami_Masters-R128-Leonardo_Mayer-Mikael_Ymer,2,B-IO,8,2,1,0,1,3,5
20190321-M-Miami_Masters-R128-Leonardo_Mayer-Mikael_Ymer,2,S-XC,4,0,0,0,0,0,4
20190321-M-Miami_Masters-R128-Leonardo_Mayer-Mikael_Ymer,2,S-DTM,2,0,0,0,0,0,2
20190321-M-Miami_Masters-R128-Leonardo_Mayer-Mikael_Ymer,2,S-DTL,3,0,0,0,0,2,1
20190324-M-Miami_Masters-R32-Roberto_Bautista_Agut-Fabio_Fognini,1,F-XC,45,9,1,7,1,31,14
20190324-M-Miami_Masters-R32-Roberto_Bautista_Agut-Fabio_Fognini,1,F-DTM,15,0,0,0,0,4,11
20190324-M-Miami_Masters-R32-Roberto_Bautista_Agut-Fabio_Fognini,1,F-DTL,5,2,1,1,0,5,0
20190324-M-Miami_Masters-R32-Roberto_Bautista_Agut-Fabio_Fognini,1,F-IO,32,6,1,4,1,25,7
20190324-M-Miami_Masters-R32-Roberto_Bautista_Agut-Fabio_Fognini,1,F-II,6,1,0,1,0,4,2
20190324-M-Miami_Masters-R32-Roberto_Bautista_Agut-Fabio_Fognini,1,B-XC,49,3,0,0,3,28,21
20190324-M-Miami_Masters-R32-Roberto_Bautista_Agut-Fabio_Fognini,1,B-DTM,28,1,0,0,1,16,12
20190324-M-Miami_Masters-R32-Roberto_Bautista_Agut-Fabio_Fognini,1,B-DTL,6,3,0,0,3,2,4
20190324-M-Miami_Masters-R32-Roberto_Bautista_Agut-Fabio_Fognini,1,S-XC,10,1,1,0,0,6,4
20190324-M-Miami_Masters-R32-Roberto_Bautista_Agut-Fabio_Fognini,1,S-DTM,1,0,0,0,0,0,1
20190324-M-Miami_Masters-R32-Roberto_Bautista_Agut-Fabio_Fognini,1,S-DTL,1,0,0,0,0,0,1
20190324-M-Miami_Masters-R32-Roberto_Bautista_Agut-Fabio_Fognini,2,F-XC,32,8,2,3,3,17,15
20190324-M-Miami_Masters-R32-Roberto_Bautista_Agut-Fabio_Fognini,2,F-DTM,17,2,0,0,2,5,12
20190324-M-Miami_Masters-R32-Roberto_Bautista_Agut-Fabio_Fognini,2,F-DTL,19,6,1,1,4,7,12
20190324-M-Miami_Masters-R32-Roberto_Bautista_Agut-Fabio_Fognini,2,F-IO,40,9,2,1,6,21,19
20190324-M-Miami_Masters-R32-Roberto_Bautista_Agut-Fabio_Fognini,2,F-II,7,5,1,2,2,4,3
20190324-M-Miami_Masters-R32-Roberto_Bautista_Agut-Fabio_Fognini,2,B-XC,40,3,0,0,3,12,28
20190324-M-Miami_Masters-R32-Roberto_Bautista_Agut-Fabio_Fognini,2,B-DTM,17,1,0,0,1,3,14
20190324-M-Miami_Masters-R32-Roberto_Bautista_Agut-Fabio_Fognini,2,B-DTL,11,5,2,1,2,5,6
20190324-M-Miami_Masters-R32-Roberto_Bautista_Agut-Fabio_Fognini,2,B-IO,4,3,1,1,1,3,1
20190324-M-Miami_Masters-R32-Roberto_Bautista_Agut-Fabio_Fognini,2,S-XC,15,3,0,1,2,6,9
20190324-M-Miami_Masters-R32-Roberto_Bautista_Agut-Fabio_Fognini,2,S-DTM,7,0,0,0,0,1,6
20190324-M-Miami_Masters-R32-Roberto_Bautista_Agut-Fabio_Fognini,2,S-IO,1,0,0,0,0,0,1
20190323-M-Miami_Masters-R64-Marin_Cilic-Andrey_Rublev,1,F-XC,31,11,3,3,5,12,19
20190323-M-Miami_Masters-R64-Marin_Cilic-Andrey_Rublev,1,F-DTM,11,1,1,0,0,3,8
20190323-M-Miami_Masters-R64-Marin_Cilic-Andrey_Rublev,1,F-DTL,3,0,0,0,0,0,3
20190323-M-Miami_Masters-R64-Marin_Cilic-Andrey_Rublev,1,F-IO,23,10,2,4,4,11,12
20190323-M-Miami_Masters-R64-Marin_Cilic-Andrey_Rublev,1,F-II,9,4,2,1,1,5,4
20190323-M-Miami_Masters-R64-Marin_Cilic-Andrey_Rublev,1,B-XC,56,10,0,0,10,17,39
20190323-M-Miami_Masters-R64-Marin_Cilic-Andrey_Rublev,1,B-DTM,12,1,0,1,0,3,9
20190323-M-Miami_Masters-R64-Marin_Cilic-Andrey_Rublev,1,B-DTL,7,5,2,1,2,5,2
20190323-M-Miami_Masters-R64-Marin_Cilic-Andrey_Rublev,1,B-IO,1,0,0,0,0,1,0
20190323-M-Miami_Masters-R64-Marin_Cilic-Andrey_Rublev,1,S-XC,2,0,0,0,0,1,1
20190323-M-Miami_Masters-R64-Marin_Cilic-Andrey_Rublev,2,F-XC,20,10,6,1,3,15,5
20190323-M-Miami_Masters-R64-Marin_Cilic-Andrey_Rublev,2,F-DTM,9,1,0,1,0,8,1
20190323-M-Miami_Masters-R64-Marin_Cilic-Andrey_Rublev,2,F-DTL,11,4,2,1,1,8,3
20190323-M-Miami_Masters-R64-Marin_Cilic-Andrey_Rublev,2,F-IO,20,8,5,1,2,15,5
20190323-M-Miami_Masters-R64-Marin_Cilic-Andrey_Rublev,2,F-II,4,1,1,0,0,3,1
20190323-M-Miami_Masters-R64-Marin_Cilic-Andrey_Rublev,2,B-XC,39,4,0,1,3,23,16
20190323-M-Miami_Masters-R64-Marin_Cilic-Andrey_Rublev,2,B-DTM,15,0,0,0,0,9,6
20190323-M-Miami_Masters-R64-Marin_Cilic-Andrey_Rublev,2,B-DTL,15,13,5,2,6,7,8
20190323-M-Miami_Masters-R64-Marin_Cilic-Andrey_Rublev,2,B-IO,1,0,0,0,0,1,0
20190323-M-Miami_Masters-R64-Marin_Cilic-Andrey_Rublev,2,S-XC,7,0,0,0,0,3,4
20190323-M-Miami_Masters-R64-Marin_Cilic-Andrey_Rublev,2,S-DTM,5,1,0,0,1,2,3
20190323-M-Miami_Masters-R64-Marin_Cilic-Andrey_Rublev,2,S-DTL,1,0,0,0,0,1,0
20000609-M-Roland_Garros-SF-Gustavo_Kuerten-Juan_Carlos_Ferrero,1,F-XC,93,21,4,10,7,49,44
20000609-M-Roland_Garros-SF-Gustavo_Kuerten-Juan_Carlos_Ferrero,1,F-DTM,50,3,0,0,3,12,38
20000609-M-Roland_Garros-SF-Gustavo_Kuerten-Juan_Carlos_Ferrero,1,F-DTL,29,5,0,1,4,11,18
20000609-M-Roland_Garros-SF-Gustavo_Kuerten-Juan_Carlos_Ferrero,1,F-IO,46,20,6,7,7,26,20
20000609-M-Roland_Garros-SF-Gustavo_Kuerten-Juan_Carlos_Ferrero,1,F-II,8,5,1,2,2,3,5
20000609-M-Roland_Garros-SF-Gustavo_Kuerten-Juan_Carlos_Ferrero,1,B-XC,137,22,3,7,12,64,73
20000609-M-Roland_Garros-SF-Gustavo_Kuerten-Juan_Carlos_Ferrero,1,B-DTM,45,5,0,1,4,20,25
20000609-M-Roland_Garros-SF-Gustavo_Kuerten-Juan_Carlos_Ferrero,1,B-DTL,22,11,4,3,4,13,9
20000609-M-Roland_Garros-SF-Gustavo_Kuerten-Juan_Carlos_Ferrero,1,B-IO,2,1,1,0,0,2,0
20000609-M-Roland_Garros-SF-Gustavo_Kuerten-Juan_Carlos_Ferrero,1,S-XC,14,0,0,0,0,7,7
20000609-M-Roland_Garros-SF-Gustavo_Kuerten-Juan_Carlos_Ferrero,1,S-DTM,10,0,0,0,0,0,10
20000609-M-Roland_Garros-SF-Gustavo_Kuerten-Juan_Carlos_Ferrero,2,F-XC,94,34,16,9,9,65,29
20000609-M-Roland_Garros-SF-Gustavo_Kuerten-Juan_Carlos_Ferrero,2,F-DTM,44,3,1,1,1,22,22
20000609-M-Roland_Garros-SF-Gustavo_Kuerten-Juan_Carlos_Ferrero,2,F-DTL,31,9,2,1,5,15,16
20000609-M-Roland_Garros-SF-Gustavo_Kuerten-Juan_Carlos_Ferrero,2,F-IO,78,20,7,5,8,54,24
20000609-M-Roland_Garros-SF-Gustavo_Kuerten-Juan_Carlos_Ferrero,2,F-II,21,9,6,1,2,11,10
20000609-M-Roland_Garros-SF-Gustavo_Kuerten-Juan_Carlos_Ferrero,2,B-XC,99,10,2,2,6,52,47
20000609-M-Roland_Garros-SF-Gustavo_Kuerten-Juan_Carlos_Ferrero,2,B-DTM,39,0,0,0,0,17,22
20000609-M-Roland_Garros-SF-Gustavo_Kuerten-Juan_Carlos_Ferrero,2,B-DTL,46,18,5,5,8,28,18
20000609-M-Roland_Garros-SF-Gustavo_Kuerten-Juan_Carlos_Ferrero,2,B-IO,10,5,1,2,2,8,2
20000609-M-Roland_Garros-SF-Gustavo_Kuerten-Juan_Carlos_Ferrero,2,S-XC,2,1,0,1,0,1,1
20000609-M-Roland_Garros-SF-Gustavo_Kuerten-Juan_Carlos_Ferrero,2,S-DTM,4,0,0,0,0,2,2
20000609-M-Roland_Garros-SF-Gustavo_Kuerten-Juan_Carlos_Ferrero,2,S-DTL,4,0,0,0,0,2,2
20000909-M-US_Open-SF-Marat_Safin-Todd_Martin,1,F-XC,30,10,6,1,3,16,14
20000909-M-US_Open-SF-Marat_Safin-Todd_Martin,1,F-DTM,17,3,0,1,2,7,10
20000909-M-US_Open-SF-Marat_Safin-Todd_Martin,1,F-DTL,10,8,3,1,4,5,5
20000909-M-US_Open-SF-Marat_Safin-Todd_Martin,1,F-IO,9,6,2,1,3,6,3
20000909-M-US_Open-SF-Marat_Safin-Todd_Martin,1,F-II,4,1,0,0,1,2,2
20000909-M-US_Open-SF-Marat_Safin-Todd_Martin,1,B-XC,44,15,10,2,3,30,14
20000909-M-US_Open-SF-Marat_Safin-Todd_Martin,1,B-DTM,19,2,0,0,2,7,12
20000909-M-US_Open-SF-Marat_Safin-Todd_Martin,1,B-DTL,17,12,7,1,4,11,6
20000909-M-US_Open-SF-Marat_Safin-Todd_Martin,1,B-IO,2,1,0,0,1,1,1
20000909-M-US_Open-SF-Marat_Safin-Todd_Martin,1,S-XC,5,0,0,0,0,2,3
20000909-M-US_Open-SF-Marat_Safin-Todd_Martin,1,S-DTM,7,0,0,0,0,2,5
20000909-M-US_Open-SF-Marat_Safin-Todd_Martin,1,S-DTL,4,0,0,0,0,2,2
20000909-M-US_Open-SF-Marat_Safin-Todd_Martin,1,S-IO,1,1,1,0,0,1,0
20000909-M-US_Open-SF-Marat_Safin-Todd_Martin,2,F-XC,27,8,3,1,4,15,12
20000909-M-US_Open-SF-Marat_Safin-Todd_Martin,2,F-DTM,12,1,0,0,1,3,9
20000909-M-US_Open-SF-Marat_Safin-Todd_Martin,2,F-DTL,4,2,1,1,0,2,2
20000909-M-US_Open-SF-Marat_Safin-Todd_Martin,2,F-IO,13,5,2,1,2,6,7
20000909-M-US_Open-SF-Marat_Safin-Todd_Martin,2,F-II,1,1,0,1,0,1,0
20000909-M-US_Open-SF-Marat_Safin-Todd_Martin,2,B-XC,18,1,0,0,1,5,13
20000909-M-US_Open-SF-Marat_Safin-Todd_Martin,2,B-DTM,5,0,0,0,0,4,1
20000909-M-US_Open-SF-Marat_Safin-Todd_Martin,2,B-DTL,4,3,1,0,2,1,3
20000909-M-US_Open-SF-Marat_Safin-Todd_Martin,2,B-IO,2,0,0,0,0,2,0
20000909-M-US_Open-SF-Marat_Safin-Todd_Martin,2,S-XC,18,1,0,1,0,8,10
20000909-M-US_Open-SF-Marat_Safin-Todd_Martin,2,S-DTM,5,2,0,1,1,2,3
20000909-M-US_Open-SF-Marat_Safin-Todd_Martin,2,S-DTL,4,0,0,0,0,2,2
20000909-M-US_Open-SF-Marat_Safin-Todd_Martin,2,S-IO,1,0,0,0,0,1,0
20190308-M-Indian_Wells_Masters-R128-Alexei_Popyrin-Jaume_Munar,1,F-XC,59,22,10,4,8,36,23
20190308-M-Indian_Wells_Masters-R128-Alexei_Popyrin-Jaume_Munar,1,F-DTM,21,1,0,0,1,12,9
20190308-M-Indian_Wells_Masters-R128-Alexei_Popyrin-Jaume_Munar,1,F-DTL,10,3,0,0,2,3,7
20190308-M-Indian_Wells_Masters-R128-Alexei_Popyrin-Jaume_Munar,1,F-IO,27,6,1,2,3,14,13
20190308-M-Indian_Wells_Masters-R128-Alexei_Popyrin-Jaume_Munar,1,F-II,5,3,2,0,1,4,1
20190308-M-Indian_Wells_Masters-R128-Alexei_Popyrin-Jaume_Munar,1,B-XC,26,3,1,0,2,18,8
20190308-M-Indian_Wells_Masters-R128-Alexei_Popyrin-Jaume_Munar,1,B-DTM,21,2,0,0,2,13,8
20190308-M-Indian_Wells_Masters-R128-Alexei_Popyrin-Jaume_Munar,1,B-DTL,9,3,2,0,1,6,3
20190308-M-Indian_Wells_Masters-R128-Alexei_Popyrin-Jaume_Munar,1,B-IO,3,0,0,0,0,1,2
20190308-M-Indian_Wells_Masters-R128-Alexei_Popyrin-Jaume_Munar,1,S-XC,19,1,0,0,1,13,6
20190308-M-Indian_Wells_Masters-R128-Alexei_Popyrin-Jaume_Munar,1,S-DTM,6,1,0,0,1,0,6
20190308-M-Indian_Wells_Masters-R128-Alexei_Popyrin-Jaume_Munar,1,S-DTL,4,0,0,0,0,1,3
20190308-M-Indian_Wells_Masters-R128-Alexei_Popyrin-Jaume_Munar,2,F-XC,55,19,4,7,8,29,26
20190308-M-Indian_Wells_Masters-R128-Alexei_Popyrin-Jaume_Munar,2,F-DTM,20,0,0,0,0,9,11
20190308-M-Indian_Wells_Masters-R128-Alexei_Popyrin-Jaume_Munar,2,F-DTL,20,10,3,1,6,7,13
20190308-M-Indian_Wells_Masters-R128-Alexei_Popyrin-Jaume_Munar,2,F-IO,34,2,0,0,2,13,21
20190308-M-Indian_Wells_Masters-R128-Alexei_Popyrin-Jaume_Munar,2,F-II,4,2,0,0,2,1,3
20190308-M-Indian_Wells_Masters-R128-Alexei_Popyrin-Jaume_Munar,2,B-XC,30,2,0,0,2,11,19
20190308-M-Indian_Wells_Masters-R128-Alexei_Popyrin-Jaume_Munar,2,B-DTM,24,0,0,0,0,11,13
20190308-M-Indian_Wells_Masters-R128-Alexei_Popyrin-Jaume_Munar,2,B-DTL,7,4,3,0,1,5,2
20190308-M-Indian_Wells_Masters-R128-Alexei_Popyrin-Jaume_Munar,2,S-XC,15,2,0,0,2,5,10
20190308-M-Indian_Wells_Masters-R128-Alexei_Popyrin-Jaume_Munar,2,S-DTM,5,0,0,0,0,2,3
20190308-M-Indian_Wells_Masters-R128-Alexei_Popyrin-Jaume_Munar,2,S-DTL,1,1,0,0,1,0,1
20190324-M-Miami_Masters-R32-Hubert_Hurkacz-Felix_Auger_Aliassime,1,F-XC,14,5,1,1,3,7,7
20190324-M-Miami_Masters-R32-Hubert_Hurkacz-Felix_Auger_Aliassime,1,F-DTM,8,0,0,0,0,4,4
20190324-M-Miami_Masters-R32-Hubert_Hurkacz-Felix_Auger_Aliassime,1,F-DTL,14,6,2,1,3,4,10
20190324-M-Miami_Masters-R32-Hubert_Hurkacz-Felix_Auger_Aliassime,1,F-IO,25,8,0,4,4,11,14
20190324-M-Miami_Masters-R32-Hubert_Hurkacz-Felix_Auger_Aliassime,1,F-II,3,0,0,0,0,2,1
20190324-M-Miami_Masters-R32-Hubert_Hurkacz-Felix_Auger_Aliassime,1,B-XC,38,2,0,0,2,22,16
20190324-M-Miami_Masters-R32-Hubert_Hurkacz-Felix_Auger_Aliassime,1,B-DTM,16,2,0,0,1,9,7
20190324-M-Miami_Masters-R32-Hubert_Hurkacz-Felix_Auger_Aliassime,1,B-DTL,11,3,1,1,1,6,5
20190324-M-Miami_Masters-R32-Hubert_Hurkacz-Felix_Auger_Aliassime,1,B-IO,2,0,0,0,0,1,1
20190324-M-Miami_Masters-R32-Hubert_Hurkacz-Felix_Auger_Aliassime,1,S-XC,3,1,0,0,1,0,3
20190324-M-Miami_Masters-R32-Hubert_Hurkacz-Felix_Auger_Aliassime,2,F-XC,20,8,5,1,2,13,7
20190324-M-Miami_Masters-R32-Hubert_Hurkacz-Felix_Auger_Aliassime,2,F-DTM,12,3,0,0,3,4,8
20190324-M-Miami_Masters-R32-Hubert_Hurkacz-Felix_Auger_Aliassime,2,F-DTL,7,5,1,1,3,4,3
20190324-M-Miami_Masters-R32-Hubert_Hurkacz-Felix_Auger_Aliassime,2,F-IO,16,6,1,1,4,6,10
20190324-M-Miami_Masters-R32-Hubert_Hurkacz-Felix_Auger_Aliassime,2,F-II,4,2,1,0,1,3,1
20190324-M-Miami_Masters-R32-Hubert_Hurkacz-Felix_Auger_Aliassime,2,B-XC,44,6,1,2,3,21,23
20190324-M-Miami_Masters-R32-Hubert_Hurkacz-Felix_Auger_Aliassime,2,B-DTM,11,2,0,0,2,3,8
20190324-M-Miami_Masters-R32-Hubert_Hurkacz-Felix_Auger_Aliassime,2,B-DTL,11,6,2,1,3,7,4
20190324-M-Miami_Masters-R32-Hubert_Hurkacz-Felix_Auger_Aliassime,2,B-IO,2,0,0,0,0,2,0
20190324-M-Miami_Masters-R32-Hubert_Hurkacz-Felix_Auger_Aliassime,2,S-XC,10,1,0,0,1,6,4
20190324-M-Miami_Masters-R32-Hubert_Hurkacz-Felix_Auger_Aliassime,2,S-DTM,3,0,0,0,0,2,1
20190325-M-Miami_Masters-R32-Jordan_Thompson-Grigor_Dimitrov,1,F-XC,25,8,1,2,5,14,11
20190325-M-Miami_Masters-R32-Jordan_Thompson-Grigor_Dimitrov,1,F-DTM,26,0,0,0,0,14,12
20190325-M-Miami_Masters-R32-Jordan_Thompson-Grigor_Dimitrov,1,F-DTL,20,3,2,0,1,11,9
20190325-M-Miami_Masters-R32-Jordan_Thompson-Grigor_Dimitrov,1,F-IO,37,6,2,1,3,21,16
20190325-M-Miami_Masters-R32-Jordan_Thompson-Grigor_Dimitrov,1,F-II,5,2,0,2,0,4,1
20190325-M-Miami_Masters-R32-Jordan_Thompson-Grigor_Dimitrov,1,B-XC,34,3,0,0,3,17,17
20190325-M-Miami_Masters-R32-Jordan_Thompson-Grigor_Dimitrov,1,B-DTM,18,1,0,0,1,7,11
20190325-M-Miami_Masters-R32-Jordan_Thompson-Grigor_Dimitrov,1,B-DTL,13,6,1,2,3,7,6
20190325-M-Miami_Masters-R32-Jordan_Thompson-Grigor_Dimitrov,1,B-IO,3,0,0,0,0,3,0
20190325-M-Miami_Masters-R32-Jordan_Thompson-Grigor_Dimitrov,1,S-XC,11,2,0,0,2,6,5
20190325-M-Miami_Masters-R32-Jordan_Thompson-Grigor_Dimitrov,1,S-DTM,3,0,0,0,0,1,2
20190325-M-Miami_Masters-R32-Jordan_Thompson-Grigor_Dimitrov,1,S-DTL,4,0,0,0,0,3,1
20190325-M-Miami_Masters-R32-Jordan_Thompson-Grigor_Dimitrov,2,F-XC,47,13,2,7,4,24,23
20190325-M-Miami_Masters-R32-Jordan_Thompson-Grigor_Dimitrov,2,F-DTM,17,1,0,0,1,6,11
20190325-M-Miami_Masters-R32-Jordan_Thompson-Grigor_Dimitrov,2,F-DTL,8,3,2,0,1,5,3
20190325-M-Miami_Masters-R32-Jordan_Thompson-Grigor_Dimitrov,2,F-IO,46,9,1,3,5,26,20
20190325-M-Miami_Masters-R32-Jordan_Thompson-Grigor_Dimitrov,2,F-II,9,4,0,1,3,5,4
20190325-M-Miami_Masters-R32-Jordan_Thompson-Grigor_Dimitrov,2,B-XC,24,5,0,1,4,8,16
20190325-M-Miami_Masters-R32-Jordan_Thompson-Grigor_Dimitrov,2,B-DTM,15,2,0,0,2,6,9
20190325-M-Miami_Masters-R32-Jordan_Thompson-Grigor_Dimitrov,2,B-DTL,13,5,2,1,2,6,7
20190325-M-Miami_Masters-R32-Jordan_Thompson-Grigor_Dimitrov,2,B-IO,1,0,0,0,0,0,1
20190325-M-Miami_Masters-R32-Jordan_Thompson-Grigor_Dimitrov,2,S-XC,28,4,0,0,4,9,19
20190325-M-Miami_Masters-R32-Jordan_Thompson-Grigor_Dimitrov,2,S-DTM,7,0,0,0,0,2,5
20190325-M-Miami_Masters-R32-Jordan_Thompson-Grigor_Dimitrov,2,S-DTL,4,2,0,1,1,3,1
19970810-M-Cincinnati_Masters-F-Pete_Sampras-Thomas_Muster,1,F-XC,22,9,6,2,1,14,8
19970810-M-Cincinnati_Masters-F-Pete_Sampras-Thomas_Muster,1,F-DTM,2,1,0,0,1,0,2
19970810-M-Cincinnati_Masters-F-Pete_Sampras-Thomas_Muster,1,F-DTL,4,2,1,1,0,2,2
19970810-M-Cincinnati_Masters-F-Pete_Sampras-Thomas_Muster,1,F-IO,12,5,4,0,1,9,3
19970810-M-Cincinnati_Masters-F-Pete_Sampras-Thomas_Muster,1,F-II,6,3,0,1,2,4,2
19970810-M-Cincinnati_Masters-F-Pete_Sampras-Thomas_Muster,1,B-XC,16,6,0,3,3,5,11
19970810-M-Cincinnati_Masters-F-Pete_Sampras-Thomas_Muster,1,B-DTM,12,1,0,0,1,2,10
19970810-M-Cincinnati_Masters-F-Pete_Sampras-Thomas_Muster,1,B-DTL,11,2,0,0,2,6,5
19970810-M-Cincinnati_Masters-F-Pete_Sampras-Thomas_Muster,1,B-IO,1,0,0,0,0,0,1
19970810-M-Cincinnati_Masters-F-Pete_Sampras-Thomas_Muster,1,S-XC,3,0,0,0,0,1,2
19970810-M-Cincinnati_Masters-F-Pete_Sampras-Thomas_Muster,1,S-DTM,2,1,0,0,1,1,1
19970810-M-Cincinnati_Masters-F-Pete_Sampras-Thomas_Muster,1,S-IO,1,0,0,0,0,1,0
19970810-M-Cincinnati_Masters-F-Pete_Sampras-Thomas_Muster,2,F-XC,38,5,0,4,1,22,16
19970810-M-Cincinnati_Masters-F-Pete_Sampras-Thomas_Muster,2,F-DTM,6,0,0,0,0,3,3
19970810-M-Cincinnati_Masters-F-Pete_Sampras-Thomas_Muster,2,F-DTL,4,1,0,1,0,4,0
19970810-M-Cincinnati_Masters-F-Pete_Sampras-Thomas_Muster,2,F-IO,9,4,3,0,1,5,4
19970810-M-Cincinnati_Masters-F-Pete_Sampras-Thomas_Muster,2,F-II,3,1,0,0,1,1,2
19970810-M-Cincinnati_Masters-F-Pete_Sampras-Thomas_Muster,2,B-XC,14,7,2,2,3,8,6
19970810-M-Cincinnati_Masters-F-Pete_Sampras-Thomas_Muster,2,B-DTM,14,2,0,1,1,5,9
19970810-M-Cincinnati_Masters-F-Pete_Sampras-Thomas_Muster,2,B-DTL,5,2,0,0,2,1,4
19970810-M-Cincinnati_Masters-F-Pete_Sampras-Thomas_Muster,2,S-DTM,3,0,0,0,0,0,3
19970810-M-Cincinnati_Masters-F-Pete_Sampras-Thomas_Muster,2,S-DTL,2,0,0,0,0,1,1
20190326-M-Miami_Masters-R16-Borna_Coric-Nick_Kyrgios,1,F-XC,33,10,4,1,5,23,10
20190326-M-Miami_Masters-R16-Borna_Coric-Nick_Kyrgios,1,F-DTM,6,1,0,0,1,5,1
20190326-M-Miami_Masters-R16-Borna_Coric-Nick_Kyrgios,1,F-DTL,8,5,3,0,2,4,4
20190326-M-Miami_Masters-R16-Borna_Coric-Nick_Kyrgios,1,F-IO,11,1,1,0,0,7,4
20190326-M-Miami_Masters-R16-Borna_Coric-Nick_Kyrgios,1,B-XC,24,5,3,1,1,14,10
20190326-M-Miami_Masters-R16-Borna_Coric-Nick_Kyrgios,1,B-DTM,11,1,0,0,1,6,5
20190326-M-Miami_Masters-R16-Borna_Coric-Nick_Kyrgios,1,B-DTL,9,5,2,2,1,6,3
20190326-M-Miami_Masters-R16-Borna_Coric-Nick_Kyrgios,1,B-IO,2,1,0,0,1,1,1
20190326-M-Miami_Masters-R16-Borna_Coric-Nick_Kyrgios,1,S-XC,6,0,0,0,0,5,1
20190326-M-Miami_Masters-R16-Borna_Coric-Nick_Kyrgios,1,S-DTM,3,0,0,0,0,1,2
20190326-M-Miami_Masters-R16-Borna_Coric-Nick_Kyrgios,1,S-DTL,3,1,1,0,0,1,2
20190326-M-Miami_Masters-R16-Borna_Coric-Nick_Kyrgios,1,S-IO,1,1,0,1,0,1,0
20190326-M-Miami_Masters-R16-Borna_Coric-Nick_Kyrgios,2,F-XC,23,5,1,1,3,8,15
20190326-M-Miami_Masters-R16-Borna_Coric-Nick_Kyrgios,2,F-DTM,11,3,0,0,3,0,11
20190326-M-Miami_Masters-R16-Borna_Coric-Nick_Kyrgios,2,F-DTL,9,5,0,1,4,2,7
20190326-M-Miami_Masters-R16-Borna_Coric-Nick_Kyrgios,2,F-IO,8,3,1,0,2,4,4
20190326-M-Miami_Masters-R16-Borna_Coric-Nick_Kyrgios,2,F-II,3,3,2,0,1,2,1
20190326-M-Miami_Masters-R16-Borna_Coric-Nick_Kyrgios,2,B-XC,21,4,0,1,3,6,15
20190326-M-Miami_Masters-R16-Borna_Coric-Nick_Kyrgios,2,B-DTM,14,1,0,0,1,4,10
20190326-M-Miami_Masters-R16-Borna_Coric-Nick_Kyrgios,2,B-DTL,6,1,0,1,0,4,2
20190326-M-Miami_Masters-R16-Borna_Coric-Nick_Kyrgios,2,S-XC,5,2,1,0,1,3,2
20190326-M-Miami_Masters-R16-Borna_Coric-Nick_Kyrgios,2,S-DTM,2,0,0,0,0,0,2
20190326-M-Miami_Masters-R16-Borna_Coric-Nick_Kyrgios,2,S-DTL,4,0,0,0,0,0,4
20190327-M-Miami_Masters-R16-Daniil_Medvedev-Roger_Federer,1,F-XC,23,4,3,0,1,10,13
20190327-M-Miami_Masters-R16-Daniil_Medvedev-Roger_Federer,1,F-DTM,10,2,0,0,2,2,8
20190327-M-Miami_Masters-R16-Daniil_Medvedev-Roger_Federer,1,F-DTL,13,4,1,1,2,3,10
20190327-M-Miami_Masters-R16-Daniil_Medvedev-Roger_Federer,1,F-IO,10,3,0,1,2,4,6
20190327-M-Miami_Masters-R16-Daniil_Medvedev-Roger_Federer,1,B-XC,53,13,3,5,5,19,34
20190327-M-Miami_Masters-R16-Daniil_Medvedev-Roger_Federer,1,B-DTM,15,0,0,0,0,4,11
20190327-M-Miami_Masters-R16-Daniil_Medvedev-Roger_Federer,1,B-DTL,8,3,1,1,1,5,3
20190327-M-Miami_Masters-R16-Daniil_Medvedev-Roger_Federer,1,B-IO,5,3,0,2,1,4,1
20190327-M-Miami_Masters-R16-Daniil_Medvedev-Roger_Federer,1,S-XC,1,0,0,0,0,0,1
20190327-M-Miami_Masters-R16-Daniil_Medvedev-Roger_Federer,1,S-DTL,2,0,0,0,0,1,1
20190327-M-Miami_Masters-R16-Daniil_Medvedev-Roger_Federer,2,F-XC,28,7,4,1,2,17,11
20190327-M-Miami_Masters-R16-Daniil_Medvedev-Roger_Federer,2,F-DTM,18,1,0,0,1,11,7
20190327-M-Miami_Masters-R16-Daniil_Medvedev-Roger_Federer,2,F-DTL,11,2,0,1,1,7,4
20190327-M-Miami_Masters-R16-Daniil_Medvedev-Roger_Federer,2,F-IO,15,4,3,1,0,11,4
20190327-M-Miami_Masters-R16-Daniil_Medvedev-Roger_Federer,2,F-II,2,1,0,1,0,2,0
20190327-M-Miami_Masters-R16-Daniil_Medvedev-Roger_Federer,2,B-XC,17,5,3,0,2,11,6
20190327-M-Miami_Masters-R16-Daniil_Medvedev-Roger_Federer,2,B-DTM,11,0,0,0,0,9,2
20190327-M-Miami_Masters-R16-Daniil_Medvedev-Roger_Federer,2,B-DTL,2,0,0,0,0,1,1
20190327-M-Miami_Masters-R16-Daniil_Medvedev-Roger_Federer,2,S-XC,12,0,0,0,0,9,3
20190327-M-Miami_Masters-R16-Daniil_Medvedev-Roger_Federer,2,S-DTM,8,0,0,0,0,7,1
20190327-M-Miami_Masters-R16-Daniil_Medvedev-Roger_Federer,2,S-DTL,7,1,1,0,0,7,0
20190327-M-Miami_Masters-R16-Daniil_Medvedev-Roger_Federer,2,S-IO,1,0,0,0,0,1,0
20140613-M-Nottingham_CH-SF-Nick_Kyrgios-Miloslav_Mecir,1,F-XC,19,7,4,2,1,12,7
20140613-M-Nottingham_CH-SF-Nick_Kyrgios-Miloslav_Mecir,1,F-DTM,16,1,0,1,0,6,10
20140613-M-Nottingham_CH-SF-Nick_Kyrgios-Miloslav_Mecir,1,F-DTL,9,4,2,0,2,6,3
20140613-M-Nottingham_CH-SF-Nick_Kyrgios-Miloslav_Mecir,1,F-IO,8,1,0,1,0,7,1
20140613-M-Nottingham_CH-SF-Nick_Kyrgios-Miloslav_Mecir,1,B-XC,24,5,3,1,1,17,7
20140613-M-Nottingham_CH-SF-Nick_Kyrgios-Miloslav_Mecir,1,B-DTM,15,1,0,0,1,9,6
20140613-M-Nottingham_CH-SF-Nick_Kyrgios-Miloslav_Mecir,1,B-DTL,5,2,1,0,1,3,2
20140613-M-Nottingham_CH-SF-Nick_Kyrgios-Miloslav_Mecir,1,B-IO,3,1,0,1,0,1,2
20140613-M-Nottingham_CH-SF-Nick_Kyrgios-Miloslav_Mecir,1,S-XC,1,0,0,0,0,1,0
20140613-M-Nottingham_CH-SF-Nick_Kyrgios-Miloslav_Mecir,1,S-DTM,1,0,0,0,0,1,0
20140613-M-Nottingham_CH-SF-Nick_Kyrgios-Miloslav_Mecir,2,F-XC,20,1,1,0,0,12,8
20140613-M-Nottingham_CH-SF-Nick_Kyrgios-Miloslav_Mecir,2,F-DTM,16,1,0,0,1,5,11
20140613-M-Nottingham_CH-SF-Nick_Kyrgios-Miloslav_Mecir,2,F-DTL,5,3,2,0,1,3,2
20140613-M-Nottingham_CH-SF-Nick_Kyrgios-Miloslav_Mecir,2,F-IO,12,4,2,2,0,9,3
20140613-M-Nottingham_CH-SF-Nick_Kyrgios-Miloslav_Mecir,2,F-II,1,0,0,0,0,0,1
20140613-M-Nottingham_CH-SF-Nick_Kyrgios-Miloslav_Mecir,2,B-XC,23,7,1,4,2,10,13
20140613-M-Nottingham_CH-SF-Nick_Kyrgios-Miloslav_Mecir,2,B-DTM,11,3,0,0,3,3,8
20140613-M-Nottingham_CH-SF-Nick_Kyrgios-Miloslav_Mecir,2,B-DTL,6,1,0,0,1,2,4
20140613-M-Nottingham_CH-SF-Nick_Kyrgios-Miloslav_Mecir,2,B-IO,6,3,1,0,2,3,3
20140613-M-Nottingham_CH-SF-Nick_Kyrgios-Miloslav_Mecir,2,S-XC,7,4,1,0,3,1,6
20140613-M-Nottingham_CH-SF-Nick_Kyrgios-Miloslav_Mecir,2,S-DTM,6,2,0,0,2,0,6
20140613-M-Nottingham_CH-SF-Nick_Kyrgios-Miloslav_Mecir,2,S-DTL,4,2,0,1,1,1,3
20180914-M-Davis_Cup_World_Group_PO-RR-Denis_Shapovalov-Robin_Haase,1,F-XC,108,19,3,6,10,65,43
20180914-M-Davis_Cup_World_Group_PO-RR-Denis_Shapovalov-Robin_Haase,1,F-DTM,47,4,0,0,4,23,24
20180914-M-Davis_Cup_World_Group_PO-RR-Denis_Shapovalov-Robin_Haase,1,F-DTL,23,10,4,3,3,15,8
20180914-M-Davis_Cup_World_Group_PO-RR-Denis_Shapovalov-Robin_Haase,1,F-IO,56,29,14,3,12,31,25
20180914-M-Davis_Cup_World_Group_PO-RR-Denis_Shapovalov-Robin_Haase,1,F-II,8,4,0,3,1,5,3
20180914-M-Davis_Cup_World_Group_PO-RR-Denis_Shapovalov-Robin_Haase,1,B-XC,73,12,3,1,8,41,32
20180914-M-Davis_Cup_World_Group_PO-RR-Denis_Shapovalov-Robin_Haase,1,B-DTM,37,3,0,0,3,16,21
20180914-M-Davis_Cup_World_Group_PO-RR-Denis_Shapovalov-Robin_Haase,1,B-DTL,16,6,1,0,5,5,11
20180914-M-Davis_Cup_World_Group_PO-RR-Denis_Shapovalov-Robin_Haase,1,B-IO,10,3,2,0,1,3,7
20180914-M-Davis_Cup_World_Group_PO-RR-Denis_Shapovalov-Robin_Haase,1,S-DTM,6,2,1,0,1,2,4
20180914-M-Davis_Cup_World_Group_PO-RR-Denis_Shapovalov-Robin_Haase,1,S-DTL,6,2,0,0,2,2,4
20180914-M-Davis_Cup_World_Group_PO-RR-Denis_Shapovalov-Robin_Haase,2,F-XC,94,17,5,3,9,47,47
20180914-M-Davis_Cup_World_Group_PO-RR-Denis_Shapovalov-Robin_Haase,2,F-DTM,46,7,0,1,6,18,28
20180914-M-Davis_Cup_World_Group_PO-RR-Denis_Shapovalov-Robin_Haase,2,F-DTL,20,11,3,3,5,7,13
20180914-M-Davis_Cup_World_Group_PO-RR-Denis_Shapovalov-Robin_Haase,2,F-IO,33,11,4,2,5,15,18
20180914-M-Davis_Cup_World_Group_PO-RR-Denis_Shapovalov-Robin_Haase,2,F-II,9,5,1,1,3,4,5
20180914-M-Davis_Cup_World_Group_PO-RR-Denis_Shapovalov-Robin_Haase,2,B-XC,18,5,0,2,3,9,9
20180914-M-Davis_Cup_World_Group_PO-RR-Denis_Shapovalov-Robin_Haase,2,B-DTM,46,5,0,1,4,17,29
20180914-M-Davis_Cup_World_Group_PO-RR-Denis_Shapovalov-Robin_Haase,2,B-DTL,9,5,2,0,3,5,4
20180914-M-Davis_Cup_World_Group_PO-RR-Denis_Shapovalov-Robin_Haase,2,B-IO,14,0,0,0,0,7,7
20180914-M-Davis_Cup_World_Group_PO-RR-Denis_Shapovalov-Robin_Haase,2,S-XC,37,3,1,1,1,22,15
20180914-M-Davis_Cup_World_Group_PO-RR-Denis_Shapovalov-Robin_Haase,2,S-DTM,27,0,0,0,0,13,14
20180914-M-Davis_Cup_World_Group_PO-RR-Denis_Shapovalov-Robin_Haase,2,S-DTL,10,0,0,0,0,4,6
20180914-M-Davis_Cup_World_Group_PO-RR-Denis_Shapovalov-Robin_Haase,2,S-IO,5,0,0,0,0,2,3
20190321-M-Miami_Masters-R64-Aljaz_Bedene-Adrian_Mannarino,1,F-XC,77,14,3,3,8,33,44
20190321-M-Miami_Masters-R64-Aljaz_Bedene-Adrian_Mannarino,1,F-DTM,28,1,0,0,1,18,10
20190321-M-Miami_Masters-R64-Aljaz_Bedene-Adrian_Mannarino,1,F-DTL,17,5,1,1,3,7,10
20190321-M-Miami_Masters-R64-Aljaz_Bedene-Adrian_Mannarino,1,F-IO,56,19,5,2,12,26,30
20190321-M-Miami_Masters-R64-Aljaz_Bedene-Adrian_Mannarino,1,F-II,9,3,0,0,3,3,6
20190321-M-Miami_Masters-R64-Aljaz_Bedene-Adrian_Mannarino,1,B-XC,61,10,1,6,3,21,40
20190321-M-Miami_Masters-R64-Aljaz_Bedene-Adrian_Mannarino,1,B-DTM,31,2,0,0,2,12,19
20190321-M-Miami_Masters-R64-Aljaz_Bedene-Adrian_Mannarino,1,B-DTL,21,5,1,2,2,10,11
20190321-M-Miami_Masters-R64-Aljaz_Bedene-Adrian_Mannarino,1,B-IO,2,0,0,0,0,1,1
20190321-M-Miami_Masters-R64-Aljaz_Bedene-Adrian_Mannarino,1,B-II,1,0,0,0,0,1,0
20190321-M-Miami_Masters-R64-Aljaz_Bedene-Adrian_Mannarino,1,S-XC,20,1,0,1,0,14,6
20190321-M-Miami_Masters-R64-Aljaz_Bedene-Adrian_Mannarino,1,S-DTM,13,1,0,0,1,4,9
20190321-M-Miami_Masters-R64-Aljaz_Bedene-Adrian_Mannarino,1,S-DTL,15,2,0,0,2,8,7
20190321-M-Miami_Masters-R64-Aljaz_Bedene-Adrian_Mannarino,1,S-IO,3,0,0,0,0,2,1
20190321-M-Miami_Masters-R64-Aljaz_Bedene-Adrian_Mannarino,2,F-XC,145,10,0,3,7,84,61
20190321-M-Miami_Masters-R64-Aljaz_Bedene-Adrian_Mannarino,2,F-DTM,24,2,0,0,2,10,14
20190321-M-Miami_Masters-R64-Aljaz_Bedene-Adrian_Mannarino,2,F-DTL,13,3,1,0,2,4,9
20190321-M-Miami_Masters-R64-Aljaz_Bedene-Adrian_Mannarino,2,F-IO,7,3,2,1,0,5,2
20190321-M-Miami_Masters-R64-Aljaz_Bedene-Adrian_Mannarino,2,F-II,1,0,0,0,0,1,0
20190321-M-Miami_Masters-R64-Aljaz_Bedene-Adrian_Mannarino,2,B-XC,78,10,2,5,3,46,32
20190321-M-Miami_Masters-R64-Aljaz_Bedene-Adrian_Mannarino,2,B-DTM,36,0,0,0,0,16,20
20190321-M-Miami_Masters-R64-Aljaz_Bedene-Adrian_Mannarino,2,B-DTL,23,6,2,1,3,11,12
20190321-M-Miami_Masters-R64-Aljaz_Bedene-Adrian_Mannarino,2,B-IO,14,2,0,1,1,7,7
20190321-M-Miami_Masters-R64-Aljaz_Bedene-Adrian_Mannarino,2,S-DTM,3,1,0,0,1,1,2
20190321-M-Miami_Masters-R64-Aljaz_Bedene-Adrian_Mannarino,2,S-DTL,2,0,0,0,0,0,2
20190321-M-Miami_Masters-R64-Aljaz_Bedene-Adrian_Mannarino,2,S-IO,2,0,0,0,0,2,0
19980704-M-Wimbledon-SF-Goran_Ivanisevic-Richard_Krajicek,1,F-XC,17,6,1,2,3,7,10
19980704-M-Wimbledon-SF-Goran_Ivanisevic-Richard_Krajicek,1,F-DTL,2,2,2,0,0,2,0
19980704-M-Wimbledon-SF-Goran_Ivanisevic-Richard_Krajicek,1,F-IO,4,3,2,1,0,3,1
19980704-M-Wimbledon-SF-Goran_Ivanisevic-Richard_Krajicek,1,F-II,1,1,1,0,0,1,0
19980704-M-Wimbledon-SF-Goran_Ivanisevic-Richard_Krajicek,1,B-XC,9,8,4,2,2,6,3
19980704-M-Wimbledon-SF-Goran_Ivanisevic-Richard_Krajicek,1,B-DTM,2,0,0,0,0,0,2
19980704-M-Wimbledon-SF-Goran_Ivanisevic-Richard_Krajicek,1,B-DTL,7,3,2,1,0,4,3
19980704-M-Wimbledon-SF-Goran_Ivanisevic-Richard_Krajicek,1,B-IO,2,2,0,2,0,2,0
19980704-M-Wimbledon-SF-Goran_Ivanisevic-Richard_Krajicek,1,S-XC,3,1,0,1,0,1,2
19980704-M-Wimbledon-SF-Goran_Ivanisevic-Richard_Krajicek,1,S-DTM,1,0,0,0,0,0,1
19980704-M-Wimbledon-SF-Goran_Ivanisevic-Richard_Krajicek,1,S-DTL,7,3,1,2,0,5,2
19980704-M-Wimbledon-SF-Goran_Ivanisevic-Richard_Krajicek,1,S-IO,1,0,0,0,0,0,1
19980704-M-Wimbledon-SF-Goran_Ivanisevic-Richard_Krajicek,2,F-XC,4,2,0,2,0,4,0
19980704-M-Wimbledon-SF-Goran_Ivanisevic-Richard_Krajicek,2,F-DTM,2,0,0,0,0,0,2
19980704-M-Wimbledon-SF-Goran_Ivanisevic-Richard_Krajicek,2,F-DTL,3,2,2,0,0,2,1
19980704-M-Wimbledon-SF-Goran_Ivanisevic-Richard_Krajicek,2,F-II,1,1,0,1,0,1,0
19980704-M-Wimbledon-SF-Goran_Ivanisevic-Richard_Krajicek,2,B-XC,9,8,4,1,3,5,4
19980704-M-Wimbledon-SF-Goran_Ivanisevic-Richard_Krajicek,2,B-DTM,3,1,0,0,1,0,3
19980704-M-Wimbledon-SF-Goran_Ivanisevic-Richard_Krajicek,2,B-DTL,4,3,0,2,1,2,2
19980704-M-Wimbledon-SF-Goran_Ivanisevic-Richard_Krajicek,2,B-IO,1,0,0,0,0,0,1
19980704-M-Wimbledon-SF-Goran_Ivanisevic-Richard_Krajicek,2,S-XC,2,1,1,0,0,1,1
19980704-M-Wimbledon-SF-Goran_Ivanisevic-Richard_Krajicek,2,S-DTL,1,0,0,0,0,1,0
20190307-M-Indian_Wells_Masters-R128-Marcos_Giron-Jeremy_Chardy,1,F-XC,18,3,0,1,2,11,7
20190307-M-Indian_Wells_Masters-R128-Marcos_Giron-Jeremy_Chardy,1,F-DTM,36,3,0,1,2,14,22
20190307-M-Indian_Wells_Masters-R128-Marcos_Giron-Jeremy_Chardy,1,F-DTL,5,1,0,0,1,4,1
20190307-M-Indian_Wells_Masters-R128-Marcos_Giron-Jeremy_Chardy,1,F-IO,24,8,1,4,3,16,8
20190307-M-Indian_Wells_Masters-R128-Marcos_Giron-Jeremy_Chardy,1,F-II,1,1,0,1,0,1,0
20190307-M-Indian_Wells_Masters-R128-Marcos_Giron-Jeremy_Chardy,1,B-XC,37,4,1,2,1,25,12
20190307-M-Indian_Wells_Masters-R128-Marcos_Giron-Jeremy_Chardy,1,B-DTM,16,0,0,0,0,9,7
20190307-M-Indian_Wells_Masters-R128-Marcos_Giron-Jeremy_Chardy,1,B-DTL,5,0,0,0,0,4,1
20190307-M-Indian_Wells_Masters-R128-Marcos_Giron-Jeremy_Chardy,1,B-IO,4,3,0,1,2,2,2
20190307-M-Indian_Wells_Masters-R128-Marcos_Giron-Jeremy_Chardy,1,S-XC,1,0,0,0,0,1,0
20190307-M-Indian_Wells_Masters-R128-Marcos_Giron-Jeremy_Chardy,1,S-DTM,7,2,0,0,2,3,4
20190307-M-Indian_Wells_Masters-R128-Marcos_Giron-Jeremy_Chardy,1,S-DTL,1,0,0,0,0,0,1
20190307-M-Indian_Wells_Masters-R128-Marcos_Giron-Jeremy_Chardy,2,F-XC,43,16,4,4,8,27,16
20190307-M-Indian_Wells_Masters-R128-Marcos_Giron-Jeremy_Chardy,2,F-DTM,24,2,0,0,2,9,15
20190307-M-Indian_Wells_Masters-R128-Marcos_Giron-Jeremy_Chardy,2,F-DTL,7,4,2,1,1,3,4
20190307-M-Indian_Wells_Masters-R128-Marcos_Giron-Jeremy_Chardy,2,F-IO,40,21,5,6,10,20,20
20190307-M-Indian_Wells_Masters-R128-Marcos_Giron-Jeremy_Chardy,2,F-II,7,3,2,0,1,4,3
20190307-M-Indian_Wells_Masters-R128-Marcos_Giron-Jeremy_Chardy,2,B-XC,17,3,0,0,3,6,11
20190307-M-Indian_Wells_Masters-R128-Marcos_Giron-Jeremy_Chardy,2,B-DTM,10,3,0,0,3,1,9
20190307-M-Indian_Wells_Masters-R128-Marcos_Giron-Jeremy_Chardy,2,B-DTL,7,7,0,1,6,1,6
20190307-M-Indian_Wells_Masters-R128-Marcos_Giron-Jeremy_Chardy,2,B-IO,4,3,0,1,2,2,2
20190307-M-Indian_Wells_Masters-R128-Marcos_Giron-Jeremy_Chardy,2,S-XC,14,2,0,0,2,6,8
20190307-M-Indian_Wells_Masters-R128-Marcos_Giron-Jeremy_Chardy,2,S-DTM,6,2,0,0,2,1,5
20190307-M-Indian_Wells_Masters-R128-Marcos_Giron-Jeremy_Chardy,2,S-DTL,4,1,0,0,1,1,3
20190327-M-Miami_Masters-QF-John_Isner-Roberto_Bautista_Agut,1,F-XC,28,12,3,4,5,12,16
20190327-M-Miami_Masters-QF-John_Isner-Roberto_Bautista_Agut,1,F-DTM,13,1,0,0,1,3,10
20190327-M-Miami_Masters-QF-John_Isner-Roberto_Bautista_Agut,1,F-DTL,14,4,1,1,2,5,9
20190327-M-Miami_Masters-QF-John_Isner-Roberto_Bautista_Agut,1,F-IO,30,15,3,2,10,10,20
20190327-M-Miami_Masters-QF-John_Isner-Roberto_Bautista_Agut,1,F-II,5,3,0,0,3,0,5
20190327-M-Miami_Masters-QF-John_Isner-Roberto_Bautista_Agut,1,B-XC,28,7,2,0,5,11,17
20190327-M-Miami_Masters-QF-John_Isner-Roberto_Bautista_Agut,1,B-DTM,31,2,0,0,2,13,18
20190327-M-Miami_Masters-QF-John_Isner-Roberto_Bautista_Agut,1,B-DTL,12,5,1,0,4,2,10
20190327-M-Miami_Masters-QF-John_Isner-Roberto_Bautista_Agut,1,S-XC,13,1,0,0,1,3,10
20190327-M-Miami_Masters-QF-John_Isner-Roberto_Bautista_Agut,1,S-DTM,6,2,0,0,2,2,4
20190327-M-Miami_Masters-QF-John_Isner-Roberto_Bautista_Agut,2,F-XC,26,4,2,0,2,19,7
20190327-M-Miami_Masters-QF-John_Isner-Roberto_Bautista_Agut,2,F-DTM,19,0,0,0,0,12,7
20190327-M-Miami_Masters-QF-John_Isner-Roberto_Bautista_Agut,2,F-DTL,9,3,2,1,0,6,3
20190327-M-Miami_Masters-QF-John_Isner-Roberto_Bautista_Agut,2,F-IO,47,6,3,1,2,32,15
20190327-M-Miami_Masters-QF-John_Isner-Roberto_Bautista_Agut,2,F-II,6,0,0,0,0,3,3
20190327-M-Miami_Masters-QF-John_Isner-Roberto_Bautista_Agut,2,B-XC,38,4,1,0,3,23,15
20190327-M-Miami_Masters-QF-John_Isner-Roberto_Bautista_Agut,2,B-DTM,14,0,0,0,0,9,5
20190327-M-Miami_Masters-QF-John_Isner-Roberto_Bautista_Agut,2,B-DTL,1,1,0,0,1,0,1
20190327-M-Miami_Masters-QF-John_Isner-Roberto_Bautista_Agut,2,B-IO,1,0,0,0,0,0,1
20190327-M-Miami_Masters-QF-John_Isner-Roberto_Bautista_Agut,2,S-XC,7,0,0,0,0,6,1
20190327-M-Miami_Masters-QF-John_Isner-Roberto_Bautista_Agut,2,S-DTM,4,0,0,0,0,3,1
20190327-M-Miami_Masters-QF-John_Isner-Roberto_Bautista_Agut,2,S-DTL,3,0,0,0,0,2,1
20190323-M-Miami_Masters-R32-Francis_Tiafoe-Miomir_Kecmanovic,1,F-XC,56,22,8,3,11,32,24
20190323-M-Miami_Masters-R32-Francis_Tiafoe-Miomir_Kecmanovic,1,F-DTM,12,1,0,1,0,6,6
20190323-M-Miami_Masters-R32-Francis_Tiafoe-Miomir_Kecmanovic,1,F-DTL,10,4,4,0,0,8,2
20190323-M-Miami_Masters-R32-Francis_Tiafoe-Miomir_Kecmanovic,1,F-IO,11,5,1,0,4,4,7
20190323-M-Miami_Masters-R32-Francis_Tiafoe-Miomir_Kecmanovic,1,F-II,4,1,0,0,1,2,2
20190323-M-Miami_Masters-R32-Francis_Tiafoe-Miomir_Kecmanovic,1,B-XC,47,9,3,3,3,19,28
20190323-M-Miami_Masters-R32-Francis_Tiafoe-Miomir_Kecmanovic,1,B-DTM,24,1,0,1,0,11,13
20190323-M-Miami_Masters-R32-Francis_Tiafoe-Miomir_Kecmanovic,1,B-DTL,10,4,2,1,1,7,3
20190323-M-Miami_Masters-R32-Francis_Tiafoe-Miomir_Kecmanovic,1,B-IO,4,3,0,0,3,0,4
20190323-M-Miami_Masters-R32-Francis_Tiafoe-Miomir_Kecmanovic,1,S-XC,19,1,0,0,1,8,11
20190323-M-Miami_Masters-R32-Francis_Tiafoe-Miomir_Kecmanovic,1,S-DTM,2,0,0,0,0,1,1
20190323-M-Miami_Masters-R32-Francis_Tiafoe-Miomir_Kecmanovic,1,S-DTL,2,1,1,0,0,1,1
20190323-M-Miami_Masters-R32-Francis_Tiafoe-Miomir_Kecmanovic,2,F-XC,51,11,4,3,4,27,24
20190323-M-Miami_Masters-R32-Francis_Tiafoe-Miomir_Kecmanovic,2,F-DTM,17,1,0,0,1,5,12
20190323-M-Miami_Masters-R32-Francis_Tiafoe-Miomir_Kecmanovic,2,F-DTL,15,7,1,2,4,8,7
20190323-M-Miami_Masters-R32-Francis_Tiafoe-Miomir_Kecmanovic,2,F-IO,32,10,5,1,4,17,15
20190323-M-Miami_Masters-R32-Francis_Tiafoe-Miomir_Kecmanovic,2,F-II,3,2,0,1,1,1,2
20190323-M-Miami_Masters-R32-Francis_Tiafoe-Miomir_Kecmanovic,2,B-XC,38,3,0,0,3,20,18
20190323-M-Miami_Masters-R32-Francis_Tiafoe-Miomir_Kecmanovic,2,B-DTM,20,0,0,0,0,11,9
20190323-M-Miami_Masters-R32-Francis_Tiafoe-Miomir_Kecmanovic,2,B-DTL,8,4,2,2,0,7,1
20190323-M-Miami_Masters-R32-Francis_Tiafoe-Miomir_Kecmanovic,2,B-IO,2,0,0,0,0,1,1
20190323-M-Miami_Masters-R32-Francis_Tiafoe-Miomir_Kecmanovic,2,S-XC,14,0,0,0,0,10,4
20190323-M-Miami_Masters-R32-Francis_Tiafoe-Miomir_Kecmanovic,2,S-DTM,5,0,0,0,0,4,1
20190323-M-Miami_Masters-R32-Francis_Tiafoe-Miomir_Kecmanovic,2,S-DTL,4,0,0,0,0,0,4
20190322-M-Miami_Masters-R64-Nick_Kyrgios-Alexander_Bublik,1,F-XC,16,7,5,0,2,12,4
20190322-M-Miami_Masters-R64-Nick_Kyrgios-Alexander_Bublik,1,F-DTM,3,1,0,1,0,2,1
20190322-M-Miami_Masters-R64-Nick_Kyrgios-Alexander_Bublik,1,F-DTL,2,1,1,0,0,1,1
20190322-M-Miami_Masters-R64-Nick_Kyrgios-Alexander_Bublik,1,F-IO,13,5,3,1,1,10,3
20190322-M-Miami_Masters-R64-Nick_Kyrgios-Alexander_Bublik,1,F-II,1,1,1,0,0,1,0
20190322-M-Miami_Masters-R64-Nick_Kyrgios-Alexander_Bublik,1,B-XC,22,9,1,1,7,9,13
20190322-M-Miami_Masters-R64-Nick_Kyrgios-Alexander_Bublik,1,B-DTM,11,1,0,0,1,3,8
20190322-M-Miami_Masters-R64-Nick_Kyrgios-Alexander_Bublik,1,B-DTL,8,3,1,0,2,4,4
20190322-M-Miami_Masters-R64-Nick_Kyrgios-Alexander_Bublik,1,B-IO,3,1,0,0,1,1,2
20190322-M-Miami_Masters-R64-Nick_Kyrgios-Alexander_Bublik,1,S-XC,4,1,0,1,0,3,1
20190322-M-Miami_Masters-R64-Nick_Kyrgios-Alexander_Bublik,1,S-DTM,2,0,0,0,0,2,0
20190322-M-Miami_Masters-R64-Nick_Kyrgios-Alexander_Bublik,1,S-DTL,4,2,1,1,0,3,1
20190322-M-Miami_Masters-R64-Nick_Kyrgios-Alexander_Bublik,2,F-XC,10,3,1,1,1,4,6
20190322-M-Miami_Masters-R64-Nick_Kyrgios-Alexander_Bublik,2,F-DTM,7,0,0,0,0,3,4
20190322-M-Miami_Masters-R64-Nick_Kyrgios-Alexander_Bublik,2,F-DTL,8,2,1,0,1,5,3
20190322-M-Miami_Masters-R64-Nick_Kyrgios-Alexander_Bublik,2,F-IO,3,1,0,1,0,1,2
20190322-M-Miami_Masters-R64-Nick_Kyrgios-Alexander_Bublik,2,F-II,1,1,1,0,0,1,0
20190322-M-Miami_Masters-R64-Nick_Kyrgios-Alexander_Bublik,2,B-XC,26,8,3,2,3,15,11
20190322-M-Miami_Masters-R64-Nick_Kyrgios-Alexander_Bublik,2,B-DTM,7,0,0,0,0,3,4
20190322-M-Miami_Masters-R64-Nick_Kyrgios-Alexander_Bublik,2,B-DTL,2,2,1,0,1,1,1
20190322-M-Miami_Masters-R64-Nick_Kyrgios-Alexander_Bublik,2,S-XC,11,3,0,1,2,5,6
20190322-M-Miami_Masters-R64-Nick_Kyrgios-Alexander_Bublik,2,S-DTM,2,1,0,0,1,1,1
20010707-M-Wimbledon-SF-Goran_Ivanisevic-Tim_Henman,1,F-XC,7,4,2,2,0,5,2
20010707-M-Wimbledon-SF-Goran_Ivanisevic-Tim_Henman,1,F-DTM,2,0,0,0,0,1,1
20010707-M-Wimbledon-SF-Goran_Ivanisevic-Tim_Henman,1,F-DTL,1,0,0,0,0,0,1
20010707-M-Wimbledon-SF-Goran_Ivanisevic-Tim_Henman,1,F-IO,1,0,0,0,0,0,1
20010707-M-Wimbledon-SF-Goran_Ivanisevic-Tim_Henman,1,F-II,1,1,1,0,0,1,0
20010707-M-Wimbledon-SF-Goran_Ivanisevic-Tim_Henman,1,B-XC,8,8,3,1,4,4,4
20010707-M-Wimbledon-SF-Goran_Ivanisevic-Tim_Henman,1,B-DTM,9,3,0,1,2,2,7
20010707-M-Wimbledon-SF-Goran_Ivanisevic-Tim_Henman,1,B-DTL,9,5,1,0,4,3,6
20010707-M-Wimbledon-SF-Goran_Ivanisevic-Tim_Henman,1,B-IO,2,2,0,1,1,1,1
20010707-M-Wimbledon-SF-Goran_Ivanisevic-Tim_Henman,1,S-XC,1,0,0,0,0,0,1
20010707-M-Wimbledon-SF-Goran_Ivanisevic-Tim_Henman,1,S-DTM,1,0,0,0,0,0,1
20010707-M-Wimbledon-SF-Goran_Ivanisevic-Tim_Henman,1,S-DTL,2,0,0,0,0,1,1
20010707-M-Wimbledon-SF-Goran_Ivanisevic-Tim_Henman,1,S-IO,2,0,0,0,0,1,1
20010707-M-Wimbledon-SF-Goran_Ivanisevic-Tim_Henman,2,F-XC,11,5,3,1,1,9,2
20010707-M-Wimbledon-SF-Goran_Ivanisevic-Tim_Henman,2,F-DTM,4,0,0,0,0,2,2
20010707-M-Wimbledon-SF-Goran_Ivanisevic-Tim_Henman,2,F-DTL,6,5,4,1,0,6,0
20010707-M-Wimbledon-SF-Goran_Ivanisevic-Tim_Henman,2,F-IO,3,0,0,0,0,1,2
20010707-M-Wimbledon-SF-Goran_Ivanisevic-Tim_Henman,2,F-II,3,1,0,1,0,2,1
20010707-M-Wimbledon-SF-Goran_Ivanisevic-Tim_Henman,2,B-XC,12,9,5,1,3,6,6
20010707-M-Wimbledon-SF-Goran_Ivanisevic-Tim_Henman,2,B-DTM,1,1,0,0,1,0,1
20010707-M-Wimbledon-SF-Goran_Ivanisevic-Tim_Henman,2,B-DTL,5,5,1,3,1,4,1
20010707-M-Wimbledon-SF-Goran_Ivanisevic-Tim_Henman,2,S-XC,1,0,0,0,0,1,0
20010707-M-Wimbledon-SF-Goran_Ivanisevic-Tim_Henman,2,S-DTM,1,0,0,0,0,0,1
20010707-M-Wimbledon-SF-Goran_Ivanisevic-Tim_Henman,2,S-DTL,1,1,0,0,1,0,1
